OPE ID,School,State,Zip Code,School Type,20062007Qtr5_Dependent Students,20062007Qtr5_Independent Students,Quarterly Total,YTD_20062007Qtr5_Dependent Students,YTD_20062007Qtr5_Independent Students,Award Year To Date Total
00100200,ALABAMA AGRCLTL & MECHL UNIV            ,AL,35762-1357,Public       ,92,87,179,5623,3084,8707
00100300,FAULKNER UNIVERSITY                     ,AL,36109-3398,Private      ,41,201,242,1051,2840,3891
00100400,UNIVERSITY OF MONTEVALLO                ,AL,35115-6000,Public       ,30,28,58,1609,926,2535
00100500,ALABAMA STATE UNIVERSITY                ,AL,36101-0000,Public       ,140,164,304,6688,3718,10406
00100700,CENTRAL ALABAMA COMMUNITY COLLEGE       ,AL,35011-0000,Public       ,45,94,139,974,1649,2623
00100800,ATHENS STATE UNIVERSITY                 ,AL,35611-1999,Public       ,10,65,75,528,2159,2687
00100900,AUBURN UNIVERSITY                       ,AL,36849-5113,Public       ,266,137,403,12174,4659,16833
00101200,BIRMINGHAM SOUTHERN COLLEGE             ,AL,35254-0002,Private      ,30,15,45,1199,273,1472
00101300,CALHOUN COMMUNITY COLLEGE               ,AL,35609-2216,Public       ,139,240,379,2962,4662,7624
00101500,ENTERPRISE-OZARK COMMUNITY COLLEGE      ,AL,36331-1300,Public       ,30,49,79,755,1072,1827
00101600,UNIVERSITY OF NORTH ALABAMA             ,AL,35632-0001,Public       ,83,68,151,3262,2188,5450
00101700,GADSDEN STATE COMMUNITY COLLEGE         ,AL,35903-2269,Public       ,86,220,306,1841,2994,4835
00101706,GADSDEN STATE COMM. COLLEGE-AYERS CAMPUS,AL,36202-0000,Public       ,14,27,41,206,421,627
00101800,GEORGE C WALLACE COMMUNITY COLLEGE      ,AL,36303-0943,Public       ,63,163,226,1150,2416,3566
00101900,HUNTINGDON COLLEGE                      ,AL,36106-2148,Private      ,13,23,36,833,309,1142
00102000,JACKSONVILLE STATE UNIVERSITY           ,AL,36265-1602,Public       ,104,168,272,4719,4280,8999
00102100,JEFFERSON DAVIS COMMUNITY COLLEGE       ,AL,36427-2790,Public       ,34,68,102,412,729,1141
00102200,JEFFERSON STATE COMMUNITY COLLEGE       ,AL,35215-3098,Public       ,77,237,314,2508,4514,7022
00102300,JUDSON COLLEGE                          ,AL,36756-2504,Private      ,4,8,12,256,110,366
00102400,UNIVERSITY OF WEST ALABAMA              ,AL,35470-0000,Public       ,48,220,268,1627,2764,4391
00102600,MARION MILITARY INSTITUTE               ,AL,36756-3214,Public       ,6,0,6,217,25,242
00102800,MILES COLLEGE                           ,AL,35064-2697,Private      ,68,66,134,1799,1182,2981
00102900,UNIVERSITY OF MOBILE                    ,AL,36613-0000,Private      ,25,56,81,997,1590,2587
00103000,BISHOP STATE COMMUNITY COLLEGE          ,AL,36603-5898,Public       ,41,112,153,1498,3786,5284
00103001,BISHOP STATE COMM COLG-CARVER CMPS      ,AL,36617-0000,Public       ,0,6,6,94,221,315
00103002,BISHOP STAT COMM CLG-SW CMPS            ,AL,36605-0000,Public       ,1,7,8,63,136,199
00103100,NORTHEAST ALABAMA STATE CMNTY COLG      ,AL,35986-0159,Public       ,42,122,164,752,1451,2203
00103300,OAKWOOD COLLEGE                         ,AL,35896-0001,Private      ,31,21,52,1593,594,2187
00103400,ALABAMA SOUTHERN COMMUNITY COLLEGE      ,AL,36460-5698,Public       ,25,72,97,678,1041,1719
00103600,SAMFORD UNIVERSITY                      ,AL,35229-7000,Private      ,31,46,77,2412,2226,4638
00103700,SELMA UNIVERSITY                        ,AL,36701-0000,Private      ,0,1,1,3,10,13
00103800,SNEAD STATE COMMUNITY COLLEGE           ,AL,35957-0734,Public       ,22,68,90,704,1263,1967
00104000,SOUTHERN UNION STATE COMMUNITY CLG      ,AL,36276-0000,Public       ,86,129,215,2122,2122,4244
00104100,SPRING HILL COLLEGE                     ,AL,36608-1791,Private      ,22,23,45,1467,568,2035
00104400,STILLMAN COLLEGE                        ,AL,35403-1430,Private      ,28,18,46,1149,396,1545
00104600,TALLADEGA COLLEGE                       ,AL,35160-2354,Private      ,18,9,27,508,130,638
00104700,TROY STATE UNIVERSITY                   ,AL,36082-0001,Public       ,131,951,1082,4493,13392,17885
00104754,TROY UNIVERSITY - DOTHAN                ,AL,36303-1575,Public       ,15,73,88,468,1684,2152
00104755,TROY UNIVERSITY - MONTGOMERY            ,AL,36103-4419,Public       ,28,199,227,881,4387,5268
00105000,TUSKEGEE UNIVERSITY                     ,AL,36088-1645,Private      ,68,27,95,4244,925,5169
00105100,UNIVERSITY OF ALABAMA (THE)             ,AL,35487-0120,Public       ,213,201,414,11895,6268,18163
00105200,UNIVERSITY OF ALABAMA AT BIRMINGHAM     ,AL,35294-1150,Public       ,164,220,384,7505,7966,15471
00105500,UNIVERSITY OF ALABAMA IN HUNTSVILLE     ,AL,35899-0001,Public       ,74,81,155,3413,2822,6235
00105700,UNIVERSITY OF SOUTH ALABAMA             ,AL,36688-0002,Public       ,90,222,312,5248,7323,12571
00105900,LAWSON STATE COMMUNITY COLLEGE          ,AL,35221-1798,Public       ,94,189,283,1587,2600,4187
00105901,LAWSON STATE COMMUNITY COLLEGE - BESSEME,AL,35021-0308,Public       ,24,55,79,355,883,1238
00106000,FAULKNER STATE COMMUNITY COLLEGE        ,AL,36507-2698,Public       ,59,92,151,1658,1773,3431
00446200,GADSDEN BUSINESS COLLEGE                ,AL,35906-3658,Proprietary  ,3,8,11,22,55,77
00526000,J.F. DRAKE STATE TECH COLLEGE           ,AL,35811-1584,Public       ,20,71,91,321,975,1296
00569100,SHELTON STATE COMMUNITY CLG             ,AL,35405-4017,Public       ,156,160,316,2586,2711,5297
00569200,REID STATE TECHNICAL COLLEGE            ,AL,36401-0000,Public       ,14,43,57,206,519,725
00569700,NORTHWEST- SHOALS COMMUNITY COLLEGE     ,AL,35661-0000,Public       ,168,128,296,1666,2089,3755
00569702,NORTHWEST-SHOALS C.C.-PHIL CAMPBELL     ,AL,35581-0000,Public       ,26,8,34,199,201,400
00569900,GEORGE C WALLACE STATE CMTY COLLEGE     ,AL,36703-0000,Public       ,52,107,159,989,1482,2471
00573300,BEVILL STATE CMTY COLLEGE-WALKER        ,AL,35148-0000,Public       ,50,149,199,953,1861,2814
00573301,BEVILL STATE COMMUNITY COLLEGE - FAYETTE,AL,35555-0000,Public       ,12,33,45,283,385,668
00573302,BEVILL STATE CMTY CLG-HAMILTON CAMP     ,AL,35570-0000,Public       ,9,14,23,181,315,496
00573305,BEVILL STATE CMTY CLG-WALKER CLG        ,AL,35501-0000,Public       ,15,20,35,281,390,671
00573400,H. COUNCILL TRENHOLM STATE TECH COLLEGE ,AL,36108-0020,Public       ,33,135,168,544,1441,1985
00573401,H. C. TRENHOLM ST TECH COL-PATTERSON CAM,AL,36116-2612,Public       ,6,23,29,179,389,568
00787100,GEORGE C WALLACE STATE CMTY CLG         ,AL,35077-2000,Public       ,71,166,237,2056,3243,5299
00831000,AUBURN UNIVERSITY-MONTGOMERY            ,AL,36124-0000,Public       ,55,114,169,2498,3202,5700
00898800,LURLEEN B WALLACE COMMUNITY COLLEGE     ,AL,36420-0418,Public       ,24,66,90,584,848,1432
01019300,HERZING COLLEGE                         ,AL,35209-4816,Proprietary  ,9,44,53,185,646,831
01055400,CONCORDIA COLLEGE                       ,AL,36701-3323,Private      ,17,52,69,580,548,1128
01123700,SOUTHERN COMMUNITY COLLEGE              ,AL,36083-1803,Private      ,2,7,9,24,156,180
01218200,CHATTAHOOCHEE VALLEY CMTY CLG           ,AL,36869-7917,Public       ,25,93,118,684,1366,2050
01303906,SOUTH UNIVERSITY - MONTGOMERY           ,AL,36116-1120,Proprietary  ,17,104,121,212,799,1011
02170600,UNITED STATES SPORTS ACADEMY            ,AL,36526-7055,Private      ,1,82,83,21,738,759
02199700,HERITAGE CHRISTIAN UNIVERSITY           ,AL,35630-0000,Private      ,0,5,5,15,78,93
02270400,SOUTHEASTERN BIBLE COLLEGE              ,AL,35244-2083,Private      ,0,8,8,102,158,260
02296000,PRINCE INSTITUTE OF PROFESSIONAL STUDIES,AL,36117-0000,Proprietary  ,3,6,9,36,75,111
02323800,GAITHER AND COMPANY BEAUTY COLLEGE      ,AL,35768-0000,Proprietary  ,0,1,1,3,18,21
02341000,FORTIS COLLEGE                          ,AL,36609-0000,Proprietary  ,23,135,158,250,891,1141
02341002,CAPPS COLLEGE - MONTGOMERY              ,AL,36109-3624,Proprietary  ,1,11,12,30,94,124
02503400,AMRIDGE UNIVERSITY                      ,AL,36124-0000,Private      ,1,34,35,29,930,959
02605500,REMINGTON COLLEGE - MOBILE CAMPUS       ,AL,36609-5593,Proprietary  ,72,388,460,495,2137,2632
03010600,VIRGINIA COLLEGE                        ,AL,35209-5154,Proprietary  ,177,1281,1458,1117,7286,8403
03010602,VIRGINIA COLLEGE - HUNTSVILLE           ,AL,35805-0000,Proprietary  ,3,21,24,110,334,444
03010605,VA COLG TECHNICAL AT PELHAM             ,AL,35124-0000,Proprietary  ,1,2,3,35,29,64
03032500,ALABAMA STATE CLG BARBER STYLING        ,AL,35215-8308,Proprietary  ,3,5,8,20,42,62
03100503,VIRGINIA COLLEGE AT PENSACOLA - VIRGINIA,AL,35242-5340,Proprietary  ,6,23,29,73,245,318
03361400,FORTIS COLLEGE                          ,AL,36535-3547,Proprietary  ,14,53,67,71,323,394
03459300,SOUTHEASTERN SCHOOL OF COSMETOLOGY      ,AL,35228-0000,Private      ,4,39,43,30,199,229
03783300,BLUE CLIFF CAREER COLLEGE               ,AL,63306-4749,Proprietary  ,7,40,47,56,216,272
03894300,HUNTSVILLE BIBLE COLLEGE                ,AL,35811-0000,Private      ,1,4,5,1,5,6
00111100,ALLAN HANCOCK COLLEGE                   ,CA,93454-6399,Public       ,105,257,362,2368,2962,5330
00111300,ANTELOPE VALLEY COLLEGE                 ,CA,93536-5426,Public       ,206,580,786,3083,5071,8154
00111600,ART CENTER COLLEGE OF DESIGN            ,CA,91103-1999,Private      ,19,29,48,1156,1353,2509
00111700,AZUSA PACIFIC UNIVERSITY                ,CA,91702-7000,Private      ,61,458,519,5586,5054,10640
00111800,BAKERSFIELD COLLEGE                     ,CA,93305-1299,Public       ,219,423,642,5796,6142,11938
00111900,BARSTOW COMMUNITY COLLEGE               ,CA,92311-6608,Public       ,58,274,332,562,2122,2684
00112000,AMER BAPT SEM OF THE WEST-BERKELEY      ,CA,94704-0000,Private      ,0,3,3,3,53,56
00112100,BETHANY UNIVERSITY /  ASSEMBLIES OF GOD ,CA,95066-2896,Private      ,7,15,22,476,451,927
00112200,BIOLA UNIVERSITY                        ,CA,90639-0001,Private      ,58,71,129,4375,2026,6401
00112300,BROOKS INSTITUTE                        ,CA,93103-1809,Proprietary  ,74,53,127,2170,1262,3432
00112400,CABRILLO COLLEGE                        ,CA,95003-3194,Public       ,190,345,535,2289,3147,5436
00112500,CALIFORNIA BAPTIST UNIVERSITY           ,CA,92504-3297,Private      ,35,104,139,2535,2289,4824
00112700,CALIFORNIA COLLEGE OF THE ARTS          ,CA,94107-2206,Private      ,18,13,31,1346,1262,2608
00113100,CALIFORNIA INSTITUTE OF TECHNOLOGY      ,CA,91125-0001,Private      ,17,6,23,2167,310,2477
00113200,CALIFORNIA INSTITUTE OF THE ARTS        ,CA,91355-2397,Private      ,12,7,19,1240,1343,2583
00113300,CALIFORNIA LUTHERAN UNIVERSITY          ,CA,91360-2787,Private      ,24,62,86,2322,1228,3550
00113400,CALIFORNIA MARITIME ACADEMY             ,CA,94590-8181,Public       ,8,7,15,538,198,736
00113700,CALIF STATE UNIV-FULLERTON              ,CA,92831-3599,Public       ,365,348,713,24721,12958,37679
00113800,"CALIFORNIA STATE UNIVERSITY, EAST BAY   ",CA,94542-3000,Public       ,134,251,385,5755,7141,12896
00113900,CALIF STATE UNIV-LONG BEACH             ,CA,90840-0006,Public       ,394,345,739,31677,15073,46750
00114000,CALIF STATE UNIV-LOS ANGELES            ,CA,90032-4226,Public       ,244,499,743,15695,13905,29600
00114100,"CALIF STATE UNIV, DOMINGUEZ HILLS       ",CA,90747-0001,Public       ,161,330,491,8130,8426,16556
00114200,CALIF STATE UNIV SAN BERNARDINO         ,CA,92407-2397,Public       ,183,391,574,10845,10166,21011
00114300,CAL POLY STATE UNIVERSITY               ,CA,93407-0001,Public       ,242,88,330,19169,3416,22585
00114400,CALIF STATE POLYTECHNIC UNIV POMONA     ,CA,91768-2500,Public       ,237,190,427,16651,6243,22894
00114600,CALIF STATE UNIV - CHICO                ,CA,95929-0001,Public       ,180,121,301,11043,5460,16503
00114700,CALIF STATE UNIV - FRESNO               ,CA,93740-8026,Public       ,184,206,390,15526,9183,24709
00114900,HUMBOLDT STATE UNIVERSITY               ,CA,95521-8299,Public       ,92,78,170,6095,3788,9883
00115000,CALIF STATE UNIV-SACRAMENTO             ,CA,95819-6044,Public       ,287,436,723,17183,13157,30340
00115100,SAN DIEGO STATE UNIVERSITY              ,CA,92182-1690,Public       ,442,314,756,31769,13755,45524
00115300,CALIF STATE UNIV-NORTHRIDGE             ,CA,91330-8307,Public       ,327,410,737,21773,13955,35728
00115301,CALIF STATE UNIV CHANNEL ISLANDS        ,CA,93012-0000,Public       ,27,30,57,1842,923,2765
00115400,SAN FRANCISCO STATE UNIVERSITY          ,CA,94132-1740,Public       ,283,295,578,21390,15565,36955
00115500,SAN JOSE STATE UNIVERSITY               ,CA,95192-0036,Public       ,259,294,553,17488,11411,28899
00115600,SONOMA STATE UNIVERSITY                 ,CA,94928-3609,Public       ,88,123,211,6503,2869,9372
00115700,CALIF STATE UNIV-STANISLAUS             ,CA,95382-0299,Public       ,80,149,229,5316,4230,9546
00115800,UNITED STATES INTERNATIONAL UNIV        ,CA,92131-1799,Private      ,3,28,31,85,1042,1127
00116100,CERRITOS COLLEGE                        ,CA,90650-6296,Public       ,248,355,603,7191,5957,13148
00116200,CHABOT COLLEGE                          ,CA,94545-2400,Public       ,142,240,382,3006,3592,6598
00116300,CHAFFEY COLLEGE                         ,CA,91737-9400,Public       ,225,422,647,5183,6384,11567
00116400,CHAPMAN UNIVERSITY                      ,CA,92866-1099,Private      ,66,664,730,5222,7798,13020
00116453,CHAPMAN UNIVERSITY SCHOOL OF LAW        ,CA,92866-0000,Private      ,1,13,14,112,1464,1576
00116500,CHURCH DIV SCH OF THE PACIFIC           ,CA,94709-0000,Private      ,0,1,1,0,71,71
00116600,CITRUS COLLEGE                          ,CA,91741-1899,Public       ,143,211,354,4036,3005,7041
00116900,CLAREMONT GRADUATE UNIVERSITY           ,CA,91711-0000,Private      ,1,58,59,24,1474,1498
00117000,CLAREMONT MCKENNA COLLEGE               ,CA,91711-6400,Private      ,13,1,14,2198,59,2257
00117100,HARVEY MUDD COLLEGE                     ,CA,91711-5990,Private      ,8,1,9,1394,22,1416
00117200,PITZER COLLEGE                          ,CA,91711-6101,Private      ,15,1,16,1896,122,2018
00117300,POMONA COLLEGE                          ,CA,91711-6301,Private      ,17,2,19,3109,71,3180
00117400,SCRIPPS COLLEGE                         ,CA,91711-3948,Private      ,5,2,7,1228,66,1294
00117600,WEST HILLS COMMUNITY COLLEGE            ,CA,93210-1399,Public       ,88,216,304,1936,2399,4335
00117700,COGSWELL POLYTECHNICAL COLLEGE          ,CA,94089-1210,Private      ,2,3,5,125,94,219
00117800,COLLEGE OF MARIN                        ,CA,94904-2590,Public       ,64,122,186,648,1290,1938
00117801,COLG OF MARIN-INDIAN VALLEY CMPS        ,CA,94949-0000,Public       ,0,7,7,8,78,86
00117900,NOTRE DAME DE NAMUR UNIVERSITY          ,CA,94002-1997,Private      ,8,25,33,852,741,1593
00118100,COLLEGE OF SAN MATEO                    ,CA,94402-3784,Public       ,65,130,195,1501,1443,2944
00118200,COLLEGE OF THE DESERT                   ,CA,92260-9305,Public       ,112,223,335,2252,2530,4782
00118300,HOLY NAMES UNIVERSITY                   ,CA,94619-1699,Private      ,5,37,42,495,727,1222
00118500,COLLEGE OF THE REDWOODS                 ,CA,95501-9300,Public       ,103,205,308,1880,2975,4855
00118600,COLLEGE OF THE SEQUOIAS                 ,CA,93277-2234,Public       ,198,357,555,4037,4679,8716
00118700,COLLEGE OF THE SISKIYOUS                ,CA,96094-2899,Public       ,39,82,121,786,876,1662
00118701,COLLEGE OF THE SISKIYOUS - YREKA CENTER ,CA,96097-9538,Public       ,4,2,6,25,36,61
00119000,CONTRA COSTA COLLEGE                    ,CA,94806-3195,Public       ,68,207,275,1384,2296,3680
00119100,DIABLO VALLEY COLLEGE                   ,CA,94523-1544,Public       ,191,228,419,2885,2627,5512
00119200,CUESTA COLLEGE                          ,CA,93403-8106,Public       ,121,182,303,2570,2497,5067
00119300,CYPRESS COLLEGE                         ,CA,90630-5897,Public       ,173,244,417,3372,3521,6893
00119600,DOMINICAN UNIVERSITY OF CALIFORNIA      ,CA,94901-2298,Private      ,20,27,47,1865,1097,2962
00119700,EL CAMINO COLLEGE                       ,CA,90506-0002,Public       ,392,553,945,6392,5637,12029
00119701,COMPTON COMMUNITY COLLEGE               ,CA,90221-5393,Public       ,52,184,236,694,1529,2223
00119900,FOOTHILL COLLEGE                        ,CA,94022-4597,Public       ,71,140,211,1310,1823,3133
00120000,FULLER THEOLOGICAL SEMINARY             ,CA,91182-0000,Private      ,1,56,57,10,2120,2130
00120100,FULLERTON COLLEGE                       ,CA,92832-2095,Public       ,247,226,473,5171,3690,8861
00120200,GAVILAN COLLEGE                         ,CA,95020-9599,Public       ,65,139,204,857,1142,1999
00120300,GLENDALE COMMUNITY COLLEGE              ,CA,91208-2894,Public       ,328,440,768,5222,4637,9859
00120400,GOLDEN GATE BAPT THEOL SEMINARY         ,CA,94941-0000,Private      ,0,2,2,0,33,33
00120500,GOLDEN GATE UNIVERSITY                  ,CA,94105-2967,Private      ,1,88,89,68,3146,3214
00120600,GOLDEN WEST COLLEGE                     ,CA,92647-2748,Public       ,151,225,376,4193,3464,7657
00120700,GRADUATE THEOLOGICAL UNION              ,CA,94709-0000,Private      ,0,6,6,0,343,343
00120800,GROSSMONT COLLEGE                       ,CA,92020-1798,Public       ,227,358,585,4373,4683,9056
00120900,HARTNELL COMMUNITY COLLEGE              ,CA,93901-1697,Public       ,120,230,350,1925,1937,3862
00121200,HUMPHREYS COLLEGE                       ,CA,95207-3896,Private      ,12,73,85,205,853,1058
00121400,IMPERIAL VALLEY COLLEGE                 ,CA,92251-9787,Public       ,248,391,639,3435,2898,6333
00121500,LA SIERRA UNIVERSITY                    ,CA,92515-3332,Private      ,34,35,69,1730,704,2434
00121600,UNIVERSITY OF LA VERNE                  ,CA,91750-4443,Private      ,43,360,403,2538,5436,7974
00121700,LASSEN COLLEGE                          ,CA,96130-3000,Public       ,29,63,92,396,603,999
00121800,LOMA LINDA UNIVERSITY                   ,CA,92350-0001,Private      ,12,70,82,747,4112,4859
00121900,LONG BEACH CITY COLLEGE                 ,CA,90808-1780,Public       ,373,831,1204,8151,9810,17961
00122000,MASTER'S COLLEGE & SEMINARY (THE)       ,CA,91321-1200,Private      ,7,16,23,1085,350,1435
00122300,LOS ANGELES CITY COLLEGE                ,CA,90029-3588,Public       ,221,708,929,3784,7121,10905
00122400,LOS ANGELES HARBOR COLLEGE              ,CA,90744-2397,Public       ,141,284,425,1827,2773,4600
00122600,LOS ANGELES PIERCE COLLEGE              ,CA,91371-0001,Public       ,248,343,591,4490,3700,8190
00122700,LOS ANGELES TRADE TECH COLLEGE          ,CA,90015-4181,Public       ,194,526,720,2460,4852,7312
00122800,LOS ANGELES VALLEY COLLEGE              ,CA,91401-4096,Public       ,260,473,733,3801,4464,8265
00122900,SO CA UNIV  HEALTH SCIENCES             ,CA,90604-4051,Private      ,0,4,4,11,563,574
00123000,SOUTHERN CA COLLEGE OF OPTOMETRY        ,CA,92831-1699,Private      ,1,1,2,8,490,498
00123200,AMERICAN RIVER COLLEGE                  ,CA,95841-4286,Public       ,320,821,1141,5890,9705,15595
00123300,SACRAMENTO CITY COLLEGE                 ,CA,95822-1386,Public       ,309,585,894,6352,7663,14015
00123600,MENLO COLLEGE                           ,CA,94027-4301,Private      ,10,6,16,765,160,925
00123700,MERCED COMMUNITY COLLEGE                ,CA,95348-2898,Public       ,185,303,488,3687,3669,7356
00123800,MILLS COLLEGE                           ,CA,94613-1301,Private      ,10,25,35,1129,1049,2178
00123900,MIRACOSTA COLLEGE                       ,CA,92056-3899,Public       ,88,187,275,1699,2222,3921
00124000,MODESTO JUNIOR COLLEGE                  ,CA,95350-5800,Public       ,212,371,583,5700,6094,11794
00124200,MONTEREY PENINSULA COLLEGE              ,CA,93940-4799,Public       ,66,125,191,1020,1356,2376
00124300,MOUNT ST MARYS COLLEGE                  ,CA,90049-1599,Private      ,18,77,95,1861,1718,3579
00124500,MT. SAN ANTONIO COLLEGE                 ,CA,91789-1399,Public       ,414,537,951,8076,6056,14132
00124600,MT SAN JACINTO COLLEGE                  ,CA,92583-2399,Public       ,195,477,672,2813,4707,7520
00124700,NAPA VALLEY COLLEGE                     ,CA,94558-6236,Public       ,63,145,208,1064,1498,2562
00124900,OCCIDENTAL COLLEGE                      ,CA,90041-3314,Private      ,29,3,32,3297,195,3492
00125000,ORANGE COAST COLLEGE - FIN AID OFF      ,CA,92628-5005,Public       ,271,269,540,6543,3930,10473
00125100,OTIS COLLEGE OF ART AND DESIGN          ,CA,90045-3505,Private      ,31,8,39,1227,489,1716
00125200,HOPE INTERNATIONAL UNIVERSITY           ,CA,92631-0000,Private      ,9,42,51,495,568,1063
00125300,FRESNO PACIFIC UNIVERSITY               ,CA,93702-4798,Private      ,25,116,141,1476,1713,3189
00125302,FRESNO PACIFIC UNIVERSITY - VISALIA CENT,CA,93277-8341,Private      ,5,11,16,7,48,55
00125303,FRESNO PACIFIC UNIVERSITY - BAKERSFIELD ,CA,93301-4533,Private      ,3,22,25,3,38,41
00125400,PACIFIC LUTHERAN THEOLOGICAL SEM        ,CA,94708-0000,Private      ,0,2,2,1,92,93
00125500,PACIFIC OAKS COLLEGE                    ,CA,91103-3592,Private      ,0,39,39,27,1113,1140
00125600,PACIFIC SCHOOL OF RELIGION              ,CA,94709-0000,Private      ,0,3,3,1,184,185
00125800,PACIFIC UNION COLLEGE                   ,CA,94508-9797,Private      ,29,27,56,1253,440,1693
00125900,PALO VERDE COLLEGE                      ,CA,92225-0000,Public       ,13,43,56,148,358,506
00126000,PALOMAR COLLEGE                         ,CA,92069-1486,Public       ,159,299,458,4040,4363,8403
00126100,PASADENA CITY COLLEGE                   ,CA,91106-2003,Public       ,453,496,949,9656,5905,15561
00126200,POINT LOMA NAZARENE UNIVERSITY          ,CA,92106-2899,Private      ,29,130,159,3175,1160,4335
00126600,LANEY COLLEGE                           ,CA,94607-4893,Public       ,115,277,392,2438,4470,6908
00126700,MERRITT COLLEGE                         ,CA,94619-3196,Public       ,51,187,238,1114,2887,4001
00126800,PORTERVILLE COLLEGE                     ,CA,93257-6059,Public       ,78,156,234,1331,1701,3032
00126900,RIO HONDO COLLEGE                       ,CA,90601-1699,Public       ,189,243,432,4683,3573,8256
00127000,RIVERSIDE COMMUNITY COLLEGE             ,CA,92506-1299,Public       ,665,1156,1821,10810,11745,22555
00127200,SAN BERNARDINO VALLEY COLLEGE           ,CA,92410-2798,Public       ,175,513,688,3210,6163,9373
00127300,SAN DIEGO CITY COLLEGE                  ,CA,92101-4787,Public       ,197,622,819,3960,7287,11247
00127500,SAN DIEGO MESA COLLEGE                  ,CA,92111-4996,Public       ,228,414,642,5513,5636,11149
00127800,SAN FRANCISCO CONSERVATORY OF MUSIC     ,CA,94122-4498,Private      ,3,1,4,268,292,560
00127900,SAN FRANCISCO THEOLOGICAL SEMINARY      ,CA,94960-0000,Private      ,0,3,3,1,99,100
00128000,SAN JOAQUIN DELTA COLLEGE               ,CA,95207-6370,Public       ,326,728,1054,6120,7788,13908
00128100,WILLIAM JESSUP UNIVERSITY               ,CA,95765-3707,Private      ,3,19,22,429,397,826
00128200,SAN JOSE CITY COLLEGE                   ,CA,95128-2797,Public       ,115,279,394,2283,3575,5858
00128400,SANTA ANA COLLEGE                       ,CA,92706-3398,Public       ,212,334,546,3345,3247,6592
00128500,SANTA BARBARA CITY COLLEGE              ,CA,93109-2394,Public       ,156,214,370,3489,2280,5769
00128600,SANTA MONICA COLLEGE                    ,CA,90405-1644,Public       ,406,415,821,8412,4969,13381
00128700,SANTA ROSA JUNIOR COLLEGE               ,CA,95401-4395,Public       ,146,305,451,3225,4073,7298
00128800,CLAREMONT SCHOOL OF THEOLOGY            ,CA,91711-0000,Private      ,0,1,1,3,205,208
00128900,SHASTA COLLEGE                          ,CA,96049-7692,Public       ,141,300,441,2596,3573,6169
00129000,SIERRA COLLEGE                          ,CA,95677-3397,Public       ,226,342,568,3595,4558,8153
00129100,SIMPSON UNIVERSITY                      ,CA,96003-8606,Private      ,13,30,43,1103,599,1702
00129200,SOLANO COMMUNITY COLLEGE                ,CA,94534-3197,Public       ,128,322,450,1829,3200,5029
00129300,VANGUARD UNIVERSITY OF SOUTHERN CA      ,CA,92626-6597,Private      ,29,43,72,1871,791,2662
00129400,SOUTHWESTERN COLLEGE                    ,CA,91910-7299,Public       ,308,393,701,5720,4608,10328
00129500,SOUTHWESTERN LAW SCHOOL                 ,CA,90010-1106,Private      ,1,17,18,18,2220,2238
00129600,DOMINICAN SCH PHILOSOPHY & THEOLOGY     ,CA,94709-0000,Private      ,1,1,2,3,19,22
00129900,ST JOHN'S SEMINARY COLLEGE              ,CA,93010-0000,Private      ,1,0,1,5,0,5
00130200,SAINT MARY'S COLLEGE OF CALIFORNIA      ,CA,94556-2744,Private      ,34,90,124,3525,1416,4941
00130500,STANFORD UNIVERSITY                     ,CA,94305-6106,Private      ,98,71,169,13002,2776,15778
00130501,STANFORD UNIVERSITY - GRADUATE SCHOOL OF,CA,94305-5301,Private      ,2,2,4,47,560,607
00130502,STANFORD UNIVERSITY - GRADUATE SCHOOL OF,CA,94305-5015,Private      ,2,7,9,27,984,1011
00130503,STANFORD UNIVERSITY - STANFORD LAW SCHOO,CA,94305-3096,Private      ,1,3,4,19,1714,1733
00130700,FRESNO CITY COLLEGE                     ,CA,93741-0002,Public       ,296,594,890,10336,10149,20485
00130800,REEDLEY COLLEGE                         ,CA,93654-2099,Public       ,175,307,482,4310,4290,8600
00130900,TAFT COLLEGE                            ,CA,93268-2317,Public       ,21,66,87,549,580,1129
00131200,UNIVERSITY OF CALIFORNIA-BERKELEY       ,CA,94720-1520,Public       ,310,198,508,36949,16394,53343
00131300,UNIVERSITY OF CALIFORNIA-DAVIS          ,CA,95616-8558,Public       ,306,133,439,32152,10886,43038
00131400,UNIVERSITY OF CALIFORNIA-IRVINE         ,CA,92697-2825,Public       ,326,176,502,33561,7549,41110
00131500,UNIVERSITY OF CALIFORNIA (UCLA)         ,CA,90095-9000,Public       ,420,369,789,43873,19623,63496
00131502,UNIV OF CALIFORNIA LOS ANG SCH MED      ,CA,90095-0000,Public       ,2,7,9,137,755,892
00131503,UNIV OF CALIFORNIA LOS ANG DENTAL       ,CA,90095-0000,Public       ,0,4,4,15,163,178
00131600,UNIVERSITY OF CALIFORNIA-RIVERSIDE      ,CA,92521-0209,Public       ,221,107,328,20851,5083,25934
00131700,UNIVERSITY OF CALIFORNIA-SAN DIEGO      ,CA,92093-0013,Public       ,282,137,419,32959,6879,39838
00131900,UNIVERSITY OF CALIFORNIA-SFRANCISCO     ,CA,94143-0246,Public       ,7,22,29,433,3095,3528
00132000,UNIVERSITY OF CALIFORNIA-SANTA BARB     ,CA,93106-3180,Public       ,289,84,373,30051,5511,35562
00132100,UNIVERSITY OF CALIFORNIA-SANTA CRUZ     ,CA,95064-0001,Public       ,140,60,200,19240,3381,22621
00132200,UNIVERSITY OF REDLANDS                  ,CA,92373-0999,Private      ,27,168,195,3624,1979,5603
00132500,UNIVERSITY OF SAN FRANCISCO             ,CA,94117-1080,Private      ,61,157,218,6331,5561,11892
00132600,SANTA CLARA UNIVERSITY                  ,CA,95053-4956,Private      ,63,94,157,6241,3225,9466
00132800,UNIVERSITY OF SOUTHERN CALIFORNIA       ,CA,90089-0914,Private      ,219,195,414,25179,17411,42590
00132900,UNIVERSITY OF THE PACIFIC               ,CA,95211-0197,Private      ,54,46,100,5344,2510,7854
00132901,UNIVERSITY OF THE PACIFIC - MCGEORGE SCH,CA,95817-2799,Private      ,0,13,13,18,2110,2128
00132902,UNIV OF THE PACIFIC SCH OF DENT         ,CA,94115-0000,Private      ,0,2,2,11,592,603
00133400,VENTURA COLLEGE                         ,CA,93003-3899,Public       ,110,171,281,2275,2280,4555
00133500,VICTOR VALLEY COLLEGE                   ,CA,92395-5849,Public       ,283,597,880,3057,5812,8869
00133800,WEST VALLEY COLLEGE                     ,CA,95070-5697,Public       ,93,178,271,1564,1667,3231
00134100,WESTMONT COLLEGE                        ,CA,93108-1099,Private      ,17,1,18,1948,45,1993
00134200,WHITTIER COLLEGE                        ,CA,90601-4413,Private      ,18,17,35,2078,311,2389
00134201,WHITTIER COLLEGE - COLLEGE OF LAW       ,CA,92626-1501,Private      ,0,7,7,2,1370,1372
00134300,WOODBURY UNIVERSITY                     ,CA,91510-7846,Private      ,11,26,37,1010,771,1781
00134400,YUBA COLLEGE                            ,CA,95901-7699,Public       ,191,416,607,2802,4164,6966
00177212,TRINITY INTERNATIONAL UNIV-CA           ,CA,92705-0000,Private      ,0,6,6,5,219,224
00274100,AMERICAN JEWISH UNIVERSITY              ,CA,90077-1599,Private      ,2,0,2,83,149,232
00301002,ANTIOCH UNIV/LOS ANGELES                ,CA,90230-7615,Private      ,3,55,58,20,798,818
00301003,ANTIOCH  UNIV/SANTA BARBARA             ,CA,93101-0000,Private      ,6,19,25,169,423,592
00304701,HEBREW UNION COLL - LOS ANGELES         ,CA,90007-0000,Private      ,0,0,0,1,6,7
00369110,MONTEREY INST OF INTERNATL STUDIES      ,CA,93940-2691,Private      ,2,8,10,18,755,773
00394700,UC-HASTINGS COLLEGE OF THE LAW          ,CA,94102-0000,Public       ,0,8,8,15,3314,3329
00394800,SAN FRANCISCO ART INSTITUTE             ,CA,94133-2299,Private      ,22,12,34,978,815,1793
00405500,HEBREW UNION COLLEGE - JEWISH INSTITUTE ,CA,90007-3796,Private      ,0,0,0,2,89,91
00408000,STARR KING SCHOOL FOR THE MINISTRY      ,CA,94709-1299,Private      ,0,2,2,1,64,65
00448000,DE ANZA COLLEGE                         ,CA,95014-5793,Public       ,251,279,530,4304,3492,7796
00448100,OHLONE COLLEGE                          ,CA,94539-5847,Public       ,98,126,224,1609,1517,3126
00448400,JOHN F. KENNEDY UNIVERSITY              ,CA,94523-4817,Private      ,1,94,95,15,1486,1501
00449000,PATTEN UNIVERSITY                       ,CA,94601-2699,Private      ,7,41,48,165,312,477
00449400,EVEREST COLLEGE                         ,CA,92408-3752,Proprietary  ,85,186,271,310,722,1032
00450200,CITY COLLEGE OF SAN FRANCISCO           ,CA,94112-0000,Public       ,311,763,1074,6121,8941,15062
00563800,DOWNEY ADULT SCHOOL                     ,CA,90241-5610,Public       ,2,2,4,11,20,31
00565500,HACIENDA LA PUENTE ADULT EDUC CTR       ,CA,91746-0000,Public       ,9,71,80,73,384,457
00616500,LA CNTY CLG OF NURSING & ALLD HLTH      ,CA,90033-1018,Public       ,3,13,16,91,321,412
00672000,COLLEGE OF ALAMEDA                      ,CA,94501-2109,Public       ,64,139,203,1352,1712,3064
00673100,CASA LOMA COLLEGE                       ,CA,91405-4523,Private      ,18,68,86,173,482,655
00686300,VENTURA COUNTY CMTY CLG DISTRICT        ,CA,93010-8552,Public       ,1,4,5,13,24,37
00697300,CANADA COLLEGE                          ,CA,94061-1099,Public       ,28,93,121,495,833,1328
00697500,LINCOLN UNIVERSITY                      ,CA,94612-2801,Private      ,0,1,1,11,39,50
00701200,SAMUEL MERRITT COLLEGE                  ,CA,94609-3108,Private      ,4,34,38,189,1525,1714
00704700,LOS ANGELES SOUTHWEST COLLEGE           ,CA,90047-4810,Public       ,131,466,597,1395,3860,5255
00705000,BAY VISTA COLLEGE OF BEAUTY             ,CA,91950-3616,Proprietary  ,8,32,40,55,152,207
00711500,MOORPARK COLLEGE                        ,CA,93021-1695,Public       ,101,107,208,2066,1561,3627
00713000,NEWBERRY SCHOOLS OF BEAUTY              ,CA,91344-7404,Proprietary  ,14,19,33,78,90,168
00714200,LYLE'S COLLEGE OF BEAUTY                ,CA,93710-3948,Proprietary  ,10,30,40,102,183,285
00714201,LYLE'S CLG OF BTY BAKERSFIELD           ,CA,93301-0000,Proprietary  ,4,4,8,45,46,91
00716400,BRYAN COLLEGE                           ,CA,90057-0000,Proprietary  ,7,54,61,73,409,482
00717801,WESTERN SEMINARY - BAY AREA CENTER      ,CA,95032-0000,Private      ,0,1,1,0,15,15
00717804,WESTERN SEMINARY - SACRAMENTO           ,CA,95821-3939,Private      ,0,3,3,3,32,35
00718700,NORTH ADRIAN'S COLLEGE OF BEAUTY        ,CA,95350-2381,Proprietary  ,12,31,43,66,140,206
00719000,WYOTECH                                 ,CA,94539-7663,Proprietary  ,139,217,356,1011,1198,2209
00720300,SALON SUCCESS ACADEMY                   ,CA,91786-4060,Proprietary  ,3,10,13,52,61,113
00720400,MODERN BEAUTY ACADEMY                   ,CA,93030-7016,Proprietary  ,8,8,16,47,56,103
00722900,WESTERN BEAUTY INSTITUTE                ,CA,91402-3104,Proprietary  ,51,149,200,208,726,934
00723400,HEALD COLLEGE                           ,CA,94105-2206,Proprietary  ,40,54,94,250,404,654
00723600,ART INST OF CALIFORNIA-LOS ANGELES      ,CA,90405-3035,Proprietary  ,209,170,379,4623,2869,7492
00724500,SAN JOSE BEAUTY COLLEGE                 ,CA,95126-0000,Proprietary  ,0,0,0,1,0,1
00725300,FEDERICO BEAUTY INSTITUTE               ,CA,95834-1905,Proprietary  ,26,31,57,167,259,426
00729600,COLEMAN COLLEGE                         ,CA,92123-0000,Private      ,28,73,101,157,592,749
00745600,MARINELLO SCH BTY BUENA PRK             ,CA,90620-0000,Proprietary  ,1,0,1,5,0,5
00746501,AMERICAN ACADEMY OF DRAMATIC ARTS - HOLL,CA,90028-7504,Private      ,8,2,10,237,103,340
00747600,MARINELLO SCHOOLS OF BEAUTY             ,CA,90023-2666,Proprietary  ,145,313,458,696,1547,2243
00747602,MARINELLO SCHOOLS OF BEAUTY - SPA ACADEM,CA,90048-5101,Proprietary  ,0,2,2,21,19,40
00747603,MARINELLO SCHOOLS OF BEAUTY - INGLEWOOD ,CA,90301-2306,Proprietary  ,1,1,2,9,12,21
00747604,MARINELLO SCHOOLS OF BEAUTY - RESEDA    ,CA,91335-4218,Proprietary  ,0,1,1,7,9,16
00747605,MARINELLO SCHOOLS OF BEAUTY - NORTH HOLL,CA,91606-3210,Proprietary  ,0,1,1,11,7,18
00747606,MARINELLO SCHOOLS OF BEAUTY - WEST COVIN,CA,91790-2805,Proprietary  ,1,1,2,13,9,22
00747607,MARINELLO SCHOOLS OF BEAUTY - SAN BERNAR,CA,92410-3261,Proprietary  ,2,4,6,19,28,47
00747608,MARINELLO SCHOOLS OF BEAUTY - ONTARIO   ,CA,91762-2113,Proprietary  ,0,2,2,23,26,49
00747609,MARINELLO SCHOOLS OF BEAUTY - WHITTIER  ,CA,90601-4107,Proprietary  ,0,0,0,15,8,23
00747611,MARINELLO SCHOOLS OF BEAUTY - SAN DIEGO ,CA,92126-4217,Proprietary  ,4,1,5,37,26,63
00747700,"HEALD COLLEGE,SCHOOLS OF BUS & TECH     ",CA,95670-6005,Proprietary  ,26,114,140,334,743,1077
00753100,ACADEMY OF ART UNIVERSITY               ,CA,94105-3410,Proprietary  ,253,352,605,3917,5519,9436
00753600,COSUMNES RIVER COLLEGE                  ,CA,95823-5799,Public       ,160,353,513,3362,3677,7039
00754802,WESTWOOD COLLEGE OF TECHNOLOGY          ,CA,92801-0000,Proprietary  ,64,56,120,903,573,1476
00754803,WESTWOOD COLLEGE OF TECHNOLOGY          ,CA,91786-0000,Proprietary  ,71,83,154,998,767,1765
00760500,ACADEMY PACIFIC BUSINESS & TRAVEL       ,CA,90028-5218,Proprietary  ,0,0,0,10,9,19
00760600,EVEREST COLLEGE                         ,CA,90010-2221,Proprietary  ,41,98,139,270,546,816
00760700,CONCORDE CAREER INSTITUTE               ,CA,91606-3134,Proprietary  ,42,68,110,305,545,850
00770700,COLUMBIA COLLEGE                        ,CA,95370-8580,Public       ,27,47,74,614,757,1371
00771300,SKYLINE COLLEGE                         ,CA,94066-1698,Public       ,76,109,185,1649,1420,3069
00793000,CONCORDE CAREER INSTITUTE               ,CA,92108-0000,Proprietary  ,44,123,167,197,695,892
00799300,CALIF STATE UNIV BAKERSFIELD            ,CA,93311-1022,Public       ,70,220,290,4926,4789,9715
00807100,CONCORDE CAREER INSTITUTE               ,CA,92840-9201,Proprietary  ,23,74,97,252,584,836
00807300,BUTTE COMMUNITY COLLEGE                 ,CA,95965-0000,Public       ,211,432,643,3886,4672,8558
00809000,EVEREST COLLEGE                         ,CA,91803-1310,Proprietary  ,94,185,279,450,943,1393
00809300,HEALD COLLEGE                           ,CA,93704-1706,Proprietary  ,74,145,219,874,1073,1947
00853200,HEALD COLLEGE                           ,CA,94545-2352,Proprietary  ,60,108,168,557,1025,1582
00853700,CONCORDE CAREER INSTITUTE               ,CA,92401-0000,Proprietary  ,58,158,216,419,1087,1506
00859600,WEST LOS ANGELES COLLEGE                ,CA,90230-3500,Public       ,146,365,511,1487,3008,4495
00859700,FEATHER RIVER COLLEGE                   ,CA,95971-9124,Public       ,16,38,54,447,289,736
00884400,CALIFORNIA CHRISTIAN COLLEGE            ,CA,93703-3599,Private      ,1,0,1,35,43,78
00884600,WRIGHT INSTITUTE                        ,CA,94704-0000,Private      ,0,4,4,1,356,357
00886800,DON'S BEAUTY SCHOOL                     ,CA,94612-0000,Proprietary  ,0,0,0,0,1,1
00890300,COLLEGE OF THE CANYONS                  ,CA,91355-1899,Public       ,130,157,287,2238,1684,3922
00891800,SADDLEBACK COLLEGE                      ,CA,92692-3699,Public       ,79,160,239,2146,2340,4486
00902200,ASSOCIATED TECHNICAL COLLEGE            ,CA,90017-0000,Proprietary  ,18,131,149,72,551,623
00903200,EMPIRE COLLEGE                          ,CA,95403-2122,Proprietary  ,23,64,87,138,463,601
00915800,DON BOSCO TECHNICAL INSTITUTE           ,CA,91770-4299,Private      ,0,1,1,10,3,13
00927200,CRAFTON HILLS COLLEGE                   ,CA,92399-1799,Public       ,59,104,163,1480,1628,3108
00932500,ABRAM FRIEDMAN OCCUP CTR                ,CA,90015-3507,Public       ,2,3,5,19,51,70
00950900,SKILLS & BUSINESS EDUCATION CENTER      ,CA,95824-1529,Public       ,19,163,182,150,921,1071
00974800,WESTERN CAREER COLLEGE                  ,CA,95826-3203,Proprietary  ,236,741,977,1300,3445,4745
00974802,WESTERN CAREER COLLEGE - PLEASANT HILL C,CA,94523-1984,Proprietary  ,35,90,125,230,467,697
00974805,WESTERN CAREER COLLEGE - FREMONT        ,CA,94538-3115,Proprietary  ,78,247,325,537,1614,2151
00974806,WESTERN CAREER COLLEGE -  ANTIOCH/WALNUT,CA,94531-1604,Proprietary  ,0,1,1,9,17,26
00998900,SANTA BARBARA BUSINESS COLLEGE          ,CA,93111-0000,Proprietary  ,19,56,75,178,396,574
01011100,CERRO-COSO COMMUNITY COLLEGE            ,CA,93555-9571,Public       ,32,146,178,414,1422,1836
01014225,TOURO CLG OSEOPATHIC MEDICINE           ,CA,94592-1115,Private      ,0,6,6,20,712,732
01014900,PEPPERDINE UNIVERSITY                   ,CA,90263-0000,Private      ,63,184,247,6155,5813,11968
01033300,JESUIT SCHOOL OF THEOLOGY - BERKELEY    ,CA,94709-1193,Private      ,0,2,2,2,63,65
01034000,LOS MEDANOS COLLEGE                     ,CA,94565-5197,Public       ,90,167,257,1273,1852,3125
01036500,CHARLES R DREW UNIV OF MED & SCI        ,CA,90059-0000,Private      ,0,11,11,48,416,464
01036800,MENNONITE BRETHREN BIBLICAL SEM         ,CA,93727-0000,Private      ,0,10,10,1,70,71
01037500,HARBOR OCCUPATIONAL CENTER              ,CA,90731-0000,Public       ,1,3,4,24,38,62
01039500,UNIVERSITY OF SAN DIEGO                 ,CA,92110-2492,Private      ,114,101,215,10388,2986,13374
01039501,UNIVERSITY OF SAN DIEGO - SCHOOL OF LAW ,CA,92110-2492,Private      ,2,9,11,62,2824,2886
01044100,PARDEE RAND GRADUATE SCHOOL             ,CA,90407-2138,Private      ,0,1,1,4,18,22
01047400,MARYMOUNT COLLEGE OF PALOS VERDES       ,CA,90275-0000,Private      ,11,4,15,512,38,550
01057900,WEST VALLEY OCCUPATIONAL CTR            ,CA,91367-0000,Public       ,4,4,8,39,71,110
01083100,NEW COLLEGE OF CALIFORNIA               ,CA,94102-0000,Private      ,5,61,66,135,1153,1288
01083200,WESTERN STATE UNIV COLLEGE OF LAW       ,CA,92831-3014,Proprietary  ,1,3,4,14,883,897
01085400,THOMAS JEFFERSON SCHOOL OF LAW          ,CA,92110-0000,Private      ,1,9,10,8,1591,1599
01102400,EVEREST COLLEGE                         ,CA,94103-2091,Proprietary  ,130,493,623,668,2282,2950
01110700,EVEREST  COLLEGE                        ,CA,92801-5231,Proprietary  ,60,161,221,363,799,1162
01110900,EVEREST COLLEGE                         ,CA,91335-4631,Proprietary  ,81,125,206,385,590,975
01111200,FIDM-FASHION INSTITUTE OF DESIGN        ,CA,90015-1421,Proprietary  ,219,95,314,5246,1587,6833
01111700,ALLIANT INTERNATIONAL UNIVERSITY        ,CA,92131-1799,Private      ,1,48,49,47,1300,1347
01111705,ALLIANT INTERNATIONAL UNIVERSITY - LOS A,CA,91803-1360,Private      ,0,5,5,8,494,502
01111706,ALLIANT INTERNATIONAL UNIVERSITY - SAN F,CA,94133-1221,Private      ,0,7,7,3,484,487
01111707,ALLIANT INTERNATIONAL UNIVERSITY - FRESN,CA,93727-2014,Private      ,1,10,11,10,279,289
01112100,EVEREST COLLEGE                         ,CA,94541-4007,Proprietary  ,46,108,154,189,580,769
01112300,EVEREST COLLEGE                         ,CA,90247-4163,Proprietary  ,71,293,364,451,1511,1962
01146000,NATIONAL UNIVERSITY                     ,CA,92037-1011,Private      ,58,2020,2078,378,13295,13673
01162600,PRACTICAL SCHOOLS                       ,CA,92805-0000,Proprietary  ,54,90,144,541,787,1328
01164900,LOYOLA MARYMOUNT UNIVERSITY             ,CA,90045-0000,Private      ,67,53,120,8369,2745,11114
01164901,LOYOLA MARYMOUNT UNIVERSITY - LOYOLA LAW,CA,90015-0019,Private      ,2,6,8,32,3025,3057
01167200,MENDOCINO COMMUNITY COLLEGE             ,CA,95482-3000,Public       ,50,127,177,806,1145,1951
01169600,NATIONAL POLYTECHNIC COLLEGE OF SCIENCE ,CA,90744-6399,Private      ,26,59,85,107,403,510
01170700,NORTH-WEST COLLEGE                      ,CA,91790-2097,Proprietary  ,26,85,111,177,425,602
01179200,FRANCISCAN SCHOOL OF THEOLOGY           ,CA,94709-0000,Private      ,0,2,2,0,26,26
01182000,SAN DIEGO MIRAMAR COLLEGE               ,CA,92126-0000,Public       ,95,245,340,1940,2762,4702
01186500,CALIFORNIA HAIR DESIGN ACADEMY          ,CA,92115-0000,Proprietary  ,7,16,23,63,88,151
01202600,JE BOUTIQUE COLLEGE OF BEAUTY           ,CA,92021-6247,Proprietary  ,12,33,45,66,146,212
01202700,GALEN COLLEGE OF CALIFORNIA             ,CA,93728-2381,Proprietary  ,14,32,46,110,196,306
01203100,SAN DIEGO CHRISTIAN COLLEGE             ,CA,92019-1157,Private      ,12,11,23,534,234,768
01206100,EVEREST COLLEGE                         ,CA,95128-3908,Proprietary  ,31,94,125,207,519,726
01215400,CALIFORNIA INSTITUTE OF INTEGRAL STUDIES,CA,94103-2557,Private      ,1,18,19,12,1067,1079
01231600,MANCHESTER BEAUTY COLLEGE               ,CA,93726-5306,Proprietary  ,9,28,37,117,198,315
01231700,TULARE BEAUTY COLLEGE                   ,CA,93274-3432,Proprietary  ,2,4,6,10,26,36
01244600,UNIVERSAL COLLEGE OF BEAUTY             ,CA,90044-0044,Proprietary  ,7,18,25,46,103,149
01245200,EVERGREEN VALLEY COLLEGE                ,CA,95135-1598,Public       ,93,183,276,2658,2492,5150
01255000,LOS ANGELES MISSION COLLEGE             ,CA,91342-3200,Public       ,165,330,495,1798,2440,4238
01265000,MARINELLO SCHOOL OF BEAUTY              ,CA,91502-2828,Proprietary  ,14,38,52,86,180,266
01265100,MARINELLO SCHOOL OF BEAUTY              ,CA,91748-1674,Proprietary  ,3,25,28,49,134,183
01284200,OXNARD COLLEGE                          ,CA,93030-0000,Public       ,88,206,294,1549,1971,3520
01287200,NORTH-WEST COLLEGE                      ,CA,91768-3199,Proprietary  ,11,63,74,69,317,386
01287300,WYOTECH                                 ,CA,90810-3800,Proprietary  ,259,561,820,1140,2502,3642
01290700,LAKE TAHOE COMMUNITY COLLEGE            ,CA,96150-4524,Public       ,17,39,56,284,439,723
01291100,MARINELLO SCHOOL OF BEAUTY              ,CA,92646-2552,Proprietary  ,8,14,22,57,71,128
01291200,MTI COLLEGE                             ,CA,95841-0000,Proprietary  ,52,99,151,355,1025,1380
01294200,ROSEMEAD BEAUTY SCHOOL                  ,CA,91770-1639,Proprietary  ,6,10,16,46,116,162
01298400,PROFESSIONAL INSTITUTE OF BEAUTY        ,CA,91731-2613,Proprietary  ,3,9,12,14,96,110
01298500,HAIR CALIFORNIA BEAUTY ACADEMY          ,CA,92867-7127,Proprietary  ,1,2,3,8,9,17
01298900,OCEANSIDE COLLEGE OF BEAUTY             ,CA,92054-5393,Proprietary  ,3,9,12,39,54,93
01301000,LANCASTER BEAUTY SCHOOL                 ,CA,93534-3098,Proprietary  ,16,32,48,81,176,257
01307400,AMERICAN BEAUTY COLLEGE                 ,CA,90706-5417,Proprietary  ,3,10,13,31,74,105
01308100,WESTGATE BEAUTY COLLEGE                 ,CA,95129-0000,Proprietary  ,0,0,0,1,0,1
01309500,SALON SUCCESS ACADEMY                   ,CA,92879-6561,Proprietary  ,10,4,14,52,49,101
01310300,CALIFORNIA WESTERN SCHOOL OF LAW        ,CA,92101-0000,Private      ,0,5,5,14,1928,1942
01323300,SIMI VALLEY ADULT SCHOOL/CAREER INS     ,CA,93065-3940,Public       ,0,3,3,18,43,61
01324000,LYTLE'S REDWOOD EMPIRE BEAUTY CLG       ,CA,95403-0000,Proprietary  ,11,17,28,83,99,182
02052300,UNIVERSITY OF WEST LOS ANGELES          ,CA,90301-0000,Private      ,0,0,0,33,107,140
02054900,MARINELLO SCHOOL OF BEAUTY              ,CA,92630-0000,Proprietary  ,6,3,9,19,36,55
02057700,ALMADEN BEAUTY COLLEGE                  ,CA,95123-0000,Proprietary  ,0,0,0,1,0,1
02059800,PARIS BEAUTY COLLEGE                    ,CA,94520-2611,Proprietary  ,8,24,32,35,79,114
02063500,COASTLINE COMMUNITY COLLEGE             ,CA,92708-0000,Public       ,26,172,198,608,1956,2564
02064300,SIERRA COLLEGE OF BEAUTY                ,CA,95340-0000,Proprietary  ,5,23,28,60,68,128
02065500,BROOKS COLLEGE                          ,CA,90804-3289,Proprietary  ,39,39,78,881,462,1343
02065501,BROOKS COLLEGE - SUNNYVALE              ,CA,94086-5303,Proprietary  ,14,25,39,343,368,711
02065700,CALIFORNIA BEAUTY COLLEGE               ,CA,95354-0000,Proprietary  ,9,7,16,69,70,139
02070500,CONCORDIA UNIVERSITY                    ,CA,92612-0000,Private      ,10,67,77,1484,896,2380
02075800,SOUTHERN CA INST OF ARCHITECTURE        ,CA,90013-0000,Private      ,0,4,4,116,487,603
02086400,MARINELLO SCHOOL OF BEAUTY              ,CA,95050-0000,Proprietary  ,1,1,2,14,11,25
02091200,ELEGANCE INTERNATIONAL                  ,CA,90028-0000,Proprietary  ,4,6,10,39,56,95
02091700,KAPLAN COLLEGE                          ,CA,92123-1509,Proprietary  ,81,178,259,504,1254,1758
02096100,FIELDING INSTITUTE                      ,CA,93105-0000,Private      ,0,46,46,0,1135,1135
02099200,AMERICAN CONSERVATORY THEATER           ,CA,94108-0000,Private      ,0,3,3,16,183,199
02110200,COLUMBIA COLLEGE                        ,CA,91356-0000,Private      ,14,8,22,236,161,397
02110800,CALIFORNIA COLLEGE SAN DIEGO            ,CA,92108-3821,Proprietary  ,22,80,102,313,652,965
02111300,CUYAMACA COLLEGE                        ,CA,92019-0000,Public       ,93,187,280,1623,1971,3594
02113601,AMERICAN INTERCONTINENTAL UNIV - LOS ANG,CA,90066-7008,Proprietary  ,46,78,124,978,1156,2134
02119100,MISSION COLLEGE                         ,CA,95054-1897,Public       ,71,207,278,1480,2549,4029
02120600,SAYBROOK GRADUATE SCHOOL                ,CA,94111-1920,Private      ,0,25,25,3,482,485
02120700,SAN JOAQUIN VALLEY COLLEGE              ,CA,93291-0000,Proprietary  ,238,696,934,2254,4927,7181
02120900,ITT TECHNICAL INSTITUTE                 ,CA,95670-6034,Proprietary  ,112,143,255,681,851,1532
02125000,CAREER ACADEMY OF BEAUTY                ,CA,92845-0000,Proprietary  ,16,28,44,77,165,242
02128200,"VICTOR VALLEY BEAUTY COLLEGE, INC       ",CA,92392-0000,Proprietary  ,13,16,29,136,122,258
02128300,INSTITUTE FOR BUSINESS & TECHNOLOGY     ,CA,95050-0000,Proprietary  ,39,208,247,209,985,1194
02128301,INSTITUTE FOR BUSINESS & TECHNOLOGY     ,CA,95610-0000,Proprietary  ,20,166,186,125,795,920
02138300,PACIFIC GRADUATE SCHOOL OF PSYCHOLO     ,CA,94303-4232,Private      ,0,0,0,3,411,414
02138300,PALO ALTO UNIVERSITY                    ,CA,94304-1337,Private      ,0,2,2,0,5,5
02147400,CLEVELAND CHIROPRACTIC COLLEGE          ,CA,90004-0000,Private      ,4,12,16,64,412,476
02161800,MUSICIANS INSTITUTE                     ,CA,90028-6157,Proprietary  ,91,67,158,1018,686,1704
02167800,ESTES INSTITUTE OF COSMETOLOGY          ,CA,93291-0000,Proprietary  ,9,8,17,95,84,179
02174600,MARINELLO SCHOOL OF BEAUTY              ,CA,90201-0000,Proprietary  ,0,10,10,36,215,251
02180600,BRIDGES  ACADEMY OF BEAUTY              ,CA,92311-2327,Proprietary  ,2,3,5,5,8,13
02184900,PALMER COLLEGE OF CHIROPRACTIC WEST     ,CA,95134-0000,Private      ,1,6,7,21,349,370
02185800,MOLER BARBER COLLEGE                    ,CA,94611-0000,Proprietary  ,6,4,10,14,46,60
02187500,"HEALD COLLEGE, SCH OF BUS & TECH        ",CA,94520-0000,Proprietary  ,35,107,142,510,871,1381
02188400,SIERRA VALLEY COLLEGE OF COURT REPORTING,CA,93726-0000,Proprietary  ,10,15,25,65,169,234
02208600,MADERA BEAUTY COLLEGE                   ,CA,93637-3519,Proprietary  ,1,2,3,16,22,38
02211000,HAIRMASTERS UNIVERSITY OF BEAUTY        ,CA,92405-0000,Proprietary  ,5,11,16,51,61,112
02220000,COLLEEN O'HARA BEAUTY ACADEMY           ,CA,92701-0000,Proprietary  ,9,51,60,44,268,312
02220200,CALIFORNIA CULINARY ACADEMY             ,CA,94102-3336,Proprietary  ,99,194,293,1315,1503,2818
02221300,MARINELLO SCHOOL OF BEAUTY              ,CA,92553-0000,Proprietary  ,16,26,42,90,188,278
02222000,AMERICAN FILM INSTITUTE                 ,CA,90027-0000,Private      ,2,4,6,105,506,611
02226000,EAST LOS ANGELES COLLEGE                ,CA,91754-0000,Public       ,343,519,862,6348,5500,11848
02228500,LIFE CHIROPRACTIC COLLEGE-WEST          ,CA,94545-0000,Private      ,0,14,14,6,492,498
02230900,FREDRICK & CHARLES BEAUTY COLLEGE       ,CA,95501-0000,Proprietary  ,6,12,18,40,63,103
02231900,GEMOLOGICAL INSTITUTE OF AMERICA        ,CA,92008-4698,Private      ,3,23,26,84,253,337
02234300,FASHION CAREERS OF CALIFORNIA           ,CA,92110-0000,Proprietary  ,9,12,21,115,105,220
02236400,"THANH LE COLG, SCH OF COSMETOLOGY       ",CA,92840-0000,Proprietary  ,1,3,4,1,46,47
02237200,PHILLIPS GRADUATE INSTITUTE             ,CA,91316-0000,Private      ,0,18,18,1,404,405
02238200,LAKE FOREST BEAUTY COLLEGE              ,CA,92630-1662,Proprietary  ,0,0,0,1,4,5
02241600,SAN DIEGO CONTINUING EDUCATION          ,CA,92113-0000,Public       ,8,61,69,58,310,368
02241800,AMERICAN CAREER COLLEGE                 ,CA,90004-0000,Proprietary  ,198,504,702,1415,3227,4642
02242700,BERKELEY CITY COLLEGE                   ,CA,94704-0000,Public       ,79,194,273,736,1891,2627
02255400,INTERNATIONAL SCHOOL OF COSMETOLOGY     ,CA,90250-0000,Proprietary  ,0,7,7,13,66,79
02255600,MARINELLO SCHOOL OF BEAUTY              ,CA,90723-0000,Proprietary  ,11,45,56,61,182,243
02258600,ALAMEDA BEAUTY COLLEGE                  ,CA,94501-0000,Proprietary  ,1,11,12,39,80,119
02262400,YESHIVA OHR ELCHONON CHABAD             ,CA,90046-0000,Private      ,15,0,15,61,1,62
02267600,INSTITUTE OF TRANSPERSONAL PSYCHLGY     ,CA,94303-4624,Private      ,0,9,9,0,379,379
02270600,LIFE PACIFIC COLLEGE                    ,CA,91773-0000,Private      ,6,13,19,370,195,565
02276800,WESTMINSTER SEMINARY CALIFORNIA         ,CA,92027-0000,Private      ,0,3,3,1,125,126
02277400,SOUTH COAST COLLEGE                     ,CA,92868-2616,Proprietary  ,11,38,49,89,354,443
02282300,ALHAMBRA BEAUTY COLLEGE                 ,CA,91802-0000,Proprietary  ,4,21,25,35,155,190
02285100,HILLTOP BEAUTY SCHOOL                   ,CA,94014-0000,Proprietary  ,6,17,23,19,173,192
02291500,ITT TECHNICAL INSTITUTE                 ,CA,91773-0000,Proprietary  ,150,154,304,1068,1214,2282
02291600,ITT TECHNICAL INSTITUTE                 ,CA,92123-0000,Proprietary  ,79,149,228,693,1267,1960
02298000,DESIGN INSTITUTE OF SAN DIEGO           ,CA,92121-0000,Proprietary  ,7,13,20,197,313,510
02299600,GINO ROBAIR BEAUTY COLLEGE              ,CA,92504-0000,Proprietary  ,0,0,0,0,1,1
02304300,"PLATT COLLEGE, SAN DIEGO                ",CA,92115-0000,Proprietary  ,16,33,49,172,241,413
02306300,KAPLAN COLLEGE                          ,CA,95368-0000,Proprietary  ,53,144,197,346,955,1301
02306302,KAPLAN COLLEGE - FRESNO                 ,CA,93612-3802,Proprietary  ,34,85,119,240,475,715
02309500,CLOVIS ADULT EDUC                       ,CA,93611-0000,Public       ,2,13,15,38,187,225
02312400,LA COLLEGE INTERNATIONAL                ,CA,90010-0000,Proprietary  ,7,26,33,125,184,309
02321800,ITT TECHNICAL INSTITUTE                 ,CA,91342-3664,Proprietary  ,132,144,276,1001,1095,2096
02321900,ITT TECHNICAL INSTITUTE                 ,CA,92801-0000,Proprietary  ,53,94,147,594,680,1274
02327600,ART INST OF CALIFORNIA-SAN DIEGO        ,CA,92108-4401,Proprietary  ,115,141,256,2158,1571,3729
02330500,LAGUNA COLLEGE OF ART AND DESIGN        ,CA,92651-0000,Private      ,7,6,13,322,143,465
02332800,CENTER FOR EMPLOYMENT TRAINING          ,CA,95110-0000,Private      ,80,505,585,339,2030,2369
02338500,GLENDALE CAREER COLLEGE                 ,CA,91201-0000,Proprietary  ,22,69,91,157,462,619
02338700,MARINELLO SCHOOL OF BEAUTY              ,CA,94103-0000,Proprietary  ,9,16,25,59,136,195
02342400,ACADEMY OF RADIO BROADCASTING           ,CA,92647-3809,Proprietary  ,11,28,39,53,105,158
02343400,"BELLUS ACADEMY, THE ACADEMY OF BEAUTY AN",CA,92064-4633,Proprietary  ,23,40,63,82,166,248
02345800,MONTEBELLO BEAUTY COLLEGE               ,CA,90640-0000,Proprietary  ,7,15,22,45,100,145
02351900,KAPLAN COLLEGE                          ,CA,95660-5512,Proprietary  ,33,103,136,225,581,806
02351901,KAPLAN COLLEGE - BAKERSFIELD            ,CA,93304-0000,Proprietary  ,46,121,167,211,547,758
02358000,THOMAS AQUINAS COLLEGE                  ,CA,93060-9622,Private      ,0,0,0,315,27,342
02359300,SHASTA BIBLE COLLEGE                    ,CA,96002-0000,Private      ,1,6,7,46,46,92
02482700,WESTERN UNIVERSITY OF HEALTH S          ,CA,91766-1854,Private      ,1,11,12,49,2813,2862
02494800,LOLA BEAUTY COLLEGE                     ,CA,92641-0000,Proprietary  ,1,10,11,6,63,69
02497300,TRINITY COLLEGE                         ,CA,93277-0000,Proprietary  ,34,102,136,239,750,989
02500000,SAN JOAQUIN COLLEGE OF LAW              ,CA,93612-0000,Private      ,1,7,8,4,252,256
02518400,THE NATIONAL HISPANIC UNIVERSITY        ,CA,95127-0000,Private      ,13,32,45,289,359,648
02519800,AVANCE BEAUTY COLLEGE                   ,CA,92154-0000,Proprietary  ,3,12,15,40,68,108
02520200,CALIFORNIA CAREER SCHOOLS               ,CA,92805-0000,Proprietary  ,0,8,8,4,49,53
02520300,INTERIOR DESIGNERS INSTITUTE            ,CA,92660-0000,Proprietary  ,6,22,28,53,152,205
02537200,PALOMAR INSTITUTE OF COSMETOLOGY        ,CA,92069-0000,Proprietary  ,9,26,35,123,163,286
02539100,KAPLAN COLLEGE                          ,CA,91606-3231,Proprietary  ,49,104,153,365,837,1202
02539500,IRVINE VALLEY COLLEGE                   ,CA,92620-0000,Public       ,75,102,177,1581,1662,3243
02542300,NATIONAL HOLISTIC INSTITUTE             ,CA,94608-0000,Proprietary  ,37,96,133,173,455,628
02543400,BROWNSON TECHNICAL SCHOOL               ,CA,92805-0000,Proprietary  ,5,15,20,22,71,93
02545900,HYPNOSIS MOTIVATION INSTITUTE           ,CA,91356-0000,Private      ,1,44,45,4,162,166
02546400,MTI BUSINESS COLLEGE INC                ,CA,95207-0000,Proprietary  ,9,45,54,41,231,272
02549000,KAPLAN COLLEGE                          ,CA,92083-7736,Proprietary  ,68,154,222,449,875,1324
02549005,KAPLAN COLLEGE -  PALM SPRINGS          ,CA,92262-7011,Proprietary  ,29,71,100,217,468,685
02552200,CULVER CITY BEAUTY COLLEGE              ,CA,90230-0000,Proprietary  ,0,0,0,0,1,1
02553500,ASSOCIATED TECHNICAL COLLEGE            ,CA,92101-0000,Proprietary  ,7,22,29,29,124,153
02553600,DIVERSIFIED LANGUAGE INSTITUTE          ,CA,90017-0000,Proprietary  ,4,179,183,10,526,536
02559300,UNITED EDUCATION INSTITUTE              ,CA,90020-0000,Proprietary  ,246,558,804,1128,2699,3827
02559400,INTERCOAST COLLEGES                     ,CA,92868-1656,Proprietary  ,22,180,202,124,878,1002
02565400,KAPLAN COLLEGE                          ,CA,95207-6216,Proprietary  ,34,119,153,284,725,1009
02570300,LOS ANGELES ORT TECHNICAL INSTITUTE     ,CA,90048-0000,Private      ,17,137,154,107,668,775
02577900,SANTA BARBARA BUSINESS COLLEGE          ,CA,93309-1664,Proprietary  ,32,79,111,242,637,879
02578000,SANTA BARBARA BUSINESS COLLEGE          ,CA,93454-6943,Proprietary  ,20,47,67,99,310,409
02584200,NEWBRIDGE COLLEGE                       ,CA,92701-0000,Proprietary  ,33,111,144,162,595,757
02591600,NORTH-WEST COLLEGE                      ,CA,91101-1744,Proprietary  ,4,17,21,41,88,129
02593100,HEALD COLLEGE                           ,CA,95678-5303,Proprietary  ,33,79,112,377,684,1061
02593200,HEALD COLLEGE                           ,CA,95035-8008,Proprietary  ,50,124,174,429,839,1268
02593300,HEALD COLLEGE                           ,CA,95210-5667,Proprietary  ,42,112,154,508,690,1198
02595600,ASIAN AMERICAN INTERNATIONAL BTY CG     ,CA,92683-4043,Proprietary  ,1,21,22,8,115,123
02597300,SOUTH BAYLO UNIVERSITY                  ,CA,92801-1701,Private      ,0,13,13,6,169,175
02602300,CENTRAL COAST COLLEGE                   ,CA,93901-3301,Proprietary  ,19,32,51,104,201,305
02608900,PINNACLE COLLEGE                        ,CA,91803-8842,Proprietary  ,8,14,22,46,72,118
02609000,EMPERORS COLG OF TRAD ORIENTAL MED      ,CA,90403-5609,Proprietary  ,0,16,16,1,198,199
02612800,LOS ANGELES RECORDING SCHOOL            ,CA,90028-3112,Proprietary  ,76,105,181,569,614,1183
02619300,SAMRA UNIV OF ORIENTAL MEDICINE         ,CA,90015-1019,Private      ,0,11,11,2,112,114
02620300,PLATT COLLEGE                           ,CA,92647-3017,Proprietary  ,6,11,17,81,76,157
03010611,VIRGINIA COLLEGE - GOLF ACADEMY OF AMERI,CA,92008-6512,Proprietary  ,9,12,21,79,109,188
03011300,"CALIF STATE UNIV, SAN MARCOS            ",CA,92096-0001,Public       ,101,128,229,5863,4005,9868
03019900,ADELANTE CAREER INSTITUTE               ,CA,91402-4924,Proprietary  ,10,24,34,30,134,164
03025600,DELL'ARTE SCH OF PHYSICAL THEATRE       ,CA,95525-0816,Private      ,0,1,1,7,31,38
03027700,PACIFIC COLLEGE OF ORIENTAL MED         ,CA,92108-4408,Proprietary  ,1,34,35,18,483,501
03029600,POMONA ADULT SCHOOL                     ,CA,91766-0000,Public       ,8,39,47,49,142,191
03031409,INTERNATIONAL ACADEMY OF DESIGN AND TECH,CA,95834-9664,Proprietary  ,4,3,7,4,3,7
03034000,HEALD COLLEGE                           ,CA,93906-5100,Proprietary  ,26,69,95,433,519,952
03035700,LAS POSITAS COLLEGE                     ,CA,94551-6750,Public       ,55,79,134,969,970,1939
03039900,FREMONT COLLEGE                         ,CA,90703-5342,Proprietary  ,21,40,61,67,144,211
03043900,NEWSCHOOL OF ARCHITECTURE & DESIGN      ,CA,92101-6634,Proprietary  ,8,19,27,184,337,521
03044500,KAPLAN COLLEGE                          ,CA,91402-4222,Proprietary  ,17,48,65,107,250,357
03044501,MARIC COLLEGE - PANORAMA CITY           ,CA,91402-4222,Proprietary  ,0,0,0,92,187,279
03052201,COURT REPORTING INSTITUTE-SAN DIEGO     ,CA,92123-1765,Proprietary  ,0,0,0,32,98,130
03054100,ROYALE COLLEGE OF BEAUTY                ,CA,92590-2525,Proprietary  ,12,9,21,57,80,137
03062300,WESTECH COLLEGE                         ,CA,91764-4988,Proprietary  ,7,62,69,46,370,416
03062400,MT DIABLO ADULT EDUC LOMA VISTA CTR     ,CA,94518-1122,Public       ,5,11,16,34,75,109
03062700,PLATT COLLEGE                           ,CA,90041-0000,Proprietary  ,5,13,18,141,181,322
03062701,PLATT COLLEGE                           ,CA,91764-0000,Proprietary  ,18,26,44,250,270,520
03063400,MODERN TECHNOLOGY SCHOOL                ,CA,92708-9821,Proprietary  ,14,42,56,79,253,332
03067400,BALDWIN PARK ADULT SCHOOL               ,CA,91706-4897,Public       ,7,31,38,29,149,178
03067500,INSTITUTE OF TECHNOLOGY                 ,CA,93612-3217,Proprietary  ,135,440,575,697,2129,2826
03069500,SAGE COLLEGE                            ,CA,92557-6720,Proprietary  ,10,48,58,98,396,494
03070400,ITT TECHNICAL INSTITUTE                 ,CA,92408-3519,Proprietary  ,140,156,296,991,1052,2043
03072300,EVEREST COLLEGE                         ,CA,91761-3222,Proprietary  ,86,279,365,547,1587,2134
03072700,WESTWOOD COLLEGE - LOS ANGELES          ,CA,90010-1577,Proprietary  ,47,72,119,968,781,1749
03074900,MARTINEZ ADULT CENTER                   ,CA,94553-3298,Public       ,0,10,10,2,39,41
03078200,AMERICAN CLG TRADITIONAL CHINESE MD     ,CA,94107-2813,Private      ,0,14,14,1,259,260
03084700,VENTURA ADULT\CONTINUING EDUCATION      ,CA,93003-7313,Public       ,9,26,35,35,123,158
03085400,CAREER WEST ACADEMY                     ,CA,95928-0000,Proprietary  ,0,0,0,0,2,2
03087400,ITT TECHNICAL INSTITUTE                 ,CA,90502-1356,Proprietary  ,126,258,384,850,1488,2338
03087700,ESCUELAS LEICESTER                      ,CA,90015-0000,Proprietary  ,0,0,0,2,13,15
03094400,ELITE PROGRESSIVE SCHOOL OF COSM        ,CA,95841-2909,Proprietary  ,44,43,87,295,292,587
03097700,CENTRAL CALIF SCH CONTINUING EDUC       ,CA,93401-6739,Proprietary  ,4,34,38,38,192,230
03098200,YO SAN UNIV TRADITIONAL CHINESE MED     ,CA,90066-1103,Private      ,0,3,3,1,114,115
03105700,MONTEREY PARK COLLEGE                   ,CA,91754-2416,Proprietary  ,1,0,1,22,25,47
03108100,SUMMIT CAREER COLLEGE                   ,CA,92324-3956,Proprietary  ,75,339,414,482,1939,2421
03109500,DONGGUK ROYAL UNIVERSITY                ,CA,90020-1765,Private      ,0,6,6,0,103,103
03113100,MARIC COLLEGE                           ,CA,92630-0000,Proprietary  ,1,1,2,131,399,530
03113102,MARIC COLLEGE - CARSON                  ,CA,90746-3228,Proprietary  ,8,12,20,95,321,416
03113103,MARIC COLLEGE - RIVERSIDE               ,CA,92507-4223,Proprietary  ,50,110,160,268,674,942
03113105,MARIC COLLEGE - POMONA                  ,CA,91768-2643,Proprietary  ,3,11,14,98,259,357
03113106,MARIC COLLEGE - SAN DIEGO               ,CA,92120-3425,Proprietary  ,0,0,0,85,229,314
03113108,MARIC COLLEGE - IRWINDALE               ,CA,91706-1410,Proprietary  ,0,0,0,0,2,2
03113300,MCED CAREER COLLEGE                     ,CA,93727-1620,Proprietary  ,10,63,73,36,214,250
03113600,SOUTHERN CALIFORNIA INST OF TECHNOL     ,CA,92805-3758,Proprietary  ,14,88,102,58,542,600
03115400,LYLE'S FRESNO COLLEGE OF BEAUTY         ,CA,93710-0000,Proprietary  ,0,0,0,32,9,41
03116600,EAST SAN GABRIEL VLY REG OCCUP PROG     ,CA,91790-2105,Public       ,0,1,1,2,12,14
03123000,SONOMA COLLEGE                          ,CA,94954-7464,Proprietary  ,2,17,19,70,273,343
03125300,JOHN WESLEY INTER. BARBER & BTY CLG     ,CA,90813-4321,Proprietary  ,4,13,17,46,83,129
03125400,ART INSTITUTE OF CALIFORNIA-HOLLYWOOD (T,CA,90010-1014,Proprietary  ,39,40,79,600,438,1038
03125800,PREMIERE CAREER COLLEGE                 ,CA,91706-3746,Proprietary  ,24,93,117,121,383,504
03126800,PACIFICA GRADUATE INSTITUTE             ,CA,93013-0000,Proprietary  ,0,27,27,0,800,800
03128000,SANTA BARBARA CLG OF ORIENTAL MED       ,CA,93101-2430,Proprietary  ,0,0,0,8,66,74
03128700,MT SIERRA COLLEGE                       ,CA,91016-3414,Proprietary  ,13,24,37,370,477,847
03131300,FIVE BRANCHES UNIVERSITY                ,CA,95062-4669,Private      ,1,9,10,21,269,290
03138400,AMERICAN COLLEGE OF MEDICAL TECH        ,CA,90248-1611,Proprietary  ,18,56,74,128,434,562
03144400,AMERICAN CLG OF HEALTH PROFESSIONS      ,CA,92374-0000,Proprietary  ,1,5,6,18,44,62
03150500,VIRGINIA SEWING MACHINES & SCH CTR      ,CA,90015-3535,Proprietary  ,0,11,11,1,81,82
03162300,FOUR-D SUCCESS ACADEMY                  ,CA,92324-4218,Proprietary  ,17,106,123,107,666,773
03163300,PACIFIC STATES UNIVERSITY               ,CA,90006-4298,Private      ,0,2,2,13,23,36
03195400,EVEREST COLLEGE                         ,CA,90501-2867,Proprietary  ,15,27,42,98,149,247
03210300,CALIFORNIA SCHOOL OF CULINARY ARTS      ,CA,91101-5221,Proprietary  ,142,235,377,1484,1487,2971
03225300,AMERICAN UNIVERSITY OF HEALTH SCIENCES  ,CA,90755-3612,Proprietary  ,4,12,16,35,71,106
03242300,CAREER NETWORK INSTITUTE                ,CA,92868-4710,Proprietary  ,21,47,68,152,373,525
03250300,COMMUNITY BASED EDUCATION AND DEVEL     ,CA,90036-1137,Private      ,6,69,75,21,327,348
03260300,CALIFORNIA STATE U-MONTEREY BAY         ,CA,93955-8001,Public       ,47,51,98,3363,1748,5111
03266300,BETHESDA CHRISTIAN UNIVERSITY           ,CA,92801-4132,Private      ,0,3,3,8,36,44
03278300,CLARITA CAREER COLLEGE                  ,CA,91351-5432,Proprietary  ,43,104,147,133,348,481
03282300,KIM ANH ACADEMY OF BEAUTY               ,CA,92683-4605,Proprietary  ,0,0,0,7,122,129
03288300,ACAD CHINESE CULTURE & HEALTH SCIS      ,CA,94512-0000,Private      ,0,5,5,2,112,114
03299300,PACIFIC COLLEGE                         ,CA,92626-3160,Proprietary  ,13,47,60,80,367,447
03308300,KENSINGTON COLLEGE                      ,CA,92705-8708,Proprietary  ,0,4,4,2,19,21
03321300,SCRIPPS RESEARCH INSTITUTE (THE)        ,CA,92037-0000,Private      ,1,0,1,6,23,29
03327400,ACUPUNCTURE AND INTEGRATIVE MEDICINE COL,CA,94704-2724,Private      ,0,6,6,2,155,157
03330300,NEWBRIDGE COLLEGE - BURBANK             ,CA,91754-2416,Proprietary  ,0,0,0,1,4,5
03332300,SOUTHERN CA BIBLE CLG & SEMINARY        ,CA,92019-1109,Private      ,1,14,15,9,172,181
03359300,ST. FRANCIS CAREER COLLEGE              ,CA,90262-2659,Private      ,8,41,49,77,288,365
03367300,PROFESSIONAL GOLFERS CAREER COLLEGE     ,CA,92591-6013,Proprietary  ,3,10,13,100,144,244
03383300,CALIFORNIA RECORDING INSTITUTE          ,CA,94103-3921,Proprietary  ,0,0,0,1,1,2
03392300,CHASE COLLEGE                           ,CA,90010-2501,Proprietary  ,31,41,72,109,186,295
03394300,REMINGTON COLLEGE - SAN DIEGO CAMPUS    ,CA,92108-3002,Proprietary  ,51,98,149,564,1289,1853
03395300,INTERNATIONAL CAREER DEVELOPMENT        ,CA,90027-5794,Proprietary  ,151,393,544,520,1388,1908
03399300,NORTHWESTERN TECHNICAL COLLEGE          ,CA,95670-4443,Proprietary  ,13,63,76,93,309,402
03403300,TRINITY LIFE BIBLE COLLEGE              ,CA,95842-3546,Private      ,9,40,49,69,180,249
03413400,ENGLISH CENTER  (THE)                   ,CA,94607-3734,Private      ,3,36,39,42,182,224
03415300,MEDACOM COLLEGE                         ,CA,94560-0000,Proprietary  ,0,0,0,2,18,20
03427400,CAREER COLLEGES OF AMERICA              ,CA,90280-7420,Proprietary  ,64,249,313,329,1456,1785
03427500,ANTELOPE VALLEY MEDICAL COLLEGE         ,CA,93534-3324,Proprietary  ,33,107,140,153,566,719
03440400,MARIAN HEALTH CAREERS CENTER            ,CA,90010-1728,Proprietary  ,26,49,75,68,136,204
03441400,VALLEY CAREER COLLEGE                   ,CA,92020-3057,Proprietary  ,21,66,87,108,341,449
03455900,VALLECITOS CENTER FOR EMPLOYMENT TR     ,CA,94541-5027,Private      ,0,5,5,13,18,31
03458300,MY LE'S BEAUTY COLLEGE                  ,CA,95824-3039,Proprietary  ,5,20,25,59,165,224
03467300,MARINELLO SCHOOL OF BEAUTY              ,CA,92545-3661,Proprietary  ,7,14,21,61,118,179
03467301,CALIFORNIA BEAUTY COLLEGE - DESERT HOT S,CA,92240-1307,Proprietary  ,1,1,2,3,2,5
03474700,OPPORTUNITIES INDUSTRIALIZATION CEN     ,CA,94025-1413,Private      ,0,0,0,0,8,8
03479300,PROFESSIONAL CAREER INSTITUTE           ,CA,90703-2522,Proprietary  ,3,23,26,55,169,224
03479400,DONALD VOCATIONAL SCHOOL                ,CA,90010-1718,Proprietary  ,0,15,15,5,72,77
03485400,JAMES ALBERT SCHOOL OF COSMETOLOGY      ,CA,92627-3831,Proprietary  ,3,8,11,16,58,74
03485401,JAMES ALBERT SCHOOL OF COSMETOLOGY - ANA,CA,92804-5384,Proprietary  ,0,0,0,2,3,5
03516300,THE KING'S COLLEGE AND SEMINARY         ,CA,91405-2233,Private      ,6,20,26,54,266,320
03532400,ADVANCED TRAINING ASSOCIATES            ,CA,92020-1236,Proprietary  ,1,1,2,4,14,18
03542400,COPPER MOUNTAIN COLLEGE                 ,CA,92252-6102,Public       ,29,96,125,356,1180,1536
03550300,OCCUPATIONAL TRAINING SERVICES          ,CA,92123-1539,Private      ,0,3,3,13,44,57
03577300,COBA ACADEMY                            ,CA,92866-1407,Proprietary  ,10,13,23,59,53,112
03590400,NTMA TRAINING CENTERS OF SOUTHERN C     ,CA,90650-6099,Private      ,19,134,153,55,423,478
03592400,IRELL & MANELLA GRADUATE SCHOOL OF BIOLO,CA,91010-0000,Private      ,0,1,1,1,10,11
03598300,AVALON BEAUTY COLLEGE                   ,CA,93103-3137,Proprietary  ,0,1,1,8,28,36
03602400,INSTITUTE OF NETWORK TECHNOLOGY         ,CA,90755-2274,Proprietary  ,0,2,2,6,17,23
03614300,UNITED BEAUTY COLLEGE                   ,CA,91733-0000,Proprietary  ,2,20,22,14,119,133
03615300,COMMUNITY BUSINESS COLLEGE              ,CA,95356-1569,Proprietary  ,1,3,4,15,37,52
03621300,LIBERTY TRAINING INSTITUTE              ,CA,90057-3202,Proprietary  ,2,45,47,13,181,194
03622300,INTERNATIONAL TECHNOLOGICAL UNIVERS     ,CA,95050-3714,Private      ,0,0,0,0,4,4
03633300,CALIFORNIA LEARNING CENTER              ,CA,92805-3700,Proprietary  ,0,0,0,7,31,38
03636300,HEARTWOOD INSTITUTE                     ,CA,95542-9446,Proprietary  ,0,1,1,15,56,71
03639300,WEST COAST ULTRASOUND INSTITUTE         ,CA,90211-3312,Proprietary  ,10,60,70,94,391,485
03646300,DESIGN'S SCHOOL OF COSMETOLOGY          ,CA,93446-1471,Proprietary  ,8,16,24,38,67,105
03662400,ACADEMY EDUCATION SERVICES              ,CA,93030-7026,Proprietary  ,0,0,0,13,47,60
03681300,CALIFORNIA HEALING ARTS COLLEGE         ,CA,90025-2589,Proprietary  ,7,24,31,36,136,172
03695300,COMMUNITY ENHANCEMENT SERVICES          ,CA,91205-2395,Private      ,3,54,57,8,139,147
03695700,SANTIAGO CANYON COLLEGE                 ,CA,92869-4512,Public       ,76,82,158,1036,768,1804
03696300,UNIVERSITY OF THE WEST                  ,CA,91770-3709,Private      ,0,6,6,0,10,10
03698300,WEST COAST UNIVERSITY                   ,CA,90004-0000,Proprietary  ,8,71,79,55,612,667
03698400,CA COLLEGE OF VOCATIONAL CAREER         ,CA,93301-1800,Proprietary  ,4,21,25,28,99,127
03722300,AMERICAN MEDICAL SCIENCES CENTER        ,CA,91601-3718,Proprietary  ,0,0,0,3,3,6
03736300,ADVANCE BEAUTY COLLEGE                  ,CA,92843-4752,Proprietary  ,2,46,48,18,278,296
03740400,ATI COLLEGE                             ,CA,90650-0000,Proprietary  ,3,6,9,25,108,133
03755300,GATES COLLEGE                           ,CA,90278-0000,Proprietary  ,1,0,1,6,15,21
03759300,COMPUTER TUTOR BUSINESS & TECH INST     ,CA,95356-0000,Proprietary  ,2,33,35,22,132,154
03786300,ADVANCED COLLEGE                        ,CA,90280-5255,Proprietary  ,8,24,32,44,110,154
03797400,CAREER CARE INSTITUTE                   ,CA,93534-4766,Proprietary  ,17,47,64,133,424,557
03806300,LAKE COLLEGE                            ,CA,96002-0926,Proprietary  ,10,72,82,60,334,394
03810300,SILICON VALLEY UNIVERSITY               ,CA,95131-1868,Private      ,3,3,6,18,33,51
03814400,SOKA UNIVERSITY OF AMERICA              ,CA,92656-8081,Private      ,5,0,5,201,26,227
03835300,CONEJO VALLEY ADULT EDUCATION           ,CA,91360-0000,Public       ,0,0,0,0,5,5
03838400,WALTER JAY M.D. INSTITUTE AN EDUCATIONAL,CA,90057-0000,Proprietary  ,0,5,5,14,42,56
03852500,CIT COLLEGE OF INFOMEDICAL TECHNOLOGY   ,CA,92831-3703,Proprietary  ,6,69,75,33,268,301
03853300,KECK GRADUATE INSTITUTE OF APPLIED LIFE ,CA,91711-4817,Private      ,0,0,0,0,66,66
03853400,LADERA CAREER PATHS TRAINING CENTERS    ,CA,90045-1931,Proprietary  ,1,4,5,4,26,30
03868300,WORLD MISSION UNIVERSITY                ,CA,90020-1789,Private      ,1,9,10,2,50,52
03868400,LOS ANGELES MUSIC ACADEMY               ,CA,91105-2540,Proprietary  ,1,6,7,65,62,127
03871300,FOLSOM LAKE COLLEGE                     ,CA,95630-6798,Public       ,61,139,200,847,1371,2218
03874300,CAMBRIDGE CAREER COLLEGE                ,CA,95993-0000,Proprietary  ,1,2,3,16,19,35
03874400,COMMMUNITY CHRISTIAN COLLEGE            ,CA,92373-4465,Private      ,0,3,3,25,28,53
03889300,STANBRIDGE COLLEGE                      ,CA,92612-0000,Proprietary  ,1,5,6,23,69,92
03901300,PACIFIC COAST TRADE SCHOOL              ,CA,93033-2441,Proprietary  ,1,4,5,5,16,21
03904300,QUALITY COLLEGE OF CULINARY CAREERS     ,CA,93727-1615,Proprietary  ,5,10,15,38,74,112
03910400,NATIONAL POLYTECHNIC COLLEGE            ,CA,90040-3066,Proprietary  ,3,16,19,21,106,127
03933300,MUELLER COLLEGE OF HOLISTIC STUDIES     ,CA,92116-2630,Proprietary  ,2,20,22,39,174,213
03959300,CAREER MANAGEMENT INSTITUTE             ,CA,92868-4117,Proprietary  ,0,0,0,0,7,7
03962300,AMERICAN INSTITUTE OF MASSAGE THERAPY   ,CA,92705-5463,Proprietary  ,2,9,11,19,51,70
03964400,INTERNATIONAL SCHOOL OF BEAUTY          ,CA,92260-2740,Proprietary  ,3,5,8,35,61,96
03969400,MEDICAL INSTITUTE                       ,CA,90029-2428,Proprietary  ,0,0,0,20,39,59
03969600,AMERICAN AUTO INSTITUTE                 ,CA,90703-2637,Proprietary  ,4,14,18,36,85,121
03971300,AMERICAN CAREER COLLEGE                 ,CA,91764-4906,Proprietary  ,29,77,106,174,419,593
03973300,EX'PRESSION COLLEGE FOR DIGITAL ARTS    ,CA,94608-1021,Proprietary  ,80,65,145,495,507,1002
03974500,CALIFORNIA CAREER COLLEGE               ,CA,91303-2006,Proprietary  ,1,8,9,21,90,111
03976400,CALIFORNIA INSTITUTE OF THE HEALING ARTS,CA,95825-8551,Proprietary  ,0,6,6,2,18,20
03980300,CALIFORNIA STATE UNIVERSITY CHANNEL ISLA,CA,93012-8599,Public       ,15,23,38,766,581,1347
03995300,UNIVERSITY OF EAST-WEST MEDICINE        ,CA,94087-6106,Proprietary  ,0,4,4,4,46,50
03999300,BEAUMONT ADULT SCHOOL                   ,CA,92223-1927,Public       ,2,30,32,2,30,32
04001300,PALACE BEAUTY COLLEGE                   ,CA,90006-4233,Proprietary  ,1,7,8,15,44,59
04001400,MOJAVE BARBER COLLEGE                   ,CA,92395-3201,Proprietary  ,0,18,18,11,47,58
04003300,CSI CAREER COLLEGE                      ,CA,95687-3100,Proprietary  ,8,29,37,40,144,184
04004300,THUY PRINCESS BEAUTY COLLEGE            ,CA,91766-0000,Proprietary  ,2,8,10,6,19,25
04005300,INTERAMERICAN COLLEGE                   ,CA,91950-4437,Private      ,1,11,12,4,63,67
04011900,AMERICAN COLLEGE OF CALIFORNIA          ,CA,94102-2305,Proprietary  ,0,0,0,11,8,19
04014400,PALLADIUM TECHNICAL ACADEMY             ,CA,91731-2429,Proprietary  ,12,17,29,24,29,53
04037300,LOS ANGELES FILM SCHOOL (THE)           ,CA,90028-7300,Proprietary  ,39,51,90,180,241,421
04049300,MAXINE WATERS EMPLOYMENT PREPARATION CEN,CA,90059-1023,Public       ,0,2,2,3,21,24
04056300,CAREER COLLEGE OF CALIFORNIA            ,CA,92705-5805,Proprietary  ,0,4,4,2,11,13
04057300,TECHSKILLS OF SACRAMENTO                ,CA,95815-4025,Proprietary  ,6,66,72,28,230,258
04076400,GNOMON SCHOOL OF VISUAL EFFECTS         ,CA,90038-2616,Proprietary  ,6,14,20,13,41,54
04092400,MAKE-UP DESIGNORY                       ,CA,91502-1322,Proprietary  ,3,4,7,3,4,7
04109300,ACADEMY OF BARBERING ARTS (THE)         ,CA,91324-3406,Proprietary  ,4,8,12,4,8,12
04114500,VALLEY COLLEGE OF MEDICAL CAREERS       ,CA,91304-2354,Proprietary  ,2,22,24,2,32,34
04116000,VIDEO SYMPHONY ENTERTRAINING            ,CA,91502-3253,Proprietary  ,2,16,18,2,16,18
00184600,BRIAR CLIFF UNIVERSITY                  ,IA,51104-2100,Private      ,5,18,23,1253,466,1719
00184700,BUENA VISTA UNIVERSITY                  ,IA,50588-9987,Private      ,16,74,90,1983,1591,3574
00184800,SOUTHEASTERN COMMUNITY COLLEGE          ,IA,52655-0000,Public       ,52,147,199,1092,1760,2852
00185000,CENTRAL COLLEGE                         ,IA,50219-1999,Private      ,7,2,9,2077,112,2189
00185200,CLARKE COLLEGE                          ,IA,52001-3198,Private      ,5,16,21,989,410,1399
00185400,COE COLLEGE                             ,IA,52402-5092,Private      ,9,2,11,1642,190,1832
00185500,DES MOINES UNIV-OSTEOPATHIC MED CTR     ,IA,50312-0000,Private      ,0,12,12,19,1468,1487
00185600,CORNELL COLLEGE                         ,IA,52314-1098,Private      ,11,2,13,1601,62,1663
00185700,SOUTHWESTERN COMMUNITY COLLEGE          ,IA,50801-1098,Public       ,6,44,50,586,580,1166
00185800,DIVINE WORD COLLEGE                     ,IA,52045-0380,Private      ,4,0,4,17,19,36
00185900,DORDT COLLEGE                           ,IA,51250-1697,Private      ,4,1,5,1191,110,1301
00186000,DRAKE UNIVERSITY                        ,IA,50311-4505,Private      ,22,51,73,3762,2223,5985
00186200,ELLSWORTH COMMUNITY COLLEGE             ,IA,50126-1199,Public       ,5,28,33,612,280,892
00186400,IOWA LAKES COMMUNITY COLLEGE            ,IA,51334-2234,Public       ,28,70,98,1257,1035,2292
00186500,IOWA CENTRAL COMMUNITY COLLEGE          ,IA,50501-0000,Public       ,47,190,237,2059,1592,3651
00186600,GRACELAND UNIVERSITY                    ,IA,50140-1699,Private      ,15,106,121,1021,988,2009
00186700,GRAND VIEW UNIVERSITY                   ,IA,50316-1599,Private      ,6,29,35,1307,971,2278
00186800,GRINNELL COLLEGE                        ,IA,50112-1690,Private      ,9,1,10,2081,26,2107
00186900,IOWA STATE UNIV SCIENCE & TECHNOLOG     ,IA,50011-2028,Public       ,141,110,251,17670,4840,22510
00187100,IOWA WESLEYAN COLLEGE                   ,IA,52641-1398,Private      ,8,11,19,588,422,1010
00187300,LORAS COLLEGE                           ,IA,52004-0178,Private      ,3,3,6,1931,202,2133
00187400,LUTHER COLLEGE                          ,IA,52101-1045,Private      ,5,1,6,2814,102,2916
00187500,MARSHALLTOWN COMMUNITY COLLEGE          ,IA,50158-4760,Public       ,25,50,75,602,751,1353
00187700,NORTH IOWA AREA COMMUNITY COLLEGE       ,IA,50401-7299,Public       ,35,71,106,1464,1025,2489
00187900,MORNINGSIDE COLLEGE                     ,IA,51106-1751,Private      ,7,27,34,1589,340,1929
00188000,MOUNT MERCY COLLEGE                     ,IA,52402-4797,Private      ,6,26,32,1132,622,1754
00188100,ASHFORD UNIVERSITY                      ,IA,52732-3997,Proprietary  ,89,2171,2260,584,7239,7823
00188300,NORTHWESTERN COLLEGE                    ,IA,51041-1996,Private      ,4,2,6,1607,96,1703
00188700,SIMPSON COLLEGE                         ,IA,50125-1297,Private      ,8,14,22,2176,509,2685
00188900,ST AMBROSE UNIVERSITY                   ,IA,52803-2898,Private      ,12,41,53,2508,1326,3834
00189000,UNIVERSITY OF NORTHERN IOWA             ,IA,50614-0705,Public       ,75,97,172,9746,2907,12653
00189100,UNIVERSITY OF DUBUQUE                   ,IA,52001-5099,Private      ,11,12,23,1515,512,2027
00189200,UNIVERSITY OF IOWA                      ,IA,52242-1316,Public       ,148,171,319,16528,8746,25274
00189300,UPPER IOWA UNIVERSITY                   ,IA,52142-9206,Private      ,20,274,294,1294,3660,4954
00189400,VENNARD COLLEGE                         ,IA,52595-0029,Private      ,3,1,4,71,35,106
00189500,WALDORF COLLEGE                         ,IA,50436-1700,Private      ,3,2,5,682,81,763
00189600,WARTBURG COLLEGE                        ,IA,50677-2200,Private      ,11,1,12,2360,76,2436
00189700,WARTBURG THEOLOGICAL SEMINARY           ,IA,52004-5004,Private      ,0,1,1,1,149,150
00190000,WILLIAM PENN UNIVERSITY                 ,IA,52577-1799,Private      ,30,118,148,1042,1555,2597
00396300,AIB COLLEGE OF BUSINESS                 ,IA,50321-1799,Private      ,7,29,36,715,527,1242
00407500,ESTRN IOWA COMMUNITY COLLEGE DIST       ,IA,52801-1221,Public       ,2,7,9,49,90,139
00407501,CLINTON COMMUNITY COLLEGE               ,IA,52732-0000,Public       ,14,24,38,398,593,991
00407502,MUSCATINE COMMUNITY COLLEGE             ,IA,52761-0000,Public       ,10,43,53,406,507,913
00407503,SCOTT COMMUNITY COLLEGE                 ,IA,52722-0000,Public       ,56,118,174,1194,2416,3610
00407600,KIRKWOOD COMMUNITY COLLEGE              ,IA,52406-2068,Public       ,139,360,499,6679,5783,12462
00423300,MERCY/ST. LUKE'S SCH RAD TECH           ,IA,52402-0000,Private      ,0,0,0,16,18,34
00458600,KAPLAN UNIVERSITY                       ,IA,52807-2095,Proprietary  ,778,12481,13259,3645,59013,62658
00458604,KAPLAN UNIVERSITY - CEDAR RAPIDS        ,IA,52404-2998,Proprietary  ,17,78,95,229,887,1116
00458605,KAPLAN UNIVERSITY - DES MOINES          ,IA,50323-5702,Proprietary  ,16,108,124,352,1005,1357
00458606,KAPLAN UNIVERSITY - MASON CITY          ,IA,50401-4665,Proprietary  ,10,55,65,171,563,734
00458607,KAPLAN UNIVERSITY - CEDAR FALLS         ,IA,50613-6309,Proprietary  ,19,60,79,255,904,1159
00458610,KAPLAN UNIVERSITY - COUNCIL BLUFFS      ,IA,51503-5289,Proprietary  ,10,43,53,106,459,565
00458700,NORTHEAST IOWA COMMUNITY COLLEGE        ,IA,52132-0400,Public       ,21,38,59,679,751,1430
00458701,NORTHEAST IOWA COMMUNITY COLLEGE        ,IA,52068-0000,Public       ,30,52,82,1012,1115,2127
00459500,HAWKEYE COMMUNITY COLLEGE               ,IA,50701-0000,Public       ,74,133,207,2854,2646,5500
00459800,IOWA WESTERN CMTY CLG-COUNCIL BLUFF     ,IA,51502-0000,Public       ,48,118,166,2120,1948,4068
00460000,NORTHWEST IOWA COMMUNITY COLLEGE        ,IA,51201-1046,Public       ,10,10,20,461,323,784
00626700,IOWA METHODIST MEDICAL CENTER SCHOOLS   ,IA,50309-1499,Private      ,0,0,0,20,37,57
00627300,MERCY COLLEGE OF HEALTH SCIENCES        ,IA,50309-1239,Private      ,4,31,35,439,621,1060
00712000,DES MOINES AREA CMTY COLLEGE            ,IA,50021-0000,Public       ,151,366,517,5078,6219,11297
00712100,FAITH BAPTIST BIBLE CLG & THEOL SEM     ,IA,50021-0000,Private      ,3,4,7,313,88,401
00729100,ST LUKE'S COLLEGE                       ,IA,51104-0263,Private      ,0,3,3,137,101,238
00731600,WESTERN IOWA TECH COMMUNITY COLLEGE     ,IA,51106-0000,Public       ,42,159,201,1220,2516,3736
00758800,CAPRI COLLEGE                           ,IA,52004-0873,Proprietary  ,22,42,64,260,235,495
00761100,EQ SCHOOL OF HAIR DESIGN                ,IA,51503-0813,Proprietary  ,2,8,10,52,62,114
00765600,AMERICAN COLLEGE OF HARISTYLING -CR     ,IA,52402-0000,Proprietary  ,3,5,8,12,21,33
00765800,AMER COLL OF HAIRSTYLING-DES MOINES     ,IA,50309-5446,Proprietary  ,4,9,13,11,48,59
00765900,LA JAMES COLLEGE OF HAIRSTYLING         ,IA,50401-3308,Proprietary  ,3,12,15,73,75,148
00771700,CAPRI COLLEGE                           ,IA,52807-2622,Proprietary  ,1,4,5,29,26,55
00794100,COLLEGE OF HAIR DESIGN                  ,IA,50703-1834,Proprietary  ,3,16,19,31,85,116
00811600,DAYTON'S SCHOOL OF HAIR DESIGN          ,IA,52601-0000,Proprietary  ,1,3,4,9,36,45
00826000,IOWA SCHOOL OF BEAUTY INC               ,IA,50322-0000,Proprietary  ,5,15,20,76,125,201
00840300,INDIAN HILLS COMMUNITY COLLEGE          ,IA,52501-1398,Public       ,67,163,230,1656,1840,3496
00840301,INDIAN HILLS COMMUNITY COLLEGE          ,IA,52544-0000,Public       ,11,31,42,251,301,552
00842400,LA JAMES INTERNATIONAL COLLEGE          ,IA,50501-5577,Proprietary  ,0,9,9,61,66,127
00959300,LA'JAMES COLLEGE OF HAIRSTYLING         ,IA,52240-0000,Proprietary  ,11,7,18,84,43,127
01111300,MAHARISHI UNIV OF MANAGEMENT            ,IA,52557-0001,Private      ,4,10,14,132,153,285
01206400,HAMILTON TECHNICAL COLLEGE              ,IA,52807-2653,Proprietary  ,10,39,49,121,305,426
01230000,PALMER COLLEGE OF CHIROPRACTIC          ,IA,52803-5287,Private      ,4,21,25,105,2467,2572
01300600,LA' JAMES INTERNATIONAL COLLEGE-CF      ,IA,50613-5242,Proprietary  ,9,14,23,80,68,148
02090300,CAPRI COLLEGE                           ,IA,52404-0000,Proprietary  ,3,0,3,41,13,54
02132000,LA JAMES COLLEGE OF HAIRSTYLING         ,IA,50703-0000,Proprietary  ,0,0,0,0,1,1
02134500,LA JAMES INTERNATIONAL COLLEGE - DAV    ,IA,52806-3952,Proprietary  ,4,15,19,48,62,110
02160900,"SALON PROFESSIONAL ACADEMY, THE         ",IA,50010-0000,Proprietary  ,3,4,7,117,39,156
02262500,FAUST INSTITUTE OF COSMETOLOGY          ,IA,50588-0000,Proprietary  ,2,2,4,27,42,69
02274100,LA' JAMES INTERNATIONAL COLLEGE - DM    ,IA,50131-0000,Proprietary  ,26,27,53,143,158,301
02289000,AMERICAN HAIR ACADEMY                   ,IA,52627-4530,Proprietary  ,2,1,3,12,15,27
02306900,IOWA SCHOOL OF BEAUTY                   ,IA,52501-0000,Proprietary  ,1,9,10,31,54,85
02328900,EMMAUS BIBLE COLLEGE                    ,IA,52001-0000,Private      ,2,2,4,189,52,241
02330900,IOWA SCHOOL OF BEAUTY                   ,IA,50158-0000,Proprietary  ,0,6,6,15,30,45
02333200,DAYTON'S SCHOOL OF HAIR DESIGN          ,IA,52632-0000,Proprietary  ,0,2,2,4,10,14
02572500,DAVENPORT BARBER STYLING COLLEGE        ,IA,52807-0000,Proprietary  ,1,4,5,7,20,27
02609200,VATTEROTT COLLEGE                       ,IA,50321-4704,Proprietary  ,11,59,70,84,393,477
03069100,ALLEN COLLEGE                           ,IA,50703-1916,Private      ,5,4,9,294,236,530
03441300,IOWA SCHOOL OF BEAUTY                   ,IA,51106-5111,Proprietary  ,4,10,14,36,55,91
03607400,TOTAL LOOK SCHOOL OF COSMETOLOGY AND MAS,IA,52136-1053,Proprietary  ,0,0,0,4,11,15
00259600,ATLANTIC COMMUNITY COLLEGE              ,NJ,08330-2699,Public       ,87,178,265,2567,3285,5852
00259700,BLOOMFIELD COLLEGE                      ,NJ,07003-3425,Private      ,27,39,66,2273,1375,3648
00259800,CALDWELL COLLEGE                        ,NJ,07006-6195,Private      ,15,33,48,1266,714,1980
00259900,CENTENARY COLLEGE                       ,NJ,07840-2184,Private      ,20,87,107,1354,894,2248
00260000,COLLEGE OF SAINT ELIZABETH              ,NJ,07960-6989,Private      ,10,44,54,686,535,1221
00260100,CUMBERLAND COUNTY COLLEGE               ,NJ,08362-0517,Public       ,29,59,88,1399,1690,3089
00260300,DREW UNIVERSITY                         ,NJ,07940-4063,Private      ,34,16,50,2665,507,3172
00260700,FAIRLEIGH DICKINSON UNIV-TEANECK        ,NJ,07666-1996,Private      ,53,97,150,2564,1841,4405
00260701,FAIRLEIGH DICKINSON UNIV-FLORHAM        ,NJ,07940-0000,Private      ,13,19,32,2269,543,2812
00260702,FAIRLEIGH DICKINSON UNIV-ED WMS CLG     ,NJ,07601-0000,Private      ,5,4,9,98,77,175
00260703,FAIRLEIGH DICKINSON UNIVERSITY          ,NJ,07940-0000,Private      ,27,18,45,1379,529,1908
00260800,GEORGIAN COURT UNIVERSITY               ,NJ,08701-2697,Private      ,19,49,68,1231,1433,2664
00260900,ROWAN UNIVERSITY                        ,NJ,08028-1702,Public       ,102,85,187,10057,2975,13032
00261000,FELICIAN COLLEGE                        ,NJ,07644-2198,Private      ,20,53,73,1239,762,2001
00261300,NEW JERSEY CITY UNIVERSITY              ,NJ,07305-1597,Public       ,67,132,199,3976,4008,7984
00261500,MIDDLESEX COUNTY COLLEGE                ,NJ,08818-3050,Public       ,135,158,293,4250,3003,7253
00261600,MONMOUTH UNIVERSITY                     ,NJ,07764-1898,Private      ,81,40,121,6020,1955,7975
00261700,MONTCLAIR STATE UNIVERSITY              ,NJ,07043-9987,Public       ,243,154,397,11957,4774,16731
00261900,NEW BRUNSWICK THEOLOGICAL SEMINARY      ,NJ,08901-0000,Private      ,1,3,4,14,103,117
00262100,NEW JERSEY INST OF TECHNOLOGY           ,NJ,07102-1982,Public       ,65,72,137,3736,1810,5546
00262200,KEAN UNIVERSITY                         ,NJ,07083-7131,Public       ,144,221,365,8065,5204,13269
00262400,OCEAN COUNTY COLLEGE                    ,NJ,08754-2001,Public       ,94,137,231,3202,2043,5245
00262500,WILLIAM PATERSON UNIVERSITY             ,NJ,07470-2152,Public       ,118,89,207,7566,2940,10506
00262600,PRINCETON THEOLOGICAL SEMINARY          ,NJ,08542-0000,Private      ,0,6,6,2,534,536
00262700,PRINCETON UNIVERSITY                    ,NJ,08544-0001,Private      ,51,22,73,8804,1066,9870
00262800,RIDER UNIVERSITY                        ,NJ,08648-3099,Private      ,53,59,112,5173,1355,6528
00262900,"RUTGERS, THE STATE UNIVERSITY OF NJ     ",NJ,08901-1281,Public       ,453,363,816,33944,15919,49863
00263200,SETON HALL UNIVERSITY                   ,NJ,07079-2697,Private      ,71,94,165,6044,2706,8750
00263201,SETON HALL UNIVERSITY - SCHOOL OF LAW   ,NJ,07079-5210,Private      ,6,10,16,139,1750,1889
00263800,ST PETER'S COLLEGE                      ,NJ,07306-5997,Private      ,39,71,110,3054,960,4014
00263900,STEVENS INSTITUTE OF TECHNOLOGY         ,NJ,07030-5370,Private      ,25,23,48,2301,461,2762
00264200,COLLEGE OF NEW JERSEY (THE)             ,NJ,08628-0718,Public       ,91,56,147,7975,1009,8984
00264300,UNION COUNTY COLLEGE                    ,NJ,07016-1598,Public       ,142,259,401,3497,4785,8282
00473600,BERGEN COMMUNITY COLLEGE                ,NJ,07652-1595,Public       ,139,137,276,4682,3209,7891
00474000,MERCER COUNTY COMMUNITY COLLEGE         ,NJ,08690-0000,Public       ,72,166,238,2185,3240,5425
00539900,MONMOUTH COUNTY VOCATIONAL SCH DIST     ,NJ,07728-5033,Public       ,2,4,6,36,54,90
00545200,TETERBORO SCH OF AERONAUTICS            ,NJ,07608-1083,Proprietary  ,4,13,17,66,69,135
00546000,SOMERSET COUNTY TECHNICAL INSTITUTE     ,NJ,08807-0350,Public       ,0,6,6,32,92,124
00546100,SALEM COMMUNITY COLLEGE                 ,NJ,08069-2799,Public       ,12,40,52,382,587,969
00641000,C E GREGORY SCHOOL OF NURSING           ,NJ,08857-0000,Private      ,0,0,0,71,94,165
00641700,HOLY NAME HOSPITAL SCH OF NURSING       ,NJ,07666-4254,Private      ,2,2,4,74,122,196
00642000,MOUNTAINSIDE HOSP SCH NRSG              ,NJ,07042-4898,Proprietary  ,1,2,3,48,154,202
00642100,MUHLENBERG SNYDER SCHOOLS               ,NJ,07061-3399,Private      ,3,23,26,121,390,511
00642900,ST FRANCIS MEDICAL CTR SCH NURSING      ,NJ,08629-1986,Private      ,1,4,5,14,38,52
00642902,ST FRANCIS MED CTR RAD TECH             ,NJ,08629-0000,Private      ,0,1,1,4,11,15
00686500,CAMDEN COUNTY COLLEGE                   ,NJ,08012-3240,Public       ,125,298,423,4573,5541,10114
00690100,GLOUCESTER COUNTY COLLEGE               ,NJ,08080-4249,Public       ,54,108,162,2155,1779,3934
00710700,ESSEX COUNTY COLLEGE                    ,NJ,07102-1798,Public       ,164,320,484,3983,5718,9701
00750200,BERKELEY COLLEGE                        ,NJ,07424-3367,Proprietary  ,55,114,169,1325,1108,2433
00750201,BERKELEY COLLEGE                        ,NJ,07095-0000,Proprietary  ,21,30,51,513,376,889
00750202,BERKELEY COLLEGE - PARAMUS              ,NJ,07652-2931,Proprietary  ,11,18,29,455,290,745
00750600,LINCOLN TECHNICAL INSTITUTE             ,NJ,07083-5032,Proprietary  ,109,173,282,1122,1119,2241
00750601,LINCOLN TECHNICAL INSTITUTE             ,NJ,07430-0000,Proprietary  ,57,63,120,757,578,1335
00750700,GIBBS COLLEGE                           ,NJ,07039-1611,Proprietary  ,69,156,225,957,1364,2321
00750701,KATHARINE GIBBS - PISCATAWAY            ,NJ,08854-0000,Proprietary  ,39,53,92,443,585,1028
00759300,PARISIAN BEAUTY ACADEMY                 ,NJ,07601-5509,Proprietary  ,12,21,33,78,142,220
00772900,COUNTY COLLEGE OF MORRIS                ,NJ,07869-0000,Public       ,68,61,129,2284,1164,3448
00773000,BURLINGTON COUNTY COLLEGE               ,NJ,08068-1599,Public       ,45,145,190,2288,2329,4617
00773100,RARITAN VALLEY COMMUNITY COLLEGE        ,NJ,08876-1265,Public       ,66,90,156,1242,1071,2313
00794700,BETH MEDRASH GOVOHA OF AMERICA          ,NJ,08701-0000,Private      ,82,257,339,315,1484,1799
00840400,BROOKDALE COMMUNITY COLLEGE             ,NJ,07738-1597,Public       ,173,197,370,4074,3022,7096
00844101,ANTHEM INSTITUTE                        ,NJ,08002-0000,Proprietary  ,0,2,2,9,15,24
00849400,HO HO KUS SCHL OF TRADE & TECH SCIENCES ,NJ,07513-1402,Proprietary  ,16,46,62,40,125,165
00860900,RABBINICAL COLLEGE OF AMERICA           ,NJ,07960-3600,Private      ,18,1,19,76,6,82
00907800,CAPRI INSTITUTE OF HAIR DESIGN          ,NJ,07011-2111,Proprietary  ,8,13,21,59,86,145
00934400,RAMAPO COLLEGE OF NEW JERSEY            ,NJ,07430-1680,Public       ,62,30,92,4721,815,5536
00934500,RICHARD STOCKTON COLLEGE OF NJ          ,NJ,08240-0195,Public       ,86,62,148,5600,2180,7780
00999400,PASSAIC COUNTY COMMUNITY COLLEGE        ,NJ,07505-1179,Public       ,187,382,569,2433,3245,5678
01039400,UNIV OF MEDICINE & DENTISTRY OF NJ      ,NJ,07107-0000,Public       ,5,57,62,187,3946,4133
01062900,P B COSMETOLOGY EDUCATION CENTRE        ,NJ,08030-1750,Proprietary  ,16,14,30,105,95,200
01085100,ANTHEM INSTITUTE                        ,NJ,07054-3409,Proprietary  ,156,328,484,827,1481,2308
01085101,ANTHEM INSTITUTE                        ,NJ,07306-0000,Proprietary  ,1,0,1,32,52,84
01085102,ANTHEM INSTITUTE                        ,NJ,08902-0000,Proprietary  ,2,2,4,31,33,64
01090300,RIZZIERI INSTITUTE                      ,NJ,08043-4600,Proprietary  ,8,11,19,93,75,168
01152300,MORRIS COUNTY SCHOOL OF TECHNOLOGY      ,NJ,07834-0000,Public       ,1,3,4,25,32,57
01170800,NATURAL MOTION INST OF HAIR DESIGN      ,NJ,07306-5496,Proprietary  ,7,19,26,34,92,126
01198900,TALMUDICAL ACADEMY                      ,NJ,07710-0000,Private      ,0,0,0,40,1,41
01209000,REIGNBOW BEAUTY ACADEMY                 ,NJ,08861-4118,Proprietary  ,10,50,60,46,167,213
01234600,DOVER BUSINESS COLLEGE                  ,NJ,07011-2161,Proprietary  ,22,96,118,111,368,479
01234602,DOVER BUSINESS COLLEGE                  ,NJ,07801-4643,Proprietary  ,10,37,47,62,253,315
01246100,LINCOLN TECHNICAL INSTITUTE             ,NJ,08820-2896,Proprietary  ,39,85,124,275,422,697
01246102,LINCOLN TECHNICAL INSTITUTE             ,NJ,08054-0000,Proprietary  ,31,72,103,249,461,710
01246103,LINCOLN TECHNICAL INSTITUTE             ,NJ,07652-2106,Proprietary  ,51,78,129,303,553,856
01246200,HOHOKUS - HACKENSACK SCHOOL OF BUSINESS ,NJ,07601-7197,Proprietary  ,21,76,97,129,534,663
01295400,HUDSON COUNTY COMMUNITY COLLEGE         ,NJ,07306-4012,Public       ,211,281,492,3413,4293,7706
02053700,EASTWICK COLLEGE                        ,NJ,07446-0000,Proprietary  ,19,67,86,164,531,695
02061800,ROMAN ACADEMY OF BEAUTY CULTURE         ,NJ,07506-0000,Proprietary  ,6,6,12,38,47,85
02092300,HOHOKUS SCHOOL - RETS/NUTLEY            ,NJ,07110-0000,Proprietary  ,19,69,88,143,308,451
02103700,CAPRI INSTITUTE OF HAIR DESIGN          ,NJ,07652-0000,Proprietary  ,14,11,25,79,82,161
02104000,HARRIS SCHOOL OF BUSINESS               ,NJ,08002-2983,Proprietary  ,51,253,304,150,932,1082
02131100,DU CRET SCHOOL OF THE ARTS              ,NJ,07060-0000,Private      ,1,0,1,20,9,29
02131600,PENNCO TECH                             ,NJ,08012-0000,Proprietary  ,34,87,121,357,488,845
02132300,BERDAN INSTITUTE                        ,NJ,07512-0000,Proprietary  ,26,62,88,179,383,562
02146800,JOE KUBERT SCH OF CARTOON & GRAPHIC     ,NJ,07801-0000,Proprietary  ,2,0,2,63,51,114
02149800,EMPIRE BEAUTY SCHOOL                    ,NJ,08021-0000,Proprietary  ,8,50,58,111,272,383
02149801,EMPIRE BEAUTY SCHOOL - BORDENTOWN       ,NJ,08505-1513,Proprietary  ,0,0,0,5,7,12
02154000,DIVERS ACAD OF EASTERN SEABOARD         ,NJ,08081-1139,Proprietary  ,7,23,30,70,129,199
02183600,CAPRI INSTITUTE OF HAIR DESIGN          ,NJ,07033-0000,Proprietary  ,6,15,21,59,83,142
02186700,HARRISON CAREER INSTITUTE               ,NJ,08075-0000,Proprietary  ,1,0,1,10,37,47
02186703,HARRISON CAREER INSTITUTE               ,NJ,08096-0000,Proprietary  ,2,6,8,20,105,125
02186707,HARRISON CAREER INSTITUTE               ,NJ,07079-0000,Proprietary  ,0,0,0,3,7,10
02186708,HARRISON CAREER INSTITUTE               ,NJ,07376-0000,Proprietary  ,0,2,2,28,84,112
02186709,HARRISON CAREER INSTITUTE               ,NJ,07011-0000,Proprietary  ,0,0,0,1,0,1
02192200,THOMAS EDISON STATE COLLEGE             ,NJ,08608-0000,Public       ,18,296,314,187,3122,3309
02219600,OMEGA INSTITUTE                         ,NJ,08109-0000,Proprietary  ,5,33,38,77,174,251
02223700,NEW HORIZON INST OF COSMETOLOGY         ,NJ,07093-0000,Proprietary  ,2,8,10,15,97,112
02223900,DRAKE COLLEGE OF BUSINESS               ,NJ,07201-0000,Proprietary  ,25,235,260,154,1123,1277
02232500,UNION COUNTY VOCATIONAL TECH INST       ,NJ,07076-0000,Public       ,8,14,22,54,70,124
02234600,SHORE BEAUTY SCHOOL                     ,NJ,08232-0000,Proprietary  ,4,8,12,25,39,64
02246000,ROSS UNIVERSITY - MEDICAL SCHOOL        ,NJ,08837-0000,Proprietary  ,3,154,157,15,3562,3577
02248600,COOPER HEALTH SYS-CTR ALLIED HEALTH     ,NJ,08103-0000,Private      ,1,3,4,30,60,90
02252700,CONCORDE SCHOOL OF HAIR DESIGN          ,NJ,07712-0000,Proprietary  ,20,52,72,98,249,347
02261800,EUROPEAN ACADEMY OF COSMETOLOGY         ,NJ,07083-0000,Proprietary  ,9,34,43,48,126,174
02265500,CAPRI INSTITUTE OF HAIR DESIGN          ,NJ,08724-0000,Proprietary  ,10,16,26,85,114,199
02277900,ROSS UNIV - SCH OF VETERINARY MED       ,NJ,08837-0000,Proprietary  ,3,38,41,5,883,888
02291000,LINCOLN TECHNICAL INSTITUTE             ,NJ,07080-2424,Proprietary  ,5,12,17,115,67,182
02301900,ALLIED MEDICAL AND TECHNICAL INSTITUTE  ,NJ,07470-3017,Proprietary  ,0,0,0,0,1,1
02312000,BERGEN COUNTY TECHNICAL SCHOOLS         ,NJ,07601-6110,Public       ,1,10,11,34,53,87
02344200,EMPIRE BEAUTY SCHOOL                    ,NJ,08002-0000,Proprietary  ,28,36,64,89,155,244
02503900,WARREN COUNTY COMMUNITY COLLEGE         ,NJ,07882-0000,Public       ,17,37,54,402,384,786
02523700,OCEAN COUNTY VOCATIONAL-TECH SCHOOL     ,NJ,08753-0000,Public       ,2,5,7,77,157,234
02525900,ARTISTIC ACADEMY OF HAIR DESIGN         ,NJ,07950-1409,Proprietary  ,10,12,22,83,67,150
02528200,REIGNBOW BEAUTY ACADEMY                 ,NJ,07060-0000,Proprietary  ,1,15,16,26,85,111
02539903,STAR TECHNICAL INSTITUTE-EGG HARBOR     ,NJ,08234-0000,Proprietary  ,9,59,68,59,299,358
02558700,PRISM CAREER INSTITUTE                  ,NJ,08037-0000,Proprietary  ,25,104,129,110,474,584
02558702,ACADEMY OF COMPUTER CAREERS             ,NJ,08080-0000,Proprietary  ,0,0,0,3,7,10
02568800,SUSSEX COUNTY COMMUNITY COLLEGE         ,NJ,07860-1149,Public       ,57,63,120,977,639,1616
02586800,HARRISON CAREER INSTITUTE               ,NJ,08360-6210,Proprietary  ,0,4,4,23,115,138
02586801,HARRISON CAREER INSTITUTE               ,NJ,07755-0000,Proprietary  ,0,0,0,16,45,61
02586900,HARRIS SCHOOL OF BUSINESS               ,NJ,08084-1520,Proprietary  ,5,39,44,38,230,268
02586901,STAR TECHNICAL INSTITUTE - LAKEWOOD     ,NJ,08701-0000,Proprietary  ,9,51,60,61,336,397
02615401,STAR TECHNICAL INSTITUTE -              ,NJ,07102-4599,Proprietary  ,9,87,96,49,400,449
02616402,SANFORD-BROWN INSTITUTE - ISELIN        ,NJ,08830-0000,Proprietary  ,43,134,177,317,1066,1383
03077500,RABBI JACOB JOSEPH SCHOOL               ,NJ,08817-4494,Private      ,0,0,0,7,0,7
03085201,HARRISON CAREER INSTITUTE               ,NJ,08648-0000,Proprietary  ,0,1,1,20,105,125
03122600,EASTERN INTERNATIONAL COLLEGE           ,NJ,07306-3906,Proprietary  ,30,85,115,145,363,508
03187300,STENOTECH CAREER INSTITUTE              ,NJ,07004-3490,Proprietary  ,3,9,12,33,78,111
03197300,INSTITUTE FOR HEALTH EDUCATION(THE)     ,NJ,07306-2929,Proprietary  ,2,5,7,4,16,20
03324300,CENTRAL CAREER SCHOOL                   ,NJ,07080-2408,Proprietary  ,0,13,13,4,56,60
03389300,ACADEMY OF MASSAGE THERAPY              ,NJ,07631-0000,Proprietary  ,3,11,14,19,93,112
03424500,NEW COMMUNITY WORKFORCE DEVELOPMENT     ,NJ,07103-2402,Private      ,7,99,106,41,382,423
03530300,"KEY SKILLS LEARNING, INC.               ",NJ,07013-1900,Proprietary  ,0,2,2,1,31,32
03536300,INSTITUTE FOR THERAPEUTIC MASSAGE       ,NJ,07420-1452,Proprietary  ,4,33,37,35,162,197
03574400,CORTIVA INSTITUTE - SOMERSET SCHOOL OF M,NJ,08854-3908,Proprietary  ,8,26,34,34,95,129
03625300,PERFORMANCE TRAINING INSTITUTE          ,NJ,08753-0000,Proprietary  ,1,3,4,2,7,9
03629300,HELMA INSTITUTE OF MASSAGE THERAPY      ,NJ,07663-6200,Proprietary  ,9,35,44,35,148,183
03650600,PC AGE                                  ,NJ,07306-3936,Proprietary  ,2,16,18,22,76,98
03650603,PC AGE                                  ,NJ,08817-2842,Proprietary  ,3,15,18,18,71,89
03666300,SOMERSET CHRISTIAN COLLEGE              ,NJ,08890-9035,Private      ,0,4,4,19,85,104
03769300,PC TECH LEARNING CENTER                 ,NJ,07306-9900,Proprietary  ,3,46,49,18,212,230
03803300,HEALTHCARE TRAINING INSTITUTE           ,NJ,07083-3504,Proprietary  ,1,18,19,41,158,199
03811300,EASTERN SCHOOL OF ACUPUNCTURE AND TRADIT,NJ,07042-3562,Proprietary  ,0,13,13,4,44,48
04081300,BAIS MEDRASH TORAS CHESED               ,NJ,08701-0000,Private      ,19,0,19,19,0,19
        ,BROOKLYN LAW SCHOOL                     ,NY,11201-0000,Private      ,1,16,17,37,3184,3221
00266500,VAUGHN COLLEGE OF AERONAUTICS AND TECHNO,NY,11369-9997,Private      ,31,40,71,712,480,1192
00266600,ADELPHI UNIVERSITY                      ,NY,11530-4299,Private      ,93,193,286,5511,4223,9734
00266700,DOWLING COLLEGE                         ,NY,11769-1999,Private      ,40,100,140,2244,2348,4592
00266800,ALFRED UNIVERSITY                       ,NY,14802-1205,Private      ,26,12,38,2704,512,3216
00266900,BANK STREET COLLEGE OF EDUCATION        ,NY,10025-0000,Private      ,0,20,20,5,801,806
00267100,BARD COLLEGE                            ,NY,12504-5000,Private      ,12,7,19,2413,478,2891
00267800,BRYANT & STRATTON COLLEGE               ,NY,14203-1713,Proprietary  ,134,510,644,1292,4801,6093
00267803,BRYANT & STRATTON COLLEGE - GREECE      ,NY,14606-4227,Proprietary  ,26,100,126,243,893,1136
00267805,BRYANT & STRATTON COLLEGE - SYRACUSE    ,NY,13203-2502,Proprietary  ,64,145,209,667,1518,2185
00267807,BRYANT & STRATTON COLLEGE - ALBANY      ,NY,12205-5230,Proprietary  ,24,58,82,244,594,838
00268100,CANISIUS COLLEGE                        ,NY,14208-1098,Private      ,43,74,117,4370,1340,5710
00268300,SEMINARY OF THE IMMACULATE CONCEPT      ,NY,11743-0000,Private      ,0,1,1,0,1,1
00268500,CAZENOVIA COLLEGE                       ,NY,13035-1085,Private      ,22,4,26,1431,125,1556
00268700,CUNY-BROOKLYN COLLEGE                   ,NY,11210-2814,Public       ,271,322,593,10762,7339,18101
00268800,CITY COLLEGE-CUNY                       ,NY,10031-9198,Public       ,272,231,503,9994,5799,15793
00268900,CUNY-HUNTER COLLEGE                     ,NY,10021-0000,Public       ,378,383,761,16267,9731,25998
00269000,QUEENS COLLEGE-CUNY                     ,NY,11367-1597,Public       ,290,362,652,9858,5850,15708
00269100,CUNY- BOROUGH OF MANHATTAN CMTY CLG     ,NY,10007-1047,Public       ,889,743,1632,11420,9990,21410
00269200,CUNY BRONX COMMUNITY COLLEGE            ,NY,10453-3102,Public       ,472,457,929,5937,6380,12317
00269300,CUNY-JOHN JAY CLG CRIMINAL JUSTICE      ,NY,10019-1093,Public       ,331,222,553,10626,5501,16127
00269400,KINGSBOROUGH COMMUNITY COLLEGE          ,NY,11235-2398,Public       ,601,446,1047,7202,4718,11920
00269600,NY CITY COLLEGE OF TECHNOLOGY-CUNY      ,NY,11201-2983,Public       ,397,338,735,9422,6110,15532
00269700,QUEENSBOROUGH COMMUNITY COLLEGE         ,NY,11364-1497,Public       ,462,335,797,6455,3669,10124
00269800,CUNY THE COLLEGE OF STATEN ISLAND       ,NY,10314-6600,Public       ,258,196,454,7704,3664,11368
00269900,CLARKSON UNIVERSITY                     ,NY,13699-5615,Private      ,29,5,34,3524,269,3793
00270000,COLGATE ROCHESTER CROZER DIVINITY S     ,NY,14620-0000,Private      ,0,9,9,4,85,89
00270100,COLGATE UNIVERSITY                      ,NY,13346-1386,Private      ,28,0,28,3624,46,3670
00270300,COLLEGE OF MOUNT SAINT VINCENT          ,NY,10471-1093,Private      ,28,21,49,2000,300,2300
00270400,COLLEGE OF NEW ROCHELLE                 ,NY,10805-2339,Private      ,63,609,672,1197,6402,7599
00270500,COLLEGE OF SAINT ROSE                   ,NY,12203-1490,Private      ,48,63,111,3957,2088,6045
00270700,COLUMBIA UNIVERSITY                     ,NY,10027-0000,Private      ,34,68,102,2909,2792,5701
00270701,COLUMBIA UNIV ARCHITECTURE              ,NY,10027-0000,Private      ,1,7,8,42,708,750
00270702,COLUMBIA UNIV SCHOOL OF THE ARTS        ,NY,10027-0000,Private      ,4,2,6,60,1019,1079
00270703,COLUMBIA UNIV BUSINESS GRAD             ,NY,10027-0000,Private      ,2,16,18,20,1534,1554
00270704,COLUMBIA UNIV SCHOOL ENGIN-UNDERGRA     ,NY,10027-0000,Private      ,10,1,11,1510,37,1547
00270705,COLUMBIA UNIV SCHOOL GENERAL STUDIE     ,NY,10027-0000,Private      ,11,27,38,293,989,1282
00270706,COLUMBIA UNIV GRAD SCHL ARTS & SCI      ,NY,10027-0000,Private      ,1,33,34,32,1713,1745
00270707,COLUMBIA UNIV SCH INTL PUB AFFAIRS      ,NY,10027-0000,Private      ,1,26,27,7,1206,1213
00270708,COLUMBIA UNIV JOURNALISM GRAD           ,NY,10027-0000,Private      ,1,10,11,15,533,548
00270710,COLUMBIA UNIV COLUMBIA COLLEGE          ,NY,10027-0000,Private      ,54,7,61,6771,212,6983
00270711,COLUMBIA UNIV SCHOOL OF LAW             ,NY,10027-0000,Private      ,1,10,11,34,3315,3349
00270712,COLUMBIA UNIV SOCIAL WORK               ,NY,10025-0000,Private      ,0,12,12,18,896,914
00270713,COLUMBIA UNIV SCHL DENT & ORAL SURG     ,NY,10032-0000,Private      ,1,1,2,10,335,345
00270714,COLUMBIA UNIV INST HUMAN NUTRITION      ,NY,10032-0000,Private      ,0,1,1,2,52,54
00270715,COLUMBIA UNIV NURSING                   ,NY,10032-0000,Private      ,1,13,14,60,636,696
00270716,COLUMBIA UNIV COLL PHYS & SURGEONS      ,NY,10032-0000,Private      ,0,3,3,12,1006,1018
00270717,COLUMBIA UNIV PHYSICAL THERAPY          ,NY,10032-0000,Private      ,0,0,0,9,106,115
00270718,COLUMBIA UNIV OCCUPATIONAL THERAPY      ,NY,10032-0000,Private      ,0,0,0,3,78,81
00270719,COLUMBIA UNIV PUBLIC HEALTH             ,NY,10032-0000,Private      ,0,5,5,4,934,938
00270720,COLUMBIA UNIV - ENGINEERING (GRAD)      ,NY,10027-0000,Private      ,5,10,15,56,316,372
00270721,COLUMBIA UNIV-CONT ED & SP PROGMS       ,NY,10027-0000,Private      ,1,12,13,10,160,170
00270800,BARNARD COLLEGE-COLUMBIA UNIV           ,NY,10027-6598,Private      ,30,1,31,3359,88,3447
00270900,CONCORDIA COLLEGE                       ,NY,10708-1998,Private      ,2,9,11,717,164,881
00271000,COOPER UNION                            ,NY,10003-7120,Private      ,13,6,19,1261,119,1380
00271100,CORNELL UNIVERSITY                      ,NY,14853-2801,Private      ,159,77,236,19106,4616,23722
00271101,WEILL CORNELL MEDICAL COLLEGE AND GRADUA,NY,10021-0000,Private      ,0,11,11,38,719,757
00271200,D'YOUVILLE COLLEGE                      ,NY,14201-1084,Private      ,17,35,52,1402,1320,2722
00271300,DOMINICAN COLLEGE                       ,NY,10962-1299,Private      ,20,30,50,1348,628,1976
00271800,ELMIRA COLLEGE                          ,NY,14901-2099,Private      ,9,25,34,1829,630,2459
00272200,FORDHAM UNIVERSITY                      ,NY,10458-5157,Private      ,165,158,323,14457,7704,22161
00272206,MARYMOUNT COLLEGE                       ,NY,10591-3796,Private      ,5,14,19,338,149,487
00272600,GENERAL THEOLOGICAL SEMINARY            ,NY,10011-0000,Private      ,0,2,2,0,111,111
00272800,HAMILTON COLLEGE                        ,NY,13323-1218,Private      ,17,1,18,2197,32,2229
00272900,HARTWICK COLLEGE                        ,NY,13820-4020,Private      ,20,3,23,2410,74,2484
00273100,HOBART & WILLIAM SMITH COLLEGES         ,NY,14456-3397,Private      ,19,1,20,2513,53,2566
00273200,HOFSTRA UNIVERSITY                      ,NY,11549-1010,Private      ,205,161,366,11617,5496,17113
00273400,HOUGHTON COLLEGE                        ,NY,14744-0128,Private      ,6,33,39,1524,287,1811
00273500,HILBERT COLLEGE                         ,NY,14075-1597,Private      ,10,6,16,846,363,1209
00273700,IONA COLLEGE                            ,NY,10801-1890,Private      ,63,48,111,5402,1010,6412
00273900,ITHACA COLLEGE                          ,NY,14850-7130,Private      ,58,8,66,10468,638,11106
00274000,JEWISH THEOLOGICAL SEMINARY OF AMER     ,NY,10027-4649,Private      ,1,1,2,119,205,324
00274200,THE JUILLIARD SCHOOL                    ,NY,10023-6588,Private      ,7,10,17,1010,581,1591
00274400,KEUKA COLLEGE                           ,NY,14478-0000,Private      ,11,91,102,1206,796,2002
00274800,LEMOYNE COLLEGE                         ,NY,13214-1399,Private      ,35,36,71,3509,1047,4556
00274900,NEW YORK COLLEGE OF PODIATRIC MED       ,NY,10035-0000,Private      ,1,4,5,28,374,402
00275100,LONG ISLAND UNIVERSITY                  ,NY,11548-1326,Private      ,118,250,368,6736,4443,11179
00275102,LONG ISLAND UNIVERSITY - ROCKLAND CAMPUS,NY,10962-0000,Private      ,0,1,1,0,1,1
00275115,LONG ISLAND UNIVERSITY - SOUTHAMPTON COL,NY,11968-4198,Private      ,17,18,35,121,135,256
00275116,LONG ISLAND UNIVERSITY - BROOKLYN       ,NY,11201-8423,Private      ,90,279,369,5090,5271,10361
00275800,MANHATTAN COLLEGE                       ,NY,10471-4098,Private      ,70,30,100,4662,371,5033
00275900,MANHATTAN SCHOOL OF MUSIC               ,NY,10027-4698,Private      ,4,1,5,619,673,1292
00276000,MANHATTANVILLE COLLEGE                  ,NY,10577-2132,Private      ,25,83,108,2391,880,3271
00276300,MARIA COLLEGE                           ,NY,12208-1798,Private      ,7,16,23,155,685,840
00276500,MARIST COLLEGE                          ,NY,12601-1387,Private      ,70,47,117,6596,1020,7616
00276900,MARYMOUNT MANHATTAN COLLEGE             ,NY,10021-4597,Private      ,22,13,35,2352,268,2620
00277200,MERCY COLLEGE                           ,NY,10522-1189,Private      ,136,452,588,2534,6732,9266
00277500,MOLLOY COLLEGE                          ,NY,11570-1100,Private      ,54,63,117,2006,1642,3648
00277700,MEDAILLE COLLEGE                        ,NY,14214-2695,Private      ,15,103,118,1166,1544,2710
00277800,MOUNT SAINT MARY COLLEGE                ,NY,12550-3494,Private      ,30,57,87,2064,1133,3197
00277900,NAZARETH COLLEGE OF ROCHESTER           ,NY,14618-3790,Private      ,24,36,60,2742,1463,4205
00278200,NEW YORK INSTITUTE OF TECHNOLOGY        ,NY,11568-8000,Private      ,79,452,531,4465,5008,9473
00278202,NY INSTITUTE OF TECHNOLOGY-OSTEOPATHIC M,NY,11568-0000,Private      ,0,4,4,6,1140,1146
00278300,NEW YORK LAW SCHOOL                     ,NY,10013-0000,Private      ,1,12,13,21,2822,2843
00278400,NEW YORK MEDICAL COLLEGE                ,NY,10595-0000,Private      ,1,12,13,11,1650,1661
00278500,NEW YORK UNIVERSITY                     ,NY,10012-1091,Private      ,267,374,641,29391,23312,52703
00278800,NIAGARA UNIVERSITY                      ,NY,14109-2010,Private      ,41,29,70,3819,756,4575
00279000,NYACK COLLEGE                           ,NY,10960-3698,Private      ,16,241,257,1227,2176,3403
00279100,PACE UNIVERSITY - NEW YORK              ,NY,10038-1598,Private      ,95,136,231,6070,2749,8819
00279101,PACE UNIVERSITY-PLEASANTVILLE           ,NY,10570-0000,Private      ,52,44,96,2981,842,3823
00279102,PACE UNIVERSITY - WHITE PLAINS          ,NY,10603-0000,Private      ,5,29,34,162,1864,2026
00279500,PAUL SMITHS CLG OF ARTS & SCIENCES      ,NY,12970-0000,Private      ,12,4,16,1037,155,1192
00279600,POLYTECHNIC INTSTITUTE OF NEW YORK UNIV ,NY,11201-3840,Private      ,37,33,70,1700,554,2254
00279800,PRATT INSTITUTE                         ,NY,11205-3899,Private      ,54,45,99,3965,2165,6130
00280300,RENSSELAER POLYTECHNIC INSTITUTE        ,NY,12180-3590,Private      ,58,20,78,6856,649,7505
00280500,ROBERTS WESLEYAN COLLEGE                ,NY,14624-1997,Private      ,14,64,78,1281,1143,2424
00280600,ROCHESTER INSTITUTE OF TECHNOLOGY       ,NY,14623-5608,Private      ,100,93,193,11851,2860,14711
00280700,ROCKEFELLER UNIVERSITY                  ,NY,10021-0000,Private      ,0,0,0,8,13,21
00280800,DAEMEN COLLEGE                          ,NY,14226-3592,Private      ,14,30,44,1782,738,2520
00281000,THE SAGE COLLEGES                       ,NY,12180-4199,Private      ,12,32,44,1405,1550,2955
00281200,TROCAIRE COLLEGE                        ,NY,14220-2094,Private      ,15,35,50,460,1125,1585
00281300,SARAH LAWRENCE COLLEGE                  ,NY,10708-5999,Private      ,15,2,17,1989,580,2569
00281400,SKIDMORE COLLEGE                        ,NY,12866-1632,Private      ,27,3,30,3381,118,3499
00281401,SKIDMORE COLL-UNIV WITHOUT WALLS        ,NY,12866-0000,Private      ,0,3,3,31,66,97
00281500,ST BERNARDS SCH THEOLOGY & MINISTRY     ,NY,14618-3822,Private      ,0,3,3,4,45,49
00281600,SIENA COLLEGE                           ,NY,12211-1462,Private      ,31,3,34,4370,231,4601
00281700,ST BONAVENTURE UNIVERSITY               ,NY,14778-2284,Private      ,16,15,31,2213,531,2744
00282000,ST FRANCIS COLLEGE                      ,NY,11201-4398,Private      ,44,26,70,1896,456,2352
00282100,ST JOHN FISHER COLLEGE                  ,NY,14618-3597,Private      ,25,35,60,4005,1435,5440
00282200,CHRIST THE KING SEMINARY                ,NY,14052-0607,Private      ,0,2,2,0,10,10
00282300,ST JOHN'S UNIVERSITY                    ,NY,11439-1343,Private      ,203,114,317,17806,5317,23123
00282500,ST JOSEPH'S COLLEGE                     ,NY,11205-3688,Private      ,21,40,61,884,588,1472
00282501,ST JOSEPH'S COLLEGE-SUFFOLK CAMPUS      ,NY,11772-0000,Private      ,57,53,110,2638,1153,3791
00282600,ST JOSEPH'S SEMINARY                    ,NY,10704-0000,Private      ,0,0,0,0,1,1
00282900,ST LAWRENCE UNIVERSITY                  ,NY,13617-1455,Private      ,16,1,17,2481,120,2601
00283200,ST THOMAS AQUINAS COLLEGE               ,NY,10976-1050,Private      ,22,9,31,1561,259,1820
00283300,ST VLADIMIR ORTHODOX THEOL SEM          ,NY,10707-0000,Private      ,0,2,2,1,40,41
00283500,SUNY AT ALBANY                          ,NY,12222-0001,Public       ,248,147,395,15913,4938,20851
00283600,BINGHAMTON UNIVERSITY (SUNY)            ,NY,13902-6000,Public       ,226,63,289,16635,2545,19180
00283700,SUNY AT BUFFALO                         ,NY,14260-0001,Public       ,253,161,414,19188,9554,28742
00283800,SUNY AT STONY BROOK                     ,NY,11794-0001,Public       ,337,186,523,17537,6360,23897
00283900,SUNY-DOWNSTATE MEDICAL CENTER           ,NY,11203-2098,Public       ,6,16,22,144,1740,1884
00284000,SUNY UPSTATE MEDICAL UNIVERSITY         ,NY,13210-2375,Public       ,5,4,9,176,1066,1242
00284100,SUNY BROCKPORT - FIN AID OFF            ,NY,14420-2914,Public       ,86,91,177,7934,2674,10608
00284200,BUFFALO STATE COLLEGE - SUNY            ,NY,14222-1095,Public       ,177,184,361,10001,4750,14751
00284300,SUNY COLLEGE-CORTLAND                   ,NY,13045-0900,Public       ,86,36,122,9021,1574,10595
00284400,SUNY AT FREDONIA                        ,NY,14063-1145,Public       ,60,26,86,6506,923,7429
00284500,SUNY GENESEO                            ,NY,14454-1401,Public       ,67,8,75,7644,603,8247
00284600,SUNY COLLEGE-NEW PALTZ                  ,NY,12561-2499,Public       ,94,42,136,8379,1977,10356
00284700,SUNY COLLEGE-ONEONTA                    ,NY,13820-4015,Public       ,100,15,115,8809,739,9548
00284800,SUNY OSWEGO                             ,NY,13126-3599,Public       ,89,59,148,8344,2217,10561
00284900,SUNY COLLEGE AT PLATTSBURGH             ,NY,12901-2681,Public       ,76,59,135,5954,1490,7444
00285000,SUNY COLLEGE-POTSDAM                    ,NY,13676-2294,Public       ,41,33,74,4047,1023,5070
00285100,SUNY COLLEGE OF ENVIRONMENT SCIENCE AND ,NY,13210-2778,Public       ,18,6,24,1455,455,1910
00285300,SUNY MARITIME COLLEGE                   ,NY,10465-4198,Public       ,12,10,22,1010,210,1220
00285400,SUNY COLLEGE OF TECHNOLOGY-ALFRED       ,NY,14802-9951,Public       ,36,21,57,3379,679,4058
00285500,SUNY CANTON COLG OF TECHNOLOGY          ,NY,13617-1098,Public       ,49,51,100,2423,949,3372
00285600,SUNY AG & TECH COLLEGE-COBLESKILL       ,NY,12043-9986,Public       ,39,15,54,2839,409,3248
00285700,SUNY DELHI                              ,NY,13753-1190,Public       ,55,18,73,2690,459,3149
00285800,SUNY FARMINGDALE                        ,NY,11735-1021,Public       ,105,86,191,4070,1590,5660
00285900,SUNY COLLEGE OF AG & TECH AT MORRISVILLE,NY,13408-0901,Public       ,57,56,113,3269,842,4111
00285901,SUNY COLLEGE OF AG & TECH AT MORRISVILLE,NY,13815-1620,Public       ,0,0,0,25,36,61
00286000,ADIRONDACK COMMUNITY COLLEGE            ,NY,12804-2004,Public       ,77,62,139,1694,1223,2917
00286100,CAYUGA COMMUNITY COLLEGE                ,NY,13021-3099,Public       ,56,64,120,1690,1455,3145
00286200,BROOME COMMUNITY COLLEGE                ,NY,13902-0000,Public       ,91,109,200,3054,2214,5268
00286300,CORNING COMMUNITY COLLEGE               ,NY,14830-3297,Public       ,95,128,223,1756,1843,3599
00286400,DUTCHESS COMMUNITY COLLEGE              ,NY,12601-1595,Public       ,138,101,239,2238,1465,3703
00286600,FASHION INSTITUTE OF TECHNOLOGY         ,NY,10001-5992,Public       ,140,65,205,6168,2445,8613
00286700,SUNY FULTON MONTGOMERY COMM CLG         ,NY,12095-3790,Public       ,46,44,90,960,785,1745
00286800,HUDSON VALLEY COMMUNITY COLLEGE         ,NY,12180-6096,Public       ,198,150,348,5502,3315,8817
00286900,JAMESTOWN COMMUNITY COLLEGE             ,NY,14702-0020,Public       ,80,96,176,2193,1664,3857
00287000,JEFFERSON COMMUNITY COLLEGE             ,NY,13601-1897,Public       ,40,110,150,1314,1675,2989
00287100,"SUNY, MOHAWK VALLEY COMMUNITY CLG       ",NY,13501-5394,Public       ,96,101,197,3435,2049,5484
00287200,MONROE COMMUNITY COLLEGE                ,NY,14623-5780,Public       ,380,501,881,7980,6794,14774
00287300,NASSAU COMMUNITY COLLEGE                ,NY,11530-6793,Public       ,515,378,893,8366,4570,12936
00287400,NIAGARA COUNTY COMMUNITY COLLEGE        ,NY,14132-9460,Public       ,79,97,176,3021,2592,5613
00287500,ONONDAGA COMMUNITY COLLEGE              ,NY,13215-4585,Public       ,208,203,411,4117,3190,7307
00287600,ORANGE COUNTY COMMUNITY COLLEGE         ,NY,10940-6441,Public       ,107,82,189,2170,1696,3866
00287700,ROCKLAND COMMUNITY COLLEGE              ,NY,10901-3611,Public       ,114,110,224,1619,1207,2826
00287800,SUFFOLK COMMUNITY COLLEGE               ,NY,11784-2899,Public       ,228,148,376,4757,2451,7208
00287801,SUFFOLK COMMUNITY CLG-W. CAMPUS         ,NY,11717-0000,Public       ,146,115,261,2373,1845,4218
00287803,SUFFOLK COMMUNITY CLG-EASTRN CAMPUS     ,NY,11901-0000,Public       ,54,52,106,812,668,1480
00287900,SULLIVAN COUNTY COMMUNITY COLLEGE       ,NY,12759-5151,Public       ,52,38,90,1174,562,1736
00288000,ULSTER COUNTY COMMUNITY COLLEGE         ,NY,12484-0557,Public       ,50,60,110,1068,726,1794
00288100,SUNY WESTCHESTER COMMUNITY COLLEGE      ,NY,10595-1698,Public       ,153,172,325,3190,2813,6003
00288200,SYRACUSE UNIVERSITY                     ,NY,13244-2130,Private      ,122,147,269,15652,5516,21168
00288300,UTICA COLLEGE OF SYRACUSE UNIV          ,NY,13502-4892,Private      ,30,46,76,2797,1147,3944
00288500,ALBANY COLLEGE OF PHARMACY AND HEALTH SC,NY,12208-3492,Private      ,8,1,9,1296,569,1865
00288600,ALBANY LAW SCHOOL                       ,NY,12208-0000,Private      ,0,3,3,30,1304,1334
00288700,ALBANY MEDICAL COLLEGE                  ,NY,12208-0000,Private      ,1,5,6,23,898,921
00288900,UNION COLLEGE                           ,NY,12308-2311,Private      ,31,2,33,2608,96,2704
00289000,UNION THEOLOGICAL SEMINARY              ,NY,10027-0000,Private      ,0,3,3,0,307,307
00289200,UNITED STATES MERCHANT MARINE ACADEMY   ,NY,11024-1699,Public       ,7,1,8,340,15,355
00289400,UNIVERSITY OF ROCHESTER                 ,NY,14627-9000,Private      ,48,41,89,6288,1410,7698
00289401,EASTMAN SCH OF MUSIC/UNIV ROCHESTER     ,NY,14604-0000,Private      ,0,0,0,752,388,1140
00289402,UNIV OF ROCHESTER SCHL OF MEDICINE      ,NY,14642-0000,Private      ,2,8,10,40,703,743
00289500,VASSAR COLLEGE                          ,NY,12604-0008,Private      ,21,0,21,3438,55,3493
00289600,VILLA MARIA COLLEGE-BUFFALO             ,NY,14225-3999,Private      ,12,18,30,393,293,686
00289900,WAGNER COLLEGE                          ,NY,10301-4495,Private      ,34,12,46,2604,281,2885
00290000,WEBB INSTITUTE                          ,NY,11542-1398,Private      ,1,0,1,55,1,56
00290100,WELLS COLLEGE                           ,NY,13026-0500,Private      ,11,4,15,772,70,842
00290300,YESHIVA UNIVERSITY                      ,NY,10033-3201,Private      ,36,35,71,1778,2698,4476
00290302,YESHIVA UNIVERSITY - BRONX CAMPUS       ,NY,10461-1975,Private      ,1,18,19,15,1160,1175
00397400,MESIVTHA TIFERETH JERUSALEM OF AMER     ,NY,10002-6382,Private      ,2,0,2,28,1,29
00397600,RABBINICAL ACAD MESIVTA RABBI CHAIM     ,NY,11230-4715,Private      ,10,0,10,15,0,15
00397700,RABBINICAL COLLEGE CH'SAN SOFER         ,NY,11204-1252,Private      ,8,12,20,11,22,33
00397800,RABBINICAL SEMINARY OF AMERICA          ,NY,11375-0000,Private      ,5,1,6,21,45,66
00397900,COLUMBIA UNIV TEACHERS COLLEGE          ,NY,10027-0000,Private      ,1,143,144,26,3747,3773
00405400,HEBREW UNION COL-JEWISH INST OF REL     ,NY,10012-0000,Private      ,0,1,1,1,97,98
00455301,ITT TECHNICAL INSTITUTE                 ,NY,12205-0000,Proprietary  ,19,36,55,269,492,761
00475900,"CUNY, YORK COLLEGE                      ",NY,11451-0001,Public       ,168,160,328,4649,3291,7940
00476500,CUNY GRADUATE SCH & UNIV CTR            ,NY,10016-0000,Public       ,0,0,0,40,1796,1836
00476500,CUNY GRADUATE SCH & UNIV CTR            ,NY,10016-4309,Public       ,0,83,83,2,205,207
00477600,CENTRAL YESHIVA TOMCHEI TMIMIM LUBA     ,NY,11230-2798,Private      ,139,10,149,328,54,382
00478800,HERKIMER COUNTY COMMUNITY COLLEGE       ,NY,13350-1598,Public       ,59,53,112,2142,995,3137
00479800,MIRRER YESHIVA CENTRAL INST             ,NY,11223-2010,Private      ,13,1,14,78,63,141
00479900,MONROE COLLEGE                          ,NY,10468-4305,Proprietary  ,168,478,646,3025,5808,8833
00481100,EVEREST INSTITUTE                       ,NY,14621-3007,Proprietary  ,101,404,505,598,2973,3571
00482500,TAYLOR BUSINESS INSTITUTE               ,NY,10011-5501,Proprietary  ,0,0,0,610,543,1153
00506401,ST JAMES MERCY HOSP SCH OF RAD          ,NY,14843-2197,Private      ,0,0,0,19,18,37
00506600,FAXTON ST. LUKE'S SCHOOL OF RADIOGRAPHY ,NY,13502-4856,Private      ,0,1,1,22,14,36
00520800,THE COLLEGE OF WESTCHESTER              ,NY,10602-0000,Proprietary  ,44,81,125,699,764,1463
00587700,ROBERT J HOCHSTIM SCHOOL OF RADIOG      ,NY,11572-1151,Private      ,0,1,1,0,10,10
00643501,ARNOT OGDEN MEDICAL CENTER              ,NY,14905-1676,Private      ,0,0,0,30,40,70
00643800,PHILLIPS BETH ISRAEL SCH OF NURSING     ,NY,10001-6354,Private      ,2,2,4,73,207,280
00644300,COCHRAN SCH NSG-ST JOHN RVSDE HOSP      ,NY,10701-1399,Private      ,1,13,14,57,333,390
00644500,CROUSE HOSP SCH OF NURSING              ,NY,13210-1690,Private      ,3,8,11,122,227,349
00644800,ELLIS HOSPITAL SCHOOL OF NURSING        ,NY,12308-0000,Private      ,1,2,3,24,120,144
00646101,ST ELIZABETH COLLEGE OF NURSING         ,NY,13501-2998,Private      ,0,0,0,95,154,249
00646102,ST ELIZABETH SCH OF RADIOGRAPHY         ,NY,13501-0000,Private      ,0,1,1,13,11,24
00646700,SAINT JOSEPH'S COLLEGE OF NURSING       ,NY,13203-1806,Private      ,1,2,3,149,235,384
00678200,GENESEE COMMUNITY COLLEGE               ,NY,14020-9704,Public       ,74,96,170,2476,1879,4355
00678500,SCHENECTADY COUNTY COMMUNITY CLG        ,NY,12305-2294,Public       ,73,106,179,1676,1535,3211
00678700,CLINTON COMMUNITY COLLEGE               ,NY,12901-5690,Public       ,40,34,74,1103,719,1822
00678800,TOMPKINS CORTLAND COMMUNITY COLLEGE     ,NY,13053-8504,Public       ,56,94,150,1885,1246,3131
00678900,COLUMBIA-GREENE COMMUNITY COLLEGE       ,NY,12534-9543,Public       ,45,41,86,874,626,1500
00679100,SUNY AT PURCHASE                        ,NY,10577-1400,Public       ,68,18,86,5030,830,5860
00702200,CUNY-LEHMAN COLLEGE                     ,NY,10468-1589,Public       ,213,318,531,7680,6392,14072
00702600,"MT SINAI SCH OF MEDICINE, NY UNIV       ",NY,10029-0000,Private      ,1,2,3,6,897,903
00710900,SUNY COLLEGE-OLD WESTBURY               ,NY,11568-0210,Public       ,81,46,127,3684,1301,4985
00711100,NORTH COUNTRY COMMUNITY COLLEGE         ,NY,12983-2046,Public       ,27,37,64,763,578,1341
00726400,MESIFTA TORAH VODAATH RABBINCAL SEM     ,NY,11218-5209,Private      ,16,9,25,34,40,74
00727300,CUNY-BERNARD BARUCH COLLEGE             ,NY,10010-5518,Public       ,304,194,498,11995,5701,17696
00730400,CULINARY INSTITUTE OF AMERICA           ,NY,12538-1499,Private      ,126,91,217,2648,1249,3897
00737200,AUSTIN'S SCHOOL OF SPA TECHNOLOGY       ,NY,12206-1513,Proprietary  ,12,42,54,52,146,198
00737500,ISLAND DRAFTING & TECHNICAL INST        ,NY,11701-2704,Proprietary  ,8,7,15,89,86,175
00738700,LONG ISLAND BEAUTY SCHOOL               ,NY,11788-4346,Proprietary  ,10,25,35,96,137,233
00738800,LONG ISLAND BEAUTY SCHOOL               ,NY,11550-3704,Proprietary  ,9,21,30,44,119,163
00739100,BEAUTY SCHOOL OF MIDDLETOWN             ,NY,10940-6574,Proprietary  ,16,25,41,62,120,182
00739400,BERKELEY COLLEGE                        ,NY,10017-0000,Proprietary  ,82,138,220,1983,1628,3611
00739402,BERKELEY COLLEGE-WESTCHESTER CAMPUS     ,NY,10601-1533,Proprietary  ,29,14,43,662,230,892
00739800,KATHARINE GIBBS SCHOOL                  ,NY,10018-2602,Proprietary  ,187,355,542,2244,3504,5748
00740100,MANDL SCHOOL                            ,NY,10019-5516,Proprietary  ,14,92,106,113,774,887
00740500,WOOD TOBE-COBURN SCHOOL                 ,NY,10016-0102,Proprietary  ,15,7,22,532,100,632
00746500,AMERICAN ACADEMY OF DRAMATIC ARTS       ,NY,10016-7089,Private      ,7,4,11,346,128,474
00746600,LIM COLLEGE                             ,NY,10022-5268,Proprietary  ,22,0,22,942,89,1031
00746800,SCHOOL OF VISUAL ARTS                   ,NY,10010-3994,Proprietary  ,45,17,62,3162,1211,4373
00750602,LINCOLN TECHNICAL INSTITUTE             ,NY,11357-6092,Proprietary  ,50,34,84,272,97,369
00751800,APEX TECHNICAL SCHOOL                   ,NY,10011-2008,Proprietary  ,158,297,455,819,1597,2416
00752200,CONTINENTAL SCH OF BEAUTY CULTURE       ,NY,14623-3231,Proprietary  ,25,91,116,168,409,577
00753200,FINGER LAKES COMMUNITY COLLEGE          ,NY,14424-8395,Public       ,88,107,195,2270,1651,3921
00757200,AMERICAN MUSICAL AND DRAMATIC ACAD      ,NY,10023-2106,Private      ,14,1,15,1299,215,1514
00757300,EMPIRE BEAUTY SCHOOL                    ,NY,11103-4028,Proprietary  ,12,26,38,85,176,261
00780400,CAREER ACADEMY OF NEW YORK              ,NY,10011-7307,Proprietary  ,22,107,129,146,425,571
00818900,CONTINENTAL SCH OF BEAUTY CULTURE       ,NY,14223-0000,Proprietary  ,0,1,1,10,6,16
00818902,CONTINENTAL SCHOOL OF BEAUTY CULTURE  - ,NY,14224-3402,Proprietary  ,0,0,0,4,9,13
00843500,INTERBORO INSTITUTE                     ,NY,10019-3604,Proprietary  ,474,480,954,2575,3193,5768
00843700,CHAMPLAIN VALLEY - TEC/PRN              ,NY,12901-0000,Public       ,1,0,1,9,32,41
00849500,JAMESTOWN BUSINESS COLLEGE              ,NY,14702-0429,Proprietary  ,11,32,43,150,276,426
00861100,"CUNY, HOSTOS CMTY COLLEGE               ",NY,10451-1499,Public       ,170,233,403,2686,3761,6447
00861400,RABBINICAL CLG BOBOVER YESHIVA BNEI     ,NY,11219-3293,Private      ,43,4,47,129,25,154
00861700,RABBINICAL SEM MKOR CHAIM-YESHIVA       ,NY,11219-4300,Private      ,11,0,11,17,0,17
00878800,SUNY-STUDENT LOAN SERVICE CENTER        ,NY,12144-3440,Public       ,3,2,5,139,105,244
00900300,OLEAN BUSINESS INSTITUTE INC            ,NY,14760-2691,Proprietary  ,1,2,3,32,84,116
00902900,NEIGHBORHOOD PLAYHOUSE                  ,NY,10022-5017,Private      ,1,0,1,35,22,57
00904300,ELMIRA BUSINESS INSTITUTE               ,NY,14901-2731,Proprietary  ,20,137,157,155,989,1144
00907700,UTICA SCHOOL OF COMMERCE                ,NY,13501-2280,Proprietary  ,6,46,52,146,331,477
00924800,SAMARITAN HOSPITAL SCH NURSING          ,NY,12180-2475,Private      ,1,1,2,51,136,187
00928300,MIDWAY-PARIS BEAUTY SCHOOL              ,NY,11385-3453,Proprietary  ,7,23,30,27,103,130
00928400,LEARNING INST FOR BEAUTY SCIENCES       ,NY,11756-1345,Proprietary  ,13,50,63,78,205,283
00933500,MESIVTA EASTERN PKWY RABBINICAL CLG     ,NY,11218-5559,Private      ,8,0,8,19,7,26
00947900,SAINT VINCENTS CMC SI NURSING SCHOOL    ,NY,10304-3850,Proprietary  ,3,1,4,34,76,110
00947901,SAINT VINCENTS CMC SI PHYS ASSIST PROG  ,NY,10304-3850,Proprietary  ,0,0,0,1,4,5
00976900,METROPOLITAN COLLEGE OF NEW YORK        ,NY,10013-1919,Private      ,12,102,114,196,1820,2016
00992900,SUNY COLLEGE OF OPTOMETRY               ,NY,10036-8003,Public       ,0,2,2,12,326,338
01005100,LA GUARDIA CMTY COLLEGE - CUNY          ,NY,11101-3083,Public       ,641,623,1264,6514,6149,12663
01005200,JEFFERSON-LEWIS BOCES PRAC NRSGPRG      ,NY,13601-9509,Public       ,0,10,10,17,114,131
01009700,CUNY-MEDGAR W EVERS COLLEGE             ,NY,11225-2010,Public       ,157,305,462,2817,4005,6822
01014200,TOURO COLLEGE                           ,NY,10010-4202,Private      ,368,946,1314,3563,11148,14711
01014700,WESTERN SUFFOLK BOCES                   ,NY,11768-3499,Public       ,8,32,40,58,212,270
01015300,HELENE FULD COL OF NRSNG/N GEN HOSP     ,NY,10035-0000,Private      ,2,52,54,7,378,385
01028600,EMPIRE STATE COLLEGE                    ,NY,12866-4391,Public       ,44,528,572,514,8557,9071
01037800,RABBINICAL COLLEGE OF LONG ISLAND       ,NY,11561-3244,Private      ,11,1,12,29,1,30
01054900,KEHILATH YAKOV RABBINICAL SEMINARY      ,NY,10562-1001,Private      ,13,9,22,41,20,61
01055100,NEW YORK SCH MED & DENTAL ASSISTANT     ,NY,11101-2327,Proprietary  ,27,70,97,129,369,498
01064100,SOUTHERN WESTCHESTER BOCES              ,NY,10543-0000,Public       ,0,4,4,8,105,113
01068400,ERIE COMMUNITY COLLEGE-ALL CAMPUSES     ,NY,14203-2698,Public       ,374,324,698,6921,6121,13042
01081300,AMERICAN ACAD MCALLISTER INST           ,NY,10019-3604,Private      ,1,6,7,65,168,233
01083700,SIMMONS INST OF FUNERAL SERVICE         ,NY,13207-2098,Proprietary  ,0,1,1,25,46,71
01093000,SUBURBAN TECHNICAL SCHOOL               ,NY,11550-3771,Proprietary  ,22,39,61,92,203,295
01094300,RABBINICAL COLLEGE BETH SHRAGA          ,NY,10952-3033,Private      ,3,0,3,10,0,10
01095200,PNW BOCES LPN PROGRAM                   ,NY,10598-0000,Public       ,0,7,7,9,82,91
01103100,TECHNICAL CAREER INSTITUTE              ,NY,10001-2789,Proprietary  ,372,428,800,2122,3428,5550
01118900,UNITED TALMUDICAL SEMINARY              ,NY,11211-7984,Private      ,424,305,729,441,319,760
01119200,BETH HAMEDRASH SHAAREI YOSHER INST      ,NY,11204-1052,Private      ,4,4,8,21,10,31
01161400,CHAMPLAIN VALLEY HOSP SCH RAD TECH      ,NY,12901-1490,Private      ,0,0,0,17,8,25
01164700,SBI CAMPUS - AN AFFILIATE OF SANFORD-BRO,NY,11747-3785,Proprietary  ,41,79,120,411,654,1065
01167000,YESHIVA OF NITRA RABBINICAL COLLEGE     ,NY,11211-7108,Private      ,34,22,56,103,25,128
01167700,MEMORIAL SLOAN KETTERING CANCER CTR     ,NY,10021-6094,Private      ,0,1,1,4,9,13
01167800,SUNY INST OF TECHNOLOGY UTICA ROME      ,NY,13504-3050,Public       ,29,50,79,1217,963,2180
01182100,YESHIVATH ZICHRON MOSHE                 ,NY,12779-0580,Private      ,7,1,8,59,4,63
01183000,BERK TRADE AND BUSINESS SCHOOL          ,NY,11101-0000,Proprietary  ,7,34,41,36,147,183
01185900,WORD OF LIFE BIBLE INSTITUTE            ,NY,12860-0129,Private      ,8,1,9,463,63,526
01186000,MERCY MED CNTR SCHL OF RADIOGRAPHY      ,NY,11570-1098,Private      ,0,0,0,0,5,5
01192100,WESTCHESTER SCH OF BEAUTY CULTURE       ,NY,10550-2295,Proprietary  ,2,11,13,11,51,62
01192200,BETH HATALMUD RABBINICAL CLG            ,NY,11214-2594,Private      ,31,0,31,31,1,32
01198400,OHR HAMEIR THEOLOGICAL SEMINARY         ,NY,10566-0990,Private      ,15,0,15,44,0,44
01201100,TALMUDICAL SEM OHOLEI TORAH             ,NY,11213-3310,Private      ,60,0,60,194,0,194
01207200,PHILLIPS HAIRSTYLING INSTITUTE          ,NY,13210-1509,Proprietary  ,2,24,26,46,117,163
01210700,INSTITUTE OF DESIGN & CONSTRUCTION      ,NY,11201-5380,Private      ,2,18,20,34,104,138
01220300,MEMORIAL HOSPITAL SCH OF NURSING        ,NY,12204-1083,Private      ,1,2,3,37,125,162
01227700,NEW YORK CHIROPRACTIC COLLEGE           ,NY,13148-0800,Private      ,1,13,14,11,713,724
01229300,VEEB NASSAU CNTY SCHL OF PRACT NURS     ,NY,11553-3037,Public       ,1,2,3,48,166,214
01235800,PLAZA COLLEGE                           ,NY,11372-6300,Proprietary  ,49,101,150,406,745,1151
01236400,SAINT VINCENTS CATHOLIC MEDICAL CENTERS ,NY,11354-0000,Proprietary  ,4,5,9,44,144,188
01240700,SCHUYLER-CHEMUNG-TIOGA BOCES            ,NY,14903-1089,Public       ,2,7,9,32,149,181
01240701,STEUBEN SCHUYLER CHEMUNG TIOGA ALLEGANY ,NY,14870-9518,Public       ,1,2,3,21,107,128
01256100,FIVE TOWNS COLLEGE                      ,NY,11746-5871,Proprietary  ,25,7,32,1287,257,1544
01258900,ERIE 1 BOCES                            ,NY,14224-0000,Public       ,5,47,52,32,202,234
01265200,ONONDAGA CORTLAND MADISON BOCES         ,NY,13090-4500,Public       ,17,111,128,141,505,646
01278300,OSWEGO COUNTY BOCES ADULT CAREERS       ,NY,13114-4498,Public       ,4,13,17,37,109,146
01292700,CENTRAL TECH NURSING PROGRAM            ,NY,13202-3092,Public       ,1,1,2,10,76,86
01302600,MACHZIKEI HADATH RABBINICAL COLLEGE     ,NY,11204-1805,Private      ,11,2,13,39,7,46
01302700,YESHIVATH VIZNITZ                       ,NY,10952-3021,Private      ,98,7,105,98,8,106
01302900,BORICUA COLLEGE                         ,NY,10032-1599,Private      ,42,138,180,321,1194,1515
02056400,CAPRI COSMETOLOGY LEARNING CENTER       ,NY,10954-0000,Proprietary  ,5,11,16,37,53,90
02066200,THE NEW SCHOOL                          ,NY,10011-0000,Private      ,55,110,165,3843,4757,8600
02069000,NEW YORK SCHOOL OF INTERIOR DESIGN      ,NY,10021-0000,Private      ,3,4,7,157,205,362
02075700,BRIARCLIFFE COLLEGE                     ,NY,11714-0000,Proprietary  ,48,38,86,1446,966,2412
02075702,BRIARCLIFFE COLLEGE - PATCHOGUE         ,NY,11772-3019,Proprietary  ,24,40,64,870,780,1650
02092400,RIDLEY-LOWELL SCHOOL OF BUSINESS        ,NY,13905-0000,Proprietary  ,5,28,33,51,307,358
02093700,LONG ISLAND BUSINESS INSTITUTE          ,NY,11725-0000,Proprietary  ,69,186,255,410,1244,1654
02098400,HERKIMER COUNTY BOCES                   ,NY,13350-0000,Public       ,0,0,0,31,76,107
02104300,OTSEGO AREA SCHOOL OF PRAC NURSING      ,NY,13820-0000,Public       ,0,0,0,17,29,46
02105900,HAIR DESIGN INSTITUTE AT FIFTH AVE      ,NY,11220-0000,Proprietary  ,3,16,19,29,77,106
02106800,BRAMSON ORT COLLEGE                     ,NY,11375-0000,Private      ,86,82,168,342,496,838
02110900,CATTARAUGUS/ALLEGANY BOCES              ,NY,14760-0000,Public       ,0,1,1,23,110,133
02116011,SANFORD-BROWN INSTITUTE - NEW YORK      ,NY,10003-2103,Proprietary  ,6,7,13,45,90,135
02118700,LONG ISLAND COLLEGE HOSPITAL - SCHOOL OF,NY,11201-6001,Private      ,4,5,9,69,203,272
02118702,LONG ISLAND COLLEGE HOSPITAL - SCHOOL OF,NY,11201-6001,Private      ,2,2,4,19,29,48
02124000,ORANGE ULSTER BOCES SCH OF PRAC NRS     ,NY,10924-9401,Public       ,3,6,9,23,116,139
02125500,CIRCLE IN THE SQUARE THEATRE SCHOOL     ,NY,10019-0000,Private      ,2,0,2,62,47,109
02126300,MADISON-ONEIDA BOCES PRAC NRS           ,NY,13478-0000,Public       ,0,19,19,18,154,172
02138500,BOCES RENSSELAER SCH OF PRAC NRSG       ,NY,12033-3221,Public       ,0,0,0,13,102,115
02145800,CAYUGA ONONDAGA BOCES                   ,NY,13021-9430,Public       ,0,0,0,17,57,74
02146000,WAYNE-FINGER LAKES BOCES                ,NY,14513-0000,Public       ,3,40,43,28,190,218
02152000,YESHIVA SHAAR HATORAH ITRI TORAH        ,NY,11418-0000,Private      ,2,0,2,2,0,2
02153600,BROOME-TIOGA BOCES PN PROG              ,NY,13905-0000,Public       ,0,3,3,21,72,93
02157900,ROCHESTER GENERAL HOSPITAL              ,NY,14621-3001,Private      ,0,2,2,21,106,127
02158200,WSHNGTN-SARTGA-WARN-HMLTN-ESX BOCES     ,NY,12839-1051,Public       ,0,1,1,18,102,120
02160100,GENEVA GENERAL HOSPITAL                 ,NY,14456-0000,Private      ,1,0,1,15,40,55
02163400,NEW YORK CAREER INSTITUTE               ,NY,10007-2801,Proprietary  ,15,52,67,177,543,720
02169100,DAVIS COLLEGE                           ,NY,13790-0000,Private      ,5,7,12,152,92,244
02170000,SWEDISH INSTITUTE                       ,NY,10001-0000,Proprietary  ,6,47,53,96,692,788
02170200,ALBANY SCHOHARIE SCHENECTADY            ,NY,12205-0000,Public       ,2,6,8,27,146,173
02171900,AILEY SCHOOL (THE)                      ,NY,10019-4402,Private      ,2,0,2,65,18,83
02172100,HAMILTON-FULTON-MONTGOMERY BOCES        ,NY,12095-0000,Public       ,0,1,1,21,37,58
02172800,DUTCHESS COUNTY BOCES SCH PRAC NURS     ,NY,12601-0000,Public       ,3,5,8,31,132,163
02173200,EMPIRE BEAUTY SCHOOL                    ,NY,10001-0000,Proprietary  ,71,136,207,423,842,1265
02173900,ULSTER COUNTY BOCES PRACTICAL NRSG      ,NY,12466-0000,Public       ,0,4,4,27,158,185
02176000,CHERYL FELL'S SCHOOL OF BUSINESS        ,NY,14304-0000,Proprietary  ,1,6,7,5,32,37
02179400,EASTERN SUFFOLK BOCES                   ,NY,11713-0000,Public       ,0,4,4,102,358,460
02179401,HARRY B WARD TECH CTR-EAST SUF BOCE     ,NY,11901-0000,Public       ,1,0,1,1,1,2
02182200,NEW SCHOOL OF RADIO & TELEVISION        ,NY,12206-1106,Proprietary  ,4,15,19,18,36,54
02187300,DARKEI NOAM RABBINICAL COLLEGE          ,NY,11210-0000,Private      ,0,0,0,0,1,1
02191600,TORAH TEMIMAH TALMUDICAL SEMINARY       ,NY,11218-0000,Private      ,23,0,23,39,1,40
02192500,BELLEVUE HOSP CTR SCH RAD TECH          ,NY,10016-0000,Public       ,0,1,1,8,18,26
02193700,SAINT LAWRENCE LEWIS COUNTY BOCES       ,NY,13617-0000,Public       ,1,0,1,56,43,99
02193701,SAINT LAWRENCE LEWIS COUNTY BOCES - NORT,NY,13669-0798,Public       ,0,0,0,2,3,5
02193702,SAINT LAWRENCE LEWIS COUNTY BOCES - SOUT,NY,13642-0342,Public       ,0,0,0,1,1,2
02193703,SAINT LAWRENCE LEWIS COUNTY BOCES - ADUL,NY,13668-3238,Public       ,0,0,0,0,6,6
02199300,ORLEANS-NIAGARA BOCES                   ,NY,14132-0000,Public       ,2,0,2,6,28,34
02206000,HUNTER BUSINESS SCHOOL                  ,NY,11756-0000,Proprietary  ,22,110,132,141,500,641
02206001,HUNTER BUSINESS SCHOOL -                ,NY,11763-0000,Proprietary  ,2,0,2,4,5,9
02217800,D.HOPFER SCH NURSING AT MT.VRN HOSP     ,NY,10550-0000,Private      ,1,7,8,29,243,272
02219500,MILDRED ELLEY                           ,NY,12206-1513,Proprietary  ,35,136,171,217,880,1097
02235600,ERIE 2-CHAUTAUQUA-CATTARAUGUS BOCES     ,NY,14006-0000,Public       ,5,3,8,23,142,165
02248700,BUFFALO VOC TECH CTR PRAC NRSG PROG     ,NY,14211-0000,Public       ,0,0,0,6,3,9
02256700,KOL YAAKOV TORAH CENTER                 ,NY,10952-0000,Private      ,1,0,1,3,0,3
02265100,YESHIVA DERECH CHAIM                    ,NY,11218-0000,Private      ,18,1,19,34,11,45
02265200,GLOBAL BUSINESS INSTITUTE               ,NY,11691-0000,Private      ,76,180,256,308,949,1257
02272900,ROCKLAND COUNTY BOCES PRAC NRSG SCH     ,NY,10994-0000,Public       ,1,0,1,15,47,62
02275900,"MODERN WELDING SCHOOL, INC.             ",NY,12304-0000,Proprietary  ,8,28,36,50,118,168
02287800,NATIONAL TRACTOR TRAILER SCHOOL         ,NY,13088-2505,Proprietary  ,3,53,56,14,246,260
02294900,INSTITUTE OF AUDIO RESEARCH             ,NY,10003-0000,Proprietary  ,70,50,120,514,404,918
02306500,PROFESSIONAL BUSINESS INSTITUTE         ,NY,10002-0000,Private      ,113,123,236,492,658,1150
02314200,NORTHERN WESTCHESTER SCH COSMETOL       ,NY,10566-0000,Proprietary  ,1,11,12,15,30,45
02320100,OHR SOMAYACH TANENBAUM EDUCATIONAL CENTE,NY,10952-0000,Private      ,0,0,0,1,1,2
02325600,NEW YORK INSTITUTE OF ENGLISH & BUS     ,NY,10001-0000,Private      ,15,57,72,92,432,524
02332300,FEGS TRADES AND BUSINESS SCHOOL         ,NY,10013-0000,Private      ,0,0,0,0,1,1
02348700,CAREER BLAZERS LEARNING CENTER          ,NY,10017-0000,Proprietary  ,9,81,90,55,441,496
02349700,RABBINICAL SEMINARY ADAS YEREIM         ,NY,11211-0000,Private      ,8,11,19,16,25,41
02350600,YESHIVA AND KOLLEL HARBOTZAS TORAH      ,NY,11230-0000,Private      ,0,4,4,0,10,10
02454300,NEW YORK UNIVERSITY SCHOOL OF MEDICINE  ,NY,10016-6497,Private      ,4,11,15,163,1007,1170
02491400,SPANISH AMERICAN INSTITUTE              ,NY,10036-0000,Private      ,1,13,14,10,46,56
02505800,YESHIVA KARLIN STOLIN RAB INSTITUTE     ,NY,11204-0000,Private      ,7,6,13,10,21,31
02505900,SH-OR YOSHUV RABBINICAL COLLEGE         ,NY,11691-0000,Private      ,12,2,14,16,9,25
02506000,ASSOCIATED BETH RIVKAH SCHOOLS          ,NY,11225-0000,Private      ,4,2,6,67,10,77
02506100,CITY UNIV OF NEW YORK-CENTRAL           ,NY,10021-0000,Public       ,10,7,17,442,267,709
02506200,MERCE CUNNINGHAM STUDIO                 ,NY,10014-0000,Private      ,2,0,2,3,6,9
02506800,YESHIVAT MIKDASH MELECH                 ,NY,11230-0000,Private      ,8,5,13,19,13,32
02511500,JOFFREY BALLET SCHOOL                   ,NY,10011-0000,Proprietary  ,2,0,2,26,3,29
02513500,MAR JON SCHOOL OF BEAUTY CULTURE        ,NY,14150-0000,Proprietary  ,2,10,12,33,74,107
02525600,ART INSTITUTE OF NEW YORK CITY (THE)    ,NY,10013-2429,Proprietary  ,107,123,230,1508,1222,2730
02540800,"GLOBE INSTITUTE OF TECHNOLOGY, INC.     ",NY,10007-0000,Proprietary  ,49,172,221,455,1517,1972
02546000,TRI-STATE COLLEGE OF ACUPUNCTURE        ,NY,10011-0000,Proprietary  ,0,2,2,3,116,119
02546300,YESHIVA OF THE TELSHE ALUMNI            ,NY,10471-0000,Private      ,28,0,28,28,0,28
02550600,TALMUDICAL INST OF UPSTATE NY           ,NY,14607-0000,Private      ,2,0,2,5,2,7
02556700,SEMINAR L'MOROS BAIS YAAKOV             ,NY,11219-0000,Private      ,16,0,16,231,1,232
02572900,BUSINESS INFORMATICS CENTER             ,NY,11580-0000,Proprietary  ,2,19,21,31,116,147
02575400,FRENCH CULINARY INSTITUTE               ,NY,10013-2618,Proprietary  ,9,28,37,203,345,548
02587600,ORLO SCH HAIR DESIGN & COSMETOLOGY      ,NY,12206-1723,Proprietary  ,10,19,29,65,79,144
02599400,NEW YORK COLLEGE OF HEALTH PROFESSIONS  ,NY,11791-4413,Private      ,10,18,28,167,712,879
02600100,NEW YORK ACADEMY OF ART (THE)           ,NY,10013-2911,Private      ,2,0,2,15,99,114
02614900,SANFORD-BROWN INSTITUTE                 ,NY,10604-2910,Proprietary  ,23,97,120,226,812,1038
02615001,SANFORD-BROWN INSTITUTE - GARDEN CITY   ,NY,11530-4734,Proprietary  ,0,1,1,2,14,16
02616600,SHEAR EGO INTL SCH OF HAIR DESIGN       ,NY,14617-3501,Proprietary  ,2,4,6,30,37,67
02617000,CONTINENTAL SCH OF BEAUTY CULTURE       ,NY,14020-1908,Proprietary  ,19,29,48,63,123,186
02617001,CONTINENTAL SCHOOL OF BEAUTY CULTURE - O,NY,14760-2618,Proprietary  ,0,0,0,5,1,6
02622900,BAIS MEDRASH ELYON                      ,NY,10952-3013,Private      ,1,0,1,2,2,4
03000100,YESHIVA GEDOLAH IMREI YOSEF DSPINKA     ,NY,11219-4696,Private      ,7,52,59,7,126,133
03007200,DANCE THEATRE OF HARLEM                 ,NY,10031-0000,Private      ,0,0,0,10,5,15
03027701,PACIFIC COLLEGE OF ORIENTAL MEDICINE - N,NY,10010-7108,Proprietary  ,0,39,39,7,345,352
03081600,DELAWARE CHENANGO MADISON OT. BOCES     ,NY,13815-9554,Public       ,2,13,15,12,59,71
03088500,NEW YORK INTERNATIONAL BEAUTY SCH       ,NY,10019-0000,Proprietary  ,13,58,71,59,319,378
03089700,COMPUTER CAREER CENTER                  ,NY,11530-3334,Proprietary  ,48,179,227,228,956,1184
03095500,ASA INST BUSINESS & COMPUTER TECH       ,NY,11201-5208,Proprietary  ,215,595,810,1209,4377,5586
03096200,CHARLES STUART SCHOOL                   ,NY,11229-2004,Proprietary  ,0,2,2,9,48,57
03099100,SUNBRIDGE COLLEGE                       ,NY,10977-0000,Private      ,0,1,1,2,90,92
03103700,ADIRONDACK BEAUTY SCHOOL                ,NY,12801-3158,Proprietary  ,1,5,6,14,30,44
03104900,SULLIVAN COUNTY BOCES                   ,NY,12754-2116,Public       ,0,1,1,9,50,59
03111100,NEW YORK PARALEGAL SCHOOL               ,NY,10007-0000,Proprietary  ,4,29,33,22,125,147
03115300,GENESEE VALLEY BOCES                    ,NY,14020-1099,Public       ,4,45,49,26,147,173
03120700,NEW YORK CONSERVATORY FOR DRAMATIC ARTS ,NY,10011-4225,Proprietary  ,4,5,9,328,124,452
03127100,YESHIVAS NOVOMINSK                      ,NY,11219-0000,Private      ,6,0,6,26,0,26
03129200,RABBINICAL CLG OHR SHIMAR YISROEL       ,NY,11211-8102,Private      ,1,33,34,50,89,139
03169300,STUDIO JEWELERS                         ,NY,10016-4112,Proprietary  ,1,2,3,3,10,13
03172400,CALIBER TRAINING INSTITUTE              ,NY,10018-6504,Proprietary  ,42,292,334,227,1252,1479
03181400,MERKAZ BNOS                             ,NY,11204-0000,Private      ,2,46,48,12,253,265
03191300,CUNY SCHOOL OF LAW @ QUEENS COLLEGE     ,NY,11367-0000,Public       ,1,4,5,133,1139,1272
03193300,MANHATTAN SCHOOL OF COMPUTER TECH       ,NY,11230-1617,Private      ,2,33,35,29,195,224
03203300,NEW YORK INSTITUTE OF MASSAGE           ,NY,14221-6021,Proprietary  ,5,35,40,75,237,312
03208300,GRACE INSTITUTE OF BUSINESS TECH        ,NY,11201-2303,Private      ,18,33,51,65,267,332
03216300,UNIFICATION THEOLOGICAL SEMINARY        ,NY,12507-5021,Private      ,0,2,2,0,10,10
03315300,HARLEM SCHOOL OF TECHNOLOGY             ,NY,10027-4426,Proprietary  ,1,4,5,6,42,48
03328300,FRANKLIN CAREER INSTITUTE               ,NY,11550-3003,Private      ,33,70,103,231,571,802
03342400,AMERICAN BARBER INSTITUTE               ,NY,10001-5271,Proprietary  ,10,23,33,40,84,124
03358300,ALLEN SCHOOL                            ,NY,11432-4901,Proprietary  ,56,267,323,237,1045,1282
03361500,WILLSEY INSTITUTE                       ,NY,10301-1989,Proprietary  ,5,49,54,32,218,250
03380300,CULINARY ACADEMY OF LONG ISLAND         ,NY,11791-5311,Proprietary  ,9,38,47,71,169,240
03419400,NORTHEASTERN SEMINARY                   ,NY,14624-1997,Private      ,0,6,6,4,109,113
03426400,ANTHEM INSTITUTE                        ,NY,10018-0000,Proprietary  ,85,278,363,582,1390,1972
03433500,LIA SCHORR INSTITUTE OF COSMETIC SK     ,NY,10022-2614,Proprietary  ,0,6,6,5,44,49
03443300,NEW YORK COLLEGE OF TRADITIONAL CHINESE ,NY,11501-0000,Private      ,0,7,7,5,69,74
03496300,YESHIVA SHAAREI TORAH OF ROCKLAND       ,NY,10901-4003,Private      ,0,0,0,4,1,5
03537300,NEW YORK AUTOMOTIVE & DIESEL INSTIT     ,NY,11101-0000,Proprietary  ,45,92,137,406,683,1089
03568300,LEON STUDIO ONE SCHOOL OF HAIR DESI     ,NY,14221-5323,Proprietary  ,10,17,27,55,96,151
03651300,SAINT JOSEPH'S MEDICAL CENTER SCHOO     ,NY,10701-4080,Private      ,0,1,1,10,15,25
03652300,METROPOLITAN LEARNING INSTITUTE         ,NY,11375-0000,Private      ,1,59,60,15,377,392
03691300,USA BEAUTY SCHOOL INTERNATIONAL         ,NY,10013-3530,Proprietary  ,1,17,18,16,156,172
03713300,BEIS MEDRASH HEICHAL DOVID              ,NY,11691-4433,Private      ,0,0,0,0,1,1
03718300,CENTURION PROFESSIONAL TRAINING         ,NY,11235-0822,Private      ,0,0,0,0,1,1
03773300,CENTER FOR NATURAL WELLNESS SCHOOL OF MA,NY,12205-1601,Proprietary  ,5,20,25,15,89,104
03802300,UTA MESIVTA OF KIRYAS JOEL              ,NY,10950-2169,Private      ,208,101,309,424,206,630
03819400,HUDSON VALLEY SCHOOL OF ADVANCED AESTHET,NY,12493-0000,Proprietary  ,7,10,17,19,41,60
03839300,AVEDA INSTITUTE NEW YORK                ,NY,10013-1522,Proprietary  ,13,27,40,102,182,284
03881300,UNION GRADUATE COLLEGE                  ,NY,12308-3103,Private      ,0,7,7,7,166,173
03903400,AMERICAN BEAUTY SCHOOL                  ,NY,10462-8003,Proprietary  ,6,33,39,36,147,183
03931300,XINCON TECHNOLOGY SCHOOL                ,NY,10001-3507,Proprietary  ,0,0,0,3,2,5
03941400,ELITE ACADEMY OF BEAUTY ARTS            ,NY,11223-1630,Proprietary  ,1,21,22,18,71,89
03983300,"SCHOOL OF PROFESSIONAL HORTICULTURE, AT ",NY,10458-5126,Private      ,0,0,0,0,9,9
04102300,NEW AGE TRAINING                        ,NY,10018-0000,Proprietary  ,2,8,10,2,8,10
00267808,BRYANT & STRATTON COLLEGE - PARMA       ,OH,44130-0000,Proprietary  ,46,207,253,506,2194,2700
00301000,ANTIOCH UNIVERSITY                      ,OH,45387-1608,Private      ,3,5,8,590,122,712
00301001,ANTIOCH UNIVERSITY MCGREGOR             ,OH,45387-0000,Private      ,0,39,39,6,651,657
00301010,ANTIOCH UNIVERSITY                      ,OH,45387-0000,Private      ,0,3,3,41,174,215
00301100,ART ACADEMY OF CINCINNATI               ,OH,45202-7106,Private      ,2,1,3,217,83,300
00301200,ASHLAND UNIVERSITY                      ,OH,44805-3799,Private      ,27,191,218,3020,2859,5879
00301300,ATHENAEUM OF OHIO                       ,OH,45230-2000,Private      ,0,0,0,0,7,7
00301400,BALDWIN-WALLACE COLLEGE                 ,OH,44017-2088,Private      ,37,54,91,3862,1345,5207
00301600,BLUFFTON UNIVERSITY                     ,OH,45817-2104,Private      ,13,6,19,1392,281,1673
00301800,BOWLING GREEN STATE UNIVERSITY          ,OH,43403-0001,Public       ,187,142,329,16682,5109,21791
00302300,CAPITAL UNIVERSITY                      ,OH,43209-2394,Private      ,41,83,124,3601,2753,6354
00302400,CASE WESTERN RESERVE UNIV               ,OH,44106-0000,Private      ,35,24,59,5344,996,6340
00302401,CASE WESTERN RESERVE UNIV - MED         ,OH,44106-0000,Private      ,0,2,2,33,954,987
00302402,CASE WESTERN RESERVE UNIV - DENTAL      ,OH,44106-0000,Private      ,1,2,3,13,333,346
00302403,CASE WESTERN RESERVE UNIV - LAW         ,OH,44106-0000,Private      ,0,4,4,16,1336,1352
00302404,CASE WESTERN RESERVE UNIV - UG          ,OH,44106-0000,Private      ,1,1,2,346,51,397
00302405,CASE WESTERN RESERVE UNIV - MSASS       ,OH,44106-0000,Private      ,0,6,6,4,469,473
00302406,CASE WESTERN RESERVE UNIV - NURS UG     ,OH,44106-0000,Private      ,1,5,6,197,163,360
00302407,CASE WESTERN RESERVE UNIV - WSOM        ,OH,44106-0000,Private      ,0,12,12,14,317,331
00302408,CASE WESTERN RESERVE UNIV -A&S GRAD     ,OH,44106-0000,Private      ,0,5,5,5,281,286
00302409,CASE WESTERN RESERVE UNIV -ENG GRAD     ,OH,44106-0000,Private      ,0,1,1,15,97,112
00302410,CASE WESTERN RESERVE UNIV -NURS GRD     ,OH,44106-0000,Private      ,1,4,5,13,325,338
00302500,CEDARVILLE UNIVERSITY                   ,OH,45314-8564,Private      ,33,3,36,3357,184,3541
00302600,CENTRAL STATE UNIVERSITY                ,OH,45384-1004,Public       ,44,25,69,2872,941,3813
00302900,CINCINNATI CHRISTIAN UNIVERSITY         ,OH,45204-3200,Private      ,8,29,37,582,542,1124
00303000,OHIO CHRISTIAN UNIVERSITY               ,OH,43113-9487,Private      ,11,61,72,222,451,673
00303100,CLEVELAND INSTITUTE OF MUSIC            ,OH,44106-1776,Private      ,1,0,1,521,359,880
00303200,CLEVELAND STATE UNIVERSITY              ,OH,44115-2214,Public       ,127,375,502,6445,11062,17507
00303300,COLLEGE OF MT ST JOSEPH                 ,OH,45233-1670,Private      ,13,25,38,1540,1060,2600
00303500,OHIO DOMINICAN UNIVERSITY               ,OH,43219-2099,Private      ,24,181,205,2314,2454,4768
00303600,FRANCISCAN UNIV OF STEUBENVILLE         ,OH,43952-1763,Private      ,17,15,32,2053,716,2769
00303700,COLLEGE OF WOOSTER                      ,OH,44691-2363,Private      ,13,2,15,2123,68,2191
00303900,COLUMBUS COLLEGE OF ART AND DESIGN      ,OH,43215-1758,Private      ,19,15,34,1650,392,2042
00304000,CUYAHOGA COMMUNITY COLLEGE              ,OH,44115-2878,Public       ,141,625,766,4394,12849,17243
00304001,CUYAHOGA COMMUNITY CLG-EASTERN CAM      ,OH,44122-6195,Public       ,17,50,67,669,1766,2435
00304002,CUYAHOGA COMMUNITY CLG-METRO CAMPUS     ,OH,44115-0000,Public       ,23,110,133,826,2425,3251
00304003,CUYAHOGA COMMUNITY CLG-WESTERN CMPS     ,OH,44130-0000,Public       ,35,57,92,1354,1455,2809
00304100,"DEFIANCE COLLEGE, THE                   ",OH,43512-1695,Private      ,12,8,20,1101,340,1441
00304200,DENISON UNIVERSITY                      ,OH,43023-1329,Private      ,11,2,13,2406,41,2447
00304300,CHANCELLOR UNIVERSITY                   ,OH,44114-1096,Proprietary  ,6,44,50,246,1129,1375
00304400,TRINITY LUTHERAN SEMINARY               ,OH,43209-0000,Private      ,0,0,0,2,159,161
00304500,UNIVERSITY OF FINDLAY                   ,OH,45840-3695,Private      ,24,45,69,3068,1403,4471
00304600,FRANKLIN UNIVERSITY                     ,OH,43215-5399,Private      ,17,318,335,753,6755,7508
00304606,FRANKLIN UNIVERSITY - NORTHWEST         ,OH,43019-5331,Private      ,0,2,2,2,25,27
00304608,FRANKLIN UNIVERSITY - NORTHEAST         ,OH,43081-1111,Private      ,0,4,4,10,37,47
00304700,HEBREW UNION COLLEGE MAIN CAMPUS        ,OH,45220-0000,Private      ,0,0,0,1,137,138
00304800,HEIDELBERG UNIVERSITY                   ,OH,44883-2462,Private      ,10,11,21,1598,322,1920
00304900,HIRAM COLLEGE                           ,OH,44234-1808,Private      ,11,12,23,1369,329,1698
00305000,JOHN CARROLL UNIVERSITY                 ,OH,44118-4581,Private      ,27,27,54,3875,803,4678
00305100,KENT STATE UNIV - KENT CAMPUS           ,OH,44242-0001,Public       ,189,233,422,17368,8530,25898
00305101,KENT STATE UNIV - GEAUGA CAMPUS         ,OH,44021-0000,Public       ,8,13,21,258,265,523
00305102,KENT STATE UNIV - STARK CAMPUS          ,OH,44720-0000,Public       ,29,55,84,1884,1696,3580
00305103,KENT STATE UNIV - TUSCARAWAS CAMPUS     ,OH,44663-0000,Public       ,7,47,54,789,1018,1807
00305104,KENT STATE UNIV - TRUMBULL CAMPUS       ,OH,44483-0000,Public       ,18,46,64,764,1237,2001
00305105,KENT STATE UNIV - ASHTABULA CAMPUS      ,OH,44004-0000,Public       ,10,33,43,619,1128,1747
00305106,KENT STATE UNIV -E.LIVERPOOL CAMPUS     ,OH,43920-0000,Public       ,10,16,26,311,549,860
00305107,KENT STATE UNIV - SALEM CAMPUS          ,OH,44460-0000,Public       ,11,17,28,608,774,1382
00306500,KENYON COLLEGE                          ,OH,43022-9623,Private      ,10,1,11,2175,24,2199
00306600,LAKE ERIE COLLEGE                       ,OH,44077-3389,Private      ,15,8,23,690,342,1032
00306800,LORAIN COUNTY COMMUNITY COLLEGE         ,OH,44035-1691,Public       ,93,289,382,2537,4981,7518
00306900,LOURDES COLLEGE                         ,OH,43560-2898,Private      ,25,79,104,623,1546,2169
00307200,MALONE UNIVERSITY                       ,OH,44709-3897,Private      ,13,50,63,1854,1102,2956
00307300,MARIETTA COLLEGE                        ,OH,45750-4033,Private      ,14,15,29,2274,247,2521
00307500,METHODIST THEOLOGICAL SCH IN OHIO       ,OH,43015-0000,Private      ,0,7,7,1,241,242
00307600,MIAMI-JACOBS COLLEGE                    ,OH,45401-0000,Proprietary  ,30,229,259,190,1456,1646
00307602,MIAMI - JACOBS CAREER COLLEGE - SPRINGBO,OH,45066-1115,Proprietary  ,18,99,117,97,329,426
00307603,MIAMI - JACOBS CAREER COLLEGE - TROY    ,OH,45373-3837,Proprietary  ,2,18,20,2,18,20
00307700,MIAMI UNIVERSITY                        ,OH,45056-1831,Public       ,179,151,330,15524,3685,19209
00307800,WRIGHT STATE UNIVERSITY                 ,OH,45435-0002,Public       ,152,316,468,10814,7817,18631
00308300,MOUNT UNION COLLEGE                     ,OH,44601-3993,Private      ,22,6,28,2965,179,3144
00308400,MUSKINGUM UNIVERSITY                    ,OH,43762-1199,Private      ,19,28,47,2090,490,2580
00308500,NOTRE DAME COLLEGE OF OHIO              ,OH,44121-4293,Private      ,9,35,44,945,968,1913
00308600,OBERLIN COLLEGE                         ,OH,44074-1090,Private      ,21,2,23,4161,103,4264
00308800,OHIO COLLEGE OF PODIATRIC MEDICINE      ,OH,44131-7304,Private      ,0,2,2,1,336,337
00308900,OHIO NORTHERN UNIVERSITY                ,OH,45810-1555,Private      ,16,6,22,4093,1119,5212
00309000,OHIO STATE UNIVERSITY-ALL CAMPUSES      ,OH,43210-1358,Public       ,478,588,1066,39361,21863,61224
00309001,OHIO STATE UNIVERSITY-LIMA              ,OH,45804-0000,Public       ,0,0,0,3,4,7
00309002,OHIO STATE UNIVERSITY-MANSFIELD         ,OH,44906-0000,Public       ,0,0,0,1,5,6
00309003,THE OHIO STATE UNIVERSITY-MARION        ,OH,43302-0000,Public       ,0,0,0,5,7,12
00309004,OHIO STATE UNIVERSITY-NEWARK            ,OH,43055-1797,Public       ,0,0,0,12,6,18
00309005,OHIO STATE UNIVERSITY-ATI/WOOSTER       ,OH,44691-0000,Public       ,0,0,0,2,0,2
00310000,OHIO UNIVERSITY                         ,OH,45701-2979,Public       ,170,165,335,17136,4662,21798
00310002,"OHIO UNIVERSITY, ZANESVILLE CAMPUS      ",OH,43701-0000,Public       ,20,52,72,906,1039,1945
00310003,"OHIO UNIVERSITY, LANCASTER CAMPUS       ",OH,43130-0000,Public       ,30,73,103,832,968,1800
00310004,"OHIO UNIVERSITY, SOUTHERN CAMPUS        ",OH,45638-0000,Public       ,42,91,133,821,1342,2163
00310005,"OHIO UNIVERSITY, CHILLICOTHE CAMPUS     ",OH,45601-0000,Public       ,21,100,121,707,1430,2137
00310006,"OHIO UNIVERSITY, EASTERN CAMPUS         ",OH,43950-0000,Public       ,13,16,29,483,329,812
00310008,OHIO UNIV COLL OF OSTEOPATHIC MED       ,OH,45701-0000,Public       ,1,3,4,13,465,478
00310900,OHIO WESLEYAN UNIVERSITY                ,OH,43015-2398,Private      ,14,1,15,2322,91,2413
00311000,OTTERBEIN COLLEGE                       ,OH,43081-2006,Private      ,31,48,79,3410,943,4353
00311300,PONTIFICAL COLLEGE JOSEPHINUM           ,OH,43235-1498,Private      ,0,1,1,41,21,62
00311401,FIRELANDS REGIONAL MEDICAL CENTER       ,OH,44870-4788,Private      ,1,0,1,68,119,187
00311500,RABBINICAL COLLEGE OF TELSHE            ,OH,44092-2584,Private      ,9,1,10,28,22,50
00311600,UNIV OF RIO GRANDE                      ,OH,45674-3131,Private      ,25,78,103,1502,1440,2942
00311900,SINCLAIR COMMUNITY COLLEGE              ,OH,45402-1460,Public       ,227,794,1021,6113,11869,17982
00312100,TIFFIN UNIVERSITY                       ,OH,44883-2161,Private      ,23,96,119,1583,1345,2928
00312200,UNITED THEOLOGICAL SEMINARY             ,OH,45406-0000,Private      ,0,2,2,1,191,192
00312300,UNIVERSITY OF AKRON                     ,OH,44325-6211,Public       ,222,254,476,15065,12180,27245
00312500,UNIVERSITY OF CINCINNATI                ,OH,45221-0125,Public       ,344,693,1037,18452,15719,34171
00312504,UNIVERSITY OF CINCINNATI - COLLEGE OF ME,OH,45267-0553,Public       ,4,4,8,76,805,881
00312700,UNIVERSITY OF DAYTON                    ,OH,45469-0002,Private      ,53,120,173,8401,3266,11667
00313100,UNIVERSITY OF TOLEDO                    ,OH,43606-3390,Public       ,158,164,322,13613,6979,20592
00313101,UNIVERSITY OF TOLEDO - HEALTH SCIENCE CA,OH,43614-2598,Public       ,6,16,22,82,1349,1431
00313300,URBANA UNIVERSITY                       ,OH,43078-2091,Private      ,8,15,23,952,563,1515
00313400,URSULINE COLLEGE                        ,OH,44124-4398,Private      ,13,45,58,745,1258,2003
00313500,WALSH UNIVERSITY                        ,OH,44720-3396,Private      ,10,35,45,2072,892,2964
00314100,WILBERFORCE UNIVERSITY                  ,OH,45384-1001,Private      ,17,28,45,1121,676,1797
00314200,WILMINGTON COLLEGE                      ,OH,45177-2499,Private      ,11,21,32,1816,512,2328
00314300,WITTENBERG UNIVERSITY                   ,OH,45501-2199,Private      ,19,10,29,2621,223,2844
00314400,XAVIER UNIVERSITY                       ,OH,45207-1035,Private      ,34,110,144,4679,2810,7489
00314500,YOUNGSTOWN STATE UNIVERSITY             ,OH,44555-0001,Public       ,141,219,360,7920,6239,14159
00398200,CLEVELAND INSTITUTE OF ART              ,OH,44106-1700,Private      ,9,4,13,759,172,931
00406000,WINEBRENNER THEOLOGICAL SEMINARY        ,OH,45840-0000,Private      ,0,1,1,2,73,75
00485200,CLARK STATE COMMUNITY COLLEGE           ,OH,45505-4795,Public       ,42,205,247,1106,2868,3974
00485300,BRADFORD SCHOOL                         ,OH,43219-0000,Proprietary  ,21,58,79,571,357,928
00485500,DAVIS COLLEGE                           ,OH,43623-4307,Proprietary  ,17,65,82,124,690,814
00486100,UNIVERSITY OF NORTHWESTERN OHIO         ,OH,45805-1498,Private      ,77,73,150,3105,1055,4160
00486600,STAUTZENBERGER COLLEGE                  ,OH,43537-4007,Proprietary  ,34,137,171,308,1145,1453
00510200,SCH OF DIAGNOSTIC IMAGING-CLEVELAND     ,OH,44119-0000,Private      ,0,1,1,10,34,44
00512700,BROWN MACKIE COLLEGE-CINCINNATI         ,OH,45215-1107,Proprietary  ,107,564,671,842,4313,5155
00531300,NORTH CENTRAL STATE COLLEGE             ,OH,44901-0000,Public       ,56,213,269,1081,2453,3534
00575300,OWENS STATE COMMUNITY COLLEGE           ,OH,43699-0000,Public       ,227,485,712,4965,9132,14097
00648700,AULTMAN COLLEGE OF NURSING AND HEALTH SC,OH,44710-1799,Private      ,2,2,4,123,206,329
00648900,CHRIST HOSP SCH OF NURSING              ,OH,45219-2989,Private      ,2,6,8,110,329,439
00649400,GOOD SAMARITAN COLG-NURSING/HEALTH      ,OH,45220-2489,Private      ,1,8,9,167,367,534
00649800,MERIDIA HURON SCHOOL OF NURSING         ,OH,44112-4308,Private      ,0,3,3,24,234,258
00650700,TRINIT HEALTH SYSTEM SCH OF NURSING     ,OH,43952-2667,Private      ,1,0,1,56,135,191
00680400,LAKELAND COMMUNITY COLLEGE              ,OH,44094-5198,Public       ,84,232,316,2232,4221,6453
00686700,COLUMBUS STATE COMMUNITY COLLEGE        ,OH,43215-1786,Public       ,386,1190,1576,9312,17511,26823
00703500,KETTERING COLLEGE OF MEDICAL ARTS       ,OH,45429-1299,Private      ,7,38,45,473,839,1312
00708500,MOUNT VERNON NAZARENE UNIVERSITY        ,OH,43050-9500,Private      ,10,18,28,1501,488,1989
00708501,MOUNT VERNON NAZARENE UNIV - AGS        ,OH,43050-0000,Private      ,2,95,97,51,1043,1094
00727500,EASTERN GATEWAY COMMUNITY COLLEGE       ,OH,43952-3598,Public       ,13,38,51,714,1134,1848
00747300,CHOFFIN CAREER & TECHNICAL CENTER       ,OH,44503-1628,Public       ,2,4,6,51,187,238
00759800,HOCKING TECHNICAL COLLEGE               ,OH,45764-9582,Public       ,92,192,284,3139,3045,6184
00777700,REMINGTON COLLEGE - CLEVELAND CAMPUS    ,OH,44125-1957,Proprietary  ,33,171,204,218,1345,1563
00777704,REMINGTON COLLEGE-CLEVELAND WEST CAMPUS ,OH,44070-3129,Proprietary  ,26,105,131,209,732,941
00812900,ADULT AND COMMUNITY EDUCATION @ HUDSON  ,OH,43211-2017,Public       ,5,31,36,53,345,398
00813200,TOLEDO SCHOOL OF PRACTICAL NURSING      ,OH,43613-5110,Public       ,3,35,38,63,352,415
00813300,ZANE STATE COLLEGE                      ,OH,43701-2626,Public       ,41,125,166,897,1527,2424
00819400,AKRON SCHOOL OF PRACTICAL NRSG          ,OH,44311-0000,Public       ,0,1,1,47,162,209
00827800,TERRA COMMUNITY COLLEGE                 ,OH,43420-9670,Public       ,24,76,100,658,1356,2014
00867700,NORTHWEST STATE COMMUNITY COLLEGE       ,OH,43502-9542,Public       ,32,99,131,914,1873,2787
00888600,PORTAGE LAKES CAREER CENTER             ,OH,44232-0000,Public       ,1,4,5,25,123,148
00908800,ITT TECHNICAL INSTITUTE                 ,OH,45414-3456,Proprietary  ,99,225,324,731,1463,2194
00915600,WAYNE COUNTY SCHOOLS CAREER CENTER      ,OH,44677-9672,Public       ,0,8,8,22,203,225
00917200,SPRINGFIELD REGIONAL SCHOOL OF NURSING  ,OH,45501-0000,Private      ,3,1,4,76,202,278
00941200,NATIONAL INSTITUTE OF TECHNOLOGY        ,OH,44221-2998,Proprietary  ,31,84,115,270,551,821
00945101,BROWN MACKIE COLLEGE-NORTH CANTON       ,OH,44720-0000,Proprietary  ,28,223,251,225,1618,1843
00953000,GERBER AKRON BEAUTY SCHOOL              ,OH,44333-3714,Proprietary  ,4,9,13,20,102,122
00953100,SPA SCHOOL (THE)                        ,OH,43214-1524,Proprietary  ,4,11,15,14,58,72
00965800,RIGGS LEMAR BEAUTY COLLEGE              ,OH,44221-1114,Proprietary  ,0,0,0,20,43,63
00966000,TIFFIN ACADEMY OF HAIR DESIGN           ,OH,44883-2833,Proprietary  ,5,9,14,44,61,105
00983700,ITT TECHNICAL INSTITUTE                 ,OH,44509-4098,Proprietary  ,103,223,326,1011,1477,2488
00994100,BELMONT TECHNICAL COLLEGE               ,OH,43950-9766,Public       ,23,117,140,860,1418,2278
00994200,SHAWNEE STATE UNIVERSITY                ,OH,45662-4344,Public       ,75,153,228,3233,2108,5341
01001700,PAYNE THEOLOGICAL SEMINARY              ,OH,45384-0474,Private      ,0,4,4,0,92,92
01002700,JAMES A. RHODES STATE COLLEGE           ,OH,45804-3597,Public       ,34,162,196,1304,2551,3855
01016800,NATIONWIDE BEAUTY ACADEMY               ,OH,43228-1000,Proprietary  ,23,50,73,277,458,735
01028000,OHIO STATE BEAUTY ACADEMY               ,OH,45801-4950,Proprietary  ,3,8,11,87,138,225
01032300,HANNAH E MULLINS SCH-PRAC NRSG          ,OH,44460-2906,Public       ,2,13,15,16,100,116
01034500,CINCINNATI STATE TECH & COMM CLG        ,OH,45223-2690,Public       ,176,547,723,3807,7767,11574
01045300,WASHINGTON STATE CMTY COLLEGE           ,OH,45750-9225,Public       ,31,91,122,854,1558,2412
01063000,NORTHERN INSTITUTE OF COSMETOLOGY       ,OH,44052-1803,Proprietary  ,2,1,3,19,56,75
01073600,MARION TECHNICAL COLLEGE                ,OH,43302-5694,Public       ,13,90,103,579,1393,1972
01088000,CHATFIELD COLLEGE                       ,OH,45118-9705,Private      ,5,33,38,64,183,247
01088100,STARK STATE COLLEGE OF TECHNOLOGY       ,OH,44720-7299,Public       ,74,189,263,2536,4978,7514
01090600,CINCINNATI CLG OF MORTUARY SCIENCE      ,OH,45224-1428,Private      ,4,9,13,97,143,240
01092300,UNION INSTITUTE & UNIVERSITY            ,OH,45206-1925,Private      ,1,201,202,40,2124,2164
01096200,MOORE UNIV OF HAIR DESIGN               ,OH,45213-0000,Proprietary  ,1,6,7,12,40,52
01099300,HOBART INSTITUTE OF WELDING TECHNOLOGY  ,OH,45373-2400,Private      ,17,20,37,165,99,264
01100500,KAPLAN COLLEGE                          ,OH,43232-4827,Proprietary  ,21,127,148,150,806,956
01104600,CENTRAL OHIO TECHNICAL COLLEGE          ,OH,43055-1767,Public       ,42,211,253,1211,3186,4397
01170300,PENTA COUNTY JOINT VOCATIONAL SCH       ,OH,43551-0000,Public       ,2,14,16,15,114,129
01174400,NATIONAL BEAUTY COLLEGE                 ,OH,44720-0000,Proprietary  ,7,20,27,65,134,199
01174500,OHIO TECHNICAL COLLEGE                  ,OH,44103-1228,Proprietary  ,34,57,91,1003,455,1458
01182500,OHIO STATE SCHOOL OF COSMETOLOGY        ,OH,43224-1107,Proprietary  ,2,8,10,44,85,129
01212800,SOUTHWESTERN COLLEGE                    ,OH,45402-3003,Proprietary  ,20,132,152,132,847,979
01212802,SOUTHWESTERN COLLEGE                    ,OH,45005-2267,Proprietary  ,7,62,69,51,399,450
01212803,SOUTHWESTERN COLLEGE                    ,OH,45202-4304,Proprietary  ,22,88,110,114,644,758
01212804,SOUTHWESTERN COLLEGE                    ,OH,45246-3121,Proprietary  ,25,167,192,169,1195,1364
01216600,CAROUSEL BEAUTY COLLEGE                 ,OH,45402-8935,Proprietary  ,12,24,36,81,184,265
01224800,CENTRAL SCHOOL OF PRACTICAL NURSING     ,OH,44103-4371,Private      ,3,26,29,50,285,335
01267200,CAROUSEL BEAUTY COLLEGE                 ,OH,45044-5113,Proprietary  ,1,5,6,17,43,60
01267400,CAROUSEL OF MIAMI VALLEY BEAUTY CLG     ,OH,45424-2063,Proprietary  ,0,0,0,19,26,45
01275000,EDISON COMMUNITY COLLEGE                ,OH,45356-9239,Public       ,20,68,88,771,1799,2570
01283800,LAURA AND ALVIN SIEGAL COLLEGE OF JUDAIC,OH,44122-7197,Private      ,0,0,0,0,5,5
01284800,MOLER-HOLLYWOOD BEAUTY COLLEGE          ,OH,45202-2577,Proprietary  ,5,30,35,35,162,197
01287000,SOUTHERN STATE COMMUNITY COLLEGE        ,OH,45133-9406,Public       ,46,181,227,975,2171,3146
01289100,ANTONELLI COLLEGE                       ,OH,45202-2592,Proprietary  ,45,137,182,362,1369,1731
01289600,VIRGINIA MARTI COLLEGE OF ART AND DESIGN,OH,44107-0778,Proprietary  ,4,8,12,200,178,378
01313200,INTERNATIONAL CLG OF BROADCASTING       ,OH,45431-1898,Proprietary  ,11,15,26,75,149,224
02052000,OHIO INST OF PHOTOGRAPHY & TECHNOLOGY   ,OH,45439-1984,Proprietary  ,21,101,122,308,861,1169
02054300,TRUMBULL BUSINESS COLLEGE               ,OH,44484-0000,Proprietary  ,11,75,86,92,547,639
02056800,DAYMAR COLLEGE                          ,OH,45601-1038,Proprietary  ,3,18,21,56,312,368
02056802,DAYMAR COLLEGE - LANCASTER              ,OH,43130-0000,Proprietary  ,1,2,3,5,16,21
02056803,DAYMAR COLLEGE - NEW BOSTON             ,OH,45662-4900,Proprietary  ,2,2,4,4,21,25
02056804,DAYMAR COLLEGE - JACKSON                ,OH,45640-1728,Proprietary  ,0,1,1,2,21,23
02066100,OHIO STATE COLLEGE/BARBER STYLING       ,OH,43213-0000,Proprietary  ,7,28,35,52,145,197
02069500,AKRON INSTITUTE                         ,OH,44306-0000,Proprietary  ,12,110,122,167,843,1010
02073300,GALLIA-JACKSON-VINTON SCH ADULT ED      ,OH,45674-0000,Public       ,2,3,5,43,191,234
02077800,CENTURY SCHOOL OF COSMETOLOGY           ,OH,43952-0000,Proprietary  ,1,5,6,7,27,34
02110700,CLEVELAND INST OF DENTAL-MED ASST       ,OH,44115-2285,Proprietary  ,31,120,151,208,742,950
02116009,SANFORD-BROWN COLLEGE - MIDDLEBURG HEIGH,OH,44130-8362,Proprietary  ,29,165,194,99,458,557
02116900,UPPER VALLEY JVS                        ,OH,45356-0000,Public       ,2,23,25,18,230,248
02117300,GREAT OAKS INSTITUTE OF TECHNOLOGY      ,OH,45241-1581,Public       ,5,27,32,149,848,997
02128600,THE ART INSTITUTE OF CINCINNATI         ,OH,45246-0000,Proprietary  ,4,4,8,140,49,189
02140700,COMMUNITY EDUCATIONAL SERVICES          ,OH,44702-1710,Public       ,1,2,3,25,218,243
02152100,ACADEMY OF COURT REPORTING AND TECHNOLOG,OH,44115-0000,Proprietary  ,36,292,328,247,2575,2822
02158500,OHIO BUSINESS COLLEGE                   ,OH,44055-3344,Proprietary  ,11,78,89,79,448,527
02158501,OHIO BUSINESS COLLEGE                   ,OH,44870-9953,Proprietary  ,1,2,3,26,75,101
02163900,BEATRICE ACADEMY OF BEAUTY              ,OH,44106-0000,Proprietary  ,0,5,5,18,83,101
02168100,TRI-COUNTY JOINT VOCATIONAL SCHOOL      ,OH,45764-0000,Public       ,0,5,5,14,110,124
02187900,ASHTABULA CO JOINT VOC SCH ADULT ED     ,OH,44047-0000,Public       ,0,16,16,15,220,235
02189000,ADULT CENTER FOR EDUCATION              ,OH,43701-0000,Public       ,3,19,22,54,225,279
02190700,RETS TECH CENTER                        ,OH,45459-0000,Proprietary  ,37,173,210,220,1322,1542
02192100,BUTLER TECHNOLOGY AND CAREER DEVELOPMENT,OH,45011-0000,Public       ,17,65,82,113,499,612
02196300,COLLINS CAREER CENTER                   ,OH,45619-0000,Public       ,2,12,14,119,487,606
02210800,MEDINA COUNTY CAREER CENTER             ,OH,44256-0000,Public       ,0,0,0,13,128,141
02215400,OHIO STATE SCHOOL OF COSMETOLOGY        ,OH,43207-0000,Proprietary  ,4,7,11,67,100,167
02220500,GOD'S BIBLE SCHOOL & COLLEGE            ,OH,45210-0000,Private      ,1,9,10,148,61,209
02220800,CAREER & TECHNOLOGY EDUCATION CENTERS OF,OH,43055-0000,Public       ,2,10,12,17,112,129
02239800,PIONEER CAREER & TECHNOLOGY CENTER      ,OH,44875-0000,Public       ,1,7,8,7,56,63
02245600,WARREN COUNTY CAREER CENTER             ,OH,45036-0000,Public       ,0,10,10,8,46,54
02246300,INSTITUTE OF MEDICAL-DENTAL TECH        ,OH,45246-3317,Proprietary  ,10,22,32,54,181,235
02261400,COLLEGE OF ART ADVERTISING              ,OH,45211-0000,Proprietary  ,0,0,0,16,18,34
02263700,MIAMI VALLEY CAREER TECHNOLOGY CTR      ,OH,45315-0000,Public       ,8,27,35,90,417,507
02269400,EASTERN HILLS ACAD OF HAIR DESIGN       ,OH,45255-0000,Proprietary  ,7,19,26,45,90,135
02269500,WESTERN HILLS SCHOOL OF BEAUTY & HAIR DE,OH,45211-0000,Proprietary  ,7,43,50,60,294,354
02270100,OHIO HI-POINT CAREER CENTER             ,OH,43311-0000,Public       ,0,5,5,18,161,179
02272700,COLUMBIANA COUNTY CAREER CENTER         ,OH,44432-0000,Public       ,1,8,9,21,179,200
02287900,RAPHAEL'S SCHOOL OF BEAUTY CULTURE      ,OH,44446-0000,Proprietary  ,4,24,28,48,147,195
02301400,OHIO VALLEY COLLEGE OF TECHNOLOGY       ,OH,43920-0000,Proprietary  ,9,22,31,65,243,308
02303600,BOHECKER'S BUSINESS COLLEGE             ,OH,44266-0000,Proprietary  ,12,86,98,202,483,685
02304700,TRI-RIVERS CAREER CENTER                ,OH,43302-0000,Public       ,3,7,10,32,132,164
02311200,AMERICAN SCHOOL OF TECHNOLOGY           ,OH,43229-0000,Proprietary  ,13,110,123,81,561,642
02315500,TOLEDO ACADEMY OF BEAUTY CULTURE - EAST ,OH,43616-0000,Proprietary  ,0,27,27,38,194,232
02328500,MOLER-PICKENS BEAUTY COLLEGE            ,OH,45014-0000,Proprietary  ,4,15,19,17,73,90
02334300,INTERNATIONAL ACAD OF HAIR DESIGN       ,OH,45239-0000,Proprietary  ,6,10,16,82,67,149
02336300,KNOX COUNTY CAREER CENTER               ,OH,43050-4298,Public       ,0,1,1,39,185,224
02336700,CUYAHOGA VALLEY CAREER CENTER           ,OH,44141-1296,Public       ,1,1,2,38,158,196
02337700,PROFESSIONAL SKILLS INSTITUTE           ,OH,43607-0000,Proprietary  ,1,29,30,90,646,736
02345600,AKRON MACHINING INSTITUTE               ,OH,44203-0000,Private      ,3,26,29,14,113,127
02351500,WILLOUGHBY EASTLAKE SCH OF PRAC NSG     ,OH,44094-0000,Public       ,0,2,2,15,102,117
02352800,POLARIS CAREER CENTER-ADULT ED DEPT     ,OH,44130-0000,Public       ,1,4,5,34,124,158
02354200,SCIOTO COUNTY JOINT VOCATIONAL SCH      ,OH,45648-0000,Public       ,4,39,43,73,313,386
02454400,NORTHEASTERN OHIO UNIVS COL OF MED      ,OH,44272-0000,Public       ,2,1,3,47,471,518
02497800,GREENE COUNTY CAREER CENTER             ,OH,45385-0000,Public       ,7,30,37,26,139,165
02512600,ADULT VOCATIONAL SERVICES               ,OH,44308-0000,Public       ,1,20,21,7,129,136
02519300,OHIO STATE SCH COSMETOLOGY              ,OH,43068-0000,Proprietary  ,0,3,3,7,20,27
02522700,EASTLAND-FAIRFIELD CAREER AND TECHNICAL ,OH,43125-0000,Public       ,3,34,37,47,259,306
02528300,TDDS TECHNICAL INSTITUTE                ,OH,44429-0000,Proprietary  ,9,81,90,65,381,446
02529500,HAMRICK SCHOOL                          ,OH,44256-0000,Proprietary  ,0,21,21,4,84,88
02541400,TOLEDO ACADEMY OF BEAUTY CULTURE-SO     ,OH,43614-0000,Proprietary  ,6,15,21,43,155,198
02545800,INNER STATE BEAUTY SCHOOLS              ,OH,44124-0000,Proprietary  ,9,36,45,53,225,278
02553000,SCHOOL OF ADVERTISING ART               ,OH,45440-0000,Proprietary  ,0,2,2,191,14,205
02560000,CASAL AVEDA INSTITUTE                   ,OH,44515-0000,Proprietary  ,14,10,24,77,69,146
02560700,PICKAWAY ROSS CO JOINT VOC TECH SCH     ,OH,45601-0000,Public       ,4,12,16,52,216,268
02562300,APOLLO CAREER CENTER-ADULT EDUC         ,OH,45806-0000,Public       ,1,23,24,67,355,422
02563000,RAPHAELS SCHOOL OF BEAUTY CULTURE       ,OH,44601-2847,Proprietary  ,2,21,23,23,67,90
02568600,MAHONING COUNTY CAREER & TECH CENTR     ,OH,44406-0000,Public       ,0,0,0,15,78,93
02582900,KAPLAN CAREER INSTITUTE                 ,OH,44129-6810,Proprietary  ,34,131,165,142,724,866
02586400,TRUMBULL CAREER & TECH CENTER-ADULT     ,OH,44483-1997,Public       ,6,32,38,43,258,301
02588500,OHIO STATE SCHOOL OF COSMETOLOGY        ,OH,43081-0000,Proprietary  ,1,0,1,26,12,38
02599711,VATTEROTT COLLEGE - CLEVELAND           ,OH,44147-3502,Proprietary  ,2,60,62,58,415,473
02603800,LORAIN COUNTY JVS ADULT CAREER CTR      ,OH,44074-9799,Public       ,1,11,12,36,167,203
02614700,SPRINGFIELD CLARK CO JOINT VOC SCH      ,OH,45505-4295,Public       ,0,6,6,5,72,77
02616200,BROWN MACKIE COLLEGE-FINDLAY            ,OH,45840-6848,Proprietary  ,47,183,230,349,1317,1666
02620000,SANDUSKY CAREER CENTER                  ,OH,44870-4786,Public       ,2,10,12,24,131,155
03007900,GALLIPOLIS CAREER COLLEGE               ,OH,45631-2600,Proprietary  ,2,12,14,26,253,279
03015100,ALLIANCE HIGH SCH-CMTY SERVICES DIV     ,OH,44601-2899,Public       ,1,14,15,32,163,195
03015300,EHOVE CAREER CENTER                     ,OH,44846-9500,Public       ,1,11,12,64,314,378
03023700,MADISON ADULT CAREER CENTER             ,OH,44905-2718,Public       ,1,7,8,13,104,117
03024300,VALLEY BEAUTY SCHOOL                    ,OH,43725-2332,Proprietary  ,3,9,12,37,70,107
03027100,FAIRVIEW ACADEMY                        ,OH,44126-2214,Proprietary  ,3,9,12,18,59,77
03034200,WASHINGTON COUNTY CAREER CENTER ADULT TE,OH,45750-9290,Public       ,3,14,17,21,155,176
03051400,AUBURN CAREER CENTER                    ,OH,44077-9723,Public       ,1,6,7,40,68,108
03051500,US GRANT JOINT VOCATIONAL SCHOOL        ,OH,45106-9502,Public       ,0,1,1,0,31,31
03065800,OHIO INSTITUTE OF HEALTH CAREERS        ,OH,44035-2394,Proprietary  ,17,99,116,133,640,773
03065900,BUCKEYE CAREER CENTER                   ,OH,44663-9437,Public       ,0,3,3,44,208,252
03067600,RAPHAEL'S SCHOOL OF BEAUTY CULTURE      ,OH,44512-2222,Proprietary  ,7,13,20,22,57,79
03068200,OHIO CENTER FOR BROADCASTING            ,OH,44125-4220,Proprietary  ,14,54,68,101,258,359
03071900,MOUNT CARMEL COLLEGE OF NURSING         ,OH,43222-1598,Private      ,9,11,20,491,498,989
03078000,OHIO CENTER FOR BROADCASTING            ,OH,45227-1509,Proprietary  ,3,8,11,35,57,92
03079000,ETI TECHNICAL COLLEGE                   ,OH,44446-4398,Proprietary  ,3,36,39,122,356,478
03084800,DELAWARE AREA CAREER CENTER             ,OH,43015-8969,Public       ,0,1,1,1,17,18
03084801,DELAWARE AREA CAREER CENTER -           ,OH,43015-9001,Public       ,0,0,0,5,12,17
03095600,VANTAGE CAREER CENTER                   ,OH,45891-1378,Public       ,4,25,29,24,120,144
03097000,MERCY COLLEGE OF NORTHWEST OHIO         ,OH,43604-1132,Private      ,15,14,29,371,653,1024
03100100,PARAMOUNT BEAUTY ACADEMY                ,OH,45662-4136,Proprietary  ,4,11,15,31,82,113
03105400,CLEVELAND EXTENSION HIGH SCH-WEST       ,OH,44102-2298,Public       ,4,42,46,29,218,247
03116200,DAYTON BARBER COLLEGE                   ,OH,45402-2310,Proprietary  ,2,16,18,22,130,152
03116300,OHIO COLLEGE OF MASSOTHERAPY            ,OH,44321-1363,Private      ,5,8,13,103,257,360
03116400,VANGUARD-SENTINELL VOC SCH DISTRICT     ,OH,43420-1197,Public       ,0,0,0,2,26,28
03117000,ASHLAND COUNTY-W HOLMES CAREER CTR      ,OH,44805-0000,Public       ,1,11,12,15,125,140
03200500,YOUNGSTOWN COLLEGE OF MASSOTHERAPY      ,OH,44471-2321,Proprietary  ,2,6,8,20,40,60
03319300,CREATIVE IMAGES-A CERTIFIED MATRIX      ,OH,45414-2557,Proprietary  ,8,21,29,61,125,186
03319301,CREATIVE IMAGES-A CERTIFIED MATRIX      ,OH,45459-0000,Proprietary  ,13,17,30,77,134,211
03416400,VALLEY BEAUTY SCHOOL                    ,OH,43701-3624,Proprietary  ,0,7,7,13,32,45
03425300,ROSEDALE BIBLE COLLEGE                  ,OH,43029-9517,Private      ,1,4,5,64,8,72
03457300,ALLEGHENY WESLEYAN COLLEGE              ,OH,44460-9598,Private      ,0,2,2,34,11,45
03468400,NATIONAL INSTITUTE OF MASSOTHERAPY      ,OH,44319-2100,Proprietary  ,0,12,12,36,110,146
03468500,ATS INSTITUTE OF TECHNOLOGY             ,OH,44143-2216,Proprietary  ,5,59,64,47,648,695
03475400,TRI-STATE BIBLE COLLEGE                 ,OH,45680-8402,Private      ,0,3,3,5,15,20
03534400,AMERICAN INST OF ALTERNATIVE MEDICI     ,OH,43229-1113,Proprietary  ,4,19,23,53,187,240
03578300,TRI-STATE COLLEGE                       ,OH,44452-8535,Proprietary  ,0,4,4,14,38,52
03586400,MED CENTRAL COLLEGE OF NURSING          ,OH,44903-2265,Private      ,2,15,17,262,304,566
03626300,BROWN AVEDA INSTITUTE                   ,OH,44060-6212,Proprietary  ,17,16,33,96,80,176
03659300,COMPUTER QUEST LTD.                     ,OH,44130-3034,Proprietary  ,0,16,16,5,129,134
03693300,CARNEGIE INST OF INTEGRATIVE MED/MASSOTH,OH,44260-9608,Private      ,2,18,20,9,67,76
03700300,REGENCY BEAUTY INSTITUTE - CLEVELAND    ,OH,44094-0000,Proprietary  ,3,13,16,39,136,175
03726300,TEMPLE BAPTIST COLLEGE                  ,OH,45240-0000,Private      ,1,1,2,22,32,54
03744300,EDUTEK COLLEGE                          ,OH,44224-0000,Private      ,0,0,0,1,20,21
03747300,BEXLEY HALL SEMINARY                    ,OH,43209-2325,Private      ,0,2,2,0,12,12
03776400,HEALING ARTS INSTITUTE                  ,OH,43551-3138,Proprietary  ,2,4,6,18,51,69
03837300,AVEDA FREDRIC'S INSTITUTE               ,OH,45208-1304,Proprietary  ,1,0,1,16,18,34
03882300,OREGON CAREER CENTER                    ,OH,43616-2631,Public       ,0,2,2,2,13,15
04074300,HONDROS COLLEGE                         ,OH,43081-3855,Proprietary  ,0,8,8,0,8,8
04117300,DAYTON SCHOOL OF MEDICAL MASSAGE        ,OH,45429-1111,Proprietary  ,4,27,31,4,27,31
        ,INVALID SCHOOL CODE                     ,  ,00000-0000,,1258,2004,3262,29070,26621,55691
00134500,ADAMS STATE COLLEGE                     ,CO,81102-2373,Public       ,49,99,148,1977,1586,3563
00134600,ARAPAHOE COMMUNITY COLLEGE              ,CO,80160-9002,Public       ,81,194,275,1312,3155,4467
00134700,COLORADO COLLEGE                        ,CO,80903-3294,Private      ,27,5,32,2349,271,2620
00134800,COLORADO SCHOOL OF MINES                ,CO,80401-1887,Public       ,32,19,51,3126,583,3709
00134900,UNIVERSITY OF NORTHERN COLORADO         ,CO,80639-0001,Public       ,132,136,268,9099,3488,12587
00135000,COLORADO STATE UNIVERSITY               ,CO,80523-0100,Public       ,267,166,433,15376,6388,21764
00135200,DENVER  SEMINARY                        ,CO,80120-2192,Private      ,0,15,15,7,548,555
00135300,FORT LEWIS COLLEGE                      ,CO,81301-3999,Public       ,67,55,122,3154,1153,4307
00135400,ILIFF SCHOOL OF THEOLOGY                ,CO,80210-0000,Private      ,0,2,2,3,228,231
00135500,LAMAR COMMUNITY COLLEGE                 ,CO,81052-3999,Public       ,14,36,50,351,394,745
00135800,MESA STATE COLLEGE                      ,CO,81501-7682,Public       ,94,94,188,3497,2443,5940
00135900,COLORADO NORTHWESTERN COMMUNITY COLLEGE ,CO,81648-3598,Public       ,8,22,30,237,280,517
00136000,METROPOLITAN STATE CLG OF DENVER        ,CO,80204-0000,Public       ,280,501,781,7638,10901,18539
00136100,NORTHEASTERN JUNIOR COLLEGE             ,CO,80751-2399,Public       ,24,18,42,826,381,1207
00136200,OTERO JUNIOR COLLEGE                    ,CO,81050-3346,Public       ,27,55,82,526,844,1370
00136300,REGIS UNIVERSITY                        ,CO,80221-1099,Private      ,21,452,473,2000,7577,9577
00136500,COLORADO STATE UNIVERSITY-PUEBLO        ,CO,81001-4901,Public       ,45,102,147,2717,2405,5122
00136800,TRINIDAD STATE JR COLLEGE               ,CO,81082-2396,Public       ,40,113,153,658,961,1619
00137000,UNIVERSITY OF COLORADO-BOULDER          ,CO,80309-0077,Public       ,245,211,456,16191,7515,23706
00137100,UNIVERSITY OF DENVER                    ,CO,80208-2000,Private      ,50,219,269,4367,7355,11722
00137200,WESTERN STATE COLLEGE                   ,CO,81231-0000,Public       ,24,5,29,1793,429,2222
00163202,AQUINAS INSTITUTE OF THEOLOGY - AQUINAS ,CO,80903-1498,Private      ,0,0,0,0,3,3
00405702,NATIONAL AMERICAN UNIVERSITY            ,CO,80918-0000,Proprietary  ,0,5,5,8,163,171
00405703,NATIONAL AMERICAN UNIVERSITY            ,CO,80222-0000,Proprietary  ,3,6,9,12,77,89
00450300,EVEREST COLLEGE                         ,CO,80916-3548,Proprietary  ,25,171,196,152,978,1130
00450600,COLORADO MOUNTAIN COLLEGE               ,CO,81602-0000,Public       ,18,30,48,872,645,1517
00450700,EVEREST COLLEGE                         ,CO,80229-4339,Proprietary  ,110,438,548,565,2777,3342
00450701,"EVEREST COLLEGE- EVEREST COLLEGE, AURORA",CO,80012-5692,Proprietary  ,1,3,4,30,53,83
00450800,UNIVERSITY OF COLORADO DENVER           ,CO,80204-2029,Public       ,20,61,81,692,3623,4315
00450824,UNIVERSITY OF COLORADO DENVER - AURARIA ,CO,80217-3364,Public       ,83,211,294,3898,6774,10672
00450900,UNIV OF COLORADO AT COLO SPRINGS        ,CO,80918-3735,Public       ,81,137,218,4327,3830,8157
00559600,EMILY GRIFFITH OPPORTUNITY SCH          ,CO,80204-2197,Public       ,22,116,138,179,1001,1180
00729700,REDSTONE COLLEGE                        ,CO,80020-9988,Proprietary  ,23,49,72,291,494,785
00754700,LINCOLN COLLEGE OF TECHNOLOGY           ,CO,80223-2013,Proprietary  ,90,107,197,889,773,1662
00754800,WESTWOOD COLLEGE - DENVER NORTH         ,CO,80221-3653,Proprietary  ,272,1306,1578,2102,7339,9441
00754801,WESTWOOD COLLEGE - DENVER SOUTH         ,CO,80227-3653,Proprietary  ,33,104,137,386,1015,1401
00758200,AIMS COMMUNITY COLLEGE                  ,CO,80632-0000,Public       ,46,154,200,1296,2214,3510
00764900,ROCKY MOUNTAIN COLG OF ART & DESIGN     ,CO,80214-0000,Proprietary  ,10,4,14,506,172,678
00793300,FRONT RANGE COMMUNITY COLLEGE           ,CO,80031-2199,Public       ,169,377,546,3764,6773,10537
00793301,FRONT RANGE COMM COLL/LARIMER CAMP      ,CO,80526-0000,Public       ,0,0,0,6,12,18
00863500,INTELLITEC MEDICAL INSTITUTE            ,CO,80909-1570,Proprietary  ,6,54,60,76,442,518
00887100,CONCORDE CAREER INSTITUTE               ,CO,80203-0000,Proprietary  ,32,142,174,175,814,989
00889600,PIKES PEAK COMMUNITY COLLEGE            ,CO,80906-5498,Public       ,175,505,680,2868,6310,9178
00940100,COLORADO CHRISTIAN UNIVERSITY           ,CO,80226-7449,Private      ,14,131,145,1278,1720,2998
00954200,COMMUNITY COLLEGE OF DENVER             ,CO,80217-2026,Public       ,121,373,494,2180,5378,7558
00954300,RED ROCKS COMMUNITY COLLEGE             ,CO,80228-1255,Public       ,80,213,293,1411,2555,3966
00985500,YESHIVA TORAS CHAIM TALMUDICAL SEM      ,CO,80204-0067,Private      ,1,5,6,2,6,8
00998100,MORGAN COMMUNITY COLLEGE                ,CO,80701-4399,Public       ,30,58,88,271,738,1009
01014800,COLORADO TECHNICAL UNIVERSITY           ,CO,80907-3896,Proprietary  ,50,816,866,745,7479,8224
01014802,COLORADO TECHNICAL UNIV - DENVER        ,CO,80111-3201,Proprietary  ,7,90,97,108,567,675
01014805,COLORADO TECH UNIV - ON LINE            ,CO,80907-0000,Proprietary  ,425,6231,6656,1634,25945,27579
01014806,COLORADO TECH UNIV - FED EXPRESS        ,CO,80921-3800,Proprietary  ,1,8,9,6,50,56
01014807,COLORADO TECH UNIV - MCI WORLD COM      ,CO,80919-3172,Proprietary  ,1,4,5,6,24,30
01014808,COLORADO TECH UNIV - USAA               ,CO,80920-1005,Proprietary  ,0,0,0,3,9,12
01014809,COLORADO TECH UNIV - SCHRIEVER AFB      ,CO,80912-7298,Proprietary  ,0,1,1,0,2,2
01014810,COLORADO TECH UNIV - PETERSON AFB       ,CO,80914-1586,Proprietary  ,0,0,0,0,2,2
01014811,COLORADO TECH UNIV-HEWLETT PACKARD      ,CO,80919-2303,Proprietary  ,0,0,0,0,6,6
01014812,COLORADO TECHNICAL UNIVERSITY - WESTMINS,CO,80021-3498,Proprietary  ,15,109,124,108,505,613
01014813,COLORADO TECH UNIV - ORACLE             ,CO,80921-3660,Proprietary  ,0,3,3,1,20,21
01014815,COLORADO TECHNCL UNIV PUEBLO            ,CO,81003-2315,Proprietary  ,4,21,25,33,78,111
01070900,EMPIRE BEAUTY SCHOOL-LAKEWOOD           ,CO,80215-0000,Proprietary  ,6,7,13,29,49,78
01073200,SAN JUAN BASINTECHNICAL COLLEGE         ,CO,81328-9196,Public       ,4,3,7,49,153,202
01157200,COLORADO SCHOOL OF TRADES               ,CO,80215-2996,Proprietary  ,8,24,32,92,209,301
01267000,BEL-REA INST OF ANIMAL TECH             ,CO,80247-3048,Proprietary  ,13,42,55,370,545,915
01285000,INTERNATIONAL SALON AND SPA ACADEMY     ,CO,80918-3684,Proprietary  ,19,39,58,73,176,249
01287500,PICKENS TECHNICAL COLLEGE               ,CO,80011-9307,Public       ,5,31,36,167,359,526
01300700,NAZARENE BIBLE COLLEGE                  ,CO,80910-3717,Private      ,1,42,43,47,568,615
02059400,INTERNATIONAL BEAUTY ACADEMY            ,CO,80918-3684,Proprietary  ,0,3,3,30,96,126
02072200,EMPIRE BEAUTY SCHOOL -ARVADA            ,CO,80212-0000,Proprietary  ,10,18,28,51,107,158
02078900,ART INSTITUTE OF COLORADO (THE)         ,CO,80203-2983,Proprietary  ,92,107,199,2274,2000,4274
02116300,PUEBLO COMMUNITY COLLEGE                ,CO,81004-0000,Public       ,110,344,454,1487,4151,5638
02117500,NAROPA UNIVERSITY                       ,CO,80302-0000,Private      ,3,13,16,282,1086,1368
02133100,COLORADO CENTER FOR MEDICAL LABORATORY S,CO,80218-0000,Private      ,0,3,3,9,43,52
02141100,ARTISTIC BEAUTY COLGS-WESTMINSTER       ,CO,80030-0000,Proprietary  ,22,46,68,103,230,333
02141102,ARTISTIC BEAUTY COLLEGES-LITTLETON      ,CO,80123-3480,Proprietary  ,2,13,15,7,18,25
02141103,ARTISTIC BEAUTY COLLEGES-AURORA         ,CO,80017-3194,Proprietary  ,7,12,19,26,83,109
02156200,DELTA - MONTROSE TECHNICAL COLLEGE      ,CO,81416-0000,Public       ,3,5,8,58,124,182
02159000,AMERICAN DIESEL & AUTO COLLEGE          ,CO,80223-0000,Proprietary  ,0,0,0,1,1,2
02160600,EMPIRE BEAUTY SCHOOL -THORNTON          ,CO,80241-1659,Proprietary  ,12,31,43,60,142,202
02165200,SALON PROFESSIONAL ACADEMY (THE)        ,CO,81504-5309,Proprietary  ,5,10,15,27,48,75
02167600,KAPLAN COLLEGE                          ,CO,80229-5309,Proprietary  ,13,67,80,110,362,472
02171300,TRINIDAD STATE JUNIOR COLLEGE           ,CO,81101-0000,Proprietary  ,0,0,0,2,4,6
02188700,DENVER ACAD OF COURT REPORTING          ,CO,80030-0000,Proprietary  ,5,23,28,21,159,180
02211901,CHEEKS INTERNATIONAL ACADEMY OF BEAUTY C,CO,80525-3053,Proprietary  ,0,1,1,9,23,32
02211902,CHEEKS INTERNATIONAL ACDMY BTY CULT     ,CO,80631-0000,Proprietary  ,0,0,0,3,20,23
02253700,INTELLITEC COLLEGE                      ,CO,80909-0000,Proprietary  ,23,83,106,113,516,629
02267500,GLENWOOD BEAUTY ACADEMY                 ,CO,81601-0000,Proprietary  ,0,2,2,15,34,49
02276900,COMMUNITY COLLEGE OF AURORA             ,CO,80011-9036,Public       ,77,224,301,1196,3035,4231
02321700,ITT TECHNICAL INSTITUTE                 ,CO,80229-5338,Proprietary  ,74,131,205,520,993,1513
02518500,HAIR DYNAMICS EDUCATION CENTER          ,CO,80525-0000,Proprietary  ,12,15,27,80,124,204
02594300,COLLEGE AMERICA - DENVER                ,CO,80222-3380,Proprietary  ,22,115,137,227,1120,1347
02611000,HERITAGE COLLEGE                        ,CO,80212-7413,Proprietary  ,30,177,207,180,856,1036
03006300,INST OF BUSINESS & MEDICAL CAREERS      ,CO,80525-3044,Proprietary  ,17,61,78,184,670,854
03012100,REMINGTON COLLEGE - COLORADO SPRINGS CAM,CO,80215-0000,Proprietary  ,6,27,33,80,438,518
03013100,BOULDER COLLEGE OF MASSAGE THERAPY      ,CO,80301-3295,Private      ,6,16,22,79,181,260
03014900,PLATT COLLEGE                           ,CO,80014-3141,Proprietary  ,3,19,22,57,160,217
03027400,XENON INTERNATIONAL ACADEMY III         ,CO,80014-1193,Proprietary  ,3,5,8,40,57,97
03030606,UTAH COLLEGE OF MASSAGE THERAPY - DENVER,CO,80031-2921,Proprietary  ,13,32,45,127,208,335
03030607,UTAH COLLEGE OF MASSAGE THERAPY - DENVER,CO,80012-2523,Proprietary  ,23,38,61,134,263,397
03031603,DPT BUSINESS SCHOOL                     ,CO,80223-0000,Proprietary  ,0,1,1,2,7,9
03066900,INTELLITEC COLLEGE                      ,CO,81506-3994,Proprietary  ,27,96,123,166,720,886
03068201,OHIO CENTER FOR BROADCASTING - COLORADO ,CO,80214-4129,Proprietary  ,10,30,40,47,120,167
03289300,COLORADO HEIGHTS UNIVERSITY             ,CO,80236-2711,Private      ,2,19,21,13,117,130
03306300,MONTESSORI EDUC CRT OF THE ROCKIES      ,CO,80301-2587,Private      ,0,2,2,5,37,42
03474400,CENTER OF ADVANCED THERAPEUTICS         ,CO,80210-1629,Proprietary  ,0,0,0,1,7,8
03534300,JONES INTERNATIONAL UNIVERSITY          ,CO,80112-3446,Proprietary  ,4,232,236,17,1364,1381
03545300,UNIVERSITY OF THE ROCKIES               ,CO,80903-3612,Proprietary  ,0,9,9,4,155,159
03584400,COLORADO SCHOOL OF HEALING ARTS         ,CO,80226-4332,Proprietary  ,5,32,37,60,298,358
03670300,TONI & GUY HAIRDRESSING ACADEMY         ,CO,80911-1713,Proprietary  ,2,4,6,48,67,115
03686300,COLORADO SCHOOL OF TRADITIONAL CHINESE M,CO,80206-2127,Proprietary  ,0,11,11,5,121,126
03805300,CORTIVA INSTITUTE-COLORADO              ,CO,80021-0000,Proprietary  ,4,9,13,12,49,61
03972300,CUTTIN' UP BEAUTY ACADEMY               ,CO,80220-0000,Proprietary  ,1,5,6,8,46,54
03976300,MASSAGE THERAPY INSTITUTE OF COLORADO   ,CO,80206-2127,Proprietary  ,5,10,15,21,75,96
04093300,ACADEMY OF NATURAL THERAPY              ,CO,80631-3425,Proprietary  ,3,19,22,8,25,33
00267811,BRYANT & STRATTON COLLEGE - VIRGINIA BEA,VA,23462-4417,Proprietary  ,16,122,138,242,1383,1625
00370200,AVERETT UNIVERSITY                      ,VA,24541-3692,Private      ,22,219,241,1213,1335,2548
00370300,BLUEFIELD COLLEGE                       ,VA,24605-1799,Private      ,6,63,69,582,703,1285
00370400,BRIDGEWATER COLLEGE                     ,VA,22812-1599,Private      ,22,0,22,2140,101,2241
00370500,COLLEGE OF WILLIAM & MARY               ,VA,23187-8795,Public       ,53,28,81,7084,3138,10222
00370600,CHRISTOPHER NEWPORT UNIVERSITY          ,VA,23606-2998,Public       ,54,26,80,5389,829,6218
00370700,RICHARD BLAND COLLEGE                   ,VA,23805-7100,Public       ,20,8,28,540,305,845
00370800,EASTERN MENNONITE UNIVERSITY            ,VA,22802-2462,Private      ,2,27,29,996,418,1414
00370900,EMORY & HENRY COLLEGE                   ,VA,24327-0010,Private      ,11,2,13,1503,113,1616
00371100,FERRUM COLLEGE                          ,VA,24088-2612,Private      ,22,1,23,1765,195,1960
00371200,TIDEWATER COMMUNITY COLLEGE             ,VA,23510-1910,Public       ,228,681,909,5808,11620,17428
00371300,HAMPDEN-SYDNEY COLLEGE                  ,VA,23943-0128,Private      ,9,0,9,1010,29,1039
00371400,HAMPTON UNIVERSITY                      ,VA,23668-0099,Private      ,172,59,231,8908,2440,11348
00371500,HOLLINS UNIVERSITY                      ,VA,24020-0000,Private      ,6,19,25,868,524,1392
00371900,LONGWOOD UNIVERSITY                     ,VA,23909-1899,Public       ,32,16,48,3924,508,4432
00372000,LYNCHBURG COLLEGE                       ,VA,24501-3199,Private      ,23,21,44,2690,512,3202
00372100,JAMES MADISON UNIVERSITY                ,VA,22807-3780,Public       ,141,34,175,15304,1661,16965
00372300,MARY BALDWIN COLLEGE                    ,VA,24401-3610,Private      ,8,31,39,1108,800,1908
00372400,MARYMOUNT UNIVERSITY                    ,VA,22207-4224,Private      ,32,64,96,2215,1803,4018
00372600,NATIONAL COLLEGE                        ,VA,24153-4524,Proprietary  ,96,742,838,814,5473,6287
00372700,NORTHERN VA CMTY CLG                    ,VA,22003-3743,Public       ,252,518,770,5517,7495,13012
00372800,OLD DOMINION UNIVERSITY                 ,VA,23529-0052,Public       ,179,306,485,11677,9582,21259
00373200,RADFORD UNIVERSITY                      ,VA,24142-6905,Public       ,64,33,97,6945,1838,8783
00373300,RANDOLPH-MACON COLLEGE                  ,VA,23005-5505,Private      ,15,0,15,1535,57,1592
00373400,RANDOLPH COLLEGE                        ,VA,24503-1526,Private      ,8,2,10,774,112,886
00373500,VIRGINIA COMMONWEALTH UNIVERSITY        ,VA,23284-9004,Public       ,256,253,509,15132,10497,25629
00373600,ROANOKE COLLEGE                         ,VA,24153-3794,Private      ,11,4,15,2285,166,2451
00373700,SHENANDOAH UNIVERSITY                   ,VA,22601-5195,Private      ,26,29,55,1827,1497,3324
00373800,SOUTHERN VIRGINIA UNIVERSITY            ,VA,24416-3038,Private      ,15,4,19,819,230,1049
00373900,ST PAULS COLLEGE                        ,VA,23868-1299,Private      ,10,23,33,612,380,992
00374200,SWEET BRIAR COLLEGE                     ,VA,24595-9998,Private      ,7,0,7,624,52,676
00374300,UNION THEO SEMINARY & PRESBYTRN SCH     ,VA,23227-0000,Private      ,0,1,1,1,121,122
00374400,UNIVERSITY OF RICHMOND                  ,VA,23173-0001,Private      ,27,24,51,3081,1934,5015
00374500,UNIVERSITY OF VIRGINIA - SFS            ,VA,22903-0000,Public       ,151,85,236,12611,7071,19682
00374600,UNIVERSITY OF MARY WASHINGTON           ,VA,22401-5358,Public       ,31,30,61,3473,723,4196
00374700,UNIV OF VIRGINIA'S COLLEGE AT WISE      ,VA,24293-4412,Public       ,15,6,21,1676,413,2089
00374800,EASTERN SHORE COMMUNITY COLLEGE         ,VA,23410-3000,Public       ,4,16,20,253,419,672
00374900,GEORGE MASON UNIVERSITY                 ,VA,22030-4444,Public       ,231,288,519,11422,10135,21557
00375100,PATRICK HENRY COMMUNITY COLLEGE         ,VA,24112-5311,Public       ,20,113,133,725,1688,2413
00375200,VIRGINIA INTERMONT COLLEGE              ,VA,24201-4298,Private      ,10,10,20,628,472,1100
00375300,VIRGINIA MILITARY INSTITUTE             ,VA,24450-2138,Public       ,11,0,11,1275,63,1338
00375400,VIRGINIA POLYTECH INST & STATE UNIV     ,VA,24061-2000,Public       ,160,93,253,19672,3748,23420
00375800,DANVILLE COMMUNITY COLLEGE              ,VA,24541-4004,Public       ,46,123,169,985,2054,3039
00375900,J. SARGEANT REYNOLDS COMMUNITY CLG      ,VA,23285-0000,Public       ,79,212,291,2341,4869,7210
00376000,VIRGINIA WESTERN CMTY COLLEGE           ,VA,24038-0000,Public       ,36,130,166,1395,2597,3992
00376100,WYTHEVILLE COMMUNITY COLLEGE            ,VA,24382-3308,Public       ,21,63,84,649,1402,2051
00376200,VIRGINIA UNIVERSITY OF LYNCHBURG        ,VA,24501-6400,Private      ,1,8,9,38,141,179
00376400,VIRGINIA STATE UNIVERSITY               ,VA,23806-0001,Public       ,151,51,202,7438,2003,9441
00376500,NORFOLK STATE UNIVERSITY                ,VA,23504-8000,Public       ,104,116,220,7463,4651,12114
00376600,VIRGINIA UNION UNIVERSITY               ,VA,23220-1711,Private      ,35,20,55,2620,789,3409
00376700,VIRGINIA WESLEYAN COLLEGE               ,VA,23502-5599,Private      ,21,10,31,1609,511,2120
00376800,WASHINGTON & LEE UNIVERSITY             ,VA,24450-0303,Private      ,10,3,13,1595,1114,2709
00400400,JOHN TYLER COMMUNITY COLLEGE            ,VA,23831-5316,Public       ,32,138,170,1658,3148,4806
00498800,CENTRAL VIRGINIA COMMUNITY COLLEGE      ,VA,24502-2498,Public       ,22,88,110,906,1395,2301
00499200,MILLER-MOTTE TECHNICAL COLLEGE          ,VA,24505-0000,Proprietary  ,8,48,56,99,426,525
00499600,DABNEY S LANCASTER COMMUNITY CLG        ,VA,24422-1000,Public       ,9,26,35,403,452,855
00522300,NEW RIVER COMMUNITY COLLEGE             ,VA,24084-1127,Public       ,21,62,83,1089,1454,2543
00607500,ROANOKE MEM HOSP SCH RAD ONCOLOGY       ,VA,24033-0000,Private      ,0,1,1,1,4,5
00607501,ROANOKE MEM HOSP SCH RAD TECH           ,VA,24014-1850,Private      ,0,1,1,2,4,6
00662200,COLLEGE OF HEALTH SCIENCES - CHRV       ,VA,24031-0000,Private      ,6,19,25,408,709,1117
00681900,BLUE RIDGE COMMUNITY COLLEGE            ,VA,24486-0080,Public       ,18,64,82,1145,1182,2327
00687100,THOMAS NELSON COMMUNITY COLLEGE         ,VA,23670-0000,Public       ,57,204,261,2122,4482,6604
00709900,VIRGINIA HIGHLANDS COMMUNITY CLG        ,VA,24210-4210,Public       ,24,55,79,928,1113,2041
00726000,SOUTHWEST VIRGINIA COMMUNITY CLG        ,VA,24641-1510,Public       ,36,146,182,1058,1699,2757
00859200,LOUISE OBICI SCHOOL OF NURSING          ,VA,23434-8038,Private      ,1,1,2,11,32,43
00859202,SUFFOLK PUB SCH-LOUISE OBICI SCH PN     ,VA,23434-0000,Private      ,0,0,0,2,7,9
00865900,LORD FAIRFAX COMMUNITY COLLEGE          ,VA,22645-0047,Public       ,32,60,92,909,1242,2151
00866000,GERMANNA COMMUNITY COLLEGE              ,VA,22508-0339,Public       ,30,73,103,804,1213,2017
00866100,SOUTHSIDE VIRGINIA CMTY CLG             ,VA,23821-2930,Public       ,65,230,295,1090,2386,3476
00915900,PAUL D CAMP COMMUNITY COLLEGE           ,VA,23851-0737,Public       ,15,59,74,298,819,1117
00916000,RAPPAHANNOCK COMMUNITY COLLEGE          ,VA,23149-2616,Public       ,17,54,71,486,740,1226
00926700,EVEREST COLLEGE                         ,VA,23606-4203,Proprietary  ,54,311,365,223,1439,1662
00942000,SANFORD-BROWN COLLEGE                   ,VA,22182-3913,Proprietary  ,40,64,104,457,656,1113
00953500,STAUNTON SCHOOL OF COSMETOLOGY          ,VA,24401-4323,Proprietary  ,1,3,4,18,28,46
00953700,VIRGINIA SCH OF HAIR DESIGN             ,VA,23669-0000,Proprietary  ,1,15,16,36,153,189
00962900,MOUNTAIN EMPIRE COMMUNITY COLLEGE       ,VA,24219-0700,Public       ,39,126,165,986,1634,2620
00992800,PIEDMONT VIRGINIA COMMUNITY COLLEGE     ,VA,22902-7589,Public       ,37,81,118,909,1244,2153
00995800,HICKS ACADEMY OF BEAUTY CULTURE         ,VA,23707-3218,Proprietary  ,0,9,9,10,56,66
01004300,BON SECOURS MEMORIAL SCH OF NURSING     ,VA,23227-4612,Private      ,4,8,12,167,495,662
01019800,ECPI COLLEGE OF TECHNOLOGY              ,VA,23462-6542,Proprietary  ,323,1307,1630,1894,6684,8578
01033800,EASTERN VIRGINIA MEDICAL SCHOOL         ,VA,23501-1980,Private      ,1,11,12,20,1025,1045
01159600,RALPH'S VIRGINIA SCH OF COSMETOLOGY     ,VA,24501-2652,Proprietary  ,2,7,9,20,32,52
01162601,WESTWOOD COLLEGE - SOUTH BAY - ARLINGTON,VA,22203-4167,Proprietary  ,21,40,61,21,45,66
01162602,WESTWOOD COLLEGE - SOUTH BAY - ANNANDALE,VA,22003-2602,Proprietary  ,16,39,55,17,42,59
01274401,SOUTHSIDE REGIONAL MED CTR PROF SCHOOLS ,VA,23803-5133,Proprietary  ,2,1,3,68,234,302
01274402,SOUTHSIDE REG MED CTR SCH RAD TECH      ,VA,23803-0000,Proprietary  ,0,0,0,5,31,36
02053000,LIBERTY UNIVERSITY                      ,VA,24502-0000,Private      ,169,1146,1315,11475,11507,22982
02108800,WARDS CORNER BEAUTY ACADEMY             ,VA,23505-0000,Proprietary  ,8,59,67,46,249,295
02111600,DANVILLE REGIONAL MEDICAL CENTER SCHOOL ,VA,24541-0000,Proprietary  ,0,2,2,34,102,136
02128700,CENTRAL SCHOOL OF PRACTICAL NURSING     ,VA,23502-2230,Public       ,1,2,3,3,8,11
02140000,RIVERSIDE SCHOOL OF HEALTH CAREERS      ,VA,23608-3802,Private      ,2,9,11,62,260,322
02140001,RIVERSIDE SCHOOL OF HEALTH CAREERS-PRACT,VA,23601-3802,Private      ,0,0,0,25,111,136
02140002,RIVERSIDE SCHOOL OF RADIOLOGIC TECH     ,VA,23601-0000,Private      ,0,0,0,6,34,40
02175800,LYNCHBURG GENERAL HOSP SCH OF NURSG     ,VA,24501-0000,Private      ,1,2,3,66,137,203
02197600,WOODROW WILSON REHABILITATION CTR       ,VA,22939-0000,Public       ,12,11,23,43,37,80
02223100,HERITAGE INSTITUTE                      ,VA,22046-4400,Proprietary  ,3,12,15,51,220,271
02242400,HENRICO CTY ST MARYS HOSP PRAC NRSG     ,VA,23075-0000,Public       ,0,0,0,8,46,54
02247200,MEDSPA CAREERS INSTITUTE                ,VA,23606-0000,Proprietary  ,69,215,284,539,2271,2810
02304500,HERITAGE INSTITUTE                      ,VA,20111-0000,Proprietary  ,20,97,117,101,321,422
02320900,TIDEWATER TECH                          ,VA,23517-0000,Proprietary  ,9,26,35,68,176,244
02334400,CENTURA COLLEGE                         ,VA,23452-0000,Proprietary  ,55,484,539,471,3315,3786
02340000,COLONIAL HEIGHTS BEAUTY ACADEMY         ,VA,23834-0000,Proprietary  ,3,18,21,24,73,97
02342700,FORTIS COLLEGE                          ,VA,23502-4101,Proprietary  ,9,54,63,100,273,373
02342701,FORTIS COLLEGE - RICHMOND CAMPUS        ,VA,23236-3472,Proprietary  ,2,29,31,69,167,236
02535400,ECPI TECHNICAL COLLEGE                  ,VA,23236-0000,Proprietary  ,77,118,195,478,709,1187
02538800,SUFFOLK BEAUTY ACADEMY                  ,VA,23434-0000,Proprietary  ,0,26,26,12,87,99
02541200,STRATFORD UNIVERSITY                    ,VA,22043-0000,Proprietary  ,16,67,83,193,460,653
02541201,STRATFORD UNIVERSITY-WOODBRIDGE         ,VA,22192-0000,Proprietary  ,0,6,6,25,88,113
02549800,NEW HORIZONS TECH SCH PR NSG            ,VA,23666-0000,Public       ,0,0,0,10,34,44
02567300,BRAXTON SCHOOL OF BUSINESS (THE)        ,VA,23230-0000,Proprietary  ,3,6,9,28,76,104
02588901,SANZ SCHOOL                             ,VA,22044-0000,Proprietary  ,0,1,1,2,19,21
02605900,TESST COLLEGE OF TECHNOLOGY             ,VA,22312-6342,Proprietary  ,13,85,98,115,447,562
02610100,WASHINGTON COUNTY ADULT SKILL CTR       ,VA,24210-2346,Public       ,5,34,39,25,131,156
03002400,GRAHAM WEBB INTERNATIONAL ACAD HAIR     ,VA,22209-2129,Proprietary  ,16,16,32,58,70,128
03010700,BAR PALMA BEAUTY CAREERS  ACADEMY       ,VA,24014-2255,Proprietary  ,2,7,9,21,60,81
03042800,"VIRGINIA BEACH CITY SCHOOLS, SCH.-PR.NSG",VA,23456-0038,Public       ,1,1,2,16,53,69
03091100,ACT COLLEGE                             ,VA,22209-2297,Proprietary  ,19,163,182,147,749,896
03091300,REGENT UNIVERSITY                       ,VA,23464-9800,Private      ,15,182,197,340,4546,4886
03092700,ECPI TECHNICAL COLLEGE-ROANOKE          ,VA,24012-1603,Proprietary  ,18,67,85,119,417,536
03096500,SPRINGFIELD BEAUTY ACADEMY              ,VA,22003-3016,Proprietary  ,4,13,17,12,126,138
03106500,SENTARA NORFOLK GENERAL HOSPITAL        ,VA,23320-2843,Private      ,12,22,34,142,590,732
03116900,BAPTIST THEOLOGICAL SEM.-RICHMOND       ,VA,23227-0000,Private      ,0,4,4,3,59,62
03126300,TIDEWATER TECH AVIATION                 ,VA,23320-5987,Proprietary  ,10,58,68,66,366,432
03126400,CENTURA COLLEGE                         ,VA,23235-5230,Proprietary  ,19,76,95,140,582,722
03126401,CENTURA COLLEGE - WEST                  ,VA,23294-0000,Proprietary  ,0,3,3,12,39,51
03127500,ADVANCED TECHNOLOGY INSTITUTE           ,VA,23462-2409,Proprietary  ,33,46,79,401,368,769
03280400,VIRGINIA SCHOOL OF MASSAGE              ,VA,22903-0000,Proprietary  ,5,17,22,41,108,149
03409500,RICHMOND SCHOOL OF HEALTH AND TECH      ,VA,23227-0000,Proprietary  ,9,95,104,126,743,869
03455300,CRESCENT COSMETOLOGY UNIVERSITY         ,VA,23666-3115,Proprietary  ,0,1,1,5,15,20
03559300,APPALACHIAN SCHOOL OF LAW               ,VA,24614-0000,Private      ,0,2,2,9,655,664
03638400,TAP THIS VALLEY WORKS CTR FOR EMPLO     ,VA,24016-1901,Private      ,0,3,3,1,21,22
03645400,RUDY & KELLY ACADEMY OF HAIR AND NA     ,VA,23464-6857,Proprietary  ,9,12,21,64,91,155
03654300,CAREER TRAINING SOLUTIONS               ,VA,22406-1014,Proprietary  ,5,41,46,39,282,321
03709300,EDWARD VIA VIRGINIA CLG OSTEOPATHIC MED ,VA,24060-6360,Private      ,0,0,0,7,637,644
03872400,INSTITUTE FOR THE PSYCHOLOGICAL SCIENCES,VA,22202-3609,Private      ,0,0,0,0,59,59
03876300,CULPEPER COSMETOLOGY TRAINING CENTER    ,VA,22701-3155,Public       ,1,1,2,6,24,30
03883400,AVIATION INSTITUTE OF MAINTENANCE       ,VA,20110-4156,Proprietary  ,10,26,36,49,141,190
03966300,CENTRAL BAPTIST THEOLOGICAL SEMINARY OF ,VA,23464-6847,Private      ,0,2,2,1,7,8
04038400,AVI CAREER INSTITUTE                    ,VA,22066-1839,Proprietary  ,1,4,5,2,17,19
00107000,THUNDERBIRD SCHOOL OF GLOBAL MANAGEMENT ,AZ,85306-6000,Private      ,0,15,15,2,517,519
00107100,ARIZONA WESTERN COLLEGE                 ,AZ,85366-0000,Public       ,77,159,236,2415,2487,4902
00107200,COCHISE COLLEGE                         ,AZ,85607-6190,Public       ,32,103,135,1046,1737,2783
00107300,EASTERN ARIZONA COLLEGE                 ,AZ,85552-0769,Public       ,43,52,95,1128,974,2102
00107400,GRAND CANYON UNIVERSITY                 ,AZ,85017-3030,Proprietary  ,45,1359,1404,924,11843,12767
00107600,GLENDALE COMMUNITY COLLEGE              ,AZ,85302-3090,Public       ,160,336,496,4571,6047,10618
00107700,MESA COMMUNITY COLLEGE                  ,AZ,85202-4866,Public       ,254,484,738,5946,8348,14294
00107800,PHOENIX COLLEGE                         ,AZ,85013-4234,Public       ,109,333,442,2679,5097,7776
00107900,YAVAPAI COLLEGE                         ,AZ,86301-3297,Public       ,45,146,191,1117,1718,2835
00108100,ARIZONA STATE UNIV (ALL CAMPUSES)       ,AZ,85287-0412,Public       ,495,646,1141,29689,23463,53152
00108200,NORTHERN ARIZONA UNIVERSITY             ,AZ,86011-0001,Public       ,169,340,509,10978,9340,20318
00108300,UNIVERSITY OF ARIZONA                   ,AZ,85721-0066,Public       ,306,236,542,17891,11211,29102
00165701,MIDWESTERN UNIVERSITY                   ,AZ,85308-0000,Private      ,1,13,14,66,1774,1840
00446700,TUCSON COLLEGE                          ,AZ,85710-0000,Proprietary  ,42,148,190,164,792,956
00711300,SOUTHWESTERN COLLEGE                    ,AZ,85032-7097,Private      ,10,3,13,238,109,347
00726600,PIMA COUNTY COMMUNITY COLLEGE           ,AZ,85709-1110,Public       ,285,633,918,6377,9615,15992
00728300,CENTRAL ARIZONA COLLEGE                 ,AZ,85228-9779,Public       ,54,121,175,1116,1666,2782
00822100,UNIVERSAL TECHNICAL INSTITUTE           ,AZ,85323-7946,Proprietary  ,624,480,1104,11354,4931,16285
00824600,DINè COLLEGE                            ,AZ,86556-0126,Public       ,46,102,148,630,1164,1794
00830300,GATEWAY COMMUNITY COLLEGE               ,AZ,85034-1795,Public       ,46,179,225,898,3205,4103
00830302,MARICOPA SKILL CENTER                   ,AZ,85034-0000,Public       ,18,68,86,186,637,823
00830400,SCOTTSDALE COMMUNITY COLLEGE            ,AZ,85250-0000,Public       ,84,150,234,2047,2666,4713
00886400,ARIZONA ACADEMY OF BEAUTY               ,AZ,85712-5021,Proprietary  ,3,5,8,25,59,84
00886500,ARTISTIC BEAUTY COLLEGES-TUCSON         ,AZ,85716-3999,Proprietary  ,28,50,78,215,332,547
00886501,ARTISTIC BEAUTY COLLEGES - TUCSON  - NOR,AZ,85705-1665,Proprietary  ,13,17,30,86,140,226
00945100,BROWN MACKIE COLLEGE                    ,AZ,85712-5300,Proprietary  ,17,63,80,130,487,617
01084700,ARIZONA AUTOMOTIVE INSTITUTE            ,AZ,85301-3503,Proprietary  ,49,108,157,437,766,1203
01085800,AVALON SCHOOL OF COSMETOLOGY            ,AZ,85210-4010,Proprietary  ,12,20,32,87,183,270
01157000,PIMA MEDICAL INSTITUTE-MESA             ,AZ,85202-2950,Proprietary  ,7,16,23,72,207,279
01168900,REFRIGERATION SCHOOL                    ,AZ,85034-0000,Proprietary  ,15,93,108,66,440,506
01180200,ARIZONA ACADEMY OF BEAUTY-NORTH         ,AZ,85705-2720,Proprietary  ,1,11,12,21,65,86
01180800,ARTISTIC BEAUTY COLLEGES-FLAGSTAFF      ,AZ,86004-5119,Proprietary  ,23,54,77,133,302,435
01180801,CLG OF BEAUTY ARTS & SCI/CHANDLER       ,AZ,85224-0000,Proprietary  ,8,25,33,60,169,229
01180802,CLG OF BEAUTY ARTS & SCI/PRESCOTT       ,AZ,86303-0000,Proprietary  ,12,19,31,41,85,126
01186200,NORTHLAND PIONEER COLLEGE               ,AZ,86025-2996,Public       ,24,100,124,380,1164,1544
01186400,MOHAVE COMMUNITY COLLEGE                ,AZ,86409-1238,Public       ,78,332,410,780,2894,3674
01218400,INTERNATIONAL ACAD OF HAIR DESIGN       ,AZ,85225-7198,Proprietary  ,11,15,26,77,100,177
01234300,ARTISTIC BEAUTY COLLEGES-PHOENIX        ,AZ,85304-0000,Proprietary  ,15,41,56,112,217,329
01234301,EMPIRE BEAUTY SCHOOL - AVONDALE         ,AZ,85323-2352,Proprietary  ,1,12,13,32,54,86
01293700,ARTISTIC BEAUTY COLLEGES - PARADISE VALL,AZ,85257-0000,Proprietary  ,2,7,9,29,51,80
02065200,ITT TECHNICAL INSTITUTE                 ,AZ,85282-0000,Proprietary  ,146,309,455,882,1954,2836
02065300,PRESCOTT COLLEGE                        ,AZ,86301-0000,Private      ,3,50,53,342,1026,1368
02071200,KAPLAN COLLEGE                          ,AZ,85029-4349,Proprietary  ,11,61,72,133,457,590
02098800,UNIVERSITY OF PHOENIX                   ,AZ,85040-0000,Proprietary  ,2908,67332,70240,11948,284664,296612
02100500,UNIVERSAL TECHNICAL INSTITUTE           ,AZ,85027-0000,Proprietary  ,438,468,906,7103,5760,12863
02100600,APOLLO COLLEGE                          ,AZ,85015-0000,Proprietary  ,236,695,931,1329,3814,5143
02113800,ROBERTO-VENN SCH OF LUTHIERY            ,AZ,85040-0000,Proprietary  ,4,2,6,33,33,66
02146600,SOUTH MOUNTAIN COMMUNITY COLLEGE        ,AZ,85040-0000,Public       ,57,115,172,1056,1654,2710
02171500,WESTERN INTERNATIONAL UNIVERSITY        ,AZ,85021-0000,Proprietary  ,69,1466,1535,770,17023,17793
02171545,AXIA- (WESTERN INTERNATIONAL UNIVERSITY),AZ,85210-4803,Proprietary  ,0,0,0,0,41,41
02173300,DEVOE COLLEGE OF BEAUTY                 ,AZ,85635-0000,Proprietary  ,4,12,16,16,39,55
02174900,COLLINS COLLEGE                         ,AZ,85040-4000,Proprietary  ,112,126,238,2355,1579,3934
02177500,RIO SALADO COMMUNITY COLLEGE            ,AZ,85281-0000,Public       ,64,569,633,616,5316,5932
02181300,LONG TECHNICAL COLLEGE                  ,AZ,85008-6915,Proprietary  ,1,0,1,25,160,185
02192300,MARICOPA BEAUTY COLLEGE                 ,AZ,85323-0000,Proprietary  ,5,8,13,47,60,107
02199900,AMERICAN INDIAN CLG-ASSEMBLIES GOD      ,AZ,85021-0000,Private      ,4,3,7,44,45,89
02217100,PIMA MEDICAL INSTITUTE                  ,AZ,85716-0000,Proprietary  ,334,851,1185,1586,4897,6483
02218800,BROOKLINE COLLEGE                       ,AZ,85019-1600,Proprietary  ,39,304,343,224,1827,2051
02220300,ARTISTIC BEAUTY COLLEGES-GLENDALE       ,AZ,85051-0000,Proprietary  ,13,22,35,78,151,229
02263100,ANTHEM COLLEGE                          ,AZ,85014-0000,Proprietary  ,516,1669,2185,3749,10531,14280
02280500,CHARLES OF ITALY BEAUTY COLLEGE         ,AZ,86403-0000,Proprietary  ,11,18,29,31,87,118
02295000,EVEREST COLLEGE                         ,AZ,85021-1610,Proprietary  ,84,739,823,437,2925,3362
02317800,AMERICAN INSTITUTE OF TECHNOLOGY        ,AZ,85043-0000,Proprietary  ,10,214,224,41,926,967
02342401,ACADEMY OF RADIO BROADCASTING           ,AZ,85008-0000,Proprietary  ,0,0,0,5,23,28
02361100,ITT TECHNICAL INSTITUTE                 ,AZ,85704-0000,Proprietary  ,68,126,194,556,956,1512
02491500,THE ART CENTER DESIGN COLLEGE           ,AZ,85716-0000,Proprietary  ,34,32,66,241,465,706
02521500,LAMSON COLLEGE                          ,AZ,85284-1141,Proprietary  ,31,158,189,130,659,789
02559000,UNIVERSITY OF ADVANCING TECHNOLOGY      ,AZ,85283-0000,Proprietary  ,33,48,81,1022,702,1724
02561900,TONI AND GUY HAIRDRESSING ACADEMY       ,AZ,85251-3301,Proprietary  ,32,20,52,179,144,323
02582700,CORTIVA INSTITUTE - TUCSON              ,AZ,85710-3503,Proprietary  ,8,24,32,50,126,176
02602500,NORTHERN ARIZONA INSTITUTE OF TECHNOLOGY,AZ,86001-0000,Proprietary  ,0,0,0,1,0,1
02616700,SCOTTSDALE CULINARY INSTITUTE           ,AZ,85251-2729,Proprietary  ,130,271,401,1386,2169,3555
02623600,PARADISE VALLEY COMMUNITY COLLEGE       ,AZ,85032-1210,Public       ,76,123,199,1411,2255,3666
02623800,CORTIVA INSTITUTE - SCOTTSDALE          ,AZ,85257-4218,Proprietary  ,9,24,33,46,160,206
03004700,MUNDUS INSTITUTE                        ,AZ,85015-3665,Proprietary  ,0,0,0,13,37,50
03005000,SAFFORD COLLEGE OF BEAUTY CULTURE       ,AZ,85546-3309,Proprietary  ,3,11,14,11,36,47
03010613,VIRGINIA COLLEGE - GOLF ACADEMY OF ARIZO,AZ,85225-6742,Proprietary  ,4,14,18,123,148,271
03030604,UTAH COLLEGE OF MASSAGE THERAPY - ARIZON,AZ,85282-0000,Proprietary  ,30,36,66,193,345,538
03030605,UTAH COLLEGE OF MASSAGE THERAPY - ARIZON,AZ,85051-3470,Proprietary  ,27,62,89,168,364,532
03034400,CONSERVATORY RECORDING ARTS & SCIS      ,AZ,85282-1707,Proprietary  ,39,46,85,449,553,1002
03072200,CHANDLER-GILBERT COMMUNITY COLLEGE      ,AZ,85225-2499,Public       ,58,109,167,1731,2220,3951
03076400,BRYMAN SCHOOL OF ARIZONA                ,AZ,85029-4919,Proprietary  ,366,714,1080,3043,4951,7994
03081200,METROPOLITAN COLLEGE                    ,AZ,85040-0000,Private      ,0,0,0,2,7,9
03097800,CARSTEN INSTITUTE OF HAIR & BEAUTY      ,AZ,85282-5404,Proprietary  ,12,15,27,120,138,258
03100400,COCONINO COUNTY COMMUNITY COLLEGE       ,AZ,86001-2701,Public       ,39,66,105,835,1229,2064
03107000,SOUTHWEST CLG OF NATUROPATHIC MED       ,AZ,85282-0000,Private      ,0,17,17,3,401,404
03115000,ARIZONA COLLEGE OF ALLIED HEALTH        ,AZ,85302-3843,Proprietary  ,11,64,75,54,389,443
03120300,COLLEGE AMERICA                         ,AZ,86004-3936,Proprietary  ,11,38,49,170,383,553
03156300,ESTRELLA MOUNTAIN COMMUNITY COLLEGE     ,AZ,85392-1010,Public       ,51,107,158,1126,1817,2943
03156301,ESTRELLA MOUNTAIN COMMUNITY COLLEGE - SO,AZ,85392-1010,Public       ,7,30,37,153,427,580
03347300,INTERNATIONAL BAPTIST COLLEGE           ,AZ,85282-6799,Private      ,0,3,3,34,22,56
03445300,HDS TRUCK DRIVING INSTITUTE             ,AZ,85731-0000,Proprietary  ,5,47,52,9,136,145
03478400,PHOENIX SEMINARY                        ,AZ,85018-7611,Private      ,0,8,8,0,8,8
03572300,EAST VALLEY INSTITUTE OF TECHNOLOGY     ,AZ,85201-6910,Public       ,3,8,11,50,92,142
03593300,SOUTHWEST INSTITUTE OF HEALING ARTS     ,AZ,85281-3658,Proprietary  ,8,34,42,68,408,476
03617500,PHOENIX INSTITUTE OF HERBAL MEDICINE & A,AZ,85012-0000,Proprietary  ,0,6,6,6,72,78
03695500,ARIZONA SCHOOL OF ACUPUNCTURE AND ORIENT,AZ,85712-1100,Proprietary  ,0,2,2,6,43,49
03740500,ART INSTITUTE OF TUCSON (THE)           ,AZ,85712-2732,Proprietary  ,12,18,30,102,117,219
03784400,TOHONO O'ODHAM COMMUNITY COLLEGE        ,AZ,85634-3129,Public       ,1,3,4,16,81,97
03814300,TURNING POINT BEAUTY COLLEGE            ,AZ,85222-4229,Proprietary  ,1,2,3,1,24,25
04051300,ART INSTITUTE OF PHOENIX (THE)          ,AZ,85021-2859,Proprietary  ,50,54,104,490,420,910
04059300,TUCSON COLLEGE OF BEAUTY                ,AZ,85705-2451,Proprietary  ,6,10,16,28,34,62
00142800,DELAWARE STATE UNIVERSITY               ,DE,19901-2277,Public       ,106,53,159,5020,1525,6545
00142900,GOLDEY BEACOM COLLEGE                   ,DE,19808-1993,Private      ,16,33,49,533,401,934
00143100,UNIVERSITY OF DELAWARE                  ,DE,19716-0099,Public       ,182,86,268,17444,2204,19648
00143300,WESLEY COLLEGE                          ,DE,19901-3875,Private      ,27,11,38,2217,330,2547
00143301,WESLEY COLLEGE-CTR FOR ADULT STUDIE     ,DE,19720-0000,Private      ,7,59,66,41,439,480
00331301,WIDENER UNIV SCHOOL OF LAW - DE         ,DE,19803-0000,Private      ,0,14,14,23,1664,1687
00705300,DELAWARE TECH & CMTY COLLEGE-OWENS      ,DE,19947-0000,Public       ,35,134,169,1213,1827,3040
00794800,WILMINGTON UNIVERSITY                   ,DE,19720-6491,Private      ,44,272,316,1330,4282,5612
01172700,DELAWARE TECH & CMTY CLG-TERRY          ,DE,19901-8736,Public       ,39,88,127,1008,1540,2548
01195002,DELAWARE COLLEGE OF ART & DESIGN        ,DE,19801-0000,Private      ,10,5,15,280,64,344
02125200,BEEBE SCHOOL OF NURSING                 ,DE,19958-1462,Private      ,2,0,2,30,47,77
02144900,DELAWARE TECH & CMTY CLG-STANTN/WLM     ,DE,19801-0000,Public       ,61,111,172,1894,2825,4719
02190400,SCHILLING DOUGLAS SCH OF HAIR DSGN      ,DE,19711-0000,Proprietary  ,8,22,30,84,138,222
02586902,STAR TECHNICAL INSTITUTE -              ,DE,19901-4615,Proprietary  ,2,36,38,32,274,306
03021000,HARRISON CAREER INSTITUTE               ,DE,19804-3259,Proprietary  ,0,0,0,6,54,60
03025800,DAWN TRAINING CENTRE                    ,DE,19805-1511,Proprietary  ,3,63,66,57,382,439
03543300,HARRIS SCHOOL OF BUSINESS               ,DE,19803-5341,Proprietary  ,12,125,137,43,236,279
03702300,DELAWARE LEARNING INSTITUTE OF COSMETOLO,DE,19939-9759,Proprietary  ,6,6,12,21,37,58
00143400,AMERICAN UNIVERSITY                     ,DC,20016-8020,Private      ,88,102,190,10119,8680,18799
00143700,CATHOLIC UNIVERSITY OF AMERICA          ,DC,20064-0002,Private      ,34,51,85,3488,2113,5601
00143711,"CATHOLIC UNIV AMERICA, LAW SCHOOL       ",DC,20064-0000,Private      ,1,9,10,31,1605,1636
00144100,UNIV OF THE DISTRICT OF COLUMBIA        ,DC,20008-0000,Public       ,67,148,215,1800,3552,5352
00144102,UNIVERSITY OF THE DISTRICT OF COLUMBIA -,DC,20008-1173,Public       ,1,2,3,44,613,657
00144300,GALLAUDET UNIVERSITY                    ,DC,20002-3695,Private      ,14,11,25,855,822,1677
00144400,GEORGE WASHINGTON UNIVERSITY            ,DC,20052-2353,Private      ,95,227,322,10899,7805,18704
00144402,GEORGE WASHINGTON UNIV LAW SCHL         ,DC,20052-0000,Private      ,2,8,10,24,3800,3824
00144403,GEORGE WASHINGTON UNIV SCH MED          ,DC,20052-0000,Private      ,1,1,2,29,1124,1153
00144500,GEORGETOWN UNIVERSITY                   ,DC,20057-1252,Private      ,102,79,181,9819,4480,14299
00144501,"GEORGETOWN UNIV, SCH OF MEDICINE        ",DC,20007-0000,Private      ,2,6,8,32,1146,1178
00144503,GEORGETOWN UNIV LAW CENTER              ,DC,20001-0000,Private      ,1,14,15,22,4800,4822
00144800,HOWARD UNIVERSITY                       ,DC,20059-0001,Private      ,183,110,293,11533,7832,19365
00145600,SOUTHEASTERN UNIVERSITY                 ,DC,20024-2788,Private      ,10,59,69,179,955,1134
00145900,STRAYER UNIVERSITY                      ,DC,20005-2603,Proprietary  ,167,3599,3766,1174,29122,30296
00146000,TRINITY UNIVERSITY                      ,DC,20017-1004,Private      ,14,61,75,770,1438,2208
00146400,WESLEY THEOLOGICAL SEMINARY             ,DC,20016-0000,Private      ,0,15,15,0,285,285
00207701,JOHNS HOPKINS UNIV SCH ADV INTL STU     ,DC,20036-0000,Private      ,1,17,18,27,1179,1206
01006500,WASHINGTON THEOLOGICAL UNION            ,DC,20012-0000,Private      ,0,1,1,0,36,36
01195000,THE CORCORAN COLLEGE OF ART & DESIG     ,DC,20006-4804,Private      ,11,10,21,462,302,764
01266500,HARRISON CTR FOR CAREER EDUCATION       ,DC,20001-5303,Private      ,0,0,0,3,108,111
01280300,DOMINICAN HOUSE OF STUDIES              ,DC,20017-1584,Private      ,0,0,0,0,6,6
02132800,NAT'L CONSERVATORY DRAMATIC ARTS        ,DC,20007-2758,Private      ,2,3,5,7,18,25
02279200,DUDLEY BEAUTY COLG-WASHINGTON           ,DC,20018-0000,Proprietary  ,3,18,21,59,153,212
02588900,SANZ SCHOOL                             ,DC,20006-0000,Proprietary  ,48,286,334,290,1272,1562
03104300,CAREER BLAZERS LEARNING CENTER OF WASHIN,DC,20037-1881,Proprietary  ,15,91,106,75,513,588
03218300,POTOMAC COLLEGE                         ,DC,20016-1860,Proprietary  ,7,76,83,28,470,498
03409600,BENNETT CAREER INSTITUTE                ,DC,20017-1754,Proprietary  ,8,30,38,74,203,277
03750300,TECHNICAL LEARNING CENTERS              ,DC,20005-3415,Proprietary  ,6,32,38,25,236,261
00154100,ABRAHAM BALDWIN AGRICULTURAL CLG        ,GA,31794-0000,Public       ,70,67,137,2691,1484,4175
00154200,AGNES SCOTT COLLEGE                     ,GA,30030-3797,Private      ,12,12,24,1126,300,1426
00154300,DARTON COLLEGE                          ,GA,31707-3098,Public       ,75,231,306,2078,3852,5930
00154400,ALBANY STATE UNIVERSITY                 ,GA,31705-2796,Public       ,118,124,242,5688,3272,8960
00154500,ANDREW COLLEGE                          ,GA,39840-1313,Private      ,10,1,11,420,47,467
00154600,ARMSTRONG ATLANTIC STATE UNIVERSITY     ,GA,31419-1997,Public       ,70,187,257,3594,4765,8359
00154700,ATLANTA CHRISTIAN COLLEGE               ,GA,30344-1999,Private      ,4,6,10,415,161,576
00154900,ATLANTA COLLEGE OF ART                  ,GA,30309-3549,Private      ,0,0,0,141,71,212
00155200,AUGUSTA STATE UNIVERSITY                ,GA,30904-2200,Public       ,75,178,253,4142,4397,8539
00155400,BERRY COLLEGE                           ,GA,30149-5007,Private      ,14,5,19,1931,186,2117
00155500,THOMAS UNIVERSITY                       ,GA,31792-7499,Private      ,7,30,37,271,792,1063
00155600,BRENAU UNIVERSITY                       ,GA,30501-3668,Private      ,24,108,132,1047,2298,3345
00155700,BREWTON PARKER COLLEGE                  ,GA,30445-0000,Private      ,12,49,61,745,888,1633
00155800,COASTAL GEORGIA COMMUNITY COLLEGE       ,GA,31520-3644,Public       ,48,109,157,1255,2379,3634
00155900,CLARK ATLANTA UNIVERSITY                ,GA,30314-4385,Private      ,277,132,409,11756,4141,15897
00156000,COLUMBIA THEOLOGICAL SEMINARY           ,GA,30031-0000,Private      ,1,10,11,3,202,205
00156100,COLUMBUS STATE UNIVERSITY               ,GA,31907-5645,Public       ,87,186,273,5015,4128,9143
00156200,GEORGIA PERIMETER COLLEGE               ,GA,30021-0000,Public       ,313,669,982,9426,12669,22095
00156300,EMMANUEL COLLEGE                        ,GA,30639-0000,Private      ,5,5,10,627,199,826
00156400,EMORY UNIVERSITY                        ,GA,30322-1960,Private      ,91,141,232,8099,7186,15285
00156600,FORT VALLEY STATE UNIVERSITY            ,GA,31030-3298,Public       ,72,46,118,3175,1377,4552
00156700,GAINESVILLE STATE COLLEGE               ,GA,30503-0000,Public       ,119,141,260,3462,1872,5334
00156800,INTERDENOMINATIONAL THEOLOGY CENTER     ,GA,30314-0000,Private      ,1,20,21,5,538,543
00156900,GEORGIA INSTITUTE OF TECHNOLOGY         ,GA,30332-0002,Public       ,177,107,284,11754,3116,14870
00157000,SOUTHERN POLYTECHNIC STATE UNIV         ,GA,30060-2896,Public       ,49,79,128,2046,1676,3722
00157100,GEORGIA MILITARY COLLEGE                ,GA,31061-3398,Public       ,142,301,443,2411,3387,5798
00157200,GEORGIA SOUTHERN UNIVERSITY             ,GA,30460-8065,Public       ,372,132,504,14263,4636,18899
00157300,GEORGIA SOUTHWESTERN STATE UNIV         ,GA,31709-4693,Public       ,33,49,82,1685,1478,3163
00157400,GEORGIA STATE UNIVERSITY                ,GA,30303-3010,Public       ,384,645,1029,17968,18861,36829
00157500,GORDON COLLEGE                          ,GA,30204-1762,Public       ,75,73,148,3074,1666,4740
00157700,KENNESAW STATE UNIVERSITY               ,GA,30144-5591,Public       ,218,418,636,10004,9115,19119
00157800,LAGRANGE COLLEGE                        ,GA,30240-2999,Private      ,12,24,36,1234,541,1775
00157900,MEDICAL COLLEGE OF GEORGIA              ,GA,30912-0004,Public       ,7,60,67,521,2199,2720
00158000,MERCER UNIVERSITY                       ,GA,31207-0003,Private      ,59,279,338,3486,6357,9843
00158100,MIDDLE GEORGIA COLLEGE                  ,GA,31014-1599,Public       ,52,56,108,2684,1461,4145
00158200,MOREHOUSE COLLEGE                       ,GA,30314-3773,Private      ,102,31,133,4056,775,4831
00158500,NORTH GEORGIA COLLEGE & STATE UNIV      ,GA,30597-0001,Public       ,55,77,132,2800,1557,4357
00158600,OGLETHORPE UNIVERSITY                   ,GA,30319-2737,Private      ,20,17,37,1083,426,1509
00158700,PAINE COLLEGE                           ,GA,30901-3182,Private      ,30,23,53,1459,470,1929
00158800,PIEDMONT COLLEGE                        ,GA,30535-5644,Private      ,18,131,149,695,1664,2359
00158900,REINHARDT COLLEGE                       ,GA,30183-2981,Private      ,21,13,34,894,298,1192
00159000,SAVANNAH STATE UNIVERSITY               ,GA,31404-5298,Public       ,87,56,143,4918,2066,6984
00159100,SHORTER COLLEGE                         ,GA,30165-4298,Private      ,20,357,377,1361,2588,3949
00159200,SOUTH GEORGIA COLLEGE                   ,GA,31533-8104,Public       ,34,47,81,1093,794,1887
00159400,SPELMAN COLLEGE                         ,GA,30314-4399,Private      ,117,38,155,4982,890,5872
00159600,TOCCOA FALLS COLLEGE                    ,GA,30598-0001,Private      ,10,3,13,1027,207,1234
00159700,TRUETT MCCONNELL COLLEGE                ,GA,30528-1264,Private      ,10,3,13,486,56,542
00159800,UNIVERSITY OF GEORGIA                   ,GA,30602-6114,Public       ,350,297,647,17656,9414,27070
00159900,VALDOSTA STATE UNIVERSITY               ,GA,31698-0001,Public       ,171,160,331,8801,4128,12929
00160000,WESLEYAN COLLEGE                        ,GA,31210-4407,Private      ,7,18,25,402,474,876
00160100,UNIV OF WEST GEORGIA                    ,GA,30118-0002,Public       ,113,185,298,7677,3928,11605
00160200,GEORGIA COLLEGE & STATE UNIVERSITY      ,GA,31061-0490,Public       ,76,69,145,4460,1714,6174
00160400,YOUNG HARRIS COLLEGE                    ,GA,30582-4137,Private      ,14,1,15,726,32,758
00348400,COVENANT COLLEGE                        ,GA,30750-4164,Private      ,10,25,35,1124,417,1541
00395600,DALTON STATE COLLEGE                    ,GA,30720-3797,Public       ,54,131,185,1806,2223,4029
00402400,GEORGIA NORTHWESTERN TECHNICAL COLLEGE  ,GA,30161-6757,Public       ,59,295,354,663,2113,2776
00402403,NORTHWESTERN TECHNICAL COLLEGE          ,GA,30739-0569,Public       ,44,202,246,486,1734,2220
00411700,GRADY HEALTH SYSTEM                     ,GA,30303-3050,Public       ,2,12,14,74,210,284
00525400,LANIER TECHNICAL COLLEGE                ,GA,30566-3499,Public       ,23,156,179,577,1921,2498
00525500,MOULTRIE TECHNICAL COLLEGE              ,GA,31768-0000,Public       ,63,300,363,517,2079,2596
00525600,VALDOSTA TECHNICAL COLLEGE              ,GA,31603-0000,Public       ,47,176,223,913,2484,3397
00551100,OKEFENOKEE TECHNICAL COLLEGE            ,GA,31501-4016,Public       ,41,170,211,372,1366,1738
00559900,AUGUSTA TECHNICAL COLLEGE               ,GA,30906-3399,Public       ,108,423,531,1697,5019,6716
00560000,ATHENS TECHNICAL COLLEGE                ,GA,30601-1579,Public       ,92,302,394,1313,3006,4319
00560100,ALBANY TECHNICAL COLLEGE                ,GA,31701-2648,Public       ,88,324,412,1005,3484,4489
00561300,FLINT RIVER TECHNICAL INSTITUTE         ,GA,30286-0014,Public       ,12,102,114,141,873,1014
00561500,SOUTHWEST GEORGIA TECHNICAL COLLEGE     ,GA,31792-2622,Public       ,33,145,178,568,1772,2340
00561700,SOUTH GEORGIA TECHNICAL COLLEGE         ,GA,31709-8167,Public       ,36,137,173,621,1308,1929
00561800,SAVANNAH TECHNICAL COLLEGE              ,GA,31405-5594,Public       ,172,648,820,1761,5879,7640
00561900,NORTH GEORGIA TECHNICAL COLLEGE         ,GA,30523-0000,Public       ,65,202,267,761,1716,2477
00562000,CHATTAHOOCHEE TECHNICAL COLLEGE         ,GA,30060-3398,Public       ,107,261,368,1864,4024,5888
00562004,NORTH METRO TECHNICAL COLLEGE           ,GA,30102-3129,Public       ,19,89,108,333,984,1317
00562005,APPALACHIAN TECHNICAL COLLEGE           ,GA,30143-0000,Public       ,20,67,87,267,695,962
00562100,GRIFFIN TECHNICAL COLLEGE               ,GA,30223-2097,Public       ,69,277,346,814,2616,3430
00562200,DEKALB TECHNICAL COLLEGE                ,GA,30021-0000,Public       ,74,362,436,1185,4666,5851
00562400,COLUMBUS TECHNICAL COLLEGE              ,GA,31904-6572,Public       ,77,419,496,981,3497,4478
00576300,CENTRAL GEORGIA TECHNICAL COLLEGE       ,GA,31206-3628,Public       ,126,564,690,1512,6347,7859
00772800,MACON STATE COLLEGE                     ,GA,31206-5145,Public       ,99,235,334,2717,4906,7623
00854300,ATLANTA TECHNICAL COLLEGE               ,GA,30310-4499,Public       ,112,393,505,1344,4423,5767
00897600,CLAYTON STATE UNIVERSITY                ,GA,30260-0285,Public       ,68,239,307,4266,6301,10567
00918300,EAST CENTRAL TECHNICAL COLLEGE          ,GA,31750-0000,Public       ,30,132,162,259,935,1194
00927000,ART INSTITUTE OF ATLANTA                ,GA,30328-1649,Proprietary  ,254,332,586,4041,3078,7119
00950700,GEORGIA HIGHLANDS COLLEGE               ,GA,30162-0000,Public       ,66,93,159,2105,2102,4207
01031903,MEDIX SCHOOL                            ,GA,30080-7630,Proprietary  ,38,146,184,194,760,954
01048700,WEST GEORGIA TECHNICAL COLLEGE          ,GA,30182-6476,Public       ,54,264,318,1104,3031,4135
01048704,WEST GEORGIA TECHNICAL COLLEGE          ,GA,30240-5957,Public       ,18,155,173,369,1521,1890
01077100,GUPTON JONES COLLEGE                    ,GA,30035-4022,Private      ,10,33,43,118,254,372
01099700,EAST GEORGIA COLLEGE                    ,GA,30401-2699,Public       ,60,44,104,1428,782,2210
01107400,BAINBRIDGE COLLEGE                      ,GA,39819-8400,Public       ,76,212,288,926,2585,3511
01110901,EVEREST COLLEGE - EVEREST INSTITUTE     ,GA,30067-8340,Proprietary  ,1,8,9,16,57,73
01157400,BAUDER COLLEGE                          ,GA,30313-2439,Proprietary  ,40,119,159,686,964,1650
01205100,PRO WAY HAIR SCHOOL                     ,GA,30083-2884,Proprietary  ,10,51,61,61,251,312
01216500,ATLANTA METROPOLITAN COLLEGE            ,GA,30310-4498,Public       ,68,117,185,1756,2601,4357
01303900,SOUTH UNIVERSITY                        ,GA,31406-4881,Proprietary  ,103,1114,1217,604,5311,5915
02055000,WAYCROSS COLLEGE                        ,GA,31503-0000,Public       ,13,28,41,483,696,1179
02060900,BROWN CLG OF COURT REPORTING & M.T.     ,GA,30318-2570,Proprietary  ,1,21,22,22,317,339
02074800,LIFE UNIVERSITY                         ,GA,30060-0000,Private      ,10,62,72,236,1672,1908
02089700,HERZING COLLEGE                         ,GA,30326-1332,Proprietary  ,38,105,143,205,895,1100
02110501,ART INSTITUTE OF CHARLOTTE (THE) - BROWN,GA,30319-3054,Proprietary  ,2,4,6,7,18,25
02113604,AMERICAN INTERCONTINENTAL UNIV - DUNWOOD,GA,30328-1649,Proprietary  ,39,203,242,1028,3222,4250
02116000,SANFORD-BROWN COLLEGE                   ,GA,30328-4803,Proprietary  ,93,497,590,676,3668,4344
02141500,SAVANNAH COLLEGE OF ART & DESIGN        ,GA,31402-3146,Private      ,149,88,237,6826,2642,9468
02202800,AUGUSTA AREA DIET INTERN UNIV HOSP      ,GA,30901-0000,Private      ,0,0,0,3,22,25
02205300,SAVANNAH RIVER COLLEGE                  ,GA,30909-0000,Proprietary  ,8,66,74,69,425,494
02217200,PORTFOLIO CENTER                        ,GA,30309-0000,Proprietary  ,0,15,15,28,160,188
02266200,AMERICAN PROFESSIONAL INSTITUTE         ,GA,31201-0000,Proprietary  ,26,180,206,125,835,960
02279500,HEART OF GEORGIA TECHNICAL COLLEGE      ,GA,31021-0000,Public       ,20,111,131,365,1179,1544
02284300,INTERACTIVE COLLEGE OF TECHNOLOGY       ,GA,30341-0000,Proprietary  ,53,279,332,233,1391,1624
02284308,INTERACTIVE LEARNING SYSTEMS            ,GA,30260-0000,Proprietary  ,4,49,53,46,242,288
02284309,INTERACTIVE COLLEGE OF TECHNOLOGY       ,GA,30501-0000,Proprietary  ,3,51,54,24,206,230
02285500,"CREATIVE CIRCUS, THE                    ",GA,30324-0000,Proprietary  ,10,21,31,57,263,320
02288400,GWINNETT TECHNICAL INSTITUTE            ,GA,30043-5702,Public       ,148,389,537,1638,4320,5958
02313902,WESTWOOD COLLEGE - O'HARE AIRPORT - ATLA,GA,30345-2807,Proprietary  ,22,42,64,177,297,474
02318600,GEORGIA MEDICAL INSTITUTE               ,GA,30303-0000,Proprietary  ,130,681,811,721,3133,3854
02321400,ROFFLER-MOLER HAIRSTYLING COLLEGE       ,GA,30062-0000,Proprietary  ,4,17,21,36,126,162
02354500,SOUTHEASTERN BEAUTY SCHOOLS             ,GA,31906-0000,Proprietary  ,6,40,46,22,198,220
02482100,MOREHOUSE SCHOOL OF MEDICINE            ,GA,30310-0000,Private      ,4,5,9,102,501,603
02502700,ADVANCED CAREER TRAINING                ,GA,30329-0000,Proprietary  ,34,81,115,134,477,611
02502701,ADVANCED CAREER TRAINING-RIVERDALE      ,GA,30274-0000,Proprietary  ,19,107,126,103,552,655
02508600,MIDDLE GEORGIA TECHNICAL COLLEGE        ,GA,31088-0000,Public       ,75,202,277,721,1799,2520
02520000,INTERNATIONAL SCH SKIN & NAILCARE       ,GA,30342-1119,Proprietary  ,6,72,78,33,284,317
02577000,ARNOLD / PADRICKS  UNIV OF COSM         ,GA,30297-0000,Proprietary  ,1,15,16,21,67,88
02577700,BEAUTY COLLEGE OF AMERICA               ,GA,30297-0000,Proprietary  ,4,12,16,33,84,117
02578300,INTERNATIONAL CITY BEAUTY COLLEGE       ,GA,31093-3631,Proprietary  ,0,10,10,10,37,47
02580200,ATLANTA SCHOOL OF MASSAGE               ,GA,30338-0000,Proprietary  ,16,66,82,90,291,381
02583000,GWINNETT COLLEGE OF BUSINESS            ,GA,30047-3447,Proprietary  ,9,91,100,105,584,689
02607600,CAPELLI LEARNING CTR FOR COSM           ,GA,30324-0000,Proprietary  ,4,31,35,49,178,227
03005400,ARTISTIC BEAUTY COLLEGE                 ,GA,30013-2076,Proprietary  ,41,135,176,251,675,926
03022601,WESTERN CULINARY INSTITUTE - LE CORDON B,GA,30084-5893,Proprietary  ,6,6,12,99,107,206
03030000,OGEECHEE TECHNICAL COLLEGE              ,GA,30458-8049,Public       ,97,265,362,860,1826,2686
03032100,ALTAMAHA TECHNICAL COLLEGE              ,GA,31545-4465,Public       ,24,134,158,287,1014,1301
03042700,LAURUSTECHNICAL INSTITUTE               ,GA,30030-1506,Proprietary  ,12,116,128,60,521,581
03066500,SOUTHEASTERN TECHNICAL COLLEGE          ,GA,30474-8817,Public       ,19,111,130,280,1060,1340
03066502,SWAINSBORO TECHNICAL COLLEGE            ,GA,30401-5700,Public       ,21,73,94,203,643,846
03072304,EVEREST COLLEGE - EVEREST INSTITUTE     ,GA,30236-0000,Proprietary  ,7,12,19,67,192,259
03076300,BEULAH HEIGHTS BIBLE COLLEGE            ,GA,30316-1873,Private      ,1,45,46,30,589,619
03079202,WESTWOOD COLLEGE - ATLANTA MIDTOWN      ,GA,30309-2848,Proprietary  ,40,84,124,435,566,1001
03081500,SOUTHEASTERN BEAUTY SCHOOL              ,GA,31917-0000,Proprietary  ,5,40,45,24,196,220
03089100,GEORGIA INSTITUTE OF COSMETOLOGY        ,GA,30606-3152,Proprietary  ,11,41,52,80,290,370
03090600,COBB BEAUTY COLLEGE                     ,GA,30144-2828,Proprietary  ,2,11,13,22,66,88
03100900,LUTHER RICE UNIVERSITY                  ,GA,30038-2454,Private      ,0,39,39,22,519,541
03102000,RIVERTOWN SCHOOL OF BEAUTY              ,GA,31904-4747,Proprietary  ,7,37,44,43,187,230
03104500,ATLANTA INSTITUTE OF MUSIC              ,GA,30096-4988,Proprietary  ,8,11,19,98,107,205
03116100,VOGUE BEAUTY SCHOOL                     ,GA,30141-2226,Proprietary  ,7,27,34,31,116,147
03155500,SANDERSVILLE REGIONAL TECH INST         ,GA,31082-6179,Public       ,10,73,83,159,564,723
03173300,ATLANTA'S JOHN MARSHALL LAW SCHOOL      ,GA,30309-0000,Proprietary  ,0,9,9,12,676,688
03232303,COMPUTER-ED INSTITUTE-                  ,GA,30071-0000,Proprietary  ,12,99,111,110,631,741
03232304,LINCOLN COLLEGE OF TECHNOLOGY           ,GA,30067-8638,Proprietary  ,29,107,136,161,603,764
03251300,BEACON UNIVERSITY                       ,GA,31909-4663,Private      ,0,12,12,38,309,347
03355402,PSYCHOLOGICAL STUDIES INSTITUTE -       ,GA,30327-2921,Private      ,0,4,4,2,46,48
03391300,ROSS MEDICAL EDUCATION CENTER           ,GA,30033-3105,Proprietary  ,2,23,25,15,159,174
03418300,GWINNETT COLLEGE-SANDY SPRINGS          ,GA,30328-3161,Proprietary  ,6,32,38,21,196,217
03445500,FAYETTE BEAUTY ACADEMY                  ,GA,30214-1191,Proprietary  ,2,5,7,22,44,66
03522300,POWDER SPRINGS BEAUTY COLLEGE           ,GA,30127-2926,Proprietary  ,0,15,15,4,63,67
03523300,AVIATION INSTITUTE OF MAINTENANCE       ,GA,30045-6716,Proprietary  ,15,66,81,113,380,493
03576300,GEORGIA AVIATION AND TECHNICAL COLL     ,GA,31023-0000,Public       ,6,10,16,104,131,235
03753400,MICHAEL'S SCHOOL OF BEAUTY              ,GA,31211-1493,Proprietary  ,1,34,35,20,145,165
03762300,INSTITUTE FOR MEDICAL SERVICES CERTIFICA,GA,30340-2702,Private      ,0,0,0,9,17,26
03804400,JAVELIN TECHNICAL TRAINING CENTER       ,GA,30339-6040,Proprietary  ,72,284,356,194,1112,1306
03812300,OMNITECH INSTITUTE                      ,GA,30035-1206,Proprietary  ,15,89,104,92,407,499
04021300,AUGUSTA SCHOOL OF MASSAGE               ,GA,30809-0000,Proprietary  ,5,11,16,15,38,53
04091300,SAVANNAH SCHOOL OF MASSAGE THERAPY      ,GA,31406-2711,Private      ,0,5,5,0,5,5
04105300,NIGHTINGALE MEDICAL INSTITUTE           ,GA,30084-4036,Proprietary  ,3,27,30,3,27,30
        ,CHICAGO THEOLOGICAL SEMINARY            ,IL,60637-0000,Private      ,0,3,3,3,160,163
00162800,AMERICAN ACADEMY OF ART                 ,IL,60604-4302,Proprietary  ,7,1,8,491,124,615
00163300,AUGUSTANA COLLEGE                       ,IL,61201-2296,Private      ,17,2,19,3285,154,3439
00163400,AURORA UNIVERSITY                       ,IL,60506-4892,Private      ,18,78,96,1977,1947,3924
00163500,BARAT COLLEGE                           ,IL,60045-3297,Private      ,0,0,0,2,12,14
00163600,SOUTHWESTERN ILLINOIS COLLEGE           ,IL,62221-5899,Public       ,154,375,529,3089,5695,8784
00163800,BLACK HAWK COLLEGE                      ,IL,61265-5899,Public       ,53,112,165,1967,2866,4833
00163900,BLACKBURN COLLEGE                       ,IL,62626-1498,Private      ,2,4,6,919,140,1059
00164000,PRAIRIE STATE COLLEGE                   ,IL,60411-8226,Public       ,63,192,255,1607,3265,4872
00164100,BRADLEY UNIVERSITY                      ,IL,61625-0002,Private      ,41,33,74,5859,1053,6912
00164300,SPOON RIVER COLLEGE                     ,IL,61520-8907,Public       ,14,32,46,658,713,1371
00164700,CITY COLLEGES OF CHICAGO                ,IL,60606-6998,Public       ,7,19,26,270,557,827
00164800,TRUMAN COLLEGE                          ,IL,60640-5691,Public       ,67,198,265,1625,3445,5070
00164900,RICHARD J DALEY COLLEGE                 ,IL,60652-1299,Public       ,116,232,348,2091,3518,5609
00165000,CITY COLLEGES OF CHICAGO-MALCOLM X      ,IL,60612-3197,Public       ,113,347,460,1744,4745,6489
00165200,HAROLD WASHINGTON COLLEGE               ,IL,60601-2403,Public       ,195,318,513,3375,5076,8451
00165400,KENNEDY KING COLLEGE                    ,IL,60621-3798,Public       ,99,465,564,1439,5298,6737
00165500,WRIGHT COLLEGE                          ,IL,60634-1591,Public       ,110,164,274,2864,3246,6110
00165700,MIDWESTERN UNIVERSITY                   ,IL,60515-1200,Private      ,3,9,12,171,2413,2584
00165900,ROSALIND FRANKLIN UNIVERSITY OF MEDICINE,IL,60064-3095,Private      ,0,27,27,9,1897,1906
00166300,SPERTUS COLLEGE                         ,IL,60605-1995,Private      ,0,9,9,2,62,64
00166400,UNIVERSITY OF ST FRANCIS                ,IL,60435-6188,Private      ,9,62,71,1232,1579,2811
00166495,ST JOSEPH COLLEGE OF NURSING            ,IL,60435-0000,Private      ,0,0,0,10,24,34
00166500,COLUMBIA COLLEGE                        ,IL,60605-1996,Private      ,197,148,345,9391,4526,13917
00166600,CONCORDIA UNIVERSITY                    ,IL,60305-1499,Private      ,12,147,159,1274,2458,3732
00166900,DANVILLE AREA COMMUNITY COLLEGE         ,IL,61832-5199,Public       ,31,96,127,791,1386,2177
00167100,DEPAUL UNIVERSITY                       ,IL,60604-2287,Private      ,151,464,615,13264,12090,25354
00167400,EASTERN ILLINOIS UNIVERSITY             ,IL,61920-3099,Public       ,93,76,169,8844,2817,11661
00167500,ELGIN COMMUNITY COLLEGE                 ,IL,60123-7193,Public       ,54,96,150,1951,2431,4382
00167600,ELMHURST COLLEGE                        ,IL,60126-3296,Private      ,23,36,59,2660,1080,3740
00167800,EUREKA COLLEGE                          ,IL,61530-9976,Private      ,5,1,6,714,150,864
00168100,HIGHLAND COMMUNITY COLLEGE              ,IL,61032-9341,Public       ,25,61,86,691,930,1621
00168200,GARRETT-EVANGELICAL THEOLOGICAL SEM     ,IL,60201-0000,Private      ,0,7,7,2,191,193
00168400,GREENVILLE COLLEGE                      ,IL,62246-1199,Private      ,12,28,40,1393,627,2020
00168500,HEBREW THEOLOGICAL COLLEGE              ,IL,60077-3263,Private      ,5,1,6,281,14,295
00168800,ILLINOIS COLLEGE                        ,IL,62650-2299,Private      ,8,3,11,1445,104,1549
00168900,ILLINOIS COLLEGE OF OPTOMETRY           ,IL,60616-3878,Private      ,0,1,1,15,654,669
00169100,ILLINOIS INSTITUTE OF TECHNOLOGY        ,IL,60616-0000,Private      ,33,46,79,2653,1484,4137
00169103,CHICAGO KENT COLLEGE OF LAW             ,IL,60661-0000,Private      ,0,17,17,8,2019,2027
00169200,ILLINOIS STATE UNIVERSITY               ,IL,61790-1000,Public       ,150,109,259,15503,4312,19815
00169300,NORTHEASTERN ILLINOIS UNIV              ,IL,60625-4699,Public       ,85,140,225,4596,5575,10171
00169400,CHICAGO STATE UNIVERSITY                ,IL,60628-1598,Public       ,92,262,354,4549,8716,13265
00169600,ILLINOIS WESLEYAN UNIVERSITY            ,IL,61701-0000,Private      ,15,2,17,2677,69,2746
00169800,JOHN MARSHALL LAW SCHOOL                ,IL,60604-0000,Private      ,1,28,29,9,2372,2381
00169900,JOLIET JUNIOR COLLEGE                   ,IL,60431-8938,Public       ,69,156,225,3107,3474,6581
00170000,JUDSON UNIVERSITY                       ,IL,60123-1498,Private      ,7,74,81,806,801,1607
00170100,KASKASKIA COLLEGE                       ,IL,62801-7878,Public       ,37,120,157,1041,1912,2953
00170300,KENDALL COLLEGE                         ,IL,60622-4278,Proprietary  ,27,86,113,662,967,1629
00170400,KNOX COLLEGE                            ,IL,61401-4999,Private      ,10,3,13,1799,73,1872
00170500,ILLINOIS VALLEY COMMUNITY COLLEGE       ,IL,61348-9692,Public       ,25,54,79,880,1228,2108
00170600,LAKE FOREST COLLEGE                     ,IL,60045-2399,Private      ,10,5,15,1577,118,1695
00170700,LEWIS UNIVERSITY                        ,IL,60446-2200,Private      ,38,127,165,3044,2343,5387
00170800,LINCOLN CHRISTIAN UNIVERSITY            ,IL,62656-2167,Private      ,1,29,30,608,592,1200
00170900,LINCOLN COLLEGE                         ,IL,62656-1699,Private      ,22,22,44,1136,320,1456
00171000,LOYOLA UNIVERSITY CHICAGO               ,IL,60626-0000,Private      ,131,227,358,13527,8272,21799
00171002,LOYOLA STRITCH SCHOOL OF MEDICINE       ,IL,60153-0000,Private      ,0,1,1,13,894,907
00171200,LUTHERAN SCHOOL OF THEOL AT CHICAGO     ,IL,60615-0000,Private      ,0,1,1,1,170,171
00171600,MACCORMAC COLLEGE                       ,IL,60602-4405,Private      ,2,14,16,94,186,280
00171700,MACMURRAY COLLEGE                       ,IL,62650-2590,Private      ,6,9,15,818,288,1106
00172100,MCCORMICK THEOLOGICAL SEMINARY          ,IL,60615-5108,Private      ,0,3,3,1,113,114
00172200,MCKENDREE UNIVERSITY                    ,IL,62254-1299,Private      ,16,85,101,1561,1369,2930
00172300,MEADVILLE LOMBARD THEOLOGICAL SCHOOL    ,IL,60637-1602,Private      ,0,2,2,1,76,77
00172400,MILLIKIN UNIVERSITY                     ,IL,62522-2084,Private      ,23,33,56,2841,783,3624
00172500,MONMOUTH COLLEGE                        ,IL,61462-1963,Private      ,13,2,15,1844,95,1939
00172800,MORTON COLLEGE                          ,IL,60804-4398,Public       ,72,102,174,1215,1516,2731
00173200,NATIONAL UNIV OF HEALTH SCIENCES        ,IL,60148-4583,Private      ,4,24,28,72,623,695
00173300,NATIONAL-LOUIS UNIVERSITY               ,IL,60603-3032,Private      ,8,535,543,305,6966,7271
00173400,NORTH CENTRAL COLLEGE                   ,IL,60540-4690,Private      ,18,20,38,2345,567,2912
00173500,NORTH PARK UNIVERSITY                   ,IL,60625-4895,Private      ,41,59,100,2202,1226,3428
00173600,NORTHERN BAPTIST THEOL SEMINARY         ,IL,60148-0000,Private      ,0,0,0,2,23,25
00173700,NORTHERN ILLINOIS UNIVERSITY            ,IL,60115-2854,Public       ,210,211,421,18386,8027,26413
00173900,NORTHWESTERN UNIV                       ,IL,60208-0001,Private      ,79,176,255,11930,8899,20829
00174100,OLIVET NAZARENE UNIVERSITY              ,IL,60914-2271,Private      ,14,182,196,2777,1914,4691
00174200,IL EASTERN COMM COLGS-OLNEY CENTRAL     ,IL,62450-1099,Public       ,24,36,60,597,666,1263
00174500,QUINCY UNIVERSITY                       ,IL,62301-2699,Private      ,12,7,19,1134,479,1613
00174600,ROBERT MORRIS UNIVERSITY ILLINOIS       ,IL,60605-1225,Private      ,129,393,522,4221,5420,9641
00174700,ROCK VALLEY COLLEGE                     ,IL,61114-5699,Public       ,59,160,219,2050,3364,5414
00174800,ROCKFORD COLLEGE                        ,IL,61108-2393,Private      ,12,51,63,822,1143,1965
00174900,ROOSEVELT UNIVERSITY                    ,IL,60605-1394,Private      ,45,263,308,2504,6396,8900
00175000,DOMINICAN UNIVERSITY                    ,IL,60305-1066,Private      ,19,42,61,1588,1274,2862
00175200,SAUK VALLEY COMMUNITY COLLEGE           ,IL,61021-9112,Public       ,22,56,78,813,1226,2039
00175300,SCHOOL OF ART INSTITUTE OF CHICAGO      ,IL,60603-3013,Private      ,24,17,41,2340,1735,4075
00175400,SEABURY-WESTERN THEO SEMINARY           ,IL,60201-0000,Private      ,0,1,1,0,39,39
00175600,SHIMER COLLEGE                          ,IL,60616-3893,Private      ,2,0,2,59,57,116
00175700,SOUTHEASTERN ILLINOIS COLLEGE           ,IL,62946-4925,Public       ,15,52,67,515,781,1296
00175800,SOUTHERN ILL UNIV-CARBONDALE            ,IL,62901-0000,Public       ,154,274,428,12251,7498,19749
00175801,SOUTHERN ILLINOIS UNIV SCHOOL MEDIC     ,IL,62794-0000,Public       ,2,0,2,73,388,461
00175900,SOUTHERN ILL UNIV-EDWARDSVILLE          ,IL,62026-1060,Public       ,75,124,199,8703,4732,13435
00175924,SO IL UNIV-SCHL OF DENTAL MEDICINE      ,IL,62002-0000,Public       ,0,0,0,8,222,230
00176100,SPRINGFIELD COLLEGE IN ILLINOIS         ,IL,62702-2694,Private      ,8,50,58,401,647,1048
00176500,UNIVERSITY OF ST MARY OF THE LAKE       ,IL,60060-0000,Private      ,0,0,0,2,10,12
00176700,BENEDICTINE UNIVERSITY                  ,IL,60532-0900,Private      ,32,189,221,1874,2372,4246
00176800,ST XAVIER UNIVERSITY                    ,IL,60655-3199,Private      ,35,110,145,3324,3399,6723
00176900,SOUTH SUBURBAN COLLEGE                  ,IL,60473-9978,Public       ,142,361,503,2194,5602,7796
00177100,TRINITY CHRISTIAN COLLEGE               ,IL,60463-0929,Private      ,13,26,39,1161,616,1777
00177200,TRINITY INTERNATIONAL UNIVERSITY        ,IL,60015-1283,Private      ,5,34,39,945,1091,2036
00177300,TRITON COLLEGE                          ,IL,60171-1995,Public       ,160,240,400,2475,3240,5715
00177400,UNIVERSITY OF CHICAGO                   ,IL,60637-1476,Private      ,77,40,117,7687,1991,9678
00177401,UNIV OF CHICAGO PRITZKER SCH OF MED     ,IL,60637-0000,Private      ,0,0,0,29,538,567
00177403,"UNIV OF CHICAGO, GRAD SCH OF BUS        ",IL,60637-0000,Private      ,0,42,42,11,1314,1325
00177405,UNIVERSITY OF CHICAGO GRADUATE          ,IL,60637-0000,Private      ,2,66,68,57,4457,4514
00177500,UNIV OF ILLINOIS @ URBANA-CHAMPAIGN     ,IL,61820-5796,Public       ,216,159,375,23852,6999,30851
00177600,UNIV OF ILLINOIS AT CHICAGO             ,IL,60607-7163,Public       ,213,249,462,15172,11883,27055
00177800,VANDERCOOK COLLEGE OF MUSIC             ,IL,60616-3731,Private      ,2,2,4,127,70,197
00177900,IL EASTERN COMM COLGS-WABASH VALLEY     ,IL,62863-2699,Public       ,7,18,25,336,322,658
00178000,WESTERN ILLINOIS UNIVERSITY             ,IL,61455-1390,Public       ,101,104,205,9382,3468,12850
00178100,WHEATON COLLEGE                         ,IL,60187-5535,Private      ,9,20,29,2494,588,3082
00178300,WORSHAM COLLEGE OF MORTUARY SCIENCE     ,IL,60090-2646,Proprietary  ,4,13,17,50,104,154
00396100,HARPER COLLEGE                          ,IL,60067-7398,Public       ,143,177,320,3135,2685,5820
00418100,ADVOCATE TRINITY HOSPITAL SCHOOL OF RADI,IL,60617-3982,Private      ,0,2,2,14,75,89
00456000,GEM CITY COLLEGE                        ,IL,62301-4949,Proprietary  ,3,15,18,20,55,75
00456800,MIDSTATE COLLEGE                        ,IL,61614-3558,Proprietary  ,5,71,76,56,848,904
00457100,SPARKS COLLEGE                          ,IL,62565-2241,Proprietary  ,1,8,9,10,42,52
00621400,BLESSING RIEMAN COLLEGE OF NURSING      ,IL,62301-0000,Private      ,0,1,1,71,70,141
00621401,BLESSING HOSP SCH MED LAB TECH          ,IL,62301-0000,Private      ,0,0,0,2,7,9
00621402,BLESSING HOSP SCH OF RAD TECH           ,IL,62301-2852,Private      ,0,0,0,15,12,27
00621403,BLESSING HOSPITAL - COLLEGE OF NURSING  ,IL,62305-7005,Private      ,1,0,1,7,10,17
00622501,TRINITY COLLEGE OF NURSING & HEALTH SCIE,IL,61201-5317,Private      ,0,1,1,57,165,222
00624000,ST FRANCIS MED CLG OF NRSG              ,IL,61603-3783,Private      ,2,8,10,143,267,410
00665600,COLLEGE OF DUPAGE                       ,IL,60137-6599,Public       ,164,278,442,4873,4963,9836
00675300,ILLINOIS CENTRAL COLLEGE                ,IL,61635-0001,Public       ,108,225,333,2844,4023,6867
00693100,WAUBONSEE COMMUNITY COLLEGE             ,IL,60554-0000,Public       ,28,91,119,1098,1631,2729
00711800,PARKLAND COLLEGE                        ,IL,61821-1899,Public       ,66,121,187,3159,2943,6102
00711900,REND LAKE COLLEGE                       ,IL,62846-9801,Public       ,24,80,104,1062,1375,2437
00717000,LINCOLN LAND COMMUNITY COLLEGE          ,IL,62794-9256,Public       ,54,129,183,1839,2938,4777
00726500,CARL SANDBURG COLLEGE                   ,IL,61401-9576,Public       ,15,76,91,864,1512,2376
00729701,WESTWOOD COLLEGE OF TECHNOLOGY          ,IL,60176-0000,Proprietary  ,0,1,1,12,15,27
00754900,COYNE AMERICAN INSTITUTE                ,IL,60607-1300,Proprietary  ,49,155,204,328,929,1257
00764400,LAKE LAND COLLEGE                       ,IL,61938-9366,Public       ,52,85,137,1916,1928,3844
00768400,KISHWAUKEE COLLEGE                      ,IL,60150-9699,Public       ,42,69,111,1204,1249,2453
00769000,KANKAKEE COMMUNITY COLLEGE              ,IL,60901-6505,Public       ,13,85,98,855,1503,2358
00769100,MCHENRY COUNTY COLLEGE                  ,IL,60012-2761,Public       ,30,65,95,1083,1089,2172
00769200,MORAINE VALLEY COMMUNITY COLLEGE        ,IL,60465-0937,Public       ,153,206,359,3458,3284,6742
00769300,SHAWNEE COMMUNITY COLLEGE               ,IL,62992-9725,Public       ,39,107,146,631,1296,1927
00769400,COLLEGE OF LAKE COUNTY                  ,IL,60030-1198,Public       ,137,301,438,2286,3375,5661
00793700,MS ROBERTS ACADEMY OF BEAUTY CULT       ,IL,60181-2930,Proprietary  ,3,22,25,19,73,92
00807600,JOHN A LOGAN COLLEGE                    ,IL,62918-2500,Public       ,54,174,228,1744,2464,4208
00825900,EDUCATORS OF BEAUTY                     ,IL,61081-3611,Proprietary  ,18,20,38,71,174,245
00825901,EDUCATORS OF BEAUTY                     ,IL,61104-0000,Proprietary  ,0,2,2,11,35,46
00832800,ALVAREITA'S COLLEGE OF COSMETOLOGY      ,IL,62025-2041,Proprietary  ,4,11,15,40,75,115
00854400,CAREER COLLEGES OF CHICAGO              ,IL,60603-6397,Proprietary  ,0,0,0,20,151,171
00854500,ROCKFORD BUSINESS COLLEGE               ,IL,61103-0000,Proprietary  ,18,99,117,147,955,1102
00869402,RASMUSSEN COLLEGE - ROCKFORD            ,IL,61108-2513,Proprietary  ,6,97,103,29,235,264
00888000,MORRISON INSTITUTE OF TECHNOLOGY        ,IL,61270-2959,Private      ,0,0,0,152,37,189
00893800,GRAHAM HOSPITAL SCH OF NURSING          ,IL,61520-2497,Private      ,0,0,0,21,70,91
00893900,CANNELLA SCHOOL OF HAIR DESIGN          ,IL,60406-2130,Proprietary  ,5,12,17,36,89,125
00914500,GOVERNORS STATE UNIVERSITY              ,IL,60466-0975,Public       ,9,184,193,574,4335,4909
00923200,CATHOLIC THEOLOGICAL UNION              ,IL,60615-0000,Private      ,0,2,2,0,55,55
00933300,UNIV OF ILLINOIS AT SPRINGFIELD         ,IL,62703-5407,Public       ,26,122,148,1447,2409,3856
00947500,EDUCATORS OF BEAUTY                     ,IL,61301-2404,Proprietary  ,2,2,4,32,43,75
00959500,CANNELLA SCHOOL OF HAIR DESIGN          ,IL,60617-4303,Proprietary  ,5,22,27,37,121,158
00976700,OLIVE-HARVEY COLLEGE                    ,IL,60628-1696,Public       ,67,211,278,991,3111,4102
00978600,IL EASTERN COMM COLGS-LINCOLN TRAIL     ,IL,62454-5708,Public       ,11,14,25,348,414,762
00980000,RUSH UNIVERSITY                         ,IL,60612-3806,Private      ,1,25,26,272,1834,2106
00989600,OAKTON COMMUNITY COLLEGE                ,IL,60016-1268,Public       ,89,106,195,2017,1808,3825
00998700,SAINT ANTHONY COLLEGE OF NURSING        ,IL,61108-2468,Private      ,4,1,5,92,189,281
01002000,LEWIS AND CLARK COMMUNITY COLLEGE       ,IL,62035-2466,Public       ,52,173,225,1510,2274,3784
01031600,LINCOLN COLLEGE OF TECHNOLOGY           ,IL,60160-1605,Proprietary  ,145,204,349,976,1436,2412
01050100,LAKEVIEW  COLLEGE OF NURSING            ,IL,61832-3781,Private      ,1,2,3,114,184,298
01069500,TRI-COUNTY BEAUTY ACADEMY               ,IL,62056-2036,Proprietary  ,0,4,4,11,34,45
01071000,CAPITAL AREA SCH OF PRAC NRSG           ,IL,62707-0000,Public       ,2,5,7,45,338,383
01072700,DEVRY UNIVERSITY                        ,IL,60618-5994,Proprietary  ,1472,5304,6776,18864,50229,69093
01073700,ADVOCATE IL MASONIC SCH OF RAD TECH     ,IL,60657-5193,Private      ,0,3,3,18,80,98
01083600,PIVOT POINT INTNL CSMTLGY RSRCH CTR     ,IL,60626-0000,Proprietary  ,30,63,93,395,487,882
01087900,RICHLAND COMMUNITY COLLEGE              ,IL,62521-8513,Public       ,35,82,117,772,1563,2335
01181000,TAYLOR BUSINESS INSTITUTE               ,IL,60606-5111,Proprietary  ,10,40,50,60,268,328
01185800,EVEREST COLLEGE                         ,IL,60077-1074,Proprietary  ,106,330,436,476,1430,1906
01236200,NORTHWESTERN COLLEGE                    ,IL,60630-2298,Proprietary  ,57,250,307,1109,2936,4045
01238500,BLOOMINGTON-NORMAL SCH RADIOGRAPHY      ,IL,61761-4604,Private      ,0,0,0,11,7,18
01258400,ILLINOIS INSTITUTE OF ART (THE)         ,IL,60654-1593,Proprietary  ,115,130,245,3619,1979,5598
01260800,DU QUOIN BEAUTY COLLEGE                 ,IL,62832-1805,Proprietary  ,0,0,0,1,0,1
01281300,JOHN WOOD COMMUNITY COLLEGE             ,IL,62305-0401,Public       ,42,100,142,1139,1322,2461
01308700,CAPRI GARFIELD RIDGE SCH OF BTY CLR     ,IL,60629-1613,Proprietary  ,4,20,24,46,192,238
01308800,CAPRI OAK FOREST COLLEGE OF BEAUTY      ,IL,60452-2798,Proprietary  ,20,19,39,144,170,314
02055200,HARRINGTON COLLEGE OF DESIGN            ,IL,60606-3433,Proprietary  ,34,85,119,860,1035,1895
02068100,ADLER SCH OF PROFESSIONAL PSYCHLGY      ,IL,60601-0000,Private      ,0,7,7,8,554,562
02069300,VATTEROTT COLLEGE                       ,IL,62305-5938,Proprietary  ,11,72,83,109,369,478
02073200,TELSHE YESHIVA-CHICAGO                  ,IL,60625-0000,Private      ,0,0,0,24,9,33
02074400,IL EASTERN COMM COLGS-FRONTIER          ,IL,62837-0000,Public       ,6,20,26,168,350,518
02075400,KELLER GRADUATE SCHOOL OF MGMT.         ,IL,60515-5683,Proprietary  ,5,1102,1107,44,11295,11339
02113600,AMERICAN INTERCONTINENTAL UNIVERSITY    ,IL,60192-3713,Proprietary  ,598,5389,5987,4588,39412,44000
02117400,BECK AREA CAREER CENTER                 ,IL,62278-0000,Public       ,2,11,13,24,109,133
02124400,UNIVERSITY OF SPA & COSMETOLOGY ART     ,IL,62704-0000,Proprietary  ,16,31,47,120,180,300
02150600,COSMETOLOGY AND SPA INSTITUTE (THE)     ,IL,60014-4003,Proprietary  ,12,22,34,80,115,195
02155300,THE CHICAGO SCHOOL OF PROF PSYCHOLOGY   ,IL,60610-4705,Private      ,0,8,8,11,1433,1444
02160300,INTERNATIONAL ACAD OF DESIGN & TECH     ,IL,60602-3319,Proprietary  ,122,138,260,2309,2049,4358
02160304,INTERNATIONAL ACADEMY OF DESIGN AND TECH,IL,60173-5160,Proprietary  ,11,21,32,168,173,341
02166800,JOHN AMICO'S SCHOOL OF HAIR DESIGN      ,IL,60452-0000,Proprietary  ,2,9,11,8,49,57
02168600,EAST WEST UNIVERSITY                    ,IL,60605-0000,Private      ,41,61,102,874,1067,1941
02179900,ARGOSY UNIVERSITY                       ,IL,60601-7757,Proprietary  ,42,771,813,730,14590,15320
02185400,ST AUGUSTINE COLLEGE                    ,IL,60640-0000,Private      ,34,139,173,372,1578,1950
02192400,MR JOHNS SCHOOL OF COSMETOLOGY          ,IL,62521-0000,Proprietary  ,6,18,24,25,117,142
02202600,CANNELLA SCHOOL OF HAIR DESIGN          ,IL,60181-1321,Proprietary  ,1,2,3,9,36,45
02214100,WEST SUBURBAN COLLEGE OF NURSING        ,IL,60302-2519,Private      ,3,5,8,90,290,380
02228100,MAC DANIEL'S BEAUTY SCHOOL              ,IL,60640-0000,Proprietary  ,2,9,11,15,87,102
02253000,CANNELLA SCHOOL OF HAIR DESIGN          ,IL,60644-0000,Proprietary  ,0,1,1,19,49,68
02261200,HAIR PROFESSIONALS ACAD COSMETOLOGY     ,IL,60118-0000,Proprietary  ,7,25,32,53,114,167
02261201,HAIR PROFESSIONALS ACADEMY OF COSMETOLOG,IL,60118-9333,Proprietary  ,0,3,3,0,5,5
02262100,HAIR PROFESSIONALS SCH COSMETOLOGY      ,IL,60543-0000,Proprietary  ,4,15,19,47,85,132
02291200,CANNELLA SCHOOL OF HAIR DESIGN          ,IL,60639-0000,Proprietary  ,1,12,13,32,89,121
02295500,CANNELLA SCHOOL OF HAIR DESIGN          ,IL,60120-0000,Proprietary  ,4,8,12,18,72,90
02297500,OEHRLEIN SCHOOL OF COSMETOLOGY          ,IL,61611-0000,Proprietary  ,8,6,14,55,59,114
02312300,LA' JAMES COLLEGE HAIRSTYLING           ,IL,61244-0000,Proprietary  ,3,2,5,20,20,40
02313900,WESTWOOD COLLEGE - O'HARE AIRPORT       ,IL,60631-2801,Proprietary  ,32,74,106,382,606,988
02317300,CONCEPT COLLEGE OF COSMETOLOGY          ,IL,61832-0000,Proprietary  ,10,15,25,67,124,191
02319200,LAKE FOREST GRAD SCHL OF MGMT           ,IL,60045-4824,Private      ,0,33,33,0,251,251
02323300,PROFESSIONAL'S CHOICE HAIR DSN ACAD     ,IL,60435-0000,Proprietary  ,2,6,8,22,33,55
02332200,HAIR PROFESSIONALS CAREER COLLEGE       ,IL,60178-0000,Proprietary  ,5,7,12,41,41,82
02337800,THE COLLEGE OF OFFICE TECHNOLOGY        ,IL,60622-0000,Proprietary  ,14,128,142,104,859,963
02349400,ALVAREITA'S COLLEGE OF COSMETOLOGY      ,IL,62035-0000,Proprietary  ,1,7,8,29,22,51
02349500,CANNELLA SCHOOL OF HAIR DESIGN          ,IL,60632-0000,Proprietary  ,7,31,38,52,175,227
02352200,COOKING & HOSPITALITY INSTITUTE         ,IL,60610-3050,Proprietary  ,49,158,207,1026,1222,2248
02498200,HAIR PROFESSIONALS ACAD COSMETOLOGY     ,IL,60187-0000,Proprietary  ,7,23,30,45,122,167
02498201,HAIR PROFESSIONALS ACADEMY OF COSMETOLOG,IL,60563-0000,Proprietary  ,0,1,1,2,9,11
02522800,FOX COLLEGE                             ,IL,60453-0000,Proprietary  ,19,13,32,213,80,293
02527600,LEXINGTON COLLEGE                       ,IL,60607-0000,Private      ,3,3,6,58,63,121
02536700,BELL MAR BEAUTY COLLEGE                 ,IL,60650-0000,Proprietary  ,1,18,19,7,81,88
02538100,REGENCY BEAUTY INSTITUTE                ,IL,61820-0000,Proprietary  ,2,7,9,12,81,93
02556100,ENVIRONMENTAL TECHNICAL INSTITUTE       ,IL,60143-0000,Proprietary  ,34,107,141,197,382,579
02556600,NILES SCHOOL OF COSMETOLOGY             ,IL,60714-0000,Proprietary  ,1,10,11,28,60,88
02570305,LOS ANGELES ORT TECHNICAL INSTITUTE -D/B,IL,60077-0000,Private      ,0,1,1,0,1,1
02573700,INSTITUTE FOR CLINICAL SOCIAL WORK      ,IL,60601-0000,Private      ,0,2,2,4,64,68
02579200,INGALLS MEMORIAL HOSPITAL               ,IL,60426-0000,Private      ,0,0,0,2,15,17
02584900,"FIRST INSTITUTE, INC.                   ",IL,60014-7489,Proprietary  ,7,17,24,33,112,145
02587700,HAIR PROFESSIONALS CAREER COLLEGE       ,IL,60465-1929,Proprietary  ,4,14,18,47,93,140
02599500,HANOVER PARK COLLEGE OF BEAUTY CULT     ,IL,60133-5421,Proprietary  ,4,5,9,51,73,124
02622700,KNOWLEDGE SYSTEMS INSTITUTE             ,IL,60076-0000,Private      ,1,11,12,3,20,23
03002000,HAIRMASTERS INST OF COSMETOLOGY         ,IL,61701-5547,Proprietary  ,11,13,24,48,68,116
03027702,PACIFIC COLLEGE OF ORIENTAL MEDICINE - C,IL,60613-4418,Proprietary  ,2,8,10,7,170,177
03065300,TREND SETTERS COLL OF COSMETOLOGY       ,IL,60915-2101,Proprietary  ,17,30,47,110,145,255
03072701,WESTWOOD COLLEGE OF TECHNOLOGY          ,IL,60409-0000,Proprietary  ,34,165,199,400,1120,1520
03072702,WESTWOOD COLLEGE OF TECHNOLOGY          ,IL,60602-0000,Proprietary  ,58,128,186,558,986,1544
03078400,CAMEO BEAUTY ACADEMY                    ,IL,60453-3196,Proprietary  ,13,13,26,65,66,131
03079200,WESTWOOD COLLEGE - DUPAGE               ,IL,60517-2321,Proprietary  ,39,61,100,502,424,926
03082900,ROSEL SCHOOL OF COSMETOLOGY             ,IL,60659-1913,Proprietary  ,4,21,25,16,153,169
03083800,HEARTLAND COMMUNITY COLLEGE             ,IL,61761-9446,Public       ,38,92,130,1130,1817,2947
03098000,ST JOHN'S COLLEGE OF NURSING            ,IL,62702-5321,Private      ,0,2,2,56,70,126
03098002,ST JOHN'S HOSP SCH MED TECH             ,IL,62769-5324,Private      ,0,1,1,6,6,12
03098003,ST JOHN'S HOSPITAL SCH OF DIETETICS     ,IL,62769-0000,Private      ,0,0,0,1,1,2
03099700,CAIN'S BARBER COLLEGE                   ,IL,60615-3510,Proprietary  ,5,32,37,59,277,336
03099800,ILLINOIS SCHOOL OF HEALTH CAREERS       ,IL,60604-0000,Proprietary  ,34,180,214,253,969,1222
03101800,ILLINOIS CENTER FOR BROADCASTING        ,IL,60148-7015,Proprietary  ,16,22,38,78,180,258
03128300,PYRAMID CAREER INSTITUTE                ,IL,60657-4207,Proprietary  ,2,7,9,7,38,45
03128500,NATIONAL LATINO EDUCATION INSTITUTE     ,IL,60609-2205,Private      ,8,17,25,27,99,126
03199300,CHRISTIAN LIFE COLLEGE                  ,IL,60056-2522,Private      ,0,1,1,26,22,48
03368300,MIDWEST TECHNICAL INSTITUTE             ,IL,62707-8805,Proprietary  ,33,213,246,185,916,1101
03416300,COMPUTER SYSTEMS INSTITUTE              ,IL,60077-0000,Proprietary  ,0,4,4,0,4,4
03448300,BIR TRAINING CENTER                     ,IL,60659-1298,Proprietary  ,4,84,88,22,295,317
03455700,CORTIVA INSTITUTE - CHICAGO             ,IL,60602-3315,Proprietary  ,8,58,66,169,465,634
03472300,CHICAGO URBAN LEAGUE COMPUTER TRAIN     ,IL,60604-2198,Private      ,1,16,17,4,62,66
03510300,ERIKSON INSTITUTE                       ,IL,60654-4510,Private      ,0,3,3,1,252,253
03623300,VEE'S SCHOOL OF BEAUTY CULTURE          ,IL,62205-2326,Proprietary  ,0,1,1,11,34,45
03643300,"MR. JOHN'S SCHOOL OF JACKSONVILLE,  INC,",IL,62650-3488,Proprietary  ,0,2,2,9,42,51
03655300,ILLINOIS CAREERPATH INSTITUTE           ,IL,60610-4705,Private      ,0,0,0,4,22,26
03669300,ILLINOIS WELDING SCHOOL                 ,IL,61607-2045,Proprietary  ,0,0,0,17,51,68
03684300,NORTHSHORE UNIVERSITY HEALTHSYSTEM SCHOO,IL,60201-9872,Private      ,0,0,0,0,25,25
03721400,AMERICAN CAREER COLLEGE                 ,IL,60402-0000,Proprietary  ,5,20,25,20,96,116
03879300,YOUR SCHOOL OF BEAUTY CULTURE           ,IL,60653-1517,Proprietary  ,1,6,7,9,88,97
03881400,EUROPEAN MASSAGE THERAPY SCHOOL         ,IL,60077-2269,Proprietary  ,4,18,22,20,104,124
03891300,SOMA INSTITUTE - THE NATIONAL SCHOOL OF ,IL,60604-4466,Proprietary  ,11,38,49,97,258,355
03914300,"CALC, INSTITUTE OF TECHNOLOGY           ",IL,62002-5931,Proprietary  ,3,14,17,15,164,179
03955400,MIDWEST INSTITUTE OF MASSAGE THERAPY    ,IL,62223-0000,Proprietary  ,2,3,5,7,40,47
        ,ASBURY THEOLOGICAL SEMINARY             ,KY,40390-0000,Private      ,1,44,45,14,1112,1126
00195100,ALICE LLOYD COLLEGE                     ,KY,41844-9703,Private      ,13,6,19,1027,100,1127
00195200,ASBURY COLLEGE                          ,KY,40390-1198,Private      ,10,18,28,1232,253,1485
00195400,BELLARMINE UNIVERSITY                   ,KY,40205-1877,Private      ,26,66,92,2206,1156,3362
00195500,BEREA COLLEGE                           ,KY,40403-0000,Private      ,37,10,47,2374,444,2818
00195800,BRESCIA UNIVERSITY                      ,KY,42301-3023,Private      ,3,12,15,407,282,689
00195900,CAMPBELLSVILLE UNIVERSITY               ,KY,42718-2799,Private      ,22,72,94,1940,1055,2995
00196000,SPALDING UNIVERSITY                     ,KY,40203-2188,Private      ,8,75,83,484,1840,2324
00196100,CENTRE COLLEGE                          ,KY,40422-1394,Private      ,7,2,9,1745,58,1803
00196200,UNIVERSITY OF THE CUMBERLANDS           ,KY,40769-1372,Private      ,22,49,71,1841,645,2486
00196300,EASTERN KENTUCKY UNIVERSITY             ,KY,40475-3102,Public       ,202,275,477,9572,7127,16699
00196400,GEORGETOWN COLLEGE                      ,KY,40324-1628,Private      ,19,50,69,1842,593,2435
00196500,KENTUCKY CHRISTIAN UNIVERSITY           ,KY,41143-2205,Private      ,14,6,20,556,197,753
00196800,KENTUCKY STATE UNIVERSITY               ,KY,40601-2355,Public       ,51,48,99,2547,1321,3868
00196900,KENTUCKY WESLEYAN COLLEGE               ,KY,42302-1039,Private      ,11,2,13,1356,226,1582
00197000,LEES COLLEGE                            ,KY,41339-0000,Private      ,0,0,0,8,8,16
00197100,LEXINGTON THEOLOGICAL SEMINARY          ,KY,40508-0000,Private      ,0,1,1,1,56,57
00197200,LINDSEY WILSON COLLEGE                  ,KY,42728-1223,Private      ,11,62,73,1708,1148,2856
00197400,LOUISVILLE PRESBYTERIAN THEOL SEM       ,KY,40205-0000,Private      ,0,2,2,0,135,135
00197500,MIDWAY COLLEGE                          ,KY,40347-1120,Private      ,8,81,89,511,1384,1895
00197600,MOREHEAD STATE UNIVERSITY               ,KY,40351-1689,Public       ,113,227,340,5649,4800,10449
00197700,MURRAY STATE UNIVERSITY                 ,KY,42071-0009,Public       ,110,117,227,5685,3467,9152
00197900,WEST KENTUCKY CMNTY & TECHNICAL COLG    ,KY,42002-7380,Public       ,39,112,151,1131,2396,3527
00197901,WEST KENTUCKY CMNTY & TECHNICAL COLG    ,KY,42001-0000,Public       ,4,4,8,337,500,837
00197903,W KY CMNTY TECH - MURRAY AREA VOC ED CTR,KY,42071-0000,Public       ,0,0,0,5,13,18
00197906,W KY CMNTY - FULTON CNTY AREA TECH CNTR ,KY,42050-0000,Public       ,0,0,0,0,2,2
00198000,PIKEVILLE COLLEGE                       ,KY,41501-1194,Private      ,14,9,23,1027,382,1409
00198001,PIKEVILLE CLG-SCH OSTEOPATHIC MEDIC     ,KY,41501-0000,Private      ,0,1,1,5,322,327
00198200,SOUTHERN BAPTIST THEOL SEMINARY         ,KY,40280-0000,Private      ,1,4,5,46,133,179
00198300,ST. CATHARINE COLLEGE                   ,KY,40061-9499,Private      ,9,11,20,538,367,905
00198700,TRANSYLVANIA UNIVERSITY                 ,KY,40508-1797,Private      ,7,3,10,1470,100,1570
00198800,UNION COLLEGE                           ,KY,40906-1499,Private      ,9,115,124,939,1038,1977
00198900,UNIVERSITY OF KENTUCKY                  ,KY,40506-0054,Public       ,226,182,408,14253,7014,21267
00198901,UNIV OF KY-COLLEGE OF DENTISTRY         ,KY,40536-0000,Public       ,0,0,0,7,201,208
00198902,UNIV OF KY-COLLEGE OF MEDICINE          ,KY,40536-0000,Public       ,0,0,0,21,393,414
00199000,ASHLAND COMMUNITY AND TECHNICAL COLLEGE ,KY,41101-3683,Public       ,54,104,158,1053,2095,3148
00199001,ASHLAND CMNTY AND TECHNCL COLG          ,KY,41102-0000,Public       ,4,9,13,172,279,451
00199100,ELIZABETHTOWN COMMUNITY  AND TECHNICAL C,KY,42701-3081,Public       ,66,201,267,1631,3129,4760
00199300,HENDERSON COMMUNITY COLLEGE             ,KY,42420-4699,Public       ,13,55,68,442,1017,1459
00199400,HOPKINSVILLE COMMUNITY COLLEGE          ,KY,42241-2621,Public       ,23,178,201,774,2837,3611
00199600,BIG SANDY COMMUNITY AND TECHNICAL COLG  ,KY,41653-1815,Public       ,56,120,176,1317,1845,3162
00199602,BIG SANDY COMMUNITY AND TECHNICAL COLG  ,KY,41240-1032,Public       ,0,0,0,72,68,140
00199700,SOMERSET COMMUNITY COLLEGE              ,KY,42501-2973,Public       ,47,173,220,2030,4591,6621
00199701,LAUREL TECHNICAL COLLEGE                ,KY,40744-0000,Public       ,0,3,3,42,93,135
00199703,SOMERSET TECHNICAL COLLEGE              ,KY,42501-3043,Public       ,0,3,3,54,102,156
00199800,SOUTHEAST KENTUCKY COMMUNITY AND TECHNIC,KY,40823-1099,Public       ,57,120,177,1050,1477,2527
00199802,CUMBERLAND VLY TEC CLG MIDDLESBORO      ,KY,40965-2265,Public       ,2,0,2,42,39,81
00199804,SOUTHEAST COMMUNITY COLLEGE             ,KY,40831-1796,Public       ,4,3,7,52,90,142
00199900,UNIVERSITY OF LOUISVILLE                ,KY,40292-0000,Public       ,195,261,456,10619,10010,20629
00200100,THOMAS MORE COLLEGE                     ,KY,41017-3495,Private      ,10,59,69,1046,705,1751
00200200,WESTERN KENTUCKY UNIVERSITY             ,KY,42101-3576,Public       ,297,300,597,11920,7186,19106
00461800,SPENCERIAN COLLEGE                      ,KY,40216-2605,Proprietary  ,70,301,371,890,2361,3251
00461900,SULLIVAN UNIVERSITY                     ,KY,40205-3000,Proprietary  ,178,429,607,1939,4600,6539
00524300,HAZARD TECHNICAL COLLEGE                ,KY,41701-1198,Public       ,2,1,3,90,90,180
00524400,BLUEGRASS COMMUNITY & TECHNICAL COLLEGE ,KY,40506-0235,Public       ,134,333,467,1787,4269,6056
00527100,BOWLING GREEN TECHNICAL COLLEGE         ,KY,42101-3601,Public       ,14,56,70,548,1102,1650
00527300,GATEWAY COMMUNITY & TECHNOLOGY COLL     ,KY,41011-0000,Public       ,32,78,110,696,1726,2422
00549500,KY TECH-JEFFERSON CAMPUS                ,KY,40203-2036,Public       ,20,25,45,599,838,1437
00549502,SHELBY COUNTY AREA TECHNOLOGY CTR       ,KY,40065-0000,Public       ,1,5,6,73,112,185
00696000,MAYSVILLE CMNTY & TECHNCL COLG          ,KY,41056-8910,Public       ,17,62,79,594,1562,2156
00696002,MAYSVILLE CMNTY & TECHNCL COLG - ROWAN  ,KY,40351-8359,Public       ,1,4,5,97,122,219
00696100,JEFFERSON COMMUNITY AND TECHNICAL COLLEG,KY,40202-2005,Public       ,124,270,394,3754,6913,10667
00696200,HAZARD COMMUNITY COLLEGE                ,KY,41701-2402,Public       ,47,111,158,1277,1774,3051
00696203,KY TECH-KNOTT CO. TECHNOLOGY CTR        ,KY,41822-0000,Public       ,0,0,0,1,3,4
00696204,KY TECH-LESLIE COUNTY AREA TECH CTR     ,KY,41749-0000,Public       ,0,0,0,1,0,1
00696205,KY TECH-LEE COUNTY AREA TECH CTR        ,KY,41311-0000,Public       ,0,1,1,3,2,5
00696206,KY TECH-LETCHER CNTY AREA TECH CTR      ,KY,41858-0000,Public       ,1,0,1,10,9,19
00696207,KY TECH-BREATHITT COUNTY VOC ED CTR     ,KY,41339-0000,Public       ,0,1,1,4,16,20
00842500,DAYMAR COLLEGE                          ,KY,42001-0000,Proprietary  ,1,20,21,80,218,298
00901000,MADISONVILLE COMMUNITY COLLEGE          ,KY,42431-9199,Public       ,37,80,117,1004,2186,3190
00927500,NORTHERN KENTUCKY UNIVERSITY            ,KY,41099-0001,Public       ,144,166,310,7329,5961,13290
00931300,DAYMAR COLLEGE                          ,KY,42301-5830,Proprietary  ,25,197,222,201,1385,1586
00931302,DAYMAR COLLEGE - LOUISVILLE CAMPUS      ,KY,40219-1973,Proprietary  ,0,2,2,7,55,62
00970700,LEXINGTON COMMUNITY COLLEGE             ,KY,40506-0235,Public       ,0,0,0,1977,2230,4207
01042400,SALON PROFESSIONAL ACADEMY THE          ,KY,40502-1776,Proprietary  ,4,10,14,30,86,116
01048900,NATIONAL COLLEGE                        ,KY,40508-0000,Proprietary  ,73,482,555,613,4257,4870
01172500,COLLINS SCHOOL OF COSMETOLOGY           ,KY,40965-2809,Proprietary  ,0,16,16,8,68,76
01208800,SULLIVAN COLLEGE OF TECHNOLOGY AND DESIG,KY,40218-4528,Proprietary  ,38,47,85,493,434,927
01212801,SOUTHWESTERN COLLEGE                    ,KY,41042-1466,Proprietary  ,18,77,95,114,499,613
01240400,LEXINGTON BEAUTY COLLEGE                ,KY,40503-1819,Proprietary  ,2,4,6,22,73,95
01267700,OWENSBORO TECHNICAL COLLEGE             ,KY,42301-4806,Public       ,0,0,0,3,5,8
01267702,KY TECH OHIO CO CENTER                  ,KY,42347-0000,Public       ,0,0,0,0,1,1
01272300,KY TECH-WAYNE COUNTY AREA TECH CTR      ,KY,42633-1088,Public       ,0,0,0,1,0,1
01291400,EMPIRE BEAUTY SCHOOL                    ,KY,40218-0000,Proprietary  ,9,48,57,116,261,377
01291500,EMPIRE BEAUTY SCHOOL                    ,KY,41042-5113,Proprietary  ,3,26,29,68,152,220
01291600,EMPIRE BEAUTY SCHOOL                    ,KY,40216-4212,Proprietary  ,5,17,22,40,112,152
01291700,EMPIRE BEAUTY SCHOOL                    ,KY,40160-0000,Proprietary  ,10,23,33,74,133,207
01296800,EMPIRE BEAUTY SCHOOL                    ,KY,40207-2695,Proprietary  ,10,13,23,96,105,201
02159100,"APPALACHIAN BEAUTY SCHOOL, INC.         ",KY,41503-0000,Proprietary  ,1,7,8,14,49,63
02177100,EMPIRE BEAUTY SCHOOL                    ,KY,40204-0000,Proprietary  ,3,11,14,39,114,153
02251500,TREND SETTERS ACAD OF BEAUTY CULT       ,KY,40258-0000,Proprietary  ,7,24,31,55,148,203
02275000,JENNY LEA ACADEMY OF COSMETOLOGY        ,KY,40831-0000,Proprietary  ,10,23,33,20,83,103
02279800,ELIZABETHTOWN BEAUTY SCHOOL             ,KY,42701-0000,Proprietary  ,1,8,9,15,36,51
02284306,INTERACTIVE LEARNING SYSTEMS            ,KY,41042-0000,Proprietary  ,4,27,31,13,114,127
02323700,PAT WILSON'S BEAUTY COLLEGE             ,KY,42420-0000,Proprietary  ,1,12,13,7,54,61
02337200,PJ'S COLLEGE OF COSMETOLOGY             ,KY,42101-0000,Proprietary  ,8,66,74,63,406,469
02340800,PAUL MITCHELL THE SCHOOL LEXINGTON      ,KY,40601-0000,Proprietary  ,0,7,7,10,24,34
02351700,DONTA SCHOOL OF BEAUTY CULTURE          ,KY,40203-0000,Proprietary  ,4,17,21,14,100,114
02491100,BECKFIELD COLLEGE                       ,KY,41042-0000,Proprietary  ,16,87,103,160,758,918
02518900,BARRETT & COMPANY SCH HAIR DESIGN       ,KY,40356-0000,Proprietary  ,8,13,21,54,86,140
02526100,JENNY LEA ACADEMY OF COSMETOLOGY        ,KY,41858-0000,Proprietary  ,0,2,2,8,21,29
02535600,CLEAR CREEK BAPTIST BIBLE COLLEGE       ,KY,40977-0000,Private      ,1,3,4,42,155,197
02551100,PJ'S COLLEGE OF COSMETOLOGY             ,KY,42121-0000,Proprietary  ,2,19,21,32,122,154
02560800,SOUTHEAST SCHOOL OF COSMETOLOGY         ,KY,40962-0000,Proprietary  ,1,9,10,23,50,73
02576200,MID-CONTINENT UNIVERSITY                ,KY,42066-9007,Private      ,5,134,139,202,1472,1674
02616204,BROWN MACKIE COLLEGE-FINDLAY - BROWN MAC,KY,40219-1916,Proprietary  ,38,203,241,175,1062,1237
03002100,KENTUCKY MOUNTAIN BIBLE COLLEGE         ,KY,41385-0010,Private      ,4,2,6,56,31,87
03007000,FRONTIER SCH OF MIDWIFERY&FAMILY NU     ,KY,41749-0000,Private      ,0,62,62,0,454,454
03026200,HEAD'S WEST KENTUCKY BEAUTY COLLEGE     ,KY,42431-0000,Proprietary  ,0,8,8,12,58,70
03029200,NU-TEK ACADEMY OF BEAUTY                ,KY,40353-9767,Proprietary  ,0,6,6,13,41,54
03034500,OWENSBORO COMMUNITY & TECHNICAL COLLEGE ,KY,42303-1899,Public       ,33,115,148,1203,2135,3338
03083700,GALEN HEALTH INSTITUTES                 ,KY,40207-1047,Proprietary  ,35,217,252,233,1692,1925
03103500,MR JIM'S BEAUTY COLLEGE                 ,KY,42301-2646,Proprietary  ,2,6,8,15,46,61
03106700,MOTIF BEAUTY ACADEMY                    ,KY,40391-1958,Proprietary  ,0,16,16,11,50,61
03516500,EZELL'S COSMETOLOGY SCHOOL              ,KY,42071-2530,Proprietary  ,1,2,3,10,49,59
03611300,BRIGHTON CENTER'S CENTER FOR EMPLOY     ,KY,41071-1968,Private      ,1,49,50,7,160,167
03804300,BELLEFONTE ACADEMY OF BEAUTY            ,KY,41169-2015,Proprietary  ,7,20,27,35,68,103
03885300,EMPLOYMENT SOLUTIONS                    ,KY,40517-3260,Private      ,3,12,15,5,37,42
03886300,REGENCY SCHOOL OF HAIR DESIGN           ,KY,41653-1278,Proprietary  ,2,4,6,21,47,68
04038300,ATA CAREER EDUCATION                    ,KY,40223-3832,Proprietary  ,20,93,113,87,502,589
00200300,CENTENARY COLLEGE OF LOUISIANA          ,LA,71104-3396,Private      ,11,10,21,1165,230,1395
00200400,DILLARD UNIVERSITY                      ,LA,70122-3097,Private      ,43,18,61,1650,393,2043
00200500,NICHOLLS STATE UNIVERSITY               ,LA,70310-0001,Public       ,77,90,167,5003,2595,7598
00200600,GRAMBLING STATE UNIVERSITY              ,LA,71245-2215,Public       ,162,95,257,6287,3100,9387
00200700,LOUISIANA COLLEGE                       ,LA,71359-0000,Private      ,9,16,25,990,252,1242
00200800,LOUISIANA TECH UNIVERSITY               ,LA,71272-0001,Public       ,88,116,204,7150,3009,10159
00201000,LOUISIANA STATE UNIV & A&M COLG         ,LA,70803-5710,Public       ,233,142,375,20874,6816,27690
00201100,LOUISIANA STATE UNIV-ALEXANDRIA         ,LA,71302-9121,Public       ,44,81,125,1428,2266,3694
00201200,LOUISIANA STATE UNIV-EUNICE             ,LA,70535-6726,Public       ,81,45,126,1937,1574,3511
00201300,LOUISIANA STATE UNIV-SHREVEPORT         ,LA,71115-2399,Public       ,34,84,118,2405,2667,5072
00201400,LA STATE UNIV HEALTH SCIENCES CTR       ,LA,70112-2223,Public       ,7,25,32,348,1573,1921
00201500,(THE) UNIVERSITY OF NEW ORLEANS         ,LA,70148-0001,Public       ,130,197,327,6385,5325,11710
00201600,LOYOLA UNIVERSITY NEW ORLEANS           ,LA,70118-6195,Private      ,34,62,96,2627,1761,4388
00201700,MCNEESE STATE UNIVERSITY                ,LA,70609-4510,Public       ,75,117,192,5100,3150,8250
00201900,NEW ORLEANS BAPTIST THEOL SEMINARY      ,LA,70126-0000,Private      ,2,3,5,37,97,134
00202000,UNIVERSITY OF LOUISIANA AT MONROE       ,LA,71209-9001,Public       ,103,147,250,6368,4549,10917
00202100,NORTHWESTERN STATE UNIVERSITY           ,LA,71497-0001,Public       ,114,204,318,6313,5235,11548
00202200,NOTRE DAME SEMINARY                     ,LA,70118-0000,Private      ,0,0,0,2,4,6
00202300,OUR LADY OF HOLY CROSS COLLEGE          ,LA,70131-7399,Private      ,20,49,69,633,908,1541
00202400,SOUTHEASTERN LOUISIANA UNIV             ,LA,70402-0001,Public       ,194,170,364,10784,5615,16399
00202500,SOUTHERN UNIVERSITY A & M COLLEGE       ,LA,70813-9374,Public       ,169,190,359,8496,6156,14652
00202600,SOUTHERN UNIV NEW ORLEANS               ,LA,70126-0002,Public       ,52,162,214,1136,2481,3617
00202700,ST JOSEPH SEMINARY COLLEGE              ,LA,70457-9990,Private      ,1,0,1,49,12,61
00202900,TULANE UNIVERSITY                       ,LA,70118-5698,Private      ,94,107,201,5988,4356,10344
00203100,UNIV OF LOUISIANA AT LAFAYETTE          ,LA,70504-0001,Public       ,179,127,306,11540,4956,16496
00203200,XAVIER UNIVERSITY OF LOUISIANA          ,LA,70125-1098,Private      ,56,20,76,3352,1250,4602
00462100,AYERS CAREER COLLEGE                    ,LA,71108-5845,Proprietary  ,13,75,88,77,425,502
00462500,DELGADO COMMUNITY COLLEGE               ,LA,70119-0000,Public       ,238,472,710,4481,8316,12797
00520300,REMINGTON COLLEGE - LAFAYETTE CAMPUS    ,LA,70508-5760,Proprietary  ,107,364,471,643,2169,2812
00520306,REMINGTON COLLEGE - BATON ROUGE CAMPUS  ,LA,70816-4040,Proprietary  ,26,126,152,242,818,1060
00546700,SOWELA TECHNICAL COMMUNITY COLLEGE      ,LA,70616-6950,Public       ,29,61,90,514,714,1228
00547200,LOUISIANA TECHNICAL COLLEGE - SIDNEY N. ,LA,70126-5511,Public       ,1,2,3,10,30,40
00548800,LOUISIANA TECH COLG-BATON ROUGE         ,LA,70807-0000,Public       ,18,58,76,319,644,963
00548802,LOUISIANA TECH COLG-ACADIAN CMPS        ,LA,70526-0000,Public       ,3,5,8,54,120,174
00548803,LOUISIANA TECH COLG-ALEXANDRIA CMPS     ,LA,71302-3137,Public       ,17,43,60,168,533,701
00548804,LOUISIANA TECH COLG-ASCENSION CMPS      ,LA,70778-3007,Public       ,4,8,12,57,62,119
00548805,LA TECH COLLEGE-AVOYELLES CAMPUS        ,LA,71327-0000,Public       ,2,4,6,42,96,138
00548806,LA TECHNICAL COLG-BASTROP CMPS          ,LA,71221-0000,Public       ,4,11,15,43,129,172
00548808,LA TECH COLG CHARLES B COREILCMPS       ,LA,70586-0000,Public       ,6,26,32,57,139,196
00548809,LA TECHNICAL COLG-DELTA-OUACHITA        ,LA,71292-9064,Public       ,19,32,51,237,464,701
00548810,EVANGELINE TECHNICAL INST               ,LA,70582-3104,Public       ,4,17,21,43,143,186
00548811,LA TECHN COLLEGE - FLORIDA PARISHES     ,LA,70441-0000,Public       ,3,6,9,24,90,114
00548812,LOUISIANA TECH COLG-FOLKES CAMPUS       ,LA,70748-0000,Public       ,4,6,10,8,21,29
00548813,LA TECHNICAL INST-GULF AREA CMPS        ,LA,70510-0878,Public       ,17,19,36,140,245,385
00548814,LOUISIANA TECH COLG-HAMMOND CMPS        ,LA,70404-0000,Public       ,6,22,28,125,255,380
00548815,LA TECH COLG-HUEY P. LONG CAMPUS        ,LA,71483-0000,Public       ,7,12,19,44,132,176
00548816,LA TECH COLLEGE-JEFFERSON CAMPUS        ,LA,70001-5605,Public       ,1,18,19,28,170,198
00548817,LOUISIANA TEC CLG-JUMONVILLE MEM CP     ,LA,70760-0000,Public       ,5,14,19,60,119,179
00548818,LA TECH COLLEGE-LAFAYETTE CAMPUS        ,LA,70506-0000,Public       ,22,71,93,402,745,1147
00548819,LOUISIANA TECHNICAL COLLEGE-LAFOURC     ,LA,70301-4336,Public       ,7,13,20,73,161,234
00548820,LOUISIANA TEC CLG-LAMAR SALTER CMPS     ,LA,71446-0000,Public       ,5,22,27,74,216,290
00548822,LOUISIANA TECHNICAL CLG-MANSFIELD       ,LA,71052-1236,Public       ,5,18,23,44,142,186
00548823,LA. TECH COLG.-MORGAN SMITH CAMPUS      ,LA,70546-0000,Public       ,2,18,20,36,95,131
00548824,LOUISIANA TEC CLG-NATCHITOCHES CMPS     ,LA,71458-0000,Public       ,5,13,18,67,167,234
00548825,LOUISIANA TECH COLG-NORTH CTRL CMPS     ,LA,71241-0000,Public       ,3,7,10,27,83,110
00548826,LOUISIANA TECH CLG-NORTHEAST LA CMP     ,LA,71295-2999,Public       ,0,7,7,39,117,156
00548827,LOUISIANA TEC CLG-NW LOUISIANA CMPS     ,LA,71058-0000,Public       ,27,32,59,155,336,491
00548828,LA TECHNICAL COLG-OAKDALE CMPS          ,LA,71463-0000,Public       ,2,13,15,43,134,177
00548829,LTC-RIVER PARISHES CAMPUS               ,LA,70084-0000,Public       ,6,20,26,107,244,351
00548830,LOUISIANA TECHNICAL COLLEGE-RUSTON      ,LA,71273-0000,Public       ,6,15,21,229,228,457
00548831,LTC - SABINE VALLEY CAMPUS              ,LA,71449-3839,Public       ,10,15,25,47,106,153
00548832,LOUISIANA TECH COLG-SHELBY JACKSON      ,LA,71334-0000,Public       ,3,17,20,36,176,212
00548833,LA TECH COLG SHREVEPORT-BOSSIER         ,LA,71137-0000,Public       ,20,82,102,243,812,1055
00548835,LA TECHNICAL COLLEGE-SLIDELL CAMPUS     ,LA,70459-0000,Public       ,1,0,1,9,20,29
00548837,LOUISIANA TECH COLG-SULLIVAN CAMPUS     ,LA,70427-5866,Public       ,3,17,20,114,249,363
00548838,LOUISIANA TECHNICAL COLG - TALLULAH     ,LA,71284-0000,Public       ,10,27,37,77,169,246
00548839,LA TECH COLG-TECHE AREA CAMPUS          ,LA,70562-0000,Public       ,8,15,23,150,277,427
00548840,LOUISIANA TECH COLG-T.H.HARRIS CMPS     ,LA,70570-6113,Public       ,24,44,68,323,491,814
00548841,LOUISIANA TECH COLG W JEFFERSON CMP     ,LA,70058-0000,Public       ,0,3,3,17,45,62
00548842,LOUISIANA TECHNICAL COLLEGE - WESTSIDE C,LA,70765-0733,Public       ,0,4,4,15,67,82
00548843,LTC-YOUNG MEMORIAL CAMPUS               ,LA,70381-0000,Public       ,5,20,25,81,236,317
00576100,L. E. FLETCHER TECHNICAL COMMUNITY COLLE,LA,70360-2863,Public       ,12,10,22,407,412,819
00576101,L.E. FLETCHER TECHNICAL COMMUNITY COLLEG,LA,70360-7310,Public       ,2,4,6,69,72,141
00768600,SOUTHERN UNIV AT SHREVEPORT/BOSSIER     ,LA,71107-4795,Public       ,61,136,197,1080,2519,3599
00806700,LSU HEALTH SCIENCES CENTR-SHREVEPOR     ,LA,71130-3932,Public       ,6,14,20,166,788,954
00989800,DEMMON SCHOOL OF BEAUTY                 ,LA,70607-2128,Proprietary  ,0,6,6,16,72,88
01005701,AMERICAN COMMERCIAL COLLEGE             ,LA,71105-2502,Proprietary  ,4,46,50,38,281,319
01109700,CLOYD'S BEAUTY SCHOOL #1                ,LA,71291-3131,Proprietary  ,5,25,30,41,147,188
01112102,BRYMAN COLLEGE                          ,LA,70119-0000,Proprietary  ,0,0,0,12,37,49
01163100,"D-JAY'S SCHL OF BEAUTY, ARTS & SCI      ",LA,70806-0000,Proprietary  ,5,23,28,40,88,128
01184100,JOHN JAY BEAUTY COLLEGE                 ,LA,70124-2592,Proprietary  ,0,1,1,17,36,53
01261100,RONNIE & DORMANS SCHOOL HAIR DESIGN     ,LA,70501-0000,Proprietary  ,0,4,4,5,32,37
01282300,PAT GOINS RUSTON BEAUTY SCHOOL          ,LA,71270-4301,Proprietary  ,2,6,8,20,38,58
01287900,PAT GOINS BENTON ROAD BEAUTY SCHOOL     ,LA,71111-4838,Proprietary  ,3,10,13,21,61,82
01288000,PAT GOINS BEAUTY SCHOOL                 ,LA,71201-5167,Proprietary  ,3,6,9,14,37,51
02055400,BOSSIER PARISH COMMUNITY COLLEGE        ,LA,71111-0000,Public       ,72,132,204,2043,2972,5015
02055500,DELTA SCH OF BUSINESS & TECHNOLOGY      ,LA,70601-0000,Proprietary  ,29,60,89,140,527,667
02065100,REMINGTON COLLEGE - NEW ORLEANS CAMPUS  ,LA,70005-3007,Proprietary  ,0,0,0,2,5,7
02089711,HERZING COLLEGE                         ,LA,70062-8727,Proprietary  ,0,2,2,15,47,62
02117800,AVEDA INSTITUTE LAFAYETTE               ,LA,70503-3246,Proprietary  ,11,9,20,91,88,179
02166100,NUNEZ COMMUNITY COLLEGE                 ,LA,70043-0000,Public       ,47,96,143,274,637,911
02166200,ITI TECHNICAL COLLEGE                   ,LA,70817-0000,Proprietary  ,32,65,97,274,451,725
02197500,BATON ROUGE SCHOOL OF COMPUTERS         ,LA,70816-0000,Proprietary  ,1,7,8,44,83,127
02234000,CAMERON COLLEGE                         ,LA,70119-0000,Proprietary  ,2,37,39,16,122,138
02258400,AVEDA INSTITUTE BATON ROUGE             ,LA,70816-2246,Proprietary  ,12,14,26,135,105,240
02260200,DIESEL DRIVING ACADEMY                  ,LA,71109-5617,Proprietary  ,10,55,65,33,273,306
02263600,BASTROP BEAUTY SCHOOL #1                ,LA,71220-0000,Proprietary  ,0,16,16,13,49,62
02265600,JOHN JAY KENNER ACADEMY                 ,LA,70062-0000,Proprietary  ,7,18,25,52,93,145
02269300,STEVENSON'S ACADEMY OF HAIR DESIGN      ,LA,70116-0000,Proprietary  ,11,19,30,59,92,151
02323100,PAT GOINS SHREVEPORT BEAUTY SCHOOL      ,LA,71108-4354,Proprietary  ,1,7,8,11,35,46
02327800,PINEVILLE BEAUTY SCHOOL                 ,LA,71360-0000,Proprietary  ,8,13,21,40,58,98
02335701,BATON ROUGE GEN MED CTR SCH NSG         ,LA,70821-0000,Private      ,6,5,11,77,183,260
02335702,BATON ROUGE GEN MED CTR-RAD TECH        ,LA,70806-0000,Private      ,0,1,1,27,52,79
02338000,"CLOYD'S BEAUTY SCHOOL #2, INC           ",LA,71202-3539,Proprietary  ,5,26,31,41,150,191
02352500,"CLOYD'S BEAUTY SCHOOL #3, INC           ",LA,71201-3211,Proprietary  ,5,19,24,41,150,191
02358600,"STAGE ONE THE HAIR SCHOOL, INC.         ",LA,70605-0000,Proprietary  ,11,15,26,70,88,158
02493400,ALEXANDRIA ACADEMY OF BEAUTY CULT       ,LA,71301-0000,Proprietary  ,2,10,12,11,63,74
02518300,SOUTH LOUISIANA BEAUTY COLLEGE          ,LA,70363-0000,Proprietary  ,9,21,30,39,82,121
02536400,LOUISIANA ACADEMY OF BEAUTY             ,LA,70535-0000,Proprietary  ,2,11,13,29,53,82
02538300,DELTA COLLEGE OF ARTS & TECH INC        ,LA,70806-1529,Proprietary  ,12,64,76,104,457,561
02538301,DELTA COLLEGE OF ARTS & TECHNOLOGY - LAF,LA,70508-6831,Proprietary  ,2,9,11,26,128,154
02548500,COSMETOLOGY TRAINING CENTER             ,LA,70503-0000,Proprietary  ,6,8,14,63,65,128
02554800,VANGUARD COLLEGE OF COSMETOLOGY         ,LA,70458-8823,Proprietary  ,7,15,22,57,84,141
02582200,"GUY'S ACADEMY HAIR, SKIN & NAILS        ",LA,71105-2404,Proprietary  ,9,20,29,70,180,250
02600900,AVEDA INSTITUTE                         ,LA,70433-2922,Proprietary  ,41,55,96,430,625,1055
02601000,AMERICAN SCHOOL OF BUSINESS             ,LA,71105-5646,Proprietary  ,7,14,21,29,123,152
02601100,OPELOUSAS SCHOOL OF COSMETOLOGY         ,LA,70570-6156,Proprietary  ,3,6,9,18,49,67
02606800,CAREER TRAINING SPECIALISTS             ,LA,71201-6046,Proprietary  ,40,114,154,290,807,1097
02606801,CAREER TECHNICAL COLLEGE - SHREVEPORT   ,LA,71105-2405,Proprietary  ,12,64,76,86,437,523
02617100,BATON ROUGE COLLEGE                     ,LA,70816-2246,Proprietary  ,1,11,12,41,102,143
02619200,DENHAM SPRINGS BEAUTY COLLEGE           ,LA,70726-3829,Proprietary  ,6,8,14,27,73,100
03010400,CRESCENT CITY SCH GAMING & BARTENDG     ,LA,70119-5507,Proprietary  ,14,155,169,45,539,584
03023500,CAMELOT CAREER COLLEGE                  ,LA,70805-7539,Proprietary  ,16,44,60,122,273,395
03030900,DIESEL DRIVING ACADEMY                  ,LA,70815-8109,Proprietary  ,12,144,156,55,486,541
03061400,ASCENSION COLLEGE                       ,LA,70737-2912,Proprietary  ,11,52,63,86,175,261
03095100,GRETNA CAREER COLLEGE                   ,LA,70053-2436,Proprietary  ,8,56,64,46,234,280
03106200,OUR LADY OF THE LAKE COLLEGE            ,LA,70808-4345,Private      ,32,53,85,870,1810,2680
03253300,JONESVILLE BEAUTY SCHOOL                ,LA,71343-0000,Proprietary  ,0,10,10,14,49,63
03294300,BLUE CLIFF SCH THERAPEUTIC MASSAGE      ,LA,70002-3458,Proprietary  ,17,84,101,157,534,691
03322300,CULINARY INSTITUTE OF NEW ORLEANS       ,LA,70140-0000,Proprietary  ,0,0,0,27,33,60
03332600,DELTA COLLEGE                           ,LA,70433-9042,Proprietary  ,5,50,55,58,298,356
03332601,DELTA COLLEGE - SLIDELL                 ,LA,70460-2624,Proprietary  ,7,25,32,33,151,184
03356300,MEDICAL TRAINING COLLEGE                ,LA,70816-5820,Proprietary  ,9,40,49,106,311,417
03402300,METROPOLITAN COMMUNITY COLLEGE          ,LA,70053-6758,Proprietary  ,0,0,0,3,4,7
03422500,BLUE CLIFF COLLEGE                      ,LA,71107-6520,Proprietary  ,12,77,89,88,353,441
03422600,BLUE CLIFF COLLEGE                      ,LA,70508-3858,Proprietary  ,8,31,39,79,173,252
03480300,MEDVANCE INSTITUTE                      ,LA,70809-1908,Proprietary  ,58,315,373,427,2147,2574
03498400,OMEGA INSTITUTE OF COSMETOLOGY          ,LA,70360-0000,Proprietary  ,7,9,16,33,48,81
03727500,MOORE CAREER COLLEGE                    ,LA,70808-4191,Proprietary  ,3,13,16,41,101,142
03730300,BATON ROUGE COMMUNITY COLLEGE           ,LA,78806-4129,Public       ,128,168,296,3329,3356,6685
03752400,SCHOOL OF URBAN MISSIONS                ,LA,70053-0000,Private      ,5,8,13,33,81,114
03789300,UNITECH TRAINING ACADEMY                ,LA,70503-5132,Proprietary  ,36,159,195,167,811,978
03789400,RIVER PARISHES COMMUNITY COLLEGE        ,LA,70778-0310,Public       ,13,35,48,309,451,760
03795300,CASSIA BEAUTY COLLEGE                   ,LA,70126-0000,Proprietary  ,0,1,1,4,5,9
03810500,COURT REPORTING INSTITUTE OF LOUISI     ,LA,70816-0000,Proprietary  ,3,7,10,17,89,106
03858300,RAY'S FAITH ACADEMY OF BEAUTY EDUCATION ,LA,70737-0000,Proprietary  ,2,7,9,2,7,9
03932300,PROFESSIONAL CHEF'S INSTITUTE OF THE SOU,LA,70809-0000,Proprietary  ,0,0,0,7,2,9
03956300,SOUTH LOUISIANA COMMUNITY COLLEGE       ,LA,70506-0000,Public       ,21,44,65,748,960,1708
04040300,COMPASS CAREER COLLEGE                  ,LA,70403-0653,Proprietary  ,4,13,17,22,104,126
04112300,LOUISIANA CULINARY INSTITUTE            ,LA,70816-4109,Proprietary  ,11,11,22,11,14,25
00143600,CAPITOL COLLEGE                         ,MD,20708-9759,Private      ,7,16,23,310,304,614
00146200,WASHINGTON BIBLE COLLEGE                ,MD,20706-3599,Private      ,6,13,19,115,244,359
00205700,ALLEGANY COLLEGE OF MARYLAND            ,MD,21502-2596,Public       ,45,79,124,1720,1462,3182
00205800,ANNE ARUNDEL COMMUNITY COLLEGE          ,MD,21012-1895,Public       ,157,299,456,2747,3828,6575
00206000,BALTIMORE HEBREW UNIVERSITY             ,MD,21215-3996,Private      ,0,0,0,13,48,61
00206100,BALTIMORE CITY COMMUNITY COLLEGE        ,MD,21215-7893,Public       ,159,481,640,2416,6400,8816
00206200,BOWIE STATE UNIVERSITY                  ,MD,20715-9465,Public       ,163,117,280,6135,3355,9490
00206300,COMMUNITY COLLEGE OF BALTIMORE COUNTY   ,MD,21228-5381,Public       ,260,578,838,5078,8373,13451
00206400,COLLEGE OF SOUTHERN MARYLAND            ,MD,20646-0910,Public       ,89,111,200,1769,2165,3934
00206500,CLG NOTRE DAME OF MARYLAND              ,MD,21210-2476,Private      ,12,58,70,764,1200,1964
00206700,COLUMBIA UNION COLLEGE                  ,MD,20912-7796,Private      ,13,39,52,870,659,1529
00206800,COPPIN STATE UNIVERSITY                 ,MD,21216-3698,Public       ,88,118,206,3287,3312,6599
00207100,FREDERICK COMMUNITY COLLEGE             ,MD,21702-9745,Public       ,29,95,124,965,1345,2310
00207200,FROSTBURG STATE UNIVERSITY              ,MD,21532-1099,Public       ,82,36,118,4990,983,5973
00207300,GOUCHER COLLEGE                         ,MD,21204-2794,Private      ,27,15,42,2263,433,2696
00207400,HAGERSTOWN COMMUNITY COLLEGE            ,MD,21742-6590,Public       ,39,100,139,1100,1491,2591
00207500,HARFORD COMMUNITY COLLEGE               ,MD,21015-1696,Public       ,41,114,155,1175,1474,2649
00207600,HOOD COLLEGE                            ,MD,21701-8575,Private      ,24,24,48,1908,619,2527
00207700,JOHNS HOPKINS UNIVERSITY                ,MD,21218-2693,Private      ,44,39,83,4969,1056,6025
00207702,JOHNS HOPKINS UNIV SCH ARTS/SCI/ENG     ,MD,21218-0000,Private      ,17,60,77,3313,1100,4413
00207703,JOHNS HOPKINS UNIV SCH OF BUS/ED        ,MD,21046-0000,Private      ,0,70,70,34,1407,1441
00207705,JOHNS HOPKINS BLOOMBERG SCH OF PH       ,MD,21205-0000,Private      ,1,21,22,14,1074,1088
00207706,JOHNS HOPKINS UNIV SCH OF MEDICINE      ,MD,21205-0000,Private      ,4,11,15,70,822,892
00207707,JOHNS HOPKINS UNIV SCH OF NURSING       ,MD,21205-0000,Private      ,3,10,13,214,711,925
00207708,JOHNS HOPKINS UNIV PEABODY CONSERV      ,MD,21202-2397,Private      ,5,1,6,619,329,948
00207800,LOYOLA UNIVERSITY MARYLAND              ,MD,21210-2699,Private      ,50,34,84,5367,1532,6899
00208000,MARYLAND INST COLLEGE OF ART            ,MD,21217-4191,Private      ,17,7,24,2065,589,2654
00208300,MORGAN STATE UNIVERSITY                 ,MD,21251-0002,Public       ,205,129,334,9194,3541,12735
00208600,MOUNT SAINT MARY'S UNIVERSITY           ,MD,21727-7799,Private      ,24,16,40,2217,314,2531
00208700,NER ISRAEL RABBINICAL COLLEGE           ,MD,21208-1198,Private      ,3,3,6,85,47,132
00208900,PRINCE GEORGES COMMUNITY COLLEGE        ,MD,20774-2199,Public       ,179,342,521,3592,5490,9082
00209100,SALISBURY UNIVERSITY                    ,MD,21801-6862,Public       ,86,55,141,7163,1237,8400
00209200,ST JOHN'S COLLEGE                       ,MD,21404-0000,Private      ,1,8,9,593,172,765
00209500,ST. MARY'S COLLEGE OF MARYLAND          ,MD,20686-3001,Public       ,21,3,24,2161,139,2300
00209600,ST MARY'S SEMINARY & UNIV               ,MD,21210-1994,Private      ,1,0,1,12,31,43
00209900,TOWSON UNIVERSITY                       ,MD,21252-0002,Public       ,257,164,421,14917,4759,19676
00210200,UNIVERSITY OF BALTIMORE                 ,MD,21201-5779,Public       ,26,146,172,637,4836,5473
00210300,"UNIVERSITY OF MARYLAND, COLLEGE PARK    ",MD,20742-5145,Public       ,338,314,652,22754,8817,31571
00210400,"UNIVERSITY OF MARYLAND, BALTIMORE       ",MD,21201-1691,Public       ,49,143,192,2414,8010,10424
00210500,UMBC                                    ,MD,21250-0002,Public       ,162,104,266,7096,3193,10289
00210600,UNIVERSITY MARYLAND EASTERN SHORE       ,MD,21853-4053,Public       ,86,41,127,4582,1140,5722
00210700,STEVENSON UNIVERSITY                    ,MD,21153-0641,Private      ,40,28,68,3127,824,3951
00210800,WASHINGTON COLLEGE                      ,MD,21620-1197,Private      ,11,0,11,1722,77,1799
00210900,MCDANIEL COLLEGE                        ,MD,21157-4390,Private      ,20,24,44,2554,470,3024
00458612,KAPLAN COLLEGE                          ,MD,21742-2797,Proprietary  ,29,79,108,362,904,1266
00458614,KAPLAN COLLEGE - FREDERICK              ,MD,21704-8307,Proprietary  ,11,52,63,47,237,284
00465000,CHESAPEAKE COLLEGE                      ,MD,21679-0008,Public       ,26,49,75,744,997,1741
00691100,MONTGOMERY COLLEGE                      ,MD,20850-1195,Public       ,282,357,639,6383,6022,12405
00734100,INTERNATIONAL BEAUTY SCHOOL             ,MD,21502-2370,Proprietary  ,9,29,38,40,101,141
00744700,DEL-MAR-VA BEAUTY ACADEMY               ,MD,21804-0000,Proprietary  ,13,7,20,48,53,101
00749100,TESST COLLEGE OF TECHNOLOGY             ,MD,21227-1063,Proprietary  ,58,230,288,436,1565,2001
00793600,LINCOLN TECHNICAL INSTITUTE             ,MD,21046-1544,Proprietary  ,132,177,309,856,964,1820
00817500,HOWARD COMMUNITY COLLEGE                ,MD,21044-3197,Public       ,78,125,203,1722,2013,3735
00826300,AWARD BEAUTY SCHOOL                     ,MD,21740-5624,Proprietary  ,16,37,53,70,231,301
00830800,CECIL COLLEGE                           ,MD,21901-1999,Public       ,25,55,80,564,669,1233
01001400,GARRETT COMMUNITY COLLEGE               ,MD,21541-1265,Public       ,26,52,78,440,318,758
01031900,MEDIX SCHOOL                            ,MD,21204-2538,Proprietary  ,62,187,249,289,824,1113
01041000,TESST COLLEGE OF TECHNOLOGY             ,MD,21286-2201,Proprietary  ,37,113,150,319,685,1004
01164400,UNIV OF MARYLAND UNIVERSITY COLLEGE     ,MD,20783-8078,Public       ,98,1387,1485,1546,17609,19155
01164402,U OF MD UNIVERSITY COLLEGE - EUROPE     ,MD,20832-0000,Public       ,28,222,250,380,2276,2656
01164404,U OF MD UNIVERSITY COLLEGE - ASIA       ,MD,31207-0000,Public       ,7,112,119,110,1026,1136
02073900,WOR-WIC COMMUNITY COLLEGE               ,MD,21804-0000,Public       ,45,108,153,944,1640,2584
02083600,TESST COLLEGE OF TECHNOLOGY             ,MD,20705-2698,Proprietary  ,47,93,140,322,606,928
02116005,SANFORD-BROWN INSTITUTE - LANDOVER      ,MD,20785-2287,Proprietary  ,13,132,145,135,814,949
02127900,SOJOURNER DOUGLASS COLLEGE              ,MD,21205-0000,Private      ,11,161,172,104,1843,1947
02155100,MARYLAND COLLEGE OF ART AND DESIGN      ,MD,20902-0000,Private      ,2,1,3,62,37,99
02269700,INTERNATIONAL BEAUTY SCHOOL             ,MD,21014-0000,Proprietary  ,5,3,8,42,39,81
02288900,ABI-ACCUTECH BUSINESS INSTITUTE         ,MD,21703-0000,Proprietary  ,0,2,2,6,32,38
02314800,BALTIMORE INTERNATIONAL COLLEGE         ,MD,21202-0000,Private      ,15,29,44,504,395,899
02331000,MARYLAND BEAUTY ACADEMY OF ESSEX        ,MD,21221-0000,Proprietary  ,9,12,21,47,143,190
02333000,HAIR ACADEMY                            ,MD,20784-0000,Proprietary  ,15,46,61,125,307,432
02343800,MONTGOMERY BEAUTY SCHOOL                ,MD,20901-0000,Proprietary  ,11,32,43,56,172,228
02494700,BALTIMORE STUDIO OF HAIR DESIGN         ,MD,21201-0000,Proprietary  ,12,23,35,95,194,289
02495000,ROBERT PAUL ACAD COSMTGY ARTS & SCI     ,MD,21093-0000,Proprietary  ,4,6,10,71,64,135
02495100,MARYLAND BEAUTY ACADEMY                 ,MD,21136-0000,Proprietary  ,0,4,4,15,49,64
02545400,NORTH AMERICAN TRADE SCHOOLS            ,MD,21244-0069,Proprietary  ,17,158,175,151,742,893
02573800,"L' ACADEMIE DE CUISINE, INC.            ",MD,20877-0000,Proprietary  ,1,7,8,29,116,145
02578400,TAI SOPHIA INSTITUTE                    ,MD,20723-6010,Private      ,1,8,9,1,234,235
03021002,HARRISON CAREER INSTITUTE-BALTIMORE     ,MD,21201-0000,Proprietary  ,0,0,0,2,20,22
03027200,BLADES SCHOOL OF HAIR DESIGN            ,MD,20619-0226,Proprietary  ,4,9,13,31,79,110
03064900,AARON'S ACADEMY OF BEAUTY               ,MD,20602-2715,Proprietary  ,3,5,8,25,51,76
03097200,AESTHETICS INSTITUTE OF COSMETOLOGY     ,MD,20877-1305,Proprietary  ,0,7,7,6,55,61
03100700,CARROLL COMMUNITY COLLEGE               ,MD,21157-6913,Public       ,16,40,56,633,578,1211
03148300,AMERICAN BEAUTY ACADEMY                 ,MD,20902-1911,Proprietary  ,28,71,99,134,330,464
03296300,BALTIMORE SCHOOL OF MASSAGE             ,MD,21090-2261,Proprietary  ,13,87,100,146,460,606
03327300,NEW CREATIONS ACADEMY OF HAIR DSN       ,MD,20746-2960,Proprietary  ,2,14,16,12,52,64
03455500,NATIONAL LABOR COLLEGE                  ,MD,20903-1790,Private      ,0,0,0,1,15,16
03493300,ALL-STATE CAREER SCHOOL                 ,MD,21224-6658,Proprietary  ,39,302,341,205,1177,1382
03771300,AMERICAN CAREER INSTITUTE               ,MD,20902-4637,Proprietary  ,2,17,19,17,74,91
03822400,MAPLE SPRINGS BAPTIST BIBLE COLLEGE & SE,MD,20743-5711,Private      ,0,3,3,2,19,21
03965500,HAIR EXPRESSIONS ACADEMY                ,MD,20852-1729,Proprietary  ,4,14,18,27,52,79
        ,MGH INSTITUTE OF HEALTH PROFESSION      ,MA,02129-0000,Private      ,1,17,18,10,667,677
00211400,AMERICAN INTERNATIONAL COLLEGE          ,MA,01109-3189,Private      ,19,52,71,1645,1124,2769
00211500,AMHERST COLLEGE                         ,MA,01002-5000,Private      ,15,1,16,2945,69,3014
00211600,ANDOVER NEWTON THEOLOGICAL SCHOOL       ,MA,02459-0000,Private      ,0,6,6,0,215,215
00211700,ANNA MARIA COLLEGE                      ,MA,01612-1198,Private      ,22,13,35,831,264,1095
00211800,ASSUMPTION COLLEGE                      ,MA,01615-1294,Private      ,32,8,40,3594,359,3953
00211900,ATLANTIC UNION COLLEGE                  ,MA,01561-1000,Private      ,11,8,19,373,270,643
00212000,MERRIMACK COLLEGE                       ,MA,01845-5800,Private      ,34,3,37,3321,112,3433
00212100,BABSON COLLEGE                          ,MA,02457-0310,Private      ,14,44,58,1846,682,2528
00212200,BAY PATH COLLEGE                        ,MA,01106-2212,Private      ,6,62,68,735,1147,1882
00212300,BECKER COLLEGE-WORCESTER                ,MA,01615-0071,Private      ,26,50,76,1969,804,2773
00212400,BENTLEY UNIVERSITY                      ,MA,02452-4705,Private      ,37,26,63,5362,697,6059
00212600,BERKLEE COLLEGE OF MUSIC                ,MA,02215-3693,Private      ,44,23,67,3405,711,4116
00212800,BOSTON COLLEGE                          ,MA,02467-3800,Private      ,104,63,167,15458,5249,20707
00212900,BOSTON CONSERVATORY OF MUSIC            ,MA,02215-9830,Private      ,4,3,7,759,238,997
00213000,BOSTON UNIVERSITY                       ,MA,02215-1789,Private      ,177,282,459,23490,13243,36733
00213300,BRANDEIS UNIVERSITY                     ,MA,02453-2700,Private      ,28,10,38,4310,760,5070
00213900,CLARK UNIVERSITY                        ,MA,01610-1473,Private      ,20,8,28,3612,541,4153
00214000,ELMS COLLEGE                            ,MA,01013-2839,Private      ,9,8,17,893,457,1350
00214100,COLLEGE OF THE HOLY CROSS               ,MA,01610-2395,Private      ,42,3,45,4750,33,4783
00214300,CURRY COLLEGE                           ,MA,02186-2395,Private      ,30,44,74,3064,868,3932
00214400,DEAN COLLEGE                            ,MA,02038-1994,Private      ,16,6,22,1332,128,1460
00214500,EASTERN NAZARENE COLLEGE                ,MA,02170-2999,Private      ,9,31,40,759,422,1181
00214507,EASTERN NAZARENE CLG - LEAD PROGRAM     ,MA,02170-0000,Private      ,0,4,4,13,55,68
00214600,EMERSON COLLEGE                         ,MA,02116-4624,Private      ,28,12,40,4956,1352,6308
00214700,EMMANUEL COLLEGE                        ,MA,02115-5798,Private      ,32,22,54,2890,324,3214
00214800,ENDICOTT COLLEGE                        ,MA,01915-2098,Private      ,22,15,37,3313,187,3500
00214900,EPISCOPAL DIVINITY SCHOOL               ,MA,02138-0000,Private      ,0,5,5,1,52,53
00215000,FISHER COLLEGE                          ,MA,02116-1500,Private      ,33,80,113,1160,800,1960
00215100,BENJAMIN FRANKLIN INSTITUTE OF TECH     ,MA,02116-6296,Public       ,6,9,15,435,180,615
00215300,GORDON COLLEGE                          ,MA,01984-1899,Private      ,14,3,17,1660,81,1741
00215400,HELLENIC COLLEGE                        ,MA,02445-7496,Private      ,4,2,6,58,100,158
00215500,HARVARD UNIVERSITY                      ,MA,02138-3800,Private      ,38,15,53,4073,587,4660
00215501,AMRCN REPERTORY THTR INST ADV THTR      ,MA,02138-0000,Private      ,0,1,1,1,110,111
00215502,HARVARD BUSINESS SCHOOL                 ,MA,02163-0000,Private      ,7,8,15,159,1538,1697
00215503,HARVARD EXTENSION SCHOOL                ,MA,02138-0000,Private      ,3,38,41,88,735,823
00215504,HARVARD SCH OF DENTAL MEDICINE          ,MA,02115-0000,Private      ,1,2,3,6,220,226
00215505,HARVARD UNIV GRAD SCH DESIGN            ,MA,02138-0000,Private      ,0,2,2,12,790,802
00215506,HARVARD DIVINITY SCHOOL                 ,MA,02138-0000,Private      ,0,6,6,23,647,670
00215507,HARVARD UNIV GRAD SCH ED                ,MA,02138-0000,Private      ,1,9,10,13,1201,1214
00215508,HARVARD UNIV GRAD S OF ARTS & SCIEN     ,MA,02138-0000,Private      ,2,13,15,83,789,872
00215509,HARVARD JOHN F KENNEDY SCHL OF GOVT     ,MA,02138-0000,Private      ,0,8,8,16,1023,1039
00215510,HARVARD LAW SCHOOL                      ,MA,02138-0000,Private      ,1,11,12,52,3255,3307
00215511,HARVARD UNIV MEDICAL SCHOOL             ,MA,02115-0000,Private      ,3,4,7,92,891,983
00215512,HARVARD UNIV SCH PUBLIC HEALTH          ,MA,02115-0000,Private      ,0,1,1,18,571,589
00215513,HARVARD UNIVERSITY-HARVARD COLLEGE      ,MA,02138-0000,Private      ,70,4,74,10059,247,10306
00215700,HEBREW COLLEGE                          ,MA,02459-2237,Private      ,0,2,2,4,101,105
00215800,LASELL COLLEGE                          ,MA,02466-2716,Private      ,17,1,18,2047,93,2140
00216000,LESLEY UNIVERSITY                       ,MA,02138-2790,Private      ,24,415,439,1680,5616,7296
00216100,UMASS LOWELL                            ,MA,01854-3089,Public       ,109,123,232,6650,2816,9466
00216300,MARIST COLLEGE & SEMINARY               ,MA,01701-0000,Private      ,0,3,3,5,324,329
00216400,NEW ENGLAND COLLEGE OF OPTOMETRY        ,MA,02115-1129,Private      ,0,4,4,4,441,445
00216500,MASS. COLLEGE OF PHARMACY  & HEALTH SCIE,MA,02115-5804,Private      ,17,10,27,2583,1936,4519
00216700,BERKSHIRE COMMUNITY COLLEGE             ,MA,01201-5786,Public       ,23,35,58,709,848,1557
00216800,CAPE COD COMMUNITY COLLEGE              ,MA,02668-1599,Public       ,29,65,94,1113,1276,2389
00216900,GREENFIELD COMMUNITY COLLEGE            ,MA,01301-9739,Public       ,35,66,101,683,1078,1761
00217000,HOLYOKE COMMUNITY COLLEGE               ,MA,01040-1099,Public       ,94,144,238,2614,2993,5607
00217100,MASSACHUSETTS BAY COMMUNITY COLLEGE     ,MA,02181-0000,Public       ,58,89,147,1506,1746,3252
00217200,MOUNT WACHUSETT COMMUNITY COLLEGE       ,MA,01440-1000,Public       ,40,89,129,1325,2008,3333
00217300,NORTH SHORE COMMUNITY COLLEGE           ,MA,01923-4093,Public       ,92,126,218,1988,2924,4912
00217400,NORTHERN ESSEX COMMUNITY COLLEGE        ,MA,01830-2399,Public       ,133,260,393,1885,2971,4856
00217500,QUINSIGAMOND COMMUNITY COLLEGE          ,MA,01606-2092,Public       ,77,139,216,2100,2492,4592
00217600,BRISTOL COMMUNITY COLLEGE               ,MA,02720-7399,Public       ,69,108,177,2349,2733,5082
00217700,MASSASOIT COMMUNITY COLLEGE             ,MA,02302-3996,Public       ,52,71,123,2315,2390,4705
00217800,MASSACHUSETTS INST OF TECHNOLOGY        ,MA,02139-4307,Private      ,37,34,71,7392,2125,9517
00218000,MASSACHUSETTS COLLEGE OF ART AND DESIGN ,MA,02115-5803,Public       ,21,11,32,1915,680,2595
00218100,MASSACHUSETTS MARITIME ACADEMY          ,MA,02532-3400,Public       ,10,3,13,915,72,987
00218300,BRIDGEWATER STATE COLLEGE               ,MA,02325-0001,Public       ,101,62,163,8441,2139,10580
00218400,FITCHBURG STATE COLLEGE                 ,MA,01420-2697,Public       ,48,35,83,4078,1010,5088
00218500,FRAMINGHAM STATE COLLEGE                ,MA,01702-2471,Public       ,41,20,61,4328,800,5128
00218700,MASSACHUSETTS CLG OF LIBERAL ARTS       ,MA,01247-4100,Public       ,21,11,32,1571,476,2047
00218800,SALEM STATE COLLEGE                     ,MA,01970-5353,Public       ,106,88,194,6474,2508,8982
00218900,WESTFIELD STATE COLLEGE                 ,MA,01086-1630,Public       ,50,20,70,5654,940,6594
00219000,WORCESTER STATE COLLEGE                 ,MA,01602-2597,Public       ,39,38,77,4125,1443,5568
00219200,MOUNT HOLYOKE COLLEGE                   ,MA,01075-1492,Private      ,17,0,17,2213,225,2438
00219300,MOUNT IDA COLLEGE                       ,MA,02459-3323,Private      ,22,4,26,1945,268,2213
00219400,NEW ENGLAND CONSERVATORY OF MUSIC       ,MA,02115-5018,Private      ,3,2,5,645,651,1296
00219700,NICHOLS COLLEGE                         ,MA,01571-6346,Private      ,10,12,22,1363,194,1557
00219900,NORTHEASTERN UNIVERSITY                 ,MA,02115-5000,Private      ,207,183,390,24470,7044,31514
00220100,PINE MANOR COLLEGE                      ,MA,02167-0000,Private      ,11,1,12,604,95,699
00220200,BLESSED JOHN XXIII NATIONAL SEMINARY    ,MA,02493-0000,Private      ,0,0,0,1,3,4
00220500,QUINCY COLLEGE                          ,MA,02169-4501,Public       ,30,83,113,885,1809,2694
00220600,REGIS COLLEGE                           ,MA,02193-0000,Private      ,17,20,37,861,512,1373
00220800,SIMMONS COLLEGE                         ,MA,02115-5898,Private      ,19,53,72,2467,2719,5186
00220900,SMITH COLLEGE                           ,MA,01063-2936,Private      ,18,9,27,2929,900,3829
00221000,UNIV OF MASSACHUSETTS-DARTMOUTH         ,MA,02747-2300,Public       ,90,42,132,8558,1759,10317
00221100,SPRINGFIELD COLLEGE                     ,MA,01109-3797,Private      ,30,136,166,3383,3749,7132
00221400,ST JOHN'S SEMINARY                      ,MA,02135-8839,Private      ,3,28,31,14,86,100
00221700,STONEHILL COLLEGE                       ,MA,02357-6110,Private      ,32,0,32,4717,117,4834
00221800,SUFFOLK UNIVERSITY                      ,MA,02108-2770,Private      ,73,45,118,6764,2085,8849
00221802,SUFFOLK UNIVERSITY LAW SCHOOL           ,MA,02108-0000,Private      ,3,12,15,116,2545,2661
00221900,TUFTS UNIVERSITY                        ,MA,02155-5808,Private      ,47,33,80,8009,2187,10196
00221901,TUFTS UNIV SCH OF DENTAL MEDICINE       ,MA,02111-0000,Private      ,0,5,5,17,802,819
00221902,TUFTS UNIVERSITY - CUMMINGS SCHOOL OF VE,MA,01536-0000,Private      ,0,2,2,20,414,434
00221904,TUFTS UNIV SCHOOL OF MEDICINE           ,MA,02111-0000,Private      ,1,3,4,46,1243,1289
00222100,UNIV OF MASSACHUSETTS-AMHERST           ,MA,01003-0000,Public       ,296,133,429,23822,5540,29362
00222200,UNIV OF MASSACHUSETTS-BOSTON            ,MA,02125-3393,Public       ,135,192,327,6151,6411,12562
00222400,WELLESLEY COLLEGE                       ,MA,02481-8203,Private      ,25,5,30,2892,129,3021
00222500,WENTWORTH INSTITUTE OF TECHNOLOGY       ,MA,02115-5998,Private      ,24,14,38,3432,457,3889
00222600,WESTERN NEW ENGLAND COLLEGE             ,MA,01119-2654,Private      ,39,15,54,4344,1301,5645
00222700,WHEATON COLLEGE                         ,MA,02766-2322,Private      ,19,1,20,2381,39,2420
00222800,WHEELOCK COLLEGE                        ,MA,02215-4176,Private      ,13,11,24,1002,588,1590
00222900,WILLIAMS COLLEGE                        ,MA,01267-2600,Private      ,18,0,18,2706,62,2768
00223300,WORCESTER POLYTECHNIC INSTITUTE         ,MA,01609-2280,Private      ,17,11,28,4400,326,4726
00396500,BAY STATE COLLEGE                       ,MA,02116-2901,Proprietary  ,21,31,52,940,419,1359
00396600,BOSTON ARCHITECTURAL COLLEGE            ,MA,02115-2795,Private      ,9,25,34,350,793,1143
00466100,HAMPSHIRE COLLEGE                       ,MA,01002-3359,Private      ,17,1,18,2116,81,2197
00466600,SALTER COLLEGE                          ,MA,01583-1700,Proprietary  ,113,455,568,627,2561,3188
00466700,SCHOOL OF MUSEUM OF FINE ARTS           ,MA,02115-5534,Private      ,11,2,13,789,314,1103
00466900,UPPER CAPE COD REGIONAL VOC TECH        ,MA,02532-3310,Public       ,0,0,0,9,46,55
00527900,GREATER LOWELL REGNL VOC TECH SCH       ,MA,01879-0000,Public       ,0,1,1,12,61,73
00551900,DIMAN REGIONAL VOC TECH INST            ,MA,02723-3519,Public       ,0,1,1,13,68,81
00552300,BLUE HILLS REGIONAL VOC TECH            ,MA,02021-1398,Public       ,0,6,6,23,125,148
00555700,MCCANN TECHNICAL SCHOOL                 ,MA,01247-0000,Public       ,0,2,2,21,49,70
00613600,NATIONAL AVIATION ACADEMY - NEW ENGLAND ,MA,01730-2620,Proprietary  ,16,13,29,135,157,292
00632200,BROCKTON HOSPITAL SCH OF NURSING        ,MA,02302-0000,Private      ,0,2,2,97,371,468
00632400,LABOURE COLLEGE                         ,MA,02124-5698,Private      ,6,17,23,147,579,726
00633100,LAWRENCE MEM HOSPITAL SCH OF NRSNG      ,MA,02155-1643,Private      ,1,8,9,61,381,442
00687300,MARIAN COURT COLLEGE                    ,MA,01907-2896,Private      ,2,11,13,181,123,304
00748100,GIBBS COLLEGE                           ,MA,02116-2904,Proprietary  ,28,60,88,404,593,997
00748400,NEWBURY COLLEGE                         ,MA,02445-5796,Private      ,24,8,32,1356,285,1641
00748600,THE NEW ENGLAND INSTITUTE OF ART        ,MA,02445-7295,Proprietary  ,51,21,72,1481,563,2044
00748800,KAPLAN CAREER INSTITUTE                 ,MA,02129-1644,Proprietary  ,33,96,129,181,474,655
00807800,SPRINGFIELD TECHNICAL COMMUNITY CLG     ,MA,01105-0000,Public       ,69,179,248,2101,3736,5837
00891600,NEW ENGLAND SCHOOL OF LAW               ,MA,02116-0000,Private      ,1,9,10,9,2028,2037
00912900,EMPIRE BEAUTY SCHOOL                    ,MA,02148-0000,Proprietary  ,3,2,5,33,58,91
00964500,BARD COLLEGE AT SIMON'S ROCK            ,MA,01230-9702,Private      ,4,0,4,334,8,342
00974700,GORDON-CONWELL THEOLOGICAL SEMINARY     ,MA,01982-0000,Private      ,0,7,7,3,665,668
00975600,UNIVERSITY OF MASS MEDICAL CENTER       ,MA,01655-0000,Public       ,0,12,12,17,742,759
00987700,HENRI'S SCHOOL OF HAIR DESIGN           ,MA,01420-5675,Proprietary  ,1,3,4,36,31,67
00989900,LOWELL ACADEMY HAIRSTYLING INST         ,MA,01852-1909,Proprietary  ,7,10,17,32,50,82
00993600,MIDDLESEX COMMUNITY COLLEGE             ,MA,01730-1197,Public       ,66,55,121,1086,795,1881
00993602,"MIDDLESEX COMMUNITY COLLEGE, LOWELL     ",MA,01852-0000,Public       ,104,122,226,1864,1425,3289
01121000,BUNKER HILL COMMUNITY COLLEGE           ,MA,02129-2991,Public       ,86,148,234,2751,4488,7239
01151000,EVEREST INSTITUTE                       ,MA,02135-7638,Proprietary  ,65,195,260,403,1116,1519
01193000,ROXBURY COMMUNITY COLLEGE               ,MA,02120-3400,Public       ,48,150,198,719,2177,2896
01204200,MANSFIELD BEAUTY SCHOOLS                ,MA,02169-5061,Proprietary  ,5,15,20,33,77,110
01206800,MANSFIELD BEAUTY SCHOOL                 ,MA,01103-1410,Proprietary  ,2,21,23,14,82,96
01238600,SOUTHEASTERN TECHNICAL INSTITUTE        ,MA,02375-1780,Public       ,2,3,5,37,120,157
01241400,EMPIRE BEAUTY SCHOOL                    ,MA,02116-1914,Proprietary  ,0,0,0,17,29,46
01255300,WHITTIER REGIONAL VOC TECH SCHOOL       ,MA,01830-1898,Public       ,0,0,0,2,6,8
01288100,MONTACHUSETT REG VOC TECH SCH           ,MA,01420-4649,Public       ,0,3,3,9,46,55
01292100,EMPIRE BEAUTY SCHOOL                    ,MA,02215-0000,Proprietary  ,31,61,92,166,309,475
01294800,ROB ROY ACADEMY                         ,MA,02721-5330,Proprietary  ,18,26,44,55,99,154
02063000,MONTSERRAT COLLEGE OF ART               ,MA,01915-0000,Private      ,8,0,8,407,48,455
02063800,BUTERA SCHOOL OF ART                    ,MA,02116-0000,Proprietary  ,1,0,1,50,9,59
02076700,EMPIRE BEAUTY SCHOOL                    ,MA,02148-0000,Proprietary  ,9,25,34,79,152,231
02079400,EMPIRE BEAUTY SCHOOL                    ,MA,02453-0000,Proprietary  ,16,42,58,90,174,264
02092100,MASSACHUSETTS SCHOOL OF BARBERING       ,MA,02169-0000,Proprietary  ,3,11,14,20,66,86
02092200,EMPIRE BEAUTY SCHOOL                    ,MA,01852-0000,Proprietary  ,16,32,48,82,172,254
02122000,NEW ENGLAND HAIR ACADEMY                ,MA,02148-0000,Proprietary  ,9,16,25,52,85,137
02137000,ROB ROY ACADEMY                         ,MA,02780-0000,Proprietary  ,8,7,15,29,35,64
02137200,MASS GEN HOSP DIETETIC INTERNSHIP       ,MA,02114-0000,Private      ,0,0,0,2,6,8
02143000,LONGY SCHOOL OF MUSIC                   ,MA,02138-3599,Private      ,1,1,2,32,116,148
02161300,WESTON JESUIT SCHOOL OF THEOLOGY        ,MA,02138-0000,Private      ,0,0,0,1,75,76
02163500,NEW ENGLAND SCHOOL OF PHOTOGRAPHY       ,MA,02215-0000,Proprietary  ,6,2,8,99,106,205
02169900,ASSABET VALLEY REGIONAL VOC SCHOOL      ,MA,01752-0000,Public       ,0,5,5,10,55,65
02181600,ROB ROY ACADEMY                         ,MA,01609-0000,Proprietary  ,12,26,38,85,141,226
02182900,CAMBRIDGE COLLEGE                       ,MA,02138-5304,Private      ,10,573,583,150,4596,4746
02197900,NORTH BENNET STREET SCHOOL              ,MA,02113-0000,Private      ,1,3,4,36,104,140
02215100,HALLMARK INSTITUTE OF PHOTOGRAPHY       ,MA,01376-0000,Proprietary  ,1,1,2,186,163,349
02219501,MILDRED ELLEY - PITTSFIELD              ,MA,01201-5300,Proprietary  ,0,0,0,4,6,10
02220400,CATHERINE HINDS INST OF ESTHETICS       ,MA,01801-0000,Proprietary  ,6,31,37,64,169,233
02237100,JOSEPH P KEEFE TECHNICAL SCHOOL         ,MA,01701-5698,Public       ,0,0,0,0,3,3
02274300,CONWAY SCHOOL OF LANDSCAPE DESIGN       ,MA,01341-0179,Private      ,0,1,1,0,14,14
02325700,LABARON HAIRDRESSING ACADEMY            ,MA,02740-0000,Proprietary  ,3,6,9,22,48,70
02325800,LABARON HAIRDRESSING ACAD-BROCKTON      ,MA,02301-0000,Proprietary  ,6,10,16,26,38,64
02337400,BANCROFT SCHOOL OF MASSAGE THERAPY      ,MA,01604-4614,Proprietary  ,1,7,8,25,88,113
02338200,BAY STATE SCHOOL OF TECHNOLOGY          ,MA,02021-0000,Proprietary  ,7,60,67,48,277,325
02339400,ROB ROY ACADEMY                         ,MA,02746-0000,Proprietary  ,3,7,10,13,34,47
02491700,CORTIVA INSTITUTE -  BOSTON             ,MA,02472-2577,Proprietary  ,4,22,26,25,190,215
02523900,ELIZABETH GRADY SCHOOL OF ESTHETICS     ,MA,02155-0000,Proprietary  ,4,14,18,30,66,96
02579800,NEW ENGLAND SCHOOL OF ACUPUNCTURE       ,MA,02458-0000,Private      ,0,1,1,0,145,145
02614901,SANFORD-BROWN INSTITUTE - SPRINGFIELD   ,MA,01104-1739,Proprietary  ,0,1,1,9,19,28
03066700,AILANO SCHOOL OF COSMETOLOGY            ,MA,02303-4740,Proprietary  ,5,6,11,32,35,67
03104000,SHAWSHEEN ADULT TECHNICAL INSTITUTE     ,MA,01821-5499,Public       ,0,0,0,8,36,44
03120800,KAY HARVEY HAIRDRESSING ACADEMY         ,MA,01089-2701,Proprietary  ,1,10,11,19,59,78
03127700,SOUTHERN NEW ENGLAND SCHOOL OF LAW      ,MA,02747-1252,Private      ,0,4,4,2,270,272
03130500,URBAN COLLEGE OF BOSTON                 ,MA,02111-1093,Private      ,0,33,33,32,564,596
03194300,BOSTON GRAD SCH OF PSYCHOANALYSIS       ,MA,02446-4602,Private      ,0,5,5,1,59,60
03196300,LINCOLN TECHNICAL INSTITUTE             ,MA,02145-1102,Proprietary  ,45,90,135,224,538,762
03196302,LINCOLN TECHNICAL INSTITUTE             ,MA,01852-5119,Proprietary  ,34,67,101,193,385,578
03205400,JOLIE HAIR & BEAUTY ACADEMY             ,MA,01056-2769,Proprietary  ,3,17,20,8,38,46
03232302,LINCOLN TECHNICAL INSTITUTE             ,MA,02401-1818,Proprietary  ,15,63,78,90,235,325
03235300,MASSACHUSETTS SCHOOL OF LAW             ,MA,01810-1094,Private      ,0,13,13,6,562,568
03240300,HAIR IN MOTION BEAUTY ACADEMY           ,MA,01604-2213,Proprietary  ,5,6,11,16,24,40
03248300,BOSTON BAPTIST COLLEGE                  ,MA,02136-4000,Private      ,6,0,6,97,40,137
03316400,FUNERAL INSTITUTE OF THE NORTHEAST      ,MA,02062-4766,Proprietary  ,1,1,2,19,65,84
03504300,NATL GRAD SCH OF QUALITY SYSTM MGMT     ,MA,02540-0000,Private      ,0,22,22,0,52,52
03763300,MEDICAL PROFESSIONAL INSTITUTE          ,MA,02148-8143,Proprietary  ,1,9,10,4,51,55
03859300,E.I.N.E.                                ,MA,01876-4709,Proprietary  ,0,8,8,5,36,41
03946300,FRANKLIN W. OLIN COLLEGE OF ENGINEERING ,MA,02492-1200,Private      ,0,0,0,21,0,21
04039300,SULLIVAN AND COGLIANO TRAINING CENTER   ,MA,02301-1822,Proprietary  ,15,94,109,18,219,237
00401000,INSTITUT INTERNAT'L D'ETUDES FRANCA     ,FC,00000-0000,Public       ,0,0,0,1,3,4
00401200,HEBREW UNIVERSITY OF JERUSALEM (THE)    ,FC,00000-0000,Public       ,0,3,3,60,161,221
00403000,UNIVERSITY OF CAMBRIDGE                 ,FC,00000-0000,Public       ,0,0,0,1,32,33
00503400,AMERICAN UNIVERSITY OF CAIRO            ,FC,00000-0000,Private      ,4,4,8,84,154,238
00667100,KATHOLIEKE UNIVERSITEIT LEUVEN          ,FC,00000-0000,Private      ,1,1,2,3,39,42
00669000,UNIVERSITY OF COPENHAGEN                ,FC,00000-0000,Public       ,1,0,1,1,10,11
00669100,UNIVERSITY OF CAMBRIDGE - PEMBROKE      ,FC,00000-0000,Public       ,1,0,1,2,8,10
00669200,UNIVERSITY OF LEEDS                     ,FC,00000-0000,Public       ,0,2,2,11,78,89
00669300,UNIV OF LONDON-LONDON SCHOOL ECON       ,FC,00000-0000,Public       ,0,3,3,27,483,510
00669400,SCH OF ORIENTAL & AFRICAN STUDIES       ,FC,00000-0000,Public       ,0,1,1,12,145,157
00669500,UNIV OF LONDON-UNIVERSITY COLLEGE       ,FC,00000-0000,Public       ,0,2,2,36,297,333
00669600,UNIV OF LONDON-SCH ADVANCED STUDY       ,FC,00000-0000,Public       ,0,0,0,0,22,22
00669700,"QUEEN MARY, UNIVERSITY OF LONDON        ",FC,00000-0000,Public       ,0,1,1,13,92,105
00669900,UNIVERSITY OF SUSSEX                    ,FC,00000-0000,Public       ,0,0,0,9,85,94
00670000,"UNIVERSITY OF YORK, THE                 ",FC,00000-0000,Public       ,0,0,0,9,96,105
00670400,UNIVERSITY COLLEGE CORK                 ,FC,00000-0000,Public       ,0,0,0,18,51,69
00671300,UPPSALA UNIVERSITY                      ,FC,00000-0000,Public       ,0,0,0,1,17,18
00671500,UNIVERSITY OF GENEVA                    ,FC,00000-0000,Public       ,0,0,0,0,32,32
00683900,UNIVERSITY OF EDINBURGH                 ,FC,00000-0000,Public       ,0,5,5,80,369,449
00684200,UNIVERSITY OF DUBLIN TRINITY COLLEG     ,FC,00000-0000,Public       ,0,0,0,26,142,168
00685000,UNIVERSITY OF CAMBRIDGE - DOWNING C     ,FC,00000-0000,Public       ,0,0,0,0,2,2
00685100,INTERNATIONAL CHRISTIAN UNIVERSITY      ,FC,00000-0000,Private      ,0,0,0,9,9,18
00763200,UNIVERSITY OF BRISTOL                   ,FC,00000-0000,Public       ,0,0,0,13,66,79
00768100,COLLEGE OF EUROPE                       ,FC,00000-0000,Private      ,0,0,0,3,6,9
00770500,ROYAL COLLEGE OF SURGEONS IN IRELAN     ,FC,00000-0000,Private      ,0,0,0,8,64,72
00788100,AMERICAN UNIVERSITY OF PARIS            ,FC,00000-0000,Private      ,4,1,5,239,113,352
00837100,AMERICAN UNIVERSITY OF BEIRUT           ,FC,00000-0000,Private      ,3,0,3,69,59,128
00837300,TEL-AVIV UNIVERSITY                     ,FC,00000-0000,Public       ,0,0,0,15,64,79
00837700,UNIVERSITEIT VAN AMSTERDAM(UNIVERSI     ,FC,00000-0000,Public       ,0,1,1,10,116,126
00838000,UNIVERSITY OF WARWICK                   ,FC,00000-0000,Public       ,0,1,1,6,49,55
00838300,UNIVERSITY OF GLASGOW                   ,FC,00000-0000,Public       ,1,2,3,34,252,286
00838600,UNIVERSITY OF HELSINKI                  ,FC,00000-0000,Public       ,0,0,0,1,8,9
00839300,UNIVERSITY OF OSLO                      ,FC,00000-0000,Public       ,0,0,0,2,19,21
00839400,UNIVERSITY OF OXFORD                    ,FC,00000-0000,Public       ,0,0,0,15,171,186
00839800,UNIVERSITY OF SHEFFIELD (THE)           ,FC,00000-0000,Public       ,0,3,3,5,56,61
00839900,UNIVERSITY OF SOUTHAMPTON               ,FC,00000-0000,Public       ,0,1,1,5,39,44
00845000,KASTURBA MEDICAL COLLEGE (A CONSTITENT I,FC,00000-0000,Private      ,0,4,4,40,401,441
00845200,ABERYSTWYTH UNIVERSITY                  ,FC,00000-0000,Public       ,0,0,0,11,32,43
00846000,UNIVERSITY OF NEWCASTLE UPON TYNE       ,FC,00000-0000,Public       ,1,0,1,5,43,48
00846100,UNIVERSITY OF SAINT ANDREWS             ,FC,00000-0000,Public       ,2,3,5,125,129,254
00846200,UNIVERSIDAD DE SALAMANCA                ,FC,00000-0000,Public       ,0,5,5,9,50,59
00850500,UNIVERSITY OF MELBOURNE                 ,FC,00000-0000,Public       ,0,10,10,15,129,144
00858600,SWANSEA UNIVERSITY                      ,FC,00000-0000,Public       ,0,0,0,7,44,51
00858700,UNIVERSITY OF DURHAM                    ,FC,00000-0000,Public       ,1,3,4,9,69,78
00866500,UNIVERSITY OF KENT AT CANTERBURY (THE)  ,FC,00000-0000,Public       ,0,0,0,4,102,106
00866600,UNIVERSITY OF HONG KONG                 ,FC,00000-0000,Public       ,0,0,0,12,33,45
00867000,UNIVERSITY OF NEW SOUTH WALES           ,FC,00000-0000,Public       ,0,5,5,13,89,102
00868700,UNIVERSITY OF ESSEX                     ,FC,00000-0000,Public       ,0,2,2,8,55,63
00869200,LEIDEN UNIVERSITY                       ,FC,00000-0000,Public       ,0,2,2,3,64,67
00869300,CITY UNIVERSITY                         ,FC,00000-0000,Public       ,0,1,1,12,96,108
00890800,THE UNIVERSITY OF BIRMINGHAM            ,FC,00000-0000,Public       ,1,2,3,9,96,105
00891000,UNIVERSITY OF HULL                      ,FC,00000-0000,Public       ,0,0,0,7,18,25
00892000,UNIVERSITY OF NOTTINGHAM                ,FC,00000-0000,Public       ,0,1,1,16,87,103
00900600,UNIVERSITY OF SALFORD (THE)             ,FC,00000-0000,Public       ,0,0,0,2,16,18
00908400,"UNIV OF LONDON, BIRKBECK                ",FC,00000-0000,Public       ,0,0,0,0,72,72
00908500,UNIV OF LONDON KING'S COLLEGE           ,FC,00000-0000,Public       ,1,4,5,13,213,226
00908600,UNIVERSITY OF LONDON - ROYAL HOLLOWAY   ,FC,00000-0000,Public       ,0,1,1,16,61,77
00914300,BAR-ILAN UNIVERSITY                     ,FC,00000-0000,Private      ,0,0,0,7,18,25
00924700,ARCHITECTURAL ASSOC SCH OF ARCHITEC     ,FC,00000-0000,Private      ,0,1,1,3,27,30
00924900,UNIVERSITY OF LIVERPOOL                 ,FC,00000-0000,Public       ,0,2,2,9,49,58
00936800,UNIVERSITY OF ABERDEEN                  ,FC,00000-0000,Public       ,1,1,2,32,91,123
00942300,ROYAL COLLEGE OF ART                    ,FC,00000-0000,Public       ,0,1,1,2,27,29
00942400,ROYAL ACADEMY OF DRAMATIC ART           ,FC,00000-0000,Private      ,0,1,1,7,10,17
00942800,TECHNION-ISRAEL INST OF TECHLGY         ,FC,00000-0000,Public       ,0,0,0,1,49,50
00944200,UNIVERSITY OF EXETER                    ,FC,00000-0000,Public       ,0,1,1,9,76,85
00944400,UNIVERSITY OF LANCASTER                 ,FC,00000-0000,Public       ,0,1,1,1,26,27
00963400,UNIVERSITY OF OXFORD ST CATHERINE'S     ,FC,00000-0000,Public       ,0,0,0,0,11,11
00980800,UNIVERSITY OF STRATHCLYDE               ,FC,00000-0000,Public       ,0,1,1,1,32,33
00981700,UNIVERSITY OF SANTO TOMAS               ,FC,00000-0000,Private      ,0,1,1,4,22,26
00986000,UNIVERSITY OF SURREY                    ,FC,00000-0000,Public       ,0,1,1,0,16,16
00988800,KAROLINSKA INSTITUTET                   ,FC,00000-0000,Public       ,0,0,0,0,3,3
00990600,PONTIFICAL NORTH AMERICAN COLLEGE       ,FC,00000-0000,Private      ,0,0,0,2,11,13
00992700,UNIVERSITY OF CAMBRIDGE - FITZWILLI     ,FC,00000-0000,Public       ,0,0,0,0,6,6
01006700,LUND UNIVERSITY                         ,FC,00000-0000,Public       ,0,0,0,0,36,36
01008400,UNIVERSITY OF CAPE TOWN                 ,FC,00000-0000,Private      ,0,3,3,9,38,47
01008700,UNIVERSITY OF OXFORD ST PETER'S COL     ,FC,00000-0000,Public       ,0,0,0,2,6,8
01008800,UNIVERSITY OF OXFORD - CORPUS CHRIS     ,FC,00000-0000,Public       ,0,0,0,0,4,4
01008900,CENTRAL SCHOOL OF SPEECH AND DRAMA      ,FC,00000-0000,Private      ,0,1,1,0,6,6
01009000,UNIVERSITY OF OXFORD - BALLIOL COLL     ,FC,00000-0000,Public       ,0,0,0,0,13,13
01014300,UNIVERSITY OF READING                   ,FC,00000-0000,Public       ,0,1,1,4,49,53
01015700,CARDIFF UNIVERSITY                      ,FC,00000-0000,Public       ,0,1,1,3,40,43
01015900,PONTIFICIA UNIVERSITA GREGORIANA        ,FC,00000-0000,Private      ,0,1,1,1,5,6
01016000,CG JUNG INST                            ,FC,00000-0000,Private      ,0,0,0,1,0,1
01018800,UNIVERSITY COLLEGE DUBLIN               ,FC,00000-0000,Public       ,0,0,0,6,139,145
01019000,UNIVERSITY OF CAMBRIDGE CHURCHILL C     ,FC,00000-0000,Public       ,0,0,0,0,5,5
01022800,UNIVERSITY OF STIRLING                  ,FC,00000-0000,Public       ,0,0,0,8,19,27
01033200,UNIVERSITY OF CAMBRIDGE - CLARE COL     ,FC,00000-0000,Public       ,1,0,1,2,8,10
01045600,UNIVERSITY OF HAIFA                     ,FC,00000-0000,Public       ,0,0,0,8,9,17
01047200,INST EUROPEEN OPEEN D'ADMINISTRATIO     ,FC,00000-0000,Private      ,0,0,0,0,61,61
01049300,CRANFIELD UNIVERSITY                    ,FC,00000-0000,Public       ,0,1,1,0,12,12
01052000,TRINITY LABAN                           ,FC,00000-0000,Public       ,0,0,0,3,2,5
01052001,LABAN CENTER FOR MOVEMENT & DANCE       ,FC,00000-0000,Public       ,0,0,0,2,5,7
01052500,UNIVERSITY OF HERTFORDSHIRE             ,FC,00000-0000,Public       ,1,0,1,8,6,14
01057400,LONDON INTRNTL FILM SCHOOL              ,FC,00000-0000,Private      ,1,0,1,1,32,33
01058400,VRIJE UNIVERSITEIT BRUSSELS             ,FC,00000-0000,Private      ,0,0,0,4,9,13
01058600,INSTITUTE OF SOCIAL STUDIES             ,FC,00000-0000,Private      ,0,0,0,1,19,20
01058800,AUSTRALIAN NATIONAL UNIVERSITY          ,FC,00000-0000,Public       ,1,2,3,7,47,54
01058900,BANGOR UNIVERSITY                       ,FC,00000-0000,Public       ,0,1,1,2,22,24
01059400,"RICHMOND, THE AMERICAN INT UNI IN LONDON",FC,00000-0000,Private      ,2,0,2,304,37,341
01059900,INST D'ETUDES POLITIQUES DE PARIS       ,FC,00000-0000,Public       ,0,1,1,1,40,41
01068100,MACQUARIE UNIVERSITY                    ,FC,00000-0000,Public       ,1,6,7,23,72,95
01069200,UNIVERSITY OF QUEENSLAND (THE)          ,FC,00000-0000,Public       ,1,12,13,25,115,140
01070400,SILLIMAN UNIVERSITY                     ,FC,00000-0000,Private      ,0,0,0,0,3,3
01078900,UNIVERSITY OF OXFORD - WORCESTER CO     ,FC,00000-0000,Public       ,0,0,0,0,9,9
01079200,CITY AND GUILDS OF LONDON INSTITUTE     ,FC,00000-0000,Private      ,0,0,0,3,6,9
01079500,AKADEMIA MEDYCZNA                       ,FC,00000-0000,Public       ,0,4,4,2,31,33
01079700,"NATIONAL UNIVERSITY OF IRELAND, MAY     ",FC,00000-0000,Public       ,0,0,0,3,8,11
01080300,SEMMELWEIS UNIVERSITY OF BUDAPEST       ,FC,00000-0000,Public       ,0,0,0,1,26,27
01081600,KINGSTON UNIVERSITY                     ,FC,00000-0000,Public       ,1,0,1,21,29,50
01083800,UNIVERSITITY OF BERGEN (UOB)            ,FC,00000-0000,Public       ,0,0,0,2,5,7
01086400,UNIV OF DUNDEE                          ,FC,00000-0000,Public       ,0,2,2,7,38,45
01086600,UNIVERSITY OF OXFORD - MAGDALEN COLLEGE ,FC,00000-0000,Public       ,0,0,0,1,14,15
01086700,UNIVERSITY OF OXFORD ST JOHN'S COLL     ,FC,00000-0000,Public       ,0,0,0,1,5,6
01091400,MONASH UNIVERSITY                       ,FC,00000-0000,Public       ,0,2,2,8,46,54
01091500,UNIV OF EAST ANGLIA                     ,FC,00000-0000,Public       ,0,0,0,8,55,63
01094200,UNIVERSITY OF OXFORD - ST HUGH'S CO     ,FC,00000-0000,Public       ,0,0,0,2,4,6
01097700,UNIVERSIDAD CENTRAL DEL ESTE            ,FC,00000-0000,Private      ,11,33,44,106,666,772
01098000,SOMERVILLE COLLEGE                      ,FC,00000-0000,Public       ,0,0,0,0,2,2
01099900,UNIV OF OXFORD - WADHAM COLLEGE         ,FC,00000-0000,Public       ,0,0,0,0,6,6
01104400,PONTIFICIA UNIVERSITA SAN TOMMASO       ,FC,00000-0000,Private      ,0,1,1,2,18,20
01105300,UNIVERSITY OF OXFORD - ST HILDA'S C     ,FC,00000-0000,Public       ,0,0,0,0,6,6
01105400,UNIVERSITY OF OXFORD - ST ANNE'S CO     ,FC,00000-0000,Public       ,0,1,1,0,6,6
01105500,UNIV OF OXFORD - LADY MARGARET HALL     ,FC,00000-0000,Public       ,0,0,0,0,4,4
01105600,UNIVERSITY OF OXFORD - UNIVERSITY C     ,FC,00000-0000,Public       ,0,1,1,1,10,11
01105700,UNIVERSITY OF OXFORD - TRINITY COLL     ,FC,00000-0000,Public       ,0,0,0,2,2,4
01105800,UNIVERSITY OF OXFORD-ST EDMUND HALL     ,FC,00000-0000,Public       ,0,0,0,0,16,16
01105900,UNIVERSITY OF OXFORD ST ANTONY'S CO     ,FC,00000-0000,Public       ,0,1,1,0,42,42
01106000,UNIVERSITY OF OXFORD - QUEEN'S COLL     ,FC,00000-0000,Public       ,0,0,0,1,8,9
01106100,UNIVERSITY OF OXFORD - PEMBROKE COL     ,FC,00000-0000,Public       ,0,0,0,1,9,10
01106200,UNIVERSITY OF OXFORD - ORIEL COLLEG     ,FC,00000-0000,Public       ,0,0,0,2,5,7
01106300,UNIVERSITY OF OXFORD - NUFFIELD COL     ,FC,00000-0000,Public       ,0,0,0,0,8,8
01106400,UNIVERSITY OF OXFORD - NEW COLLEGE      ,FC,00000-0000,Public       ,0,1,1,1,11,12
01106500,UNIVERSITY OF OXFORD MERTON COLLEGE     ,FC,00000-0000,Public       ,0,0,0,2,7,9
01106600,UNIVERSITY OF OXFORD - LINCOLN COLL     ,FC,00000-0000,Public       ,0,0,0,1,7,8
01106700,UNIVERSITY OF OXFORD - KEBLE COLLEG     ,FC,00000-0000,Public       ,0,0,0,1,6,7
01106800,UNIVERSITY OF OXFORD - JESUS COLLEG     ,FC,00000-0000,Public       ,0,0,0,0,16,16
01106900,UNIVERSITY OF OXFORD - HERTFORD COL     ,FC,00000-0000,Public       ,0,0,0,1,10,11
01107000,UNIVERSITY OF OXFORD EXETER COLLEGE     ,FC,00000-0000,Public       ,0,2,2,0,18,18
01107100,UNIV OF OXFORD - CHRIST CHURCH          ,FC,00000-0000,Public       ,0,0,0,1,17,18
01107200,UNIVERSITY OF OXFORD - BRASENOSE CO     ,FC,00000-0000,Public       ,0,0,0,0,5,5
01109100,FLINDERS UNIVERSITY OF S AUSTRALIA      ,FC,00000-0000,Public       ,1,2,3,3,31,34
01109400,UNIVERSITY OF WESTERN AUSTRALIA (THE)   ,FC,00000-0000,Public       ,0,1,1,5,22,27
01156700,"IMPERIAL COLLEGE OF SCIENCE, TECHNOLOGY ",FC,00000-0000,Public       ,0,2,2,7,41,48
01167900,UNIVERSITY OF BATH                      ,FC,00000-0000,Public       ,0,0,0,4,34,38
01168300,FRANKLIN COLLEGE  SWITZERLAND           ,FC,00000-0000,Private      ,2,0,2,264,12,276
01175800,UNIV OF CAMBRIDGE - PETERHOUSE          ,FC,00000-0000,Public       ,0,0,0,1,9,10
01176400,ROYAL ACADEMY OF MUSIC                  ,FC,00000-0000,Public       ,0,0,0,7,16,23
01176500,GOLDSMITHS' COLLEGE-UNIV OF LONDON      ,FC,00000-0000,Public       ,0,4,4,11,120,131
01176600,UNIV OF LONDON - INST OF EDUC           ,FC,00000-0000,Public       ,0,0,0,0,30,30
01177900,STOCKHOLM SCHOOL OF ECONOMICS           ,FC,00000-0000,Private      ,0,0,0,0,6,6
01178000,BRUNEL UNIVERSITY                       ,FC,00000-0000,Public       ,0,0,0,5,41,46
01178400,UNIVERSITY OF WARSAW                    ,FC,00000-0000,Public       ,0,1,1,0,6,6
01183800,UNIVERSITY OF OXFORD - MANSFIELD CO     ,FC,00000-0000,Public       ,0,0,0,0,2,2
01207500,UNIVERSITY CAMBRIDGE - TRINITY COLL     ,FC,00000-0000,Public       ,0,0,0,0,13,13
01207800,VICTORIA UNIV OF WELLINGTON             ,FC,00000-0000,Public       ,3,3,6,23,49,72
01210100,UNIVERSITY OF CAMBRIDGE - GIRTON CO     ,FC,00000-0000,Public       ,0,0,0,0,1,1
01213600,VICTORIA UNIV OF MANCHESTER (THE)       ,FC,00000-0000,Public       ,0,0,0,4,76,80
01219800,UNIVERSITY OF BRADFORD                  ,FC,00000-0000,Public       ,0,1,1,3,43,46
01220100,UNIVERSITY OF OXFORD - REGENT'S PAR     ,FC,00000-0000,Public       ,0,0,0,1,7,8
01220600,JAMES COOK UNIVERSITY                   ,FC,00000-0000,Public       ,0,8,8,21,78,99
01221300,PONTIFICIA BOLIVARIANA UNIVERSITY       ,FC,00000-0000,Private      ,0,0,0,1,2,3
01221500,BIRMINGHAM CITY UNIVERSITY              ,FC,00000-0000,Public       ,0,0,0,0,16,16
01222300,JAGIELLONIAN UNIVERSITY COLLEGIUM M     ,FC,00000-0000,Public       ,0,1,1,3,54,57
01222500,UNIVERSITY OF SZEGED FACULTY OF MEDICINE,FC,00000-0000,Public       ,0,0,0,1,17,18
01223400,KOREA UNIVERSITY                        ,FC,00000-0000,Private      ,0,0,0,3,10,13
01225800,ASTON UNIVERSITY                        ,FC,00000-0000,Public       ,0,0,0,0,6,6
01227500,UNIVERSITY OF OXFORD - WOLFSON COLL     ,FC,00000-0000,Public       ,0,1,1,0,15,15
01230200,GONVILLE & CAIUS COLLEGE                ,FC,00000-0000,Public       ,0,0,0,0,9,9
01233300,UNIV OF THE ARTS LONDON- CAMBERWELL COLL,FC,00000-0000,Public       ,0,0,0,6,14,20
01233500,ROYAL COLLEGE OF MUSIC                  ,FC,00000-0000,Public       ,0,0,0,4,10,14
01233700,WROCLAW UNIVERSITY OF MEDICINE          ,FC,00000-0000,Public       ,0,0,0,2,6,8
01234100,UNIVERSITY OF WALES - ST DAVID'S UN     ,FC,00000-0000,Public       ,0,2,2,5,38,43
01239700,KONINKLIJK CONSERVATORIUM               ,FC,00000-0000,Public       ,0,1,1,2,7,9
01242100,UNIV OF AUCKLAND                        ,FC,00000-0000,Public       ,3,7,10,20,75,95
01253900,UNIVERSITY OF THE ARTS LONDON IDO - CENT,FC,00000-0000,Public       ,0,0,0,31,61,92
01254000,UNIVERSIDAD DE NAVARRA                  ,FC,00000-0000,Private      ,0,1,1,6,20,26
01276500,UNIVERSITY OF OXFORD - LINACRE COLL     ,FC,00000-0000,Public       ,0,1,1,0,19,19
01276600,"NATIONAL UNIVERSITY IRELAND, GALWAY     ",FC,00000-0000,Public       ,0,0,0,5,61,66
01280200,PONTIFICIA UNIV CATOLICA MAD Y MAES     ,FC,00000-0000,Private      ,4,5,9,61,115,176
01281100,INST TECNOLOGICO DE SANTO DOMINGO       ,FC,00000-0000,Private      ,1,1,2,11,66,77
01283900,UNIVERSITY OF CAMBRIDGE - SAINT JOH     ,FC,00000-0000,Public       ,0,0,0,0,10,10
01286200,MOUNTVIEW ACADEMY OF THEATRE ARTS       ,FC,00000-0000,Private      ,0,0,0,2,4,6
01297800,UNIVERSITY OF HUDDERSFIELD (THE)        ,FC,00000-0000,Public       ,0,0,0,1,6,7
01315300,MASSEY UNIVERSITY                       ,FC,00000-0000,Public       ,1,5,6,11,73,84
01322500,COLLEGE OF LAW                          ,FC,00000-0000,Private      ,0,0,0,0,18,18
02052400,DARWIN COLLEGE                          ,FC,00000-0000,Public       ,0,0,0,0,9,9
02082400,UNIVERSITY OF CAMBRIDGE - QUEEN'S C     ,FC,00000-0000,Public       ,0,0,0,0,15,15
02083400,UNIVERSITY OF CAMBRIDGE - WOLFSON C     ,FC,00000-0000,Public       ,0,0,0,0,18,18
02087400,UNIVERSITY OF CAMBRIDGE - NEWNHAM C     ,FC,00000-0000,Public       ,0,0,0,0,3,3
02087900,OXFORD BROOKES UNIVERSITY               ,FC,00000-0000,Public       ,0,1,1,8,51,59
02094100,BEN-GURION UNIV                         ,FC,00000-0000,Public       ,0,0,0,3,126,129
02094400,UNIV OF CAMBRIDGE - ST EDMUND'S HOU     ,FC,00000-0000,Public       ,0,0,0,1,4,5
02095500,LONDON BUS SCHOOL                       ,FC,00000-0000,Private      ,0,2,2,2,149,151
02098700,FATIMA COLLEGE OF MEDICINE              ,FC,00000-0000,Private      ,0,4,4,2,49,51
02101900,ROEHAMPTON UNIVERSITY                   ,FC,00000-0000,Public       ,0,1,1,14,66,80
02108600,LONDON ACADEMY OF MUSIC & DRAMATIC      ,FC,00000-0000,Private      ,0,0,0,9,17,26
02115900,UNIVERSITY OF PORTSMOUTH                ,FC,00000-0000,Public       ,0,0,0,4,9,13
02116700,UNIVERSITY OF CAMBRIDGE - LUCY CAVE     ,FC,00000-0000,Public       ,0,0,0,0,4,4
02120000,UNIV OF LONDON - COURTALD INST OF A     ,FC,00000-0000,Public       ,0,0,0,2,25,27
02133400,UNIVERSITY OF CAMBRIDGE - SIDNEY SU     ,FC,00000-0000,Public       ,0,0,0,0,2,2
02142000,UNIVERSITY OF CAMBRIDGE - HOMERTON      ,FC,00000-0000,Public       ,0,0,0,1,3,4
02149700,UNIVERSITY OF WINCHESTER (THE)          ,FC,00000-0000,Public       ,0,1,1,2,2,4
02156800,UNIV OF OTAGO                           ,FC,00000-0000,Public       ,0,5,5,9,37,46
02162300,"IESE BUSINESS SCH, UNIV OF NAVARRA      ",FC,00000-0000,Private      ,0,0,0,2,60,62
02164600,DAYANAND MEDICAL COLLEGE & HOSPITAL     ,FC,00000-0000,Private      ,0,0,0,1,1,2
02167400,UNIVERSITY OF CAMBRIDGE - CORPUS CH     ,FC,00000-0000,Public       ,0,0,0,0,5,5
02168200,NORWEGIAN UNIV OF SCIENCE ANDTECH       ,FC,00000-0000,Public       ,0,0,0,0,2,2
02175700,OHR SOMAYACH INSTITUTIONS               ,FC,00000-0000,Private      ,0,1,1,3,6,9
02177700,KING'S COLLEGE- UNIV OF CAMBRIDGE       ,FC,00000-0000,Public       ,0,0,0,3,21,24
02180500,MIDDLESEX UNIVERSITY                    ,FC,00000-0000,Public       ,0,2,2,23,53,76
02181000,UNIVERSITY OF SOUTH AUSTRALIA           ,FC,00000-0000,Public       ,1,0,1,1,15,16
02183500,UNIV OF OXFORD - WYCLIFFE HALL          ,FC,00000-0000,Public       ,0,0,0,2,7,9
02186000,UNIVERSITY OF CAMBRIDGE - MAGDALENE     ,FC,00000-0000,Public       ,0,0,0,0,3,3
02186100,UNIVERSITY OF CAMBRIDGE - EMMANUEL      ,FC,00000-0000,Public       ,0,1,1,0,3,3
02189600,UNIVERSITY OF GRONINGEN                 ,FC,00000-0000,Public       ,0,0,0,0,9,9
02194800,UNIVERSITY OF THE WEST OF ENGLAND -     ,FC,00000-0000,Public       ,0,0,0,4,13,17
02195100,UNIV OF WESTMINSTER                     ,FC,00000-0000,Public       ,0,0,0,22,89,111
02196700,GUILDHALL SCHOOL OF MUSIC & DRAMA       ,FC,00000-0000,Public       ,0,0,0,10,10,20
02197000,INT'L GRAD PROGRAMME STOCKHOLM UNIV     ,FC,00000-0000,Public       ,0,0,0,0,8,8
02207300,UNIVERSITY OF CAMBRIDGE - CHRIST'S      ,FC,00000-0000,Public       ,0,0,0,0,9,9
02209500,UNIVERSITEIT UTRECHT                    ,FC,00000-0000,Public       ,0,1,1,8,38,46
02210000,UNIV OF LONDON - LONDON SCHOOL OF H     ,FC,00000-0000,Public       ,0,0,0,0,59,59
02212300,UNIVERSITY OF CAMBRIDGE - ROBINSON      ,FC,00000-0000,Public       ,0,0,0,0,4,4
02216300,UNIVERSIDAD DE CHILE                    ,FC,00000-0000,Public       ,0,1,1,7,11,18
02225300,UNIV OF CANTERBURY                      ,FC,00000-0000,Public       ,0,2,2,11,36,47
02229100,UNIVERSITY OF LEICESTER                 ,FC,00000-0000,Public       ,0,3,3,4,68,72
02229600,SACKLER SCHOOL OF MEDICINE              ,FC,00000-0000,Public       ,0,0,0,0,198,198
02232100,UNIVERSITY OF CAMBRIDGE                 ,FC,00000-0000,Public       ,0,0,0,0,27,27
02233300,"ST GEORGE'S UNIV, SCH OF MEDICINE       ",FC,00000-0000,Proprietary  ,0,113,113,12,2550,2562
02235300,LONDON METROPOLITAN UNIVERSITY          ,FC,00000-0000,Public       ,0,2,2,36,123,159
02240900,AISH HATORAH CLG OF JEWISH STUDIES      ,FC,00000-0000,Private      ,0,0,0,1,6,7
02244400,AMERICAN UNIV OF THE CARIBBEAN          ,FC,00000-0000,Proprietary  ,1,56,57,11,1077,1088
02257100,COVENTRY UNIVERSITY                     ,FC,00000-0000,Public       ,0,0,0,6,6,12
02266600,UNIVERSITY OF LONDON - SAINT GEORGE     ,FC,00000-0000,Public       ,0,0,0,1,7,8
02271700,UNIVERSITY OF CAMBRIDGE - CLARE HAL     ,FC,00000-0000,Public       ,0,1,1,0,11,11
02271800,UNIV OF OXFORD - CAMPION HALL           ,FC,00000-0000,Public       ,0,0,0,0,3,3
02272100,UNIV OF OXFORD - GREYFRIARS             ,FC,00000-0000,Public       ,0,0,0,0,1,1
02272200,UNIV OF CAMBRIDGE - NEW HALL            ,FC,00000-0000,Public       ,0,0,0,0,4,4
02273600,QUEEN'S UNIV OF BELFAST (THE)           ,FC,00000-0000,Public       ,2,0,2,6,28,34
02273900,HERIOT WATT UNIVERSITY                  ,FC,00000-0000,Public       ,0,4,4,1,38,39
02276700,NYENRODE BUSINESS UNIVERSITEIT          ,FC,00000-0000,Private      ,0,0,0,0,6,6
02279700,UNIVERSITY OF MANCHESTER - INSTITUT     ,FC,00000-0000,Public       ,0,1,1,11,78,89
02293400,ECOLE DES HAUTES ETUDES COMERCIALS      ,FC,00000-0000,Public       ,0,1,1,0,30,30
02296300,UNIVERSITY OF CAMBRIDGE - JESUS COL     ,FC,00000-0000,Public       ,0,0,0,0,4,4
02310500,DE MONTFORT UNIVERSITY                  ,FC,00000-0000,Public       ,0,0,0,2,14,16
02320500,ROYAL NORTHERN COLLEGE OF MUSIC         ,FC,00000-0000,Public       ,0,0,0,2,8,10
02335100,UNIV OF CAMBRIDGE - TRINITY HALL        ,FC,00000-0000,Public       ,0,1,1,1,10,11
02338900,UNIVERSITY  FOR THE CREATIVE ARTS       ,FC,00000-0000,Public       ,0,0,0,4,1,5
02338903,KENT INSTITUTE OF ART & DESIGN          ,FC,00000-0000,Public       ,0,0,0,1,4,5
02339300,ERASMUS UNIV ROTTERDAM                  ,FC,00000-0000,Public       ,0,2,2,0,33,33
02347300,ESCUELA AUTONOMA DE CIENCIAS MEDICA     ,FC,00000-0000,Private      ,0,1,1,6,15,21
02351800,UNIVERSIDAD IBEROAMERICANA (UNIBE       ,FC,00000-0000,Private      ,8,21,29,141,804,945
02352100,UNIVERSITY OF PLYMOUTH                  ,FC,00000-0000,Public       ,0,2,2,1,23,24
02355200,ECOLE SUPERIEURE DE CUISINE FRANCAISE-FE,FC,00000-0000,Public       ,0,0,0,4,15,19
02363000,GSA CONSERVATOIRE                       ,FC,00000-0000,Private      ,0,0,0,2,3,5
02493000,ESCUELA SUPERIOR ADMINISTRACION Y D     ,FC,00000-0000,Private      ,0,0,0,0,28,28
02496600,UNIVERSITY OF STELLENBOSCH              ,FC,00000-0000,Public       ,0,1,1,1,10,11
02502600,PECSI ORVOSTUDOMANYI EGYETEM (PECS      ,FC,00000-0000,Public       ,0,0,0,1,18,19
02530000,E.M. LYON                               ,FC,00000-0000,Private      ,0,0,0,0,4,4
02545700,GLASGOW SCHOOL OF ART                   ,FC,00000-0000,Public       ,0,0,0,9,28,37
02579600,MURDOCH UNIVERSITY                      ,FC,00000-0000,Public       ,0,4,4,8,48,56
02588000,UNIVERSITY OF ULSTER                    ,FC,00000-0000,Public       ,0,0,0,6,14,20
02591800,CURTIN UNIVERSITY OF TECHNOLOGY         ,FC,00000-0000,Public       ,0,2,2,6,41,47
02592300,MILLTOWN INST OF THEOLOGY & PHILOSO     ,FC,00000-0000,Private      ,0,0,0,0,5,5
02604300,AALBORG UNIVERSITY                      ,FC,00000-0000,Public       ,0,0,0,4,12,16
02611500,HELSINKI SCH OF ECONOMICS & BUS ADM     ,FC,00000-0000,Public       ,0,0,0,1,4,5
02611600,ECOL NATIONAL DES PONTS ET CHAUSSEE     ,FC,00000-0000,Public       ,0,0,0,1,8,9
02611700,DUBLIN CITY UNIVERSITY                  ,FC,00000-0000,Public       ,0,1,1,4,31,35
02623200,UNIVERSITY OF NEWCASTLE (THE)           ,FC,00000-0000,Public       ,2,1,3,12,23,35
03012700,UNIVERSITY OF BUCKINGHAM                ,FC,00000-0000,Private      ,0,1,1,1,13,14
03029400,KEELE UNIVERSITY                        ,FC,00000-0000,Public       ,0,0,0,0,9,9
03029500,NORTHUMBRIA UNIVERSITY                  ,FC,00000-0000,Public       ,0,1,1,3,16,19
03029800,NORGES HANDELSHOYSKOLE                  ,FC,00000-0000,Public       ,0,1,1,3,3,6
03033300,MANCHESTER METROPOLITAN UNIV            ,FC,00000-0000,Public       ,1,0,1,3,24,27
03033700,NORWEGIAN SCHOOL OF MANAGEMENT          ,FC,00000-0000,Private      ,0,0,0,1,3,4
03045000,UNIVERSITY OF EAST LONDON               ,FC,00000-0000,Public       ,0,0,0,6,33,39
03050100,STUDIO ART CENTERS INTERNATIONAL        ,FC,00000-0000,Private      ,0,0,0,35,56,91
03066800,PONTIFICIO ATENEO DELLA SANTA CROCE     ,FC,00000-0000,Private      ,0,1,1,2,13,15
03067200,UNIVERSITY OF SYDNEY                    ,FC,00000-0000,Public       ,0,22,22,22,194,216
03073800,UNIV OF DEBRECEN MED & HEALTH SCI       ,FC,00000-0000,Public       ,1,1,2,7,20,27
03078700,UNIVERSITA COMMERCIALE L BOCCONI        ,FC,00000-0000,Public       ,0,0,0,4,20,24
03080300,SHEFFIELD HALLAM UNIVERSITY             ,FC,00000-0000,Public       ,0,0,0,1,7,8
03084300,UNIVERSITY OF LIMERICK                  ,FC,00000-0000,Public       ,0,0,0,12,24,36
03085100,UNIV OF WOLVERHAMPTON (WOLVERHAMPTO     ,FC,00000-0000,Public       ,0,0,0,2,8,10
03088100,SOPHIA ANTIPOLIS MANAGEMENT INST        ,FC,00000-0000,Private      ,0,0,0,0,2,2
03088700,ROYAL SCOTTISH ACAD MUSIC & DRAMA       ,FC,00000-0000,Public       ,0,0,0,8,12,20
03091400,UNIVERSITY OF WOLLONGONG                ,FC,00000-0000,Public       ,0,1,1,10,25,35
03091500,UNIVERSITY OF CANBERRA                  ,FC,00000-0000,Public       ,0,1,1,3,5,8
03091700,KAROL MARCINKOWSKI UNIV OF MED SCI      ,FC,00000-0000,Public       ,0,2,2,8,160,168
03092500,NOTTINGHAM TRENT UNIVERSITY             ,FC,00000-0000,Public       ,0,0,0,5,18,23
03095000,RMIT UNIVERSITY                         ,FC,00000-0000,Public       ,0,0,0,6,27,33
03095400,BOND UNIVERSITY                         ,FC,00000-0000,Private      ,0,1,1,24,77,101
03095900,ESSEC BUSINESS SCHOOL                   ,FC,00000-0000,Private      ,0,0,0,0,6,6
03096100,LA TROBE UNIVERSITY                     ,FC,00000-0000,Public       ,0,4,4,9,26,35
03096900,DEAKIN UNIVERSITY                       ,FC,00000-0000,Public       ,0,2,2,6,19,25
03097100,UNIVERSITY OF WESTERN SYDNEY            ,FC,00000-0000,Public       ,1,0,1,5,7,12
03097300,VICTORIA UNIVERSITY OF TECHNOLOGY       ,FC,00000-0000,Public       ,0,2,2,3,14,17
03097500,CENTRAL QUEENSLAND UNIVERSITY           ,FC,00000-0000,Public       ,1,1,2,4,7,11
03100000,UNIVERSITY OF ADELAIDE (THE)            ,FC,00000-0000,Public       ,1,3,4,3,39,42
03100200,INST DE MANAGEMENT HOTELIER INTERNA     ,FC,00000-0000,Private      ,0,0,0,1,0,1
03101600,ASIAN INSTITUTE OF MANAGEMENT           ,FC,00000-0000,Private      ,0,0,0,2,3,5
03102500,AMERICAN UNIVERSITY OF ROME             ,FC,00000-0000,Private      ,3,2,5,118,55,173
03102800,ROBERT GORDON UNIVERSITY (THE)          ,FC,00000-0000,Public       ,0,0,0,2,10,12
03103200,INT'L STUDIES CTR AT THE CORVINUS UNIVER,FC,00000-0000,Public       ,0,0,0,0,5,5
03104800,GRIFFITH UNIVERSITY                     ,FC,00000-0000,Public       ,1,3,4,18,40,58
03106100,ROSKILDE UNIV ROSKILDE UNIVERSITY C     ,FC,00000-0000,Public       ,0,0,0,0,2,2
03123500,HOGESCHOOL VAN AMSTERDAM                ,FC,00000-0000,Private      ,1,1,2,5,10,15
03125200,LINCOLN UNIVERSITY                      ,FC,00000-0000,Public       ,0,1,1,1,6,7
03136300,AUSTRALIAN CATHOLIC UNIVERSITY          ,FC,00000-0000,Public       ,0,0,0,1,6,7
03137400,CHARLES STURT UNIVERSITY                ,FC,00000-0000,Public       ,1,0,1,2,8,10
03140300,EDITH COWAN UNIVERSITY                  ,FC,00000-0000,Public       ,1,2,3,5,18,23
03140400,NORTHERN TERRITORY UNIVERSITY           ,FC,00000-0000,Public       ,0,0,0,0,2,2
03140500,QUEENSLAND UNIVERSITY OF TECHNOLOGY     ,FC,00000-0000,Public       ,0,2,2,7,24,31
03140600,SOUTHERN CROSS UNIVERSITY               ,FC,00000-0000,Public       ,1,0,1,6,16,22
03140700,SWINBURNE UNIVERSITY OF TECHNOLOGY      ,FC,00000-0000,Public       ,1,0,1,3,6,9
03140900,UNIVERSITY OF BALLARAT                  ,FC,00000-0000,Public       ,0,0,0,0,2,2
03150300,UNIVERSITY OF TASMANIA                  ,FC,00000-0000,Public       ,0,2,2,4,18,22
03274300,"KUNGLIGA TEKNISKA HOGSKOLAN, KTH        ",FC,00000-0000,Public       ,0,0,0,0,7,7
03287300,LIVERPOOL INSTITUTE FOR PERFORMING ARTS ,FC,00000-0000,Public       ,0,0,0,9,10,19
03300300,"2ND SCHOOL OF MEDICINE, CHARLES UNI     ",FC,00000-0000,Public       ,0,0,0,3,7,10
03300400,"FIRST FACULTY OF MEDICINE, CHARLES UNIV.",FC,00000-0000,Public       ,0,0,0,2,28,30
03329300,JOHN CABOT UNIVERSITY                   ,FC,00000-0000,Private      ,3,0,3,92,19,111
03332400,AGRICULTURE UNIVERSITY OF WROCLAW       ,FC,00000-0000,Public       ,0,0,0,0,4,4
03333300,MEDICAL UNIVERSITY SCHOOL OF LUBLIN     ,FC,00000-0000,Public       ,0,14,14,37,209,246
03334300,UNIVERSIDAD NORDESTANA                  ,FC,00000-0000,Private      ,0,1,1,2,5,7
03335300,MEDICAL UNIVERSITY OF SILESIA           ,FC,00000-0000,Public       ,0,5,5,19,134,153
03342300,GLASGOW CALEDONIAN UNIVERSITY           ,FC,00000-0000,Public       ,0,0,0,2,8,10
03349400,"QUEEN MARGARET UNIVERSITY COLLEGE, EDINB",FC,00000-0000,Public       ,0,0,0,0,7,7
03350300,BOURNEMOUTH UNIVERSITY                  ,FC,00000-0000,Public       ,0,0,0,4,25,29
03352300,LONDON SOUTH BANK UNIVERSITY            ,FC,00000-0000,Private      ,0,0,0,14,26,40
03363300,THE ARTS EDUCATIONAL SCHOOLS LONDON     ,FC,00000-0000,Private      ,0,0,0,1,4,5
03364300,"FACULTY OF MEDICINE, PALACKY UNIVER     ",FC,00000-0000,Public       ,0,1,1,0,7,7
03365400,AUCKLAND INSTITUTE OF TECHNOLOGY        ,FC,00000-0000,Public       ,0,1,1,3,14,17
03366300,TROPICAL AGRICULTURE RESEARCH AND H     ,FC,00000-0000,Private      ,0,0,0,0,1,1
03375300,"CHARLES UNIVERSITY, FACULTY OF MEDI     ",FC,00000-0000,Public       ,0,0,0,2,9,11
03377300,"UNIVERSITY OF WALES INSTITUTE, CARD     ",FC,00000-0000,Public       ,0,0,0,1,5,6
03378300,"THE 3RD FACULTY OF MEDICINE, CHARLE     ",FC,00000-0000,Public       ,0,0,0,2,7,9
03386300,CHARLES UNIVERSITY-MEDICAL FACULTY      ,FC,00000-0000,Public       ,0,0,0,2,10,12
03397400,HOGESCHOOL VOOR DE KUNSTEN UTRECHT      ,FC,00000-0000,Private      ,0,0,0,1,9,10
03406300,"THE SCHOOL OF PHARMACY, UNIVERSITY      ",FC,00000-0000,Public       ,0,0,0,1,0,1
03418400,NAPIER UNIVERSITY                       ,FC,00000-0000,Public       ,1,0,1,6,28,34
03435300,ANGLIA POLYTECHNIC UNIVERSITY HIGHE     ,FC,00000-0000,Public       ,0,0,0,1,5,6
03456600,ANGELES UNIVERSITY FOUNDATION           ,FC,00000-0000,Private      ,0,0,0,0,2,2
03460300,INTERNATIONALES THEOLOGISCHES INSTI     ,FC,00000-0000,Private      ,0,1,1,2,15,17
03462400,UNIV OF ARTS LONDON - LON COLL OF COMMUN,FC,00000-0000,Public       ,0,0,0,6,28,34
03466300,INSTITUTO CENTROAMERICANO DE ADMINI     ,FC,00000-0000,Private      ,0,1,1,0,7,7
03473300,UNIV OF ARTS LONDON - LON COLL FASHION  ,FC,00000-0000,Public       ,0,1,1,35,33,68
03475300,UNIV OF THE ARTS  LONDON - CHELSEA COLL ,FC,00000-0000,Public       ,0,0,0,4,12,16
03477400,UNIVERSITY OF LUTON                     ,FC,00000-0000,Public       ,0,0,0,1,0,1
03478300,ROYAL WELSH COLLEGE OF MUSIC AND DRAMA  ,FC,00000-0000,Public       ,0,0,0,3,2,5
03484300,LANDEGG INTERNATIONAL UNIVERSITY        ,FC,00000-0000,Private      ,0,0,0,0,4,4
03492400,UNIV OF CAMBRIDGE-ST CATHERINE'S CG     ,FC,00000-0000,Public       ,0,0,0,0,5,5
03494400,UNIV OF CAMBRIDGE-SELWYN COLLEGE        ,FC,00000-0000,Public       ,0,0,0,0,7,7
03494600,UNIV OF OXFORD-HARRIS MANCHESTER        ,FC,00000-0000,Public       ,0,0,0,0,5,5
03500300,WIMBLEDON COLLEGE OF ART                ,FC,00000-0000,Public       ,0,0,0,1,2,3
03501400,LEEDS METROPOLITAN UNIVERSITY           ,FC,00000-0000,Public       ,0,0,0,3,13,16
03507300,UNIVERSITY OF SUNDERLAND                ,FC,00000-0000,Public       ,0,1,1,5,10,15
03515300,UNIVERSITY OF CENTRAL LANCASHIRE        ,FC,00000-0000,Public       ,0,0,0,3,9,12
03517300,UNIVERSITY OF BRIGHTON                  ,FC,00000-0000,Public       ,0,1,1,5,15,20
03518300,EUROPEAN GRADUATE SCHOOL                ,FC,00000-0000,Private      ,0,9,9,1,87,88
03526300,INST CENTROAMERICANO DE ADM DE EMP      ,FC,00000-0000,Private      ,0,2,2,0,6,6
03527300,SOFIA UNIVERSITY ST. KLIMENT OHRIDSKI   ,FC,00000-0000,Public       ,0,0,0,0,4,4
03533300,BATH SPA UNIVERSITY                     ,FC,00000-0000,Public       ,0,0,0,0,22,22
03547300,UNIVERSITY OF GLAMORGAN                 ,FC,00000-0000,Public       ,0,0,0,0,3,3
03580300,LIVERPOOL JOHN MOORES UNIVERSITY        ,FC,00000-0000,Public       ,0,0,0,2,3,5
03594300,GROUP ESC GRENOBLE GRAD SCH OF BUS.     ,FC,00000-0000,Private      ,0,2,2,0,23,23
03597300,JAGIELLONIAN UNIVERSITY                 ,FC,00000-0000,Public       ,0,0,0,1,21,22
03601300,UNIVERSITAT JAUME I DE CASTELLO/UJI     ,FC,00000-0000,Public       ,0,0,0,1,14,15
03603300,LEEDS COLLEGE OF MUSIC                  ,FC,00000-0000,Public       ,0,0,0,0,2,2
03619300,UNIVERSITY OF GREENWICH                 ,FC,00000-0000,Public       ,0,1,1,9,18,27
03653400,UNIVERSIDAD DE IBEROAMERICA - UNIBE     ,FC,00000-0000,Private      ,1,2,3,10,20,30
03674300,UNIVERSITY OF ABERTAY DUNDEE            ,FC,00000-0000,Public       ,0,0,0,2,3,5
03684400,UNIVERSITY OF LINCOLN                   ,FC,00000-0000,Public       ,0,0,0,0,4,4
03684500,MEDICAL UNIVERSITY OF GDANSK            ,FC,00000-0000,Public       ,0,0,0,1,2,3
03684600,POMERANIAN MEDICAL UNIVERSITY           ,FC,00000-0000,Public       ,0,0,0,1,0,1
03692300,DONCASTER COLLEGE                       ,FC,00000-0000,Public       ,0,0,0,0,1,1
03694300,UNIVERSITY COLLEGE CHICHESTER           ,FC,00000-0000,Public       ,0,0,0,0,1,1
03697300,NATIONAL FILM & TELEVISION SCHOOL       ,FC,00000-0000,Private      ,0,1,1,0,2,2
03716300,"UNIVERSITY OF WALES, NEWPORT            ",FC,00000-0000,Public       ,0,0,0,3,4,7
03721300,WRITTLE COLLEGE                         ,FC,00000-0000,Public       ,0,0,0,0,3,3
03770300,NAZARENE THEOLOGICAL COLLEGE            ,FC,00000-0000,Private      ,0,1,1,0,12,12
03777400,WESTMINSTER COLLEGE                     ,FC,00000-0000,Private      ,0,0,0,1,2,3
03816400,AMERICAN GRAD SCH OF INTERNTL REL & DIPL,FC,00000-0000,Private      ,0,3,3,1,45,46
03818300,LEIPZIG GRADUATE SCHOOL OF MANAGEMENT   ,FC,00000-0000,Private      ,0,0,0,0,4,4
03824300,"ROYAL VETERINARY COLLEGE (THE), UNIVERSI",FC,00000-0000,Public       ,0,0,0,0,72,72
03850500,MEDICAL UNIVERSITY OF LODZ              ,FC,00000-0000,Public       ,0,2,2,4,55,59
03859400,UNIVERSITY COLLEGE FALMOUTH             ,FC,00000-0000,Public       ,0,0,0,0,7,7
03926400,NATIONAL COLLEGE OF ART AND DESIGN      ,FC,00000-0000,Public       ,0,0,0,2,3,5
03941301,AVE MARIA UNIVERSITY - LATIN AMERICA    ,FC,00000-0000,Private      ,24,4,28,156,42,198
00380600,ALDERSON-BROADDUS COLLEGE               ,WV,26416-1051,Private      ,8,3,11,737,378,1115
00380700,MOUNTAIN STATE UNIVERSITY               ,WV,25801-5624,Private      ,56,544,600,1235,5238,6473
00380800,BETHANY COLLEGE                         ,WV,26032-0417,Private      ,14,1,15,1138,64,1202
00380900,BLUEFIELD STATE COLLEGE                 ,WV,24701-2198,Public       ,28,73,101,1298,1669,2967
00381000,CONCORD UNIVERSITY                      ,WV,24712-0000,Public       ,38,37,75,2624,1025,3649
00381100,DAVIS & ELKINS COLLEGE                  ,WV,26241-3996,Private      ,9,17,26,555,318,873
00381200,FAIRMONT STATE UNIVERSITY               ,WV,26554-2470,Public       ,57,110,167,4837,3250,8087
00381300,GLENVILLE STATE COLLEGE                 ,WV,26351-1292,Public       ,25,16,41,1320,426,1746
00381500,MARSHALL UNIVERSITY                     ,WV,25755-3300,Public       ,125,195,320,8101,5855,13956
00381600,SOUTHERN WV COMMUNITY COLLEGE           ,WV,25637-2900,Public       ,53,91,144,1068,1363,2431
00381800,UNIVERSITY OF CHARLESTON                ,WV,25304-1099,Private      ,23,10,33,1388,568,1956
00381900,OHIO VALLEY COLLEGE                     ,WV,26105-8000,Private      ,8,14,22,433,210,643
00382000,SALEM INTERNATIONAL UNIVERSITY          ,WV,26426-0500,Proprietary  ,15,59,74,233,275,508
00382200,SHEPHERD UNIVERSITY                     ,WV,25443-3210,Public       ,44,33,77,2954,1119,4073
00382300,WEST LIBERTY STATE COLLEGE              ,WV,26074-0295,Public       ,18,14,32,2201,590,2791
00382600,WEST VIRGINIA STATE UNIVERSITY          ,WV,25112-0000,Public       ,68,81,149,2551,2853,5404
00382700,WEST VIRGINIA UNIVERSITY                ,WV,26506-6201,Public       ,214,181,395,19785,7436,27221
00382711,WEST VIRGINIA UNIVERSITY - POTOMAC STATE,WV,26726-3000,Public       ,25,15,40,1128,359,1487
00382721,WEST VIRGINIA UNIV INST OF TECH         ,WV,25136-2436,Public       ,21,26,47,1329,761,2090
00382800,WEST VIRGINIA UNIV AT PARKERSBURG       ,WV,26101-9577,Public       ,27,77,104,1365,2176,3541
00383000,WEST VIRGINIA WESLEYAN COLLEGE          ,WV,26201-2600,Private      ,15,1,16,1618,117,1735
00383100,WHEELING JESUIT UNIVERSITY              ,WV,26003-6243,Private      ,11,23,34,1288,542,1830
00500700,WEST VIRGINIA JUNIOR COLLEGE            ,WV,26505-5596,Proprietary  ,5,16,21,116,180,296
00500800,MOUNTAIN STATE COLLEGE                  ,WV,26101-3993,Proprietary  ,4,31,35,40,216,256
00754400,APPALACHIAN BIBLE COLLEGE               ,WV,25818-1353,Private      ,3,2,5,238,82,320
00757800,HUNTINGTON SCHOOL OF BEAUTY CULTURE     ,WV,25705-2030,Proprietary  ,5,10,15,47,93,140
00760000,INTERNATIONAL BEAUTY SCHOOL             ,WV,25401-3231,Proprietary  ,3,16,19,36,91,127
00835500,JAMES RUMSEY TECHNICAL INSTITUTE        ,WV,25403-0259,Public       ,1,5,6,49,119,168
00895900,CLARKSBURG BEAUTY ACADEMY               ,WV,26301-2903,Proprietary  ,9,28,37,53,83,136
00904700,HUNTINGTON JUNIOR COLLEGE               ,WV,25701-2004,Proprietary  ,25,122,147,188,1188,1376
00905400,WEST VIRGINIA NORTHERN CMTY COLLEGE     ,WV,26003-0000,Public       ,28,82,110,849,1975,2824
01014000,MINERAL COUNTY VOCATIONAL TECH CTR      ,WV,26726-0000,Public       ,0,0,0,8,28,36
01021703,INTERNATIONAL ACADEMY OF DESIGN AND TECH,WV,26554-9790,Proprietary  ,0,0,0,7,3,10
01035600,EVEREST INSTITUTE                       ,WV,25313-1304,Proprietary  ,72,287,359,417,1758,2175
01057300,WEST VIRGINIA JUNIOR COLLEGE            ,WV,25322-0000,Proprietary  ,10,39,49,94,291,385
01057302,WEST VIRGINIA JUNIOR COLLEGE            ,WV,26330-0000,Proprietary  ,16,31,47,194,322,516
01086100,WEST VIRGINIA BUSINESS COLLEGE          ,WV,26301-0000,Proprietary  ,7,24,31,34,171,205
01124500,WEST VIRGINIA SCH OSTEOPATHIC MED       ,WV,24901-1128,Public       ,1,4,5,11,611,622
01174900,WOOD COUNTY SCH OF PRAC NURSING         ,WV,26101-6424,Public       ,0,2,2,14,42,56
01235900,B M SPURR SCHOOL OF PRAC NURSING        ,WV,26038-1660,Private      ,0,2,2,7,33,40
01257300,WEST VIRGINIA UNIV-HOSP-RAD TECH        ,WV,26506-8062,Private      ,0,2,2,52,57,109
01274300,BENJAMIN FRANKLIN CAREER&TECH           ,WV,25064-0000,Public       ,5,14,19,60,142,202
01290400,MONONGALIA CNTY TECH ED CTR             ,WV,26501-6841,Public       ,2,3,5,48,114,162
01290500,ACADEMY OF CAREERS AND TECHNOLOGY       ,WV,25801-0000,Public       ,2,4,6,62,193,255
02057400,ROANE-JACKSON TECHNICAL CENTER          ,WV,25252-0000,Public       ,0,1,1,17,56,73
02068000,UNITED TECHNICAL CENTER                 ,WV,26301-0000,Public       ,1,9,10,25,64,89
02070100,BECKLEY BEAUTY ACADEMY                  ,WV,25801-0000,Proprietary  ,4,10,14,27,49,76
02073400,CARVER CAREER TECH ED CTR               ,WV,25306-6397,Public       ,5,10,15,104,230,334
02145100,SCOTT COLLEGE OF COSMETOLOGY            ,WV,26003-0000,Proprietary  ,4,8,12,50,48,98
02175900,MARION COUNTY TECHNICAL CENTER          ,WV,26571-0000,Public       ,0,0,0,1,1,2
02178200,CHARLESTON SCHOOL OF BEAUTY CULTURE     ,WV,25301-0000,Proprietary  ,6,18,24,41,116,157
02218200,GARNET CAREER CENTER                    ,WV,25301-0000,Public       ,3,43,46,56,296,352
02275300,CABELL COUNTY CAREER TECHNOLOGY CTR     ,WV,25705-0000,Public       ,0,11,11,41,147,188
02280300,WV CAREER AND TECHNICAL INSTITUTE       ,WV,25112-0000,Public       ,2,3,5,62,38,100
02524500,RALPH R WILLIS VOCATIONAL CENTER        ,WV,25601-0000,Public       ,0,0,0,10,32,42
02534800,FRED W EBERLE TECHNICAL CENTER          ,WV,26201-0000,Public       ,1,10,11,31,100,131
02535500,MERCER COUNTY TECH EDUC CNTR            ,WV,24740-0000,Public       ,1,5,6,38,88,126
02579900,NORTH CENTRAL OPPORTUNITIES IND CTR     ,WV,26554-2936,Private      ,4,26,30,16,100,116
02609400,VALLEY COLLEGE                          ,WV,25404-5711,Proprietary  ,2,32,34,28,168,196
03052000,MEREDITH MANOR EQUESTRIAN CENTRE        ,WV,26184-9707,Proprietary  ,7,2,9,72,38,110
03076500,FAYETTE INSTITUTE OF TECHNOLOGY         ,WV,25901-2174,Public       ,0,8,8,15,46,61
03084200,VALLEY COLLEGE                          ,WV,24740-3141,Proprietary  ,1,16,17,7,72,79
03084400,VALLEY COLLEGE                          ,WV,25801-2643,Proprietary  ,1,19,20,25,155,180
03098300,PUTNAM CAREER & TECHNICAL CENTER        ,WV,25070-0000,Public       ,0,1,1,25,51,76
03099200,"MOUNTAINEER BEAUTY COLLEGE, INC         ",WV,25177-2917,Proprietary  ,0,7,7,24,64,88
03102100,MORGANTOWN BEAUTY COLLEGE               ,WV,26505-5430,Proprietary  ,4,5,9,61,64,125
03123200,STANLEY TECHNICAL INSTITUTE             ,WV,26505-3751,Private      ,0,5,5,7,45,52
03327500,SOUTH BRANCH VOCATIONAL TECH CENTER     ,WV,26847-1698,Public       ,1,0,1,4,17,21
03734300,JOHN D. ROCKEFELLER IV CAREER CENTER    ,WV,26047-9424,Public       ,0,0,0,6,16,22
03819300,AMERICAN PUBLIC UNIVERSITY SYSTEM       ,WV,25414-1621,Proprietary  ,14,622,636,33,1351,1384
03957300,BLUE RIDGE COMMUNITY AND TECHNICAL COLLE,WV,25401-3244,Public       ,24,44,68,262,507,769
03960300,NEW RIVER COMMUNITY AND TECHNICAL COLLEG,WV,25801-2636,Public       ,22,83,105,509,1136,1645
04028300,MOUNTAIN STATE SCHOOL OF MASSAGE        ,WV,25304-2025,Proprietary  ,1,8,9,21,54,75
04038500,PIERPONT COMMUNITY & TECHNICAL COLLEGE  ,WV,26554-2451,Public       ,14,18,32,118,226,344
04038600,WEST VIRGINIA STATE COMMUNITY AND TECHNI,WV,25112-1000,Public       ,15,31,46,159,385,544
04041400,MARSHALL COMMUNITY AND TECHNICAL COLLEGE,WV,25755-3300,Public       ,12,32,44,295,436,731
04047300,BRIDGEMONT COMMUNITY & TECHNICAL COLLEGE,WV,25136-2435,Public       ,3,6,9,6,11,17
00106100,ALASKA PACIFIC UNIVERSITY               ,AK,99508-4672,Private      ,8,32,40,393,575,968
00106200,SHELDON JACKSON COLLEGE                 ,AK,99835-7699,Private      ,3,2,5,88,77,165
00106300,UNIVERSITY OF ALASKA FAIRBANKS          ,AK,99775-7500,Public       ,75,145,220,2116,2674,4790
00106500,UNIVERSITY OF ALASKA SOUTHEAST          ,AK,99801-8680,Public       ,16,55,71,481,841,1322
00884300,ALASKA BIBLE COLLEGE                    ,AK,99588-0000,Private      ,0,0,0,8,20,28
01146200,UNIVERSITY OF ALASKA ANCHORAGE          ,AK,99514-1608,Public       ,133,266,399,4138,5903,10041
02541000,CAREER ACADEMY                          ,AK,99507-0000,Proprietary  ,24,77,101,118,504,622
02576900,CHARTER COLLEGE                         ,AK,99508-0000,Proprietary  ,17,99,116,104,689,793
03160300,ALASKA VOCATIONAL TECHNICAL CENTER      ,AK,99664-0889,Public       ,7,10,17,129,257,386
03461300,ILISAGVIK COLLEGE                       ,AK,99723-0749,Public       ,1,1,2,13,73,86
03677300,GALENA CITY SCHOOL DISTRICT - PROJE     ,AK,99741-0359,Public       ,1,0,1,3,1,4
00108500,UNIV ARKANSAS MONTICELLO                ,AR,71656-0000,Public       ,48,89,137,1744,1734,3478
00108501,GREAT RIVERS TECHNICAL INSTITUTE        ,AR,71654-0000,Public       ,0,2,2,12,43,55
00108502,FOREST ECHOES TECHNICAL INSTITUTE       ,AR,71635-0000,Public       ,0,3,3,21,41,62
00108600,UNIV OF ARKANSAS AT PINE BLUFF          ,AR,71601-2790,Public       ,76,49,125,3094,1656,4750
00108700,ARKANSAS BAPTIST COLLEGE                ,AR,72202-6099,Private      ,18,20,38,177,334,511
00108800,LYON COLLEGE                            ,AR,72501-3699,Private      ,3,3,6,608,116,724
00108900,ARKANSAS TECH UNIVERSITY                ,AR,72801-2222,Public       ,93,100,193,3940,2861,6801
00109000,ARKANSAS STATE UNIVERSITY               ,AR,72467-0000,Public       ,173,238,411,6222,7006,13228
00109006,DELTA TECHNICAL INSTITUTE               ,AR,72365-9558,Public       ,1,5,6,43,88,131
00109100,ARKANSAS STATE UNIVERSITY - BEEBE       ,AR,72012-1000,Public       ,53,157,210,1271,2186,3457
00109103,ARKANSAS STATE UNIV-BEEBE-SEARCY        ,AR,72143-4798,Public       ,0,0,0,44,58,102
00109200,UNIVERSITY OF CENTRAL ARKANSAS          ,AR,72035-0001,Public       ,130,92,222,7685,3774,11459
00109300,CENTRAL BAPTIST COLLEGE                 ,AR,72034-6470,Private      ,6,21,27,290,240,530
00109400,UNIVERSITY OF THE OZARKS                ,AR,72830-2880,Private      ,12,5,17,501,102,603
00109500,CROWLEYS RIDGE COLLEGE                  ,AR,72450-9775,Private      ,0,2,2,108,48,156
00109700,HARDING UNIVERSITY                      ,AR,72149-0001,Private      ,40,108,148,3097,1322,4419
00109800,HENDERSON STATE UNIVERSITY              ,AR,71999-0001,Public       ,52,62,114,2309,1615,3924
00109900,HENDRIX COLLEGE                         ,AR,72032-3080,Private      ,11,4,15,1375,85,1460
00110000,JOHN BROWN UNIVERSITY                   ,AR,72761-2747,Private      ,8,89,97,1193,1137,2330
00110100,UNIV ARKANSAS LITTLE ROCK               ,AR,72204-1099,Public       ,88,264,352,3838,8439,12277
00110200,OUACHITA BAPTIST UNIVERSITY             ,AR,71998-0001,Private      ,25,8,33,1227,129,1356
00110300,PHILANDER SMITH COLLEGE                 ,AR,72202-3718,Private      ,9,16,25,622,733,1355
00110400,PHILLIPS COUNTY COMMUNITY COLLEGE       ,AR,72342-0000,Public       ,30,81,111,495,993,1488
00110401,RICE BELT TECH INST                     ,AR,72042-0000,Public       ,0,0,0,7,4,11
00110600,WILLIAMS BAPTIST COLLEGE                ,AR,72476-4661,Private      ,6,6,12,531,180,711
00110700,SOUTHERN ARKANSAS UNIVERSITY            ,AR,71754-0000,Public       ,58,79,137,1991,1463,3454
00110800,UNIV ARKANSAS FAYETTEVILLE              ,AR,72701-0000,Public       ,205,165,370,8075,5192,13267
00110900,UNIV OF ARKANSAS FOR MEDCL SCIENCES     ,AR,72205-7102,Public       ,5,22,27,399,1459,1858
00110901,UNIV OF ARKANSAS COLG OF MEDICINE       ,AR,72205-0000,Public       ,0,2,2,24,607,631
00111000,UNIVERSITY OF ARKANSAS-FORT SMITH       ,AR,72904-7397,Public       ,67,160,227,2641,3710,6351
00524500,U OF A COMM COLLEGE AT MORRILTON        ,AR,72110-9601,Public       ,21,34,55,757,1249,2006
00570700,SEARK COLLEGE                           ,AR,71603-0000,Public       ,32,117,149,620,1912,2532
00573200,UNIV AR COMMUNITY COLLEGE AT HOPE       ,AR,71801-0000,Public       ,17,63,80,424,801,1225
00704400,CROWLEYS RIDGE TECHNICAL INSTITUTE      ,AR,72336-0000,Public       ,5,24,29,89,235,324
00773800,SOUTHERN ARKANSAS UNIVERSITY TECH       ,AR,71701-1900,Public       ,14,26,40,339,616,955
00792100,FAYETTEVILLE BEAUTY COLLEGE             ,AR,72701-0000,Proprietary  ,3,14,17,32,96,128
00997600,OUACHITA TECHNICAL COLLEGE              ,AR,72104-0816,Public       ,12,41,53,287,714,1001
01074100,MELLIE'S BEAUTY COLLEGE                 ,AR,72901-3886,Proprietary  ,2,8,10,15,48,63
01210500,NATIONAL PARK COMMUNITY COLLEGE         ,AR,71913-9174,Public       ,44,113,157,740,1675,2415
01226000,EAST ARKANSAS COMMUNITY COLLEGE         ,AR,72335-2204,Public       ,17,78,95,498,832,1330
01226100,NORTH ARKANSAS COLLEGE                  ,AR,72601-5508,Public       ,20,71,91,708,1324,2032
01286000,ARKANSAS NORTHEASTERN COLLEGE           ,AR,72316-1109,Public       ,35,107,142,708,1456,2164
02052200,BLACK RIVER TECHNICAL COLLEGE           ,AR,72455-0000,Public       ,29,85,114,645,1362,2007
02073500,UNIVERSITY OF ARKANSAS COMMUNITY COLLEGE,AR,72503-0000,Public       ,26,69,95,401,968,1369
02073700,NORTHWEST TECHNICAL INSTITUTE           ,AR,72765-0000,Public       ,3,16,19,90,331,421
02074600,SOUTH ARKANSAS COMMUNITY COLLEGE        ,AR,71731-0000,Public       ,12,58,70,358,1108,1466
02075300,PULASKI TECHNICAL COLLEGE               ,AR,72118-0000,Public       ,79,335,414,2204,8367,10571
02087000,OZARKA COLLEGE                          ,AR,72556-0000,Public       ,25,61,86,264,697,961
02111100,RICH MOUNTAIN COMMUNITY COLLEGE         ,AR,71953-0000,Public       ,18,44,62,339,494,833
02202400,PROFESSIONAL COSMETOLOGY EDUC CTR       ,AR,71730-5828,Proprietary  ,4,6,10,18,71,89
02220900,COSSATOT COMMUNITY COLLEGE              ,AR,71832-0000,Public       ,11,68,79,291,816,1107
02260400,BEE JAY'S HAIRSTYLING ACADEMY           ,AR,72212-0000,Proprietary  ,3,9,12,9,44,53
02272400,EASTERN COLLEGE OF HEALTH VOCATIONS     ,AR,72209-0000,Proprietary  ,26,106,132,172,711,883
02284200,NEW TYLER BARBER COLLEGE INC            ,AR,72114-0000,Proprietary  ,5,11,16,43,85,128
02287400,MARSHA KAY BEAUTY COLLEGE               ,AR,72653-0000,Proprietary  ,3,4,7,11,27,38
02321701,ITT TECHNICAL INSTITUTE                 ,AR,72204-9925,Proprietary  ,52,94,146,281,684,965
02330800,JEFFERSON SCHOOL OF NURSING             ,AR,71603-0000,Private      ,0,7,7,30,120,150
02339800,SOUTHERN INSTITUTE OF COSMETOLOGY       ,AR,72301-0000,Proprietary  ,8,24,32,20,64,84
02341700,CAREER ACADEMY OF HAIR DESIGN           ,AR,72764-4304,Proprietary  ,0,8,8,40,94,134
02348200,MID-SOUTH COMMUNITY COLLEGE             ,AR,72301-0000,Public       ,37,140,177,566,1223,1789
02363500,ARTHUR'S BEAUTY COLLEGE                 ,AR,72901-0000,Proprietary  ,1,4,5,39,121,160
02525800,LEE'S SCHOOL OF COSMETOLOGY             ,AR,72114-0000,Proprietary  ,6,16,22,24,60,84
02538500,ARTHUR'S BEAUTY COLLEGE                 ,AR,72076-0000,Proprietary  ,13,42,55,90,268,358
02569600,SEARCY BEAUTY COLLEGE                   ,AR,72143-0000,Proprietary  ,1,15,16,18,82,100
03005100,ARKANSAS BEAUTY SCHOOL                  ,AR,72209-5116,Proprietary  ,3,11,14,33,95,128
03007100,HOT SPRINGS BEAUTY COLLEGE              ,AR,71901-5432,Proprietary  ,2,15,17,29,76,105
03007600,ARKANSAS BEAUTY SCHOOL-CONWAY           ,AR,72032-4354,Proprietary  ,6,9,15,33,60,93
03023400,ARKANSAS COLLEGE OF BARBERING           ,AR,72114-5615,Proprietary  ,3,8,11,22,122,144
03063300,NORTHWEST ARKANSAS COMMUNITY COLLEG     ,AR,72712-5190,Public       ,59,109,168,1366,2356,3722
03065100,ABC BEAUTY COLLEGE                      ,AR,71923-4206,Proprietary  ,1,11,12,19,48,67
03105200,BAPTIST HEALTH SCHOOLS LITTLE ROCK      ,AR,72210-0000,Private      ,1,30,31,257,1008,1265
03116800,"DELUXE BEAUTY SCHOOL, L.L.C.            ",AR,71603-0000,Proprietary  ,5,4,9,13,25,38
03124900,IMAGINE -  PAUL MITCHELL PARTNER SCHOOL ,AR,72117-2516,Proprietary  ,1,4,5,13,25,38
03127200,ASKINS VO-TECH                          ,AR,72908-8028,Proprietary  ,0,17,17,11,38,49
03212300,BLYTHEVILLE ACADEMY OF COSMETOLOGY      ,AR,72315-3424,Proprietary  ,0,3,3,10,37,47
03214300,VELVATEX COLLEGE OF BEAUTY CULTURE      ,AR,72202-5452,Proprietary  ,1,3,4,10,29,39
03254300,MARGARET'S HAIR ACADEMY                 ,AR,71655-4905,Proprietary  ,4,8,12,14,67,81
03519400,LYNNDALE FUNDAMENTALS OF BEAUTY SCH     ,AR,71730-4804,Proprietary  ,4,6,10,11,52,63
03855300,ECCLESIA COLLEGE                        ,AR,72762-8159,Private      ,2,2,4,41,27,68
03912300,CROSSETT SCHOOL OF COSMETOLOGY          ,AR,71635-0000,Proprietary  ,1,7,8,13,33,46
03997300,ARKANSAS BEAUTY COLLEGE                 ,AR,72801-3741,Proprietary  ,3,5,8,29,52,81
00133900,CORBAN COLLEGE                          ,OR,97301-9392,Private      ,11,22,33,1066,388,1454
00316505,CASCADE COLLEGE                         ,OR,97216-0000,Private      ,9,5,14,323,122,445
00318600,BLUE MOUNTAIN COMMUNITY COLLEGE         ,OR,97801-0000,Public       ,23,73,96,706,1156,1862
00318800,CENTRAL OREGON COMMUNITY COLLEGE        ,OR,97701-5998,Public       ,73,181,254,1620,2143,3763
00318900,CLATSOP COMMUNITY COLLEGE               ,OR,97103-3698,Public       ,13,37,50,355,531,886
00319100,CONCORDIA UNIVERSITY                    ,OR,97211-6099,Private      ,12,35,47,1051,1233,2284
00319300,EASTERN OREGON UNIVERSITY               ,OR,97850-2899,Public       ,49,72,121,2006,2178,4184
00319400,GEORGE FOX UNIVERSITY                   ,OR,97132-2697,Private      ,22,77,99,2265,1767,4032
00319600,LANE COMMUNITY COLLEGE                  ,OR,97405-0640,Public       ,169,488,657,3897,6692,10589
00319700,LEWIS & CLARK COLLEGE                   ,OR,97219-7899,Private      ,21,25,46,3392,2598,5990
00319800,LINFIELD COLLEGE                        ,OR,97128-6894,Private      ,22,26,48,2818,529,3347
00319801,LINFIELD COLLEGE - PORTLAND CAMPUS      ,OR,97210-0000,Private      ,4,13,17,374,734,1108
00319900,MARYLHURST UNIVERSITY                   ,OR,97036-7036,Private      ,6,66,72,124,1124,1248
00320300,MOUNT ANGEL SEMINARY                    ,OR,97373-0505,Private      ,1,0,1,12,30,42
00320400,MOUNT HOOD COMMUNITY COLLEGE            ,OR,97030-3300,Public       ,143,256,399,2907,4100,7007
00320600,MULTNOMAH BIBLE COLLEGE/SEMINARY        ,OR,97220-5898,Private      ,7,7,14,548,507,1055
00320700,PACIFIC NORTHWEST COLLEGE OF ART        ,OR,97209-3023,Private      ,10,9,19,396,339,735
00320800,NORTHWEST CHRISTIAN UNIVERSITY          ,OR,97401-3727,Private      ,8,27,35,414,452,866
00320900,WESTERN OREGON UNIVERSITY               ,OR,97361-1394,Public       ,66,57,123,4403,1754,6157
00321000,OREGON STATE UNIVERSITY                 ,OR,97331-8507,Public       ,229,193,422,14353,7002,21355
00321100,OREGON INSTITUTE OF TECHNOLOGY          ,OR,97601-8801,Public       ,49,38,87,1693,1440,3133
00321200,PACIFIC UNIVERSITY                      ,OR,97116-1797,Private      ,23,31,54,2137,2309,4446
00321300,PORTLAND COMMUNITY COLLEGE              ,OR,97219-7198,Public       ,334,1053,1387,6761,14840,21601
00321600,PORTLAND STATE UNIVERSITY               ,OR,97207-0000,Public       ,259,625,884,9570,15491,25061
00321700,REED COLLEGE                            ,OR,97202-8199,Private      ,16,7,23,2232,273,2505
00321800,CHEMEKETA COMMUNITY COLLEGE             ,OR,97309-1500,Public       ,141,390,531,3220,6263,9483
00321900,SOUTHERN OREGON UNIVERSITY              ,OR,97520-5010,Public       ,76,105,181,3831,2255,6086
00322000,SOUTHWESTERN OREGON COMMUNITY CLG       ,OR,97420-2956,Public       ,29,71,100,1047,984,2031
00322100,TREASURE VALLEY COMMUNITY COLLEGE       ,OR,97914-3423,Public       ,40,96,136,938,1310,2248
00322200,UMPQUA COMMUNITY COLLEGE                ,OR,97470-0226,Public       ,40,109,149,808,1300,2108
00322300,UNIVERSITY OF OREGON                    ,OR,97403-1226,Public       ,219,180,399,14674,8005,22679
00322400,UNIVERSITY OF PORTLAND                  ,OR,97203-5798,Private      ,54,38,92,5433,1423,6856
00322500,WARNER PACIFIC COLLEGE                  ,OR,97215-4099,Private      ,11,53,64,576,680,1256
00322700,WILLAMETTE UNIVERSITY                   ,OR,97301-3930,Private      ,26,17,43,3066,1489,4555
00487800,CLACKAMAS COMMUNITY COLLEGE             ,OR,97045-7998,Public       ,100,185,285,1875,2755,4630
00488200,OREGON HEALTH & SCIENCE UNIVERSITY      ,OR,97239-0000,Public       ,6,28,34,431,2552,2983
00488230,OREGON GRAD INST OF SCIENCE & TECH      ,OR,97006-0000,Public       ,0,0,0,6,29,35
00693800,LINN BENTON COMMUNITY COLLEGE           ,OR,97321-3774,Public       ,99,215,314,2403,2999,5402
00717800,WESTERN SEMINARY                        ,OR,97215-0000,Private      ,1,16,17,3,199,202
00723402,HEALD COLLEGE - PORTLAND                ,OR,97205-3432,Proprietary  ,10,28,38,43,123,166
00781900,ART INSTITUTE OF PORTLAND (THE)         ,OR,97209-2911,Proprietary  ,46,57,103,1365,1196,2561
00888700,CONCORDE CAREER INSTITUTE               ,OR,97232-2242,Proprietary  ,37,131,168,215,740,955
00907900,EVEREST COLLEGE                         ,OR,97204-2296,Proprietary  ,110,442,552,698,3069,3767
00958100,SPRINGFIELD COLLEGE OF BEAUTY           ,OR,97477-5474,Proprietary  ,12,9,21,84,99,183
01012200,PHAGANS' MEDFORD BEAUTY SCHOOL          ,OR,97504-5297,Proprietary  ,2,19,21,46,117,163
01018200,ROGUE COMMUNITY COLLEGE                 ,OR,97527-0000,Public       ,86,264,350,1479,3234,4713
01050700,ACADEMY OF HAIR DESIGN                  ,OR,97301-3526,Proprietary  ,4,14,18,32,86,118
01185200,ITT TECHNICAL INSTITUTE                 ,OR,97220-0000,Proprietary  ,101,167,268,678,1168,1846
01230900,WESTERN STATES CHIROPRACTIC COLLEGE     ,OR,97230-3099,Private      ,3,7,10,22,473,495
01234700,PHAGANS CENTRAL OREGON BEAUTY CLG       ,OR,97701-5175,Proprietary  ,9,20,29,55,125,180
01234800,PHAGANS BEAUTY COLLEGE                  ,OR,97333-4716,Proprietary  ,4,10,14,56,65,121
01235000,PHAGANS SCHOOL OF HAIR DESIGN           ,OR,97267-4808,Proprietary  ,3,11,14,28,62,90
01235100,PHAGANS SCHOOL OF BEAUTY                ,OR,97301-4732,Proprietary  ,3,17,20,38,95,133
01300800,PHAGANS TIGARD BEAUTY SCHOOL            ,OR,97223-0000,Proprietary  ,5,3,8,28,35,63
02101000,NORTHWEST COLLEGE OF HAIR DESIGN        ,OR,97086-7702,Proprietary  ,13,20,33,57,118,175
02101002,NORTHWEST COLLEGE                       ,OR,97007-3954,Proprietary  ,0,0,0,14,26,40
02104900,COLLEGE OF LEGAL ARTS                   ,OR,97219-9998,Proprietary  ,3,21,24,20,157,177
02106100,COLLEGE OF COSMETOLOGY                  ,OR,97601-0000,Proprietary  ,6,14,20,41,59,100
02154400,BEAU MONDE CLG OF HAIR DESIGN           ,OR,97205-0000,Proprietary  ,14,25,39,100,168,268
02159700,EUGENE BIBLE COLLEGE                    ,OR,97405-0000,Private      ,3,7,10,126,113,239
02201900,PHAGANS' SCHOOL OF HAIR DESIGN          ,OR,97232-0000,Proprietary  ,2,19,21,84,172,256
02311000,PAUL MITCHELL THE SCHOOL                ,OR,97103-0000,Proprietary  ,4,4,8,19,33,52
02330100,PIONEER PACIFIC COLLEGE                 ,OR,97070-0000,Proprietary  ,36,106,142,303,1035,1338
02330102,PIONEER PACIFIC COLLEGE                 ,OR,97403-0000,Proprietary  ,18,55,73,144,562,706
02337900,COLLEGE OF HAIR DESIGN CAREERS          ,OR,97301-0000,Proprietary  ,3,7,10,52,62,114
02344100,ROSEBURG BEAUTY COLLEGE                 ,OR,97470-0000,Proprietary  ,1,3,4,29,65,94
02534000,NATIONAL COLLEGE OF NATURAL MEDICINE    ,OR,97201-0000,Private      ,0,3,3,9,554,563
02578800,NORTHWEST NANNIES INSTITUTE             ,OR,97035-0000,Proprietary  ,2,3,5,32,7,39
02603700,OREGON COL OF ORIENTAL MEDICINE         ,OR,97216-0000,Private      ,0,4,4,3,294,297
03007300,OREGON COLLEGE OF ART & CRAFT           ,OR,97225-6399,Private      ,5,5,10,108,197,305
03022600,WESTERN CULINARY INSTITUTE              ,OR,97205-2793,Proprietary  ,163,428,591,2011,2931,4942
03042500,APOLLO COLLEGE                          ,OR,97232-1302,Proprietary  ,82,279,361,405,1414,1819
03074400,PHAGANS NEWPORT ACAD CSMTLGY CAREER     ,OR,97365-4963,Proprietary  ,7,14,21,20,49,69
03074500,EAST-WEST COLLEGE OF THE HEALING ARTS   ,OR,97232-2765,Proprietary  ,9,31,40,75,316,391
03185300,PHAGANS GRANTS PASS COLLEGE OF BTY      ,OR,97527-3039,Proprietary  ,6,10,16,45,73,118
03428300,KLAMATH COMMUNITY COLLEGE               ,OR,97603-7121,Public       ,26,84,110,266,906,1172
03642300,VALLEY MEDICAL COLLEGE                  ,OR,97305-1373,Proprietary  ,2,22,24,25,142,167
03668300,BIRTHINGWAY COLLEGE OF MIDWIFERY        ,OR,97266-4042,Private      ,0,3,3,5,92,97
03783400,ABDILL CAREER COLLEGE                   ,OR,97504-7137,Proprietary  ,0,15,15,16,111,127
03932400,GUTENBERG COLLEGE                       ,OR,97403-1368,Private      ,0,0,0,27,18,45
00137400,ALBERTUS MAGNUS COLLEGE                 ,CT,06511-1189,Private      ,5,55,60,726,737,1463
00137403,ALBERTUS MAGNUS CLG-NEW DIMENSIONS      ,CT,06511-0000,Private      ,4,156,160,55,870,925
00137800,CENTRAL CONNECTICUT STATE UNIV          ,CT,06050-2490,Public       ,99,106,205,7511,3200,10711
00137900,CONNECTICUT COLLEGE                     ,CT,06320-4196,Private      ,9,4,13,2071,82,2153
00138000,WESTERN CONNECTICUT STATE UNIV          ,CT,06810-6826,Public       ,82,37,119,4155,1206,5361
00138500,FAIRFIELD UNIVERSITY                    ,CT,06430-0000,Private      ,50,27,77,5271,636,5907
00138700,HARTFORD SEMINARY                       ,CT,06105-0000,Private      ,1,2,3,11,19,30
00138900,HOLY APOSTLES COLLEGE & SEMINARY        ,CT,06416-2005,Private      ,0,1,1,6,46,52
00139200,MANCHESTER COMMUNITY COLLEGE            ,CT,06045-1046,Public       ,79,96,175,2185,2018,4203
00139300,MITCHELL COLLEGE                        ,CT,06320-4498,Private      ,9,9,18,774,173,947
00139700,UNIVERSITY OF NEW HAVEN                 ,CT,06516-1999,Private      ,38,82,120,3530,1461,4991
00139800,NORTHWESTERN CT COMMUNITY COLLEGE       ,CT,06098-1747,Public       ,15,21,36,392,423,815
00139900,NORWALK COMMUNITY TECHNICAL COLLEGE     ,CT,06854-1655,Public       ,49,69,118,1202,1541,2743
00140100,POST UNIVERSITY                         ,CT,06723-3240,Proprietary  ,22,91,113,1048,914,1962
00140200,QUINNIPIAC UNIVERSITY                   ,CT,06518-1908,Private      ,73,33,106,8972,1256,10228
00140201,QUINNIPIAC UNIVERSITY SCHOOL OF LAW     ,CT,06518-0000,Private      ,1,6,7,130,1062,1192
00140300,SACRED HEART UNIVERSITY                 ,CT,06825-1000,Private      ,52,61,113,5678,1184,6862
00140600,SOUTHERN CONNECTICUT STATE UNIV         ,CT,06515-1355,Public       ,109,124,233,7581,4102,11683
00140900,SAINT JOSEPH COLLEGE                    ,CT,06117-2791,Private      ,10,32,42,931,901,1832
00141400,TRINITY COLLEGE                         ,CT,06106-3100,Private      ,21,7,28,2460,231,2691
00141600,UNIVERSITY OF BRIDGEPORT                ,CT,06601-5650,Private      ,44,104,148,1873,1906,3779
00141700,UNIVERSITY OF CONNECTICUT-STORRS        ,CT,06269-2151,Public       ,190,145,335,21129,4583,25712
00141702,UNIV CONN STAMFORD                      ,CT,06901-0000,Public       ,8,6,14,383,204,587
00141703,UNIV OF CONNECTICUT - TORINGTON         ,CT,06790-0000,Public       ,3,2,5,184,58,242
00141706,UNIV OF CONNECTICUT SCH LAW             ,CT,06105-0000,Public       ,1,3,4,27,1084,1111
00141707,UNIV OF CT - SCH OF SOCIAL WORK         ,CT,06117-0000,Public       ,1,3,4,73,470,543
00141708,UNIVERSITY OF CONNECTICUT - SCHOOL OF ME,CT,06030-1920,Public       ,2,4,6,10,412,422
00141709,UNIVERSITY OF CONNECTICUT - SCHOOL OF DE,CT,06030-1920,Public       ,0,2,2,2,198,200
00142200,UNIVERSITY OF HARTFORD                  ,CT,06117-1599,Private      ,110,48,158,8429,1418,9847
00142400,WESLEYAN UNIVERSITY                     ,CT,06459-3208,Private      ,18,3,21,3420,124,3544
00142500,EASTERN CONNECTICUT STATE UNIV          ,CT,06226-2295,Public       ,52,25,77,4535,1044,5579
00142600,YALE UNIVERSITY                         ,CT,06520-8288,Private      ,69,41,110,10112,5741,15853
00142601,YALE UNIV PHYSICIANS ASSOC PROG         ,CT,06510-0000,Private      ,0,1,1,2,66,68
00142602,YALE UNIV EPIDEMIOLOGY & PUB HLTH       ,CT,06510-0000,Private      ,0,3,3,4,193,197
00142603,YALE UNIV SCHOOL MEDICINE               ,CT,06510-0000,Private      ,2,1,3,21,669,690
00280301,RENSSELAER POLYTECHNIC INSTITUTE-RENSSEL,CT,06120-2991,Private      ,0,8,8,2,60,62
00280303,RENSSELAER POLYTECHNIC INSTITUTE - RENSS,CT,06340-6097,Private      ,0,0,0,3,0,3
00280400,RENSSELAER HARTFORD GRADUATE CENTER     ,CT,06120-0000,Private      ,0,1,1,0,26,26
00451300,HOUSATONIC COMMUNITY COLLEGE            ,CT,06604-4704,Public       ,44,86,130,1490,2527,4017
00618100,BRIDGEPORT HOSP SCHL OF NURSING         ,CT,06610-2896,Private      ,0,8,8,72,263,335
00619100,ST. VINCENT'S COLLEGE                   ,CT,06606-9966,Private      ,3,13,16,183,498,681
00698200,NAUGATUCK VALLEY COMM-TECH COLG         ,CT,06708-3089,Public       ,54,62,116,1623,1839,3462
00730000,ELI WHITNEY TECHNICAL HIGH SCHOOL       ,CT,06514-0000,Public       ,1,12,13,21,102,123
00730300,LINCOLN TECHNICAL INSTITUTE             ,CT,06051-0000,Proprietary  ,126,306,432,697,1704,2401
00730500,PORTER AND CHESTER INSTITUTE OF BRANFORD,CT,06405-4022,Proprietary  ,17,25,42,157,189,346
00731100,WINDHAM TECHNICAL HIGH SCHOOL           ,CT,06226-2100,Public       ,1,2,3,6,30,36
00745900,PAIER COLLEGE OF ART                    ,CT,06514-3902,Proprietary  ,6,2,8,163,78,241
00763500,CAPITAL COMMUNITY COLLEGE               ,CT,06103-1207,Public       ,50,111,161,1207,2609,3816
00803700,GATEWAY COMMUNITY-TECHNICAL COLLEGE     ,CT,06511-0000,Public       ,63,121,184,1691,2750,4441
00803800,MIDDLESEX COMMUNITY CLG                 ,CT,06457-4889,Public       ,26,60,86,668,979,1647
00887200,RENASCI ACADEMY OF HAIR                 ,CT,06460-4160,Proprietary  ,2,6,8,11,29,40
00887300,PAUL MITCHELL THE SCHOOL                ,CT,06810-6716,Proprietary  ,12,6,18,42,61,103
00887400,BRIO ACADEMY OF COSMETOLOGY             ,CT,06450-4836,Proprietary  ,27,55,82,158,287,445
00906500,THE HARTFORD CONSERVATORY               ,CT,06105-2891,Private      ,2,1,3,55,17,72
00927700,E C GOODWIN TECHNICAL HIGH SCHOOL       ,CT,06053-0000,Public       ,1,6,7,14,47,61
00929100,J M WRIGHT TECHNICAL HIGH SCHOOL        ,CT,06904-0000,Public       ,0,9,9,6,38,44
00940700,BRIARWOOD COLLEGE                       ,CT,06489-1057,Proprietary  ,12,18,30,522,359,881
00976400,TUNXIS COMMUNITY COLLEGE                ,CT,06032-3187,Public       ,40,63,103,1002,1211,2213
00976500,THREE RIVERS COMMUNITY TECH COLLEGE     ,CT,06360-0000,Public       ,51,84,135,1037,1672,2709
00982200,ALBERT I PRINCE TECHNICAL HIGH SCHOOL   ,CT,06106-3799,Public       ,1,11,12,13,71,84
01041700,BRIO ACADEMY OF EAST HARTFORD           ,CT,06108-2220,Proprietary  ,7,29,36,74,157,231
01053000,QUINEBAUG VALLEY COMMUNITY COLLEGE      ,CT,06239-1440,Public       ,20,31,51,536,848,1384
01077900,PORTER AND CHESTER INSTITUTE-ALLCAMPUSES,CT,06615-7158,Proprietary  ,122,264,386,907,1520,2427
01077904,PORTER & CHESTER INSTITUTE              ,CT,06109-0000,Proprietary  ,0,0,0,0,1,1
01115000,ASNUNTUCK COMMUNITY COLLEGE             ,CT,06082-3800,Public       ,14,31,45,309,390,699
01149600,BULLARD HAVENS VOC TECH SCHOOL          ,CT,06610-3499,Public       ,1,11,12,6,54,60
01169700,VINAL REGIONAL VOC TECH SCHOOL          ,CT,06457-4918,Public       ,0,8,8,6,51,57
01184300,NORWICH TECHNICAL HIGH SCHOOL           ,CT,06360-7097,Public       ,2,8,10,10,51,61
01218500,H C WILCOX TECHNICAL HIGH SCHOOL        ,CT,06450-0000,Public       ,0,0,0,4,5,9
01242500,STONE ACADEMY                           ,CT,06514-4125,Proprietary  ,23,182,205,150,1314,1464
01242503,STONE ACADEMY -WATERBURY                ,CT,06705-3823,Proprietary  ,0,0,0,6,20,26
01287700,GIBBS COLLEGE                           ,CT,06855-1436,Proprietary  ,61,105,166,612,769,1381
01291300,LEON INSTITUTE OF HAIR DESIGN           ,CT,06604-4226,Proprietary  ,2,8,10,13,56,69
01326400,HENRY ABBOTT TECHNICAL HIGH SCHOOL      ,CT,06811-4881,Public       ,5,13,18,11,35,46
02058900,HARVARD H ELLIS TECHNICAL HIGH SCHOOL   ,CT,06239-0000,Public       ,0,1,1,18,14,32
02074000,BRANFORD HALL CAREER INSTITUTE          ,CT,06405-0000,Proprietary  ,203,750,953,866,3324,4190
02106600,FOX INSTITUTE OF BUSINESS               ,CT,06110-0000,Proprietary  ,24,80,104,113,420,533
02112300,RIDLEY LOWELL BUSINESS & TECH INST      ,CT,06320-0000,Proprietary  ,11,63,74,58,424,482
02112700,NORTH HAVEN ACADEMY                     ,CT,06473-3108,Proprietary  ,7,7,14,106,66,172
02115100,BUTLER BUSINESS SCHOOL                  ,CT,06604-0000,Proprietary  ,9,31,40,42,267,309
02148700,CONNECTICUT INST OF HAIR DESIGN         ,CT,06716-0000,Proprietary  ,2,2,4,18,19,37
02202500,NEW ENGLAND TRACTOR TRAILER SCH         ,CT,06071-2036,Proprietary  ,16,219,235,67,871,938
02213000,ELLA T GRASSO SOUTHEASTERN TECHNICAL HIG,CT,06340-0000,Public       ,0,0,0,4,9,13
02228800,BARAN INSTITUTE OF TECHNOLOGY           ,CT,06088-9631,Proprietary  ,62,50,112,835,388,1223
02244900,GOODWIN COLLEGE                         ,CT,06118-9980,Private      ,29,121,150,345,1801,2146
02245300,HOWELL CHENEY TECHNICAL HIGH SCHOOL     ,CT,06040-0000,Public       ,0,5,5,4,37,41
02265900,WINDHAM COMMUNITY MEM HOSP-RAD TECH     ,CT,06226-0000,Private      ,0,0,0,11,26,37
02296100,YALE-NEW HAVEN HOSP DIETETIC INTERN     ,CT,06510-8900,Private      ,0,0,0,9,12,21
02300000,W F KAYNOR TECHNICAL HIGH SCHOOL        ,CT,06708-0000,Public       ,2,10,12,6,47,53
02316600,CONNECTICUT CTR FOR MASSAGE THERAPY     ,CT,06111-3975,Proprietary  ,3,16,19,61,265,326
02316601,CONNECTICUT CENTER FOR MASSAGE THERAPY -,CT,06880-4619,Proprietary  ,4,11,15,31,136,167
02316603,CONNECTICUT CENTER FOR MASSAGE THERAPY -,CT,06340-4619,Proprietary  ,0,12,12,25,133,158
02562400,EMMETT O BRIEN REG VOC TECH SCHOOL      ,CT,06401-2500,Public       ,0,0,0,0,4,4
02565000,PLATT TECHNICAL HIGH SCHOOL             ,CT,06460-2105,Public       ,0,2,2,11,18,29
03079400,LYME ACADEMY COLLEGE OF FINE ARTS       ,CT,06371-2333,Private      ,0,0,0,86,43,129
03094800,INDUSTRIAL MANAGEMENT & TRAINING        ,CT,06706-1211,Proprietary  ,6,14,20,49,149,198
03231400,OLIVER WOLCOTT TECHNICAL HIGH SCHOOL    ,CT,06790-3859,Public       ,0,0,0,2,7,9
03234300,CHARTER OAK STATE COLLEGE               ,CT,06053-2150,Public       ,3,51,54,42,736,778
03316300,LINCOLN TECHNICAL INSTITUTE - HARTFORD  ,CT,06105-3630,Proprietary  ,16,34,50,376,322,698
03381300,CONNECTICUT TRAINING CENTER             ,CT,06108-2705,Private      ,13,66,79,63,294,357
03927300,ALBERT SCHOOL (THE)                     ,CT,06357-2447,Proprietary  ,7,14,21,38,65,103
04053300,CLEMENS COLLEGE                         ,CT,06078-0000,Proprietary  ,4,1,5,7,5,12
04104300,ACADEMY DI CAPELLI - SCHOOL OF COSMETOLO,CT,06492-0000,Proprietary  ,1,1,2,1,1,2
00146600,BARRY UNIVERSITY                        ,FL,33161-6695,Private      ,84,278,362,3894,7217,11111
00146601,BARRY UNIVERSITY SCHOOL OF LAW          ,FL,32807-0000,Private      ,0,11,11,49,1042,1091
00146700,BETHUNE COOKMAN UNIVERSITY              ,FL,32114-3099,Private      ,129,48,177,5452,1060,6512
00146800,ST THOMAS UNIVERSITY                    ,FL,33054-0000,Private      ,33,100,133,1155,2571,3726
00146900,FLORIDA INSTITUTE OF TECHNOLOGY         ,FL,32901-6988,Private      ,35,52,87,3137,1075,4212
00147000,BREVARD COMMUNITY COLLEGE               ,FL,32922-6503,Public       ,109,257,366,3026,4578,7604
00147100,CENTRAL FLORIDA COMMUNITY COLLEGE       ,FL,34478-1388,Public       ,76,193,269,2549,3369,5918
00147200,CHIPOLA  COLLEGE                        ,FL,32446-2053,Public       ,27,50,77,673,775,1448
00147300,CLEARWATER CHRISTIAN COLLEGE            ,FL,33759-0000,Private      ,12,4,16,708,98,806
00147500,DAYTONA STATE COLLEGE                   ,FL,32114-2800,Public       ,205,438,643,3952,6060,10012
00147700,EDISON COLLEGE                          ,FL,33906-6210,Public       ,91,189,280,3055,3556,6611
00147800,EDWARD WATERS COLLEGE                   ,FL,32209-6199,Private      ,31,29,60,966,690,1656
00147900,EMBRY-RIDDLE AERONAUTICAL UNIV          ,FL,32114-3900,Private      ,117,345,462,6564,4501,11065
00148000,FLORIDA A & M UNIVERSITY                ,FL,32307-3100,Public       ,409,121,530,12813,5786,18599
00148100,FLORIDA ATLANTIC UNIVERSITY             ,FL,33431-6498,Public       ,426,365,791,11186,8860,20046
00148101,FLORIDA ATLANTIC UNIVERSITY/DAVIE       ,FL,33314-0000,Public       ,23,69,92,801,2111,2912
00148103,FLORIDA ATLANTIC UNIV-JUPITER/PSL       ,FL,33458-0000,Public       ,9,39,48,450,529,979
00148200,FLORIDA COLLEGE                         ,FL,33617-5578,Private      ,3,3,6,414,41,455
00148400,FLORIDA STATE COLLEGE AT JACKSONVILLE   ,FL,32202-4030,Public       ,312,898,1210,7295,14248,21543
00148500,FLORIDA KEYS COMMUNITY COLLEGE          ,FL,33040-4397,Public       ,12,33,45,217,430,647
00148600,FLORIDA MEMORIAL UNIVERSITY             ,FL,33054-6199,Private      ,43,81,124,1813,1316,3129
00148700,ECKERD COLLEGE                          ,FL,33711-4744,Private      ,17,56,73,2220,703,2923
00148800,FLORIDA SOUTHERN COLLEGE                ,FL,33801-5698,Private      ,32,35,67,2133,671,2804
00148900,FLORIDA STATE UNIVERSITY                ,FL,32306-2430,Public       ,1340,403,1743,27598,13001,40599
00149000,GULF COAST COMMUNITY COLLEGE            ,FL,32401-1058,Public       ,56,125,181,1497,2686,4183
00149300,INDIAN RIVER STATE COLLEGE              ,FL,34981-5596,Public       ,126,287,413,2951,3894,6845
00149500,JACKSONVILLE UNIVERSITY                 ,FL,32211-3394,Private      ,54,173,227,2899,2318,5217
00149700,JONES COLLEGE                           ,FL,32211-5588,Private      ,10,72,82,91,859,950
00149900,EVEREST UNIVERSITY                      ,FL,32810-5601,Proprietary  ,319,1489,1808,1901,10714,12615
00150000,BROWARD COLLEGE- DOWNTOWN CTR           ,FL,33301-2208,Public       ,221,377,598,3891,5867,9758
00150001,BROWARD COLLEGE - DAVIE CAMPUS          ,FL,33314-0000,Public       ,135,181,316,3079,3283,6362
00150002,BROWARD COLLEGE- NORTH CAMPUS           ,FL,33066-0000,Public       ,87,136,223,1886,2374,4260
00150003,BROWARD COLLEGE- SOUTH CAMPUS           ,FL,33024-0000,Public       ,97,129,226,2261,2608,4869
00150100,LAKE CITY COMMUNITY COLLEGE             ,FL,32025-2007,Public       ,26,92,118,760,1529,2289
00150200,LAKE SUMTER COMMUNITY COLLEGE           ,FL,34788-8751,Public       ,39,75,114,1084,1441,2525
00150400,MANATEE COMMUNITY COLLEGE               ,FL,34207-3596,Public       ,109,180,289,2660,4011,6671
00150500,LYNN UNIVERSITY                         ,FL,33431-5598,Private      ,27,42,69,1413,682,2095
00150600,MIAMI DADE COLLEGE ADMINISTRATION ONLY  ,FL,33176-3393,Public       ,23,40,63,1230,1429,2659
00150601,MIAMI DADE COLLEGE - NORTH CAMPUS       ,FL,33167-3495,Public       ,435,720,1155,8464,11640,20104
00150602,MIAMI DADE COLLEGE - KENDALL CAMPUS     ,FL,33176-3393,Public       ,433,506,939,9283,7765,17048
00150603,MIAMI DADE COLLEGE - WOLFSON CAMPUS     ,FL,33132-2297,Public       ,244,310,554,4773,5436,10209
00150604,MIAMI DADE COLLEGE - MEDICAL CAMPUS     ,FL,33127-4693,Public       ,35,116,151,935,2476,3411
00150605,MIAMI DADE COLLEGE - HOMESTEAD CAMPUS   ,FL,33030-6009,Public       ,48,100,148,1010,1530,2540
00150606,MIAMI DADE COLLEGE -INTERAMERICAN CAMPUS,FL,33135-0000,Public       ,118,295,413,2160,4431,6591
00150800,NORTH FLORIDA COMMUNITY COLLEGE         ,FL,32340-1699,Public       ,14,34,48,418,644,1062
00150900,NOVA SOUTHEASTERN UNIVERSITY            ,FL,33314-7796,Private      ,118,1480,1598,3461,26628,30089
00151000,NORTHWEST FLORIDA STATE COLLEGE         ,FL,32578-1295,Public       ,59,191,250,1301,2589,3890
00151200,PALM BEACH COMMUNITY COLLEGE            ,FL,33461-4796,Public       ,356,378,734,6062,6450,12512
00151300,PENSACOLA JR COLLEGE                    ,FL,32504-8998,Public       ,156,326,482,2989,4914,7903
00151400,POLK COMMUNITY COLLEGE                  ,FL,33881-4299,Public       ,65,139,204,1799,2810,4609
00151500,ROLLINS COLLEGE                         ,FL,32789-4499,Private      ,36,32,68,1905,1244,3149
00151900,SANTA FE COLLEGE                        ,FL,32606-6200,Public       ,182,215,397,5506,4848,10354
00152000,SEMINOLE COMMUNITY COLLEGE              ,FL,32773-6199,Public       ,117,250,367,3554,5577,9131
00152100,SOUTHEASTERN UNIVERSITY                 ,FL,33801-6099,Private      ,32,45,77,2478,930,3408
00152200,SOUTH FLORIDA COMMUNITY COLLEGE         ,FL,33825-9399,Public       ,40,47,87,824,1073,1897
00152201,SOUTH FLORIDA COMMUNITY COLLEGE - LAKE P,FL,33852-9605,Public       ,0,0,0,15,31,46
00152300,ST JOHNS RIVER COMMUNITY COLLEGE        ,FL,32177-3897,Public       ,45,133,178,1326,2343,3669
00152600,SAINT LEO UNIVERSITY                    ,FL,33574-6665,Private      ,84,934,1018,2526,11596,14122
00152800,ST. PETERSBURG COLLEGE                  ,FL,33760-3768,Public       ,208,626,834,5072,11444,16516
00153100,STETSON UNIVERSITY                      ,FL,32723-3761,Private      ,44,28,72,2335,638,2973
00153101,STETSON UNIVERSITY - COLLEGE OF LAW     ,FL,33707-3299,Private      ,0,8,8,24,1636,1660
00153300,TALLAHASSEE COMMUNITY COLLEGE           ,FL,32304-2895,Public       ,221,250,471,6393,5600,11993
00153400,EVEREST UNIVERSITY                      ,FL,33614-5801,Proprietary  ,220,2176,2396,1452,13108,14560
00153500,UNIVERSITY OF FLORIDA                   ,FL,32611-3150,Public       ,1017,427,1444,25565,14787,40352
00153600,UNIVERSITY OF MIAMI                     ,FL,33146-6531,Private      ,194,166,360,12771,4355,17126
00153601,UNIV OF MIAMI SCHOOL OF LAW             ,FL,33124-0000,Private      ,5,5,10,69,1914,1983
00153602,UNIV OF MIAMI-SCH OF MEDICINE           ,FL,33136-0000,Private      ,27,12,39,525,1038,1563
00153700,UNIVERSITY OF SOUTH FLORIDA             ,FL,33620-6960,Public       ,1023,501,1524,22988,15449,38437
00153701,UNIV OF SOUTH FLORIDA-ST PETERSBURG     ,FL,33701-0000,Public       ,16,35,51,489,644,1133
00153702,UNIV OF SOUTH FLORIDA-SARASOTA          ,FL,34243-0000,Public       ,6,12,18,191,483,674
00153705,UNIV OF SOUTH FLORIDA                   ,FL,33803-0000,Public       ,18,9,27,498,380,878
00153706,UNIV OF SOUTH FLORIDA- MEDICINE         ,FL,33612-0000,Public       ,32,13,45,621,848,1469
00153800,UNIVERSITY OF TAMPA                     ,FL,33606-1490,Private      ,98,56,154,5466,1583,7049
00154000,WEBBER INTERNATIONAL UNIVERSITY         ,FL,33827-0096,Private      ,9,8,17,597,203,800
00173308,NATIONAL-LOUIS UNIVERSITY               ,FL,33609-0000,Private      ,0,9,9,6,113,119
00177201,TRINITY INTERNATIONAL UNIVERSITY - SOUTH,FL,33324-4611,Private      ,4,36,40,30,367,397
00395400,UNIV OF CENTRAL FLORIDA                 ,FL,32816-0001,Public       ,1132,488,1620,30462,14530,44992
00395500,UNIVERSITY OF WEST FLORIDA              ,FL,32514-5750,Public       ,116,181,297,4272,4211,8483
00407215,NORTHWOOD UNIVERSITY                    ,FL,33409-0000,Private      ,13,11,24,523,284,807
00558500,LIVELY TECHNICAL CENTER                 ,FL,32304-0000,Public       ,11,60,71,234,816,1050
00558501,LIVELY TECHNICAL CENTER - AVIATION SCHOO,FL,32304-8723,Public       ,2,2,4,9,14,23
00558600,LINDSEY HOPKINS TECHNICAL ED CENTER     ,FL,33127-4692,Public       ,10,84,94,157,673,830
00559400,D G ERWIN TECHNICAL CENTER              ,FL,33610-8255,Public       ,20,125,145,283,1168,1451
00560500,PINELLAS TECH ED CTR-CLEARWATER         ,FL,33760-2194,Public       ,18,109,127,161,570,731
00560700,SARASOTA COUNTY TECHNICAL INSTITUTE     ,FL,34233-0000,Public       ,2,17,19,85,296,381
00560800,TRAVISS TECHNICAL CENTER                ,FL,33803-0000,Public       ,12,29,41,157,551,708
00561200,MANATEE TECHNICAL INSTITUTE             ,FL,34210-0000,Public       ,15,39,54,134,516,650
00561201,MANATEE TECHNICAL INSTITUTE-EAST        ,FL,34211-0000,Public       ,8,11,19,28,177,205
00675000,VALENCIA COMMUNITY COLLEGE              ,FL,32802-3028,Public       ,608,612,1220,13514,11708,25222
00752500,SUWANNEE-HAMILTON AREA VOC TECH CTR     ,FL,32060-0000,Public       ,2,13,15,44,173,217
00752600,WASHINGTON HOLMES TECHNICAL CENTER      ,FL,32428-1699,Public       ,10,56,66,102,335,437
00755800,LEE COUNTY HIGH TECH CENTER CENTRAL     ,FL,33916-2299,Public       ,9,31,40,143,268,411
00758600,REMINGTON COLLEGE - TAMPA CAMPUS        ,FL,33612-8410,Proprietary  ,26,134,160,357,1167,1524
00758604,REMINGTON COLLEGE-LARGO CAMPUS          ,FL,33771-0000,Proprietary  ,2,2,4,9,37,46
00758605,REMINGTON COLLEGE-JACKSONVILLE CAMPUS   ,FL,32256-6932,Proprietary  ,0,3,3,10,38,48
00787000,HILLSBOROUGH COMMUNITY COLLEGE          ,FL,33606-3572,Public       ,304,483,787,7024,9378,16402
00789300,FLAGLER COLLEGE                         ,FL,32085-1027,Private      ,26,12,38,2320,548,2868
00807500,ST JOHN VIANNEY COLLEGE SEMINARY        ,FL,33165-3244,Private      ,0,0,0,14,5,19
00814600,EVEREST UNIVERSITY - POMPANO BEACH      ,FL,33062-2522,Proprietary  ,92,433,525,686,3787,4473
00822300,ST VINCENT DE PAUL REGIONL SEMINARY     ,FL,33436-0000,Private      ,0,0,0,0,8,8
00841700,STENOTYPE INST OF JACKSONVILLE          ,FL,32207-0000,Proprietary  ,12,78,90,90,498,588
00850100,RASMUSSEN COLLEGE                       ,FL,34471-7051,Proprietary  ,15,75,90,170,716,886
00850103,RASMUSSEN COLLEGE-HOLIDAY               ,FL,34690-0000,Proprietary  ,10,84,94,97,563,660
00884800,WARNER SOUTHERN COLLEGE                 ,FL,33859-8725,Private      ,11,71,82,490,695,1185
00884900,PALM BEACH ATLANTIC UNIVERSITY          ,FL,33401-6505,Private      ,41,59,100,2175,1855,4030
00887800,MIAMI INTERNATIONAL UNIV ART&DESIGN     ,FL,33132-1418,Proprietary  ,125,157,282,2003,1451,3454
00910400,RIVERSIDE HAIRSTYLING ACADEMY           ,FL,32207-3810,Proprietary  ,3,13,16,25,90,115
00963500,FLORIDA INTERNATIONAL UNIVERSITY        ,FL,33199-0001,Public       ,815,604,1419,21312,16643,37955
00984100,UNIVERSITY OF NORTH FLORIDA             ,FL,32224-2645,Public       ,307,178,485,8238,5664,13902
00990200,SHERIDAN TECHNICAL CENTER               ,FL,33021-3399,Public       ,41,133,174,305,1027,1332
01016100,"LORAINE'S ACADEMY, INC                  ",FL,33710-0000,Proprietary  ,7,38,45,52,199,251
01019500,ART INSTITUTE OF FT LAUDERDALE          ,FL,33316-3000,Proprietary  ,116,149,265,2141,1838,3979
01065200,PASCO-HERNANDO COMMUNITY CLG            ,FL,34654-5199,Public       ,80,251,331,2117,3795,5912
01072401,CARLOS ALBIZU UNIVERSITY                ,FL,33172-0000,Private      ,4,88,92,113,1164,1277
01082600,TOM P. HANEY TECHNICAL CENTER           ,FL,32405-5099,Public       ,4,31,35,87,421,508
01112700,GOODING INST OF NUR ANES BAY MED CT     ,FL,32401-0000,Public       ,0,0,0,1,43,44
01226300,ATLANTIC TECHNICAL CENTER               ,FL,33063-3902,Public       ,19,79,98,267,689,956
01254400,FIRST COAST TECHNICAL COLLEGE           ,FL,32084-1921,Public       ,27,82,109,151,504,655
01254401,FIRST COAST TECHNICAL INSTITUTE - PUTNAM,FL,32077-6830,Public       ,2,4,6,6,16,22
01257400,RINGLING SCHOOL OF ART AND DESIGN       ,FL,34234-5895,Private      ,12,4,16,1148,282,1430
01303904,SOUTH UNIVERSITY                        ,FL,33409-5149,Proprietary  ,18,105,123,240,947,1187
01323400,LORENZO WALKER INST OF TECHNOLOGY       ,FL,34104-4405,Public       ,15,25,40,117,281,398
02052002,FLORIDA EDUCATION CENTER - LAUDERHILL   ,FL,33313-5857,Proprietary  ,29,92,121,118,503,621
02089600,CONCORDE CAREER INSTITUTE               ,FL,32211-0000,Proprietary  ,21,123,144,181,921,1102
02089709,HERZING COLLEGE                         ,FL,32792-5509,Proprietary  ,0,6,6,21,53,74
02113606,AMERICAN INTERCONTINENTAL UNIV          ,FL,33324-0000,Proprietary  ,1,12,13,59,170,229
02113609,AMERICAN INTERCONTINENTAL UNIV - WESTON ,FL,33326-3233,Proprietary  ,43,69,112,847,1350,2197
02115300,PINELLAS TECHNICAL EDUCATION CENTERS - S,FL,33711-0000,Public       ,15,72,87,120,557,677
02116006,SANFORD-BROWN INSTITUTE - FT. LAUDERDALE,FL,33309-1906,Proprietary  ,46,122,168,279,1027,1306
02121800,EVEREST INSTITUTE                       ,FL,33169-4759,Proprietary  ,141,383,524,703,1856,2559
02148200,FASHION FOCUS HAIR ACADEMY              ,FL,34231-0000,Proprietary  ,2,5,7,11,33,44
02148300,MANHATTAN BEAUTY SCHOOL                 ,FL,33611-0000,Proprietary  ,30,136,166,151,721,872
02149900,PAUL MITCHELL THE SCHOOL-JACKSONVILLE   ,FL,32205-0000,Proprietary  ,0,0,0,11,64,75
02151900,KEISER  UNIVERSITY                      ,FL,33309-0000,Proprietary  ,450,1463,1913,3403,11160,14563
02156300,MARGATE SCHOOL OF BEAUTY                ,FL,33063-0000,Proprietary  ,0,0,0,1,6,7
02156700,FLORIDA CHRISTIAN COLLEGE               ,FL,34744-0000,Private      ,3,9,12,175,153,328
02159600,BAPTIST COLLEGE OF FLORIDA (THE)        ,FL,32440-0000,Private      ,11,11,22,246,302,548
02172700,CONCORDE CAREER INSTITUTE               ,FL,33607-0000,Proprietary  ,29,106,135,198,788,986
02188900,HOBE SOUND BIBLE COLLEGE                ,FL,33475-0000,Private      ,5,1,6,68,25,93
02200100,BRADENTON BEAUTY & BARBER ACADEMY       ,FL,34209-0000,Proprietary  ,16,51,67,32,149,181
02215900,ATI CAREER TRAINING CENTER              ,FL,33309-1785,Proprietary  ,33,76,109,203,537,740
02218700,FLORIDA TECHNICAL COLLEGE               ,FL,32826-2707,Proprietary  ,59,189,248,508,1195,1703
02228300,LAKE TECHNICAL CENTER                   ,FL,32726-0000,Public       ,10,21,31,107,367,474
02245500,CENTRAL FLORIDA COLLEGE                 ,FL,32789-4679,Proprietary  ,33,174,207,232,875,1107
02245502,CFC-CAREER TRAINING INSTITUTE - ORLANDO ,FL,32804-0000,Proprietary  ,3,17,20,44,92,136
02245504,CENTRAL FLORIDA  COLLEGE -  LARGO       ,FL,33771-4957,Proprietary  ,1,7,8,65,110,175
02257900,INTERNATIONAL ACADEMY                   ,FL,32119-3541,Proprietary  ,17,60,77,131,285,416
02275100,CONCORDE CAREER INSTITUTE               ,FL,33025-0000,Proprietary  ,21,83,104,128,559,687
02278800,SOUTHWEST FLORIDA COLLEGE               ,FL,33907-0000,Proprietary  ,50,167,217,485,1267,1752
02278801,SOUTHWEST FLORIDA COLLEGE - TAMPA       ,FL,33619-1344,Proprietary  ,34,56,90,287,612,899
02279600,CORTIVA INSTITUTE - FLORIDA             ,FL,33781-0000,Proprietary  ,5,22,27,29,135,164
02280800,NEW ENGLAND INST TECH-PALM BEACH        ,FL,33407-0000,Proprietary  ,69,152,221,689,1151,1840
02283800,BEAUTY SCHOOLS OF AMERICA               ,FL,33012-3322,Proprietary  ,46,214,260,219,1103,1322
02286500,ITT TECHNICAL INSTITUTE                 ,FL,33634-7515,Proprietary  ,167,299,466,1268,2121,3389
02287100,LA BELLE BEAUTY SCHOOL                  ,FL,33012-0000,Proprietary  ,4,41,45,31,305,336
02293200,ATI CAREER TRAINING CENTER              ,FL,33309-5916,Proprietary  ,57,145,202,359,838,1197
02293201,ATI CAREER TRAINING CENTER - MIAMI      ,FL,33122-1707,Proprietary  ,2,3,5,8,9,17
02293202,ATI CAREER TAINING CENTER - ATI COLLEGE ,FL,87109-2016,Proprietary  ,27,135,162,167,960,1127
02293600,ADVANCED TECHNICAL CENTERS              ,FL,33266-1597,Private      ,0,2,2,7,22,29
02297000,CHARLOTTE TECHNICAL CENTER              ,FL,33948-0000,Public       ,5,18,23,70,228,298
02300900,WITHLACOOCHEE TECHNICAL INSTITUTE       ,FL,34450-0000,Public       ,7,30,37,103,302,405
02305700,GULF COAST COLLEGE                      ,FL,33619-0000,Proprietary  ,3,23,26,63,222,285
02305800,FLORIDA CAREER COLLEGE                  ,FL,33012-7028,Proprietary  ,412,739,1151,2094,3661,5755
02307400,GEORGE STONE AREA VOCATIONAL TECHNICAL  ,FL,32526-0000,Public       ,16,42,58,98,385,483
02314100,SCHILLER INTERNATIONAL UNIVERSITY       ,FL,33770-3716,Proprietary  ,4,6,10,74,115,189
02316200,MIAMI LAKES TECHNICAL EDUCATION CTR     ,FL,33014-0000,Public       ,21,62,83,228,646,874
02321200,ORANGE TECH EDUC CTR- WESTSIDE TECH     ,FL,34787-0000,Public       ,12,37,49,127,253,380
02325100,KEY COLLEGE                             ,FL,33004-3046,Proprietary  ,2,8,10,20,101,121
02326800,RESORT & SPA SCHOOLS INTERNATIONAL      ,FL,34233-0000,Proprietary  ,20,41,61,39,100,139
02326900,SUNSTATE ACADEMY OF HAIR DESIGN         ,FL,33907-1415,Proprietary  ,21,46,67,92,168,260
02329900,FLORIDA INSTITUTE OF ULTRASOUND         ,FL,32514-0000,Proprietary  ,0,4,4,44,108,152
02337000,SUNCOAST II THE TAMPA BAY SCHOOL OF MASS,FL,33607-3802,Proprietary  ,4,16,20,6,62,68
02338400,FT PIERCE BEAUTY ACADEMY                ,FL,34982-0000,Proprietary  ,19,52,71,75,275,350
02341001,FORTIS COLLEGE - DBA FORTIS INSTITUTE   ,FL,32504-7322,Proprietary  ,1,2,3,13,46,59
02346200,WYOTECH                                 ,FL,32174-1010,Proprietary  ,24,44,68,221,438,659
02362100,FULL SAIL UNIVERSITY                    ,FL,32792-0000,Proprietary  ,366,228,594,6985,3545,10530
02499000,ACADEMY OF COSMETOLOGY                  ,FL,32953-3311,Proprietary  ,6,17,23,28,88,116
02501500,"O*TEC, MID-FLORIDA TECH                 ",FL,32809-0000,Public       ,24,49,73,234,379,613
02502702,ADVANCED CAREER TRAINING-JACKSONVIL     ,FL,32256-0000,Proprietary  ,25,108,133,110,629,739
02504600,WINTER PARK TECH                        ,FL,32789-0000,Public       ,13,33,46,84,336,420
02508900,TALMUDIC COLLEGE OF FLORIDA             ,FL,33139-0000,Private      ,5,1,6,20,7,27
02511700,RIDGE TECHNICAL CENTER                  ,FL,33881-0000,Public       ,8,38,46,91,370,461
02513200,ORLANDO TECHNICAL CENTER                ,FL,32801-0000,Public       ,14,47,61,173,549,722
02515400,CITY COLLEGE                            ,FL,33309-3073,Private      ,44,157,201,279,1183,1462
02517100,SARASOTA SCHOOL OF MASSAGE THERAPY      ,FL,34243-6130,Proprietary  ,3,10,13,36,104,140
02524000,SUNSTATE ACADEMY OF HAIR DESIGN         ,FL,34624-0000,Proprietary  ,15,37,52,55,89,144
02524200,ROBERT MORGAN EDUCATIONAL CENTER        ,FL,33177-0000,Public       ,24,91,115,306,623,929
02547600,FLORIDA NATIONAL COLLEGE                ,FL,33012-0000,Proprietary  ,111,364,475,862,2377,3239
02554200,RADFORD LOCKLIN TECH CENTER             ,FL,32570-0000,Public       ,3,12,15,19,100,119
02573200,LA BELLE BEAUTY ACADEMY                 ,FL,33135-0000,Proprietary  ,1,14,15,33,199,232
02586200,FLORIDA CAREER COLLEGE                  ,FL,33759-3924,Proprietary  ,90,165,255,297,765,1062
02597100,HERITAGE INSTITUTE                      ,FL,33912-7132,Proprietary  ,49,112,161,163,430,593
02598200,FLORIDA TECHNICAL CLG JACKSONVILLE      ,FL,32211-5123,Proprietary  ,2,29,31,64,185,249
02599800,EVEREST UNIVERSITY                      ,FL,33759-1359,Proprietary  ,96,661,757,650,4511,5161
02601600,HENRY W BREWSTER TECHNICAL CENTER       ,FL,33602-0000,Public       ,7,63,70,51,256,307
02612700,DARLYNE MCGEE'S ACAD OF COSMETOLOGY     ,FL,32905-2805,Proprietary  ,3,12,15,25,78,103
02616400,SANFORD-BROWN INSTITUTE                 ,FL,32256-3520,Proprietary  ,14,87,101,123,597,720
02616401,SANFORD-BROWN INSTITUTE - TAMPA         ,FL,33610-8304,Proprietary  ,34,132,166,198,874,1072
03003200,EVEREST INSTITUTE                       ,FL,33186-1410,Proprietary  ,110,376,486,581,1771,2352
03003600,MCFATTER TECHNICAL CENTER               ,FL,33317-7499,Public       ,12,52,64,195,567,762
03008600,FLORIDA COLLEGE OF NATURAL HEALTH       ,FL,33064-1342,Proprietary  ,39,171,210,280,893,1173
03010608,VIRGINIA COLLEGE - PENSACOLA            ,FL,32501-5650,Proprietary  ,32,196,228,434,1333,1767
03010612,VIRGINIA COLLEGE - GOLF ACADEMY OF AMERI,FL,32701-0000,Proprietary  ,12,10,22,107,113,220
03012300,ASM BEAUTY WORLD ACADEMY                ,FL,33021-0000,Proprietary  ,3,15,18,19,131,150
03018500,BENE'S INTERNATIONAL SCHOOL OF BEAUTY   ,FL,34652-1637,Proprietary  ,13,44,57,62,182,244
03028200,TRINITY COLLEGE OF FLORIDA              ,FL,34655-4401,Private      ,3,7,10,91,117,208
03031400,INTERNATIONAL ACAD OF DESIGN & TECH     ,FL,33634-6313,Proprietary  ,245,434,679,3170,3260,6430
03031402,INTERNATIONAL ACADEMY OF DESIGN AND TECH,FL,32809-4633,Proprietary  ,16,12,28,658,541,1199
03031403,IADT - ORLANDO CULINARY ACADEMY         ,FL,32819-0000,Proprietary  ,5,8,13,542,578,1120
03035800,HERITAGE INSTITUTE                      ,FL,32216-0948,Proprietary  ,13,97,110,74,358,432
03035900,NATIONAL AVIATION ACADEMY               ,FL,33760-3931,Proprietary  ,22,55,77,127,381,508
03037500,HODGES UNIVERSITY                       ,FL,34119-7932,Private      ,43,212,255,344,1913,2257
03054200,TECHNICAL CAREER INSTITUTE              ,FL,33144-2373,Proprietary  ,53,99,152,438,521,959
03071600,COLLEGE OF BUSINESS & TECHNOLOGY        ,FL,33176-1412,Proprietary  ,26,220,246,140,846,986
03071601,COLLEGE OF BUSINESS & TECHNOLOGY -      ,FL,33144-2072,Proprietary  ,2,0,2,4,4,8
03071602,COLLEGE OF BUSINESS & TECHNOLOGY -      ,FL,33012-3436,Proprietary  ,0,0,0,6,6,12
03079800,GEORGE T BAKER AVIATION                 ,FL,33142-5687,Public       ,13,18,31,138,117,255
03079900,CITY COLLEGE                            ,FL,32707-5342,Private      ,4,25,29,20,145,165
03087600,ITT TECHNICAL INSTITUTE                 ,FL,32746-1607,Proprietary  ,152,307,459,1017,1864,2881
03089200,NOUVELLE INSTITUTE                      ,FL,33125-4141,Proprietary  ,5,86,91,27,506,533
03096300,FLORIDA CAREER INSTITUTE                ,FL,33860-0000,Proprietary  ,7,27,34,63,171,234
03099600,MERCY HOSPITAL SCHOOL OF PRACTICAL NSG  ,FL,33133-4237,Private      ,1,3,4,37,113,150
03100800,TAYLOR TECHNICAL INSTITUTE              ,FL,32348-0894,Public       ,3,6,9,26,136,162
03101900,TRINITY BAPTIST COLLEGE                 ,FL,32221-1398,Private      ,4,3,7,251,95,346
03103900,MARION COUNTY COMMUNITY TECH & ADUL     ,FL,34474-3172,Public       ,2,6,8,94,317,411
03108500,EVERGLADES UNIVERSITY                   ,FL,33431-0000,Private      ,12,117,129,132,828,960
03108600,COM-PU-MED VOCATIONAL CAREERS           ,FL,33012-4861,Proprietary  ,22,187,209,75,705,780
03113400,ACADEMY OF HEALING ARTS                 ,FL,33463-2113,Proprietary  ,6,21,27,18,91,109
03114700,PRAXIS INSTITUTE                        ,FL,33135-2657,Proprietary  ,4,105,109,34,504,538
03115500,FLORIDA HOSPITAL COLG OF HEALTH SCI     ,FL,32803-1237,Private      ,26,38,64,727,1650,2377
03123900,KEISER CAREER INSTITUTE                 ,FL,33413-0000,Proprietary  ,56,122,178,325,923,1248
03125600,MIAMI AD SCHOOL                         ,FL,33139-5203,Proprietary  ,8,6,14,64,268,332
03127900,TECHNICAL EDUCATION CTR OSCEOLA         ,FL,34744-4459,Public       ,8,38,46,106,342,448
03139600,DELTA CONNECTION ACADEMY                ,FL,32773-9683,Proprietary  ,2,8,10,46,89,135
03158300,LEE COUNTY HIGH TECH CENTER NORTH       ,FL,33993-2479,Public       ,5,29,34,50,168,218
03178400,CORAL RIDGE NURSES ASST TRAINING        ,FL,33306-0000,Proprietary  ,0,1,1,2,19,21
03224300,NEW PROFESSIONS TECHNICAL INSTITUTE     ,FL,33134-1640,Proprietary  ,18,128,146,68,586,654
03230300,OKALOOSA APPLIED TECHNOLOGY CENTER      ,FL,32547-1299,Public       ,2,16,18,67,298,365
03238300,FLORIDA COLLEGE OF INTEGRATIVE MED      ,FL,32809-5721,Proprietary  ,1,10,11,15,138,153
03255300,FLORIDA GULF COAST UNIVERSITY           ,FL,33965-6565,Public       ,162,69,231,4817,2282,7099
03256300,YESHIVA GEDOLAH RABBINICAL COLLEGE      ,FL,33139-4708,Private      ,4,0,4,19,4,23
03346300,ACAD FOR PRAC NURSING & HEALTH OCCP     ,FL,33417-4574,Private      ,16,43,59,80,578,658
03348400,PROFESSIONAL TRAINING CENTERS           ,FL,33184-0000,Proprietary  ,5,30,35,137,693,830
03370300,AUDIO RECORDING TECHNOLOGY INSTITUTE    ,FL,32811-0000,Proprietary  ,7,7,14,89,95,184
03373300,BEACON COLLEGE                          ,FL,34748-5224,Private      ,1,1,2,65,34,99
03374300,FLORIDA COASTAL SCHOOL OF LAW           ,FL,32256-0000,Proprietary  ,0,24,24,23,2002,2025
03382300,BRADFORD-UNION AREA CAREERTECHNICAL CENT,FL,32091-2434,Public       ,1,6,7,28,127,155
03390300,LINCOLN TECHNICAL INSTITUTE             ,FL,32730-2351,Proprietary  ,21,118,139,127,645,772
03411400,INTERNATIONAL TRAINING CAREERS          ,FL,33155-1462,Private      ,9,97,106,32,365,397
03414500,SOUTHEAST INSTITUTE OF ORIENTAL MED     ,FL,33176-1509,Proprietary  ,4,25,29,16,133,149
03425400,CENTRAL FLORIDA INSTITUTE               ,FL,34684-4436,Proprietary  ,18,96,114,101,505,606
03429600,ATLANTIC INST OF ORIENTAL MEDICINE      ,FL,33316-0000,Private      ,0,9,9,4,82,86
03429700,EAST WEST COLLG OF NATURAL MEDICINE     ,FL,34236-4959,Proprietary  ,0,6,6,1,136,137
03433400,NEW CONCEPT MASSAGE AND BEAUTY SCHO     ,FL,33135-0000,Proprietary  ,0,5,5,6,37,43
03434300,FORTIS COLLEGE                          ,FL,32073-2999,Proprietary  ,29,74,103,135,592,727
03459400,SAINT PETERSBURG THEOLOGICAL SEMINA     ,FL,33708-3116,Private      ,0,4,4,6,47,53
03480302,MEDVANCE INSTITUTE - STUART             ,FL,34994-3000,Proprietary  ,0,1,1,3,32,35
03491400,AMERICAN ADVANCED TECHNICIANS INST      ,FL,33014-4430,Proprietary  ,4,11,15,18,71,89
03524300,ACADEMY FOR FIVE ELEMENT ACUPUNCTURE    ,FL,32601-6811,Private      ,0,0,0,1,54,55
03549300,ULTIMATE MEDICAL ACADEMY                ,FL,33756-5802,Proprietary  ,12,67,79,48,348,396
03553300,KEISER CAREER COLLEGE                   ,FL,32216-0000,Proprietary  ,1,6,7,10,33,43
03557300,NORTH FLORIDA COSMETOLOGY INSTITUTE     ,FL,32312-0000,Proprietary  ,3,14,17,50,115,165
03564300,SUPERIOR CAREER INSTITUTE               ,FL,33311-1141,Proprietary  ,8,14,22,23,90,113
03570400,ENGLISH CENTER (THE)                    ,FL,33133-2703,Public       ,0,19,19,16,160,176
03595400,ANGLEY COLLEGE                          ,FL,32720-4257,Proprietary  ,3,41,44,29,157,186
03611400,FLORIDA BARBER ACADEMY                  ,FL,33441-0000,Proprietary  ,4,14,18,18,48,66
03618300,FLORIDA INSTITUTE OF ANIMAL ARTS        ,FL,32792-1740,Proprietary  ,6,8,14,33,73,106
03627400,JACKSONVILLE BEAUTY INSTITUTE           ,FL,32208-1885,Proprietary  ,5,64,69,23,276,299
03627600,FLORIDA EDUCATION INSTITUTE             ,FL,33144-5036,Proprietary  ,13,60,73,40,271,311
03661400,SOUTH FLORIDA INSTITUTE OF TECHNOLO     ,FL,33135-0000,Proprietary  ,16,92,108,45,322,367
03691400,AVE MARIA SCHOOL OF LAW                 ,FL,34119-1376,Private      ,0,2,2,1,531,532
03706300,AMERICAN INSTITUTE                      ,FL,33319-5613,Proprietary  ,17,81,98,73,383,456
03757300,ADVANCE SCIENCE INSTITUTE               ,FL,33012-0000,Proprietary  ,10,35,45,30,166,196
03801400,BEAUTY INSTITUTE (THE)                  ,FL,33409-2972,Proprietary  ,0,18,18,18,127,145
03816300,ARTISTIC NAILS & BEAUTY ACADEMY         ,FL,33605-5919,Proprietary  ,14,59,73,48,215,263
03823300,FLORIDA ACADEMY OF HEALTH & BEAUTY      ,FL,33311-0000,Proprietary  ,0,10,10,11,53,64
03832300,DADE MEDICAL COLLEGE                    ,FL,33126-5534,Proprietary  ,8,39,47,57,234,291
03842500,CAMBRIDGE INSTITUTE OF ALLIED HEALTH    ,FL,32750-0000,Proprietary  ,4,15,19,16,78,94
03856300,UNIVERSAL BEAUTY SCHOOL                 ,FL,33174-4406,Proprietary  ,5,37,42,16,176,192
03866300,GALIANO CAREER ACADEMY                  ,FL,32701-0000,Proprietary  ,17,90,107,92,540,632
03875300,MEDICAL CAREER INSTITUTE OF SOUTH FLORID,FL,33407-2103,Proprietary  ,19,85,104,65,388,453
03888300,DRAGON RISES COLLEGE OF ORIENTAL MEDICIN,FL,32601-5089,Proprietary  ,0,2,2,3,9,12
03903500,SOUTHERN TECHNICAL COLLEGE              ,FL,32809-0000,Proprietary  ,0,6,6,20,41,61
03905300,LEVIN SCHOOL OF HEALTH CARE             ,FL,33445-4699,Proprietary  ,0,0,0,0,2,2
03906300,CAREER INSTITUTE OF FLORIDA             ,FL,33773-3434,Proprietary  ,3,70,73,21,332,353
03911300,TOTAL INTERNATIONAL CAREER INSTITUTE    ,FL,33012-0000,Proprietary  ,1,24,25,2,38,40
03939400,CENTURA INSTITUTE                       ,FL,32807-3566,Proprietary  ,4,36,40,33,177,210
03939600,DAYTONA COLLEGE                         ,FL,32174-8445,Proprietary  ,3,22,25,9,81,90
03941300,AVE MARIA UNIVERSITY                    ,FL,34142-9505,Private      ,20,4,24,524,126,650
03957400,NEW COLLEGE OF FLORIDA                  ,FL,34243-2109,Public       ,17,0,17,835,131,966
03985300,COMMERCIAL DIVING ACADEMY               ,FL,32208-0000,Proprietary  ,12,52,64,56,214,270
03985400,SPACE COAST HEALTH INSTITUTE            ,FL,32904-8771,Proprietary  ,4,11,15,6,14,20
03986300,AVIATOR COLLEGE OF AERONAUTICAL SCIENCE ,FL,34946-9022,Proprietary  ,1,3,4,12,24,36
04016500,AMERICAN INSTITUTE OF BEAUTY            ,FL,33773-0000,Proprietary  ,4,41,45,32,143,175
04029300,TRENDSETTERS OF FLORIDA SCHOOL OF BEAUTY,FL,32205-0000,Proprietary  ,2,10,12,8,64,72
04058300,HEALTH OPPORTUNITY TECHNICAL CENTER     ,FL,33169-4517,Proprietary  ,1,30,31,6,134,140
04105400,PENSACOLA SCHOOL OF MASSAGE THERAPY & HE,FL,32504-7337,Proprietary  ,5,26,31,5,26,31
04119500,LANE INSTITUTE OF HEALTH SCIENCES       ,FL,32780-2898,Private      ,0,1,1,0,1,1
00160500,CHAMINADE UNIV OF HONOLULU              ,HI,96816-1578,Private      ,20,90,110,1360,1492,2852
00160600,BRIGHAM YOUNG UNIV-HAWAII CAMPUS        ,HI,96762-1294,Private      ,37,37,74,858,669,1527
00161000,UNIVERSITY OF HAWAII AT MANOA           ,HI,96822-2399,Public       ,128,109,237,8667,6614,15281
00161100,UNIVERSITY OF HAWAII AT HILO            ,HI,96720-4091,Public       ,51,24,75,2327,1419,3746
00161200,HONOLULU COMMUNITY COLLEGE              ,HI,96817-4598,Public       ,31,40,71,1066,1137,2203
00161300,KAPIOLANI COMMUNITY COLLEGE             ,HI,96816-4421,Public       ,46,61,107,1563,1614,3177
00161400,KAUAI COMMUNITY COLLEGE                 ,HI,96766-9591,Public       ,8,4,12,220,263,483
00161500,MAUI COMMUNITY COLLEGE                  ,HI,96732-1644,Public       ,25,44,69,664,996,1660
00454900,LEEWARD COMMUNITY COLLEGE               ,HI,96782-3393,Public       ,29,61,90,1073,1505,2578
00525800,HAWAII COMMUNITY COLLEGE                ,HI,96720-4075,Public       ,17,21,38,871,1011,1882
00723401,HEALD COLLEGE - HONOLULU                ,HI,96814-0000,Proprietary  ,58,106,164,670,807,1477
00727900,HAWAII PACIFIC UNIVERSITY               ,HI,96813-2882,Private      ,53,124,177,3472,3078,6550
00777500,HOLLYWOOD BEAUTY COLLEGE                ,HI,96701-4100,Proprietary  ,3,9,12,28,66,94
01122000,WINDWARD COMMUNITY COLLEGE              ,HI,96744-0000,Public       ,16,25,41,398,581,979
02055100,HAWAII BUSINESS COLLEGE                 ,HI,96813-0000,Proprietary  ,0,0,0,165,271,436
02100300,MED-ASSIST SCHOOL OF HAWAII             ,HI,96813-0000,Proprietary  ,8,14,22,56,112,168
02107800,UNIVERSITY OF HAWAII - WEST OAHU        ,HI,96782-0000,Public       ,6,16,22,232,583,815
02139500,HAWAII INSTITUTE OF HAIR DESIGN         ,HI,96817-5195,Proprietary  ,2,10,12,28,92,120
02208704,SAN DIEGO GOLF ACADEMY - THE GOLF ACADEM,HI,96744-3724,Proprietary  ,1,2,3,14,21,35
02321300,HAWAI'I THEOLOGICAL SEMINARY            ,HI,96817-0000,Private      ,0,1,1,9,20,29
03017800,TRAVEL INSTITUTE OF THE PACIFIC         ,HI,96814-1946,Proprietary  ,8,32,40,52,186,238
03020800,NEW YORK TECHNICAL INST OF HAWAII       ,HI,96817-4415,Proprietary  ,1,3,4,15,36,51
03072500,WORLD MEDICINE INSTITUTE                ,HI,96826-0000,Private      ,0,2,2,4,52,56
03649300,HAWAII TECHNOLOGY INSTITUTE             ,HI,96813-3036,Private      ,2,3,5,15,25,40
03735300,INST OF CLINICAL ACUPUNCTURE & ORIENT MD,HI,96813-2307,Proprietary  ,0,1,1,3,29,32
03999400,TRADITIONAL CHINESE MEDICAL COLLEGE OF H,HI,96743-8324,Private      ,0,0,0,0,5,5
00161600,BOISE STATE UNIVERSITY                  ,ID,83725-1000,Public       ,187,332,519,8129,9834,17963
00161700,"COLLEGE OF IDAHO, THE                   ",ID,83605-4432,Private      ,14,5,19,1038,224,1262
00161900,COLLEGE OF SOUTHERN IDAHO               ,ID,83301-0000,Public       ,94,170,264,2069,2817,4886
00162000,IDAHO STATE UNIVERSITY                  ,ID,83209-5377,Public       ,99,199,298,4273,7908,12181
00162100,LEWIS-CLARK STATE COLLEGE               ,ID,83501-2698,Public       ,43,67,110,1737,1923,3660
00162300,NORTH IDAHO COLLEGE                     ,ID,83814-2199,Public       ,53,111,164,1891,2276,4167
00162400,NORTHWEST NAZARENE UNIVERSITY           ,ID,83686-5897,Private      ,12,48,60,1225,922,2147
00162500,BRIGHAM YOUNG UNIVERSITY-IDAHO          ,ID,83460-1650,Private      ,430,456,886,6761,5686,12447
00162600,UNIVERSITY OF IDAHO                     ,ID,83844-4291,Public       ,101,84,185,7422,4113,11535
00455300,ITT TECHNICAL INSTITUTE                 ,ID,83713-1529,Proprietary  ,74,203,277,485,1073,1558
00987300,MR JUAN'S CLG OF HAIR DESIGN            ,ID,83301-4154,Proprietary  ,2,5,7,19,48,67
01113300,EASTERN IDAHO TECHNICAL COLLEGE         ,ID,83404-5788,Public       ,8,40,48,266,806,1072
02210700,CAREER BEAUTY COLLEGE                   ,ID,83440-0000,Proprietary  ,3,7,10,46,47,93
02218000,APOLLO COLLEGE                          ,ID,83704-0000,Proprietary  ,23,149,172,265,794,1059
02234500,BOISE BIBLE COLLEGE                     ,ID,83714-1220,Private      ,6,3,9,174,91,265
02275800,MR LEONS SCHOOL OF HAIR DESIGN          ,ID,83843-8384,Proprietary  ,2,6,8,28,49,77
02314000,SCHOOL OF HAIRSTYLING (THE)             ,ID,83202-0000,Proprietary  ,3,2,5,46,58,104
02319800,HEADMASTERS SCHOOL OF HAIR DESIGN       ,ID,83814-0000,Proprietary  ,23,32,55,113,139,252
02349200,HEADMASTERS SCHOOL OF HAIR DESIGN       ,ID,83501-0000,Proprietary  ,3,7,10,25,44,69
02559500,RAZZLE DAZZLE CLG OF HAIR DESIGN        ,ID,83686-5104,Proprietary  ,3,7,10,33,73,106
02607100,SCOT LEWIS SCHOOLS                      ,ID,83709-1662,Proprietary  ,10,21,31,82,130,212
03052202,COURT REPORTING INSTITUTE/CRI COMPUTER T,ID,83709-8101,Proprietary  ,0,0,0,4,22,26
03098700,ACADEMY OF COURT REPORTING              ,ID,83704-8320,Proprietary  ,43,174,217,229,889,1118
03832400,COSMETOLOGY SCHOOL OF ARTS & SCIENCES   ,ID,83318-1327,Proprietary  ,2,5,7,9,49,58
00163200,AQUINAS INSTITUTE OF THEOLOGY           ,MO,63108-3323,Private      ,0,1,1,3,53,56
00244900,AVILA COLLEGE                           ,MO,64145-1698,Private      ,13,41,54,991,1096,2087
00245000,CALVARY BIBLE COLLEGE                   ,MO,64147-1341,Private      ,3,8,11,180,181,361
00245200,CENTRAL BIBLE COLLEGE                   ,MO,65803-1096,Private      ,5,4,9,604,301,905
00245300,CENTRAL METHODIST UNIVERSITY            ,MO,65248-1198,Private      ,20,20,40,1068,544,1612
00245301,CENTRAL METHODIST UNIVERSITY            ,MO,63601-0000,Private      ,0,10,10,58,158,216
00245302,CENTRAL METHODIST UNIVERSITY- UNION     ,MO,63084-0000,Private      ,0,0,0,32,43,75
00245400,UNIVERSITY OF CENTRAL MISSOURI          ,MO,64093-5178,Public       ,75,124,199,6546,3592,10138
00245600,COLUMBIA COLLEGE                        ,MO,65216-4581,Private      ,90,818,908,2273,10399,12672
00245700,CONCORDIA SEMINARY                      ,MO,63105-3199,Private      ,1,15,16,3,685,688
00245800,COTTEY COLLEGE                          ,MO,64772-2790,Private      ,1,2,3,360,20,380
00245900,CROWDER COLLEGE                         ,MO,64850-9165,Public       ,69,107,176,1319,1685,3004
00246000,CULVER STOCKTON COLLEGE                 ,MO,63435-1299,Private      ,12,3,15,1128,187,1315
00246100,DRURY UNIVERSITY                        ,MO,65802-3791,Private      ,43,204,247,2181,3234,5415
00246200,EDEN THEOLOGICAL SEMINARY               ,MO,63119-0000,Private      ,0,3,3,0,118,118
00246300,EVANGEL UNIVERSITY                      ,MO,65802-2125,Private      ,19,17,36,1883,528,2411
00246400,FONTBONNE UNIVERSITY                    ,MO,63105-3098,Private      ,12,231,243,1166,2476,3642
00246600,HARRIS-STOWE STATE COLLEGE              ,MO,63103-2199,Public       ,29,68,97,1165,1673,2838
00246700,CONCEPTION SEMINARY COLLEGE             ,MO,64433-0000,Private      ,0,0,0,34,12,46
00246800,JEFFERSON COLLEGE                       ,MO,63050-2441,Public       ,45,91,136,1814,1670,3484
00247100,ST LOUIS COMMUNITY COLLEGE              ,MO,63102-0000,Public       ,257,745,1002,7630,11378,19008
00247300,KANSAS CITY ART INSTITUTE               ,MO,64111-1874,Private      ,7,2,9,883,189,1072
00247400,KANSAS CITY UNIV OF MED & BIOSCIENCES   ,MO,64106-0000,Private      ,2,3,5,20,1062,1082
00247600,KENRICK-GLENNON SEMINARY                ,MO,63119-0000,Private      ,0,0,0,6,6,12
00247700,A.T. STILL UNIV OF HEALTH SCIENCES      ,MO,63501-0000,Private      ,0,110,110,6,1877,1883
00247900,LINCOLN UNIVERSITY                      ,MO,65101-3500,Public       ,45,65,110,2156,1391,3547
00248000,LINDENWOOD UNIVERSITY                   ,MO,63301-1695,Private      ,47,401,448,4004,5223,9227
00248200,MARYVILLE UNIVERSITY                    ,MO,63141-7299,Private      ,17,62,79,2077,1753,3830
00248400,METROPOLITAN COMMUNITY COLLEGE          ,MO,64111-2408,Public       ,176,439,615,6338,9211,15549
00248500,MIDWESTERN BAPTIST THEOL SEMINARY       ,MO,64118-0000,Private      ,0,0,0,27,84,111
00248500,MIDWESTERN BAPTIST THEOL SEMINARY       ,MO,64118-4697,Private      ,2,15,17,18,105,123
00248600,MINERAL AREA COLLEGE                    ,MO,63601-1000,Public       ,59,83,142,1387,1618,3005
00248800,MISSOURI SOUTHERN STATE UNIVERSITY      ,MO,64801-1595,Public       ,37,84,121,2768,3024,5792
00248900,MISSOURI VALLEY COLLEGE                 ,MO,65340-3197,Private      ,20,10,30,1359,340,1699
00249000,MISSOURI WESTERN STATE UNIVERSITY       ,MO,64507-2294,Public       ,71,89,160,3540,2003,5543
00249100,MOBERLY AREA COMMUNITY COLLEGE          ,MO,65270-1304,Public       ,44,70,114,1825,1742,3567
00249400,NAZARENE THEOLOGICAL SEMINARY           ,MO,64131-1246,Private      ,0,5,5,0,174,174
00249500,TRUMAN STATE UNIVERSITY                 ,MO,63501-4221,Public       ,40,12,52,4725,402,5127
00249600,NORTHWEST MISSOURI STATE UNIV           ,MO,64468-6001,Public       ,46,54,100,5126,971,6097
00249800,PARK UNIVERSITY                         ,MO,64152-3795,Private      ,39,483,522,1170,7348,8518
00249900,ROCKHURST UNIVERSITY                    ,MO,64110-2561,Private      ,14,46,60,1719,1145,2864
00250000,COLLEGE OF THE OZARKS                   ,MO,65726-2502,Private      ,23,3,26,2478,253,2731
00250100,SOUTHEAST MISSOURI STATE UNIV           ,MO,63701-4799,Public       ,91,105,196,6013,3416,9429
00250200,SOUTHWEST BAPTIST UNIVERSITY            ,MO,65613-2597,Private      ,30,81,111,1857,1364,3221
00250300,MISSOURI STATE UNIVERSITY               ,MO,65897-0094,Public       ,141,185,326,11463,5845,17308
00250400,ST LOUIS COLLEGE OF PHARMACY            ,MO,63110-1088,Private      ,6,1,7,717,433,1150
00250600,SAINT LOUIS UNIVERSITY                  ,MO,63103-2097,Private      ,48,154,202,8029,5472,13501
00250602,SAINT LOUIS UNIV SCH MEDICINE           ,MO,63104-0000,Private      ,2,8,10,203,751,954
00250900,SAINT PAUL SCHOOL OF THEOLOGY           ,MO,64127-2499,Private      ,0,3,3,0,206,206
00251200,STEPHENS COLLEGE                        ,MO,65215-0001,Private      ,10,10,20,839,326,1165
00251400,NORTH CENTRAL MISSOURI COLLEGE          ,MO,64683-1824,Public       ,18,47,65,598,737,1335
00251600,UNIVERSITY OF MISSOURI-COLUMBIA         ,MO,65211-1600,Public       ,205,204,409,17408,6572,23980
00251700,MISSOURI UNIVERSITY OF SCIENCE & TECHNOL,MO,65409-0250,Public       ,37,32,69,3813,1001,4814
00251800,UNIVERSITY OF MISSOURI-KANSAS CITY      ,MO,64110-2497,Public       ,106,218,324,5517,7638,13155
00251900,UNIVERSITY OF MISSOURI-ST LOUIS         ,MO,63121-4499,Public       ,86,296,382,5018,7600,12618
00252000,WASHINGTON UNIVERSITY                   ,MO,63130-4899,Private      ,77,87,164,10593,4472,15065
00252001,WASHINGTON UNIV-SCHOOL OF MEDICINE      ,MO,63110-0000,Private      ,1,4,5,35,1113,1148
00252100,WEBSTER UNIVERSITY                      ,MO,63119-3194,Private      ,28,687,715,2832,11405,14237
00252200,WENTWORTH MILITARY ACADEMY              ,MO,64067-1799,Private      ,10,8,18,153,203,356
00252300,WESTMINSTER COLLEGE                     ,MO,65251-1299,Private      ,14,3,17,967,80,1047
00252400,WILLIAM JEWELL COLLEGE                  ,MO,64068-1896,Private      ,14,18,32,1403,277,1680
00252500,WILLIAM WOODS UNIVERSITY                ,MO,65251-2388,Private      ,13,295,308,865,2095,2960
00405704,NATIONAL AMERICAN UNIVERSITY            ,MO,64057-1791,Proprietary  ,0,12,12,28,278,306
00441300,ST JOHNS HOSP SCH RAD TECH              ,MO,65802-0000,Private      ,0,5,5,31,55,86
00470300,LOGAN COLLEGE OF CHIROPRACTIC           ,MO,63006-1065,Private      ,1,21,22,77,1168,1245
00470700,COVENANT THEOLOGICAL SEMINARY           ,MO,63141-8697,Private      ,0,6,6,5,466,471
00471100,LINN STATE TECHNICAL COLLEGE            ,MO,65051-9607,Public       ,29,2,31,898,259,1157
00471300,THREE RIVERS COMMUNITY COLLEGE          ,MO,63901-2393,Public       ,54,147,201,1454,2137,3591
00528700,BROOKFIELD AREA CAREER CENTER           ,MO,64628-0000,Public       ,0,0,0,2,1,3
00528800,KIRKSVILLE AREA TECHNICAL CENTER        ,MO,63501-0000,Public       ,0,2,2,19,59,78
00528900,WAYNESVILLE TECHNICAL ACADEMY           ,MO,65583-0000,Public       ,0,1,1,11,75,86
00542400,SOUTH CENTRAL CAREER CENTER             ,MO,65775-3334,Public       ,0,8,8,41,141,182
00542600,SIKESTON CAREER AND TECHNOLOGY CTR      ,MO,63801-0000,Public       ,1,8,9,25,133,158
00542900,ROLLA TECHNICAL INSTITUTE               ,MO,65401-3601,Public       ,5,7,12,176,236,412
00543000,POPLAR BLUFF TECHNICAL CAREER CNTR      ,MO,63901-0000,Public       ,3,9,12,36,110,146
00543600,DAVIS H HART MEXICO AREA VOC TECH       ,MO,65265-0000,Public       ,1,0,1,24,25,49
00543800,SALINE COUNTY CAREER CENTER             ,MO,65340-0000,Public       ,1,1,2,8,63,71
00544500,TRUMAN MEDICAL CENTER SCHOOL OF NURSE AN,MO,64108-2677,Private      ,2,3,5,9,51,60
00553100,GRAND RIVER TECHNICAL SCHOOL            ,MO,64601-1299,Public       ,2,0,2,62,50,112
00553200,CAPE GIRARDEAU CAREER & TECHNOLOGY CENTE,MO,63703-7511,Public       ,0,13,13,65,252,317
00638500,CHAMBERLAIN COLLEGE OF NURSING          ,MO,63139-3297,Proprietary  ,8,141,149,262,1057,1319
00638900,BARNES JEWISH COLLEGE OF NURSING AND ALL,MO,63110-1091,Private      ,7,16,23,175,688,863
00639200,RESEARCH COLLEGE OF NURSING             ,MO,64132-1199,Proprietary  ,0,0,0,62,170,232
00639201,RESEARCH MEDICAL CENTER - COLLEGE OF NUR,MO,64132-1199,Proprietary  ,0,0,0,7,11,18
00639202,RESEARCH MED CTR SCHL OF RAD TECH       ,MO,64132-0000,Proprietary  ,0,0,0,13,22,35
00639203,RESEARCH MED CTR SCH NUCL MED TECH      ,MO,64132-0000,Proprietary  ,0,0,0,0,9,9
00666600,LUTHERAN  SCHOOL OF NURSING             ,MO,63118-3909,Proprietary  ,1,3,4,51,267,318
00754000,MISSOURI BAPTIST UNIVERSITY             ,MO,63141-8698,Private      ,27,109,136,1036,1355,2391
00755700,ITT TECHNICAL INSTITUTE                 ,MO,63045-1122,Proprietary  ,200,383,583,1467,2492,3959
00808000,STATE FAIR COMMUNITY COLLEGE            ,MO,65301-0000,Public       ,41,75,116,1460,1678,3138
00826900,HILLYARD TECHNICAL CENTER               ,MO,64506-0000,Public       ,3,3,6,88,114,202
00855200,PATRICIA STEVENS COLLEGE                ,MO,63102-2334,Proprietary  ,10,23,33,82,141,223
00860600,TRI-COUNTY TECHNICAL SCHOOL             ,MO,65026-0000,Public       ,0,1,1,10,47,57
00886200,EAST CENTRAL COLLEGE                    ,MO,63084-0529,Public       ,47,86,133,1426,1316,2742
00908900,HANNIBAL-LAGRANGE COLLEGE               ,MO,63401-1999,Private      ,8,18,26,671,426,1097
00952000,NATIONAL ACADEMY OF BEAUTY ARTS         ,MO,63128-1307,Proprietary  ,21,40,61,188,265,453
00959000,INDEPENDENCE COLLEGE OF COSMETOLOGY     ,MO,64055-1105,Proprietary  ,8,9,17,65,73,138
00960700,HOUSE OF HEAVILIN BEAUTY COLLEGE        ,MO,64110-2826,Proprietary  ,0,11,11,19,68,87
00978200,SAINT LUKE'S COLLEGE                    ,MO,64114-3237,Private      ,1,4,5,69,133,202
00979500,MISSOURI COLLEGE                        ,MO,63144-2901,Proprietary  ,28,109,137,412,711,1123
01014814,COLORADO TECHNL UNIV NORTH KANSAS CITY  ,MO,64116-3614,Proprietary  ,22,106,128,241,1035,1276
01027900,HICKEY COLLEGE                          ,MO,63146-0000,Proprietary  ,27,11,38,355,160,515
01040500,PINNACLE CAREER INSTITUTE               ,MO,64131-3367,Proprietary  ,31,143,174,101,486,587
01102600,WARRENSBURG AREA VOC TECH SCH           ,MO,64093-0000,Public       ,0,0,0,33,45,78
01173500,PIKE/LINCOLN TECHNICAL CENTER           ,MO,63344-0000,Public       ,1,1,2,25,58,83
01212000,ASSEMBLIES OF GOD THEO. SEMINARY        ,MO,65802-0000,Private      ,0,5,5,11,317,328
01250000,RANKEN TECHNICAL COLLEGE                ,MO,63113-2811,Private      ,12,27,39,1006,578,1584
01258000,ST LOUIS CHRISTIAN COLLEGE              ,MO,63033-6499,Private      ,9,15,24,153,256,409
01320800,BAPTIST BIBLE COLLEGE                   ,MO,65803-3498,Private      ,6,13,19,464,298,762
02056100,FOUR RIVERS CAREER CENTER               ,MO,63090-0000,Public       ,0,1,1,23,33,56
02066900,NICHOLS CAREER CENTER                   ,MO,65101-2814,Public       ,0,0,0,75,93,168
02068200,COX HEALTH - COX COLLEGE                ,MO,65802-0000,Private      ,2,17,19,200,644,844
02068202,COX HEALTH - RADIOLOGIC TECHNOLOGY      ,MO,65802-0000,Private      ,0,2,2,36,50,86
02068204,COX HEALTH - MEDICAL TECHNOLOGY         ,MO,65807-0000,Private      ,0,2,2,9,16,25
02073600,KENNETT CAREER & TECHNOLOGY CENTER      ,MO,63857-0000,Public       ,0,1,1,6,51,57
02090400,BOONSLICK TECHNICAL EDUCATION CTR       ,MO,65233-0000,Public       ,0,1,1,12,41,53
02121100,MIDWEST INSTITUTE                       ,MO,63122-0000,Proprietary  ,13,37,50,69,269,338
02124500,FRANKLIN TECHNOLOGY CENTER              ,MO,64801-0000,Public       ,0,13,13,76,311,387
02142200,LEX LA RAY TECHNICAL CENTER             ,MO,64067-0000,Public       ,0,2,2,18,54,72
02151000,HANNIBAL CAREER AND TECHNICAL CENTE     ,MO,63401-2285,Public       ,1,0,1,19,81,100
02154900,MISSOURI SCH OF BARB & HAIR             ,MO,63031-0000,Proprietary  ,2,1,3,21,64,85
02164200,FOREST INST PROFESSIONAL PSYCHOLOGY     ,MO,65807-0000,Private      ,0,0,0,7,277,284
02165900,CHILLICOTHE BEAUTY ACADEMY              ,MO,64601-0000,Proprietary  ,0,5,5,6,25,31
02180200,METRO BUSINESS COLLEGE                  ,MO,63701-0000,Proprietary  ,17,87,104,149,585,734
02187200,NORTH CENTRAL AREA VOC TECH SCHOOL      ,MO,64424-0000,Public       ,0,0,0,2,0,2
02188000,NORTHWEST TECHNICAL SCHOOL              ,MO,64468-0000,Public       ,4,6,10,55,95,150
02188100,NORTHLAND CAREER CENTER                 ,MO,64079-8333,Public       ,0,4,4,19,48,67
02202700,OZARK CHRISTIAN COLLEGE                 ,MO,64801-0000,Private      ,9,16,25,567,217,784
02203400,NEVADA REGIONAL TECHNICAL CENTER        ,MO,64772-0000,Public       ,1,2,3,12,59,71
02205200,SANFORD-BROWN COLLEGE                   ,MO,63026-7305,Proprietary  ,81,457,538,872,3378,4250
02205203,SANFORD BROWN COLLEGE-ST. PETERS        ,MO,63301-4042,Proprietary  ,33,127,160,282,792,1074
02205205,SANFORD BROWN COLLEGE-HAZELWOOD         ,MO,63042-2708,Proprietary  ,34,111,145,230,909,1139
02214500,SALEM COLLEGE OF HAIRSTYLING            ,MO,65401-0000,Proprietary  ,2,7,9,15,45,60
02239200,ALLIED COLLEGE - NORTH                  ,MO,63043-0000,Proprietary  ,94,273,367,740,1626,2366
02242800,GIBSON TECHNICAL CENTER                 ,MO,65737-0169,Public       ,0,2,2,5,60,65
02250600,EVEREST COLLEGE                         ,MO,65807-2446,Proprietary  ,54,223,277,587,1874,2461
02263400,LAKE CAREER AND TECHNICAL CENTER        ,MO,65020-0000,Public       ,0,0,0,13,14,27
02266400,CENTRAL CHRISTIAN CLG OF THE BIBLE      ,MO,65270-0000,Private      ,6,10,16,377,179,556
02277500,HOUSE OF HEAVILIN OF BLUE SPRINGS       ,MO,64014-3953,Proprietary  ,4,19,23,52,99,151
02289200,COLUMBIA AREA CAREER CENTER             ,MO,65203-0000,Public       ,1,9,10,49,145,194
02292400,COLUMBIA BEAUTY ACADEMY                 ,MO,65203-0000,Proprietary  ,0,0,0,13,18,31
02295700,MISSOURI BEAUTY ACADEMY                 ,MO,63640-1827,Proprietary  ,3,13,16,22,51,73
02295701,"MISSOURI BEAUTY ACADEMY, LLC - CRYSTAL C",MO,63019-1724,Proprietary  ,0,0,0,18,23,41
02304000,MISSOURI TECH                           ,MO,63132-0000,Proprietary  ,7,11,18,61,92,153
02309100,AMERICAN COLLEGE OF HAIR DESIGN         ,MO,65301-2144,Proprietary  ,4,10,14,36,70,106
02311100,ABBOTT ACADEMY OF COSMETIC ARTS/SCI     ,MO,63376-0000,Proprietary  ,2,5,7,27,42,69
02313000,CASS CAREER CENTER                      ,MO,64701-0000,Public       ,0,0,0,9,26,35
02340500,ST LOUIS COLLEGE OF HEALTH CAREERS      ,MO,63110-0000,Proprietary  ,26,105,131,111,647,758
02340501,ST LOUIS COLLEGE OF HEALTH              ,MO,63129-0000,Proprietary  ,0,1,1,2,14,16
02342100,CAREER & TECHNOLOGY CTR AT FT OSAGE     ,MO,64058-0000,Public       ,0,0,0,9,11,20
02361600,CONCORDE CAREER COLLEGE                 ,MO,64111-0000,Proprietary  ,18,106,124,157,859,1016
02497500,CLINTON TECHNICAL SCHOOL                ,MO,64735-2966,Public       ,0,0,0,1,3,4
02520800,MERRELL UNIV OF BTY ARTS & SCIENCES     ,MO,65109-0000,Proprietary  ,8,17,25,99,118,217
02530600,SAINT CHARLES COMMUNITY COLLEGE         ,MO,63376-0975,Public       ,34,77,111,2468,1907,4375
02543800,PARIS II EDUCATIONAL CENTER (THE)       ,MO,64118-0000,Proprietary  ,9,19,28,37,129,166
02550400,OZARK MOUNTAIN TECHNICAL CENTER         ,MO,65711-0000,Public       ,0,0,0,3,2,5
02555300,PATSY AND ROB'S ACADEMY OF BEAUTY       ,MO,63074-0000,Proprietary  ,2,14,16,37,126,163
02564700,ELAINE STEVEN BEAUTY COLLEGE            ,MO,63136-0000,Proprietary  ,10,27,37,69,205,274
02564701,ELAINE STEVEN BEAUTY COLLEGE - ADVANCE B,MO,63383-2006,Proprietary  ,0,0,0,5,6,11
02568500,GRABBER SCHOOL OF HAIR DESIGN           ,MO,63011-0000,Proprietary  ,6,14,20,82,97,179
02599700,VATTEROTT COLLEGE                       ,MO,63134-2900,Proprietary  ,37,207,244,177,1203,1380
02599701,VATTEROTT COLLEGE - KANSAS CITY         ,MO,64129-1692,Proprietary  ,17,155,172,225,1188,1413
02599702,VATTEROTT COLLEGE - SPRINGFIELD LOCATION,MO,65807-5340,Proprietary  ,12,66,78,107,510,617
02599703,VATTEROTT COLLEGE - JOPLIN              ,MO,64801-5033,Proprietary  ,9,63,72,97,414,511
02599705,VATTEROTT COLLEGE - SUNSET HILLS        ,MO,63127-1516,Proprietary  ,37,95,132,246,628,874
02599712,VATTEROTT COLLEGE - O'FALLON            ,MO,63366-2748,Proprietary  ,11,54,65,121,396,517
02608000,NEOSHO BEAUTY COLLEGE                   ,MO,64850-1525,Proprietary  ,0,6,6,14,30,44
02608001,NEOSHO BEAUTY COLLEGE - CLASS ACT I COSM,MO,64801-2314,Proprietary  ,0,3,3,6,30,36
02609202,VATTEROTT COLLEGE-ST JOSEPH             ,MO,64501-2911,Proprietary  ,9,43,52,115,352,467
02609203,VATTEROTT COLLEGE - L'ECOLE CULINAIRE   ,MO,63124-1103,Proprietary  ,20,53,73,189,418,607
02611001,HERITAGE COLLEGE                        ,MO,64151-0000,Proprietary  ,59,146,205,224,789,1013
03011900,LAMAR AREA VOCATIONAL-TECHNICAL SCH     ,MO,64759-1285,Public       ,0,0,0,1,0,1
03032000,EXCELSIOR SPRINGS AREA CAREER CTR       ,MO,64024-0248,Public       ,0,0,0,1,2,3
03042400,LEBANON TECHNOLOGY & CAREER CENTER      ,MO,65536-3296,Public       ,1,4,5,27,72,99
03066300,BRYAN CAREER COLLEGE                    ,MO,65806-2507,Proprietary  ,11,29,40,80,240,320
03068600,NORTH COUNTY TECH SPECIAL SCH DIST      ,MO,63033-6498,Public       ,5,39,44,38,353,391
03070200,CENTRAL COLLEGE OF COSMETOLOGY          ,MO,65583-0000,Proprietary  ,3,15,18,33,72,105
03070900,SE MO HOSP CLG NURSING & HEALTH SCI     ,MO,63703-4507,Private      ,2,10,12,68,196,264
03072800,DALLAS COUNTY CAREER CENTER             ,MO,65685-9152,Public       ,0,0,0,1,4,5
03077200,COSMETOLOGY CONCEPTS INSTITUTE          ,MO,65202-1972,Proprietary  ,0,5,5,23,30,53
03083000,OZARKS TECHNICAL COMMUNITY COLLEGE      ,MO,65802-3601,Public       ,127,229,356,4679,5095,9774
03092600,MESSENGER COLLEGE                       ,MO,64804-4909,Private      ,3,1,4,57,57,114
03097600,ST LOUIS HAIR ACADEMY                   ,MO,63107-1737,Proprietary  ,1,7,8,14,57,71
03101000,NEW DIMENSION SCHOOL OF HAIR DESIGN     ,MO,64801-5017,Proprietary  ,1,4,5,21,40,61
03106000,MISSOURI STATE UNIVERSITY - WEST PLAINS ,MO,65775-2715,Public       ,32,49,81,833,790,1623
03110900,HOUSE OF HEAVILIN BEAUTY COLLEGE        ,MO,64030-1154,Proprietary  ,1,12,13,19,71,90
03166300,MOBERLY AREA TECHNICAL CENTER           ,MO,65270-1904,Public       ,0,1,1,19,12,31
03174300,HERNDON CAREER CENTER                   ,MO,64138-2695,Public       ,0,0,0,13,8,21
03519300,MISSOURI COLLEGE OF COSMETOLOGY NORTH   ,MO,65803-1235,Proprietary  ,7,35,42,97,220,317
03528300,MIDWEST UNIVERSITY                      ,MO,63385-2905,Private      ,0,3,3,1,10,11
03579300,TEXAS COUNTY TECHNICAL INSTITUTE        ,MO,65483-2700,Private      ,2,20,22,26,280,306
03616300,AVIATION INSTITUTE OF MAINTENANCE       ,MO,64129-1811,Proprietary  ,8,42,50,57,288,345
03663400,UNIVERSITY OF COSMETOLOGY               ,MO,63080-1910,Proprietary  ,2,9,11,15,40,55
03817300,ST. CHARLES SCHOOL OF MASSAGE THERAPY   ,MO,63303-5607,Proprietary  ,1,1,2,12,29,41
03878300,PROFESSIONAL MASSAGE TRAINING CENTER    ,MO,65803-2939,Proprietary  ,5,12,17,38,77,115
03916300,ECLIPS SCHOOL OF COSMETOLOGY AND BARBERI,MO,63703-5809,Proprietary  ,1,7,8,15,46,61
03924300,HAIR ACADEMY 110 (THE)                  ,MO,63501-2915,Proprietary  ,1,1,2,12,24,36
03970400,MTTI-WELLSPRING CENTER FOR NATURAL HEALT,MO,64114-3313,Proprietary  ,3,38,41,56,166,222
04048300,DIVAS UNLIMITED ACADEMY                 ,MO,63114-2625,Proprietary  ,0,5,5,0,5,5
00163201,AQUINAS INSTITUTE OF THEOLOGY - MINISTRY,OK,73123-0380,Private      ,0,0,0,1,4,5
00314600,WESTERN OKLAHOMA STATE COLLEGE          ,OK,73521-1397,Public       ,26,55,81,500,838,1338
00314700,BACONE COLLEGE                          ,OK,74403-1597,Private      ,11,36,47,688,705,1393
00314900,SOUTHERN NAZARENE UNIVERSITY            ,OK,73008-2694,Private      ,24,271,295,1164,1496,2660
00315000,CAMERON UNIVERSITY                      ,OK,73505-6377,Public       ,78,169,247,1706,3264,4970
00315100,OKLAHOMA WESLEYAN UNIVERSITY            ,OK,74006-6299,Private      ,4,110,114,563,881,1444
00315200,UNIV OF CENTRAL OKLAHOMA                ,OK,73034-5209,Public       ,124,163,287,7512,6031,13543
00315300,CONNORS STATE COLLEGE                   ,OK,74469-9700,Public       ,32,50,82,857,1211,2068
00315400,EAST CENTRAL UNIVERSITY                 ,OK,74820-6999,Public       ,43,78,121,2232,2480,4712
00315500,EASTERN OKLAHOMA STATE COLLEGE          ,OK,74578-4999,Public       ,23,68,91,930,1118,2048
00315600,REDLANDS COMMUNITY COLLEGE              ,OK,73036-5304,Public       ,25,75,100,624,1133,1757
00315700,LANGSTON UNIVERSITY                     ,OK,73050-0000,Public       ,62,79,141,2110,1922,4032
00315800,MURRAY STATE COLLEGE                    ,OK,73460-3137,Public       ,44,106,150,1020,1572,2592
00316000,NORTHEASTERN OKLAHOMA A & M COLLEGE     ,OK,74354-6497,Public       ,34,45,79,1351,920,2271
00316100,NORTHEASTERN STATE UNIVERSITY           ,OK,74464-2399,Public       ,76,153,229,4535,5649,10184
00316200,NORTHERN OKLAHOMA COLLEGE               ,OK,74653-0310,Public       ,68,82,150,1657,2091,3748
00316300,NORTHWESTERN OKLAHOMA STATE UNIV        ,OK,73717-2799,Public       ,18,31,49,923,932,1855
00316400,OKLAHOMA BAPTIST UNIVERSITY             ,OK,74801-2590,Private      ,23,12,35,1430,307,1737
00316500,OKLAHOMA CHRISTIAN UNIVERSITY           ,OK,73131-0000,Private      ,17,19,36,1970,536,2506
00316600,OKLAHOMA CITY UNIVERSITY                ,OK,73106-1493,Private      ,30,50,80,1844,2114,3958
00316700,UNIV OF SCIENCE & ARTS OF OKLAHOMA      ,OK,73018-5322,Public       ,20,21,41,886,554,1440
00316800,ROGERS STATE UNIVERSITY                 ,OK,74017-3252,Public       ,46,68,114,1725,2418,4143
00317000,OKLAHOMA STATE UNIVERSITY               ,OK,74078-1015,Public       ,229,179,408,12593,6675,19268
00317200,OKLAHOMA STATE UNIVERSITY-OKMULGEE      ,OK,74447-3901,Public       ,51,68,119,1348,1195,2543
00317400,OKLAHOMA PANHANDLE STATE UNIVERSITY     ,OK,73939-0000,Public       ,13,22,35,678,398,1076
00317600,CARL ALBERT STATE COLLEGE               ,OK,74953-5208,Public       ,23,100,123,1064,1924,2988
00317800,SEMINOLE STATE COLLEGE                  ,OK,74818-1902,Public       ,30,79,109,753,1230,1983
00317900,SOUTHEASTERN OKLAHOMA STATE UNIV        ,OK,74701-0609,Public       ,48,81,129,2205,2083,4288
00318000,SOUTHWESTERN CHRISTIAN UNIVERSITY       ,OK,73008-2335,Private      ,3,7,10,142,196,338
00318100,SOUTHWESTERN OKLAHOMA STATE UNIV        ,OK,73096-3098,Public       ,56,67,123,2653,1861,4514
00318101,SOUTHWESTERN OK STATE UNIV AT SAYRE     ,OK,73662-0000,Public       ,6,16,22,153,287,440
00318300,ST GREGORY'S UNIVERSITY                 ,OK,74804-2499,Private      ,6,51,57,321,490,811
00318308,SAINT GREGORY'S UNIVERSITY - IPD TULSA  ,OK,74135-2499,Private      ,0,14,14,16,161,177
00318400,UNIVERSITY OF OKLAHOMA                  ,OK,73019-4078,Public       ,245,266,511,12676,8386,21062
00318401,UNIVERSITY OF OKLAHOMA-HLTH SCI CTR     ,OK,73190-0000,Public       ,3,45,48,407,2920,3327
00318500,UNIVERSITY OF TULSA                     ,OK,74104-3189,Private      ,37,40,77,2531,1829,4360
00398500,ORAL ROBERTS UNIVERSITY                 ,OK,74171-0001,Private      ,37,71,108,2672,1470,4142
00531100,TULSA COUNTY AREA VOC TECH SCHOOL       ,OK,74145-0000,Public       ,6,39,45,163,654,817
00531200,RED RIVER TECHNOLOGY CENTER             ,OK,73533-2700,Public       ,2,12,14,27,151,178
00533900,METRO TECHNOLOGY CENTERS SCH DIST22     ,OK,73111-0000,Public       ,14,84,98,170,985,1155
00533903,METRO TECHNOLOGY CENTERS SCH DIST22     ,OK,73129-0000,Public       ,2,17,19,40,268,308
00694200,MID-AMERICA CHRISTIAN UNIVERSITY        ,OK,73170-4504,Private      ,8,76,84,381,745,1126
00767800,SPARTAN COLLEGE OF AERONAUTICS AND TECHN,OK,74115-5800,Proprietary  ,34,63,97,782,652,1434
00791100,VIRGILS BEAUTY COLLEGE                  ,OK,74401-6802,Proprietary  ,1,10,11,12,51,63
00834300,AUTRY TECHNOLOGY CENTER                 ,OK,73703-2598,Public       ,1,9,10,51,231,282
00861900,TRI COUNTY TECHNOLOGY CENTER            ,OK,74006-6029,Public       ,1,3,4,79,153,232
00918500,ROSE STATE COLLEGE                      ,OK,73110-2799,Public       ,75,276,351,1951,4671,6622
00920400,KIAMICHI AREA VOC TECH SCHOOL           ,OK,74578-0548,Public       ,19,77,96,235,1029,1264
00920408,KIAMICHI AREA VOC TECH SCHOOL           ,OK,74953-0000,Public       ,0,5,5,21,81,102
00961800,TULSA WELDING SCHOOL                    ,OK,74104-0000,Proprietary  ,86,248,334,550,1047,1597
00964700,"OKLAHOMA STATE UNIV, OKLA CITY          ",OK,73107-6159,Public       ,54,243,297,1510,4099,5609
00970800,EVES COLLEGE OF HAIRSTYLING             ,OK,73501-4359,Proprietary  ,3,28,31,28,90,118
00976300,TULSA COMMUNITY COLLEGE                 ,OK,74135-6198,Public       ,151,449,600,4553,8918,13471
00996300,CADDO KIOWA VOC TECH CENTER             ,OK,73038-0000,Public       ,7,53,60,78,407,485
00996400,CENTRAL OKLAHOMA AREA VOC TECH SCH      ,OK,74030-9613,Public       ,3,12,15,51,211,262
00996500,CANADIAN VALLEY TECHNOLOGY CENTER       ,OK,73036-9117,Public       ,8,42,50,75,468,543
00996800,GORDON COOPER TECHNOLOGY CENTER         ,OK,74804-9913,Public       ,14,51,65,89,422,511
01005300,INDIAN CAPITAL TECHNOLGY CENTER #4      ,OK,74403-9907,Public       ,5,31,36,131,528,659
01026600,HILLSDALE FREE WILL BAPTIST COLLEGE     ,OK,73153-0000,Private      ,2,4,6,161,82,243
01034200,SOUTHERN OKLAHOMA TECHNOLOGY CENTER     ,OK,73401-2100,Public       ,3,16,19,84,235,319
01039100,OKLAHOMA CITY COMMUNITY COLLEGE         ,OK,73159-4444,Public       ,131,357,488,3183,6032,9215
01071700,GREAT PLAINS TECHNOLOGY CENTER SCHOOL DI,OK,73505-8399,Public       ,3,14,17,92,483,575
01076200,WESTERN OK AREA VOC TECH SCH DIST12     ,OK,73624-1469,Public       ,4,7,11,51,125,176
01120600,PIONEER TECHNOLOGY CENTER               ,OK,74601-1106,Public       ,1,6,7,25,155,180
01128200,OKLAHOMA STATE UNV CLG OSTEOPTHC MD     ,OK,74107-0000,Public       ,1,9,10,36,513,549
01153700,MID-AMERICA TECHNOLOGY CENTER           ,OK,73095-0210,Public       ,1,2,3,31,77,108
01227200,MOORE-NORMAN TECHNOLOGY CENTER          ,OK,73069-8399,Public       ,0,41,41,125,575,700
02052700,NORTHEAST TECHNOLOGY CENTER             ,OK,74361-0487,Public       ,6,23,29,68,345,413
02060800,MERIDIAN TECHNOLOGY CENTER              ,OK,74074-0000,Public       ,1,17,18,106,271,377
02126500,ENID BEAUTY COLLEGE                     ,OK,73701-0000,Proprietary  ,3,5,8,20,31,51
02177900,STATE BARBER AND HAIR DESIGN CLG        ,OK,73108-0000,Proprietary  ,4,16,20,27,79,106
02184400,SAND SPRINGS BEAUTY COLLEGE             ,OK,74063-0000,Proprietary  ,4,18,22,52,161,213
02197300,HOLLYWOOD COSMETOLOGY CENTER            ,OK,73189-0000,Proprietary  ,1,3,4,14,41,55
02222700,FRANCIS TUTTLE TECHNOLOGY CENTER        ,OK,73142-0000,Public       ,12,81,93,189,1075,1264
02238500,CENTRAL STATE BEAUTY ACADEMY            ,OK,73162-6007,Proprietary  ,8,21,29,52,163,215
02250900,E OK COUNTY AREA VO-TECH                ,OK,73020-0000,Public       ,1,11,12,24,61,85
02256200,"BROKEN ARROW BEAUTY COLLEGE, INC        ",OK,74012-0000,Proprietary  ,13,20,33,68,138,206
02282100,HIGH PLAINS AREA VOC-TECH               ,OK,73801-0000,Public       ,1,6,7,13,99,112
02306800,PLATT COLLEGE                           ,OK,74145-0000,Proprietary  ,39,290,329,291,2127,2418
02510300,BEAUTY TECHNICAL COLLEGE                ,OK,74465-0000,Proprietary  ,1,8,9,17,62,79
02531200,WOODWARD BEAUTY COLLEGE                 ,OK,73801-0000,Proprietary  ,0,0,0,6,12,18
02554300,AMERICAN BEAUTY INSTITUTE               ,OK,74501-0000,Proprietary  ,4,6,10,20,58,78
02556500,YUKON BEAUTY COLLEGE                    ,OK,73099-4108,Proprietary  ,0,6,6,8,24,32
02560200,PHILLIPS THEOLOGICAL SEMINARY -         ,OK,74116-5612,Private      ,0,3,3,0,116,116
02571500,CITY COLLEGE                            ,OK,73160-0000,Proprietary  ,4,46,50,48,499,547
02581100,CLAREMORE BEAUTY COLLEGE                ,OK,74017-7034,Proprietary  ,4,5,9,13,21,34
02581200,CC'S COSMETOLOGY COLLEGE                ,OK,74129-0000,Proprietary  ,9,60,69,44,295,339
02591101,CAREER POINT INSTITUTE                  ,OK,74146-0000,Proprietary  ,0,6,6,10,71,81
02597400,PONTOTOC TECHNOLOGY CENTER SCHOOL       ,OK,74820-8621,Public       ,3,9,12,43,180,223
02599706,VATTEROTT COLLEGE - TULSA               ,OK,74146-2205,Proprietary  ,7,28,35,56,276,332
02599713,VATTEROTT COLLEGE - TULSA               ,OK,74146-4406,Proprietary  ,0,0,0,8,15,23
02600000,NORTHWEST TECHNOLOG CTR SCH DIST 10     ,OK,73717-9600,Public       ,0,2,2,17,57,74
02600500,WES WATKINS TECHNOLOGY CENTER           ,OK,74883-9660,Public       ,1,8,9,36,174,210
02609205,VATTEROTT COLLEGE - OKLAHOMA CITY       ,OK,73127-2103,Proprietary  ,8,87,95,84,681,765
03008700,SOUTHWEST TECHNOLOGY CENTER             ,OK,73521-1527,Public       ,5,14,19,36,92,128
03010300,POTEAU BEAUTY COLLEGE                   ,OK,74953-5400,Proprietary  ,3,13,16,22,92,114
03024700,STILLWATER BEAUTY ACADEMY               ,OK,74075-3467,Proprietary  ,0,9,9,23,49,72
03030700,OKLAHOMA SCHOOL OF PHOTOGRAPHY          ,OK,73160-3320,Proprietary  ,1,4,5,24,42,66
03030800,AMERICAN BROADCASTING SCHOOL            ,OK,73115-3334,Proprietary  ,10,36,46,55,260,315
03051100,CHISHOLM TRAIL TECHNOLOGY CENTER        ,OK,73764-9720,Public       ,0,7,7,11,48,59
03067300,METROPOLITAN CLG OF LEGAL STUDIES       ,OK,74145-0000,Private      ,0,0,0,5,43,48
03078500,TECH INST OF COSMETOLOGY ARTS & SCI     ,OK,74120-3610,Proprietary  ,2,8,10,2,8,10
03081300,METROPOLITAN COLLEGE                    ,OK,73118-5438,Private      ,0,0,0,5,84,89
03089400,SCHOOL OF HAIR DESIGN                   ,OK,74745-3447,Proprietary  ,6,9,15,34,114,148
03103800,SOUTHERN SCHOOL OF BEAUTY               ,OK,74701-5008,Proprietary  ,3,20,23,24,95,119
03109800,PONCA CITY BEAUTY COLLEGE               ,OK,74601-4201,Proprietary  ,1,2,3,4,17,21
03109801,BARTLESVILLE BEAUTY COLLEGE             ,OK,74003-2835,Proprietary  ,0,8,8,4,25,29
03115100,HERITAGE COLLEGE                        ,OK,73119-0000,Proprietary  ,41,208,249,262,1066,1328
03124800,PLATT COLLEGE                           ,OK,73501-3808,Proprietary  ,4,34,38,42,235,277
03126200,GREEN COUNTRY AREA VOC TECH SCHOOL      ,OK,74447-1217,Public       ,0,5,5,26,92,118
03198400,MID-DEL AREA VOCATIONAL & TECH SCH      ,OK,73110-4825,Public       ,2,8,10,18,83,101
03329400,PRYOR BEAUTY COLLEGE                    ,OK,74361-0000,Proprietary  ,5,27,32,21,112,133
03329401,PRYOR BEAUTY COLLEGE - GROVE BEAUTY COLL,OK,74345-0009,Proprietary  ,2,4,6,8,28,36
03367400,COMMUNITY CARE COLLEGE                  ,OK,74145-6420,Proprietary  ,39,152,191,200,934,1134
03396300,OKLAHOMA HEALTH ACADEMY                 ,OK,74105-6220,Proprietary  ,11,53,64,50,214,264
03396400,OKLAHOMA HEALTH ACADEMY                 ,OK,73160-3667,Proprietary  ,14,47,61,64,268,332
03453400,SHAWNEE BEAUTY COLLEGE                  ,OK,74801-7014,Proprietary  ,3,12,15,13,63,76
03676300,FAMILY OF FAITH COLLEGE                 ,OK,74802-1805,Private      ,1,6,7,11,22,33
03831300,INSTITUTE OF HAIR DESIGN                ,OK,74804-0000,Proprietary  ,3,7,10,11,45,56
03928300,CENTRAL STATE MASSAGE ACADEMY           ,OK,73162-6007,Proprietary  ,1,14,15,14,85,99
04027300,4-STATES ACADEMY OF COSMETOLOGY         ,OK,74354-0000,Proprietary  ,1,2,3,5,23,28
04060300,AMERICAN INSTITUTE OF MEDICAL TECHNOLOGY,OK,74146-5201,Proprietary  ,2,14,16,2,26,28
04062300,OKLAHOMA TECHNOLOGY INSTITUTE           ,OK,73114-6318,Proprietary  ,2,15,17,6,56,62
00163700,BETHANY THEOLOGICAL SEMINARY            ,IN,47374-0000,Private      ,0,1,1,0,29,29
00178400,ANCILLA COLLEGE-FINANCIAL AID OFFC      ,IN,46513-0001,Private      ,7,21,28,374,457,831
00178500,ANDERSON UNIVERSITY                     ,IN,46012-3495,Private      ,23,38,61,2624,930,3554
00178600,BALL STATE UNIVERSITY                   ,IN,47306-0880,Public       ,148,148,296,16844,7320,24164
00178700,BETHEL COLLEGE INC                      ,IN,46545-5591,Private      ,10,42,52,1493,1171,2664
00178800,BUTLER UNIVERSITY                       ,IN,46208-3487,Private      ,23,30,53,4877,1167,6044
00178900,CHRISTIAN THEOLOGICAL SEMINARY          ,IN,46208-0000,Private      ,0,5,5,4,203,207
00179200,DEPAUW UNIVERSITY                       ,IN,46135-0037,Private      ,16,3,19,2645,51,2696
00179300,EARLHAM COLLEGE                         ,IN,47374-4095,Private      ,13,2,15,1448,128,1576
00179301,EARLHAM SCHOOL OF RELIGION              ,IN,47374-0000,Private      ,0,1,1,16,58,74
00179500,UNIVERSITY OF EVANSVILLE                ,IN,47722-0002,Private      ,18,16,34,3514,474,3988
00179800,FRANKLIN COLLEGE OF INDIANA             ,IN,46131-2623,Private      ,6,7,13,1514,122,1636
00179900,GOSHEN COLLEGE                          ,IN,46526-4794,Private      ,3,12,15,929,283,1212
00180000,GRACE COLLEGE & THEO SEMINARY           ,IN,46590-1224,Private      ,6,3,9,1120,632,1752
00180100,HANOVER COLLEGE                         ,IN,47243-0108,Private      ,4,1,5,1402,50,1452
00180300,HUNTINGTON UNIVERSITY                   ,IN,46750-1299,Private      ,7,19,26,1117,234,1351
00180400,UNIVERSITY OF INDIANAPOLIS              ,IN,46227-3697,Private      ,40,91,131,4121,2641,6762
00180500,INDIANA INSTITUTE OF TECHNOLOGY         ,IN,46803-1297,Private      ,14,160,174,1338,2110,3448
00180700,INDIANA STATE UNIVERSITY                ,IN,47809-2501,Public       ,92,132,224,7687,5055,12742
00180800,UNIVERSITY OF SOUTHERN INDIANA          ,IN,47712-3596,Public       ,68,92,160,7710,2795,10505
00180900,INDIANA UNIVERSITY-BLOOMINGTON          ,IN,47405-1223,Public       ,203,226,429,24551,9778,34329
00181100,INDIANA UNIV-EAST                       ,IN,47374-1289,Public       ,35,83,118,1013,1689,2702
00181300,INDIANA UNIV-PURDUE UNIV INDPLS         ,IN,46202-5145,Public       ,160,529,689,12222,17847,30069
00181301,INDIANA UNIVERSITY - PURDUE UNIVERSITY I,IN,47203-1769,Public       ,17,45,62,884,1055,1939
00181400,INDIANA UNIV KOKOMO                     ,IN,46902-3557,Public       ,21,50,71,1322,1761,3083
00181500,INDIANA UNIV-NORTHWEST                  ,IN,46408-1197,Public       ,58,156,214,2191,3652,5843
00181600,INDIANA UNIVERSITY - SOUTH BEND         ,IN,46615-0000,Public       ,82,177,259,3450,4080,7530
00181700,INDIANA UNIVERSITY-SOUTHEAST            ,IN,47150-6405,Public       ,50,152,202,2623,3101,5724
00182000,MANCHESTER COLLEGE                      ,IN,46962-1276,Private      ,10,4,14,1622,116,1738
00182100,MARIAN UNIVERSITY                       ,IN,46222-1997,Private      ,20,63,83,1341,1548,2889
00182200,INDIANA WESLEYAN UNIVERSITY             ,IN,46953-4974,Private      ,43,1445,1488,3565,11510,15075
00182300,ASSOCIATED MENNONITE BIBLICAL SEM       ,IN,46517-1999,Private      ,0,1,1,3,85,88
00182400,OAKLAND CITY UNIVERSITY                 ,IN,47660-1099,Private      ,12,42,54,705,1627,2332
00182500,PURDUE UNIVERSITY                       ,IN,47907-2050,Public       ,189,146,335,27951,6463,34414
00182600,PURDUE UNIV NORTH CENTRAL CAMPUS        ,IN,46391-9528,Public       ,28,60,88,2074,2244,4318
00182700,PURDUE UNIV CALUMET                     ,IN,46323-2094,Public       ,89,163,252,4218,4612,8830
00182800,INDIANA UNIV-PURDUE UNIV FORT WAYNE     ,IN,46805-1499,Public       ,81,208,289,6573,6147,12720
00183000,ROSE HULMAN INSTITUTE OF TECHNOLOGY     ,IN,47803-3999,Private      ,11,2,13,2749,94,2843
00183200,UNIVERSITY OF SAINT FRANCIS             ,IN,46808-3994,Private      ,20,35,55,1928,1465,3393
00183300,ST JOSEPH'S COLLEGE                     ,IN,47978-0000,Private      ,6,3,9,1177,129,1306
00183400,CALUMET COLLEGE OF SAINT JOSEPH         ,IN,46394-2195,Private      ,13,61,74,404,952,1356
00183500,SAINT MARY-OF-THE-WOODS COLLEGE         ,IN,47876-0067,Private      ,3,108,111,363,1233,1596
00183600,ST MARY'S COLLEGE                       ,IN,46556-5007,Private      ,8,3,11,1589,52,1641
00183800,TAYLOR UNIVERSITY                       ,IN,46989-1001,Private      ,10,5,15,2108,80,2188
00183801,TAYLOR UNIVERSITY - FORT WAYNE          ,IN,46807-0000,Private      ,6,8,14,555,388,943
00183900,TRINE UNIVERSITY                        ,IN,46703-1764,Private      ,16,28,44,1723,575,2298
00184000,UNIVERSITY OF NOTRE DAME                ,IN,46556-5602,Private      ,64,38,102,11004,2931,13935
00184200,VALPARAISO UNIVERSITY                   ,IN,46383-6493,Private      ,13,30,43,4264,1889,6153
00184300,VINCENNES UNIVERSITY                    ,IN,47591-1523,Public       ,78,112,190,4904,2718,7622
00184302,VINCENNES UNIV - FORT HARRISON CNTR     ,IN,46256-0000,Public       ,3,7,10,79,95,174
00184400,WABASH COLLEGE                          ,IN,47933-0352,Private      ,6,0,6,1142,28,1170
00224905,DAVENPORT UNIVERSITY-MERRILLVILLE       ,IN,46410-0000,Private      ,7,50,57,163,957,1120
00420300,GOOD SAMARITAN HOSP RADIOGRAPHY PRG     ,IN,47591-0000,Public       ,1,0,1,4,13,17
00457900,INTERNATIONAL BUSINESS COLLEGE          ,IN,46804-0000,Proprietary  ,8,26,34,685,316,1001
00457901,INTERNATIONAL BUSINESS COLLEGE          ,IN,46256-0000,Proprietary  ,10,9,19,379,131,510
00458300,BROWN MACKIE COLLEGE-SOUTH BEND         ,IN,46635-1776,Proprietary  ,36,351,387,464,2794,3258
00512730,BROWN MACKIE COLLEGE-MERRILLVILLE       ,IN,46410-0000,Proprietary  ,34,268,302,284,2184,2468
00625700,SAINT ELIZABETH SCHOOL OF NURSING       ,IN,47904-2198,Private      ,0,2,2,109,189,298
00726300,HOLY CROSS COLLEGE                      ,IN,46556-0308,Private      ,8,1,9,502,71,573
00727600,SAINT MEINRAD SCHOOL OF THEOLOGY        ,IN,47577-1002,Private      ,0,4,4,5,85,90
00732700,ITT TECHNICAL INSTITUTE                 ,IN,47630-7430,Proprietary  ,339,575,914,2138,3427,5565
00732900,ITT TECHNICAL INSTITUTE                 ,IN,46268-1119,Proprietary  ,320,930,1250,2395,5721,8116
00736200,MEDTECH COLLEGE                         ,IN,46250-3970,Proprietary  ,20,126,146,74,716,790
00793800,LINCOLN COLLEGE OF TECHNOLOGY           ,IN,46202-0000,Proprietary  ,138,166,304,2086,1181,3267
00832900,ITT TECHNICAL INSTITUTE                 ,IN,46825-2393,Proprietary  ,202,352,554,1710,2402,4112
00842300,IVY TECH COMMUNITY COLLEGE OF INDIANA - ,IN,46601-3892,Public       ,66,311,377,1475,4441,5916
00854600,NOT FOR STUDENT USE                     ,IN,46208-4700,Public       ,60,184,244,1616,3443,5059
00854700,IVY TECH COMMUNITY COLLEGE OF INDIANA - ,IN,47802-4898,Public       ,54,234,288,1569,3752,5321
00951500,J MICHAEL HARROLD BEAUTY ACADEMY        ,IN,47807-3390,Proprietary  ,3,22,25,29,55,84
00961200,"APEX SCHOOL OF BEAUTY CULTURE, INC      ",IN,46016-0000,Proprietary  ,1,1,2,7,34,41
00961300,MERRILLVILLE BEAUTY COLLEGE             ,IN,46410-3401,Proprietary  ,4,28,32,32,157,189
00967300,RUDAE'S SCHOOL OF BEAUTY CULTURE        ,IN,46825-5444,Proprietary  ,10,15,25,70,140,210
00967301,RUDAE'S SCHOOL OF BEAUTY CULTURE - FORT ,IN,46825-5444,Proprietary  ,3,2,5,6,10,16
00977700,KAPLAN COLLEGE                          ,IN,46278-1736,Proprietary  ,55,156,211,357,1018,1375
00991700,IVY TECH COMMUNITY COLLEGE OF INDIANA - ,IN,46208-1763,Public       ,126,458,584,3500,8006,11506
00992300,IVY TECH COMMUNITY COLLEGE OF INDIANA - ,IN,47250-1881,Public       ,26,87,113,631,1515,2146
00992400,IVY TECH COMMUNITY COLLEGE OF INDIANA - ,IN,47302-9448,Public       ,65,261,326,2117,4890,7007
00992500,IVY TECH COMMUNITY COLLEGE OF INDIANA - ,IN,47710-3398,Public       ,51,210,261,1411,3239,4650
00992600,IVY TECH COMMUNITY COLLEGE OF INDIANA- R,IN,46805-1489,Public       ,96,351,447,2487,5867,8354
01003700,IVY TECH STATE COLLEGE - REGION 9       ,IN,47374-1220,Public       ,31,131,162,593,2151,2744
01003800,IVY TECH COMMUNITY COLLEGE OF INDIANA - ,IN,47203-1868,Public       ,24,140,164,823,2127,2950
01003900,IVY TECH COMMUNITY COLLEGE OF INDIANA - ,IN,47903-6299,Public       ,62,161,223,1919,3134,5053
01004000,IVY TECH COMMUNITY COLLEGE OF INDIANA - ,IN,46409-1303,Public       ,82,372,454,1391,4831,6222
01004100,IVY TECH STATE COLLEGE - REGION 5       ,IN,46903-1373,Public       ,25,168,193,878,2890,3768
01010900,IVY TECH COMMUNITY COLLEGE OF INDIANA - ,IN,47172-1897,Public       ,32,137,169,880,2159,3039
01015100,VINCENNES BEAUTY COLLEGE                ,IN,47591-1297,Proprietary  ,1,0,1,35,50,85
01040900,LAFAYETTE BEAUTY ACADEMY                ,IN,47901-1149,Proprietary  ,1,8,9,27,63,90
01061800,MID-AMERICA CLG FUNERAL SERVICE         ,IN,47130-9990,Private      ,6,8,14,33,83,116
01150500,CREATIVE HAIR STYLING ACADEMY           ,IN,46322-1554,Proprietary  ,5,9,14,48,71,119
02084800,RAVENSCROFT BEAUTY COLLEGE              ,IN,46815-0000,Proprietary  ,10,35,45,77,180,257
02087600,CONCORDIA THEOLOGICAL SEMINARY          ,IN,46825-0000,Private      ,0,9,9,3,310,313
02118900,EVANSVILLE TRI STATE BEAUTY COLLEGE     ,IN,47715-0000,Proprietary  ,2,9,11,47,52,99
02140800,MARTIN UNIVERSITY                       ,IN,46218-0000,Private      ,8,78,86,115,1136,1251
02158400,HARRISON COLLEGE                        ,IN,46204-2611,Proprietary  ,32,247,279,474,2058,2532
02158401,HARRISON COLLEGE - COLUMBUS             ,IN,47203-1843,Proprietary  ,9,41,50,119,488,607
02158402,HARRISON COLLEGE - LAFAYETTE            ,IN,47905-4859,Proprietary  ,12,59,71,134,462,596
02158404,HARRISON COLLEGE - MARION               ,IN,46952-0000,Proprietary  ,3,29,32,48,248,296
02158405,HARRISON COLLEGE - TERRE HAUTE          ,IN,47802-0000,Proprietary  ,8,59,67,83,459,542
02158407,HARRISON COLLEGE - ANDERSON             ,IN,46013-0000,Proprietary  ,14,38,52,127,399,526
02158409,HARRISON COLLEGE - EVANSVILLE           ,IN,47715-3901,Proprietary  ,7,55,62,100,538,638
02158410,HARRISON COLLEGE - EAST                 ,IN,46239-8903,Proprietary  ,18,82,100,186,884,1070
02158412,HARRISON COLLEGE - FORT WAYNE           ,IN,46825-0000,Proprietary  ,14,81,95,219,732,951
02158413,HARRISON COLLEGE - NORTHWEST            ,IN,46278-0000,Proprietary  ,7,42,49,80,349,429
02158800,DON ROBERTS BEAUTY SCHOOLS              ,IN,46383-0000,Proprietary  ,0,6,6,22,43,65
02164300,DON ROBERTS SCHOOL OF HAIR DESIGN       ,IN,46375-9999,Proprietary  ,5,5,10,25,57,82
02201800,KAPLAN COLLEGE                          ,IN,46410-0000,Proprietary  ,18,87,105,173,654,827
02201802,KAPLAN COLLEGE - HAMMOND                ,IN,46324-3347,Proprietary  ,26,106,132,227,1076,1303
02241700,PJ'S COLLEGE OF COSMETOLOGY             ,IN,47129-0000,Proprietary  ,4,20,24,21,122,143
02302700,J EVERETT LIGHT CAREER CENTER           ,IN,46240-0000,Public       ,0,6,6,29,209,238
02304800,PJ'S COLLEGE OF COSMETOLOGY             ,IN,47374-0000,Proprietary  ,1,3,4,20,61,81
02308900,MASTER'S OF COSMETOLOGY COLLEGE         ,IN,46809-0000,Proprietary  ,7,9,16,72,85,157
02339600,ROGER'S ACADEMY OF HAIR DESIGN          ,IN,47712-0000,Proprietary  ,8,14,22,64,106,170
02345200,EMPIRE BEAUTY SCHOOL                    ,IN,46237-0000,Proprietary  ,8,27,35,76,218,294
02347600,BALL MEMORIAL HOSPITAL SCH RAD TECH     ,IN,47303-0000,Private      ,0,0,0,29,37,66
02351300,KNOX BEAUTY COLLEGE                     ,IN,46534-0000,Proprietary  ,2,2,4,10,23,33
02490500,HAIR FASHIONS BY KAYE BEAUTY CLG        ,IN,46250-0000,Proprietary  ,0,4,4,21,60,81
02490800,HAIR FASHIONS BY KAYE BEAUTY CLG        ,IN,46060-0000,Proprietary  ,11,45,56,73,268,341
02607000,HAIR ARTS ACADEMY                       ,IN,47404-3581,Proprietary  ,0,5,5,28,48,76
02615800,COLLEGE OF COURT REPORTING              ,IN,46342-5969,Proprietary  ,1,33,34,20,299,319
02622800,INDIANA COSMETOLOGY ACADEMY             ,IN,47404-0000,Proprietary  ,0,0,0,1,0,1
03009700,HARRISON COLLEGE                        ,IN,47303-6413,Proprietary  ,18,52,70,161,512,673
03084601,THE ART INSTITUTE OF INDIANAPOLIS       ,IN,46268-1170,Proprietary  ,31,56,87,348,360,708
03100600,MARION COMM TUCKER AREA VOC SCHOOL      ,IN,46952-3831,Public       ,0,0,0,54,140,194
03176300,AMERICAN TRANS AIR AVIATION ACADEMY     ,IN,46241-1445,Proprietary  ,10,38,48,54,313,367
03262300,DAVID DEMUTH INSTITUTE OF COSM          ,IN,47374-4101,Proprietary  ,0,5,5,10,47,57
03456700,CROSSROADS BIBLE COLLEGE                ,IN,46219-4912,Private      ,2,23,25,73,267,340
03521300,IVY TECH COMMUNITY COLLEGE OF INDIANA - ,IN,47404-9772,Public       ,55,182,237,1737,3036,4773
03538300,ALEXANDRIA SCH OF SCIENTIFIC THERAP     ,IN,46001-0287,Proprietary  ,0,1,1,34,65,99
04038700,IDEAL BEAUTY ACADEMY                    ,IN,47130-4215,Proprietary  ,2,11,13,8,20,28
04100300,SUCCESS SCHOOLS                         ,IN,46410-5310,Proprietary  ,2,14,16,4,20,24
00190100,ALLEN COUNTY COMMUNITY COLLEGE          ,KS,66749-1607,Public       ,56,73,129,858,899,1757
00190200,COWLEY COUNTY COMMUNITY COLLEGE & AREA V,KS,67005-2662,Public       ,58,143,201,1548,2226,3774
00190300,BAKER UNIVERSITY                        ,KS,66006-0065,Private      ,16,360,376,1380,2574,3954
00190400,BETHANY COLLEGE                         ,KS,67456-1897,Private      ,7,4,11,871,81,952
00190500,BETHEL COLLEGE                          ,KS,67117-0531,Private      ,7,3,10,532,162,694
00190600,BUTLER COUNTY COMMUNITY COLLEGE         ,KS,67042-3280,Public       ,87,194,281,2876,3801,6677
00190700,CENTRAL BAPTIST THEOLOGY SEMINARY       ,KS,66226-3513,Private      ,0,1,1,2,39,41
00190800,CENTRAL CHRISTIAN COLLEGE OF KANSAS     ,KS,67460-5799,Private      ,4,1,5,458,90,548
00190900,CLOUD COUNTY COMMUNITY COLLEGE          ,KS,66901-1002,Public       ,28,62,90,720,755,1475
00191000,COFFEYVILLE COMMUNITY COLLEGE           ,KS,67337-5064,Public       ,37,21,58,859,325,1184
00191008,COFFEYVILLE COMM COL/AREA VOC TECH CAMP ,KS,67337-5064,Public       ,0,0,0,17,1,18
00191100,COLBY COMMUNITY COLLEGE                 ,KS,67701-4099,Public       ,20,22,42,611,386,997
00191300,DODGE CITY COMMUNITY COLLEGE            ,KS,67801-2399,Public       ,20,35,55,591,407,998
00191400,DONNELLY COLLEGE                        ,KS,66102-4298,Private      ,21,103,124,221,544,765
00191500,FORT HAYS STATE UNIVERSITY              ,KS,67601-4099,Public       ,37,127,164,3529,2733,6262
00191600,FORT SCOTT COMMUNITY COLLEGE            ,KS,66701-3199,Public       ,57,30,87,988,728,1716
00191700,BARCLAY COLLEGE                         ,KS,67059-0288,Private      ,1,1,2,85,27,112
00191800,FRIENDS UNIVERSITY                      ,KS,67213-3397,Private      ,16,178,194,1254,2641,3895
00191900,GARDEN CITY COMMUNITY COLLEGE           ,KS,67846-6398,Public       ,25,45,70,780,573,1353
00192000,HESSTON COLLEGE                         ,KS,67062-2093,Private      ,4,4,8,407,171,578
00192100,HIGHLAND COMMUNITY COLLEGE              ,KS,66035-4062,Public       ,35,27,62,958,640,1598
00192114,HIGHLAND COMMUNITY COLLEGE - NOTHEAST KA,KS,66002-1513,Public       ,4,5,9,109,128,237
00192300,HUTCHINSON COMMUNITY COLLEGE            ,KS,67501-5894,Public       ,56,118,174,1762,1694,3456
00192400,INDEPENDENCE COMMUNITY COLLEGE          ,KS,67301-0000,Public       ,41,37,78,436,275,711
00192500,KANSAS CITY KANSAS COMMUNITY CLG        ,KS,66112-9978,Public       ,76,221,297,1244,2811,4055
00192502,"KANSAS CITY KS AREA TECH SCHOOL, KS     ",KS,66104-0000,Public       ,20,39,59,137,380,517
00192600,PITTSBURG STATE UNIVERSITY              ,KS,66762-7500,Public       ,72,87,159,4015,2273,6288
00192700,EMPORIA STATE UNIVERSITY                ,KS,66801-5087,Public       ,37,83,120,3435,2345,5780
00192800,KANSAS STATE UNIVERSITY                 ,KS,66506-1104,Public       ,208,158,366,13959,5276,19235
00192900,KANSAS WESLEYAN UNIVERSITY              ,KS,67401-6196,Private      ,12,15,27,1025,406,1431
00193000,LABETTE COMMUNITY COLLEGE               ,KS,67357-4299,Public       ,16,51,67,499,654,1153
00193100,MANHATTAN CHRISTIAN COLLEGE             ,KS,66502-4081,Private      ,6,10,16,354,129,483
00193300,MCPHERSON COLLEGE                       ,KS,67460-3899,Private      ,12,5,17,720,166,886
00193600,NEOSHO COUNTY COMMUNITY COLLEGE         ,KS,66720-2699,Public       ,19,42,61,539,692,1231
00193700,OTTAWA UNIVERSITY                       ,KS,66067-3399,Private      ,25,217,242,617,2180,2797
00193800,PRATT COMMUNITY COLLEGE                 ,KS,67124-8432,Public       ,10,15,25,558,337,895
00193900,NEWMAN UNIVERSITY                       ,KS,67213-2084,Private      ,11,38,49,967,1171,2138
00194000,SOUTHWESTERN COLLEGE                    ,KS,67156-2499,Private      ,9,71,80,729,947,1676
00194300,UNIVERSITY OF ST MARY                   ,KS,66048-5023,Private      ,7,29,36,497,467,964
00194500,STERLING COLLEGE                        ,KS,67579-1533,Private      ,7,2,9,797,65,862
00194600,TABOR COLLEGE                           ,KS,67063-1799,Private      ,4,10,14,559,187,746
00194800,UNIVERSITY OF KANSAS                    ,KS,66045-7535,Public       ,184,185,369,14197,6875,21072
00194802,UNIVERSITY OF KANSAS MED CENTER         ,KS,66160-0000,Public       ,2,16,18,236,1612,1848
00194900,WASHBURN UNIVERSITY                     ,KS,66621-1110,Public       ,58,135,193,3335,4135,7470
00195000,WICHITA STATE UNIVERSITY                ,KS,67208-0001,Public       ,79,227,306,5634,6404,12038
00460800,BARTON COUNTY COMMUNITY COLLEGE         ,KS,67530-9283,Public       ,12,93,105,715,1224,1939
00526400,FLINT HILLS TECHNICAL COLLEGE           ,KS,66801-5999,Public       ,0,13,13,143,261,404
00526500,NORTH CENTRAL KANSAS TECH COLG          ,KS,67420-0000,Public       ,4,5,9,310,190,500
00526700,NORTHWEST KANSAS TECHNICAL SCHOOL       ,KS,67735-3441,Public       ,3,3,6,222,100,322
00549800,WICHITA AREA TECHNICAL COLLEGE          ,KS,67211-2099,Public       ,7,27,34,263,817,1080
00549900,SALINA AREA TECHNICAL COLLEGE           ,KS,67401-8195,Public       ,7,4,11,162,102,264
00550000,MANHATTAN AREA TECHNICAL COLLEGE        ,KS,66503-2499,Public       ,9,18,27,255,312,567
00675500,BROWN MACKIE COLLEGE (THE)              ,KS,67401-7307,Proprietary  ,21,105,126,291,1141,1432
00703200,MID AMERICA NAZARENE UNIVERSITY         ,KS,66062-1899,Private      ,6,55,61,1033,919,1952
00817200,SOUTHWEST KANSAS TECHNICAL SCHOOL       ,KS,67905-2013,Public       ,3,5,8,78,47,125
00822800,SEWARD CO COMM CO/AREA TECHNICAL SCHOOL ,KS,67905-0000,Public       ,14,25,39,382,383,765
00824400,JOHNSON COUNTY COMMUNITY COLLEGE        ,KS,66210-1299,Public       ,135,235,370,4219,5079,9298
00833200,B-STREET DESIGN SCHOOL OF INTERNATIONAL ,KS,66502-6082,Proprietary  ,4,10,14,26,68,94
00868200,ACADEMY OF HAIR DESIGN                  ,KS,67401-2803,Proprietary  ,5,10,15,46,73,119
01025600,BENEDICTINE COLLEGE                     ,KS,66002-1499,Private      ,23,7,30,1451,169,1620
01043800,HASKELL INDIAN NATIONS UNIVERSITY       ,KS,66046-4800,Public       ,29,20,49,844,597,1441
01050300,WICHITA TECHNICAL INSTITUTE             ,KS,67213-1927,Proprietary  ,40,268,308,255,1650,1905
01068900,KAW AREA TECHNICAL SCHOOL               ,KS,66604-2199,Public       ,3,6,9,162,322,484
02090700,CLEVELAND CHIROPRACTIC COLLEGE          ,KS,66210-1613,Private      ,4,16,20,56,547,603
02134800,OLD TOWN BARBER AND BEAUTY COLLEGE      ,KS,67211-0000,Proprietary  ,3,18,21,25,103,128
02196400,CAPITOL CITY HAIR DESIGN COLLEGE        ,KS,66102-0000,Proprietary  ,11,35,46,67,208,275
02204900,AMERICAN ACADEMY OF HAIR DESIGN         ,KS,66611-0000,Proprietary  ,5,12,17,46,68,114
02257700,HAYS ACADEMY OF HAIR DESIGN             ,KS,67601-0000,Proprietary  ,2,1,3,45,31,76
02303500,AMERICAN INSTITUTE OF BAKING            ,KS,66502-0000,Private      ,1,2,3,5,11,16
02340700,LABARON HAIRDRESSING ACADEMY            ,KS,66204-0000,Proprietary  ,4,13,17,25,52,77
02590900,WRIGHT CAREER COLLEGE                   ,KS,66212-0000,Private      ,49,431,480,227,1891,2118
02599709,VATTEROTT COLLEGE - WICHITA             ,KS,67226-1304,Proprietary  ,5,55,60,62,430,492
02603100,XENON INTERNATIONAL ACADEMY             ,KS,67203-5428,Proprietary  ,16,15,31,147,142,289
02606300,PAUL MITCHELL THE SCHOOL WICHITA        ,KS,67226-2803,Proprietary  ,3,10,13,29,85,114
02613000,PINNACLE CAREER INSTITUTE               ,KS,66046-2703,Proprietary  ,6,34,40,80,258,338
03031300,XENON INTERNATIONAL ACADEMY IV          ,KS,66061-3765,Proprietary  ,1,6,7,38,108,146
03066200,BRYAN COLLEGE                           ,KS,66604-2496,Proprietary  ,5,39,44,56,365,421
03450300,B-STREET DESIGN SCHOOL OF INTERNATIONAL ,KS,66611-2373,Proprietary  ,7,21,28,32,98,130
03450301,B-STREET DESIGN SCHOOL OF INTERNATIONAL ,KS,67207-5148,Proprietary  ,4,11,15,35,71,106
03450302,B-STREET DESIGN SCHOOL OF INTERNATIONAL ,KS,66212-5451,Proprietary  ,9,19,28,48,78,126
03529300,SIDNEY'S HAIRDRESSING COLLEGE           ,KS,67501-7094,Proprietary  ,2,5,7,26,45,71
03862300,BMSI INSTITUTE                          ,KS,66212-3388,Proprietary  ,0,0,0,4,15,19
00203300,UNIVERSITY OF MAINE-PRESQUE ISLE        ,ME,04769-2888,Public       ,9,17,26,737,489,1226
00203500,BANGOR THEOLOGICAL SEMINARY             ,ME,04402-0411,Private      ,0,2,2,2,89,91
00203600,BATES COLLEGE                           ,ME,04240-6028,Private      ,19,1,20,2203,32,2235
00203800,BOWDOIN COLLEGE                         ,ME,04011-8451,Private      ,14,3,17,2691,38,2729
00203900,COLBY COLLEGE                           ,ME,04901-8841,Private      ,12,0,12,2229,32,2261
00204000,UNIVERSITY OF MAINE-FARMINGTON          ,ME,04938-1990,Public       ,16,7,23,2684,451,3135
00204100,UNIVERSITY OF MAINE-FORT KENT           ,ME,04743-1292,Public       ,8,10,18,448,270,718
00204300,HUSSON UNIVERSITY                       ,ME,04401-2999,Private      ,11,44,55,1719,785,2504
00204400,MAINE MARITIME ACADEMY                  ,ME,04420-0001,Public       ,5,4,9,863,126,989
00205000,UNIVERSITY OF NEW ENGLAND               ,ME,04005-9599,Private      ,19,41,60,2668,1806,4474
00205100,SAINT JOSEPH'S COLLEGE                  ,ME,04084-5263,Private      ,9,32,41,1360,565,1925
00205200,THOMAS COLLEGE                          ,ME,04901-5097,Private      ,6,5,11,779,165,944
00205300,UNIVERSITY OF MAINE                     ,ME,04469-0001,Public       ,81,72,153,9238,2905,12143
00205400,UNIVERSITY OF SOUTHERN MAINE            ,ME,04104-0000,Public       ,68,103,171,5548,4400,9948
00205500,UNIVERSITY OF MAINE-MACHIAS             ,ME,04654-1397,Public       ,7,14,21,493,253,746
00520400,BEAL COLLEGE                            ,ME,04401-6896,Proprietary  ,17,59,76,202,543,745
00527600,CENTRAL MAINE COMMUNITY COLLEGE         ,ME,04210-6498,Public       ,34,26,60,970,938,1908
00527700,EASTERN MAINE COMMUNITY COLLEGE         ,ME,04401-4280,Public       ,32,43,75,1157,937,2094
00552500,SOUTHERN MAINE COMMUNITY  COLLEGE       ,ME,04106-1698,Public       ,65,67,132,2194,1967,4161
00576000,NORTHERN MAINE COMMUNITY COLLEGE        ,ME,04769-2016,Public       ,12,30,42,474,503,977
00577600,MERCY HOSP SCH OF RADIOLOGIC TECH       ,ME,04101-3795,Private      ,0,0,0,10,20,30
00630501,CENTRAL MAINE MEDICAL CENTER - COLLEGE O,ME,04240-4500,Private      ,1,4,5,35,150,185
00676000,UNIVERSITY OF MAINE-AUGUSTA             ,ME,04330-9410,Public       ,31,100,131,1520,4406,5926
00685800,UNITY COLLEGE                           ,ME,04988-9502,Private      ,11,1,12,629,95,724
00903800,MR BERNARD'S SCH HAIR FASHION INC       ,ME,04243-1163,Proprietary  ,3,7,10,35,76,111
00923100,WASHINGTON COUNTY COMMUNITY COLLEGE     ,ME,04619-9704,Public       ,8,16,24,229,223,452
00929200,ANDOVER COLLEGE                         ,ME,04106-2415,Proprietary  ,17,80,97,179,666,845
00929201,ANDOVER COLLEGE -                       ,ME,04240-0000,Proprietary  ,25,130,155,176,784,960
00945900,EMPIRE BEAUTY SCHOOL                    ,ME,04101-3348,Proprietary  ,16,48,64,242,441,683
00982600,KENNEBEC VALLEY  COMMUNITY  COLLEGE     ,ME,04937-1367,Public       ,11,42,53,533,1191,1724
01138500,COLLEGE OF THE ATLANTIC                 ,ME,04609-1105,Private      ,5,0,5,376,61,437
01167300,MAINE COLLEGE OF ART                    ,ME,04101-3987,Private      ,5,5,10,609,199,808
02104400,SPA TECH INSTITUTE                      ,ME,04102-0000,Proprietary  ,18,50,68,145,333,478
02347100,NEW ENGLAND SCHOOL OF COMMUNICATIONS    ,ME,04401-0000,Private      ,4,1,5,382,78,460
02361300,LANDING SCHOOL OF BOATBUILDING & DESIGN ,ME,04046-1490,Private      ,1,0,1,20,40,60
03122900,YORK COUNTY COMMUNITY COLLEGE           ,ME,04090-0529,Public       ,11,19,30,317,342,659
03429300,SEACOAST CAREER SCHOOLS                 ,ME,04073-0000,Proprietary  ,19,136,155,139,674,813
03612300,BIRTHWISE MIDWIFERY SCHOOL              ,ME,04009-1110,Proprietary  ,0,0,0,10,31,41
03990300,FULLER CIRCLES SCHOOL FOR MASSAGE THERAP,ME,04963-5230,Proprietary  ,0,0,0,4,12,16
00209300,ST JOHN'S COLLEGE                       ,NM,87505-4599,Private      ,6,18,24,517,217,734
00264900,COLLEGE OF SANTA FE                     ,NM,87505-7634,Private      ,11,58,69,690,813,1503
00265000,UNIVERSITY OF THE SOUTHWEST             ,NM,88240-9129,Private      ,9,17,26,360,365,725
00265100,EASTERN NEW MEXICO UNIV PORTALES        ,NM,88130-6000,Public       ,50,97,147,2395,2031,4426
00265101,EASTERN NEW MEXICO UNIV-ROSWELL CAM     ,NM,88202-0000,Public       ,42,71,113,900,1366,2266
00265300,NEW MEXICO HIGHLANDS UNIVERSITY         ,NM,87701-4436,Public       ,26,65,91,1299,1892,3191
00265400,NEW MEXICO INST OF MINING & TECH        ,NM,87801-4796,Public       ,19,12,31,1007,290,1297
00265500,NEW MEXICO JUNIOR COLLEGE               ,NM,88240-9123,Public       ,36,34,70,720,827,1547
00265600,NEW MEXICO MILITARY INSTITUTE           ,NM,88201-5173,Public       ,8,2,10,304,11,315
00265700,NEW MEXICO STATE UNIVERSITY             ,NM,88003-8001,Public       ,217,248,465,8939,6702,15641
00265701,NEW MEXICO STATE UNIV-ALAMOGORDO        ,NM,88311-0000,Public       ,19,51,70,369,890,1259
00265702,NEW MEXICO STATE UNIV.-DONA ANA CLG     ,NM,88003-0000,Public       ,77,107,184,1555,2418,3973
00265703,NEW MEXICO STATE UNIV-CARLSBAD          ,NM,88220-0000,Public       ,13,33,46,297,653,950
00265704,NEW MEXICO STATE UNIV-GRANTS            ,NM,87020-0000,Public       ,8,27,35,135,355,490
00266000,SAN JUAN COLLEGE                        ,NM,87402-4699,Public       ,57,114,171,1237,2352,3589
00266300,THE UNIVERSITY OF NEW MEXICO            ,NM,87131-0001,Public       ,332,401,733,10685,11977,22662
00266301,UNIV OF NEW MEXICO - GALLUP BRANCH      ,NM,87301-5697,Public       ,27,69,96,731,1428,2159
00266302,UNIV OF NEW MEXICO - VALENCIA BRANCH    ,NM,87031-0000,Public       ,16,48,64,442,814,1256
00266303,UNIV OF NEW MEXICO - LOS ALAMOS         ,NM,87544-0000,Public       ,2,4,6,134,149,283
00266400,WESTERN NEW MEXICO UNIVERSITY           ,NM,88061-5417,Public       ,37,70,107,858,1415,2273
00405701,NATIONAL AMERICAN UNIVERSITY            ,NM,87110-0000,Proprietary  ,3,29,32,31,341,372
00474200,CENTRAL NEW MEXICO COMMUNITY COLLEGE    ,NM,87106-4096,Public       ,213,622,835,4714,10305,15019
00474300,CLOVIS COMMUNITY COLLEGE                ,NM,88101-8381,Public       ,34,139,173,537,1485,2022
00996200,LUNA COMMUNITY COLLEGE                  ,NM,87701-0000,Public       ,17,43,60,289,515,804
01063200,DEWOLFF CLG HAIRSTYLING/COSMETOLOGY     ,NM,87112-4113,Proprietary  ,6,23,29,46,150,196
01300500,OLYMPIAN UNIVERSITY OF COSMETOLOGY      ,NM,88310-5051,Proprietary  ,26,146,172,313,892,1205
02083900,NORTHERN NEW MEXICO COLLEGE             ,NM,87530-0000,Public       ,31,87,118,496,967,1463
02146400,INSTITUTE OF AMERICAN INDIAN ARTS       ,NM,87508-0000,Public       ,4,8,12,162,168,330
02278100,SANTA FE COMMUNITY COLLEGE              ,NM,87507-0000,Public       ,22,80,102,636,1169,1805
02357600,CROWNPOINT INSTITUTE OF TECHNOLOGY      ,NM,87313-0000,Public       ,12,42,54,213,396,609
02491501,THE ART CENTER DESIGN COLLEGE- ALBQ     ,NM,87110-0000,Proprietary  ,5,5,10,80,75,155
02496900,ALBUQUERQUE BARBER COLLEGE              ,NM,87108-1859,Proprietary  ,0,0,0,5,8,13
02511000,SOUTHWESTERN INDIAN POLYTECH INST       ,NM,87184-0000,Public       ,19,25,44,299,366,665
02532900,BUSINESS SKILLS INSTITUTE               ,NM,88001-0000,Proprietary  ,4,12,16,28,152,180
02622000,SOUTHWEST ACUPUNCTURE COLLEGE           ,NM,87505-0000,Proprietary  ,0,3,3,2,315,317
03076100,SOUTHWESTERN COLLEGE                    ,NM,87507-0000,Private      ,0,4,4,4,161,165
03099300,METROPOLITAIN CLG COURT REPORTING       ,NM,87110-4129,Private      ,0,0,0,8,54,62
03128200,KAPLAN CAREER INSTITUTE                 ,NM,87109-2072,Proprietary  ,18,49,67,81,352,433
03206300,MESALANDS COMMUNITY COLLEGE             ,NM,88401-3352,Public       ,7,24,31,116,249,365
03430300,UNIVERSAL THERAPEUTIC MASSAGE INSTITUTE ,NM,87107-4403,Proprietary  ,1,22,23,37,101,138
03678300,PIMA MEDICAL INSTITUTE                  ,NM,87110-4127,Proprietary  ,3,7,10,19,52,71
03944300,MASSAGE THERAPY TRAINING INSTITUTE      ,NM,88007-0000,Proprietary  ,0,10,10,21,69,90
00223400,ADRIAN COLLEGE                          ,MI,49221-2575,Private      ,22,3,25,1791,182,1973
00223500,ALBION COLLEGE                          ,MI,49224-1831,Private      ,20,1,21,2314,108,2422
00223600,ALMA COLLEGE                            ,MI,48801-1599,Private      ,16,2,18,1805,90,1895
00223700,ALPENA COMMUNITY COLLEGE                ,MI,49707-1495,Public       ,31,57,88,860,915,1775
00223800,ANDREWS UNIVERSITY                      ,MI,49104-0750,Private      ,18,38,56,1409,1192,2601
00223900,AQUINAS COLLEGE                         ,MI,49506-1799,Private      ,12,38,50,1896,735,2631
00224000,BAY DE NOC COMMUNITY COLLEGE            ,MI,49829-2524,Public       ,31,50,81,1014,1138,2152
00224100,CALVIN COLLEGE                          ,MI,49546-4388,Private      ,25,9,34,3863,303,4166
00224200,CALVIN THEOLOGICAL SEMINARY             ,MI,49546-4387,Private      ,1,1,2,9,163,172
00224300,CENTRAL MICHIGAN UNIVERSITY             ,MI,48859-0001,Public       ,198,502,700,17753,8513,26266
00224600,CLEARY UNIVERSITY                       ,MI,48105-2659,Private      ,10,62,72,140,624,764
00224700,CONCORDIA UNIVERSITY-ANN ARBOR          ,MI,48105-2797,Private      ,5,96,101,645,469,1114
00224800,CRANBROOK ACADEMY OF ART                ,MI,48303-0000,Private      ,0,1,1,11,238,249
00224900,DAVENPORT UNIVERSITY                    ,MI,49503-0000,Private      ,126,896,1022,2922,14040,16962
00225100,DELTA COLLEGE                           ,MI,48710-0001,Public       ,128,382,510,4632,5611,10243
00225400,MICHIGAN STATE UNIVERSITY COLLEGE OF LAW,MI,48824-1300,Private      ,9,17,26,310,1664,1974
00225900,EASTERN MICHIGAN UNIVERSITY             ,MI,48197-2214,Public       ,251,411,662,13012,10045,23057
00226000,FERRIS STATE UNIVERSITY                 ,MI,49307-2251,Public       ,121,110,231,10519,4984,15503
00226100,CHARLES STEWART MOTT COMMUNITY CLG      ,MI,48503-2089,Public       ,172,582,754,3802,7199,11001
00226200,KETTERING UNIVERSITY                    ,MI,48504-4898,Private      ,36,17,53,2352,303,2655
00226300,GLEN OAKS COMMUNITY COLLEGE             ,MI,49032-9784,Public       ,16,52,68,404,764,1168
00226400,GOGEBIC COMMUNITY COLLEGE               ,MI,49938-1365,Public       ,16,26,42,462,448,910
00226500,GRACE BIBLE COLLEGE                     ,MI,49509-1998,Private      ,2,3,5,223,51,274
00226600,CORNERSTONE UNIVERSITY                  ,MI,49525-5897,Private      ,11,111,122,1679,1489,3168
00226700,GRAND RAPIDS COMMUNITY COLLEGE          ,MI,49503-3295,Public       ,156,430,586,7229,7139,14368
00226800,GRAND VALLEY STATE UNIVERSITY           ,MI,49401-9403,Public       ,175,220,395,18481,6891,25372
00226900,GREAT LAKES CHRISTIAN COLLEGE           ,MI,48917-1299,Private      ,3,7,10,176,131,307
00227000,HENRY FORD COMMUNITY COLLEGE            ,MI,48128-1495,Public       ,201,401,602,6069,8837,14906
00227300,HOPE COLLEGE                            ,MI,49423-3607,Private      ,17,3,20,3611,151,3762
00227400,JACKSON COMMUNITY COLLEGE               ,MI,49201-8399,Public       ,68,263,331,2266,3850,6116
00227500,KALAMAZOO COLLEGE                       ,MI,49006-3295,Private      ,2,4,6,1494,68,1562
00227600,KELLOGG COMMUNITY COLLEGE               ,MI,49017-3397,Public       ,52,204,256,1751,3459,5210
00227700,LAKE MICHIGAN COLLEGE                   ,MI,49022-1899,Public       ,42,130,172,1265,1997,3262
00227800,LANSING COMMUNITY COLLEGE               ,MI,48933-1293,Public       ,233,504,737,6208,8932,15140
00227900,LAWRENCE TECHNOLOGICAL UNIVERSITY       ,MI,48075-1058,Private      ,39,67,106,1808,1335,3143
00228200,MADONNA UNIVERSITY                      ,MI,48150-1173,Private      ,27,92,119,1207,2457,3664
00228400,MARYGROVE COLLEGE                       ,MI,48221-2599,Private      ,24,163,187,559,2955,3514
00228800,ROCHESTER COLLEGE                       ,MI,48307-2764,Private      ,7,28,35,596,652,1248
00229000,MICHIGAN STATE UNIVERSITY               ,MI,48824-1113,Public       ,371,321,692,30352,10178,40530
00229200,MICHIGAN TECHNOLOGICAL UNIV             ,MI,49931-1295,Public       ,57,20,77,5138,852,5990
00229300,LAKE SUPERIOR STATE UNIVERSITY          ,MI,49783-1691,Public       ,23,39,62,2119,910,3029
00229400,MONROE COUNTY COMMUNITY CLG             ,MI,48161-9746,Public       ,32,99,131,1072,1390,2462
00229500,MONTCALM COMMUNITY COLLEGE              ,MI,48885-9723,Public       ,19,161,180,760,2099,2859
00229700,MUSKEGON COMMUNITY COLLEGE              ,MI,49442-1432,Public       ,59,176,235,2158,2451,4609
00229900,NORTH CENTRAL MICHIGAN COLLEGE          ,MI,49770-8740,Public       ,28,48,76,776,1251,2027
00230100,NORTHERN MICHIGAN UNIVERSITY            ,MI,49855-5316,Public       ,85,84,169,7009,2688,9697
00230200,NORTHWESTERN MICHIGAN COLLEGE           ,MI,49686-3061,Public       ,50,110,160,2136,2207,4343
00230300,OAKLAND COMMUNITY COLLEGE               ,MI,48304-2266,Public       ,7,23,30,231,342,573
00230301,OAKLAND COMMUNITY COLLEGE - ORCHARD RIDG,MI,48334-4579,Public       ,63,107,170,1316,1928,3244
00230302,OAKLAND COMMUNITY COLLEGE - ROYAL OAK CA,MI,48067-3898,Public       ,88,239,327,1986,4117,6103
00230304,OAKLAND COMMUNITY COLLEGE - AUBURN HILLS,MI,48323-2845,Public       ,58,174,232,1774,2680,4454
00230305,OAKLAND COMMUNITY COLLEGE - HIGHLAND LAK,MI,48327-4187,Public       ,33,88,121,936,1650,2586
00230700,OAKLAND UNIVERSITY                      ,MI,48309-4401,Public       ,181,239,420,8871,6115,14986
00230800,OLIVET COLLEGE                          ,MI,49076-9902,Private      ,7,10,17,1226,284,1510
00231000,ST. CLAIR COUNTY COMMUNITY COLLEGE      ,MI,48061-0000,Public       ,42,122,164,1530,2123,3653
00231100,KUYPER COLLEGE                          ,MI,49525-9749,Private      ,1,2,3,208,101,309
00231300,SACRED HEART MAJOR SEMINARY             ,MI,48206-1799,Private      ,2,5,7,24,164,188
00231400,SAGINAW VALLEY STATE UNIV               ,MI,48710-0001,Public       ,74,147,221,6389,3447,9836
00231500,SCHOOLCRAFT COLLEGE                     ,MI,48152-2696,Public       ,136,273,409,3284,4857,8141
00231600,SIENA HEIGHTS UNIVERSITY                ,MI,49221-1796,Private      ,11,69,80,1069,1282,2351
00231700,SOUTHWESTERN MICHIGAN COLLEGE           ,MI,49047-9793,Public       ,32,136,168,841,1457,2298
00231800,SPRING ARBOR UNIVERSITY                 ,MI,49283-9984,Private      ,21,291,312,1931,3277,5208
00232200,FINLANDIA UNIVERSITY                    ,MI,49930-1882,Private      ,6,9,15,558,309,867
00232300,UNIVERSITY OF DETROIT MERCY             ,MI,48221-3038,Private      ,51,139,190,2711,3465,6176
00232301,UNIVERSITY OF DETROIT MERCY- DENTAL SCH ,MI,48219-3580,Private      ,1,4,5,91,498,589
00232303,UNIV OF DETROIT MERCY - LAW SCHOOL      ,MI,48226-0000,Private      ,1,17,18,21,995,1016
00232500,UNIVERSITY OF MICHIGAN - ANN ARBOR      ,MI,48109-1316,Public       ,242,218,460,22654,9531,32185
00232501,UNIVERSITY OF MICHIGAN-MEDICAL SCH      ,MI,48109-0000,Public       ,1,1,2,91,1013,1104
00232503,UNIVERSITY OF MICHIGAN LAW SCHOOL       ,MI,48109-0000,Public       ,3,12,15,31,2473,2504
00232600,UNIVERSITY OF MICHIGAN-DEARBORN         ,MI,48128-2406,Public       ,87,137,224,3892,3702,7594
00232700,UNIVERSITY OF MICHIGAN-FLINT            ,MI,48502-1950,Public       ,68,183,251,2699,4287,6986
00232800,WASHTENAW COMMUNITY COLLEGE             ,MI,48106-0000,Public       ,132,375,507,3022,5868,8890
00232900,WAYNE STATE UNIVERSITY                  ,MI,48202-0000,Public       ,366,758,1124,13791,17364,31155
00232901,WAYNE STATE UNIV SCH OF MEDICINE        ,MI,48201-3359,Public       ,7,7,14,186,1456,1642
00232902,WAYNE STATE UNIVERSITY - LAW SCHOOL     ,MI,48202-3424,Public       ,4,18,22,86,1187,1273
00233000,WESTERN MICHIGAN UNIVERSITY             ,MI,49008-3899,Public       ,231,201,432,16526,7051,23577
00233100,WESTERN THEOLOGICAL SEMINARY            ,MI,49423-0000,Private      ,0,2,2,2,112,114
00407100,WALSH COLLEGE OF ACCT & BUS ADMN        ,MI,48007-7006,Private      ,10,142,152,207,1864,2071
00407200,NORTHWOOD UNIVERSITY                    ,MI,48640-2398,Private      ,24,81,105,2203,1507,3710
00467300,BAKER COLLEGE - FLINT                   ,MI,48507-5508,Private      ,140,600,740,2233,6126,8359
00467301,BAKER COLLEGE OF CADILLAC               ,MI,49601-0000,Private      ,45,183,228,507,1698,2205
00467302,BAKER COLLEGE OF CLINTON TOWNSHIP       ,MI,48035-0000,Private      ,124,450,574,2286,4968,7254
00467303,BAKER COLLEGE OF MUSKEGON               ,MI,49442-0000,Private      ,109,429,538,2490,4237,6727
00467304,BAKER COLLEGE OF OWOSSO                 ,MI,48867-0000,Private      ,61,181,242,1496,2035,3531
00467305,BAKER COLLEGE OF AUBURN HILLS           ,MI,48326-0000,Private      ,97,295,392,1265,3314,4579
00467306,BAKER COLLEGE OF PORT HURON             ,MI,48060-0000,Private      ,35,137,172,614,1445,2059
00467309,BAKER COLLEGE OF JACKSON                ,MI,49202-0000,Private      ,33,129,162,639,1769,2408
00467311,BAKER COLLEGE-CASS CITY                 ,MI,48726-0000,Private      ,15,60,75,177,500,677
00467313,BAKER COLLEGE - GRADUATE ON-LINE        ,MI,48507-0000,Private      ,17,315,332,216,4318,4534
00467317,BAKER COLLEGE-ALLEN PARK                ,MI,48101-0000,Private      ,61,152,213,763,1735,2498
00469200,DORSEY SCHOOL OF BUSINESS               ,MI,48195-2334,Proprietary  ,8,54,62,60,306,366
00469201,DORSEY SCHOOL OF BUSINESS               ,MI,48184-0000,Proprietary  ,10,58,68,52,335,387
00469202,DORSEY SCHOOL OF BUSINESS               ,MI,48071-0000,Proprietary  ,8,48,56,47,291,338
00469204,DORSEY SCHOOL OF BUSINESS               ,MI,48066-0000,Proprietary  ,15,66,81,105,559,664
00676800,MID MICHIGAN COMMUNITY COLLEGE          ,MI,48625-9447,Public       ,57,94,151,1772,2166,3938
00677100,COLLEGE FOR CREATIVE STUDIES            ,MI,48202-4034,Private      ,20,13,33,1316,513,1829
00694900,KALAMAZOO VALLEY COMMUNITY COLLEGE      ,MI,49003-4070,Public       ,118,265,383,3808,4573,8381
00717100,KIRTLAND COMMUNITY COLLEGE              ,MI,48653-0000,Public       ,39,97,136,767,1279,2046
00761700,CARNEGIE INSTITUTE                      ,MI,48083-1159,Proprietary  ,8,58,66,76,525,601
00795000,WEST SHORE COMMUNITY COLLEGE            ,MI,49454-0000,Public       ,18,26,44,495,770,1265
00817800,EMPIRE BEAUTY SCHOOL                    ,MI,49525-2440,Proprietary  ,23,40,63,301,321,622
00890600,MACOMB COMMUNITY COLLEGE                ,MI,48088-3896,Public       ,234,508,742,5857,6962,12819
00894600,PORT HURON COSMETOLOGY COLLEGE          ,MI,48329-1618,Proprietary  ,4,20,24,44,81,125
00923000,WAYNE COUNTY COMMUNITY CLG-DISTRICT     ,MI,48226-3095,Public       ,333,1013,1346,5412,15084,20496
00973200,VIRGINIA FARRELL BEAUTY SCHOOL          ,MI,48080-1448,Proprietary  ,5,17,22,35,96,131
00973400,VIRGINIA FARRELL BEAUTY SCHOOL          ,MI,48220-1739,Proprietary  ,8,39,47,106,304,410
00982800,EVEREST INSTITUTE                       ,MI,48033-4400,Proprietary  ,215,915,1130,1356,5144,6500
01047000,KALAMAZOO BEAUTY ACADEMY                ,MI,49002-5220,Proprietary  ,3,8,11,22,37,59
01062700,ITT TECHNICAL INSTITUTE                 ,MI,49519-0000,Proprietary  ,153,336,489,1429,2501,3930
01082700,DAVID PRESSLEY PROF SCH OF COSMTLGY     ,MI,48067-3219,Proprietary  ,20,16,36,122,107,229
01109800,FLINT INSTITUTE OF BARBERING            ,MI,48504-4395,Proprietary  ,3,13,16,32,98,130
01164600,VIRGINIA FARRELL BEAUTY SCHOOL          ,MI,48185-3091,Proprietary  ,6,21,27,54,169,223
01229100,WRIGHT BEAUTY ACADEMY                   ,MI,49015-2696,Proprietary  ,7,24,31,26,91,117
01239900,LEWIS COLLEGE OF BUSINESS               ,MI,48235-0000,Private      ,10,32,42,220,469,689
01262700,THOMAS M. COOLEY LAW SCHOOL             ,MI,48901-1586,Private      ,2,150,152,18,4810,4828
01321800,M J MURPHY BTY CLG MT PLEASANT          ,MI,48858-2502,Proprietary  ,3,10,13,45,82,127
02060300,MICHIGAN INSTITUTE OF AERONAUTICS       ,MI,48111-0000,Proprietary  ,16,38,54,259,385,644
02068700,ADRIAN BEAUTY ACADEMY                   ,MI,49221-0000,Proprietary  ,2,5,7,19,32,51
02099700,ROSS MEDICAL EDUCATION CENTER           ,MI,48532-0000,Proprietary  ,15,139,154,123,858,981
02100400,EVEREST INSTITUTE                       ,MI,49525-2301,Proprietary  ,110,659,769,620,2983,3603
02125600,MICHIGAN COLLEGE OF BEAUTY              ,MI,48083-0000,Proprietary  ,16,52,68,204,313,517
02135000,MARQUETTE GEN HOSP SCH RAD TECH         ,MI,49855-0000,Private      ,0,0,0,14,11,25
02158600,MR BELA'S SCHOOL OF COSMETOLOGY         ,MI,48092-4637,Proprietary  ,6,16,22,29,72,101
02160303,INTERNATIONAL ACADEMY OF DESIGN AND TECH,MI,48083-2160,Proprietary  ,62,90,152,693,793,1486
02180100,ROSS MEDICAL EDUCATION CENTER           ,MI,48092-0000,Proprietary  ,12,62,74,76,370,446
02198900,MICHIGAN SCHOOL OF PROFESSIONAL PSYCHOLO,MI,48334-4512,Private      ,0,1,1,4,92,96
02209200,TAYLORTOWN SCHOOL OF BEAUTY             ,MI,48180-0000,Proprietary  ,4,11,15,35,126,161
02237800,SPECS HOWARD SCHOOL OF MEDIA ARTS       ,MI,48075-0000,Proprietary  ,47,68,115,521,505,1026
02285700,BAYSHIRE BEAUTY ACADEMY                 ,MI,48708-5614,Proprietary  ,4,12,16,30,72,102
02289801,KAPLAN INSTITUTE - DETROIT CAMPUS       ,MI,48202-0000,Proprietary  ,35,171,206,119,694,813
02324500,MICHIGAN COLLEGE OF BEAUTY              ,MI,48161-0000,Proprietary  ,2,21,23,39,85,124
02339700,ROSS MEDICAL EDUCATION CENTER           ,MI,48116-0000,Proprietary  ,11,78,89,75,404,479
02361500,MICHIGAN BARBER COLLEGE                 ,MI,48204-2244,Private      ,8,37,45,93,234,327
02363800,YESHIVA GEDOLAH OF GREATER DETROIT      ,MI,48237-0000,Private      ,2,0,2,4,2,6
02491000,WEST MI COLG OF BARBERING & BEAUTY      ,MI,49008-0000,Proprietary  ,2,12,14,22,91,113
02495800,FOCUS:HOPE                              ,MI,48238-0000,Private      ,11,29,40,101,216,317
02498300,VIRGINIA FARRELL BEAUTY SCHOOL          ,MI,48154-0000,Proprietary  ,10,11,21,63,182,245
02533600,ROSS MEDICAL EDUCATION CENTER           ,MI,48917-2108,Proprietary  ,14,97,111,111,483,594
02588200,DOUGLAS J AVEDA INSTITUTE               ,MI,48823-4351,Proprietary  ,16,24,40,246,203,449
02588201,DOUGLAS J AVEDA INSTITUTE - ANN ARBOR   ,MI,48104-2211,Proprietary  ,3,2,5,59,72,131
02594600,HOWELL COLLEGE OF COSMETOLOGY           ,MI,48843-8584,Proprietary  ,0,0,0,6,22,28
02595700,HILLSDALE BEAUTY COLLEGE                ,MI,49242-0000,Proprietary  ,4,5,9,49,34,83
02618400,MICHIGAN CAREER & TECHNICAL INST        ,MI,49080-9254,Public       ,28,14,42,221,132,353
03005700,DETROIT BUSINESS INST. DOWNRIVER        ,MI,48193-6761,Proprietary  ,11,56,67,64,341,405
03025100,MR DAVID'S SCHOOL OF COSMETOLOGY        ,MI,48507-2054,Proprietary  ,0,0,0,14,43,57
03028500,LAWTON SCHOOL                           ,MI,48075-5406,Proprietary  ,6,39,45,42,193,235
03066600,BAY MILLS COMMUNITY COLLEGE             ,MI,49715-9750,Public       ,8,42,50,83,309,392
03075200,TWIN CITY BEAUTY COLLEGE                ,MI,49085-3305,Proprietary  ,9,41,50,81,190,271
03075201,TWIN CITY BEAUTY COLLEGE - TRAVERSE CITY,MI,49686-5119,Proprietary  ,0,2,2,6,15,21
03090000,SHARP'S ACADEMY OF HAIRSTYLING INC.     ,MI,48433-0000,Proprietary  ,3,8,11,15,54,69
03109700,HOUGHTON LAKE INST OF COSMETOLOGY       ,MI,48629-0669,Proprietary  ,0,3,3,10,18,28
03110300,THE SCHOOL OF CREATIVE HAIR DESIGN      ,MI,49036-1139,Proprietary  ,1,10,11,24,51,75
03124000,NORTHWESTERN TECHNOLOGICAL INST         ,MI,48075-2412,Proprietary  ,23,125,148,135,530,665
03135300,MICHIGAN THEOLOGICAL SEMINARY           ,MI,48170-4399,Private      ,1,5,6,6,107,113
03284300,MICHIGAN JEWISH INSTITUTE               ,MI,48237-0000,Private      ,32,2,34,233,35,268
03340300,WARREN WOODS VOCATIONAL ADULT EDUC      ,MI,48088-3699,Public       ,1,8,9,16,52,68
03474300,AVE MARIA COLLEGE                       ,MI,48197-2451,Private      ,1,0,1,72,31,103
03490300,PAUL MITCHELL THE SCHOOL ESCANABA       ,MI,49829-0000,Proprietary  ,1,5,6,10,26,36
03588300,IRENE'S MYOMASSOLOGY INSTITUTE          ,MI,48033-2404,Proprietary  ,8,60,68,62,296,358
03704300,BLUE WATER COLLEGE OF COSMETOLOGY       ,MI,48040-0000,Proprietary  ,2,12,14,26,42,68
03772300,SAGINAW CHIPPEWA TRIBAL COLLEGE         ,MI,48858-0000,Public       ,0,1,1,7,32,39
03815300,IN SESSION-ARTS OF COSMETOLOGY BEAU     ,MI,48609-0000,Proprietary  ,8,19,27,49,89,138
03907300,PAUL MITCHELL THE SCHOOL GREAT LAKES    ,MI,48060-0000,Proprietary  ,5,11,16,67,71,138
03915300,CAREER QUEST LEARNING CENTER            ,MI,48910-4732,Proprietary  ,6,48,54,19,251,270
03976500,ANN ARBOR INSTITUTE OF MASSAGE THERAPY  ,MI,48103-0000,Proprietary  ,6,19,25,27,95,122
04002400,ECUMENICAL THEOLOGICAL SEMINARY         ,MI,48201-3035,Private      ,0,1,1,2,56,58
04006300,NUVO COLLEGE OF COSMETOLOGY             ,MI,49441-3822,Proprietary  ,5,7,12,28,71,99
04014300,P&A SCHOLARS BEAUTY SCHOOL              ,MI,48204-0000,Proprietary  ,6,29,35,60,154,214
04055300,CREATIVE HAIR SCHOOL OF COSMETOLOGY     ,MI,48504-1234,Proprietary  ,3,6,9,11,25,36
04094300,ROBERT B. MILLER COLLEGE (THE)          ,MI,49017-3306,Private      ,2,8,10,6,65,71
00233200,ANOKA-RAMSEY CC-CAMBRIDGE/COONRAPID     ,MN,55433-3499,Public       ,125,127,252,2563,2426,4989
00233400,AUGSBURG COLLEGE                        ,MN,55454-1351,Private      ,17,118,135,1982,1950,3932
00233500,RIVERLAND COMMUNITY COLLEGE             ,MN,55912-1473,Public       ,22,55,77,954,1415,2369
00233600,BEMIDJI STATE UNIVERSITY                ,MN,56601-2699,Public       ,24,77,101,2628,1508,4136
00233700,BETHANY LUTHERAN COLLEGE INC            ,MN,56001-6163,Private      ,2,1,3,590,60,650
00233900,CENTRAL LAKES COLG-BRAINERD/STAPLES     ,MN,56401-3900,Public       ,23,82,105,1428,1417,2845
00234000,CARLETON COLLEGE                        ,MN,55057-4001,Private      ,15,1,16,2509,20,2529
00234100,COLLEGE OF ST BENEDICT                  ,MN,56374-2099,Private      ,7,0,7,1928,29,1957
00234200,ST. CATHERINE UNIVERSITY                ,MN,55105-1789,Private      ,20,99,119,2067,3061,5128
00234201,COLLEGE OF ST CATHERINE-MINNEAPOLIS     ,MN,55454-0000,Private      ,0,0,0,0,1,1
00234300,COLLEGE OF ST SCHOLASTICA               ,MN,55811-4199,Private      ,11,80,91,2000,1452,3452
00234500,UNIVERSITY OF ST THOMAS                 ,MN,55105-1096,Private      ,50,157,207,5450,3342,8792
00234600,CONCORDIA COLLEGE-MOORHEAD              ,MN,56562-0001,Private      ,26,5,31,2940,158,3098
00234700,"CONCORDIA UNIVERSITY, ST PAUL, MN       ",MN,55104-5494,Private      ,14,127,141,1059,1292,2351
00235000,VERMILION COMMUNITY COLLEGE             ,MN,55731-1996,Public       ,5,5,10,499,118,617
00235300,GUSTAVUS ADOLPHUS COLLEGE               ,MN,56082-1498,Private      ,10,0,10,2911,36,2947
00235400,HAMLINE UNIVERSITY                      ,MN,55104-1284,Private      ,19,115,134,2268,2556,4824
00235500,HIBBING COMMUNITY COLLEGE               ,MN,55746-3300,Public       ,28,60,88,716,789,1505
00235600,ITASCA COMMUNITY COLLEGE                ,MN,55744-3397,Public       ,19,18,37,674,466,1140
00235700,LUTHER SEMINARY                         ,MN,55108-0000,Private      ,0,6,6,3,479,482
00235800,MACALESTER COLLEGE                      ,MN,55105-1899,Private      ,13,1,14,2896,67,2963
00236000,"MINNESOTA STATE UNIVERSITY, MANKATO     ",MN,56002-0000,Public       ,86,107,193,9530,3361,12891
00236100,MARTIN LUTHER COLLEGE                   ,MN,56073-3965,Private      ,3,3,6,675,55,730
00236200,MINNEAPOLIS COMM AND TECH COLLEGE       ,MN,55403-1779,Public       ,126,340,466,3004,6594,9598
00236500,MINNEAPOLIS COLLEGE OF ART & DESIGN     ,MN,55404-4343,Private      ,4,6,10,818,320,1138
00236600,CROSSROADS COLLEGE                      ,MN,55902-2382,Private      ,2,6,8,91,82,173
00236700,MINNESOTA STATE UNIVERSITY MOORHEAD     ,MN,56563-0001,Public       ,50,64,114,5171,1989,7160
00236900,NORTH CENTRAL UNIVERSITY                ,MN,55404-1391,Private      ,10,12,22,1201,309,1510
00237000,NORTH HENNEPIN COMMUNITY COLLEGE        ,MN,55445-2299,Public       ,95,128,223,1986,2996,4982
00237100,NORTHWESTERN COLLEGE                    ,MN,55113-1598,Private      ,8,71,79,2219,758,2977
00237300,ROCHESTER COMMUNITY/TECH COLLEGE        ,MN,55904-4999,Public       ,48,101,149,2423,2453,4876
00237500,SOUTHWEST MINNESOTA STATE UNIVERSITY    ,MN,56258-1598,Public       ,15,36,51,1934,990,2924
00237700,ST CLOUD STATE UNIVERSITY               ,MN,56301-4498,Public       ,128,157,285,8956,3781,12737
00237900,SAINT JOHNS UNIVERSITY                  ,MN,56321-0000,Private      ,7,2,9,1716,83,1799
00238000,SAINT MARY'S UNIVERSITY                 ,MN,55987-1399,Private      ,7,165,172,1342,2605,3947
00238200,ST OLAF COLLEGE                         ,MN,55057-1098,Private      ,13,1,14,3410,79,3489
00238300,CROWN COLLEGE                           ,MN,55375-9001,Private      ,6,40,46,725,682,1407
00238500,NORTHLAND COMMUNITY & TECHNICAL CLG     ,MN,56701-2598,Public       ,45,95,140,1591,1872,3463
00238600,UNITED THEOLGCL SEMINRY TWIN CITIES     ,MN,55112-0000,Private      ,0,2,2,3,104,107
00238800,"UNIVERSITY OF MINNESOTA, DULUTH         ",MN,55812-2496,Public       ,83,38,121,8374,1835,10209
00238900,"UNIVERSITY OF MINNESOTA, MORRIS         ",MN,56267-2113,Public       ,27,6,33,1690,208,1898
00239100,WILLIAM MITCHELL COLLEGE OF LAW         ,MN,55105-0000,Private      ,0,3,3,1,1376,1377
00239300,MINNESOTA STATE COLLEGE-SE TECH         ,MN,55987-0409,Public       ,26,52,78,816,1103,1919
00239400,WINONA STATE UNIVERSITY                 ,MN,55987-5838,Public       ,52,41,93,5838,1234,7072
00396900,UNIVERSITY OF MINNESOTA-TWIN CITIES     ,MN,55455-0422,Public       ,309,484,793,24102,15577,39679
00400900,MESABI RANGE CMNTY & TECH COLLEGE       ,MN,55792-0000,Public       ,20,26,46,501,550,1051
00405708,NATIONAL AMERICAN UNIVERSITY            ,MN,55113-0000,Proprietary  ,2,15,17,31,265,296
00405715,NATIONAL AMERICAN UNIVERSITY - BLOOMINGT,MN,55425-5550,Proprietary  ,1,11,12,12,108,120
00406900,UNIVERSITY OF MINNESOTA-CROOKSTON       ,MN,56716-5001,Public       ,7,7,14,846,268,1114
00438600,VETERAN'S MEDICAL CTR- SCH RAD TECH     ,MN,55417-2399,Public       ,0,0,0,5,18,23
00464100,DUNWOODY COLLEGE OF TECHNOLOGY          ,MN,55403-1192,Private      ,49,57,106,893,863,1756
00464200,GLOBE UNIVERSITY                        ,MN,55125-5408,Proprietary  ,37,106,143,428,972,1400
00464500,MINNEAPOLIS BUSINESS COLLEGE            ,MN,55113-4036,Proprietary  ,2,0,2,454,109,563
00464600,MINNESOTA SCHOOL OF BUSINESS            ,MN,55423-0000,Proprietary  ,162,514,676,2188,4368,6556
00464800,RASMUSSEN COLLEGE - EAGAN               ,MN,55122-1346,Proprietary  ,23,101,124,156,682,838
00525200,RIDGEWATER COLLEGE                      ,MN,56201-2098,Public       ,41,97,138,2027,1582,3609
00526300,MINNESOTA WEST CMNTY & TECH COLG        ,MN,56241-1096,Public       ,23,54,77,999,1121,2120
00553300,"SAINT PAUL COLLEGE, COMMUNITY/TECHNICAL ",MN,55102-1800,Public       ,51,187,238,1410,3400,4810
00553400,ST CLOUD TECHNICAL COLLEGE              ,MN,56303-1240,Public       ,39,36,75,1935,1357,3292
00553500,PINE TECHNICAL COLLEGE                  ,MN,55063-2198,Public       ,2,21,23,179,421,600
00553700,SOUTH CENTRAL COLLEGE                   ,MN,56003-0000,Public       ,30,57,87,1286,1405,2691
00554100,MINNESOTA STATE COMMUNITY AND TECHNICAL ,MN,56573-1405,Public       ,67,124,191,2500,2685,5185
00554400,ALEXANDRIA TECHNICAL COLLEGE            ,MN,56308-3799,Public       ,16,25,41,1326,636,1962
00575700,LAKE SUPERIOR COLLEGE                   ,MN,55811-3399,Public       ,59,101,160,1818,2009,3827
00575900,NORTHWEST TECHNICAL COLLEGE - BEMIDJI   ,MN,56601-4907,Public       ,12,37,49,484,668,1152
00677500,RAINY RIVER COMMUNITY COLLEGE           ,MN,56649-2187,Public       ,7,1,8,205,115,320
00735000,ANOKA-HENNEPIN TECHNICAL COLLEGE        ,MN,55303-1590,Public       ,23,64,87,709,1242,1951
00735100,BROWN COLLEGE                           ,MN,55120-1004,Proprietary  ,69,136,205,1500,1636,3136
00746200,COLLEGE OF VISUAL ARTS                  ,MN,55102-2199,Private      ,4,0,4,150,49,199
00795400,NORMANDALE COMMUNITY COLLEGE            ,MN,55431-4399,Public       ,120,153,273,3247,3336,6583
00826700,NORTHWEST TECHNICAL INSTITUTE           ,MN,55121-5001,Proprietary  ,4,5,9,108,54,162
00869400,RASMUSSEN COLLEGE                       ,MN,56301-3713,Proprietary  ,23,97,120,232,846,1078
00869401,RASMUSSEN COLLEGE - BROOKLYN PARK       ,MN,55445-1512,Proprietary  ,32,147,179,236,786,1022
00905800,BETHEL UNIVERSITY                       ,MN,55112-6999,Private      ,26,112,138,2819,1702,4521
00960000,COSMETOLOGY CAREERS UNLTD-DULUTH        ,MN,55802-2031,Proprietary  ,4,9,13,36,59,95
00972200,EMPIRE BEAUTY SCHOOL                    ,MN,55119-7003,Proprietary  ,13,30,43,115,198,313
00974000,INVER HILLS COMMUNITY COLLEGE           ,MN,55076-3224,Public       ,84,117,201,1700,2086,3786
00983100,MODEL COLLEGE OF HAIR DESIGN            ,MN,56301-4280,Proprietary  ,6,3,9,120,53,173
00987000,EMPIRE BEAUTY SCHOOL                    ,MN,55420-2919,Proprietary  ,8,24,32,130,194,324
00989200,"DULUTH BUSINESS UNIV, INC.              ",MN,55807-0000,Proprietary  ,12,49,61,173,372,545
00999200,OAK HILLS CHRISTIAN COLLEGE             ,MN,56601-0000,Private      ,3,3,6,150,92,242
01024800,ART INSTITUTES INTL MINNESOTA           ,MN,55402-3137,Proprietary  ,47,86,133,1358,955,2313
01037400,METROPOLITAN STATE UNIVERSITY           ,MN,55106-5000,Public       ,23,144,167,1246,4475,5721
01040200,DAKOTA COUNTY TECHNICAL COLLEGE         ,MN,55068-2999,Public       ,43,103,146,1026,1401,2427
01049000,REGENCY BEAUTY INSTITUTE                ,MN,55428-0000,Proprietary  ,119,182,301,779,825,1604
01049100,HENNEPIN TECHNICAL COLLEGE              ,MN,55445-2399,Public       ,41,162,203,1342,2624,3966
01054600,CENTURY COMMUNITY AND TECHNICAL CLG     ,MN,55110-1894,Public       ,127,218,345,3220,3761,6981
01101700,HERZING COLLEGE                         ,MN,55428-3548,Proprietary  ,7,22,29,166,292,458
01168600,RASMUSSEN COLLEGE - EDEN PRAIRIE        ,MN,55344-7220,Proprietary  ,26,181,207,136,1069,1205
01173200,"MAYO CLINIC, COLLEGE OF MEDICINE        ",MN,55905-0000,Private      ,1,4,5,31,249,280
01173201,MAYO SCHOOL OF HEALTH-RELATED SCIEN     ,MN,55905-0000,Private      ,0,0,0,37,115,152
01173206,MAYO GRAD SCHOOL                        ,MN,55901-0000,Private      ,0,0,0,1,24,25
01173207,MAYO MEDICAL SCHOOL                     ,MN,55901-0000,Private      ,0,3,3,3,202,205
01232800,NORTHWESTERN HEALTH SCIENCES UNIV       ,MN,55431-1599,Private      ,3,12,15,75,923,998
02050300,ACADEMY COLLEGE                         ,MN,55420-1554,Proprietary  ,5,17,22,72,198,270
02096002,REGIONS HOSPITAL -DIETETIC INTRNSHP     ,MN,55101-0000,Private      ,0,1,1,2,4,6
02123200,AVEDA INSTITUTE                         ,MN,55414-0000,Proprietary  ,22,34,56,351,276,627
02159800,COSMETOLOGY CAREERS UNLTD - HIBBING     ,MN,55746-0000,Proprietary  ,2,3,5,16,26,42
02160901,"SALON PROFESSIONAL ACADEMY, THE - THE SA",MN,55428-4928,Proprietary  ,5,4,9,56,44,100
02238100,MINNESOTA SCHOOL OF COSMETOLOGY         ,MN,55125-0000,Proprietary  ,10,26,36,81,170,251
02260500,SUMMIT ACAD OPPORTUNITIES IND CTR       ,MN,55405-0000,Private      ,7,56,63,17,163,180
02284500,PILLSBURY BAPTIST BIBLE COLLEGE         ,MN,55060-0000,Private      ,4,2,6,159,37,196
02503300,RASMUSSEN COLLEGE - MANKATO             ,MN,56001-8658,Proprietary  ,17,74,91,237,658,895
02503302,RASMUSSEN COLLEGE - MANKATO -  LAKE ELMO,MN,55042-8624,Proprietary  ,3,36,39,3,36,39
02504200,WALDEN UNIVERSITY                       ,MN,55401-2511,Proprietary  ,6,3003,3009,36,22674,22710
02514100,AMERICAN INDIAN OPPORTUNITIES CTR       ,MN,55404-0000,Private      ,0,30,30,3,128,131
02543600,INGENUE                                 ,MN,56560-0000,Proprietary  ,0,4,4,20,16,36
02551200,EAST METRO OIC                          ,MN,55104-3435,Private      ,2,21,23,10,99,109
03001200,MCNALLY SMITH COLLEGE OF MUSIC          ,MN,55101-2220,Proprietary  ,14,12,26,472,159,631
03051900,ALFRED ADLER GRADUATE SCHOOL            ,MN,55305-0000,Private      ,0,12,12,0,139,139
03096400,LEECH LAKE TRIBAL COLLEGE               ,MN,56633-0000,Public       ,6,23,29,44,246,290
03129100,FOND DU LAC TRIBAL & COMMUNITY CLG      ,MN,55720-2984,Public       ,16,69,85,374,794,1168
03267300,CAPELLA UNIVERSITY                      ,MN,55402-3389,Proprietary  ,8,2235,2243,65,23621,23686
03473400,MINNEAPOLIS SCHOOL OF MASSAGE AND B     ,MN,55418-3343,Private      ,1,6,7,27,99,126
03833300,AMERICAN ACADEMY OF ACUPUNCTURE AND ORIE,MN,55113-0000,Proprietary  ,0,4,4,1,84,85
03921400,WHITE EARTH TRIBAL AND COMMUNITY COLLEGE,MN,56557-0478,Private      ,4,16,20,16,124,140
04044300,HAZELDEN GRADUATE SCHOOL OF ADDICTION ST,MN,55012-0000,Private      ,0,11,11,0,38,38
00239600,ALCORN STATE UNIVERSITY                 ,MS,39096-7500,Public       ,70,114,184,3388,2559,5947
00239700,BELHAVEN COLLEGE                        ,MS,39202-1789,Private      ,20,269,289,1076,2977,4053
00239800,BLUE MOUNTAIN COLLEGE                   ,MS,38610-9370,Private      ,8,14,22,238,246,484
00240100,COAHOMA COMMUNITY COLLEGE               ,MS,38614-9799,Public       ,69,148,217,1077,1889,2966
00240200,COPIAH-LINCOLN COMMUNITY COLLEGE        ,MS,39191-0649,Public       ,76,108,184,1728,1902,3630
00240300,DELTA STATE UNIVERSITY                  ,MS,38733-0000,Public       ,64,83,147,2892,2806,5698
00240400,EAST CENTRAL COMMUNITY COLLEGE          ,MS,39327-0129,Public       ,48,90,138,1318,1534,2852
00240500,EAST MISSISSIPPI COMM COLLEGE           ,MS,39358-0000,Public       ,136,252,388,2039,3242,5281
00240700,HINDS COMMUNITY COLLEGE                 ,MS,39154-9799,Public       ,241,426,667,5454,7349,12803
00240800,HOLMES COMMUNITY COLLEGE                ,MS,39079-0000,Public       ,98,209,307,2329,3862,6191
00240900,ITAWAMBA COMMUNITY COLLEGE              ,MS,38843-1099,Public       ,119,276,395,2565,3797,6362
00241000,JACKSON STATE UNIVERSITY                ,MS,39217-0001,Public       ,187,285,472,7523,7492,15015
00241100,JONES COUNTY JUNIOR COLLEGE             ,MS,39437-3999,Public       ,112,137,249,2908,2323,5231
00241300,MERIDIAN COMMUNITY COLLEGE              ,MS,39307-5890,Public       ,64,135,199,1852,2161,4013
00241400,MILLSAPS COLLEGE                        ,MS,39201-0000,Private      ,19,15,34,1125,392,1517
00241500,MISSISSIPPI COLLEGE                     ,MS,39058-0001,Private      ,38,120,158,2079,2529,4608
00241501,MISSISSIPPI COLLEGE - SCHOOL OF LAW     ,MS,39201-1391,Private      ,0,7,7,27,725,752
00241600,MISSISSIPPI DELTA CMTY COLLEGE          ,MS,38761-0000,Public       ,73,106,179,1819,2312,4131
00241700,MISSISSIPPI GULF CST CLG-PERKINSTON     ,MS,39573-0000,Public       ,48,26,74,1109,669,1778
00241701,MISSISSIPPI GULF CST CLG-JEFF DAVIS     ,MS,39507-0000,Public       ,48,106,154,1440,2489,3929
00241702,MISSISSIPPI GULF CST CLG-JACKSON CN     ,MS,39553-0000,Public       ,62,97,159,1413,2035,3448
00242200,MISSISSIPPI UNIV FOR WOMEN              ,MS,39701-5818,Public       ,36,49,85,1534,1587,3121
00242300,MISSISSIPPI STATE UNIVERSITY            ,MS,39762-9698,Public       ,183,178,361,9390,5525,14915
00242400,MISSISSIPPI VALLEY STATE UNIVERSITY     ,MS,38941-1400,Public       ,76,129,205,2594,3647,6241
00242600,NORTHEAST MS CMNTY COLLEGE              ,MS,38829-1731,Public       ,56,73,129,2060,1696,3756
00242700,NORTHWEST MISSISSIPPI COMMUNITY CLG     ,MS,38668-1703,Public       ,132,191,323,3777,3596,7373
00243000,PEARL RIVER COMMUNITY COLLEGE           ,MS,39470-2201,Public       ,98,133,231,2223,2606,4829
00243300,RUST COLLEGE                            ,MS,38635-2328,Private      ,14,22,36,1093,409,1502
00243500,SOUTHEASTERN BAPTIST COLLEGE            ,MS,39440-0000,Private      ,1,5,6,25,61,86
00243600,SOUTHWEST MISSISSIPPI CMNTY CLG         ,MS,39666-8099,Public       ,18,40,58,1095,1161,2256
00243900,TOUGALOO COLLEGE                        ,MS,39174-9799,Private      ,21,16,37,1465,452,1917
00244000,UNIVERSITY OF MISSISSIPPI               ,MS,38677-1848,Public       ,168,157,325,8480,4913,13393
00244001,UNIVERSITY OF MISSISSIPPI - MED CTR     ,MS,39216-0000,Public       ,5,18,23,410,1296,1706
00244100,UNIVERSITY OF SOUTHERN MISSISSIPPI      ,MS,39406-0001,Public       ,232,344,576,9493,8117,17610
00244700,WILLIAM CAREY UNIVERSITY                ,MS,39401-5499,Private      ,50,145,195,1094,2361,3455
01146100,WESLEY COLLEGE                          ,MS,39073-1070,Private      ,1,6,7,53,81,134
01289101,ANTONELLI COLLEGE - JACKSON             ,MS,39208-4526,Proprietary  ,1,4,5,12,38,50
01289102,ANTONELLI COLLEGE - HATTIESBURG         ,MS,39401-3056,Proprietary  ,1,1,2,6,22,28
02074900,CHRIS' BEAUTY COLLEGE                   ,MS,39501-0000,Proprietary  ,2,10,12,41,88,129
02160500,NORTH MISSISSIPPI MED CTR MED TECH      ,MS,38801-0000,Private      ,0,0,0,8,32,40
02235900,ACADEMY OF HAIR DESIGN #4               ,MS,39208-0000,Proprietary  ,1,7,8,31,70,101
02244300,ACADEMY OF HAIR DESIGN #1               ,MS,38901-0000,Proprietary  ,11,33,44,72,234,306
02249900,DELTA BEAUTY COLLEGE                    ,MS,38701-0000,Proprietary  ,2,16,18,46,128,174
02251600,ACADEMY OF HAIR DESIGN #6               ,MS,39401-7581,Proprietary  ,0,14,14,41,122,163
02251700,FOSTER'S COSMETOLOGY COLLEGE            ,MS,38663-0000,Proprietary  ,2,12,14,8,47,55
02302800,MISSISSIPPI COLLEGE OF BEAUTY CULT      ,MS,39440-0000,Proprietary  ,0,15,15,21,70,91
02320800,MAGNOLIA COLLEGE OF COSMETOLOGY         ,MS,39206-0000,Proprietary  ,4,25,29,45,152,197
02361200,MAGNOLIA BIBLE COLLEGE                  ,MS,39090-0000,Private      ,1,4,5,9,34,43
02490200,"ICS, THE WRIGHT BEAUTY COLLEGE          ",MS,38834-0000,Proprietary  ,0,4,4,8,39,47
02502100,CREATIONS COLLEGE OF COSMETOLOGY        ,MS,38803-0000,Proprietary  ,2,17,19,24,107,131
02516200,WESLEY BIBLICAL SEMINARY                ,MS,39206-0000,Private      ,0,9,9,1,94,95
02554600,GIBSON'S BARBER AND BEAUTY COLLEGE      ,MS,39773-0000,Proprietary  ,0,7,7,40,77,117
02586000,J & J HAIR DESIGN COLLEGE               ,MS,39051-3716,Proprietary  ,2,38,40,18,138,156
03004000,FINAL TOUCH BEAUTY SCHOOL               ,MS,39307-2934,Proprietary  ,4,18,22,21,93,114
03010404,CRESCENT CITY SCHOOL OF GAMING & BARTEND,MS,38664-1903,Proprietary  ,0,2,2,0,8,8
03010603,VIRGINIA COLLEGE - JACKSON              ,MS,39206-5602,Proprietary  ,2,15,17,55,223,278
03010610,VIRGINIA COLLEGE - BILOXI               ,MS,39532-2124,Proprietary  ,2,2,4,17,102,119
03263300,TRAXLER'S SCHOOL OF HAIR                ,MS,39212-2529,Proprietary  ,3,13,16,20,68,88
03464300,ACADEMY OF HAIR DESIGN                  ,MS,39562-0000,Proprietary  ,1,20,21,12,47,59
03525300,BLUE CLIFF COLLEGE                      ,MS,39507-0000,Proprietary  ,2,17,19,28,166,194
03848300,DAY SPA CAREER COLLEGE                  ,MS,39564-0000,Proprietary  ,5,8,13,23,71,94
03963300,HEALING TOUCH SCHOOL OF MASSAGE THERAPY ,MS,39402-1300,Proprietary  ,2,5,7,18,43,61
00252600,CARROLL COLLEGE                         ,MT,59625-0002,Private      ,22,7,29,1513,263,1776
00252700,UNIVERSITY OF GREAT FALLS               ,MT,59405-4996,Private      ,5,32,37,416,622,1038
00252800,MILES COMMUNITY COLLEGE                 ,MT,59301-4799,Public       ,9,15,24,283,243,526
00252900,DAWSON COMMUNITY COLLEGE                ,MT,59330-1405,Public       ,7,7,14,246,143,389
00253000,MONTANA STATE UNIVERSITY - BILLINGS     ,MT,59101-0298,Public       ,52,110,162,2475,3066,5541
00253100,MONTANA TECH OF THE UNIV OF MONTANA     ,MT,59701-8997,Public       ,28,29,57,1285,1026,2311
00253200,MONTANA STATE UNIVERSITY - BOZEMAN      ,MT,59717-0001,Public       ,108,117,225,8084,3590,11674
00253300,MONTANA STATE UNIVERSITY-NORTHERN       ,MT,59501-3148,Public       ,11,42,53,726,908,1634
00253400,ROCKY MOUNTAIN COLLEGE                  ,MT,59102-1796,Private      ,15,13,28,864,356,1220
00253600,UNIVERSITY OF MONTANA (THE)             ,MT,59812-0001,Public       ,127,183,310,7547,6285,13832
00253700,UNIVERSITY OF MONTANA WESTERN (THE)     ,MT,59725-3598,Public       ,12,31,43,880,504,1384
00442500,BENEFIS HEALTHCARE SCH RAD TECH         ,MT,59405-4324,Private      ,0,0,0,7,12,19
00677700,FLATHEAD VALLEY COMMUNITY COLLEGE       ,MT,59901-2699,Public       ,27,61,88,523,735,1258
00757000,HELENA COLLEGE OF TECHNOLOGY            ,MT,59601-3098,Public       ,13,27,40,401,593,994
00790000,BUTTE ACADEMY OF BEAUTY CULTURE         ,MT,59701-9197,Proprietary  ,0,2,2,23,29,52
00894700,"DAHL'S COLLEGE OF BEAUTY,INC            ",MT,59401-3731,Proprietary  ,2,6,8,22,53,75
00931400,MSU COLLEGE OF TECH-GREAT FALLS         ,MT,59405-4907,Public       ,24,76,100,472,1175,1647
00946800,COLLEGE OF COIFFURE ART LTD             ,MT,59102-5333,Proprietary  ,3,4,7,29,31,60
02143400,SALISH KOOTENAI COLLEGE                 ,MT,59855-0000,Public       ,8,51,59,253,851,1104
02286600,LITTLE BIG HORN COLLEGE                 ,MT,59022-0000,Public       ,10,22,32,122,178,300
02343000,FT PECK COMMUNITY COLLEGE               ,MT,59255-0000,Public       ,10,50,60,80,332,412
02510600,BLACKFEET COMMUNITY COLLEGE             ,MT,59417-0000,Private      ,23,98,121,162,489,651
02517500,FORT BELKNAP COLLEGE                    ,MT,59526-0000,Public       ,5,14,19,55,109,164
02545200,CHIEF DULL KNIFE COLLEGE                ,MT,59043-0098,Public       ,3,12,15,54,124,178
02610900,STONE CHILD COLLEGE                     ,MT,59521-9796,Public       ,9,52,61,71,222,293
02621300,ACADEMY OF COSMETOLOGY                  ,MT,59715-3544,Proprietary  ,0,1,1,35,24,59
03205300,MODERN BEAUTY SCHOOL                    ,MT,59801-8386,Proprietary  ,2,4,6,26,34,60
03763400,"ACADEMY OF NAIL, SKIN & HAIR            ",MT,59101-0000,Proprietary  ,5,9,14,57,74,131
03778300,HEALTH WORKS INSTITUTE                  ,MT,59715-0000,Proprietary  ,5,14,19,28,49,77
00253900,CHADRON STATE COLLEGE                   ,NE,69337-2690,Public       ,19,23,42,1423,751,2174
00254000,COLLEGE OF ST MARY                      ,NE,68106-2606,Private      ,5,28,33,452,965,1417
00254100,CONCORDIA UNIVERSITY                    ,NE,68434-1594,Private      ,2,31,33,1304,171,1475
00254200,CREIGHTON UNIVERSITY                    ,NE,68178-0001,Private      ,29,48,77,4191,4147,8338
00254300,DANA COLLEGE                            ,NE,68008-9905,Private      ,2,1,3,851,96,947
00254400,DOANE COLLEGE                           ,NE,68333-2421,Private      ,11,75,86,1347,826,2173
00254700,GRACE UNIVERSITY                        ,NE,68108-3629,Private      ,4,11,15,359,238,597
00254800,HASTINGS COLLEGE                        ,NE,68901-7621,Private      ,9,5,14,1451,139,1590
00255100,UNIVERSITY OF NEBRASKA AT KEARNEY       ,NE,68849-0001,Public       ,30,71,101,4073,1425,5498
00255300,MIDLAND LUTHERAN COLLEGE                ,NE,68025-4254,Private      ,8,3,11,1069,146,1215
00255400,UNIVERSITY OF NEBRASKA-OMAHA            ,NE,68182-0001,Public       ,123,148,271,7306,5005,12311
00255500,NEBRASKA WESLEYAN UNIVERSITY            ,NE,68504-2796,Private      ,16,17,33,1913,473,2386
00255700,MID-PLAINS COMM COLLEGE - NORTH PLATTE  ,NE,69101-9420,Public       ,21,43,64,440,562,1002
00255701,MID-PLAINS COMMUNITY COLLEGE - MCCOOK   ,NE,69001-2631,Public       ,2,11,13,250,149,399
00255900,PERU STATE COLLEGE                      ,NE,68421-0010,Public       ,10,41,51,848,738,1586
00256000,WESTERN NEBRASKA COMMUNITY COLLEGE      ,NE,69361-1815,Public       ,20,55,75,561,768,1329
00256300,UNION COLLEGE                           ,NE,68506-4387,Private      ,10,0,10,789,261,1050
00256500,UNIVERSITY OF NEBRASKA-LINCOLN          ,NE,68588-0419,Public       ,146,118,264,13049,4454,17503
00256596,UNIVERSITY OF NEBRASKA - CURTIS         ,NE,69025-9522,Public       ,3,4,7,256,22,278
00256600,WAYNE STATE COLLEGE                     ,NE,68787-1172,Public       ,19,48,67,2465,871,3336
00256700,YORK COLLEGE                            ,NE,68467-2699,Private      ,7,1,8,454,98,552
00443100,MARY LANNING MEM HOSP SCH RAD TECH      ,NE,68901-4497,Private      ,0,0,0,9,4,13
00443600,REGNL WST MEDCL CTR SCHL RAD            ,NE,69361-0000,Private      ,0,0,0,7,8,15
00458608,KAPLAN UNIVERSITY - OMAHA               ,NE,68134-1002,Proprietary  ,30,108,138,207,1239,1446
00458609,KAPLAN UNIVERSITY - LINCOLN             ,NE,68508-2668,Proprietary  ,26,121,147,275,787,1062
00639900,BRYANLGH COLLEGE OF HEALTH SCIENCES     ,NE,68506-1398,Private      ,1,5,6,225,180,405
00640400,NEBR METHODIST CLG OF NURS ALLD HLTH    ,NE,68114-2852,Private      ,9,11,20,378,492,870
00689500,UNIVERSITY OF NEBRASKA-MED CTR          ,NE,68198-4265,Public       ,2,18,20,533,2001,2534
00750100,VATTEROTT COLLEGE                       ,NE,68137-1237,Proprietary  ,34,117,151,267,955,1222
00849200,ALEGENT HEALTH SCHOOLS                  ,NE,68114-2767,Private      ,0,2,2,24,79,103
00952300,BAHNER COLLEGE OF HAIRSTYLING           ,NE,68025-3297,Proprietary  ,10,2,12,102,27,129
00961700,CAPITOL BEAUTY SCHOOL                   ,NE,68144-3873,Proprietary  ,5,8,13,115,86,201
00974300,BELLEVUE UNIVERSITY                     ,NE,68005-0000,Private      ,47,695,742,715,5406,6121
00986200,CLARKSON COLLEGE                        ,NE,68131-2739,Private      ,2,12,14,426,536,962
01151900,JOSEPH'S COLLEGE OF BEAUTY/ALL CAMPUSES ,NE,68510-2226,Proprietary  ,12,39,51,216,331,547
01166700,NORTHEAST COMMUNITY COLLEGE             ,NE,68702-0000,Public       ,15,51,66,1533,1058,2591
01258600,METROPOLITAN COMMUNITY COLLEGE          ,NE,68103-0000,Public       ,154,511,665,2926,6709,9635
01297600,NEBRASKA CHRISTIAN COLLEGE              ,NE,68046-4256,Private      ,2,1,3,142,34,176
02079700,COLLEGE OF HAIR DESIGN                  ,NE,68508-0000,Proprietary  ,13,15,28,147,89,236
02099500,CENTRAL COMMUNITY COLLEGE- GI           ,NE,68801-0000,Public       ,24,62,86,531,1068,1599
02099501,CENTRAL COMMUNITY COLLEGE - HASTINGS    ,NE,68902-0000,Public       ,15,39,54,856,618,1474
02099502,CENTRAL COMMUNITY COLLEGE - COLUMBUS    ,NE,68602-0000,Public       ,14,25,39,428,380,808
02508300,SOUTHEAST COMM. COLLEGE-ALL CAMPUSES    ,NE,68520-0000,Public       ,116,203,319,3289,3441,6730
02508301,SOUTHEAST COMMUNITY COLLEGE             ,NE,68310-7042,Public       ,0,0,0,454,274,728
02508302,SOUTHEAST COMMUNITY COLLEGE             ,NE,68405-0000,Public       ,0,0,0,752,166,918
02550800,NEBRASKA INDIAN COMMUNITY COLLEGE       ,NE,68039-0000,Public       ,3,8,11,19,72,91
02610500,XENON INTERNATIONAL ACADEMY II          ,NE,68127-3522,Proprietary  ,14,19,33,215,152,367
03023300,VATTEROTT COLLEGE                       ,NE,68137-1237,Proprietary  ,0,0,0,16,33,49
03127300,OMAHA SCHOOL OF MASSAGE THERAPY         ,NE,68127-5002,Proprietary  ,11,17,28,54,113,167
03164300,THE CREATIVE CENTER                     ,NE,68164-2911,Proprietary  ,1,0,1,104,19,123
03279300,MYOTHERAPY INSTITUTE                    ,NE,68516-3641,Proprietary  ,1,0,1,37,63,100
03323300,LITTLE PRIEST TRIBAL COLLEGE            ,NE,68071-0000,Private      ,2,23,25,20,83,103
03821400,UNIVERSAL COLLEGE OF HEALING ARTS       ,NE,68112-1810,Proprietary  ,1,7,8,11,55,66
00256800,UNIVERSITY OF NEVADA RENO               ,NV,89557-0002,Public       ,175,103,278,6027,3946,9973
00256900,UNIVERSITY OF NEVADA-LAS VEGAS          ,NV,89154-1001,Public       ,269,328,597,9380,10590,19970
00697700,GREAT BASIN COLLEGE                     ,NV,89801-3348,Public       ,18,64,82,340,757,1097
00736700,MARINELLO SCHOOLS OF BEAUTY             ,NV,89110-3563,Proprietary  ,17,55,72,119,314,433
00919200,SIERRA NEVADA COLLEGE                   ,NV,89451-0000,Private      ,5,34,39,233,357,590
01036200,COLLEGE OF SOUTHERN NEVADA              ,NV,89146-1139,Public       ,207,497,704,4190,9481,13671
01036300,WESTERN NEVADA COLLEGE                  ,NV,89703-0000,Public       ,42,79,121,531,1186,1717
01323200,ACADEMY OF HAIR DESIGN                  ,NV,89102-0000,Proprietary  ,10,35,45,123,215,338
02097100,SOUTHERN NEVADA UNIV OF COSMETOLOGY     ,NV,89121-0000,Proprietary  ,3,13,16,42,87,129
02107700,TRUCKEE MEADOWS COMMUNITY CLG           ,NV,89512-0000,Public       ,80,202,282,1585,3103,4688
02237500,EVEREST COLLEGE                         ,NV,89103-0000,Proprietary  ,39,82,121,300,882,1182
02338509,NEVADA CAREER INSTITUTE                 ,NV,89121-0000,Proprietary  ,24,60,84,114,472,586
02361001,ITT TECHNICAL INSTITUTE                 ,NV,89014-0000,Proprietary  ,37,95,132,371,679,1050
02600700,LAS VEGAS GAMING & TECHNICAL SCHOOL     ,NV,89109-0000,Proprietary  ,0,0,0,0,1,1
02616703,SCOTTSDALE CULINARY INSTITUTE - LE CORDO,NV,89144-7047,Proprietary  ,7,10,17,105,188,293
02621500,CAREER COLLEGE OF NORTHERN NEVADA       ,NV,89434-7905,Proprietary  ,15,70,85,105,433,538
03030603,UTAH CLG OF MASSAGE THERAPY-NSMT        ,NV,89123-0000,Proprietary  ,29,51,80,198,442,640
03031405,INTERNATIONAL ACADEMY OF DESIGN AND TECH,NV,89074-7750,Proprietary  ,4,7,11,93,88,181
03043200,KAPLAN COLLEGE                          ,NV,89102-8618,Proprietary  ,29,94,123,160,561,721
03084600,THE ART INSTITUTE OF LAS VEGAS          ,NV,89074-7737,Proprietary  ,67,95,162,890,1037,1927
03088200,CARSON CITY BEAUTY ACADEMY              ,NV,89706-0000,Proprietary  ,2,15,17,29,82,111
03110000,ACADEMY OF HEALING ARTS                 ,NV,89106-4031,Proprietary  ,31,106,137,100,442,542
03232305,COMPUTER-ED INSTITUTE -                 ,NV,89014-6398,Proprietary  ,21,40,61,85,177,262
03232306,EUPHORIA INSTITUTE - SUMMERLIN          ,NV,89117-8803,Proprietary  ,2,4,6,2,4,6
03232307,EUPHORIA INSTITUTE - GREEN VALLEY       ,NV,89052-4964,Proprietary  ,4,8,12,4,8,12
03787300,EXPERTISE SCHOOL OF BEAUTY              ,NV,89106-2516,Private      ,3,23,26,31,110,141
03838500,NORTHWEST HEALTH CAREERS                ,NV,89128-0000,Proprietary  ,5,20,25,38,168,206
03975300,INSTITUTE OF PROFESSIONAL CAREERS       ,NV,89119-7825,Proprietary  ,1,3,4,22,77,99
04065300,UNIVERSITY OF SOUTHERN NEVADA           ,NV,89014-2333,Private      ,3,60,63,12,292,304
04114300,NEVADA STATE COLLEGE                    ,NV,89002-9455,Public       ,19,35,54,30,63,93
00257200,COLBY-SAWYER COLLEGE                    ,NH,03257-4648,Private      ,13,1,14,1396,40,1436
00257300,DARTMOUTH COLLEGE                       ,NH,03755-3529,Private      ,42,8,50,6970,1594,8564
00257500,FRANKLIN PIERCE UNIVERSITY              ,NH,03461-0060,Private      ,35,54,89,2952,921,3873
00257900,NEW ENGLAND COLLEGE                     ,NH,03242-3293,Private      ,14,35,49,1358,365,1723
00258000,SOUTHERN NEW HAMPSHIRE UNIVERSITY       ,NH,03106-1045,Private      ,38,223,261,3136,2989,6125
00258100,NHTI  - CONCORD'S COMMUNITY COLLEGE     ,NH,03301-7412,Public       ,42,43,85,1732,1160,2892
00258200,MANCHESTER COMMUNITY COLLEGE            ,NH,03102-8518,Public       ,26,20,46,692,731,1423
00258201,NH COMM TECH COLLEGE - STRATHAM         ,NH,03885-0000,Public       ,0,0,0,273,342,615
00258202,NEW HAMPSHIRE COMMUNITY TECHNICAL COLLEG,NH,03038-0000,Public       ,0,0,0,16,23,39
00258204,HEW HAMPSHIRE COMMUNITY TECHNICAL COLLEG,NH,03803-2807,Public       ,1,1,2,32,38,70
00258300,GREAT BAY COMMUNITY COLLEGE             ,NH,03885-0000,Public       ,15,25,40,143,204,347
00258600,RIVIER COLLEGE                          ,NH,03060-5086,Private      ,7,42,49,1200,777,1977
00258700,SAINT ANSELM COLLEGE                    ,NH,03102-1310,Private      ,14,3,17,3181,46,3227
00258900,UNIVERSITY OF NEW HAMPSHIRE             ,NH,03824-2511,Public       ,99,56,155,15281,2715,17996
00259000,KEENE STATE COLLEGE                     ,NH,03431-0000,Public       ,40,13,53,5277,575,5852
00259100,PLYMOUTH STATE UNIVERSITY               ,NH,03264-1595,Public       ,45,47,92,5366,802,6168
00301004,ANTIOCH UNIVERSITY                      ,NH,03431-0000,Private      ,0,8,8,2,854,856
00472900,HESSER COLLEGE                          ,NH,03103-7230,Proprietary  ,38,144,182,1013,1168,2181
00472901,HESSER COLLEGE - NASHUA CAMPUS          ,NH,03063-1286,Proprietary  ,21,75,96,167,476,643
00472904,HESSER COLLEGE - PORTSMOUTH CAMPUS      ,NH,03801-3245,Proprietary  ,27,78,105,198,495,693
00472905,HESSER COLLEGE - SALEM CAMPUS           ,NH,03079-2842,Proprietary  ,25,72,97,234,602,836
00472906,HESSER COLLEGE - CONCORD CAMPUS         ,NH,03301-3415,Proprietary  ,15,59,74,116,437,553
00473000,MCINTOSH COLLEGE INC                    ,NH,03820-3990,Proprietary  ,37,84,121,930,894,1824
00473100,DANIEL WEBSTER COLLEGE                  ,NH,03063-1300,Proprietary  ,10,19,29,946,258,1204
00473300,CHESTER COLLEGE OF NEW ENGLAND          ,NH,03036-4331,Private      ,3,3,6,286,50,336
00529100,WHITE MOUNTAINS COMMUNITY COLLEGE       ,NH,03570-3799,Public       ,19,39,58,251,450,701
00529101,N.H.COMM TECH COLLEGE - LACONIA         ,NH,03246-0000,Public       ,2,5,7,300,249,549
00702500,LEBANON COLLEGE                         ,NH,03766-0000,Private      ,0,3,3,10,40,50
00755500,LAKES REGION COMMUNITY COLLEGE          ,NH,03246-1326,Public       ,11,21,32,114,105,219
00756000,RIVER VALLEY COMMUNITY COLLEGE          ,NH,03743-9707,Public       ,8,27,35,207,483,690
00849300,CONTINENTAL ACADEMIE OF HAIR DESIGN     ,NH,03103-4901,Proprietary  ,4,5,9,28,19,47
00864500,EMPIRE BEAUTY SCHOOL                    ,NH,03220-0000,Proprietary  ,16,31,47,117,135,252
00923600,NASHUA COMMUNITY COLLEGE                ,NH,03063-2052,Public       ,32,23,55,644,568,1212
01318900,CONTINENTAL ACADEMIE OF HAIR DESIGN     ,NH,03051-3754,Proprietary  ,3,0,3,55,16,71
02097900,FRANKLIN PIERCE LAW CENTER              ,NH,03301-0000,Private      ,0,5,5,14,690,704
02140400,ST JOSEPH SCH OF PRAC NRSG              ,NH,03060-0000,Private      ,4,6,10,24,116,140
02174800,MICHAEL'S SCHOOL OF HAIR DESIGN & ESTHET,NH,03110-0000,Proprietary  ,7,15,22,85,84,169
02179600,EMPIRE BEAUTY SCHOOL                    ,NH,03878-0000,Proprietary  ,21,44,65,129,177,306
02211600,PORTSMOUTH BTY SCH OF HAIR DESIGN       ,NH,03801-4084,Proprietary  ,4,2,6,32,20,52
02245400,KEENE BEAUTY ACADEMY                    ,NH,03431-0000,Proprietary  ,8,8,16,40,31,71
02247000,NEW ENGLAND SCHOOL OF HAIR DESIGN       ,NH,03784-0000,Proprietary  ,5,9,14,34,46,80
02300200,CONCORD ACADEMY OF HAIR DESIGN          ,NH,03301-0000,Proprietary  ,0,3,3,12,17,29
03043100,THOMAS MORE COLLEGE OF LIBERAL ARTS     ,NH,03054-4818,Private      ,2,0,2,94,12,106
03101300,GRANITE STATE COLLEGE                   ,NH,03301-6400,Public       ,6,106,112,143,1174,1317
03182300,NEW HAMPSHIRE INSTITUTE OF ART          ,NH,03104-4858,Private      ,6,0,6,263,68,331
03305300,SECOND START                            ,NH,03301-5706,Private      ,5,18,23,10,92,102
03437300,UPPER VALLEY TEACHER TRANING PROGRAM    ,NH,03766-1358,Private      ,0,0,0,1,41,42
03729300,NH INSTITUTE FOR THERAPEUTIC ARTS       ,NH,03051-4906,Proprietary  ,1,1,2,22,45,67
00267000,BAPTIST BIBLE COLG OF PENNSYLVANIA      ,PA,18411-1297,Private      ,6,8,14,730,152,882
00322800,BRYN ATHYN COLLEGE OF THE NEW CHURCH    ,PA,19009-0717,Private      ,0,1,1,77,6,83
00322900,ALBRIGHT COLLEGE                        ,PA,19612-5234,Private      ,29,57,86,2893,738,3631
00323000,ALLEGHENY COLLEGE                       ,PA,16335-3902,Private      ,20,1,21,3075,66,3141
00323100,COMM CLG OF ALLEGHENY-ALLEGHENY CMP     ,PA,15212-0000,Public       ,50,202,252,2024,3805,5829
00323101,"COMM CLG OF ALLEGHENY, BOYCE CAMPUS     ",PA,15146-0000,Public       ,21,83,104,1128,1779,2907
00323102,"COMM CLG OF ALLEGHENY, NORTH CAMPUS     ",PA,15237-0000,Public       ,33,49,82,924,987,1911
00323103,"COMM CLG OF ALLEGHENY, SOUTH CAMPUS     ",PA,15122-0000,Public       ,42,95,137,1555,1955,3510
00323300,ALVERNIA UNIVERSITY                     ,PA,19607-1799,Private      ,10,42,52,1526,1189,2715
00323500,ARCADIA UNIVERSITY                      ,PA,19038-3295,Private      ,38,38,76,3347,1373,4720
00323700,BRYN MAWR COLLEGE                       ,PA,19010-2899,Private      ,9,4,13,1389,481,1870
00323800,BUCKNELL UNIVERSITY                     ,PA,17837-2122,Private      ,30,2,32,4952,123,5075
00323900,BUCKS COUNTY COMMUNITY COLLEGE          ,PA,18940-1320,Public       ,60,103,163,2281,1894,4175
00324000,BUTLER COUNTY COMMUNITY COLLEGE         ,PA,16001-0000,Public       ,30,63,93,1445,1386,2831
00324100,CABRINI COLLEGE                         ,PA,19087-3698,Private      ,19,92,111,2258,552,2810
00324200,CARNEGIE MELLON UNIVERSITY              ,PA,15213-3890,Private      ,46,17,63,7507,933,8440
00324201,CARNEGIE MELLON UNIV- THE HEINZ SCH     ,PA,15213-0000,Private      ,4,11,15,486,425,911
00324202,CARNEGIE MELLON- TEPPER SCHOOL OF BUSINE,PA,15213-0000,Private      ,0,12,12,12,580,592
00324300,CEDAR CREST COLLEGE                     ,PA,18104-6196,Private      ,11,37,48,1325,1064,2389
00324400,CHATHAM UNIVERSITY                      ,PA,15232-2826,Private      ,2,35,37,594,1008,1602
00324500,CHESTNUT HILL COLLEGE                   ,PA,19118-2693,Private      ,22,49,71,1247,1183,2430
00324700,MISERICORDIA  UNIVERSITY                ,PA,18612-1008,Private      ,3,44,47,1698,816,2514
00324900,COMMUNITY COLLEGE OF PHILADELPHIA       ,PA,19130-3991,Public       ,187,552,739,8802,14090,22892
00325100,CURTIS INSTITUTE OF MUSIC               ,PA,19103-6187,Private      ,1,0,1,223,86,309
00325200,DELAWARE VALLEY COLLEGE                 ,PA,18901-2697,Private      ,12,25,37,1962,299,2261
00325300,DICKINSON COLLEGE                       ,PA,17013-2896,Private      ,20,0,20,2866,49,2915
00325400,DICKINSON SCHOOL OF LAW                 ,PA,17013-2899,Private      ,0,4,4,31,1685,1716
00325600,DREXEL UNIVERSITY                       ,PA,19104-2875,Private      ,186,472,658,14375,9968,24343
00325800,DUQUESNE UNIVERSITY                     ,PA,15282-0001,Private      ,44,84,128,6648,3787,10435
00325900,EASTERN UNIVERSITY                      ,PA,19087-3696,Private      ,13,102,115,2164,1828,3992
00325908,EASTERN BAPTIST THEOLGCL SEMINARY       ,PA,19096-0000,Private      ,0,4,4,1,127,128
00326200,ELIZABETHTOWN COLLEGE                   ,PA,17022-2298,Private      ,14,18,32,2771,302,3073
00326300,EVANGELICAL SCHOOL OF THEOLOGY          ,PA,17067-0000,Private      ,0,2,2,0,92,92
00326500,FRANKLIN & MARSHALL COLLEGE             ,PA,17604-0000,Private      ,28,0,28,2251,57,2308
00326600,GANNON UNIVERSITY                       ,PA,16541-0001,Private      ,18,36,54,3119,1251,4370
00326700,GENEVA COLLEGE                          ,PA,15010-3599,Private      ,9,64,73,1761,993,2754
00326800,GETTYSBURG COLLEGE                      ,PA,17325-1486,Private      ,23,1,24,3565,57,3622
00326900,GROVE CITY COLLEGE                      ,PA,16127-0000,Private      ,7,0,7,1719,29,1748
00327000,GWYNEDD-MERCY COLLEGE                   ,PA,19437-0901,Private      ,11,88,99,1479,1170,2649
00327200,HARCUM COLLEGE                          ,PA,19010-3476,Private      ,9,25,34,492,721,1213
00327300,HARRISBURG AREA COMMUNITY COLLEGE       ,PA,17110-2999,Public       ,154,440,594,6016,9204,15220
00327400,HAVERFORD COLLEGE                       ,PA,19041-1392,Private      ,9,0,9,1736,15,1751
00327500,HOLY FAMILY UNIVERSITY                  ,PA,19114-2094,Private      ,16,34,50,1722,1779,3501
00327600,IMMACULATA UNIVERSITY                   ,PA,19345-0647,Private      ,13,88,101,1138,1314,2452
00327700,INDIANA UNIVERSITY OF PENNSYLVANIA      ,PA,15705-1097,Public       ,92,74,166,11420,3356,14776
00327900,JUNIATA COLLEGE                         ,PA,16652-2196,Private      ,10,2,12,1906,83,1989
00328000,KEYSTONE COLLEGE                        ,PA,18440-0200,Private      ,17,36,53,1527,734,2261
00328200,KINGS COLLEGE                           ,PA,18711-0801,Private      ,17,14,31,2574,385,2959
00328300,LACKAWANNA COLLEGE                      ,PA,18509-9961,Private      ,34,28,62,1247,732,1979
00328400,LAFAYETTE COLLEGE                       ,PA,18042-1768,Private      ,16,1,17,3118,48,3166
00328500,LANCASTER BIBLE COLLEGE                 ,PA,17601-5036,Private      ,9,13,22,597,278,875
00328600,LANCASTER THEOLOGICAL SEMINARY          ,PA,17603-0000,Private      ,0,2,2,1,97,98
00328700,LASALLE UNIVERSITY                      ,PA,19141-1199,Private      ,38,71,109,5026,2647,7673
00328800,LEBANON VALLEY COLLEGE                  ,PA,17003-1400,Private      ,12,4,16,2391,185,2576
00328900,LEHIGH UNIVERSITY                       ,PA,18015-1588,Private      ,39,15,54,6680,613,7293
00329000,LINCOLN UNIVERSITY                      ,PA,19352-0999,Public       ,36,27,63,3184,1054,4238
00329100,LUTHERAN THEOLOG SEMINARY-GETTYSBRG     ,PA,17325-0000,Private      ,0,3,3,1,154,155
00329200,LUTHERAN THEOLOGICAL SEMINARY           ,PA,19119-0000,Private      ,0,7,7,0,211,211
00329300,LYCOMING COLLEGE                        ,PA,17701-5192,Private      ,10,2,12,1876,114,1990
00329400,MANOR COLLEGE                           ,PA,19046-3399,Private      ,18,19,37,505,512,1017
00329600,MARYWOOD UNIVERSITY                     ,PA,18509-1598,Private      ,19,45,64,2148,1477,3625
00329700,MERCYHURST COLLEGE                      ,PA,16546-0001,Private      ,33,99,132,4061,1429,5490
00329800,MESSIAH COLLEGE                         ,PA,17027-0800,Private      ,9,2,11,3256,128,3384
00330000,MOORE COLLEGE OF ART & DESIGN           ,PA,19103-1179,Private      ,5,4,9,624,200,824
00330100,MORAVIAN COLLEGE                        ,PA,18018-6650,Private      ,6,7,13,1968,226,2194
00330101,MORAVIAN THEOLOGICAL SEMINARY           ,PA,18018-0000,Private      ,1,2,3,12,65,77
00330200,MOUNT ALOYSIUS COLLEGE                  ,PA,16630-1999,Private      ,14,24,38,1136,905,2041
00330300,CARLOW COLLEGE                          ,PA,15213-3165,Private      ,7,33,40,1236,1574,2810
00330400,MUHLENBERG COLLEGE                      ,PA,18104-5586,Private      ,18,9,27,2907,200,3107
00330600,VALLEY FORGE CHRISTIAN COLLEGE          ,PA,19460-2399,Private      ,9,5,14,847,235,1082
00330900,PEIRCE COLLEGE                          ,PA,19102-4699,Private      ,16,184,200,316,2116,2432
00331100,PENNSYLVANIA COLLEGE OF OPTOMETRY       ,PA,19027-1598,Private      ,0,4,4,12,787,799
00331300,WIDENER UNIVERSITY                      ,PA,19013-5792,Private      ,32,47,79,3838,2033,5871
00331302,WIDENER UNIV SCH OF LAW- HARRISBURG     ,PA,17106-9381,Private      ,0,5,5,4,808,812
00331500,BLOOMSBURG UNIVERSITY OF PA             ,PA,17815-1301,Public       ,104,41,145,8902,1653,10555
00331600,CALIFORNIA UNIV OF PENNSYLVANIA         ,PA,15419-1394,Public       ,54,138,192,5645,3234,8879
00331700,CHEYNEY UNIVERSITY OF PENNSYLVANIA      ,PA,19319-0200,Public       ,49,32,81,2388,857,3245
00331800,CLARION UNIVERSITY OF PENNSYLVANIA      ,PA,16214-1232,Public       ,47,52,99,5087,1808,6895
00332000,EAST STROUDSBURG UNIVERSITY             ,PA,18301-2999,Public       ,56,32,88,6881,1385,8266
00332100,EDINBORO UNIVERSITY OF PENNSYLVANIA     ,PA,16444-0001,Public       ,53,72,125,5481,2848,8329
00332200,KUTZTOWN UNIVERSITY OF PENNSYLVANIA     ,PA,19530-9339,Public       ,69,29,98,9209,1616,10825
00332300,LOCK HAVEN UNIV OF PENNSYLVANIA         ,PA,17745-2439,Public       ,60,53,113,5150,1056,6206
00332400,MANSFIELD UNIVERSITY                    ,PA,16933-1123,Public       ,41,39,80,2932,1155,4087
00332500,MILLERSVILLE UNIVERSITY OF PA           ,PA,17551-1800,Public       ,47,26,73,7197,1679,8876
00332600,SHIPPENSBURG UNIVERSITY                 ,PA,17257-2299,Public       ,56,28,84,6724,1228,7952
00332700,SLIPPERY ROCK UNIVERSITY                ,PA,16057-1326,Public       ,45,58,103,7231,1847,9078
00332800,WEST CHESTER UNIVERSITY                 ,PA,19383-0001,Public       ,132,83,215,11649,2884,14533
00332900,PENN STATE UNIVERSITY                   ,PA,16802-1503,Public       ,801,533,1334,60368,15300,75668
00332901,PENN STATE UNIV-HERSHEY MEDCL CTR       ,PA,17033-0000,Public       ,4,6,10,58,1047,1105
00335000,UNIVERSITY OF THE ARTS (THE)            ,PA,19102-9493,Private      ,23,14,37,2866,518,3384
00335100,PHILADELPHIA BIBLICAL UNIVERSITY        ,PA,19047-2942,Private      ,4,29,33,863,526,1389
00335200,PHILADELPHIA CLG OSTEOPATHIC MED        ,PA,19131-0000,Private      ,0,33,33,19,2319,2338
00335300,UNIVERSITY OF THE SCIENCES IN PHILADELPH,PA,19104-4495,Private      ,20,13,33,3024,773,3797
00335400,PHILADELPHIA UNIVERSITY                 ,PA,19144-5497,Private      ,24,27,51,3556,813,4369
00335600,PITTSBURGH THEOLOGICAL SEMINARY         ,PA,15206-0000,Private      ,1,2,3,1,213,214
00335700,POINT PARK UNIVERSITY                   ,PA,15222-1912,Private      ,24,86,110,2605,2097,4702
00335800,REFORMED PRESBYTERIAN THEOL SEMINAR     ,PA,15208-0000,Private      ,0,1,1,0,40,40
00335900,ROBERT MORRIS UNIVERSITY                ,PA,15108-1189,Private      ,23,75,98,3496,2013,5509
00336000,ROSEMONT COLLEGE                        ,PA,19010-1699,Private      ,7,25,32,493,509,1002
00336200,SETON HILL UNIVERSITY                   ,PA,15601-1599,Private      ,13,28,41,1696,747,2443
00336400,ST. CHARLES BORROMEO SEMINARY           ,PA,19096-0000,Private      ,1,4,5,29,59,88
00336600,SAINT FRANCIS UNIVERSITY                ,PA,15940-0600,Private      ,17,27,44,1755,557,2312
00336700,SAINT JOSEPH'S UNIVERSITY               ,PA,19131-1395,Private      ,48,87,135,5623,1663,7286
00336800,ST VINCENT COLLEGE                      ,PA,15650-2690,Private      ,13,7,20,1831,278,2109
00336900,SUSQUEHANNA UNIVERSITY                  ,PA,17870-1001,Private      ,13,0,13,2316,81,2397
00337000,SWARTHMORE COLLEGE                      ,PA,19081-1397,Private      ,7,0,7,2493,40,2533
00337100,TEMPLE UNIV - MAIN CAMPUS               ,PA,19122-6003,Private      ,268,146,414,23792,6608,30400
00337101,TEMPLE UNIV - SCHOOL OF LAW             ,PA,19122-0000,Private      ,2,7,9,57,2192,2249
00337102,TEMPLE UNIV - SCHOOL OF MEDICINE        ,PA,19140-0000,Private      ,2,6,8,99,1209,1308
00337103,TEMPLE UNIV - SCHOOL OF DENTISTRY       ,PA,19140-0000,Private      ,0,3,3,19,588,607
00337104,TEMPLE UNIV - AMBLER CAMPUS             ,PA,19002-0000,Private      ,15,11,26,851,616,1467
00337105,TEMPLE UNIV - SCH OF ALLIED HEALTH      ,PA,19140-0000,Private      ,3,9,12,333,358,691
00337106,TEMPLE UNIV - SCHOOL OF PHARMACY        ,PA,19140-0000,Private      ,2,7,9,341,630,971
00337107,TEMPLE UNIV - TYLER SCHOOL OF ART       ,PA,19122-0000,Private      ,6,3,9,734,294,1028
00337108,TEMPLE UNIV - GRAD DIV HEALTH SCI       ,PA,19140-0000,Private      ,1,9,10,74,372,446
00337109,TEMPLE UNIV - GRADUATE DIVISION         ,PA,19122-0000,Private      ,3,73,76,145,2727,2872
00337111,TEMPLE UNIV-SCH OF PODIATRIC MED        ,PA,19107-0000,Private      ,0,1,1,9,307,316
00337600,THIEL COLLEGE                           ,PA,16125-2181,Private      ,17,0,17,1583,141,1724
00337800,UNIVERSITY OF PENNSYLVANIA              ,PA,19104-6216,Private      ,90,184,274,11713,10627,22340
00337900,UNIVERSITY OF PITTSBURGH                ,PA,15260-0000,Public       ,202,286,488,22269,9698,31967
00337906,UNIVERSITY OF PITTSBURGH - SCHOOL OF MED,PA,15261-0001,Public       ,0,1,1,48,933,981
00337907,UNIVERSITY OF PITTSBURGH - SCHOOL OF DEN,PA,15261-2523,Public       ,0,0,0,21,371,392
00338400,UNIVERSITY OF SCRANTON                  ,PA,18510-4622,Private      ,41,102,143,5592,1505,7097
00338500,URSINUS COLLEGE                         ,PA,19426-2562,Private      ,21,2,23,2800,75,2875
00338600,VALLEY FORGE MILITARY COLLEGE           ,PA,19087-3695,Private      ,1,0,1,200,16,216
00338800,VILLANOVA UNIVERSITY                    ,PA,19085-1699,Private      ,48,54,102,9668,1650,11318
00338801,VILLANOVA UNIV SCH OF LAW               ,PA,19085-0000,Private      ,1,2,3,11,1458,1469
00338900,WASHINGTON & JEFFERSON COLLEGE          ,PA,15301-4801,Private      ,13,0,13,2346,45,2391
00339100,WAYNESBURG UNIVERSITY                   ,PA,15370-1222,Private      ,14,57,71,1734,787,2521
00339200,WESTMINSTER COLLEGE                     ,PA,16172-0002,Private      ,10,7,17,1769,119,1888
00339300,WESTMINSTER THEOLOGICAL SEMINARY        ,PA,19038-0000,Private      ,0,6,6,2,234,236
00339400,WILKES UNIVERSITY                       ,PA,18766-0998,Private      ,18,25,43,3136,775,3911
00339500,PENNSYLVANIA COLLEGE OF TECHNOLOGY      ,PA,17701-5779,Public       ,35,39,74,5278,2157,7435
00339600,WILSON COLLEGE                          ,PA,17201-1285,Private      ,4,22,26,333,375,708
00339900,YORK COLLEGE OF PENNSYLVANIA            ,PA,17405-7199,Private      ,40,29,69,5162,1052,6214
00398600,DESALES UNIVERSITY                      ,PA,18034-9568,Private      ,9,50,59,2080,965,3045
00398700,LA ROCHE COLLEGE                        ,PA,15237-5898,Private      ,12,6,18,1082,455,1537
00398800,NEUMANN COLLEGE                         ,PA,19014-1298,Private      ,14,58,72,2418,921,3339
00405800,GRATZ COLLEGE                           ,PA,19027-3097,Private      ,0,9,9,1,100,101
00445200,MONTGOMERY COUNTY COMMUNITY COLLEGE     ,PA,19422-6300,Public       ,64,132,196,2506,2739,5245
00488600,ELECTRONIC INSTITUTES                   ,PA,17057-9984,Private      ,0,0,0,1,1,2
00488700,BRANDYWINE SCHOOL OF NURSING            ,PA,19320-1536,Proprietary  ,0,1,1,37,69,106
00488900,CAMBRIA-ROWE BUSINESS COLLEGE           ,PA,15902-2494,Proprietary  ,7,24,31,200,311,511
00489000,CENTRAL PENNSYLVANIA COLLEGE            ,PA,17093-0309,Proprietary  ,27,57,84,1037,617,1654
00489300,DU BOIS BUSINESS COLLEGE                ,PA,15801-2401,Proprietary  ,8,24,32,223,300,523
00489400,ERIE BUSINESS CENTER                    ,PA,16501-1305,Proprietary  ,9,43,52,136,538,674
00489401,ERIE BUSINESS CENTER SOUTH              ,PA,16101-0000,Proprietary  ,4,9,13,49,128,177
00489800,MCCANN SCHOOL OF BUSINESS & TECHNOL     ,PA,17901-1335,Proprietary  ,63,251,314,723,1801,2524
00489900,MERCY HOSP SCH OF NURSING               ,PA,15219-5166,Private      ,2,2,4,102,83,185
00490100,NEWPORT BUSINESS INSTITUTE              ,PA,15068-3929,Proprietary  ,2,9,11,27,80,107
00490200,PENN COMMERCIAL BUSINESS/TECHNICAL SCHL ,PA,15301-2871,Proprietary  ,16,55,71,256,485,741
00491000,KAPLAN CAREER INSTITUTE                 ,PA,17111-3571,Proprietary  ,19,74,93,280,605,885
00491001,THOMPSON INSTITUTE-PHILADEPHIA CAMPUS   ,PA,19104-3386,Proprietary  ,43,178,221,314,1222,1536
00491002,THOMPSON INSTITUTE-CHAMBERSBURG         ,PA,17201-0000,Proprietary  ,0,0,0,1,0,1
00491400,NEWPORT BUSINESS INSTITUTE              ,PA,17701-5855,Proprietary  ,0,13,13,50,142,192
00500701,WEST VIRGINIA CAREER INSTITUTE          ,PA,15456-0000,Proprietary  ,14,24,38,93,213,306
00531000,PITTSBURGH INST OF AERONAUTICS          ,PA,15236-0000,Private      ,9,9,18,206,133,339
00533000,FAYETTE CNTY AREA VOC TECH PRC NRSG     ,PA,15401-0000,Public       ,1,7,8,19,118,137
00533500,CENTRAL PENN INST OF SCI & TECH PNP     ,PA,16823-0000,Public       ,0,6,6,23,76,99
00534100,UPPER BUCKS CO AREA VOC-TECH SCHOOL     ,PA,18944-0000,Public       ,0,0,0,1,5,6
00536500,YORK CO AREA VOC-TECH SCH-PRAC NSG      ,PA,17402-0000,Public       ,1,11,12,22,129,151
00594200,UPMC PRESBYTERIAN SCH OF RADIOLOGIC     ,PA,15213-2582,Private      ,0,2,2,34,44,78
00594600,SCHOOL OF RADIOLOGIC TECHNOLOGY AT ST. C,PA,19134-1995,Proprietary  ,0,1,1,35,45,80
00653400,CITIZENS SCHOOL OF NURSING              ,PA,15068-6591,Private      ,1,3,4,40,111,151
00653700,CONEMAUGH VLY MEM HOSP SCH NRSNG        ,PA,15905-4398,Private      ,0,0,0,91,105,196
00653702,CONEMAUGH HOSP- SCH HISTOTECHNOLOGY     ,PA,15905-0000,Private      ,0,0,0,6,5,11
00653704,CONEMAUGH VLY MEM HOSP SCH RAD TECH     ,PA,15905-0000,Private      ,0,1,1,29,19,48
00653706,CONEMAUGH VLY MEM HOSP SCH  MED TECH    ,PA,15905-4398,Private      ,0,0,0,5,4,9
00653900,EPISCOPAL HOSPITAL SCHL OF NURSING      ,PA,19125-1000,Private      ,1,3,4,51,297,348
00655100,ST MARGARET SCHL OF NURSING             ,PA,15238-3205,Private      ,6,9,15,73,171,244
00656000,OHIO VALLEY HOSP SCH OF NURSING         ,PA,15136-1694,Private      ,0,1,1,19,57,76
00656500,READING HOSPITAL SCHOOL OF HEALTH SCIENC,PA,19611-1744,Private      ,1,4,5,146,289,435
00657400,"ST LUKE'S HOSPITAL OF BETHLEHEM, PA     ",PA,18015-1065,Private      ,0,1,1,75,120,195
00657600,SEWICKLEY VALLEY HOSP SCH NRSNG         ,PA,15143-1498,Private      ,0,1,1,51,89,140
00657602,HVHS SCHOOL OF RADIOLOGIC TECHNOLOGY    ,PA,15143-0000,Private      ,0,0,0,12,8,20
00657700,UPMC SHADYSIDE SCHOOL OF NURSING        ,PA,15232-1381,Private      ,6,25,31,98,343,441
00657800,SHARON REGIONAL SCHOOL OF NURSING       ,PA,16146-3395,Private      ,0,1,1,24,69,93
00658200,WASHINGTON HOSP SCH OF NURSING          ,PA,15301-3398,Private      ,0,0,0,71,143,214
00658202,WASHINGTON HOSP SCH OF RAD TECH         ,PA,15301-3398,Private      ,0,0,0,21,19,40
00658300,WESTERN PENN HOSP-SCH OF NURSING        ,PA,15224-1790,Private      ,2,2,4,117,114,231
00680700,COMMUNITY COLLEGE OF BEAVER COUNTY      ,PA,15061-2588,Public       ,16,73,89,1010,1185,2195
00681000,LEHIGH CARBON COMMUNITY COLLEGE         ,PA,18078-2598,Public       ,63,125,188,2480,2383,4863
00681100,LUZERNE COUNTY COMMUNITY COLLEGE        ,PA,18634-3899,Public       ,83,130,213,2677,2520,5197
00708700,ABINGTON MEM HOSP SCHL OF NURSING       ,PA,19090-1284,Private      ,1,6,7,93,163,256
00709000,METHODIST HOSPITAL SCH OF NURSING       ,PA,19148-3594,Private      ,0,0,0,14,34,48
00709100,EVEREST INSTITUTE                       ,PA,15222-1320,Proprietary  ,22,129,151,219,977,1196
00711000,DELAWARE COUNTY COMMUNITY COLLEGE       ,PA,19063-1094,Public       ,100,165,265,3074,3617,6691
00719100,NORTHAMPTON COMMUNITY COLLEGE           ,PA,18020-7599,Public       ,83,126,209,3532,3198,6730
00739802,KATHERINE GIBBS-PHILADELPHIA            ,PA,19403-2422,Proprietary  ,1,1,2,54,46,100
00743000,ANTONELLI INST OF ART & PHOTOGRAPHY     ,PA,19038-8242,Proprietary  ,1,1,2,214,21,235
00743600,KAPLAN CAREER INSTITUTE - ICM CAMPUS    ,PA,15222-1977,Proprietary  ,37,105,142,548,1473,2021
00743700,PITTSBURGH TECHNICAL INSTITUTE          ,PA,15071-3205,Proprietary  ,40,46,86,2206,876,3082
00746900,"HUSSIAN SCHOOL OF ART, INC.             ",PA,19106-0000,Proprietary  ,2,0,2,163,17,180
00747000,"ART INSTITUTE OF PITTSBURGH, THE        ",PA,15219-1328,Proprietary  ,424,2272,2696,4830,11086,15916
00752900,CTR ART TCH BRDYWN CMPS PRC NRS PRG     ,PA,19320-2459,Public       ,0,4,4,26,129,155
00775900,LINCOLN TECHNICAL INSTITUTE             ,PA,18104-3298,Proprietary  ,37,73,110,384,522,906
00777900,LANSDALE SCHOOL OF BUSINESS             ,PA,19454-4148,Proprietary  ,15,45,60,104,318,422
00778000,NEW CASTLE SCHOOL OF TRADES             ,PA,16143-9721,Proprietary  ,39,73,112,243,514,757
00778100,CHI INSTITUTE/RETS CAMPUS               ,PA,19008-3516,Proprietary  ,36,124,160,368,1075,1443
00782600,BEREAN INSTITUTE                        ,PA,19130-1526,Private      ,13,24,37,119,131,250
00783200,LINCOLN TECH INSTITUTE                  ,PA,19136-1595,Proprietary  ,44,61,105,506,530,1036
00783900,TRIANGLE TECH                           ,PA,15214-3897,Proprietary  ,21,30,51,256,281,537
00791200,THADDEUS STEVENS CLG OF TECHNOLOGY      ,PA,17602-0000,Public       ,11,5,16,777,239,1016
00791600,FRANKLIN CNTY CAREER & TECH CTR-PNP     ,PA,17201-0000,Public       ,3,7,10,11,37,48
00820000,JAMESON MEMORIAL HOSP SCH NURSING       ,PA,16105-2595,Private      ,1,0,1,52,99,151
00826301,AWARD BEAUTY SCHOOL - CHAMBERSBURG BEAUT,PA,17201-2435,Proprietary  ,0,0,0,3,2,5
00835000,ART INSTITUTE OF PHILADELPHIA           ,PA,19103-5198,Proprietary  ,106,103,209,3625,1775,5400
00844100,ANTHEM INSTITUTE                        ,PA,19064-1243,Proprietary  ,68,182,250,443,933,1376
00856800,VET TECH INSTITUTE                      ,PA,15222-3400,Proprietary  ,7,6,13,296,110,406
00865300,JEFFERSON CO DUBOIS VOC TECH-PR NSG     ,PA,15851-0000,Public       ,0,0,0,15,58,73
00888900,LEHIGH VALLEY COLLEGE                   ,PA,18034-8447,Proprietary  ,33,62,95,863,824,1687
00895500,PRUONTOS HAIR DESIGN INSTITUTE & BEAUTY ,PA,16602-0000,Proprietary  ,1,4,5,26,20,46
00918600,DEAN INSTITUTE OF TECHNOLOGY            ,PA,15226-1197,Proprietary  ,2,18,20,51,132,183
00944900,PENNCO TECH                             ,PA,19007-0000,Proprietary  ,46,79,125,422,486,908
00966400,EMPIRE BEAUTY SCHOOL                    ,PA,18052-5730,Proprietary  ,15,32,47,189,324,513
00966500,EMPIRE BEAUTY SCHOOL                    ,PA,17109-2210,Proprietary  ,7,27,34,104,174,278
00966600,EMPIRE BEAUTY SCHOOL                    ,PA,19605-2803,Proprietary  ,16,32,48,123,214,337
00972100,BRADFORD SCHOOL                         ,PA,15219-2602,Proprietary  ,1,1,2,569,87,656
00972300,FRANKFORD HOSP SCH OF NURSING           ,PA,19124-2696,Private      ,5,4,9,214,275,489
00973700,UPHS PRESBYTERIAN MC SCH PRACTL NRS     ,PA,19104-2692,Private      ,0,0,0,0,6,6
00978300,GORDON PHILLIPS SCH OF BEAUTY CULT      ,PA,19135-0000,Proprietary  ,42,60,102,231,322,553
00986300,LANCASTER GENERAL COLLEGE OF NURSING AND,PA,17602-4955,Private      ,2,7,9,209,314,523
01000600,GREATER JOHNSTOWN AREA VOC TECH SCH     ,PA,15904-0000,Public       ,4,24,28,54,185,239
01005500,CRAWFORD CNTY AREA VO-TECH PRAC NUR     ,PA,16335-0000,Public       ,0,0,0,5,33,38
01017600,WESTMORELAND COUNTY COMMUNITY CLG       ,PA,15697-1895,Public       ,78,183,261,1987,2562,4549
01038800,READING AREA COMMUNITY COLLEGE          ,PA,19603-1706,Public       ,85,252,337,1385,2762,4147
01054100,EMPIRE BEAUTY SCHOOL                    ,PA,15146-2229,Proprietary  ,28,41,69,222,297,519
01054200,EMPIRE BEAUTY SCHOOL                    ,PA,18701-0000,Proprietary  ,12,22,34,175,176,351
01054300,EMPIRE BEAUTY SCHOOL                    ,PA,17701-3914,Proprietary  ,14,32,46,135,191,326
01081400,PITTSBURGH INST MORTUARY SCIENCE        ,PA,15206-3706,Private      ,2,13,15,69,147,216
01086000,GREATER ALTOONA CAREER/TECH CENTER      ,PA,16602-0000,Public       ,0,1,1,55,136,191
01096300,GREENE COUNTY VOC-TECH SCHOOL           ,PA,15370-0000,Public       ,0,1,1,5,45,50
01097000,EMPIRE BEAUTY SCHOOL                    ,PA,17042-5209,Proprietary  ,2,3,5,24,29,53
01099800,PENNSYLVANIA INSTITUTE OF TECH          ,PA,19063-4098,Private      ,34,149,183,394,640,1034
01102000,EMPIRE BEAUTY SCHOOL                    ,PA,17604-4335,Proprietary  ,6,12,18,65,83,148
01102100,EMPIRE BEAUTY SCHOOL                    ,PA,17402-2862,Proprietary  ,16,52,68,178,333,511
01162100,AUTOMOTIVE TRAINING CENTER              ,PA,19341-1310,Proprietary  ,37,31,68,669,185,854
01162200,WELDER TRAINING & TESTING INST          ,PA,18109-3253,Proprietary  ,9,11,20,22,31,53
01163800,EMPIRE BEAUTY SCHOOL                    ,PA,17876-0000,Proprietary  ,1,13,14,44,61,105
01171500,POTTSVILLE HOSPITAL SCHOOL OF NURSING   ,PA,17901-3692,Private      ,0,0,0,38,48,86
01191900,BEAVER FALLS BEAUTY ACADEMY             ,PA,15010-4208,Proprietary  ,4,6,10,24,39,63
01205000,ROSEDALE TECHNICAL INSTITUTE            ,PA,15205-9791,Private      ,20,17,37,182,167,349
01239300,THOMAS JEFF UNIV-CLG ALLIED HEALTH      ,PA,19107-0000,Private      ,3,10,13,344,615,959
01239301,JEFFERSON MED CLG-T. JEFFERSON UNIV     ,PA,19107-5587,Private      ,0,5,5,126,1243,1369
01239303,THOMAS JEFFERSON UNIV-GRADUATE COLG     ,PA,19107-0000,Private      ,0,14,14,119,768,887
01246104,LINCOLN TECHNICAL INSTITUTE             ,PA,19104-0202,Proprietary  ,45,110,155,310,758,1068
01246105,LINCOLN TECHNICAL INSTITUTE             ,PA,19116-4202,Proprietary  ,17,73,90,198,424,622
01246106,THE CITTONE INSTITUTE                   ,PA,19462-1326,Proprietary  ,20,40,60,179,392,571
01252300,TALMUDICAL YESHIVA OF PHILA             ,PA,19131-1296,Private      ,26,0,26,28,0,28
01260500,EMPIRE BEAUTY SCHOOL                    ,PA,17331-2405,Proprietary  ,2,6,8,64,57,121
01260600,EMPIRE BEAUTY SCHOOL                    ,PA,17901-2505,Proprietary  ,19,43,62,95,261,356
01260700,EMPIRE BEAUTY SCHOOL                    ,PA,16801-5218,Proprietary  ,0,3,3,15,29,44
01292900,SOUTH HILLS BEAUTY ACADEMY              ,PA,15216-2335,Proprietary  ,4,12,16,43,82,125
01301500,GORDON PHILLIPS SCH BEAUTY CULTURE      ,PA,19102-2701,Proprietary  ,22,73,95,239,448,687
01313400,YESHIVATH BETH MOSHE                    ,PA,18505-2196,Private      ,4,0,4,33,1,34
01321400,ROXBOROUGH MEM HOSP SCH OF NURSING      ,PA,19128-0000,Proprietary  ,1,1,2,42,168,210
01326300,SOUTH HILLS SCH OF BUS & TECHNOLOGY     ,PA,16801-4516,Proprietary  ,3,3,6,476,430,906
01326304,SOUTH HILLS SCHOOL OF BUSINESS & TECHNOL,PA,16602-1188,Proprietary  ,0,2,2,34,32,66
02061000,VENUS BEAUTY ACADEMY                    ,PA,19079-0000,Proprietary  ,7,15,22,84,62,146
02068300,DOUGLAS SCHOOL OF BUSINESS              ,PA,15062-0000,Proprietary  ,10,19,29,203,220,423
02090200,TRIANGLE TECH                           ,PA,16502-0000,Proprietary  ,12,23,35,128,182,310
02092500,LAUREL TECHNICAL INSTITUTE              ,PA,16146-0000,Proprietary  ,1,15,16,25,115,140
02092502,BUSINESS INSTITUTE OF PENNSYLVANIA      ,PA,16335-0000,Proprietary  ,0,11,11,16,100,116
02107300,PENNSYLVANIA ACADEMY OF FINE ARTS       ,PA,19102-1424,Private      ,1,0,1,144,208,352
02112200,GREAT LAKES INSTITUTE OF TECHNOLOGY     ,PA,16509-0000,Proprietary  ,16,73,89,258,451,709
02114200,JOHNSON COLLEGE                         ,PA,18508-0000,Private      ,2,2,4,348,132,480
02116001,SANFORD-BROWN INSTITUTE - TREVOSE       ,PA,19053-4700,Proprietary  ,30,173,203,367,1104,1471
02118000,LEVITTOWN BEAUTY ACADEMY LLC            ,PA,19054-1713,Proprietary  ,4,8,12,41,56,97
02119300,PA ACAD OF COSMETOLOGY ARTS & SCI       ,PA,15904-0000,Proprietary  ,9,15,24,55,85,140
02119301,PA ACAD OF COSMTLGY ARTS & SCI          ,PA,15801-0000,Proprietary  ,0,0,0,6,2,8
02120800,"YORKTOWNE BUSINESS INSTITUTE, INC.      ",PA,17404-0000,Proprietary  ,7,28,35,117,309,426
02127400,YORK TECHNICAL INSTITUTE                ,PA,17402-0000,Proprietary  ,46,81,127,1374,1162,2536
02129000,TRIANGLE TECH                           ,PA,15601-0000,Proprietary  ,15,37,52,302,291,593
02129001,TRIANGLE TECH - BUSINESS CAREERS INSTITU,PA,15601-3304,Proprietary  ,0,0,0,1,3,4
02144000,"VISION ACADEMY, THE                     ",PA,18103-0000,Proprietary  ,4,22,26,46,66,112
02147800,SCHUYLKILL INST BUSINESS & TECHNLGY     ,PA,17901-0000,Proprietary  ,0,1,1,50,92,142
02149000,EMPIRE BEAUTY SCHOOL                    ,PA,19341-2804,Proprietary  ,16,28,44,116,145,261
02151500,CENTRAL SUSQUEHANNA LPN CENTER          ,PA,17847-0000,Public       ,0,2,2,27,148,175
02153500,OAKBRIDGE ACADEMY OF ARTS               ,PA,15068-0000,Proprietary  ,4,1,5,66,24,90
02158300,JUNIATA-MIFFLIN CO AREA VOC TECH        ,PA,17044-0000,Public       ,6,7,13,23,58,81
02161400,NORTHEASTERN HOSP SCH OF NRSG           ,PA,19134-0000,Private      ,1,3,4,37,135,172
02169600,CLEARFIELD CTY CAREER AND TECH CNTR     ,PA,16830-0000,Public       ,1,13,14,19,73,92
02174400,TRIANGLE TECH                           ,PA,15801-0000,Proprietary  ,22,25,47,330,291,621
02178900,ACADEMY OF HAIR DESIGN                  ,PA,18202-1465,Proprietary  ,2,6,8,14,18,32
02183000,ORLEANS TECHNICAL INSTITUTE             ,PA,19111-0000,Private      ,32,98,130,190,576,766
02186705,HARRISON CAREER INSTITUTE               ,PA,18704-0000,Proprietary  ,0,0,0,0,2,2
02192800,WALNUT HILL COLLEGE                     ,PA,19104-0000,Proprietary  ,24,15,39,503,228,731
02202300,SANFORD-BROWN INSTITUTE                 ,PA,15219-1907,Proprietary  ,28,122,150,336,759,1095
02202301,SANFORD-BROWN INSTITUTE                 ,PA,15146-2141,Proprietary  ,21,62,83,301,550,851
02203900,ERIE INSTITUTE OF TECHNOLOGY            ,PA,16565-1002,Proprietary  ,3,13,16,108,135,243
02206200,AMBLER BEAUTY ACADEMY                   ,PA,19002-0000,Proprietary  ,4,15,19,36,66,102
02206300,STROUDSBURG SCHOOL OF COSMETOLOGY       ,PA,18360-0000,Proprietary  ,3,3,6,18,37,55
02212700,LANCASTER SCHOOL OF COSMETOLOGY         ,PA,17602-0000,Proprietary  ,7,35,42,45,143,188
02213400,PROFESSIONAL SKILLS CAREER ACADEMY      ,PA,16148-0000,Proprietary  ,3,2,5,21,18,39
02234200,ACADEMY OF MEDICAL ARTS & BUSINESS      ,PA,17112-0000,Proprietary  ,8,24,32,89,205,294
02251200,SCHUYLKILL COUNTY AREA VOC TECH SCH     ,PA,17931-0000,Public       ,3,4,7,33,122,155
02251202,SCHUYLKILL COUNTY AREA VOC TECH SCH     ,PA,17931-0000,Public       ,1,10,11,19,49,68
02253900,BERKS TECHNICAL INSTITUTE               ,PA,19610-0000,Proprietary  ,22,57,79,450,647,1097
02255200,PENNSYLVANIA SCHOOL OF BUSINESS         ,PA,18101-1604,Proprietary  ,37,95,132,166,387,553
02269900,PENNSYLVANIA COLLEGE OF ART & DESIGN    ,PA,17603-3528,Private      ,1,0,1,283,60,343
02270500,BUCKS COUNTY SCHOOL OF BEAUTY CULT      ,PA,19053-0000,Proprietary  ,5,4,9,38,38,76
02273400,RECONSTRUCTIONIST RABBINICAL COLLEG     ,PA,19095-0000,Private      ,0,0,0,0,44,44
02276600,HANOVER PUBLIC SCH DIST PRAC NURSG      ,PA,17331-0000,Public       ,1,0,1,14,48,62
02282500,LENAPE SCHOOL OF PRACTICAL NURSING      ,PA,16226-0000,Public       ,2,19,21,40,163,203
02288800,EMPIRE BEAUTY SCHOOL                    ,PA,18974-4508,Proprietary  ,8,11,19,56,62,118
02289500,PACE INSTITUTE                          ,PA,19601-0000,Proprietary  ,2,31,33,43,229,272
02289600,CONSOLIDATED SCHOOL OF BUSINESS         ,PA,17404-0000,Proprietary  ,2,13,15,62,147,209
02289700,ACADEMY OF CREATIVE HAIR DESIGN         ,PA,18702-0000,Proprietary  ,9,5,14,50,47,97
02289800,CHI INSTITUTE - FRANKLIN MILLS          ,PA,19154-0000,Proprietary  ,52,138,190,427,816,1243
02290400,"ALTOONA BEAUTY SCHOOL, INC              ",PA,16602-0000,Proprietary  ,3,8,11,30,48,78
02292700,LANSDALE SCHOOL OF COSMETOLOGY          ,PA,19446-0000,Proprietary  ,4,8,12,25,33,58
02299300,TRINITY EPISCOPAL SCHOOL MINISTRY       ,PA,15003-0000,Private      ,0,4,4,0,48,48
02301300,PJA SCHOOL (THE)                        ,PA,19082-1917,Proprietary  ,13,36,49,80,343,423
02304400,YTI CAREER INSTITUTE - MECHANICSBURG    ,PA,17055-0000,Proprietary  ,15,49,64,218,481,699
02306200,VENANGO COUNTY AREA VOC TECH SCHOOL     ,PA,16301-0000,Public       ,0,0,0,13,28,41
02310800,LANCASTER COUNTY CAREER & TECH CTR      ,PA,17584-0000,Public       ,9,29,38,109,369,478
02330300,LEBANON CO CAREER & TECHNOLOGY CTR      ,PA,17042-0000,Public       ,0,3,3,22,110,132
02330600,PENNSYLVANIA GUNSMITH SCHOOL            ,PA,15202-0000,Proprietary  ,1,3,4,23,40,63
02350100,WESTERN AREA CAREER & TECHNOLOGY CT     ,PA,15317-0000,Public       ,1,0,1,15,76,91
02350200,INDIANA COUNTY TECH CTR SCH PR NSG      ,PA,15701-1465,Public       ,1,2,3,21,37,58
02353100,NORTHERN TIER CAREER CENTER             ,PA,18848-0000,Public       ,1,2,3,13,53,66
02361002,ITT TECHNICAL INSTITUTE                 ,PA,19406-0000,Proprietary  ,28,41,69,302,383,685
02362300,MERCER COUNTY AREA VOC TECH SCHOOL      ,PA,16137-0000,Public       ,0,0,0,19,76,95
02492500,DELAWARE VLY ACAD MED DNTL ASSTS        ,PA,19114-0000,Proprietary  ,9,31,40,64,183,247
02492600,EASTERN CTR ARTS AND TECH PR NSG        ,PA,19090-0000,Public       ,2,1,3,21,130,151
02495500,ALL-STATE CAREER SCHOOL                 ,PA,19029-0000,Proprietary  ,29,211,240,114,926,1040
02529800,WILKES BARRE AREA CAREER AND TECHNICAL C,PA,18705-0000,Public       ,3,31,34,37,190,227
02530400,CLEARFIELD BEAUTY ACADEMY               ,PA,16830-0000,Proprietary  ,0,0,0,1,1,2
02536600,COMMONWEALTH TECH INSTIT @ HIRAM G      ,PA,15905-0000,Public       ,30,10,40,271,148,419
02539900,STAR TECHNICAL INSTITUTE                ,PA,19082-0000,Proprietary  ,4,47,51,34,248,282
02544300,BUTLER BEAUTY SCHOOL                    ,PA,16001-0000,Proprietary  ,4,19,23,62,120,182
02545000,LAWRENCE COUNTY CAREER AND TECHNICAL CEN,PA,16101-0000,Public       ,0,6,6,11,79,90
02546200,LAUREL BUSINESS INSTITUTE               ,PA,15401-0877,Proprietary  ,9,25,34,180,295,475
02550000,CLARION CO AREA VOC-TECH PRAC NRSG      ,PA,16254-0000,Public       ,0,0,0,18,48,66
02554500,HAZLETON AREA CAREER CENTER PRACTICAL NU,PA,18201-0000,Public       ,0,1,1,18,46,64
02557800,ART INSTITUTE OF YORK (THE) - PENNSYLVAN,PA,17402-9012,Proprietary  ,25,19,44,645,231,876
02558701,PRISM CAREER INSTITUTE - PHL CAMPUS     ,PA,19152-0000,Proprietary  ,0,1,1,3,9,12
02566400,ALBERT EINSTEIN MED CTR DEPT DNTL       ,PA,19141-3098,Private      ,0,2,2,8,11,19
02574800,PENNSYLVANIA INSTITUTE OF TAXIDERMY     ,PA,15931-0000,Proprietary  ,3,6,9,14,35,49
02609500,CAREER TRAINING ACADEMY                 ,PA,15068-6308,Proprietary  ,7,34,41,89,246,335
02609501,CAREER TRAINING ACADEMY                 ,PA,15146-0000,Proprietary  ,1,0,1,11,6,17
02615400,STAR TECHNICAL INSTITUTE                ,PA,19114-2204,Proprietary  ,10,69,79,122,528,650
02616100,JEAN MADELINE ED CTR FOR COSM           ,PA,19147-1542,Proprietary  ,7,18,25,275,198,473
03006800,PENNSYLVANIA CULINARY INSTITUTE         ,PA,15222-3511,Proprietary  ,118,247,365,1482,1660,3142
03010800,TRI-STATE BUSINESS INSTITUTE            ,PA,16506-1013,Proprietary  ,28,172,200,492,1746,2238
03011500,ALLIED MEDICAL AND TECHNICAL INSTITUTE  ,PA,18702-0000,Proprietary  ,15,69,84,144,298,442
03011600,ALLIED MEDICAL AND TECHNICAL INSTITUTE  ,PA,18509-2903,Proprietary  ,18,69,87,158,319,477
03021001,HARRISON CAREER INSTITUTE.              ,PA,18103-0000,Proprietary  ,0,0,0,12,41,53
03029900,CONSOLIDATED SCHOOL OF BUSINESS         ,PA,17603-2389,Proprietary  ,4,28,32,96,223,319
03031600,DPT BUSINESS SCHOOL                     ,PA,19116-3961,Proprietary  ,13,185,198,100,942,1042
03031601,DPT BUSINESS SCHOOL                     ,PA,19106-0000,Proprietary  ,30,104,134,110,521,631
03067000,ANTONELLI MEDICAL & PROF INST           ,PA,19464-9244,Proprietary  ,1,12,13,8,55,63
03072400,ALL-STATE CAREER SCHOOL                 ,PA,15122-1000,Proprietary  ,5,48,53,17,215,232
03072600,DCI CAREER INSTITUTE                    ,PA,15061-2307,Proprietary  ,6,36,42,35,189,224
03081900,YTI CAREER INSTITUTE - ALTOONA          ,PA,16602-4457,Proprietary  ,14,48,62,143,405,548
03085200,HARRISON CAREER INSTITUTE               ,PA,19103-5402,Proprietary  ,1,2,3,9,59,68
03090800,LAKE ERIE COLL OF OSTEOPATHIC MED       ,PA,16509-0000,Private      ,0,6,6,121,2150,2271
03098600,CAREER TECH CTR OF LACKAWANNA CNTY      ,PA,18508-0000,Public       ,1,2,3,21,116,137
03101500,BIDWELL TRAINING CENTER                 ,PA,15233-2233,Private      ,3,15,18,9,60,69
03103300,JNA INSTITUTE OF CULINARY ARTS          ,PA,19146-3119,Proprietary  ,6,13,19,67,109,176
03109100,METROPOLITAN CAREER CENTER              ,PA,19144-0000,Private      ,6,11,17,32,154,186
03110700,AVIATION INSTITUTE OF MAINTENANCE       ,PA,19114-1017,Proprietary  ,16,42,58,123,280,403
03120400,REGIONAL CAREER & TECHNICAL CENTER      ,PA,16509-4699,Public       ,0,0,0,3,3,6
03126000,CENTER FOR INNOVATIVE TRAINING & ED     ,PA,19106-4414,Proprietary  ,0,6,6,1,22,23
03128400,DELAWARE COUNTY TECHNICAL SCHOOL        ,PA,19032-1998,Public       ,1,6,7,23,145,168
03128800,GECAC TRAINING INSTITUTE                ,PA,16502-1137,Private      ,2,4,6,9,53,62
03180400,PENNSYLVANIA HIGHLANDS COMMUNITY COLLEGE,PA,15904-2927,Public       ,20,45,65,490,633,1123
03236400,LT INTERNATIONAL BEAUTY SCHOOL          ,PA,19130-2235,Proprietary  ,2,40,42,20,159,179
03353300,ACADEMY OF VOCAL ARTS                   ,PA,19103-6685,Private      ,0,0,0,5,34,39
03439400,NAWCC SCHOOL OF HOROLOGY                ,PA,17512-2130,Private      ,0,1,1,2,5,7
03471400,NORTH CENTRAL INDUSTRIAL TECHNICAL      ,PA,15853-9708,Private      ,0,0,0,19,36,55
03503300,WINNER INSTITUTE OF ARTS & SCIENCES     ,PA,16154-1811,Private      ,2,10,12,31,51,82
03535300,HUNTINGDON COUNTY CAREER AND TECHNO     ,PA,17060-0905,Public       ,0,1,1,5,33,38
03561400,SUSQUEHANNA COUNTY CAREER & TECHNOL     ,PA,18816-0100,Public       ,0,0,0,4,13,17
03661300,SPRINGHOUSE COMPUTER SCHOOL             ,PA,19341-1129,Proprietary  ,0,0,0,2,2,4
03766300,PENNSYLVANIA SCHOOL OF MUSCLE THERAPY   ,PA,19406-3101,Proprietary  ,6,15,21,30,84,114
03781300,PRINCETON INFORMATION TECHNOLOGY CENTER ,PA,19038-4535,Proprietary  ,0,0,0,0,1,1
03899300,CALVARY BAPTIST THEOLOGICAL SEMINARY    ,PA,19446-4718,Private      ,0,3,3,2,13,15
03923300,PRECISION MANUFACTURING INSTITUTE       ,PA,16335-8380,Private      ,1,10,11,8,33,41
03948300,HARRISBURG UNIVERSITY OF SCIENCE AND TEC,PA,17101-2116,Private      ,6,2,8,6,4,10
03949300,WON INSTITUTE OF GRADUATE STUDIES       ,PA,19038-4535,Private      ,0,0,0,0,19,19
03950500,NORTHWEST REGIONAL TECHNOLOGY INSTITUTE ,PA,16508-2820,Proprietary  ,0,15,15,7,71,78
03952300,NATIONAL MASSAGE THERAPY INSTITUTE      ,PA,19116-3965,Proprietary  ,0,3,3,101,339,440
04119900,PENNSYLVANIA MYOTHERAPY INSTITUTE       ,PA,17350-8426,Proprietary  ,0,1,1,0,1,1
00267813,BRYANT & STRATTON COLLEGE - MIL DOWNTOWN,WI,53203-2608,Proprietary  ,24,114,138,378,1433,1811
00383200,ALVERNO COLLEGE                         ,WI,53234-3922,Private      ,22,69,91,1341,2016,3357
00383500,BELOIT COLLEGE                          ,WI,53511-5595,Private      ,8,3,11,1731,96,1827
00383700,CARDINAL STRITCH UNIVERSITY             ,WI,53217-9884,Private      ,16,550,566,824,4421,5245
00383800,CARROLL UNIVERSITY                      ,WI,53186-5593,Private      ,13,18,31,2916,702,3618
00383900,CARTHAGE COLLEGE                        ,WI,53141-0000,Private      ,34,24,58,3201,516,3717
00384000,WESTERN TECHNICAL COLLEGE               ,WI,54601-0908,Public       ,55,87,142,1658,2009,3667
00384200,CONCORDIA UNIVERSITY WISCONSIN          ,WI,53097-2402,Private      ,11,198,209,1825,2432,4257
00384800,EDGEWOOD COLLEGE                        ,WI,53711-1958,Private      ,17,43,60,1353,1043,2396
00385000,SILVER LAKE COLLEGE                     ,WI,54220-9319,Private      ,1,23,24,133,412,545
00385400,LAKELAND COLLEGE                        ,WI,53082-0000,Private      ,10,68,78,1037,1649,2686
00385600,LAWRENCE UNIVERSITY                     ,WI,54912-0599,Private      ,12,0,12,1956,81,2037
00386100,MARIAN UNIVERSITY                       ,WI,54935-4699,Private      ,13,88,101,1182,1255,2437
00386300,MARQUETTE UNIVERSITY                    ,WI,53201-0000,Private      ,49,80,129,9353,3583,12936
00386600,MILWAUKEE AREA TECH COLLEGE             ,WI,53233-1443,Public       ,227,551,778,4695,11292,15987
00386800,MILWAUKEE SCHOOL OF ENGINEERING         ,WI,53202-3109,Private      ,25,18,43,2170,571,2741
00386900,MOUNT MARY COLLEGE                      ,WI,53222-4597,Private      ,10,32,42,750,1095,1845
00387400,NASHOTAH HOUSE                          ,WI,53058-0000,Private      ,0,1,1,0,48,48
00387500,NORTHLAND COLLEGE                       ,WI,54806-3999,Private      ,5,6,11,1007,162,1169
00388400,RIPON COLLEGE                           ,WI,54971-0248,Private      ,10,2,12,1177,49,1226
00389200,ST. NORBERT COLLEGE                     ,WI,54115-2002,Private      ,10,3,13,2019,102,2121
00389500,UNIVERSITY OF WISCONSIN-MADISON         ,WI,53715-1382,Public       ,219,198,417,18871,10290,29161
00389600,UNIVERSITY OF WISCONSIN-MILWAUKEE       ,WI,53201-3165,Public       ,294,289,583,14979,9535,24514
00389700,UNIVERSITY OF WISCONSIN COLLEGES        ,WI,53708-8680,Public       ,61,60,121,1335,1118,2453
00389701,UNIVERSITY OF WISCONSIN-BARABOO         ,WI,53913-1098,Public       ,7,4,11,268,138,406
00389702,UNIVERSITY OF WISCONSIN-BARRON          ,WI,54868-2497,Public       ,11,11,22,300,136,436
00389703,UNIVERSITY OF WISCONSIN-FOND DU LAC     ,WI,54935-2998,Public       ,15,9,24,425,218,643
00389704,UNIVERSITY OF WISCONSIN-FOX VALLEY      ,WI,54952-1297,Public       ,21,17,38,870,379,1249
00389705,UNIVERSITY OF WISCONSIN-MANITOWOC       ,WI,54220-6699,Public       ,5,5,10,259,118,377
00389706,UNIVERSITY OF WISCONSIN-MARATHON        ,WI,54401-5396,Public       ,21,14,35,646,264,910
00389707,UNIVERSITY OF WISCONSIN-MARINETTE       ,WI,54143-4299,Public       ,7,6,13,223,104,327
00389708,UNIVERSITY OF WISCONSIN-MARSHFIELD      ,WI,54449-3310,Public       ,12,9,21,288,142,430
00389709,UNIVERSITY OF WISCONSIN-RICHLAND        ,WI,53581-1399,Public       ,5,4,9,232,68,300
00389710,UNIVERSITY OF WISCONSIN COLLEGES - ROCK ,WI,53546-5699,Public       ,12,12,24,401,306,707
00389711,UNIVERSITY OF WISCONSIN-SHEBOYGAN       ,WI,53081-4789,Public       ,11,10,21,309,185,494
00389712,UNIVERSITY OF WISCONSIN-WASHINGTON      ,WI,53095-3699,Public       ,16,4,20,405,144,549
00389713,UNIVERSITY OF WISCONSIN-WAUKESHA        ,WI,53188-2799,Public       ,36,17,53,812,307,1119
00389900,UNIVERSITY OF WISCONSIN-GREEN BAY       ,WI,54311-7001,Public       ,40,41,81,3826,1499,5325
00391100,VITERBO UNIVERSITY                      ,WI,54601-4777,Private      ,14,49,63,1440,907,2347
00391500,UNIVERSITY OF WISCONSIN-STOUT           ,WI,54751-0790,Public       ,77,70,147,5316,1762,7078
00391700,UNIVERSITY OF WISCONSIN-EAU CLAIRE      ,WI,54702-4004,Public       ,103,43,146,7294,1476,8770
00391900,UNIVERSITY OF WISCONSIN-LA CROSSE       ,WI,54601-3742,Public       ,75,87,162,6316,1720,8036
00392000,UNIVERSITY OF WISCONSIN-OSHKOSH         ,WI,54901-8604,Public       ,87,112,199,6503,2699,9202
00392100,UNIVERSITY OF WISCONSIN-PLATTEVILLE     ,WI,53818-3099,Public       ,59,82,141,4495,1396,5891
00392300,UNIVERSITY OF WISCONSIN-RIVER FALLS     ,WI,54022-5013,Public       ,76,62,138,4419,1108,5527
00392400,UNIVERSITY OF WISCONSIN-STEVENS POINT   ,WI,54481-3871,Public       ,85,59,144,6153,1630,7783
00392500,UNIVERSITY OF WISCONSIN-SUPERIOR        ,WI,54880-2898,Public       ,27,61,88,1520,1388,2908
00392600,UNIVERSITY OF WISCONSIN-WHITEWATER      ,WI,53190-1792,Public       ,89,93,182,6603,2016,8619
00400700,MADISON AREA TECHNICAL COLLEGE          ,WI,53704-2599,Public       ,169,205,374,3522,4663,8185
00501500,UNIVERSITY OF WISCONSIN-PARKSIDE        ,WI,53141-2000,Public       ,65,52,117,2862,1667,4529
00529400,WAUKESHA COUNTY TECHNICAL COLLEGE       ,WI,53072-4696,Public       ,38,85,123,1094,1609,2703
00530100,NORTHEAST WISCONSIN TECHNICAL COLLEGE   ,WI,54307-9042,Public       ,56,147,203,1728,3224,4952
00530400,CHIPPEWA VALLEY TECHNICAL COLLEGE       ,WI,54701-6162,Public       ,57,91,148,1974,2863,4837
00538000,MID-STATE TECHNICAL COLLEGE             ,WI,54494-5512,Public       ,21,47,68,738,1256,1994
00538400,NICOLET AREA TECHNICAL COLLEGE          ,WI,54501-0000,Public       ,18,39,57,429,647,1076
00538700,NORTHCENTRAL TECHNICAL COLLEGE          ,WI,54401-1899,Public       ,29,54,83,713,1506,2219
00538900,GATEWAY TECHNICAL COLLEGE               ,WI,53144-1690,Public       ,44,127,171,1243,4091,5334
00539000,BLACKHAWK TECHNICAL COLLEGE             ,WI,53547-5009,Public       ,30,90,120,593,1495,2088
00610800,BELLIN HOSP SCH OF RAD TECH             ,WI,54305-3505,Private      ,0,0,0,15,6,21
00611500,MERCY MED CTR SCH OF RAD TECH           ,WI,54904-3370,Private      ,0,0,0,11,4,15
00612601,ST LUKE'S MEDCL CTR SCHL RAD TECH       ,WI,53215-4330,Private      ,0,1,1,5,25,30
00612603,ST LUKE'S MED CTR SCH OF SONOGRAPHY     ,WI,53215-0000,Private      ,0,0,0,2,10,12
00613100,THEDA CLARK REG MED CTR SCH RAD TEC     ,WI,54957-0000,Private      ,0,1,1,6,4,10
00663900,BELLIN COLLEGE                          ,WI,54305-0000,Private      ,3,3,6,197,149,346
00766900,SOUTHWEST WISCONSIN TECH COLLEGE        ,WI,53809-0000,Public       ,10,27,37,587,587,1174
00777400,SCIENTIFIC COLLEGE OF BEAUTY/BARBER     ,WI,54601-0000,Proprietary  ,2,2,4,27,45,72
00821700,WISCONSIN COLLEGE OF COSMETOLOGY        ,WI,54304-0000,Proprietary  ,3,3,6,60,56,116
00919400,LAKESHORE TECHNICAL COLLEGE             ,WI,53015-1412,Public       ,13,43,56,479,1184,1663
00925600,MORAINE PARK TECHNICAL COLLEGE          ,WI,54936-0000,Public       ,15,56,71,733,1807,2540
00941900,STATE CLG OF BEAUTY CULT-WAUSAU         ,WI,54403-4667,Proprietary  ,4,6,10,49,57,106
00962100,HERZING COLLEGE                         ,WI,53718-4236,Proprietary  ,47,210,257,525,1942,2467
00974400,FOX VALLEY TECHNICAL COLLEGE            ,WI,54913-0000,Public       ,42,110,152,1855,2781,4636
01091300,MADISON MEDIA INSTITUTE                 ,WI,53718-6787,Proprietary  ,14,7,21,305,179,484
01148400,ADVANCED INSTITUTE OF HAIR DESIGN       ,WI,53225-0000,Proprietary  ,12,13,25,143,104,247
01182400,WISCONSIN INDIANHEAD TECH CLG WITC      ,WI,54871-9300,Public       ,30,104,134,1002,1688,2690
01290600,MADISON COSMETOLOGY COLLEGE             ,WI,53711-1030,Proprietary  ,5,14,19,48,88,136
02077100,MILWAUKEE INST OF ART & DESIGN          ,WI,53202-0000,Private      ,9,5,14,718,130,848
02078000,SACRED HEART SCHOOL OF THEOLOGY         ,WI,53130-0000,Private      ,0,0,0,0,15,15
02136600,WISCONSIN LUTHERAN COLLEGE              ,WI,53226-0000,Private      ,10,2,12,755,71,826
02201803,KAPLAN COLLEGE - MILWAUKEE              ,WI,53212-3939,Proprietary  ,39,194,233,189,995,1184
02271300,WI SCH OF PROFESSIONAL PSYCHOLOGY       ,WI,53225-0000,Private      ,0,1,1,0,72,72
02317200,MARANATHA BAPTIST BIBLE COLLEGE         ,WI,53094-0000,Private      ,13,2,15,717,100,817
02324700,EMPIRE BEAUTY SCHOOL                    ,WI,53717-0000,Proprietary  ,6,22,28,121,167,288
02332100,EMPIRE BEAUTY SCHOOL                    ,WI,54220-0000,Proprietary  ,7,29,36,96,202,298
02453500,MEDICAL COLLEGE OF WISCONSIN            ,WI,53226-0000,Private      ,0,5,5,22,1090,1112
02494300,GILL-TECH ACADEMY OF HAIR DESIGN        ,WI,54911-0000,Proprietary  ,0,4,4,68,36,104
02532200,LAC COURTE OREILLES OJIBWA CMTY CLG     ,WI,54843-0000,Public       ,13,80,93,80,422,502
03007400,LAKESIDE SCHOOL OF MASSAGE THERAPY      ,WI,53719-1103,Private      ,5,30,35,59,173,232
03061200,MIDWEST COLLEGE OF ORIENTAL MEDICINE    ,WI,53403-9747,Proprietary  ,0,15,15,4,232,236
03077600,EMPIRE BEAUTY SCHOOL                    ,WI,54304-4838,Proprietary  ,29,51,80,202,354,556
03087500,ITT TECHNICAL INSTITUTE                 ,WI,53220-4612,Proprietary  ,177,265,442,1121,1819,2940
03125100,COLLEGE OF MENOMINEE NATION             ,WI,54135-0000,Private      ,12,35,47,125,471,596
03125102,COLLEGE OF  THE MENOMINEE NATION - GREEN,WI,54304-4964,Private      ,0,0,0,2,9,11
03220300,"SALON PROFESSIONAL ACADEMY, THE         ",WI,54701-7633,Proprietary  ,7,12,19,79,84,163
03309300,MONTESSORI INSTITUTE OF MILWAUKEE       ,WI,53207-0000,Private      ,0,0,0,0,16,16
03822300,FOUR SEASONS SALON AND COSMETOLOGY SCHOO,WI,53566-0000,Proprietary  ,0,4,4,7,19,26
03872500,NORTHLAND INTERNATIONAL UNIVERSITY      ,WI,54119-9285,Private      ,24,5,29,369,57,426
03925300,BLUE SKY SCHOOL OF PROFESSIONAL MASSAGE ,WI,53024-9699,Private      ,7,29,36,50,128,178
00290500,NORTH CAROLINA A&T STATE UNIV           ,NC,27411-0001,Public       ,167,102,269,12575,4337,16912
00290600,APPALACHIAN STATE UNIVERSITY            ,NC,28608-2059,Public       ,148,91,239,10612,2753,13365
00290700,UNIVERSITY OF NC AT ASHEVILLE           ,NC,28804-3299,Public       ,41,14,55,2619,1053,3672
00290800,BARTON COLLEGE                          ,NC,27893-3104,Private      ,16,22,38,1143,633,1776
00291000,BELMONT ABBEY COLLEGE                   ,NC,28012-1802,Private      ,8,74,82,1006,719,1725
00291100,BENNETT COLLEGE                         ,NC,27401-3239,Private      ,17,8,25,868,246,1114
00291200,BREVARD COLLEGE                         ,NC,28712-3306,Private      ,6,3,9,829,131,960
00291300,CAMPBELL UNIVERSITY                     ,NC,27506-0036,Private      ,52,89,141,3306,2831,6137
00291400,CATAWBA COLLEGE                         ,NC,28144-2488,Private      ,7,16,23,1225,479,1704
00291500,CENTRAL PIEDMONT COMMUNITY COLLEGE      ,NC,28204-2297,Public       ,151,457,608,4043,7974,12017
00291600,CHOWAN UNIVERSITY                       ,NC,27855-1850,Private      ,26,5,31,1294,189,1483
00291700,COLLEGE OF THE ALBEMARLE                ,NC,27909-2327,Public       ,17,53,70,545,1145,1690
00291800,DAVIDSON COLLEGE                        ,NC,28035-7157,Private      ,19,0,19,1946,47,1993
00291900,DAVIDSON COUNTY COMMUNITY COLLEGE       ,NC,27293-0000,Public       ,32,113,145,642,1907,2549
00292000,DUKE UNIVERSITY                         ,NC,27708-0397,Private      ,84,26,110,10401,966,11367
00292001,DUKE UNIV - SCHOOL OF MEDICINE          ,NC,27710-0000,Private      ,3,7,10,53,996,1049
00292002,DUKE UNIV - SCHOOL OF LAW               ,NC,27708-0000,Private      ,1,25,26,26,1772,1798
00292003,DUKE UNIV - GRAD SCH ARTS & SCIENCE     ,NC,27708-0000,Private      ,4,28,32,39,694,733
00292004,DUKE UNIV - FUQUA SCH OF BUSINESS       ,NC,27708-0000,Private      ,1,36,37,44,1045,1089
00292005,DUKE UNIV/NICHOLAS SCH OF ENVIRON.      ,NC,27708-0000,Private      ,0,1,1,13,290,303
00292006,DUKE UNIV - DIVINITY SCHOOL             ,NC,27708-0000,Private      ,1,4,5,55,651,706
00292007,DUKE UNIV - SCHOOL OF NURSING           ,NC,27710-0000,Private      ,3,26,29,58,459,517
00292300,EAST CAROLINA UNIVERSITY                ,NC,27858-1818,Public       ,192,276,468,14430,8373,22803
00292600,ELIZABETH CITY STATE UNIVERSITY         ,NC,27909-7806,Public       ,44,49,93,2855,1218,4073
00292700,ELON UNIVERSITY                         ,NC,27244-2010,Private      ,43,16,59,5329,566,5895
00292800,FAYETTEVILLE STATE UNIVERSITY           ,NC,28301-4298,Public       ,90,159,249,4866,5151,10017
00292900,GARDNER-WEBB UNIVERSITY                 ,NC,28017-0000,Private      ,26,96,122,1929,2213,4142
00293000,GREENSBORO COLLEGE                      ,NC,27401-1875,Private      ,16,27,43,1319,672,1991
00293100,GUILFORD COLLEGE                        ,NC,27410-4171,Private      ,25,92,117,2023,2174,4197
00293300,HIGH POINT UNIVERSITY                   ,NC,27262-4221,Private      ,23,59,82,2052,1600,3652
00293400,ISOTHERMAL COMMUNITY COLLEGE            ,NC,28160-0804,Public       ,21,64,85,454,1232,1686
00293500,JOHN WESLEY COLLEGE                     ,NC,27265-0000,Private      ,0,6,6,37,185,222
00293600,JOHNSON C SMITH UNIVERSITY              ,NC,28216-5398,Private      ,45,28,73,2919,646,3565
00293700,KING'S COLLEGE-CHARLOTTE                ,NC,28204-2435,Proprietary  ,21,27,48,573,281,854
00293900,LEES MCRAE COLLEGE                      ,NC,28604-0000,Private      ,11,5,16,844,278,1122
00294000,LENOIR COMMUNITY COLLEGE                ,NC,28502-0188,Public       ,18,88,106,640,1765,2405
00294100,LENOIR-RHYNE UNIVERSITY                 ,NC,28603-0000,Private      ,17,11,28,1770,515,2285
00294200,LIVINGSTONE COLLEGE                     ,NC,28144-5298,Private      ,25,23,48,1100,368,1468
00294300,LOUISBURG COLLEGE                       ,NC,27549-2398,Private      ,21,6,27,1007,106,1113
00294400,MARS HILL COLLEGE                       ,NC,28754-0000,Private      ,13,21,34,1356,480,1836
00294500,MEREDITH COLLEGE                        ,NC,27607-5298,Private      ,19,13,32,1676,802,2478
00294600,METHODIST UNIVERSITY                    ,NC,28311-1420,Private      ,19,48,67,1913,1184,3097
00294700,MITCHELL COMMUNITY COLLEGE              ,NC,28677-5264,Public       ,11,48,59,534,1334,1868
00294800,MONTREAT COLLEGE                        ,NC,28757-1267,Private      ,3,128,131,534,768,1302
00294900,MOUNT OLIVE COLLEGE                     ,NC,28365-1299,Private      ,14,224,238,820,2858,3678
00295000,NORTH CAROLINA CENTRAL UNIVERSITY       ,NC,27707-3198,Public       ,117,152,269,6810,5976,12786
00295100,NORTH CAROLINA WESLEYAN COLLEGE         ,NC,27804-8699,Private      ,22,41,63,1181,1030,2211
00295300,PEACE COLLEGE                           ,NC,27604-1194,Private      ,7,5,12,767,177,944
00295400,UNIV OF NORTH CAROLINA AT PEMBROKE      ,NC,28372-1510,Public       ,99,124,223,4137,3085,7222
00295500,PFEIFFER UNIVERSITY                     ,NC,28109-0000,Private      ,11,82,93,856,1244,2100
00295600,PIEDMONT BAPTIST COLLEGE AND GRADUATE SC,NC,27101-5025,Private      ,3,6,9,194,145,339
00295700,QUEENS UNIVERSITY OF CHARLOTTE          ,NC,28274-0001,Private      ,25,73,98,1296,1306,2602
00295800,ROCKINGHAM COMMUNITY COLLEGE            ,NC,27375-0000,Public       ,17,44,61,542,1091,1633
00296000,SALEM COLLEGE                           ,NC,27108-0000,Private      ,6,37,43,546,582,1128
00296100,SANDHILLS COMMUNITY COLLEGE             ,NC,28374-8283,Public       ,46,99,145,1005,2222,3227
00296200,SHAW UNIVERSITY                         ,NC,27601-2393,Private      ,59,78,137,2946,2543,5489
00296300,SOUTHEASTERN BAPTIST THEOL SEMINARY     ,NC,27588-0000,Private      ,3,2,5,39,93,132
00296400,SOUTHEASTERN COMMUNITY COLLEGE          ,NC,28472-5422,Public       ,43,86,129,656,1345,2001
00296700,ST ANDREWS PRESBYTERIAN COLLEGE         ,NC,28352-9979,Private      ,14,6,20,762,158,920
00296800,ST AUGUSTINES COLLEGE                   ,NC,27610-2298,Private      ,38,36,74,1721,570,2291
00297000,SURRY COMMUNITY COLLEGE                 ,NC,27017-0304,Public       ,17,42,59,775,1048,1823
00297200,NORTH CAROLINA STATE UNIV-RALEIGH       ,NC,27695-1751,Public       ,199,187,386,16817,6503,23320
00297300,GASTON COLLEGE                          ,NC,28034-1499,Public       ,30,138,168,1218,2721,3939
00297400,UNIVERSITY OF N C-CHAPEL HILL           ,NC,27514-0000,Public       ,169,234,403,16314,10085,26399
00297500,UNIVERSITY OF NC AT CHARLOTTE           ,NC,28223-0001,Public       ,186,274,460,12425,7784,20209
00297600,UNIVERSITY OF N C - GREENSBORO          ,NC,27412-0001,Public       ,136,167,303,11540,6736,18276
00297800,WAKE FOREST UNIV - UNDERGRADUATE        ,NC,27109-7246,Private      ,32,6,38,4140,199,4339
00297801,WAKE FOREST UNIV - SCH OF MEDICINE      ,NC,27157-1090,Private      ,1,10,11,46,858,904
00297803,WAKE FOREST UNIVERSITY - SCHOOLS OF BUSI,NC,27109-7659,Private      ,0,9,9,19,459,478
00297805,WAKE FOREST UNIV - SCH OF LAW           ,NC,27109-7206,Private      ,0,2,2,12,1010,1022
00297806,WAKE FOREST UNIV - GRAD A&S/DIVINITY    ,NC,27109-7246,Private      ,0,9,9,38,349,387
00297900,WARREN WILSON COLLEGE                   ,NC,28815-0000,Private      ,5,6,11,935,288,1223
00298000,WAYNE COMMUNITY COLLEGE                 ,NC,27533-0000,Public       ,35,88,123,966,2060,3026
00298100,WESTERN CAROLINA UNIVERSITY             ,NC,28723-9731,Public       ,72,73,145,5668,2141,7809
00298200,WESTERN PIEDMONT COMMUNITY COLLEGE      ,NC,28655-4504,Public       ,19,71,90,681,1651,2332
00298300,WILKES COMMUNITY COLLEGE                ,NC,28697-2100,Public       ,45,70,115,710,1062,1772
00298400,UNIVERSITY OF N C-WILMINGTON            ,NC,28403-3297,Public       ,166,84,250,8922,3180,12102
00298500,WINGATE UNIVERSITY                      ,NC,28174-0159,Private      ,24,19,43,1831,570,2401
00298600,WINSTON-SALEM STATE UNIVERSITY          ,NC,27102-0000,Public       ,101,83,184,6304,3195,9499
00398100,UNC SCHOOL OF THE ARTS                  ,NC,27127-2188,Public       ,14,0,14,1018,251,1269
00403300,ASHEVILLE BUNCOMBE TECH CMTY CLG        ,NC,28801-4897,Public       ,41,125,166,1072,2260,3332
00406200,PITT COMMUNITY COLLEGE                  ,NC,28590-0000,Public       ,59,136,195,1975,3224,5199
00483500,CALDWELL COMMUNITY CLG & TECH INST      ,NC,28638-2626,Public       ,21,115,136,840,1805,2645
00483800,GUILFORD TECHNICAL COMMUNITY CLG        ,NC,27282-0309,Public       ,83,224,307,2841,5861,8702
00484400,WAKE TECHNICAL COMMUNITY COLLEGE        ,NC,27603-5696,Public       ,87,210,297,2475,4977,7452
00484500,WILSON COMMUNITY COLLEGE                ,NC,27893-3310,Public       ,18,90,108,448,1585,2033
00499201,MILLER-MOTTE TECHNICAL COLLEGE - MILLER-,NC,27511-9209,Proprietary  ,16,67,83,94,802,896
00531600,COASTAL CAROLINA COMMUNITY COLLEGE      ,NC,28546-6816,Public       ,40,171,211,821,2660,3481
00531700,FORSYTH TECHNICAL COMMUNITY COLLEGE     ,NC,27103-5197,Public       ,57,176,233,1386,4030,5416
00531800,CATAWBA VALLEY COMMUNITY COLLEGE        ,NC,28602-8302,Public       ,36,133,169,1164,2312,3476
00532000,CAPE FEAR COMMUNITY COLLEGE             ,NC,28401-3910,Public       ,69,139,208,2086,2699,4785
00544700,RANDOLPH COMMUNITY COLLEGE              ,NC,27204-1009,Public       ,16,63,79,529,1214,1743
00544800,DURHAM TECHNICAL CMNTY COLLEGE          ,NC,27703-5023,Public       ,19,140,159,751,2927,3678
00544900,CENTRAL CAROLINA COMMUNITY COLLEGE      ,NC,27330-9000,Public       ,30,121,151,828,2287,3115
00546300,ALAMANCE COMMUNITY COLLEGE              ,NC,27253-0000,Public       ,29,103,132,785,2101,2886
00546400,RICHMOND COMMUNITY COLLEGE              ,NC,28345-4522,Public       ,11,86,97,446,1492,1938
00575400,ROWAN-CABARRUS COMMUNITY COLLEGE        ,NC,28145-1595,Public       ,34,162,196,1123,2794,3917
00647700,CABARRUS COLLEGE OF HEALTH SCIENCES     ,NC,28025-0000,Private      ,6,8,14,214,345,559
00647800,MERCY HOSP SCH OF NURSING               ,NC,28207-0000,Public       ,2,12,14,90,307,397
00648300,WATTS SCHOOL OF NURSING                 ,NC,27704-0000,Private      ,2,7,9,58,207,265
00679900,CRAVEN COMMUNITY COLLEGE                ,NC,28562-0000,Public       ,29,100,129,507,1766,2273
00703100,PAMLICO COMMUNITY COLLEGE               ,NC,28529-0000,Public       ,6,23,29,59,223,282
00764000,FAYETTEVILLE TECHNICAL CMTY COLLEGE     ,NC,28303-0236,Public       ,79,340,419,2189,8268,10457
00768700,JAMES SPRUNT COMMUNITY COLLEGE          ,NC,28349-0398,Public       ,12,39,51,289,825,1114
00781400,BROOKSTONE COLLEGE OF BUSINESS          ,NC,28262-0000,Proprietary  ,4,46,50,57,376,433
00781401,BROOKSTONE COLLEGE OF BUSINESS          ,NC,27409-0000,Proprietary  ,10,52,62,57,378,435
00789200,SAMPSON COMMUNITY COLLEGE               ,NC,28328-0000,Public       ,6,28,34,360,1154,1514
00798500,SOUTH PIEDMONT COMMUNITY COLLEGE        ,NC,28135-9703,Public       ,20,67,87,377,1260,1637
00798600,HALIFAX COMMUNITY COLLEGE               ,NC,27890-0089,Public       ,31,75,106,452,1048,1500
00798700,BLADEN COMMUNITY COLLEGE                ,NC,28332-0266,Public       ,17,55,72,343,1291,1634
00798800,MARTIN COMMUNITY COLLEGE                ,NC,27892-8307,Public       ,5,20,25,189,763,952
00808100,CARTERET COMMUNITY COLLEGE              ,NC,28557-2989,Public       ,17,47,64,389,966,1355
00808200,CLEVELAND COMMUNITY COLLEGE             ,NC,28150-0000,Public       ,17,111,128,523,1920,2443
00808300,HAYWOOD COMMUNITY COLLEGE               ,NC,28721-0000,Public       ,19,46,65,428,796,1224
00808500,MCDOWELL TECHNICAL COMMUNITY CLG        ,NC,28752-8728,Public       ,13,49,62,248,615,863
00808700,MONTGOMERY COMMUNITY COLLEGE            ,NC,27371-0787,Public       ,11,44,55,200,630,830
00846600,SOUTHWESTERN COMMUNITY COLLEGE          ,NC,28779-8581,Public       ,23,60,83,499,949,1448
00855700,NASH COMMUNITY COLLEGE                  ,NC,27804-0488,Public       ,36,68,104,646,1302,1948
00855800,BEAUFORT COUNTY COMMUNITY COLLEGE       ,NC,27889-7889,Public       ,10,30,40,359,1019,1378
00861200,ROBESON COMMUNITY COLLEGE               ,NC,28359-2151,Public       ,23,100,123,730,2494,3224
00861300,ROANOKE-CHOWAN COMMUNITY COLLEGE        ,NC,27910-9522,Public       ,14,50,64,286,787,1073
00885500,EDGECOMBE COMMUNITY COLLEGE             ,NC,27886-9399,Public       ,14,68,82,361,1361,1722
00885501,EDGECOMBE COMMUNITY COLLEGE             ,NC,27801-0000,Public       ,8,42,50,199,846,1045
00902500,SOUTH EASTERN CLG OF BEAUTY CULTURE     ,NC,28204-0000,Proprietary  ,17,48,65,123,293,416
00933600,JOHNSTON COMMUNITY COLLEGE              ,NC,27577-0000,Public       ,35,56,91,685,1536,2221
00943000,TRI-COUNTY COMMUNITY COLLEGE            ,NC,28906-7919,Public       ,11,32,43,230,523,753
00964600,PIEDMONT COMMUNITY COLLEGE              ,NC,27573-1197,Public       ,18,60,78,324,1110,1434
00968400,BLUE RIDGE COMMUNITY COLLEGE            ,NC,28731-9624,Public       ,14,42,56,393,735,1128
00974701,GORDON-CONWELL THEO SEM - CHARLOTTE     ,NC,28273-0000,Private      ,0,7,7,1,181,182
00990300,VANCE-GRANVILLE CMTY COLLEGE            ,NC,27536-0917,Public       ,47,141,188,917,2523,3440
01026400,SOUTH COLLEGE                           ,NC,28803-3152,Proprietary  ,6,44,50,49,274,323
01119400,STANLY COMMUNITY COLLEGE                ,NC,28001-7458,Public       ,12,65,77,394,1059,1453
01119700,MAYLAND COMMUNITY COLLEGE               ,NC,28777-2777,Public       ,10,29,39,262,480,742
01179900,PAUL MITCHELL THE SCHOOL FAYETTEVILLE   ,NC,28303-5364,Proprietary  ,5,15,20,13,104,117
01192600,LEON'S BEAUTY SCHOOL                    ,NC,27403-2812,Proprietary  ,8,13,21,90,147,237
02056500,MITCHELL'S HAIR STYLING ACADEMY         ,NC,27893-0000,Proprietary  ,10,15,25,48,114,162
02056501,MITCHELL'S HAIR STYLING ACADEMY - MITCHE,NC,27606-3326,Proprietary  ,0,1,1,13,29,42
02110500,ART INSTITUTE OF CHARLOTTE (THE)        ,NC,28217-0000,Proprietary  ,85,97,182,1200,1014,2214
02170700,BRUNSWICK COMMUNITY COLLEGE             ,NC,28422-0000,Public       ,18,37,55,320,569,889
02205000,COLLEGE OF WILMINGTON                   ,NC,28403-0000,Proprietary  ,1,5,6,7,39,46
02210400,FAYETTEVILLE BEAUTY COLLEGE             ,NC,28303-0000,Proprietary  ,2,11,13,33,144,177
02227800,MITCHELL'S HAIR STYLING ACADEMY         ,NC,27534-0000,Proprietary  ,0,1,1,2,10,12
02227900,MITCHELL'S HAIR STYLING ACADEMY         ,NC,27858-0000,Proprietary  ,1,3,4,10,25,35
02238700,HAIRSTYLING INSTITUTE OF CHARLOTTE      ,NC,28204-0000,Proprietary  ,1,8,9,29,82,111
02280900,ROANOKE BIBLE COLLEGE                   ,NC,27909-0000,Private      ,2,2,4,109,77,186
02286300,CAROLINA BEAUTY COLLEGE                 ,NC,27262-0000,Proprietary  ,20,147,167,161,912,1073
02558900,CHEVEUX SCHOOL OF HAIR DESIGN           ,NC,28540-0000,Proprietary  ,2,9,11,9,63,72
02560600,PINNACLE INSTITUTE OF COSMETOLOGY       ,NC,28115-8020,Proprietary  ,5,7,12,36,44,80
02614201,MILLER-MOTTE BUSINESS COLLEGE           ,NC,28403-0000,Proprietary  ,23,126,149,246,1094,1340
03009500,WINSTON-SALEM BARBER SCHOOL             ,NC,27107-0000,Proprietary  ,1,9,10,33,72,105
03064400,REGENCY BEAUTY INSTITUTE                ,NC,27127-0000,Proprietary  ,3,10,13,39,86,125
03089300,HERITAGE BIBLE COLLEGE                  ,NC,28335-0000,Private      ,1,4,5,26,101,127
03104200,CAROLINAS COLLEGE OF HEALTH SCIENCE     ,NC,28232-2861,Public       ,7,17,24,196,487,683
03104201,CHS NURSE ANESTHESIA PROGRAM / UNCC     ,NC,28232-2861,Public       ,3,9,12,116,147,263
03109000,SCHOOL OF COMMUNICATION ARTS OF NORTH CA,NC,27614-7076,Proprietary  ,42,23,65,389,213,602
03237300,ANSON COLLEGE OF COSMETOLOGY            ,NC,28170-2147,Proprietary  ,0,1,1,8,32,40
03361300,MEDICAL ARTS MASSAGE SCHOOL             ,NC,27616-6453,Proprietary  ,0,32,32,24,156,180
03513400,APEX SCHOOL OF THEOLOGY                 ,NC,27703-8024,Private      ,1,10,11,7,90,97
03555400,SOUTHEASTERN SCHOOL OF NEUROMUSCULAR  MA,NC,29406-0000,Proprietary  ,4,9,13,12,54,66
03570300,CAROLINA CHRISTIAN COLLEGE              ,NC,27105-3241,Private      ,2,1,3,13,36,49
03663300,HOOD THEOLOGICAL SEMINARY               ,NC,28144-5768,Private      ,0,8,8,1,201,202
03748500,LA SHE'S BEAUTY ACADEMY                 ,NC,27707-3569,Proprietary  ,4,24,28,30,115,145
03777300,CAROLINA ACAD OF COSMETIC ART & SCI     ,NC,28054-0460,Proprietary  ,11,41,52,86,174,260
03827300,NEW LIFE THEOLOGICAL SEMINARY           ,NC,28205-1648,Private      ,0,5,5,2,54,56
04115700,REGINA'S COLLEGE OF BEAUTY              ,NC,28110-2831,Proprietary  ,1,6,7,1,6,7
00298800,BISMARCK STATE COLLEGE                  ,ND,58501-1299,Public       ,57,69,126,1757,1291,3048
00298900,DICKINSON STATE UNIVERSITY              ,ND,58601-4896,Public       ,24,26,50,1397,679,2076
00299000,JAMESTOWN COLLEGE                       ,ND,58405-3401,Private      ,10,4,14,942,153,1095
00299100,LAKE REGION STATE COLLEGE               ,ND,58301-1598,Public       ,6,33,39,316,363,679
00299200,UNIVERSITY OF MARY                      ,ND,58504-9652,Private      ,20,78,98,1715,1371,3086
00299300,MAYVILLE STATE UNIVERSITY               ,ND,58257-1299,Public       ,10,8,18,557,231,788
00299400,MINOT STATE UNIVERSITY                  ,ND,58707-0002,Public       ,21,56,77,1689,1563,3252
00299500,MINOT STATE UNIV-BOTTINEAU CAMPUS       ,ND,58318-1159,Public       ,3,18,21,211,207,418
00299600,NORTH DAKOTA STATE CLG OF SCIENCE       ,ND,58076-0002,Public       ,29,29,58,1652,678,2330
00299700,NORTH DAKOTA STATE UNIVERSITY           ,ND,58108-6050,Public       ,66,64,130,7869,2474,10343
00300500,UNIVERSITY OF NORTH DAKOTA              ,ND,58202-8193,Public       ,88,88,176,7590,3873,11463
00300700,WILLISTON STATE COLLEGE                 ,ND,58802-1326,Public       ,6,15,21,312,447,759
00300800,VALLEY CITY STATE UNIVERSITY            ,ND,58072-0000,Public       ,10,3,13,643,219,862
00484600,RASMUSSEN COLLEGE                       ,ND,58103-7196,Proprietary  ,37,157,194,391,1375,1766
00775600,JOSEF'S SCHOOL OF HAIR DESIGN INC       ,ND,58102-4977,Proprietary  ,4,5,9,65,45,110
00935400,MEDCENTER ONE COLLEGE OF NURSING        ,ND,58501-4494,Private      ,2,1,3,58,83,141
01040600,JOSEF'S SCHOOL OF HAIR DESIGN           ,ND,58201-6394,Proprietary  ,4,6,10,59,58,117
01205900,TRINITY BIBLE COLLEGE                   ,ND,58436-7150,Private      ,2,7,9,240,147,387
01229500,R D HAIRSTYLING COLLEGE                 ,ND,58501-4001,Proprietary  ,1,6,7,24,30,54
02188200,SITTING BULL COLLEGE                    ,ND,58538-9721,Public       ,7,48,55,61,376,437
02236500,LITTLE HOOP COMMUNITY COLLEGE           ,ND,58335-0000,Public       ,5,41,46,46,217,263
02242900,UNITED TRIBES TECHNICAL COLLEGE         ,ND,58504-0000,Private      ,18,64,82,257,815,1072
02298200,HEADQUARTERS ACADEMY OF HAIR DESIGN     ,ND,58701-0000,Proprietary  ,3,6,9,28,55,83
02301100,TURTLE MTN CMNTY COLG-FIN AID OFC       ,ND,58316-0000,Private      ,11,38,49,174,405,579
02553700,FORT BERTHOLD COMMUNITY COLLEGE         ,ND,58763-0000,Public       ,7,44,51,43,222,265
03087200,MOLER BARBER CLG OF HAIRSTYLING         ,ND,58103-0000,Proprietary  ,0,1,1,5,14,19
04031300,SALON PROFESSIONAL ACADEMY (THE)        ,ND,58103-3337,Proprietary  ,6,5,11,70,28,98
00301005,ANTIOCH UNIV/SEATTLE                    ,WA,98121-0000,Private      ,1,56,57,29,1131,1160
00376900,BELLEVUE COMMUNITY COLLEGE              ,WA,98007-6484,Public       ,122,243,365,2613,3548,6161
00377000,BIG BEND COMMUNITY COLLEGE              ,WA,98837-3299,Public       ,34,109,143,747,1212,1959
00377100,"CENTRAL WASHINGTON UNIV., FIN AID       ",WA,98926-7495,Public       ,154,120,274,7745,3992,11737
00377200,CENTRALIA COLLEGE                       ,WA,98531-4099,Public       ,32,121,153,748,1238,1986
00377300,CLARK COLLEGE                           ,WA,98663-3598,Public       ,131,341,472,2862,5245,8107
00377400,COLUMBIA BASIN COLLEGE                  ,WA,99301-3379,Public       ,78,269,347,1913,2998,4911
00377500,EASTERN WASHINGTON UNIVERSITY           ,WA,99004-2447,Public       ,135,167,302,7841,5516,13357
00377600,EVERETT COMMUNITY COLLEGE               ,WA,98201-1352,Public       ,88,262,350,1562,3616,5178
00377700,HERITAGE UNIVERSITY                     ,WA,98948-9562,Private      ,6,52,58,400,1581,1981
00377800,GONZAGA UNIVERSITY                      ,WA,99258-0083,Private      ,65,120,185,5882,2944,8826
00377900,GRAYS HARBOR COLLEGE                    ,WA,98520-7599,Public       ,36,106,142,588,1095,1683
00378000,GREEN RIVER COMMUNITY COLLEGE           ,WA,98092-3622,Public       ,86,194,280,1905,2756,4661
00378100,HIGHLINE COMMUNITY COLLEGE              ,WA,98198-9800,Public       ,116,289,405,1872,3418,5290
00378200,LOWER COLUMBIA COLLEGE                  ,WA,98632-0310,Public       ,44,212,256,727,1802,2529
00378300,NORTHWEST UNIVERSITY                    ,WA,98083-0000,Private      ,13,33,46,1118,652,1770
00378400,OLYMPIC COLLEGE                         ,WA,98337-1600,Public       ,68,236,304,1220,2887,4107
00378500,PACIFIC LUTHERAN UNIVERSITY             ,WA,98447-0003,Private      ,34,28,62,3876,1516,5392
00378600,PENINSULA COLLEGE                       ,WA,98362-6660,Public       ,26,92,118,397,1078,1475
00378700,SEATTLE CENTRAL COMMUNITY COLLEGE       ,WA,98122-2413,Public       ,82,274,356,2108,4153,6261
00378703,SEATTLE VOCATIONAL INSTITUTE            ,WA,98144-0000,Public       ,14,78,92,92,449,541
00378800,SEATTLE PACIFIC UNIVERSITY              ,WA,98119-1997,Private      ,63,54,117,4245,1532,5777
00379000,SEATTLE UNIVERSITY                      ,WA,98122-1090,Private      ,84,120,204,6211,5763,11974
00379100,SHORELINE COMMUNITY COLLEGE             ,WA,98133-5696,Public       ,84,167,251,1699,2803,4502
00379200,SKAGIT VALLEY COLLEGE                   ,WA,98273-5899,Public       ,47,157,204,955,2104,3059
00379300,SPOKANE COMMUNITY COLLEGE               ,WA,99207-5399,Public       ,131,566,697,2773,6868,9641
00379400,ST MARTIN'S UNIVERSITY                  ,WA,98503-7500,Private      ,15,36,51,1080,1007,2087
00379600,TACOMA COMMUNITY COLLEGE                ,WA,98466-6100,Public       ,84,406,490,2006,5106,7112
00379700,UNIVERSITY OF PUGET SOUND               ,WA,98416-1039,Private      ,26,12,38,4165,827,4992
00379800,UNIVERSITY OF WASHINGTON                ,WA,98195-5880,Public       ,382,444,826,22098,19763,41861
00379900,WALLA WALLA UNIVERSITY                  ,WA,99324-1198,Private      ,11,21,32,1340,695,2035
00380000,WASHINGTON STATE UNIVERSITY             ,WA,99164-1035,Public       ,228,222,450,15157,9190,24347
00380100,WENATCHEE VALLEY COLLEGE                ,WA,98801-1799,Public       ,61,183,244,1131,2085,3216
00380200,WESTERN WASHINGTON UNIVERSITY           ,WA,98225-5946,Public       ,200,119,319,12028,3936,15964
00380300,WHITMAN COLLEGE                         ,WA,99362-2067,Private      ,18,4,22,2169,62,2231
00380400,WHITWORTH UNIVERSITY                    ,WA,99251-0001,Private      ,32,40,72,2824,892,3716
00380500,YAKIMA VALLEY COMMUNITY COLLEGE         ,WA,98907-2520,Public       ,53,224,277,1887,3655,5542
00499800,PUGET SOUND CHRISTIAN COLLEGE           ,WA,98201-3516,Private      ,2,7,9,103,84,187
00499900,BELLINGHAM TECHNICAL COLLEGE            ,WA,98225-0000,Public       ,20,83,103,359,955,1314
00500000,PIERCE COLLEGE                          ,WA,98498-1919,Public       ,87,299,386,1883,4436,6319
00500100,EDMONDS COMMUNITY COLLEGE               ,WA,98036-5999,Public       ,67,224,291,1436,2772,4208
00500600,WALLA WALLA COMMUNITY COLLEGE           ,WA,99362-9267,Public       ,40,158,198,1247,1952,3199
00530600,BATES TECHNICAL COLLEGE                 ,WA,98405-0000,Public       ,32,196,228,512,1988,2500
00537200,SOUTH PUGET SOUND COMMUNITY COLLEGE     ,WA,98512-6292,Public       ,63,189,252,1349,2634,3983
00537300,LAKE WASHINGTON TECHNICAL COLLEGE       ,WA,98034-8505,Public       ,30,100,130,418,1369,1787
00575200,CLOVER PARK TECHNICAL COLLEGE           ,WA,98499-0000,Public       ,71,354,425,805,2988,3793
00717805,WESTERN SEMINARY - SEATTLE              ,WA,98021-4440,Private      ,0,0,0,0,1,1
00815500,EVERGREEN STATE COLLEGE (THE)           ,WA,98505-0002,Public       ,58,103,161,2804,2999,5803
00844300,ITT TECHNICAL INSTITUTE                 ,WA,98168-3334,Proprietary  ,93,177,270,642,1263,1905
00907901,EVEREST COLLEGE                         ,WA,98684-6950,Proprietary  ,3,7,10,25,78,103
00938700,PERRY TECHNICAL INSTITUTE               ,WA,98903-1239,Private      ,23,39,62,324,465,789
00954400,SPOKANE FALLS COMMUNITY COLLEGE         ,WA,99224-5204,Public       ,122,345,467,2991,4417,7408
00970400,NORTH SEATTLE COMMUNITY COLLEGE         ,WA,98103-3599,Public       ,47,158,205,1168,2654,3822
00970600,SOUTH SEATTLE COMMUNITY COLLEGE         ,WA,98106-1499,Public       ,56,141,197,1206,1981,3187
00973900,GLEN DOW ACAD OF HAIR DESIGN            ,WA,99201-0209,Proprietary  ,13,15,28,121,133,254
01036400,WHATCOM COMMUNITY COLLEGE               ,WA,98226-8003,Public       ,60,94,154,1220,1518,2738
01043400,RENTON TECHNICAL COLLEGE                ,WA,98056-0000,Public       ,27,142,169,513,1538,2051
01148100,DIVERS INSTITUTE OF TECHNOLOGY          ,WA,98107-0667,Proprietary  ,25,50,75,108,334,442
01231500,CORNISH COLLEGE OF THE ARTS             ,WA,98121-4604,Private      ,8,8,16,913,322,1235
01249600,GREENWOOD BEAUTY SCHOOL                 ,WA,98103-0000,Proprietary  ,2,6,8,18,67,85
01302200,CITY UNIVERSITY OF SEATTLE              ,WA,98005-3030,Private      ,5,221,226,106,2540,2646
01309400,BELLINGHAM BEAUTY SCHOOL                ,WA,98225-0000,Proprietary  ,5,6,11,36,57,93
02091701,KAPLAN COLLEGE - SEATTLE                ,WA,98055-4910,Proprietary  ,4,35,39,32,128,160
02105300,BELLEVUE BEAUTY SCHOOL                  ,WA,98007-0000,Proprietary  ,0,4,4,13,23,36
02106700,TRINITY LUTHERAN COLLEGE                ,WA,98201-3569,Private      ,1,2,3,75,39,114
02180000,NORTHWEST INDIAN COLLEGE                ,WA,98226-9278,Public       ,14,69,83,126,455,581
02184200,PAROBA COLLEGE OF COSMETOLOGY           ,WA,98208-0000,Proprietary  ,14,28,42,66,131,197
02202200,STYLEMASTERS COLLEGE OF HAIR DESIGN     ,WA,98632-0000,Proprietary  ,4,18,22,32,71,103
02203300,GENE JUAREZ ACADEMY OF BEAUTY           ,WA,98125-0000,Proprietary  ,24,33,57,328,299,627
02203301,GENE JUAREZ ACADEMY OF BEAUTY           ,WA,98003-0000,Proprietary  ,1,3,4,46,46,92
02222900,INTERNATIONAL AIR & HOSPITALITY ACADEMY ,WA,98661-4835,Proprietary  ,33,25,58,216,148,364
02231100,CROWN COLLEGE                           ,WA,98444-0000,Proprietary  ,1,6,7,28,302,330
02236800,PROFESSIONAL BEAUTY SCHOOL              ,WA,98902-0000,Proprietary  ,5,10,15,46,73,119
02242500,BASTYR UNIVERSITY                       ,WA,98028-0000,Private      ,2,44,46,109,1197,1306
02291300,ART INSTITUTE OF SEATTLE                ,WA,98121-1622,Proprietary  ,85,123,208,2001,1711,3712
02291700,HENRY COGSWELL COLLEGE                  ,WA,98201-0000,Private      ,0,0,0,72,49,121
02300100,EVEREST COLLEGE                         ,WA,98367-1835,Proprietary  ,81,405,486,346,1741,2087
02326500,INTERFACE COLLEGE                       ,WA,99201-3209,Proprietary  ,6,39,45,29,231,260
02331400,NORTHWEST HAIR ACADEMY                  ,WA,98273-0000,Proprietary  ,13,17,30,74,133,207
02331402,NORTHWEST HAIR ACADEMY - EVERETT        ,WA,98204-0000,Proprietary  ,1,0,1,7,8,15
02345100,PHAGAN'S ORCHARDS BEAUTY SCHOOL         ,WA,98662-0000,Proprietary  ,4,2,6,35,43,78
02504900,ACADEMY OF HAIR DESIGN (THE)            ,WA,98801-0000,Proprietary  ,6,12,18,43,58,101
02541900,BJ'S BEAUTY AND BARBER COLLEGE          ,WA,98409-0000,Proprietary  ,9,16,25,33,78,111
02602100,NORTHWEST COLLEGE OF ART                ,WA,98370-8625,Proprietary  ,2,1,3,146,24,170
02606200,EVEREST COLLEGE                         ,WA,98055-2990,Proprietary  ,108,376,484,504,1834,2338
02617500,EVEREST COLLEGE                         ,WA,98133-9018,Proprietary  ,75,175,250,660,1597,2257
03031406,INTERNATIONAL ACADEMY OF DESIGN AND TECH,WA,98188-3319,Proprietary  ,7,2,9,13,14,27
03052200,COURT REPORTING INSTITUTE               ,WA,98133-7500,Proprietary  ,0,0,0,6,35,41
03065000,CLARE'S BEAUTY COLLEGE                  ,WA,99301-5505,Proprietary  ,2,12,14,23,84,107
03071800,ITT TECHNICAL INSTITUTE                 ,WA,99216-1589,Proprietary  ,54,106,160,448,955,1403
03099000,CORTIVA INSTITUTE - SEATTLE             ,WA,98109-5474,Proprietary  ,8,27,35,63,195,258
03139500,MONTESSORI SCHOOLS OF WASHINGTON        ,WA,98203-6600,Private      ,0,0,0,0,4,4
03280300,SEATTLE INST OF ORIENTAL MEDICINE       ,WA,98115-0000,Proprietary  ,0,1,1,2,49,51
03283300,NORTHWEST HVAC/R ASSOCIATION & TRAINING ,WA,99202-2125,Private      ,0,0,0,3,59,62
03361600,SEATTLE MIDWIFERY SCHOOL                ,WA,98144-0000,Private      ,0,2,2,5,73,78
03466400,MARS HILL GRADUATE SCHOOL               ,WA,98121-0000,Private      ,0,3,3,0,226,226
03483500,CASCADIA COMMUNITY COLLEGE              ,WA,98011-9510,Public       ,29,51,80,491,642,1133
03490400,EMIL FRIES PIANO HOSPITAL & TRAININ     ,WA,98661-4323,Private      ,0,1,1,1,6,7
03631500,CORTIVA INSTITUTE - BRIAN UTTING SCHOOL ,WA,98109-5211,Proprietary  ,2,10,12,26,101,127
03689400,FAITH EVANGELICAL SEMINARY              ,WA,98407-2607,Private      ,0,13,13,7,164,171
03707500,CHETTA'S ACADEMY OF HAIR AND NAILS      ,WA,98362-4310,Proprietary  ,0,2,2,10,27,37
03724300,DIGIPEN INSTITUTE OF TECHNOLOGY         ,WA,98052-5170,Proprietary  ,13,2,15,646,187,833
03917300,EVERGREEN BEAUTY AND BARBER COLLEGE     ,WA,98208-3759,Proprietary  ,6,14,20,23,95,118
03932500,TOTAL COSMETOLOGY TRAINING CENTER       ,WA,99217-6231,Proprietary  ,3,6,9,36,80,116
03953300,YAKIMA BEAUTY SCHOOL;BEAUTYWORKS        ,WA,98901-2202,Proprietary  ,1,6,7,17,52,69
04043400,ALPINE COLLEGE                          ,WA,99206-5097,Proprietary  ,2,9,11,7,52,59
00340100,BROWN UNIVERSITY                        ,RI,02912-9127,Private      ,65,11,76,10854,305,11159
00340101,BROWN UNIVERSITY - GRADUATE SCHOOL      ,RI,02912-1827,Private      ,0,25,25,22,1419,1441
00340102,BROWN MEDICAL SCHOOL                    ,RI,02912-0000,Private      ,0,2,2,15,370,385
00340200,BRYANT UNIVERSITY                       ,RI,02917-1284,Private      ,48,6,54,4839,292,5131
00340400,JOHNSON & WALES UNIVERSITY              ,RI,02903-3703,Private      ,228,127,355,17842,3629,21471
00340600,PROVIDENCE COLLEGE                      ,RI,02918-0001,Private      ,43,13,56,6694,523,7217
00340700,RHODE ISLAND COLLEGE                    ,RI,02908-1991,Public       ,65,70,135,5790,2837,8627
00340800,COMMUNITY COLLEGE OF RI - WARWICK       ,RI,02906-0000,Public       ,102,141,243,3525,4392,7917
00340801,COMMUNITY COLLEGE OF RI - LINCOLN       ,RI,02865-4585,Public       ,39,47,86,1297,1470,2767
00340802,COMMUNITY COLLEGE OF RI- PROVIDENCE     ,RI,02905-2313,Public       ,38,63,101,1297,2092,3389
00340900,RHODE ISLAND SCHOOL OF DESIGN           ,RI,02903-2784,Private      ,27,3,30,2346,1096,3442
00341000,ROGER WILLIAMS UNIVERSITY               ,RI,02809-2921,Private      ,42,13,55,6290,1442,7732
00341100,SALVE REGINA UNIVERSITY                 ,RI,02840-4192,Private      ,31,13,44,3928,293,4221
00341400,UNIVERSITY OF RHODE ISLAND              ,RI,02881-0000,Public       ,157,109,266,13936,3151,17087
00659100,ST. JOSEPH HOSP SCH OF NURSING          ,RI,02904-5199,Private      ,1,2,3,54,134,188
00784400,GIBBS COLLEGE                           ,RI,02920-7807,Proprietary  ,29,80,109,452,743,1195
00784500,NEW ENGLAND INSTITUTE OF TECHNOLOGY     ,RI,02886-2266,Private      ,133,197,330,2552,1909,4461
01115900,"SAWYER SCHOOL,THE                       ",RI,02860-4117,Proprietary  ,22,127,149,170,928,1098
02071900,ARTHUR ANGELO SCH COSMET&HAIR DSGN      ,RI,02903-0000,Proprietary  ,11,23,34,114,161,275
02176900,WARWICK ACADEMY OF BEAUTY CULTURE       ,RI,02886-1534,Proprietary  ,8,10,18,88,138,226
02584400,NEW ENGLAND TRACTOR TRAILER TRAINING SCH,RI,02860-1752,Proprietary  ,30,240,270,103,934,1037
03080000,NEWPORT SCHOOL OF HAIRDRESSING          ,RI,02860-4038,Proprietary  ,1,15,16,14,100,114
03115200,MOTORING TECHNICAL TRAINING INST        ,RI,02914-0000,Proprietary  ,15,37,52,115,229,344
03232300,LINCOLN TECHNICAL INSTITUTE             ,RI,02865-4211,Proprietary  ,41,159,200,283,815,1098
03570500,ZION BIBLE COLLEGE                      ,RI,02806-1246,Private      ,3,2,5,139,102,241
03732300,INTERNATIONAL YACHT RESTORATION SCH     ,RI,02840-6720,Private      ,0,0,0,9,10,19
00341700,ALLEN UNIVERSITY                        ,SC,29204-1085,Private      ,17,14,31,575,349,924
00341800,ANDERSON UNIVERSITY                     ,SC,29621-4035,Private      ,10,36,46,1642,589,2231
00341900,CHARLESTON SOUTHERN UNIVERSITY          ,SC,29406-2160,Private      ,42,58,100,3157,1585,4742
00342000,BENEDICT COLLEGE                        ,SC,29204-1086,Private      ,51,57,108,2885,1342,4227
00342200,SOUTHERN WESLEYAN UNIVERSITY            ,SC,29630-1020,Private      ,12,218,230,624,2486,3110
00342300,THE CITADEL                             ,SC,29409-0002,Public       ,31,48,79,2093,902,2995
00342400,CLAFLIN UNIVERSITY                      ,SC,29115-4498,Private      ,57,45,102,2182,922,3104
00342500,CLEMSON UNIVERSITY                      ,SC,29634-0001,Public       ,108,72,180,11471,2819,14290
00342600,UNIV OF SC AT SUMTER                    ,SC,29150-2498,Public       ,12,38,50,586,631,1217
00342700,COKER COLLEGE                           ,SC,29550-3797,Private      ,17,24,41,826,927,1753
00342800,COLLEGE OF CHARLESTON                   ,SC,29424-0100,Public       ,86,50,136,7551,2072,9623
00342900,COLUMBIA INTERNATIONAL UNIVERSITY       ,SC,29203-1599,Private      ,6,14,20,542,623,1165
00343000,COLUMBIA COLLEGE                        ,SC,29203-5998,Private      ,15,37,52,1203,1117,2320
00343100,CONVERSE COLLEGE                        ,SC,29302-0006,Private      ,10,33,43,715,700,1415
00343200,ERSKINE COLLEGE                         ,SC,29639-0000,Private      ,8,1,9,749,38,787
00343201,ERSKINE THEOLOGICAL SEMINARY            ,SC,29639-0000,Private      ,0,7,7,7,184,191
00343400,FURMAN UNIVERSITY                       ,SC,29613-5253,Private      ,27,10,37,2688,315,3003
00343500,LANDER UNIVERSITY                       ,SC,29649-2099,Public       ,25,12,37,2584,748,3332
00343600,LIMESTONE COLLEGE                       ,SC,29340-3799,Private      ,21,141,162,1034,3004,4038
00343700,LUTHERAN THEOLOGICAL SOUTHERN SEM       ,SC,29203-5898,Private      ,0,1,1,1,109,110
00343800,MEDICAL UNIV OF SOUTH CAROLINA - FA     ,SC,29425-1760,Public       ,3,34,37,214,2673,2887
00343900,MORRIS COLLEGE                          ,SC,29150-3599,Private      ,33,19,52,1174,427,1601
00344000,NEWBERRY COLLEGE                        ,SC,29108-2197,Private      ,15,6,21,1182,148,1330
00344100,NORTH GREENVILLE COLLEGE                ,SC,29688-1892,Private      ,16,8,24,1971,302,2273
00344500,PRESBYTERIAN COLLEGE                    ,SC,29325-2503,Private      ,5,0,5,1226,35,1261
00344600,SOUTH CAROLINA STATE UNIVERSITY         ,SC,29117-4427,Public       ,81,120,201,5556,2300,7856
00344700,SPARTANBURG METHODIST COLLEGE           ,SC,29301-5899,Private      ,18,4,22,1121,151,1272
00344800,UNIVERSITY OF SOUTH CAROLINA            ,SC,29208-3999,Public       ,195,255,450,15878,9374,25252
00344900,UNIVERSITY OF SOUTH CAROLINA AIKEN      ,SC,29801-6399,Public       ,29,37,66,2612,1317,3929
00345000,UNIV OF SC AT BEAUFORT                  ,SC,29902-4602,Public       ,19,33,52,635,688,1323
00345100,COASTAL CAROLINA UNIVERSITY             ,SC,29528-0000,Public       ,99,50,149,7110,1605,8715
00345300,UNIV OF SC AT LANCASTER                 ,SC,29721-0889,Public       ,15,35,50,617,578,1195
00345400,UNIV OF SC SYSTEM SALKEHATCHIE          ,SC,29810-0617,Public       ,12,21,33,456,401,857
00345500,VOORHEES COLLEGE                        ,SC,29042-0000,Private      ,18,27,45,667,503,1170
00345600,WINTHROP UNIVERSITY                     ,SC,29733-0001,Public       ,57,48,105,5282,1641,6923
00345700,WOFFORD COLLEGE                         ,SC,29303-3663,Private      ,10,2,12,1431,70,1501
00399000,FLORENCE-DARLINGTON TECH COLLEGE        ,SC,29501-0548,Public       ,83,170,253,2520,3745,6265
00399100,GREENVILLE TECHNICAL COLLEGE            ,SC,29607-2439,Public       ,236,604,840,5858,10186,16044
00399200,PIEDMONT TECHNICAL COLLEGE              ,SC,29648-1467,Public       ,76,250,326,1876,4114,5990
00399300,MIDLANDS TECHNICAL COLLEGE              ,SC,29202-0000,Public       ,189,445,634,5958,9230,15188
00399400,SPARTANBURG COMMUNITY COLLEGE           ,SC,29305-4386,Public       ,78,158,236,2471,3894,6365
00399500,CENTRAL CAROLINA TECHNICAL COLLEGE      ,SC,29150-2499,Public       ,45,186,231,1160,2900,4060
00399600,YORK TECHNICAL COLLEGE                  ,SC,29730-3395,Public       ,80,358,438,2336,4319,6655
00492000,TRIDENT TECHNICAL COLLEGE               ,SC,29423-8067,Public       ,220,461,681,5665,8779,14444
00492300,CLINTON JR COLLEGE                      ,SC,29730-5152,Private      ,4,4,8,100,38,138
00492400,FORREST JUNIOR COLLEGE                  ,SC,29624-2405,Proprietary  ,4,26,30,28,192,220
00492500,HORRY-GEORGETOWN TECH COLLEGE           ,SC,29526-9521,Public       ,134,249,383,2556,4110,6666
00492600,TRI-COUNTY TECHNICAL COLLEGE            ,SC,29670-9133,Public       ,85,174,259,2764,3247,6011
00492700,UNIV OF SC AT UNION                     ,SC,29379-0729,Public       ,5,13,18,201,180,381
00536300,DENMARK TECHNICAL COLLEGE               ,SC,29042-0000,Public       ,106,106,212,948,899,1847
00681500,ORANGEBURG-CALHOUN TECHNICAL COLG       ,SC,29118-8299,Public       ,47,119,166,1329,2281,3610
00695100,UNIVERSITY OF SOUTH CAROLINA UPSTATE    ,SC,29303-9972,Public       ,54,55,109,3852,2181,6033
00760200,NORTHEASTERN TECHNICAL COLLEGE          ,SC,29520-7015,Public       ,9,61,70,499,1124,1623
00922600,FRANCIS MARION UNIVERSITY               ,SC,29501-0000,Public       ,35,38,73,3826,1274,5100
00932200,WILLIAMSBURG TECHNICAL COLLEGE          ,SC,29556-4197,Public       ,17,55,72,326,679,1005
00991000,TECHNICAL COLLEGE OF THE LOWCOUNTRY     ,SC,29902-5441,Public       ,43,142,185,701,1771,2472
00991100,UNIV OF SC-REGIONAL CAMPUSES ADMIN      ,SC,29208-0001,Public       ,3,3,6,107,57,164
01005600,AIKEN TECHNICAL COLLEGE                 ,SC,29802-0696,Public       ,49,144,193,1510,2666,4176
01209200,KENNETH SHULER SCHOOL OF COSMETOLOGY    ,SC,29732-2169,Proprietary  ,2,7,9,14,36,50
01303907,SOUTH UNIVERSITY                        ,SC,29203-6400,Proprietary  ,20,133,153,201,1174,1375
02063700,SHERMAN CLG STRAIGHT CHIROPRACTIC       ,SC,29316-0000,Private      ,0,4,4,18,441,459
02189800,NO AMER INST OF AVIATION OF SO CAR      ,SC,29527-0000,Proprietary  ,0,0,0,0,12,12
02310300,COLUMBIA BEAUTY SCHOOL                  ,SC,29033-0000,Proprietary  ,0,0,0,11,44,55
02338600,CHARZANNE BEAUTY COLLEGE                ,SC,29649-0000,Proprietary  ,1,13,14,20,87,107
02341100,KENNETH SHULER SCHOOL OF COSMETOLOGY & N,SC,29210-0000,Proprietary  ,18,61,79,145,395,540
02356600,CHARLESTON COSMETOLOGY INSTITUTE        ,SC,29420-0000,Proprietary  ,17,14,31,79,126,205
02552400,ACADEMY OF HAIR TECHNOLOGY              ,SC,29615-2363,Proprietary  ,6,18,24,58,111,169
02567600,SUMTER BEAUTY COLLEGE                   ,SC,29150-0000,Proprietary  ,4,4,8,20,91,111
02614202,MILLER - MOTTE TECHNICAL COLLEGE - NORTH,SC,29406-9239,Proprietary  ,27,148,175,271,1024,1295
03010614,VIRGINIA COLLEGE - GOLF ACADEMY OF AMERI,SC,29579-0000,Proprietary  ,15,24,39,227,210,437
03052300,KENNETH SHULER SCH COSM & HAIR DESG     ,SC,29841-2013,Proprietary  ,3,22,25,40,105,145
03088300,ACADEMY OF COSMETOLOGY                  ,SC,29418-5667,Proprietary  ,2,5,7,42,130,172
03258300,SOUTHERN METHODIST COLLEGE              ,SC,29116-1027,Private      ,0,0,0,7,51,58
03293300,STRAND COLLEGE OF HAIR DESIGN           ,SC,29572-4310,Proprietary  ,5,12,17,33,74,107
03304300,CENTURA COLLEGE                         ,SC,29406-9235,Proprietary  ,49,189,238,209,878,1087
03513300,LACY COSMETOLOGY SCHOOL                 ,SC,29803-9084,Proprietary  ,2,12,14,31,78,109
03513301,LACY COSMETOLOGY SCHOOL -               ,SC,29072-0000,Proprietary  ,4,4,8,4,4,8
03595300,CHARLESTON SCHOOL OF MASSAGE            ,SC,29412-8270,Proprietary  ,1,5,6,15,45,60
03746300,LEGRAND INSTITUTE OF COSMETOLOGY        ,SC,29020-0000,Proprietary  ,0,4,4,17,46,63
03746400,SOUTHEASTERN INSTITUTE                  ,SC,29210-0000,Proprietary  ,1,16,17,34,113,147
03768400,STYLETRENDS BARBER AND HAIRSTYLING ACADE,SC,29730-4511,Proprietary  ,1,5,6,7,49,56
03842300,PLATINUM SHEAR SCHOOL OF COSMETOLOGY    ,SC,29115-0000,Proprietary  ,1,9,10,13,24,37
03856400,W. L. BONNER COLLEGE                    ,SC,29203-0000,Private      ,0,4,4,6,62,68
03892300,HARLEY'S BEAUTY & BARBER CAREER INST.   ,SC,29204-1919,Proprietary  ,1,7,8,14,60,74
00345800,AUGUSTANA COLLEGE                       ,SD,57197-0001,Private      ,14,9,23,1753,231,1984
00345900,BLACK HILLS STATE UNIVERSITY            ,SD,57799-9670,Public       ,28,44,72,2193,1481,3674
00346100,DAKOTA WESLEYAN UNIVERSITY              ,SD,57301-4398,Private      ,4,10,14,637,356,993
00346300,DAKOTA STATE UNIVERSITY                 ,SD,57042-1799,Public       ,11,17,28,1187,531,1718
00346500,MOUNT MARTY COLLEGE                     ,SD,57078-3724,Private      ,11,20,31,580,580,1160
00346600,NORTHERN STATE UNIVERSITY               ,SD,57401-7198,Public       ,12,21,33,1498,655,2153
00346700,PRESENTATION COLLEGE                    ,SD,57401-1299,Private      ,5,15,20,369,592,961
00346900,UNIVERSITY OF SIOUX FALLS               ,SD,57105-1699,Private      ,10,22,32,1210,552,1762
00347000,SOUTH DAKOTA SCH OF MINES & TECH        ,SD,57701-3995,Public       ,10,9,19,1227,559,1786
00347100,SOUTH DAKOTA STATE UNIVERSITY           ,SD,57007-2298,Public       ,78,70,148,7348,2576,9924
00347400,UNIVERSITY OF SOUTH DAKOTA              ,SD,57069-2390,Public       ,50,92,142,4474,3917,8391
00405600,SIOUX FALLS SEMINARY                    ,SD,57105-2729,Private      ,0,2,2,0,89,89
00405700,NATIONAL AMERICAN UNIVERSITY            ,SD,57701-3692,Proprietary  ,64,673,737,603,4657,5260
00405707,NATIONAL AMERICAN UNIVERSITY            ,SD,57105-0000,Proprietary  ,1,13,14,48,263,311
00492900,MCKENNAN HOSP-RADOLOGICAL TECH          ,SD,57101-0000,Private      ,0,1,1,33,16,49
00530900,LAKE AREA TECHNICAL INSTITUTE           ,SD,57201-2869,Public       ,11,12,23,778,371,1149
00598700,AVERA SACRED HEART HOSPITAL SCHOOL OF RA,SD,57078-3899,Private      ,0,0,0,12,5,17
00776400,SOUTHEAST TECHNICAL INST                ,SD,57107-0000,Public       ,24,40,64,1466,1021,2487
00828400,MITCHELL TECHNICAL INSTITUTE            ,SD,57301-2002,Public       ,10,9,19,515,321,836
01013800,STEWART SCHOOL                          ,SD,57104-0000,Proprietary  ,8,7,15,120,69,189
01014804,COLORADO TECHNICAL UNIVERSITY           ,SD,57108-2272,Proprietary  ,11,63,74,382,1003,1385
01017000,WESTERN DAKOTA TECHNICAL INSTITUTE      ,SD,57701-4018,Public       ,14,44,58,536,831,1367
01147701,SIOUX VALLEY HOSP-MEDICAL TECH          ,SD,57117-5039,Private      ,0,1,1,19,15,34
01465900,OGLALA LAKOTA COLLEGE                   ,SD,57752-0490,Public       ,38,182,220,271,1305,1576
02137100,BLACK HILLS BEAUTY COLLEGE              ,SD,57701-0000,Proprietary  ,6,8,14,60,79,139
02143700,SINTE GLESKA UNIVERSITY                 ,SD,57570-0000,Public       ,17,108,125,143,715,858
02144600,KILIAN COMMUNITY COLLEGE                ,SD,57103-7020,Private      ,14,44,58,154,614,768
02277300,SISSETON WAHPETON COLLEGE               ,SD,57262-0000,Public       ,7,41,48,51,194,245
02297800,HEADLINES ACADEMY                       ,SD,57701-0000,Proprietary  ,2,9,11,44,88,132
00347700,AQUINAS COLLEGE                         ,TN,37205-2086,Private      ,4,24,28,253,766,1019
00347701,AQUINAS COLLEGE -  PRIMETIME PROGRAM    ,TN,37214-3644,Private      ,1,41,42,13,369,382
00347800,AUSTIN PEAY STATE UNIVERSITY            ,TN,37044-0002,Public       ,110,325,435,5292,6283,11575
00347900,BELMONT UNIVERSITY                      ,TN,37212-3757,Private      ,50,54,104,3985,1902,5887
00348000,BETHEL COLLEGE                          ,TN,38201-1705,Private      ,28,130,158,1067,1772,2839
00348100,CARSON-NEWMAN COLLEGE                   ,TN,37760-2204,Private      ,37,14,51,2485,541,3026
00348200,CHRISTIAN BROTHERS UNIVERSITY           ,TN,38104-5581,Private      ,32,64,96,1671,1360,3031
00348300,COLUMBIA STATE COMMUNITY COLLEGE        ,TN,38401-5653,Public       ,63,114,177,2144,2518,4662
00348500,CUMBERLAND UNIVERSITY                   ,TN,37087-3554,Private      ,22,53,75,1310,809,2119
00348600,LIPSCOMB UNIVERSITY                     ,TN,37204-3951,Private      ,22,39,61,2418,633,3051
00348700,EAST TENNESSEE STATE UNIV - MAIN CAMPUS ,TN,37614-2857,Public       ,104,182,286,8277,5685,13962
00348701,EAST TENNESSEE STATE UNIV - MEDICINE    ,TN,37614-1708,Public       ,1,3,4,75,264,339
00348709,EAST TENNESSEE STATE UNIV - PHARMACY    ,TN,37614-1704,Public       ,21,33,54,24,73,97
00349000,FISK UNIVERSITY                         ,TN,37208-3045,Private      ,33,13,46,1777,427,2204
00349200,FREED-HARDEMAN UNIVERSITY               ,TN,38340-2399,Private      ,17,31,48,1529,817,2346
00349400,HIWASSEE COLLEGE                        ,TN,37354-4001,Private      ,10,4,14,424,106,530
00349500,JOHNSON BIBLE COLLEGE                   ,TN,37998-9775,Private      ,7,10,17,644,256,900
00349600,KING COLLEGE                            ,TN,37620-2699,Private      ,10,21,31,1153,673,1826
00349800,LAMBUTH UNIVERSITY                      ,TN,38301-5296,Private      ,14,3,17,1254,301,1555
00349900,LANE COLLEGE                            ,TN,38301-4598,Private      ,49,76,125,2153,743,2896
00350000,LEE UNIVERSITY                          ,TN,37320-0000,Private      ,46,40,86,3121,1210,4331
00350100,LEMOYNE-OWEN COLLEGE                    ,TN,38126-6510,Private      ,10,35,45,833,971,1804
00350200,LINCOLN MEMORIAL UNIVERSITY             ,TN,37752-7920,Private      ,19,51,70,1165,2352,3517
00350400,MARTIN METHODIST COLLEGE                ,TN,38478-2799,Private      ,7,22,29,761,422,1183
00350500,MARYVILLE COLLEGE                       ,TN,37804-5907,Private      ,12,9,21,1722,183,1905
00350600,MEHARRY MEDICAL COLLEGE                 ,TN,37208-0000,Private      ,2,3,5,36,1213,1249
00350700,MEMPHIS COLLEGE OF ART                  ,TN,38104-2764,Private      ,13,2,15,519,175,694
00350900,UNIVERSITY OF MEMPHIS (THE)             ,TN,38152-4611,Public       ,267,403,670,13157,13344,26501
00351000,MIDDLE TENNESSEE STATE UNIV             ,TN,37130-0000,Public       ,248,268,516,17232,8505,25737
00351100,MILLIGAN COLLEGE                        ,TN,37682-4001,Private      ,9,21,30,891,463,1354
00351700,SOUTHERN COLLEGE OF OPTOMETRY           ,TN,38104-2222,Private      ,1,1,2,23,566,589
00351800,SOUTHERN ADVENTIST UNIVERSITY           ,TN,37315-0370,Private      ,44,18,62,1951,586,2537
00351900,RHODES COLLEGE                          ,TN,38112-1690,Private      ,27,3,30,2282,214,2496
00352200,TENNESSEE STATE UNIVERSITY              ,TN,37209-1561,Public       ,184,214,398,9211,7110,16321
00352300,TENNESSEE TECHNOLOGICAL UNIV            ,TN,38505-0001,Public       ,64,118,182,6721,3027,9748
00352400,TENNESSEE TEMPLE UNIVERSITY             ,TN,37404-3587,Private      ,10,14,24,504,176,680
00352500,TENNESSEE WESLEYAN COLLEGE              ,TN,37371-0040,Private      ,4,10,14,863,388,1251
00352600,TREVECCA NAZARENE UNIVERSITY            ,TN,37210-2877,Private      ,25,102,127,1097,1676,2773
00352700,TUSCULUM COLLEGE                        ,TN,37743-0001,Private      ,32,135,167,1598,2096,3694
00352800,UNION UNIVERSITY                        ,TN,38305-3697,Private      ,24,114,138,1896,1667,3563
00352900,UNIVERSITY OF TENNESSEE-CHATTANOOGA     ,TN,37403-2598,Public       ,113,95,208,8178,3254,11432
00353000,UNIVERSITY OF TENNESSEE-KNOXVILLE       ,TN,37996-0150,Public       ,271,176,447,21252,7892,29144
00353006,UNIVERSITY OF TENNESSEE-HEALTH SCI CTR  ,TN,38103-0000,Public       ,9,24,33,326,2685,3011
00353100,UNIVERSITY OF TENNESSEE-MARTIN          ,TN,38238-0002,Public       ,84,69,153,5886,2370,8256
00353400,UNIVERSITY OF THE SOUTH                 ,TN,37383-1000,Private      ,15,3,18,1301,61,1362
00353500,VANDERBILT UNIVERSITY                   ,TN,37240-0001,Private      ,75,73,148,7365,4377,11742
00353501,VANDERBILT UNIV MED CTR ALLIEDHEAL      ,TN,37232-5510,Private      ,1,2,3,28,185,213
00353502,VANDERBILT UNIV - SCH OF MED            ,TN,37232-0000,Private      ,2,6,8,57,803,860
00353600,BRYAN COLLEGE                           ,TN,37321-7000,Private      ,10,36,46,847,400,1247
00399800,CHATTANOOGA STATE COMMUNITY COLLEGE     ,TN,37406-1097,Public       ,115,281,396,3250,5362,8612
00399900,CLEVELAND STATE COMMUNITY COLLEGE       ,TN,37312-2858,Public       ,49,79,128,1259,1693,2952
00402500,TN TECHNOLOGY CTR AT KNOXVILLE          ,TN,37919-2327,Public       ,26,88,114,380,863,1243
00402600,TENNESSEE TECH. CNTR AT CROSSVILLE      ,TN,38555-4142,Public       ,19,36,55,245,443,688
00461700,NATIONAL COLLEGE OF BUSINESS & TECH     ,TN,37211-6605,Proprietary  ,26,148,174,144,926,1070
00493400,DRAUGHONS JR CLG OF BUSINESS            ,TN,37217-1056,Proprietary  ,64,307,371,485,2963,3448
00493700,JACKSON STATE COMMUNITY COLLEGE         ,TN,38301-3797,Public       ,46,104,150,2113,2920,5033
00493800,SOUTH COLLEGE                           ,TN,37909-3323,Proprietary  ,31,219,250,306,1352,1658
00494700,WEST TENNESSEE BUSINESS COLLEGE         ,TN,38301-3256,Proprietary  ,12,67,79,117,505,622
00528000,TN TECHNOLOGY CTR AT COVINGTON          ,TN,38019-0249,Public       ,2,37,39,87,229,316
00528100,TN TECHNOLOGY CTR AT ELIZABETHTON       ,TN,37643-0789,Public       ,13,83,96,191,739,930
00528200,TN TECHNOLOGY CTR AT HARTSVILLE         ,TN,37074-0000,Public       ,4,12,16,103,280,383
00528300,TN TECHNOLOGY CTR AT NEWBERN            ,TN,38059-1198,Public       ,4,74,78,105,355,460
00530700,TN TECHNOLOGY CTR AT MCMINNVILLE        ,TN,37110-1322,Public       ,4,11,15,120,423,543
00535100,TENNESSEE TECHNOLOGY CENTER AT MORRISTOW,TN,37813-2094,Public       ,15,68,83,355,855,1210
00535200,TN TECHNOLOGY CENTER AT MCKENZIE        ,TN,38201-1620,Public       ,8,19,27,152,305,457
00535300,TN TECHNOLOGY CENTER AT LIVINGSTON      ,TN,38570-0219,Public       ,16,78,94,206,491,697
00535400,TN TECHNOLOGY CTR AT JACKSON            ,TN,38301-0000,Public       ,5,24,29,344,740,1084
00535600,TENNESSEE TECHNOLOGY CENTER AT HOHENWALD,TN,38462-0000,Public       ,10,29,39,192,472,664
00535700,TENNESSEE TECHNOLOGY CENTER AT CRUMP    ,TN,38327-3402,Public       ,10,30,40,154,424,578
00535800,TN TECHNOLOGY CENTER AT ATHENS          ,TN,37371-0848,Public       ,9,19,28,158,254,412
00535900,TENNESSEE TECHNOLOGY CENTER AT NASHVILLE,TN,37209-0000,Public       ,21,75,96,364,1003,1367
00536000,TENNESSEE TECHNOLOGY CENTER AT MEMPHIS  ,TN,38105-3604,Public       ,36,114,150,559,1588,2147
00537800,NORTHEAST STATE TECH CMNTY COLG         ,TN,37617-0246,Public       ,86,175,261,2239,2891,5130
00537900,TN TECHNOLOGY CTR AT SHELBYVILLE        ,TN,37160-3697,Public       ,4,23,27,317,644,961
00660000,METHODIST HOSP SCH OF NURSING           ,TN,38104-3499,Private      ,0,0,0,55,109,164
00683500,DYERSBURG STATE COMMUNITY COLLEGE       ,TN,38024-0000,Public       ,38,94,132,1262,1946,3208
00683600,MOTLOW STATE COMMUNITY COLLEGE          ,TN,37388-7972,Public       ,61,123,184,1670,1845,3515
00743900,FOUNTAINHEAD COLLEGE OF TECHNOLOGY      ,TN,37918-2583,Proprietary  ,6,22,28,97,199,296
00744000,NASHVILLE AUTO DIESEL COLLEGE           ,TN,37206-3298,Proprietary  ,210,114,324,2408,905,3313
00778200,TENNESSEE TECHNOLOGY CENTER AT DICKSON  ,TN,37055-0000,Public       ,19,87,106,218,667,885
00778300,MIDDLE TENNESSEE SCH OF ANESTHESIA      ,TN,37116-0417,Private      ,0,0,0,8,161,169
00814500,NASHVILLE STATE TECH CMNTY COLLEGE      ,TN,37209-0000,Public       ,88,212,300,2151,4583,6734
00865500,GENESIS CAREER COLLEGE OF COOKEVILLE    ,TN,38501-1959,Proprietary  ,5,16,21,59,105,164
00885900,JOHN A GUPTON COLLEGE                   ,TN,37203-2934,Private      ,5,9,14,54,119,173
00886300,WALTERS STATE COMMUNITY COLLEGE         ,TN,37813-6899,Public       ,63,133,196,2889,3214,6103
00946400,TN TECHNOLOGY CTR AT PULASKI            ,TN,38478-4541,Public       ,15,56,71,109,510,619
00956700,TENNESSEE SCHOOL OF BEAUTY              ,TN,37921-3303,Proprietary  ,9,33,42,96,238,334
00971000,TENNESSEE TECHNOLOGY CENTER AT ONEIDA/HU,TN,37756-4149,Public       ,8,33,41,73,261,334
00991200,VOLUNTEER STATE COMMUNITY COLLEGE       ,TN,37066-3188,Public       ,74,181,255,2749,3455,6204
00991400,ROANE STATE COMMUNITY COLLEGE           ,TN,37748-8664,Public       ,58,131,189,2403,3168,5571
00998200,CRICHTON COLLEGE                        ,TN,38111-4745,Private      ,21,93,114,529,1306,1835
01021700,INTERNATIONAL ACADEMY OF DESIGN & TECH  ,TN,37212-0000,Proprietary  ,43,74,117,798,889,1687
01032600,TN TECHNOLOGY CTR AT HARRIMAN           ,TN,37748-1109,Public       ,8,15,23,146,291,437
01043900,SOUTHWEST TENNESSEE COMMUNITY COLLG     ,TN,38104-3322,Public       ,186,487,673,5093,10427,15520
01044700,"PLAZA BEAUTY SCHOOL, INC.               ",TN,38117-4822,Proprietary  ,11,22,33,66,140,206
01046000,AMERICAN BAPTIST THEOLOGICAL SEMINA     ,TN,37207-4994,Private      ,2,4,6,20,101,121
01052900,MEMPHIS THEOLOGICAL SEMINARY            ,TN,38104-0000,Private      ,0,6,6,7,171,178
01070000,TN TECHNOLOGY CENTER AT JACKSBORO       ,TN,37757-2461,Public       ,6,14,20,114,253,367
01155300,WM R MOORE COLLEGE OF TECHNOLOGY        ,TN,38104-0000,Private      ,1,5,6,43,75,118
01216400,TENNESSEE TECHNICAL CNTR AT RIPLEY      ,TN,38063-7359,Public       ,3,26,29,49,269,318
01254700,EMMANUEL SCHOOL OF RELIGION             ,TN,37601-0000,Private      ,0,3,3,3,54,57
01269300,PELLISSIPPI STATE COMMUNITY COLLEGE     ,TN,37933-0990,Public       ,125,174,299,3466,3309,6775
02092800,TENNESSEE TECHNOLOGY CENTER AT WHITEVILL,TN,38075-0000,Public       ,11,36,47,105,270,375
02103500,TN TECHNOLOGY CTR AT MURFREESBORO       ,TN,37129-0000,Public       ,9,14,23,207,403,610
02106400,O'MORE COLLEGE OF DESIGN                ,TN,37064-0000,Private      ,5,0,5,181,81,262
02125300,NASHVILLE CLG OF MEDICAL CAREERS        ,TN,37115-0000,Proprietary  ,6,52,58,37,302,339
02153100,JON NAVE UNIVERSITY OF COSMETOLOGY      ,TN,37013-3347,Proprietary  ,7,14,21,63,111,174
02157100,CONCORDE CAREER COLLEGE                 ,TN,38137-0000,Proprietary  ,39,215,254,334,1666,2000
02188300,PENTECOSTAL THEOLOGICAL SEMINARY        ,TN,37320-0000,Private      ,0,14,14,2,199,201
02204200,"CHATTANOOGA COLLEGE - MEDICAL, DENTAL AN",TN,37411-0000,Proprietary  ,2,41,43,26,299,325
02237900,TN TECHNOLOGY CENTER AT PARIS           ,TN,38242-0000,Public       ,13,30,43,154,594,748
02257400,ARNOLD'S BEAUTY SCHOOL                  ,TN,38358-0000,Proprietary  ,5,11,16,36,50,86
02274500,ACADEMY OF COSMETOLOGY                  ,TN,38111-0000,Proprietary  ,0,0,0,1,0,1
02275500,REUBEN-ALLEN COLLEGE                    ,TN,37922-0000,Proprietary  ,2,6,8,24,38,62
02278700,MR WAYNES SCH OF UNISEX HAIR DESIGN     ,TN,38501-0000,Proprietary  ,4,5,9,19,25,44
02293900,VOLUNTEER BEAUTY ACADEMY-NASHVILLE      ,TN,37115-2112,Proprietary  ,4,12,16,36,82,118
02294000,VOLUNTEER BEAUTY ACADEMY-DYERSBURG      ,TN,38024-1622,Proprietary  ,4,17,21,29,82,111
02326200,KAPLAN CAREER INSTITUTE                 ,TN,37217-1342,Proprietary  ,14,66,80,116,502,618
02326300,MEDVANCE INSTITUTE                      ,TN,38501-4305,Proprietary  ,39,166,205,338,1339,1677
02335900,VOLUNTEER BEAUTY ACADEMY-NASHVILLE      ,TN,37209-3033,Proprietary  ,1,12,13,30,100,130
02359800,ITT TECHNICAL INSTITUTE                 ,TN,37214-3717,Proprietary  ,148,313,461,1236,2296,3532
02498000,NEW WAVE HAIR ACADEMY                   ,TN,38128-0000,Proprietary  ,1,23,24,37,175,212
02539800,QUEEN CITY COLLEGE                      ,TN,37042-0000,Proprietary  ,5,32,37,37,216,253
02540000,TENNESSEE ACADEMY OF COSMETOLOGY        ,TN,38133-0000,Proprietary  ,8,13,21,61,167,228
02578200,NOSSI COLLEGE OF ART                    ,TN,37072-0000,Proprietary  ,13,35,48,240,329,569
02595000,FAYETTEVILLE BEAUTY SCHOOL              ,TN,37334-2909,Proprietary  ,4,16,20,24,98,122
02597600,NEW WAVE HAIR ACADEMY                   ,TN,38301-3812,Proprietary  ,5,24,29,56,218,274
02599710,VATTEROTT COLLEGE - MEMPHIS             ,TN,38132-1714,Proprietary  ,21,148,169,119,719,838
02605501,REMINGTON COLLEGE - MEMPHIS CAMPUS      ,TN,38132-0000,Proprietary  ,38,275,313,370,1717,2087
02614200,MILLER MOTTE BUSINESS COLLEGE           ,TN,37040-6023,Proprietary  ,20,132,152,167,824,991
02614203,MILLER - MOTTE TECHNICAL COLLEGE - CHATT,TN,37421-7220,Proprietary  ,30,159,189,221,1049,1270
02614204,MILLER - MOTTE TECHNICAL COLLEGE - GOODL,TN,37072-1870,Proprietary  ,5,72,77,64,404,468
03001800,FREE WILL BAPTIST BIBLE COLLEGE         ,TN,37205-2498,Private      ,1,11,12,263,100,363
03008800,FRANKLIN ACADEMY                        ,TN,37312-3939,Private      ,3,6,9,29,63,92
03010606,VIRGINIA COLLEGE - SCH OF BUSNSS & HLTH ,TN,37411-5600,Proprietary  ,1,7,8,1,7,8
03012500,NEW WAVE HAIR ACADEMY                   ,TN,38111-4253,Proprietary  ,11,79,90,95,467,562
03024900,TENNESSEE ACADEMY OF COSMETOLOGY        ,TN,38125-3442,Proprietary  ,3,16,19,48,162,210
03061100,GENESIS CAREER COLLEGE OF LEBANON       ,TN,37087-2718,Proprietary  ,14,38,52,57,234,291
03073400,ITT TECHNICAL INSTITUTE                 ,TN,37932-3343,Proprietary  ,246,359,605,1717,2502,4219
03079100,NORTH CENTRAL INSTITUTE                 ,TN,37042-3116,Proprietary  ,1,6,7,21,82,103
03088800,WATKINS INSTITUTE COLLEGE OF ART & DESIG,TN,37228-1306,Private      ,6,6,12,285,246,531
03126900,STYLES & PROFILES BEAUTY COLLEGE        ,TN,38375-2109,Proprietary  ,0,4,4,5,23,28
03149300,NEW DIRECTIONS HAIR ACADEMY             ,TN,37209-0000,Proprietary  ,18,52,70,145,334,479
03355400,RICHMONT GRADUATE UNIVERSITY            ,TN,37404-0000,Private      ,0,3,3,5,181,186
03440300,BAPTIST MEMORIAL COLLEGE OF HEALTH      ,TN,38104-3104,Private      ,6,17,23,610,1023,1633
03454300,TENNESSEE CAREER COLLEGE                ,TN,37214-2945,Proprietary  ,0,15,15,25,133,158
03487300,TEMPLE BAPTIST SEMINARY                 ,TN,37404-0000,Private      ,0,6,6,4,35,39
03513500,WILLIAMSON CHRISTIAN COLLEGE            ,TN,37067-8237,Private      ,1,8,9,13,67,80
03647300,NEW CONCEPTS SCHOOL OF COSMETOLOGY      ,TN,37311-7373,Proprietary  ,1,6,7,12,39,51
03683300,INTERNATIONAL BARBER & STYLE COLLEGE    ,TN,37209-0000,Proprietary  ,8,44,52,37,242,279
03774300,PYRAMID BEAUTY SCHOOL                   ,TN,38104-2324,Proprietary  ,1,11,12,21,83,104
03774400,SHEAR ACADEMY                           ,TN,38555-4177,Proprietary  ,2,3,5,11,32,43
03830300,SAE INSTITUTE OF TECHNOLOGY             ,TN,37203-4310,Proprietary  ,14,18,32,222,246,468
03841300,CAREER BEAUTY COLLEGE                   ,TN,38464-3634,Proprietary  ,2,7,9,15,50,65
03920300,INSTITUTE OF HAIR DESIGN                ,TN,38310-1801,Proprietary  ,1,6,7,19,66,85
03930300,BUCHANAN BEAUTY COLLEGE                 ,TN,37160-2741,Proprietary  ,0,11,11,14,45,59
03982300,VISIBLE SCHOOL - MUSIC AND WORSHIPS ARTS,TN,38104-5814,Private      ,3,3,6,14,16,30
04025300,LAST MINUTE CUTS SCHOOL OF BARBERING AND,TN,38109-7709,Proprietary  ,3,26,29,24,93,117
04035300,NAVE COSMETOLOGY ACADEMY                ,TN,38401-6335,Proprietary  ,5,21,26,37,107,144
04037400,MASON ACADEMY OF COSMETOLOGY            ,TN,38049-7048,Proprietary  ,0,2,2,4,14,18
00353700,ABILENE CHRISTIAN UNIVERSITY            ,TX,79699-3701,Private      ,63,40,103,4098,1209,5307
00353900,ALVIN COMMUNITY COLLEGE                 ,TX,77511-4807,Public       ,30,97,127,800,1569,2369
00354000,AMARILLO COLLEGE                        ,TX,79109-2446,Public       ,74,221,295,2431,5056,7487
00354100,ANGELO STATE UNIVERSITY                 ,TX,76909-5069,Public       ,67,53,120,4814,2165,6979
00354300,AUSTIN COLLEGE                          ,TX,75090-4440,Private      ,16,2,18,1571,146,1717
00354400,AUSTIN PRESBYTERIAN THEOLOGICAL SEM     ,TX,78705-5797,Private      ,0,1,1,0,159,159
00354500,BAYLOR UNIVERSITY                       ,TX,76798-1458,Private      ,190,77,267,13874,3393,17267
00354600,COASTAL BEND COLLEGE                    ,TX,78102-2197,Public       ,42,87,129,1362,2011,3373
00354900,BLINN COLLEGE                           ,TX,77833-4098,Public       ,188,132,320,7110,3380,10490
00355300,CISCO JUNIOR COLLEGE                    ,TX,76437-9803,Public       ,45,78,123,1528,1884,3412
00355400,CLARENDON COLLEGE                       ,TX,79226-0000,Public       ,13,16,29,393,444,837
00355600,COMMONWEALTH INST OF FUNERAL SVC        ,TX,77090-5918,Private      ,4,9,13,59,149,208
00355700,CONCORDIA UNIVERSITY TEXAS              ,TX,78726-4141,Private      ,18,143,161,1040,1051,2091
00355800,NORTH CENTRAL TEXAS COLLEGE             ,TX,76240-4699,Public       ,72,87,159,1723,2291,4014
00356000,DALLAS BAPTIST UNIVERSITY               ,TX,75211-9299,Private      ,42,173,215,2183,3365,5548
00356100,CEDAR VALLEY COLLEGE                    ,TX,75134-0000,Public       ,50,152,202,1547,2648,4195
00356200,DALLAS THEOLOGICAL SEM                  ,TX,75204-0000,Private      ,0,20,20,14,535,549
00356300,DEL MAR COLLEGE                         ,TX,78404-3897,Public       ,120,240,360,4201,6025,10226
00356400,EAST TEXAS BAPTIST UNIVERSITY           ,TX,75670-1423,Private      ,12,11,23,1570,409,1979
00356500,TEXAS A&M UNIVERSITY - COMMERCE         ,TX,75429-3011,Public       ,88,208,296,3576,4912,8488
00356600,EPISCOPAL THEOL SEM OF THE STHWST       ,TX,78768-0000,Private      ,0,0,0,1,15,16
00356800,FRANK PHILLIPS COLLEGE                  ,TX,79008-0000,Public       ,15,42,57,339,535,874
00357000,GRAYSON COUNTY COLLEGE                  ,TX,75020-8299,Public       ,44,71,115,1133,2015,3148
00357100,HARDIN-SIMMONS UNIVERSITY               ,TX,79698-6050,Private      ,22,15,37,2066,957,3023
00357200,TRINITY VALLEY COMMUNITY COLLEGE        ,TX,75751-2734,Public       ,65,132,197,1563,2802,4365
00357300,HILL COLLEGE                            ,TX,76645-2711,Public       ,13,37,50,622,636,1258
00357301,HILL COLLEGE                            ,TX,76031-0000,Public       ,17,59,76,491,1032,1523
00357400,HOWARD COLLEGE                          ,TX,79720-0213,Public       ,37,78,115,953,1576,2529
00357500,HOWARD PAYNE UNIVERSITY                 ,TX,76801-2715,Private      ,23,12,35,1462,418,1880
00357600,HOUSTON BAPTIST UNIVERSITY              ,TX,77074-3298,Private      ,45,53,98,1746,1777,3523
00357700,HUSTON - TILLOTSON UNIVERSITY           ,TX,78702-2795,Private      ,14,11,25,764,453,1217
00357800,UNIVERSITY OF THE INCARNATE WORD        ,TX,78209-6398,Private      ,56,154,210,3395,3866,7261
00357900,JACKSONVILLE COLLEGE                    ,TX,75766-4759,Private      ,6,7,13,224,164,388
00358000,KILGORE COLLEGE                         ,TX,75662-3299,Public       ,52,109,161,2094,2983,5077
00358100,LAMAR UNIVERSITY-BEAUMONT               ,TX,77710-0042,Public       ,135,162,297,6336,4457,10793
00358200,LAREDO COMMUNITY COLLEGE                ,TX,78040-4395,Public       ,94,97,191,4002,3412,7414
00358300,LEE COLLEGE                             ,TX,77520-4796,Public       ,44,125,169,1268,2942,4210
00358400,LETOURNEAU UNIVERSITY                   ,TX,75607-0000,Private      ,17,225,242,1519,3995,5514
00358500,LON MORRIS COLLEGE                      ,TX,75766-2900,Private      ,9,6,15,375,103,478
00358600,LUBBOCK CHRISTIAN UNIVERSITY            ,TX,79407-2099,Private      ,19,47,66,1440,1197,2637
00358800,UNIVERSITY OF MARY HARDIN-BAYLOR        ,TX,76513-2599,Private      ,31,49,80,2520,1351,3871
00359000,MCLENNAN COMMUNITY COLLEGE              ,TX,76708-1498,Public       ,57,115,172,3054,4997,8051
00359100,MCMURRY UNIVERSITY                      ,TX,79697-0001,Private      ,20,22,42,1553,626,2179
00359200,MIDWESTERN STATE UNIVERSITY             ,TX,76308-2099,Public       ,58,93,151,3334,2694,6028
00359300,NAVARRO COLLEGE                         ,TX,75110-4818,Public       ,98,192,290,2698,3311,6009
00359400,UNIVERSITY OF NORTH TEXAS               ,TX,76203-1370,Public       ,354,435,789,21431,14501,35932
00359500,OBLATE SCHOOL OF THEOLOGY               ,TX,78216-0000,Private      ,0,1,1,3,26,29
00359600,ODESSA COLLEGE                          ,TX,79764-7127,Public       ,34,112,146,1459,2411,3870
00359800,OUR LADY OF THE LAKE UNIVERSITY         ,TX,78207-4689,Private      ,23,77,100,2039,2637,4676
00359900,UNIVERSITY OF TEXAS - PAN AMERICAN      ,TX,78541-2999,Public       ,262,306,568,12776,8139,20915
00360000,PANOLA COLLEGE                          ,TX,75633-2397,Public       ,32,58,90,811,1130,1941
00360100,PARIS JR COLLEGE                        ,TX,75460-6298,Public       ,62,141,203,1309,2252,3561
00360200,PAUL QUINN COLLEGE                      ,TX,75241-4398,Private      ,21,46,67,709,957,1666
00360300,RANGER COLLEGE                          ,TX,76470-3298,Public       ,12,11,23,541,320,861
00360400,RICE UNIVERSITY                         ,TX,77251-1892,Private      ,69,33,102,5281,1626,6907
00360600,SAM HOUSTON STATE UNIVERSITY            ,TX,77340-0000,Public       ,203,169,372,12123,5659,17782
00360700,ALAMO CMTY CLG DISTRICT PROGRAM         ,TX,78207-0000,Public       ,3,18,21,157,268,425
00360800,ST PHILLIPS COLLEGE                     ,TX,78203-2098,Public       ,122,407,529,4007,8588,12595
00360900,SAN JACINTO CLG-CENTRAL-NORTH-SOUTH     ,TX,77501-0000,Public       ,189,373,562,5822,8390,14212
00361000,SCHREINER UNIVERSITY                    ,TX,78028-5697,Private      ,7,5,12,954,465,1419
00361100,SOUTH PLAINS COLLEGE                    ,TX,79336-6504,Public       ,109,155,264,4377,4168,8545
00361200,UNIV OF HOUSTON-DOWNTOWN                ,TX,77002-1001,Public       ,114,237,351,5369,7678,13047
00361300,SOUTHERN METHODIST UNIVERSITY           ,TX,75275-0181,Private      ,64,91,155,5061,4475,9536
00361400,SOUTHWEST TEXAS JR COLLEGE              ,TX,78801-6221,Public       ,48,115,163,2033,2725,4758
00361500,TEXAS STATE UNIVERSITY--SAN MARCOS      ,TX,78666-4602,Public       ,391,350,741,18807,10298,29105
00361600,SOUTHWESTERN ASSEMBLIES OF GOD UNIV     ,TX,75165-2397,Private      ,32,29,61,1093,868,1961
00361700,SOUTHWESTERN BAPTIST THEOL SEMINARY     ,TX,76122-0000,Private      ,1,6,7,28,150,178
00361800,SOUTHWESTERN CHRISTIAN COLLEGE          ,TX,75160-3400,Private      ,9,3,12,199,98,297
00361900,SOUTHWESTERN ADVENTIST UNIVERSITY       ,TX,76059-1922,Private      ,15,9,24,663,462,1125
00362000,SOUTHWESTERN UNIVERSITY                 ,TX,78626-6111,Private      ,13,2,15,1752,136,1888
00362100,ST EDWARDS UNIVERSITY                   ,TX,78704-0000,Private      ,39,81,120,3760,2486,6246
00362300,ST MARY'S UNIV OF SAN ANTONIO           ,TX,78228-8500,Private      ,41,41,82,3298,2651,5949
00362400,STEPHEN F AUSTIN STATE UNIVERSITY       ,TX,75962-0001,Public       ,206,121,327,9523,3856,13379
00362500,SUL ROSS STATE UNIVERSITY               ,TX,79832-0113,Public       ,23,84,107,1399,1799,3198
00362600,TARRANT COUNTY COLLEGE                  ,TX,76102-6599,Public       ,317,749,1066,8720,13401,22121
00362700,TEMPLE COLLEGE                          ,TX,76504-7435,Public       ,43,148,191,1519,2668,4187
00362800,TEXARKANA COLLEGE                       ,TX,75599-0001,Public       ,36,129,165,1399,2158,3557
00363000,PRAIRIE VIEW A&M UNIVERSITY             ,TX,77446-2967,Public       ,130,188,318,8227,5022,13249
00363100,TARLETON STATE UNIVERSITY               ,TX,76402-0000,Public       ,84,132,216,5286,4421,9707
00363200,TEXAS A&M UNIVERSITY                    ,TX,77842-0000,Public       ,442,187,629,27278,7218,34496
00363400,TEXAS STATE TECHNICAL CLG AT WACO       ,TX,76705-1695,Public       ,93,154,247,2605,2859,5464
00363500,TEXAS CHIROPRACTIC COLLEGE              ,TX,77505-1699,Private      ,0,15,15,25,451,476
00363600,TEXAS CHRISTIAN UNIVERSITY              ,TX,76129-0001,Private      ,95,61,156,7347,2544,9891
00363700,JARVIS CHRISTIAN COLLEGE                ,TX,75765-1470,Private      ,28,18,46,632,234,866
00363800,TEXAS COLLEGE                           ,TX,75702-4500,Private      ,21,33,54,707,623,1330
00363900,TEXAS A&M UNIVERSITY-KINGSVILLE         ,TX,78363-8203,Public       ,95,118,213,4487,3957,8444
00364100,TEXAS LUTHERAN UNIVERSITY               ,TX,78155-5999,Private      ,21,6,27,1832,237,2069
00364200,TEXAS SOUTHERN UNIVERSITY               ,TX,77004-4598,Public       ,237,249,486,11076,10770,21846
00364300,TEXAS SOUTHMOST COLLEGE                 ,TX,78520-4992,Public       ,9,15,24,237,357,594
00364400,TEXAS TECH UNIVERSITY                   ,TX,79409-0000,Public       ,278,185,463,18021,8264,26285
00364500,TEXAS WESLEYAN UNIVERSITY               ,TX,76105-1536,Private      ,18,48,66,1030,3075,4105
00364600,TEXAS WOMAN'S UNIVERSITY                ,TX,76204-5587,Public       ,68,228,296,4533,7965,12498
00364700,TRINITY UNIVERSITY                      ,TX,78212-7200,Private      ,40,9,49,2871,457,3328
00364800,TYLER JUNIOR COLLEGE                    ,TX,75701-3436,Public       ,136,162,298,4767,4381,9148
00365100,UNIVERSITY OF DALLAS                    ,TX,75062-4799,Private      ,20,53,73,1502,1154,2656
00365200,UNIVERSITY OF HOUSTON                   ,TX,77204-2010,Public       ,431,503,934,22829,18632,41461
00365400,UNIVERSITY OF ST THOMAS                 ,TX,77006-4626,Private      ,15,62,77,1407,1248,2655
00365600,UNIVERSITY OF TEXAS-ARLINGTON           ,TX,76019-0000,Public       ,248,382,630,13904,14071,27975
00365800,UNIVERSITY OF TEXAS-AUSTIN              ,TX,78713-7758,Public       ,475,290,765,34635,16499,51134
00365900,UT HEALTH CENTER-SAN ANTONIO            ,TX,78229-3900,Public       ,11,72,83,534,2791,3325
00366100,UNIVERSITY OF TEXAS-EL PASO             ,TX,79968-0629,Public       ,206,276,482,11207,9572,20779
00366200,VICTORIA COLLEGE (THE)                  ,TX,77901-4494,Public       ,36,107,143,1166,2074,3240
00366300,WAYLAND BAPTIST UNIVERSITY              ,TX,79072-6998,Private      ,19,219,238,995,2714,3709
00366400,WEATHERFORD COLLEGE                     ,TX,76086-5699,Public       ,46,84,130,1524,1699,3223
00366500,WEST TEXAS A&M UNIVERSITY               ,TX,79016-0000,Public       ,89,115,204,3711,3371,7082
00366800,WHARTON COUNTY JR COLLEGE               ,TX,77488-3298,Public       ,54,94,148,1967,1982,3949
00366900,WILEY COLLEGE                           ,TX,75670-5199,Private      ,15,27,42,601,579,1180
00400300,CENTRAL TEXAS COLLEGE                   ,TX,76540-4199,Public       ,59,659,718,1824,8542,10366
00407221,NORTHWOOD UNIVERSITY                    ,TX,75104-0000,Private      ,15,41,56,661,767,1428
00445300,EL CENTRO COLLEGE                       ,TX,75202-0000,Public       ,74,291,365,2351,5352,7703
00494800,TEXAS A&M UNIV SYSTEM HEALTH SCI CT     ,TX,77840-7896,Public       ,4,4,8,51,425,476
00494801,TEXAS A&M UNIV SYSTEMS-HSC              ,TX,77843-1114,Public       ,6,5,11,151,670,821
00494900,BAYLOR COLLEGE OF MEDICINE              ,TX,77030-0000,Private      ,7,17,24,152,1133,1285
00495100,UNIV OF TEXAS HEALTH SCIENCE CENTER     ,TX,77225-0000,Public       ,3,40,43,298,2464,2762
00495200,UNIV OF TEXAS MEDICAL BRANCH            ,TX,77550-0000,Public       ,4,34,38,299,1861,2160
00497200,GALVESTON COLLEGE                       ,TX,77550-7447,Public       ,33,71,104,830,1395,2225
00497700,SOUTH TEXAS COLLEGE OF LAW              ,TX,77002-0000,Private      ,2,17,19,17,1927,1944
00520307,REMINGTON COLLEGE - DALLAS CAMPUS       ,TX,75041-9935,Proprietary  ,4,3,7,42,100,142
00661200,COVENANT SCH OF NSG & ALLIED HEALTH     ,TX,79410-0000,Private      ,2,1,3,115,259,374
00666100,ANGELINA COLLEGE                        ,TX,75902-0000,Public       ,45,119,164,1816,2752,4568
00694100,DALLAS CHRISTIAN COLLEGE                ,TX,75234-7229,Private      ,6,17,23,232,304,536
00709600,COLLEGE OF THE MAINLAND                 ,TX,77591-2499,Public       ,43,101,144,856,1942,2798
00728700,BRAZOSPORT COLLEGE                      ,TX,77566-3199,Public       ,29,44,73,727,1125,1852
00732907,ITT TECHNICAL INSTITUTE                 ,TX,77063-3751,Proprietary  ,1,16,17,132,228,360
00754805,WESTWOOD COLLEGE OF TECHNOLOGY          ,TX,77074-0000,Proprietary  ,37,78,115,268,456,724
00758602,REMINGTON COLLEGE - FORT WORTH CAMPUS   ,TX,76112-1280,Proprietary  ,46,118,164,306,1035,1341
00835300,LINCOLN COLLEGE OF TECHNOLOGY           ,TX,75052-0000,Proprietary  ,173,206,379,969,1135,2104
00849800,MIMS CLASSIC BEAUTY COLLEGE             ,TX,78216-0000,Proprietary  ,4,7,11,41,73,114
00850300,MOUNTAIN VIEW COLLEGE                   ,TX,75211-6599,Public       ,83,167,250,2192,3187,5379
00850400,RICHLAND COLLEGE                        ,TX,75243-2199,Public       ,123,274,397,3087,4724,7811
00851000,EASTFIELD COLLEGE                       ,TX,75150-2099,Public       ,90,245,335,2545,4332,6877
00908200,INTERNATIONAL BUSINESS COLLEGE          ,TX,79903-0000,Proprietary  ,21,112,133,196,619,815
00916300,SAN ANTONIO COLLEGE                     ,TX,78212-4299,Public       ,357,737,1094,9321,14168,23489
00916302,SAN ANTONIO COLLEGE FT SAM HOUSTON      ,TX,78234-0000,Public       ,1,2,3,44,34,78
00922500,TEXAS STATE TECHNICAL COLLEGE  HARLINGEN,TX,78550-3697,Public       ,126,163,289,3097,2963,6060
00946600,KAPLAN CAREER INSTITUTE                 ,TX,78216-1899,Proprietary  ,72,200,272,374,1211,1585
00946607,SAN ANT COL OF MED & DENTAL - MCALLEN   ,TX,78503-1622,Proprietary  ,81,226,307,445,1028,1473
00946609,CAREER CENTERS OF TX - CORPUS CHRISTI   ,TX,78416-9900,Proprietary  ,25,173,198,170,894,1064
00946610,KAPLAN CAREER INSTITUTE - CAREER CENTERS,TX,76103-2310,Proprietary  ,27,211,238,158,893,1051
00954900,WESTERN TEXAS COLLEGE                   ,TX,79549-9501,Public       ,11,18,29,419,283,702
00965100,TEXAS A&M INTERNATIONAL UNIVERSITY      ,TX,78041-1900,Public       ,75,112,187,3324,2679,6003
00974100,UNIVERSITY OF TEXAS AT DALLAS           ,TX,75083-0000,Public       ,95,170,265,6007,6418,12425
00976800,UNIVERSITY OF NORTH TEXAS HEALTH SCIENCE,TX,76107-2699,Public       ,1,11,12,83,1124,1207
00979700,MIDLAND COLLEGE                         ,TX,79705-6397,Public       ,36,72,108,1528,2176,3704
00993000,UNIVERSITY OF TEXAS-PERMIAN BASIN       ,TX,79762-0001,Public       ,28,66,94,1610,2097,3707
00993200,TEXAS STATE TECH CLG-WEST TEXAS         ,TX,79556-4108,Public       ,16,71,87,457,818,1275
00993201,TEXAS STATE TECH COLLEGE-ABILENE        ,TX,79601-0000,Public       ,5,27,32,154,363,517
00993204,TEXAS STATE TECH CLG-BRECKENRIDGE       ,TX,76424-0000,Public       ,3,5,8,49,183,232
00993205,TEXAS STATE TECH COLLEGE-BROWNWOOD      ,TX,76801-0000,Public       ,9,35,44,121,348,469
01001900,UNIV OF TEXAS SOUTHWESTERN MED CTR      ,TX,75390-9096,Public       ,4,25,29,154,1604,1758
01005700,AMERICAN COMMERCIAL COLLEGE             ,TX,79602-1399,Proprietary  ,5,61,66,40,357,397
01005900,AMERICAN COMMERCIAL COLLEGE             ,TX,79761-0000,Proprietary  ,14,70,84,79,377,456
01005901,AMERICAN COMMERCIAL COLLEGE - AMERICAN C,TX,76310-2303,Proprietary  ,15,58,73,67,326,393
01006000,VERNON COLLEGE                          ,TX,76384-4092,Public       ,20,72,92,852,1850,2702
01011500,UNIVERSITY OF TEXAS-SAN ANTONIO         ,TX,78249-0600,Public       ,358,383,741,21632,14874,36506
01013000,WADE COLLEGE                            ,TX,75207-3199,Proprietary  ,17,17,34,197,203,400
01038700,EL PASO COMMUNITY COLLEGE               ,TX,79998-0000,Public       ,305,552,857,10832,13394,24226
01050900,HALLMARK COLLEGE OF AERONAUTICS         ,TX,78214-0000,Proprietary  ,44,135,179,296,887,1183
01062400,CENTRAL TEXAS COMMERCIAL COLLEGE        ,TX,75231-5033,Proprietary  ,10,4,14,69,38,107
01063300,HOUSTON COMMUNITY COLLEGE               ,TX,77002-0000,Public       ,55,154,209,1232,2450,3682
01063303,HOUSTON COMMUNITY COLLEGE - CENTRAL     ,TX,77004-0000,Public       ,119,415,534,2533,6007,8540
01063304,HOUSTON COMMUNITY COLLEGE - RICE AVIATIO,TX,77061-5001,Public       ,90,258,348,1591,3477,5068
01063305,HOUSTON COMMUNITY COLLEGE - NORTHEAST CO,TX,77066-5221,Public       ,103,217,320,1839,3455,5294
01063306,HOUSTON COMMUNITY COLLEGE - CENTRAL COLL,TX,77088-6372,Public       ,65,196,261,1462,2630,4092
01063339,HOUSTON COMMUNITY COLLEGE - STAFFORD    ,TX,77477-0000,Public       ,82,150,232,1351,1956,3307
01063347,HOUSTON COMMUNITY COLLEGE - SOUTHWEST   ,TX,77081-7849,Public       ,98,252,350,3591,6235,9826
01063348,HOUSTON COMMUNITY COLLEGE - COLEMAN     ,TX,77030-0000,Public       ,12,88,100,324,1591,1915
01067400,TEXAS TECH U HEALTH SCIENCES CENTER     ,TX,79430-0000,Public       ,7,49,56,555,2244,2799
01076100,DALLAS INSTITUTE OF FUNERAL SERVICE     ,TX,75227-4314,Private      ,3,20,23,81,237,318
01114500,LONE STAR COLLEGE SYSTEM                ,TX,77073-3499,Public       ,146,320,466,3716,6524,10240
01114501,LONE STAR COLLEGE-KINGWOOD              ,TX,77339-0000,Public       ,70,169,239,1268,2335,3603
01114502,LONE STAR COLLEGE-TOMBALL               ,TX,77375-0000,Public       ,41,102,143,1000,1731,2731
01114503,LONE STAR COLLEGE-MONTGOMERY            ,TX,77384-0000,Public       ,50,167,217,1301,2667,3968
01114504,LONE STAR COLLEGE-CY-FAIR               ,TX,77433-1383,Public       ,52,119,171,1744,2378,4122
01116100,TEXAS A&M UNIV CORPUS CHRISTI           ,TX,78412-5599,Public       ,106,112,218,6724,4052,10776
01116300,UNIVERSITY OF TEXAS AT TYLER            ,TX,75799-6699,Public       ,59,100,159,3579,3647,7226
01171100,UNIVERSITY OF HOUSTON-CLEAR LAKE        ,TX,77058-1002,Public       ,42,182,224,1454,5700,7154
01201500,AUSTIN COMMUNITY COLLEGE                ,TX,78752-4390,Public       ,328,637,965,9298,13024,22322
01202000,VICTORIA BEAUTY COLLEGE                 ,TX,77901-6233,Proprietary  ,5,16,21,43,116,159
01226800,BALDWIN BEAUTY SCHOOL #5                ,TX,78704-4785,Proprietary  ,8,23,31,72,149,221
01229700,LAREDO BEAUTY COLLEGE                   ,TX,78040-1051,Proprietary  ,5,40,45,66,273,339
01248200,ATI TECHNICAL TRAINING CENTER           ,TX,75235-4622,Proprietary  ,63,208,271,363,1365,1728
01248300,COSMETOLOGY CAREER CENTER               ,TX,75006-2566,Proprietary  ,12,35,47,109,240,349
01248800,INTERNATIONAL BEAUTY COLLEGE NO 3       ,TX,75040-0000,Proprietary  ,4,9,13,22,81,103
01276400,METROPLEX BEAUTY SCHOOL                 ,TX,75149-0000,Proprietary  ,3,19,22,25,119,144
01293000,CHARLES & SUE'S SCH OF HAIR DESIGN      ,TX,77801-0000,Proprietary  ,3,13,16,49,92,141
01293100,VELMA B'S BEAUTY ACADEMY                ,TX,75216-1511,Proprietary  ,1,14,15,27,68,95
01293200,TINT SCHOOL OF MAKEUP & COSMETOLOGY     ,TX,75061-4235,Proprietary  ,2,19,21,21,74,95
01298200,BORDER INSTITUTE OF TECHNOLOGY          ,TX,79925-6709,Proprietary  ,7,9,16,48,109,157
01300300,NEILSON BEAUTY COLLEGE                  ,TX,75208-4637,Proprietary  ,3,22,25,22,90,112
01301600,OGLE SCHOOL HAIR SKIN NAILS             ,TX,76013-7400,Proprietary  ,32,36,68,147,181,328
01323100,UNIVERSITY OF HOUSTON-VICTORIA          ,TX,77901-5731,Public       ,5,62,67,317,1766,2083
02058600,CONLEE'S COLLEGE OF COSMETOLOGY         ,TX,78028-0000,Proprietary  ,2,6,8,14,45,59
02074100,CAPITOL CITY TRADE & TECHNICAL SCH      ,TX,78704-0000,Proprietary  ,41,138,179,174,661,835
02077400,NORTH LAKE COLLEGE                      ,TX,75038-0000,Public       ,65,129,194,1407,2458,3865
02078100,STEPHENVILLE BEAUTY COLLEGE             ,TX,76401-0000,Proprietary  ,0,4,4,16,29,45
02081400,ARLINGTON BAPTIST COLLEGE               ,TX,76012-0000,Private      ,4,4,8,101,113,214
02093600,SOUTHWEST SCHOOL OF ELECTRONIC          ,TX,78735-0000,Proprietary  ,4,9,13,35,97,132
02098300,WESTERN TECHNICAL COLLEGE               ,TX,79927-2105,Proprietary  ,198,283,481,739,1051,1790
02100200,BROOKHAVEN COLLEGE                      ,TX,75244-0000,Public       ,45,186,231,1646,3109,4755
02113610,AMERICAN INTERCONTINENTAL UNIV - HOUSTON,TX,77042-4516,Proprietary  ,12,77,89,312,642,954
02116008,SANFORD-BROWN COLLEGE - HOUSTON         ,TX,77036-8507,Proprietary  ,19,106,125,151,838,989
02116012,SANFORD-BROWN INSTITUTE - HOUSTON NORTH ,TX,77008-1058,Proprietary  ,23,68,91,117,525,642
02117100,ART INSTITUTE OF HOUSTON                ,TX,77056-0000,Proprietary  ,75,76,151,1437,1260,2697
02119200,COURT REPORTING INSTITUTE OF DALLAS     ,TX,75247-6913,Proprietary  ,9,100,109,228,1197,1425
02136800,AMERICAN COMMERCIAL COLLEGE             ,TX,76904-0000,Proprietary  ,1,34,35,44,247,291
02144800,VET TECH INSTITUTE OF HOUSTON           ,TX,77027-9881,Proprietary  ,10,9,19,130,94,224
02176100,PIPO ACADEMY OF HAIR DESIGN             ,TX,79903-0000,Proprietary  ,2,25,27,34,82,116
02188600,AUSTIN BUSINESS COLLEGE                 ,TX,78741-0000,Proprietary  ,4,7,11,120,293,413
02200800,AMERICAN COMMERCIAL COLLEGE             ,TX,79411-0000,Proprietary  ,12,48,60,57,289,346
02218300,SOUTHWEST SCHOOL OF BUSINESS & TECHNICAL,TX,78221-0000,Proprietary  ,25,53,78,90,249,339
02224600,TRI-STATE BEAUTY SCHOOL #1              ,TX,79915-0000,Proprietary  ,14,74,88,125,400,525
02228400,TEXAS AERO TECHNOLOGY                   ,TX,75209-0000,Proprietary  ,0,0,0,0,1,1
02230500,OGLE SCHOOL HAIR SKIN NAILS             ,TX,76132-3638,Proprietary  ,26,53,79,164,247,411
02230600,OGLE SCHOOL HAIR SKIN NAILS             ,TX,76053-4650,Proprietary  ,14,25,39,76,99,175
02239100,CENTRAL TEXAS BEAUTY COLLEGE #2         ,TX,78664-4204,Proprietary  ,6,40,46,47,181,228
02245200,MTI COLLEGE OF BUS. & TECHNOLOGY        ,TX,77036-0000,Proprietary  ,39,111,150,220,790,1010
02248200,MILAN INSTITUTE OF COSMETOLOGY          ,TX,79103-0000,Proprietary  ,55,122,177,192,527,719
02254800,TEXAS VOCATIONAL SCHOOLS                ,TX,77901-0000,Proprietary  ,5,35,40,56,155,211
02259400,AMBERTON UNIVERSITY                     ,TX,75041-0000,Private      ,0,8,8,17,160,177
02261300,EVEREST INSTITUTE                       ,TX,78213-3841,Proprietary  ,149,803,952,877,3798,4675
02261301,NATIONAL INSTITUTE OF TECHNOLOGY        ,TX,77027-0000,Proprietary  ,0,0,0,68,157,225
02267100,EXPOSITO SCHOOL OF HAIR DESIGN          ,TX,79109-0000,Proprietary  ,5,9,14,37,80,117
02276000,FRANKLIN BEAUTY SCHOOL #2               ,TX,77021-0000,Proprietary  ,9,18,27,48,156,204
02285900,UNIVERSITY OF COSMETOLOGY ARTS&SCI      ,TX,78504-0000,Proprietary  ,15,106,121,178,674,852
02294800,CAPITOL CITY CAREERS                    ,TX,78745-0000,Proprietary  ,7,70,77,42,274,316
02305300,PARKER COLLEGE OF CHIROPRACTIC          ,TX,75229-0000,Private      ,0,21,21,54,1268,1322
02306700,FORT WORTH BEAUTY SCHOOL                ,TX,76116-3299,Proprietary  ,3,50,53,36,183,219
02312200,TEXAS SCHOOL OF BUSINESS                ,TX,77073-6032,Proprietary  ,60,156,216,266,802,1068
02312201,TEXAS SCHOOL OF BUSINESS - SOUTHWEST CAM,TX,77057-0000,Proprietary  ,51,144,195,249,828,1077
02312202,TEXAS SCHOOL OF BUSINESS - FRIENDSWOOD C,TX,77546-8938,Proprietary  ,19,112,131,100,625,725
02312203,TEXAS SCHOOL OF BUSINESS - EAST CAMPUS  ,TX,77029-1916,Proprietary  ,30,155,185,147,754,901
02313901,WESTWOOD COLLEGE - DALLAS               ,TX,75243-0000,Proprietary  ,67,101,168,433,674,1107
02315400,NORTHEAST TEXAS COMMUNITY COLLEGE       ,TX,75456-0000,Public       ,41,77,118,922,1295,2217
02318200,"KD STUDIO, ACTOR'S CONSERVATORY         ",TX,75207-2111,Proprietary  ,22,14,36,94,95,189
02320200,HOUSTON GRADUATE SCHOOL OF THEOLOGY     ,TX,77004-0000,Private      ,1,20,21,4,155,159
02326000,SAN ANTONIO BEAUTY COLLEGE NO 3         ,TX,78217-0000,Proprietary  ,11,31,42,41,155,196
02328600,ITT TECHNICAL INSTITUTE                 ,TX,76011-0000,Proprietary  ,89,164,253,650,1070,1720
02331200,BAPTIST MISSIONARY ASSN THEOL SEM       ,TX,75766-0000,Private      ,0,3,3,4,48,52
02331300,INTERACTIVE LEARNING SYSTEMS            ,TX,77502-1201,Proprietary  ,3,62,65,23,356,379
02331301,INTERACTIVE LEARNING SYSTEMS            ,TX,77081-0000,Proprietary  ,6,68,74,29,385,414
02331303,INTERACTIVE LEARNING SYSTEMS            ,TX,77502-0000,Proprietary  ,8,69,77,32,307,339
02331304,INTERACTIVE LEARNING SYSTEMS            ,TX,77060-0000,Proprietary  ,5,59,64,21,250,271
02341300,PALO ALTO COLLEGE                       ,TX,78224-0000,Public       ,139,241,380,3901,5318,9219
02348500,LAMAR STATE COLLEGE-PORT ARTHUR         ,TX,77640-0000,Public       ,29,65,94,803,1387,2190
02357700,ACADEMY OF HAIR DESIGN                  ,TX,77090-0000,Proprietary  ,0,0,0,26,72,98
02358200,LAMAR STATE COLLEGE-ORANGE              ,TX,77630-0000,Public       ,30,93,123,645,1389,2034
02361400,COLLIN COUNTY COMMUNITY COLLEGE         ,TX,75071-0000,Public       ,138,269,407,3224,4586,7810
02362000,UNIVERSAL TECHNICAL INSTITUTE           ,TX,77073-0000,Proprietary  ,303,261,564,6547,2614,9161
02362800,AUSTIN GRADUATE SCHOOL OF THEOLOGY      ,TX,78752-1333,Private      ,0,2,2,3,43,46
02521200,ARLINGTON CAREER INSTITUTE              ,TX,75050-0000,Proprietary  ,3,64,67,71,426,497
02521800,SEGUIN BEAUTY SCHOOL                    ,TX,78155-0000,Proprietary  ,2,15,17,42,105,147
02527500,HOUSTON TRAINING SCHOOLS                ,TX,77020-0000,Proprietary  ,23,151,174,181,880,1061
02530700,SEBRING CAREER SCHOOLS                  ,TX,77083-1510,Proprietary  ,6,15,21,31,163,194
02538900,INTERNATIONAL BUSINESS COLLEGE          ,TX,79414-3509,Proprietary  ,0,0,0,42,153,195
02539600,ART INSTITUTE OF DALLAS                 ,TX,75231-5993,Proprietary  ,88,107,195,1561,1235,2796
02548800,SOUTH TEXAS VO-TECH INSTITUTE           ,TX,78596-0000,Proprietary  ,35,138,173,204,527,731
02549400,SOUTH TEXAS VO-TECH INSTITUTE           ,TX,78501-0000,Proprietary  ,11,108,119,153,538,691
02555400,UNIV OF TX MD ANDERSON CANCER CTR       ,TX,77030-0000,Public       ,1,4,5,45,170,215
02557400,STAR COLLEGE OF COSMETOLOGY             ,TX,75961-0000,Proprietary  ,2,11,13,22,77,99
02568100,TEXAS BARBER COLLEGES & HAIRSTYLING     ,TX,75208-0000,Proprietary  ,43,124,167,304,986,1290
02569300,TEXAS CULINARY ACADEMY                  ,TX,78758-3403,Proprietary  ,72,130,202,843,1078,1921
02572000,COMPUTER CAREER CENTER                  ,TX,79925-2021,Proprietary  ,23,100,123,111,510,621
02572100,"CAREER ACADEMY, INC.                    ",TX,75501-0000,Proprietary  ,1,12,13,19,81,100
02572200,INSTITUTE OF COSMETOLOGY & ESTHETICS    ,TX,77036-0000,Proprietary  ,1,9,10,31,61,92
02580100,IVERSON BUSINESS SCH & COURT REPORT     ,TX,76011-1344,Proprietary  ,21,133,154,86,662,748
02591100,CAREER POINT INSTITUTE                  ,TX,78201-2027,Proprietary  ,100,567,667,521,2529,3050
02591900,CAREER CENTERS OF TEXAS - EL PASO       ,TX,79907-1525,Proprietary  ,107,276,383,577,1464,2041
02591905,CAREER CENTERS OF TEXAS-BROWNSVILLE     ,TX,78521-9905,Proprietary  ,69,153,222,319,795,1114
02596400,REDSTONE COLLEGE - LOS ANGELES          ,TX,77061-0000,Proprietary  ,46,78,124,649,571,1220
02596412,WESTWOOD COLLEGE OF AVIATION TECHNOLOGY ,TX,77061-5114,Proprietary  ,6,12,18,127,206,333
02596500,ATI CAREER TRAINING CENTER              ,TX,76180-1599,Proprietary  ,52,148,200,322,848,1170
02596600,ATI-CAREER TRAINING CENTER              ,TX,75220-4443,Proprietary  ,66,205,271,415,1366,1781
02600200,OCEAN CORPORATION (THE)                 ,TX,77099-3479,Proprietary  ,24,80,104,151,572,723
02604700,CENTER FOR ADVANCED LEGAL STUDIES       ,TX,77098-4151,Proprietary  ,6,46,52,32,290,322
02615000,SANFORD-BROWN INSTITUTE                 ,TX,75247-6931,Proprietary  ,66,220,286,388,1522,1910
03009400,SW SCH BUS & TECH CAREERS               ,TX,78212-2840,Proprietary  ,3,6,9,13,29,42
03010000,VANGUARD INSTITUTE OF TECHNOLOGY        ,TX,78539-0000,Proprietary  ,21,156,177,210,1244,1454
03010604,VIRGINIA COLLEGE - VIRGINIA COLLEGE AT A,TX,78723-0000,Proprietary  ,0,0,0,0,1,1
03011800,UNIVERSITY OF COSMETOLOGY ARTS & SCIENCE,TX,78226-1160,Proprietary  ,2,8,10,16,90,106
03019800,PCI HEALTH TRAINING CENTER              ,TX,75247-4720,Proprietary  ,64,179,243,405,1031,1436
03021500,SW SCH BUS & TECH CAREERS               ,TX,78852-4859,Proprietary  ,5,11,16,61,64,125
03023800,AIMS ACADEMY                            ,TX,75050-0000,Proprietary  ,1,6,7,17,59,76
03025000,TEXAS COLLEGE OF COSMETOLOGY            ,TX,79605-2001,Proprietary  ,9,23,32,68,184,252
03026000,DALFORTH AIRCRAFT TECH                  ,TX,75209-3091,Proprietary  ,0,0,0,0,1,1
03026100,POLYTECHNIC INSTITUTE                   ,TX,77022-2914,Proprietary  ,0,0,0,33,154,187
03026500,REMINGTON COLLEGE - HOUSTON CAMPUS      ,TX,77082-1849,Proprietary  ,92,260,352,586,1815,2401
03026501,REMINGTON COLLEGE - NORTH HOUSTON CAMPUS,TX,77067-1849,Proprietary  ,3,6,9,36,90,126
03028800,CIRCLE J BEAUTY SCHOOL                  ,TX,77587-3714,Proprietary  ,8,41,49,24,160,184
03031408,INTERNATIONAL ACADEMY OF DESIGN AND TECH,TX,78229-2263,Proprietary  ,30,41,71,32,43,75
03032300,SCHOOL OF AUTOMOTIVE MACHINISTS         ,TX,77055-1803,Proprietary  ,8,9,17,62,82,144
03035200,TINT SCHOOL OF MAKEUP & COSMETOLOGY     ,TX,75229-3734,Proprietary  ,10,31,41,40,195,235
03035300,SOUTHERN CAREERS INSTITUTE              ,TX,78704-5252,Proprietary  ,65,221,286,440,1305,1745
03035301,SOUTHERN CAREERS INSTITUTE              ,TX,78577-0000,Proprietary  ,38,120,158,287,664,951
03035302,SOUTHERN CAREERS INSTITUTE - CORPUS CHRI,TX,78414-2904,Proprietary  ,21,80,101,129,541,670
03035303,SOUTHERN CAREERS INSTITUTE - #1         ,TX,78221-4351,Proprietary  ,8,50,58,66,375,441
03035304,SOUTHERN CAREERS INSTITUTE-LAREDO       ,TX,78041-0000,Proprietary  ,5,27,32,58,155,213
03061800,STAR COLLEGE OF COSMETOLOGY             ,TX,75702-8214,Proprietary  ,14,39,53,73,208,281
03064600,UNIVERSITY OF TEXAS AT BROWNSVILLE      ,TX,78520-4993,Public       ,213,242,455,6511,7198,13709
03071400,ITT TECHNICAL INSTITUTE                 ,TX,78249-3303,Proprietary  ,66,76,142,522,733,1255
03075400,ICC TECHNICAL INSTITUTE                 ,TX,77004-2930,Private      ,1,6,7,20,79,99
03079201,WESTWOOD COLLEGE OF TECHNOLOGY          ,TX,76180-0000,Proprietary  ,37,56,93,296,480,776
03091200,CAREERS UNLIMITED                       ,TX,75702-7110,Proprietary  ,5,19,24,34,113,147
03103400,SOUTH TEXAS COLLEGE                     ,TX,78501-6699,Public       ,321,592,913,8756,9979,18735
03104700,TEXAS COLLEGE OF COSMETOLOGY            ,TX,76903-4708,Proprietary  ,9,22,31,68,173,241
03105900,CAREERS UNLIMITED                       ,TX,77055-4002,Proprietary  ,3,10,13,58,545,603
03108700,ROYAL BEAUTY CAREERS                    ,TX,77069-4611,Proprietary  ,10,67,77,91,360,451
03111000,MID-CITIES BARBER COLLEGE               ,TX,75051-4810,Proprietary  ,5,14,19,28,106,134
03115800,TEXAS CAREERS                           ,TX,78238-4203,Proprietary  ,51,258,309,309,1607,1916
03115802,TEXAS CAREERS - LAREDO                  ,TX,78041-6181,Proprietary  ,34,85,119,173,382,555
03115803,TEXAS CAREERS - BEAUMONT                ,TX,77701-3706,Proprietary  ,36,130,166,162,608,770
03115804,TEXAS CAREERS - LUBBOCK                 ,TX,79401-2601,Proprietary  ,28,140,168,157,809,966
03128100,ACADEMY OF HEALTH CARE PROFESSIONS      ,TX,77092-8108,Proprietary  ,57,226,283,302,1103,1405
03144300,NATIONAL BEAUTY COLLEGE                 ,TX,75043-4046,Proprietary  ,2,22,24,17,94,111
03153300,AMER COLL OF ACUPUNCTURE & O.M.         ,TX,77063-4104,Proprietary  ,0,6,6,1,103,104
03156400,ACADEMY OF ORIENTAL MEDICINE AT AUSTIN  ,TX,78757-1132,Proprietary  ,0,7,7,7,234,241
03159300,ARLINGTON MEDICAL INSTITUTE             ,TX,76011-2645,Proprietary  ,3,9,12,35,130,165
03170300,TEXAS A&M UNIVERSITY-TEXARKANA          ,TX,75501-0000,Public       ,6,47,53,322,1123,1445
03179500,TEXAS COLG TRADITIONAL CHINESE MED      ,TX,78704-6748,Proprietary  ,0,5,5,5,101,106
03189400,COLLEGE OF SAINT THOMAS MORE            ,TX,76109-2323,Private      ,0,0,0,12,25,37
03237400,FARIS COMPUTER SCHOOL                   ,TX,77627-3829,Proprietary  ,0,17,17,1,58,59
03272300,SOUTHEASTERN CAREER INSTITUTE           ,TX,75234-7288,Proprietary  ,12,66,78,107,391,498
03272301,SOUTHEASTERN CAREER INSTITUTE - MIDLAND ,TX,79703-5531,Proprietary  ,22,67,89,106,397,503
03275300,TOUCH OF CLASS SCHOOL OF COSM           ,TX,75402-6314,Proprietary  ,8,21,29,40,118,158
03276300,ACADEMY OF HAIR DESIGN                  ,TX,75901-4900,Proprietary  ,5,24,29,34,151,185
03277300,ACADEMY OF HAIR DESIGN                  ,TX,77701-4650,Proprietary  ,4,12,16,30,92,122
03303300,NORTHWEST EDUCATIONAL CENTER            ,TX,77092-7055,Proprietary  ,3,95,98,32,442,474
03341300,SOUTHWESTERN PROFESSIONAL INSTITUTE     ,TX,77056-6239,Proprietary  ,0,0,0,16,105,121
03371300,TONI&GUY HAIRDRESSING ACADEMY           ,TX,75006-2351,Proprietary  ,14,14,28,85,96,181
03372300,NORTHWEST VISTA COLLEGE                 ,TX,78251-4217,Public       ,161,230,391,3993,4883,8876
03396500,TEXAS STATE TECHNICAL COLG/MARSHALL     ,TX,75672-7402,Public       ,7,17,24,323,351,674
03400300,CAREER QUEST                            ,TX,78229-3539,Proprietary  ,10,70,80,45,333,378
03412300,ADVANCED BARBER COLLEGE & HAIR DESI     ,TX,78596-0000,Proprietary  ,1,20,21,26,123,149
03416500,DALLAS NURSING INSTITUTE                ,TX,75243-5502,Proprietary  ,6,75,81,66,484,550
03422300,MILAN INSTITUTE                         ,TX,78238-3327,Proprietary  ,40,91,131,309,570,879
03422400,COLLEGE OF BIBLICAL STUDIES-HOUSTON     ,TX,77036-3211,Private      ,1,43,44,55,655,710
03424400,MEDVANCE INSTITUTE                      ,TX,77057-7386,Proprietary  ,32,101,133,153,644,797
03426300,CAREER ADVANCEMENT CENTER               ,TX,78752-1470,Proprietary  ,14,44,58,69,263,332
03486300,SYLVIA'S INTERNATIONAL SCHOOL OF BE     ,TX,77091-3203,Proprietary  ,1,14,15,7,53,60
03509400,CORYELL COSMETOLOGY COLLEGE             ,TX,76528-2036,Proprietary  ,1,8,9,6,29,35
03520300,LUBBOCK HAIR ACADEMY                    ,TX,79410-3524,Proprietary  ,5,13,18,21,85,106
03541300,BEHOLD! BEAUTY ACADEMY                  ,TX,77016-3725,Proprietary  ,1,0,1,14,49,63
03542300,CONCORDE CAREER INSTITUTE               ,TX,76011-4016,Proprietary  ,30,205,235,221,1338,1559
03551400,STATE BEAUTY ACADEMY                    ,TX,75116-3501,Proprietary  ,1,3,4,32,64,96
03556400,KUSSAD INSTITUTE OF COURT REPORTING     ,TX,78704-5712,Proprietary  ,1,2,3,7,25,32
03563300,ACADEMY OF COSEMTOLOGY                  ,TX,78745-2858,Proprietary  ,0,2,2,18,54,72
03573300,AVIATION INSTITUTE OF MAINTENANCE       ,TX,75209-3017,Proprietary  ,16,58,74,87,327,414
03610300,MJ'S BEAUTY ACADEMY INC                 ,TX,75224-4409,Proprietary  ,2,11,13,27,71,98
03612400,VALLEY GRANDE INSTITUTE FOR ACADEMI     ,TX,78596-0000,Private      ,17,106,123,163,628,791
03627300,LAMAR INSTITUTE OF TECHNOLOGY           ,TX,77705-4142,Public       ,58,95,153,1072,1818,2890
03676400,HEALTHY HAIR ACADEMY                    ,TX,75227-0000,Proprietary  ,4,15,19,24,86,110
03680300,JAY'S TECHNICAL INSTITUTE               ,TX,77031-3509,Proprietary  ,2,29,31,13,119,132
03682400,DALLAS BARBER & STYLIST COLLEGE         ,TX,75231-0000,Proprietary  ,7,28,35,64,211,275
03714300,TREND BARBER COLLEGE                    ,TX,77071-2104,Proprietary  ,4,27,31,44,159,203
03723300,CULINARY INST ALAIN & MARIE LENOTRE     ,TX,77022-4322,Proprietary  ,9,25,34,52,189,241
03727600,CULINARY ACADEMY OF AUSTIN              ,TX,78752-0000,Proprietary  ,3,12,15,74,120,194
03731300,INTERNATIONAL RENOWNED BEAUTY ACADE     ,TX,76103-2504,Proprietary  ,0,0,0,10,36,46
03733300,BAPTIST UNIVERSITY OF THE AMERICAS      ,TX,78224-1336,Private      ,2,9,11,36,164,200
03756300,ANAMARC EDUCATIONAL INSTITUTE           ,TX,79930-6230,Proprietary  ,21,116,137,87,578,665
03885400,COMPUTER LABS                           ,TX,79906-5924,Proprietary  ,0,0,0,2,4,6
03885700,HOUSTON'S TRAINING AND EDUCATION CENTER ,TX,77036-2021,Proprietary  ,1,16,17,30,165,195
03922300,SOUTH TEXAS BARBER COLLEGE              ,TX,78415-3463,Proprietary  ,1,3,4,9,65,74
03926300,AMESED                                  ,TX,75081-0000,Proprietary  ,1,7,8,10,55,65
03944400,PROFESSIONAL CAREERS INSTITUTE          ,TX,77036-2252,Proprietary  ,0,33,33,9,85,94
03984300,ALLIED CAREER CENTER                    ,TX,75007-0000,Proprietary  ,0,13,13,8,77,85
03987300,TEXAS HEALTH SCHOOL                     ,TX,77079-2106,Proprietary  ,9,27,36,35,151,186
04036300,SOUTHEAST TEXAS CAREER INSTITUTE        ,TX,77656-8601,Proprietary  ,5,10,15,17,42,59
04045300,NORTHWEST BEAUTY SCHOOL                 ,TX,77091-1208,Proprietary  ,5,10,15,19,73,92
04045400,MAI-TRIX BEAUTY COLLEGE                 ,TX,77040-0000,Proprietary  ,2,16,18,18,70,88
04089400,CCI TRAINING CENTER                     ,TX,76011-4857,Proprietary  ,11,77,88,16,115,131
04117900,CHAMPION BEAUTY COLLEGE                 ,TX,77069-4611,Proprietary  ,0,3,3,0,3,3
00367000,BRIGHAM YOUNG UNIVERSITY                ,UT,84602-8406,Private      ,487,756,1243,9270,12136,21406
00367100,DIXIE STATE COLLEGE OF UTAH             ,UT,84770-3876,Public       ,79,124,203,2020,1951,3971
00367200,LDS BUSINESS COLLEGE                    ,UT,84101-3500,Private      ,31,27,58,501,439,940
00367400,STEVENS HENAGER COLLEGE                 ,UT,84401-1420,Proprietary  ,50,289,339,517,2153,2670
00367500,UNIVERSITY OF UTAH                      ,UT,84112-9055,Public       ,242,491,733,7580,13510,21090
00367600,COLLEGE OF EASTERN UTAH                 ,UT,84501-2699,Public       ,34,50,84,604,689,1293
00367700,UTAH STATE UNIVERSITY                   ,UT,84322-1400,Public       ,167,268,435,5494,7999,13493
00367800,SOUTHERN UTAH UNIVERSITY                ,UT,84720-2470,Public       ,90,106,196,2773,2671,5444
00367900,SNOW COLLEGE                            ,UT,84627-1299,Public       ,78,53,131,1633,667,2300
00368000,WEBER STATE UNIVERSITY                  ,UT,84408-1136,Public       ,162,389,551,3820,8854,12674
00368100,WESTMINSTER COLLEGE                     ,UT,84105-3697,Private      ,23,51,74,1506,1364,2870
00402700,UTAH VALLEY UNIVERSITY                  ,UT,84058-5999,Public       ,306,594,900,5171,10792,15963
00522000,SALT LAKE COMMUNITY COLLEGE             ,UT,84123-0000,Public       ,282,556,838,4728,10450,15178
00943300,SHERMAN KENDALL'S ACADEMY OF BEAUTY     ,UT,84106-1836,Proprietary  ,2,4,6,22,36,58
01009800,NEUMONT UNIVERSITY                      ,UT,84095-0000,Proprietary  ,13,28,41,238,307,545
01116500,UINTAH BASIN APPLIED TECHNOLOGY CLG     ,UT,84066-0000,Public       ,0,12,12,11,67,78
01116600,UTAH CAREER COLLEGE                     ,UT,84088-4021,Proprietary  ,45,124,169,273,867,1140
02078800,SHERMAN KENDALL'S ACADEMY OF BEAUTY     ,UT,84047-0000,Proprietary  ,3,3,6,13,27,40
02115400,BRIDGERLAND APPLIED TECHNOLOGY COLLEGE  ,UT,84321-0000,Public       ,12,45,57,119,413,532
02156600,DAVIS APPLIED TECHNOLOGY COLLEGE        ,UT,84037-0000,Public       ,17,69,86,176,711,887
02178500,EAGLE GATE COLLEGE                      ,UT,84123-0000,Proprietary  ,53,177,230,297,1176,1473
02270800,AMERITECH COLLEGE                       ,UT,84604-6927,Proprietary  ,12,41,53,91,310,401
02298500,EVEREST COLLEGE                         ,UT,84119-2668,Proprietary  ,45,232,277,246,1271,1517
02346500,OGDEN-WEBER APPLIED TECHNOLOGY COLG     ,UT,84404-0000,Public       ,18,98,116,163,916,1079
02360800,PROVO COLLEGE                           ,UT,84601-0000,Proprietary  ,40,95,135,234,755,989
02361000,ITT TECHNICAL INSTITUTE                 ,UT,84123-0000,Proprietary  ,44,86,130,284,780,1064
02504000,MARINELLO SCHOOL OF BEAUTY              ,UT,84041-0000,Proprietary  ,10,21,31,50,124,174
02516100,MARINELLO SCHOOL OF BEAUTY              ,UT,84405-1501,Proprietary  ,8,20,28,40,61,101
02531800,VON CURTIS ACADEMY OF HAIR DESIGN       ,UT,84606-0000,Proprietary  ,138,119,257,725,588,1313
02556800,HAIRITAGE COLLEGE OF BEAUTY             ,UT,84117-7204,Proprietary  ,26,15,41,116,88,204
02557700,PREMIER HAIR ACADEMY                    ,UT,84120-3603,Proprietary  ,0,6,6,7,27,34
02572700,EVANS HAIRSTYLING COLLEGE               ,UT,84770-0000,Proprietary  ,1,3,4,23,17,40
02572800,VISTA COLLEGE                           ,UT,84015-0000,Proprietary  ,5,21,26,21,110,131
02572801,CERTIFIED CAREERS INSTITUTE             ,UT,84015-0000,Proprietary  ,2,15,17,22,123,145
02573100,EVANS HAIRSTYLING COLLEGE               ,UT,84720-0000,Proprietary  ,1,2,3,36,25,61
02612200,MARINELLO SCHOOL OF BEAUTY              ,UT,84604-1585,Proprietary  ,6,10,16,121,97,218
03030600,UTAH COLLEGE OF MASSAGE THERAPY         ,UT,84111-1606,Proprietary  ,71,73,144,482,672,1154
03030601,UTAH CLG OF MASSAGE THER-PROVO CMPS     ,UT,84042-0000,Proprietary  ,33,43,76,148,248,396
03082100,MYOTHERAPY COLLEGE OF UTAH              ,UT,84115-2522,Proprietary  ,5,8,13,23,66,89
03108200,ECHELON EDGE ACADEMY OF HAIR SKIN & NAIL,UT,84070-2004,Proprietary  ,6,10,16,29,53,82
03110400,HAIRITAGE HAIR ACADEMY                  ,UT,84770-5233,Proprietary  ,8,5,13,25,36,61
03339400,WESTERN GOVERNORS UNIVERSITY            ,UT,84107-2533,Private      ,34,1475,1509,205,8741,8946
03413300,MOUNTAINLAND APPLIED TECHNOLOGY COLLEGE ,UT,84058-5857,Public       ,5,12,17,31,70,101
03463300,CAREERS UNLIMITED                       ,UT,84058-0000,Proprietary  ,1,0,1,17,20,37
03617300,HEALING MOUNTAIN MASSAGE SCHOOL         ,UT,84111-3232,Proprietary  ,4,4,8,11,47,58
03829500,SKINWORKS SCHOOL OF ADVANCED SKINCARE   ,UT,84115-0000,Proprietary  ,4,3,7,18,46,64
03838300,OGDEN INSTITUTE OF MASSAGE THERAPY      ,UT,84403-0000,Proprietary  ,2,13,15,19,57,76
03902300,RENAISSANCE SCHOOL OF THERAPEUTIC MASSAG,UT,84010-2835,Proprietary  ,0,1,1,1,17,18
03909300,MAXIMUM STYLE TEC SCHOOL OF COSMETOLOGY ,UT,84323-4679,Proprietary  ,2,1,3,12,25,37
03921300,CAMEO COLLEGE OF ESSENTIAL BEAUTY       ,UT,84115-0000,Proprietary  ,14,22,36,92,193,285
04054300,SOUTHWEST APPLIED TECHNOLOGY COLLEGE    ,UT,84720-6608,Public       ,0,4,4,1,8,9
00368200,BENNINGTON COLLEGE                      ,VT,05201-6001,Private      ,8,2,10,781,215,996
00368300,CASTLETON STATE COLLEGE                 ,VT,05735-0000,Public       ,23,7,30,2400,440,2840
00368400,CHAMPLAIN COLLEGE                       ,VT,05401-3950,Private      ,18,30,48,2449,729,3178
00368402,WOODBURY COLLEGE                        ,VT,05602-0000,Private      ,1,7,8,12,171,183
00368500,COLLEGE OF ST JOSEPH                    ,VT,05701-3899,Private      ,1,12,13,201,272,473
00368600,GODDARD COLLEGE                         ,VT,05667-0000,Private      ,5,47,52,62,791,853
00368700,GREEN MOUNTAIN COLLEGE                  ,VT,05764-1199,Private      ,7,4,11,981,103,1084
00368800,JOHNSON STATE COLLEGE                   ,VT,05656-9898,Public       ,24,30,54,1269,931,2200
00368900,LYNDON STATE COLLEGE                    ,VT,05851-0919,Public       ,22,8,30,1416,342,1758
00369000,MARLBORO COLLEGE                        ,VT,05344-0300,Private      ,6,4,10,445,82,527
00369100,MIDDLEBURY COLLEGE                      ,VT,05753-0000,Private      ,17,8,25,2682,978,3660
00369200,NORWICH UNIVERSITY                      ,VT,05663-1035,Private      ,23,170,193,2389,1846,4235
00369300,SOUTHERN VERMONT COLLEGE                ,VT,05201-6002,Private      ,6,9,15,453,154,607
00369400,ST MICHAELS COLLEGE                     ,VT,05439-0001,Private      ,21,3,24,2828,217,3045
00369600,UNIVERSITY OF VERMONT                   ,VT,05405-0160,Public       ,91,38,129,12324,2638,14962
00369800,VERMONT TECHNICAL COLLEGE               ,VT,05061-0000,Public       ,11,16,27,968,580,1548
00857500,SALON PROFESSIONAL ACADEMY (THE)        ,VT,05495-4001,Proprietary  ,7,5,12,71,57,128
00865800,O'BRIENS AVEDA INSTITUTE                ,VT,05403-7747,Proprietary  ,0,4,4,25,36,61
00886000,SIT                                     ,VT,05301-4801,Private      ,0,3,3,21,528,549
01116700,COMMUNITY COLLEGE OF VERMONT            ,VT,05676-1552,Public       ,90,231,321,1432,3513,4945
01193400,VERMONT LAW SCHOOL                      ,VT,05068-0000,Private      ,0,5,5,1,977,978
01218300,BURLINGTON COLLEGE                      ,VT,05401-8477,Private      ,3,11,14,88,158,246
02143500,STERLING COLLEGE                        ,VT,05827-0000,Private      ,1,1,2,117,26,143
02207000,NEW ENGLAND SCHOOL OF RADIOLOGIC TE     ,VT,05701-0000,Private      ,0,0,0,1,1,2
02254000,NEW ENGLAND CULINARY INSTITUTE          ,VT,05602-0000,Proprietary  ,18,17,35,543,290,833
02532600,LANDMARK COLLEGE                        ,VT,05346-0000,Private      ,9,2,11,326,53,379
03708300,BURLINGTON TECHNICAL CENTER             ,VT,05401-2721,Public       ,0,0,0,17,9,26
00392800,CASPER COLLEGE                          ,WY,82601-4612,Public       ,36,71,107,1065,1210,2275
00392900,EASTERN WYOMING COLLEGE                 ,WY,82240-1603,Public       ,5,19,24,288,279,567
00393000,SHERIDAN COLLEGE                        ,WY,82801-9133,Public       ,25,41,66,593,742,1335
00393100,NORTHWEST COLLEGE                       ,WY,82435-1895,Public       ,25,28,53,828,568,1396
00393200,UNIVERSITY OF WYOMING                   ,WY,82071-3663,Public       ,92,98,190,5761,3962,9723
00393300,WESTERN WYOMING COMMUNITY COLLEGE       ,WY,82902-0000,Public       ,15,28,43,643,710,1353
00728900,CENTRAL WYOMING COLLEGE                 ,WY,82501-0000,Public       ,7,49,56,376,650,1026
00915700,WYOMING TECHNICAL INSTITUTE             ,WY,82072-9519,Proprietary  ,238,190,428,5263,1757,7020
00925900,LARAMIE COUNTY COMMUNITY CLG            ,WY,82007-3299,Public       ,42,93,135,885,1449,2334
02211900,CHEEKS INTERNATIONAL ACDMY              ,WY,82001-0000,Proprietary  ,9,11,20,46,139,185
03291300,BUSINESS SKILLS INSTITUTE A DEPARTMENT O,WY,82930-0000,Public       ,1,2,3,8,23,31
00393500,UNIV OF GUAM                            ,GU,96923-0000,Public       ,79,78,157,1576,1301,2877
01536100,GUAM COMMUNITY COLLEGE                  ,GU,96921-0000,Public       ,62,74,136,773,1109,1882
03438300,PACIFIC ISLANDS BIBLE COLLEGE           ,GU,96913-2619,Private      ,5,9,14,148,83,231
00393600,PONTIFICAL CATHOLIC UNIV OF PR          ,PR,00717-0777,Private      ,87,283,370,5347,4898,10245
00393700,UNIVERSITY OF THE SACRED HEART          ,PR,00914-0383,Private      ,77,175,252,3109,1881,4990
00393800,INTER-AMER UNIV PR-CNTRL ADMN           ,PR,00936-0000,Private      ,101,386,487,2589,4935,7524
00393801,INTER-AMER UNIV PR SCHL LAW             ,PR,00936-8351,Private      ,0,3,3,0,326,326
00393802,INTER AMERICAN UNIVERSITY OF PUERTO RICO,PR,00926-0000,Private      ,16,87,103,1225,1832,3057
00393803,INTER AMERICAN UNIVERSITY OF PR         ,PR,00683-0000,Private      ,61,147,208,3952,2373,6325
00393804,INTER-AMER UNIV PR-RECINTO AGUADILA     ,PR,00605-2000,Private      ,118,196,314,2796,2390,5186
00393805,INTER-AMER UNIV PR-ARECIBO CAMPUS       ,PR,00614-4050,Private      ,55,127,182,3251,2435,5686
00393806,INTER-AMER UNIV PR-BARRANQUITAS REG     ,PR,00794-0517,Private      ,50,78,128,1578,1155,2733
00393807,INTER-AMER UNIV PR-FAJARDO REGIONAL     ,PR,00738-0000,Private      ,34,81,115,1337,1301,2638
00393808,INTER-AMER UNIV PR - GUAYAMA CAMPUS     ,PR,00785-4004,Private      ,38,132,170,1184,1553,2737
00393809,INTER-AMER UNIV PR-PONCE REGIONAL       ,PR,00715-0000,Private      ,107,238,345,3475,3036,6511
00393810,INTER-AMER UNIV PR - SCH OF OPTOMETRY   ,PR,00918-0000,Private      ,1,0,1,2,50,52
00393811,INTER-AMER UNIV PR-BAYAMON REG CLG      ,PR,00959-0000,Private      ,84,131,215,4252,1876,6128
00394100,COLEGIO UNIVERSITARIO DEL ESTE          ,PR,00983-0000,Private      ,155,850,1005,4995,8032,13027
00394200,UNIVERSITY OF PR-CENTRAL ADMINISTRATION ,PR,00936-4984,Public       ,9,18,27,710,323,1033
00394201,UNIVERSITY OF PR-RIO PIEDRAS CAMPUS     ,PR,00931-3300,Public       ,116,133,249,8972,2680,11652
00394202,UNIV OF PUERTO RICO-MAYAGUEZ CAMPUS     ,PR,00681-5000,Public       ,80,73,153,8380,1493,9873
00394203,"UNIVERSITY OF PR, MED. SCIENCES CAMPUS  ",PR,00936-5067,Public       ,1,37,38,311,1182,1493
00394204,"UNIVERSITY OF PUERTO RICO, CAYEY CAMPUS ",PR,00736-0000,Public       ,17,29,46,2875,616,3491
00394205,"UNIVERSITY OF PR, HUMACAO CAMPUS        ",PR,00791-4057,Public       ,23,38,61,3171,580,3751
00394206,UNIVERSITY OF PR-AGUADILLA CAMPUS       ,PR,00604-6150,Public       ,19,19,38,2710,507,3217
00394207,UNIVERSITY OF PUERTO RICO-ARECIBO CAMPUS,PR,00614-0000,Public       ,25,23,48,3819,584,4403
00394208,UNIVERSITY OF PUERTO RICO-BAYAMON CAMPUS,PR,00959-0000,Public       ,26,14,40,3535,465,4000
00394209,UNIVERSITY OF PUERTO RICO-CAROLINA      ,PR,00984-4800,Public       ,26,29,55,2949,482,3431
00394210,UNIVERSITY OF PUERTO RICO-PONCE         ,PR,00732-0000,Public       ,11,13,24,3181,450,3631
00394211,"UNIVERSITY OF PR, UTUADO CAMPUS         ",PR,00641-0000,Public       ,16,7,23,1308,297,1605
00501900,UNIV ADVENTISTA DE LAS ANTILLAS         ,PR,00681-0118,Private      ,9,17,26,531,335,866
00502200,BAYAMON CENTRAL UNIVERSITY              ,PR,00960-0000,Private      ,45,103,148,1210,1552,2762
00890200,COLUMBIA CENTRO UNIVERSITARIO           ,PR,00726-0000,Proprietary  ,24,111,135,510,1167,1677
01056700,COLEGIO TECNOLOGICO DE SAN JUAN         ,PR,00918-2973,Public       ,20,39,59,343,486,829
01072400,CARLOS ALBIZU UNIVERSITY                ,PR,00902-3711,Private      ,0,17,17,89,710,799
01081900,CONSERVATORIO DE MUSICA DE PUERTO RICO  ,PR,00907-3373,Public       ,0,8,8,235,67,302
01120300,RYDER MEMORIAL HOSP SCH OF NURSING      ,PR,00792-0000,Private      ,0,0,0,11,11,22
01171900,UNIVERSIDAD DEL TURABO                  ,PR,00778-0000,Private      ,203,908,1111,6711,10523,17234
01194000,ICPR JUNIOR COLLEGE                     ,PR,00919-0000,Proprietary  ,110,163,273,814,1038,1852
01194100,AMERICAN UNIVERSITY OF PUERTO RICO      ,PR,00960-2037,Private      ,48,94,142,910,915,1825
01194101,AMERICAN UNIVERSITY OF PUERTO RICO      ,PR,00674-0000,Private      ,57,93,150,926,884,1810
01252500,CARIBBEAN UNIVERSITY                    ,PR,00960-0493,Private      ,98,376,474,1833,3251,5084
01314800,RAMIREZ COLLEGE OF BUS & TECH           ,PR,00918-0000,Proprietary  ,38,90,128,272,472,744
02063100,MBTI BUSINESS TRNG INSTITUTE            ,PR,00907-3917,Proprietary  ,51,104,155,470,656,1126
02097000,"COLEGIO TECNICO METROPOLITANO, INC.     ",PR,00920-0000,Proprietary  ,0,0,0,105,244,349
02100000,POLYTECHNIC UNIVERSITY OF PR            ,PR,00917-0000,Private      ,70,163,233,2991,2090,5081
02163300,UNIVERSIDAD CENTRAL DEL CARIBE          ,PR,00960-0000,Private      ,1,9,10,80,363,443
02165100,EDP COLLEGE OF PUERTO RICO              ,PR,00919-0000,Private      ,57,145,202,592,1389,1981
02166400,INSTITUTO DE BANCA Y COMERCIO           ,PR,00925-0000,Proprietary  ,844,1569,2413,8122,10199,18321
02170300,INST EDUC TECNIA OCUP LA REINA          ,PR,00674-0000,Proprietary  ,48,83,131,296,364,660
02170301,INST EDUC TECNICA OCUPLA LA REINA       ,PR,00603-0000,Proprietary  ,0,0,0,12,2,14
02189100,CENTRO DE ESTUDIOS MULTIDISCIPLIN       ,PR,00926-0000,Private      ,91,218,309,865,1460,2325
02189300,EMMA'S BEAUTY ACADEMY                   ,PR,00680-0000,Proprietary  ,24,37,61,241,258,499
02195400,MODERN HAIRSTYLING INSTITUTE            ,PR,00960-0000,Proprietary  ,80,122,202,476,580,1056
02195500,MODERN HAIRSTYLING INSTITUTE            ,PR,00612-0000,Proprietary  ,0,0,0,1,1,2
02195800,LICEO E ARTE Y TECNOLGIA                ,PR,00919-0000,Private      ,58,69,127,820,610,1430
02195900,MODERN HAIRSTYLING INSTITUTE            ,PR,00980-0000,Proprietary  ,0,0,0,6,1,7
02234900,ANTILLES SCHOOL OF TECH CAREERS         ,PR,00909-0000,Proprietary  ,19,46,65,136,267,403
02241901,COMMONWEALTH OF PR DEPT OF EDUC - CARLOS,PR,00986-0000,Public       ,0,5,5,19,48,67
02241902,COMMONWEALTH OF PR DEPT OF EDUC - TOMAS ,PR,00613-0000,Public       ,0,1,1,19,25,44
02241904,COMMONWEALTH OF PR DEPT OF EDUC - ITPR R,PR,00655-0000,Public       ,9,11,20,505,229,734
02241905,COMMONWEALTH OF PR DEPT OF EDUC - JOSE A,PR,00674-0000,Public       ,2,6,8,725,195,920
02241907,COMMONWEALTH OF PR DEPT OF EDUC - ITPR R,PR,00928-0000,Public       ,10,11,21,443,177,620
02241908,COMMONWEALTH OF PR DEPT OF EDUC - ITPR R,PR,00732-0000,Public       ,4,5,9,644,243,887
02241909,COMMONWEALTH OF PR DEPT OF EDUC - TROQUE,PR,00959-0000,Public       ,0,0,0,11,2,13
02260600,NATIONAL COLLEGE OF BUSINESS & TECH     ,PR,00960-2036,Proprietary  ,183,473,656,2957,3743,6700
02260601,NATIONAL COLLEGE OF BUSINESS & TECHNOLOG,PR,00612-0000,Proprietary  ,0,0,0,22,11,33
02260602,NATIONAL COLLEGE OF BUSINESS & TECHNOLOG,PR,00745-9903,Proprietary  ,0,1,1,10,11,21
02260800,HUERTAS JUNIOR COLLEGE                  ,PR,00726-0000,Proprietary  ,91,213,304,924,1064,1988
02276400,INTERNATIONAL JUNIOR COLLEGE            ,PR,00910-0000,Proprietary  ,0,0,0,55,104,159
02276402,INTERNATIONAL JUNIOR COLLEGE            ,PR,00791-0000,Proprietary  ,0,0,0,8,7,15
02276403,INTERNATIONAL JUNIOR COLLEGE            ,PR,00733-0000,Proprietary  ,0,0,0,6,2,8
02297700,AUTOMECA TECHNICAL COLLEGE              ,PR,00957-0000,Proprietary  ,67,88,155,1068,706,1774
02303800,AMERICAN EDUCATIONAL COLLEGE            ,PR,00961-0000,Proprietary  ,58,112,170,541,693,1234
02335500,COLEGIO BIBLICO PENTECOSTAL DE PR       ,PR,00978-0000,Private      ,3,13,16,19,120,139
02340600,HUMACAO COMMUNITY COLLEGE               ,PR,00792-0000,Private      ,17,50,67,243,346,589
02343600,INSTITUTE OF BEAUTY CAREERS             ,PR,00613-0000,Proprietary  ,42,103,145,389,673,1062
02482400,PONCE SCHOOL OF MEDICINE                ,PR,00716-2347,Private      ,0,13,13,6,540,546
02502400,SERBIA'S SCHOOL OF BEAUTY CULTURE       ,PR,00785-0000,Proprietary  ,24,59,83,196,334,530
02504500,INSTITUCION CHAVIANO DE MAYAGUEZ        ,PR,00708-0000,Proprietary  ,4,32,36,26,123,149
02505400,ATLANTIC COLLEGE                        ,PR,00970-0000,Private      ,39,58,97,706,416,1122
02512100,INSTITUTO IRMA VALENTIN - UTUADO        ,PR,00641-0000,Proprietary  ,0,0,0,18,115,133
02534900,PONCE PARAMEDICAL COLLEGE (POPAC)       ,PR,00731-0000,Proprietary  ,126,233,359,1827,1607,3434
02549700,ACADEMIA MAISON D'ESTHETIQUE            ,PR,00907-0000,Proprietary  ,9,16,25,108,202,310
02552300,COLEGIO MAYOR DE TECHNOLOGIA            ,PR,00714-0000,Proprietary  ,45,79,124,261,425,686
02562500,INTERNATIONAL TECHNICAL COLLEGE         ,PR,00918-0000,Proprietary  ,14,28,42,98,127,225
02563500,ROGIES SCHOOL OF BEAUTY CULTURE         ,PR,00910-0000,Proprietary  ,32,48,80,196,249,445
02566800,PUERTO RICO TECH JUNIOR COLLEGE         ,PR,00917-0000,Proprietary  ,13,15,28,69,73,142
02569400,ESCUELA DE ARTES PLASTICAS              ,PR,00902-1112,Public       ,5,10,15,276,153,429
02570400,EDUCATIONAL TECHNICAL COLLEGE           ,PR,00925-3404,Proprietary  ,53,213,266,437,1104,1541
02576100,ESCUELA TECNICA DE ELECTRICIDAD         ,PR,00731-0000,Proprietary  ,29,76,105,398,448,846
02587500,UNIVERSIDAD METROPOLITANA               ,PR,00928-0000,Private      ,131,744,875,4888,8307,13195
02588600,SEMINARIO EVANGELICO DE PUERTO RICO     ,PR,00925-0000,Private      ,0,1,1,0,32,32
02593700,HISPANIC AMERICAN COLLEGE               ,PR,00725-0000,Proprietary  ,17,32,49,154,228,382
02611100,INSTITUTO MERLIX                        ,PR,00961-0000,Proprietary  ,14,86,100,82,252,334
03021900,EDIC COLLEGE                            ,PR,00726-0000,Proprietary  ,30,104,134,478,666,1144
03025500,MECH TECH COLLEGE                       ,PR,00725-6118,Proprietary  ,178,190,368,2691,1332,4023
03025900,"LICEO DE ARTE, DISENOS Y COMERCIO       ",PR,00726-0000,Proprietary  ,18,60,78,280,494,774
03029700,"UNIVERSAL TECHNOLOGY CLG OF PR, INC     ",PR,00605-1955,Private      ,65,150,215,715,1520,2235
03061900,COLEGIO TECHNOLOGICO Y COMERCIAL        ,PR,00602-0000,Proprietary  ,4,11,15,25,73,98
03068400,STAR BEAUTY ACADEMY                     ,PR,00961-6312,Proprietary  ,8,15,23,50,106,156
03070500,D'MART INSTITUTE                        ,PR,00794-3517,Proprietary  ,121,234,355,963,1251,2214
03075600,EMMA'S BEAUTY ACADEMY                   ,PR,00795-0000,Proprietary  ,12,40,52,300,304,604
03076000,PUERTO RICO BARBER COLLEGE              ,PR,00738-4632,Proprietary  ,2,21,23,43,91,134
03085700,PROFESSIONAL TECHNICAL INSTITUTION      ,PR,00960-7061,Proprietary  ,21,32,53,256,276,532
03098100,INSTITUTO IRMA VALENTIN - MANATI        ,PR,00674-0333,Proprietary  ,0,0,0,33,80,113
03104400,PROFESSIONAL ELECTRIC SCHOOL            ,PR,00674-1797,Proprietary  ,3,5,8,68,91,159
03106900,ESCUELA DE PERITOS ELECTRICITAS         ,PR,00662-0457,Proprietary  ,1,12,13,39,58,97
03112100,JOHN DEWEY COLLEGE                      ,PR,00915-9538,Private      ,226,468,694,849,2360,3209
03112101,JOHN DEWEY COLLEGE                      ,PR,00986-0000,Private      ,107,140,247,526,695,1221
03112102,JOHN DEWEY COLLEGE-BAYAMON CAMPUS       ,PR,00959-0000,Private      ,77,135,212,302,609,911
03112104,JOHN DEWEY COLLEGE - YABUCOA LRNING SITE,PR,00767-0767,Private      ,18,57,75,114,292,406
03112105,JOHN DEWEY COLLEGE - FAJARDO BRANCH     ,PR,00738-0738,Private      ,29,60,89,273,355,628
03112106,JOHN DEWEY COLLEGE - ARROYO BRANCH      ,PR,00714-0714,Private      ,18,63,81,143,411,554
03112107,JOHN DEWEY COLLEGE - JUANA DIAZ BRANCH  ,PR,00795-0000,Private      ,25,65,90,279,385,664
03115900,TRINITY COLLEGE OF PUERTO RICO          ,PR,00734-0000,Private      ,7,37,44,83,224,307
03120500,CAGUAS CENTRAL COLLEGE                  ,PR,00725-7199,Proprietary  ,0,0,0,0,1,1
03122500,ACADEMIA SERRANT INC.                   ,PR,00717-1568,Proprietary  ,14,54,68,112,285,397
03123100,GLOBELLE TECHNICAL INSTITUTE            ,PR,00693-4218,Proprietary  ,6,24,30,47,129,176
03124200,NOVA COLLEGE DE PUERTO RICO             ,PR,00960-4016,Proprietary  ,12,55,67,80,229,309
03142300,ACADEMIA VOCATIONAL DEL TURABO          ,PR,00725-3657,Proprietary  ,1,18,19,28,76,104
03157600,"COLEGIO DE CINEMATOGRAFIA, ARTES Y TELEV",PR,00961-6345,Proprietary  ,26,21,47,290,147,437
03177300,SAN JUAN BAUTISTA SCH OF MEDICINE       ,PR,00726-0000,Private      ,0,0,0,1,209,210
03326300,UNIVERSAL CAREER COMMUNITY COLLEGE      ,PR,00907-0000,Proprietary  ,40,74,114,383,514,897
03336300,CENTURY COLLEGE                         ,PR,00603-4802,Proprietary  ,25,41,66,76,154,230
03414300,MONTECLARO                              ,PR,00745-9612,Private      ,0,0,0,10,0,10
03452300,INSTITUTO PRE-VOCACIONAL E INDUSTRI     ,PR,00613-1800,Private      ,7,17,24,63,159,222
03461400,POLITEC INSTITUTE                       ,PR,00732-0000,Proprietary  ,4,24,28,75,110,185
03469300,IVAEM COLLEGE                           ,PR,00725-0000,Proprietary  ,2,1,3,111,58,169
03531300,COLEGIO PENTECOSTAL MIZPA               ,PR,00928-0966,Private      ,0,12,12,10,164,174
03544300,ATENAS COLLEGE                          ,PR,00674-0000,Private      ,28,106,134,480,885,1365
03552300,LESTON COLLEGE                          ,PR,00961-6309,Proprietary  ,20,27,47,63,121,184
03585300,CENTRO DE CAPACITACION Y ASESORAMIE     ,PR,00612-0000,Proprietary  ,9,49,58,47,291,338
03600300,AMERICAN TECHNOLOGICAL COLLEGE          ,PR,00928-3713,Proprietary  ,5,14,19,49,129,178
03608300,CARIBBEAN FORENSIC & TECHNICAL COLL     ,PR,00926-0000,Proprietary  ,4,40,44,42,175,217
03638300,ROSSLYN TRAINING ACADEMY OF COSMETOLOGY ,PR,00602-3225,Proprietary  ,0,0,0,23,64,87
03735400,"CHARLIES GUARD,DETECTIVE BUREAU&ACA     ",PR,00605-0000,Proprietary  ,9,23,32,51,137,188
03751300,ESCUELA HOTELERA DE SAN JUAN            ,PR,00917-0091,Proprietary  ,17,32,49,305,263,568
03758300,BAYAMON COMMUNITY COLLEGE               ,PR,00960-0000,Proprietary  ,7,39,46,46,170,216
03781400,INDUSTRIAL TECHNICAL COLLEGE            ,PR,00792-0000,Proprietary  ,6,18,24,79,130,209
03785300,J.G. GUAYNABO TECHNICAL COLLEGE         ,PR,00960-0000,Proprietary  ,5,26,31,23,70,93
03800300,COLEGIO TECNICO DE ELECTRICIDAD GALLOSA ,PR,00602-0000,Proprietary  ,3,19,22,21,70,91
03800400,INSTITUTE OF BEAUTY OCCUPATIONS AND TECH,PR,00676-5071,Proprietary  ,11,12,23,70,175,245
03843300,ADVANCED TECH COLLEGE                   ,PR,00961-6321,Proprietary  ,5,19,24,25,141,166
03849300,AGUADILLA TECHNICAL COLLEGE             ,PR,00603-0000,Proprietary  ,4,16,20,11,48,59
03965400,MYRANGEL BEAUTY INSTITUTE               ,PR,00754-3917,Proprietary  ,2,11,13,14,51,65
04030300,ASPIRA  DE PUERTO RICO                  ,PR,00987-0000,Private      ,0,1,1,2,2,4
04107300,CARIB TECHNOLOGICAL INSTITUTE           ,PR,00960-0000,Proprietary  ,0,16,16,1,27,28
00394600,UNIVERSITY OF THE VIRGIN ISLANDS        ,VI,00802-6000,Public       ,17,21,38,815,543,1358
00394601,UNIV OF THE VIRGIN ISLANDS-ST CROIX     ,VI,00850-0000,Public       ,7,11,18,325,433,758
00667400,CANADIAN THEOLOGICAL SEMINARY           ,CN,00000-0000,Private      ,0,0,0,0,1,1
00667700,MCGILL UNIVERSITY                       ,CN,00000-0000,Public       ,17,4,21,1332,376,1708
00667900,QUEEN'S UNIVERSITY AT KINGSTON          ,CN,00000-0000,Public       ,3,1,4,109,32,141
00668100,ST FRANCIS XAVIER UNIVERSITY            ,CN,00000-0000,Public       ,0,0,0,32,9,41
00668200,ST THOMAS UNIVERSITY                    ,CN,00000-0000,Public       ,0,0,0,15,4,19
00668300,UNIVERSITY OF GUELPH                    ,CN,00000-0000,Public       ,0,1,1,34,36,70
00668400,UNIVERSITY OF MANITOBA                  ,CN,00000-0000,Public       ,0,1,1,39,30,69
00668500,UNIVERSITY OF NEW BRUNSWICK (THE)       ,CN,00000-0000,Public       ,0,1,1,22,12,34
00668600,UNIVERSITY OF OTTAWA                    ,CN,00000-0000,Public       ,0,3,3,31,32,63
00668800,UNIVERSITY OF TORONTO                   ,CN,00000-0000,Public       ,2,9,11,264,358,622
00668900,UNIVERSITY OF WINDSOR                   ,CN,00000-0000,Public       ,1,2,3,15,38,53
00683700,UNIVERSITE LAVAL                        ,CN,00000-0000,Public       ,1,0,1,7,19,26
00683800,DALHOUSIE UNIVERSITY                    ,CN,00000-0000,Public       ,2,0,2,108,69,177
00685200,BISHOP'S UNIVERSITY                     ,CN,00000-0000,Private      ,1,0,1,27,1,28
00685300,MCMASTER UNIVERSITY                     ,CN,00000-0000,Public       ,1,0,1,23,21,44
00767900,YORK UNIVERSITY                         ,CN,00000-0000,Public       ,3,2,5,106,94,200
00787400,UNIVERSITY AT CALGARY (THE)             ,CN,00000-0000,Public       ,0,4,4,19,43,62
00814800,UNIVERSITY OF WINNIPEG                  ,CN,00000-0000,Public       ,0,1,1,9,5,14
00836200,UNIVERSITY OF ALBERTA (THE)             ,CN,00000-0000,Public       ,1,3,4,19,41,60
00836300,MOUNT SAINT VINCENT UNIVERSITY          ,CN,00000-0000,Private      ,0,0,0,7,2,9
00836400,SAINT MARY'S UNIVERSITY                 ,CN,00000-0000,Public       ,0,0,0,22,13,35
00836500,CONCORDIA UNIVERSITY - SIR GEORGE W     ,CN,00000-0000,Public       ,9,2,11,198,147,345
00836600,UNIVERSITE DE MONTREAL                  ,CN,00000-0000,Public       ,0,0,0,9,33,42
00836800,CARLETON UNIVERSITY                     ,CN,00000-0000,Public       ,0,1,1,41,20,61
00836900,UNIVERSITY OF BRITISH COLUMBIA          ,CN,00000-0000,Public       ,7,9,16,558,420,978
00837000,"SAFA, UNIVERSITY OF VICTORIA            ",CN,00000-0000,Public       ,1,4,5,107,63,170
00844400,SIMON FRASER UNIVERSITY                 ,CN,00000-0000,Public       ,0,2,2,62,82,144
00844600,UNIVERSITY OF WESTERN ONTARIO (THE)     ,CN,00000-0000,Public       ,3,0,3,38,40,78
00844800,UNIVERSITY OF REGINA                    ,CN,00000-0000,Public       ,0,0,0,8,8,16
00844900,ACADIA UNIVERSITY                       ,CN,00000-0000,Public       ,3,0,3,61,13,74
00852600,UNIVERSITY OF WATERLOO                  ,CN,00000-0000,Public       ,1,2,3,29,17,46
00858200,WILFRID LAURIER UNIVERSITY              ,CN,00000-0000,Public       ,0,0,0,7,5,12
00874200,UNIVERSITE DE SHERBROOKE                ,CN,00000-0000,Private      ,0,0,0,2,3,5
00891300,LAKEHEAD UNIVERSITY                     ,CN,00000-0000,Public       ,0,0,0,5,8,13
00911900,UNIVERSITE DE MONCTON                   ,CN,00000-0000,Public       ,0,0,0,0,2,2
00918000,LAURENTIAN UNIVERSITY OF SUDBURY        ,CN,00000-0000,Public       ,0,0,0,1,4,5
00925200,BROCK UNIVERSITY                        ,CN,00000-0000,Public       ,0,0,0,10,10,20
00936700,UNIVERSITY OF PRINCE EDWARD ISLAND      ,CN,00000-0000,Public       ,0,0,0,10,93,103
00942100,BRANDON UNIVERSITY                      ,CN,00000-0000,Public       ,0,0,0,2,7,9
00948600,TRINITY WESTERN UNIVERSITY              ,CN,00000-0000,Private      ,6,1,7,298,69,367
00950000,MEMORIAL UNIVERSITY OF NEWFOUNDLAND     ,CN,00000-0000,Public       ,1,1,2,14,29,43
00950100,UNIVERSITY OF KING'S COLLEGE            ,CN,00000-0000,Public       ,0,0,0,21,0,21
00950300,MOUNT ALLISON UNIVERSITY                ,CN,00000-0000,Public       ,0,0,0,34,2,36
00950500,TRENT UNIVERSITY                        ,CN,00000-0000,Public       ,0,0,0,10,3,13
00969700,LETHBRIDGE COLLEGE                      ,CN,00000-0000,Public       ,0,0,0,3,1,4
00969800,MEDICINE HAT COLLEGE                    ,CN,00000-0000,Public       ,0,0,0,2,2,4
00970100,SENECA COLG OF APPLIED ARTS & TECH      ,CN,00000-0000,Public       ,0,1,1,7,15,22
01012300,NOVA SCOTIA COLLEGE OF ART & DESIGN     ,CN,00000-0000,Public       ,1,0,1,11,13,24
01022100,SAINT PAUL UNIVERSITY                   ,CN,00000-0000,Public       ,0,0,0,1,4,5
01045800,SHERIDAN COLLEGE OF APPLIED ARTS AN     ,CN,00000-0000,Public       ,0,1,1,20,8,28
01067500,REGENT COLLEGE                          ,CN,00000-0000,Private      ,0,4,4,4,141,145
01070300,UNIVERSITY OF LETHBRIDGE                ,CN,00000-0000,Public       ,1,1,2,6,3,9
01072000,RYERSON UNIVERSITY                      ,CN,00000-0000,Public       ,0,0,0,30,33,63
01172200,BRIERCREST BIBLE COLLEGE                ,CN,00000-0000,Private      ,0,0,0,32,30,62
01221100,ALGONQUIN CLG OF APPLIED ARTS &TECH     ,CN,00000-0000,Public       ,0,0,0,7,6,13
01222800,HUMBER COLLEGE                          ,CN,00000-0000,Public       ,1,0,1,8,16,24
01227400,PROVIDENCE COLLEGE                      ,CN,00000-0000,Private      ,0,0,0,27,14,41
02054200,DAWSON COLLEGE                          ,CN,00000-0000,Public       ,0,0,0,0,2,2
02081600,SAULT COLLG OF APPLIED ARTS & TECH      ,CN,00000-0000,Public       ,0,0,0,0,1,1
02102100,BETHANY BIBLE COLLEGE                   ,CN,00000-0000,Private      ,0,0,0,90,26,116
02116600,CANADIAN MEMORIAL CHIROPRACTIC COLL     ,CN,00000-0000,Private      ,0,0,0,0,2,2
02167000,PRAIRIE BIBLE INST                      ,CN,00000-0000,Private      ,0,0,0,35,27,62
02184600,INSTITUTE FOR CHRISTIAN STUDIES         ,CN,00000-0000,Private      ,0,0,0,1,10,11
02195600,LASALLE COLLEGE                         ,CN,00000-0000,Private      ,0,1,1,3,9,12
02195700,TAYLOR UNIVERSITY COLLEGE AND SEMINARY  ,CN,00000-0000,Private      ,0,0,0,10,2,12
02201100,COLUMBIA BIBLE COLLEGE                  ,CN,00000-0000,Private      ,0,0,0,19,8,27
02209700,UNIVERSITE DU QUEBEC (UNIVERSITY OF     ,CN,00000-0000,Public       ,0,0,0,0,10,10
02216400,TYNDALE COLLEGE & SEMINARY              ,CN,00000-0000,Private      ,0,0,0,4,6,10
02219000,ST. LAWRENCE COLLEGE                    ,CN,00000-0000,Public       ,0,1,1,2,3,5
02219200,UNIVERSITY OF SASKATCHEWAN              ,CN,00000-0000,Public       ,0,1,1,4,13,17
02324900,EMMANUEL BIBLE COLLEGE                  ,CN,00000-0000,Private      ,0,0,0,0,1,1
02338800,EMILY CARR UNIVERSITY OF ART AND DESIGN ,CN,00000-0000,Public       ,0,0,0,53,25,78
02354700,RED DEER COLLEGE                        ,CN,00000-0000,Public       ,0,0,0,0,1,1
02529200,AUGUSTANA UNIVERSITY COLLEGE            ,CN,00000-0000,Private      ,0,0,0,0,1,1
02592600,NEW BRUNSWICK COMMUNITY COLLEGE         ,CN,00000-0000,Public       ,0,0,0,2,1,3
02593800,CONCORDIA UNIVERSITY COLLEGE            ,CN,00000-0000,Private      ,0,0,0,8,3,11
02611900,THE KING'S UNIVERSITY COLLEGE           ,CN,00000-0000,Private      ,0,0,0,2,1,3
03018300,ROCKY MOUNTAIN COLLEGE: CENTRE FOR      ,CN,00000-0000,Private      ,0,0,0,4,2,6
03033800,UNIVERSITY COLLEGE OF CAPE BRETON       ,CN,00000-0000,Public       ,0,0,0,8,1,9
03076200,COVENANT BIBLE COLLEGE                  ,CN,00000-0000,Private      ,0,0,0,21,2,23
03078300,VANCOUVER SCHOOL OF THEOLOGY            ,CN,00000-0000,Private      ,0,0,0,1,12,13
03273300,CANADIAN COLLEGE OF NATUROPATHIC ME     ,CN,00000-0000,Private      ,0,0,0,3,24,27
03298300,ALBERTA COLLEGE OF ART & DESIGN         ,CN,00000-0000,Public       ,2,0,2,24,2,26
03332500,KWANTLEN UNIVERSITY COLLEGE             ,CN,00000-0000,Public       ,0,0,0,5,9,14
03335400,CANADIAN UNIVERSITY COLLEGE             ,CN,00000-0000,Private      ,0,0,0,42,8,50
03339300,ST. STEPHENS UNIVERSITY                 ,CN,00000-0000,Private      ,0,0,0,4,4,8
03348500,REDEEMER UNIVERSITY COLLEGE             ,CN,00000-0000,Private      ,0,0,0,16,2,18
03408300,CANDIAN NAZARENE UNIVERSITY COLLEGE     ,CN,00000-0000,Private      ,0,0,0,3,1,4
03420300,HOLLAND COLLEGE                         ,CN,00000-0000,Public       ,1,1,2,1,1,2
03421300,LOYALIST COLLEGE OF APPLIED ARTS &      ,CN,00000-0000,Public       ,0,0,0,1,2,3
03433300,LANGARA COLLEGE                         ,CN,00000-0000,Public       ,0,0,0,5,5,10
03435400,ROYAL ROADS UNIVERSITY                  ,CN,00000-0000,Public       ,0,0,0,1,5,6
03465300,NIPISSING UNIVERSITY                    ,CN,00000-0000,Public       ,0,0,0,1,0,1
03511300,CN CLG ACUPUNCTURE & ORIENTAL MED       ,CN,00000-0000,Private      ,0,1,1,1,10,11
03551300,INTERNATIONAL BIBLE COLLEGE             ,CN,00000-0000,Private      ,0,0,0,4,2,6
03560400,NIAGARA COLLEGE-WELLAND CAMPUS          ,CN,00000-0000,Public       ,0,0,0,1,9,10
03613300,UNIV OF NORTHERN BRITISH COLUMBIA       ,CN,00000-0000,Public       ,1,1,2,6,6,12
03674400,CANADIAN SOUTHERN BAPTIST SEMINARY      ,CN,00000-0000,Private      ,0,0,0,0,3,3
03711300,CAPILANO UNIVERSITY                     ,CN,00000-0000,Public       ,0,0,0,5,6,11
03745300,BRITISH COLUMBIA INSTITUTE OF TECHNOLOGY,CN,00000-0000,Public       ,0,0,0,5,7,12
03846300,PACIFIC LIFE BIBLE COLLEGE              ,CN,00000-0000,Private      ,1,0,1,1,0,1
00814700,UNIVERSIDAD AUTONOMA DE GUADALAJARA     ,MX,00000-0000,Private      ,0,33,33,39,1218,1257
01041800,INST TEC Y DE ESTSUPER DE MONTERRE      ,MX,00000-0000,Private      ,1,0,1,43,50,93
01067600,UNIVERSIDAD DE MONTERREY                ,MX,00000-0000,Private      ,1,1,2,12,31,43
01093800,UNIVERSIDAD DE GUANAJUATO               ,MX,00000-0000,Public       ,1,2,3,13,21,34
01097600,INSTITUTO ALLENDE                       ,MX,00000-0000,Private      ,0,0,0,3,10,13
01230100,UNIV AUTON DE TAMAULIPAS FAC DEMED      ,MX,00000-0000,Public       ,0,0,0,0,3,3
02053300,CENTRO DE ESTUDIOS UNIVERSITARIOS D     ,MX,00000-0000,Private      ,7,7,14,92,196,288
02283100,UNIVERSIDAD TECNOLOGICA DE MEXICO       ,MX,00000-0000,Proprietary  ,0,1,1,5,18,23
01001000,AMERICAN SAMOA CMNTY COLLEGE            ,AS,96799-2609,Public       ,89,45,134,1348,333,1681
01034300,COLLEGE OF MICRONESIA - FSM             ,FM,96941-0159,Public       ,165,84,249,2219,668,2887
01100900,PALAU COMMUNITY COLLEGE                 ,PW,96940-0009,Public       ,58,27,85,827,394,1221
03022400,COLLEGE OF THE MARSHALL ISLANDS         ,MH,96960-1258,Public       ,42,22,64,584,336,920
03033000,NORTHERN MARIANAS COLLEGE               ,MP,96950-0000,Public       ,16,36,52,388,385,773
