OPE ID,School,State,Zip Code,School Type,20082009Qtr5_Dependent Students,20082009Qtr5_Independent Students,Quarterly Total,YTD_20082009Qtr5_Dependent Students,YTD_20082009Qtr5_Independent Students,Award Year To Date Total
00100200,ALABAMA AGRCLTL & MECHL UNIV            ,AL,35762-1357,Public       ,121,104,225,5361,2836,8197
00100300,FAULKNER UNIVERSITY                     ,AL,36109-3398,Private      ,33,239,272,1366,3448,4814
00100400,UNIVERSITY OF MONTEVALLO                ,AL,35115-6000,Public       ,41,43,84,1835,1112,2947
00100500,ALABAMA STATE UNIVERSITY                ,AL,36101-0000,Public       ,193,201,394,7698,4210,11908
00100700,CENTRAL ALABAMA COMMUNITY COLLEGE       ,AL,35011-0000,Public       ,47,141,188,1055,1764,2819
00100800,ATHENS STATE UNIVERSITY                 ,AL,35611-1999,Public       ,17,81,98,565,2623,3188
00100900,AUBURN UNIVERSITY                       ,AL,36849-5113,Public       ,276,183,459,13443,4854,18297
00101200,BIRMINGHAM SOUTHERN COLLEGE             ,AL,35254-0002,Private      ,36,15,51,1598,276,1874
00101300,CALHOUN COMMUNITY COLLEGE               ,AL,35609-2216,Public       ,190,396,586,3628,5725,9353
00101500,ENTERPRISE-OZARK COMMUNITY COLLEGE      ,AL,36331-1300,Public       ,46,105,151,1019,1479,2498
00101600,UNIVERSITY OF NORTH ALABAMA             ,AL,35632-0001,Public       ,110,104,214,3660,2210,5870
00101700,GADSDEN STATE COMMUNITY COLLEGE         ,AL,35903-2269,Public       ,137,398,535,2455,4381,6836
00101800,GEORGE C WALLACE COMMUNITY COLLEGE      ,AL,36303-0943,Public       ,97,248,345,1529,3127,4656
00101900,HUNTINGDON COLLEGE                      ,AL,36106-2148,Private      ,16,28,44,1049,448,1497
00102000,JACKSONVILLE STATE UNIVERSITY           ,AL,36265-1602,Public       ,101,222,323,5582,4633,10215
00102100,JEFFERSON DAVIS COMMUNITY COLLEGE       ,AL,36427-2790,Public       ,55,66,121,482,801,1283
00102200,JEFFERSON STATE COMMUNITY COLLEGE       ,AL,35215-3098,Public       ,140,353,493,3075,5699,8774
00102300,JUDSON COLLEGE                          ,AL,36756-2504,Private      ,7,9,16,305,117,422
00102400,UNIVERSITY OF WEST ALABAMA              ,AL,35470-0000,Public       ,58,278,336,1715,4271,5986
00102600,MARION MILITARY INSTITUTE               ,AL,36756-3214,Public       ,20,4,24,471,45,516
00102800,MILES COLLEGE                           ,AL,35064-2697,Private      ,57,57,114,2293,1259,3552
00102900,UNIVERSITY OF MOBILE                    ,AL,36663-0220,Private      ,23,48,71,1275,1466,2741
00103000,BISHOP STATE COMMUNITY COLLEGE          ,AL,36603-5898,Public       ,86,273,359,1432,3401,4833
00103001,BISHOP STATE COMM COLG-CARVER CMPS      ,AL,36617-0000,Public       ,11,27,38,124,275,399
00103002,BISHOP STAT COMM CLG-SW CMPS            ,AL,36605-0000,Public       ,6,8,14,74,146,220
00103100,NORTHEAST ALABAMA STATE CMNTY COLG      ,AL,35986-0159,Public       ,81,206,287,1095,1784,2879
00103300,OAKWOOD COLLEGE                         ,AL,35896-0001,Private      ,46,25,71,1759,645,2404
00103400,ALABAMA SOUTHERN COMMUNITY COLLEGE      ,AL,36460-5698,Public       ,39,67,106,848,1018,1866
00103600,SAMFORD UNIVERSITY                      ,AL,35229-7000,Private      ,43,62,105,2650,2325,4975
00103700,SELMA UNIVERSITY                        ,AL,36701-0000,Private      ,0,0,0,0,1,1
00103800,SNEAD STATE COMMUNITY COLLEGE           ,AL,35957-0734,Public       ,22,108,130,901,1550,2451
00104000,SOUTHERN UNION STATE COMMUNITY CLG      ,AL,36276-0000,Public       ,97,167,264,2416,2511,4927
00104100,SPRING HILL COLLEGE                     ,AL,36608-1791,Private      ,23,23,46,1657,501,2158
00104400,STILLMAN COLLEGE                        ,AL,35403-1430,Private      ,37,23,60,2024,423,2447
00104600,TALLADEGA COLLEGE                       ,AL,35160-2354,Private      ,13,14,27,544,257,801
00104700,TROY STATE UNIVERSITY                   ,AL,36082-0001,Public       ,196,1531,1727,6767,21822,28589
00105000,TUSKEGEE UNIVERSITY                     ,AL,36088-1645,Private      ,88,17,105,4652,1008,5660
00105100,UNIVERSITY OF ALABAMA (THE)             ,AL,35487-0120,Public       ,297,248,545,14279,7234,21513
00105200,UNIVERSITY OF ALABAMA AT BIRMINGHAM     ,AL,35294-1150,Public       ,197,333,530,6885,8513,15398
00105500,UNIVERSITY OF ALABAMA IN HUNTSVILLE     ,AL,35899-0001,Public       ,77,112,189,3671,3058,6729
00105700,UNIVERSITY OF SOUTH ALABAMA             ,AL,36688-0002,Public       ,164,305,469,6091,7852,13943
00105900,LAWSON STATE COMMUNITY COLLEGE          ,AL,35221-1798,Public       ,134,324,458,1994,3307,5301
00105901,LAWSON STATE COMMUNITY COLLEGE - BESSEME,AL,35021-0308,Public       ,23,55,78,356,736,1092
00106000,FAULKNER STATE COMMUNITY COLLEGE        ,AL,36507-2698,Public       ,78,160,238,1985,2386,4371
00526000,J.F. DRAKE STATE TECH COLLEGE           ,AL,35811-1584,Public       ,41,143,184,372,1213,1585
00569100,SHELTON STATE COMMUNITY CLG             ,AL,35405-4017,Public       ,192,232,424,3098,2985,6083
00569200,REID STATE TECHNICAL COLLEGE            ,AL,36401-0000,Public       ,27,53,80,292,601,893
00569700,NORTHWEST- SHOALS COMMUNITY COLLEGE     ,AL,35661-0000,Public       ,218,182,400,1826,2131,3957
00569702,NORTHWEST-SHOALS C.C.-PHIL CAMPBELL     ,AL,35581-0000,Public       ,22,12,34,204,186,390
00569900,GEORGE C WALLACE STATE CMTY COLLEGE     ,AL,36703-0000,Public       ,57,125,182,1033,1673,2706
00573300,BEVILL STATE CMTY COLLEGE-WALKER        ,AL,35148-0000,Public       ,50,146,196,1128,2004,3132
00573301,BEVILL STATE COMMUNITY COLLEGE - FAYETTE,AL,35555-0000,Public       ,19,26,45,413,569,982
00573302,BEVILL STATE CMTY CLG-HAMILTON CAMP     ,AL,35570-0000,Public       ,5,24,29,154,292,446
00573305,BEVILL STATE CMTY CLG-WALKER CLG        ,AL,35501-0000,Public       ,14,21,35,311,426,737
00573400,H. COUNCILL TRENHOLM STATE TECH COLLEGE ,AL,36108-0020,Public       ,57,151,208,575,1529,2104
00573401,H. C. TRENHOLM ST TECH COL-PATTERSON CAM,AL,36116-2612,Public       ,15,47,62,249,530,779
00787100,GEORGE C WALLACE STATE CMTY CLG         ,AL,35077-2000,Public       ,135,248,383,2483,3604,6087
00831000,AUBURN UNIVERSITY-MONTGOMERY            ,AL,36124-0000,Public       ,71,156,227,2771,3734,6505
00898800,LURLEEN B WALLACE COMMUNITY COLLEGE     ,AL,36420-0418,Public       ,55,104,159,726,1119,1845
01019300,HERZING COLLEGE                         ,AL,35209-4816,Proprietary  ,15,70,85,141,833,974
01055400,CONCORDIA COLLEGE                       ,AL,36701-3323,Private      ,20,29,49,513,424,937
01218200,CHATTAHOOCHEE VALLEY CMTY CLG           ,AL,36869-7917,Public       ,37,107,144,702,1546,2248
01303906,SOUTH UNIVERSITY - MONTGOMERY           ,AL,36116-1120,Proprietary  ,39,130,169,278,1061,1339
02170600,UNITED STATES SPORTS ACADEMY            ,AL,36526-7055,Private      ,2,117,119,31,844,875
02199700,HERITAGE CHRISTIAN UNIVERSITY           ,AL,35630-0000,Private      ,1,3,4,14,65,79
02270400,SOUTHEASTERN BIBLE COLLEGE              ,AL,35244-2083,Private      ,4,11,15,103,160,263
02296000,PRINCE INSTITUTE OF PROFESSIONAL STUDIES,AL,36117-0000,Proprietary  ,3,14,17,25,143,168
02341000,FORTIS COLLEGE                          ,AL,36609-0000,Proprietary  ,72,188,260,397,1091,1488
02341002,CAPPS COLLEGE - MONTGOMERY              ,AL,36109-3624,Proprietary  ,2,8,10,29,128,157
02341004,FORTIS COLLEGE - SCHOOL OF COSMETOLOGY  ,AL,36609-1981,Proprietary  ,0,5,5,17,46,63
02503400,AMRIDGE UNIVERSITY                      ,AL,36124-0000,Private      ,4,53,57,29,817,846
02605500,REMINGTON COLLEGE - MOBILE CAMPUS       ,AL,36609-5593,Proprietary  ,91,398,489,496,2122,2618
03010600,VIRGINIA COLLEGE                        ,AL,35209-5154,Proprietary  ,322,3263,3585,2028,18463,20491
03010602,VIRGINIA COLLEGE - HUNTSVILLE           ,AL,35805-0000,Proprietary  ,37,195,232,166,717,883
03010605,VA COLG TECHNICAL AT PELHAM             ,AL,35124-0000,Proprietary  ,0,0,0,2,7,9
03010607,VIRGINIA COLLEGE - MOBILE               ,AL,36606-4748,Proprietary  ,1,26,27,53,330,383
03010616,VIRGINIA COLLEGE - MONTGOMERY           ,AL,36117-2802,Proprietary  ,12,52,64,115,520,635
03032500,ALABAMA STATE CLG BARBER STYLING        ,AL,35215-8308,Proprietary  ,4,12,16,24,54,78
03361400,FORTIS COLLEGE                          ,AL,36535-3547,Proprietary  ,11,72,83,60,342,402
03459300,SOUTHEASTERN SCHOOL OF COSMETOLOGY      ,AL,35228-0000,Private      ,7,58,65,35,205,240
03783300,BLUE CLIFF CAREER COLLEGE               ,AL,63306-4749,Proprietary  ,10,39,49,68,243,311
03894300,HUNTSVILLE BIBLE COLLEGE                ,AL,35811-0000,Private      ,0,5,5,6,54,60
04067300,SELMA UNIVERSITY                        ,AL,36701-0000,Private      ,1,19,20,19,118,137
04116500,MIMI'S BEAUTY ACADEMY OF COSMETOLOGY    ,AL,35810-3453,Proprietary  ,0,2,2,12,44,56
04121500,COLUMBIA SOUTHERN UNIVERSITY            ,AL,36561-3815,Proprietary  ,18,478,496,91,2424,2515
04125200,TONI LOVE'S COSMETOLOGY TRAINING CENTER ,AL,35474-0005,Proprietary  ,0,0,0,2,18,20
04149200,XCELL ACADEMY-A PAUL MITCHELL PARTNER SC,AL,35216-4990,Proprietary  ,0,1,1,0,1,1
00111100,ALLAN HANCOCK COLLEGE                   ,CA,93454-6399,Public       ,180,373,553,2841,3602,6443
00111300,ANTELOPE VALLEY COLLEGE                 ,CA,93536-5426,Public       ,401,1008,1409,4348,7618,11966
00111600,ART CENTER COLLEGE OF DESIGN            ,CA,91103-1999,Private      ,42,52,94,1218,1234,2452
00111700,AZUSA PACIFIC UNIVERSITY                ,CA,91702-7000,Private      ,100,486,586,5933,5908,11841
00111800,BAKERSFIELD COLLEGE                     ,CA,93305-1299,Public       ,331,751,1082,6996,8314,15310
00111900,BARSTOW COMMUNITY COLLEGE               ,CA,92311-6608,Public       ,72,432,504,570,2764,3334
00112000,AMER BAPT SEM OF THE WEST-BERKELEY      ,CA,94704-0000,Private      ,0,2,2,2,53,55
00112100,BETHANY UNIVERSITY /  ASSEMBLIES OF GOD ,CA,95066-2896,Private      ,6,11,17,431,345,776
00112200,BIOLA UNIVERSITY                        ,CA,90639-0001,Private      ,67,83,150,4705,1999,6704
00112300,BROOKS INSTITUTE                        ,CA,93103-1809,Proprietary  ,60,50,110,1424,757,2181
00112400,CABRILLO COLLEGE                        ,CA,95003-3194,Public       ,283,512,795,3098,4168,7266
00112500,CALIFORNIA BAPTIST UNIVERSITY           ,CA,92504-3297,Private      ,49,86,135,3242,2450,5692
00112700,CALIFORNIA COLLEGE OF THE ARTS          ,CA,94107-2206,Private      ,33,31,64,1566,1357,2923
00113100,CALIFORNIA INSTITUTE OF TECHNOLOGY      ,CA,91125-0001,Private      ,29,16,45,2532,376,2908
00113200,CALIFORNIA INSTITUTE OF THE ARTS        ,CA,91355-2397,Private      ,23,10,33,1476,1211,2687
00113300,CALIFORNIA LUTHERAN UNIVERSITY          ,CA,91360-2787,Private      ,28,90,118,2685,1418,4103
00113400,CALIFORNIA MARITIME ACADEMY             ,CA,94590-8181,Public       ,14,8,22,618,215,833
00113700,CALIF STATE UNIV-FULLERTON              ,CA,92831-3599,Public       ,620,544,1164,31128,14561,45689
00113800,"CALIFORNIA STATE UNIVERSITY, EAST BAY   ",CA,94542-3000,Public       ,207,470,677,7889,8829,16718
00113900,CALIF STATE UNIV-LONG BEACH             ,CA,90840-0006,Public       ,639,508,1147,36435,16597,53032
00114000,CALIF STATE UNIV-LOS ANGELES            ,CA,90032-4226,Public       ,416,722,1138,20441,15494,35935
00114100,"CALIF STATE UNIV, DOMINGUEZ HILLS       ",CA,90747-0001,Public       ,276,481,757,9752,9630,19382
00114200,CALIF STATE UNIV SAN BERNARDINO         ,CA,92407-2397,Public       ,288,501,789,13336,11422,24758
00114300,CAL POLY STATE UNIVERSITY               ,CA,93407-0001,Public       ,342,114,456,25127,3466,28593
00114400,CALIF STATE POLYTECHNIC UNIV POMONA     ,CA,91768-2500,Public       ,384,328,712,20857,7264,28121
00114600,CALIF STATE UNIV - CHICO                ,CA,95929-0001,Public       ,229,137,366,13800,5619,19419
00114700,CALIF STATE UNIV - FRESNO               ,CA,93740-8026,Public       ,272,242,514,17276,10049,27325
00114900,HUMBOLDT STATE UNIVERSITY               ,CA,95521-8299,Public       ,146,86,232,8397,3820,12217
00115000,CALIF STATE UNIV-SACRAMENTO             ,CA,95819-6044,Public       ,484,483,967,20364,14822,35186
00115100,SAN DIEGO STATE UNIVERSITY              ,CA,92182-1690,Public       ,670,456,1126,37686,15018,52704
00115300,CALIF STATE UNIV-NORTHRIDGE             ,CA,91330-8307,Public       ,485,556,1041,27070,16033,43103
00115400,SAN FRANCISCO STATE UNIVERSITY          ,CA,94132-1740,Public       ,433,424,857,26065,16128,42193
00115500,SAN JOSE STATE UNIVERSITY               ,CA,95192-0036,Public       ,355,489,844,22644,13811,36455
00115600,SONOMA STATE UNIVERSITY                 ,CA,94928-3609,Public       ,117,79,196,8026,3038,11064
00115700,CALIF STATE UNIV-STANISLAUS             ,CA,95382-0299,Public       ,159,205,364,6431,5038,11469
00115800,UNITED STATES INTERNATIONAL UNIV        ,CA,92131-1799,Private      ,0,0,0,5,135,140
00116100,CERRITOS COLLEGE                        ,CA,90650-6296,Public       ,556,735,1291,9254,7793,17047
00116200,CHABOT COLLEGE                          ,CA,94545-2400,Public       ,228,450,678,3558,4748,8306
00116300,CHAFFEY COLLEGE                         ,CA,91737-9400,Public       ,422,652,1074,7311,9423,16734
00116400,CHAPMAN UNIVERSITY                      ,CA,92866-1099,Private      ,113,759,872,5895,8869,14764
00116453,CHAPMAN UNIVERSITY SCHOOL OF LAW        ,CA,92866-0000,Private      ,4,10,14,122,1876,1998
00116500,CHURCH DIV SCH OF THE PACIFIC           ,CA,94709-0000,Private      ,0,0,0,0,72,72
00116600,CITRUS COLLEGE                          ,CA,91741-1899,Public       ,363,493,856,5011,4147,9158
00116900,CLAREMONT GRADUATE UNIVERSITY           ,CA,91711-0000,Private      ,1,65,66,14,1740,1754
00117000,CLAREMONT MCKENNA COLLEGE               ,CA,91711-6400,Private      ,22,2,24,2634,87,2721
00117100,HARVEY MUDD COLLEGE                     ,CA,91711-5990,Private      ,8,0,8,1791,24,1815
00117200,PITZER COLLEGE                          ,CA,91711-6101,Private      ,23,3,26,2593,131,2724
00117300,POMONA COLLEGE                          ,CA,91711-6301,Private      ,33,4,37,3968,80,4048
00117400,SCRIPPS COLLEGE                         ,CA,91711-3948,Private      ,10,2,12,1495,43,1538
00117600,WEST HILLS COMMUNITY COLLEGE            ,CA,93210-1399,Public       ,67,157,224,1160,1310,2470
00117700,COGSWELL POLYTECHNICAL COLLEGE          ,CA,94089-1210,Private      ,5,5,10,140,59,199
00117800,COLLEGE OF MARIN                        ,CA,94904-2590,Public       ,69,237,306,647,1572,2219
00117801,COLG OF MARIN-INDIAN VALLEY CMPS        ,CA,94949-0000,Public       ,5,13,18,20,73,93
00117900,NOTRE DAME DE NAMUR UNIVERSITY          ,CA,94002-1997,Private      ,19,55,74,795,801,1596
00118100,COLLEGE OF SAN MATEO                    ,CA,94402-3784,Public       ,103,218,321,1571,1802,3373
00118200,COLLEGE OF THE DESERT                   ,CA,92260-9305,Public       ,190,352,542,3065,3381,6446
00118300,HOLY NAMES UNIVERSITY                   ,CA,94619-1699,Private      ,16,38,54,604,683,1287
00118500,COLLEGE OF THE REDWOODS                 ,CA,95501-9300,Public       ,147,398,545,2267,3807,6074
00118600,COLLEGE OF THE SEQUOIAS                 ,CA,93277-2234,Public       ,263,571,834,4659,6040,10699
00118700,COLLEGE OF THE SISKIYOUS                ,CA,96094-2899,Public       ,38,95,133,872,1051,1923
00118701,COLLEGE OF THE SISKIYOUS - YREKA CENTER ,CA,96097-9538,Public       ,3,9,12,40,91,131
00119000,CONTRA COSTA COLLEGE                    ,CA,94806-3195,Public       ,126,392,518,1498,2647,4145
00119100,DIABLO VALLEY COLLEGE                   ,CA,94523-1544,Public       ,275,385,660,3367,3472,6839
00119200,CUESTA COLLEGE                          ,CA,93403-8106,Public       ,173,331,504,2928,2864,5792
00119300,CYPRESS COLLEGE                         ,CA,90630-5897,Public       ,267,470,737,4296,4851,9147
00119600,DOMINICAN UNIVERSITY OF CALIFORNIA      ,CA,94901-2298,Private      ,21,44,65,2131,1154,3285
00119700,EL CAMINO COLLEGE                       ,CA,90506-0002,Public       ,596,900,1496,7485,7354,14839
00119701,COMPTON COMMUNITY COLLEGE               ,CA,90221-5393,Public       ,157,535,692,1121,2771,3892
00119900,FOOTHILL COLLEGE                        ,CA,94022-4597,Public       ,113,228,341,1426,2230,3656
00120000,FULLER THEOLOGICAL SEMINARY             ,CA,91182-0000,Private      ,0,61,61,7,2050,2057
00120100,FULLERTON COLLEGE                       ,CA,92832-2095,Public       ,409,473,882,6664,4907,11571
00120200,GAVILAN COLLEGE                         ,CA,95020-9599,Public       ,133,165,298,1255,1599,2854
00120300,GLENDALE COMMUNITY COLLEGE              ,CA,91208-2894,Public       ,432,662,1094,5726,5588,11314
00120400,GOLDEN GATE BAPT THEOL SEMINARY         ,CA,94941-0000,Private      ,0,1,1,1,55,56
00120500,GOLDEN GATE UNIVERSITY                  ,CA,94105-2967,Private      ,6,127,133,74,3400,3474
00120600,GOLDEN WEST COLLEGE                     ,CA,92647-2748,Public       ,258,409,667,4615,4411,9026
00120700,GRADUATE THEOLOGICAL UNION              ,CA,94709-0000,Private      ,0,4,4,1,354,355
00120800,GROSSMONT COLLEGE                       ,CA,92020-1798,Public       ,309,620,929,5118,5760,10878
00120900,HARTNELL COMMUNITY COLLEGE              ,CA,93901-1697,Public       ,229,382,611,2314,2389,4703
00121200,HUMPHREYS COLLEGE                       ,CA,95207-3896,Private      ,24,113,137,196,945,1141
00121400,IMPERIAL VALLEY COLLEGE                 ,CA,92251-9787,Public       ,276,449,725,3877,3495,7372
00121500,LA SIERRA UNIVERSITY                    ,CA,92515-3332,Private      ,39,52,91,1659,776,2435
00121600,UNIVERSITY OF LA VERNE                  ,CA,91750-4443,Private      ,39,385,424,2380,6218,8598
00121700,LASSEN COLLEGE                          ,CA,96130-3000,Public       ,29,102,131,386,706,1092
00121800,LOMA LINDA UNIVERSITY                   ,CA,92350-0001,Private      ,25,114,139,733,4522,5255
00121900,LONG BEACH CITY COLLEGE                 ,CA,90808-1780,Public       ,612,1183,1795,9116,11364,20480
00122000,MASTER'S COLLEGE & SEMINARY (THE)       ,CA,91321-1200,Private      ,10,28,38,1036,347,1383
00122300,LOS ANGELES CITY COLLEGE                ,CA,90029-3588,Public       ,435,1071,1506,4536,8166,12702
00122400,LOS ANGELES HARBOR COLLEGE              ,CA,90744-2397,Public       ,221,464,685,2309,3275,5584
00122600,LOS ANGELES PIERCE COLLEGE              ,CA,91371-0001,Public       ,558,707,1265,6114,5192,11306
00122700,LOS ANGELES TRADE TECH COLLEGE          ,CA,90015-4181,Public       ,299,1060,1359,3081,6702,9783
00122800,LOS ANGELES VALLEY COLLEGE              ,CA,91401-4096,Public       ,476,847,1323,4653,5681,10334
00122900,SO CA UNIV  HEALTH SCIENCES             ,CA,90604-4051,Private      ,4,26,30,22,526,548
00123000,SOUTHERN CA COLLEGE OF OPTOMETRY        ,CA,92831-1699,Private      ,0,1,1,13,460,473
00123200,AMERICAN RIVER COLLEGE                  ,CA,95841-4286,Public       ,587,1539,2126,7754,14142,21896
00123300,SACRAMENTO CITY COLLEGE                 ,CA,95822-1386,Public       ,476,1065,1541,8057,10663,18720
00123600,MENLO COLLEGE                           ,CA,94027-4301,Private      ,15,10,25,753,154,907
00123700,MERCED COMMUNITY COLLEGE                ,CA,95348-2898,Public       ,278,437,715,4530,4778,9308
00123800,MILLS COLLEGE                           ,CA,94613-1301,Private      ,14,34,48,1383,1290,2673
00123900,MIRACOSTA COLLEGE                       ,CA,92056-3899,Public       ,134,272,406,1938,2902,4840
00124000,MODESTO JUNIOR COLLEGE                  ,CA,95350-5800,Public       ,378,698,1076,6966,8654,15620
00124200,MONTEREY PENINSULA COLLEGE              ,CA,93940-4799,Public       ,143,253,396,1407,1772,3179
00124300,MOUNT ST MARYS COLLEGE                  ,CA,90049-1599,Private      ,27,74,101,1955,1633,3588
00124500,MT. SAN ANTONIO COLLEGE                 ,CA,91789-1399,Public       ,701,945,1646,10717,8574,19291
00124600,MT SAN JACINTO COLLEGE                  ,CA,92583-2399,Public       ,416,1053,1469,4696,7536,12232
00124700,NAPA VALLEY COLLEGE                     ,CA,94558-6236,Public       ,120,215,335,1401,1894,3295
00124900,OCCIDENTAL COLLEGE                      ,CA,90041-3314,Private      ,34,8,42,4083,182,4265
00125000,ORANGE COAST COLLEGE - FIN AID OFF      ,CA,92628-5005,Public       ,429,499,928,7942,5844,13786
00125100,OTIS COLLEGE OF ART AND DESIGN          ,CA,90045-3505,Private      ,19,18,37,1456,573,2029
00125200,HOPE INTERNATIONAL UNIVERSITY           ,CA,92631-0000,Private      ,17,63,80,560,641,1201
00125300,FRESNO PACIFIC UNIVERSITY               ,CA,93702-4798,Private      ,23,168,191,1452,1858,3310
00125302,FRESNO PACIFIC UNIVERSITY - VISALIA CENT,CA,93277-8341,Private      ,4,19,23,32,213,245
00125303,FRESNO PACIFIC UNIVERSITY - BAKERSFIELD ,CA,93301-4533,Private      ,2,11,13,38,194,232
00125400,PACIFIC LUTHERAN THEOLOGICAL SEM        ,CA,94708-0000,Private      ,0,1,1,2,94,96
00125500,PACIFIC OAKS COLLEGE                    ,CA,91103-3592,Private      ,0,35,35,15,734,749
00125600,PACIFIC SCHOOL OF RELIGION              ,CA,94709-0000,Private      ,0,4,4,1,182,183
00125800,PACIFIC UNION COLLEGE                   ,CA,94508-9797,Private      ,36,27,63,1305,425,1730
00125900,PALO VERDE COLLEGE                      ,CA,92225-0000,Public       ,18,63,81,199,480,679
00126000,PALOMAR COLLEGE                         ,CA,92069-1486,Public       ,300,490,790,5125,5321,10446
00126100,PASADENA CITY COLLEGE                   ,CA,91106-2003,Public       ,756,1019,1775,11514,7655,19169
00126200,POINT LOMA NAZARENE UNIVERSITY          ,CA,92106-2899,Private      ,41,95,136,3141,1285,4426
00126600,LANEY COLLEGE                           ,CA,94607-4893,Public       ,218,713,931,2739,5665,8404
00126700,MERRITT COLLEGE                         ,CA,94619-3196,Public       ,101,404,505,1261,3223,4484
00126800,PORTERVILLE COLLEGE                     ,CA,93257-6059,Public       ,74,262,336,1483,2202,3685
00126900,RIO HONDO COLLEGE                       ,CA,90601-1699,Public       ,423,648,1071,5566,4691,10257
00127000,RIVERSIDE COMMUNITY COLLEGE             ,CA,92506-1299,Public       ,1278,2312,3590,14374,17475,31849
00127200,SAN BERNARDINO VALLEY COLLEGE           ,CA,92410-2798,Public       ,308,811,1119,4309,8476,12785
00127300,SAN DIEGO CITY COLLEGE                  ,CA,92101-4787,Public       ,309,898,1207,5179,9319,14498
00127500,SAN DIEGO MESA COLLEGE                  ,CA,92111-4996,Public       ,311,574,885,5924,6803,12727
00127800,SAN FRANCISCO CONSERVATORY OF MUSIC     ,CA,94122-4498,Private      ,3,2,5,249,326,575
00127900,SAN FRANCISCO THEOLOGICAL SEMINARY      ,CA,94960-0000,Private      ,0,8,8,0,85,85
00128000,SAN JOAQUIN DELTA COLLEGE               ,CA,95207-6370,Public       ,488,1015,1503,7286,10133,17419
00128100,WILLIAM JESSUP UNIVERSITY               ,CA,95765-3707,Private      ,6,18,24,459,281,740
00128200,SAN JOSE CITY COLLEGE                   ,CA,95128-2797,Public       ,209,472,681,2680,4245,6925
00128400,SANTA ANA COLLEGE                       ,CA,92706-3398,Public       ,378,653,1031,4564,4597,9161
00128500,SANTA BARBARA CITY COLLEGE              ,CA,93109-2394,Public       ,323,377,700,4620,3441,8061
00128600,SANTA MONICA COLLEGE                    ,CA,90405-1644,Public       ,725,845,1570,9995,6645,16640
00128700,SANTA ROSA JUNIOR COLLEGE               ,CA,95401-4395,Public       ,225,558,783,3799,5238,9037
00128800,CLAREMONT SCHOOL OF THEOLOGY            ,CA,91711-0000,Private      ,0,7,7,5,168,173
00128900,SHASTA COLLEGE                          ,CA,96049-7692,Public       ,159,514,673,3248,4874,8122
00129000,SIERRA COLLEGE                          ,CA,95677-3397,Public       ,315,535,850,4877,6198,11075
00129100,SIMPSON UNIVERSITY                      ,CA,96003-8606,Private      ,16,28,44,1127,814,1941
00129200,SOLANO COMMUNITY COLLEGE                ,CA,94534-3197,Public       ,183,492,675,2370,4576,6946
00129300,VANGUARD UNIVERSITY OF SOUTHERN CA      ,CA,92626-6597,Private      ,27,59,86,1956,890,2846
00129400,SOUTHWESTERN COLLEGE                    ,CA,91910-7299,Public       ,433,523,956,6683,5358,12041
00129500,SOUTHWESTERN LAW SCHOOL                 ,CA,90010-1106,Private      ,0,30,30,21,2596,2617
00129600,DOMINICAN SCH PHILOSOPHY & THEOLOGY     ,CA,94709-0000,Private      ,0,2,2,3,35,38
00129900,ST JOHN'S SEMINARY COLLEGE              ,CA,93010-0000,Private      ,0,0,0,0,2,2
00130200,SAINT MARY'S COLLEGE OF CALIFORNIA      ,CA,94556-2744,Private      ,41,71,112,3550,1314,4864
00130500,STANFORD UNIVERSITY                     ,CA,94305-6106,Private      ,226,135,361,16993,3209,20202
00130501,STANFORD UNIV SCHOOL OF MEDICINE        ,CA,94305-5404,Private      ,6,10,16,105,709,814
00130502,STANFORD UNIV GRAD SCH OF BUS           ,CA,94305-5015,Private      ,2,10,12,58,1040,1098
00130503,STANFORD UNIV LAW SCHOOL                ,CA,94305-8610,Private      ,4,11,15,49,2130,2179
00130700,FRESNO CITY COLLEGE                     ,CA,93741-0002,Public       ,495,1103,1598,11831,13596,25427
00130800,REEDLEY COLLEGE                         ,CA,93654-2099,Public       ,236,535,771,4694,4734,9428
00130900,TAFT COLLEGE                            ,CA,93268-2317,Public       ,32,118,150,705,906,1611
00131200,UNIVERSITY OF CALIFORNIA-BERKELEY       ,CA,94720-1520,Public       ,511,302,813,44574,17345,61919
00131300,UNIVERSITY OF CALIFORNIA-DAVIS          ,CA,95616-8558,Public       ,517,180,697,40422,11961,52383
00131400,UNIVERSITY OF CALIFORNIA-IRVINE         ,CA,92697-2825,Public       ,594,226,820,41919,8574,50493
00131500,UNIVERSITY OF CALIFORNIA (UCLA)         ,CA,90095-9000,Public       ,652,440,1092,53874,23220,77094
00131502,UNIV OF CALIFORNIA LOS ANG SCH MED      ,CA,90095-0000,Public       ,7,5,12,183,784,967
00131503,UNIV OF CALIFORNIA LOS ANG DENTAL       ,CA,90095-0000,Public       ,2,4,6,31,124,155
00131600,UNIVERSITY OF CALIFORNIA-RIVERSIDE      ,CA,92521-0209,Public       ,349,184,533,25374,5868,31242
00131700,UNIVERSITY OF CALIFORNIA-SAN DIEGO      ,CA,92093-0013,Public       ,452,161,613,39473,7703,47176
00131900,UNIVERSITY OF CALIFORNIA-SFRANCISCO     ,CA,94143-0246,Public       ,12,35,47,624,3173,3797
00132000,UNIVERSITY OF CALIFORNIA-SANTA BARB     ,CA,93106-3180,Public       ,455,112,567,39333,5607,44940
00132100,UNIVERSITY OF CALIFORNIA-SANTA CRUZ     ,CA,95064-0001,Public       ,298,111,409,24947,3443,28390
00132200,UNIVERSITY OF REDLANDS                  ,CA,92373-0999,Private      ,37,240,277,3895,2408,6303
00132500,UNIVERSITY OF SAN FRANCISCO             ,CA,94117-1080,Private      ,113,277,390,7422,6822,14244
00132600,SANTA CLARA UNIVERSITY                  ,CA,95053-4956,Private      ,86,141,227,7460,4121,11581
00132800,UNIVERSITY OF SOUTHERN CALIFORNIA       ,CA,90089-0914,Private      ,376,320,696,27147,18675,45822
00132900,UNIVERSITY OF THE PACIFIC               ,CA,95211-0197,Private      ,111,60,171,5566,2616,8182
00132901,UNIV OF THE PACIFIC MCGEORGE LAW        ,CA,95817-0000,Private      ,0,19,19,12,2281,2293
00132902,UNIV OF THE PACIFIC SCH OF DENT         ,CA,94115-0000,Private      ,1,4,5,22,549,571
00133400,VENTURA COLLEGE                         ,CA,93003-3899,Public       ,252,327,579,3971,3259,7230
00133500,VICTOR VALLEY COLLEGE                   ,CA,92395-5849,Public       ,491,1147,1638,4349,8406,12755
00133800,WEST VALLEY COLLEGE                     ,CA,95070-5697,Public       ,153,281,434,1662,2031,3693
00134100,WESTMONT COLLEGE                        ,CA,93108-1099,Private      ,40,1,41,2104,53,2157
00134200,WHITTIER COLLEGE                        ,CA,90601-4413,Private      ,29,20,49,2119,323,2442
00134201,WHITTIER LAW SCHOOL                     ,CA,92626-0000,Private      ,1,9,10,7,1168,1175
00134300,WOODBURY UNIVERSITY                     ,CA,91510-7846,Private      ,16,31,47,1057,844,1901
00134400,YUBA COLLEGE                            ,CA,95901-7699,Public       ,213,574,787,3216,5314,8530
00177212,TRINITY INTERNATIONAL UNIV-CA           ,CA,92705-0000,Private      ,0,11,11,5,204,209
00274100,AMERICAN JEWISH UNIVERSITY              ,CA,90077-1599,Private      ,4,4,8,86,136,222
00301002,ANTIOCH UNIV/LOS ANGELES                ,CA,90230-7615,Private      ,1,66,67,26,917,943
00301003,ANTIOCH  UNIV/SANTA BARBARA             ,CA,93101-0000,Private      ,12,17,29,363,469,832
00369110,MONTEREY INST OF INTERNATL STUDIES      ,CA,93940-2691,Private      ,1,12,13,26,867,893
00394700,UC-HASTINGS COLLEGE OF THE LAW          ,CA,94102-0000,Public       ,1,22,23,13,3878,3891
00394800,SAN FRANCISCO ART INSTITUTE             ,CA,94133-2299,Private      ,38,27,65,1061,882,1943
00405500,HEBREW UNION COLLEGE - JEWISH INSTITUTE ,CA,90007-3796,Private      ,0,0,0,0,87,87
00408000,STARR KING SCHOOL FOR THE MINISTRY      ,CA,94709-1299,Private      ,0,1,1,1,67,68
00448000,DE ANZA COLLEGE                         ,CA,95014-5793,Public       ,362,467,829,5116,4086,9202
00448100,OHLONE COLLEGE                          ,CA,94539-5847,Public       ,175,217,392,1941,1837,3778
00448101,OHLONE COLLEGE - NEWARK CENTER FOR HEALT,CA,94560-4902,Public       ,1,0,1,1,0,1
00448400,JOHN F. KENNEDY UNIVERSITY              ,CA,94523-4817,Private      ,1,61,62,20,1623,1643
00449000,PATTEN UNIVERSITY                       ,CA,94601-2699,Private      ,5,35,40,234,427,661
00449400,EVEREST COLLEGE                         ,CA,92408-3752,Proprietary  ,109,283,392,413,1134,1547
00450200,CITY COLLEGE OF SAN FRANCISCO           ,CA,94112-0000,Public       ,479,1095,1574,6995,9900,16895
00563800,DOWNEY ADULT SCHOOL                     ,CA,90241-5610,Public       ,3,10,13,31,80,111
00565500,HACIENDA LA PUENTE ADULT EDUC CTR       ,CA,91746-0000,Public       ,26,132,158,110,515,625
00616500,LA CNTY CLG OF NURSING & ALLD HLTH      ,CA,90033-1018,Public       ,3,23,26,91,351,442
00672000,COLLEGE OF ALAMEDA                      ,CA,94501-2109,Public       ,87,247,334,1449,2008,3457
00673100,CASA LOMA COLLEGE                       ,CA,91405-4523,Private      ,32,99,131,235,514,749
00686300,VENTURA COUNTY CMTY CLG DISTRICT        ,CA,93010-8552,Public       ,2,5,7,27,22,49
00697300,CANADA COLLEGE                          ,CA,94061-1099,Public       ,56,145,201,535,1115,1650
00697500,LINCOLN UNIVERSITY                      ,CA,94612-2801,Private      ,1,7,8,12,53,65
00701200,SAMUEL MERRITT COLLEGE                  ,CA,94609-3108,Private      ,3,47,50,265,1969,2234
00704700,LOS ANGELES SOUTHWEST COLLEGE           ,CA,90047-4810,Public       ,196,752,948,1913,5143,7056
00705000,BAY VISTA COLLEGE OF BEAUTY             ,CA,91950-3616,Proprietary  ,18,36,54,87,174,261
00711500,MOORPARK COLLEGE                        ,CA,93021-1695,Public       ,177,195,372,2558,2080,4638
00713000,NEWBERRY SCHOOLS OF BEAUTY              ,CA,91344-7404,Proprietary  ,16,15,31,73,94,167
00714200,LYLE'S COLLEGE OF BEAUTY                ,CA,93710-3948,Proprietary  ,8,28,36,71,172,243
00714201,LYLE'S CLG OF BTY BAKERSFIELD           ,CA,93301-0000,Proprietary  ,2,7,9,42,42,84
00716400,BRYAN COLLEGE                           ,CA,90057-0000,Proprietary  ,23,167,190,106,750,856
00717801,WESTERN SEMINARY - BAY AREA CENTER      ,CA,95032-0000,Private      ,0,1,1,1,14,15
00717804,WESTERN SEMINARY - SACRAMENTO           ,CA,95821-3939,Private      ,1,0,1,10,45,55
00718700,NORTH ADRIAN'S COLLEGE OF BEAUTY        ,CA,95350-2381,Proprietary  ,21,47,68,120,199,319
00719000,WYOTECH                                 ,CA,94539-7663,Proprietary  ,154,344,498,900,1527,2427
00719001,WYOTECH - SIERRA CAMPUS                 ,CA,94621-4523,Proprietary  ,1,1,2,72,75,147
00720300,SALON SUCCESS ACADEMY                   ,CA,91786-4060,Proprietary  ,11,24,35,66,97,163
00720400,MODERN BEAUTY ACADEMY                   ,CA,93030-7016,Proprietary  ,8,6,14,38,49,87
00722900,WESTERN BEAUTY INSTITUTE                ,CA,91402-3104,Proprietary  ,27,105,132,213,688,901
00723400,HEALD COLLEGE                           ,CA,94105-2206,Proprietary  ,92,206,298,427,1100,1527
00723600,ART INST OF CALIFORNIA-LOS ANGELES      ,CA,90405-3035,Proprietary  ,301,411,712,5190,3937,9127
00725300,FEDERICO BEAUTY INSTITUTE               ,CA,95834-1905,Proprietary  ,12,44,56,151,227,378
00729600,COLEMAN COLLEGE                         ,CA,92123-0000,Private      ,22,96,118,167,614,781
00745600,MARINELLO SCH BTY BUENA PRK             ,CA,90620-0000,Proprietary  ,0,0,0,3,2,5
00746501,AMERICAN ACADEMY OF DRAMATIC ARTS - HOLL,CA,90028-7504,Private      ,2,5,7,185,82,267
00747600,MARINELLO SCHOOLS OF BEAUTY             ,CA,90023-2666,Proprietary  ,122,306,428,856,1804,2660
00747602,MARINELLO SCHOOLS OF BEAUTY - SPA ACADEM,CA,90048-5101,Proprietary  ,0,6,6,37,33,70
00747603,MARINELLO SCHOOLS OF BEAUTY - INGLEWOOD ,CA,90301-2306,Proprietary  ,1,0,1,18,21,39
00747604,MARINELLO SCHOOLS OF BEAUTY - RESEDA    ,CA,91335-4218,Proprietary  ,0,2,2,8,7,15
00747605,MARINELLO SCHOOLS OF BEAUTY - NORTH HOLL,CA,91606-3210,Proprietary  ,1,4,5,15,20,35
00747606,MARINELLO SCHOOLS OF BEAUTY - WEST COVIN,CA,91790-2805,Proprietary  ,1,2,3,17,16,33
00747607,MARINELLO SCHOOLS OF BEAUTY - SAN BERNAR,CA,92410-3261,Proprietary  ,0,5,5,26,41,67
00747608,MARINELLO SCHOOLS OF BEAUTY - ONTARIO   ,CA,91762-2113,Proprietary  ,3,8,11,30,59,89
00747609,MARINELLO SCHOOLS OF BEAUTY - WHITTIER  ,CA,90601-4107,Proprietary  ,0,0,0,16,8,24
00747611,MARINELLO SCHOOLS OF BEAUTY - SAN DIEGO ,CA,92126-4217,Proprietary  ,2,5,7,30,53,83
00747700,"HEALD COLLEGE,SCHOOLS OF BUS & TECH     ",CA,95670-6005,Proprietary  ,42,223,265,345,1279,1624
00753100,ACADEMY OF ART UNIVERSITY               ,CA,94105-3410,Proprietary  ,360,826,1186,5910,9455,15365
00753600,COSUMNES RIVER COLLEGE                  ,CA,95823-5799,Public       ,244,514,758,4385,5080,9465
00754802,WESTWOOD COLLEGE OF TECHNOLOGY          ,CA,92801-0000,Proprietary  ,93,88,181,1083,668,1751
00754803,WESTWOOD COLLEGE OF TECHNOLOGY          ,CA,91786-0000,Proprietary  ,69,93,162,1045,865,1910
00760600,EVEREST COLLEGE                         ,CA,90010-2221,Proprietary  ,75,170,245,348,784,1132
00760700,CONCORDE CAREER INSTITUTE               ,CA,91606-3134,Proprietary  ,72,138,210,387,711,1098
00770700,COLUMBIA COLLEGE                        ,CA,95370-8580,Public       ,45,91,136,775,954,1729
00771300,SKYLINE COLLEGE                         ,CA,94066-1698,Public       ,157,182,339,1845,1815,3660
00793000,CONCORDE CAREER INSTITUTE               ,CA,92108-0000,Proprietary  ,60,152,212,322,933,1255
00799300,CALIF STATE UNIV BAKERSFIELD            ,CA,93311-1022,Public       ,120,252,372,5631,5206,10837
00807100,CONCORDE CAREER INSTITUTE               ,CA,92840-9201,Proprietary  ,50,143,193,348,861,1209
00807300,BUTTE COMMUNITY COLLEGE                 ,CA,95965-0000,Public       ,270,557,827,4693,6059,10752
00809000,EVEREST COLLEGE                         ,CA,91803-1310,Proprietary  ,69,144,213,348,699,1047
00809300,HEALD COLLEGE                           ,CA,93704-1706,Proprietary  ,80,274,354,718,1697,2415
00853200,HEALD COLLEGE                           ,CA,94545-2352,Proprietary  ,113,269,382,712,1568,2280
00853700,CONCORDE CAREER INSTITUTE               ,CA,92401-0000,Proprietary  ,62,152,214,436,1133,1569
00859600,WEST LOS ANGELES COLLEGE                ,CA,90230-3500,Public       ,193,613,806,1963,4267,6230
00859700,FEATHER RIVER COLLEGE                   ,CA,95971-9124,Public       ,29,50,79,633,414,1047
00884400,CALIFORNIA CHRISTIAN COLLEGE            ,CA,93703-3599,Private      ,2,0,2,33,34,67
00884600,WRIGHT INSTITUTE                        ,CA,94704-0000,Private      ,0,3,3,0,438,438
00890300,COLLEGE OF THE CANYONS                  ,CA,91355-1899,Public       ,245,379,624,2889,2678,5567
00891800,SADDLEBACK COLLEGE                      ,CA,92692-3699,Public       ,172,306,478,2407,3166,5573
00902200,ASSOCIATED TECHNICAL COLLEGE            ,CA,90017-0000,Proprietary  ,39,111,150,155,676,831
00903200,EMPIRE COLLEGE                          ,CA,95403-2122,Proprietary  ,28,103,131,133,496,629
00915706,WYOMING TECHNICAL INSTITUTE - WEST SACRA,CA,95605-1507,Proprietary  ,105,199,304,355,612,967
00927200,CRAFTON HILLS COLLEGE                   ,CA,92399-1799,Public       ,127,185,312,2009,2334,4343
00932500,ABRAM FRIEDMAN OCCUP CTR                ,CA,90015-3507,Public       ,2,8,10,33,65,98
00950900,SKILLS & BUSINESS EDUCATION CENTER      ,CA,95824-1529,Public       ,31,260,291,196,1467,1663
00974800,WESTERN CAREER COLLEGE                  ,CA,95826-3203,Proprietary  ,79,306,385,1035,2740,3775
00974801,WESTERN CAREER COLLEGE - SAN LEANDRO CAM,CA,94578-3711,Proprietary  ,57,157,214,366,852,1218
00974802,WESTERN CAREER COLLEGE - PLEASANT HILL C,CA,94523-1984,Proprietary  ,45,114,159,251,608,859
00974803,WESTERN CAREER COLLEGE - STOCKTON       ,CA,95207-5509,Proprietary  ,67,125,192,299,508,807
00974804,WESTERN CAREER COLLEGE - CITRUS HEIGHTS ,CA,95621-5577,Proprietary  ,71,204,275,337,875,1212
00974806,WESTERN CAREER COLLEGE -  ANTIOCH/WALNUT,CA,94531-1604,Proprietary  ,42,129,171,288,651,939
00974807,WESTERN CAREER COLLEGE - SAN JOSE       ,CA,95119-1325,Proprietary  ,86,211,297,445,885,1330
00974808,WESTERN CAREER COLLEGE - EMERYVILLE     ,CA,94608-3006,Proprietary  ,32,87,119,49,120,169
00974809,WESTERN CAREER COLLEGE -  EMERYVILLE SHE,CA,94608-3006,Proprietary  ,0,0,0,92,249,341
00974810,WESTERN CAREER COLLEGE - CONCORD        ,CA,94520-5671,Proprietary  ,0,6,6,14,25,39
00998900,SANTA BARBARA BUSINESS COLLEGE          ,CA,93111-0000,Proprietary  ,39,96,135,247,564,811
01011100,CERRO-COSO COMMUNITY COLLEGE            ,CA,93555-9571,Public       ,49,160,209,583,1527,2110
01014225,TOURO CLG OSEOPATHIC MEDICINE           ,CA,94592-1115,Private      ,0,7,7,11,452,463
01014900,PEPPERDINE UNIVERSITY                   ,CA,90263-0000,Private      ,80,274,354,6139,6409,12548
01033300,JESUIT SCHOOL OF THEOLOGY - BERKELEY    ,CA,94709-1193,Private      ,0,0,0,0,47,47
01034000,LOS MEDANOS COLLEGE                     ,CA,94565-5197,Public       ,194,439,633,1884,3008,4892
01036500,CHARLES R DREW UNIV OF MED & SCI        ,CA,90059-0000,Private      ,3,13,16,60,459,519
01036800,MENNONITE BRETHREN BIBLICAL SEM         ,CA,93727-0000,Private      ,0,2,2,1,58,59
01037500,HARBOR OCCUPATIONAL CENTER              ,CA,90731-0000,Public       ,1,6,7,25,41,66
01039500,UNIVERSITY OF SAN DIEGO                 ,CA,92110-2492,Private      ,173,139,312,11898,3394,15292
01039501,UNIVERSITY OF SAN DIEGO - SCHOOL OF LAW ,CA,92110-2492,Private      ,7,28,35,112,3228,3340
01044100,PARDEE RAND GRADUATE SCHOOL             ,CA,90407-2138,Private      ,0,3,3,0,37,37
01047400,MARYMOUNT COLLEGE OF PALOS VERDES       ,CA,90275-0000,Private      ,16,1,17,586,65,651
01057900,WEST VALLEY OCCUPATIONAL CTR            ,CA,91367-0000,Public       ,2,13,15,51,84,135
01083100,NEW COLLEGE OF CALIFORNIA               ,CA,94102-0000,Private      ,0,0,0,13,146,159
01083200,WESTERN STATE UNIV COLLEGE OF LAW       ,CA,92831-3014,Proprietary  ,0,7,7,6,1005,1011
01085400,THOMAS JEFFERSON SCHOOL OF LAW          ,CA,92110-0000,Private      ,3,27,30,16,1942,1958
01102400,EVEREST COLLEGE                         ,CA,94103-2091,Proprietary  ,63,111,174,298,622,920
01110700,EVEREST  COLLEGE                        ,CA,92801-5231,Proprietary  ,93,265,358,373,930,1303
01110900,EVEREST COLLEGE                         ,CA,91335-4631,Proprietary  ,107,171,278,464,720,1184
01111200,FIDM-FASHION INSTITUTE OF DESIGN        ,CA,90015-1421,Proprietary  ,245,156,401,6029,2059,8088
01111700,ALLIANT INTERNATIONAL UNIVERSITY        ,CA,92131-1799,Private      ,4,88,92,81,2395,2476
01111705,ALLIANT INTERNATIONAL UNIVERSITY - LOS A,CA,91803-1360,Private      ,0,15,15,5,624,629
01111706,ALLIANT INTERNATIONAL UNIVERSITY - SAN F,CA,94133-1221,Private      ,1,13,14,7,656,663
01111707,ALLIANT INTERNATIONAL UNIVERSITY - FRESN,CA,93727-2014,Private      ,0,21,21,24,398,422
01112100,EVEREST COLLEGE                         ,CA,94541-4007,Proprietary  ,43,158,201,211,768,979
01112300,EVEREST COLLEGE                         ,CA,90247-4163,Proprietary  ,58,215,273,325,944,1269
01146000,NATIONAL UNIVERSITY                     ,CA,92037-1011,Private      ,73,2296,2369,401,15034,15435
01162600,PRACTICAL SCHOOLS                       ,CA,92805-0000,Proprietary  ,44,103,147,477,792,1269
01164900,LOYOLA MARYMOUNT UNIVERSITY             ,CA,90045-0000,Private      ,95,106,201,9217,3001,12218
01164901,LOYOLA LAW SCHOOL                       ,CA,90015-0000,Private      ,1,29,30,31,3543,3574
01167200,MENDOCINO COMMUNITY COLLEGE             ,CA,95482-3000,Public       ,73,184,257,923,1338,2261
01169600,NATIONAL POLYTECHNIC COLLEGE OF SCIENCE ,CA,90744-6399,Private      ,9,63,72,81,364,445
01170700,NORTH-WEST COLLEGE                      ,CA,91790-2097,Proprietary  ,46,81,127,227,489,716
01179200,FRANCISCAN SCHOOL OF THEOLOGY           ,CA,94709-0000,Private      ,0,1,1,1,31,32
01182000,SAN DIEGO MIRAMAR COLLEGE               ,CA,92126-0000,Public       ,125,249,374,2300,3315,5615
01186500,CALIFORNIA HAIR DESIGN ACADEMY          ,CA,92115-0000,Proprietary  ,15,32,47,70,114,184
01186600,LU ROSS ACADEMY                         ,CA,93001-2927,Proprietary  ,5,3,8,5,3,8
01202600,JE BOUTIQUE COLLEGE OF BEAUTY           ,CA,92021-6247,Proprietary  ,13,16,29,51,109,160
01202700,GALEN COLLEGE OF CALIFORNIA             ,CA,93728-2381,Proprietary  ,16,23,39,70,132,202
01203100,SAN DIEGO CHRISTIAN COLLEGE             ,CA,92019-1157,Private      ,14,18,32,470,188,658
01206100,EVEREST COLLEGE                         ,CA,95128-3908,Proprietary  ,49,162,211,192,556,748
01215400,CALIFORNIA INST OF INTEGRAL STUDIES     ,CA,94103-2557,Private      ,0,34,34,6,1198,1204
01231600,MANCHESTER BEAUTY COLLEGE               ,CA,93726-5306,Proprietary  ,7,33,40,83,202,285
01231700,TULARE BEAUTY COLLEGE                   ,CA,93274-3432,Proprietary  ,0,5,5,10,30,40
01244600,UNIVERSAL COLLEGE OF BEAUTY             ,CA,90044-0044,Proprietary  ,3,19,22,40,100,140
01245200,EVERGREEN VALLEY COLLEGE                ,CA,95135-1598,Public       ,158,273,431,3050,3054,6104
01255000,LOS ANGELES MISSION COLLEGE             ,CA,91342-3200,Public       ,219,421,640,2325,3016,5341
01265000,MARINELLO SCHOOL OF BEAUTY              ,CA,91502-2828,Proprietary  ,17,35,52,103,225,328
01265100,MARINELLO SCHOOL OF BEAUTY              ,CA,91748-1674,Proprietary  ,11,40,51,44,161,205
01284200,OXNARD COLLEGE                          ,CA,93030-0000,Public       ,189,338,527,2054,2653,4707
01287200,NORTH-WEST COLLEGE                      ,CA,91768-3199,Proprietary  ,19,71,90,158,474,632
01287300,WYOTECH                                 ,CA,90810-3800,Proprietary  ,226,476,702,1163,2151,3314
01287301,WYOTECH - EVEREST  COLLEGE              ,CA,90034-3158,Proprietary  ,46,154,200,232,794,1026
01287302,WYOTECH - EVEREST  COLLEGE              ,CA,91746-3412,Proprietary  ,103,244,347,503,1091,1594
01290700,LAKE TAHOE COMMUNITY COLLEGE            ,CA,96150-4524,Public       ,33,89,122,434,609,1043
01291100,MARINELLO SCHOOL OF BEAUTY              ,CA,92646-2552,Proprietary  ,4,19,23,55,106,161
01291200,MTI COLLEGE                             ,CA,95841-0000,Proprietary  ,50,163,213,415,1169,1584
01294200,ROSEMEAD BEAUTY SCHOOL                  ,CA,91770-1639,Proprietary  ,10,35,45,42,191,233
01298400,PROFESSIONAL INSTITUTE OF BEAUTY        ,CA,91731-2613,Proprietary  ,3,24,27,19,104,123
01298500,HAIR CALIFORNIA BEAUTY ACADEMY          ,CA,92867-7127,Proprietary  ,2,1,3,8,15,23
01298900,OCEANSIDE COLLEGE OF BEAUTY             ,CA,92054-5393,Proprietary  ,8,8,16,37,59,96
01301000,LANCASTER BEAUTY SCHOOL                 ,CA,93534-3098,Proprietary  ,11,29,40,84,148,232
01307400,AMERICAN BEAUTY COLLEGE                 ,CA,90706-5417,Proprietary  ,1,7,8,25,86,111
01309500,SALON SUCCESS ACADEMY                   ,CA,92879-6561,Proprietary  ,19,22,41,123,152,275
01310300,CALIFORNIA WESTERN SCHOOL OF LAW        ,CA,92101-0000,Private      ,4,9,13,22,2139,2161
01324000,LYTLE'S REDWOOD EMPIRE BEAUTY CLG       ,CA,95403-0000,Proprietary  ,6,7,13,76,111,187
02054900,MARINELLO SCHOOL OF BEAUTY              ,CA,92630-0000,Proprietary  ,13,16,29,54,96,150
02059800,PARIS BEAUTY COLLEGE                    ,CA,94520-2611,Proprietary  ,14,33,47,56,136,192
02063500,COASTLINE COMMUNITY COLLEGE             ,CA,92708-0000,Public       ,40,378,418,747,3329,4076
02064300,SIERRA COLLEGE OF BEAUTY                ,CA,95340-0000,Proprietary  ,3,32,35,70,102,172
02065500,BROOKS COLLEGE                          ,CA,90804-3289,Proprietary  ,2,9,11,86,66,152
02065501,BROOKS COLLEGE - SUNNYVALE              ,CA,94086-5303,Proprietary  ,0,0,0,19,11,30
02065700,CALIFORNIA BEAUTY COLLEGE               ,CA,95354-0000,Proprietary  ,7,15,22,76,80,156
02070500,CONCORDIA UNIVERSITY                    ,CA,92612-0000,Private      ,27,162,189,1760,1193,2953
02075800,SOUTHERN CA INST OF ARCHITECTURE        ,CA,90013-0000,Private      ,2,12,14,159,519,678
02086400,MARINELLO SCHOOL OF BEAUTY              ,CA,95050-0000,Proprietary  ,30,101,131,86,208,294
02091200,ELEGANCE INTERNATIONAL                  ,CA,90028-0000,Proprietary  ,7,15,22,74,112,186
02091700,KAPLAN COLLEGE                          ,CA,92123-1509,Proprietary  ,73,246,319,580,1625,2205
02096100,FIELDING INSTITUTE                      ,CA,93105-0000,Private      ,0,51,51,3,1241,1244
02099200,AMERICAN CONSERVATORY THEATER           ,CA,94108-0000,Private      ,0,5,5,15,183,198
02110200,COLUMBIA COLLEGE                        ,CA,91356-0000,Private      ,11,5,16,305,156,461
02110800,CALIFORNIA COLLEGE SAN DIEGO            ,CA,92108-3821,Proprietary  ,56,168,224,400,1107,1507
02111300,CUYAMACA COLLEGE                        ,CA,92019-0000,Public       ,161,288,449,2162,2812,4974
02113601,AMERICAN INTERCONTINENTAL UNIV - LOS ANG,CA,90066-7008,Proprietary  ,2,24,26,287,545,832
02119100,MISSION COLLEGE                         ,CA,95054-1897,Public       ,134,397,531,1654,3098,4752
02120600,SAYBROOK GRADUATE SCHOOL                ,CA,94111-1920,Private      ,0,35,35,1,559,560
02120700,SAN JOAQUIN VALLEY COLLEGE              ,CA,93291-0000,Proprietary  ,418,882,1300,2336,5168,7504
02120900,ITT TECHNICAL INSTITUTE                 ,CA,95670-6034,Proprietary  ,125,285,410,686,1375,2061
02125000,CAREER ACADEMY OF BEAUTY                ,CA,92845-0000,Proprietary  ,11,37,48,51,153,204
02128200,"VICTOR VALLEY BEAUTY COLLEGE, INC       ",CA,92392-0000,Proprietary  ,11,16,27,128,138,266
02128300,INSTITUTE FOR BUSINESS & TECHNOLOGY     ,CA,95050-0000,Proprietary  ,41,181,222,249,800,1049
02128301,INSTITUTE FOR BUSINESS & TECHNOLOGY     ,CA,95610-0000,Proprietary  ,16,73,89,116,502,618
02138300,PACIFIC GRADUATE SCHOOL OF PSYCHOLO     ,CA,94303-4232,Private      ,0,4,4,10,511,521
02147400,CLEVELAND CHIROPRACTIC COLLEGE          ,CA,90004-0000,Private      ,3,18,21,36,396,432
02161800,MUSICIANS INSTITUTE                     ,CA,90028-6157,Proprietary  ,146,136,282,1230,928,2158
02167800,ESTES INSTITUTE OF COSMETOLOGY          ,CA,93291-0000,Proprietary  ,8,18,26,110,84,194
02174600,MARINELLO SCHOOL OF BEAUTY              ,CA,90201-0000,Proprietary  ,10,18,28,56,147,203
02180600,BRIDGES  ACADEMY OF BEAUTY              ,CA,92311-2327,Proprietary  ,0,1,1,9,12,21
02184900,PALMER COLLEGE OF CHIROPRACTIC WEST     ,CA,95134-0000,Private      ,1,7,8,10,331,341
02185800,MOLER BARBER COLLEGE                    ,CA,94611-0000,Proprietary  ,2,10,12,17,39,56
02187500,"HEALD COLLEGE, SCH OF BUS & TECH        ",CA,94520-0000,Proprietary  ,88,301,389,614,1461,2075
02188400,SIERRA VALLEY COLLEGE OF COURT REPORTING,CA,93726-0000,Proprietary  ,8,28,36,87,223,310
02208600,MADERA BEAUTY COLLEGE                   ,CA,93637-3519,Proprietary  ,1,7,8,43,31,74
02211000,HAIRMASTERS UNIVERSITY OF BEAUTY        ,CA,92405-0000,Proprietary  ,3,13,16,41,65,106
02220000,COLLEEN O'HARA BEAUTY ACADEMY           ,CA,92701-0000,Proprietary  ,15,57,72,105,271,376
02220200,CALIFORNIA CULINARY ACADEMY             ,CA,94102-3336,Proprietary  ,76,126,202,757,883,1640
02221300,MARINELLO SCHOOL OF BEAUTY              ,CA,92553-0000,Proprietary  ,23,59,82,137,299,436
02222000,AMERICAN FILM INSTITUTE                 ,CA,90027-0000,Private      ,7,8,15,113,505,618
02226000,EAST LOS ANGELES COLLEGE                ,CA,91754-0000,Public       ,633,888,1521,7576,7104,14680
02228500,LIFE CHIROPRACTIC COLLEGE-WEST          ,CA,94545-0000,Private      ,0,8,8,7,441,448
02230900,FREDRICK & CHARLES BEAUTY COLLEGE       ,CA,95501-0000,Proprietary  ,0,12,12,45,67,112
02231900,GEMOLOGICAL INSTITUTE OF AMERICA        ,CA,92008-4698,Private      ,1,21,22,44,224,268
02234300,FASHION CAREERS OF CALIFORNIA           ,CA,92110-0000,Proprietary  ,10,12,22,133,120,253
02236400,"THANH LE COLG, SCH OF COSMETOLOGY       ",CA,92840-0000,Proprietary  ,2,7,9,9,66,75
02237200,PHILLIPS GRADUATE INSTITUTE             ,CA,91316-0000,Private      ,0,13,13,2,387,389
02241600,SAN DIEGO CONTINUING EDUCATION          ,CA,92113-0000,Public       ,5,54,59,72,400,472
02241800,AMERICAN CAREER COLLEGE                 ,CA,90004-0000,Proprietary  ,363,789,1152,2006,4313,6319
02242700,BERKELEY CITY COLLEGE                   ,CA,94704-0000,Public       ,101,204,305,1254,2284,3538
02250602,EVEREST COLLEGE                         ,CA,91761-8525,Proprietary  ,54,122,176,375,997,1372
02255400,INTERNATIONAL SCHOOL OF COSMETOLOGY     ,CA,90250-0000,Proprietary  ,12,3,15,37,38,75
02255600,MARINELLO SCHOOL OF BEAUTY              ,CA,90723-0000,Proprietary  ,14,43,57,104,220,324
02258600,ALAMEDA BEAUTY COLLEGE                  ,CA,94501-0000,Proprietary  ,22,39,61,98,169,267
02262400,YESHIVA OHR ELCHONON CHABAD             ,CA,90046-0000,Private      ,24,0,24,75,1,76
02263101,ANTHEM COLLEGE - HIGH-TECH INSTITUTE - S,CA,95827-0000,Proprietary  ,5,6,11,82,82,164
02267600,INSTITUTE OF TRANSPERSONAL PSYCHLGY     ,CA,94303-4624,Private      ,0,14,14,2,458,460
02270600,LIFE PACIFIC COLLEGE                    ,CA,91773-0000,Private      ,4,9,13,320,168,488
02276800,WESTMINSTER SEMINARY CALIFORNIA         ,CA,92027-0000,Private      ,0,2,2,3,135,138
02277400,SOUTH COAST COLLEGE                     ,CA,92868-2616,Proprietary  ,14,39,53,122,370,492
02282300,ALHAMBRA BEAUTY COLLEGE                 ,CA,91802-0000,Proprietary  ,3,11,14,25,112,137
02285100,HILLTOP BEAUTY SCHOOL                   ,CA,94014-0000,Proprietary  ,6,32,38,25,158,183
02291500,ITT TECHNICAL INSTITUTE                 ,CA,91773-0000,Proprietary  ,139,219,358,932,1374,2306
02291600,ITT TECHNICAL INSTITUTE                 ,CA,92123-0000,Proprietary  ,129,323,452,871,1904,2775
02298000,DESIGN INSTITUTE OF SAN DIEGO           ,CA,92121-0000,Proprietary  ,6,11,17,160,278,438
02304300,"PLATT COLLEGE, SAN DIEGO                ",CA,92115-0000,Proprietary  ,27,32,59,201,295,496
02306300,KAPLAN COLLEGE                          ,CA,95368-0000,Proprietary  ,93,185,278,516,1053,1569
02306302,KAPLAN COLLEGE - FRESNO                 ,CA,93612-3802,Proprietary  ,53,105,158,282,600,882
02309500,CLOVIS ADULT EDUC                       ,CA,93611-0000,Public       ,6,24,30,44,254,298
02312400,LA COLLEGE INTERNATIONAL                ,CA,90010-0000,Proprietary  ,6,135,141,52,602,654
02321800,ITT TECHNICAL INSTITUTE                 ,CA,91342-3664,Proprietary  ,169,239,408,918,1443,2361
02321900,ITT TECHNICAL INSTITUTE                 ,CA,92801-0000,Proprietary  ,107,248,355,639,1106,1745
02327600,ART INST OF CALIFORNIA-SAN DIEGO        ,CA,92108-4401,Proprietary  ,171,250,421,2851,2416,5267
02330500,LAGUNA COLLEGE OF ART AND DESIGN        ,CA,92651-0000,Private      ,14,6,20,384,154,538
02332800,CENTER FOR EMPLOYMENT TRAINING          ,CA,95110-0000,Private      ,138,749,887,519,2855,3374
02338500,GLENDALE CAREER COLLEGE                 ,CA,91201-0000,Proprietary  ,22,32,54,123,212,335
02338700,MARINELLO SCHOOL OF BEAUTY              ,CA,94103-0000,Proprietary  ,11,35,46,48,139,187
02342400,ACADEMY OF RADIO BROADCASTING           ,CA,92647-3809,Proprietary  ,15,51,66,44,183,227
02343400,"BELLUS ACADEMY, THE ACADEMY OF BEAUTY AN",CA,92064-4633,Proprietary  ,29,46,75,114,210,324
02345800,MONTEBELLO BEAUTY COLLEGE               ,CA,90640-0000,Proprietary  ,6,13,19,39,76,115
02351900,KAPLAN COLLEGE                          ,CA,95660-5512,Proprietary  ,41,168,209,247,842,1089
02351901,KAPLAN COLLEGE - BAKERSFIELD            ,CA,93304-0000,Proprietary  ,81,187,268,365,929,1294
02358000,THOMAS AQUINAS COLLEGE                  ,CA,93060-9622,Private      ,2,2,4,321,21,342
02359300,SHASTA BIBLE COLLEGE                    ,CA,96002-0000,Private      ,0,5,5,36,49,85
02482700,WESTERN UNIVERSITY OF HEALTH S          ,CA,91766-1854,Private      ,3,29,32,50,3427,3477
02494800,LOLA BEAUTY COLLEGE                     ,CA,92641-0000,Proprietary  ,0,8,8,1,35,36
02497300,TRINITY COLLEGE                         ,CA,93277-0000,Proprietary  ,52,186,238,250,891,1141
02500000,SAN JOAQUIN COLLEGE OF LAW              ,CA,93612-0000,Private      ,0,3,3,10,279,289
02518400,THE NATIONAL HISPANIC UNIVERSITY        ,CA,95127-0000,Private      ,9,49,58,196,389,585
02519800,AVANCE BEAUTY COLLEGE                   ,CA,92154-0000,Proprietary  ,7,17,24,53,88,141
02520200,CALIFORNIA CAREER SCHOOLS               ,CA,92805-0000,Proprietary  ,3,10,13,25,52,77
02520300,INTERIOR DESIGNERS INSTITUTE            ,CA,92660-0000,Proprietary  ,8,18,26,52,152,204
02520400,ADRIAN'S BEAUTY COLLEGE OF TURLOCK      ,CA,95382-0000,Proprietary  ,12,36,48,94,165,259
02537200,PALOMAR INSTITUTE OF COSMETOLOGY        ,CA,92069-0000,Proprietary  ,23,26,49,135,174,309
02539100,KAPLAN COLLEGE                          ,CA,91606-3231,Proprietary  ,78,177,255,557,1241,1798
02539102,KAPLAN COLLEGE -  RIVERSIDE             ,CA,92507-4223,Proprietary  ,97,179,276,410,926,1336
02539500,IRVINE VALLEY COLLEGE                   ,CA,92620-0000,Public       ,110,211,321,2051,2220,4271
02542300,NATIONAL HOLISTIC INSTITUTE             ,CA,94608-0000,Proprietary  ,34,98,132,189,540,729
02543400,BROWNSON TECHNICAL SCHOOL               ,CA,92805-0000,Proprietary  ,4,54,58,38,174,212
02545900,HYPNOSIS MOTIVATION INSTITUTE           ,CA,91356-0000,Private      ,1,43,44,6,176,182
02546400,MTI BUSINESS COLLEGE INC                ,CA,95207-0000,Proprietary  ,4,44,48,34,255,289
02549000,KAPLAN COLLEGE                          ,CA,92083-7736,Proprietary  ,94,291,385,505,1198,1703
02549005,KAPLAN COLLEGE -  PALM SPRINGS          ,CA,92262-7011,Proprietary  ,52,163,215,282,681,963
02553500,ASSOCIATED TECHNICAL COLLEGE            ,CA,92101-0000,Proprietary  ,22,78,100,73,282,355
02553600,DIVERSIFIED LANGUAGE INSTITUTE          ,CA,90017-0000,Proprietary  ,3,228,231,11,1061,1072
02559300,UNITED EDUCATION INSTITUTE              ,CA,90020-0000,Proprietary  ,717,1526,2243,2435,5257,7692
02559400,INTERCOAST COLLEGES                     ,CA,92868-1656,Proprietary  ,51,614,665,144,1664,1808
02565400,KAPLAN COLLEGE                          ,CA,95207-6216,Proprietary  ,57,128,185,292,724,1016
02570300,LOS ANGELES ORT TECHNICAL INSTITUTE     ,CA,90048-0000,Private      ,30,210,240,143,808,951
02577900,SANTA BARBARA BUSINESS COLLEGE          ,CA,93309-1664,Proprietary  ,63,175,238,392,895,1287
02578000,SANTA BARBARA BUSINESS COLLEGE          ,CA,93454-6943,Proprietary  ,29,99,128,135,418,553
02584200,NEWBRIDGE COLLEGE                       ,CA,92701-0000,Proprietary  ,38,125,163,231,844,1075
02591600,NORTH-WEST COLLEGE                      ,CA,91101-1744,Proprietary  ,6,17,23,39,103,142
02593100,HEALD COLLEGE                           ,CA,95678-5303,Proprietary  ,64,255,319,352,1283,1635
02593200,HEALD COLLEGE                           ,CA,95035-8008,Proprietary  ,61,285,346,476,1293,1769
02593300,HEALD COLLEGE                           ,CA,95210-5667,Proprietary  ,88,308,396,741,1657,2398
02595600,ASIAN AMERICAN INTERNATIONAL BTY CG     ,CA,92683-4043,Proprietary  ,4,16,20,12,71,83
02597300,SOUTH BAYLO UNIVERSITY                  ,CA,92801-1701,Private      ,0,39,39,7,201,208
02602300,CENTRAL COAST COLLEGE                   ,CA,93901-3301,Proprietary  ,22,35,57,143,242,385
02608900,PINNACLE COLLEGE                        ,CA,91803-8842,Proprietary  ,15,51,66,75,157,232
02608901,PINNACLE COLLEGE - SACRAMENTO           ,CA,95826-2581,Proprietary  ,4,8,12,7,14,21
02609000,EMPERORS COLG OF TRAD ORIENTAL MED      ,CA,90403-5609,Proprietary  ,0,21,21,4,174,178
02612800,LOS ANGELES RECORDING SCHOOL            ,CA,90028-3112,Proprietary  ,48,55,103,724,735,1459
02619300,SAMRA UNIV OF ORIENTAL MEDICINE         ,CA,90015-1019,Private      ,0,7,7,2,72,74
02620300,PLATT COLLEGE                           ,CA,92647-3017,Proprietary  ,0,0,0,12,12,24
03010611,VIRGINIA COLLEGE - GOLF ACADEMY OF AMERI,CA,92008-6512,Proprietary  ,8,23,31,125,184,309
03011300,"CALIF STATE UNIV, SAN MARCOS            ",CA,92096-0001,Public       ,176,172,348,7801,4416,12217
03019900,ADELANTE CAREER INSTITUTE               ,CA,91402-4924,Proprietary  ,8,25,33,25,118,143
03025600,DELL'ARTE SCH OF PHYSICAL THEATRE       ,CA,95525-0816,Private      ,0,0,0,4,41,45
03027700,PACIFIC COLLEGE OF ORIENTAL MED         ,CA,92108-4408,Proprietary  ,0,21,21,15,495,510
03029600,POMONA ADULT SCHOOL                     ,CA,91766-0000,Public       ,21,74,95,104,277,381
03031409,INTERNATIONAL ACADEMY OF DESIGN AND TECH,CA,95834-9664,Proprietary  ,39,52,91,129,149,278
03034000,HEALD COLLEGE                           ,CA,93906-5100,Proprietary  ,88,222,310,545,1096,1641
03035700,LAS POSITAS COLLEGE                     ,CA,94551-6750,Public       ,119,192,311,1349,1454,2803
03039900,FREMONT COLLEGE                         ,CA,90703-5342,Proprietary  ,16,44,60,102,225,327
03043900,NEWSCHOOL OF ARCHITECTURE & DESIGN      ,CA,92101-6634,Proprietary  ,7,24,31,251,448,699
03044500,KAPLAN COLLEGE                          ,CA,91402-4222,Proprietary  ,18,82,100,121,364,485
03054100,ROYALE COLLEGE OF BEAUTY                ,CA,92590-2525,Proprietary  ,9,14,23,44,82,126
03062300,WESTECH COLLEGE                         ,CA,91764-4988,Proprietary  ,28,146,174,172,705,877
03062400,MT DIABLO ADULT EDUC LOMA VISTA CTR     ,CA,94518-1122,Public       ,2,20,22,42,146,188
03062700,PLATT COLLEGE                           ,CA,90041-0000,Proprietary  ,15,28,43,137,172,309
03062701,PLATT COLLEGE                           ,CA,91764-0000,Proprietary  ,18,55,73,191,306,497
03063400,MODERN TECHNOLOGY SCHOOL                ,CA,92708-9821,Proprietary  ,10,32,42,58,194,252
03067400,BALDWIN PARK ADULT SCHOOL               ,CA,91706-4897,Public       ,17,56,73,74,236,310
03067500,INSTITUTE OF TECHNOLOGY                 ,CA,93612-3217,Proprietary  ,186,670,856,931,2790,3721
03069500,SAGE COLLEGE                            ,CA,92557-6720,Proprietary  ,23,83,106,128,538,666
03070400,ITT TECHNICAL INSTITUTE                 ,CA,92408-3519,Proprietary  ,148,245,393,1077,1600,2677
03072300,EVEREST COLLEGE                         ,CA,91761-3222,Proprietary  ,84,206,290,408,945,1353
03072700,WESTWOOD COLLEGE - LOS ANGELES          ,CA,90010-1577,Proprietary  ,220,791,1011,1182,1570,2752
03074900,MARTINEZ ADULT CENTER                   ,CA,94553-3298,Public       ,0,22,22,6,61,67
03078200,AMERICAN CLG TRADITIONAL CHINESE MD     ,CA,94107-2813,Private      ,0,26,26,6,297,303
03084700,VENTURA ADULT\CONTINUING EDUCATION      ,CA,93003-7313,Public       ,8,31,39,37,167,204
03087400,ITT TECHNICAL INSTITUTE                 ,CA,90502-1356,Proprietary  ,137,352,489,1000,2131,3131
03094400,ELITE PROGRESSIVE SCHOOL OF COSM        ,CA,95841-2909,Proprietary  ,29,29,58,241,268,509
03097700,CENTRAL CALIF SCH CONTINUING EDUC       ,CA,93401-6739,Proprietary  ,5,37,42,42,216,258
03098200,YO SAN UNIV TRADITIONAL CHINESE MED     ,CA,90066-1103,Private      ,0,11,11,1,153,154
03105700,MONTEREY PARK COLLEGE                   ,CA,91754-2416,Proprietary  ,0,0,0,27,17,44
03108100,SUMMIT CAREER COLLEGE                   ,CA,92324-3956,Proprietary  ,92,372,464,382,1539,1921
03109500,DONGGUK ROYAL UNIVERSITY                ,CA,90020-1765,Private      ,1,8,9,3,101,104
03113300,MCED CAREER COLLEGE                     ,CA,93727-1620,Proprietary  ,6,39,45,86,1423,1509
03113600,SOUTHERN CALIFORNIA INST OF TECHNOL     ,CA,92805-3758,Proprietary  ,21,170,191,113,1067,1180
03115400,LYLE'S FRESNO COLLEGE OF BEAUTY         ,CA,93710-0000,Proprietary  ,0,0,0,23,7,30
03116600,EAST SAN GABRIEL VLY REG OCCUP PROG     ,CA,91790-2105,Public       ,17,208,225,50,406,456
03125300,JOHN WESLEY INTER. BARBER & BTY CLG     ,CA,90813-4321,Proprietary  ,3,9,12,26,76,102
03125400,ART INSTITUTE OF CALIFORNIA-HOLLYWOOD (T,CA,90010-1014,Proprietary  ,130,146,276,1238,1143,2381
03125800,PREMIERE CAREER COLLEGE                 ,CA,91706-3746,Proprietary  ,29,92,121,140,394,534
03126800,PACIFICA GRADUATE INSTITUTE             ,CA,93013-0000,Proprietary  ,1,33,34,2,901,903
03128700,MT SIERRA COLLEGE                       ,CA,91016-3414,Proprietary  ,22,33,55,248,373,621
03131300,FIVE BRANCHES UNIVERSITY                ,CA,95062-4669,Private      ,0,15,15,15,339,354
03144400,AMERICAN CLG OF HEALTH PROFESSIONS      ,CA,92374-0000,Proprietary  ,0,5,5,10,28,38
03150500,VIRGINIA SEWING MACHINES & SCH CTR      ,CA,90015-3535,Proprietary  ,0,11,11,1,74,75
03162300,FOUR-D SUCCESS ACADEMY                  ,CA,92324-4218,Proprietary  ,37,142,179,178,833,1011
03163300,PACIFIC STATES UNIVERSITY               ,CA,90006-4298,Private      ,0,2,2,15,29,44
03195400,EVEREST COLLEGE                         ,CA,90501-2867,Proprietary  ,25,39,64,88,173,261
03210300,CALIFORNIA SCHOOL OF CULINARY ARTS      ,CA,91101-5221,Proprietary  ,216,416,632,1586,2118,3704
03225300,AMERICAN UNIVERSITY OF HEALTH SCIENCES  ,CA,90755-3612,Proprietary  ,7,12,19,56,102,158
03242300,CAREER NETWORK INSTITUTE                ,CA,92868-4710,Proprietary  ,35,123,158,179,644,823
03250300,COMMUNITY BASED EDUCATION AND DEVEL     ,CA,90036-1137,Private      ,5,68,73,38,347,385
03260300,CALIFORNIA STATE U-MONTEREY BAY         ,CA,93955-8001,Public       ,94,102,196,5848,2052,7900
03266300,BETHESDA CHRISTIAN UNIVERSITY           ,CA,92801-4132,Private      ,0,5,5,6,35,41
03278300,CLARITA CAREER COLLEGE                  ,CA,91351-5432,Proprietary  ,83,251,334,392,1161,1553
03282300,KIM ANH ACADEMY OF BEAUTY               ,CA,92683-4605,Proprietary  ,6,41,47,10,189,199
03288300,ACAD CHINESE CULTURE & HEALTH SCIS      ,CA,94512-0000,Private      ,0,11,11,7,96,103
03299300,PACIFIC COLLEGE                         ,CA,92626-3160,Proprietary  ,6,93,99,69,378,447
03308300,KENSINGTON COLLEGE                      ,CA,92705-8708,Proprietary  ,0,9,9,2,63,65
03321300,SCRIPPS RESEARCH INSTITUTE (THE)        ,CA,92037-0000,Private      ,0,2,2,9,44,53
03327400,ACUPUNCTURE AND INTEGRATIVE MEDICINE COL,CA,94704-2724,Private      ,0,8,8,3,195,198
03332300,SOUTHERN CA BIBLE CLG & SEMINARY        ,CA,92019-1109,Private      ,0,6,6,9,152,161
03359300,ST. FRANCIS CAREER COLLEGE              ,CA,90262-2659,Private      ,8,32,40,76,312,388
03367300,PROFESSIONAL GOLFERS CAREER COLLEGE     ,CA,92591-6013,Proprietary  ,22,38,60,205,290,495
03383300,CALIFORNIA RECORDING INSTITUTE          ,CA,94103-3921,Proprietary  ,0,0,0,0,1,1
03394300,REMINGTON COLLEGE - SAN DIEGO CAMPUS    ,CA,92108-3002,Proprietary  ,36,88,124,349,727,1076
03395300,INTERNATIONAL CAREER DEVELOPMENT        ,CA,90027-5794,Proprietary  ,257,560,817,830,2091,2921
03399300,NORTHWESTERN TECHNICAL COLLEGE          ,CA,95670-4443,Proprietary  ,23,103,126,139,493,632
03403300,TRINITY LIFE BIBLE COLLEGE              ,CA,95842-3546,Private      ,4,31,35,89,251,340
03413400,ENGLISH CENTER  (THE)                   ,CA,94607-3734,Private      ,6,28,34,23,172,195
03427400,CAREER COLLEGES OF AMERICA              ,CA,90280-7420,Proprietary  ,92,440,532,475,2131,2606
03427500,ANTELOPE VALLEY MEDICAL COLLEGE         ,CA,93534-3324,Proprietary  ,61,146,207,332,754,1086
03440400,MARIAN HEALTH CAREERS CENTER            ,CA,90010-1728,Proprietary  ,28,41,69,79,173,252
03441400,VALLEY CAREER COLLEGE                   ,CA,92020-3057,Proprietary  ,21,126,147,148,563,711
03455900,VALLECITOS CENTER FOR EMPLOYMENT TR     ,CA,94541-5027,Private      ,2,1,3,5,31,36
03458300,MY LE'S BEAUTY COLLEGE                  ,CA,95824-3039,Proprietary  ,4,20,24,44,180,224
03467300,MARINELLO SCHOOL OF BEAUTY              ,CA,92545-3661,Proprietary  ,38,71,109,114,231,345
03467301,CALIFORNIA BEAUTY COLLEGE - DESERT HOT S,CA,92240-1307,Proprietary  ,0,0,0,6,7,13
03474700,OPPORTUNITIES INDUSTRIALIZATION CEN     ,CA,94025-1413,Private      ,0,1,1,2,2,4
03479300,PROFESSIONAL CAREER INSTITUTE           ,CA,90703-2522,Proprietary  ,11,29,40,53,225,278
03479400,DONALD VOCATIONAL SCHOOL                ,CA,90010-1718,Proprietary  ,0,0,0,3,1,4
03485400,JAMES ALBERT SCHOOL OF COSMETOLOGY      ,CA,92627-3831,Proprietary  ,11,39,50,66,122,188
03485401,JAMES ALBERT SCHOOL OF COSMETOLOGY - ANA,CA,92804-5384,Proprietary  ,2,2,4,7,12,19
03516300,THE KING'S COLLEGE AND SEMINARY         ,CA,91405-2233,Private      ,2,25,27,51,307,358
03532400,ADVANCED TRAINING ASSOCIATES            ,CA,92020-1236,Proprietary  ,4,15,19,9,49,58
03542400,COPPER MOUNTAIN COLLEGE                 ,CA,92252-6102,Public       ,34,143,177,491,1535,2026
03577300,COBA ACADEMY                            ,CA,92866-1407,Proprietary  ,11,10,21,43,63,106
03590400,NTMA TRAINING CENTERS OF SOUTHERN C     ,CA,90650-6099,Private      ,30,165,195,108,554,662
03592400,CITY OF HOPE GRADUATE SCHOOL            ,CA,91010-0000,Private      ,0,0,0,1,14,15
03598300,AVALON BEAUTY COLLEGE                   ,CA,93103-3137,Proprietary  ,9,8,17,78,44,122
03614300,UNITED BEAUTY COLLEGE                   ,CA,91733-0000,Proprietary  ,4,4,8,12,66,78
03621300,LIBERTY TRAINING INSTITUTE              ,CA,90057-3202,Proprietary  ,12,41,53,55,177,232
03636300,HEARTWOOD INSTITUTE                     ,CA,95542-9446,Proprietary  ,0,0,0,1,1,2
03639300,WEST COAST ULTRASOUND INSTITUTE         ,CA,90211-3312,Proprietary  ,27,130,157,190,783,973
03646300,DESIGN'S SCHOOL OF COSMETOLOGY          ,CA,93446-1471,Proprietary  ,16,41,57,73,172,245
03681300,CALIFORNIA HEALING ARTS COLLEGE         ,CA,90025-2589,Proprietary  ,6,37,43,43,134,177
03695300,COMMUNITY ENHANCEMENT SERVICES          ,CA,91205-2395,Private      ,2,31,33,4,115,119
03695400,SALVATION ARMY CRESTMONT COLLEGE (THE)  ,CA,90275-5301,Private      ,0,0,0,2,1,3
03695700,SANTIAGO CANYON COLLEGE                 ,CA,92869-4512,Public       ,152,172,324,1549,1242,2791
03696300,UNIVERSITY OF THE WEST                  ,CA,91770-3709,Private      ,3,4,7,13,49,62
03698300,WEST COAST UNIVERSITY                   ,CA,90004-6818,Proprietary  ,91,388,479,309,1953,2262
03698400,CA COLLEGE OF VOCATIONAL CAREER         ,CA,93301-1800,Proprietary  ,6,19,25,37,111,148
03736300,ADVANCE BEAUTY COLLEGE                  ,CA,92843-4752,Proprietary  ,7,52,59,37,318,355
03740400,ATI COLLEGE                             ,CA,90650-0000,Proprietary  ,8,44,52,63,250,313
03759300,COMPUTER TUTOR BUSINESS & TECH INST     ,CA,95356-0000,Proprietary  ,3,21,24,26,117,143
03786300,ADVANCED COLLEGE                        ,CA,90280-5255,Proprietary  ,7,47,54,52,246,298
03797400,CAREER CARE INSTITUTE                   ,CA,93534-0000,Proprietary  ,36,129,165,173,676,849
03806300,LAKE COLLEGE                            ,CA,96002-0926,Proprietary  ,10,33,43,41,325,366
03810300,SILICON VALLEY UNIVERSITY               ,CA,95131-1868,Private      ,2,4,6,17,36,53
03814400,SOKA UNIVERSITY OF AMERICA              ,CA,92656-8081,Private      ,7,0,7,325,31,356
03838400,WALTER JAY M.D. INSTITUTE AN EDUCATIONAL,CA,90057-0000,Proprietary  ,5,41,46,13,137,150
03852500,CIT COLLEGE OF INFOMEDICAL TECHNOLOGY   ,CA,92831-3703,Proprietary  ,5,114,119,41,407,448
03853300,KECK GRADUATE INSTITUTE OF APPLIED LIFE ,CA,91711-4817,Private      ,0,0,0,0,75,75
03853400,LADERA CAREER PATHS TRAINING CENTERS    ,CA,90045-1931,Proprietary  ,0,4,4,4,16,20
03868300,WORLD MISSION UNIVERSITY                ,CA,90020-1789,Private      ,0,10,10,2,63,65
03868400,LOS ANGELES MUSIC ACADEMY               ,CA,91105-2540,Proprietary  ,8,6,14,58,65,123
03871300,FOLSOM LAKE COLLEGE                     ,CA,95630-6798,Public       ,117,214,331,1425,2083,3508
03874300,CAMBRIDGE JUNIOR COLLEGE                ,CA,95993-0000,Proprietary  ,19,52,71,71,234,305
03874400,COMMMUNITY CHRISTIAN COLLEGE            ,CA,92373-4465,Private      ,3,6,9,44,92,136
03889300,STANBRIDGE COLLEGE                      ,CA,92612-0000,Proprietary  ,13,82,95,98,464,562
03901300,PACIFIC COAST TRADE SCHOOL              ,CA,93033-2441,Proprietary  ,6,54,60,36,175,211
03910400,NATIONAL POLYTECHNIC COLLEGE            ,CA,90040-3066,Proprietary  ,15,57,72,51,203,254
03933300,MUELLER COLLEGE OF HOLISTIC STUDIES     ,CA,92116-2630,Proprietary  ,3,31,34,38,167,205
03962300,AMERICAN INSTITUTE OF MASSAGE THERAPY   ,CA,92705-5463,Proprietary  ,4,7,11,18,32,50
03964400,INTERNATIONAL SCHOOL OF BEAUTY          ,CA,92260-2740,Proprietary  ,9,26,35,52,131,183
03969600,AMERICAN AUTO INSTITUTE                 ,CA,90703-2637,Proprietary  ,12,17,29,54,93,147
03971300,AMERICAN CAREER COLLEGE                 ,CA,91764-4906,Proprietary  ,121,316,437,565,1317,1882
03973300,EX'PRESSION COLLEGE FOR DIGITAL ARTS    ,CA,94608-1021,Proprietary  ,57,42,99,747,616,1363
03974500,CALIFORNIA CAREER COLLEGE               ,CA,91303-2006,Proprietary  ,4,8,12,28,87,115
03976400,CALIFORNIA INSTITUTE OF THE HEALING ARTS,CA,95825-8551,Proprietary  ,0,0,0,10,22,32
03980300,CALIFORNIA STATE UNIVERSITY CHANNEL ISLA,CA,93012-8599,Public       ,62,65,127,3835,1808,5643
03995300,UNIVERSITY OF EAST-WEST MEDICINE        ,CA,94087-6106,Proprietary  ,0,5,5,7,55,62
03999300,BEAUMONT ADULT SCHOOL                   ,CA,92223-1927,Public       ,6,24,30,30,125,155
04001300,PALACE BEAUTY COLLEGE                   ,CA,90006-4233,Proprietary  ,5,25,30,34,98,132
04001400,MOJAVE BARBER COLLEGE                   ,CA,92395-3201,Proprietary  ,5,17,22,17,94,111
04003300,CSI CAREER COLLEGE                      ,CA,95687-3100,Proprietary  ,42,102,144,184,516,700
04004300,THUY PRINCESS BEAUTY COLLEGE            ,CA,91766-0000,Proprietary  ,1,8,9,5,51,56
04005300,INTERAMERICAN COLLEGE                   ,CA,91950-4437,Private      ,4,37,41,13,121,134
04014400,PALLADIUM TECHNICAL ACADEMY             ,CA,91731-2429,Proprietary  ,1,33,34,22,76,98
04023400,PROTEUS                                 ,CA,93291-3014,Private      ,1,4,5,2,20,22
04037300,LOS ANGELES FILM SCHOOL (THE)           ,CA,90028-7300,Proprietary  ,32,60,92,586,594,1180
04049300,MAXINE WATERS EMPLOYMENT PREPARATION CEN,CA,90059-1023,Public       ,3,9,12,21,63,84
04056300,CAREER COLLEGE OF CALIFORNIA            ,CA,92705-5805,Proprietary  ,0,5,5,8,24,32
04057300,TECHSKILLS OF SACRAMENTO                ,CA,95815-4025,Proprietary  ,10,62,72,68,363,431
04071300,AMERICAN PACIFIC COLLEGE                ,CA,91405-6232,Proprietary  ,1,9,10,14,57,71
04076400,GNOMON SCHOOL OF VISUAL EFFECTS         ,CA,90038-2616,Proprietary  ,0,11,11,22,88,110
04092300,COASTLINE BEAUTY COLLEGE                ,CA,92708-3847,Proprietary  ,1,36,37,12,149,161
04092400,MAKE-UP DESIGNORY                       ,CA,91502-1322,Proprietary  ,18,28,46,192,161,353
04100400,TAFT UNIVERSITY SYSTEM (THE)            ,CA,92704-6954,Proprietary  ,0,51,51,0,55,55
04109300,ACADEMY OF BARBERING ARTS (THE)         ,CA,91324-3406,Proprietary  ,7,22,29,48,97,145
04111300,WEST HILLS COLLEGE LEMOORE              ,CA,93245-9248,Public       ,86,234,320,1162,2124,3286
04114500,VALLEY COLLEGE OF MEDICAL CAREERS       ,CA,91304-2354,Proprietary  ,16,50,66,56,178,234
04115300,COACHELLA VALLEY BEAUTY COLLEGE         ,CA,92253-2051,Proprietary  ,3,4,7,28,56,84
04115600,MAYFIELD COLLEGE                        ,CA,92234-7014,Proprietary  ,2,17,19,12,48,60
04115800,MERIDIAN INSTITUTE                      ,CA,90010-3606,Proprietary  ,0,0,0,1,14,15
04116000,VIDEO SYMPHONY ENTERTRAINING            ,CA,91502-3253,Proprietary  ,7,21,28,58,222,280
04119200,CAREER COLLEGE CONSULTANTS              ,CA,90041-2088,Proprietary  ,4,24,28,10,62,72
04126400,CHAMPION INSTITUTE OF COSMETOLOGY       ,CA,92264-7458,Proprietary  ,2,10,12,4,17,21
04126500,COAST CAREER INSTITUTE                  ,CA,90015-3040,Proprietary  ,3,22,25,4,37,41
04127100,"UNIVERSITY OF CALIFORNIA, MERCED        ",CA,95343-5001,Public       ,103,26,129,7214,696,7910
04127800,HEALTHY HAIR ACADEMY                    ,CA,90303-3137,Proprietary  ,14,53,67,48,173,221
04127900,TUI UNIVERSITY                          ,CA,90630-5023,Proprietary  ,1,178,179,28,1668,1696
04129700,INTERNATIONAL POLYTECHNIC INSTITUTE     ,CA,92231-1737,Private      ,0,1,1,0,1,1
04132300,INSTITUTE OF MEDICAL EDUCATION          ,CA,95113-2207,Proprietary  ,14,105,119,34,213,247
04132400,ACADEMY OF ESTHETICS AND COSMETOLOGY    ,CA,91342-3373,Proprietary  ,0,5,5,1,9,10
04132700,INFOTECH CAREER COLLEGE                 ,CA,90706-5579,Proprietary  ,6,43,49,19,94,113
04133000,BIOHEALTH COLLEGE                       ,CA,95134-2033,Proprietary  ,2,64,66,9,96,105
04134500,CAREER COLLEGE OF SAN DIEGO             ,CA,92102-3348,Proprietary  ,3,28,31,15,101,116
04134700,INTERNATL PROFESSIONAL SCHL OF BODYWORK ,CA,92123-1520,Proprietary  ,4,49,53,4,49,53
04137200,BORNER'S BARBER COLLEGE                 ,CA,90047-3856,Proprietary  ,0,2,2,2,22,24
04138700,CAO INSTITUTE OF AESTHETICS (THE)       ,CA,91801-3903,Proprietary  ,13,11,24,33,55,88
04141300,SAN FRANCISCO INSTITUTE OF ESTHETICS    ,CA,94103-4083,Proprietary  ,25,32,57,25,32,57
04141400,LAURUS COLLEGE                          ,CA,93401-5405,Proprietary  ,15,53,68,17,83,100
04141700,HEALING HANDS SCHOOL OF HOLISTIC HEALTH ,CA,92025-1722,Proprietary  ,2,7,9,2,7,9
00184600,BRIAR CLIFF UNIVERSITY                  ,IA,51104-2100,Private      ,5,20,25,1181,459,1640
00184700,BUENA VISTA UNIVERSITY                  ,IA,50588-9987,Private      ,23,91,114,1756,1672,3428
00184800,SOUTHEASTERN COMMUNITY COLLEGE          ,IA,52655-0000,Public       ,49,157,206,1095,1927,3022
00185000,CENTRAL COLLEGE                         ,IA,50219-1999,Private      ,11,8,19,2150,85,2235
00185200,CLARKE COLLEGE                          ,IA,52001-3198,Private      ,3,17,20,987,468,1455
00185400,COE COLLEGE                             ,IA,52402-5092,Private      ,8,5,13,1784,153,1937
00185500,DES MOINES UNIV-OSTEOPATHIC MED CTR     ,IA,50312-0000,Private      ,0,19,19,19,1685,1704
00185600,CORNELL COLLEGE                         ,IA,52314-1098,Private      ,11,0,11,1731,75,1806
00185700,SOUTHWESTERN COMMUNITY COLLEGE          ,IA,50801-1098,Public       ,14,56,70,523,639,1162
00185800,DIVINE WORD COLLEGE                     ,IA,52045-0380,Private      ,2,1,3,12,20,32
00185900,DORDT COLLEGE                           ,IA,51250-1697,Private      ,4,0,4,1400,87,1487
00186000,DRAKE UNIVERSITY                        ,IA,50311-4505,Private      ,25,64,89,4156,2332,6488
00186200,ELLSWORTH COMMUNITY COLLEGE             ,IA,50126-1199,Public       ,12,18,30,647,310,957
00186400,IOWA LAKES COMMUNITY COLLEGE            ,IA,51334-2234,Public       ,27,110,137,1205,1118,2323
00186500,IOWA CENTRAL COMMUNITY COLLEGE          ,IA,50501-0000,Public       ,53,196,249,2434,2062,4496
00186600,GRACELAND UNIVERSITY                    ,IA,50140-1699,Private      ,15,106,121,996,1156,2152
00186700,GRAND VIEW UNIVERSITY                   ,IA,50316-1599,Private      ,15,41,56,1637,997,2634
00186800,GRINNELL COLLEGE                        ,IA,50112-1690,Private      ,23,0,23,2328,35,2363
00186900,IOWA STATE UNIV SCIENCE & TECHNOLOG     ,IA,50011-2028,Public       ,196,154,350,19152,5010,24162
00187100,IOWA WESLEYAN COLLEGE                   ,IA,52641-1398,Private      ,6,15,21,745,419,1164
00187300,LORAS COLLEGE                           ,IA,52004-0178,Private      ,9,3,12,1828,158,1986
00187400,LUTHER COLLEGE                          ,IA,52101-1045,Private      ,8,6,14,2775,81,2856
00187500,MARSHALLTOWN COMMUNITY COLLEGE          ,IA,50158-4760,Public       ,28,83,111,644,820,1464
00187700,NORTH IOWA AREA COMMUNITY COLLEGE       ,IA,50401-7299,Public       ,48,101,149,1710,1070,2780
00187900,MORNINGSIDE COLLEGE                     ,IA,51106-1751,Private      ,10,26,36,1517,447,1964
00188000,MOUNT MERCY COLLEGE                     ,IA,52402-4797,Private      ,8,41,49,1011,720,1731
00188100,ASHFORD UNIVERSITY                      ,IA,52732-3997,Proprietary  ,534,11052,11586,2450,47773,50223
00188300,NORTHWESTERN COLLEGE                    ,IA,51041-1996,Private      ,6,3,9,1508,107,1615
00188700,SIMPSON COLLEGE                         ,IA,50125-1297,Private      ,11,28,39,2140,517,2657
00188900,ST AMBROSE UNIVERSITY                   ,IA,52803-2898,Private      ,14,42,56,2681,1245,3926
00189000,UNIVERSITY OF NORTHERN IOWA             ,IA,50614-0705,Public       ,79,112,191,10040,2920,12960
00189100,UNIVERSITY OF DUBUQUE                   ,IA,52001-5099,Private      ,14,10,24,1617,510,2127
00189200,UNIVERSITY OF IOWA                      ,IA,52242-1316,Public       ,179,195,374,16835,8992,25827
00189300,UPPER IOWA UNIVERSITY                   ,IA,52142-9206,Private      ,24,352,376,1360,4562,5922
00189400,VENNARD COLLEGE                         ,IA,52595-0029,Private      ,0,0,0,61,20,81
00189500,WALDORF COLLEGE                         ,IA,50436-1700,Private      ,11,3,14,660,86,746
00189600,WARTBURG COLLEGE                        ,IA,50677-2200,Private      ,9,2,11,2417,73,2490
00189700,WARTBURG THEOLOGICAL SEMINARY           ,IA,52004-5004,Private      ,0,3,3,5,149,154
00190000,WILLIAM PENN UNIVERSITY                 ,IA,52577-1799,Private      ,22,96,118,1042,1422,2464
00396300,AIB COLLEGE OF BUSINESS                 ,IA,50321-1799,Private      ,14,41,55,664,664,1328
00407500,ESTRN IOWA COMMUNITY COLLEGE DIST       ,IA,52801-1221,Public       ,2,10,12,49,87,136
00407501,CLINTON COMMUNITY COLLEGE               ,IA,52732-0000,Public       ,13,54,67,420,580,1000
00407502,MUSCATINE COMMUNITY COLLEGE             ,IA,52761-0000,Public       ,18,49,67,450,510,960
00407503,SCOTT COMMUNITY COLLEGE                 ,IA,52722-0000,Public       ,71,198,269,1260,2511,3771
00407600,KIRKWOOD COMMUNITY COLLEGE              ,IA,52406-2068,Public       ,160,504,664,6649,6071,12720
00423300,MERCY/ST. LUKE'S SCH RAD TECH           ,IA,52402-0000,Private      ,0,1,1,6,10,16
00458600,KAPLAN UNIVERSITY                       ,IA,52807-2095,Proprietary  ,1482,22958,24440,6688,109965,116653
00458604,KAPLAN UNIVERSITY - CEDAR RAPIDS        ,IA,52404-2998,Proprietary  ,24,169,193,209,1100,1309
00458605,KAPLAN UNIVERSITY - DES MOINES          ,IA,50323-5702,Proprietary  ,42,207,249,330,1437,1767
00458606,KAPLAN UNIVERSITY - MASON CITY          ,IA,50401-4665,Proprietary  ,9,76,85,129,655,784
00458607,KAPLAN UNIVERSITY - CEDAR FALLS         ,IA,50613-6309,Proprietary  ,20,137,157,199,1029,1228
00458610,KAPLAN UNIVERSITY - COUNCIL BLUFFS      ,IA,51503-5289,Proprietary  ,10,83,93,66,534,600
00458700,NORTHEAST IOWA COMMUNITY COLLEGE        ,IA,52132-0400,Public       ,21,77,98,719,766,1485
00458701,NORTHEAST IOWA COMMUNITY COLLEGE        ,IA,52068-0000,Public       ,36,104,140,1059,1149,2208
00459500,HAWKEYE COMMUNITY COLLEGE               ,IA,50701-0000,Public       ,81,195,276,3034,2400,5434
00459800,IOWA WESTERN CMTY CLG-COUNCIL BLUFF     ,IA,51502-0000,Public       ,78,158,236,2455,2116,4571
00460000,NORTHWEST IOWA COMMUNITY COLLEGE        ,IA,51201-1046,Public       ,15,27,42,469,321,790
00626700,IOWA METHODIST MEDICAL CENTER SCHOOLS   ,IA,50309-1499,Private      ,0,1,1,15,34,49
00627300,MERCY COLLEGE OF HEALTH SCIENCES        ,IA,50309-1239,Private      ,10,56,66,407,705,1112
00712000,DES MOINES AREA CMTY COLLEGE            ,IA,50021-0000,Public       ,203,582,785,5553,7487,13040
00712100,FAITH BAPTIST BIBLE CLG & THEOL SEM     ,IA,50021-0000,Private      ,1,4,5,317,80,397
00729100,ST LUKE'S COLLEGE                       ,IA,51104-0263,Private      ,0,3,3,101,99,200
00731600,WESTERN IOWA TECH COMMUNITY COLLEGE     ,IA,51106-0000,Public       ,55,223,278,1454,2495,3949
00758800,CAPRI COLLEGE                           ,IA,52004-0873,Proprietary  ,12,26,38,183,207,390
00761100,EQ SCHOOL OF HAIR DESIGN                ,IA,51503-0813,Proprietary  ,3,8,11,41,52,93
00765600,AMERICAN COLLEGE OF HARISTYLING -CR     ,IA,52402-0000,Proprietary  ,1,2,3,6,27,33
00765800,AMER COLL OF HAIRSTYLING-DES MOINES     ,IA,50309-5446,Proprietary  ,2,8,10,11,41,52
00765900,LA JAMES COLLEGE OF HAIRSTYLING         ,IA,50401-3308,Proprietary  ,5,14,19,101,79,180
00771700,CAPRI COLLEGE                           ,IA,52807-2622,Proprietary  ,8,14,22,49,56,105
00794100,COLLEGE OF HAIR DESIGN                  ,IA,50703-1834,Proprietary  ,1,11,12,20,56,76
00811600,DAYTON'S SCHOOL OF HAIR DESIGN          ,IA,52601-0000,Proprietary  ,0,7,7,5,31,36
00826000,IOWA SCHOOL OF BEAUTY INC               ,IA,50322-0000,Proprietary  ,6,21,27,65,137,202
00840300,INDIAN HILLS COMMUNITY COLLEGE          ,IA,52501-1398,Public       ,79,263,342,1705,2078,3783
00840301,INDIAN HILLS COMMUNITY COLLEGE          ,IA,52544-0000,Public       ,17,30,47,221,283,504
00842400,LA JAMES INTERNATIONAL COLLEGE          ,IA,50501-5577,Proprietary  ,9,21,30,95,77,172
00959300,LA'JAMES COLLEGE OF HAIRSTYLING         ,IA,52240-0000,Proprietary  ,9,10,19,92,66,158
01111300,MAHARISHI UNIV OF MANAGEMENT            ,IA,52557-0001,Private      ,4,10,14,145,247,392
01206400,HAMILTON TECHNICAL COLLEGE              ,IA,52807-2653,Proprietary  ,13,55,68,115,297,412
01230000,PALMER COLLEGE OF CHIROPRACTIC          ,IA,52803-5287,Private      ,6,43,49,87,2468,2555
01300600,LA' JAMES INTERNATIONAL COLLEGE-CF      ,IA,50613-5242,Proprietary  ,10,10,20,93,69,162
02090300,CAPRI COLLEGE                           ,IA,52404-0000,Proprietary  ,14,14,28,64,67,131
02134500,LA JAMES INTERNATIONAL COLLEGE - DAV    ,IA,52806-3952,Proprietary  ,8,25,33,50,74,124
02160900,"SALON PROFESSIONAL ACADEMY, THE         ",IA,50010-0000,Proprietary  ,6,5,11,133,40,173
02262500,FAUST INSTITUTE OF COSMETOLOGY          ,IA,50588-0000,Proprietary  ,1,8,9,37,41,78
02274100,LA' JAMES INTERNATIONAL COLLEGE - DM    ,IA,50131-0000,Proprietary  ,12,49,61,146,164,310
02289000,AMERICAN HAIR ACADEMY                   ,IA,52627-4530,Proprietary  ,1,4,5,18,24,42
02306900,IOWA SCHOOL OF BEAUTY                   ,IA,52501-0000,Proprietary  ,3,10,13,27,48,75
02328900,EMMAUS BIBLE COLLEGE                    ,IA,52001-0000,Private      ,2,0,2,213,26,239
02330900,IOWA SCHOOL OF BEAUTY                   ,IA,50158-0000,Proprietary  ,1,5,6,16,25,41
02333200,DAYTON'S SCHOOL OF HAIR DESIGN          ,IA,52632-0000,Proprietary  ,0,3,3,3,16,19
02609200,VATTEROTT COLLEGE                       ,IA,50321-4704,Proprietary  ,31,174,205,143,617,760
03069100,ALLEN COLLEGE                           ,IA,50703-1916,Private      ,0,13,13,260,271,531
03441300,IOWA SCHOOL OF BEAUTY                   ,IA,51106-5111,Proprietary  ,3,5,8,33,39,72
03607400,TOTAL LOOK SCHOOL OF COSMETOLOGY AND MAS,IA,52136-1053,Proprietary  ,0,0,0,7,8,15
03720300,CARLSON COLLEGE OF MASSAGE THERAPY      ,IA,52205-7519,Proprietary  ,1,6,7,24,39,63
04089300,BIO-CHI INSTITUTE OF MASSAGE THERAPY    ,IA,51103-2138,Proprietary  ,0,3,3,3,27,30
00259600,ATLANTIC COMMUNITY COLLEGE              ,NJ,08330-2699,Public       ,113,280,393,3393,3558,6951
00259700,BLOOMFIELD COLLEGE                      ,NJ,07003-3425,Private      ,46,69,115,2317,1250,3567
00259800,CALDWELL COLLEGE                        ,NJ,07006-6195,Private      ,27,51,78,1398,913,2311
00259900,CENTENARY COLLEGE                       ,NJ,07840-2184,Private      ,20,87,107,1588,1023,2611
00260000,COLLEGE OF SAINT ELIZABETH              ,NJ,07960-6989,Private      ,16,38,54,706,654,1360
00260100,CUMBERLAND COUNTY COLLEGE               ,NJ,08362-0517,Public       ,29,77,106,1998,2279,4277
00260300,DREW UNIVERSITY                         ,NJ,07940-4063,Private      ,55,16,71,3366,527,3893
00260700,FAIRLEIGH DICKINSON UNIV-TEANECK        ,NJ,07666-1996,Private      ,77,146,223,2700,2056,4756
00260701,FAIRLEIGH DICKINSON UNIV-FLORHAM        ,NJ,07940-0000,Private      ,26,25,51,2191,510,2701
00260702,FAIRLEIGH DICKINSON UNIV-ED WMS CLG     ,NJ,07601-0000,Private      ,6,10,16,136,108,244
00260703,FAIRLEIGH DICKINSON UNIVERSITY          ,NJ,07940-0000,Private      ,40,45,85,1590,660,2250
00260800,GEORGIAN COURT UNIVERSITY               ,NJ,08701-2697,Private      ,20,70,90,1386,1573,2959
00260900,ROWAN UNIVERSITY                        ,NJ,08028-1702,Public       ,134,98,232,10869,3206,14075
00261000,FELICIAN COLLEGE                        ,NJ,07644-2198,Private      ,46,92,138,1674,1107,2781
00261300,NEW JERSEY CITY UNIVERSITY              ,NJ,07305-1597,Public       ,89,178,267,4417,4558,8975
00261500,MIDDLESEX COUNTY COLLEGE                ,NJ,08818-3050,Public       ,161,204,365,5506,3553,9059
00261600,MONMOUTH UNIVERSITY                     ,NJ,07764-1898,Private      ,77,66,143,6914,1980,8894
00261700,MONTCLAIR STATE UNIVERSITY              ,NJ,07043-9987,Public       ,236,210,446,14633,5435,20068
00261900,NEW BRUNSWICK THEOLOGICAL SEMINARY      ,NJ,08901-0000,Private      ,0,4,4,23,106,129
00262100,NEW JERSEY INST OF TECHNOLOGY           ,NJ,07102-1982,Public       ,89,101,190,4453,1934,6387
00262200,KEAN UNIVERSITY                         ,NJ,07083-7131,Public       ,174,218,392,9402,6034,15436
00262400,OCEAN COUNTY COLLEGE                    ,NJ,08754-2001,Public       ,160,227,387,4544,2812,7356
00262500,WILLIAM PATERSON UNIVERSITY             ,NJ,07470-2152,Public       ,157,126,283,9155,3203,12358
00262600,PRINCETON THEOLOGICAL SEMINARY          ,NJ,08542-0000,Private      ,0,5,5,8,578,586
00262700,PRINCETON UNIVERSITY                    ,NJ,08544-0001,Private      ,115,27,142,12802,1267,14069
00262800,RIDER UNIVERSITY                        ,NJ,08648-3099,Private      ,81,62,143,6383,1425,7808
00262900,"RUTGERS, THE STATE UNIVERSITY OF NJ     ",NJ,08901-1281,Public       ,549,472,1021,39526,17385,56911
00263200,SETON HALL UNIVERSITY                   ,NJ,07079-2697,Private      ,142,138,280,9212,3151,12363
00263201,SETON HALL UNIVERSITY - SCHOOL OF LAW   ,NJ,07079-5210,Private      ,10,13,23,190,2114,2304
00263800,ST PETER'S COLLEGE                      ,NJ,07306-5997,Private      ,55,63,118,3230,1002,4232
00263900,STEVENS INSTITUTE OF TECHNOLOGY         ,NJ,07030-5370,Private      ,37,37,74,3019,462,3481
00264200,COLLEGE OF NEW JERSEY (THE)             ,NJ,08628-0718,Public       ,85,46,131,9605,974,10579
00264300,UNION COUNTY COLLEGE                    ,NJ,07016-1598,Public       ,214,435,649,4279,5604,9883
00473600,BERGEN COMMUNITY COLLEGE                ,NJ,07652-1595,Public       ,211,232,443,6103,3700,9803
00474000,MERCER COUNTY COMMUNITY COLLEGE         ,NJ,08690-0000,Public       ,114,281,395,2810,3642,6452
00539900,MONMOUTH COUNTY VOCATIONAL SCH DIST     ,NJ,07728-5033,Public       ,2,12,14,40,72,112
00545200,TETERBORO SCH OF AERONAUTICS            ,NJ,07608-1083,Proprietary  ,10,22,32,82,95,177
00546000,SOMERSET COUNTY TECHNICAL INSTITUTE     ,NJ,08807-0350,Public       ,5,5,10,47,130,177
00546100,SALEM COMMUNITY COLLEGE                 ,NJ,08069-2799,Public       ,18,28,46,547,633,1180
00641000,C E GREGORY SCHOOL OF NURSING           ,NJ,08857-0000,Private      ,0,1,1,22,31,53
00641700,HOLY NAME HOSPITAL SCH OF NURSING       ,NJ,07666-4254,Private      ,0,3,3,85,143,228
00642000,MOUNTAINSIDE HOSP SCH NRSG              ,NJ,07042-4898,Proprietary  ,0,2,2,39,142,181
00642100,MUHLENBERG SNYDER SCHOOLS               ,NJ,07061-3399,Private      ,5,16,21,129,444,573
00642900,ST FRANCIS MEDICAL CTR SCH NURSING      ,NJ,08629-1986,Private      ,2,5,7,24,53,77
00642902,ST FRANCIS MED CTR RAD TECH             ,NJ,08629-0000,Private      ,0,0,0,5,9,14
00686500,CAMDEN COUNTY COLLEGE                   ,NJ,08012-3240,Public       ,184,483,667,5931,6883,12814
00690100,GLOUCESTER COUNTY COLLEGE               ,NJ,08080-4249,Public       ,60,129,189,2707,2011,4718
00710700,ESSEX COUNTY COLLEGE                    ,NJ,07102-1798,Public       ,209,411,620,4775,6646,11421
00736203,STUART SCHOOL OF BUSINESS ADMINISTRATION,NJ,07719-3970,Proprietary  ,0,1,1,7,60,67
00750200,BERKELEY COLLEGE                        ,NJ,07424-3367,Proprietary  ,62,158,220,1745,1618,3363
00750201,BERKELEY COLLEGE                        ,NJ,07095-0000,Proprietary  ,37,42,79,665,521,1186
00750202,BERKELEY COLLEGE - PARAMUS              ,NJ,07652-2931,Proprietary  ,10,34,44,478,366,844
00750600,LINCOLN TECHNICAL INSTITUTE             ,NJ,07083-5032,Proprietary  ,131,222,353,927,1148,2075
00750601,LINCOLN TECHNICAL INSTITUTE             ,NJ,07430-0000,Proprietary  ,63,78,141,614,450,1064
00750700,GIBBS COLLEGE                           ,NJ,07039-1611,Proprietary  ,4,5,9,340,497,837
00750701,KATHARINE GIBBS - PISCATAWAY            ,NJ,08854-0000,Proprietary  ,0,1,1,94,133,227
00759300,PARISIAN BEAUTY ACADEMY                 ,NJ,07601-5509,Proprietary  ,24,27,51,124,142,266
00772900,COUNTY COLLEGE OF MORRIS                ,NJ,07869-0000,Public       ,108,94,202,2858,1332,4190
00773000,BURLINGTON COUNTY COLLEGE               ,NJ,08068-1599,Public       ,87,213,300,3201,2992,6193
00773100,RARITAN VALLEY COMMUNITY COLLEGE        ,NJ,08876-1265,Public       ,79,113,192,1830,1359,3189
00780401,CAREER ACADEMY OF NEW YORK - STAR LAKEWO,NJ,08701-5900,Proprietary  ,18,78,96,28,110,138
00780402,CAREER ACADEMY OF NEW YORK - STAR EGG HA,NJ,08234-4863,Proprietary  ,15,79,94,24,120,144
00794700,BETH MEDRASH GOVOHA OF AMERICA          ,NJ,08701-0000,Private      ,87,416,503,325,1732,2057
00840400,BROOKDALE COMMUNITY COLLEGE             ,NJ,07738-1597,Public       ,274,262,536,5284,3368,8652
00844101,ANTHEM INSTITUTE                        ,NJ,08002-0000,Proprietary  ,1,1,2,15,45,60
00849400,HO HO KUS SCHL OF TRADE & TECH SCIENCES ,NJ,07513-1402,Proprietary  ,22,60,82,88,207,295
00860900,RABBINICAL COLLEGE OF AMERICA           ,NJ,07960-3600,Private      ,19,2,21,85,9,94
00907800,CAPRI INSTITUTE OF HAIR DESIGN          ,NJ,07011-2111,Proprietary  ,11,21,32,78,135,213
00934400,RAMAPO COLLEGE OF NEW JERSEY            ,NJ,07430-1680,Public       ,73,35,108,5834,852,6686
00934500,RICHARD STOCKTON COLLEGE OF NJ          ,NJ,08240-0195,Public       ,103,79,182,6778,2325,9103
00982804,EVEREST INSTITUTE - SOUTH PLAINFIELD    ,NJ,07080-1125,Proprietary  ,50,158,208,158,511,669
00999400,PASSAIC COUNTY COMMUNITY COLLEGE        ,NJ,07505-1179,Public       ,211,435,646,3011,3716,6727
01039400,UNIV OF MEDICINE & DENTISTRY OF NJ      ,NJ,07107-0000,Public       ,2,103,105,201,4386,4587
01062900,P B COSMETOLOGY EDUCATION CENTRE        ,NJ,08030-1750,Proprietary  ,13,14,27,124,115,239
01085100,ANTHEM INSTITUTE                        ,NJ,07054-3409,Proprietary  ,135,298,433,819,1521,2340
01085101,ANTHEM INSTITUTE                        ,NJ,07306-0000,Proprietary  ,3,3,6,49,56,105
01085102,ANTHEM INSTITUTE                        ,NJ,08902-0000,Proprietary  ,1,5,6,34,56,90
01090300,RIZZIERI INSTITUTE                      ,NJ,08053-1800,Proprietary  ,6,19,25,102,110,212
01152300,MORRIS COUNTY SCHOOL OF TECHNOLOGY      ,NJ,07834-0000,Public       ,0,3,3,42,37,79
01170800,NATURAL MOTION INST OF HAIR DESIGN      ,NJ,07306-5496,Proprietary  ,6,15,21,54,115,169
01198900,TALMUDICAL ACADEMY                      ,NJ,07710-0000,Private      ,0,0,0,36,1,37
01209000,REIGNBOW BEAUTY ACADEMY                 ,NJ,08861-4118,Proprietary  ,6,31,37,48,170,218
01234600,DOVER BUSINESS COLLEGE                  ,NJ,07652-0000,Proprietary  ,42,114,156,302,756,1058
01234602,DOVER BUSINESS COLLEGE                  ,NJ,07801-4643,Proprietary  ,23,55,78,130,364,494
01246100,LINCOLN TECHNICAL INSTITUTE             ,NJ,08820-2896,Proprietary  ,54,114,168,453,745,1198
01246102,LINCOLN TECHNICAL INSTITUTE             ,NJ,08054-0000,Proprietary  ,22,163,185,248,875,1123
01246103,LINCOLN TECHNICAL INSTITUTE             ,NJ,07652-2106,Proprietary  ,46,139,185,350,720,1070
01246200,HOHOKUS - HACKENSACK SCHOOL OF BUSINESS ,NJ,07601-7197,Proprietary  ,28,142,170,186,839,1025
01295400,HUDSON COUNTY COMMUNITY COLLEGE         ,NJ,07306-4012,Public       ,295,473,768,3830,4915,8745
02053700,EASTWICK COLLEGE                        ,NJ,07446-0000,Proprietary  ,35,111,146,280,811,1091
02061800,ROMAN ACADEMY OF BEAUTY CULTURE         ,NJ,07506-0000,Proprietary  ,13,10,23,37,36,73
02092300,HOHOKUS SCHOOL - RETS/NUTLEY            ,NJ,07110-0000,Proprietary  ,35,110,145,235,487,722
02103700,CAPRI INSTITUTE OF HAIR DESIGN          ,NJ,07652-0000,Proprietary  ,9,23,32,55,85,140
02104000,HARRIS SCHOOL OF BUSINESS               ,NJ,08002-2983,Proprietary  ,77,374,451,308,1545,1853
02106601,FOX INSTITUTE OF BUSINESS - CLIFTON     ,NJ,07011-2345,Proprietary  ,17,79,96,74,235,309
02131100,DU CRET SCHOOL OF THE ARTS              ,NJ,07060-0000,Private      ,2,1,3,25,13,38
02131600,PENNCO TECH                             ,NJ,08012-0000,Proprietary  ,58,170,228,439,742,1181
02132300,BERDAN INSTITUTE                        ,NJ,07512-0000,Proprietary  ,31,84,115,258,474,732
02146800,JOE KUBERT SCH OF CARTOON & GRAPHIC     ,NJ,07801-0000,Proprietary  ,2,1,3,63,38,101
02149800,EMPIRE BEAUTY SCHOOL                    ,NJ,08021-0000,Proprietary  ,24,82,106,152,429,581
02149801,EMPIRE BEAUTY SCHOOL - BORDENTOWN       ,NJ,08505-1513,Proprietary  ,0,0,0,5,7,12
02154000,DIVERS ACAD OF EASTERN SEABOARD         ,NJ,08081-1139,Proprietary  ,22,54,76,74,188,262
02183600,CAPRI INSTITUTE OF HAIR DESIGN          ,NJ,07033-0000,Proprietary  ,11,34,45,58,116,174
02192200,THOMAS EDISON STATE COLLEGE             ,NJ,08608-0000,Public       ,25,451,476,282,4359,4641
02219600,OMEGA INSTITUTE                         ,NJ,08109-0000,Proprietary  ,6,39,45,56,167,223
02223700,NEW HORIZON INST OF COSMETOLOGY         ,NJ,07093-0000,Proprietary  ,5,36,41,24,181,205
02223900,DRAKE COLLEGE OF BUSINESS               ,NJ,07201-0000,Proprietary  ,137,994,1131,457,3399,3856
02232500,UNION COUNTY VOCATIONAL TECH INST       ,NJ,07076-0000,Public       ,3,21,24,67,90,157
02234600,SHORE BEAUTY SCHOOL                     ,NJ,08232-0000,Proprietary  ,8,26,34,55,93,148
02246000,ROSS UNIVERSITY - MEDICAL SCHOOL        ,NJ,08837-0000,Proprietary  ,4,246,250,23,4166,4189
02248600,COOPER HEALTH SYS-CTR ALLIED HEALTH     ,NJ,08103-0000,Private      ,1,5,6,18,66,84
02252700,CONCORDE SCHOOL OF HAIR DESIGN          ,NJ,07712-0000,Proprietary  ,27,49,76,125,263,388
02252701,CONCORDE SCHOOL OF HAIR DESIGN - BLOOMFI,NJ,07003-2517,Proprietary  ,0,0,0,1,14,15
02261800,EUROPEAN ACADEMY OF COSMETOLOGY         ,NJ,07083-0000,Proprietary  ,4,33,37,54,159,213
02265500,CAPRI INSTITUTE OF HAIR DESIGN          ,NJ,08724-0000,Proprietary  ,15,17,32,91,119,210
02277900,ROSS UNIV - SCH OF VETERINARY MED       ,NJ,08837-0000,Proprietary  ,2,57,59,4,1000,1004
02291000,ENGINE CITY TECHNICAL INSTITUTE         ,NJ,07080-2424,Proprietary  ,20,14,34,137,90,227
02312000,BERGEN COUNTY TECHNICAL SCHOOLS         ,NJ,07601-6110,Public       ,3,5,8,44,69,113
02344200,EMPIRE BEAUTY SCHOOL                    ,NJ,08002-0000,Proprietary  ,15,50,65,141,279,420
02503900,WARREN COUNTY COMMUNITY COLLEGE         ,NJ,07882-0000,Public       ,31,26,57,591,437,1028
02523700,OCEAN COUNTY VOCATIONAL-TECH SCHOOL     ,NJ,08753-0000,Public       ,4,4,8,118,177,295
02525900,ARTISTIC ACADEMY OF HAIR DESIGN         ,NJ,07950-1409,Proprietary  ,13,15,28,110,70,180
02528200,REIGNBOW BEAUTY ACADEMY                 ,NJ,07060-0000,Proprietary  ,10,25,35,36,95,131
02539903,STAR TECHNICAL INSTITUTE-EGG HARBOR     ,NJ,08234-0000,Proprietary  ,0,0,0,34,158,192
02558700,PRISM CAREER INSTITUTE                  ,NJ,08037-0000,Proprietary  ,47,254,301,230,1092,1322
02568800,SUSSEX COUNTY COMMUNITY COLLEGE         ,NJ,07860-1149,Public       ,64,89,153,1383,777,2160
02586900,HARRIS SCHOOL OF BUSINESS               ,NJ,08084-1520,Proprietary  ,33,172,205,63,326,389
02586901,STAR TECHNICAL INSTITUTE - LAKEWOOD     ,NJ,08701-0000,Proprietary  ,0,0,0,56,179,235
02615401,STAR TECHNICAL INSTITUTE -              ,NJ,07102-4599,Proprietary  ,0,2,2,58,429,487
02616402,SANFORD-BROWN INSTITUTE - ISELIN        ,NJ,08830-0000,Proprietary  ,64,215,279,459,1234,1693
03077500,RABBI JACOB JOSEPH SCHOOL               ,NJ,08817-4494,Private      ,0,0,0,12,0,12
03122600,EASTERN INTERNATIONAL COLLEGE           ,NJ,07306-3906,Proprietary  ,43,171,214,152,449,601
03187300,STENOTECH CAREER INSTITUTE              ,NJ,07004-3490,Proprietary  ,3,15,18,33,76,109
03197300,INSTITUTE FOR HEALTH EDUCATION(THE)     ,NJ,07306-2929,Proprietary  ,7,43,50,26,145,171
03324300,CENTRAL CAREER SCHOOL                   ,NJ,07080-2408,Proprietary  ,6,29,35,10,71,81
03380302,CULINARY ACADEMY OF LONG ISLAND - STAR N,NJ,07102-4510,Proprietary  ,15,106,121,26,135,161
03389300,ACADEMY OF MASSAGE THERAPY              ,NJ,07631-0000,Proprietary  ,8,46,54,37,177,214
03424500,NEW COMMUNITY WORKFORCE DEVELOPMENT     ,NJ,07103-2402,Private      ,3,58,61,30,395,425
03530300,"KEY SKILLS LEARNING, INC.               ",NJ,07013-1900,Proprietary  ,0,11,11,5,45,50
03536300,INSTITUTE FOR THERAPEUTIC MASSAGE       ,NJ,07420-1452,Proprietary  ,5,41,46,33,183,216
03574400,CORTIVA INSTITUTE - SOMERSET SCHOOL OF M,NJ,08854-3908,Proprietary  ,8,29,37,33,134,167
03625300,PERFORMANCE TRAINING INSTITUTE          ,NJ,08753-0000,Proprietary  ,0,1,1,3,7,10
03629300,HELMA INSTITUTE OF MASSAGE THERAPY      ,NJ,07663-6200,Proprietary  ,0,0,0,0,2,2
03637300,METRO AUTO ELECTRONICS TRAINING INSTITUT,NJ,07033-1798,Proprietary  ,14,39,53,48,74,122
03650600,PC AGE                                  ,NJ,07306-3936,Proprietary  ,0,28,28,15,106,121
03650603,PC AGE                                  ,NJ,08817-2842,Proprietary  ,1,2,3,7,24,31
03666300,SOMERSET CHRISTIAN COLLEGE              ,NJ,08890-9035,Private      ,2,29,31,51,226,277
03769300,PC TECH LEARNING CENTER                 ,NJ,07306-9900,Proprietary  ,10,88,98,44,276,320
03803300,HEALTHCARE TRAINING INSTITUTE           ,NJ,07083-3504,Proprietary  ,8,63,71,44,262,306
03811300,EASTERN SCHOOL OF ACUPUNCTURE AND TRADIT,NJ,07042-3562,Proprietary  ,0,4,4,3,47,50
04081300,BAIS MEDRASH TORAS CHESED               ,NJ,08701-0000,Private      ,14,0,14,25,2,27
04123400,YESHIVAS BE'ER YITZCHOK                 ,NJ,07208-2380,Private      ,1,10,11,2,12,14
04125000,GENTLE HEALING SCHOOL OF MASSAGE        ,NJ,08512-3600,Proprietary  ,0,5,5,4,29,33
04131100,YESHIVA TORAS CHAIM                     ,NJ,08701-2120,Private      ,17,0,17,43,0,43
04131200,TOTAL IMAGE BEAUTY ACADEMY              ,NJ,07307-2943,Proprietary  ,1,6,7,1,6,7
04134100,CENTER FOR ALLIED HEALTH & NURSING EDUCA,NJ,07601-5801,Proprietary  ,6,55,61,44,273,317
04136400,AMERICAN INSTITUTE OF MEDICAL SCIENCES &,NJ,07080-1183,Proprietary  ,3,30,33,5,40,45
        ,BROOKLYN LAW SCHOOL                     ,NY,11201-0000,Private      ,0,4,4,41,3249,3290
00266500,VAUGHN COLLEGE OF AERONAUTICS AND TECHNO,NY,11369-9997,Private      ,40,40,80,848,534,1382
00266600,ADELPHI UNIVERSITY                      ,NY,11530-4299,Private      ,127,214,341,6783,4525,11308
00266700,DOWLING COLLEGE                         ,NY,11769-1999,Private      ,59,154,213,2605,2250,4855
00266800,ALFRED UNIVERSITY                       ,NY,14802-1205,Private      ,32,19,51,3078,545,3623
00266900,BANK STREET COLLEGE OF EDUCATION        ,NY,10025-0000,Private      ,0,30,30,6,833,839
00267100,BARD COLLEGE                            ,NY,12504-5000,Private      ,18,5,23,2793,550,3343
00267700,BROOKLYN LAW SCHOOL                     ,NY,11201-0000,Private      ,3,16,19,3,16,19
00267800,BRYANT & STRATTON COLLEGE               ,NY,14203-1713,Proprietary  ,231,1130,1361,1841,7134,8975
00267803,BRYANT & STRATTON COLLEGE - GREECE      ,NY,14606-4227,Proprietary  ,16,120,136,266,1011,1277
00267805,BRYANT & STRATTON COLLEGE - SYRACUSE    ,NY,13203-2502,Proprietary  ,60,164,224,644,1621,2265
00267807,BRYANT & STRATTON COLLEGE - ALBANY      ,NY,12205-5230,Proprietary  ,23,88,111,278,836,1114
00268100,CANISIUS COLLEGE                        ,NY,14208-1098,Private      ,21,57,78,4352,1505,5857
00268500,CAZENOVIA COLLEGE                       ,NY,13035-1085,Private      ,24,4,28,1719,116,1835
00268700,CUNY-BROOKLYN COLLEGE                   ,NY,11210-2814,Public       ,318,345,663,13652,8408,22060
00268800,CITY COLLEGE-CUNY                       ,NY,10031-9198,Public       ,355,307,662,14812,6765,21577
00268900,CUNY-HUNTER COLLEGE                     ,NY,10021-5024,Public       ,485,472,957,21394,10527,31921
00269000,QUEENS COLLEGE-CUNY                     ,NY,11367-1597,Public       ,408,456,864,12748,6729,19477
00269100,CUNY- BOROUGH OF MANHATTAN CMTY CLG     ,NY,10007-1047,Public       ,1123,958,2081,16519,11491,28010
00269200,CUNY BRONX COMMUNITY COLLEGE            ,NY,10453-3102,Public       ,519,503,1022,7572,6752,14324
00269300,CUNY-JOHN JAY CLG CRIMINAL JUSTICE      ,NY,10019-1093,Public       ,293,282,575,12208,5767,17975
00269400,KINGSBOROUGH COMMUNITY COLLEGE          ,NY,11235-2398,Public       ,851,595,1446,9101,5098,14199
00269600,NY CITY COLLEGE OF TECHNOLOGY-CUNY      ,NY,11201-2983,Public       ,530,459,989,11551,6415,17966
00269700,QUEENSBOROUGH COMMUNITY COLLEGE         ,NY,11364-1497,Public       ,641,354,995,7892,3876,11768
00269800,CUNY THE COLLEGE OF STATEN ISLAND       ,NY,10314-6600,Public       ,288,230,518,8824,3795,12619
00269900,CLARKSON UNIVERSITY                     ,NY,13699-5615,Private      ,31,3,34,3884,269,4153
00270000,COLGATE ROCHESTER CROZER DIVINITY S     ,NY,14620-0000,Private      ,0,1,1,7,83,90
00270100,COLGATE UNIVERSITY                      ,NY,13346-1386,Private      ,31,1,32,4660,58,4718
00270300,COLLEGE OF MOUNT SAINT VINCENT          ,NY,10471-1093,Private      ,25,13,38,2212,329,2541
00270400,COLLEGE OF NEW ROCHELLE                 ,NY,10805-2339,Private      ,41,452,493,1253,5458,6711
00270500,COLLEGE OF SAINT ROSE                   ,NY,12203-1490,Private      ,40,88,128,4039,2116,6155
00270700,COLUMBIA UNIVERSITY                     ,NY,10027-0000,Private      ,89,166,255,3968,3257,7225
00270701,COLUMBIA UNIV ARCHITECTURE              ,NY,10027-0000,Private      ,2,10,12,42,720,762
00270702,COLUMBIA UNIV SCHOOL OF THE ARTS        ,NY,10027-0000,Private      ,2,13,15,96,1279,1375
00270703,COLUMBIA UNIV BUSINESS GRAD             ,NY,10027-0000,Private      ,1,39,40,35,1550,1585
00270704,COLUMBIA UNIV SCHOOL ENGIN-UNDERGRA     ,NY,10027-0000,Private      ,13,2,15,1855,59,1914
00270705,COLUMBIA UNIV SCHOOL GENERAL STUDIE     ,NY,10027-0000,Private      ,14,38,52,414,1140,1554
00270706,COLUMBIA UNIV GRAD SCHL ARTS & SCI      ,NY,10027-0000,Private      ,0,141,141,31,1613,1644
00270707,COLUMBIA UNIV SCH INTL PUB AFFAIRS      ,NY,10027-0000,Private      ,1,54,55,14,1367,1381
00270708,COLUMBIA UNIV JOURNALISM GRAD           ,NY,10027-0000,Private      ,0,8,8,18,452,470
00270710,COLUMBIA UNIV COLUMBIA COLLEGE          ,NY,10027-0000,Private      ,74,15,89,8197,299,8496
00270711,COLUMBIA UNIV SCHOOL OF LAW             ,NY,10027-0000,Private      ,3,16,19,31,4135,4166
00270712,COLUMBIA UNIV SOCIAL WORK               ,NY,10025-0000,Private      ,1,10,11,15,906,921
00270713,COLUMBIA UNIV SCHL DENT & ORAL SURG     ,NY,10032-0000,Private      ,0,4,4,4,327,331
00270714,COLUMBIA UNIV INST HUMAN NUTRITION      ,NY,10032-0000,Private      ,0,1,1,3,56,59
00270715,COLUMBIA UNIV NURSING                   ,NY,10032-0000,Private      ,6,8,14,113,714,827
00270716,COLUMBIA UNIV COLL PHYS & SURGEONS      ,NY,10032-0000,Private      ,1,1,2,22,1097,1119
00270717,COLUMBIA UNIV PHYSICAL THERAPY          ,NY,10032-0000,Private      ,1,1,2,6,121,127
00270718,COLUMBIA UNIV OCCUPATIONAL THERAPY      ,NY,10032-0000,Private      ,2,4,6,5,109,114
00270719,COLUMBIA UNIV PUBLIC HEALTH             ,NY,10032-0000,Private      ,0,4,4,6,999,1005
00270720,COLUMBIA UNIV - ENGINEERING (GRAD)      ,NY,10027-0000,Private      ,2,18,20,49,330,379
00270721,COLUMBIA UNIV-CONT ED & SP PROGMS       ,NY,10027-0000,Private      ,1,35,36,15,309,324
00270800,BARNARD COLLEGE-COLUMBIA UNIV           ,NY,10027-6598,Private      ,34,5,39,3443,113,3556
00270900,CONCORDIA COLLEGE                       ,NY,10708-1998,Private      ,12,8,20,816,213,1029
00271000,COOPER UNION                            ,NY,10003-7120,Private      ,37,4,41,1609,143,1752
00271100,CORNELL UNIVERSITY                      ,NY,14853-2801,Private      ,247,102,349,23441,5410,28851
00271200,D'YOUVILLE COLLEGE                      ,NY,14201-1084,Private      ,18,47,65,1470,1478,2948
00271300,DOMINICAN COLLEGE                       ,NY,10962-1299,Private      ,25,47,72,1539,804,2343
00271800,ELMIRA COLLEGE                          ,NY,14901-2099,Private      ,21,27,48,2022,555,2577
00272200,FORDHAM UNIVERSITY                      ,NY,10458-5157,Private      ,230,245,475,18608,8880,27488
00272600,GENERAL THEOLOGICAL SEMINARY            ,NY,10011-0000,Private      ,0,1,1,0,118,118
00272800,HAMILTON COLLEGE                        ,NY,13323-1218,Private      ,32,0,32,2712,31,2743
00272900,HARTWICK COLLEGE                        ,NY,13820-4020,Private      ,27,3,30,2518,64,2582
00273100,HOBART & WILLIAM SMITH COLLEGES         ,NY,14456-3397,Private      ,24,1,25,3164,48,3212
00273200,HOFSTRA UNIVERSITY                      ,NY,11549-1010,Private      ,295,182,477,15102,5809,20911
00273400,HOUGHTON COLLEGE                        ,NY,14744-0128,Private      ,3,13,16,1497,255,1752
00273500,HILBERT COLLEGE                         ,NY,14075-1597,Private      ,9,14,23,1005,327,1332
00273700,IONA COLLEGE                            ,NY,10801-1890,Private      ,70,57,127,6170,1156,7326
00273900,ITHACA COLLEGE                          ,NY,14850-7130,Private      ,101,8,109,12165,684,12849
00274000,JEWISH THEOLOGICAL SEMINARY OF AMER     ,NY,10027-4649,Private      ,1,1,2,122,185,307
00274200,THE JUILLIARD SCHOOL                    ,NY,10023-6588,Private      ,11,3,14,1147,569,1716
00274400,KEUKA COLLEGE                           ,NY,14478-0000,Private      ,17,75,92,1326,1025,2351
00274800,LEMOYNE COLLEGE                         ,NY,13214-1399,Private      ,45,48,93,3983,970,4953
00274900,NEW YORK COLLEGE OF PODIATRIC MED       ,NY,10035-0000,Private      ,3,6,9,58,386,444
00275100,LONG ISLAND UNIVERSITY                  ,NY,11548-1326,Private      ,257,636,893,10947,9643,20590
00275101,LONG ISLAND UNIVERSITY - BRENTWOOD CAMPU,NY,11717-5326,Private      ,0,0,0,12,41,53
00275102,LONG ISLAND UNIVERSITY - ROCKLAND CAMPUS,NY,10962-0000,Private      ,0,0,0,5,21,26
00275104,LONG ISLAND UNIVERSITY - NEW YORK UNIVER,NY,10011-0000,Private      ,0,0,0,114,52,166
00275105,LONG ISLAND UNIVERSITY - WEST POINT CAMP,NY,10966-0000,Private      ,0,0,0,59,4,63
00275106,LONG ISLAND UNIVERSITY - JEWISH BOARD OF,NY,10019-0000,Private      ,0,0,0,8,2,10
00275107,LONG ISLAND UNIVERSITY - QUEENS DISTRICT,NY,11364-0000,Private      ,0,0,0,8,3,11
00275108,LONG ISLAND UNIVERSITY - FREEPORT PUBLIC,NY,11520-3144,Private      ,0,0,0,5,1,6
00275109,LONG ISLAND UNIVERSITY - LOCUST VALLEY H,NY,11560-1105,Private      ,0,0,0,1,1,2
00275110,LONG ISLAND UNIVERSITY - WESTBURY SENIOR,NY,11568-1619,Private      ,0,0,0,119,24,143
00275111,LONG ISLAND UNIVERSITY - BABYLON SENIOR ,NY,11702-2222,Private      ,0,0,0,5,0,5
00275112,LONG ISLAND UNIVERSITY - HARBORFIELDS HI,NY,11740-1432,Private      ,0,0,0,1,0,1
00275113,LONG ISLAND UNIVERSITY - SOUTH SIDE HIGH,NY,11570-2248,Private      ,0,0,0,0,2,2
00275115,LONG ISLAND UNIVERSITY - SOUTHAMPTON COL,NY,11548-1326,Private      ,0,0,0,182,33,215
00275116,LONG ISLAND UNIV-BROOKLYN CAMPUS        ,NY,11548-1326,Private      ,0,0,0,645,138,783
00275800,MANHATTAN COLLEGE                       ,NY,10471-4098,Private      ,69,19,88,5208,380,5588
00275900,MANHATTAN SCHOOL OF MUSIC               ,NY,10027-4698,Private      ,9,7,16,668,739,1407
00276000,MANHATTANVILLE COLLEGE                  ,NY,10577-2132,Private      ,35,119,154,2850,973,3823
00276300,MARIA COLLEGE                           ,NY,12208-1798,Private      ,14,19,33,231,692,923
00276500,MARIST COLLEGE                          ,NY,12601-1387,Private      ,87,50,137,8488,1024,9512
00276900,MARYMOUNT MANHATTAN COLLEGE             ,NY,10021-4597,Private      ,39,13,52,2903,272,3175
00277200,MERCY COLLEGE                           ,NY,10522-1189,Private      ,151,560,711,2873,6926,9799
00277500,MOLLOY COLLEGE                          ,NY,11570-1100,Private      ,50,98,148,2515,1628,4143
00277700,MEDAILLE COLLEGE                        ,NY,14214-2695,Private      ,26,85,111,1511,1466,2977
00277800,MOUNT SAINT MARY COLLEGE                ,NY,12550-3494,Private      ,37,66,103,2323,1029,3352
00277900,NAZARETH COLLEGE OF ROCHESTER           ,NY,14618-3790,Private      ,25,26,51,3011,1502,4513
00278200,NEW YORK INSTITUTE OF TECHNOLOGY        ,NY,11568-8000,Private      ,102,121,223,4733,3847,8580
00278202,NY INSTITUTE OF TECHNOLOGY-OSTEOPATHIC M,NY,11568-0000,Private      ,1,3,4,74,1209,1283
00278300,NEW YORK LAW SCHOOL                     ,NY,10013-0000,Private      ,4,19,23,26,3298,3324
00278400,NEW YORK MEDICAL COLLEGE                ,NY,10595-0000,Private      ,1,21,22,14,1928,1942
00278500,NEW YORK UNIVERSITY                     ,NY,10012-1091,Private      ,381,617,998,32631,24685,57316
00278800,NIAGARA UNIVERSITY                      ,NY,14109-2010,Private      ,25,33,58,3773,766,4539
00279000,NYACK COLLEGE                           ,NY,10960-3698,Private      ,32,222,254,1310,2244,3554
00279100,PACE UNIVERSITY - NEW YORK              ,NY,10038-1598,Private      ,134,184,318,7406,2856,10262
00279101,PACE UNIVERSITY-PLEASANTVILLE           ,NY,10570-0000,Private      ,51,48,99,3276,1021,4297
00279102,PACE UNIVERSITY - WHITE PLAINS          ,NY,10603-0000,Private      ,6,62,68,270,2144,2414
00279500,PAUL SMITHS CLG OF ARTS & SCIENCES      ,NY,12970-0000,Private      ,10,2,12,1149,133,1282
00279600,POLYTECHNIC INTSTITUTE OF NEW YORK UNIV ,NY,11201-3840,Private      ,31,72,103,1894,745,2639
00279800,PRATT INSTITUTE                         ,NY,11205-3899,Private      ,75,59,134,4431,2310,6741
00280300,RENSSELAER POLYTECHNIC INSTITUTE        ,NY,12180-3590,Private      ,71,18,89,9417,564,9981
00280500,ROBERTS WESLEYAN COLLEGE                ,NY,14624-1997,Private      ,7,82,89,1532,1215,2747
00280600,ROCHESTER INSTITUTE OF TECHNOLOGY       ,NY,14623-5608,Private      ,136,106,242,13672,2773,16445
00280700,ROCKEFELLER UNIVERSITY                  ,NY,10021-0000,Private      ,1,1,2,20,17,37
00280800,DAEMEN COLLEGE                          ,NY,14226-3592,Private      ,23,45,68,1900,878,2778
00281000,THE SAGE COLLEGES                       ,NY,12180-4199,Private      ,16,56,72,1261,1575,2836
00281200,TROCAIRE COLLEGE                        ,NY,14220-2094,Private      ,16,35,51,546,1187,1733
00281300,SARAH LAWRENCE COLLEGE                  ,NY,10708-5999,Private      ,14,5,19,2199,656,2855
00281400,SKIDMORE COLLEGE                        ,NY,12866-1632,Private      ,32,2,34,4242,105,4347
00281401,SKIDMORE COLL-UNIV WITHOUT WALLS        ,NY,12866-0000,Private      ,1,1,2,23,40,63
00281500,ST BERNARDS SCH THEOLOGY & MINISTRY     ,NY,14618-3822,Private      ,0,1,1,1,49,50
00281600,SIENA COLLEGE                           ,NY,12211-1462,Private      ,35,8,43,5440,211,5651
00281700,ST BONAVENTURE UNIVERSITY               ,NY,14778-2284,Private      ,14,16,30,2344,521,2865
00282000,ST FRANCIS COLLEGE                      ,NY,11201-4398,Private      ,54,47,101,2057,475,2532
00282100,ST JOHN FISHER COLLEGE                  ,NY,14618-3597,Private      ,31,36,67,4281,1549,5830
00282200,CHRIST THE KING SEMINARY                ,NY,14052-0607,Private      ,0,1,1,0,11,11
00282300,ST JOHN'S UNIVERSITY                    ,NY,11439-1343,Private      ,315,120,435,21421,5941,27362
00282500,ST JOSEPH'S COLLEGE                     ,NY,11205-3688,Private      ,20,46,66,961,627,1588
00282501,ST JOSEPH'S COLLEGE-SUFFOLK CAMPUS      ,NY,11772-0000,Private      ,72,79,151,3022,1226,4248
00282900,ST LAWRENCE UNIVERSITY                  ,NY,13617-1455,Private      ,37,9,46,3017,107,3124
00283200,ST THOMAS AQUINAS COLLEGE               ,NY,10976-1050,Private      ,32,13,45,1781,302,2083
00283300,ST VLADIMIR ORTHODOX THEOL SEM          ,NY,10707-0000,Private      ,0,1,1,0,64,64
00283400,EXCELSIOR COLLEGE                       ,NY,12203-5159,Private      ,16,583,599,163,5040,5203
00283500,SUNY AT ALBANY                          ,NY,12222-0001,Public       ,316,164,480,20075,5030,25105
00283600,BINGHAMTON UNIVERSITY (SUNY)            ,NY,13902-6000,Public       ,301,79,380,21306,2619,23925
00283700,SUNY AT BUFFALO                         ,NY,14260-0001,Public       ,287,151,438,20625,9762,30387
00283800,SUNY AT STONY BROOK                     ,NY,11794-0001,Public       ,426,233,659,21329,6477,27806
00283900,SUNY-DOWNSTATE MEDICAL CENTER           ,NY,11203-2098,Public       ,0,20,20,119,1842,1961
00284000,SUNY UPSTATE MEDICAL UNIVERSITY         ,NY,13210-2375,Public       ,1,7,8,189,1174,1363
00284100,SUNY BROCKPORT - FIN AID OFF            ,NY,14420-2914,Public       ,113,97,210,8610,2671,11281
00284200,BUFFALO STATE COLLEGE - SUNY            ,NY,14222-1095,Public       ,249,215,464,10862,4879,15741
00284300,SUNY COLLEGE-CORTLAND                   ,NY,13045-0900,Public       ,102,58,160,10396,1629,12025
00284400,SUNY AT FREDONIA                        ,NY,14063-1145,Public       ,68,31,99,6943,953,7896
00284500,SUNY GENESEO                            ,NY,14454-1401,Public       ,89,12,101,9151,550,9701
00284600,SUNY COLLEGE-NEW PALTZ                  ,NY,12561-2499,Public       ,144,73,217,10515,2019,12534
00284700,SUNY COLLEGE-ONEONTA                    ,NY,13820-4015,Public       ,99,16,115,9825,659,10484
00284800,SUNY OSWEGO                             ,NY,13126-3599,Public       ,108,85,193,9598,2016,11614
00284900,SUNY COLLEGE AT PLATTSBURGH             ,NY,12901-2681,Public       ,83,51,134,6594,1387,7981
00285000,SUNY COLLEGE-POTSDAM                    ,NY,13676-2294,Public       ,59,34,93,4454,1036,5490
00285100,SUNY COLLEGE OF ENVIRONMENT SCIENCE AND ,NY,13210-2778,Public       ,12,9,21,1869,509,2378
00285300,SUNY MARITIME COLLEGE                   ,NY,10465-4198,Public       ,23,19,42,1292,255,1547
00285400,SUNY COLLEGE OF TECHNOLOGY-ALFRED       ,NY,14802-9951,Public       ,58,31,89,3537,735,4272
00285500,SUNY CANTON COLG OF TECHNOLOGY          ,NY,13617-1098,Public       ,65,65,130,2605,1117,3722
00285600,SUNY AG & TECH COLLEGE-COBLESKILL       ,NY,12043-9986,Public       ,64,30,94,3003,409,3412
00285700,SUNY DELHI                              ,NY,13753-1190,Public       ,46,28,74,3363,651,4014
00285800,SUNY FARMINGDALE                        ,NY,11735-1021,Public       ,111,82,193,4936,1716,6652
00285900,SUNY COLLEGE OF AG & TECH AT MORRISVILLE,NY,13408-0901,Public       ,54,47,101,3470,924,4394
00286000,ADIRONDACK COMMUNITY COLLEGE            ,NY,12804-2004,Public       ,66,86,152,1771,1268,3039
00286100,CAYUGA COMMUNITY COLLEGE                ,NY,13021-3099,Public       ,82,120,202,1672,1698,3370
00286200,BROOME COMMUNITY COLLEGE                ,NY,13902-1398,Public       ,121,167,288,3532,2417,5949
00286300,CORNING COMMUNITY COLLEGE               ,NY,14830-3297,Public       ,90,184,274,1844,1969,3813
00286400,DUTCHESS COMMUNITY COLLEGE              ,NY,12601-1595,Public       ,191,177,368,2710,1771,4481
00286600,FASHION INSTITUTE OF TECHNOLOGY         ,NY,10001-5992,Public       ,152,106,258,6830,2415,9245
00286700,SUNY FULTON MONTGOMERY COMM CLG         ,NY,12095-3790,Public       ,63,60,123,1238,889,2127
00286800,HUDSON VALLEY COMMUNITY COLLEGE         ,NY,12180-6096,Public       ,240,182,422,6315,3586,9901
00286900,JAMESTOWN COMMUNITY COLLEGE             ,NY,14701-1999,Public       ,62,86,148,2287,1782,4069
00287000,JEFFERSON COMMUNITY COLLEGE             ,NY,13601-1897,Public       ,58,167,225,1333,1740,3073
00287100,"SUNY, MOHAWK VALLEY COMMUNITY CLG       ",NY,13501-5394,Public       ,142,170,312,3849,2314,6163
00287200,MONROE COMMUNITY COLLEGE                ,NY,14623-5780,Public       ,457,569,1026,9370,7493,16863
00287300,NASSAU COMMUNITY COLLEGE                ,NY,11530-6793,Public       ,541,328,869,9860,4791,14651
00287400,NIAGARA COUNTY COMMUNITY COLLEGE        ,NY,14132-9460,Public       ,93,112,205,3538,2945,6483
00287500,ONONDAGA COMMUNITY COLLEGE              ,NY,13215-4585,Public       ,223,257,480,5610,3518,9128
00287600,ORANGE COUNTY COMMUNITY COLLEGE         ,NY,10940-6441,Public       ,109,99,208,2576,1834,4410
00287700,ROCKLAND COMMUNITY COLLEGE              ,NY,10901-3611,Public       ,204,207,411,2222,1641,3863
00287800,SUFFOLK COMMUNITY COLLEGE               ,NY,11784-2899,Public       ,302,203,505,5947,2804,8751
00287801,SUFFOLK COMMUNITY CLG-W. CAMPUS         ,NY,11717-0000,Public       ,172,166,338,2875,2098,4973
00287803,SUFFOLK COMMUNITY CLG-EASTRN CAMPUS     ,NY,11901-0000,Public       ,86,84,170,983,792,1775
00287900,SULLIVAN COUNTY COMMUNITY COLLEGE       ,NY,12759-5151,Public       ,54,41,95,1341,647,1988
00288000,ULSTER COUNTY COMMUNITY COLLEGE         ,NY,12484-0557,Public       ,78,73,151,1226,871,2097
00288100,SUNY WESTCHESTER COMMUNITY COLLEGE      ,NY,10595-1698,Public       ,205,251,456,4324,3517,7841
00288200,SYRACUSE UNIVERSITY                     ,NY,13244-2130,Private      ,218,192,410,19643,5248,24891
00288300,UTICA COLLEGE OF SYRACUSE UNIV          ,NY,13502-4892,Private      ,32,71,103,3105,1348,4453
00288500,ALBANY COLLEGE OF PHARMACY AND HEALTH SC,NY,12208-3492,Private      ,7,3,10,1618,707,2325
00288600,ALBANY LAW SCHOOL                       ,NY,12208-0000,Private      ,1,2,3,21,1442,1463
00288700,ALBANY MEDICAL COLLEGE                  ,NY,12208-0000,Private      ,0,11,11,42,980,1022
00288900,UNION COLLEGE                           ,NY,12308-2311,Private      ,32,2,34,3272,78,3350
00289000,UNION THEOLOGICAL SEMINARY              ,NY,10027-0000,Private      ,0,6,6,1,308,309
00289200,UNITED STATES MERCHANT MARINE ACADEMY   ,NY,11024-1699,Public       ,3,1,4,403,11,414
00289400,UNIVERSITY OF ROCHESTER                 ,NY,14627-9000,Private      ,63,68,131,7491,1571,9062
00289401,EASTMAN SCH OF MUSIC/UNIV ROCHESTER     ,NY,14604-0000,Private      ,4,3,7,775,357,1132
00289402,UNIV OF ROCHESTER SCHL OF MEDICINE      ,NY,14642-0000,Private      ,3,13,16,47,729,776
00289500,VASSAR COLLEGE                          ,NY,12604-0008,Private      ,37,2,39,4561,71,4632
00289600,VILLA MARIA COLLEGE-BUFFALO             ,NY,14225-3999,Private      ,18,15,33,446,248,694
00289900,WAGNER COLLEGE                          ,NY,10301-4495,Private      ,48,20,68,2883,326,3209
00290000,WEBB INSTITUTE                          ,NY,11542-1398,Private      ,4,0,4,56,1,57
00290100,WELLS COLLEGE                           ,NY,13026-0500,Private      ,16,2,18,970,70,1040
00290300,YESHIVA UNIVERSITY                      ,NY,10033-3201,Private      ,35,44,79,2023,3126,5149
00290302,YESHIVA UNIVERSITY - BRONX CAMPUS       ,NY,10461-1975,Private      ,1,11,12,15,1151,1166
00397400,MESIVTHA TIFERETH JERUSALEM OF AMER     ,NY,10002-6382,Private      ,13,1,14,33,2,35
00397600,RABBINICAL ACAD MESIVTA RABBI CHAIM     ,NY,11230-4715,Private      ,11,1,12,19,1,20
00397700,RABBINICAL COLLEGE CH'SAN SOFER         ,NY,11204-1252,Private      ,3,21,24,16,26,42
00397800,RABBINICAL SEMINARY OF AMERICA          ,NY,11375-0000,Private      ,6,5,11,23,36,59
00397900,COLUMBIA UNIV TEACHERS COLLEGE          ,NY,10027-0000,Private      ,3,192,195,28,4134,4162
00405400,HEBREW UNION COL-JEWISH INST OF REL     ,NY,10012-0000,Private      ,0,0,0,0,91,91
00455301,ITT TECHNICAL INSTITUTE                 ,NY,12205-0000,Proprietary  ,32,85,117,207,436,643
00475900,"CUNY, YORK COLLEGE                      ",NY,11451-0001,Public       ,227,246,473,6516,3649,10165
00476200,WEILL CORNELL MEDICAL COLLEGE AND GRADUA,NY,10021-0000,Private      ,2,31,33,16,884,900
00476500,CUNY GRADUATE SCH & UNIV CTR            ,NY,10016-4309,Public       ,5,116,121,51,2336,2387
00477600,CENTRAL YESHIVA TOMCHEI TMIMIM LUBA     ,NY,11230-2798,Private      ,181,15,196,331,42,373
00478800,HERKIMER COUNTY COMMUNITY COLLEGE       ,NY,13350-1598,Public       ,67,85,152,2361,1104,3465
00479800,MIRRER YESHIVA CENTRAL INST             ,NY,11223-2010,Private      ,18,9,27,82,51,133
00479900,MONROE COLLEGE                          ,NY,10468-4305,Proprietary  ,238,556,794,3416,6300,9716
00479901,MONROE COLLEGE                          ,NY,10801-0000,Proprietary  ,0,0,0,58,28,86
00481100,EVEREST INSTITUTE                       ,NY,14621-3007,Proprietary  ,74,244,318,413,1907,2320
00506401,ST JAMES MERCY HOSP SCH OF RAD          ,NY,14843-2197,Private      ,1,0,1,14,14,28
00506600,FAXTON ST. LUKE'S SCHOOL OF RADIOGRAPHY ,NY,13502-4856,Private      ,0,0,0,15,19,34
00520800,THE COLLEGE OF WESTCHESTER              ,NY,10602-0000,Proprietary  ,46,119,165,936,875,1811
00587700,ROBERT J HOCHSTIM SCHOOL OF RADIOG      ,NY,11572-1151,Private      ,0,0,0,0,2,2
00643501,ARNOT OGDEN MEDICAL CENTER              ,NY,14905-1676,Private      ,0,0,0,28,49,77
00643800,PHILLIPS BETH ISRAEL SCH OF NURSING     ,NY,10001-6354,Private      ,2,4,6,102,293,395
00644300,COCHRAN SCH NSG-ST JOHN RVSDE HOSP      ,NY,10701-1399,Private      ,3,11,14,68,379,447
00644500,CROUSE HOSP SCH OF NURSING              ,NY,13210-1690,Private      ,3,8,11,142,250,392
00644800,ELLIS HOSPITAL SCHOOL OF NURSING        ,NY,12308-0000,Private      ,1,4,5,49,109,158
00646101,ST ELIZABETH COLLEGE OF NURSING         ,NY,13501-2998,Private      ,1,2,3,113,165,278
00646102,ST ELIZABETH SCH OF RADIOGRAPHY         ,NY,13501-0000,Private      ,0,0,0,8,17,25
00646700,SAINT JOSEPH'S COLLEGE OF NURSING       ,NY,13203-1806,Private      ,1,3,4,167,228,395
00678200,GENESEE COMMUNITY COLLEGE               ,NY,14020-9704,Public       ,98,181,279,2603,2110,4713
00678500,SCHENECTADY COUNTY COMMUNITY CLG        ,NY,12305-2294,Public       ,87,128,215,1887,1657,3544
00678700,CLINTON COMMUNITY COLLEGE               ,NY,12901-5690,Public       ,37,35,72,1160,616,1776
00678800,TOMPKINS CORTLAND COMMUNITY COLLEGE     ,NY,13053-8504,Public       ,78,81,159,2284,1301,3585
00678900,COLUMBIA-GREENE COMMUNITY COLLEGE       ,NY,12534-9543,Public       ,60,60,120,961,679,1640
00679100,SUNY AT PURCHASE                        ,NY,10577-1400,Public       ,93,30,123,6551,875,7426
00702200,CUNY-LEHMAN COLLEGE                     ,NY,10468-1589,Public       ,292,342,634,10159,7163,17322
00702600,"MT SINAI SCH OF MEDICINE, NY UNIV       ",NY,10029-0000,Private      ,0,7,7,7,1106,1113
00710900,SUNY COLLEGE-OLD WESTBURY               ,NY,11568-0210,Public       ,103,65,168,4428,1458,5886
00711100,NORTH COUNTRY COMMUNITY COLLEGE         ,NY,12983-2046,Public       ,29,36,65,720,557,1277
00726400,MESIFTA TORAH VODAATH RABBINCAL SEM     ,NY,11218-5209,Private      ,0,3,3,19,31,50
00727300,CUNY-BERNARD BARUCH COLLEGE             ,NY,10010-5518,Public       ,360,261,621,14992,6351,21343
00730400,CULINARY INSTITUTE OF AMERICA           ,NY,12538-1499,Private      ,130,94,224,3057,1319,4376
00737200,AUSTIN'S SCHOOL OF SPA TECHNOLOGY       ,NY,12206-1513,Proprietary  ,21,55,76,116,257,373
00737500,ISLAND DRAFTING & TECHNICAL INST        ,NY,11701-2704,Proprietary  ,5,13,18,79,89,168
00738700,LONG ISLAND BEAUTY SCHOOL               ,NY,11788-4346,Proprietary  ,16,25,41,93,114,207
00738800,LONG ISLAND BEAUTY SCHOOL               ,NY,11550-3704,Proprietary  ,8,40,48,50,148,198
00739100,BEAUTY SCHOOL OF MIDDLETOWN             ,NY,10940-6574,Proprietary  ,3,13,16,40,104,144
00739400,BERKELEY COLLEGE                        ,NY,10017-0000,Proprietary  ,130,267,397,2479,2274,4753
00739402,BERKELEY COLLEGE-WESTCHESTER CAMPUS     ,NY,10601-1533,Proprietary  ,32,21,53,768,308,1076
00739800,KATHARINE GIBBS SCHOOL                  ,NY,10018-2602,Proprietary  ,3,22,25,402,699,1101
00740100,MANDL SCHOOL                            ,NY,10019-5516,Proprietary  ,12,72,84,144,722,866
00740500,WOOD TOBE-COBURN SCHOOL                 ,NY,10016-0102,Proprietary  ,21,6,27,551,108,659
00746500,AMERICAN ACADEMY OF DRAMATIC ARTS       ,NY,10016-7089,Private      ,11,9,20,301,117,418
00746600,LABORATORY INST. OF MERCHANDISING       ,NY,10022-5268,Proprietary  ,36,16,52,1476,140,1616
00746800,SCHOOL OF VISUAL ARTS                   ,NY,10010-3994,Proprietary  ,58,22,80,3553,1174,4727
00750602,LINCOLN TECHNICAL INSTITUTE             ,NY,11357-6092,Proprietary  ,71,50,121,603,295,898
00751800,APEX TECHNICAL SCHOOL                   ,NY,10011-2008,Proprietary  ,233,472,705,973,2063,3036
00752200,CONTINENTAL SCH OF BEAUTY CULTURE       ,NY,14623-3231,Proprietary  ,57,109,166,203,513,716
00753200,FINGER LAKES COMMUNITY COLLEGE          ,NY,14424-8395,Public       ,95,143,238,2999,1877,4876
00757200,AMERICAN MUSICAL AND DRAMATIC ACAD      ,NY,10023-2106,Private      ,28,3,31,1630,292,1922
00757300,LEARNING INSTITUTE FOR BEAUTY SCIENCES  ,NY,11103-4028,Proprietary  ,15,41,56,68,230,298
00780400,CAREER ACADEMY OF NEW YORK              ,NY,10011-7307,Proprietary  ,44,148,192,282,806,1088
00818900,CONTINENTAL SCH OF BEAUTY CULTURE       ,NY,14223-0000,Proprietary  ,1,2,3,6,14,20
00818902,CONTINENTAL SCHOOL OF BEAUTY CULTURE  - ,NY,14224-3402,Proprietary  ,0,0,0,5,7,12
00843500,INTERBORO INSTITUTE                     ,NY,10019-3604,Proprietary  ,0,0,0,0,1,1
00843700,CHAMPLAIN VALLEY - TEC/PRN              ,NY,12901-0000,Public       ,0,0,0,12,37,49
00849500,JAMESTOWN BUSINESS COLLEGE              ,NY,14702-0429,Proprietary  ,12,39,51,134,285,419
00861100,"CUNY, HOSTOS CMTY COLLEGE               ",NY,10451-1499,Public       ,234,306,540,3636,4289,7925
00861400,RABBINICAL CLG BOBOVER YESHIVA BNEI     ,NY,11219-3293,Private      ,30,27,57,128,38,166
00861700,RABBINICAL SEM MKOR CHAIM-YESHIVA       ,NY,11219-4300,Private      ,9,0,9,14,0,14
00878800,SUNY-STUDENT LOAN SERVICE CENTER        ,NY,12144-3440,Public       ,1,0,1,22,7,29
00900300,OLEAN BUSINESS INSTITUTE INC            ,NY,14760-2691,Proprietary  ,0,5,5,36,71,107
00902900,NEIGHBORHOOD PLAYHOUSE                  ,NY,10022-5017,Private      ,0,2,2,21,25,46
00904300,ELMIRA BUSINESS INSTITUTE               ,NY,14901-2731,Proprietary  ,29,141,170,141,776,917
00907700,UTICA SCHOOL OF COMMERCE                ,NY,13501-2280,Proprietary  ,8,28,36,157,381,538
00924800,SAMARITAN HOSPITAL SCH NURSING          ,NY,12180-2475,Private      ,0,0,0,47,161,208
00928300,MIDWAY-PARIS BEAUTY SCHOOL              ,NY,11385-3453,Proprietary  ,5,15,20,27,84,111
00928400,LEARNING INST FOR BEAUTY SCIENCES       ,NY,11756-1345,Proprietary  ,13,61,74,91,293,384
00933500,MESIVTA EASTERN PKWY RABBINICAL CLG     ,NY,11218-5559,Private      ,1,0,1,21,6,27
00947900,SAINT VINCENTS CMC SI NURSING SCHOOL    ,NY,10304-3850,Private      ,2,5,7,52,126,178
00976900,METROPOLITAN COLLEGE OF NEW YORK        ,NY,10013-1919,Private      ,19,126,145,168,1543,1711
00992900,SUNY COLLEGE OF OPTOMETRY               ,NY,10036-8003,Public       ,0,0,0,17,333,350
01005100,LA GUARDIA CMTY COLLEGE - CUNY          ,NY,11101-3083,Public       ,890,877,1767,8753,6876,15629
01005200,JEFFERSON-LEWIS BOCES PRAC NRSGPRG      ,NY,13601-9509,Public       ,1,6,7,17,98,115
01009700,CUNY-MEDGAR W EVERS COLLEGE             ,NY,11225-2010,Public       ,259,418,677,3803,4718,8521
01014200,TOURO COLLEGE                           ,NY,10010-4202,Private      ,322,787,1109,3130,11209,14339
01014700,WESTERN SUFFOLK BOCES                   ,NY,11768-3499,Public       ,12,54,66,65,311,376
01015300,HELENE FULD COL OF NRSNG/N GEN HOSP     ,NY,10035-0000,Private      ,0,54,54,28,437,465
01028600,EMPIRE STATE COLLEGE                    ,NY,12866-4391,Public       ,59,709,768,736,10571,11307
01037800,RABBINICAL COLLEGE OF LONG ISLAND       ,NY,11561-3244,Private      ,12,0,12,44,0,44
01054900,KEHILATH YAKOV RABBINICAL SEMINARY      ,NY,10562-1001,Private      ,7,9,16,29,12,41
01055100,NEW YORK SCH MED & DENTAL ASSISTANT     ,NY,11101-2327,Proprietary  ,35,75,110,208,404,612
01064100,SOUTHERN WESTCHESTER BOCES              ,NY,10543-0000,Public       ,2,1,3,12,121,133
01068400,ERIE COMMUNITY COLLEGE-ALL CAMPUSES     ,NY,14203-2698,Public       ,443,443,886,7816,6539,14355
01081300,AMERICAN ACAD MCALLISTER INST           ,NY,10019-3604,Private      ,2,10,12,70,259,329
01083700,SIMMONS INST OF FUNERAL SERVICE         ,NY,13207-2098,Proprietary  ,1,1,2,27,27,54
01093000,SUBURBAN TECHNICAL SCHOOL               ,NY,11550-3771,Proprietary  ,40,126,166,120,480,600
01094300,RABBINICAL COLLEGE BETH SHRAGA          ,NY,10952-3033,Private      ,1,0,1,7,0,7
01095200,PNW BOCES LPN PROGRAM                   ,NY,10598-0000,Public       ,1,1,2,9,82,91
01103100,TECHNICAL CAREER INSTITUTE              ,NY,10001-2789,Proprietary  ,360,603,963,2673,4776,7449
01118900,UNITED TALMUDICAL SEMINARY              ,NY,11211-7984,Private      ,142,259,401,592,431,1023
01161400,CHAMPLAIN VALLEY HOSP SCH RAD TECH      ,NY,12901-1490,Private      ,0,0,0,18,8,26
01161700,NEW YORK METHODIST HOSPITAL             ,NY,11229-9023,Private      ,2,8,10,32,88,120
01164700,SBI CAMPUS - AN AFFILIATE OF SANFORD-BRO,NY,11747-3785,Proprietary  ,38,65,103,415,608,1023
01167000,YESHIVA OF NITRA RABBINICAL COLLEGE     ,NY,11211-7108,Private      ,76,17,93,81,18,99
01167700,MEMORIAL SLOAN KETTERING CANCER CTR     ,NY,10021-6094,Private      ,0,0,0,1,13,14
01167800,SUNY INST OF TECHNOLOGY UTICA ROME      ,NY,13504-3050,Public       ,33,43,76,1610,1079,2689
01182100,YESHIVATH ZICHRON MOSHE                 ,NY,12779-0580,Private      ,31,5,36,84,6,90
01183000,BERK TRADE AND BUSINESS SCHOOL          ,NY,11101-0000,Proprietary  ,7,34,41,43,109,152
01185900,WORD OF LIFE BIBLE INSTITUTE            ,NY,12860-0129,Private      ,9,1,10,509,71,580
01186000,MERCY MED CNTR SCHL OF RADIOGRAPHY      ,NY,11570-1098,Private      ,0,0,0,1,4,5
01192100,WESTCHESTER SCH OF BEAUTY CULTURE       ,NY,10550-2295,Proprietary  ,2,10,12,14,57,71
01192200,BETH HATALMUD RABBINICAL CLG            ,NY,11214-2594,Private      ,32,0,32,32,0,32
01198400,OHR HAMEIR THEOLOGICAL SEMINARY         ,NY,10566-0990,Private      ,20,0,20,66,2,68
01201100,TALMUDICAL SEM OHOLEI TORAH             ,NY,11213-3310,Private      ,74,0,74,196,0,196
01207200,PHILLIPS HAIRSTYLING INSTITUTE          ,NY,13210-1509,Proprietary  ,8,19,27,39,121,160
01210700,INSTITUTE OF DESIGN & CONSTRUCTION      ,NY,11201-5380,Private      ,5,19,24,35,112,147
01220300,MEMORIAL HOSPITAL SCH OF NURSING        ,NY,12204-1083,Private      ,1,3,4,42,120,162
01227700,NEW YORK CHIROPRACTIC COLLEGE           ,NY,13148-0800,Private      ,1,15,16,14,735,749
01229300,VEEB NASSAU CNTY SCHL OF PRACT NURS     ,NY,11553-3037,Public       ,1,4,5,41,202,243
01235800,PLAZA COLLEGE                           ,NY,11372-6300,Proprietary  ,94,149,243,607,1100,1707
01236400,SAINT VINCENTS CATHOLIC MEDICAL CENTERS ,NY,11365-1535,Private      ,1,8,9,45,156,201
01240700,SCHUYLER-CHEMUNG-TIOGA BOCES            ,NY,14903-1089,Public       ,0,1,1,24,126,150
01240701,STEUBEN SCHUYLER CHEMUNG TIOGA ALLEGANY ,NY,14870-9518,Public       ,0,0,0,1,2,3
01256100,FIVE TOWNS COLLEGE                      ,NY,11746-5871,Proprietary  ,32,18,50,1412,269,1681
01258900,ERIE 1 BOCES                            ,NY,14224-0000,Public       ,8,59,67,54,265,319
01265200,ONONDAGA CORTLAND MADISON BOCES         ,NY,13090-4500,Public       ,28,140,168,176,643,819
01278300,OSWEGO COUNTY BOCES ADULT CAREERS       ,NY,13114-4498,Public       ,2,19,21,32,100,132
01292700,CENTRAL TECH NURSING PROGRAM            ,NY,13202-3092,Public       ,1,2,3,17,79,96
01302600,MACHZIKEI HADATH RABBINICAL COLLEGE     ,NY,11204-1805,Private      ,12,2,14,24,3,27
01302700,YESHIVATH VIZNITZ                       ,NY,10952-3021,Private      ,111,22,133,111,23,134
01302900,BORICUA COLLEGE                         ,NY,10032-1599,Private      ,65,145,210,390,1235,1625
02056400,CAPRI COSMETOLOGY LEARNING CENTER       ,NY,10954-0000,Proprietary  ,16,41,57,85,145,230
02066200,THE NEW SCHOOL                          ,NY,10011-0000,Private      ,81,159,240,4918,5316,10234
02069000,NEW YORK SCHOOL OF INTERIOR DESIGN      ,NY,10021-0000,Private      ,6,5,11,163,259,422
02075700,BRIARCLIFFE COLLEGE                     ,NY,11714-0000,Proprietary  ,35,44,79,1087,701,1788
02075702,BRIARCLIFFE COLLEGE - PATCHOGUE         ,NY,11772-3019,Proprietary  ,35,47,82,729,524,1253
02092400,RIDLEY-LOWELL SCHOOL OF BUSINESS        ,NY,13905-0000,Proprietary  ,1,54,55,39,241,280
02093700,LONG ISLAND BUSINESS INSTITUTE          ,NY,11725-0000,Proprietary  ,67,167,234,480,1338,1818
02098400,HERKIMER COUNTY BOCES                   ,NY,13350-0000,Public       ,1,0,1,43,87,130
02104300,OTSEGO AREA SCHOOL OF PRAC NURSING      ,NY,13820-0000,Public       ,0,2,2,10,33,43
02105900,HAIR DESIGN INSTITUTE AT FIFTH AVE      ,NY,11220-0000,Proprietary  ,3,15,18,21,71,92
02106800,BRAMSON ORT COLLEGE                     ,NY,11375-0000,Private      ,65,103,168,404,608,1012
02110900,CATTARAUGUS/ALLEGANY BOCES              ,NY,14760-0000,Public       ,0,0,0,26,102,128
02116011,SANFORD-BROWN INSTITUTE - NEW YORK      ,NY,10003-2103,Proprietary  ,130,290,420,681,1918,2599
02118700,LONG ISLAND COLLEGE HOSPITAL - SCHOOL OF,NY,11201-6001,Private      ,1,8,9,118,294,412
02118702,LONG ISLAND COLLEGE HOSPITAL - SCHOOL OF,NY,11201-6001,Private      ,3,4,7,52,44,96
02124000,ORANGE ULSTER BOCES SCH OF PRAC NRS     ,NY,10924-9401,Public       ,0,1,1,18,99,117
02125500,CIRCLE IN THE SQUARE THEATRE SCHOOL     ,NY,10019-0000,Private      ,0,1,1,51,60,111
02126300,MADISON-ONEIDA BOCES PRAC NRS           ,NY,13478-0000,Public       ,1,35,36,25,179,204
02138500,BOCES RENSSELAER SCH OF PRAC NRSG       ,NY,12033-3221,Public       ,0,0,0,12,74,86
02145800,CAYUGA ONONDAGA BOCES                   ,NY,13021-9430,Public       ,0,0,0,15,60,75
02146000,WAYNE-FINGER LAKES BOCES                ,NY,14513-0000,Public       ,0,0,0,29,146,175
02152000,YESHIVA SHAAR HATORAH ITRI TORAH        ,NY,11418-0000,Private      ,1,0,1,3,0,3
02153600,BROOME-TIOGA BOCES PN PROG              ,NY,13905-0000,Public       ,0,4,4,22,81,103
02157900,ROCHESTER GENERAL HOSPITAL              ,NY,14621-3001,Private      ,0,1,1,17,117,134
02158200,WSHNGTN-SARTGA-WARN-HMLTN-ESX BOCES     ,NY,12839-1051,Public       ,0,0,0,25,118,143
02160100,GENEVA GENERAL HOSPITAL                 ,NY,14456-0000,Private      ,1,2,3,28,70,98
02163400,NEW YORK CAREER INSTITUTE               ,NY,10007-2801,Proprietary  ,15,60,75,201,621,822
02169100,DAVIS COLLEGE                           ,NY,13790-0000,Private      ,2,5,7,190,109,299
02170000,SWEDISH INSTITUTE                       ,NY,10001-0000,Proprietary  ,10,53,63,96,596,692
02170200,ALBANY SCHOHARIE SCHENECTADY            ,NY,12205-0000,Public       ,0,2,2,31,133,164
02171900,AILEY SCHOOL (THE)                      ,NY,10019-4402,Private      ,3,2,5,69,18,87
02172100,HAMILTON-FULTON-MONTGOMERY BOCES        ,NY,12095-0000,Public       ,2,0,2,31,49,80
02172800,DUTCHESS COUNTY BOCES SCH PRAC NURS     ,NY,12601-0000,Public       ,1,17,18,27,147,174
02173200,EMPIRE BEAUTY SCHOOL                    ,NY,10001-0000,Proprietary  ,64,141,205,441,839,1280
02173201,LEARNING INSTITUTES FOR BEAUTY SCIENCES-,NY,11214-4347,Proprietary  ,0,3,3,0,7,7
02173900,ULSTER COUNTY BOCES PRACTICAL NRSG      ,NY,12466-0000,Public       ,2,10,12,27,122,149
02176000,CHERYL FELL'S SCHOOL OF BUSINESS        ,NY,14304-0000,Proprietary  ,0,3,3,9,42,51
02179400,EASTERN SUFFOLK BOCES                   ,NY,11713-0000,Public       ,3,5,8,125,465,590
02182200,NEW SCHOOL OF RADIO & TELEVISION        ,NY,12206-1106,Proprietary  ,1,1,2,25,26,51
02187300,DARKEI NOAM RABBINICAL COLLEGE          ,NY,11210-0000,Private      ,0,0,0,0,1,1
02191600,TORAH TEMIMAH TALMUDICAL SEMINARY       ,NY,11218-0000,Private      ,9,0,9,32,0,32
02192500,BELLEVUE HOSP CTR SCH RAD TECH          ,NY,10016-0000,Public       ,0,0,0,5,29,34
02193700,SAINT LAWRENCE LEWIS COUNTY BOCES       ,NY,13617-0000,Public       ,0,0,0,67,23,90
02193701,SAINT LAWRENCE LEWIS COUNTY BOCES - NORT,NY,13669-0798,Public       ,0,0,0,2,2,4
02193702,SAINT LAWRENCE LEWIS COUNTY BOCES - SOUT,NY,13642-0342,Public       ,0,0,0,2,1,3
02193703,SAINT LAWRENCE LEWIS COUNTY BOCES - ADUL,NY,13668-3238,Public       ,0,0,0,1,4,5
02199300,ORLEANS-NIAGARA BOCES                   ,NY,14132-0000,Public       ,2,10,12,14,68,82
02206000,HUNTER BUSINESS SCHOOL                  ,NY,11756-0000,Proprietary  ,24,153,177,145,659,804
02206001,HUNTER BUSINESS SCHOOL -                ,NY,11763-0000,Proprietary  ,1,2,3,23,8,31
02217800,D.HOPFER SCH NURSING AT MT.VRN HOSP     ,NY,10550-0000,Private      ,1,1,2,15,258,273
02219500,MILDRED ELLEY                           ,NY,12206-1513,Proprietary  ,40,202,242,270,1117,1387
02235600,ERIE 2-CHAUTAUQUA-CATTARAUGUS BOCES     ,NY,14006-0000,Public       ,5,21,26,28,150,178
02265100,YESHIVA DERECH CHAIM                    ,NY,11218-0000,Private      ,14,4,18,28,11,39
02265200,GLOBAL BUSINESS INSTITUTE               ,NY,11691-0000,Private      ,137,267,404,462,1041,1503
02272900,ROCKLAND COUNTY BOCES PRAC NRSG SCH     ,NY,10994-0000,Public       ,0,0,0,18,75,93
02275900,"MODERN WELDING SCHOOL, INC.             ",NY,12304-0000,Proprietary  ,3,14,17,60,97,157
02287800,NATIONAL TRACTOR TRAILER SCHOOL         ,NY,13088-2505,Proprietary  ,9,137,146,31,458,489
02294900,INSTITUTE OF AUDIO RESEARCH             ,NY,10003-0000,Proprietary  ,42,47,89,462,413,875
02306500,PROFESSIONAL BUSINESS INSTITUTE         ,NY,10002-0000,Private      ,86,115,201,544,807,1351
02314200,NORTHERN WESTCHESTER SCH COSMETOL       ,NY,10566-0000,Proprietary  ,4,5,9,15,29,44
02320100,OHR SOMAYACH TANENBAUM EDUCATIONAL CENTE,NY,10952-0000,Private      ,0,0,0,3,0,3
02325600,NEW YORK INSTITUTE OF ENGLISH & BUS     ,NY,10001-0000,Private      ,21,61,82,92,340,432
02349700,RABBINICAL SEMINARY ADAS YEREIM         ,NY,11211-0000,Private      ,1,20,21,1,20,21
02350600,YESHIVA AND KOLLEL HARBOTZAS TORAH      ,NY,11230-0000,Private      ,0,3,3,0,16,16
02454300,NEW YORK UNIVERSITY SCHOOL OF MEDICINE  ,NY,10016-6497,Private      ,3,17,20,218,1247,1465
02491400,SPANISH AMERICAN INSTITUTE              ,NY,10036-0000,Private      ,2,4,6,6,19,25
02505800,YESHIVA KARLIN STOLIN RAB INSTITUTE     ,NY,11204-0000,Private      ,11,9,20,17,26,43
02505900,SH-OR YOSHUV RABBINICAL COLLEGE         ,NY,11691-0000,Private      ,8,2,10,27,13,40
02506000,ASSOCIATED BETH RIVKAH SCHOOLS          ,NY,11225-0000,Private      ,3,1,4,61,7,68
02506100,CITY UNIV OF NEW YORK-CENTRAL           ,NY,10021-0000,Public       ,21,13,34,542,328,870
02506200,MERCE CUNNINGHAM STUDIO                 ,NY,10014-0000,Private      ,0,1,1,1,6,7
02506800,YESHIVAT MIKDASH MELECH                 ,NY,11230-0000,Private      ,2,7,9,12,9,21
02511500,JOFFREY BALLET SCHOOL                   ,NY,10011-0000,Proprietary  ,8,0,8,48,4,52
02513500,MAR JON SCHOOL OF BEAUTY CULTURE        ,NY,14150-0000,Proprietary  ,3,8,11,20,59,79
02525600,ART INSTITUTE OF NEW YORK CITY(THE)     ,NY,10013-1917,Proprietary  ,101,83,184,1956,1159,3115
02540800,"GLOBE INSTITUTE OF TECHNOLOGY, INC.     ",NY,10007-0000,Proprietary  ,24,30,54,382,439,821
02546000,TRI-STATE COLLEGE OF ACUPUNCTURE        ,NY,10011-0000,Proprietary  ,0,1,1,4,149,153
02546300,YESHIVA OF THE TELSHE ALUMNI            ,NY,10471-0000,Private      ,14,0,14,15,0,15
02550600,TALMUDICAL INST OF UPSTATE NY           ,NY,14607-0000,Private      ,4,1,5,6,3,9
02556700,SEMINAR L'MOROS BAIS YAAKOV             ,NY,11219-0000,Private      ,13,0,13,252,1,253
02572900,BUSINESS INFORMATICS CENTER             ,NY,11580-0000,Proprietary  ,3,12,15,47,108,155
02575400,FRENCH CULINARY INSTITUTE               ,NY,10013-2618,Proprietary  ,23,83,106,247,557,804
02587600,ORLO SCH HAIR DESIGN & COSMETOLOGY      ,NY,12206-1723,Proprietary  ,13,22,35,97,103,200
02599400,NEW YORK COLLEGE OF HEALTH PROFESSIONS  ,NY,11791-4413,Private      ,12,51,63,191,717,908
02600100,NEW YORK ACADEMY OF ART (THE)           ,NY,10013-2911,Private      ,4,4,8,63,139,202
02614900,SANFORD-BROWN INSTITUTE                 ,NY,10604-2910,Proprietary  ,22,109,131,188,623,811
02615001,SANFORD-BROWN INSTITUTE - GARDEN CITY   ,NY,11530-4734,Proprietary  ,0,4,4,15,35,50
02616600,SHEAR EGO INTL SCH OF HAIR DESIGN       ,NY,14617-3501,Proprietary  ,8,31,39,55,119,174
02617000,CONTINENTAL SCH OF BEAUTY CULTURE       ,NY,14020-1908,Proprietary  ,7,35,42,60,147,207
02617001,CONTINENTAL SCHOOL OF BEAUTY CULTURE - O,NY,14760-2618,Proprietary  ,0,0,0,1,4,5
02622900,BAIS MEDRASH ELYON                      ,NY,10952-3013,Private      ,4,1,5,14,2,16
03000100,YESHIVA GEDOLAH IMREI YOSEF DSPINKA     ,NY,11219-4696,Private      ,10,22,32,12,86,98
03007200,DANCE THEATRE OF HARLEM                 ,NY,10031-0000,Private      ,0,0,0,16,1,17
03027701,PACIFIC COLLEGE OF ORIENTAL MEDICINE - N,NY,10010-7108,Proprietary  ,2,32,34,12,332,344
03081600,DELAWARE CHENANGO MADISON OT. BOCES     ,NY,13815-9554,Public       ,7,33,40,17,82,99
03088500,NEW YORK INTERNATIONAL BEAUTY SCH       ,NY,10019-0000,Proprietary  ,10,54,64,60,202,262
03089700,COMPUTER CAREER CENTER                  ,NY,11530-3334,Proprietary  ,85,361,446,374,1564,1938
03095500,ASA INST BUSINESS & COMPUTER TECH       ,NY,11201-5208,Proprietary  ,355,686,1041,1601,4276,5877
03096200,CHARLES STUART SCHOOL                   ,NY,11229-2004,Proprietary  ,0,10,10,9,45,54
03097801,CARSTEN INSTITUTE                       ,NY,10003-1901,Proprietary  ,0,1,1,5,13,18
03099100,SUNBRIDGE COLLEGE                       ,NY,10977-0000,Private      ,0,0,0,2,50,52
03103700,ADIRONDACK BEAUTY SCHOOL                ,NY,12801-3158,Proprietary  ,0,7,7,20,30,50
03104900,SULLIVAN COUNTY BOCES                   ,NY,12754-2116,Public       ,0,0,0,19,49,68
03111100,NEW YORK PARALEGAL SCHOOL               ,NY,10007-1901,Proprietary  ,1,0,1,18,43,61
03115300,GENESEE VALLEY BOCES                    ,NY,14020-1099,Public       ,1,23,24,22,148,170
03120700,NEW YORK CONSERVATORY FOR DRAMATIC ARTS ,NY,10011-4225,Proprietary  ,14,3,17,390,92,482
03127100,YESHIVAS NOVOMINSK                      ,NY,11219-0000,Private      ,20,0,20,28,1,29
03129200,RABBINICAL CLG OHR SHIMAR YISROEL       ,NY,11211-8102,Private      ,11,43,54,55,74,129
03169300,STUDIO JEWELERS                         ,NY,10016-4112,Proprietary  ,3,1,4,4,12,16
03172400,CALIBER TRAINING INSTITUTE              ,NY,10018-6504,Proprietary  ,0,0,0,21,66,87
03181400,MERKAZ BNOS                             ,NY,11204-0000,Private      ,1,91,92,14,305,319
03191300,CUNY SCHOOL OF LAW @ QUEENS COLLEGE     ,NY,11367-0000,Public       ,6,11,17,182,1135,1317
03193300,MANHATTAN SCHOOL OF COMPUTER TECH       ,NY,11230-1617,Private      ,12,88,100,59,340,399
03203300,NEW YORK INSTITUTE OF MASSAGE           ,NY,14221-6021,Proprietary  ,5,18,23,57,147,204
03216300,UNIFICATION THEOLOGICAL SEMINARY        ,NY,12507-5021,Private      ,0,1,1,1,15,16
03315300,HARLEM SCHOOL OF TECHNOLOGY             ,NY,10027-4426,Proprietary  ,0,0,0,11,42,53
03328300,FRANKLIN CAREER INSTITUTE               ,NY,11550-3003,Private      ,52,133,185,281,623,904
03342400,AMERICAN BARBER INSTITUTE               ,NY,10001-5271,Proprietary  ,18,37,55,72,166,238
03358300,ALLEN SCHOOL                            ,NY,11432-4901,Proprietary  ,80,384,464,362,1548,1910
03361500,WILLSEY INSTITUTE                       ,NY,10301-1989,Proprietary  ,0,0,0,16,68,84
03380300,CULINARY ACADEMY OF LONG ISLAND         ,NY,11791-5311,Proprietary  ,18,32,50,107,224,331
03419400,NORTHEASTERN SEMINARY                   ,NY,14624-1997,Private      ,0,5,5,2,102,104
03426400,ANTHEM INSTITUTE                        ,NY,10018-0000,Proprietary  ,67,133,200,499,757,1256
03433500,LIA SCHORR INSTITUTE OF COSMETIC SK     ,NY,10022-2614,Proprietary  ,2,10,12,6,63,69
03443300,NEW YORK COLLEGE OF TRADITIONAL CHINESE ,NY,11501-0000,Private      ,0,8,8,1,64,65
03496300,YESHIVA SHAAREI TORAH OF ROCKLAND       ,NY,10901-4003,Private      ,5,1,6,5,1,6
03537300,NEW YORK AUTOMOTIVE & DIESEL INSTIT     ,NY,11101-0000,Proprietary  ,30,67,97,168,265,433
03568300,LEON STUDIO ONE SCHOOL OF HAIR DESI     ,NY,14221-5323,Proprietary  ,3,12,15,48,80,128
03651300,SAINT JOSEPH'S MEDICAL CENTER SCHOO     ,NY,10701-4080,Private      ,2,1,3,13,16,29
03652300,METROPOLITAN LEARNING INSTITUTE         ,NY,11375-0000,Private      ,4,90,94,21,621,642
03691300,USA BEAUTY SCHOOL INTERNATIONAL         ,NY,10013-3530,Proprietary  ,2,44,46,27,394,421
03713300,BEIS MEDRASH HEICHAL DOVID              ,NY,11691-4433,Private      ,16,10,26,18,11,29
03773300,CENTER FOR NATURAL WELLNESS SCHOOL OF MA,NY,12205-1601,Proprietary  ,6,27,33,30,130,160
03802300,UTA MESIVTA OF KIRYAS JOEL              ,NY,10950-2169,Private      ,292,274,566,470,380,850
03809400,MICROPOWER CAREER INSTITUTE             ,NY,10001-2812,Proprietary  ,12,121,133,20,216,236
03819400,HUDSON VALLEY SCHOOL OF ADVANCED AESTHET,NY,12561-1401,Proprietary  ,2,8,10,21,29,50
03839300,AVEDA INSTITUTE NEW YORK                ,NY,10013-1522,Proprietary  ,14,41,55,104,212,316
03881300,UNION GRADUATE COLLEGE                  ,NY,12308-3103,Private      ,0,15,15,29,177,206
03903400,AMERICAN BEAUTY SCHOOL                  ,NY,10462-8003,Proprietary  ,22,57,79,76,280,356
03941400,ELITE ACADEMY OF BEAUTY ARTS            ,NY,11223-1630,Proprietary  ,2,11,13,21,92,113
03983300,"SCHOOL OF PROFESSIONAL HORTICULTURE, AT ",NY,10458-5126,Private      ,0,4,4,0,15,15
04043300,ACE COMPUTER TRAINING CENTER            ,NY,11375-5337,Proprietary  ,0,6,6,8,39,47
04095300,KING'S COLLEGE (THE)                    ,NY,10018-0110,Private      ,4,1,5,294,21,315
04102300,NEW AGE TRAINING                        ,NY,10018-0000,Proprietary  ,1,9,10,12,65,77
04115500,TALMUDICAL SEMINARY OF BOBOV            ,NY,11219-3826,Private      ,37,43,80,49,44,93
04117700,"MONROE 2-ORLEANS BOCES, CENTER FOR WORK ",NY,14624-1119,Public       ,3,4,7,14,33,47
04123200,INSTITUTE OF ALLIED MEDICAL PROFESSIONS ,NY,11373-5541,Private      ,30,154,184,121,620,741
04123300,HUDSON VALLEY SCHOOL OF MASSAGE THERAPY ,NY,12528-1426,Proprietary  ,0,12,12,9,42,51
04125600,CAREER SCHOOL OF NY                     ,NY,10301-2416,Private      ,5,13,18,27,37,64
04134000,"JOHN PAUL'S HAIR, NAIL & SKIN CARE INSTI",NY,12020-1245,Proprietary  ,6,27,33,6,28,34
04137700,ANN MARIE'S WORLD OF BEAUTY SCHOOL      ,NY,13901-2308,Proprietary  ,1,3,4,3,7,10
00267808,BRYANT & STRATTON COLLEGE - PARMA       ,OH,44130-0000,Proprietary  ,65,297,362,649,3179,3828
00301000,ANTIOCH UNIVERSITY                      ,OH,45387-1608,Private      ,1,86,87,109,155,264
00301001,ANTIOCH UNIVERSITY MCGREGOR             ,OH,45387-0000,Private      ,0,0,0,12,673,685
00301010,ANTIOCH UNIVERSITY                      ,OH,45387-0000,Private      ,0,0,0,13,115,128
00301100,ART ACADEMY OF CINCINNATI               ,OH,45202-7106,Private      ,2,1,3,262,69,331
00301200,ASHLAND UNIVERSITY                      ,OH,44805-3799,Private      ,25,197,222,3256,2993,6249
00301300,ATHENAEUM OF OHIO                       ,OH,45230-2000,Private      ,0,1,1,2,8,10
00301400,BALDWIN-WALLACE COLLEGE                 ,OH,44017-2088,Private      ,33,63,96,4302,1439,5741
00301600,BLUFFTON UNIVERSITY                     ,OH,45817-2104,Private      ,12,12,24,1397,329,1726
00301800,BOWLING GREEN STATE UNIVERSITY          ,OH,43403-0001,Public       ,206,191,397,16392,5294,21686
00302300,CAPITAL UNIVERSITY                      ,OH,43209-2394,Private      ,32,70,102,3695,2537,6232
00302400,CASE WESTERN RESERVE UNIV               ,OH,44106-0000,Private      ,30,23,53,5995,963,6958
00302401,CASE WESTERN RESERVE UNIV - MED         ,OH,44106-0000,Private      ,0,3,3,43,1053,1096
00302402,CASE WESTERN RESERVE UNIV - DENTAL      ,OH,44106-0000,Private      ,0,3,3,15,298,313
00302403,CASE WESTERN RESERVE UNIV - LAW         ,OH,44106-0000,Private      ,0,5,5,8,1306,1314
00302404,CASE WESTERN RESERVE UNIV - UG          ,OH,44106-0000,Private      ,3,3,6,514,63,577
00302405,CASE WESTERN RESERVE UNIV - MSASS       ,OH,44106-0000,Private      ,0,1,1,6,424,430
00302406,CASE WESTERN RESERVE UNIV - NURS UG     ,OH,44106-0000,Private      ,0,4,4,209,126,335
00302407,CASE WESTERN RESERVE UNIV - WSOM        ,OH,44106-0000,Private      ,0,9,9,15,298,313
00302408,CASE WESTERN RESERVE UNIV -A&S GRAD     ,OH,44106-0000,Private      ,1,6,7,13,325,338
00302409,CASE WESTERN RESERVE UNIV -ENG GRAD     ,OH,44106-0000,Private      ,1,1,2,22,92,114
00302410,CASE WESTERN RESERVE UNIV -NURS GRD     ,OH,44106-0000,Private      ,0,12,12,6,319,325
00302500,CEDARVILLE UNIVERSITY                   ,OH,45314-8564,Private      ,26,4,30,3601,187,3788
00302600,CENTRAL STATE UNIVERSITY                ,OH,45384-1004,Public       ,58,36,94,3529,1221,4750
00302900,CINCINNATI CHRISTIAN UNIVERSITY         ,OH,45204-3200,Private      ,15,36,51,543,587,1130
00303000,OHIO CHRISTIAN UNIVERSITY               ,OH,43113-9487,Private      ,8,109,117,361,836,1197
00303100,CLEVELAND INSTITUTE OF MUSIC            ,OH,44106-1776,Private      ,3,1,4,444,334,778
00303200,CLEVELAND STATE UNIVERSITY              ,OH,44115-2214,Public       ,144,551,695,7181,12647,19828
00303300,COLLEGE OF MT ST JOSEPH                 ,OH,45233-1670,Private      ,12,48,60,1548,1046,2594
00303500,OHIO DOMINICAN UNIVERSITY               ,OH,43219-2099,Private      ,29,203,232,2430,2478,4908
00303600,FRANCISCAN UNIV OF STEUBENVILLE         ,OH,43952-1763,Private      ,19,27,46,2149,675,2824
00303700,COLLEGE OF WOOSTER                      ,OH,44691-2363,Private      ,24,3,27,2866,59,2925
00303900,COLUMBUS COLLEGE OF ART AND DESIGN      ,OH,43215-1758,Private      ,24,13,37,1746,385,2131
00304000,CUYAHOGA COMMUNITY COLLEGE              ,OH,44115-2878,Public       ,249,1025,1274,5946,16950,22896
00304001,CUYAHOGA COMMUNITY CLG-EASTERN CAM      ,OH,44122-6195,Public       ,14,45,59,528,1083,1611
00304002,CUYAHOGA COMMUNITY CLG-METRO CAMPUS     ,OH,44115-0000,Public       ,21,138,159,853,2233,3086
00304003,CUYAHOGA COMMUNITY CLG-WESTERN CMPS     ,OH,44130-0000,Public       ,38,81,119,1348,1465,2813
00304100,"DEFIANCE COLLEGE, THE                   ",OH,43512-1695,Private      ,8,10,18,1202,358,1560
00304200,DENISON UNIVERSITY                      ,OH,43023-1329,Private      ,22,4,26,2773,37,2810
00304300,CHANCELLOR UNIVERSITY                   ,OH,44114-1096,Private      ,3,69,72,54,590,644
00304400,TRINITY LUTHERAN SEMINARY               ,OH,43209-0000,Private      ,0,2,2,0,153,153
00304500,UNIVERSITY OF FINDLAY                   ,OH,45840-3695,Private      ,22,55,77,3129,1396,4525
00304600,FRANKLIN UNIVERSITY                     ,OH,43215-5399,Private      ,46,436,482,904,8301,9205
00304606,FRANKLIN UNIVERSITY - NORTHWEST         ,OH,43019-5331,Private      ,0,0,0,5,35,40
00304608,FRANKLIN UNIVERSITY - NORTHEAST         ,OH,43081-1111,Private      ,0,0,0,11,39,50
00304700,HEBREW UNION COLLEGE MAIN CAMPUS        ,OH,45220-0000,Private      ,0,0,0,0,114,114
00304800,HEIDELBERG UNIVERSITY                   ,OH,44883-2462,Private      ,16,12,28,1927,318,2245
00304900,HIRAM COLLEGE                           ,OH,44234-1808,Private      ,9,11,20,1706,301,2007
00305000,JOHN CARROLL UNIVERSITY                 ,OH,44118-4581,Private      ,24,43,67,4103,914,5017
00305100,KENT STATE UNIV - KENT CAMPUS           ,OH,44242-0001,Public       ,243,317,560,18369,8863,27232
00305101,KENT STATE UNIV - GEAUGA CAMPUS         ,OH,44021-0000,Public       ,4,27,31,320,448,768
00305102,KENT STATE UNIV - STARK CAMPUS          ,OH,44720-0000,Public       ,53,91,144,2048,1930,3978
00305103,KENT STATE UNIV - TUSCARAWAS CAMPUS     ,OH,44663-0000,Public       ,21,70,91,875,1140,2015
00305104,KENT STATE UNIV - TRUMBULL CAMPUS       ,OH,44483-0000,Public       ,29,146,175,840,1429,2269
00305105,KENT STATE UNIV - ASHTABULA CAMPUS      ,OH,44004-0000,Public       ,30,81,111,697,1259,1956
00305106,KENT STATE UNIV -E.LIVERPOOL CAMPUS     ,OH,43920-0000,Public       ,8,41,49,357,604,961
00305107,KENT STATE UNIV - SALEM CAMPUS          ,OH,44460-0000,Public       ,18,38,56,671,839,1510
00306500,KENYON COLLEGE                          ,OH,43022-9623,Private      ,16,1,17,2539,38,2577
00306600,LAKE ERIE COLLEGE                       ,OH,44077-3389,Private      ,10,15,25,1156,387,1543
00306800,LORAIN COUNTY COMMUNITY COLLEGE         ,OH,44035-1691,Public       ,145,613,758,3169,6350,9519
00306900,LOURDES COLLEGE                         ,OH,43560-2898,Private      ,13,61,74,691,1774,2465
00307200,MALONE UNIVERSITY                       ,OH,44709-3897,Private      ,20,84,104,2038,1228,3266
00307300,MARIETTA COLLEGE                        ,OH,45750-4033,Private      ,20,19,39,2500,294,2794
00307500,METHODIST THEOLOGICAL SCH IN OHIO       ,OH,43015-0000,Private      ,0,3,3,0,221,221
00307600,MIAMI-JACOBS COLLEGE                    ,OH,45401-0000,Proprietary  ,23,211,234,155,1472,1627
00307602,MIAMI - JACOBS CAREER COLLEGE - SPRINGBO,OH,45066-1115,Proprietary  ,13,123,136,133,696,829
00307603,MIAMI - JACOBS CAREER COLLEGE - TROY    ,OH,45373-3837,Proprietary  ,23,171,194,164,818,982
00307700,MIAMI UNIVERSITY                        ,OH,45056-1831,Public       ,195,214,409,16796,5530,22326
00307800,WRIGHT STATE UNIVERSITY                 ,OH,45435-0002,Public       ,190,472,662,11848,8919,20767
00308300,MOUNT UNION COLLEGE                     ,OH,44601-3993,Private      ,17,6,23,3193,161,3354
00308400,MUSKINGUM COLLEGE                       ,OH,43762-1199,Private      ,15,65,80,2290,592,2882
00308500,NOTRE DAME COLLEGE OF OHIO              ,OH,44121-4293,Private      ,21,52,73,1260,1133,2393
00308600,OBERLIN COLLEGE                         ,OH,44074-1090,Private      ,35,6,41,4623,127,4750
00308800,OHIO COLLEGE OF PODIATRIC MEDICINE      ,OH,44131-7304,Private      ,0,2,2,6,425,431
00308900,OHIO NORTHERN UNIVERSITY                ,OH,45810-1555,Private      ,23,11,34,3999,1205,5204
00309000,OHIO STATE UNIVERSITY-ALL CAMPUSES      ,OH,43210-1358,Public       ,526,723,1249,42728,24018,66746
00310000,OHIO UNIVERSITY                         ,OH,45701-2979,Public       ,220,246,466,18335,4959,23294
00310002,"OHIO UNIVERSITY, ZANESVILLE CAMPUS      ",OH,43701-0000,Public       ,29,93,122,1023,1272,2295
00310003,"OHIO UNIVERSITY, LANCASTER CAMPUS       ",OH,43130-0000,Public       ,22,105,127,920,1155,2075
00310004,"OHIO UNIVERSITY, SOUTHERN CAMPUS        ",OH,45638-0000,Public       ,41,143,184,791,1477,2268
00310005,"OHIO UNIVERSITY, CHILLICOTHE CAMPUS     ",OH,45601-0000,Public       ,45,149,194,867,1685,2552
00310006,"OHIO UNIVERSITY, EASTERN CAMPUS         ",OH,43950-0000,Public       ,10,18,28,436,239,675
00310008,OHIO UNIV COLL OF OSTEOPATHIC MED       ,OH,45701-0000,Public       ,0,0,0,8,463,471
00310900,OHIO WESLEYAN UNIVERSITY                ,OH,43015-2398,Private      ,27,5,32,2740,115,2855
00311000,OTTERBEIN COLLEGE                       ,OH,43081-2006,Private      ,45,52,97,3861,1002,4863
00311300,PONTIFICAL COLLEGE JOSEPHINUM           ,OH,43235-1498,Private      ,0,1,1,29,28,57
00311401,FIRELANDS REGIONAL MEDICAL CENTER       ,OH,44870-4788,Private      ,0,1,1,70,123,193
00311500,RABBINICAL COLLEGE OF TELSHE            ,OH,44092-2584,Private      ,9,0,9,15,14,29
00311600,UNIV OF RIO GRANDE                      ,OH,45674-3131,Private      ,18,50,68,1741,1503,3244
00311601,UNIVERSITY OF RIO GRANDE                ,OH,45674-9989,Private      ,10,19,29,10,19,29
00311602,UNIVERSITY OF RIO GRANDE - MEIGS CENTER ,OH,45760-0000,Private      ,0,1,1,0,1,1
00311603,UNIVERSITY OF RIO GRANDE - CHILLICOTHE G,OH,45601-0000,Private      ,0,1,1,0,1,1
00311605,UNIVERSITY OF RIO GRANDE - COLUMBUS GRAD,OH,43215-0000,Private      ,0,2,2,0,2,2
00311607,UNIVERSITY OF RIO GRANDE -              ,OH,45764-0000,Private      ,0,1,1,0,1,1
00311900,SINCLAIR COMMUNITY COLLEGE              ,OH,45402-1460,Public       ,381,1539,1920,7055,14768,21823
00312100,TIFFIN UNIVERSITY                       ,OH,44883-2161,Private      ,42,172,214,1929,1973,3902
00312200,UNITED THEOLOGICAL SEMINARY             ,OH,45406-0000,Private      ,0,8,8,0,177,177
00312300,UNIVERSITY OF AKRON                     ,OH,44325-6211,Public       ,245,333,578,17858,12692,30550
00312500,UNIVERSITY OF CINCINNATI                ,OH,45221-0125,Public       ,403,1010,1413,21170,17736,38906
00312504,UNIV OF CINCINNATI-CLG MEDICINE         ,OH,45267-0552,Public       ,1,12,13,114,859,973
00312700,UNIVERSITY OF DAYTON                    ,OH,45469-0002,Private      ,74,135,209,9756,3643,13399
00313100,UNIVERSITY OF TOLEDO                    ,OH,43606-3390,Public       ,227,317,544,15992,7996,23988
00313101,UNIVERSITY OF TOLEDO - HEALTH SCIENCE CA,OH,43614-2598,Public       ,11,27,38,521,1620,2141
00313300,URBANA UNIVERSITY                       ,OH,43078-2091,Private      ,5,31,36,914,568,1482
00313400,URSULINE COLLEGE                        ,OH,44124-4398,Private      ,8,55,63,791,1183,1974
00313500,WALSH UNIVERSITY                        ,OH,44720-3396,Private      ,20,41,61,2432,1010,3442
00314100,WILBERFORCE UNIVERSITY                  ,OH,45384-1001,Private      ,16,19,35,1274,567,1841
00314200,WILMINGTON COLLEGE                      ,OH,45177-2499,Private      ,16,32,48,1957,512,2469
00314300,WITTENBERG UNIVERSITY                   ,OH,45501-2199,Private      ,23,7,30,2902,221,3123
00314400,XAVIER UNIVERSITY                       ,OH,45207-1035,Private      ,72,145,217,4966,2784,7750
00314500,YOUNGSTOWN STATE UNIVERSITY             ,OH,44555-0001,Public       ,161,274,435,8739,6887,15626
00398200,CLEVELAND INSTITUTE OF ART              ,OH,44106-1700,Private      ,5,4,9,743,184,927
00406000,WINEBRENNER THEOLOGICAL SEMINARY        ,OH,45840-0000,Private      ,0,1,1,0,64,64
00485200,CLARK STATE COMMUNITY COLLEGE           ,OH,45505-4795,Public       ,91,436,527,1338,3913,5251
00485300,BRADFORD SCHOOL                         ,OH,43219-0000,Proprietary  ,29,63,92,640,535,1175
00485500,DAVIS COLLEGE                           ,OH,43623-4307,Proprietary  ,12,86,98,138,804,942
00486100,UNIVERSITY OF NORTHWESTERN OHIO         ,OH,45805-1498,Private      ,89,155,244,3792,1211,5003
00486600,STAUTZENBERGER COLLEGE                  ,OH,43537-4007,Proprietary  ,51,168,219,403,1393,1796
00510200,SCH OF DIAGNOSTIC IMAGING-CLEVELAND     ,OH,44119-0000,Private      ,1,2,3,8,39,47
00512700,BROWN MACKIE COLLEGE-CINCINNATI         ,OH,45215-1107,Proprietary  ,282,1119,1401,1811,7097,8908
00512728,BROWN MACKIE COLLEGE-CINCINNATI - LANDMA,OH,45215-1231,Proprietary  ,0,12,12,8,55,63
00521000,CLEVELAND INSTITUTE OF ELECTRONICS      ,OH,44114-0000,Proprietary  ,0,50,50,9,262,271
00531300,NORTH CENTRAL STATE COLLEGE             ,OH,44901-0000,Public       ,61,305,366,1218,2697,3915
00575300,OWENS STATE COMMUNITY COLLEGE           ,OH,43699-0000,Public       ,259,724,983,5718,11053,16771
00648700,AULTMAN COLLEGE OF NURSING AND HEALTH SC,OH,44710-1799,Private      ,4,12,16,139,294,433
00648900,CHRIST HOSP SCH OF NURSING              ,OH,45219-2989,Private      ,0,0,0,30,30,60
00649400,GOOD SAMARITAN COLG-NURSING/HEALTH      ,OH,45220-2489,Private      ,6,9,15,190,339,529
00649800,MERIDIA HURON SCHOOL OF NURSING         ,OH,44112-4308,Private      ,1,15,16,54,429,483
00650700,TRINIT HEALTH SYSTEM SCH OF NURSING     ,OH,43952-2667,Private      ,1,0,1,50,92,142
00680400,LAKELAND COMMUNITY COLLEGE              ,OH,44094-5198,Public       ,119,311,430,2746,5445,8191
00686700,COLUMBUS STATE COMMUNITY COLLEGE        ,OH,43215-1786,Public       ,488,1779,2267,11151,21364,32515
00703500,KETTERING COLLEGE OF MEDICAL ARTS       ,OH,45429-1299,Private      ,8,54,62,435,739,1174
00708500,MOUNT VERNON NAZARENE UNIVERSITY        ,OH,43050-9500,Private      ,8,46,54,1626,575,2201
00708501,MOUNT VERNON NAZARENE UNIV - AGS        ,OH,43050-0000,Private      ,3,89,92,47,956,1003
00727500,JEFFERSON COMMUNITY COLLEGE             ,OH,43952-3598,Public       ,31,59,90,817,1153,1970
00747300,CHOFFIN CAREER & TECHNICAL CENTER       ,OH,44503-1628,Public       ,1,6,7,45,214,259
00759800,HOCKING TECHNICAL COLLEGE               ,OH,45764-9582,Public       ,133,327,460,3517,3536,7053
00777700,REMINGTON COLLEGE - CLEVELAND CAMPUS    ,OH,44125-1957,Proprietary  ,35,281,316,283,1522,1805
00777704,REMINGTON COLLEGE-CLEVELAND WEST CAMPUS ,OH,44070-3129,Proprietary  ,20,108,128,156,537,693
00812900,ADULT AND COMMUNITY EDUCATION @ HUDSON  ,OH,43211-2017,Public       ,0,20,20,29,371,400
00813200,TOLEDO SCHOOL OF PRACTICAL NURSING      ,OH,43613-5110,Public       ,5,40,45,94,438,532
00813300,ZANE STATE COLLEGE                      ,OH,43701-2626,Public       ,62,244,306,1099,2220,3319
00819400,AKRON SCHOOL OF PRACTICAL NRSG          ,OH,44311-0000,Public       ,1,12,13,53,179,232
00827800,TERRA COMMUNITY COLLEGE                 ,OH,43420-9670,Public       ,35,119,154,753,1682,2435
00867700,NORTHWEST STATE COMMUNITY COLLEGE       ,OH,43502-9542,Public       ,21,163,184,1036,2338,3374
00888600,PORTAGE LAKES CAREER CENTER             ,OH,44232-0000,Public       ,0,3,3,30,127,157
00908800,ITT TECHNICAL INSTITUTE                 ,OH,45414-3456,Proprietary  ,86,320,406,740,1898,2638
00915600,WAYNE COUNTY SCHOOLS CAREER CENTER      ,OH,44677-9672,Public       ,1,12,13,42,225,267
00917200,SPRINGFIELD REGIONAL SCHOOL OF NURSING  ,OH,45501-1228,Private      ,3,10,13,67,194,261
00941200,NATIONAL INSTITUTE OF TECHNOLOGY        ,OH,44221-2998,Proprietary  ,37,136,173,313,809,1122
00945101,BROWN MACKIE COLLEGE-NORTH CANTON       ,OH,44720-0000,Proprietary  ,5,46,51,155,936,1091
00953000,GERBER AKRON BEAUTY SCHOOL              ,OH,44333-3714,Proprietary  ,2,8,10,16,96,112
00953100,SPA SCHOOL (THE)                        ,OH,43214-1524,Proprietary  ,5,26,31,26,113,139
00966000,TIFFIN ACADEMY OF HAIR DESIGN           ,OH,44883-2833,Proprietary  ,3,10,13,37,87,124
00983700,ITT TECHNICAL INSTITUTE                 ,OH,44509-4098,Proprietary  ,93,256,349,862,1826,2688
00994100,BELMONT TECHNICAL COLLEGE               ,OH,43950-9766,Public       ,36,147,183,918,1519,2437
00994200,SHAWNEE STATE UNIVERSITY                ,OH,45662-4344,Public       ,94,100,194,3671,2000,5671
01001700,PAYNE THEOLOGICAL SEMINARY              ,OH,45384-0474,Private      ,0,5,5,1,128,129
01002700,JAMES A. RHODES STATE COLLEGE           ,OH,45804-3597,Public       ,61,293,354,1613,3036,4649
01016800,NATIONWIDE BEAUTY ACADEMY               ,OH,43228-1000,Proprietary  ,12,56,68,196,431,627
01028000,OHIO STATE BEAUTY ACADEMY               ,OH,45801-4950,Proprietary  ,2,14,16,92,141,233
01032300,HANNAH E MULLINS SCH-PRAC NRSG          ,OH,44460-2906,Public       ,6,5,11,19,113,132
01034500,CINCINNATI STATE TECH & COMM CLG        ,OH,45223-2690,Public       ,298,879,1177,4247,8293,12540
01045300,WASHINGTON STATE CMTY COLLEGE           ,OH,45750-9225,Public       ,37,173,210,926,1559,2485
01063000,NORTHERN INSTITUTE OF COSMETOLOGY       ,OH,44052-1803,Proprietary  ,1,15,16,13,65,78
01073600,MARION TECHNICAL COLLEGE                ,OH,43302-5694,Public       ,17,158,175,658,1725,2383
01088000,CHATFIELD COLLEGE                       ,OH,45118-9705,Private      ,2,15,17,50,206,256
01088100,STARK STATE COLLEGE OF TECHNOLOGY       ,OH,44720-7299,Public       ,93,318,411,3061,6934,9995
01090600,CINCINNATI CLG OF MORTUARY SCIENCE      ,OH,45224-1428,Private      ,3,11,14,77,137,214
01092300,UNION INSTITUTE & UNIVERSITY            ,OH,45206-1925,Private      ,7,207,214,47,2108,2155
01096200,MOORE UNIV OF HAIR DESIGN               ,OH,45213-0000,Proprietary  ,1,2,3,5,30,35
01099300,HOBART INSTITUTE OF WELDING TECHNOLOGY  ,OH,45373-2400,Private      ,17,29,46,190,179,369
01100500,KAPLAN COLLEGE                          ,OH,43232-4827,Proprietary  ,37,162,199,237,1000,1237
01104600,CENTRAL OHIO TECHNICAL COLLEGE          ,OH,43055-1767,Public       ,91,356,447,1459,4516,5975
01170300,PENTA COUNTY JOINT VOCATIONAL SCH       ,OH,43551-0000,Public       ,0,2,2,24,100,124
01174400,NATIONAL BEAUTY COLLEGE                 ,OH,44720-0000,Proprietary  ,2,16,18,45,133,178
01174500,OHIO TECHNICAL COLLEGE                  ,OH,44103-1228,Proprietary  ,55,71,126,1190,471,1661
01182500,OHIO STATE SCHOOL OF COSMETOLOGY        ,OH,43224-1107,Proprietary  ,4,9,13,48,110,158
01212800,SOUTHWESTERN COLLEGE                    ,OH,45402-3003,Proprietary  ,43,271,314,263,1477,1740
01212802,SOUTHWESTERN COLLEGE                    ,OH,45005-2267,Proprietary  ,15,105,120,70,549,619
01212803,SOUTHWESTERN COLLEGE                    ,OH,45202-4304,Proprietary  ,38,184,222,196,1241,1437
01212804,SOUTHWESTERN COLLEGE                    ,OH,45246-3121,Proprietary  ,58,278,336,306,1806,2112
01216600,CAROUSEL BEAUTY COLLEGE                 ,OH,45402-8935,Proprietary  ,7,23,30,57,179,236
01224800,CENTRAL SCHOOL OF PRACTICAL NURSING     ,OH,44103-4371,Private      ,4,33,37,49,302,351
01267200,CAROUSEL BEAUTY COLLEGE                 ,OH,45044-5113,Proprietary  ,2,6,8,23,40,63
01267400,CAROUSEL OF MIAMI VALLEY BEAUTY CLG     ,OH,45424-2063,Proprietary  ,0,2,2,0,8,8
01275000,EDISON COMMUNITY COLLEGE                ,OH,45356-9239,Public       ,30,148,178,934,2021,2955
01283800,LAURA AND ALVIN SIEGAL COLLEGE OF JUDAIC,OH,44122-7197,Private      ,0,0,0,0,7,7
01284800,MOLER-HOLLYWOOD BEAUTY COLLEGE          ,OH,45202-2577,Proprietary  ,5,31,36,24,141,165
01287000,SOUTHERN STATE COMMUNITY COLLEGE        ,OH,45133-9406,Public       ,50,295,345,942,2273,3215
01289100,ANTONELLI COLLEGE                       ,OH,45202-2592,Proprietary  ,10,55,65,235,705,940
01289600,VIRGINIA MARTI COLLEGE OF ART AND DESIGN,OH,44107-0778,Proprietary  ,7,12,19,235,196,431
01313200,INTERNATIONAL CLG OF BROADCASTING       ,OH,45431-1898,Proprietary  ,7,16,23,67,137,204
02052000,OHIO INST OF PHOTOGRAPHY & TECHNOLOGY   ,OH,45439-1984,Proprietary  ,22,184,206,387,1109,1496
02054300,TRUMBULL BUSINESS COLLEGE               ,OH,44484-0000,Proprietary  ,7,74,81,103,506,609
02056800,DAYMAR COLLEGE                          ,OH,45601-1038,Proprietary  ,11,137,148,82,759,841
02056802,DAYMAR COLLEGE - LANCASTER              ,OH,43130-0000,Proprietary  ,1,4,5,6,27,33
02056803,DAYMAR COLLEGE - NEW BOSTON             ,OH,45662-4900,Proprietary  ,0,0,0,2,7,9
02056804,DAYMAR COLLEGE - JACKSON                ,OH,45640-1728,Proprietary  ,0,6,6,3,18,21
02066100,OHIO STATE COLLEGE/BARBER STYLING       ,OH,43213-0000,Proprietary  ,5,32,37,65,241,306
02069500,AKRON INSTITUTE                         ,OH,44306-0000,Proprietary  ,34,162,196,235,1160,1395
02073300,GALLIA-JACKSON-VINTON SCH ADULT ED      ,OH,45674-0000,Public       ,5,6,11,49,191,240
02077800,CENTURY SCHOOL OF COSMETOLOGY           ,OH,43952-0000,Proprietary  ,0,0,0,1,2,3
02110700,CLEVELAND INST OF DENTAL-MED ASST       ,OH,44115-2285,Proprietary  ,32,145,177,179,737,916
02116009,SANFORD-BROWN COLLEGE - MIDDLEBURG HEIGH,OH,44130-8362,Proprietary  ,46,280,326,398,1647,2045
02116900,UPPER VALLEY JVS                        ,OH,45356-0000,Public       ,0,50,50,23,301,324
02117300,GREAT OAKS INSTITUTE OF TECHNOLOGY      ,OH,45241-1581,Public       ,12,47,59,206,946,1152
02128600,THE ART INSTITUTE OF CINCINNATI         ,OH,45246-0000,Proprietary  ,8,11,19,239,108,347
02140700,COMMUNITY EDUCATIONAL SERVICES          ,OH,44702-1710,Public       ,0,3,3,26,189,215
02152100,ACADEMY OF COURT REPORTING              ,OH,44115-0000,Proprietary  ,4,55,59,188,1711,1899
02152101,ACADEMY OF COURT REPORTING & TECHNOLOGY ,OH,43215-3902,Proprietary  ,6,98,104,18,167,185
02152102,ACADEMY OF COURT REPORTING - MIAMI-JACOB,OH,44313-3607,Proprietary  ,0,31,31,5,76,81
02152104,ACADEMY OF COURT REPORTING & TECHNOLOGY ,OH,45202-2123,Proprietary  ,2,31,33,10,86,96
02158500,OHIO BUSINESS COLLEGE                   ,OH,44055-0000,Proprietary  ,18,95,113,79,543,622
02158501,OHIO BUSINESS COLLEGE                   ,OH,44870-9953,Proprietary  ,5,88,93,84,438,522
02163900,BEATRICE ACADEMY OF BEAUTY              ,OH,44106-0000,Proprietary  ,0,0,0,14,40,54
02168100,TRI-COUNTY JOINT VOCATIONAL SCHOOL      ,OH,45764-0000,Public       ,1,5,6,20,103,123
02187900,ASHTABULA CO JOINT VOC SCH ADULT ED     ,OH,44047-0000,Public       ,0,13,13,29,193,222
02189000,ADULT CENTER FOR EDUCATION              ,OH,43701-0000,Public       ,1,66,67,54,304,358
02190700,RETS TECH CENTER                        ,OH,45459-0000,Proprietary  ,56,457,513,338,2064,2402
02192100,BUTLER TECHNOLOGY AND CAREER DEVELOPMENT,OH,45011-0000,Public       ,24,98,122,184,624,808
02196300,COLLINS CAREER CENTER                   ,OH,45619-0000,Public       ,7,27,34,183,503,686
02210800,MEDINA COUNTY CAREER CENTER             ,OH,44256-0000,Public       ,0,6,6,30,111,141
02215400,OHIO STATE SCHOOL OF COSMETOLOGY        ,OH,43207-0000,Proprietary  ,5,6,11,49,96,145
02220500,GOD'S BIBLE SCHOOL & COLLEGE            ,OH,45210-0000,Private      ,4,1,5,164,61,225
02220800,CAREER & TECHNOLOGY EDUCATION CENTERS OF,OH,43055-0000,Public       ,5,22,27,29,160,189
02239800,PIONEER CAREER & TECHNOLOGY CENTER      ,OH,44875-0000,Public       ,0,3,3,5,43,48
02245600,WARREN COUNTY CAREER CENTER             ,OH,45036-0000,Public       ,3,33,36,27,146,173
02246300,INSTITUTE OF MEDICAL-DENTAL TECH        ,OH,45246-3317,Proprietary  ,8,46,54,62,209,271
02263700,MIAMI VALLEY CAREER TECHNOLOGY CTR      ,OH,45315-0000,Public       ,5,49,54,75,396,471
02269400,EASTERN HILLS ACAD OF HAIR DESIGN       ,OH,45255-0000,Proprietary  ,4,14,18,28,93,121
02269500,WESTERN HILLS SCHOOL OF BEAUTY & HAIR DE,OH,45211-0000,Proprietary  ,8,32,40,58,331,389
02270100,OHIO HI-POINT CAREER CENTER             ,OH,43311-0000,Public       ,3,29,32,36,204,240
02272700,COLUMBIANA COUNTY CAREER CENTER         ,OH,44432-0000,Public       ,2,19,21,30,211,241
02287900,RAPHAEL'S SCHOOL OF BEAUTY CULTURE      ,OH,44446-0000,Proprietary  ,14,42,56,70,188,258
02289802,KAPLAN COLLEGE                          ,OH,45203-0000,Proprietary  ,23,178,201,64,490,554
02301400,OHIO VALLEY COLLEGE OF TECHNOLOGY       ,OH,43920-0000,Proprietary  ,5,34,39,63,234,297
02303600,BOHECKER'S BUSINESS COLLEGE             ,OH,44266-0000,Proprietary  ,16,101,117,229,717,946
02304700,TRI-RIVERS CAREER CENTER                ,OH,43302-0000,Public       ,9,22,31,40,236,276
02311200,AMERICAN SCHOOL OF TECHNOLOGY           ,OH,43229-0000,Proprietary  ,10,116,126,44,550,594
02315500,TOLEDO ACADEMY OF BEAUTY CULTURE - EAST ,OH,43612-0000,Proprietary  ,4,16,20,42,147,189
02328500,MOLER-PICKENS BEAUTY COLLEGE            ,OH,45014-0000,Proprietary  ,4,16,20,17,55,72
02334300,INTERNATIONAL ACAD OF HAIR DESIGN       ,OH,45239-0000,Proprietary  ,4,13,17,71,65,136
02336300,KNOX COUNTY CAREER CENTER               ,OH,43050-4298,Public       ,0,5,5,39,216,255
02336700,CUYAHOGA VALLEY CAREER CENTER           ,OH,44141-1296,Public       ,0,9,9,42,206,248
02337700,PROFESSIONAL SKILLS INSTITUTE           ,OH,43607-0000,Proprietary  ,8,52,60,107,727,834
02351500,WILLOUGHBY EASTLAKE SCH OF PRAC NSG     ,OH,44094-0000,Public       ,1,3,4,14,129,143
02352800,POLARIS CAREER CENTER-ADULT ED DEPT     ,OH,44130-0000,Public       ,3,30,33,46,209,255
02354200,SCIOTO COUNTY JOINT VOCATIONAL SCH      ,OH,45648-0000,Public       ,11,28,39,80,302,382
02454400,NORTHEASTERN OHIO UNIVS COL OF MED      ,OH,44272-0000,Public       ,0,1,1,94,698,792
02497800,GREENE COUNTY CAREER CENTER             ,OH,45385-0000,Public       ,1,16,17,25,162,187
02512600,ADULT VOCATIONAL SERVICES               ,OH,44308-0000,Public       ,0,2,2,4,44,48
02519300,OHIO STATE SCH COSMETOLOGY              ,OH,43068-0000,Proprietary  ,0,3,3,10,32,42
02522700,EASTLAND-FAIRFIELD CAREER AND TECHNICAL ,OH,43125-0000,Public       ,11,50,61,76,274,350
02528300,TDDS TECHNICAL INSTITUTE                ,OH,44429-0000,Proprietary  ,8,139,147,66,552,618
02529500,HAMRICK SCHOOL                          ,OH,44256-0000,Proprietary  ,3,62,65,24,216,240
02541400,TOLEDO ACADEMY OF BEAUTY CULTURE-SO     ,OH,43614-0000,Proprietary  ,3,15,18,45,178,223
02545800,INNER STATE BEAUTY SCHOOLS              ,OH,44124-0000,Proprietary  ,7,25,32,50,249,299
02553000,SCHOOL OF ADVERTISING ART               ,OH,45440-0000,Proprietary  ,1,0,1,238,25,263
02560000,CASAL AVEDA INSTITUTE                   ,OH,44515-0000,Proprietary  ,15,29,44,114,113,227
02560700,PICKAWAY ROSS CO JOINT VOC TECH SCH     ,OH,45601-0000,Public       ,3,34,37,58,336,394
02562300,APOLLO CAREER CENTER-ADULT EDUC         ,OH,45806-0000,Public       ,5,64,69,75,506,581
02563000,RAPHAELS SCHOOL OF BEAUTY CULTURE       ,OH,44601-2847,Proprietary  ,3,24,27,58,136,194
02568600,MAHONING COUNTY CAREER & TECH CENTR     ,OH,44406-0000,Public       ,1,4,5,12,70,82
02582900,KAPLAN CAREER INSTITUTE                 ,OH,44129-6810,Proprietary  ,36,198,234,218,961,1179
02586400,TRUMBULL CAREER & TECH CENTER-ADULT     ,OH,44483-1997,Public       ,3,19,22,57,324,381
02588500,OHIO STATE SCHOOL OF COSMETOLOGY        ,OH,43081-0000,Proprietary  ,3,6,9,65,83,148
02599711,VATTEROTT COLLEGE - CLEVELAND           ,OH,44147-3502,Proprietary  ,7,127,134,54,511,565
02603800,LORAIN COUNTY JVS ADULT CAREER CTR      ,OH,44074-9799,Public       ,0,15,15,26,146,172
02616200,BROWN MACKIE COLLEGE-FINDLAY            ,OH,45840-6848,Proprietary  ,115,580,695,815,2868,3683
02616201,BROWN MACKIE COLLEGE-FINDLAY - ART INSTI,OH,45249-3317,Proprietary  ,0,0,0,27,12,39
02620000,SANDUSKY CAREER CENTER                  ,OH,44870-4786,Public       ,1,8,9,31,181,212
03007900,GALLIPOLIS CAREER COLLEGE               ,OH,45631-2600,Proprietary  ,5,26,31,27,235,262
03015100,ALLIANCE HIGH SCH-CMTY SERVICES DIV     ,OH,44601-2899,Public       ,4,9,13,42,178,220
03015300,EHOVE CAREER CENTER                     ,OH,44846-9500,Public       ,3,27,30,67,352,419
03023700,MADISON ADULT CAREER CENTER             ,OH,44905-2718,Public       ,2,19,21,19,134,153
03024300,VALLEY BEAUTY SCHOOL                    ,OH,43725-2332,Proprietary  ,4,20,24,31,77,108
03027100,FAIRVIEW ACADEMY                        ,OH,44126-2214,Proprietary  ,2,9,11,12,54,66
03034200,WASHINGTON COUNTY CAREER CENTER ADULT TE,OH,45750-9290,Public       ,4,28,32,55,236,291
03051400,AUBURN CAREER CENTER                    ,OH,44077-9723,Public       ,1,7,8,40,184,224
03051500,US GRANT JOINT VOCATIONAL SCHOOL        ,OH,45106-9502,Public       ,0,5,5,1,32,33
03065800,OHIO INSTITUTE OF HEALTH CAREERS        ,OH,44035-2394,Proprietary  ,13,59,72,128,424,552
03065900,BUCKEYE CAREER CENTER                   ,OH,44663-9437,Public       ,0,6,6,56,207,263
03067600,RAPHAEL'S SCHOOL OF BEAUTY CULTURE      ,OH,44512-2222,Proprietary  ,2,10,12,17,62,79
03068200,OHIO CENTER FOR BROADCASTING            ,OH,44125-4220,Proprietary  ,16,87,103,190,529,719
03068202,OHIO CENTER FOR BROADCASTING - COLUMBUS ,OH,43213-2571,Proprietary  ,1,11,12,1,14,15
03071900,MOUNT CARMEL COLLEGE OF NURSING         ,OH,43222-1598,Private      ,6,28,34,572,704,1276
03072303,EVEREST INSTITUTE - COLUMBUS            ,OH,43230-6653,Proprietary  ,44,304,348,177,1178,1355
03078000,OHIO CENTER FOR BROADCASTING            ,OH,45227-1509,Proprietary  ,5,14,19,33,101,134
03079000,ETI TECHNICAL COLLEGE                   ,OH,44446-4398,Proprietary  ,9,63,72,102,351,453
03084800,DELAWARE AREA CAREER CENTER             ,OH,43015-8969,Public       ,1,2,3,6,20,26
03084801,DELAWARE AREA CAREER CENTER -           ,OH,43015-9001,Public       ,1,1,2,4,16,20
03095600,VANTAGE CAREER CENTER                   ,OH,45891-1378,Public       ,5,23,28,19,167,186
03097000,MERCY COLLEGE OF NORTHWEST OHIO         ,OH,43604-1132,Private      ,11,36,47,466,727,1193
03100100,PARAMOUNT BEAUTY ACADEMY                ,OH,45662-4136,Proprietary  ,5,13,18,42,91,133
03105400,CLEVELAND EXTENSION HIGH SCH-WEST       ,OH,44102-2298,Public       ,2,34,36,22,221,243
03116200,DAYTON BARBER COLLEGE                   ,OH,45402-2310,Proprietary  ,6,23,29,43,139,182
03116300,OHIO COLLEGE OF MASSOTHERAPY            ,OH,44321-1363,Private      ,3,15,18,72,193,265
03116400,VANGUARD-SENTINELL VOC SCH DISTRICT     ,OH,43420-1197,Public       ,1,2,3,6,37,43
03117000,ASHLAND COUNTY-W HOLMES CAREER CTR      ,OH,44805-0000,Public       ,0,13,13,15,125,140
03319300,CREATIVE IMAGES-A CERTIFIED MATRIX      ,OH,45414-2557,Proprietary  ,9,37,46,66,221,287
03319301,CREATIVE IMAGES-A CERTIFIED MATRIX      ,OH,45459-0000,Proprietary  ,7,18,25,62,160,222
03416400,VALLEY BEAUTY SCHOOL                    ,OH,43701-3624,Proprietary  ,1,6,7,19,48,67
03425300,ROSEDALE BIBLE COLLEGE                  ,OH,43029-9517,Private      ,8,0,8,77,8,85
03457300,ALLEGHENY WESLEYAN COLLEGE              ,OH,44460-9598,Private      ,0,1,1,35,12,47
03468400,NATIONAL INSTITUTE OF MASSOTHERAPY      ,OH,44319-2100,Proprietary  ,4,9,13,23,108,131
03468500,ATS INSTITUTE OF TECHNOLOGY             ,OH,44143-2216,Proprietary  ,7,49,56,55,676,731
03475400,TRI-STATE BIBLE COLLEGE                 ,OH,45680-8402,Private      ,0,0,0,9,17,26
03534400,AMERICAN INST OF ALTERNATIVE MEDICI     ,OH,43229-1113,Proprietary  ,6,20,26,35,203,238
03578300,TRI-STATE COLLEGE                       ,OH,44452-8535,Proprietary  ,1,2,3,22,55,77
03586400,MED CENTRAL COLLEGE OF NURSING          ,OH,44903-2265,Private      ,3,16,19,285,264,549
03626300,BROWN AVEDA INSTITUTE                   ,OH,44060-6212,Proprietary  ,23,30,53,174,218,392
03693300,CARNEGIE INST OF INTEGRATIVE MED/MASSOTH,OH,44260-9608,Private      ,1,13,14,9,90,99
03700300,REGENCY BEAUTY INSTITUTE - CLEVELAND    ,OH,44094-0000,Proprietary  ,12,29,41,53,136,189
03726300,TEMPLE BAPTIST COLLEGE                  ,OH,45240-0000,Private      ,0,3,3,4,19,23
03747300,BEXLEY HALL SEMINARY                    ,OH,43209-2325,Private      ,0,0,0,0,7,7
03776400,HEALING ARTS INSTITUTE                  ,OH,43551-3138,Proprietary  ,5,13,18,22,57,79
03837300,AVEDA FREDRIC'S INSTITUTE               ,OH,45208-1304,Proprietary  ,7,4,11,78,54,132
03882300,OREGON CAREER CENTER                    ,OH,43616-2631,Public       ,1,10,11,6,38,44
04050400,DESIGNER'S BEAUTY ACADEMY               ,OH,43920-0000,Proprietary  ,5,6,11,11,38,49
04074300,HONDROS COLLEGE                         ,OH,43081-3855,Proprietary  ,24,143,167,131,989,1120
04116700,NEWLIFE TECHNICAL INSTITUTE             ,OH,43920-2920,Private      ,2,10,12,7,17,24
04117300,DAYTON SCHOOL OF MEDICAL MASSAGE        ,OH,45429-1111,Proprietary  ,45,117,162,235,720,955
04118300,NORTHCOAST MEDICAL TRAINING ACADEMY     ,OH,44240-4174,Proprietary  ,7,48,55,101,220,321
04124500,TECHSKILLS                              ,OH,43231-0000,Proprietary  ,2,60,62,15,235,250
04125700,CUT BEAUTY SCHOOL (THE)                 ,OH,44118-2918,Proprietary  ,0,17,17,24,147,171
04137800,AVEDA INSTITUTE COLUMBUS                ,OH,43201-2333,Proprietary  ,30,17,47,50,47,97
04138000,INSTITUTE OF THERAPEUTIC MASSAGE        ,OH,45875-0350,Proprietary  ,1,15,16,9,60,69
        ,INVALID SCHOOL CODE                     ,  ,00000-0000,,423,1264,1687,7115,10273,17388
00134500,ADAMS STATE COLLEGE                     ,CO,81102-2373,Public       ,41,110,151,2085,1780,3865
00134600,ARAPAHOE COMMUNITY COLLEGE              ,CO,80160-9002,Public       ,111,359,470,1655,3795,5450
00134700,COLORADO COLLEGE                        ,CO,80903-3294,Private      ,28,11,39,2707,272,2979
00134800,COLORADO SCHOOL OF MINES                ,CO,80401-1887,Public       ,39,30,69,3879,717,4596
00134900,UNIVERSITY OF NORTHERN COLORADO         ,CO,80639-0001,Public       ,156,193,349,8473,3475,11948
00135000,COLORADO STATE UNIVERSITY               ,CO,80523-0100,Public       ,350,331,681,17332,7266,24598
00135200,DENVER  SEMINARY                        ,CO,80120-2192,Private      ,0,14,14,1,591,592
00135300,FORT LEWIS COLLEGE                      ,CO,81301-3999,Public       ,95,52,147,3392,1151,4543
00135400,ILIFF SCHOOL OF THEOLOGY                ,CO,80210-0000,Private      ,0,11,11,1,197,198
00135500,LAMAR COMMUNITY COLLEGE                 ,CO,81052-3999,Public       ,17,56,73,375,407,782
00135800,MESA STATE COLLEGE                      ,CO,81501-7682,Public       ,147,157,304,3774,2496,6270
00135900,COLORADO NORTHWESTERN COMMUNITY COLLEGE ,CO,81648-3598,Public       ,13,27,40,317,289,606
00136000,METROPOLITAN STATE CLG OF DENVER        ,CO,80204-0000,Public       ,457,740,1197,9197,12178,21375
00136100,NORTHEASTERN JUNIOR COLLEGE             ,CO,80751-2399,Public       ,41,53,94,1035,450,1485
00136200,OTERO JUNIOR COLLEGE                    ,CO,81050-3346,Public       ,37,56,93,597,770,1367
00136300,REGIS UNIVERSITY                        ,CO,80221-1099,Private      ,29,565,594,2144,8305,10449
00136500,COLORADO STATE UNIVERSITY-PUEBLO        ,CO,81001-4901,Public       ,70,227,297,3606,2609,6215
00136800,TRINIDAD STATE JR COLLEGE               ,CO,81082-2396,Public       ,33,118,151,644,1084,1728
00137000,UNIVERSITY OF COLORADO-BOULDER          ,CO,80309-0077,Public       ,401,269,670,20142,8044,28186
00137100,UNIVERSITY OF DENVER                    ,CO,80208-2000,Private      ,78,361,439,5487,8770,14257
00137200,WESTERN STATE COLLEGE                   ,CO,81231-0000,Public       ,42,21,63,2052,416,2468
00163202,AQUINAS INSTITUTE OF THEOLOGY - AQUINAS ,CO,80903-1498,Private      ,0,1,1,2,7,9
00405702,NATIONAL AMERICAN UNIVERSITY            ,CO,80918-0000,Proprietary  ,0,15,15,20,172,192
00405703,NATIONAL AMERICAN UNIVERSITY            ,CO,80222-0000,Proprietary  ,0,17,17,23,194,217
00450300,EVEREST COLLEGE                         ,CO,80916-3548,Proprietary  ,45,227,272,156,991,1147
00450600,COLORADO MOUNTAIN COLLEGE               ,CO,81602-0000,Public       ,31,60,91,1089,751,1840
00450700,EVEREST COLLEGE                         ,CO,80229-4339,Proprietary  ,47,278,325,202,1197,1399
00450701,"EVEREST COLLEGE- EVEREST COLLEGE, AURORA",CO,80012-5692,Proprietary  ,36,177,213,146,764,910
00450800,UNIVERSITY OF CO ANSCHUTZ MED CAMPUS    ,CO,80045-0000,Public       ,7,103,110,331,2866,3197
00450824,UNIVERSITY OF COLORADO DENVER - AURARIA ,CO,80217-3364,Public       ,142,402,544,5095,8638,13733
00450900,UNIV OF COLORADO AT COLO SPRINGS        ,CO,80918-3735,Public       ,121,197,318,4862,4170,9032
00559600,EMILY GRIFFITH OPPORTUNITY SCH          ,CO,80204-2197,Public       ,37,216,253,316,1213,1529
00729700,REDSTONE COLLEGE                        ,CO,80020-9988,Proprietary  ,27,109,136,343,670,1013
00754700,LINCOLN COLLEGE OF TECHNOLOGY           ,CO,80223-2013,Proprietary  ,149,111,260,979,660,1639
00754800,WESTWOOD COLLEGE - DENVER NORTH         ,CO,80221-3653,Proprietary  ,361,1683,2044,2412,10321,12733
00754801,WESTWOOD COLLEGE - DENVER SOUTH         ,CO,80227-3653,Proprietary  ,44,137,181,310,972,1282
00758200,AIMS COMMUNITY COLLEGE                  ,CO,80632-0000,Public       ,103,281,384,1555,2646,4201
00764900,ROCKY MOUNTAIN COLG OF ART & DESIGN     ,CO,80214-0000,Proprietary  ,15,16,31,677,215,892
00793300,FRONT RANGE COMMUNITY COLLEGE           ,CO,80031-2199,Public       ,300,671,971,4685,8069,12754
00863500,INTELLITEC MEDICAL INSTITUTE            ,CO,80909-1570,Proprietary  ,17,62,79,78,386,464
00887100,CONCORDE CAREER INSTITUTE               ,CO,80203-0000,Proprietary  ,43,190,233,244,1075,1319
00889600,PIKES PEAK COMMUNITY COLLEGE            ,CO,80906-5498,Public       ,306,899,1205,3624,7949,11573
00940100,COLORADO CHRISTIAN UNIVERSITY           ,CO,80226-7449,Private      ,21,173,194,1251,1950,3201
00954200,COMMUNITY COLLEGE OF DENVER             ,CO,80217-2026,Public       ,168,550,718,2870,6000,8870
00954300,RED ROCKS COMMUNITY COLLEGE             ,CO,80228-1255,Public       ,166,423,589,1879,3477,5356
00985500,YESHIVA TORAS CHAIM TALMUDICAL SEM      ,CO,80204-0067,Private      ,0,0,0,1,3,4
00998100,MORGAN COMMUNITY COLLEGE                ,CO,80701-4399,Public       ,48,93,141,280,785,1065
01014800,COLORADO TECHNICAL UNIVERSITY           ,CO,80907-3896,Proprietary  ,68,937,1005,556,7265,7821
01014802,COLORADO TECHNICAL UNIV - DENVER        ,CO,80111-3201,Proprietary  ,18,144,162,170,920,1090
01014805,COLORADO TECH UNIV - ON LINE            ,CO,80907-0000,Proprietary  ,266,6227,6493,1696,34861,36557
01014806,COLORADO TECH UNIV - FED EXPRESS        ,CO,80921-3800,Proprietary  ,1,6,7,12,60,72
01014807,COLORADO TECH UNIV - MCI WORLD COM      ,CO,80919-3172,Proprietary  ,0,0,0,6,21,27
01014808,COLORADO TECH UNIV - USAA               ,CO,80920-1005,Proprietary  ,1,4,5,8,13,21
01014809,COLORADO TECH UNIV - SCHRIEVER AFB      ,CO,80912-7298,Proprietary  ,0,0,0,0,2,2
01014810,COLORADO TECH UNIV - PETERSON AFB       ,CO,80914-1586,Proprietary  ,0,0,0,1,3,4
01014811,COLORADO TECH UNIV-HEWLETT PACKARD      ,CO,80919-2303,Proprietary  ,0,1,1,3,11,14
01014812,COLORADO TECHNICAL UNIVERSITY - WESTMINS,CO,80021-3498,Proprietary  ,27,182,209,190,1074,1264
01014813,COLORADO TECH UNIV - ORACLE             ,CO,80921-3660,Proprietary  ,0,2,2,0,14,14
01014815,COLORADO TECHNCL UNIV PUEBLO            ,CO,81003-2315,Proprietary  ,8,58,66,78,528,606
01070900,ARTISTIC BEAUTY COLLEGES-LAKEWOOD       ,CO,80215-0000,Proprietary  ,12,27,39,47,136,183
01073200,SAN JUAN BASINTECHNICAL COLLEGE         ,CO,81328-9196,Public       ,2,12,14,43,115,158
01157200,COLORADO SCHOOL OF TRADES               ,CO,80215-2996,Proprietary  ,13,24,37,80,178,258
01267000,BEL-REA INST OF ANIMAL TECH             ,CO,80247-3048,Proprietary  ,24,72,96,411,662,1073
01285000,INTERNATIONAL SALON AND SPA ACADEMY     ,CO,80918-3684,Proprietary  ,17,48,65,98,217,315
01287500,PICKENS TECHNICAL COLLEGE               ,CO,80011-9307,Public       ,22,40,62,222,545,767
01300700,NAZARENE BIBLE COLLEGE                  ,CO,80910-3717,Private      ,2,46,48,49,733,782
02072200,ARTISTIC BEAUTY COLLEGES-DENVER         ,CO,80212-0000,Proprietary  ,5,14,19,46,126,172
02078900,ART INSTITUTE OF COLORADO (THE)         ,CO,80203-2983,Proprietary  ,110,171,281,1875,1812,3687
02116300,PUEBLO COMMUNITY COLLEGE                ,CO,81004-0000,Public       ,155,587,742,1583,4974,6557
02117500,NAROPA UNIVERSITY                       ,CO,80302-0000,Private      ,6,16,22,345,1155,1500
02133100,COLORADO CENTER FOR MEDICAL LABORATORY S,CO,80218-0000,Private      ,0,0,0,15,40,55
02141100,ARTISTIC BEAUTY COLGS-WESTMINSTER       ,CO,80030-0000,Proprietary  ,22,36,58,105,179,284
02141102,ARTISTIC BEAUTY COLLEGES-LITTLETON      ,CO,80123-3480,Proprietary  ,0,1,1,13,24,37
02141103,ARTISTIC BEAUTY COLLEGES-AURORA         ,CO,80017-3194,Proprietary  ,9,18,27,39,84,123
02156200,DELTA - MONTROSE TECHNICAL COLLEGE      ,CO,81416-0000,Public       ,6,16,22,70,167,237
02160600,EMPIRE BEAUTY SCHOOL -THORNTON          ,CO,80241-1659,Proprietary  ,17,34,51,94,155,249
02165200,SALON PROFESSIONAL ACADEMY (THE)        ,CO,81504-5309,Proprietary  ,6,13,19,41,69,110
02167600,KAPLAN COLLEGE                          ,CO,80229-5309,Proprietary  ,19,124,143,118,591,709
02188700,DENVER ACAD OF COURT REPORTING          ,CO,80030-0000,Proprietary  ,4,17,21,18,104,122
02211901,CHEEKS INTERNATIONAL ACADEMY OF BEAUTY C,CO,80525-3053,Proprietary  ,0,1,1,8,16,24
02211902,CHEEKS INTERNATIONAL ACDMY BTY CULT     ,CO,80631-0000,Proprietary  ,0,0,0,4,7,11
02253700,INTELLITEC COLLEGE                      ,CO,80909-0000,Proprietary  ,26,135,161,140,590,730
02267500,GLENWOOD BEAUTY ACADEMY                 ,CO,81601-0000,Proprietary  ,2,13,15,23,48,71
02276900,COMMUNITY COLLEGE OF AURORA             ,CO,80011-9036,Public       ,116,386,502,1570,3791,5361
02321700,ITT TECHNICAL INSTITUTE                 ,CO,80229-5338,Proprietary  ,76,278,354,445,1279,1724
02518500,HAIR DYNAMICS EDUCATION CENTER          ,CO,80525-0000,Proprietary  ,19,30,49,85,146,231
02594300,COLLEGE AMERICA - DENVER                ,CO,80222-3380,Proprietary  ,83,537,620,404,2261,2665
02611000,HERITAGE COLLEGE                        ,CO,80212-7413,Proprietary  ,38,187,225,260,833,1093
03006300,INST OF BUSINESS & MEDICAL CAREERS      ,CO,80525-3044,Proprietary  ,21,130,151,175,862,1037
03012100,REMINGTON COLLEGE - COLORADO SPRINGS CAM,CO,80215-0000,Proprietary  ,5,45,50,45,276,321
03013100,BOULDER COLLEGE OF MASSAGE THERAPY      ,CO,80301-3295,Private      ,4,12,16,88,242,330
03014900,PLATT COLLEGE                           ,CO,80014-3141,Proprietary  ,4,21,25,50,192,242
03027400,XENON INTERNATIONAL ACADEMY III         ,CO,80014-1193,Proprietary  ,8,19,27,51,83,134
03030606,UTAH COLLEGE OF MASSAGE THERAPY - DENVER,CO,80031-2921,Proprietary  ,27,55,82,165,291,456
03030607,UTAH COLLEGE OF MASSAGE THERAPY - DENVER,CO,80012-2523,Proprietary  ,19,33,52,101,235,336
03031603,DPT BUSINESS SCHOOL                     ,CO,80223-0000,Proprietary  ,0,0,0,4,14,18
03066900,INTELLITEC COLLEGE                      ,CO,81506-3994,Proprietary  ,38,179,217,202,714,916
03068201,OHIO CENTER FOR BROADCASTING - COLORADO ,CO,80214-4129,Proprietary  ,10,37,47,47,148,195
03076401,BRYMAN SCHOOL OF ARIZONA (THE) - ANTHEM ,CO,80014-2622,Proprietary  ,2,2,4,18,58,76
03289300,TEIKYO LORETTO HEIGHTS UNIVERSITY       ,CO,80236-2711,Private      ,2,15,17,10,140,150
03306300,MONTESSORI EDUC CRT OF THE ROCKIES      ,CO,80301-2587,Private      ,0,0,0,3,37,40
03534300,JONES INTERNATIONAL UNIVERSITY          ,CO,80112-3446,Proprietary  ,26,585,611,73,3009,3082
03545300,UNIVERSITY OF THE ROCKIES               ,CO,80903-3612,Proprietary  ,0,191,191,19,426,445
03584400,COLORADO SCHOOL OF HEALING ARTS         ,CO,80226-4332,Proprietary  ,7,31,38,62,276,338
03670300,TONI & GUY HAIRDRESSING ACADEMY         ,CO,80911-1713,Proprietary  ,4,19,23,53,105,158
03686300,COLORADO SCHOOL OF TRADITIONAL CHINESE M,CO,80206-2127,Proprietary  ,0,9,9,3,106,109
03972300,CUTTIN' UP BEAUTY ACADEMY               ,CO,80220-0000,Proprietary  ,2,18,20,16,74,90
03976300,MASSAGE THERAPY INSTITUTE OF COLORADO   ,CO,80206-2127,Proprietary  ,2,9,11,27,84,111
04080300,ASPEN UNIVERSITY                        ,CO,80246-1930,Proprietary  ,0,6,6,0,6,6
04093300,ACADEMY OF NATURAL THERAPY              ,CO,80631-3425,Proprietary  ,3,8,11,17,60,77
04121200,INSTITUTE OF TAOIST EDUCATION AND ACUPUN,CO,80027-1028,Private      ,0,0,0,0,17,17
04125100,MONTESSORI CENTRE INTERNATIONAL DENVER  ,CO,80111-5263,Private      ,0,1,1,1,9,10
04139300,NATIONAL BEAUTY COLLEGE                 ,CO,80221-0000,Proprietary  ,3,24,27,16,88,104
00267811,BRYANT & STRATTON COLLEGE - VIRGINIA BEA,VA,23462-4417,Proprietary  ,45,201,246,397,1754,2151
00370200,AVERETT UNIVERSITY                      ,VA,24541-3692,Private      ,19,284,303,1370,1802,3172
00370300,BLUEFIELD COLLEGE                       ,VA,24605-1799,Private      ,5,50,55,514,612,1126
00370400,BRIDGEWATER COLLEGE                     ,VA,22812-1599,Private      ,33,4,37,2641,107,2748
00370500,COLLEGE OF WILLIAM & MARY               ,VA,23187-8795,Public       ,90,37,127,8545,3736,12281
00370600,CHRISTOPHER NEWPORT UNIVERSITY          ,VA,23606-2998,Public       ,84,32,116,6196,798,6994
00370700,RICHARD BLAND COLLEGE                   ,VA,23805-7100,Public       ,26,18,44,885,361,1246
00370800,EASTERN MENNONITE UNIVERSITY            ,VA,22802-2462,Private      ,8,18,26,973,379,1352
00370900,EMORY & HENRY COLLEGE                   ,VA,24327-0010,Private      ,7,9,16,1315,100,1415
00371100,FERRUM COLLEGE                          ,VA,24088-2612,Private      ,22,2,24,2375,190,2565
00371200,TIDEWATER COMMUNITY COLLEGE             ,VA,23510-1910,Public       ,364,1142,1506,8234,15672,23906
00371300,HAMPDEN-SYDNEY COLLEGE                  ,VA,23943-0128,Private      ,9,1,10,1052,26,1078
00371400,HAMPTON UNIVERSITY                      ,VA,23668-0099,Private      ,177,65,242,9848,2518,12366
00371500,HOLLINS UNIVERSITY                      ,VA,24020-0000,Private      ,9,20,29,908,562,1470
00371900,LONGWOOD UNIVERSITY                     ,VA,23909-1899,Public       ,67,23,90,4404,629,5033
00372000,LYNCHBURG COLLEGE                       ,VA,24501-3199,Private      ,38,24,62,2942,580,3522
00372100,JAMES MADISON UNIVERSITY                ,VA,22807-3780,Public       ,235,35,270,17575,1922,19497
00372300,MARY BALDWIN COLLEGE                    ,VA,24401-3610,Private      ,11,39,50,1244,853,2097
00372400,MARYMOUNT UNIVERSITY                    ,VA,22207-4224,Private      ,51,78,129,2230,1873,4103
00372600,NATIONAL COLLEGE                        ,VA,24153-4524,Proprietary  ,160,1153,1313,971,7166,8137
00372700,NORTHERN VA CMTY CLG                    ,VA,22003-3743,Public       ,443,874,1317,8444,10581,19025
00372800,OLD DOMINION UNIVERSITY                 ,VA,23529-0052,Public       ,282,421,703,14929,10840,25769
00373200,RADFORD UNIVERSITY                      ,VA,24142-6905,Public       ,112,43,155,7911,1861,9772
00373300,RANDOLPH-MACON COLLEGE                  ,VA,23005-5505,Private      ,34,3,37,2091,90,2181
00373400,RANDOLPH COLLEGE                        ,VA,24503-1526,Private      ,7,3,10,1037,96,1133
00373500,VIRGINIA COMMONWEALTH UNIVERSITY        ,VA,23284-9004,Public       ,408,356,764,19343,11562,30905
00373600,ROANOKE COLLEGE                         ,VA,24153-3794,Private      ,15,9,24,2580,172,2752
00373700,SHENANDOAH UNIVERSITY                   ,VA,22601-5195,Private      ,20,44,64,2200,1727,3927
00373800,SOUTHERN VIRGINIA UNIVERSITY            ,VA,24416-3038,Private      ,22,8,30,810,192,1002
00373900,ST PAULS COLLEGE                        ,VA,23868-1299,Private      ,5,18,23,684,399,1083
00374200,SWEET BRIAR COLLEGE                     ,VA,24595-9998,Private      ,2,0,2,739,51,790
00374300,UNION THEO SEMINARY & PRESBYTRN SCH     ,VA,23227-0000,Private      ,0,6,6,2,100,102
00374400,UNIVERSITY OF RICHMOND                  ,VA,23173-0001,Private      ,43,38,81,4621,2256,6877
00374500,UNIVERSITY OF VIRGINIA - SFS            ,VA,22903-0000,Public       ,226,137,363,15712,8820,24532
00374600,UNIVERSITY OF MARY WASHINGTON           ,VA,22401-5358,Public       ,53,53,106,4146,923,5069
00374700,UNIV OF VIRGINIA'S COLLEGE AT WISE      ,VA,24293-4412,Public       ,20,14,34,1745,414,2159
00374800,EASTERN SHORE COMMUNITY COLLEGE         ,VA,23410-3000,Public       ,6,20,26,345,569,914
00374900,GEORGE MASON UNIVERSITY                 ,VA,22030-4444,Public       ,320,438,758,13705,11352,25057
00375100,PATRICK HENRY COMMUNITY COLLEGE         ,VA,24112-5311,Public       ,41,203,244,991,2124,3115
00375200,VIRGINIA INTERMONT COLLEGE              ,VA,24201-4298,Private      ,6,21,27,532,308,840
00375300,VIRGINIA MILITARY INSTITUTE             ,VA,24450-2138,Public       ,13,4,17,1378,52,1430
00375400,VIRGINIA POLYTECH INST & STATE UNIV     ,VA,24061-2000,Public       ,260,147,407,22569,4201,26770
00375800,DANVILLE COMMUNITY COLLEGE              ,VA,24541-4004,Public       ,54,235,289,1206,2447,3653
00375900,J. SARGEANT REYNOLDS COMMUNITY CLG      ,VA,23285-0000,Public       ,105,413,518,3386,6685,10071
00376000,VIRGINIA WESTERN CMTY COLLEGE           ,VA,24038-0000,Public       ,60,226,286,2004,3354,5358
00376100,WYTHEVILLE COMMUNITY COLLEGE            ,VA,24382-3308,Public       ,45,124,169,1049,1591,2640
00376200,VIRGINIA UNIVERSITY OF LYNCHBURG        ,VA,24501-6400,Private      ,4,36,40,84,251,335
00376400,VIRGINIA STATE UNIVERSITY               ,VA,23806-0001,Public       ,163,84,247,8863,2224,11087
00376500,NORFOLK STATE UNIVERSITY                ,VA,23504-8000,Public       ,156,176,332,8242,4933,13175
00376600,VIRGINIA UNION UNIVERSITY               ,VA,23220-1711,Private      ,64,36,100,2374,857,3231
00376700,VIRGINIA WESLEYAN COLLEGE               ,VA,23502-5599,Private      ,35,22,57,1904,494,2398
00376800,WASHINGTON & LEE UNIVERSITY             ,VA,24450-0303,Private      ,18,6,24,2129,1251,3380
00400400,JOHN TYLER COMMUNITY COLLEGE            ,VA,23831-5316,Public       ,64,247,311,2247,4002,6249
00450301,"EVEREST COLLEGE- EVEREST COLLEGE, MCLEAN",VA,22102-3000,Proprietary  ,51,101,152,160,455,615
00450702,"EVEREST COLLEGE- EVEREST COLLEGE, ARLING",VA,22203-1905,Proprietary  ,83,216,299,396,1214,1610
00498800,CENTRAL VIRGINIA COMMUNITY COLLEGE      ,VA,24502-2498,Public       ,45,126,171,1234,1698,2932
00499200,MILLER-MOTTE TECHNICAL COLLEGE          ,VA,24505-0000,Proprietary  ,29,74,103,157,445,602
00499600,DABNEY S LANCASTER COMMUNITY CLG        ,VA,24422-1000,Public       ,11,29,40,449,500,949
00522300,NEW RIVER COMMUNITY COLLEGE             ,VA,24084-1127,Public       ,58,105,163,1335,1692,3027
00607500,ROANOKE MEM HOSP SCH RAD ONCOLOGY       ,VA,24033-0000,Private      ,0,0,0,3,4,7
00607501,ROANOKE MEM HOSP SCH RAD TECH           ,VA,24014-1850,Private      ,0,0,0,6,8,14
00662200,COLLEGE OF HEALTH SCIENCES - CHRV       ,VA,24031-0000,Private      ,4,23,27,469,893,1362
00681900,BLUE RIDGE COMMUNITY COLLEGE            ,VA,24486-0080,Public       ,47,95,142,1498,1525,3023
00687100,THOMAS NELSON COMMUNITY COLLEGE         ,VA,23670-0000,Public       ,127,385,512,2682,5571,8253
00709900,VIRGINIA HIGHLANDS COMMUNITY CLG        ,VA,24210-4210,Public       ,22,85,107,1099,1295,2394
00726000,SOUTHWEST VIRGINIA COMMUNITY CLG        ,VA,24641-1510,Public       ,34,183,217,1159,1692,2851
00859200,LOUISE OBICI SCHOOL OF NURSING          ,VA,23434-8038,Private      ,0,1,1,9,37,46
00859202,SUFFOLK PUB SCH-LOUISE OBICI SCH PN     ,VA,23434-0000,Private      ,0,0,0,3,8,11
00865900,LORD FAIRFAX COMMUNITY COLLEGE          ,VA,22645-0047,Public       ,58,143,201,1367,1825,3192
00866000,GERMANNA COMMUNITY COLLEGE              ,VA,22508-0339,Public       ,53,182,235,1339,2142,3481
00866100,SOUTHSIDE VIRGINIA CMTY CLG             ,VA,23821-2930,Public       ,107,312,419,1501,2853,4354
00915900,PAUL D CAMP COMMUNITY COLLEGE           ,VA,23851-0737,Public       ,23,92,115,405,1035,1440
00916000,RAPPAHANNOCK COMMUNITY COLLEGE          ,VA,23149-2616,Public       ,26,74,100,637,914,1551
00926700,EVEREST COLLEGE                         ,VA,23606-4203,Proprietary  ,26,198,224,136,921,1057
00926701,EVEREST COLLEGE - CHESAPEAKE            ,VA,23320-2637,Proprietary  ,39,229,268,186,1173,1359
00942000,SANFORD-BROWN COLLEGE                   ,VA,22182-3913,Proprietary  ,49,139,188,464,738,1202
00953500,STAUNTON SCHOOL OF COSMETOLOGY          ,VA,24401-4323,Proprietary  ,0,10,10,21,35,56
00953700,VIRGINIA SCH OF HAIR DESIGN             ,VA,23669-0000,Proprietary  ,7,18,25,26,129,155
00962900,MOUNTAIN EMPIRE COMMUNITY COLLEGE       ,VA,24219-0700,Public       ,31,152,183,1108,1683,2791
00992800,PIEDMONT VIRGINIA COMMUNITY COLLEGE     ,VA,22902-7589,Public       ,59,156,215,1138,1644,2782
01004300,BON SECOURS MEMORIAL SCH OF NURSING     ,VA,23227-4612,Private      ,5,13,18,111,424,535
01019800,ECPI COLLEGE OF TECHNOLOGY              ,VA,23462-6542,Proprietary  ,509,1819,2328,3102,10051,13153
01033800,EASTERN VIRGINIA MEDICAL SCHOOL         ,VA,23501-1980,Private      ,2,7,9,21,1166,1187
01159600,RALPH'S VIRGINIA SCH OF COSMETOLOGY     ,VA,24501-2652,Proprietary  ,2,8,10,14,39,53
01162601,WESTWOOD COLLEGE - SOUTH BAY - ARLINGTON,VA,22203-4167,Proprietary  ,64,101,165,351,458,809
01162602,WESTWOOD COLLEGE - SOUTH BAY - ANNANDALE,VA,22003-2602,Proprietary  ,30,82,112,235,495,730
01274401,SOUTHSIDE REGIONAL MED CTR              ,VA,23803-5133,Proprietary  ,1,5,6,52,245,297
01274402,SOUTHSIDE REG MED CTR SCH RAD TECH      ,VA,23803-0000,Proprietary  ,0,3,3,8,23,31
02053000,LIBERTY UNIVERSITY                      ,VA,24502-0000,Private      ,256,2325,2581,14692,25421,40113
02108800,WARDS CORNER BEAUTY ACADEMY             ,VA,23505-0000,Proprietary  ,18,79,97,62,297,359
02111600,DANVILLE REGIONAL MEDICAL CENTER SCHOOL ,VA,24541-0000,Proprietary  ,0,8,8,37,81,118
02128700,CENTRAL SCHOOL OF PRACTICAL NURSING     ,VA,23502-2230,Public       ,1,1,2,25,73,98
02140000,RIVERSIDE SCHOOL OF HEALTH CAREERS      ,VA,23608-3802,Private      ,6,20,26,110,452,562
02175800,LYNCHBURG GENERAL HOSP SCH OF NURSG     ,VA,24501-0000,Private      ,2,5,7,86,146,232
02197600,WOODROW WILSON REHABILITATION CTR       ,VA,22939-0000,Public       ,8,5,13,39,35,74
02223100,HERITAGE INSTITUTE                      ,VA,22046-4400,Proprietary  ,0,0,0,4,4,8
02242400,HENRICO CTY ST MARYS HOSP PRAC NRSG     ,VA,23075-0000,Public       ,0,1,1,20,35,55
02247200,MEDSPA CAREERS INSTITUTE                ,VA,23606-0000,Proprietary  ,28,77,105,238,760,998
02304500,HERITAGE INSTITUTE                      ,VA,20111-0000,Proprietary  ,19,111,130,117,487,604
02320900,TIDEWATER TECH                          ,VA,23517-0000,Proprietary  ,16,108,124,114,534,648
02334400,CENTURA COLLEGE                         ,VA,23452-0000,Proprietary  ,84,672,756,574,4406,4980
02340000,COLONIAL HEIGHTS BEAUTY ACADEMY         ,VA,23834-0000,Proprietary  ,0,0,0,12,49,61
02342700,FORTIS COLLEGE                          ,VA,23502-4101,Proprietary  ,21,68,89,140,410,550
02342701,FORTIS COLLEGE - RICHMOND CAMPUS        ,VA,23236-3472,Proprietary  ,17,75,92,109,366,475
02535400,ECPI TECHNICAL COLLEGE                  ,VA,23236-0000,Proprietary  ,22,59,81,379,610,989
02538800,SUFFOLK BEAUTY ACADEMY                  ,VA,23434-0000,Proprietary  ,1,14,15,14,61,75
02541200,STRATFORD UNIVERSITY                    ,VA,22043-0000,Proprietary  ,14,96,110,127,577,704
02541201,STRATFORD UNIVERSITY-WOODBRIDGE         ,VA,22192-0000,Proprietary  ,2,19,21,37,152,189
02605900,TESST COLLEGE OF TECHNOLOGY             ,VA,22312-6342,Proprietary  ,0,0,0,13,41,54
02610100,WASHINGTON COUNTY ADULT SKILL CTR       ,VA,24210-2346,Public       ,2,19,21,23,129,152
03002400,GRAHAM WEBB INTERNATIONAL ACAD HAIR     ,VA,22209-2129,Proprietary  ,9,21,30,49,85,134
03010700,BAR PALMA BEAUTY CAREERS  ACADEMY       ,VA,24014-2255,Proprietary  ,1,16,17,29,83,112
03042800,"VIRGINIA BEACH CITY SCHOOLS, SCH.-PR.NSG",VA,23456-0038,Public       ,1,1,2,12,44,56
03091100,ACT COLLEGE                             ,VA,22209-2297,Proprietary  ,27,102,129,139,515,654
03091300,REGENT UNIVERSITY                       ,VA,23464-9800,Private      ,23,274,297,578,5416,5994
03092700,ECPI TECHNICAL COLLEGE-ROANOKE          ,VA,24012-1603,Proprietary  ,25,111,136,147,523,670
03096500,SPRINGFIELD BEAUTY ACADEMY              ,VA,22003-3016,Proprietary  ,4,16,20,14,105,119
03106500,SENTARA NORFOLK GENERAL HOSPITAL        ,VA,23320-2843,Private      ,4,14,18,143,557,700
03116900,BAPTIST THEOLOGICAL SEM.-RICHMOND       ,VA,23227-0000,Private      ,0,1,1,2,42,44
03126300,TIDEWATER TECH AVIATION                 ,VA,23320-5987,Proprietary  ,22,67,89,99,400,499
03126400,CENTURA COLLEGE                         ,VA,23235-5230,Proprietary  ,24,101,125,144,578,722
03126401,CENTURA COLLEGE - WEST                  ,VA,23294-0000,Proprietary  ,1,3,4,6,48,54
03127500,ADVANCED TECHNOLOGY INSTITUTE           ,VA,23462-2409,Proprietary  ,38,73,111,443,464,907
03280400,VIRGINIA SCHOOL OF MASSAGE              ,VA,22903-0000,Proprietary  ,11,29,40,73,181,254
03409500,RICHMOND SCHOOL OF HEALTH AND TECH      ,VA,23227-0000,Proprietary  ,18,131,149,151,831,982
03455300,CRESCENT COSMETOLOGY UNIVERSITY         ,VA,23666-3115,Proprietary  ,1,1,2,5,10,15
03559300,APPALACHIAN SCHOOL OF LAW               ,VA,24614-0000,Private      ,0,1,1,3,865,868
03638400,TAP THIS VALLEY WORKS CTR FOR EMPLO     ,VA,24016-1901,Private      ,0,6,6,0,19,19
03645400,RUDY & KELLY ACADEMY OF HAIR AND NA     ,VA,23464-6857,Proprietary  ,9,18,27,75,131,206
03654300,CAREER TRAINING SOLUTIONS               ,VA,22406-1014,Proprietary  ,9,57,66,57,325,382
03709300,EDWARD VIA VIRGINIA CLG OSTEOPATHIC MED ,VA,24060-6360,Private      ,0,2,2,11,670,681
03872400,INSTITUTE FOR THE PSYCHOLOGICAL SCIENCES,VA,22202-3609,Private      ,0,0,0,0,78,78
03876300,CULPEPER COSMETOLOGY TRAINING CENTER    ,VA,22701-3155,Public       ,1,1,2,12,44,56
03883400,AVIATION INSTITUTE OF MAINTENANCE       ,VA,20110-4156,Proprietary  ,15,56,71,68,273,341
04038400,AVI CAREER INSTITUTE                    ,VA,22066-1839,Proprietary  ,0,12,12,5,47,52
04124000,DOMINION SCHOOL OF HAIR DESIGN          ,VA,23062-2221,Proprietary  ,2,3,5,12,23,35
04133400,CENTURA COLLEGE                         ,VA,22312-2670,Proprietary  ,15,23,38,27,94,121
04133800,SOUTHEAST CULINARY & HOSPITALITY COLLEGE,VA,24201-4159,Proprietary  ,2,13,15,21,45,66
04140000,GLOBAL HEALTH NURSE TRAINING SERVICES   ,VA,22314-4585,Proprietary  ,4,37,41,4,48,52
00107000,THUNDERBIRD SCHOOL OF GLOBAL MANAGEMENT ,AZ,85306-6000,Private      ,1,31,32,3,785,788
00107100,ARIZONA WESTERN COLLEGE                 ,AZ,85366-0000,Public       ,106,204,310,3177,3569,6746
00107200,COCHISE COLLEGE                         ,AZ,85607-6190,Public       ,52,161,213,1151,2028,3179
00107300,EASTERN ARIZONA COLLEGE                 ,AZ,85552-0769,Public       ,46,114,160,1116,1093,2209
00107400,GRAND CANYON UNIVERSITY                 ,AZ,85017-3030,Proprietary  ,172,4348,4520,1992,33390,35382
00107600,GLENDALE COMMUNITY COLLEGE              ,AZ,85302-3090,Public       ,331,701,1032,5872,7817,13689
00107700,MESA COMMUNITY COLLEGE                  ,AZ,85202-4866,Public       ,425,929,1354,6956,10458,17414
00107800,PHOENIX COLLEGE                         ,AZ,85013-4234,Public       ,217,690,907,3233,6830,10063
00107900,YAVAPAI COLLEGE                         ,AZ,86301-3297,Public       ,87,267,354,1511,2495,4006
00108100,ARIZONA STATE UNIV (ALL CAMPUSES)       ,AZ,85287-0412,Public       ,944,1193,2137,33476,25941,59417
00108200,NORTHERN ARIZONA UNIVERSITY             ,AZ,86011-0001,Public       ,287,492,779,14943,10480,25423
00108300,UNIVERSITY OF ARIZONA                   ,AZ,85721-0066,Public       ,478,354,832,21275,12352,33627
00165701,MIDWESTERN UNIVERSITY                   ,AZ,85308-0000,Private      ,4,19,23,72,2402,2474
00446700,TUCSON COLLEGE                          ,AZ,85710-0000,Proprietary  ,29,147,176,151,700,851
00711300,SOUTHWESTERN COLLEGE                    ,AZ,85032-7097,Private      ,9,4,13,350,188,538
00726600,PIMA COUNTY COMMUNITY COLLEGE           ,AZ,85709-5000,Public       ,419,1097,1516,7651,11749,19400
00728300,CENTRAL ARIZONA COLLEGE                 ,AZ,85228-9779,Public       ,105,242,347,1589,2651,4240
00822100,UNIVERSAL TECHNICAL INSTITUTE           ,AZ,85323-7946,Proprietary  ,701,724,1425,9548,5218,14766
00824600,DINè COLLEGE                            ,AZ,86556-0126,Public       ,47,122,169,647,1073,1720
00830300,GATEWAY COMMUNITY COLLEGE               ,AZ,85034-1795,Public       ,78,438,516,1092,4226,5318
00830302,MARICOPA SKILL CENTER                   ,AZ,85034-0000,Public       ,29,204,233,329,1237,1566
00830400,SCOTTSDALE COMMUNITY COLLEGE            ,AZ,85250-0000,Public       ,164,255,419,2541,3234,5775
00886400,ARIZONA ACADEMY OF BEAUTY               ,AZ,85712-5021,Proprietary  ,2,10,12,36,59,95
00886500,ARTISTIC BEAUTY COLLEGES-TUCSON         ,AZ,85716-3999,Proprietary  ,19,56,75,177,334,511
00886501,ARTISTIC BEAUTY COLLEGES - TUCSON  - NOR,AZ,85705-1665,Proprietary  ,0,2,2,16,10,26
00945100,BROWN MACKIE COLLEGE                    ,AZ,85712-5300,Proprietary  ,58,457,515,455,2386,2841
01084700,ARIZONA AUTOMOTIVE INSTITUTE            ,AZ,85301-3503,Proprietary  ,84,217,301,517,1157,1674
01085800,EARLS ACADEMY OF BEAUTY                 ,AZ,85210-4010,Proprietary  ,37,74,111,141,270,411
01157000,PIMA MEDICAL INSTITUTE-MESA             ,AZ,85202-2950,Proprietary  ,0,0,0,84,308,392
01168900,REFRIGERATION SCHOOL                    ,AZ,85034-0000,Proprietary  ,29,139,168,130,727,857
01180200,ARIZONA ACADEMY OF BEAUTY-NORTH         ,AZ,85705-2720,Proprietary  ,2,12,14,28,80,108
01180800,ARTISTIC BEAUTY COLLEGES-FLAGSTAFF      ,AZ,86004-5119,Proprietary  ,20,57,77,173,374,547
01180801,CLG OF BEAUTY ARTS & SCI/CHANDLER       ,AZ,85224-0000,Proprietary  ,0,2,2,40,130,170
01180802,CLG OF BEAUTY ARTS & SCI/PRESCOTT       ,AZ,86303-0000,Proprietary  ,0,3,3,18,29,47
01186200,NORTHLAND PIONEER COLLEGE               ,AZ,86025-2996,Public       ,55,144,199,463,1456,1919
01186400,MOHAVE COMMUNITY COLLEGE                ,AZ,86409-1238,Public       ,148,626,774,1178,4607,5785
01218400,INTERNATIONAL ACAD OF HAIR DESIGN       ,AZ,85225-7198,Proprietary  ,14,14,28,90,176,266
01234300,ARTISTIC BEAUTY COLLEGES-PHOENIX        ,AZ,85304-0000,Proprietary  ,27,32,59,208,382,590
01234301,EMPIRE BEAUTY SCHOOL - AVONDALE         ,AZ,85323-2352,Proprietary  ,1,5,6,31,50,81
01293700,ARTISTIC BEAUTY COLLEGES - PARADISE VALL,AZ,85257-0000,Proprietary  ,4,4,8,61,80,141
02065200,ITT TECHNICAL INSTITUTE                 ,AZ,85282-0000,Proprietary  ,113,346,459,841,2426,3267
02065300,PRESCOTT COLLEGE                        ,AZ,86301-0000,Private      ,7,68,75,423,1074,1497
02071200,KAPLAN COLLEGE                          ,AZ,85029-4349,Proprietary  ,64,239,303,318,1393,1711
02098800,UNIVERSITY OF PHOENIX                   ,AZ,85040-0000,Proprietary  ,5489,99184,104673,25268,455407,480675
02100500,UNIVERSAL TECHNICAL INSTITUTE           ,AZ,85027-0000,Proprietary  ,574,1061,1635,7632,7759,15391
02100600,APOLLO COLLEGE                          ,AZ,85015-0000,Proprietary  ,331,1089,1420,1984,6360,8344
02113800,ROBERTO-VENN SCH OF LUTHIERY            ,AZ,85040-0000,Proprietary  ,1,5,6,42,56,98
02146600,SOUTH MOUNTAIN COMMUNITY COLLEGE        ,AZ,85040-0000,Public       ,79,211,290,1321,2355,3676
02171500,WESTERN INTERNATIONAL UNIVERSITY        ,AZ,85021-0000,Proprietary  ,8,413,421,64,2320,2384
02174900,COLLINS COLLEGE                         ,AZ,85040-4000,Proprietary  ,86,82,168,1532,1226,2758
02177500,RIO SALADO COMMUNITY COLLEGE            ,AZ,85281-0000,Public       ,129,1352,1481,1130,9320,10450
02192300,MARICOPA BEAUTY COLLEGE                 ,AZ,85323-0000,Proprietary  ,8,12,20,54,74,128
02199900,AMERICAN INDIAN CLG-ASSEMBLIES GOD      ,AZ,85021-0000,Private      ,3,6,9,57,72,129
02217100,PIMA MEDICAL INSTITUTE                  ,AZ,85716-0000,Proprietary  ,465,1562,2027,2173,7027,9200
02218800,IIA COLLEGE                             ,AZ,85019-1600,Proprietary  ,98,481,579,412,2293,2705
02218804,IIA COLLEGE - MESA                      ,AZ,85204-4448,Proprietary  ,1,4,5,1,4,5
02220300,ARTISTIC BEAUTY COLLEGES-GLENDALE       ,AZ,85051-0000,Proprietary  ,25,69,94,113,320,433
02263100,ANTHEM COLLEGE                          ,AZ,85014-0000,Proprietary  ,114,481,595,1061,3539,4600
02280500,CHARLES OF ITALY BEAUTY COLLEGE         ,AZ,86403-0000,Proprietary  ,8,7,15,35,79,114
02295000,EVEREST COLLEGE                         ,AZ,85021-1610,Proprietary  ,201,1589,1790,800,6796,7596
02295002,EVEREST COLLEGE - MESA                  ,AZ,85206-4704,Proprietary  ,46,149,195,174,730,904
02317800,AMERICAN INSTITUTE OF TECHNOLOGY        ,AZ,85043-0000,Proprietary  ,7,351,358,45,1173,1218
02361100,ITT TECHNICAL INSTITUTE                 ,AZ,85704-0000,Proprietary  ,114,314,428,718,1594,2312
02491500,THE ART CENTER DESIGN COLLEGE           ,AZ,85716-0000,Proprietary  ,18,30,48,272,464,736
02521500,LAMSON COLLEGE                          ,AZ,85284-1141,Proprietary  ,32,124,156,150,713,863
02533200,FRANK LLOYD WRIGHT SCHOOL OF ARCHITECTUR,AZ,85261-4430,Private      ,3,4,7,3,4,7
02559000,UNIVERSITY OF ADVANCING TECHNOLOGY      ,AZ,85283-0000,Proprietary  ,49,40,89,1061,647,1708
02561900,TONI AND GUY HAIRDRESSING ACADEMY       ,AZ,85251-3301,Proprietary  ,22,15,37,170,145,315
02582700,CORTIVA INSTITUTE - TUCSON              ,AZ,85710-3503,Proprietary  ,4,47,51,53,210,263
02616700,SCOTTSDALE CULINARY INSTITUTE           ,AZ,85251-2729,Proprietary  ,125,335,460,1097,1975,3072
02623600,PARADISE VALLEY COMMUNITY COLLEGE       ,AZ,85032-1210,Public       ,126,268,394,2041,2916,4957
02623800,CORTIVA INSTITUTE - SCOTTSDALE          ,AZ,85257-4218,Proprietary  ,8,36,44,54,174,228
03005000,SAFFORD COLLEGE OF BEAUTY CULTURE       ,AZ,85546-3309,Proprietary  ,4,11,15,11,39,50
03010613,VIRGINIA COLLEGE - GOLF ACADEMY OF ARIZO,AZ,85225-6742,Proprietary  ,8,27,35,110,191,301
03030604,UTAH COLLEGE OF MASSAGE THERAPY - ARIZON,AZ,85282-0000,Proprietary  ,38,59,97,222,362,584
03030605,UTAH COLLEGE OF MASSAGE THERAPY - ARIZON,AZ,85051-3470,Proprietary  ,41,71,112,209,417,626
03034400,CONSERVATORY RECORDING ARTS & SCIS      ,AZ,85282-1707,Proprietary  ,43,73,116,568,639,1207
03072200,CHANDLER-GILBERT COMMUNITY COLLEGE      ,AZ,85225-2499,Public       ,128,291,419,2638,3454,6092
03076400,BRYMAN SCHOOL OF ARIZONA                ,AZ,85029-4919,Proprietary  ,269,763,1032,1593,4055,5648
03076406,BRYMAN SCHOOL OF ARIZONA (THE) - TEMPE  ,AZ,85284-0000,Proprietary  ,0,0,0,7,9,16
03097800,CARSTEN INSTITUTE OF HAIR & BEAUTY      ,AZ,85282-5404,Proprietary  ,14,31,45,120,138,258
03100400,COCONINO COUNTY COMMUNITY COLLEGE       ,AZ,86001-2701,Public       ,47,110,157,952,1419,2371
03107000,SOUTHWEST CLG OF NATUROPATHIC MED       ,AZ,85282-0000,Private      ,0,11,11,4,455,459
03115000,ARIZONA COLLEGE OF ALLIED HEALTH        ,AZ,85302-3843,Proprietary  ,24,168,192,153,714,867
03120300,COLLEGE AMERICA                         ,AZ,86004-3936,Proprietary  ,26,141,167,151,535,686
03156300,ESTRELLA MOUNTAIN COMMUNITY COLLEGE     ,AZ,85392-1010,Public       ,136,282,418,1709,2651,4360
03156301,ESTRELLA MOUNTAIN COMMUNITY COLLEGE - SO,AZ,85392-1010,Public       ,36,87,123,468,900,1368
03347300,INTERNATIONAL BAPTIST COLLEGE           ,AZ,85282-7504,Private      ,2,1,3,46,21,67
03445300,HDS TRUCK DRIVING INSTITUTE             ,AZ,85731-0000,Proprietary  ,1,42,43,6,178,184
03478400,PHOENIX SEMINARY                        ,AZ,85018-7611,Private      ,0,4,4,1,75,76
03572300,EAST VALLEY INSTITUTE OF TECHNOLOGY     ,AZ,85201-6910,Public       ,6,12,18,88,114,202
03593300,SOUTHWEST INSTITUTE OF HEALING ARTS     ,AZ,85281-3658,Proprietary  ,21,71,92,94,550,644
03617500,PHOENIX INSTITUTE OF HERBAL MEDICINE & A,AZ,85012-0000,Proprietary  ,0,11,11,7,140,147
03695500,ARIZONA SCHOOL OF ACUPUNCTURE AND ORIENT,AZ,85712-1100,Proprietary  ,0,3,3,5,64,69
03740500,ART INSTITUTE OF TUCSON (THE)           ,AZ,85712-2732,Proprietary  ,26,26,52,206,270,476
03784400,TOHONO O'ODHAM COMMUNITY COLLEGE        ,AZ,85634-3129,Public       ,4,24,28,16,83,99
03814300,TURNING POINT BEAUTY COLLEGE            ,AZ,85222-4229,Proprietary  ,2,9,11,16,48,64
04051300,ART INSTITUTE OF PHOENIX (THE)          ,AZ,85021-2859,Proprietary  ,84,132,216,1180,1147,2327
04059300,TUCSON COLLEGE OF BEAUTY                ,AZ,85705-2451,Proprietary  ,6,16,22,67,71,138
04120900,ARIZONA CULINARY INSTITUTE              ,AZ,85259-4939,Proprietary  ,13,37,50,164,235,399
04131400,PHOENIX SCHOOL OF LAW                   ,AZ,85012-3330,Proprietary  ,1,19,20,8,441,449
04138800,MODERN TECHNIQUES BEAUTY COLLEGE        ,AZ,86403-2974,Proprietary  ,5,6,11,5,7,12
00142800,DELAWARE STATE UNIVERSITY               ,DE,19901-2277,Public       ,143,57,200,6205,1619,7824
00142900,GOLDEY BEACOM COLLEGE                   ,DE,19808-1993,Private      ,8,18,26,488,370,858
00143100,UNIVERSITY OF DELAWARE                  ,DE,19716-0099,Public       ,234,107,341,20833,2378,23211
00143300,WESLEY COLLEGE                          ,DE,19901-3875,Private      ,29,17,46,1938,391,2329
00143301,WESLEY COLLEGE-CTR FOR ADULT STUDIE     ,DE,19720-0000,Private      ,1,45,46,41,419,460
00331301,WIDENER UNIV SCHOOL OF LAW - DE         ,DE,19803-0000,Private      ,1,15,16,39,1687,1726
00705300,DELAWARE TECH & CMTY COLLEGE-OWENS      ,DE,19947-0000,Public       ,51,190,241,1682,2396,4078
00794800,WILMINGTON UNIVERSITY                   ,DE,19720-6491,Private      ,83,444,527,1840,5358,7198
01172700,DELAWARE TECH & CMTY CLG-TERRY          ,DE,19901-8736,Public       ,48,128,176,1549,2074,3623
01195002,DELAWARE COLLEGE OF ART & DESIGN        ,DE,19801-0000,Private      ,0,0,0,265,44,309
02125200,BEEBE SCHOOL OF NURSING                 ,DE,19958-1462,Private      ,2,2,4,31,47,78
02144900,DELAWARE TECH & CMTY CLG-STANTN/WLM     ,DE,19801-0000,Public       ,72,191,263,2689,3079,5768
02190400,SCHILLING DOUGLAS SCH OF HAIR DSGN      ,DE,19711-0000,Proprietary  ,11,22,33,71,149,220
02586902,STAR TECHNICAL INSTITUTE -              ,DE,19901-4615,Proprietary  ,0,2,2,28,214,242
03025800,DAWN TRAINING CENTRE                    ,DE,19805-1511,Proprietary  ,15,104,119,64,493,557
03543300,HARRIS SCHOOL OF BUSINESS               ,DE,19803-5341,Proprietary  ,48,152,200,158,541,699
03702300,DELAWARE LEARNING INSTITUTE OF COSMETOLO,DE,19939-9759,Proprietary  ,7,20,27,42,119,161
04130700,ACADEMY OF MASSAGE AND BODYWORK         ,DE,19701-1321,Proprietary  ,3,8,11,13,31,44
04139800,DELAWARE COLLEGE OF ART & DESIGN        ,DE,19801-3007,Private      ,5,3,8,53,28,81
        ,FEDERAL STUDENT AID USE ONLY            ,DC,20202-0000,,0,0,0,11,1740,1751
00143400,AMERICAN UNIVERSITY                     ,DC,20016-8020,Private      ,110,131,241,11442,9502,20944
00143700,CATHOLIC UNIVERSITY OF AMERICA          ,DC,20064-0002,Private      ,44,60,104,4733,2298,7031
00143711,"CATHOLIC UNIV AMERICA, LAW SCHOOL       ",DC,20064-0000,Private      ,0,9,9,30,1625,1655
00144100,UNIV OF THE DISTRICT OF COLUMBIA        ,DC,20008-0000,Public       ,77,177,254,1913,4056,5969
00144102,UNIV OF DIST OF COLUMBIA LAW SCH        ,DC,20008-0000,Public       ,1,9,10,39,670,709
00144300,GALLAUDET UNIVERSITY                    ,DC,20002-3695,Private      ,20,18,38,764,748,1512
00144400,GEORGE WASHINGTON UNIVERSITY            ,DC,20052-2353,Private      ,142,323,465,11266,8988,20254
00144402,GEORGE WASHINGTON UNIV LAW SCHL         ,DC,20052-0000,Private      ,0,22,22,26,4557,4583
00144403,GEORGE WASHINGTON UNIV SCH MED          ,DC,20052-0000,Private      ,0,7,7,33,1241,1274
00144500,GEORGETOWN UNIVERSITY                   ,DC,20057-1252,Private      ,107,122,229,12134,5480,17614
00144501,"GEORGETOWN UNIV, SCH OF MEDICINE        ",DC,20007-0000,Private      ,0,5,5,29,1196,1225
00144502,GEORGETOWN UNIVERSITY - GRADUATE SCHOOL ,DC,20057-0004,Private      ,0,11,11,0,11,11
00144503,GEORGETOWN UNIV LAW CENTER              ,DC,20001-0000,Private      ,1,29,30,29,5502,5531
00144800,HOWARD UNIVERSITY                       ,DC,20059-0001,Private      ,247,166,413,13890,8195,22085
00145600,SOUTHEASTERN UNIVERSITY                 ,DC,20024-2788,Private      ,4,44,48,177,895,1072
00145900,STRAYER UNIVERSITY                      ,DC,20005-2603,Proprietary  ,370,6858,7228,1983,46083,48066
00146000,TRINITY UNIVERSITY                      ,DC,20017-1004,Private      ,18,104,122,993,1629,2622
00146400,WESLEY THEOLOGICAL SEMINARY             ,DC,20016-0000,Private      ,0,21,21,1,285,286
00207701,JOHNS HOPKINS UNIV SCH ADV INTL STU     ,DC,20036-0000,Private      ,2,22,24,60,1281,1341
01006500,WASHINGTON THEOLOGICAL UNION            ,DC,20012-0000,Private      ,0,0,0,0,38,38
01195000,THE CORCORAN COLLEGE OF ART & DESIG     ,DC,20006-4804,Private      ,10,9,19,428,293,721
01266500,HARRISON CTR FOR CAREER EDUCATION       ,DC,20001-5303,Private      ,0,0,0,4,14,18
01280300,DOMINICAN HOUSE OF STUDIES              ,DC,20017-1584,Private      ,0,1,1,1,13,14
02132800,NAT'L CONSERVATORY DRAMATIC ARTS        ,DC,20007-2758,Private      ,2,1,3,6,24,30
02279200,DUDLEY BEAUTY COLG-WASHINGTON           ,DC,20018-0000,Proprietary  ,5,26,31,56,150,206
02588900,SANZ SCHOOL                             ,DC,20006-0000,Proprietary  ,84,383,467,304,1399,1703
03104300,CAREER BLAZERS LEARNING CENTER OF WASHIN,DC,20037-1881,Proprietary  ,30,195,225,140,889,1029
03218300,POTOMAC COLLEGE                         ,DC,20016-1860,Proprietary  ,12,148,160,61,655,716
03409600,BENNETT CAREER INSTITUTE                ,DC,20017-1754,Proprietary  ,8,43,51,73,275,348
03750300,TECHNICAL LEARNING CENTERS              ,DC,20005-3415,Proprietary  ,3,30,33,29,273,302
00154100,ABRAHAM BALDWIN AGRICULTURAL CLG        ,GA,31794-0000,Public       ,58,98,156,3387,1660,5047
00154200,AGNES SCOTT COLLEGE                     ,GA,30030-3797,Private      ,18,17,35,1188,313,1501
00154300,DARTON COLLEGE                          ,GA,31707-3098,Public       ,92,350,442,2520,4742,7262
00154400,ALBANY STATE UNIVERSITY                 ,GA,31705-2796,Public       ,137,188,325,6719,3657,10376
00154500,ANDREW COLLEGE                          ,GA,39840-1313,Private      ,10,3,13,446,49,495
00154600,ARMSTRONG ATLANTIC STATE UNIVERSITY     ,GA,31419-1997,Public       ,129,264,393,4143,5286,9429
00154700,ATLANTA CHRISTIAN COLLEGE               ,GA,30344-1999,Private      ,14,123,137,396,504,900
00155200,AUGUSTA STATE UNIVERSITY                ,GA,30904-2200,Public       ,116,212,328,4456,4730,9186
00155400,BERRY COLLEGE                           ,GA,30149-5007,Private      ,20,11,31,2301,229,2530
00155500,THOMAS UNIVERSITY                       ,GA,31792-7499,Private      ,8,74,82,323,1110,1433
00155600,BRENAU UNIVERSITY                       ,GA,30501-3668,Private      ,18,155,173,1060,2583,3643
00155700,BREWTON PARKER COLLEGE                  ,GA,30445-0000,Private      ,18,45,63,696,710,1406
00155800,COASTAL GEORGIA COMMUNITY COLLEGE       ,GA,31520-3644,Public       ,59,140,199,1361,2474,3835
00155900,CLARK ATLANTA UNIVERSITY                ,GA,30314-4385,Private      ,328,174,502,13690,4324,18014
00156000,COLUMBIA THEOLOGICAL SEMINARY           ,GA,30031-0000,Private      ,0,5,5,4,192,196
00156100,COLUMBUS STATE UNIVERSITY               ,GA,31907-5645,Public       ,121,247,368,5212,4698,9910
00156200,GEORGIA PERIMETER COLLEGE               ,GA,30021-0000,Public       ,535,1163,1698,12606,16830,29436
00156300,EMMANUEL COLLEGE                        ,GA,30639-0000,Private      ,8,11,19,705,212,917
00156400,EMORY UNIVERSITY                        ,GA,30322-1960,Private      ,152,243,395,10544,8600,19144
00156600,FORT VALLEY STATE UNIVERSITY            ,GA,31030-3298,Public       ,109,70,179,5106,1636,6742
00156700,GAINESVILLE STATE COLLEGE               ,GA,30503-0000,Public       ,155,194,349,5262,2655,7917
00156800,INTERDENOMINATIONAL THEOLOGY CENTER     ,GA,30314-0000,Private      ,0,14,14,3,545,548
00156900,GEORGIA INSTITUTE OF TECHNOLOGY         ,GA,30332-0002,Public       ,229,162,391,13358,3760,17118
00157000,SOUTHERN POLYTECHNIC STATE UNIV         ,GA,30060-2896,Public       ,75,133,208,2715,2160,4875
00157100,GEORGIA MILITARY COLLEGE                ,GA,31061-3398,Public       ,230,402,632,3274,4180,7454
00157200,GEORGIA SOUTHERN UNIVERSITY             ,GA,30460-8065,Public       ,536,305,841,16698,5499,22197
00157300,GEORGIA SOUTHWESTERN STATE UNIV         ,GA,31709-4693,Public       ,39,77,116,1956,1704,3660
00157400,GEORGIA STATE UNIVERSITY                ,GA,30303-3010,Public       ,516,908,1424,21078,21916,42994
00157500,GORDON COLLEGE                          ,GA,30204-1762,Public       ,109,120,229,3714,2233,5947
00157700,KENNESAW STATE UNIVERSITY               ,GA,30144-5591,Public       ,317,628,945,12363,11532,23895
00157800,LAGRANGE COLLEGE                        ,GA,30240-2999,Private      ,15,47,62,1144,595,1739
00157900,MEDICAL COLLEGE OF GEORGIA              ,GA,30912-0004,Public       ,17,72,89,547,2458,3005
00158000,MERCER UNIVERSITY                       ,GA,31207-0003,Private      ,65,329,394,3997,7431,11428
00158100,MIDDLE GEORGIA COLLEGE                  ,GA,31014-1599,Public       ,74,116,190,3324,1853,5177
00158200,MOREHOUSE COLLEGE                       ,GA,30314-3773,Private      ,142,43,185,5068,928,5996
00158500,NORTH GEORGIA COLLEGE & STATE UNIV      ,GA,30597-0001,Public       ,64,111,175,3392,1767,5159
00158600,OGLETHORPE UNIVERSITY                   ,GA,30319-2737,Private      ,28,35,63,1631,469,2100
00158700,PAINE COLLEGE                           ,GA,30901-3182,Private      ,36,20,56,1622,509,2131
00158800,PIEDMONT COLLEGE                        ,GA,30535-5644,Private      ,14,146,160,812,2372,3184
00158900,REINHARDT COLLEGE                       ,GA,30183-2981,Private      ,19,19,38,950,354,1304
00159000,SAVANNAH STATE UNIVERSITY               ,GA,31404-5298,Public       ,142,110,252,5651,2258,7909
00159100,SHORTER COLLEGE                         ,GA,30165-4298,Private      ,32,365,397,1483,3102,4585
00159200,SOUTH GEORGIA COLLEGE                   ,GA,31533-8104,Public       ,36,60,96,1534,1115,2649
00159400,SPELMAN COLLEGE                         ,GA,30314-4399,Private      ,165,41,206,6118,1056,7174
00159600,TOCCOA FALLS COLLEGE                    ,GA,30598-0001,Private      ,6,7,13,946,221,1167
00159700,TRUETT MCCONNELL COLLEGE                ,GA,30528-1264,Private      ,9,8,17,482,81,563
00159800,UNIVERSITY OF GEORGIA                   ,GA,30602-6114,Public       ,417,393,810,20298,10252,30550
00159900,VALDOSTA STATE UNIVERSITY               ,GA,31698-0001,Public       ,222,238,460,10900,4902,15802
00160000,WESLEYAN COLLEGE                        ,GA,31210-4407,Private      ,6,27,33,416,497,913
00160100,UNIV OF WEST GEORGIA                    ,GA,30118-0002,Public       ,135,218,353,9016,4693,13709
00160200,GEORGIA COLLEGE & STATE UNIVERSITY      ,GA,31061-0490,Public       ,95,100,195,5125,1963,7088
00160400,YOUNG HARRIS COLLEGE                    ,GA,30582-4137,Private      ,20,4,24,808,57,865
00348400,COVENANT COLLEGE                        ,GA,30750-4164,Private      ,17,54,71,1259,434,1693
00395600,DALTON STATE COLLEGE                    ,GA,30720-3797,Public       ,97,283,380,2715,3153,5868
00402300,APPALACHIAN TECHNICAL COLLEGE           ,GA,30143-0000,Public       ,22,115,137,302,863,1165
00402400,COOSA VALLEY TECHNICAL COLLEGE          ,GA,30161-6757,Public       ,99,436,535,1127,3213,4340
00402403,NORTHWESTERN TECHNICAL COLLEGE          ,GA,30739-0569,Public       ,84,442,526,980,3341,4321
00411700,GRADY HEALTH SYSTEM                     ,GA,30303-3050,Public       ,0,12,12,79,266,345
00525400,LANIER TECHNICAL COLLEGE                ,GA,30566-3499,Public       ,66,338,404,800,2636,3436
00525500,MOULTRIE TECHNICAL COLLEGE              ,GA,31768-0000,Public       ,61,396,457,696,2427,3123
00525600,VALDOSTA TECHNICAL COLLEGE              ,GA,31603-0000,Public       ,82,355,437,900,2876,3776
00551100,OKEFENOKEE TECHNICAL COLLEGE            ,GA,31501-4016,Public       ,50,240,290,435,1587,2022
00559900,AUGUSTA TECHNICAL COLLEGE               ,GA,30906-3399,Public       ,153,562,715,2012,5936,7948
00560000,ATHENS TECHNICAL COLLEGE                ,GA,30601-1579,Public       ,135,507,642,2086,4451,6537
00560100,ALBANY TECHNICAL COLLEGE                ,GA,31701-2648,Public       ,110,601,711,1254,4388,5642
00561300,FLINT RIVER TECHNICAL INSTITUTE         ,GA,30286-0014,Public       ,32,135,167,247,1145,1392
00561401,WEST GEORGIA TECHNICAL COLLEGE - ROOSEVE,GA,31830-0268,Public       ,1,2,3,2,2,4
00561500,SOUTHWEST GEORGIA TECHNICAL COLLEGE     ,GA,31792-2622,Public       ,53,229,282,634,2057,2691
00561600,SWAINSBORO TECHNICAL COLLEGE            ,GA,30401-5700,Public       ,22,107,129,231,780,1011
00561700,SOUTH GEORGIA TECHNICAL COLLEGE         ,GA,31709-8167,Public       ,82,271,353,931,1841,2772
00561800,SAVANNAH TECHNICAL COLLEGE              ,GA,31405-5594,Public       ,194,942,1136,2243,7964,10207
00561900,NORTH GEORGIA TECHNICAL COLLEGE         ,GA,30523-0000,Public       ,102,368,470,940,2192,3132
00562000,CHATTAHOOCHEE TECHNICAL COLLEGE         ,GA,30060-3398,Public       ,190,582,772,2347,5174,7521
00562100,GRIFFIN TECHNICAL COLLEGE               ,GA,30223-2097,Public       ,103,499,602,1326,4144,5470
00562200,DEKALB TECHNICAL COLLEGE                ,GA,30021-0000,Public       ,164,852,1016,1730,7152,8882
00562400,COLUMBUS TECHNICAL COLLEGE              ,GA,31904-6572,Public       ,94,448,542,1293,4228,5521
00576300,CENTRAL GEORGIA TECHNICAL COLLEGE       ,GA,31206-3628,Public       ,166,993,1159,1800,7313,9113
00772800,MACON STATE COLLEGE                     ,GA,31206-5145,Public       ,86,324,410,3337,5439,8776
00854300,ATLANTA TECHNICAL COLLEGE               ,GA,30310-4499,Public       ,141,724,865,1828,6003,7831
00897600,CLAYTON STATE UNIVERSITY                ,GA,30260-0285,Public       ,118,379,497,4758,7626,12384
00918300,EAST CENTRAL TECHNICAL COLLEGE          ,GA,31750-0000,Public       ,33,228,261,320,1319,1639
00927000,ART INSTITUTE OF ATLANTA                ,GA,30328-1649,Proprietary  ,442,685,1127,7440,5509,12949
00950700,GEORGIA HIGHLANDS COLLEGE               ,GA,30162-0000,Public       ,102,164,266,2834,2627,5461
01031903,MEDIX SCHOOL                            ,GA,30080-7630,Proprietary  ,66,229,295,270,1088,1358
01035601,EVEREST INSTITUTE - DEKALB              ,GA,30035-3420,Proprietary  ,79,265,344,334,1135,1469
01048700,WEST GEORGIA TECHNICAL COLLEGE          ,GA,30182-6476,Public       ,123,520,643,1519,4089,5608
01048704,WEST GEORGIA TECHNICAL COLLEGE          ,GA,30240-5957,Public       ,48,265,313,622,1795,2417
01077100,GUPTON JONES COLLEGE                    ,GA,30035-4022,Private      ,12,52,64,117,281,398
01099700,EAST GEORGIA COLLEGE                    ,GA,30401-2699,Public       ,101,103,204,2257,1163,3420
01107400,BAINBRIDGE COLLEGE                      ,GA,39819-8400,Public       ,83,315,398,1184,3262,4446
01110901,EVEREST COLLEGE - EVEREST INSTITUTE     ,GA,30067-8340,Proprietary  ,53,237,290,193,886,1079
01112301,EVEREST COLLEGE - EVEREST INSTITUTE- NOR,GA,30093-2813,Proprietary  ,57,317,374,258,1399,1657
01157400,BAUDER COLLEGE                          ,GA,30313-2439,Proprietary  ,79,227,306,770,1336,2106
01205100,PRO WAY HAIR SCHOOL                     ,GA,30083-2884,Proprietary  ,14,63,77,80,357,437
01216500,ATLANTA METROPOLITAN COLLEGE            ,GA,30310-4498,Public       ,107,256,363,2090,3442,5532
01303900,SOUTH UNIVERSITY                        ,GA,31406-4881,Proprietary  ,280,4109,4389,1567,19024,20591
02055000,WAYCROSS COLLEGE                        ,GA,31503-0000,Public       ,30,53,83,538,738,1276
02060900,BROWN CLG OF COURT REPORTING & M.T.     ,GA,30318-2570,Proprietary  ,3,36,39,30,357,387
02074800,LIFE UNIVERSITY                         ,GA,30060-0000,Private      ,22,47,69,294,2169,2463
02089700,HERZING COLLEGE                         ,GA,30326-1332,Proprietary  ,39,140,179,278,1057,1335
02110501,ART INSTITUTE OF CHARLOTTE (THE) - BROWN,GA,30328-1635,Proprietary  ,2,7,9,63,59,122
02113604,AMERICAN INTERCONTINENTAL UNIV - DUNWOOD,GA,30328-1649,Proprietary  ,34,140,174,652,1996,2648
02116000,SANFORD-BROWN COLLEGE                   ,GA,30328-4803,Proprietary  ,57,319,376,363,2030,2393
02141500,SAVANNAH COLLEGE OF ART & DESIGN        ,GA,31402-3146,Private      ,185,151,336,8385,3455,11840
02202800,AUGUSTA AREA DIET INTERN UNIV HOSP      ,GA,30901-0000,Private      ,0,0,0,2,26,28
02205300,SAVANNAH RIVER COLLEGE                  ,GA,30909-0000,Proprietary  ,1,15,16,54,408,462
02217200,PORTFOLIO CENTER                        ,GA,30309-0000,Proprietary  ,1,12,13,19,143,162
02263105,ANTHEM COLLEGE - HIGH-TECH INSTITUTE - M,GA,30324-3398,Proprietary  ,2,0,2,28,43,71
02266200,AMERICAN PROFESSIONAL INSTITUTE         ,GA,31201-0000,Proprietary  ,81,403,484,336,1655,1991
02279500,HEART OF GEORGIA TECHNICAL COLLEGE      ,GA,31021-0000,Public       ,42,158,200,434,1403,1837
02284300,INTERACTIVE COLLEGE OF TECHNOLOGY       ,GA,30341-0000,Proprietary  ,50,404,454,251,1856,2107
02284308,INTERACTIVE LEARNING SYSTEMS            ,GA,30260-0000,Proprietary  ,8,60,68,59,326,385
02284309,INTERACTIVE COLLEGE OF TECHNOLOGY       ,GA,30501-0000,Proprietary  ,7,85,92,41,299,340
02285500,"CREATIVE CIRCUS, THE                    ",GA,30324-0000,Proprietary  ,4,20,24,77,271,348
02288400,GWINNETT TECHNICAL INSTITUTE            ,GA,30043-5702,Public       ,203,731,934,2565,6402,8967
02313902,WESTWOOD COLLEGE - O'HARE AIRPORT - ATLA,GA,30345-2807,Proprietary  ,30,80,110,315,542,857
02318600,GEORGIA MEDICAL INSTITUTE               ,GA,30303-0000,Proprietary  ,0,0,0,68,134,202
02321400,ROFFLER-MOLER HAIRSTYLING COLLEGE       ,GA,30062-0000,Proprietary  ,10,17,27,53,121,174
02354500,SOUTHEASTERN BEAUTY SCHOOLS             ,GA,31906-0000,Proprietary  ,4,27,31,24,148,172
02482100,MOREHOUSE SCHOOL OF MEDICINE            ,GA,30310-0000,Private      ,3,9,12,126,603,729
02502700,ADVANCED CAREER TRAINING                ,GA,30329-0000,Proprietary  ,52,298,350,184,1115,1299
02502701,ADVANCED CAREER TRAINING-RIVERDALE      ,GA,30274-0000,Proprietary  ,52,198,250,209,763,972
02508600,MIDDLE GEORGIA TECHNICAL COLLEGE        ,GA,31088-0000,Public       ,91,366,457,842,2513,3355
02520000,INTERNATIONAL SCH SKIN & NAILCARE       ,GA,30342-0000,Proprietary  ,9,65,74,51,297,348
02577000,ARNOLD / PADRICKS  UNIV OF COSM         ,GA,30297-0000,Proprietary  ,21,39,60,83,226,309
02577700,BEAUTY COLLEGE OF AMERICA               ,GA,30297-0000,Proprietary  ,4,11,15,38,110,148
02578300,INTERNATIONAL CITY BEAUTY COLLEGE       ,GA,31093-3631,Proprietary  ,0,1,1,9,29,38
02580200,ATLANTA SCHOOL OF MASSAGE               ,GA,30338-0000,Proprietary  ,10,40,50,76,323,399
02583000,GWINNETT COLLEGE OF BUSINESS            ,GA,30047-3447,Proprietary  ,16,93,109,151,780,931
02607600,CAPELLI LEARNING CTR FOR COSM           ,GA,30324-0000,Proprietary  ,6,35,41,70,253,323
03005400,ARTISTIC BEAUTY COLLEGE                 ,GA,30013-2076,Proprietary  ,47,179,226,260,811,1071
03022601,WESTERN CULINARY INSTITUTE - LE CORDON B,GA,30084-5893,Proprietary  ,13,24,37,146,220,366
03029000,NORTH METRO TECHNICAL COLLEGE           ,GA,30102-3129,Public       ,171,463,634,1547,2953,4500
03030000,OGEECHEE TECHNICAL COLLEGE              ,GA,30458-8049,Public       ,102,380,482,1304,2645,3949
03032100,ALTAMAHA TECHNICAL COLLEGE              ,GA,31545-4465,Public       ,28,128,156,289,1013,1302
03042700,LAURUSTECHNICAL INSTITUTE               ,GA,30030-1506,Proprietary  ,25,162,187,115,636,751
03066500,SOUTHEASTERN TECHNICAL COLLEGE          ,GA,30474-8817,Public       ,33,188,221,391,1352,1743
03072304,EVEREST COLLEGE - EVEREST INSTITUTE     ,GA,30236-0000,Proprietary  ,98,292,390,424,1401,1825
03076300,BEULAH HEIGHTS BIBLE COLLEGE            ,GA,30316-1873,Private      ,1,40,41,41,703,744
03079202,WESTWOOD COLLEGE - ATLANTA MIDTOWN      ,GA,30309-2848,Proprietary  ,63,152,215,638,997,1635
03081500,SOUTHEASTERN BEAUTY SCHOOL              ,GA,31917-0000,Proprietary  ,4,27,31,27,157,184
03089100,GEORGIA INSTITUTE OF COSMETOLOGY        ,GA,30606-3152,Proprietary  ,14,57,71,100,307,407
03090600,COBB BEAUTY COLLEGE                     ,GA,30144-2828,Proprietary  ,2,5,7,22,50,72
03100900,LUTHER RICE UNIVERSITY                  ,GA,30038-2454,Private      ,0,32,32,19,675,694
03102000,RIVERTOWN SCHOOL OF BEAUTY              ,GA,31904-4747,Proprietary  ,4,45,49,53,182,235
03104500,ATLANTA INSTITUTE OF MUSIC              ,GA,30096-4988,Proprietary  ,22,19,41,144,159,303
03116100,VOGUE BEAUTY SCHOOL                     ,GA,30141-2226,Proprietary  ,7,19,26,31,112,143
03155500,SANDERSVILLE REGIONAL TECH INST         ,GA,31082-6179,Public       ,31,104,135,229,685,914
03173300,ATLANTA'S JOHN MARSHALL LAW SCHOOL      ,GA,30309-0000,Proprietary  ,2,16,18,17,1117,1134
03232304,LINCOLN COLLEGE OF TECHNOLOGY           ,GA,30067-8638,Proprietary  ,57,114,171,239,745,984
03251300,BEACON UNIVERSITY                       ,GA,31909-4663,Private      ,0,6,6,32,235,267
03355402,PSYCHOLOGICAL STUDIES INSTITUTE -       ,GA,30327-2921,Private      ,0,0,0,13,161,174
03391300,ROSS MEDICAL EDUCATION CENTER           ,GA,30033-3105,Proprietary  ,0,0,0,10,38,48
03418300,GWINNETT COLLEGE-SANDY SPRINGS          ,GA,30328-3161,Proprietary  ,4,40,44,33,185,218
03445500,FAYETTE BEAUTY ACADEMY                  ,GA,30214-1191,Proprietary  ,0,11,11,12,72,84
03522300,POWDER SPRINGS BEAUTY COLLEGE           ,GA,30127-2926,Proprietary  ,0,0,0,4,28,32
03523300,AVIATION INSTITUTE OF MAINTENANCE       ,GA,30045-6716,Proprietary  ,21,108,129,181,657,838
03753400,MICHAEL'S SCHOOL OF BEAUTY              ,GA,31211-1493,Proprietary  ,5,23,28,38,164,202
03804400,JAVELIN TECHNICAL TRAINING CENTER       ,GA,30339-6040,Proprietary  ,100,369,469,409,1739,2148
03804401,JAVELIN TECHNICAL TRAINING CENTER -     ,GA,30260-1756,Proprietary  ,0,4,4,11,50,61
03804402,JAVELIN TECHNICAL TRAINING CENTER -     ,GA,30084-5252,Proprietary  ,1,4,5,9,49,58
03812300,OMNITECH INSTITUTE                      ,GA,30035-1206,Proprietary  ,35,89,124,176,493,669
04021300,AUGUSTA SCHOOL OF MASSAGE               ,GA,30809-0000,Proprietary  ,2,5,7,21,49,70
04091300,SAVANNAH SCHOOL OF MASSAGE THERAPY      ,GA,31406-2711,Proprietary  ,2,6,8,28,82,110
04105300,NIGHTINGALE MEDICAL INSTITUTE           ,GA,30084-4036,Proprietary  ,0,0,0,80,264,344
04126800,ACADEMY OF SOMATIC HEALING ARTS (ASHA)  ,GA,30071-1024,Proprietary  ,2,15,17,30,145,175
04128500,SOUTHERN CATHOLIC COLLEGE               ,GA,30534-3111,Private      ,3,1,4,199,21,220
04142900,GEORGIA GWINNETT COLLEGE                ,GA,30043-7409,Public       ,94,114,208,360,404,764
04147000,PAUL MITCHELL THE SCHOOL ATLANTA        ,GA,30318-5241,Proprietary  ,14,27,41,14,27,41
        ,CHICAGO THEOLOGICAL SEMINARY            ,IL,60637-0000,Private      ,0,0,0,3,141,144
00162800,AMERICAN ACADEMY OF ART                 ,IL,60604-4302,Proprietary  ,7,8,15,511,129,640
00163300,AUGUSTANA COLLEGE                       ,IL,61201-2296,Private      ,13,4,17,3401,143,3544
00163400,AURORA UNIVERSITY                       ,IL,60506-4892,Private      ,28,133,161,2276,2423,4699
00163600,SOUTHWESTERN ILLINOIS COLLEGE           ,IL,62221-5899,Public       ,166,510,676,3489,6048,9537
00163800,BLACK HAWK COLLEGE                      ,IL,61265-5899,Public       ,70,148,218,1929,2668,4597
00163900,BLACKBURN COLLEGE                       ,IL,62626-1498,Private      ,10,2,12,878,124,1002
00164000,PRAIRIE STATE COLLEGE                   ,IL,60411-8226,Public       ,96,251,347,1978,3669,5647
00164100,BRADLEY UNIVERSITY                      ,IL,61625-0002,Private      ,42,41,83,6113,1002,7115
00164300,SPOON RIVER COLLEGE                     ,IL,61520-8907,Public       ,15,46,61,701,720,1421
00164700,CITY COLLEGES OF CHICAGO                ,IL,60606-6998,Public       ,15,40,55,377,604,981
00164800,TRUMAN COLLEGE                          ,IL,60640-5691,Public       ,102,375,477,2241,4056,6297
00164900,RICHARD J DALEY COLLEGE                 ,IL,60652-1299,Public       ,131,346,477,2199,3721,5920
00165000,CITY COLLEGES OF CHICAGO-MALCOLM X      ,IL,60612-3197,Public       ,123,510,633,2168,5399,7567
00165200,HAROLD WASHINGTON COLLEGE               ,IL,60601-2403,Public       ,239,453,692,4348,5717,10065
00165400,KENNEDY KING COLLEGE                    ,IL,60621-3798,Public       ,189,733,922,3149,8074,11223
00165500,WRIGHT COLLEGE                          ,IL,60634-1591,Public       ,161,308,469,3881,4245,8126
00165700,MIDWESTERN UNIVERSITY                   ,IL,60515-1200,Private      ,4,11,15,122,2617,2739
00165900,ROSALIND FRANKLIN UNIVERSITY OF MEDICINE,IL,60064-3095,Private      ,0,18,18,17,2037,2054
00166100,CHICAGO THEOLOGICAL SEMINARY            ,IL,60637-0000,Private      ,0,3,3,0,3,3
00166300,SPERTUS COLLEGE                         ,IL,60605-1995,Private      ,0,12,12,0,82,82
00166400,UNIVERSITY OF ST FRANCIS                ,IL,60435-6188,Private      ,14,84,98,1368,1668,3036
00166500,COLUMBIA COLLEGE                        ,IL,60605-1996,Private      ,233,182,415,11654,4533,16187
00166600,CONCORDIA UNIVERSITY                    ,IL,60305-1499,Private      ,17,233,250,1450,3111,4561
00166900,DANVILLE AREA COMMUNITY COLLEGE         ,IL,61832-5199,Public       ,42,134,176,794,1436,2230
00167100,DEPAUL UNIVERSITY                       ,IL,60604-2287,Private      ,235,730,965,15286,13897,29183
00167400,EASTERN ILLINOIS UNIVERSITY             ,IL,61920-3099,Public       ,138,124,262,9608,3134,12742
00167500,ELGIN COMMUNITY COLLEGE                 ,IL,60123-7193,Public       ,103,188,291,2433,2789,5222
00167600,ELMHURST COLLEGE                        ,IL,60126-3296,Private      ,43,38,81,3332,1078,4410
00167800,EUREKA COLLEGE                          ,IL,61530-9976,Private      ,5,5,10,871,212,1083
00168100,HIGHLAND COMMUNITY COLLEGE              ,IL,61032-9341,Public       ,51,124,175,811,1054,1865
00168200,GARRETT-EVANGELICAL THEOLOGICAL SEM     ,IL,60201-0000,Private      ,0,6,6,1,189,190
00168400,GREENVILLE COLLEGE                      ,IL,62246-1199,Private      ,12,52,64,1532,738,2270
00168500,HEBREW THEOLOGICAL COLLEGE              ,IL,60077-3263,Private      ,10,1,11,360,16,376
00168800,ILLINOIS COLLEGE                        ,IL,62650-2299,Private      ,5,1,6,1272,82,1354
00168900,ILLINOIS COLLEGE OF OPTOMETRY           ,IL,60616-3878,Private      ,0,1,1,16,669,685
00169100,ILLINOIS INSTITUTE OF TECHNOLOGY        ,IL,60616-0000,Private      ,33,93,126,2563,2085,4648
00169103,CHICAGO KENT COLLEGE OF LAW             ,IL,60661-0000,Private      ,0,18,18,16,1944,1960
00169200,ILLINOIS STATE UNIVERSITY               ,IL,61790-1000,Public       ,195,110,305,17228,4227,21455
00169300,NORTHEASTERN ILLINOIS UNIV              ,IL,60625-4699,Public       ,104,190,294,5091,6118,11209
00169400,CHICAGO STATE UNIVERSITY                ,IL,60628-1598,Public       ,103,403,506,5732,9728,15460
00169600,ILLINOIS WESLEYAN UNIVERSITY            ,IL,61701-0000,Private      ,13,2,15,2776,82,2858
00169800,JOHN MARSHALL LAW SCHOOL                ,IL,60604-0000,Private      ,0,44,44,18,2472,2490
00169900,JOLIET JUNIOR COLLEGE                   ,IL,60431-8938,Public       ,121,302,423,4442,4581,9023
00170000,JUDSON UNIVERSITY                       ,IL,60123-1498,Private      ,8,72,80,829,779,1608
00170100,KASKASKIA COLLEGE                       ,IL,62801-7878,Public       ,38,191,229,1270,2133,3403
00170300,KENDALL COLLEGE                         ,IL,60622-4278,Proprietary  ,39,191,230,1008,1945,2953
00170400,KNOX COLLEGE                            ,IL,61401-4999,Private      ,11,2,13,2308,74,2382
00170500,ILLINOIS VALLEY COMMUNITY COLLEGE       ,IL,61348-9692,Public       ,32,97,129,1118,1385,2503
00170600,LAKE FOREST COLLEGE                     ,IL,60045-2399,Private      ,17,5,22,1710,110,1820
00170700,LEWIS UNIVERSITY                        ,IL,60446-2200,Private      ,38,155,193,3643,2663,6306
00170800,LINCOLN CHRISTIAN COLLEGE               ,IL,62656-2167,Private      ,4,41,45,483,590,1073
00170900,LINCOLN COLLEGE                         ,IL,62656-1699,Private      ,24,30,54,1246,473,1719
00171000,LOYOLA UNIVERSITY CHICAGO               ,IL,60626-0000,Private      ,159,309,468,15249,9170,24419
00171002,LOYOLA STRITCH SCHOOL OF MEDICINE       ,IL,60153-0000,Private      ,0,4,4,11,1080,1091
00171200,LUTHERAN SCHOOL OF THEOL AT CHICAGO     ,IL,60615-0000,Private      ,0,3,3,0,143,143
00171600,MACCORMAC COLLEGE                       ,IL,60602-4405,Private      ,7,11,18,57,140,197
00171700,MACMURRAY COLLEGE                       ,IL,62650-2590,Private      ,0,4,4,698,230,928
00172100,MCCORMICK THEOLOGICAL SEMINARY          ,IL,60615-5108,Private      ,0,7,7,1,126,127
00172200,MCKENDREE UNIVERSITY                    ,IL,62254-1299,Private      ,19,79,98,1636,1512,3148
00172300,MEADVILLE LOMBARD THEOLOGICAL SCHOOL    ,IL,60637-1602,Private      ,0,4,4,0,63,63
00172400,MILLIKIN UNIVERSITY                     ,IL,62522-2084,Private      ,22,38,60,2660,794,3454
00172500,MONMOUTH COLLEGE                        ,IL,61462-1963,Private      ,7,0,7,1853,82,1935
00172800,MORTON COLLEGE                          ,IL,60804-4398,Public       ,88,192,280,1429,1918,3347
00173200,NATIONAL UNIV OF HEALTH SCIENCES        ,IL,60148-4583,Private      ,2,37,39,57,839,896
00173300,NATIONAL-LOUIS UNIVERSITY               ,IL,60603-3032,Private      ,7,685,692,276,7428,7704
00173400,NORTH CENTRAL COLLEGE                   ,IL,60540-4690,Private      ,28,39,67,2854,690,3544
00173500,NORTH PARK UNIVERSITY                   ,IL,60625-4895,Private      ,22,81,103,2288,1455,3743
00173600,NORTHERN BAPTIST THEOL SEMINARY         ,IL,60148-0000,Private      ,0,1,1,1,15,16
00173700,NORTHERN ILLINOIS UNIVERSITY            ,IL,60115-2854,Public       ,242,282,524,18500,8341,26841
00173900,NORTHWESTERN UNIV                       ,IL,60208-0001,Private      ,139,297,436,15473,9886,25359
00174100,OLIVET NAZARENE UNIVERSITY              ,IL,60914-2271,Private      ,18,293,311,2815,2115,4930
00174200,IL EASTERN COMM COLGS-OLNEY CENTRAL     ,IL,62450-1099,Public       ,21,65,86,598,707,1305
00174500,QUINCY UNIVERSITY                       ,IL,62301-2699,Private      ,11,107,118,1337,774,2111
00174600,ROBERT MORRIS UNIVERSITY ILLINOIS       ,IL,60605-1225,Private      ,138,356,494,4610,5523,10133
00174700,ROCK VALLEY COLLEGE                     ,IL,61114-5699,Public       ,76,299,375,2517,4251,6768
00174800,ROCKFORD COLLEGE                        ,IL,61108-2393,Private      ,10,77,87,946,1079,2025
00174900,ROOSEVELT UNIVERSITY                    ,IL,60605-1394,Private      ,84,357,441,3546,7186,10732
00175000,DOMINICAN UNIVERSITY                    ,IL,60305-1066,Private      ,24,109,133,2135,1518,3653
00175200,SAUK VALLEY COMMUNITY COLLEGE           ,IL,61021-9112,Public       ,45,98,143,985,1164,2149
00175300,SCHOOL OF ART INSTITUTE OF CHICAGO      ,IL,60603-3017,Private      ,51,58,109,2872,2019,4891
00175400,SEABURY-WESTERN THEO SEMINARY           ,IL,60201-0000,Private      ,0,0,0,0,27,27
00175600,SHIMER COLLEGE                          ,IL,60616-3893,Private      ,3,8,11,112,61,173
00175700,SOUTHEASTERN ILLINOIS COLLEGE           ,IL,62946-4925,Public       ,31,56,87,593,774,1367
00175800,SOUTHERN ILL UNIV-CARBONDALE            ,IL,62901-0000,Public       ,178,329,507,14123,8160,22283
00175900,SOUTHERN ILL UNIV-EDWARDSVILLE          ,IL,62026-1060,Public       ,101,155,256,9605,5076,14681
00175924,SO IL UNIV-SCHL OF DENTAL MEDICINE      ,IL,62002-0000,Public       ,0,1,1,6,202,208
00176100,SPRINGFIELD COLLEGE IN ILLINOIS         ,IL,62702-2694,Private      ,6,27,33,432,610,1042
00176500,UNIVERSITY OF ST MARY OF THE LAKE       ,IL,60060-0000,Private      ,0,0,0,0,12,12
00176700,BENEDICTINE UNIVERSITY                  ,IL,60532-0900,Private      ,28,361,389,2250,3366,5616
00176800,ST XAVIER UNIVERSITY                    ,IL,60655-3199,Private      ,30,145,175,3687,3452,7139
00176900,SOUTH SUBURBAN COLLEGE                  ,IL,60473-9978,Public       ,141,440,581,2439,5879,8318
00177100,TRINITY CHRISTIAN COLLEGE               ,IL,60463-0929,Private      ,17,39,56,1196,736,1932
00177200,TRINITY INTERNATIONAL UNIVERSITY        ,IL,60015-1283,Private      ,15,80,95,862,1192,2054
00177300,TRITON COLLEGE                          ,IL,60171-1995,Public       ,197,389,586,2956,3943,6899
00177400,UNIVERSITY OF CHICAGO                   ,IL,60637-1476,Private      ,97,67,164,9825,2242,12067
00177401,UNIV OF CHICAGO PRITZKER SCH OF MED     ,IL,60637-0000,Private      ,0,0,0,30,657,687
00177403,"UNIV OF CHICAGO, GRAD SCH OF BUS        ",IL,60637-0000,Private      ,0,78,78,23,1377,1400
00177405,UNIVERSITY OF CHICAGO GRADUATE          ,IL,60637-0000,Private      ,1,74,75,101,5422,5523
00177500,UNIV OF ILLINOIS @ URBANA-CHAMPAIGN     ,IL,61820-5796,Public       ,268,241,509,24939,7967,32906
00177600,UNIV OF ILLINOIS AT CHICAGO             ,IL,60607-7163,Public       ,267,377,644,17118,13109,30227
00177800,VANDERCOOK COLLEGE OF MUSIC             ,IL,60616-3731,Private      ,2,2,4,148,88,236
00177900,IL EASTERN COMM COLGS-WABASH VALLEY     ,IL,62863-2699,Public       ,23,42,65,438,386,824
00178000,WESTERN ILLINOIS UNIVERSITY             ,IL,61455-1390,Public       ,115,131,246,9917,3527,13444
00178100,WHEATON COLLEGE                         ,IL,60187-5535,Private      ,17,16,33,2477,598,3075
00178300,WORSHAM COLLEGE OF MORTUARY SCIENCE     ,IL,60090-2646,Proprietary  ,3,12,15,55,122,177
00396100,HARPER COLLEGE                          ,IL,60067-7398,Public       ,223,312,535,4025,3359,7384
00418100,ADVOCATE TRINITY HOSPITAL SCHOOL OF RADI,IL,60617-3982,Private      ,0,1,1,24,90,114
00456000,GEM CITY COLLEGE                        ,IL,62301-4949,Proprietary  ,0,10,10,11,41,52
00456800,MIDSTATE COLLEGE                        ,IL,61614-3558,Proprietary  ,7,92,99,72,875,947
00457100,SPARKS COLLEGE                          ,IL,62565-2241,Proprietary  ,2,1,3,7,16,23
00512732,BROWN MACKIE COLLEGE-MERRILLVILLE - BROW,IL,61265-7062,Proprietary  ,0,6,6,5,27,32
00621400,BLESSING RIEMAN COLLEGE OF NURSING      ,IL,62301-0000,Private      ,0,2,2,63,76,139
00621401,BLESSING HOSP SCH MED LAB TECH          ,IL,62301-0000,Private      ,0,0,0,0,4,4
00621402,BLESSING HOSP SCH OF RAD TECH           ,IL,62301-2852,Private      ,0,0,0,8,12,20
00621403,BLESSING HOSPITAL - COLLEGE OF NURSING  ,IL,62305-7005,Private      ,0,0,0,13,16,29
00622501,TRINITY COLLEGE OF NURSING & HEALTH SCIE,IL,61201-5317,Private      ,1,7,8,80,205,285
00622800,METHODIST MED CTR OF ILL SCH NRSNG      ,IL,61636-0000,Private      ,0,3,3,75,155,230
00624000,ST FRANCIS MED CLG OF NRSG              ,IL,61603-3783,Private      ,0,6,6,161,307,468
00665600,COLLEGE OF DUPAGE                       ,IL,60137-6599,Public       ,233,466,699,6156,6057,12213
00675300,ILLINOIS CENTRAL COLLEGE                ,IL,61635-0001,Public       ,121,397,518,3445,4655,8100
00693100,WAUBONSEE COMMUNITY COLLEGE             ,IL,60554-0000,Public       ,106,220,326,1587,2245,3832
00711800,PARKLAND COLLEGE                        ,IL,61821-1899,Public       ,85,179,264,3648,3105,6753
00711900,REND LAKE COLLEGE                       ,IL,62846-9801,Public       ,38,93,131,1197,1523,2720
00717000,LINCOLN LAND COMMUNITY COLLEGE          ,IL,62794-9256,Public       ,46,161,207,2114,3177,5291
00726500,CARL SANDBURG COLLEGE                   ,IL,61401-9576,Public       ,20,114,134,912,1457,2369
00754900,COYNE AMERICAN INSTITUTE                ,IL,60607-1300,Proprietary  ,56,226,282,451,1301,1752
00764400,LAKE LAND COLLEGE                       ,IL,61938-9366,Public       ,43,160,203,2042,2007,4049
00768400,KISHWAUKEE COLLEGE                      ,IL,60150-9699,Public       ,43,82,125,1421,1371,2792
00769000,KANKAKEE COMMUNITY COLLEGE              ,IL,60901-6505,Public       ,48,184,232,1138,1993,3131
00769100,MCHENRY COUNTY COLLEGE                  ,IL,60012-2761,Public       ,47,136,183,1306,1446,2752
00769200,MORAINE VALLEY COMMUNITY COLLEGE        ,IL,60465-0937,Public       ,194,252,446,4151,3804,7955
00769300,SHAWNEE COMMUNITY COLLEGE               ,IL,62992-9725,Public       ,31,168,199,680,1443,2123
00769400,COLLEGE OF LAKE COUNTY                  ,IL,60030-1198,Public       ,225,394,619,2866,3792,6658
00793700,MS ROBERTS ACADEMY OF BEAUTY CULT       ,IL,60181-2930,Proprietary  ,6,11,17,27,77,104
00807600,JOHN A LOGAN COLLEGE                    ,IL,62918-2500,Public       ,77,170,247,1969,2609,4578
00814604,EVEREST UNIVERSITY - EVEREST  COLLEGE   ,IL,60803-4517,Proprietary  ,42,249,291,219,1251,1470
00825900,EDUCATORS OF BEAUTY                     ,IL,61081-3611,Proprietary  ,5,31,36,52,173,225
00825901,EDUCATORS OF BEAUTY                     ,IL,61104-0000,Proprietary  ,1,8,9,38,143,181
00832800,ALVAREITA'S COLLEGE OF COSMETOLOGY      ,IL,62025-2041,Proprietary  ,2,15,17,33,79,112
00854500,ROCKFORD BUSINESS COLLEGE               ,IL,61103-0000,Proprietary  ,31,114,145,195,941,1136
00869402,RASMUSSEN COLLEGE - SAINT CLOUD - ROCKFO,IL,61108-2513,Proprietary  ,29,176,205,227,995,1222
00869403,RASMUSSEN COLLEGE - SAINT CLOUD - AURORA,IL,60506-0000,Proprietary  ,13,55,68,39,143,182
00869404,RASMUSSEN COLLEGE - SAINT CLOUD - ROMEOV,IL,60446-0000,Proprietary  ,0,2,2,0,2,2
00888000,MORRISON INSTITUTE OF TECHNOLOGY        ,IL,61270-2959,Private      ,0,0,0,136,18,154
00893800,GRAHAM HOSPITAL SCH OF NURSING          ,IL,61520-2497,Private      ,0,3,3,24,55,79
00893900,CANNELLA SCHOOL OF HAIR DESIGN          ,IL,60406-2130,Proprietary  ,1,19,20,28,115,143
00914500,GOVERNORS STATE UNIVERSITY              ,IL,60466-0975,Public       ,25,268,293,734,5222,5956
00923200,CATHOLIC THEOLOGICAL UNION              ,IL,60615-0000,Private      ,0,0,0,0,51,51
00933300,UNIV OF ILLINOIS AT SPRINGFIELD         ,IL,62703-5407,Public       ,28,117,145,1703,2592,4295
00947500,EDUCATORS OF BEAUTY                     ,IL,61301-2404,Proprietary  ,3,9,12,21,53,74
00959500,CANNELLA SCHOOL OF HAIR DESIGN          ,IL,60617-4303,Proprietary  ,0,11,11,30,104,134
00976700,OLIVE-HARVEY COLLEGE                    ,IL,60628-1696,Public       ,82,363,445,1159,3382,4541
00978600,IL EASTERN COMM COLGS-LINCOLN TRAIL     ,IL,62454-5708,Public       ,11,26,37,351,408,759
00980000,RUSH UNIVERSITY                         ,IL,60612-3806,Private      ,1,40,41,161,2001,2162
00989600,OAKTON COMMUNITY COLLEGE                ,IL,60016-1268,Public       ,107,213,320,2534,2196,4730
00998700,SAINT ANTHONY COLLEGE OF NURSING        ,IL,61108-2468,Private      ,0,2,2,99,213,312
01002000,LEWIS AND CLARK COMMUNITY COLLEGE       ,IL,62035-2466,Public       ,103,191,294,1876,2604,4480
01031600,LINCOLN COLLEGE OF TECHNOLOGY           ,IL,60160-1605,Proprietary  ,125,257,382,975,1277,2252
01050100,LAKEVIEW  COLLEGE OF NURSING            ,IL,61832-3781,Private      ,0,1,1,130,172,302
01069500,TRI-COUNTY BEAUTY ACADEMY               ,IL,62056-2036,Proprietary  ,2,7,9,12,41,53
01071000,CAPITAL AREA SCH OF PRAC NRSG           ,IL,62707-0000,Public       ,0,6,6,43,369,412
01072700,DEVRY UNIVERSITY                        ,IL,60618-5994,Proprietary  ,1535,8362,9897,22714,69179,91893
01073700,ADVOCATE IL MASONIC SCH OF RAD TECH     ,IL,60657-5193,Private      ,0,0,0,12,32,44
01083600,PIVOT POINT INTNL CSMTLGY RSRCH CTR     ,IL,60626-0000,Proprietary  ,50,79,129,383,489,872
01087900,RICHLAND COMMUNITY COLLEGE              ,IL,62521-8513,Public       ,48,173,221,808,1589,2397
01102401,EVEREST COLLEGE - CHICAGO               ,IL,60604-2052,Proprietary  ,94,399,493,659,2310,2969
01151002,EVEREST INSTITUTE - EVEREST COLLEGE     ,IL,60542-1610,Proprietary  ,26,139,165,155,582,737
01181000,TAYLOR BUSINESS INSTITUTE               ,IL,60606-5111,Proprietary  ,13,38,51,61,293,354
01185800,EVEREST COLLEGE                         ,IL,60077-1074,Proprietary  ,64,286,350,318,1153,1471
01185802,EVEREST COLLEGE - BURR RIDGE            ,IL,60527-7826,Proprietary  ,40,199,239,207,773,980
01236200,NORTHWESTERN COLLEGE                    ,IL,60630-2298,Proprietary  ,97,450,547,1186,3145,4331
01238500,BLOOMINGTON-NORMAL SCH RADIOGRAPHY      ,IL,61761-4604,Private      ,1,2,3,11,12,23
01258400,ILLINOIS INSTITUTE OF ART (THE)         ,IL,60654-1593,Proprietary  ,214,359,573,4496,3077,7573
01258401,ILLINOIS INSTITUTE OF ART (THE) - THE IL,IL,60173-4913,Proprietary  ,0,0,0,88,45,133
01281300,JOHN WOOD COMMUNITY COLLEGE             ,IL,62305-0401,Public       ,45,114,159,1172,1414,2586
01308700,CAPRI GARFIELD RIDGE SCH OF BTY CLR     ,IL,60629-1613,Proprietary  ,5,29,34,57,228,285
01308800,CAPRI OAK FOREST COLLEGE OF BEAUTY      ,IL,60452-2798,Proprietary  ,12,22,34,150,178,328
02055200,HARRINGTON COLLEGE OF DESIGN            ,IL,60606-3433,Proprietary  ,37,65,102,785,993,1778
02068100,ADLER SCH OF PROFESSIONAL PSYCHLGY      ,IL,60601-0000,Private      ,0,16,16,12,824,836
02069300,VATTEROTT COLLEGE                       ,IL,62305-5938,Proprietary  ,13,101,114,154,597,751
02073200,TELSHE YESHIVA-CHICAGO                  ,IL,60625-0000,Private      ,5,0,5,32,8,40
02074400,IL EASTERN COMM COLGS-FRONTIER          ,IL,62837-0000,Public       ,11,31,42,190,367,557
02075400,KELLER GRADUATE SCHOOL OF MGMT.         ,IL,60181-0000,Proprietary  ,3,1494,1497,30,15425,15455
02113600,AMERICAN INTERCONTINENTAL UNIVERSITY    ,IL,60192-3713,Proprietary  ,499,6193,6692,3608,38137,41745
02117400,BECK AREA CAREER CENTER                 ,IL,62278-0000,Public       ,0,9,9,21,128,149
02124400,UNIVERSITY OF SPA & COSMETOLOGY ART     ,IL,62704-0000,Proprietary  ,9,26,35,107,176,283
02150600,COSMETOLOGY AND SPA INSTITUTE (THE)     ,IL,60014-4003,Proprietary  ,15,24,39,93,157,250
02155300,THE CHICAGO SCHOOL OF PROF PSYCHOLOGY   ,IL,60610-4705,Private      ,0,145,145,18,2642,2660
02160300,INTERNATIONAL ACAD OF DESIGN & TECH     ,IL,60602-3319,Proprietary  ,62,119,181,1553,1631,3184
02160304,INTERNATIONAL ACADEMY OF DESIGN AND TECH,IL,60173-5160,Proprietary  ,6,35,41,167,246,413
02168600,EAST WEST UNIVERSITY                    ,IL,60605-0000,Private      ,57,75,132,739,1788,2527
02179900,ARGOSY UNIVERSITY                       ,IL,60601-7757,Proprietary  ,151,2541,2692,1331,25447,26778
02185400,ST AUGUSTINE COLLEGE                    ,IL,60640-0000,Private      ,55,200,255,387,1612,1999
02192400,MR JOHNS SCHOOL OF COSMETOLOGY          ,IL,62521-0000,Proprietary  ,6,17,23,19,113,132
02202600,CANNELLA SCHOOL OF HAIR DESIGN          ,IL,60181-1321,Proprietary  ,1,7,8,8,53,61
02214100,WEST SUBURBAN COLLEGE OF NURSING        ,IL,60302-2519,Private      ,3,6,9,125,364,489
02228100,MAC DANIEL'S BEAUTY SCHOOL              ,IL,60640-0000,Proprietary  ,3,11,14,20,80,100
02261200,HAIR PROFESSIONALS ACAD COSMETOLOGY     ,IL,60118-0000,Proprietary  ,23,52,75,93,190,283
02261201,HAIR PROFESSIONALS ACADEMY OF COSMETOLOG,IL,60118-9333,Proprietary  ,3,0,3,6,6,12
02262100,HAIR PROFESSIONALS SCH COSMETOLOGY      ,IL,60543-0000,Proprietary  ,5,14,19,41,88,129
02291200,CANNELLA SCHOOL OF HAIR DESIGN          ,IL,60639-0000,Proprietary  ,2,17,19,40,119,159
02295500,CANNELLA SCHOOL OF HAIR DESIGN          ,IL,60120-0000,Proprietary  ,5,6,11,14,65,79
02297500,OEHRLEIN SCHOOL OF COSMETOLOGY          ,IL,61611-0000,Proprietary  ,2,17,19,55,90,145
02312300,LA' JAMES COLLEGE HAIRSTYLING           ,IL,61244-0000,Proprietary  ,4,7,11,20,37,57
02313900,WESTWOOD COLLEGE - O'HARE AIRPORT       ,IL,60631-2801,Proprietary  ,79,133,212,604,869,1473
02317300,CONCEPT COLLEGE OF COSMETOLOGY          ,IL,61832-0000,Proprietary  ,4,15,19,36,109,145
02319200,LAKE FOREST GRAD SCHL OF MGMT           ,IL,60045-4824,Private      ,0,68,68,1,332,333
02323300,PROFESSIONAL'S CHOICE HAIR DSN ACAD     ,IL,60435-0000,Proprietary  ,2,10,12,19,49,68
02332200,HAIR PROFESSIONALS CAREER COLLEGE       ,IL,60178-0000,Proprietary  ,3,13,16,41,67,108
02337800,THE COLLEGE OF OFFICE TECHNOLOGY        ,IL,60622-0000,Proprietary  ,10,87,97,111,633,744
02349400,ALVAREITA'S COLLEGE OF COSMETOLOGY      ,IL,62035-0000,Proprietary  ,7,7,14,40,35,75
02349500,CANNELLA SCHOOL OF HAIR DESIGN          ,IL,60632-0000,Proprietary  ,3,30,33,48,180,228
02352200,COOKING & HOSPITALITY INSTITUTE         ,IL,60610-3050,Proprietary  ,58,189,247,751,1340,2091
02498200,HAIR PROFESSIONALS ACAD COSMETOLOGY     ,IL,60187-0000,Proprietary  ,9,30,39,42,141,183
02498201,HAIR PROFESSIONALS ACADEMY OF COSMETOLOG,IL,60563-0000,Proprietary  ,1,2,3,15,18,33
02522800,FOX COLLEGE                             ,IL,60453-0000,Proprietary  ,19,25,44,288,171,459
02527600,LEXINGTON COLLEGE                       ,IL,60607-0000,Private      ,0,1,1,70,40,110
02536700,BELL MAR BEAUTY COLLEGE                 ,IL,60650-0000,Proprietary  ,0,12,12,10,63,73
02538100,REGENCY BEAUTY INSTITUTE                ,IL,61820-0000,Proprietary  ,0,0,0,17,28,45
02556100,ENVIRONMENTAL TECHNICAL INSTITUTE       ,IL,60143-0000,Proprietary  ,24,86,110,216,412,628
02556600,NILES SCHOOL OF COSMETOLOGY             ,IL,60714-0000,Proprietary  ,4,4,8,29,48,77
02570305,LOS ANGELES ORT TECHNICAL INSTITUTE -D/B,IL,60077-0000,Private      ,0,0,0,2,4,6
02573700,INSTITUTE FOR CLINICAL SOCIAL WORK      ,IL,60601-0000,Private      ,0,5,5,6,82,88
02579200,INGALLS MEMORIAL HOSPITAL               ,IL,60426-0000,Private      ,0,0,0,4,19,23
02584900,"FIRST INSTITUTE, INC.                   ",IL,60014-7489,Proprietary  ,3,23,26,45,160,205
02587700,HAIR PROFESSIONALS CAREER COLLEGE       ,IL,60465-1929,Proprietary  ,4,19,23,44,119,163
02599500,HANOVER PARK COLLEGE OF BEAUTY CULT     ,IL,60133-5421,Proprietary  ,8,12,20,76,87,163
02622700,KNOWLEDGE SYSTEMS INSTITUTE             ,IL,60076-0000,Private      ,0,0,0,0,3,3
03002000,HAIRMASTERS INST OF COSMETOLOGY         ,IL,61701-5547,Proprietary  ,3,10,13,27,76,103
03027702,PACIFIC COLLEGE OF ORIENTAL MED         ,IL,60613-0000,Proprietary  ,0,11,11,3,195,198
03065300,TREND SETTERS COLL OF COSMETOLOGY       ,IL,60915-2101,Proprietary  ,14,32,46,128,164,292
03072701,WESTWOOD COLLEGE OF TECHNOLOGY          ,IL,60409-0000,Proprietary  ,30,151,181,367,1119,1486
03072702,WESTWOOD COLLEGE OF TECHNOLOGY          ,IL,60602-0000,Proprietary  ,87,163,250,717,1275,1992
03078400,CAMEO BEAUTY ACADEMY                    ,IL,60453-3196,Proprietary  ,9,15,24,56,87,143
03079200,WESTWOOD COLLEGE - DUPAGE               ,IL,60517-2321,Proprietary  ,38,74,112,518,597,1115
03082900,ROSEL SCHOOL OF COSMETOLOGY             ,IL,60659-1913,Proprietary  ,9,25,34,29,157,186
03083800,HEARTLAND COMMUNITY COLLEGE             ,IL,61761-9446,Public       ,54,103,157,1538,1962,3500
03098000,ST JOHN'S COLLEGE OF NURSING            ,IL,62702-5321,Private      ,0,1,1,46,59,105
03098002,ST JOHN'S HOSP SCH MED TECH             ,IL,62769-5324,Private      ,0,1,1,4,9,13
03099700,CAIN'S BARBER COLLEGE                   ,IL,60615-3510,Proprietary  ,8,56,64,68,290,358
03099800,ILLINOIS SCHOOL OF HEALTH CAREERS       ,IL,60604-0000,Proprietary  ,31,182,213,291,976,1267
03101800,ILLINOIS CENTER FOR BROADCASTING        ,IL,60148-7015,Proprietary  ,20,58,78,96,280,376
03128300,PYRAMID CAREER INSTITUTE                ,IL,60657-4207,Proprietary  ,0,0,0,2,4,6
03128500,NATIONAL LATINO EDUCATION INSTITUTE     ,IL,60609-2205,Private      ,7,21,28,54,111,165
03199300,CHRISTIAN LIFE COLLEGE                  ,IL,60056-2522,Private      ,1,1,2,23,19,42
03368300,MIDWEST TECHNICAL INSTITUTE             ,IL,62707-8805,Proprietary  ,42,308,350,327,1363,1690
03416300,COMPUTER SYSTEMS INSTITUTE              ,IL,60077-0000,Proprietary  ,38,169,207,166,742,908
03448300,BIR TRAINING CENTER                     ,IL,60659-1298,Proprietary  ,10,107,117,39,504,543
03455700,CORTIVA INSTITUTE - CHICAGO             ,IL,60602-3315,Proprietary  ,17,86,103,189,461,650
03472300,CHICAGO URBAN LEAGUE COMPUTER TRAIN     ,IL,60604-2198,Private      ,0,0,0,1,2,3
03510300,ERIKSON INSTITUTE                       ,IL,60654-4510,Private      ,0,2,2,1,283,284
03623300,VEE'S SCHOOL OF BEAUTY CULTURE          ,IL,62205-2326,Proprietary  ,0,3,3,3,25,28
03643300,MR. JOHN'S SCHOOL OF COSMETOLOGY &      ,IL,62650-3488,Proprietary  ,2,5,7,12,45,57
03684300,NORTHSHORE UNIVERSITY HEALTHSYSTEM SCHOO,IL,60201-9872,Private      ,0,0,0,2,25,27
03721400,AMERICAN CAREER COLLEGE                 ,IL,60402-0000,Proprietary  ,4,19,23,23,98,121
03881400,EUROPEAN MASSAGE THERAPY SCHOOL         ,IL,60077-2269,Proprietary  ,6,28,34,20,123,143
03891300,SOMA INSTITUTE - THE NATIONAL SCHOOL OF ,IL,60604-4466,Proprietary  ,14,42,56,104,253,357
03914300,"CALC, INSTITUTE OF TECHNOLOGY           ",IL,62002-5931,Proprietary  ,5,54,59,29,262,291
03955400,MIDWEST INSTITUTE OF MASSAGE THERAPY    ,IL,62223-0000,Proprietary  ,0,0,0,1,13,14
04117500,SOLEX MEDICAL ACADEMY                   ,IL,60090-3104,Proprietary  ,1,2,3,9,18,27
04136900,UNIVERSITY OF AESTHETICS (THE)          ,IL,60622-2151,Proprietary  ,0,5,5,1,19,20
04137000,UNIVERSITY OF AESTHETICS (THE)          ,IL,60515-5602,Proprietary  ,0,2,2,4,7,11
04137500,TRICOCI UNIVERSITY OF BEAUTY CULTURE    ,IL,60656-1805,Proprietary  ,14,33,47,15,36,51
04147300,TRICOCI UNIVERSITY OF BEAUTY CULTURE    ,IL,60139-3119,Proprietary  ,12,10,22,12,11,23
04147400,TRICOCI UNIVERSITY OF BEAUTY CULTURE    ,IL,61614-4831,Proprietary  ,6,9,15,6,10,16
04147500,TRICOCI UNIVERSITY OF BEAUTY CULTURE    ,IL,61108-2337,Proprietary  ,11,22,33,11,22,33
        ,ASBURY THEOLOGICAL SEMINARY             ,KY,40390-0000,Private      ,0,8,8,17,1313,1330
00195100,ALICE LLOYD COLLEGE                     ,KY,41844-9703,Private      ,11,2,13,937,105,1042
00195200,ASBURY COLLEGE                          ,KY,40390-1198,Private      ,13,32,45,1513,412,1925
00195300,ASBURY THEOLOGICAL SEMINARY             ,KY,40390-0000,Private      ,0,32,32,0,32,32
00195400,BELLARMINE UNIVERSITY                   ,KY,40205-1877,Private      ,37,85,122,2903,1210,4113
00195500,BEREA COLLEGE                           ,KY,40403-0000,Private      ,36,14,50,2571,470,3041
00195800,BRESCIA UNIVERSITY                      ,KY,42301-3023,Private      ,9,29,38,568,346,914
00195900,CAMPBELLSVILLE UNIVERSITY               ,KY,42718-2799,Private      ,26,90,116,2090,1192,3282
00196000,SPALDING UNIVERSITY                     ,KY,40203-2188,Private      ,10,96,106,612,2037,2649
00196100,CENTRE COLLEGE                          ,KY,40422-1394,Private      ,12,3,15,1927,52,1979
00196200,UNIVERSITY OF THE CUMBERLANDS           ,KY,40769-1372,Private      ,23,99,122,2094,1072,3166
00196300,EASTERN KENTUCKY UNIVERSITY             ,KY,40475-3102,Public       ,217,339,556,10570,7585,18155
00196400,GEORGETOWN COLLEGE                      ,KY,40324-1628,Private      ,22,49,71,1997,633,2630
00196500,KENTUCKY CHRISTIAN UNIVERSITY           ,KY,41143-2205,Private      ,14,4,18,746,181,927
00196800,KENTUCKY STATE UNIVERSITY               ,KY,40601-2355,Public       ,74,59,133,3173,1422,4595
00196900,KENTUCKY WESLEYAN COLLEGE               ,KY,42302-1039,Private      ,14,4,18,1189,218,1407
00197000,LEES COLLEGE                            ,KY,41339-0000,Private      ,0,1,1,2,6,8
00197100,LEXINGTON THEOLOGICAL SEMINARY          ,KY,40508-0000,Private      ,0,4,4,2,65,67
00197200,LINDSEY WILSON COLLEGE                  ,KY,42728-1223,Private      ,16,85,101,1635,1436,3071
00197400,LOUISVILLE PRESBYTERIAN THEOL SEM       ,KY,40205-0000,Private      ,0,0,0,5,138,143
00197500,MIDWAY COLLEGE                          ,KY,40347-1120,Private      ,14,86,100,513,1216,1729
00197600,MOREHEAD STATE UNIVERSITY               ,KY,40351-1689,Public       ,128,257,385,5986,4868,10854
00197700,MURRAY STATE UNIVERSITY                 ,KY,42071-0009,Public       ,94,130,224,6016,3549,9565
00197900,WEST KENTUCKY CMNTY & TECHNICAL COLG    ,KY,42002-7380,Public       ,30,147,177,1437,2859,4296
00198000,PIKEVILLE COLLEGE                       ,KY,41501-1194,Private      ,14,15,29,1167,388,1555
00198001,PIKEVILLE CLG-SCH OSTEOPATHIC MEDIC     ,KY,41501-0000,Private      ,0,1,1,9,287,296
00198200,SOUTHERN BAPTIST THEOL SEMINARY         ,KY,40280-0000,Private      ,0,7,7,53,194,247
00198300,ST. CATHARINE COLLEGE                   ,KY,40061-9499,Private      ,8,13,21,598,357,955
00198700,TRANSYLVANIA UNIVERSITY                 ,KY,40508-1797,Private      ,10,8,18,1649,98,1747
00198800,UNION COLLEGE                           ,KY,40906-1499,Private      ,19,76,95,1184,1095,2279
00198900,UNIVERSITY OF KENTUCKY                  ,KY,40506-0054,Public       ,290,234,524,15193,7704,22897
00198901,UNIV OF KY-COLLEGE OF DENTISTRY         ,KY,40536-0000,Public       ,0,2,2,10,203,213
00198902,UNIV OF KY-COLLEGE OF MEDICINE          ,KY,40536-0000,Public       ,1,4,5,27,412,439
00199000,ASHLAND COMMUNITY AND TECHNICAL COLLEGE ,KY,41101-3683,Public       ,65,151,216,1357,2325,3682
00199100,ELIZABETHTOWN COMMUNITY  AND TECHNICAL C,KY,42701-3081,Public       ,111,366,477,2037,4033,6070
00199300,HENDERSON COMMUNITY COLLEGE             ,KY,42420-4699,Public       ,13,80,93,496,1277,1773
00199400,HOPKINSVILLE COMMUNITY COLLEGE          ,KY,42241-2621,Public       ,33,316,349,1029,3450,4479
00199600,BIG SANDY COMMUNITY AND TECHNICAL COLG  ,KY,41653-1815,Public       ,43,119,162,1606,1978,3584
00199700,SOMERSET COMMUNITY COLLEGE              ,KY,42501-2973,Public       ,107,261,368,2444,5172,7616
00199800,SOUTHEAST KENTUCKY COMMUNITY AND TECHNIC,KY,40823-1099,Public       ,56,150,206,1095,1535,2630
00199802,CUMBERLAND VLY TEC CLG MIDDLESBORO      ,KY,40965-2265,Public       ,0,0,0,30,26,56
00199804,SOUTHEAST COMMUNITY COLLEGE             ,KY,40831-1796,Public       ,1,8,9,87,137,224
00199900,UNIVERSITY OF LOUISVILLE                ,KY,40292-0000,Public       ,235,366,601,12209,10676,22885
00200100,THOMAS MORE COLLEGE                     ,KY,41017-3495,Private      ,11,92,103,1265,908,2173
00200200,WESTERN KENTUCKY UNIVERSITY             ,KY,42101-3576,Public       ,358,437,795,13116,8062,21178
00461800,SPENCERIAN COLLEGE                      ,KY,40216-2605,Proprietary  ,48,273,321,799,2325,3124
00461900,SULLIVAN UNIVERSITY                     ,KY,40205-3000,Proprietary  ,232,627,859,2178,5192,7370
00512729,BROWN MACKIE COLLEGE-CINCINNATI - 279 BU,KY,41017-2136,Proprietary  ,0,7,7,12,49,61
00524400,BLUEGRASS COMMUNITY & TECHNICAL COLLEGE ,KY,40506-0235,Public       ,173,556,729,4154,7721,11875
00527100,BOWLING GREEN TECHNICAL COLLEGE         ,KY,42101-3601,Public       ,47,157,204,767,1629,2396
00527300,GATEWAY COMMUNITY & TECHNOLOGY COLL     ,KY,41011-0000,Public       ,69,252,321,978,2706,3684
00696000,MAYSVILLE CMNTY & TECHNCL COLG          ,KY,41056-8910,Public       ,43,174,217,824,2198,3022
00696100,JEFFERSON COMMUNITY AND TECHNICAL COLLEG,KY,40202-2005,Public       ,223,459,682,5124,9066,14190
00696200,HAZARD COMMUNITY COLLEGE                ,KY,41701-2402,Public       ,51,207,258,1280,1783,3063
00696203,KY TECH-KNOTT CO. TECHNOLOGY CTR        ,KY,41822-0000,Public       ,2,0,2,5,4,9
00696204,KY TECH-LESLIE COUNTY AREA TECH CTR     ,KY,41749-0000,Public       ,0,0,0,2,2,4
00696205,KY TECH-LEE COUNTY AREA TECH CTR        ,KY,41311-0000,Public       ,0,0,0,1,4,5
00696206,KY TECH-LETCHER CNTY AREA TECH CTR      ,KY,41858-0000,Public       ,0,0,0,15,13,28
00696207,KY TECH-BREATHITT COUNTY VOC ED CTR     ,KY,41339-0000,Public       ,0,1,1,8,20,28
00842500,DAYMAR COLLEGE                          ,KY,42001-0000,Proprietary  ,3,74,77,80,602,682
00901000,MADISONVILLE COMMUNITY COLLEGE          ,KY,42431-9199,Public       ,32,131,163,1066,2315,3381
00927500,NORTHERN KENTUCKY UNIVERSITY            ,KY,41099-0001,Public       ,178,255,433,8229,6668,14897
00931300,DAYMAR COLLEGE                          ,KY,42301-5830,Proprietary  ,49,391,440,308,2201,2509
00931302,DAYMAR COLLEGE - LOUISVILLE CAMPUS      ,KY,40219-1973,Proprietary  ,2,16,18,34,144,178
01042400,SALON PROFESSIONAL ACADEMY THE          ,KY,40502-1776,Proprietary  ,7,12,19,66,119,185
01048900,NATIONAL COLLEGE                        ,KY,40508-0000,Proprietary  ,83,665,748,566,4695,5261
01172500,COLLINS SCHOOL OF COSMETOLOGY           ,KY,40965-2809,Proprietary  ,4,4,8,24,59,83
01208800,SULLIVAN COLLEGE OF TECHNOLOGY AND DESIG,KY,40218-4528,Proprietary  ,45,57,102,506,485,991
01208801,LOUISVILLE TECHNICAL INSTITUTE -        ,KY,40218-4528,Proprietary  ,0,0,0,45,33,78
01212801,SOUTHWESTERN COLLEGE                    ,KY,41042-1466,Proprietary  ,25,126,151,125,671,796
01240400,LEXINGTON BEAUTY COLLEGE                ,KY,40503-1819,Proprietary  ,0,10,10,24,72,96
01272300,KY TECH-WAYNE COUNTY AREA TECH CTR      ,KY,42633-1088,Public       ,0,0,0,1,2,3
01291400,HAIR DESIGN SCHOOL (THE)                ,KY,40218-0000,Proprietary  ,17,34,51,170,302,472
01291500,HAIR DESIGN SCHOOL (THE)                ,KY,41042-5113,Proprietary  ,4,19,23,97,182,279
01291600,HAIR DESIGN SCHOOL (THE)                ,KY,40216-4212,Proprietary  ,6,18,24,47,147,194
01291700,HAIR DESIGN SCHOOL (THE)                ,KY,40160-0000,Proprietary  ,15,33,48,95,241,336
01296800,HAIR DESIGN SCHOOL (THE)                ,KY,40207-2695,Proprietary  ,9,19,28,90,128,218
02159100,"APPALACHIAN BEAUTY SCHOOL, INC.         ",KY,41503-0000,Proprietary  ,1,4,5,16,32,48
02177100,HAIR DESIGN SCHOOL (THE)                ,KY,40204-0000,Proprietary  ,10,25,35,84,157,241
02251500,TREND SETTERS ACAD OF BEAUTY CULT       ,KY,40258-0000,Proprietary  ,5,35,40,42,168,210
02275000,JENNY LEA ACADEMY OF COSMETOLOGY        ,KY,40831-0000,Proprietary  ,13,33,46,68,172,240
02279800,ELIZABETHTOWN BEAUTY SCHOOL             ,KY,42701-0000,Proprietary  ,0,2,2,19,34,53
02284306,INTERACTIVE LEARNING SYSTEMS            ,KY,41042-0000,Proprietary  ,0,23,23,15,130,145
02323700,PAT WILSON'S BEAUTY COLLEGE             ,KY,42420-0000,Proprietary  ,1,7,8,9,55,64
02337200,PJ'S COLLEGE OF COSMETOLOGY             ,KY,42101-0000,Proprietary  ,18,99,117,102,492,594
02340800,PAUL MITCHELL THE SCHOOL LEXINGTON      ,KY,40601-0000,Proprietary  ,11,24,35,18,67,85
02351700,DONTA SCHOOL OF BEAUTY CULTURE          ,KY,40203-0000,Proprietary  ,4,14,18,23,76,99
02491100,BECKFIELD COLLEGE                       ,KY,41042-0000,Proprietary  ,28,177,205,229,1106,1335
02518900,BARRETT & COMPANY SCH HAIR DESIGN       ,KY,40356-0000,Proprietary  ,7,21,28,51,125,176
02526100,JENNY LEA ACADEMY OF COSMETOLOGY        ,KY,41858-0000,Proprietary  ,1,8,9,14,27,41
02535600,CLEAR CREEK BAPTIST BIBLE COLLEGE       ,KY,40977-0000,Private      ,1,3,4,34,141,175
02551100,PJ'S COLLEGE OF COSMETOLOGY             ,KY,42121-0000,Proprietary  ,4,15,19,29,76,105
02560800,SOUTHEAST SCHOOL OF COSMETOLOGY         ,KY,40962-0000,Proprietary  ,1,14,15,21,73,94
02576200,MID-CONTINENT UNIVERSITY                ,KY,42066-9007,Private      ,11,190,201,278,2386,2664
02616204,BROWN MACKIE COLLEGE-FINDLAY - BROWN MAC,KY,40219-1916,Proprietary  ,8,30,38,253,1083,1336
02616205,BROWN MACKIE COLLEGE-LOUISVILLE - BROWN ,KY,42240-3579,Proprietary  ,0,12,12,6,55,61
03002100,KENTUCKY MOUNTAIN BIBLE COLLEGE         ,KY,41385-0010,Private      ,1,2,3,50,24,74
03007000,FRONTIER SCH OF MIDWIFERY&FAMILY NU     ,KY,41749-0000,Private      ,0,48,48,1,677,678
03026200,HEAD'S WEST KENTUCKY BEAUTY COLLEGE     ,KY,42431-0000,Proprietary  ,0,11,11,10,44,54
03029200,NU-TEK ACADEMY OF BEAUTY                ,KY,40353-9767,Proprietary  ,1,9,10,14,34,48
03034500,OWENSBORO COMMUNITY & TECHNICAL COLLEGE ,KY,42303-1899,Public       ,58,185,243,1385,2571,3956
03083700,GALEN HEALTH INSTITUTES                 ,KY,40207-1047,Proprietary  ,49,390,439,522,2867,3389
03103500,MR JIM'S BEAUTY COLLEGE                 ,KY,42301-2646,Proprietary  ,1,6,7,17,43,60
03106700,MOTIF BEAUTY ACADEMY                    ,KY,40391-1958,Proprietary  ,0,0,0,3,8,11
03516500,EZELL'S COSMETOLOGY SCHOOL              ,KY,42071-2530,Proprietary  ,2,3,5,23,35,58
03611300,BRIGHTON CENTER'S CENTER FOR EMPLOY     ,KY,41071-1968,Private      ,3,63,66,11,155,166
03804300,BELLEFONTE ACADEMY OF BEAUTY            ,KY,41169-2015,Proprietary  ,6,18,24,36,94,130
03885300,EMPLOYMENT SOLUTIONS                    ,KY,40517-3260,Private      ,7,47,54,17,144,161
03886300,REGENCY SCHOOL OF HAIR DESIGN           ,KY,41653-1278,Proprietary  ,0,8,8,8,38,46
04038300,ATA CAREER EDUCATION                    ,KY,40223-3832,Proprietary  ,32,170,202,143,906,1049
04123900,LEXINGTON HEALING ARTS ACADEMY          ,KY,40503-1932,Proprietary  ,2,16,18,24,109,133
00200300,CENTENARY COLLEGE OF LOUISIANA          ,LA,71104-3396,Private      ,7,4,11,1099,179,1278
00200400,DILLARD UNIVERSITY                      ,LA,70122-3097,Private      ,33,18,51,1616,578,2194
00200500,NICHOLLS STATE UNIVERSITY               ,LA,70310-0001,Public       ,67,86,153,5033,2475,7508
00200600,GRAMBLING STATE UNIVERSITY              ,LA,71245-2215,Public       ,164,134,298,6948,2924,9872
00200700,LOUISIANA COLLEGE                       ,LA,71359-0000,Private      ,7,63,70,930,471,1401
00200800,LOUISIANA TECH UNIVERSITY               ,LA,71272-0001,Public       ,97,144,241,6320,2729,9049
00201000,LOUISIANA STATE UNIV & A&M COLG         ,LA,70803-5710,Public       ,277,159,436,20320,6649,26969
00201100,LOUISIANA STATE UNIV-ALEXANDRIA         ,LA,71302-9121,Public       ,48,74,122,1357,2038,3395
00201200,LOUISIANA STATE UNIV-EUNICE             ,LA,70535-6726,Public       ,63,82,145,1816,1594,3410
00201300,LOUISIANA STATE UNIV-SHREVEPORT         ,LA,71115-2399,Public       ,45,93,138,2387,2693,5080
00201400,LA STATE UNIV HEALTH SCIENCES CTR       ,LA,70112-2223,Public       ,15,30,45,436,1819,2255
00201500,UNIVERSITY OF NEW ORLEANS               ,LA,70148-0001,Public       ,137,269,406,6040,6199,12239
00201600,LOYOLA UNIVERSITY NEW ORLEANS           ,LA,70118-6195,Private      ,45,69,114,2807,2296,5103
00201700,MCNEESE STATE UNIVERSITY                ,LA,70609-4510,Public       ,101,135,236,4946,3277,8223
00201900,NEW ORLEANS BAPTIST THEOL SEMINARY      ,LA,70126-0000,Private      ,1,5,6,32,111,143
00202000,UNIVERSITY OF LOUISIANA AT MONROE       ,LA,71209-9001,Public       ,104,177,281,5970,4256,10226
00202100,NORTHWESTERN STATE UNIVERSITY           ,LA,71497-0001,Public       ,125,268,393,5726,4889,10615
00202200,NOTRE DAME SEMINARY                     ,LA,70118-0000,Private      ,0,0,0,1,6,7
00202300,OUR LADY OF HOLY CROSS COLLEGE          ,LA,70131-7399,Private      ,13,66,79,610,1045,1655
00202400,SOUTHEASTERN LOUISIANA UNIV             ,LA,70402-0001,Public       ,209,190,399,10467,5241,15708
00202500,SOUTHERN UNIVERSITY A & M COLLEGE       ,LA,70813-9374,Public       ,157,208,365,7926,6076,14002
00202600,SOUTHERN UNIV NEW ORLEANS               ,LA,70126-0002,Public       ,55,162,217,1371,3338,4709
00202700,ST JOSEPH SEMINARY COLLEGE              ,LA,70457-9990,Private      ,1,0,1,25,19,44
00202900,TULANE UNIVERSITY                       ,LA,70118-5698,Private      ,122,162,284,9249,5729,14978
00203100,UNIV OF LOUISIANA AT LAFAYETTE          ,LA,70504-0001,Public       ,186,187,373,11034,4607,15641
00203200,XAVIER UNIVERSITY OF LOUISIANA          ,LA,70125-1098,Private      ,87,29,116,4239,1456,5695
00462100,AYERS CAREER COLLEGE                    ,LA,71108-5845,Proprietary  ,13,80,93,74,425,499
00462500,DELGADO COMMUNITY COLLEGE               ,LA,70119-0000,Public       ,324,707,1031,5994,10947,16941
00520300,REMINGTON COLLEGE - LAFAYETTE CAMPUS    ,LA,70508-5760,Proprietary  ,84,382,466,683,2060,2743
00520306,REMINGTON COLLEGE - BATON ROUGE CAMPUS  ,LA,70816-4040,Proprietary  ,20,112,132,171,618,789
00546700,SOWELA TECHNICAL COMMUNITY COLLEGE      ,LA,70616-6950,Public       ,38,74,112,759,1103,1862
00548800,LOUISIANA TECH COLG-BATON ROUGE         ,LA,70807-0000,Public       ,28,95,123,369,796,1165
00548802,LOUISIANA TECH COLG-ACADIAN CMPS        ,LA,70526-0000,Public       ,8,16,24,88,170,258
00548803,LOUISIANA TECH COLG-ALEXANDRIA CMPS     ,LA,71302-3137,Public       ,11,30,41,175,512,687
00548804,LOUISIANA TECH COLG-ASCENSION CMPS      ,LA,70778-3007,Public       ,7,14,21,96,139,235
00548805,LA TECH COLLEGE-AVOYELLES CAMPUS        ,LA,71327-0000,Public       ,8,7,15,69,108,177
00548806,LA TECHNICAL COLG-BASTROP CMPS          ,LA,71221-0000,Public       ,5,20,25,42,145,187
00548808,LA TECH COLG CHARLES B COREILCMPS       ,LA,70586-0000,Public       ,5,12,17,92,182,274
00548809,LA TECHNICAL COLG-DELTA-OUACHITA        ,LA,71292-9064,Public       ,7,44,51,166,376,542
00548810,EVANGELINE TECHNICAL INST               ,LA,70582-3104,Public       ,6,25,31,55,145,200
00548811,LA TECHN COLLEGE - FLORIDA PARISHES     ,LA,70441-0000,Public       ,6,14,20,53,112,165
00548812,LOUISIANA TECH COLG-FOLKES CAMPUS       ,LA,70748-0000,Public       ,1,8,9,16,64,80
00548813,LA TECHNICAL INST-GULF AREA CMPS        ,LA,70510-0878,Public       ,18,26,44,154,237,391
00548814,LOUISIANA TECH COLG-HAMMOND CMPS        ,LA,70404-0000,Public       ,12,34,46,162,346,508
00548815,LA TECH COLG-HUEY P. LONG CAMPUS        ,LA,71483-0000,Public       ,5,8,13,70,141,211
00548816,LA TECH COLLEGE-JEFFERSON CAMPUS        ,LA,70001-5605,Public       ,6,28,34,62,222,284
00548817,LOUISIANA TEC CLG-JUMONVILLE MEM CP     ,LA,70760-0000,Public       ,9,10,19,40,107,147
00548818,LA TECH COLLEGE-LAFAYETTE CAMPUS        ,LA,70506-0000,Public       ,33,56,89,429,809,1238
00548819,LOUISIANA TECHNICAL COLLEGE-LAFOURC     ,LA,70301-4336,Public       ,5,11,16,94,202,296
00548820,LOUISIANA TEC CLG-LAMAR SALTER CMPS     ,LA,71446-0000,Public       ,6,29,35,61,170,231
00548822,LOUISIANA TECHNICAL CLG-MANSFIELD       ,LA,71052-1236,Public       ,2,12,14,47,131,178
00548823,LA. TECH COLG.-MORGAN SMITH CAMPUS      ,LA,70546-0000,Public       ,5,14,19,40,103,143
00548824,LOUISIANA TEC CLG-NATCHITOCHES CMPS     ,LA,71458-0000,Public       ,8,29,37,83,259,342
00548825,LOUISIANA TECH COLG-NORTH CTRL CMPS     ,LA,71241-0000,Public       ,3,10,13,46,116,162
00548826,LOUISIANA TECH CLG-NORTHEAST LA CMP     ,LA,71295-2999,Public       ,4,18,22,53,169,222
00548827,LOUISIANA TEC CLG-NW LOUISIANA CMPS     ,LA,71058-0000,Public       ,18,56,74,185,432,617
00548828,LA TECHNICAL COLG-OAKDALE CMPS          ,LA,71463-0000,Public       ,6,10,16,48,102,150
00548829,LTC-RIVER PARISHES CAMPUS               ,LA,70084-0000,Public       ,7,16,23,181,348,529
00548830,LOUISIANA TECHNICAL COLLEGE-RUSTON      ,LA,71273-0000,Public       ,9,12,21,233,231,464
00548831,LTC - SABINE VALLEY CAMPUS              ,LA,71449-3839,Public       ,8,14,22,51,115,166
00548832,LOUISIANA TECH COLG-SHELBY JACKSON      ,LA,71334-0000,Public       ,6,21,27,52,191,243
00548833,LA TECH COLG SHREVEPORT-BOSSIER         ,LA,71137-0000,Public       ,29,109,138,268,1029,1297
00548837,LOUISIANA TECH COLG-SULLIVAN CAMPUS     ,LA,70427-5866,Public       ,23,48,71,153,395,548
00548838,LOUISIANA TECHNICAL COLG - TALLULAH     ,LA,71284-0000,Public       ,21,38,59,85,240,325
00548839,LA TECH COLG-TECHE AREA CAMPUS          ,LA,70562-0000,Public       ,14,24,38,214,280,494
00548840,LOUISIANA TECH COLG-T.H.HARRIS CMPS     ,LA,70570-6113,Public       ,18,34,52,322,365,687
00548841,LOUISIANA TECH COLG W JEFFERSON CMP     ,LA,70058-0000,Public       ,8,23,31,42,145,187
00548842,LOUISIANA TECHNICAL COLLEGE - WESTSIDE C,LA,70765-0733,Public       ,1,5,6,23,83,106
00548843,LTC-YOUNG MEMORIAL CAMPUS               ,LA,70381-0000,Public       ,10,31,41,110,272,382
00576100,L. E. FLETCHER TECHNICAL COMMUNITY COLLE,LA,70360-2863,Public       ,23,28,51,506,655,1161
00768600,SOUTHERN UNIV AT SHREVEPORT/BOSSIER     ,LA,71107-4795,Public       ,74,190,264,1161,2576,3737
00806700,LSU HEALTH SCIENCES CENTR-SHREVEPOR     ,LA,71130-3932,Public       ,16,32,48,230,906,1136
00989800,DEMMON SCHOOL OF BEAUTY                 ,LA,70607-2128,Proprietary  ,5,20,25,14,66,80
01005701,AMERICAN COMMERCIAL COLLEGE             ,LA,71105-2502,Proprietary  ,5,34,39,30,228,258
01109700,CLOYD'S BEAUTY SCHOOL #1                ,LA,71291-3131,Proprietary  ,5,27,32,45,144,189
01163100,"D-JAY'S SCHL OF BEAUTY, ARTS & SCI      ",LA,70806-0000,Proprietary  ,5,28,33,34,122,156
01184100,JOHN JAY BEAUTY COLLEGE                 ,LA,70124-2592,Proprietary  ,3,8,11,24,25,49
01261100,RONNIE & DORMANS SCHOOL HAIR DESIGN     ,LA,70501-0000,Proprietary  ,1,2,3,7,32,39
01282300,PAT GOINS RUSTON BEAUTY SCHOOL          ,LA,71270-4301,Proprietary  ,7,9,16,23,39,62
01287900,PAT GOINS BENTON ROAD BEAUTY SCHOOL     ,LA,71111-4838,Proprietary  ,4,16,20,22,69,91
01288000,PAT GOINS BEAUTY SCHOOL                 ,LA,71201-5167,Proprietary  ,0,4,4,10,28,38
02055400,BOSSIER PARISH COMMUNITY COLLEGE        ,LA,71111-0000,Public       ,95,193,288,2151,3045,5196
02055500,DELTA SCH OF BUSINESS & TECHNOLOGY      ,LA,70601-0000,Proprietary  ,9,62,71,108,430,538
02089711,HERZING COLLEGE                         ,LA,70062-8727,Proprietary  ,2,17,19,50,241,291
02117800,AVEDA INSTITUTE LAFAYETTE               ,LA,70503-3246,Proprietary  ,15,15,30,101,142,243
02166100,NUNEZ COMMUNITY COLLEGE                 ,LA,70043-0000,Public       ,46,123,169,466,1024,1490
02166200,ITI TECHNICAL COLLEGE                   ,LA,70817-0000,Proprietary  ,32,63,95,313,546,859
02197500,BATON ROUGE SCHOOL OF COMPUTERS         ,LA,70816-0000,Proprietary  ,4,5,9,35,56,91
02234000,CAMERON COLLEGE                         ,LA,70119-0000,Proprietary  ,6,34,40,41,176,217
02258400,AVEDA INSTITUTE BATON ROUGE             ,LA,70816-2246,Proprietary  ,17,29,46,117,124,241
02260200,DIESEL DRIVING ACADEMY                  ,LA,71109-5617,Proprietary  ,11,127,138,45,436,481
02263600,BASTROP BEAUTY SCHOOL #1                ,LA,71220-0000,Proprietary  ,0,5,5,6,29,35
02265600,JOHN JAY KENNER ACADEMY                 ,LA,70062-0000,Proprietary  ,6,18,24,65,99,164
02269300,STEVENSON'S ACADEMY OF HAIR DESIGN      ,LA,70116-0000,Proprietary  ,7,17,24,67,110,177
02323100,PAT GOINS SHREVEPORT BEAUTY SCHOOL      ,LA,71108-4354,Proprietary  ,0,0,0,2,1,3
02327800,PINEVILLE BEAUTY SCHOOL                 ,LA,71360-0000,Proprietary  ,0,10,10,17,67,84
02335701,BATON ROUGE GEN MED CTR SCH NSG         ,LA,70821-0000,Private      ,2,10,12,68,161,229
02335702,BATON ROUGE GEN MED CTR-RAD TECH        ,LA,70806-0000,Private      ,0,2,2,27,48,75
02338000,"CLOYD'S BEAUTY SCHOOL #2, INC           ",LA,71202-3539,Proprietary  ,5,26,31,41,141,182
02352500,"CLOYD'S BEAUTY SCHOOL #3, INC           ",LA,71201-3211,Proprietary  ,6,26,32,47,145,192
02358600,"STAGE ONE THE HAIR SCHOOL, INC.         ",LA,70605-0000,Proprietary  ,6,13,19,69,104,173
02493400,ALEXANDRIA ACADEMY OF BEAUTY CULT       ,LA,71301-0000,Proprietary  ,0,0,0,11,22,33
02518300,SOUTH LOUISIANA BEAUTY COLLEGE          ,LA,70363-0000,Proprietary  ,6,14,20,32,69,101
02536400,LOUISIANA ACADEMY OF BEAUTY             ,LA,70535-0000,Proprietary  ,5,5,10,18,32,50
02538300,DELTA COLLEGE OF ARTS & TECH INC        ,LA,70806-1529,Proprietary  ,19,51,70,122,481,603
02538301,DELTA COLLEGE OF ARTS & TECHNOLOGY - LAF,LA,70508-6831,Proprietary  ,3,17,20,39,160,199
02548500,COSMETOLOGY TRAINING CENTER             ,LA,70503-0000,Proprietary  ,7,12,19,53,63,116
02554800,VANGUARD COLLEGE OF COSMETOLOGY         ,LA,70458-8823,Proprietary  ,24,16,40,107,139,246
02582200,"GUY'S ACADEMY HAIR, SKIN & NAILS        ",LA,71105-2404,Proprietary  ,13,31,44,58,156,214
02600900,AVEDA INSTITUTE                         ,LA,70433-2922,Proprietary  ,71,134,205,495,753,1248
02601000,AMERICAN SCHOOL OF BUSINESS             ,LA,71105-5646,Proprietary  ,2,12,14,10,92,102
02601100,OPELOUSAS SCHOOL OF COSMETOLOGY         ,LA,70570-6156,Proprietary  ,0,3,3,18,39,57
02606800,CAREER TRAINING SPECIALISTS             ,LA,71201-6046,Proprietary  ,45,154,199,330,998,1328
02606801,CAREER TECHNICAL COLLEGE - SHREVEPORT   ,LA,71105-2405,Proprietary  ,15,75,90,88,523,611
02617100,BATON ROUGE COLLEGE                     ,LA,70816-2246,Proprietary  ,3,16,19,34,81,115
02619200,DENHAM SPRINGS BEAUTY COLLEGE           ,LA,70726-3829,Proprietary  ,2,10,12,31,75,106
03010400,CRESCENT CITY SCH GAMING & BARTENDG     ,LA,70119-5507,Proprietary  ,13,219,232,49,843,892
03023500,CAMELOT CAREER COLLEGE                  ,LA,70805-7539,Proprietary  ,14,46,60,101,250,351
03030900,DIESEL DRIVING ACADEMY                  ,LA,70815-8109,Proprietary  ,18,217,235,55,650,705
03061400,ASCENSION COLLEGE                       ,LA,70737-2912,Proprietary  ,14,38,52,85,190,275
03095100,GRETNA CAREER COLLEGE                   ,LA,70053-2436,Proprietary  ,9,71,80,47,283,330
03106200,OUR LADY OF THE LAKE COLLEGE            ,LA,70808-4398,Private      ,18,67,85,857,1779,2636
03253300,JONESVILLE BEAUTY SCHOOL                ,LA,71343-0000,Proprietary  ,18,38,56,39,99,138
03294300,BLUE CLIFF SCH THERAPEUTIC MASSAGE      ,LA,70002-3458,Proprietary  ,35,135,170,208,629,837
03332600,DELTA COLLEGE                           ,LA,70433-9042,Proprietary  ,9,32,41,70,301,371
03332601,DELTA COLLEGE - SLIDELL                 ,LA,70460-2624,Proprietary  ,7,35,42,51,234,285
03356300,MEDICAL TRAINING COLLEGE                ,LA,70816-5820,Proprietary  ,8,51,59,104,284,388
03422500,BLUE CLIFF COLLEGE                      ,LA,71107-6520,Proprietary  ,17,89,106,138,451,589
03422600,BLUE CLIFF COLLEGE                      ,LA,70508-3858,Proprietary  ,34,112,146,168,561,729
03480300,MEDVANCE INSTITUTE                      ,LA,70809-1908,Proprietary  ,56,233,289,404,1424,1828
03498400,OMEGA INSTITUTE OF COSMETOLOGY          ,LA,70360-0000,Proprietary  ,4,7,11,47,59,106
03727500,BLUE CLIFF COLLEGE-BATON ROUGE          ,LA,70808-4191,Proprietary  ,8,9,17,29,71,100
03730300,BATON ROUGE COMMUNITY COLLEGE           ,LA,78806-4129,Public       ,172,276,448,3807,4093,7900
03752400,SCHOOL OF URBAN MISSIONS                ,LA,70053-0000,Private      ,6,3,9,56,76,132
03789300,UNITECH TRAINING ACADEMY                ,LA,70503-5132,Proprietary  ,33,233,266,142,717,859
03789400,RIVER PARISHES COMMUNITY COLLEGE        ,LA,70778-0310,Public       ,13,46,59,383,504,887
03810500,COURT REPORTING INSTITUTE OF LOUISI     ,LA,70816-0000,Proprietary  ,2,7,9,12,58,70
03858300,RAY'S FAITH ACADEMY OF BEAUTY EDUCATION ,LA,70737-0000,Proprietary  ,0,0,0,0,8,8
03956300,SOUTH LOUISIANA COMMUNITY COLLEGE       ,LA,70506-0000,Public       ,48,76,124,1163,1265,2428
04040300,COMPASS CAREER COLLEGE                  ,LA,70403-0653,Proprietary  ,7,41,48,35,214,249
04112300,LOUISIANA CULINARY INSTITUTE            ,LA,70816-4109,Proprietary  ,9,11,20,79,84,163
04120700,ALDEN'S SCHOOL OF COSMETOLOGY           ,LA,70714-1502,Proprietary  ,4,7,11,13,42,55
04130100,LOUISIANA DELTA COMMUNITY COLLEGE       ,LA,71203-3618,Public       ,31,50,81,647,769,1416
00143600,CAPITOL COLLEGE                         ,MD,20708-9759,Private      ,7,28,35,268,282,550
00146200,WASHINGTON BIBLE COLLEGE                ,MD,20706-3599,Private      ,9,43,52,99,331,430
00205700,ALLEGANY COLLEGE OF MARYLAND            ,MD,21502-2596,Public       ,61,104,165,2100,1591,3691
00205800,ANNE ARUNDEL COMMUNITY COLLEGE          ,MD,21012-1895,Public       ,225,485,710,3364,4799,8163
00206000,BALTIMORE HEBREW UNIVERSITY             ,MD,21215-3996,Private      ,1,1,2,6,39,45
00206100,BALTIMORE CITY COMMUNITY COLLEGE        ,MD,21215-7893,Public       ,170,606,776,2787,7218,10005
00206200,BOWIE STATE UNIVERSITY                  ,MD,20715-9465,Public       ,160,168,328,7167,3824,10991
00206300,COMMUNITY COLLEGE OF BALTIMORE COUNTY   ,MD,21228-5381,Public       ,382,867,1249,6058,10076,16134
00206400,COLLEGE OF SOUTHERN MARYLAND            ,MD,20646-0910,Public       ,102,197,299,2357,2949,5306
00206401,COLLEGE OF SOUTHERN MARYLAND - PRINCE FR,MD,20676-9702,Public       ,1,3,4,1,3,4
00206402,COLLEGE OF SOUTHERN MARYLAND - LEONARDTO,MD,20650-1758,Public       ,2,3,5,2,3,5
00206500,CLG NOTRE DAME OF MARYLAND              ,MD,21210-2476,Private      ,16,66,82,695,1191,1886
00206700,COLUMBIA UNION COLLEGE                  ,MD,20912-7796,Private      ,19,50,69,819,761,1580
00206800,COPPIN STATE UNIVERSITY                 ,MD,21216-3698,Public       ,111,137,248,3826,3657,7483
00207100,FREDERICK COMMUNITY COLLEGE             ,MD,21702-9745,Public       ,86,152,238,1387,1891,3278
00207200,FROSTBURG STATE UNIVERSITY              ,MD,21532-1099,Public       ,106,34,140,5908,1063,6971
00207300,GOUCHER COLLEGE                         ,MD,21204-2794,Private      ,33,22,55,3068,460,3528
00207400,HAGERSTOWN COMMUNITY COLLEGE            ,MD,21742-6590,Public       ,42,192,234,1384,1967,3351
00207500,HARFORD COMMUNITY COLLEGE               ,MD,21015-1696,Public       ,85,153,238,1591,1810,3401
00207600,HOOD COLLEGE                            ,MD,21701-8575,Private      ,29,40,69,2016,804,2820
00207700,JOHNS HOPKINS UNIVERSITY                ,MD,21218-2693,Private      ,77,73,150,6762,1328,8090
00207702,JOHNS HOPKINS UNIV SCH ARTS/SCI/ENG     ,MD,21218-0000,Private      ,27,69,96,4030,1625,5655
00207703,JOHNS HOPKINS UNIV SCH OF BUS/ED        ,MD,21046-0000,Private      ,3,66,69,30,1458,1488
00207705,JOHNS HOPKINS BLOOMBERG SCH OF PH       ,MD,21205-0000,Private      ,2,30,32,21,1222,1243
00207706,JOHNS HOPKINS UNIV SCH OF MEDICINE      ,MD,21205-0000,Private      ,3,12,15,85,1069,1154
00207707,JOHNS HOPKINS UNIV SCH OF NURSING       ,MD,21205-0000,Private      ,5,17,22,205,757,962
00207708,JOHNS HOPKINS UNIV PEABODY CONSERV      ,MD,21202-2397,Private      ,3,2,5,559,424,983
00207800,LOYOLA UNIVERSITY MARYLAND              ,MD,21210-2699,Private      ,37,47,84,5764,1674,7438
00208000,MARYLAND INST COLLEGE OF ART            ,MD,21217-4191,Private      ,25,12,37,2395,557,2952
00208300,MORGAN STATE UNIVERSITY                 ,MD,21251-0002,Public       ,236,197,433,10457,4178,14635
00208600,MOUNT SAINT MARY'S UNIVERSITY           ,MD,21727-7799,Private      ,20,17,37,2596,285,2881
00208700,NER ISRAEL RABBINICAL COLLEGE           ,MD,21208-1198,Private      ,4,1,5,88,48,136
00208900,PRINCE GEORGES COMMUNITY COLLEGE        ,MD,20774-2199,Public       ,224,561,785,4171,6718,10889
00209100,SALISBURY UNIVERSITY                    ,MD,21801-6862,Public       ,166,40,206,8786,1445,10231
00209200,ST JOHN'S COLLEGE                       ,MD,21404-0000,Private      ,5,22,27,656,166,822
00209500,ST. MARY'S COLLEGE OF MARYLAND          ,MD,20686-3001,Public       ,32,7,39,2772,165,2937
00209600,ST MARY'S SEMINARY & UNIV               ,MD,21210-1994,Private      ,0,1,1,31,24,55
00209900,TOWSON UNIVERSITY                       ,MD,21252-0002,Public       ,332,227,559,18549,5576,24125
00210200,UNIVERSITY OF BALTIMORE                 ,MD,21201-5779,Public       ,55,209,264,1261,5673,6934
00210300,"UNIVERSITY OF MARYLAND, COLLEGE PARK    ",MD,20742-5145,Public       ,471,442,913,28417,11169,39586
00210400,"UNIVERSITY OF MARYLAND, BALTIMORE       ",MD,21201-1691,Public       ,55,163,218,2139,8354,10493
00210500,UMBC                                    ,MD,21250-0002,Public       ,162,138,300,7916,3431,11347
00210600,UNIVERSITY MARYLAND EASTERN SHORE       ,MD,21853-4053,Public       ,121,47,168,5051,1290,6341
00210700,STEVENSON UNIVERSITY                    ,MD,21153-0641,Private      ,42,30,72,3901,970,4871
00210800,WASHINGTON COLLEGE                      ,MD,21620-1197,Private      ,31,3,34,2366,71,2437
00210900,MCDANIEL COLLEGE                        ,MD,21157-4390,Private      ,19,22,41,2783,563,3346
00465000,CHESAPEAKE COLLEGE                      ,MD,21679-0008,Public       ,43,92,135,934,1234,2168
00691100,MONTGOMERY COLLEGE                      ,MD,20850-1195,Public       ,383,505,888,7955,7384,15339
00734100,INTERNATIONAL BEAUTY SCHOOL             ,MD,21502-2370,Proprietary  ,12,110,122,71,277,348
00744700,DEL-MAR-VA BEAUTY ACADEMY               ,MD,21804-0000,Proprietary  ,3,8,11,40,75,115
00749100,TESST COLLEGE OF TECHNOLOGY             ,MD,21227-1063,Proprietary  ,61,291,352,457,1562,2019
00793600,LINCOLN TECHNICAL INSTITUTE             ,MD,21046-1544,Proprietary  ,130,191,321,949,1065,2014
00794600,KAPLAN COLLEGE                          ,MD,21742-2797,Proprietary  ,40,159,199,369,992,1361
00794601,KAPLAN COLLEGE -  CAREER TECHNOLOGY CENT,MD,21742-2797,Proprietary  ,1,5,6,16,36,52
00794602,KAPLAN COLLEGE - FREDERICK              ,MD,21704-8307,Proprietary  ,10,60,70,71,298,369
00817500,HOWARD COMMUNITY COLLEGE                ,MD,21044-3197,Public       ,112,191,303,2306,2559,4865
00826300,AWARD BEAUTY SCHOOL                     ,MD,21740-5624,Proprietary  ,17,60,77,95,309,404
00830800,CECIL COLLEGE                           ,MD,21901-1999,Public       ,29,62,91,765,836,1601
00907906,EVEREST COLLEGE- EVEREST INSTITUTE      ,MD,20910-3737,Proprietary  ,99,188,287,302,729,1031
01001400,GARRETT COMMUNITY COLLEGE               ,MD,21541-1265,Public       ,24,40,64,629,301,930
01031900,MEDIX SCHOOL                            ,MD,21204-2538,Proprietary  ,70,355,425,533,1992,2525
01041000,TESST COLLEGE OF TECHNOLOGY             ,MD,21286-2201,Proprietary  ,38,143,181,200,547,747
01164400,UNIV OF MARYLAND UNIVERSITY COLLEGE     ,MD,20783-8078,Public       ,126,1898,2024,1860,21323,23183
01164402,U OF MD UNIVERSITY COLLEGE - EUROPE     ,MD,20832-0000,Public       ,20,219,239,325,2015,2340
01164404,U OF MD UNIVERSITY COLLEGE - ASIA       ,MD,31207-0000,Public       ,9,102,111,118,1014,1132
02073900,WOR-WIC COMMUNITY COLLEGE               ,MD,21804-0000,Public       ,78,193,271,1270,2283,3553
02083600,TESST COLLEGE OF TECHNOLOGY             ,MD,20705-2698,Proprietary  ,54,128,182,382,653,1035
02116005,SANFORD-BROWN INSTITUTE - LANDOVER      ,MD,20785-2287,Proprietary  ,29,200,229,178,1035,1213
02127900,SOJOURNER DOUGLASS COLLEGE              ,MD,21205-0000,Private      ,12,227,239,153,2407,2560
02155100,MARYLAND COLLEGE OF ART AND DESIGN      ,MD,20902-0000,Private      ,1,3,4,77,35,112
02269700,INTERNATIONAL BEAUTY SCHOOL             ,MD,21014-0000,Proprietary  ,1,8,9,30,66,96
02314800,BALTIMORE INTERNATIONAL COLLEGE         ,MD,21202-0000,Private      ,16,21,37,613,462,1075
02331000,MARYLAND BEAUTY ACADEMY OF ESSEX        ,MD,21221-0000,Proprietary  ,7,22,29,49,119,168
02333000,HAIR ACADEMY                            ,MD,20784-0000,Proprietary  ,20,70,90,152,411,563
02343800,MONTGOMERY BEAUTY SCHOOL                ,MD,20901-0000,Proprietary  ,9,37,46,58,182,240
02494700,BALTIMORE STUDIO OF HAIR DESIGN         ,MD,21201-0000,Proprietary  ,10,32,42,59,197,256
02495000,ROBERT PAUL ACAD COSMTGY ARTS & SCI     ,MD,21093-0000,Proprietary  ,9,8,17,62,60,122
02495100,MARYLAND BEAUTY ACADEMY                 ,MD,21136-0000,Proprietary  ,0,9,9,12,38,50
02545400,NORTH AMERICAN TRADE SCHOOLS            ,MD,21244-0069,Proprietary  ,37,192,229,231,990,1221
02573800,"L' ACADEMIE DE CUISINE, INC.            ",MD,20877-0000,Proprietary  ,3,9,12,30,108,138
02578400,TAI SOPHIA INSTITUTE                    ,MD,20723-6010,Private      ,0,14,14,2,257,259
03027200,BLADES SCHOOL OF HAIR DESIGN            ,MD,20619-0226,Proprietary  ,6,10,16,30,69,99
03064900,AARON'S ACADEMY OF BEAUTY               ,MD,20602-2715,Proprietary  ,0,6,6,25,70,95
03097200,AESTHETICS INSTITUTE OF COSMETOLOGY     ,MD,20877-1305,Proprietary  ,2,7,9,5,51,56
03100700,CARROLL COMMUNITY COLLEGE               ,MD,21157-6913,Public       ,41,67,108,831,781,1612
03148300,AMERICAN BEAUTY ACADEMY                 ,MD,20902-1911,Proprietary  ,49,124,173,230,514,744
03296300,BALTIMORE SCHOOL OF MASSAGE             ,MD,21090-2261,Proprietary  ,37,115,152,175,595,770
03327300,NEW CREATIONS ACADEMY OF HAIR DSN       ,MD,20746-2960,Proprietary  ,1,5,6,9,44,53
03493300,ALL-STATE CAREER SCHOOL                 ,MD,21224-6658,Proprietary  ,111,529,640,469,2171,2640
03771300,AMERICAN CAREER INSTITUTE               ,MD,20902-4637,Proprietary  ,7,52,59,26,200,226
03822400,MAPLE SPRINGS BAPTIST BIBLE COLLEGE & SE,MD,20743-5711,Private      ,0,4,4,0,45,45
03965500,HAIR EXPRESSIONS ACADEMY                ,MD,20852-1729,Proprietary  ,6,13,19,32,78,110
04121600,FILA ACADEMY (THE)                      ,MD,21061-1634,Proprietary  ,8,19,27,57,140,197
04139700,FREDERICK SCHOOL OF COSMETOLOGY         ,MD,21701-0000,Proprietary  ,3,3,6,3,3,6
        ,MGH INSTITUTE OF HEALTH PROFESSION      ,MA,02129-0000,Private      ,0,0,0,30,858,888
00211400,AMERICAN INTERNATIONAL COLLEGE          ,MA,01109-3189,Private      ,40,167,207,2101,2040,4141
00211500,AMHERST COLLEGE                         ,MA,01002-5000,Private      ,32,2,34,4630,137,4767
00211600,ANDOVER NEWTON THEOLOGICAL SCHOOL       ,MA,02459-0000,Private      ,0,2,2,0,202,202
00211700,ANNA MARIA COLLEGE                      ,MA,01612-1198,Private      ,16,30,46,1261,385,1646
00211800,ASSUMPTION COLLEGE                      ,MA,01615-1294,Private      ,25,19,44,4087,461,4548
00211900,ATLANTIC UNION COLLEGE                  ,MA,01561-1000,Private      ,9,15,24,275,242,517
00212000,MERRIMACK COLLEGE                       ,MA,01845-5800,Private      ,44,11,55,3734,163,3897
00212100,BABSON COLLEGE                          ,MA,02457-0310,Private      ,30,80,110,2353,869,3222
00212200,BAY PATH COLLEGE                        ,MA,01106-2212,Private      ,13,99,112,765,1568,2333
00212300,BECKER COLLEGE-WORCESTER                ,MA,01615-0071,Private      ,24,64,88,2057,905,2962
00212400,BENTLEY UNIVERSITY                      ,MA,02452-4705,Private      ,41,30,71,5972,737,6709
00212600,BERKLEE COLLEGE OF MUSIC                ,MA,02215-3693,Private      ,72,48,120,3603,885,4488
00212800,BOSTON COLLEGE                          ,MA,02467-3800,Private      ,131,64,195,18383,6439,24822
00212900,BOSTON CONSERVATORY OF MUSIC            ,MA,02215-9830,Private      ,10,1,11,964,270,1234
00213000,BOSTON UNIVERSITY                       ,MA,02215-1789,Private      ,247,321,568,29215,15406,44621
00213300,BRANDEIS UNIVERSITY                     ,MA,02453-2700,Private      ,34,18,52,4835,1007,5842
00213900,CLARK UNIVERSITY                        ,MA,01610-1473,Private      ,30,18,48,4200,524,4724
00214000,ELMS COLLEGE                            ,MA,01013-2839,Private      ,10,22,32,1035,464,1499
00214100,COLLEGE OF THE HOLY CROSS               ,MA,01610-2395,Private      ,32,2,34,5533,65,5598
00214300,CURRY COLLEGE                           ,MA,02186-2395,Private      ,39,46,85,3767,898,4665
00214400,DEAN COLLEGE                            ,MA,02038-1994,Private      ,22,8,30,1584,124,1708
00214500,EASTERN NAZARENE COLLEGE                ,MA,02170-2999,Private      ,11,43,54,831,459,1290
00214507,EASTERN NAZARENE CLG - LEAD PROGRAM     ,MA,02170-0000,Private      ,0,3,3,13,75,88
00214600,EMERSON COLLEGE                         ,MA,02116-4624,Private      ,49,15,64,6357,1333,7690
00214700,EMMANUEL COLLEGE                        ,MA,02115-5798,Private      ,37,27,64,4197,381,4578
00214800,ENDICOTT COLLEGE                        ,MA,01915-2098,Private      ,30,18,48,3955,289,4244
00214900,EPISCOPAL DIVINITY SCHOOL               ,MA,02138-0000,Private      ,0,6,6,0,77,77
00215000,FISHER COLLEGE                          ,MA,02116-1500,Private      ,31,79,110,1236,931,2167
00215100,BENJAMIN FRANKLIN INSTITUTE OF TECH     ,MA,02116-6296,Public       ,13,11,24,586,257,843
00215300,GORDON COLLEGE                          ,MA,01984-1899,Private      ,12,3,15,1938,94,2032
00215400,HELLENIC COLLEGE                        ,MA,02445-7496,Private      ,2,2,4,38,87,125
00215500,HARVARD UNIVERSITY                      ,MA,02138-3800,Private      ,100,45,145,6028,946,6974
00215501,AMRCN REPERTORY THTR INST ADV THTR      ,MA,02138-0000,Private      ,0,1,1,2,108,110
00215502,HARVARD BUSINESS SCHOOL                 ,MA,02163-0000,Private      ,7,13,20,221,1699,1920
00215503,HARVARD EXTENSION SCHOOL                ,MA,02138-0000,Private      ,7,81,88,128,1014,1142
00215504,HARVARD SCH OF DENTAL MEDICINE          ,MA,02115-0000,Private      ,1,1,2,11,178,189
00215505,HARVARD UNIV GRAD SCH DESIGN            ,MA,02138-0000,Private      ,1,10,11,7,852,859
00215506,HARVARD DIVINITY SCHOOL                 ,MA,02138-0000,Private      ,1,4,5,13,664,677
00215507,HARVARD UNIV GRAD SCH ED                ,MA,02138-0000,Private      ,1,20,21,16,1152,1168
00215508,HARVARD UNIV GRAD S OF ARTS & SCIEN     ,MA,02138-0000,Private      ,1,23,24,110,851,961
00215509,HARVARD JOHN F KENNEDY SCHL OF GOVT     ,MA,02138-0000,Private      ,1,14,15,23,1207,1230
00215510,HARVARD LAW SCHOOL                      ,MA,02138-0000,Private      ,4,15,19,84,4095,4179
00215511,HARVARD UNIV MEDICAL SCHOOL             ,MA,02115-0000,Private      ,5,8,13,110,1133,1243
00215512,HARVARD UNIV SCH PUBLIC HEALTH          ,MA,02115-0000,Private      ,1,6,7,51,675,726
00215513,HARVARD UNIVERSITY-HARVARD COLLEGE      ,MA,02138-0000,Private      ,86,10,96,13453,348,13801
00215700,HEBREW COLLEGE                          ,MA,02459-2237,Private      ,0,0,0,1,74,75
00215800,LASELL COLLEGE                          ,MA,02466-2716,Private      ,25,7,32,2495,129,2624
00216000,LESLEY UNIVERSITY                       ,MA,02138-2790,Private      ,35,392,427,2304,5144,7448
00216100,UMASS LOWELL                            ,MA,01854-3089,Public       ,129,205,334,8538,3552,12090
00216400,NEW ENGLAND COLLEGE OF OPTOMETRY        ,MA,02115-1129,Private      ,1,3,4,6,425,431
00216500,MASS. COLLEGE OF PHARMACY  & HEALTH SCIE,MA,02115-5804,Private      ,28,10,38,3690,2049,5739
00216700,BERKSHIRE COMMUNITY COLLEGE             ,MA,01201-5786,Public       ,36,49,85,787,907,1694
00216800,CAPE COD COMMUNITY COLLEGE              ,MA,02668-1599,Public       ,68,117,185,1432,1596,3028
00216900,GREENFIELD COMMUNITY COLLEGE            ,MA,01301-9739,Public       ,52,86,138,768,1245,2013
00217000,HOLYOKE COMMUNITY COLLEGE               ,MA,01040-1099,Public       ,114,177,291,3219,3380,6599
00217100,MASSACHUSETTS BAY COMMUNITY COLLEGE     ,MA,02181-0000,Public       ,81,109,190,1771,1872,3643
00217200,MOUNT WACHUSETT COMMUNITY COLLEGE       ,MA,01440-1000,Public       ,61,179,240,1629,2498,4127
00217300,NORTH SHORE COMMUNITY COLLEGE           ,MA,01923-4093,Public       ,122,177,299,2815,3250,6065
00217400,NORTHERN ESSEX COMMUNITY COLLEGE        ,MA,01830-2399,Public       ,126,236,362,2485,3361,5846
00217500,QUINSIGAMOND COMMUNITY COLLEGE          ,MA,01606-2092,Public       ,121,169,290,3141,3277,6418
00217600,BRISTOL COMMUNITY COLLEGE               ,MA,02720-7399,Public       ,107,181,288,3243,3426,6669
00217700,MASSASOIT COMMUNITY COLLEGE             ,MA,02302-3996,Public       ,65,107,172,2736,2771,5507
00217800,MASSACHUSETTS INST OF TECHNOLOGY        ,MA,02139-4307,Private      ,70,102,172,9065,2560,11625
00218000,MASSACHUSETTS COLLEGE OF ART AND DESIGN ,MA,02115-5803,Public       ,25,14,39,2075,670,2745
00218100,MASSACHUSETTS MARITIME ACADEMY          ,MA,02532-3400,Public       ,12,5,17,1098,81,1179
00218300,BRIDGEWATER STATE COLLEGE               ,MA,02325-0001,Public       ,145,69,214,10035,2395,12430
00218400,FITCHBURG STATE COLLEGE                 ,MA,01420-2697,Public       ,50,32,82,4879,1197,6076
00218500,FRAMINGHAM STATE COLLEGE                ,MA,01702-2471,Public       ,49,32,81,4845,941,5786
00218700,MASSACHUSETTS CLG OF LIBERAL ARTS       ,MA,01247-4100,Public       ,20,16,36,1706,445,2151
00218800,SALEM STATE COLLEGE                     ,MA,01970-5353,Public       ,114,96,210,8185,2763,10948
00218900,WESTFIELD STATE COLLEGE                 ,MA,01086-1630,Public       ,79,29,108,6480,964,7444
00219000,WORCESTER STATE COLLEGE                 ,MA,01602-2597,Public       ,55,69,124,4872,1640,6512
00219200,MOUNT HOLYOKE COLLEGE                   ,MA,01075-1492,Private      ,23,2,25,2436,256,2692
00219300,MOUNT IDA COLLEGE                       ,MA,02459-3323,Private      ,18,2,20,2209,289,2498
00219400,NEW ENGLAND CONSERVATORY OF MUSIC       ,MA,02115-5018,Private      ,5,4,9,646,467,1113
00219700,NICHOLS COLLEGE                         ,MA,01571-6346,Private      ,22,22,44,2005,287,2292
00219900,NORTHEASTERN UNIVERSITY                 ,MA,02115-5000,Private      ,316,366,682,30105,8506,38611
00220100,PINE MANOR COLLEGE                      ,MA,02167-0000,Private      ,4,2,6,593,137,730
00220200,BLESSED JOHN XXIII NATIONAL SEMINARY    ,MA,02493-0000,Private      ,0,0,0,0,2,2
00220500,QUINCY COLLEGE                          ,MA,02169-4501,Public       ,63,151,214,1119,2211,3330
00220600,REGIS COLLEGE                           ,MA,02193-0000,Private      ,16,21,37,1635,537,2172
00220800,SIMMONS COLLEGE                         ,MA,02115-5898,Private      ,29,71,100,2990,2969,5959
00220900,SMITH COLLEGE                           ,MA,01063-2936,Private      ,22,11,33,3351,893,4244
00221000,UNIV OF MASSACHUSETTS-DARTMOUTH         ,MA,02747-2300,Public       ,122,73,195,10272,1845,12117
00221100,SPRINGFIELD COLLEGE                     ,MA,01109-3797,Private      ,19,168,187,3661,3838,7499
00221400,ST JOHN'S SEMINARY                      ,MA,02135-8839,Private      ,4,18,22,11,60,71
00221700,STONEHILL COLLEGE                       ,MA,02357-6110,Private      ,46,3,49,5919,103,6022
00221800,SUFFOLK UNIVERSITY                      ,MA,02108-2770,Private      ,91,51,142,8773,2244,11017
00221802,SUFFOLK UNIVERSITY LAW SCHOOL           ,MA,02108-0000,Private      ,0,11,11,140,2939,3079
00221900,TUFTS UNIVERSITY                        ,MA,02155-5808,Private      ,51,43,94,9218,2262,11480
00221901,TUFTS UNIV SCH OF DENTAL MEDICINE       ,MA,02111-0000,Private      ,0,5,5,13,785,798
00221902,TUFTS UNIVERSITY - CUMMINGS SCHOOL OF VE,MA,01536-0000,Private      ,0,1,1,33,406,439
00221904,TUFTS UNIV SCHOOL OF MEDICINE           ,MA,02111-0000,Private      ,0,6,6,40,1561,1601
00222100,UNIV OF MASSACHUSETTS-AMHERST           ,MA,01003-0000,Public       ,308,187,495,30629,5899,36528
00222200,UNIV OF MASSACHUSETTS-BOSTON            ,MA,02125-3393,Public       ,208,313,521,8430,7558,15988
00222400,WELLESLEY COLLEGE                       ,MA,02481-8203,Private      ,25,4,29,3228,161,3389
00222500,WENTWORTH INSTITUTE OF TECHNOLOGY       ,MA,02115-5998,Private      ,62,30,92,4127,513,4640
00222600,WESTERN NEW ENGLAND COLLEGE             ,MA,01119-2654,Private      ,28,32,60,4876,1558,6434
00222700,WHEATON COLLEGE                         ,MA,02766-2322,Private      ,24,0,24,2677,34,2711
00222800,WHEELOCK COLLEGE                        ,MA,02215-4176,Private      ,15,11,26,1321,546,1867
00222900,WILLIAMS COLLEGE                        ,MA,01267-2600,Private      ,17,1,18,3987,84,4071
00223300,WORCESTER POLYTECHNIC INSTITUTE         ,MA,01609-2280,Private      ,38,11,49,5148,349,5497
00396500,BAY STATE COLLEGE                       ,MA,02116-2901,Proprietary  ,30,24,54,1214,457,1671
00396600,BOSTON ARCHITECTURAL COLLEGE            ,MA,02115-2795,Private      ,14,30,44,505,1019,1524
00466100,HAMPSHIRE COLLEGE                       ,MA,01002-3359,Private      ,19,1,20,2417,93,2510
00466600,SALTER COLLEGE                          ,MA,01583-1700,Proprietary  ,149,618,767,752,2866,3618
00466700,SCHOOL OF MUSEUM OF FINE ARTS           ,MA,02115-5534,Private      ,10,5,15,905,274,1179
00466900,UPPER CAPE COD REGIONAL VOC TECH        ,MA,02532-3310,Public       ,0,3,3,10,80,90
00527900,GREATER LOWELL REGNL VOC TECH SCH       ,MA,01879-0000,Public       ,0,2,2,19,75,94
00551900,DIMAN REGIONAL VOC TECH INST            ,MA,02723-3519,Public       ,2,4,6,17,71,88
00552300,BLUE HILLS REGIONAL VOC TECH            ,MA,02021-1398,Public       ,1,3,4,30,114,144
00555700,MCCANN TECHNICAL SCHOOL                 ,MA,01247-0000,Public       ,1,3,4,22,58,80
00613600,NATIONAL AVIATION ACADEMY - NEW ENGLAND ,MA,01730-2620,Proprietary  ,8,21,29,108,119,227
00632200,BROCKTON HOSPITAL SCH OF NURSING        ,MA,02302-0000,Private      ,1,3,4,129,357,486
00632400,LABOURE COLLEGE                         ,MA,02124-5698,Private      ,8,31,39,167,660,827
00633100,LAWRENCE MEM HOSPITAL SCH OF NRSNG      ,MA,02155-1643,Private      ,3,11,14,63,361,424
00687300,MARIAN COURT COLLEGE                    ,MA,01907-2896,Private      ,11,4,15,214,100,314
00748100,GIBBS COLLEGE                           ,MA,02116-2904,Proprietary  ,3,7,10,128,229,357
00748400,NEWBURY COLLEGE                         ,MA,02445-5796,Private      ,18,16,34,1562,226,1788
00748600,THE NEW ENGLAND INSTITUTE OF ART        ,MA,02445-7295,Proprietary  ,74,46,120,2008,655,2663
00748800,KAPLAN CAREER INSTITUTE                 ,MA,02129-1644,Proprietary  ,44,118,162,222,637,859
00807800,SPRINGFIELD TECHNICAL COMMUNITY CLG     ,MA,01105-0000,Public       ,121,196,317,2401,4032,6433
00809002,EVEREST COLLEGE - EVEREST INSTITUTE     ,MA,02150-2333,Proprietary  ,36,105,141,189,500,689
00891600,NEW ENGLAND SCHOOL OF LAW               ,MA,02116-0000,Private      ,0,10,10,12,2263,2275
00964500,BARD COLLEGE AT SIMON'S ROCK            ,MA,01230-9702,Private      ,5,1,6,442,10,452
00974700,GORDON-CONWELL THEOLOGICAL SEMINARY     ,MA,01982-0000,Private      ,0,27,27,5,625,630
00975600,UNIVERSITY OF MASS MEDICAL CENTER       ,MA,01655-0000,Public       ,2,7,9,24,710,734
00987700,HENRI'S SCHOOL OF HAIR DESIGN           ,MA,01420-5675,Proprietary  ,3,8,11,32,38,70
00989900,LOWELL ACADEMY HAIRSTYLING INST         ,MA,01852-1909,Proprietary  ,14,14,28,57,53,110
00993600,MIDDLESEX COMMUNITY COLLEGE             ,MA,01730-1197,Public       ,50,77,127,1244,990,2234
00993602,"MIDDLESEX COMMUNITY COLLEGE, LOWELL     ",MA,01852-0000,Public       ,110,146,256,2143,1725,3868
01121000,BUNKER HILL COMMUNITY COLLEGE           ,MA,02129-2991,Public       ,132,239,371,3578,5309,8887
01151000,EVEREST INSTITUTE                       ,MA,02135-7638,Proprietary  ,63,139,202,260,646,906
01193000,ROXBURY COMMUNITY COLLEGE               ,MA,02120-3400,Public       ,52,164,216,907,2363,3270
01204200,MANSFIELD BEAUTY SCHOOLS                ,MA,02169-5061,Proprietary  ,9,18,27,43,107,150
01206800,MANSFIELD BEAUTY SCHOOL                 ,MA,01103-1410,Proprietary  ,1,14,15,8,68,76
01238600,SOUTHEASTERN TECHNICAL INSTITUTE        ,MA,02375-1780,Public       ,1,1,2,46,157,203
01288100,MONTACHUSETT REG VOC TECH SCH           ,MA,01420-4649,Public       ,0,2,2,7,50,57
01292100,"BLAINE, THE BEAUTY CAREER SCHOOLS       ",MA,02215-0000,Proprietary  ,40,60,100,223,327,550
01292101,"BLAINE, THE BEAUTY CAREER SCHOOLS - HYAN",MA,02601-2022,Proprietary  ,2,2,4,11,12,23
01294800,ROB ROY ACADEMY                         ,MA,02721-5330,Proprietary  ,14,29,43,64,104,168
02063000,MONTSERRAT COLLEGE OF ART               ,MA,01915-0000,Private      ,6,1,7,496,51,547
02063800,BUTERA SCHOOL OF ART                    ,MA,02116-0000,Proprietary  ,0,1,1,53,13,66
02076700,"BLAINE, THE BEAUTY CAREER SCHOOL        ",MA,02148-0000,Proprietary  ,19,26,45,98,205,303
02079400,BLAINE THE BEAUTY CAREER SCHOOL         ,MA,02453-0000,Proprietary  ,11,25,36,80,190,270
02092100,MASSACHUSETTS SCHOOL OF BARBERING       ,MA,02169-0000,Proprietary  ,8,23,31,25,96,121
02092200,BLAINE THE BEAUTY CAREER SCHOOLS        ,MA,01852-0000,Proprietary  ,7,29,36,78,172,250
02122000,NEW ENGLAND HAIR ACADEMY                ,MA,02148-0000,Proprietary  ,0,16,16,50,93,143
02137000,ROB ROY ACADEMY                         ,MA,02780-0000,Proprietary  ,6,8,14,30,42,72
02137200,MASS GEN HOSP DIETETIC INTERNSHIP       ,MA,02114-0000,Private      ,1,2,3,2,14,16
02143000,LONGY SCHOOL OF MUSIC                   ,MA,02138-3599,Private      ,0,0,0,37,128,165
02161300,WESTON JESUIT SCHOOL OF THEOLOGY        ,MA,02138-0000,Private      ,0,0,0,0,19,19
02163500,NEW ENGLAND SCHOOL OF PHOTOGRAPHY       ,MA,02215-0000,Proprietary  ,2,2,4,131,107,238
02163600,MASS SCH OF PROFESSIONAL PSYCHOLOGY     ,MA,02132-0000,Private      ,1,3,4,6,517,523
02169900,ASSABET VALLEY REGIONAL VOC SCHOOL      ,MA,01752-0000,Public       ,0,2,2,13,51,64
02181600,ROB ROY ACADEMY                         ,MA,01609-0000,Proprietary  ,16,25,41,89,162,251
02182900,CAMBRIDGE COLLEGE                       ,MA,02138-5304,Private      ,34,537,571,279,5080,5359
02197900,NORTH BENNET STREET SCHOOL              ,MA,02113-0000,Private      ,0,3,3,24,95,119
02215100,HALLMARK INSTITUTE OF PHOTOGRAPHY       ,MA,01376-0000,Proprietary  ,0,0,0,181,150,331
02219501,MILDRED ELLEY                           ,MA,01201-0000,Proprietary  ,0,1,1,3,18,21
02220400,CATHERINE HINDS INST OF ESTHETICS       ,MA,01801-0000,Proprietary  ,2,24,26,41,141,182
02231600,MGH INSTITUTE OF HEALTH PROFESSION      ,MA,02129-0000,Private      ,6,43,49,6,43,49
02237100,JOSEPH P KEEFE TECHNICAL SCHOOL         ,MA,01701-5698,Public       ,0,0,0,2,0,2
02274300,CONWAY SCHOOL OF LANDSCAPE DESIGN       ,MA,01341-0179,Private      ,0,0,0,0,22,22
02325700,LABARON HAIRDRESSING ACADEMY            ,MA,02740-0000,Proprietary  ,3,9,12,17,49,66
02325800,LABARON HAIRDRESSING ACAD-BROCKTON      ,MA,02301-0000,Proprietary  ,1,9,10,20,46,66
02337400,BANCROFT SCHOOL OF MASSAGE THERAPY      ,MA,01604-4614,Proprietary  ,1,7,8,16,44,60
02338200,BAY STATE SCHOOL OF TECHNOLOGY          ,MA,02021-0000,Proprietary  ,9,71,80,69,249,318
02339400,ROB ROY ACADEMY                         ,MA,02746-0000,Proprietary  ,4,2,6,17,18,35
02491700,CORTIVA INSTITUTE -  BOSTON             ,MA,02472-2577,Proprietary  ,7,54,61,39,278,317
02523900,ELIZABETH GRADY SCHOOL OF ESTHETICS     ,MA,02155-0000,Proprietary  ,5,16,21,45,97,142
02579800,NEW ENGLAND SCHOOL OF ACUPUNCTURE       ,MA,02458-0000,Private      ,0,3,3,0,154,154
03006802,PENNSYLVANIA CULINARY INSTITUTE - LE COR,MA,02142-1221,Proprietary  ,37,118,155,129,350,479
03066700,AILANO SCHOOL OF COSMETOLOGY            ,MA,02303-4740,Proprietary  ,2,9,11,27,50,77
03104000,SHAWSHEEN ADULT TECHNICAL INSTITUTE     ,MA,01821-5499,Public       ,0,0,0,10,35,45
03120800,KAY HARVEY HAIRDRESSING ACADEMY         ,MA,01089-2701,Proprietary  ,5,19,24,24,75,99
03127700,SOUTHERN NEW ENGLAND SCHOOL OF LAW      ,MA,02747-1252,Private      ,0,1,1,3,278,281
03130500,URBAN COLLEGE OF BOSTON                 ,MA,02111-1093,Private      ,5,41,46,36,622,658
03194300,BOSTON GRAD SCH OF PSYCHOANALYSIS       ,MA,02446-4602,Private      ,0,4,4,2,73,75
03196300,LINCOLN TECHNICAL INSTITUTE             ,MA,02145-1102,Proprietary  ,79,149,228,362,742,1104
03196302,LINCOLN TECHNICAL INSTITUTE             ,MA,01852-5119,Proprietary  ,52,133,185,283,515,798
03205400,JOLIE HAIR & BEAUTY ACADEMY             ,MA,01056-2769,Proprietary  ,7,19,26,26,76,102
03232302,LINCOLN TECHNICAL INSTITUTE             ,MA,02401-1818,Proprietary  ,78,152,230,233,498,731
03235300,MASSACHUSETTS SCHOOL OF LAW             ,MA,01810-1094,Private      ,0,18,18,2,639,641
03240300,HAIR IN MOTION BEAUTY ACADEMY           ,MA,01604-2213,Proprietary  ,0,8,8,12,23,35
03248300,BOSTON BAPTIST COLLEGE                  ,MA,02136-4000,Private      ,1,2,3,82,39,121
03316400,FUNERAL INSTITUTE OF THE NORTHEAST      ,MA,02062-4766,Proprietary  ,0,4,4,18,96,114
03504300,NATL GRAD SCH OF QUALITY SYSTM MGMT     ,MA,02540-0000,Private      ,0,19,19,0,34,34
03763300,MEDICAL PROFESSIONAL INSTITUTE          ,MA,02148-8143,Proprietary  ,2,21,23,23,142,165
03859300,E.I.N.E.                                ,MA,01876-4709,Proprietary  ,1,8,9,5,33,38
03946300,FRANKLIN W. OLIN COLLEGE OF ENGINEERING ,MA,02492-1200,Private      ,2,0,2,407,8,415
03965300,NEW ENGLAND COLLEGE OF FINANCE          ,MA,02110-1605,Proprietary  ,0,4,4,0,4,4
04039300,SULLIVAN AND COGLIANO TRAINING CENTER   ,MA,02301-1822,Proprietary  ,20,288,308,74,1013,1087
04116900,DIGRIGOLI SCHOOL OF COSMETOLOGY         ,MA,01089-4623,Proprietary  ,1,8,9,26,40,66
04128000,MILLENNIUM TRAINING INSTITUTE           ,MA,01801-6386,Proprietary  ,1,18,19,3,32,35
04128900,CENTRAL MASS SCHOOL OF MASSAGE AND THERA,MA,01562-1712,Proprietary  ,1,9,10,15,24,39
00324204,CARNEGIE MELLON UNIVERSITY - QATAR      ,FC,00000-0000,Private      ,0,0,0,3,2,5
00324206,CARNEGIE MELLON UNIVERSITY  - THE HEINZ ,FC,00000-0000,Private      ,0,0,0,0,3,3
00369102,MIDDLEBURY COLLEGE - GERMANY            ,FC,00000-0000,Private      ,0,0,0,0,1,1
00369103,MIDDLEBURY COLLEGE - ITALY              ,FC,00000-0000,Private      ,0,1,1,0,1,1
00369104,MIDDLEBURY COLLEGE - SPAIN              ,FC,00000-0000,Private      ,0,3,3,0,4,4
00369105,MIDDLEBURY COLLEGE - RUSSIA             ,FC,00000-0000,Private      ,0,0,0,0,3,3
00401000,INSTITUT INTERNAT'L D'ETUDES FRANCA     ,FC,00000-0000,Public       ,0,0,0,1,3,4
00401200,HEBREW UNIVERSITY OF JERUSALEM (THE)    ,FC,00000-0000,Public       ,0,3,3,62,113,175
00403000,UNIVERSITY OF CAMBRIDGE                 ,FC,00000-0000,Public       ,0,1,1,2,60,62
00503400,AMERICAN UNIVERSITY OF CAIRO            ,FC,00000-0000,Private      ,4,3,7,82,216,298
00667100,KATHOLIEKE UNIVERSITEIT LEUVEN          ,FC,00000-0000,Private      ,0,3,3,1,37,38
00669000,UNIVERSITY OF COPENHAGEN                ,FC,00000-0000,Public       ,0,0,0,1,3,4
00669100,UNIVERSITY OF CAMBRIDGE - PEMBROKE      ,FC,00000-0000,Public       ,0,0,0,1,11,12
00669200,UNIVERSITY OF LEEDS                     ,FC,00000-0000,Public       ,0,1,1,14,84,98
00669300,UNIV OF LONDON-LONDON SCHOOL ECON       ,FC,00000-0000,Public       ,1,6,7,20,479,499
00669400,SCH OF ORIENTAL & AFRICAN STUDIES       ,FC,00000-0000,Public       ,0,1,1,7,146,153
00669500,UNIV OF LONDON-UNIVERSITY COLLEGE       ,FC,00000-0000,Public       ,0,4,4,16,274,290
00669600,UNIV OF LONDON-SCH ADVANCED STUDY       ,FC,00000-0000,Public       ,0,0,0,1,17,18
00669700,"QUEEN MARY, UNIVERSITY OF LONDON        ",FC,00000-0000,Public       ,0,0,0,19,103,122
00669900,UNIVERSITY OF SUSSEX                    ,FC,00000-0000,Public       ,0,1,1,14,70,84
00670000,"UNIVERSITY OF YORK, THE                 ",FC,00000-0000,Public       ,0,0,0,11,87,98
00670400,UNIVERSITY COLLEGE CORK                 ,FC,00000-0000,Public       ,0,1,1,9,56,65
00671300,UPPSALA UNIVERSITY                      ,FC,00000-0000,Public       ,0,1,1,0,21,21
00671500,UNIVERSITY OF GENEVA                    ,FC,00000-0000,Public       ,0,0,0,5,58,63
00683900,UNIVERSITY OF EDINBURGH                 ,FC,00000-0000,Public       ,2,7,9,114,496,610
00684200,UNIVERSITY OF DUBLIN TRINITY COLLEG     ,FC,00000-0000,Public       ,2,0,2,44,138,182
00685000,UNIVERSITY OF CAMBRIDGE - DOWNING C     ,FC,00000-0000,Public       ,0,0,0,0,5,5
00685100,INTERNATIONAL CHRISTIAN UNIVERSITY      ,FC,00000-0000,Private      ,0,0,0,10,7,17
00763200,UNIVERSITY OF BRISTOL                   ,FC,00000-0000,Public       ,0,1,1,9,72,81
00768100,COLLEGE OF EUROPE                       ,FC,00000-0000,Private      ,0,1,1,1,6,7
00770500,ROYAL COLLEGE OF SURGEONS IN IRELAN     ,FC,00000-0000,Private      ,0,0,0,7,62,69
00788100,AMERICAN UNIVERSITY OF PARIS            ,FC,00000-0000,Private      ,8,5,13,280,207,487
00837100,AMERICAN UNIVERSITY OF BEIRUT           ,FC,00000-0000,Private      ,5,1,6,71,77,148
00837300,TEL-AVIV UNIVERSITY                     ,FC,00000-0000,Public       ,0,0,0,16,63,79
00837600,VRIJE UNIVERSITEIT AMSTERDAM            ,FC,00000-0000,Public       ,0,2,2,0,5,5
00837700,UNIVERSITEIT VAN AMSTERDAM(UNIVERSI     ,FC,00000-0000,Public       ,0,1,1,9,113,122
00838000,UNIVERSITY OF WARWICK                   ,FC,00000-0000,Public       ,0,1,1,9,60,69
00838300,UNIVERSITY OF GLASGOW                   ,FC,00000-0000,Public       ,0,3,3,35,330,365
00838600,UNIVERSITY OF HELSINKI                  ,FC,00000-0000,Public       ,0,0,0,2,5,7
00839300,UNIVERSITY OF OSLO                      ,FC,00000-0000,Public       ,0,0,0,3,15,18
00839400,UNIVERSITY OF OXFORD                    ,FC,00000-0000,Public       ,1,2,3,14,164,178
00839800,UNIVERSITY OF SHEFFIELD (THE)           ,FC,00000-0000,Public       ,0,1,1,11,68,79
00839900,UNIVERSITY OF SOUTHAMPTON               ,FC,00000-0000,Public       ,0,1,1,5,39,44
00845000,KASTURBA MEDICAL COLLEGE (A CONSTITENT I,FC,00000-0000,Private      ,0,0,0,25,66,91
00845200,ABERYSTWYTH UNIVERSITY                  ,FC,00000-0000,Public       ,0,0,0,7,22,29
00846000,UNIVERSITY OF NEWCASTLE UPON TYNE       ,FC,00000-0000,Public       ,0,1,1,7,57,64
00846100,UNIVERSITY OF SAINT ANDREWS             ,FC,00000-0000,Public       ,1,1,2,139,134,273
00846200,UNIVERSIDAD DE SALAMANCA                ,FC,00000-0000,Public       ,0,0,0,3,38,41
00850500,UNIVERSITY OF MELBOURNE                 ,FC,00000-0000,Public       ,1,8,9,12,139,151
00858600,SWANSEA UNIVERSITY                      ,FC,00000-0000,Public       ,0,0,0,10,35,45
00858700,UNIVERSITY OF DURHAM                    ,FC,00000-0000,Public       ,0,1,1,9,108,117
00866500,UNIVERSITY OF KENT AT CANTERBURY (THE)  ,FC,00000-0000,Public       ,0,1,1,15,144,159
00866600,UNIVERSITY OF HONG KONG                 ,FC,00000-0000,Public       ,0,0,0,13,40,53
00867000,UNIVERSITY OF NEW SOUTH WALES           ,FC,00000-0000,Public       ,0,12,12,10,114,124
00868700,UNIVERSITY OF ESSEX                     ,FC,00000-0000,Public       ,0,0,0,7,58,65
00869200,LEIDEN UNIVERSITY                       ,FC,00000-0000,Public       ,0,0,0,0,8,8
00869300,CITY UNIVERSITY                         ,FC,00000-0000,Public       ,0,1,1,6,116,122
00890800,THE UNIVERSITY OF BIRMINGHAM            ,FC,00000-0000,Public       ,0,2,2,6,103,109
00891000,UNIVERSITY OF HULL                      ,FC,00000-0000,Public       ,0,0,0,7,16,23
00892000,UNIVERSITY OF NOTTINGHAM                ,FC,00000-0000,Public       ,0,0,0,17,95,112
00900600,UNIVERSITY OF SALFORD (THE)             ,FC,00000-0000,Public       ,0,0,0,0,11,11
00908400,"UNIV OF LONDON, BIRKBECK                ",FC,00000-0000,Public       ,0,0,0,2,77,79
00908500,UNIV OF LONDON KING'S COLLEGE           ,FC,00000-0000,Public       ,0,4,4,21,227,248
00908600,UNIVERSITY OF LONDON - ROYAL HOLLOWAY   ,FC,00000-0000,Public       ,0,0,0,9,56,65
00914300,BAR-ILAN UNIVERSITY                     ,FC,00000-0000,Private      ,0,1,1,9,12,21
00924700,ARCHITECTURAL ASSOC SCH OF ARCHITEC     ,FC,00000-0000,Private      ,0,0,0,4,25,29
00924900,UNIVERSITY OF LIVERPOOL                 ,FC,00000-0000,Public       ,0,8,8,14,74,88
00936800,UNIVERSITY OF ABERDEEN                  ,FC,00000-0000,Public       ,1,0,1,43,130,173
00942300,ROYAL COLLEGE OF ART                    ,FC,00000-0000,Public       ,0,2,2,4,31,35
00942400,ROYAL ACADEMY OF DRAMATIC ART           ,FC,00000-0000,Private      ,0,0,0,9,3,12
00942800,TECHNION-ISRAEL INST OF TECHLGY         ,FC,00000-0000,Public       ,0,0,0,0,73,73
00944200,UNIVERSITY OF EXETER                    ,FC,00000-0000,Public       ,0,2,2,6,89,95
00944400,UNIVERSITY OF LANCASTER                 ,FC,00000-0000,Public       ,0,0,0,2,37,39
00963400,UNIVERSITY OF OXFORD ST CATHERINE'S     ,FC,00000-0000,Public       ,0,0,0,2,13,15
00980800,UNIVERSITY OF STRATHCLYDE               ,FC,00000-0000,Public       ,0,1,1,3,32,35
00981700,UNIVERSITY OF SANTO TOMAS               ,FC,00000-0000,Private      ,0,0,0,2,3,5
00986000,UNIVERSITY OF SURREY                    ,FC,00000-0000,Public       ,0,0,0,5,17,22
00990600,PONTIFICAL NORTH AMERICAN COLLEGE       ,FC,00000-0000,Private      ,0,0,0,1,9,10
00992700,UNIVERSITY OF CAMBRIDGE - FITZWILLI     ,FC,00000-0000,Public       ,0,1,1,1,9,10
01006700,LUND UNIVERSITY                         ,FC,00000-0000,Public       ,1,1,2,5,66,71
01008400,UNIVERSITY OF CAPE TOWN                 ,FC,00000-0000,Private      ,0,4,4,8,57,65
01008700,UNIVERSITY OF OXFORD ST PETER'S COL     ,FC,00000-0000,Public       ,0,1,1,1,6,7
01008800,UNIVERSITY OF OXFORD - CORPUS CHRIS     ,FC,00000-0000,Public       ,0,0,0,0,9,9
01008900,CENTRAL SCHOOL OF SPEECH AND DRAMA      ,FC,00000-0000,Private      ,0,0,0,9,45,54
01009000,UNIVERSITY OF OXFORD - BALLIOL COLL     ,FC,00000-0000,Public       ,0,0,0,1,20,21
01014300,UNIVERSITY OF READING                   ,FC,00000-0000,Public       ,0,1,1,8,38,46
01015700,CARDIFF UNIVERSITY                      ,FC,00000-0000,Public       ,0,1,1,7,58,65
01015900,PONTIFICIA UNIVERSITA GREGORIANA        ,FC,00000-0000,Private      ,0,0,0,0,9,9
01018800,UNIVERSITY COLLEGE DUBLIN               ,FC,00000-0000,Public       ,0,4,4,18,152,170
01019000,UNIVERSITY OF CAMBRIDGE CHURCHILL C     ,FC,00000-0000,Public       ,0,0,0,2,9,11
01022800,UNIVERSITY OF STIRLING                  ,FC,00000-0000,Public       ,0,0,0,14,27,41
01033200,UNIVERSITY OF CAMBRIDGE - CLARE COL     ,FC,00000-0000,Public       ,1,0,1,1,12,13
01045600,UNIVERSITY OF HAIFA                     ,FC,00000-0000,Public       ,0,0,0,12,12,24
01047200,INST EUROPEEN OPEEN D'ADMINISTRATIO     ,FC,00000-0000,Private      ,0,2,2,0,102,102
01049300,CRANFIELD UNIVERSITY                    ,FC,00000-0000,Public       ,1,1,2,1,12,13
01052000,TRINITY LABAN                           ,FC,00000-0000,Public       ,0,0,0,2,6,8
01052001,LABAN CENTER FOR MOVEMENT & DANCE       ,FC,00000-0000,Public       ,0,0,0,0,6,6
01052500,UNIVERSITY OF HERTFORDSHIRE             ,FC,00000-0000,Public       ,0,0,0,5,9,14
01057400,LONDON INTRNTL FILM SCHOOL              ,FC,00000-0000,Private      ,1,2,3,6,38,44
01058400,VRIJE UNIVERSITEIT BRUSSELS             ,FC,00000-0000,Private      ,0,0,0,1,1,2
01058600,INSTITUTE OF SOCIAL STUDIES             ,FC,00000-0000,Private      ,0,0,0,0,14,14
01058800,AUSTRALIAN NATIONAL UNIVERSITY          ,FC,00000-0000,Public       ,1,2,3,8,55,63
01058900,BANGOR UNIVERSITY                       ,FC,00000-0000,Public       ,0,1,1,12,33,45
01059400,"RICHMOND, THE AMERICAN INT UNI IN LONDON",FC,00000-0000,Private      ,4,0,4,336,34,370
01059900,INST D'ETUDES POLITIQUES DE PARIS       ,FC,00000-0000,Public       ,0,0,0,7,37,44
01068100,MACQUARIE UNIVERSITY                    ,FC,00000-0000,Public       ,0,9,9,22,91,113
01069200,UNIVERSITY OF QUEENSLAND (THE)          ,FC,00000-0000,Public       ,2,16,18,20,125,145
01070400,SILLIMAN UNIVERSITY                     ,FC,00000-0000,Private      ,0,0,0,2,5,7
01078900,UNIVERSITY OF OXFORD - WORCESTER CO     ,FC,00000-0000,Public       ,0,0,0,0,5,5
01079200,CITY AND GUILDS OF LONDON INSTITUTE     ,FC,00000-0000,Private      ,0,0,0,0,1,1
01079700,"NATIONAL UNIVERSITY OF IRELAND, MAY     ",FC,00000-0000,Public       ,0,0,0,2,4,6
01080300,SEMMELWEIS UNIVERSITY OF BUDAPEST       ,FC,00000-0000,Public       ,0,2,2,3,40,43
01081600,KINGSTON UNIVERSITY                     ,FC,00000-0000,Public       ,0,1,1,27,38,65
01083800,UNIVERSITITY OF BERGEN (UOB)            ,FC,00000-0000,Public       ,0,1,1,0,3,3
01086400,UNIV OF DUNDEE                          ,FC,00000-0000,Public       ,0,2,2,3,35,38
01086600,UNIVERSITY OF OXFORD - MAGDALEN COLLEGE ,FC,00000-0000,Public       ,1,0,1,1,11,12
01086700,UNIVERSITY OF OXFORD ST JOHN'S COLL     ,FC,00000-0000,Public       ,0,0,0,3,4,7
01091400,MONASH UNIVERSITY                       ,FC,00000-0000,Public       ,2,3,5,7,36,43
01091500,UNIV OF EAST ANGLIA                     ,FC,00000-0000,Public       ,1,1,2,12,57,69
01094200,UNIVERSITY OF OXFORD - ST HUGH'S CO     ,FC,00000-0000,Public       ,0,0,0,0,6,6
01097700,UNIVERSIDAD CENTRAL DEL ESTE            ,FC,00000-0000,Private      ,12,66,78,86,781,867
01098000,SOMERVILLE COLLEGE                      ,FC,00000-0000,Public       ,0,0,0,0,3,3
01099900,UNIV OF OXFORD - WADHAM COLLEGE         ,FC,00000-0000,Public       ,0,0,0,1,1,2
01104400,PONTIFICIA UNIVERSITA SAN TOMMASO       ,FC,00000-0000,Private      ,0,0,0,0,15,15
01105300,UNIVERSITY OF OXFORD - ST HILDA'S C     ,FC,00000-0000,Public       ,0,0,0,2,10,12
01105400,UNIVERSITY OF OXFORD - ST ANNE'S CO     ,FC,00000-0000,Public       ,0,1,1,2,11,13
01105500,UNIV OF OXFORD - LADY MARGARET HALL     ,FC,00000-0000,Public       ,0,0,0,1,11,12
01105600,UNIVERSITY OF OXFORD - UNIVERSITY C     ,FC,00000-0000,Public       ,0,1,1,2,14,16
01105700,UNIVERSITY OF OXFORD - TRINITY COLL     ,FC,00000-0000,Public       ,0,0,0,1,12,13
01105800,UNIVERSITY OF OXFORD-ST EDMUND HALL     ,FC,00000-0000,Public       ,0,0,0,1,16,17
01105900,UNIVERSITY OF OXFORD ST ANTONY'S CO     ,FC,00000-0000,Public       ,0,0,0,0,35,35
01106000,UNIVERSITY OF OXFORD - QUEEN'S COLL     ,FC,00000-0000,Public       ,0,0,0,0,2,2
01106100,UNIVERSITY OF OXFORD - PEMBROKE COL     ,FC,00000-0000,Public       ,0,0,0,0,5,5
01106200,UNIVERSITY OF OXFORD - ORIEL COLLEG     ,FC,00000-0000,Public       ,0,0,0,1,5,6
01106300,UNIVERSITY OF OXFORD - NUFFIELD COL     ,FC,00000-0000,Public       ,0,0,0,0,9,9
01106400,UNIVERSITY OF OXFORD - NEW COLLEGE      ,FC,00000-0000,Public       ,0,2,2,1,11,12
01106500,UNIVERSITY OF OXFORD MERTON COLLEGE     ,FC,00000-0000,Public       ,0,0,0,1,8,9
01106600,UNIVERSITY OF OXFORD - LINCOLN COLL     ,FC,00000-0000,Public       ,0,0,0,2,10,12
01106700,UNIVERSITY OF OXFORD - KEBLE COLLEG     ,FC,00000-0000,Public       ,0,0,0,1,7,8
01106800,UNIVERSITY OF OXFORD - JESUS COLLEG     ,FC,00000-0000,Public       ,0,0,0,1,8,9
01106900,UNIVERSITY OF OXFORD - HERTFORD COL     ,FC,00000-0000,Public       ,0,0,0,0,9,9
01107000,UNIVERSITY OF OXFORD EXETER COLLEGE     ,FC,00000-0000,Public       ,0,0,0,1,22,23
01107100,UNIV OF OXFORD - CHRIST CHURCH          ,FC,00000-0000,Public       ,0,1,1,1,22,23
01107200,UNIVERSITY OF OXFORD - BRASENOSE CO     ,FC,00000-0000,Public       ,0,0,0,1,7,8
01109100,FLINDERS UNIVERSITY OF S AUSTRALIA      ,FC,00000-0000,Public       ,0,2,2,5,22,27
01109400,UNIVERSITY OF WESTERN AUSTRALIA (THE)   ,FC,00000-0000,Public       ,0,2,2,2,18,20
01156700,"IMPERIAL COLLEGE OF SCIENCE, TECHNOLOGY ",FC,00000-0000,Public       ,0,0,0,5,49,54
01167900,UNIVERSITY OF BATH                      ,FC,00000-0000,Public       ,0,1,1,2,22,24
01168300,FRANKLIN COLLEGE  SWITZERLAND           ,FC,00000-0000,Private      ,7,0,7,377,12,389
01175800,UNIV OF CAMBRIDGE - PETERHOUSE          ,FC,00000-0000,Public       ,0,0,0,0,8,8
01176400,ROYAL ACADEMY OF MUSIC                  ,FC,00000-0000,Public       ,0,0,0,11,13,24
01176500,GOLDSMITHS' COLLEGE-UNIV OF LONDON      ,FC,00000-0000,Public       ,0,2,2,22,126,148
01176600,UNIV OF LONDON - INST OF EDUC           ,FC,00000-0000,Public       ,0,2,2,0,19,19
01177900,STOCKHOLM SCHOOL OF ECONOMICS           ,FC,00000-0000,Private      ,0,0,0,0,5,5
01178000,BRUNEL UNIVERSITY                       ,FC,00000-0000,Public       ,0,0,0,0,4,4
01178400,UNIVERSITY OF WARSAW                    ,FC,00000-0000,Public       ,0,0,0,4,9,13
01207500,UNIVERSITY CAMBRIDGE - TRINITY COLL     ,FC,00000-0000,Public       ,0,1,1,0,16,16
01207800,VICTORIA UNIV OF WELLINGTON             ,FC,00000-0000,Public       ,5,10,15,20,49,69
01210100,UNIVERSITY OF CAMBRIDGE - GIRTON CO     ,FC,00000-0000,Public       ,0,0,0,1,2,3
01213600,VICTORIA UNIV OF MANCHESTER (THE)       ,FC,00000-0000,Public       ,0,4,4,13,65,78
01219800,UNIVERSITY OF BRADFORD                  ,FC,00000-0000,Public       ,0,0,0,2,26,28
01220100,UNIVERSITY OF OXFORD - REGENT'S PAR     ,FC,00000-0000,Public       ,0,1,1,2,6,8
01220600,JAMES COOK UNIVERSITY                   ,FC,00000-0000,Public       ,2,7,9,23,72,95
01221300,PONTIFICIA BOLIVARIANA UNIVERSITY       ,FC,00000-0000,Private      ,0,0,0,4,3,7
01221500,BIRMINGHAM CITY UNIVERSITY              ,FC,00000-0000,Public       ,0,0,0,4,11,15
01222300,JAGIELLONIAN UNIVERSITY COLLEGIUM M     ,FC,00000-0000,Public       ,0,0,0,2,63,65
01222500,UNIVERSITY OF SZEGED FACULTY OF MEDICINE,FC,00000-0000,Public       ,0,0,0,1,8,9
01223400,KOREA UNIVERSITY                        ,FC,00000-0000,Private      ,0,0,0,2,5,7
01225800,ASTON UNIVERSITY                        ,FC,00000-0000,Public       ,1,1,2,2,11,13
01227500,UNIVERSITY OF OXFORD - WOLFSON COLL     ,FC,00000-0000,Public       ,0,0,0,0,14,14
01230200,GONVILLE & CAIUS COLLEGE                ,FC,00000-0000,Public       ,0,0,0,1,4,5
01233300,UNIV OF THE ARTS LONDON- CAMBERWELL COLL,FC,00000-0000,Public       ,0,1,1,12,21,33
01233500,ROYAL COLLEGE OF MUSIC                  ,FC,00000-0000,Public       ,0,0,0,3,11,14
01233700,WROCLAW UNIVERSITY OF MEDICINE          ,FC,00000-0000,Public       ,0,1,1,3,8,11
01234100,UNIVERSITY OF WALES - ST DAVID'S UN     ,FC,00000-0000,Public       ,0,1,1,3,38,41
01236000,EDINBURGH COLLEGE OF ART                ,FC,00000-0000,Public       ,0,1,1,1,10,11
01242100,UNIV OF AUCKLAND                        ,FC,00000-0000,Public       ,4,2,6,27,75,102
01253900,UNIVERSITY OF THE ARTS LONDON IDO - CENT,FC,00000-0000,Public       ,1,3,4,57,59,116
01254000,UNIVERSIDAD DE NAVARRA                  ,FC,00000-0000,Private      ,1,0,1,11,25,36
01276500,UNIVERSITY OF OXFORD - LINACRE COLL     ,FC,00000-0000,Public       ,0,0,0,0,11,11
01276600,"NATIONAL UNIVERSITY IRELAND, GALWAY     ",FC,00000-0000,Public       ,0,3,3,14,74,88
01280200,PONTIFICIA UNIV CATOLICA MAD Y MAES     ,FC,00000-0000,Private      ,8,10,18,82,133,215
01281100,INST TECNOLOGICO DE SANTO DOMINGO       ,FC,00000-0000,Private      ,2,7,9,17,92,109
01283900,UNIVERSITY OF CAMBRIDGE - SAINT JOH     ,FC,00000-0000,Public       ,0,0,0,0,14,14
01286200,MOUNTVIEW ACADEMY OF THEATRE ARTS       ,FC,00000-0000,Private      ,0,0,0,2,5,7
01297800,UNIVERSITY OF HUDDERSFIELD (THE)        ,FC,00000-0000,Public       ,0,0,0,1,3,4
01315300,MASSEY UNIVERSITY                       ,FC,00000-0000,Public       ,2,7,9,14,109,123
01322500,COLLEGE OF LAW                          ,FC,00000-0000,Private      ,1,0,1,2,20,22
02052400,DARWIN COLLEGE                          ,FC,00000-0000,Public       ,0,0,0,0,18,18
02082400,UNIVERSITY OF CAMBRIDGE - QUEEN'S C     ,FC,00000-0000,Public       ,0,0,0,0,14,14
02083400,UNIVERSITY OF CAMBRIDGE - WOLFSON C     ,FC,00000-0000,Public       ,0,0,0,0,17,17
02087400,UNIVERSITY OF CAMBRIDGE - NEWNHAM C     ,FC,00000-0000,Public       ,0,0,0,0,3,3
02087900,OXFORD BROOKES UNIVERSITY               ,FC,00000-0000,Public       ,0,1,1,9,44,53
02094100,BEN-GURION UNIV                         ,FC,00000-0000,Public       ,1,1,2,3,158,161
02094400,UNIV OF CAMBRIDGE - ST EDMUND'S HOU     ,FC,00000-0000,Public       ,0,0,0,1,9,10
02095500,LONDON BUS SCHOOL                       ,FC,00000-0000,Private      ,0,4,4,2,166,168
02098700,FATIMA COLLEGE OF MEDICINE              ,FC,00000-0000,Private      ,0,1,1,6,51,57
02101900,ROEHAMPTON UNIVERSITY                   ,FC,00000-0000,Public       ,0,0,0,18,54,72
02108600,LONDON ACADEMY OF MUSIC & DRAMATIC      ,FC,00000-0000,Private      ,1,0,1,11,11,22
02115900,UNIVERSITY OF PORTSMOUTH                ,FC,00000-0000,Public       ,0,0,0,7,8,15
02116700,UNIVERSITY OF CAMBRIDGE - LUCY CAVE     ,FC,00000-0000,Public       ,0,0,0,0,9,9
02120000,UNIV OF LONDON - COURTALD INST OF A     ,FC,00000-0000,Public       ,0,1,1,0,22,22
02133400,UNIVERSITY OF CAMBRIDGE - SIDNEY SU     ,FC,00000-0000,Public       ,0,1,1,1,8,9
02142000,UNIVERSITY OF CAMBRIDGE - HOMERTON      ,FC,00000-0000,Public       ,0,0,0,0,7,7
02149700,UNIVERSITY OF WINCHESTER (THE)          ,FC,00000-0000,Public       ,1,0,1,7,5,12
02156800,UNIV OF OTAGO                           ,FC,00000-0000,Public       ,0,2,2,5,36,41
02162300,"IESE BUSINESS SCH, UNIV OF NAVARRA      ",FC,00000-0000,Private      ,0,0,0,2,73,75
02167400,UNIVERSITY OF CAMBRIDGE - CORPUS CH     ,FC,00000-0000,Public       ,0,0,0,0,7,7
02175700,OHR SOMAYACH INSTITUTIONS               ,FC,00000-0000,Private      ,0,0,0,6,7,13
02177700,KING'S COLLEGE- UNIV OF CAMBRIDGE       ,FC,00000-0000,Public       ,1,0,1,2,33,35
02180500,MIDDLESEX UNIVERSITY                    ,FC,00000-0000,Public       ,0,3,3,10,45,55
02181000,UNIVERSITY OF SOUTH AUSTRALIA           ,FC,00000-0000,Public       ,0,0,0,5,17,22
02183500,UNIV OF OXFORD - WYCLIFFE HALL          ,FC,00000-0000,Public       ,0,0,0,0,7,7
02186000,UNIVERSITY OF CAMBRIDGE - MAGDALENE     ,FC,00000-0000,Public       ,0,0,0,0,9,9
02186100,UNIVERSITY OF CAMBRIDGE - EMMANUEL      ,FC,00000-0000,Public       ,0,1,1,0,7,7
02189600,UNIVERSITY OF GRONINGEN                 ,FC,00000-0000,Public       ,0,0,0,4,6,10
02194800,UNIVERSITY OF THE WEST OF ENGLAND -     ,FC,00000-0000,Public       ,0,0,0,6,10,16
02195100,UNIV OF WESTMINSTER                     ,FC,00000-0000,Public       ,0,1,1,25,112,137
02196700,GUILDHALL SCHOOL OF MUSIC & DRAMA       ,FC,00000-0000,Public       ,0,0,0,7,16,23
02197000,INT'L GRAD PROGRAMME STOCKHOLM UNIV     ,FC,00000-0000,Public       ,0,0,0,0,19,19
02207300,UNIVERSITY OF CAMBRIDGE - CHRIST'S      ,FC,00000-0000,Public       ,0,0,0,1,4,5
02207400,CHINESE UNIVERSITY OF HONG KONG (THE)   ,FC,00000-0000,Public       ,0,4,4,3,6,9
02209500,UNIVERSITEIT UTRECHT                    ,FC,00000-0000,Public       ,1,3,4,11,46,57
02210000,UNIV OF LONDON - LONDON SCHOOL OF H     ,FC,00000-0000,Public       ,0,1,1,0,45,45
02212300,UNIVERSITY OF CAMBRIDGE - ROBINSON      ,FC,00000-0000,Public       ,0,0,0,0,1,1
02216300,UNIVERSIDAD DE CHILE                    ,FC,00000-0000,Public       ,0,0,0,1,4,5
02225300,UNIV OF CANTERBURY                      ,FC,00000-0000,Public       ,0,2,2,7,35,42
02229100,UNIVERSITY OF LEICESTER                 ,FC,00000-0000,Public       ,0,2,2,8,56,64
02229600,SACKLER SCHOOL OF MEDICINE              ,FC,00000-0000,Public       ,0,3,3,0,197,197
02232100,UNIVERSITY OF CAMBRIDGE                 ,FC,00000-0000,Public       ,0,0,0,2,11,13
02233300,"ST GEORGE'S UNIV, SCH OF MEDICINE       ",FC,00000-0000,Proprietary  ,0,216,216,20,2844,2864
02235300,LONDON METROPOLITAN UNIVERSITY          ,FC,00000-0000,Public       ,1,2,3,36,145,181
02240900,AISH HATORAH CLG OF JEWISH STUDIES      ,FC,00000-0000,Private      ,0,0,0,3,2,5
02244400,AMERICAN UNIV OF THE CARIBBEAN          ,FC,00000-0000,Proprietary  ,0,59,59,5,1188,1193
02257100,COVENTRY UNIVERSITY                     ,FC,00000-0000,Public       ,0,0,0,6,8,14
02266600,UNIVERSITY OF LONDON - SAINT GEORGE     ,FC,00000-0000,Public       ,0,0,0,0,6,6
02271700,UNIVERSITY OF CAMBRIDGE - CLARE HAL     ,FC,00000-0000,Public       ,0,0,0,0,9,9
02271800,UNIV OF OXFORD - CAMPION HALL           ,FC,00000-0000,Public       ,0,0,0,0,1,1
02271900,UNIVERSITY OF OXFORD - BLACKFRIARS      ,FC,00000-0000,Public       ,0,0,0,1,2,3
02272100,UNIV OF OXFORD - GREYFRIARS             ,FC,00000-0000,Public       ,0,0,0,0,1,1
02272200,UNIV OF CAMBRIDGE - NEW HALL            ,FC,00000-0000,Public       ,1,0,1,3,7,10
02273600,QUEEN'S UNIV OF BELFAST (THE)           ,FC,00000-0000,Public       ,1,1,2,4,18,22
02273900,HERIOT WATT UNIVERSITY                  ,FC,00000-0000,Public       ,1,2,3,5,26,31
02276700,NYENRODE BUSINESS UNIVERSITEIT          ,FC,00000-0000,Private      ,0,0,0,0,3,3
02279700,UNIVERSITY OF MANCHESTER - INSTITUT     ,FC,00000-0000,Public       ,0,0,0,14,100,114
02293400,ECOLE DES HAUTES ETUDES COMERCIALS      ,FC,00000-0000,Public       ,0,2,2,0,52,52
02296300,UNIVERSITY OF CAMBRIDGE - JESUS COL     ,FC,00000-0000,Public       ,0,1,1,0,8,8
02310500,DE MONTFORT UNIVERSITY                  ,FC,00000-0000,Public       ,0,0,0,4,12,16
02320500,ROYAL NORTHERN COLLEGE OF MUSIC         ,FC,00000-0000,Public       ,0,0,0,2,6,8
02335100,UNIV OF CAMBRIDGE - TRINITY HALL        ,FC,00000-0000,Public       ,0,0,0,1,13,14
02338900,UNIVERSITY  FOR THE CREATIVE ARTS       ,FC,00000-0000,Public       ,0,0,0,3,2,5
02338903,KENT INSTITUTE OF ART & DESIGN          ,FC,00000-0000,Public       ,0,0,0,2,0,2
02339300,ERASMUS UNIV ROTTERDAM                  ,FC,00000-0000,Public       ,0,0,0,1,13,14
02347300,ESCUELA AUTONOMA DE CIENCIAS MEDICA     ,FC,00000-0000,Private      ,1,0,1,11,26,37
02351800,UNIVERSIDAD IBEROAMERICANA (UNIBE       ,FC,00000-0000,Private      ,3,35,38,112,1045,1157
02352100,UNIVERSITY OF PLYMOUTH                  ,FC,00000-0000,Public       ,0,0,0,1,0,1
02355200,ECOLE SUPERIEURE DE CUISINE FRANCAISE-FE,FC,00000-0000,Public       ,0,1,1,4,19,23
02363000,GSA CONSERVATOIRE                       ,FC,00000-0000,Private      ,0,0,0,5,3,8
02493000,ESCUELA SUPERIOR ADMINISTRACION Y D     ,FC,00000-0000,Private      ,0,0,0,2,15,17
02496600,UNIVERSITY OF STELLENBOSCH              ,FC,00000-0000,Public       ,0,0,0,4,8,12
02502600,PECSI ORVOSTUDOMANYI EGYETEM (PECS      ,FC,00000-0000,Public       ,1,0,1,1,15,16
02545700,GLASGOW SCHOOL OF ART                   ,FC,00000-0000,Public       ,0,1,1,13,32,45
02579600,MURDOCH UNIVERSITY                      ,FC,00000-0000,Public       ,0,8,8,5,68,73
02588000,UNIVERSITY OF ULSTER                    ,FC,00000-0000,Public       ,0,0,0,6,18,24
02591800,CURTIN UNIVERSITY OF TECHNOLOGY         ,FC,00000-0000,Public       ,1,3,4,2,20,22
02592300,MILLTOWN INST OF THEOLOGY & PHILOSO     ,FC,00000-0000,Private      ,0,1,1,0,3,3
02604300,AALBORG UNIVERSITY                      ,FC,00000-0000,Public       ,1,1,2,1,18,19
02611500,HELSINKI SCH OF ECONOMICS & BUS ADM     ,FC,00000-0000,Public       ,0,0,0,0,2,2
02611600,ECOL NATIONAL DES PONTS ET CHAUSSEE     ,FC,00000-0000,Public       ,0,0,0,1,5,6
02611700,DUBLIN CITY UNIVERSITY                  ,FC,00000-0000,Public       ,0,0,0,18,32,50
02622500,DENMARKS TEKNISKE UNIVERSITET           ,FC,00000-0000,Public       ,0,0,0,0,5,5
02623200,UNIVERSITY OF NEWCASTLE (THE)           ,FC,00000-0000,Public       ,1,0,1,11,24,35
03012700,UNIVERSITY OF BUCKINGHAM                ,FC,00000-0000,Private      ,0,1,1,2,13,15
03029400,KEELE UNIVERSITY                        ,FC,00000-0000,Public       ,0,0,0,1,8,9
03029500,NORTHUMBRIA UNIVERSITY                  ,FC,00000-0000,Public       ,1,0,1,5,22,27
03029800,NORGES HANDELSHOYSKOLE                  ,FC,00000-0000,Public       ,0,0,0,0,5,5
03033300,MANCHESTER METROPOLITAN UNIV            ,FC,00000-0000,Public       ,0,1,1,17,27,44
03045000,UNIVERSITY OF EAST LONDON               ,FC,00000-0000,Public       ,0,1,1,13,33,46
03050100,STUDIO ART CENTERS INTERNATIONAL        ,FC,00000-0000,Private      ,2,1,3,22,59,81
03066800,PONTIFICIO ATENEO DELLA SANTA CROCE     ,FC,00000-0000,Private      ,0,2,2,0,11,11
03067200,UNIVERSITY OF SYDNEY                    ,FC,00000-0000,Public       ,1,20,21,32,229,261
03073800,UNIV OF DEBRECEN MED & HEALTH SCI       ,FC,00000-0000,Public       ,0,1,1,3,20,23
03078700,UNIVERSITA COMMERCIALE L BOCCONI        ,FC,00000-0000,Public       ,0,0,0,5,37,42
03080300,SHEFFIELD HALLAM UNIVERSITY             ,FC,00000-0000,Public       ,0,0,0,4,5,9
03084300,UNIVERSITY OF LIMERICK                  ,FC,00000-0000,Public       ,0,0,0,21,25,46
03086900,AMERN GRAD SCHL OF BUS THE INST OF      ,FC,00000-0000,Private      ,0,0,0,0,2,2
03088700,ROYAL SCOTTISH ACAD MUSIC & DRAMA       ,FC,00000-0000,Public       ,0,0,0,13,16,29
03091400,UNIVERSITY OF WOLLONGONG                ,FC,00000-0000,Public       ,1,0,1,10,15,25
03091500,UNIVERSITY OF CANBERRA                  ,FC,00000-0000,Public       ,0,2,2,2,7,9
03091700,KAROL MARCINKOWSKI UNIV OF MED SCI      ,FC,00000-0000,Public       ,0,0,0,8,182,190
03092500,NOTTINGHAM TRENT UNIVERSITY             ,FC,00000-0000,Public       ,0,1,1,5,26,31
03095000,RMIT UNIVERSITY                         ,FC,00000-0000,Public       ,0,3,3,7,36,43
03095400,BOND UNIVERSITY                         ,FC,00000-0000,Private      ,0,3,3,42,77,119
03095900,ESSEC BUSINESS SCHOOL                   ,FC,00000-0000,Private      ,0,0,0,0,17,17
03096100,LA TROBE UNIVERSITY                     ,FC,00000-0000,Public       ,0,4,4,11,39,50
03096900,DEAKIN UNIVERSITY                       ,FC,00000-0000,Public       ,0,2,2,5,11,16
03097100,UNIVERSITY OF WESTERN SYDNEY            ,FC,00000-0000,Public       ,1,0,1,6,7,13
03097300,VICTORIA UNIVERSITY OF TECHNOLOGY       ,FC,00000-0000,Public       ,0,0,0,1,7,8
03097500,CENTRAL QUEENSLAND UNIVERSITY           ,FC,00000-0000,Public       ,0,0,0,2,9,11
03100000,UNIVERSITY OF ADELAIDE (THE)            ,FC,00000-0000,Public       ,0,5,5,4,33,37
03101600,ASIAN INSTITUTE OF MANAGEMENT           ,FC,00000-0000,Private      ,0,0,0,1,4,5
03102500,AMERICAN UNIVERSITY OF ROME             ,FC,00000-0000,Private      ,1,3,4,118,58,176
03102800,ROBERT GORDON UNIVERSITY (THE)          ,FC,00000-0000,Public       ,0,1,1,3,22,25
03104800,GRIFFITH UNIVERSITY                     ,FC,00000-0000,Public       ,2,2,4,24,35,59
03106100,ROSKILDE UNIV ROSKILDE UNIVERSITY C     ,FC,00000-0000,Public       ,0,0,0,2,0,2
03123500,HOGESCHOOL VAN AMSTERDAM                ,FC,00000-0000,Private      ,0,0,0,3,9,12
03136300,AUSTRALIAN CATHOLIC UNIVERSITY          ,FC,00000-0000,Public       ,0,0,0,1,8,9
03137400,CHARLES STURT UNIVERSITY                ,FC,00000-0000,Public       ,0,0,0,0,1,1
03140300,EDITH COWAN UNIVERSITY                  ,FC,00000-0000,Public       ,2,1,3,6,17,23
03140400,NORTHERN TERRITORY UNIVERSITY           ,FC,00000-0000,Public       ,0,1,1,0,4,4
03140500,QUEENSLAND UNIVERSITY OF TECHNOLOGY     ,FC,00000-0000,Public       ,1,1,2,6,35,41
03140600,SOUTHERN CROSS UNIVERSITY               ,FC,00000-0000,Public       ,0,1,1,3,15,18
03140700,SWINBURNE UNIVERSITY OF TECHNOLOGY      ,FC,00000-0000,Public       ,1,3,4,2,12,14
03140900,UNIVERSITY OF BALLARAT                  ,FC,00000-0000,Public       ,0,0,0,0,1,1
03150300,UNIVERSITY OF TASMANIA                  ,FC,00000-0000,Public       ,0,1,1,6,12,18
03274300,"KUNGLIGA TEKNISKA HOGSKOLAN, KTH        ",FC,00000-0000,Public       ,0,0,0,1,16,17
03287300,LIVERPOOL INSTITUTE FOR PERFORMING ARTS ,FC,00000-0000,Public       ,0,0,0,11,12,23
03300300,"2ND SCHOOL OF MEDICINE, CHARLES UNI     ",FC,00000-0000,Public       ,0,1,1,3,9,12
03300400,"FIRST FACULTY OF MEDICINE, CHARLES UNIV.",FC,00000-0000,Public       ,0,0,0,2,38,40
03329300,JOHN CABOT UNIVERSITY                   ,FC,00000-0000,Private      ,2,1,3,99,20,119
03332400,AGRICULTURE UNIVERSITY OF WROCLAW       ,FC,00000-0000,Public       ,0,0,0,1,3,4
03333300,MEDICAL UNIVERSITY SCHOOL OF LUBLIN     ,FC,00000-0000,Public       ,1,27,28,25,208,233
03334300,UNIVERSIDAD NORDESTANA                  ,FC,00000-0000,Private      ,0,3,3,4,30,34
03335300,MEDICAL UNIVERSITY OF SILESIA           ,FC,00000-0000,Public       ,1,6,7,8,123,131
03349400,"QUEEN MARGARET UNIVERSITY COLLEGE, EDINB",FC,00000-0000,Public       ,0,1,1,2,10,12
03350300,BOURNEMOUTH UNIVERSITY                  ,FC,00000-0000,Public       ,0,1,1,6,23,29
03352300,LONDON SOUTH BANK UNIVERSITY            ,FC,00000-0000,Private      ,0,0,0,6,24,30
03363300,THE ARTS EDUCATIONAL SCHOOLS LONDON     ,FC,00000-0000,Private      ,0,0,0,1,0,1
03364300,"FACULTY OF MEDICINE, PALACKY UNIVER     ",FC,00000-0000,Public       ,0,0,0,0,3,3
03365400,AUCKLAND INSTITUTE OF TECHNOLOGY        ,FC,00000-0000,Public       ,0,0,0,7,16,23
03366300,TROPICAL AGRICULTURE RESEARCH AND H     ,FC,00000-0000,Private      ,0,1,1,0,2,2
03377300,"UNIVERSITY OF WALES INSTITUTE, CARD     ",FC,00000-0000,Public       ,0,0,0,4,4,8
03378300,"THE 3RD FACULTY OF MEDICINE, CHARLE     ",FC,00000-0000,Public       ,0,0,0,1,9,10
03386300,CHARLES UNIVERSITY-MEDICAL FACULTY      ,FC,00000-0000,Public       ,0,0,0,1,17,18
03406300,"THE SCHOOL OF PHARMACY, UNIVERSITY      ",FC,00000-0000,Public       ,0,2,2,1,6,7
03418400,NAPIER UNIVERSITY                       ,FC,00000-0000,Public       ,0,0,0,9,13,22
03435300,ANGLIA POLYTECHNIC UNIVERSITY HIGHE     ,FC,00000-0000,Public       ,0,1,1,1,5,6
03456600,ANGELES UNIVERSITY FOUNDATION           ,FC,00000-0000,Private      ,0,0,0,2,0,2
03460300,INTERNATIONALES THEOLOGISCHES INSTI     ,FC,00000-0000,Private      ,1,0,1,3,13,16
03462400,UNIV OF ARTS LONDON - LON COLL OF COMMUN,FC,00000-0000,Public       ,0,2,2,21,38,59
03466300,INSTITUTO CENTROAMERICANO DE ADMINI     ,FC,00000-0000,Private      ,0,0,0,0,7,7
03473300,UNIV OF ARTS LONDON - LON COLL FASHION  ,FC,00000-0000,Public       ,0,2,2,44,58,102
03475300,UNIV OF THE ARTS  LONDON - CHELSEA COLL ,FC,00000-0000,Public       ,0,1,1,8,15,23
03478300,WELSH COLLEGE OF MUSIC AND DRAMA        ,FC,00000-0000,Public       ,0,0,0,0,4,4
03492400,UNIV OF CAMBRIDGE-ST CATHERINE'S CG     ,FC,00000-0000,Public       ,0,0,0,1,4,5
03494400,UNIV OF CAMBRIDGE-SELWYN COLLEGE        ,FC,00000-0000,Public       ,0,0,0,0,6,6
03494500,UNIV OF OXFORD-SAINT BENET'S HALL       ,FC,00000-0000,Public       ,0,1,1,0,1,1
03494600,UNIV OF OXFORD-HARRIS MANCHESTER        ,FC,00000-0000,Public       ,0,0,0,1,5,6
03500300,WIMBLEDON COLLEGE OF ART                ,FC,00000-0000,Public       ,0,0,0,11,7,18
03501400,LEEDS METROPOLITAN UNIVERSITY           ,FC,00000-0000,Public       ,0,0,0,5,16,21
03507300,UNIVERSITY OF SUNDERLAND                ,FC,00000-0000,Public       ,0,0,0,2,14,16
03515300,UNIVERSITY OF CENTRAL LANCASHIRE        ,FC,00000-0000,Public       ,0,0,0,1,14,15
03517300,UNIVERSITY OF BRIGHTON                  ,FC,00000-0000,Public       ,0,0,0,5,24,29
03518300,EUROPEAN GRADUATE SCHOOL                ,FC,00000-0000,Private      ,0,15,15,0,98,98
03526300,INST CENTROAMERICANO DE ADM DE EMP      ,FC,00000-0000,Private      ,0,0,0,1,5,6
03527300,SOFIA UNIVERSITY ST. KLIMENT OHRIDSKI   ,FC,00000-0000,Public       ,0,3,3,2,4,6
03533300,BATH SPA UNIVERSITY                     ,FC,00000-0000,Public       ,1,0,1,7,23,30
03547300,UNIVERSITY OF GLAMORGAN                 ,FC,00000-0000,Public       ,0,0,0,1,7,8
03580300,LIVERPOOL JOHN MOORES UNIVERSITY        ,FC,00000-0000,Public       ,0,0,0,6,9,15
03589400,THE ARTS INSTITUTE AT BOURNEMOUTH       ,FC,00000-0000,Public       ,0,0,0,2,1,3
03594300,GROUP ESC GRENOBLE GRAD SCH OF BUS.     ,FC,00000-0000,Private      ,0,2,2,1,35,36
03597300,JAGIELLONIAN UNIVERSITY                 ,FC,00000-0000,Public       ,0,1,1,2,34,36
03601300,UNIVERSITAT JAUME I DE CASTELLO/UJI     ,FC,00000-0000,Public       ,0,0,0,0,9,9
03603300,LEEDS COLLEGE OF MUSIC                  ,FC,00000-0000,Public       ,0,0,0,1,2,3
03619300,UNIVERSITY OF GREENWICH                 ,FC,00000-0000,Public       ,0,0,0,17,26,43
03653400,UNIVERSIDAD DE IBEROAMERICA - UNIBE     ,FC,00000-0000,Private      ,0,2,2,5,26,31
03674300,UNIVERSITY OF ABERTAY DUNDEE            ,FC,00000-0000,Public       ,0,0,0,3,8,11
03684400,UNIVERSITY OF LINCOLN                   ,FC,00000-0000,Public       ,0,0,0,2,7,9
03684500,MEDICAL UNIVERSITY OF GDANSK            ,FC,00000-0000,Public       ,0,1,1,1,17,18
03684600,POMERANIAN MEDICAL UNIVERSITY           ,FC,00000-0000,Public       ,0,0,0,0,1,1
03685300,UNIVERSITAT POMPEU FABRA                ,FC,00000-0000,Public       ,0,1,1,0,3,3
03697300,NATIONAL FILM & TELEVISION SCHOOL       ,FC,00000-0000,Private      ,0,0,0,0,1,1
03716300,"UNIVERSITY OF WALES, NEWPORT            ",FC,00000-0000,Public       ,0,2,2,2,11,13
03721300,WRITTLE COLLEGE                         ,FC,00000-0000,Public       ,0,0,0,1,1,2
03727400,UNIVERSITY OF WAIKATO (THE)             ,FC,00000-0000,Public       ,0,0,0,6,10,16
03738300,LONDON SCHOOL OF THEOLOGY               ,FC,00000-0000,Private      ,0,5,5,0,5,5
03770300,NAZARENE THEOLOGICAL COLLEGE            ,FC,00000-0000,Private      ,0,1,1,1,9,10
03794400,ANGLO EUROPEAN COLLEGE OF CHIROPRACTIC  ,FC,00000-0000,Private      ,0,1,1,0,1,1
03816400,AMERICAN GRAD SCH OF INTERNTL REL & DIPL,FC,00000-0000,Private      ,0,2,2,5,57,62
03818300,LEIPZIG GRADUATE SCHOOL OF MANAGEMENT   ,FC,00000-0000,Private      ,0,0,0,0,8,8
03824300,"ROYAL VETERINARY COLLEGE (THE), UNIVERSI",FC,00000-0000,Public       ,0,2,2,1,100,101
03850500,MEDICAL UNIVERSITY OF LODZ              ,FC,00000-0000,Public       ,0,3,3,5,71,76
03859400,UNIVERSITY COLLEGE FALMOUTH             ,FC,00000-0000,Public       ,0,0,0,7,10,17
03897400,INTERNATIONAL SPACE UNIVERSITY          ,FC,00000-0000,Private      ,0,0,0,0,5,5
03926400,NATIONAL COLLEGE OF ART AND DESIGN      ,FC,00000-0000,Public       ,0,0,0,5,5,10
03941301,AVE MARIA UNIVERSITY - LATIN AMERICA    ,FC,00000-0000,Private      ,6,1,7,172,48,220
03978300,SPURGEON'S COLLEGE                      ,FC,00000-0000,Private      ,0,0,0,0,1,1
04021400,"AMERICAN COLLEGE, DUBLIN LIMITED (THE)  ",FC,00000-0000,Private      ,0,0,0,5,8,13
04021500,CENTRAL EUROPEAN UNIVERSITY             ,FC,00000-0000,Private      ,0,2,2,0,20,20
04046300,HK UNIVERSITY OF SCI & TECH (HKUST)     ,FC,00000-0000,Public       ,0,1,1,0,1,1
04070300,"RAPHAEL RECANATI INTERNATIONAL SCHOOL, T",FC,00000-0000,Private      ,1,3,4,53,30,83
04085400,NEW ZEALAND COLLEGE OF CHIROPRACTIC     ,FC,00000-0000,Private      ,0,0,0,0,6,6
04116300,EDHEC BUSINESS SCHOOL                   ,FC,00000-0000,Private      ,0,1,1,0,2,2
04121400,ISAPZURICH (INTERNATIONAL SCHOOL OF ANAL,FC,00000-0000,Private      ,0,0,0,0,3,3
00380600,ALDERSON-BROADDUS COLLEGE               ,WV,26416-1051,Private      ,8,7,15,813,346,1159
00380700,MOUNTAIN STATE UNIVERSITY               ,WV,25801-5624,Private      ,57,625,682,1223,6095,7318
00380800,BETHANY COLLEGE                         ,WV,26032-0417,Private      ,16,4,20,1356,67,1423
00380900,BLUEFIELD STATE COLLEGE                 ,WV,24701-2198,Public       ,34,96,130,1295,1551,2846
00381000,CONCORD UNIVERSITY                      ,WV,24712-0000,Public       ,49,24,73,2945,959,3904
00381100,DAVIS & ELKINS COLLEGE                  ,WV,26241-3996,Private      ,14,8,22,587,268,855
00381200,FAIRMONT STATE UNIVERSITY               ,WV,26554-2470,Public       ,75,148,223,4705,3217,7922
00381300,GLENVILLE STATE COLLEGE                 ,WV,26351-1292,Public       ,31,24,55,1337,454,1791
00381500,MARSHALL UNIVERSITY                     ,WV,25755-3300,Public       ,133,232,365,8180,6148,14328
00381600,SOUTHERN WV COMMUNITY COLLEGE           ,WV,25637-2900,Public       ,34,111,145,1159,1272,2431
00381800,UNIVERSITY OF CHARLESTON                ,WV,25304-1099,Private      ,23,21,44,1576,723,2299
00381900,OHIO VALLEY COLLEGE                     ,WV,26105-8000,Private      ,7,24,31,453,202,655
00382000,SALEM INTERNATIONAL UNIVERSITY          ,WV,26426-0500,Proprietary  ,12,100,112,265,554,819
00382200,SHEPHERD UNIVERSITY                     ,WV,25443-3210,Public       ,66,60,126,3189,1172,4361
00382300,WEST LIBERTY STATE COLLEGE              ,WV,26074-0295,Public       ,31,24,55,2553,652,3205
00382600,WEST VIRGINIA STATE UNIVERSITY          ,WV,25112-0000,Public       ,46,117,163,2466,2506,4972
00382700,WEST VIRGINIA UNIVERSITY                ,WV,26506-6201,Public       ,221,198,419,22774,7980,30754
00382711,WEST VIRGINIA UNIVERSITY - POTOMAC STATE,WV,26726-3000,Public       ,21,15,36,1487,353,1840
00382721,WEST VIRGINIA UNIV INST OF TECH         ,WV,25136-2436,Public       ,18,7,25,1300,463,1763
00382800,WEST VIRGINIA UNIV AT PARKERSBURG       ,WV,26101-9577,Public       ,25,147,172,1451,2342,3793
00383000,WEST VIRGINIA WESLEYAN COLLEGE          ,WV,26201-2600,Private      ,19,3,22,1709,164,1873
00383100,WHEELING JESUIT UNIVERSITY              ,WV,26003-6243,Private      ,21,35,56,1175,610,1785
00500700,WEST VIRGINIA JUNIOR COLLEGE            ,WV,26505-5596,Proprietary  ,7,29,36,125,210,335
00500800,MOUNTAIN STATE COLLEGE                  ,WV,26101-3993,Proprietary  ,3,42,45,38,239,277
00754400,APPALACHIAN BIBLE COLLEGE               ,WV,25818-1353,Private      ,3,1,4,235,71,306
00757800,HUNTINGTON SCHOOL OF BEAUTY CULTURE     ,WV,25705-2030,Proprietary  ,3,22,25,39,116,155
00760000,INTERNATIONAL BEAUTY SCHOOL             ,WV,25401-3231,Proprietary  ,7,15,22,32,69,101
00835500,JAMES RUMSEY TECHNICAL INSTITUTE        ,WV,25403-0259,Public       ,3,8,11,57,143,200
00895900,CLARKSBURG BEAUTY ACADEMY               ,WV,26301-2903,Proprietary  ,6,20,26,53,96,149
00904700,HUNTINGTON JUNIOR COLLEGE               ,WV,25701-2004,Proprietary  ,18,175,193,198,1264,1462
00905400,WEST VIRGINIA NORTHERN CMTY COLLEGE     ,WV,26003-0000,Public       ,50,135,185,964,1976,2940
01014000,MINERAL COUNTY VOCATIONAL TECH CTR      ,WV,26726-0000,Public       ,0,2,2,12,36,48
01035600,EVEREST INSTITUTE                       ,WV,25313-1304,Proprietary  ,28,142,170,164,667,831
01057300,WEST VIRGINIA JUNIOR COLLEGE            ,WV,25322-0000,Proprietary  ,18,52,70,168,342,510
01057302,WEST VIRGINIA JUNIOR COLLEGE            ,WV,26330-0000,Proprietary  ,15,40,55,139,275,414
01086100,WEST VIRGINIA BUSINESS COLLEGE          ,WV,26301-0000,Proprietary  ,1,30,31,26,163,189
01124500,WEST VIRGINIA SCH OSTEOPATHIC MED       ,WV,24901-1128,Public       ,0,1,1,9,776,785
01174900,WOOD COUNTY SCH OF PRAC NURSING         ,WV,26101-6424,Public       ,0,0,0,12,40,52
01235900,B M SPURR SCHOOL OF PRAC NURSING        ,WV,26038-1660,Private      ,0,0,0,9,17,26
01257300,WEST VIRGINIA UNIV-HOSP-RAD TECH        ,WV,26506-8062,Private      ,1,2,3,64,37,101
01274300,BENJAMIN FRANKLIN CAREER&TECH           ,WV,25064-0000,Public       ,7,11,18,61,114,175
01290400,MONONGALIA CNTY TECH ED CTR             ,WV,26501-6841,Public       ,1,9,10,37,85,122
01290500,ACADEMY OF CAREERS AND TECHNOLOGY       ,WV,25801-0000,Public       ,0,9,9,68,197,265
02057400,ROANE-JACKSON TECHNICAL CENTER          ,WV,25252-0000,Public       ,2,3,5,16,58,74
02068000,UNITED TECHNICAL CENTER                 ,WV,26301-0000,Public       ,1,8,9,37,107,144
02070100,BECKLEY BEAUTY ACADEMY                  ,WV,25801-0000,Proprietary  ,5,13,18,42,66,108
02073400,CARVER CAREER TECH ED CTR               ,WV,25306-6397,Public       ,16,22,38,123,212,335
02145100,SCOTT COLLEGE OF COSMETOLOGY            ,WV,26003-0000,Proprietary  ,4,12,16,45,50,95
02178200,CHARLESTON SCHOOL OF BEAUTY CULTURE     ,WV,25301-0000,Proprietary  ,6,27,33,30,109,139
02218200,GARNET CAREER CENTER                    ,WV,25301-0000,Public       ,4,27,31,68,256,324
02275300,CABELL COUNTY CAREER TECHNOLOGY CTR     ,WV,25705-0000,Public       ,3,7,10,41,104,145
02524500,RALPH R WILLIS VOCATIONAL CENTER        ,WV,25601-0000,Public       ,1,0,1,12,28,40
02534800,FRED W EBERLE TECHNICAL CENTER          ,WV,26201-0000,Public       ,1,16,17,42,96,138
02535500,MERCER COUNTY TECH EDUC CNTR            ,WV,24740-0000,Public       ,3,10,13,51,131,182
02579900,NORTH CENTRAL OPPORTUNITIES IND CTR     ,WV,26554-2936,Private      ,2,17,19,29,70,99
02609400,VALLEY COLLEGE                          ,WV,25404-5711,Proprietary  ,3,35,38,19,159,178
03052000,MEREDITH MANOR EQUESTRIAN CENTRE        ,WV,26184-9707,Proprietary  ,9,5,14,129,72,201
03076500,FAYETTE INSTITUTE OF TECHNOLOGY         ,WV,25901-2174,Public       ,0,8,8,15,46,61
03084200,VALLEY COLLEGE                          ,WV,24740-3141,Proprietary  ,1,13,14,11,64,75
03084400,VALLEY COLLEGE                          ,WV,25801-2643,Proprietary  ,1,22,23,21,100,121
03098300,PUTNAM CAREER & TECHNICAL CENTER        ,WV,25070-0000,Public       ,0,5,5,23,55,78
03099200,"MOUNTAINEER BEAUTY COLLEGE, INC         ",WV,25177-2917,Proprietary  ,4,4,8,19,54,73
03102100,MORGANTOWN BEAUTY COLLEGE               ,WV,26505-5430,Proprietary  ,3,9,12,53,79,132
03123200,STANLEY TECHNICAL INSTITUTE             ,WV,26505-3751,Private      ,1,7,8,10,58,68
03327500,SOUTH BRANCH VOCATIONAL TECH CENTER     ,WV,26847-1698,Public       ,0,2,2,9,17,26
03734300,JOHN D. ROCKEFELLER IV CAREER CENTER    ,WV,26047-9424,Public       ,0,1,1,6,25,31
03819300,AMERICAN PUBLIC UNIVERSITY SYSTEM       ,WV,25414-1621,Proprietary  ,36,1226,1262,202,7876,8078
03957300,BLUE RIDGE COMMUNITY AND TECHNICAL COLLE,WV,25401-3244,Public       ,28,83,111,458,889,1347
03960300,NEW RIVER COMMUNITY AND TECHNICAL COLLEG,WV,25801-2636,Public       ,46,206,252,863,1700,2563
04028300,MOUNTAIN STATE SCHOOL OF MASSAGE        ,WV,25304-2025,Proprietary  ,1,9,10,19,49,68
04038500,PIERPONT COMMUNITY & TECHNICAL COLLEGE  ,WV,26554-2451,Public       ,12,47,59,503,519,1022
04038600,WEST VIRGINIA STATE COMMUNITY AND TECHNI,WV,25112-1000,Public       ,20,40,60,501,960,1461
04041400,MARSHALL COMMUNITY AND TECHNICAL COLLEGE,WV,25755-3300,Public       ,36,104,140,729,1014,1743
04047300,COMM AND TECH COLLEGE AT WVU TECH       ,WV,25136-2437,Public       ,16,19,35,303,230,533
00106100,ALASKA PACIFIC UNIVERSITY               ,AK,99508-4672,Private      ,8,36,44,629,572,1201
00106300,UNIVERSITY OF ALASKA FAIRBANKS          ,AK,99775-7500,Public       ,86,210,296,2281,2777,5058
00106500,UNIVERSITY OF ALASKA SOUTHEAST          ,AK,99801-8680,Public       ,20,72,92,492,968,1460
00884300,ALASKA BIBLE COLLEGE                    ,AK,99588-0000,Private      ,0,1,1,17,16,33
01146200,UNIVERSITY OF ALASKA  ANCHORAGE         ,AK,99514-1608,Public       ,175,367,542,4646,6231,10877
02541000,CAREER ACADEMY                          ,AK,99507-0000,Proprietary  ,22,100,122,102,498,600
02576900,CHARTER COLLEGE                         ,AK,99508-0000,Proprietary  ,58,289,347,249,1412,1661
03160300,ALASKA VOCATIONAL TECHNICAL CENTER      ,AK,99664-0889,Public       ,3,16,19,155,221,376
03461300,ILISAGVIK COLLEGE                       ,AK,99723-0749,Public       ,8,9,17,17,53,70
04138600,ALASKA CHRISTIAN COLLEGE                ,AK,99669-9755,Private      ,1,0,1,14,2,16
00108500,UNIV ARKANSAS MONTICELLO                ,AR,71656-0000,Public       ,50,95,145,1880,1930,3810
00108501,GREAT RIVERS TECHNICAL INSTITUTE        ,AR,71654-0000,Public       ,0,0,0,2,9,11
00108502,FOREST ECHOES TECHNICAL INSTITUTE       ,AR,71635-0000,Public       ,0,0,0,5,8,13
00108600,UNIV OF ARKANSAS AT PINE BLUFF          ,AR,71601-2790,Public       ,68,78,146,3660,1796,5456
00108700,ARKANSAS BAPTIST COLLEGE                ,AR,72202-6099,Private      ,23,31,54,583,657,1240
00108800,LYON COLLEGE                            ,AR,72501-3699,Private      ,13,5,18,661,94,755
00108900,ARKANSAS TECH UNIVERSITY                ,AR,72801-2222,Public       ,100,112,212,4402,3190,7592
00109000,ARKANSAS STATE UNIVERSITY               ,AR,72467-0000,Public       ,200,392,592,7058,7952,15010
00109006,DELTA TECHNICAL INSTITUTE               ,AR,72365-9558,Public       ,3,5,8,40,80,120
00109100,ARKANSAS STATE UNIVERSITY - BEEBE       ,AR,72012-1000,Public       ,36,111,147,1522,2555,4077
00109200,UNIVERSITY OF CENTRAL ARKANSAS          ,AR,72035-0001,Public       ,139,152,291,7523,4180,11703
00109300,CENTRAL BAPTIST COLLEGE                 ,AR,72034-6470,Private      ,7,22,29,371,283,654
00109400,UNIVERSITY OF THE OZARKS                ,AR,72830-2880,Private      ,9,8,17,619,121,740
00109500,CROWLEYS RIDGE COLLEGE                  ,AR,72450-9775,Private      ,3,1,4,140,51,191
00109700,HARDING UNIVERSITY                      ,AR,72149-0001,Private      ,48,77,125,3212,1512,4724
00109800,HENDERSON STATE UNIVERSITY              ,AR,71999-0001,Public       ,70,95,165,2963,1621,4584
00109900,HENDRIX COLLEGE                         ,AR,72032-3080,Private      ,20,0,20,1891,74,1965
00110000,JOHN BROWN UNIVERSITY                   ,AR,72761-2747,Private      ,12,59,71,1232,1060,2292
00110100,UNIV ARKANSAS LITTLE ROCK               ,AR,72204-1099,Public       ,108,314,422,4092,9021,13113
00110200,OUACHITA BAPTIST UNIVERSITY             ,AR,71998-0001,Private      ,21,4,25,1423,148,1571
00110300,PHILANDER SMITH COLLEGE                 ,AR,72202-3718,Private      ,15,25,40,681,572,1253
00110400,PHILLIPS COUNTY COMMUNITY COLLEGE       ,AR,72342-0000,Public       ,40,93,133,449,1051,1500
00110401,RICE BELT TECH INST                     ,AR,72042-0000,Public       ,1,1,2,6,6,12
00110600,WILLIAMS BAPTIST COLLEGE                ,AR,72476-4661,Private      ,8,1,9,506,153,659
00110700,SOUTHERN ARKANSAS UNIVERSITY            ,AR,71754-0000,Public       ,49,54,103,2022,1555,3577
00110800,UNIV ARKANSAS FAYETTEVILLE              ,AR,72701-0000,Public       ,195,181,376,9388,5341,14729
00110900,UNIV OF ARKANSAS FOR MEDCL SCIENCES     ,AR,72205-7102,Public       ,8,37,45,407,1715,2122
00110901,UNIV OF ARKANSAS COLG OF MEDICINE       ,AR,72205-0000,Public       ,1,7,8,42,627,669
00111000,UNIVERSITY OF ARKANSAS-FORT SMITH       ,AR,72904-7397,Public       ,79,235,314,3218,3862,7080
00524500,U OF A COMM COLLEGE AT MORRILTON        ,AR,72110-9601,Public       ,23,60,83,954,1526,2480
00570700,SEARK COLLEGE                           ,AR,71603-0000,Public       ,37,160,197,664,2048,2712
00573200,UNIV AR COMMUNITY COLLEGE AT HOPE       ,AR,71801-0000,Public       ,51,144,195,447,1069,1516
00704400,CROWLEYS RIDGE TECHNICAL INSTITUTE      ,AR,72336-0000,Public       ,4,26,30,96,272,368
00773800,SOUTHERN ARKANSAS UNIVERSITY TECH       ,AR,71701-1900,Public       ,10,37,47,367,644,1011
00792100,FAYETTEVILLE BEAUTY COLLEGE             ,AR,72701-0000,Proprietary  ,6,9,15,46,88,134
00997600,OUACHITA TECHNICAL COLLEGE              ,AR,72104-0816,Public       ,15,40,55,329,858,1187
01074100,MELLIE'S BEAUTY COLLEGE                 ,AR,72901-3886,Proprietary  ,4,16,20,53,140,193
01210500,NATIONAL PARK COMMUNITY COLLEGE         ,AR,71913-9174,Public       ,40,144,184,924,2159,3083
01226000,EAST ARKANSAS COMMUNITY COLLEGE         ,AR,72335-2204,Public       ,32,63,95,495,835,1330
01226100,NORTH ARKANSAS COLLEGE                  ,AR,72601-5508,Public       ,23,72,95,862,1607,2469
01286000,ARKANSAS NORTHEASTERN COLLEGE           ,AR,72316-1109,Public       ,31,158,189,665,1562,2227
02052200,BLACK RIVER TECHNICAL COLLEGE           ,AR,72455-0000,Public       ,25,85,110,657,1534,2191
02073500,UNIV OF AR CMNTY CLG-BATESVILLE         ,AR,72503-0000,Public       ,19,106,125,425,1242,1667
02073700,NORTHWEST TECHNICAL INSTITUTE           ,AR,72765-0000,Public       ,4,21,25,122,310,432
02074600,SOUTH ARKANSAS COMMUNITY COLLEGE        ,AR,71731-0000,Public       ,19,73,92,462,1332,1794
02075300,PULASKI TECHNICAL COLLEGE               ,AR,72118-0000,Public       ,110,464,574,2626,9909,12535
02087000,OZARKA COLLEGE                          ,AR,72556-0000,Public       ,18,51,69,311,978,1289
02111100,RICH MOUNTAIN COMMUNITY COLLEGE         ,AR,71953-0000,Public       ,18,45,63,374,554,928
02202400,PROFESSIONAL COSMETOLOGY EDUC CTR       ,AR,71730-5828,Proprietary  ,0,3,3,19,48,67
02220900,COSSATOT COMMUNITY COLLEGE              ,AR,71832-0000,Public       ,13,74,87,392,964,1356
02260400,BEE JAY'S HAIRSTYLING ACADEMY           ,AR,72212-0000,Proprietary  ,3,5,8,17,53,70
02260401,BEE JAY'S HAIRSTYLING ACADEMY - BATESVIL,AR,72501-6709,Proprietary  ,0,4,4,1,13,14
02272400,EASTERN COLLEGE OF HEALTH VOCATIONS     ,AR,72209-0000,Proprietary  ,36,136,172,176,737,913
02284200,NEW TYLER BARBER COLLEGE INC            ,AR,72114-0000,Proprietary  ,6,14,20,27,95,122
02287400,MARSHA KAY BEAUTY COLLEGE               ,AR,72653-0000,Proprietary  ,3,9,12,10,34,44
02321701,ITT TECHNICAL INSTITUTE                 ,AR,72204-9925,Proprietary  ,56,138,194,333,833,1166
02330800,JEFFERSON SCHOOL OF NURSING             ,AR,71603-0000,Private      ,2,4,6,32,93,125
02339800,SOUTHERN INSTITUTE OF COSMETOLOGY       ,AR,72301-0000,Proprietary  ,4,22,26,17,67,84
02341700,CAREER ACADEMY OF HAIR DESIGN           ,AR,72764-4304,Proprietary  ,6,28,34,72,172,244
02348200,MID-SOUTH COMMUNITY COLLEGE             ,AR,72301-0000,Public       ,52,173,225,620,1577,2197
02363500,ARTHUR'S BEAUTY COLLEGE                 ,AR,72901-0000,Proprietary  ,2,8,10,23,77,100
02525800,LEE'S SCHOOL OF COSMETOLOGY             ,AR,72114-0000,Proprietary  ,4,6,10,32,62,94
02538500,ARTHUR'S BEAUTY COLLEGE                 ,AR,72076-0000,Proprietary  ,6,33,39,83,219,302
02569600,SEARCY BEAUTY COLLEGE                   ,AR,72143-0000,Proprietary  ,0,11,11,22,63,85
03005100,ARKANSAS BEAUTY SCHOOL                  ,AR,72209-5116,Proprietary  ,1,12,13,33,99,132
03007100,HOT SPRINGS BEAUTY COLLEGE              ,AR,71901-5432,Proprietary  ,0,11,11,31,80,111
03007600,ARKANSAS BEAUTY SCHOOL-CONWAY           ,AR,72032-4354,Proprietary  ,9,10,19,34,68,102
03023400,ARKANSAS COLLEGE OF BARBERING           ,AR,72114-5615,Proprietary  ,4,38,42,39,173,212
03030903,DIESEL DRIVING ACADEMY - LITTLE ROCK    ,AR,72117-9624,Proprietary  ,0,0,0,1,4,5
03063300,NORTHWEST ARKANSAS COMMUNITY COLLEG     ,AR,72712-5190,Public       ,83,209,292,1904,3653,5557
03065100,ABC BEAUTY COLLEGE                      ,AR,71923-4206,Proprietary  ,4,14,18,26,69,95
03066302,BRYAN COLLEGE -                         ,AR,72756-1825,Proprietary  ,14,52,66,61,244,305
03105200,BAPTIST HEALTH SCHOOLS LITTLE ROCK      ,AR,72210-0000,Private      ,8,33,41,341,1230,1571
03116800,"DELUXE BEAUTY SCHOOL, L.L.C.            ",AR,71603-0000,Proprietary  ,0,1,1,15,23,38
03124900,IMAGINE -  PAUL MITCHELL PARTNER SCHOOL ,AR,72117-2516,Proprietary  ,12,19,31,71,106,177
03127200,ASKINS VO-TECH                          ,AR,72908-8028,Proprietary  ,2,11,13,3,35,38
03212300,BLYTHEVILLE ACADEMY OF COSMETOLOGY      ,AR,72315-3424,Proprietary  ,0,0,0,5,33,38
03214300,VELVATEX COLLEGE OF BEAUTY CULTURE      ,AR,72202-5452,Proprietary  ,0,1,1,6,38,44
03254300,MARGARET'S HAIR ACADEMY                 ,AR,71655-4905,Proprietary  ,3,22,25,20,75,95
03519400,LYNNDALE FUNDAMENTALS OF BEAUTY SCH     ,AR,71730-4804,Proprietary  ,2,3,5,13,42,55
03855300,ECCLESIA COLLEGE                        ,AR,72762-8159,Private      ,2,2,4,69,29,98
03912300,CROSSETT SCHOOL OF COSMETOLOGY          ,AR,71635-0000,Proprietary  ,1,6,7,19,27,46
03997300,ARKANSAS BEAUTY COLLEGE                 ,AR,72801-3741,Proprietary  ,3,11,14,16,56,72
00133900,CORBAN COLLEGE                          ,OR,97301-9392,Private      ,11,28,39,1095,443,1538
00316505,CASCADE COLLEGE                         ,OR,97216-0000,Private      ,3,6,9,339,138,477
00318600,BLUE MOUNTAIN COMMUNITY COLLEGE         ,OR,97801-0000,Public       ,44,175,219,870,1507,2377
00318800,CENTRAL OREGON COMMUNITY COLLEGE        ,OR,97701-5998,Public       ,179,569,748,2249,3897,6146
00318900,CLATSOP COMMUNITY COLLEGE               ,OR,97103-3698,Public       ,27,78,105,376,581,957
00319100,CONCORDIA UNIVERSITY                    ,OR,97211-6099,Private      ,12,117,129,1122,1445,2567
00319300,EASTERN OREGON UNIVERSITY               ,OR,97850-2899,Public       ,53,133,186,1949,2369,4318
00319400,GEORGE FOX UNIVERSITY                   ,OR,97132-2697,Private      ,24,95,119,2342,1898,4240
00319600,LANE COMMUNITY COLLEGE                  ,OR,97405-0640,Public       ,342,1088,1430,4924,9102,14026
00319700,LEWIS & CLARK COLLEGE                   ,OR,97219-7899,Private      ,32,43,75,4302,3124,7426
00319800,LINFIELD COLLEGE                        ,OR,97128-6894,Private      ,26,34,60,2796,595,3391
00319801,LINFIELD COLLEGE - PORTLAND CAMPUS      ,OR,97210-0000,Private      ,5,21,26,298,644,942
00319900,MARYLHURST UNIVERSITY                   ,OR,97036-7036,Private      ,6,152,158,166,1720,1886
00320300,MOUNT ANGEL SEMINARY                    ,OR,97373-0505,Private      ,0,0,0,15,19,34
00320400,MOUNT HOOD COMMUNITY COLLEGE            ,OR,97030-3300,Public       ,207,502,709,3235,5062,8297
00320600,MULTNOMAH BIBLE COLLEGE/SEMINARY        ,OR,97220-5898,Private      ,6,30,36,548,651,1199
00320700,PACIFIC NORTHWEST COLLEGE OF ART        ,OR,97209-3023,Private      ,12,13,25,600,450,1050
00320800,NORTHWEST CHRISTIAN UNIVERSITY          ,OR,97401-3727,Private      ,12,16,28,559,537,1096
00320900,WESTERN OREGON UNIVERSITY               ,OR,97361-1394,Public       ,89,82,171,5058,1986,7044
00321000,OREGON STATE UNIVERSITY                 ,OR,97331-8507,Public       ,345,349,694,16260,7577,23837
00321100,OREGON INSTITUTE OF TECHNOLOGY          ,OR,97601-8801,Public       ,39,85,124,1859,1619,3478
00321200,PACIFIC UNIVERSITY                      ,OR,97116-1797,Private      ,43,69,112,2495,2715,5210
00321300,PORTLAND COMMUNITY COLLEGE              ,OR,97219-7198,Public       ,641,2259,2900,8437,19197,27634
00321600,PORTLAND STATE UNIVERSITY               ,OR,97207-0000,Public       ,369,908,1277,11330,17468,28798
00321700,REED COLLEGE                            ,OR,97202-8199,Private      ,21,14,35,2702,297,2999
00321800,CHEMEKETA COMMUNITY COLLEGE             ,OR,97309-1500,Public       ,271,895,1166,3892,8517,12409
00321900,SOUTHERN OREGON UNIVERSITY              ,OR,97520-5010,Public       ,105,188,293,4247,2579,6826
00322000,SOUTHWESTERN OREGON COMMUNITY CLG       ,OR,97420-2956,Public       ,54,104,158,1342,1291,2633
00322100,TREASURE VALLEY COMMUNITY COLLEGE       ,OR,97914-3423,Public       ,64,225,289,1296,2047,3343
00322200,UMPQUA COMMUNITY COLLEGE                ,OR,97470-0226,Public       ,84,321,405,1110,2433,3543
00322300,UNIVERSITY OF OREGON                    ,OR,97403-1226,Public       ,343,300,643,17892,8839,26731
00322400,UNIVERSITY OF PORTLAND                  ,OR,97203-5798,Private      ,73,54,127,6513,1478,7991
00322500,WARNER PACIFIC COLLEGE                  ,OR,97215-4099,Private      ,19,151,170,592,1254,1846
00322700,WILLAMETTE UNIVERSITY                   ,OR,97301-3930,Private      ,32,23,55,3483,1488,4971
00487800,CLACKAMAS COMMUNITY COLLEGE             ,OR,97045-7998,Public       ,164,424,588,2350,3326,5676
00488200,OREGON HEALTH & SCIENCE UNIVERSITY      ,OR,97239-0000,Public       ,13,56,69,381,2933,3314
00488230,OREGON GRAD INST OF SCIENCE & TECH      ,OR,97006-0000,Public       ,1,0,1,9,31,40
00693800,LINN BENTON COMMUNITY COLLEGE           ,OR,97321-3774,Public       ,154,371,525,2958,3744,6702
00717800,WESTERN SEMINARY                        ,OR,97215-0000,Private      ,0,21,21,5,311,316
00723402,HEALD COLLEGE - PORTLAND                ,OR,97205-3432,Proprietary  ,49,193,242,250,855,1105
00781900,ART INSTITUTE OF PORTLAND (THE)         ,OR,97209-2911,Proprietary  ,58,114,172,1646,1501,3147
00888700,CONCORDE CAREER INSTITUTE               ,OR,97232-2242,Proprietary  ,46,187,233,321,1056,1377
00907900,EVEREST COLLEGE                         ,OR,97204-2296,Proprietary  ,30,201,231,235,1041,1276
00958100,SPRINGFIELD COLLEGE OF BEAUTY           ,OR,97477-5474,Proprietary  ,5,9,14,68,138,206
01012200,PHAGANS' MEDFORD BEAUTY SCHOOL          ,OR,97504-5297,Proprietary  ,2,27,29,61,146,207
01018200,ROGUE COMMUNITY COLLEGE                 ,OR,97527-0000,Public       ,179,645,824,1985,4470,6455
01050700,ACADEMY OF HAIR DESIGN                  ,OR,97301-3526,Proprietary  ,12,19,31,56,104,160
01185200,ITT TECHNICAL INSTITUTE                 ,OR,97220-0000,Proprietary  ,96,254,350,703,1431,2134
01230900,WESTERN STATES CHIROPRACTIC COLLEGE     ,OR,97230-3099,Private      ,3,14,17,26,490,516
01234700,PHAGANS CENTRAL OREGON BEAUTY CLG       ,OR,97701-5175,Proprietary  ,16,41,57,70,207,277
01234800,PHAGANS BEAUTY COLLEGE                  ,OR,97333-4716,Proprietary  ,5,10,15,63,81,144
01235000,PHAGANS SCHOOL OF HAIR DESIGN           ,OR,97267-4808,Proprietary  ,2,22,24,44,102,146
01235100,PHAGANS SCHOOL OF BEAUTY                ,OR,97301-4732,Proprietary  ,4,19,23,50,124,174
01300800,PHAGANS TIGARD BEAUTY SCHOOL            ,OR,97223-0000,Proprietary  ,2,3,5,25,72,97
02101000,NORTHWEST COLLEGE OF HAIR DESIGN        ,OR,97086-7702,Proprietary  ,20,41,61,108,200,308
02101002,NORTHWEST COLLEGE                       ,OR,97007-3954,Proprietary  ,1,3,4,10,18,28
02104900,COLLEGE OF LEGAL ARTS                   ,OR,97219-9998,Proprietary  ,6,42,48,43,273,316
02106100,COLLEGE OF COSMETOLOGY                  ,OR,97601-0000,Proprietary  ,6,15,21,32,88,120
02154400,BEAU MONDE CLG OF HAIR DESIGN           ,OR,97205-0000,Proprietary  ,18,38,56,106,194,300
02159700,EUGENE BIBLE COLLEGE                    ,OR,97405-0000,Private      ,7,6,13,91,109,200
02201900,PHAGANS' SCHOOL OF HAIR DESIGN          ,OR,97232-0000,Proprietary  ,10,38,48,126,269,395
02239203,ALLIED COLLEGE - ANTHEM COLLEGE         ,OR,97005-0000,Proprietary  ,2,14,16,40,88,128
02330100,PIONEER PACIFIC COLLEGE                 ,OR,97070-0000,Proprietary  ,52,233,285,360,1157,1517
02330102,PIONEER PACIFIC COLLEGE                 ,OR,97403-0000,Proprietary  ,19,167,186,141,826,967
02337900,COLLEGE OF HAIR DESIGN CAREERS          ,OR,97301-0000,Proprietary  ,6,21,27,67,89,156
02344100,ROSEBURG BEAUTY COLLEGE                 ,OR,97470-0000,Proprietary  ,2,7,9,32,82,114
02534000,NATIONAL COLLEGE OF NATURAL MEDICINE    ,OR,97201-0000,Private      ,1,9,10,12,610,622
02578800,NORTHWEST NANNIES INSTITUTE             ,OR,97035-0000,Proprietary  ,2,3,5,32,20,52
02603700,OREGON COL OF ORIENTAL MEDICINE         ,OR,97216-0000,Private      ,0,5,5,5,348,353
02617506,EVEREST COLLEGE - EVEREST INSTITUTE     ,OR,97223-6581,Proprietary  ,18,77,95,87,291,378
03007300,OREGON COLLEGE OF ART & CRAFT           ,OR,97225-6399,Private      ,3,10,13,103,230,333
03022600,WESTERN CULINARY INSTITUTE              ,OR,97205-2793,Proprietary  ,143,388,531,1786,2345,4131
03042500,APOLLO COLLEGE                          ,OR,97232-1302,Proprietary  ,105,391,496,517,1932,2449
03074400,PHAGANS NEWPORT ACAD CSMTLGY CAREER     ,OR,97365-4963,Proprietary  ,3,12,15,33,68,101
03074500,EAST-WEST COLLEGE OF THE HEALING ARTS   ,OR,97232-2765,Proprietary  ,9,42,51,102,393,495
03185300,PHAGANS GRANTS PASS COLLEGE OF BTY      ,OR,97527-3039,Proprietary  ,3,15,18,49,96,145
03428300,KLAMATH COMMUNITY COLLEGE               ,OR,97603-7121,Public       ,47,165,212,406,1133,1539
03642300,VALLEY MEDICAL COLLEGE                  ,OR,97305-1373,Proprietary  ,8,30,38,42,205,247
03668300,BIRTHINGWAY COLLEGE OF MIDWIFERY        ,OR,97266-4042,Private      ,0,11,11,16,120,136
03783400,ABDILL CAREER COLLEGE                   ,OR,97504-7137,Proprietary  ,8,34,42,33,181,214
00137400,ALBERTUS MAGNUS COLLEGE                 ,CT,06511-1189,Private      ,19,74,93,810,1075,1885
00137403,ALBERTUS MAGNUS CLG-NEW DIMENSIONS      ,CT,06511-0000,Private      ,1,91,92,48,860,908
00137800,CENTRAL CONNECTICUT STATE UNIV          ,CT,06050-2490,Public       ,142,158,300,8602,3671,12273
00137900,CONNECTICUT COLLEGE                     ,CT,06320-4196,Private      ,14,0,14,2585,67,2652
00138000,WESTERN CONNECTICUT STATE UNIV          ,CT,06810-6826,Public       ,102,59,161,5012,1302,6314
00138500,FAIRFIELD UNIVERSITY                    ,CT,06430-0000,Private      ,58,48,106,6255,789,7044
00138700,HARTFORD SEMINARY                       ,CT,06105-0000,Private      ,0,1,1,10,25,35
00138900,HOLY APOSTLES COLLEGE & SEMINARY        ,CT,06416-2005,Private      ,0,7,7,9,55,64
00139200,MANCHESTER COMMUNITY COLLEGE            ,CT,06045-1046,Public       ,85,135,220,2707,2459,5166
00139300,MITCHELL COLLEGE                        ,CT,06320-4498,Private      ,16,2,18,1012,187,1199
00139700,UNIVERSITY OF NEW HAVEN                 ,CT,06516-1999,Private      ,108,96,204,5459,1644,7103
00139800,NORTHWESTERN CT COMMUNITY COLLEGE       ,CT,06098-1747,Public       ,20,21,41,480,460,940
00139900,NORWALK COMMUNITY TECHNICAL COLLEGE     ,CT,06854-1655,Public       ,82,99,181,1586,1832,3418
00140100,POST UNIVERSITY                         ,CT,06723-3240,Proprietary  ,38,209,247,1044,1324,2368
00140200,QUINNIPIAC UNIVERSITY                   ,CT,06518-1908,Private      ,78,57,135,12216,1355,13571
00140201,QUINNIPIAC UNIVERSITY SCHOOL OF LAW     ,CT,06518-0000,Private      ,3,5,8,128,1094,1222
00140300,SACRED HEART UNIVERSITY                 ,CT,06825-1000,Private      ,64,69,133,6890,1346,8236
00140600,SOUTHERN CONNECTICUT STATE UNIV         ,CT,06515-1355,Public       ,127,154,281,8781,4440,13221
00140900,SAINT JOSEPH COLLEGE                    ,CT,06117-2791,Private      ,11,46,57,1156,987,2143
00141400,TRINITY COLLEGE                         ,CT,06106-3100,Private      ,35,10,45,2818,233,3051
00141600,UNIVERSITY OF BRIDGEPORT                ,CT,06601-5650,Private      ,76,111,187,2203,2328,4531
00141700,UNIVERSITY OF CONNECTICUT-STORRS        ,CT,06269-2151,Public       ,229,188,417,23901,5028,28929
00141702,UNIV CONN STAMFORD                      ,CT,06901-0000,Public       ,7,11,18,405,231,636
00141703,UNIV OF CONNECTICUT - TORINGTON         ,CT,06790-0000,Public       ,2,2,4,164,62,226
00141706,UNIV OF CONNECTICUT SCH LAW             ,CT,06105-0000,Public       ,0,8,8,28,1152,1180
00141707,UNIV OF CT - SCH OF SOCIAL WORK         ,CT,06117-0000,Public       ,3,7,10,68,476,544
00141708,UNIVERSITY OF CONNECTICUT - SCHOOL OF ME,CT,06030-1920,Public       ,2,4,6,14,480,494
00141709,UNIVERSITY OF CONNECTICUT - SCHOOL OF DE,CT,06030-1920,Public       ,0,1,1,5,183,188
00142200,UNIVERSITY OF HARTFORD                  ,CT,06117-1599,Private      ,130,62,192,9495,1544,11039
00142400,WESLEYAN UNIVERSITY                     ,CT,06459-3208,Private      ,37,5,42,4415,154,4569
00142500,EASTERN CONNECTICUT STATE UNIV          ,CT,06226-2295,Public       ,79,51,130,4973,1177,6150
00142600,YALE UNIVERSITY                         ,CT,06520-8288,Private      ,116,59,175,13827,6426,20253
00142601,YALE UNIV PHYSICIANS ASSOC PROG         ,CT,06510-0000,Private      ,1,1,2,4,88,92
00142602,YALE UNIV EPIDEMIOLOGY & PUB HLTH       ,CT,06510-0000,Private      ,0,0,0,6,278,284
00142603,YALE UNIV SCHOOL MEDICINE               ,CT,06510-0000,Private      ,2,4,6,36,808,844
00280301,RENSSELAER POLYTECHNIC INSTITUTE-RENSSEL,CT,06120-2991,Private      ,0,13,13,14,94,108
00451300,HOUSATONIC COMMUNITY COLLEGE            ,CT,06604-4704,Public       ,86,158,244,2060,3127,5187
00618100,BRIDGEPORT HOSP SCHL OF NURSING         ,CT,06610-2896,Private      ,3,11,14,75,261,336
00619100,ST. VINCENT'S COLLEGE                   ,CT,06606-9966,Private      ,5,26,31,217,497,714
00698200,NAUGATUCK VALLEY COMM-TECH COLG         ,CT,06708-3089,Public       ,100,147,247,2210,2350,4560
00730000,ELI WHITNEY TECHNICAL HIGH SCHOOL       ,CT,06514-0000,Public       ,0,4,4,19,81,100
00730300,LINCOLN TECHNICAL INSTITUTE             ,CT,06051-0000,Proprietary  ,137,423,560,1034,2109,3143
00730500,PORTER AND CHESTER INSTITUTE OF BRANFORD,CT,06405-4022,Proprietary  ,32,40,72,245,285,530
00731100,WINDHAM TECHNICAL HIGH SCHOOL           ,CT,06226-2100,Public       ,0,0,0,10,32,42
00745900,PAIER COLLEGE OF ART                    ,CT,06514-3902,Proprietary  ,6,3,9,163,53,216
00763500,CAPITAL COMMUNITY COLLEGE               ,CT,06103-1207,Public       ,57,156,213,1539,3451,4990
00803700,GATEWAY COMMUNITY-TECHNICAL COLLEGE     ,CT,06511-0000,Public       ,100,171,271,2294,3375,5669
00803800,MIDDLESEX COMMUNITY CLG                 ,CT,06457-4889,Public       ,40,63,103,923,1092,2015
00887200,RENASCI ACADEMY OF HAIR                 ,CT,06460-4160,Proprietary  ,2,4,6,13,25,38
00887300,PAUL MITCHELL THE SCHOOL                ,CT,06810-6716,Proprietary  ,7,11,18,80,67,147
00887400,BRIO ACADEMY OF COSMETOLOGY             ,CT,06450-4836,Proprietary  ,21,65,86,148,328,476
00887403,BRIO ACADEMY OF COSMETOLOGY - WILLIMANTI,CT,06226-1940,Proprietary  ,0,0,0,8,9,17
00906500,THE HARTFORD CONSERVATORY               ,CT,06105-2891,Private      ,1,2,3,49,19,68
00927700,E C GOODWIN TECHNICAL HIGH SCHOOL       ,CT,06053-0000,Public       ,1,0,1,19,39,58
00929100,J M WRIGHT TECHNICAL HIGH SCHOOL        ,CT,06904-0000,Public       ,0,0,0,11,21,32
00940700,BRIARWOOD COLLEGE                       ,CT,06489-1057,Proprietary  ,24,28,52,592,427,1019
00976400,TUNXIS COMMUNITY COLLEGE                ,CT,06032-3187,Public       ,64,92,156,1309,1558,2867
00976500,THREE RIVERS COMMUNITY TECH COLLEGE     ,CT,06360-0000,Public       ,70,137,207,1236,1942,3178
00982200,ALBERT I PRINCE TECHNICAL HIGH SCHOOL   ,CT,06106-3799,Public       ,0,0,0,14,49,63
01041700,BRIO ACADEMY OF EAST HARTFORD           ,CT,06108-2220,Proprietary  ,10,25,35,72,160,232
01053000,QUINEBAUG VALLEY COMMUNITY COLLEGE      ,CT,06239-1440,Public       ,33,61,94,683,1060,1743
01077900,PORTER AND CHESTER INSTITUTE-ALLCAMPUSES,CT,06615-7158,Proprietary  ,186,402,588,1295,2058,3353
01115000,ASNUNTUCK COMMUNITY COLLEGE             ,CT,06082-3800,Public       ,21,47,68,412,564,976
01149600,BULLARD HAVENS VOC TECH SCHOOL          ,CT,06610-3499,Public       ,0,6,6,9,78,87
01169700,VINAL REGIONAL VOC TECH SCHOOL          ,CT,06457-4918,Public       ,0,2,2,15,41,56
01184300,NORWICH TECHNICAL HIGH SCHOOL           ,CT,06360-7097,Public       ,0,0,0,8,36,44
01218500,H C WILCOX TECHNICAL HIGH SCHOOL        ,CT,06450-0000,Public       ,0,0,0,9,12,21
01242500,STONE ACADEMY                           ,CT,06514-4125,Proprietary  ,29,207,236,247,1350,1597
01242503,STONE ACADEMY -WATERBURY                ,CT,06705-3823,Proprietary  ,1,10,11,16,43,59
01242504,STONE ACADEMY -  EAST HARTFORD          ,CT,06118-0000,Proprietary  ,1,2,3,1,2,3
01287700,GIBBS COLLEGE                           ,CT,06855-1436,Proprietary  ,7,11,18,225,336,561
01291300,LEON INSTITUTE OF HAIR DESIGN           ,CT,06604-4226,Proprietary  ,1,16,17,15,66,81
01326400,HENRY ABBOTT TECHNICAL HIGH SCHOOL      ,CT,06811-4881,Public       ,1,2,3,10,37,47
02058900,HARVARD H ELLIS TECHNICAL HIGH SCHOOL   ,CT,06239-0000,Public       ,0,0,0,14,12,26
02074000,BRANFORD HALL CAREER INSTITUTE          ,CT,06405-0000,Proprietary  ,241,1069,1310,1094,4643,5737
02106600,FOX INSTITUTE OF BUSINESS               ,CT,06110-0000,Proprietary  ,23,95,118,120,406,526
02112300,RIDLEY LOWELL BUSINESS & TECH INST      ,CT,06320-0000,Proprietary  ,27,166,193,120,700,820
02112700,NORTH HAVEN ACADEMY                     ,CT,06473-3108,Proprietary  ,36,26,62,159,98,257
02115100,BUTLER BUSINESS SCHOOL                  ,CT,06604-0000,Proprietary  ,15,63,78,74,361,435
02148700,CONNECTICUT INST OF HAIR DESIGN         ,CT,06716-0000,Proprietary  ,3,9,12,34,43,77
02202500,NEW ENGLAND TRACTOR TRAILER SCH         ,CT,06071-2036,Proprietary  ,40,313,353,111,1012,1123
02213000,ELLA T GRASSO SOUTHEASTERN TECHNICAL HIG,CT,06340-0000,Public       ,0,0,0,3,10,13
02228800,BARAN INSTITUTE OF TECHNOLOGY           ,CT,06088-9631,Proprietary  ,99,96,195,1032,588,1620
02244900,GOODWIN COLLEGE                         ,CT,06118-9980,Private      ,34,227,261,533,2262,2795
02245300,HOWELL CHENEY TECHNICAL HIGH SCHOOL     ,CT,06040-0000,Public       ,0,1,1,4,20,24
02265900,WINDHAM COMMUNITY MEM HOSP-RAD TECH     ,CT,06226-0000,Private      ,0,1,1,9,14,23
02296100,YALE-NEW HAVEN HOSP DIETETIC INTERN     ,CT,06510-8900,Private      ,1,0,1,10,4,14
02300000,W F KAYNOR TECHNICAL HIGH SCHOOL        ,CT,06708-0000,Public       ,0,1,1,11,46,57
02316600,CONNECTICUT CTR FOR MASSAGE THERAPY     ,CT,06111-3975,Proprietary  ,7,39,46,55,295,350
02316601,CONNECTICUT CENTER FOR MASSAGE THERAPY -,CT,06880-4619,Proprietary  ,5,31,36,40,177,217
02316603,CONNECTICUT CENTER FOR MASSAGE THERAPY -,CT,06340-4619,Proprietary  ,4,19,23,40,139,179
02562400,EMMETT O BRIEN REG VOC TECH SCHOOL      ,CT,06401-2500,Public       ,1,0,1,1,2,3
02565000,PLATT TECHNICAL HIGH SCHOOL             ,CT,06460-2105,Public       ,0,1,1,8,20,28
03079400,LYME ACADEMY COLLEGE OF FINE ARTS       ,CT,06371-2333,Private      ,2,1,3,82,37,119
03094800,INDUSTRIAL MANAGEMENT & TRAINING        ,CT,06706-1211,Proprietary  ,5,29,34,47,176,223
03231400,OLIVER WOLCOTT TECHNICAL HIGH SCHOOL    ,CT,06790-3859,Public       ,0,0,0,5,2,7
03234300,CHARTER OAK STATE COLLEGE               ,CT,06053-2150,Public       ,8,80,88,77,908,985
03316300,CONNECTICUT CULINARY INSTITUTE          ,CT,06105-3630,Proprietary  ,32,57,89,493,393,886
03381300,CONNECTICUT TRAINING CENTER             ,CT,06108-2705,Private      ,17,86,103,58,334,392
03927300,ALBERT SCHOOL (THE)                     ,CT,06357-2447,Proprietary  ,13,19,32,72,106,178
04053300,CLEMENS COLLEGE                         ,CT,06078-0000,Proprietary  ,4,4,8,110,19,129
04104300,ACADEMY DI CAPELLI - SCHOOL OF COSMETOLO,CT,06492-0000,Proprietary  ,3,13,16,29,46,75
04128800,BRANFORD ACADEMY OF HAIR & COSMETOLOGY  ,CT,06405-0000,Proprietary  ,4,5,9,19,40,59
00146600,BARRY UNIVERSITY                        ,FL,33161-6695,Private      ,150,337,487,4126,7579,11705
00146601,BARRY UNIVERSITY SCHOOL OF LAW          ,FL,32807-0000,Private      ,2,16,18,49,1388,1437
00146700,BETHUNE COOKMAN UNIVERSITY              ,FL,32114-3099,Private      ,213,58,271,7060,1329,8389
00146800,ST THOMAS UNIVERSITY                    ,FL,33054-0000,Private      ,52,113,165,1203,2694,3897
00146900,FLORIDA INSTITUTE OF TECHNOLOGY         ,FL,32901-6988,Private      ,92,826,918,3287,4337,7624
00147000,BREVARD COMMUNITY COLLEGE               ,FL,32922-6503,Public       ,233,575,808,4301,6678,10979
00147100,CENTRAL FLORIDA COMMUNITY COLLEGE       ,FL,34478-1388,Public       ,136,393,529,3513,5283,8796
00147200,CHIPOLA  COLLEGE                        ,FL,32446-2053,Public       ,33,88,121,853,1034,1887
00147300,CLEARWATER CHRISTIAN COLLEGE            ,FL,33759-0000,Private      ,9,3,12,793,91,884
00147500,DAYTONA STATE COLLEGE                   ,FL,32114-2800,Public       ,364,899,1263,5857,10052,15909
00147700,EDISON COLLEGE                          ,FL,33906-6210,Public       ,221,434,655,5004,6195,11199
00147800,EDWARD WATERS COLLEGE                   ,FL,32209-6199,Private      ,34,29,63,1302,670,1972
00147900,EMBRY-RIDDLE AERONAUTICAL UNIV          ,FL,32114-3900,Private      ,142,412,554,6555,4746,11301
00148000,FLORIDA A & M UNIVERSITY                ,FL,32307-3100,Public       ,540,201,741,14210,6822,21032
00148100,FLORIDA ATLANTIC UNIVERSITY             ,FL,33431-6498,Public       ,729,528,1257,14002,10759,24761
00148101,FLORIDA ATLANTIC UNIVERSITY/DAVIE       ,FL,33314-0000,Public       ,31,85,116,828,2316,3144
00148103,FLORIDA ATLANTIC UNIV-JUPITER/PSL       ,FL,33458-0000,Public       ,11,28,39,429,554,983
00148200,FLORIDA COLLEGE                         ,FL,33617-5578,Private      ,6,5,11,430,37,467
00148400,FLORIDA COMMUNITY COLLEGE AT JAX        ,FL,32202-4030,Public       ,509,1628,2137,9293,18314,27607
00148500,FLORIDA KEYS COMMUNITY COLLEGE          ,FL,33040-4397,Public       ,24,67,91,351,700,1051
00148600,FLORIDA MEMORIAL UNIVERSITY             ,FL,33054-6199,Private      ,95,59,154,2319,1313,3632
00148700,ECKERD COLLEGE                          ,FL,33711-4744,Private      ,31,87,118,2499,874,3373
00148800,FLORIDA SOUTHERN COLLEGE                ,FL,33801-5698,Private      ,49,51,100,2167,740,2907
00148900,FLORIDA STATE UNIVERSITY                ,FL,32306-2430,Public       ,1745,472,2217,29785,14340,44125
00149000,GULF COAST COMMUNITY COLLEGE            ,FL,32401-1058,Public       ,89,275,364,1846,3400,5246
00149300,INDIAN RIVER STATE COLLEGE              ,FL,34981-5596,Public       ,255,516,771,4440,6955,11395
00149500,JACKSONVILLE UNIVERSITY                 ,FL,32211-3394,Private      ,140,223,363,3439,2872,6311
00149700,JONES COLLEGE                           ,FL,32211-5588,Private      ,13,72,85,105,940,1045
00149900,EVEREST UNIVERSITY                      ,FL,32810-5601,Proprietary  ,148,484,632,1040,8022,9062
00149901,EVEREST UNIVERSITY - ORLANDO SOUTH      ,FL,32819-7666,Proprietary  ,247,1439,1686,1139,5936,7075
00149902,EVEREST UNIVERSITY - MELBOURNE          ,FL,32905-6609,Proprietary  ,62,411,473,276,1980,2256
00150000,BROWARD COLLEGE- DOWNTOWN CTR           ,FL,33301-2208,Public       ,395,794,1189,5878,9191,15069
00150001,BROWARD COLLEGE - DAVIE CAMPUS          ,FL,33314-0000,Public       ,235,308,543,6156,6017,12173
00150002,BROWARD COLLEGE- NORTH CAMPUS           ,FL,33066-0000,Public       ,153,219,372,1915,2131,4046
00150003,BROWARD COLLEGE- SOUTH CAMPUS           ,FL,33024-0000,Public       ,167,263,430,2142,2350,4492
00150100,LAKE CITY COMMUNITY COLLEGE             ,FL,32025-2007,Public       ,39,128,167,925,2089,3014
00150200,LAKE SUMTER COMMUNITY COLLEGE           ,FL,34788-8751,Public       ,65,173,238,1550,2218,3768
00150400,MANATEE COMMUNITY COLLEGE               ,FL,34207-3596,Public       ,183,414,597,4300,6398,10698
00150500,LYNN UNIVERSITY                         ,FL,33431-5598,Private      ,29,31,60,1441,616,2057
00150600,MIAMI DADE COLLEGE ADMINISTRATION ONLY  ,FL,33176-3393,Public       ,33,78,111,648,806,1454
00150601,MIAMI DADE COLLEGE - NORTH CAMPUS       ,FL,33167-3495,Public       ,481,903,1384,9339,11641,20980
00150602,MIAMI DADE COLLEGE - KENDALL CAMPUS     ,FL,33176-3393,Public       ,735,947,1682,12936,10215,23151
00150603,MIAMI DADE COLLEGE - WOLFSON CAMPUS     ,FL,33132-2297,Public       ,332,530,862,5582,6150,11732
00150604,MIAMI DADE COLLEGE - MEDICAL CAMPUS     ,FL,33127-4693,Public       ,77,256,333,1265,3459,4724
00150605,MIAMI DADE COLLEGE - HOMESTEAD CAMPUS   ,FL,33030-6009,Public       ,103,202,305,1453,2049,3502
00150606,MIAMI DADE COLLEGE -INTERAMERICAN CAMPUS,FL,33135-0000,Public       ,160,394,554,2749,4847,7596
00150607,MIAMI DADE COLLEGE - HIALEAH CAMPUS     ,FL,33012-2918,Public       ,118,257,375,1779,2336,4115
00150800,NORTH FLORIDA COMMUNITY COLLEGE         ,FL,32340-1699,Public       ,27,50,77,484,752,1236
00150900,NOVA SOUTHEASTERN UNIVERSITY            ,FL,33314-7796,Private      ,171,1610,1781,4392,30072,34464
00151000,NORTHWEST FLORIDA STATE COLLEGE         ,FL,32578-1295,Public       ,66,239,305,1673,3559,5232
00151200,PALM BEACH COMMUNITY COLLEGE            ,FL,33461-4796,Public       ,465,749,1214,8780,10275,19055
00151300,PENSACOLA JR COLLEGE                    ,FL,32504-8998,Public       ,168,530,698,3731,6508,10239
00151400,POLK COMMUNITY COLLEGE                  ,FL,33881-4299,Public       ,113,259,372,2787,4255,7042
00151500,ROLLINS COLLEGE                         ,FL,32789-4499,Private      ,39,44,83,2224,1249,3473
00151900,SANTA FE COLLEGE                        ,FL,32606-6200,Public       ,295,336,631,7191,5727,12918
00152000,SEMINOLE COMMUNITY COLLEGE              ,FL,32773-6199,Public       ,264,634,898,5197,8366,13563
00152100,SOUTHEASTERN UNIVERSITY                 ,FL,33801-6099,Private      ,32,50,82,2672,1338,4010
00152200,SOUTH FLORIDA COMMUNITY COLLEGE         ,FL,33825-9399,Public       ,31,134,165,1091,1685,2776
00152300,ST JOHNS RIVER COMMUNITY COLLEGE        ,FL,32177-3897,Public       ,70,195,265,1811,2940,4751
00152600,SAINT LEO UNIVERSITY                    ,FL,33574-6665,Private      ,113,1024,1137,2966,10695,13661
00152800,ST. PETERSBURG COLLEGE                  ,FL,33760-3768,Public       ,365,1012,1377,6622,14547,21169
00153100,STETSON UNIVERSITY                      ,FL,32723-3761,Private      ,68,53,121,2712,695,3407
00153101,STETSON UNIVERSITY - COLLEGE OF LAW     ,FL,33707-3299,Private      ,0,23,23,44,1833,1877
00153300,TALLAHASSEE COMMUNITY COLLEGE           ,FL,32304-2895,Public       ,311,415,726,7749,7034,14783
00153400,EVEREST UNIVERSITY                      ,FL,33614-5801,Proprietary  ,113,666,779,922,9230,10152
00153408,EVEREST UNIVERSITY - TAMPA BRANDON CAMPU,FL,33619-1354,Proprietary  ,227,2494,2721,819,7223,8042
00153409,EVEREST UNIVERSITY - ORANGE PARK        ,FL,32073-1111,Proprietary  ,65,283,348,394,1922,2316
00153500,UNIVERSITY OF FLORIDA                   ,FL,32611-3150,Public       ,1433,550,1983,29905,16443,46348
00153600,UNIVERSITY OF MIAMI                     ,FL,33146-6531,Private      ,296,209,505,14266,4930,19196
00153601,UNIV OF MIAMI SCHOOL OF LAW             ,FL,33124-0000,Private      ,6,18,24,67,1721,1788
00153602,UNIV OF MIAMI-SCH OF MEDICINE           ,FL,33136-0000,Private      ,27,22,49,518,1180,1698
00153700,UNIVERSITY OF SOUTH FLORIDA             ,FL,33620-6960,Public       ,1669,712,2381,27503,19445,46948
00153701,UNIV OF SOUTH FLORIDA-ST PETERSBURG     ,FL,33701-0000,Public       ,22,40,62,694,815,1509
00153702,UNIV OF SOUTH FLORIDA-SARASOTA          ,FL,34243-0000,Public       ,9,30,39,240,606,846
00153705,UNIV OF SOUTH FLORIDA                   ,FL,33803-0000,Public       ,31,25,56,524,529,1053
00153706,UNIV OF SOUTH FLORIDA- MEDICINE         ,FL,33612-0000,Public       ,61,18,79,788,1014,1802
00153800,UNIVERSITY OF TAMPA                     ,FL,33606-1490,Private      ,163,89,252,6562,1803,8365
00154000,WEBBER INTERNATIONAL UNIVERSITY         ,FL,33827-0096,Private      ,13,6,19,645,183,828
00173308,NATIONAL-LOUIS UNIVERSITY               ,FL,33609-0000,Private      ,0,9,9,3,72,75
00177201,TRINITY INTERNATIONAL UNIVERSITY - SOUTH,FL,33324-4611,Private      ,4,30,34,32,385,417
00395400,UNIV OF CENTRAL FLORIDA                 ,FL,32816-0001,Public       ,1905,769,2674,36780,17566,54346
00395500,UNIVERSITY OF WEST FLORIDA              ,FL,32514-5750,Public       ,171,193,364,5270,4935,10205
00407215,NORTHWOOD UNIVERSITY                    ,FL,33409-0000,Private      ,9,19,28,554,279,833
00558500,LIVELY TECHNICAL CENTER                 ,FL,32304-0000,Public       ,34,147,181,332,1182,1514
00558501,LIVELY TECHNICAL CENTER - AVIATION SCHOO,FL,32304-8723,Public       ,3,4,7,15,50,65
00558600,LINDSEY HOPKINS TECHNICAL ED CENTER     ,FL,33127-4692,Public       ,26,107,133,221,869,1090
00559400,D G ERWIN TECHNICAL CENTER              ,FL,33610-8255,Public       ,50,226,276,499,1872,2371
00560500,PINELLAS TECH ED CTR-CLEARWATER         ,FL,33760-2194,Public       ,46,156,202,250,829,1079
00560700,SARASOTA COUNTY TECHNICAL INSTITUTE     ,FL,34233-0000,Public       ,17,56,73,171,674,845
00560800,TRAVISS TECHNICAL CENTER                ,FL,33803-0000,Public       ,19,73,92,216,834,1050
00561200,MANATEE TECHNICAL INSTITUTE             ,FL,34210-0000,Public       ,38,115,153,270,871,1141
00561201,MANATEE TECHNICAL INSTITUTE-EAST        ,FL,34211-0000,Public       ,12,48,60,147,657,804
00675000,VALENCIA COMMUNITY COLLEGE              ,FL,32802-3028,Public       ,1329,1274,2603,18822,16703,35525
00752500,SUWANNEE-HAMILTON AREA VOC TECH CTR     ,FL,32060-0000,Public       ,2,13,15,50,224,274
00752600,WASHINGTON HOLMES TECHNICAL CENTER      ,FL,32428-1699,Public       ,18,91,109,134,505,639
00755800,LEE COUNTY HIGH TECH CENTER CENTRAL     ,FL,33916-2299,Public       ,31,93,124,289,755,1044
00758600,REMINGTON COLLEGE - TAMPA CAMPUS        ,FL,33612-8410,Proprietary  ,17,67,84,165,637,802
00758604,REMINGTON COLLEGE-LARGO CAMPUS          ,FL,33771-0000,Proprietary  ,0,10,10,8,53,61
00758605,REMINGTON COLLEGE-JACKSONVILLE CAMPUS   ,FL,32256-6932,Proprietary  ,0,0,0,7,15,22
00787000,HILLSBOROUGH COMMUNITY COLLEGE          ,FL,33606-3572,Public       ,418,855,1273,10499,13586,24085
00789300,FLAGLER COLLEGE                         ,FL,32085-1027,Private      ,50,12,62,2727,477,3204
00789301,FLAGLER COLLEGE - TALLAHASSEE COMMUNITY ,FL,32304-2895,Private      ,3,8,11,113,327,440
00807500,ST JOHN VIANNEY COLLEGE SEMINARY        ,FL,33165-3244,Private      ,0,1,1,17,5,22
00814600,EVEREST UNIVERSITY - POMPANO BEACH      ,FL,33062-2522,Proprietary  ,86,504,590,586,2947,3533
00822300,ST VINCENT DE PAUL REGIONL SEMINARY     ,FL,33436-0000,Private      ,0,0,0,0,7,7
00841700,STENOTYPE INST OF JACKSONVILLE          ,FL,32207-0000,Proprietary  ,12,76,88,84,462,546
00850100,RASMUSSEN COLLEGE                       ,FL,34471-7051,Proprietary  ,49,417,466,376,2024,2400
00850103,RASMUSSEN COLLEGE-HOLIDAY               ,FL,34690-0000,Proprietary  ,25,138,163,175,872,1047
00850106,RASMUSSEN COLLEGE - FORT MYERS          ,FL,33905-7805,Proprietary  ,33,97,130,95,355,450
00884800,WARNER SOUTHERN COLLEGE                 ,FL,33859-8725,Private      ,15,61,76,587,784,1371
00884900,PALM BEACH ATLANTIC UNIVERSITY          ,FL,33401-6505,Private      ,60,122,182,2422,2096,4518
00887800,MIAMI INTERNATIONAL UNIV ART&DESIGN     ,FL,33132-1418,Proprietary  ,198,249,447,3035,2373,5408
00910400,RIVERSIDE HAIRSTYLING ACADEMY           ,FL,32207-3810,Proprietary  ,1,13,14,21,92,113
00963500,FLORIDA INTERNATIONAL UNIVERSITY        ,FL,33199-0001,Public       ,1065,814,1879,22491,20260,42751
00984100,UNIVERSITY OF NORTH FLORIDA             ,FL,32224-2645,Public       ,603,266,869,9700,6711,16411
00990200,SHERIDAN TECHNICAL CENTER               ,FL,33021-3399,Public       ,80,263,343,529,1672,2201
01016100,"LORAINE'S ACADEMY, INC                  ",FL,33710-0000,Proprietary  ,4,48,52,42,204,246
01019500,ART INSTITUTE OF FT LAUDERDALE          ,FL,33316-3000,Proprietary  ,128,210,338,2365,2200,4565
01065200,PASCO-HERNANDO COMMUNITY CLG            ,FL,34654-5199,Public       ,150,423,573,3306,5343,8649
01072401,CARLOS ALBIZU UNIVERSITY                ,FL,33172-0000,Private      ,10,65,75,118,1214,1332
01082600,TOM P. HANEY TECHNICAL CENTER           ,FL,32405-5099,Public       ,8,82,90,117,570,687
01112700,GOODING INST OF NUR ANES BAY MED CT     ,FL,32401-0000,Public       ,0,1,1,3,58,61
01226300,ATLANTIC TECHNICAL CENTER               ,FL,33063-3902,Public       ,48,160,208,437,1241,1678
01254400,FIRST COAST TECHNICAL COLLEGE           ,FL,32084-1921,Public       ,22,85,107,190,658,848
01254401,FIRST COAST TECHNICAL INSTITUTE - PUTNAM,FL,32077-6830,Public       ,4,7,11,46,102,148
01257400,RINGLING SCHOOL OF ART AND DESIGN       ,FL,34234-5895,Private      ,27,7,34,1484,282,1766
01303904,SOUTH UNIVERSITY                        ,FL,33409-5149,Proprietary  ,28,176,204,333,1509,1842
01323400,LORENZO WALKER INST OF TECHNOLOGY       ,FL,34104-4405,Public       ,17,65,82,236,555,791
02052002,FLORIDA EDUCATION CENTER - LAUDERHILL   ,FL,33313-5857,Proprietary  ,7,35,42,112,439,551
02089600,CONCORDE CAREER INSTITUTE               ,FL,32211-0000,Proprietary  ,44,174,218,200,1108,1308
02089709,HERZING COLLEGE                         ,FL,32792-5509,Proprietary  ,3,10,13,27,90,117
02113609,AMERICAN INTERCONTINENTAL UNIV - WESTON ,FL,33326-3233,Proprietary  ,25,98,123,560,1107,1667
02115300,PINELLAS TECHNICAL EDUCATION CENTERS - S,FL,33711-0000,Public       ,29,205,234,191,938,1129
02116006,SANFORD-BROWN INSTITUTE - FT. LAUDERDALE,FL,33309-1906,Proprietary  ,42,170,212,315,1076,1391
02121800,EVEREST INSTITUTE                       ,FL,33169-4759,Proprietary  ,80,262,342,463,1403,1866
02121801,EVEREST INSTITUTE  - HIALEAH            ,FL,33012-7193,Proprietary  ,108,219,327,630,1193,1823
02148200,FASHION FOCUS HAIR ACADEMY              ,FL,34231-0000,Proprietary  ,5,11,16,21,57,78
02148300,MANHATTAN BEAUTY SCHOOL                 ,FL,33611-0000,Proprietary  ,27,186,213,145,723,868
02149900,PAUL MITCHELL THE SCHOOL-JACKSONVILLE   ,FL,32205-0000,Proprietary  ,22,43,65,129,262,391
02151100,ATI COLLEGE OF HEALTH                   ,FL,33169-0000,Proprietary  ,101,313,414,426,2006,2432
02151900,KEISER  UNIVERSITY                      ,FL,33309-0000,Proprietary  ,514,2057,2571,4261,14690,18951
02156700,FLORIDA CHRISTIAN COLLEGE               ,FL,34744-0000,Private      ,6,5,11,202,141,343
02159600,BAPTIST COLLEGE OF FLORIDA (THE)        ,FL,32440-0000,Private      ,8,19,27,289,295,584
02172700,CONCORDE CAREER INSTITUTE               ,FL,33607-0000,Proprietary  ,25,162,187,186,821,1007
02188900,HOBE SOUND BIBLE COLLEGE                ,FL,33475-0000,Private      ,0,3,3,88,50,138
02200100,BRADENTON BEAUTY & BARBER ACADEMY       ,FL,34209-0000,Proprietary  ,10,45,55,42,215,257
02215900,ATI CAREER TRAINING CENTER              ,FL,33309-1785,Proprietary  ,46,153,199,179,638,817
02218700,FLORIDA TECHNICAL COLLEGE               ,FL,32826-2707,Proprietary  ,60,233,293,422,1739,2161
02218707,FLORIDA TECHNICAL COLLEGE - LAKELAND    ,FL,33813-2101,Proprietary  ,4,55,59,14,148,162
02218709,FLORIDA TECHNICAL COLLEGE - DELAND      ,FL,32720-7415,Proprietary  ,2,11,13,22,80,102
02228300,LAKE TECHNICAL CENTER                   ,FL,32726-0000,Public       ,15,57,72,188,684,872
02245500,CENTRAL FLORIDA COLLEGE                 ,FL,32789-4679,Proprietary  ,37,142,179,219,944,1163
02257900,INTERNATIONAL ACADEMY                   ,FL,32119-3541,Proprietary  ,28,67,95,106,288,394
02275100,CONCORDE CAREER INSTITUTE               ,FL,33025-0000,Proprietary  ,32,135,167,117,597,714
02278800,SOUTHWEST FLORIDA COLLEGE               ,FL,33907-0000,Private      ,80,253,333,547,1593,2140
02278801,SOUTHWEST FLORIDA COLLEGE - TAMPA       ,FL,33619-1344,Private      ,40,79,119,268,617,885
02278802,SOUTHWEST FLORIDA COLLEGE - INSTITUTUE O,FL,33928-9469,Private      ,0,1,1,0,1,1
02278803,SOUTHWEST FLORIDA COLLEGE - PORT CHARLOT,FL,33953-3100,Private      ,6,38,44,6,38,44
02279600,CORTIVA INSTITUTE - FLORIDA             ,FL,33781-0000,Proprietary  ,3,45,48,43,190,233
02280800,NEW ENGLAND INST TECH-PALM BEACH        ,FL,33407-0000,Proprietary  ,88,309,397,849,1956,2805
02283800,BEAUTY SCHOOLS OF AMERICA               ,FL,33012-3322,Proprietary  ,117,558,675,499,2252,2751
02286500,ITT TECHNICAL INSTITUTE                 ,FL,33634-7515,Proprietary  ,195,483,678,1316,2774,4090
02287100,LA BELLE BEAUTY SCHOOL                  ,FL,33012-0000,Proprietary  ,7,64,71,44,324,368
02293200,ATI CAREER TRAINING CENTER              ,FL,33309-0000,Proprietary  ,180,557,737,758,2294,3052
02293201,ATI CAREER TRAINING CENTER - MIAMI      ,FL,33122-0000,Proprietary  ,3,6,9,30,74,104
02293600,ADVANCED TECHNICAL CENTERS              ,FL,33266-1597,Private      ,1,2,3,4,26,30
02297000,CHARLOTTE TECHNICAL CENTER              ,FL,33948-0000,Public       ,12,52,64,145,464,609
02300900,WITHLACOOCHEE TECHNICAL INSTITUTE       ,FL,34450-0000,Public       ,9,33,42,193,518,711
02305700,GULF COAST COLLEGE                      ,FL,33619-0000,Proprietary  ,14,63,77,73,352,425
02305800,FLORIDA CAREER COLLEGE                  ,FL,33012-7028,Proprietary  ,338,914,1252,1954,4112,6066
02307400,GEORGE STONE AREA VOCATIONAL TECHNICAL  ,FL,32526-0000,Public       ,33,157,190,160,700,860
02314100,SCHILLER INTERNATIONAL UNIVERSITY       ,FL,33770-3716,Proprietary  ,4,8,12,73,119,192
02316200,MIAMI LAKES TECHNICAL EDUCATION CTR     ,FL,33014-0000,Public       ,43,107,150,289,740,1029
02321200,ORANGE TECH EDUC CTR- WESTSIDE TECH     ,FL,34787-0000,Public       ,31,95,126,221,504,725
02325100,KEY COLLEGE                             ,FL,33004-3046,Proprietary  ,3,10,13,19,100,119
02326303,MEDVANCE INSTITUTE - WEST PALM          ,FL,33461-2171,Proprietary  ,65,190,255,345,846,1191
02326306,MEDVANCE INSTITUTE - MIAMI              ,FL,33173-3431,Proprietary  ,17,81,98,125,450,575
02326800,RESORT & SPA SCHOOLS INTERNATIONAL      ,FL,34233-0000,Proprietary  ,13,85,98,57,280,337
02326900,SUNSTATE ACADEMY OF HAIR DESIGN         ,FL,33907-1415,Proprietary  ,33,64,97,154,285,439
02329900,FLORIDA INSTITUTE OF ULTRASOUND         ,FL,32514-0000,Proprietary  ,1,8,9,32,136,168
02337000,SUNCOAST II THE TAMPA BAY SCHOOL OF MASS,FL,33607-3802,Proprietary  ,0,0,0,4,8,12
02338400,FT PIERCE BEAUTY ACADEMY                ,FL,34982-0000,Proprietary  ,12,83,95,115,391,506
02341001,FORTIS COLLEGE - DBA FORTIS INSTITUTE   ,FL,32504-7322,Proprietary  ,2,3,5,17,89,106
02346200,WYOTECH                                 ,FL,32174-1010,Proprietary  ,53,113,166,574,777,1351
02362100,FULL SAIL UNIVERSITY                    ,FL,32792-0000,Proprietary  ,398,680,1078,8063,5905,13968
02499000,ACADEMY OF COSMETOLOGY                  ,FL,32953-3311,Proprietary  ,8,37,45,36,182,218
02501500,"O*TEC, MID-FLORIDA TECH                 ",FL,32809-0000,Public       ,30,98,128,330,679,1009
02502702,ADVANCED CAREER TRAINING-JACKSONVIL     ,FL,32256-0000,Proprietary  ,0,0,0,51,278,329
02504600,WINTER PARK TECH                        ,FL,32789-0000,Public       ,15,105,120,146,589,735
02508900,TALMUDIC COLLEGE OF FLORIDA             ,FL,33139-0000,Private      ,1,0,1,11,7,18
02511700,RIDGE TECHNICAL CENTER                  ,FL,33881-0000,Public       ,18,65,83,163,561,724
02513200,ORLANDO TECHNICAL CENTER                ,FL,32801-0000,Public       ,28,151,179,268,1004,1272
02515400,CITY COLLEGE                            ,FL,33309-3073,Private      ,60,203,263,378,1459,1837
02517100,SARASOTA SCHOOL OF MASSAGE THERAPY      ,FL,34243-6130,Proprietary  ,2,21,23,43,124,167
02524000,SUNSTATE ACADEMY OF HAIR DESIGN         ,FL,34624-0000,Proprietary  ,30,46,76,110,190,300
02524200,ROBERT MORGAN EDUCATIONAL CENTER        ,FL,33177-0000,Public       ,57,109,166,446,833,1279
02547600,FLORIDA NATIONAL COLLEGE                ,FL,33012-0000,Proprietary  ,106,463,569,976,3251,4227
02554200,RADFORD LOCKLIN TECH CENTER             ,FL,32570-0000,Public       ,5,27,32,29,147,176
02573200,LA BELLE BEAUTY ACADEMY                 ,FL,33135-0000,Proprietary  ,9,44,53,40,231,271
02586200,FLORIDA CAREER COLLEGE                  ,FL,33759-3924,Proprietary  ,18,81,99,306,875,1181
02586201,FLORIDA CAREER COLLEGE -                ,FL,33569-2553,Proprietary  ,0,3,3,8,24,32
02597100,HERITAGE INSTITUTE                      ,FL,33912-7132,Proprietary  ,73,282,355,309,1143,1452
02598200,FLORIDA TECHNICAL CLG JACKSONVILLE      ,FL,32211-5123,Proprietary  ,13,88,101,95,405,500
02599800,EVEREST UNIVERSITY                      ,FL,33759-1359,Proprietary  ,50,275,325,297,1797,2094
02599801,EVEREST UNIVERSITY - TAMPA LAKELAND CAMP,FL,33801-3801,Proprietary  ,52,243,295,278,1659,1937
02599805,EVEREST UNIVERSITY - JACKSONVILLE       ,FL,32256-0000,Proprietary  ,79,322,401,476,2189,2665
02601600,HENRY W BREWSTER TECHNICAL CENTER       ,FL,33602-0000,Public       ,8,122,130,82,519,601
02612700,DARLYNE MCGEE'S ACAD OF COSMETOLOGY     ,FL,32905-2805,Proprietary  ,3,26,29,24,131,155
02616400,SANFORD-BROWN INSTITUTE                 ,FL,32256-3520,Proprietary  ,97,434,531,518,2211,2729
02616401,SANFORD-BROWN INSTITUTE - TAMPA         ,FL,33610-8304,Proprietary  ,43,252,295,247,1269,1516
03003200,EVEREST INSTITUTE                       ,FL,33186-1410,Proprietary  ,91,193,284,444,1001,1445
03003201,EVEREST INSTITUTE - FT. LAUDERDALE      ,FL,33304-2522,Proprietary  ,35,140,175,229,663,892
03003600,MCFATTER TECHNICAL CENTER               ,FL,33317-7499,Public       ,35,142,177,290,863,1153
03006801,PENNSYLVANIA CULINARY INSTITUTE - LE COR,FL,33025-3929,Proprietary  ,66,221,287,296,880,1176
03008600,FLORIDA COLLEGE OF NATURAL HEALTH       ,FL,33064-1342,Proprietary  ,50,216,266,338,1182,1520
03010608,VIRGINIA COLLEGE - PENSACOLA            ,FL,32501-5650,Proprietary  ,1,48,49,70,521,591
03010612,VIRGINIA COLLEGE - GOLF ACADEMY OF AMERI,FL,32701-0000,Proprietary  ,8,21,29,124,180,304
03012300,ASM BEAUTY WORLD ACADEMY                ,FL,33021-0000,Proprietary  ,1,26,27,19,163,182
03018500,BENE'S INTERNATIONAL SCHOOL OF BEAUTY   ,FL,34652-1637,Proprietary  ,24,52,76,107,263,370
03028200,TRINITY COLLEGE OF FLORIDA              ,FL,34655-4401,Private      ,4,12,16,135,127,262
03031400,INTERNATIONAL ACAD OF DESIGN & TECH     ,FL,33634-6313,Proprietary  ,233,727,960,2983,4880,7863
03031402,INTERNATIONAL ACADEMY OF DESIGN AND TECH,FL,32809-4633,Proprietary  ,27,46,73,633,609,1242
03031403,IADT - ORLANDO CULINARY ACADEMY         ,FL,32819-0000,Proprietary  ,30,43,73,326,377,703
03035800,HERITAGE INSTITUTE                      ,FL,32216-0948,Proprietary  ,27,145,172,114,531,645
03035900,NATIONAL AVIATION ACADEMY               ,FL,33760-3931,Proprietary  ,19,81,100,196,519,715
03037500,HODGES UNIVERSITY                       ,FL,34119-7932,Private      ,52,303,355,499,2525,3024
03054200,TECHNICAL CAREER INSTITUTE              ,FL,33144-2373,Proprietary  ,49,142,191,509,652,1161
03071600,COLLEGE OF BUSINESS & TECHNOLOGY        ,FL,33176-1412,Proprietary  ,30,283,313,157,1206,1363
03071601,COLLEGE OF BUSINESS & TECHNOLOGY -      ,FL,33144-2072,Proprietary  ,1,2,3,22,23,45
03071602,COLLEGE OF BUSINESS & TECHNOLOGY -      ,FL,33012-3436,Proprietary  ,0,0,0,4,9,13
03076402,HIGH-TECH INSTITUTE - ORLANDO           ,FL,32803-3509,Proprietary  ,13,26,39,116,219,335
03079800,GEORGE T BAKER AVIATION                 ,FL,33142-5687,Public       ,20,31,51,191,203,394
03079900,CITY COLLEGE                            ,FL,32707-5342,Private      ,11,55,66,52,306,358
03087600,ITT TECHNICAL INSTITUTE                 ,FL,32746-1607,Proprietary  ,214,535,749,1355,2982,4337
03089200,NOUVELLE INSTITUTE                      ,FL,33125-4141,Proprietary  ,8,92,100,44,491,535
03096300,FLORIDA CAREER INSTITUTE                ,FL,33860-0000,Proprietary  ,11,59,70,57,271,328
03099600,MERCY HOSPITAL SCHOOL OF PRACTICAL NSG  ,FL,33133-4237,Private      ,1,13,14,39,132,171
03100800,TAYLOR TECHNICAL INSTITUTE              ,FL,32348-0894,Public       ,17,31,48,93,221,314
03101900,TRINITY BAPTIST COLLEGE                 ,FL,32221-1398,Private      ,13,13,26,205,122,327
03103900,MARION COUNTY COMMUNITY TECH & ADUL     ,FL,34474-3172,Public       ,11,39,50,162,537,699
03108500,EVERGLADES UNIVERSITY                   ,FL,33431-0000,Private      ,15,169,184,157,1286,1443
03108600,COM-PU-MED VOCATIONAL CAREERS           ,FL,33012-4861,Proprietary  ,15,139,154,80,599,679
03113400,ACADEMY OF HEALING ARTS                 ,FL,33463-2113,Proprietary  ,8,26,34,38,121,159
03114700,PRAXIS INSTITUTE                        ,FL,33135-2657,Proprietary  ,20,135,155,64,529,593
03115500,FLORIDA HOSPITAL COLG OF HEALTH SCI     ,FL,32803-1237,Private      ,27,158,185,748,2062,2810
03123900,KEISER CAREER INSTITUTE                 ,FL,33413-0000,Proprietary  ,66,291,357,431,1489,1920
03125600,MIAMI AD SCHOOL                         ,FL,33139-5203,Proprietary  ,6,20,26,68,299,367
03127900,TECHNICAL EDUCATION CTR OSCEOLA         ,FL,34744-4459,Public       ,32,69,101,207,561,768
03139600,DELTA CONNECTION ACADEMY                ,FL,32773-9683,Proprietary  ,1,10,11,43,99,142
03158300,LEE COUNTY HIGH TECH CENTER NORTH       ,FL,33993-2479,Public       ,8,71,79,113,427,540
03171300,UNIVERSITY OF ST. AUGUSTINE FOR HEALTH S,FL,32084-4215,Proprietary  ,0,64,64,0,64,64
03178400,CORAL RIDGE NURSES ASST TRAINING        ,FL,33306-0000,Proprietary  ,1,13,14,7,65,72
03224300,NEW PROFESSIONS TECHNICAL INSTITUTE     ,FL,33134-1640,Proprietary  ,25,210,235,83,748,831
03230300,OKALOOSA APPLIED TECHNOLOGY CENTER      ,FL,32547-1299,Public       ,9,55,64,93,494,587
03238300,FLORIDA COLLEGE OF INTEGRATIVE MED      ,FL,32809-5721,Proprietary  ,0,8,8,23,173,196
03255300,FLORIDA GULF COAST UNIVERSITY           ,FL,33965-6565,Public       ,327,128,455,7110,3085,10195
03256300,YESHIVA GEDOLAH RABBINICAL COLLEGE      ,FL,33139-4708,Private      ,7,1,8,16,3,19
03264300,SOUTH FLORIDA BIBLE COLLEGE AND THEOLOGI,FL,33441-5768,Private      ,3,6,9,4,21,25
03346300,ACAD FOR PRAC NURSING & HEALTH OCCP     ,FL,33417-4574,Private      ,9,70,79,112,829,941
03348400,PROFESSIONAL TRAINING CENTERS           ,FL,33184-0000,Proprietary  ,18,102,120,120,579,699
03370300,AUDIO RECORDING TECHNOLOGY INSTITUTE    ,FL,32811-0000,Proprietary  ,11,5,16,85,94,179
03373300,BEACON COLLEGE                          ,FL,34748-5224,Private      ,2,0,2,83,28,111
03374300,FLORIDA COASTAL SCHOOL OF LAW           ,FL,32256-0000,Proprietary  ,1,24,25,19,2761,2780
03382300,BRADFORD-UNION AREA CAREERTECHNICAL CENT,FL,32091-2434,Public       ,3,15,18,44,200,244
03390300,AMERICARE SCHOOL OF NURSING             ,FL,32730-2351,Proprietary  ,19,105,124,99,587,686
03390301,AMERICARE SCHOOL OF NURSING - ST. PETERS,FL,33709-3142,Proprietary  ,0,0,0,8,15,23
03411400,INTERNATIONAL TRAINING CAREERS          ,FL,33155-1462,Private      ,15,106,121,48,395,443
03414500,SOUTHEAST INSTITUTE OF ORIENTAL MED     ,FL,33176-1509,Proprietary  ,5,19,24,14,155,169
03425400,CENTRAL FLORIDA INSTITUTE               ,FL,34684-4436,Proprietary  ,31,133,164,217,844,1061
03429600,ATLANTIC INST OF ORIENTAL MEDICINE      ,FL,33316-0000,Private      ,2,9,11,6,108,114
03429700,EAST WEST COLLG OF NATURAL MEDICINE     ,FL,34236-4959,Proprietary  ,0,7,7,6,137,143
03433400,NEW CONCEPT MASSAGE AND BEAUTY SCHO     ,FL,33135-0000,Proprietary  ,1,19,20,11,87,98
03434300,NORTH FLORIDA INSTITUTE                 ,FL,32073-2999,Proprietary  ,31,133,164,159,749,908
03459400,SAINT PETERSBURG THEOLOGICAL SEMINA     ,FL,33708-3116,Private      ,1,6,7,8,58,66
03480301,MEDVANCE INSTITUTE - FORT LAUDERDALE    ,FL,33313-7261,Proprietary  ,46,194,240,183,814,997
03480302,MEDVANCE INSTITUTE - STUART             ,FL,34994-3000,Proprietary  ,10,43,53,99,458,557
03491400,AMERICAN ADVANCED TECHNICIANS INST      ,FL,33014-4430,Proprietary  ,7,21,28,23,70,93
03549300,ULTIMATE MEDICAL ACADEMY                ,FL,33756-5802,Proprietary  ,94,532,626,393,2162,2555
03553300,KEISER CAREER COLLEGE                   ,FL,32216-0000,Proprietary  ,7,21,28,35,118,153
03557300,NORTH FLORIDA COSMETOLOGY INSTITUTE     ,FL,32312-0000,Proprietary  ,7,25,32,49,170,219
03564300,SUPERIOR CAREER INSTITUTE               ,FL,33311-1141,Proprietary  ,4,43,47,22,176,198
03570400,ENGLISH CENTER (THE)                    ,FL,33133-2703,Public       ,2,36,38,23,189,212
03595400,ANGLEY COLLEGE                          ,FL,32720-4257,Proprietary  ,27,116,143,59,369,428
03611400,FLORIDA BARBER ACADEMY                  ,FL,33441-0000,Proprietary  ,9,36,45,45,168,213
03618300,FLORIDA INSTITUTE OF ANIMAL ARTS        ,FL,32792-1740,Proprietary  ,11,42,53,80,209,289
03627400,JACKSONVILLE BEAUTY INSTITUTE           ,FL,32208-1885,Proprietary  ,11,107,118,37,331,368
03627600,FLORIDA EDUCATION INSTITUTE             ,FL,33144-5036,Proprietary  ,24,101,125,77,388,465
03661400,SOUTH FLORIDA INSTITUTE OF TECHNOLO     ,FL,33135-0000,Proprietary  ,17,167,184,78,706,784
03696400,SABER                                   ,FL,33134-1604,Private      ,8,77,85,17,365,382
03706300,AMERICAN INSTITUTE                      ,FL,33319-5613,Proprietary  ,45,133,178,143,564,707
03757300,ADVANCE SCIENCE INSTITUTE               ,FL,33012-0000,Proprietary  ,5,30,35,28,142,170
03801400,BEAUTY INSTITUTE (THE)                  ,FL,33409-2972,Proprietary  ,6,35,41,32,153,185
03801401,BEAUTY INSTITUTE (THE) - MARGATE        ,FL,33068-5704,Proprietary  ,0,1,1,5,18,23
03816300,ARTISTIC NAILS & BEAUTY ACADEMY         ,FL,33605-5919,Proprietary  ,12,61,73,64,284,348
03823300,FLORIDA ACADEMY OF HEALTH & BEAUTY      ,FL,33311-0000,Proprietary  ,0,14,14,8,66,74
03832300,DADE MEDICAL COLLEGE                    ,FL,33125-4013,Proprietary  ,39,178,217,195,717,912
03842500,CAMBRIDGE INSTITUTE OF ALLIED HEALTH    ,FL,32750-0000,Proprietary  ,6,49,55,25,169,194
03856300,UNIVERSAL BEAUTY SCHOOL                 ,FL,33174-4406,Proprietary  ,0,24,24,18,139,157
03866300,GALIANO CAREER ACADEMY                  ,FL,32701-0000,Proprietary  ,25,136,161,113,562,675
03875300,MEDICAL CAREER INSTITUTE OF SOUTH FLORID,FL,33407-2103,Proprietary  ,11,66,77,58,395,453
03888300,DRAGON RISES COLLEGE OF ORIENTAL MEDICIN,FL,32601-5089,Proprietary  ,0,2,2,7,53,60
03903500,SOUTHERN TECHNICAL COLLEGE              ,FL,32809-0000,Proprietary  ,40,170,210,162,707,869
03906300,CAREER INSTITUTE OF FLORIDA             ,FL,33773-3434,Proprietary  ,4,64,68,35,350,385
03911300,TOTAL INTERNATIONAL CAREER INSTITUTE    ,FL,33012-0000,Proprietary  ,7,69,76,10,100,110
03939300,WOLFORD COLLEGE                         ,FL,34108-1931,Private      ,0,4,4,6,251,257
03939400,CENTURA INSTITUTE                       ,FL,32807-3566,Proprietary  ,10,56,66,48,246,294
03939600,DAYTONA COLLEGE                         ,FL,32174-8445,Proprietary  ,5,27,32,46,111,157
03941300,AVE MARIA UNIVERSITY                    ,FL,34142-9505,Private      ,6,6,12,591,136,727
03957400,NEW COLLEGE OF FLORIDA                  ,FL,34243-2109,Public       ,26,2,28,1170,135,1305
03985300,COMMERCIAL DIVING ACADEMY               ,FL,32208-0000,Proprietary  ,25,85,110,155,515,670
03985400,SPACE COAST HEALTH INSTITUTE            ,FL,32904-8771,Proprietary  ,0,0,0,10,51,61
03986300,ARI BEN AVIATOR                         ,FL,34946-0000,Proprietary  ,2,7,9,20,40,60
04016500,AMERICAN INSTITUTE OF BEAUTY            ,FL,33773-0000,Proprietary  ,15,39,54,48,197,245
04029300,TRENDSETTERS OF FLORIDA SCHOOL OF BEAUTY,FL,32205-0000,Proprietary  ,4,14,18,18,68,86
04058300,HEALTH OPPORTUNITY TECHNICAL CENTER     ,FL,33169-4517,Proprietary  ,0,17,17,11,210,221
04105400,PENSACOLA SCHOOL OF MASSAGE THERAPY & HE,FL,32504-7337,Proprietary  ,5,46,51,38,155,193
04106300,PALM BEACH ACADEMY OF HEALTH & BEAUTY   ,FL,33403-2130,Proprietary  ,9,24,33,35,113,148
04116600,PROFESSIONAL HEALTH TRAINING ACADEMY    ,FL,34480-8714,Proprietary  ,2,16,18,20,213,233
04119400,AVEDA INSTITUTE - SAINT PETERSBURG      ,FL,33701-4242,Proprietary  ,52,83,135,209,259,468
04120400,HI-TECH SCHOOL OF COSMETOLOGY           ,FL,33174-0000,Proprietary  ,16,30,46,62,113,175
04120500,ACADEMY OF PROFESSIONAL CAREERS         ,FL,32792-4433,Proprietary  ,3,2,5,29,42,71
04126900,ACADEMY OF CAREER TRAINING              ,FL,34741-4644,Proprietary  ,13,46,59,74,193,267
04127400,DIGITAL MEDIA ARTS COLLEGE              ,FL,33431-5919,Proprietary  ,14,6,20,311,198,509
04128400,MANAGEMENT RESOURCES INSTITUTE          ,FL,33134-1586,Proprietary  ,4,103,107,9,216,225
04129900,FLORIDA SCHOOL OF MASSAGE               ,FL,32608-5419,Proprietary  ,8,26,34,44,164,208
04130400,SHEAR EXCELLENCE INTERNATIONAL HAIR ACAD,FL,33614-2783,Private      ,3,23,26,13,84,97
04131900,FASTTRAIN OF MIAMI                      ,FL,33134-1065,Proprietary  ,24,68,92,69,302,371
04132000,FASTTRAIN OF FORT LAUDERDALE            ,FL,33311-1506,Proprietary  ,6,45,51,18,127,145
04132100,FASTTRAIN OF TAMPA                      ,FL,33607-4153,Proprietary  ,7,55,62,25,167,192
04132200,FASTTRAIN OF JACKSONVILLE               ,FL,32256-4843,Proprietary  ,9,42,51,23,151,174
04133500,ACADEMY FOR FIVE ELEMENT ACUPUNCTURE    ,FL,32601-6811,Private      ,0,7,7,4,65,69
04134800,AVEDA INSTITUTE - TALLAHASSEE           ,FL,32304-3186,Proprietary  ,11,15,26,66,83,149
04134900,ORANGE PARK BEAUTY ACADEMY              ,FL,32073-5524,Proprietary  ,7,30,37,7,43,50
04135000,COZMO THE SCHOOL                        ,FL,34135-4810,Proprietary  ,3,14,17,22,65,87
04135900,ALLIED HEALTH INSTITUTE                 ,FL,33309-1900,Proprietary  ,5,68,73,10,170,180
04140800,NORTH FLORIDA ACADEMY                   ,FL,32065-7758,Proprietary  ,5,7,12,5,8,13
00160500,CHAMINADE UNIV OF HONOLULU              ,HI,96816-1578,Private      ,43,71,114,1364,1469,2833
00160600,BRIGHAM YOUNG UNIV-HAWAII CAMPUS        ,HI,96762-1294,Private      ,58,51,109,922,669,1591
00161000,UNIVERSITY OF HAWAII AT MANOA           ,HI,96822-2399,Public       ,202,180,382,9857,6864,16721
00161100,UNIVERSITY OF HAWAII AT HILO            ,HI,96720-4091,Public       ,63,49,112,2862,1925,4787
00161200,HONOLULU COMMUNITY COLLEGE              ,HI,96817-4598,Public       ,45,76,121,1222,1278,2500
00161300,KAPIOLANI COMMUNITY COLLEGE             ,HI,96816-4421,Public       ,69,117,186,2059,2114,4173
00161400,KAUAI COMMUNITY COLLEGE                 ,HI,96766-9591,Public       ,16,22,38,280,365,645
00161500,MAUI COMMUNITY COLLEGE                  ,HI,96732-1644,Public       ,41,87,128,1043,1647,2690
00454900,LEEWARD COMMUNITY COLLEGE               ,HI,96782-3393,Public       ,91,101,192,1729,1914,3643
00525800,HAWAII COMMUNITY COLLEGE                ,HI,96720-4075,Public       ,41,61,102,1140,1477,2617
00723401,HEALD COLLEGE - HONOLULU                ,HI,96814-0000,Proprietary  ,121,195,316,791,1037,1828
00727900,HAWAII PACIFIC UNIVERSITY               ,HI,96813-2882,Private      ,82,151,233,3618,3017,6635
00777500,HOLLYWOOD BEAUTY COLLEGE                ,HI,96701-4100,Proprietary  ,0,0,0,4,10,14
01122000,WINDWARD COMMUNITY COLLEGE              ,HI,96744-0000,Public       ,31,45,76,584,814,1398
02100300,MED-ASSIST SCHOOL OF HAWAII             ,HI,96813-0000,Proprietary  ,10,18,28,61,118,179
02107800,UNIVERSITY OF HAWAII - WEST OAHU        ,HI,96782-0000,Public       ,19,29,48,544,851,1395
02139500,HAWAII INSTITUTE OF HAIR DESIGN         ,HI,96817-5195,Proprietary  ,5,15,20,28,111,139
02208704,SAN DIEGO GOLF ACADEMY - THE GOLF ACADEM,HI,96744-3724,Proprietary  ,0,0,0,4,4,8
02321300,HAWAI'I THEOLOGICAL SEMINARY            ,HI,96817-0000,Private      ,0,0,0,2,7,9
03017800,TRAVEL INSTITUTE OF THE PACIFIC         ,HI,96814-1946,Proprietary  ,1,38,39,49,178,227
03020800,NEW YORK TECHNICAL INST OF HAWAII       ,HI,96817-4415,Proprietary  ,1,0,1,15,22,37
03072500,WORLD MEDICINE INSTITUTE                ,HI,96826-0000,Private      ,0,1,1,12,63,75
03649300,HAWAII TECHNOLOGY INSTITUTE             ,HI,96813-3036,Private      ,2,6,8,25,56,81
03735300,INST OF CLINICAL ACUPUNCTURE & ORIENT MD,HI,96813-2307,Proprietary  ,0,1,1,1,37,38
03999400,TRADITIONAL CHINESE MEDICAL COLLEGE OF H,HI,96743-8324,Private      ,0,1,1,2,38,40
00161600,BOISE STATE UNIVERSITY                  ,ID,83725-1000,Public       ,266,619,885,9574,11421,20995
00161700,"COLLEGE OF IDAHO, THE                   ",ID,83605-4432,Private      ,23,20,43,1185,255,1440
00161900,COLLEGE OF SOUTHERN IDAHO               ,ID,83301-0000,Public       ,245,456,701,2539,3497,6036
00162000,IDAHO STATE UNIVERSITY                  ,ID,83209-5377,Public       ,157,337,494,4483,7991,12474
00162100,LEWIS-CLARK STATE COLLEGE               ,ID,83501-2698,Public       ,53,91,144,1945,1903,3848
00162300,NORTH IDAHO COLLEGE                     ,ID,83814-2199,Public       ,81,163,244,2138,2613,4751
00162400,NORTHWEST NAZARENE UNIVERSITY           ,ID,83686-5897,Private      ,17,68,85,1310,1079,2389
00162500,BRIGHAM YOUNG UNIVERSITY-IDAHO          ,ID,83460-1650,Private      ,623,707,1330,7714,6582,14296
00162600,UNIVERSITY OF IDAHO                     ,ID,83844-4291,Public       ,135,111,246,7754,3899,11653
00455300,ITT TECHNICAL INSTITUTE                 ,ID,83713-1529,Proprietary  ,135,394,529,836,1928,2764
00458304,BROWN MACKIE COLLEGE-SOUTH BEND - BROWN ,ID,83709-2746,Proprietary  ,30,139,169,51,238,289
00987300,MR JUAN'S CLG OF HAIR DESIGN            ,ID,83301-4154,Proprietary  ,3,10,13,20,44,64
01113300,EASTERN IDAHO TECHNICAL COLLEGE         ,ID,83404-5788,Public       ,11,81,92,255,980,1235
02210700,CAREER BEAUTY COLLEGE                   ,ID,83440-0000,Proprietary  ,2,6,8,35,44,79
02218000,APOLLO COLLEGE                          ,ID,83704-0000,Proprietary  ,37,197,234,360,1268,1628
02234500,BOISE BIBLE COLLEGE                     ,ID,83714-1220,Private      ,4,4,8,162,58,220
02275800,MR LEONS SCHOOL OF HAIR DESIGN          ,ID,83843-8384,Proprietary  ,4,9,13,42,57,99
02275801,MR. LEON'S SCHOOL OF HAIR DESIGN        ,ID,83501-1910,Proprietary  ,1,1,2,1,1,2
02314000,SCHOOL OF HAIRSTYLING (THE)             ,ID,83202-0000,Proprietary  ,2,3,5,39,66,105
02319800,HEADMASTERS SCHOOL OF HAIR DESIGN       ,ID,83814-0000,Proprietary  ,12,32,44,106,171,277
02349200,HEADMASTERS SCHOOL OF HAIR DESIGN       ,ID,83501-0000,Proprietary  ,8,15,23,46,43,89
02559500,RAZZLE DAZZLE CLG OF HAIR DESIGN        ,ID,83686-5104,Proprietary  ,1,20,21,44,143,187
02607100,SCOT LEWIS SCHOOLS                      ,ID,83709-1662,Proprietary  ,12,29,41,119,162,281
03098700,ACADEMY OF COURT REPORTING              ,ID,83704-8320,Proprietary  ,63,225,288,321,1072,1393
03832400,COSMETOLOGY SCHOOL OF ARTS & SCIENCES   ,ID,83318-1327,Proprietary  ,2,7,9,15,53,68
04134300,EVANS HAIRSTYLING COLLEGE               ,ID,83440-5277,Proprietary  ,6,2,8,19,14,33
04144500,HAIR ACDMY PAUL MITCHELL PARTNER SCHOOL ,ID,83440-2600,Proprietary  ,26,40,66,28,42,70
00163200,AQUINAS INSTITUTE OF THEOLOGY           ,MO,63108-3323,Private      ,0,0,0,0,73,73
00244900,AVILA COLLEGE                           ,MO,64145-1698,Private      ,14,70,84,1036,1277,2313
00245000,CALVARY BIBLE COLLEGE                   ,MO,64147-1341,Private      ,3,11,14,178,166,344
00245200,CENTRAL BIBLE COLLEGE                   ,MO,65803-1096,Private      ,7,15,22,500,293,793
00245300,CENTRAL METHODIST UNIVERSITY            ,MO,65248-1198,Private      ,17,58,75,1270,628,1898
00245301,CENTRAL METHODIST UNIVERSITY            ,MO,63601-0000,Private      ,2,12,14,57,215,272
00245302,CENTRAL METHODIST UNIVERSITY- UNION     ,MO,63084-0000,Private      ,1,3,4,30,46,76
00245400,UNIVERSITY OF CENTRAL MISSOURI          ,MO,64093-5178,Public       ,85,180,265,7108,3909,11017
00245600,COLUMBIA COLLEGE                        ,MO,65216-4581,Private      ,106,1173,1279,2692,13759,16451
00245700,CONCORDIA SEMINARY                      ,MO,63105-3199,Private      ,0,13,13,3,551,554
00245800,COTTEY COLLEGE                          ,MO,64772-2790,Private      ,5,4,9,353,32,385
00245900,CROWDER COLLEGE                         ,MO,64850-9165,Public       ,72,179,251,1642,2161,3803
00246000,CULVER STOCKTON COLLEGE                 ,MO,63435-1299,Private      ,10,4,14,1133,139,1272
00246100,DRURY UNIVERSITY                        ,MO,65802-3791,Private      ,57,228,285,2195,3512,5707
00246200,EDEN THEOLOGICAL SEMINARY               ,MO,63119-0000,Private      ,0,5,5,2,128,130
00246300,EVANGEL UNIVERSITY                      ,MO,65802-2125,Private      ,21,41,62,1773,703,2476
00246400,FONTBONNE UNIVERSITY                    ,MO,63105-3098,Private      ,21,200,221,1218,2828,4046
00246600,HARRIS-STOWE STATE COLLEGE              ,MO,63103-2199,Public       ,45,102,147,1606,1870,3476
00246700,CONCEPTION SEMINARY COLLEGE             ,MO,64433-0000,Private      ,1,1,2,44,18,62
00246800,JEFFERSON COLLEGE                       ,MO,63050-2441,Public       ,74,142,216,2340,2204,4544
00247100,ST LOUIS COMMUNITY COLLEGE              ,MO,63102-0000,Public       ,406,1104,1510,8306,12854,21160
00247104,SAINT LOUIS COMMUNITY COLLEGE - WILDWOOD,MO,63040-1168,Public       ,0,0,0,24,44,68
00247300,KANSAS CITY ART INSTITUTE               ,MO,64111-1874,Private      ,9,7,16,940,211,1151
00247400,KANSAS CITY UNIV OF MED & BIOSCIENCES   ,MO,64106-0000,Private      ,0,0,0,33,1163,1196
00247600,KENRICK-GLENNON SEMINARY                ,MO,63119-0000,Private      ,0,0,0,8,5,13
00247700,A.T. STILL UNIV OF HEALTH SCIENCES      ,MO,63501-0000,Private      ,1,133,134,5,2555,2560
00247900,LINCOLN UNIVERSITY                      ,MO,65101-3500,Public       ,48,68,116,2592,1527,4119
00248000,LINDENWOOD UNIVERSITY                   ,MO,63301-1695,Private      ,72,581,653,4334,6241,10575
00248200,MARYVILLE UNIVERSITY                    ,MO,63141-7299,Private      ,18,111,129,2132,2000,4132
00248400,METROPOLITAN COMMUNITY COLLEGE          ,MO,64111-2408,Public       ,210,680,890,7673,11038,18711
00248500,MIDWESTERN BAPTIST THEOL SEMINARY       ,MO,64118-4697,Private      ,1,10,11,61,217,278
00248600,MINERAL AREA COLLEGE                    ,MO,63601-1000,Public       ,43,110,153,1555,1898,3453
00248800,MISSOURI SOUTHERN STATE UNIVERSITY      ,MO,64801-1595,Public       ,56,118,174,3346,3181,6527
00248900,MISSOURI VALLEY COLLEGE                 ,MO,65340-3197,Private      ,26,23,49,1509,346,1855
00249000,MISSOURI WESTERN STATE UNIVERSITY       ,MO,64507-2294,Public       ,68,83,151,4078,2207,6285
00249100,MOBERLY AREA COMMUNITY COLLEGE          ,MO,65270-1304,Public       ,68,103,171,2220,2234,4454
00249400,NAZARENE THEOLOGICAL SEMINARY           ,MO,64131-1246,Private      ,0,11,11,4,155,159
00249500,TRUMAN STATE UNIVERSITY                 ,MO,63501-4221,Public       ,53,15,68,5187,428,5615
00249600,NORTHWEST MISSOURI STATE UNIV           ,MO,64468-6001,Public       ,65,62,127,6059,1181,7240
00249800,PARK UNIVERSITY                         ,MO,64152-3795,Private      ,52,533,585,1308,7303,8611
00249900,ROCKHURST UNIVERSITY                    ,MO,64110-2561,Private      ,24,70,94,1889,1273,3162
00250000,COLLEGE OF THE OZARKS                   ,MO,65726-2502,Private      ,24,9,33,2734,301,3035
00250100,SOUTHEAST MISSOURI STATE UNIV           ,MO,63701-4799,Public       ,104,161,265,6881,3528,10409
00250200,SOUTHWEST BAPTIST UNIVERSITY            ,MO,65613-2597,Private      ,31,97,128,1928,1564,3492
00250300,MISSOURI STATE UNIVERSITY               ,MO,65897-0094,Public       ,186,225,411,12278,6281,18559
00250400,ST LOUIS COLLEGE OF PHARMACY            ,MO,63110-1088,Private      ,4,6,10,748,492,1240
00250600,SAINT LOUIS UNIVERSITY                  ,MO,63103-2097,Private      ,94,216,310,7945,6622,14567
00250900,SAINT PAUL SCHOOL OF THEOLOGY           ,MO,64127-2499,Private      ,0,7,7,3,171,174
00251200,STEPHENS COLLEGE                        ,MO,65215-0001,Private      ,12,11,23,940,436,1376
00251400,NORTH CENTRAL MISSOURI COLLEGE          ,MO,64683-1824,Public       ,15,51,66,711,833,1544
00251600,UNIVERSITY OF MISSOURI-COLUMBIA         ,MO,65211-1600,Public       ,316,274,590,19922,7138,27060
00251700,MISSOURI UNIVERSITY OF SCIENCE & TECHNOL,MO,65409-0250,Public       ,56,38,94,4250,976,5226
00251800,UNIVERSITY OF MISSOURI-KANSAS CITY      ,MO,64110-2497,Public       ,106,273,379,5868,7961,13829
00251900,UNIVERSITY OF MISSOURI-ST LOUIS         ,MO,63121-4499,Public       ,131,375,506,5146,8012,13158
00252000,WASHINGTON UNIVERSITY                   ,MO,63130-4899,Private      ,109,106,215,11858,5071,16929
00252001,WASHINGTON UNIV-SCHOOL OF MEDICINE      ,MO,63110-0000,Private      ,1,9,10,62,1261,1323
00252100,WEBSTER UNIVERSITY                      ,MO,63119-3194,Private      ,42,753,795,3149,13107,16256
00252200,WENTWORTH MILITARY ACADEMY              ,MO,64067-1799,Private      ,18,30,48,154,202,356
00252300,WESTMINSTER COLLEGE                     ,MO,65251-1299,Private      ,16,4,20,1064,84,1148
00252400,WILLIAM JEWELL COLLEGE                  ,MO,64068-1896,Private      ,16,19,35,1415,236,1651
00252500,WILLIAM WOODS UNIVERSITY                ,MO,65251-2388,Private      ,23,327,350,938,2404,3342
00405704,NATIONAL AMERICAN UNIVERSITY            ,MO,64057-1791,Proprietary  ,3,37,40,36,331,367
00441300,ST JOHNS HOSP SCH RAD TECH              ,MO,65802-0000,Private      ,1,2,3,36,52,88
00470300,LOGAN COLLEGE OF CHIROPRACTIC           ,MO,63006-1065,Private      ,5,25,30,68,1232,1300
00470700,COVENANT THEOLOGICAL SEMINARY           ,MO,63141-8697,Private      ,0,10,10,4,505,509
00471100,LINN STATE TECHNICAL COLLEGE            ,MO,65051-9607,Public       ,25,21,46,982,310,1292
00471300,THREE RIVERS COMMUNITY COLLEGE          ,MO,63901-2393,Public       ,76,192,268,1602,2330,3932
00528800,KIRKSVILLE AREA TECHNICAL CENTER        ,MO,63501-0000,Public       ,0,0,0,23,62,85
00528900,WAYNESVILLE TECHNICAL ACADEMY           ,MO,65583-0000,Public       ,2,4,6,18,110,128
00542400,SOUTH CENTRAL CAREER CENTER             ,MO,65775-3334,Public       ,3,4,7,38,123,161
00542600,SIKESTON CAREER AND TECHNOLOGY CTR      ,MO,63801-0000,Public       ,0,2,2,26,127,153
00542900,ROLLA TECHNICAL INSTITUTE               ,MO,65401-3601,Public       ,3,15,18,228,310,538
00543000,POPLAR BLUFF TECHNICAL CAREER CNTR      ,MO,63901-0000,Public       ,2,4,6,34,95,129
00543800,SALINE COUNTY CAREER CENTER             ,MO,65340-0000,Public       ,0,2,2,14,75,89
00544500,TRUMAN MEDICAL CENTER SCHOOL OF NURSE AN,MO,64108-2677,Private      ,0,8,8,29,76,105
00553100,GRAND RIVER TECHNICAL SCHOOL            ,MO,64601-1299,Public       ,0,1,1,62,33,95
00553200,CAPE GIRARDEAU CAREER & TECHNOLOGY CENTE,MO,63703-7511,Public       ,3,5,8,81,272,353
00638500,CHAMBERLAIN COLLEGE OF NURSING          ,MO,63139-3297,Proprietary  ,47,769,816,624,4490,5114
00638900,BARNES JEWISH COLLEGE OF NURSING AND ALL,MO,63110-1091,Private      ,7,20,27,238,660,898
00639200,RESEARCH COLLEGE OF NURSING             ,MO,64132-1199,Proprietary  ,0,7,7,45,149,194
00639201,RESEARCH MEDICAL CENTER - COLLEGE OF NUR,MO,64132-1199,Proprietary  ,0,1,1,5,15,20
00639202,RESEARCH MED CTR SCHL OF RAD TECH       ,MO,64132-0000,Proprietary  ,0,0,0,0,4,4
00666600,LUTHERAN  SCHOOL OF NURSING             ,MO,63118-3909,Proprietary  ,0,7,7,72,298,370
00754000,MISSOURI BAPTIST UNIVERSITY             ,MO,63141-8698,Private      ,16,160,176,1225,1861,3086
00755700,ITT TECHNICAL INSTITUTE                 ,MO,63045-1122,Proprietary  ,246,617,863,1713,3686,5399
00808000,STATE FAIR COMMUNITY COLLEGE            ,MO,65301-0000,Public       ,69,175,244,1805,2128,3933
00826900,HILLYARD TECHNICAL CENTER               ,MO,64506-0000,Public       ,2,5,7,88,152,240
00855200,PATRICIA STEVENS COLLEGE                ,MO,63102-2334,Proprietary  ,5,19,24,81,151,232
00860600,TRI-COUNTY TECHNICAL SCHOOL             ,MO,65026-0000,Public       ,0,2,2,16,53,69
00886200,EAST CENTRAL COLLEGE                    ,MO,63084-0529,Public       ,74,163,237,1673,1635,3308
00908900,HANNIBAL-LAGRANGE COLLEGE               ,MO,63401-1999,Private      ,2,25,27,784,502,1286
00952000,NATIONAL ACADEMY OF BEAUTY ARTS         ,MO,63128-1307,Proprietary  ,31,79,110,195,405,600
00959000,INDEPENDENCE COLLEGE OF COSMETOLOGY     ,MO,64055-1105,Proprietary  ,8,18,26,44,78,122
00960700,HOUSE OF HEAVILIN BEAUTY COLLEGE        ,MO,64110-2826,Proprietary  ,4,18,22,28,89,117
00978200,SAINT LUKE'S COLLEGE                    ,MO,64114-3237,Private      ,1,1,2,69,144,213
00979500,MISSOURI COLLEGE                        ,MO,63144-2901,Proprietary  ,48,170,218,350,925,1275
01014814,COLORADO TECHNL UNIV NORTH KANSAS CITY  ,MO,64116-3614,Proprietary  ,22,157,179,231,1113,1344
01027900,HICKEY COLLEGE                          ,MO,63146-0000,Proprietary  ,36,17,53,383,180,563
01040500,PINNACLE CAREER INSTITUTE               ,MO,64131-3367,Proprietary  ,27,339,366,231,1683,1914
01040501,PINNACLE CAREER INSTITUTE - NORTH KANSAS,MO,64153-1151,Proprietary  ,10,57,67,32,171,203
01102600,WARRENSBURG AREA VOC TECH SCH           ,MO,64093-0000,Public       ,1,2,3,25,62,87
01173500,PIKE/LINCOLN TECHNICAL CENTER           ,MO,63344-0000,Public       ,0,3,3,29,68,97
01212000,ASSEMBLIES OF GOD THEO. SEMINARY        ,MO,65802-0000,Private      ,0,4,4,8,279,287
01250000,RANKEN TECHNICAL COLLEGE                ,MO,63113-2811,Private      ,25,41,66,1143,944,2087
01258000,ST LOUIS CHRISTIAN COLLEGE              ,MO,63033-6499,Private      ,5,20,25,135,227,362
01320800,BAPTIST BIBLE COLLEGE                   ,MO,65803-3498,Private      ,6,5,11,378,218,596
02056100,FOUR RIVERS CAREER CENTER               ,MO,63090-0000,Public       ,0,3,3,13,39,52
02066900,NICHOLS CAREER CENTER                   ,MO,65101-2814,Public       ,4,2,6,66,102,168
02068200,COX HEALTH - COX COLLEGE                ,MO,65802-0000,Private      ,8,25,33,193,542,735
02068202,COX HEALTH - RADIOLOGIC TECHNOLOGY      ,MO,65802-0000,Private      ,1,1,2,26,58,84
02068204,COX HEALTH - MEDICAL TECHNOLOGY         ,MO,65807-0000,Private      ,1,1,2,5,17,22
02073600,KENNETT CAREER & TECHNOLOGY CENTER      ,MO,63857-0000,Public       ,1,2,3,13,49,62
02090400,BOONSLICK TECHNICAL EDUCATION CTR       ,MO,65233-0000,Public       ,1,2,3,12,51,63
02121100,MIDWEST INSTITUTE                       ,MO,63122-0000,Proprietary  ,12,66,78,59,270,329
02124500,FRANKLIN TECHNOLOGY CENTER              ,MO,64801-0000,Public       ,2,6,8,84,295,379
02142200,LEX LA RAY TECHNICAL CENTER             ,MO,64067-0000,Public       ,0,0,0,23,72,95
02151000,HANNIBAL CAREER AND TECHNICAL CENTE     ,MO,63401-2285,Public       ,0,4,4,21,83,104
02164200,FOREST INST PROFESSIONAL PSYCHOLOGY     ,MO,65807-0000,Private      ,0,1,1,0,274,274
02165900,CHILLICOTHE BEAUTY ACADEMY              ,MO,64601-0000,Proprietary  ,1,1,2,11,23,34
02180200,METRO BUSINESS COLLEGE                  ,MO,63701-0000,Proprietary  ,20,137,157,211,809,1020
02188100,NORTHLAND CAREER CENTER                 ,MO,64079-8333,Public       ,0,2,2,17,55,72
02202700,OZARK CHRISTIAN COLLEGE                 ,MO,64801-0000,Private      ,7,6,13,507,181,688
02203400,NEVADA REGIONAL TECHNICAL CENTER        ,MO,64772-0000,Public       ,1,3,4,18,63,81
02205200,SANFORD-BROWN COLLEGE                   ,MO,63026-7305,Proprietary  ,52,418,470,602,2807,3409
02205203,SANFORD BROWN COLLEGE-ST. PETERS        ,MO,63301-4042,Proprietary  ,35,174,209,253,1193,1446
02205205,SANFORD BROWN COLLEGE-HAZELWOOD         ,MO,63042-2708,Proprietary  ,0,0,0,138,963,1101
02214500,SALEM COLLEGE OF HAIRSTYLING            ,MO,65401-0000,Proprietary  ,0,8,8,15,48,63
02239200,ALLIED COLLEGE - NORTH                  ,MO,63043-0000,Proprietary  ,113,269,382,730,1676,2406
02239202,ALLIED COLLEGE - METRO SOUTH            ,MO,63026-0000,Proprietary  ,1,3,4,33,43,76
02242800,GIBSON TECHNICAL CENTER                 ,MO,65737-0169,Public       ,0,0,0,2,47,49
02250600,EVEREST COLLEGE                         ,MO,65807-2446,Proprietary  ,27,142,169,180,1058,1238
02263106,HIGH-TECH INSTITUTE - KANSAS CITY       ,MO,64114-0000,Proprietary  ,2,0,2,23,38,61
02263400,LAKE CAREER AND TECHNICAL CENTER        ,MO,65020-0000,Public       ,0,2,2,14,20,34
02266400,CENTRAL CHRISTIAN CLG OF THE BIBLE      ,MO,65270-0000,Private      ,5,7,12,288,183,471
02277500,HOUSE OF HEAVILIN OF BLUE SPRINGS       ,MO,64014-3953,Proprietary  ,12,18,30,44,113,157
02289200,COLUMBIA AREA CAREER CENTER             ,MO,65203-0000,Public       ,2,9,11,44,157,201
02295700,MISSOURI BEAUTY ACADEMY                 ,MO,63640-1827,Proprietary  ,15,30,45,63,162,225
02300105,EVEREST COLLEGE - EARTH CITY            ,MO,63045-1100,Proprietary  ,38,192,230,198,1199,1397
02304000,MISSOURI TECH                           ,MO,63132-0000,Proprietary  ,1,16,17,50,129,179
02309100,AMERICAN COLLEGE OF HAIR DESIGN         ,MO,65301-2144,Proprietary  ,1,11,12,18,58,76
02311100,ABBOTT ACADEMY OF COSMETIC ARTS/SCI     ,MO,63376-0000,Proprietary  ,0,0,0,5,3,8
02313000,CASS CAREER CENTER                      ,MO,64701-0000,Public       ,0,1,1,9,52,61
02340500,ST LOUIS COLLEGE OF HEALTH CAREERS      ,MO,63110-0000,Proprietary  ,19,118,137,138,713,851
02340501,ST LOUIS COLLEGE OF HEALTH              ,MO,63129-0000,Proprietary  ,0,0,0,7,29,36
02342100,CAREER & TECHNOLOGY CTR AT FT OSAGE     ,MO,64058-0000,Public       ,0,1,1,9,14,23
02361600,CONCORDE CAREER COLLEGE                 ,MO,64111-0000,Proprietary  ,27,186,213,189,1147,1336
02497500,CLINTON TECHNICAL SCHOOL                ,MO,64735-2966,Public       ,0,0,0,2,8,10
02520800,MERRELL UNIV OF BTY ARTS & SCIENCES     ,MO,65109-0000,Proprietary  ,14,18,32,84,154,238
02530600,SAINT CHARLES COMMUNITY COLLEGE         ,MO,63376-0975,Public       ,88,167,255,3152,2400,5552
02543800,PARIS II EDUCATIONAL CENTER (THE)       ,MO,64118-0000,Proprietary  ,6,29,35,40,118,158
02555300,PATSY AND ROB'S ACADEMY OF BEAUTY       ,MO,63074-0000,Proprietary  ,4,19,23,50,132,182
02564700,ELAINE STEVEN BEAUTY COLLEGE            ,MO,63136-0000,Proprietary  ,12,38,50,63,168,231
02564701,ELAINE STEVEN BEAUTY COLLEGE - ADVANCE B,MO,63383-2006,Proprietary  ,0,0,0,0,8,8
02564702,ELAINE STEVEN BEAUTY COLLEGE - ADVANCE B,MO,63401-2269,Proprietary  ,0,3,3,3,9,12
02568500,GRABBER SCHOOL OF HAIR DESIGN           ,MO,63011-0000,Proprietary  ,5,14,19,59,75,134
02599700,VATTEROTT COLLEGE                       ,MO,63134-2900,Proprietary  ,65,238,303,355,1607,1962
02599701,VATTEROTT COLLEGE - KANSAS CITY         ,MO,64129-1692,Proprietary  ,28,222,250,209,1143,1352
02599702,VATTEROTT COLLEGE - SPRINGFIELD LOCATION,MO,65807-5340,Proprietary  ,15,159,174,149,798,947
02599703,VATTEROTT COLLEGE - JOPLIN              ,MO,64801-5033,Proprietary  ,8,103,111,102,601,703
02599705,VATTEROTT COLLEGE - SUNSET HILLS        ,MO,63127-1516,Proprietary  ,21,170,191,205,1019,1224
02599712,VATTEROTT COLLEGE - O'FALLON            ,MO,63366-2748,Proprietary  ,16,64,80,121,377,498
02608000,NEOSHO BEAUTY COLLEGE                   ,MO,64850-1525,Proprietary  ,3,7,10,17,41,58
02608001,NEOSHO BEAUTY COLLEGE - CLASS ACT I COSM,MO,64801-2314,Proprietary  ,0,0,0,3,4,7
02609202,VATTEROTT COLLEGE-ST JOSEPH             ,MO,64501-2911,Proprietary  ,17,102,119,124,511,635
02609203,VATTEROTT COLLEGE - L'ECOLE CULINAIRE   ,MO,63124-1103,Proprietary  ,26,103,129,270,750,1020
02611004,HERITAGE COLLEGE-KANSAS CITY            ,MO,64131-4203,Proprietary  ,52,149,201,228,728,956
03042400,LEBANON TECHNOLOGY & CAREER CENTER      ,MO,65536-3296,Public       ,2,2,4,33,115,148
03066300,BRYAN CAREER COLLEGE                    ,MO,65806-2507,Proprietary  ,10,46,56,65,259,324
03068600,NORTH COUNTY TECH SPECIAL SCH DIST      ,MO,63033-6498,Public       ,7,44,51,58,490,548
03070200,CENTRAL COLLEGE OF COSMETOLOGY          ,MO,65583-0000,Proprietary  ,5,13,18,29,98,127
03070900,SE MO HOSP CLG NURSING & HEALTH SCI     ,MO,63703-4507,Private      ,7,8,15,67,228,295
03077200,COSMETOLOGY CONCEPTS INSTITUTE          ,MO,65202-1972,Proprietary  ,5,12,17,42,66,108
03083000,OZARKS TECHNICAL COMMUNITY COLLEGE      ,MO,65802-3601,Public       ,199,424,623,5550,6974,12524
03092600,MESSENGER COLLEGE                       ,MO,64804-4909,Private      ,1,5,6,44,54,98
03097600,ST LOUIS HAIR ACADEMY                   ,MO,63107-1737,Proprietary  ,1,9,10,12,52,64
03101000,NEW DIMENSION SCHOOL OF HAIR DESIGN     ,MO,64801-5017,Proprietary  ,1,4,5,25,44,69
03106000,MISSOURI STATE UNIVERSITY - WEST PLAINS ,MO,65775-2715,Public       ,41,75,116,971,1086,2057
03110900,HOUSE OF HEAVILIN BEAUTY COLLEGE        ,MO,64030-1154,Proprietary  ,0,12,12,18,66,84
03166300,MOBERLY AREA TECHNICAL CENTER           ,MO,65270-1904,Public       ,0,0,0,13,14,27
03174300,HERNDON CAREER CENTER                   ,MO,64138-2695,Public       ,0,0,0,19,13,32
03519300,MISSOURI COLLEGE OF COSMETOLOGY NORTH   ,MO,65803-1235,Proprietary  ,14,27,41,106,223,329
03528300,MIDWEST UNIVERSITY                      ,MO,63385-2905,Private      ,0,3,3,3,38,41
03579300,TEXAS COUNTY TECHNICAL INSTITUTE        ,MO,65483-2700,Private      ,8,27,35,48,323,371
03616300,AVIATION INSTITUTE OF MAINTENANCE       ,MO,64129-1811,Proprietary  ,14,48,62,60,279,339
03663400,UNIVERSITY OF COSMETOLOGY               ,MO,63080-1910,Proprietary  ,3,5,8,19,32,51
03817300,ST. CHARLES SCHOOL OF MASSAGE THERAPY   ,MO,63303-5607,Proprietary  ,0,0,0,6,18,24
03878300,PROFESSIONAL MASSAGE TRAINING CENTER    ,MO,65803-2939,Proprietary  ,4,28,32,38,98,136
03916300,ECLIPS SCHOOL OF COSMETOLOGY AND BARBERI,MO,63703-5809,Proprietary  ,3,16,19,20,66,86
03924300,HAIR ACADEMY 110 (THE)                  ,MO,63501-2915,Proprietary  ,1,2,3,9,24,33
03970400,MTTI-WELLSPRING CENTER FOR NATURAL HEALT,MO,64114-3313,Proprietary  ,6,40,46,45,159,204
04037500,ACADEMY OF HAIR DESIGN                  ,MO,65804-2303,Proprietary  ,6,29,35,67,146,213
04048300,DIVAS UNLIMITED ACADEMY                 ,MO,63114-2625,Proprietary  ,0,4,4,12,31,43
04127000,PEMISCOT COUNTY SPECIAL SCHOOL DISTRICT ,MO,63851-1666,Public       ,0,0,0,7,23,30
04130600,HEALING ARTS CENTER                     ,MO,63143-2103,Proprietary  ,0,12,12,7,41,48
04133300,TREND SETTERS SCHOOL OF COSMETOLOGY     ,MO,63702-7607,Proprietary  ,4,9,13,43,68,111
04145700,THE SYSTEM A PAUL MITCHELL PARTNER SCHL ,MO,65807-5969,Proprietary  ,7,10,17,7,10,17
00163201,AQUINAS INSTITUTE OF THEOLOGY - MINISTRY,OK,73123-0380,Private      ,0,1,1,0,7,7
00314600,WESTERN OKLAHOMA STATE COLLEGE          ,OK,73521-1397,Public       ,37,63,100,545,872,1417
00314700,BACONE COLLEGE                          ,OK,74403-1597,Private      ,19,32,51,764,727,1491
00314900,SOUTHERN NAZARENE UNIVERSITY            ,OK,73008-2694,Private      ,17,185,202,1190,1599,2789
00315000,CAMERON UNIVERSITY                      ,OK,73505-6377,Public       ,85,188,273,1831,3171,5002
00315100,OKLAHOMA WESLEYAN UNIVERSITY            ,OK,74006-6299,Private      ,5,95,100,517,855,1372
00315200,UNIV OF CENTRAL OKLAHOMA                ,OK,73034-5209,Public       ,182,250,432,7208,6217,13425
00315300,CONNORS STATE COLLEGE                   ,OK,74469-9700,Public       ,34,85,119,906,1197,2103
00315400,EAST CENTRAL UNIVERSITY                 ,OK,74820-6999,Public       ,51,104,155,2189,2518,4707
00315500,EASTERN OKLAHOMA STATE COLLEGE          ,OK,74578-4999,Public       ,23,95,118,793,1108,1901
00315600,REDLANDS COMMUNITY COLLEGE              ,OK,73036-5304,Public       ,31,70,101,633,1056,1689
00315700,LANGSTON UNIVERSITY                     ,OK,73050-0000,Public       ,66,87,153,2115,2021,4136
00315800,MURRAY STATE COLLEGE                    ,OK,73460-3137,Public       ,33,134,167,1086,1688,2774
00316000,NORTHEASTERN OKLAHOMA A & M COLLEGE     ,OK,74354-6497,Public       ,37,69,106,1272,914,2186
00316100,NORTHEASTERN STATE UNIVERSITY           ,OK,74464-2399,Public       ,78,198,276,4392,5578,9970
00316200,NORTHERN OKLAHOMA COLLEGE               ,OK,74653-0310,Public       ,77,128,205,1708,1956,3664
00316300,NORTHWESTERN OKLAHOMA STATE UNIV        ,OK,73717-2799,Public       ,19,44,63,1038,883,1921
00316400,OKLAHOMA BAPTIST UNIVERSITY             ,OK,74801-2590,Private      ,24,11,35,1655,316,1971
00316500,OKLAHOMA CHRISTIAN UNIVERSITY           ,OK,73131-0000,Private      ,32,14,46,1925,597,2522
00316600,OKLAHOMA CITY UNIVERSITY                ,OK,73106-1493,Private      ,36,55,91,1974,2237,4211
00316700,UNIV OF SCIENCE & ARTS OF OKLAHOMA      ,OK,73018-5322,Public       ,13,16,29,753,473,1226
00316800,ROGERS STATE UNIVERSITY                 ,OK,74017-3252,Public       ,37,107,144,2038,2497,4535
00317000,OKLAHOMA STATE UNIVERSITY               ,OK,74078-1015,Public       ,292,250,542,12591,6516,19107
00317200,OKLAHOMA STATE UNIVERSITY-OKMULGEE      ,OK,74447-3901,Public       ,55,86,141,1442,1287,2729
00317400,OKLAHOMA PANHANDLE STATE UNIVERSITY     ,OK,73939-0000,Public       ,24,23,47,763,394,1157
00317600,CARL ALBERT STATE COLLEGE               ,OK,74953-5208,Public       ,30,86,116,1154,1789,2943
00317800,SEMINOLE STATE COLLEGE                  ,OK,74818-1902,Public       ,28,85,113,814,1130,1944
00317900,SOUTHEASTERN OKLAHOMA STATE UNIV        ,OK,74701-0609,Public       ,56,115,171,2268,1946,4214
00318000,SOUTHWESTERN CHRISTIAN UNIVERSITY       ,OK,73008-2335,Private      ,4,14,18,156,219,375
00318100,SOUTHWESTERN OKLAHOMA STATE UNIV        ,OK,73096-3098,Public       ,74,73,147,2582,1667,4249
00318101,SOUTHWESTERN OK STATE UNIV AT SAYRE     ,OK,73662-0000,Public       ,6,18,24,125,217,342
00318300,ST GREGORY'S UNIVERSITY                 ,OK,74804-2499,Private      ,8,38,46,334,447,781
00318308,SAINT GREGORY'S UNIVERSITY - IPD TULSA  ,OK,74135-2499,Private      ,2,13,15,30,165,195
00318400,UNIVERSITY OF OKLAHOMA                  ,OK,73019-4078,Public       ,266,378,644,14112,8935,23047
00318401,UNIVERSITY OF OKLAHOMA-HLTH SCI CTR     ,OK,73190-0000,Public       ,7,68,75,406,3248,3654
00318500,UNIVERSITY OF TULSA                     ,OK,74104-3189,Private      ,50,57,107,2733,1801,4534
00398500,ORAL ROBERTS UNIVERSITY                 ,OK,74171-0001,Private      ,39,64,103,2492,1359,3851
00458305,BROWN MACKIE COLLEGE-SOUTH BEND - BROWN ,OK,74146-5234,Proprietary  ,10,71,81,18,125,143
00531100,TULSA COUNTY AREA VOC TECH SCHOOL       ,OK,74145-0000,Public       ,10,44,54,176,709,885
00531200,RED RIVER TECHNOLOGY CENTER             ,OK,73533-2700,Public       ,4,11,15,29,171,200
00533900,METRO TECHNOLOGY CENTERS SCH DIST22     ,OK,73111-0000,Public       ,19,115,134,179,1006,1185
00533903,METRO TECHNOLOGY CENTERS SCH DIST22     ,OK,73129-0000,Public       ,9,27,36,59,253,312
00694200,MID-AMERICA CHRISTIAN UNIVERSITY        ,OK,73170-4504,Private      ,7,99,106,461,989,1450
00767800,SPARTAN COLLEGE OF AERONAUTICS AND TECHN,OK,74115-5800,Proprietary  ,52,99,151,1114,914,2028
00791100,VIRGILS BEAUTY COLLEGE                  ,OK,74401-6802,Proprietary  ,2,9,11,15,49,64
00834300,AUTRY TECHNOLOGY CENTER                 ,OK,73703-2598,Public       ,1,5,6,53,244,297
00861900,TRI COUNTY TECHNOLOGY CENTER            ,OK,74006-6029,Public       ,0,3,3,106,146,252
00918500,ROSE STATE COLLEGE                      ,OK,73110-2799,Public       ,101,374,475,1957,4485,6442
00920400,KIAMICHI AREA VOC TECH SCHOOL           ,OK,74578-0548,Public       ,11,71,82,271,1036,1307
00920408,KIAMICHI AREA VOC TECH SCHOOL           ,OK,74953-0000,Public       ,3,8,11,36,104,140
00961800,TULSA WELDING SCHOOL                    ,OK,74104-0000,Proprietary  ,194,529,723,940,1621,2561
00964700,"OKLAHOMA STATE UNIV, OKLA CITY          ",OK,73107-6159,Public       ,86,314,400,1660,4350,6010
00970800,EVES COLLEGE OF HAIRSTYLING             ,OK,73501-4359,Proprietary  ,4,27,31,29,117,146
00976300,TULSA COMMUNITY COLLEGE                 ,OK,74135-6198,Public       ,219,667,886,6404,9310,15714
00996300,CADDO KIOWA VOC TECH CENTER             ,OK,73038-0000,Public       ,10,60,70,75,358,433
00996400,CENTRAL OKLAHOMA AREA VOC TECH SCH      ,OK,74030-9613,Public       ,2,16,18,55,207,262
00996500,CANADIAN VALLEY TECHNOLOGY CENTER       ,OK,73036-9117,Public       ,8,25,33,72,323,395
00996800,GORDON COOPER TECHNOLOGY CENTER         ,OK,74804-9913,Public       ,7,20,27,71,329,400
01005300,INDIAN CAPITAL TECHNOLGY CENTER #4      ,OK,74403-9907,Public       ,8,45,53,156,532,688
01026600,HILLSDALE FREE WILL BAPTIST COLLEGE     ,OK,73153-0000,Private      ,3,2,5,225,65,290
01034200,SOUTHERN OKLAHOMA TECHNOLOGY CENTER     ,OK,73401-2100,Public       ,2,15,17,78,218,296
01039100,OKLAHOMA CITY COMMUNITY COLLEGE         ,OK,73159-4444,Public       ,210,535,745,3583,6632,10215
01071700,GREAT PLAINS TECHNOLOGY CENTER SCHOOL DI,OK,73505-8399,Public       ,3,22,25,79,372,451
01076200,WESTERN OK AREA VOC TECH SCH DIST12     ,OK,73624-1469,Public       ,0,7,7,37,98,135
01120600,PIONEER TECHNOLOGY CENTER               ,OK,74601-1106,Public       ,1,10,11,29,164,193
01128200,OKLAHOMA STATE UNV CLG OSTEOPTHC MD     ,OK,74107-0000,Public       ,1,7,8,38,517,555
01153700,MID-AMERICA TECHNOLOGY CENTER           ,OK,73095-0210,Public       ,3,10,13,28,65,93
01227200,MOORE-NORMAN TECHNOLOGY CENTER          ,OK,73069-8399,Public       ,7,60,67,141,628,769
02052700,NORTHEAST TECHNOLOGY CENTER             ,OK,74361-0487,Public       ,4,47,51,83,436,519
02052701,NORTHEAST TECHNOLOGY CENTER -           ,OK,74362-0825,Public       ,2,8,10,2,8,10
02060800,MERIDIAN TECHNOLOGY CENTER              ,OK,74074-0000,Public       ,3,18,21,105,248,353
02069301,VATTEROTT COLLEGE                       ,OK,73127-2103,Proprietary  ,5,68,73,46,553,599
02126500,ENID BEAUTY COLLEGE                     ,OK,73701-0000,Proprietary  ,5,11,16,20,62,82
02177900,STATE BARBER AND HAIR DESIGN CLG        ,OK,73108-0000,Proprietary  ,0,1,1,13,87,100
02184400,SAND SPRINGS BEAUTY COLLEGE             ,OK,74063-0000,Proprietary  ,2,16,18,37,131,168
02197300,HOLLYWOOD COSMETOLOGY CENTER            ,OK,73189-0000,Proprietary  ,2,9,11,8,38,46
02222700,FRANCIS TUTTLE TECHNOLOGY CENTER        ,OK,73142-0000,Public       ,20,102,122,233,1041,1274
02238500,CENTRAL STATE BEAUTY ACADEMY            ,OK,73162-6007,Proprietary  ,8,42,50,58,233,291
02250900,E OK COUNTY AREA VO-TECH                ,OK,73020-0000,Public       ,1,8,9,25,77,102
02256200,"BROKEN ARROW BEAUTY COLLEGE, INC        ",OK,74012-0000,Proprietary  ,2,14,16,60,119,179
02282100,HIGH PLAINS AREA VOC-TECH               ,OK,73801-0000,Public       ,3,2,5,24,67,91
02306800,PLATT COLLEGE                           ,OK,74145-0000,Proprietary  ,40,394,434,338,2178,2516
02510300,BEAUTY TECHNICAL COLLEGE                ,OK,74465-0000,Proprietary  ,1,4,5,8,30,38
02531200,WOODWARD BEAUTY COLLEGE                 ,OK,73801-0000,Proprietary  ,1,1,2,14,17,31
02554300,AMERICAN BEAUTY INSTITUTE               ,OK,74501-0000,Proprietary  ,0,3,3,15,27,42
02556500,YUKON BEAUTY COLLEGE                    ,OK,73099-4108,Proprietary  ,1,1,2,10,26,36
02560200,PHILLIPS THEOLOGICAL SEMINARY -         ,OK,74116-5612,Private      ,0,3,3,2,96,98
02581100,CLAREMORE BEAUTY COLLEGE                ,OK,74017-7034,Proprietary  ,0,4,4,9,16,25
02581200,CC'S COSMETOLOGY COLLEGE                ,OK,74129-0000,Proprietary  ,1,55,56,6,228,234
02591101,CAREER POINT INSTITUTE                  ,OK,74146-0000,Proprietary  ,1,5,6,11,64,75
02596501,ATI-CAREER TRAINING CENTER - OKLAHOMA CI,OK,73107-2442,Proprietary  ,1,3,4,5,36,41
02597400,PONTOTOC TECHNOLOGY CENTER SCHOOL       ,OK,74820-8621,Public       ,4,8,12,46,169,215
02599706,VATTEROTT COLLEGE - TULSA               ,OK,74146-2205,Proprietary  ,8,57,65,57,365,422
02600000,NORTHWEST TECHNOLOG CTR SCH DIST 10     ,OK,73717-9600,Public       ,2,1,3,22,45,67
02600500,WES WATKINS TECHNOLOGY CENTER           ,OK,74883-9660,Public       ,2,20,22,42,182,224
03008700,SOUTHWEST TECHNOLOGY CENTER             ,OK,73521-1527,Public       ,0,17,17,26,122,148
03010300,POTEAU BEAUTY COLLEGE                   ,OK,74953-5400,Proprietary  ,1,13,14,32,108,140
03024700,STILLWATER BEAUTY ACADEMY               ,OK,74075-3467,Proprietary  ,4,4,8,20,31,51
03030700,OKLAHOMA SCHOOL OF PHOTOGRAPHY          ,OK,73160-3320,Proprietary  ,2,4,6,20,43,63
03030800,AMERICAN BROADCASTING SCHOOL            ,OK,73115-3334,Proprietary  ,6,50,56,56,261,317
03051100,CHISHOLM TRAIL TECHNOLOGY CENTER        ,OK,73764-9720,Public       ,0,3,3,11,57,68
03078500,TECH INST OF COSMETOLOGY ARTS & SCI     ,OK,74120-3610,Proprietary  ,1,4,5,11,49,60
03089400,SCHOOL OF HAIR DESIGN                   ,OK,74745-3447,Proprietary  ,0,0,0,5,19,24
03103800,SOUTHERN SCHOOL OF BEAUTY               ,OK,74701-5008,Proprietary  ,1,10,11,14,50,64
03109800,PONCA CITY BEAUTY COLLEGE               ,OK,74601-4201,Proprietary  ,0,6,6,0,20,20
03109801,BARTLESVILLE BEAUTY COLLEGE             ,OK,74003-2835,Proprietary  ,0,5,5,7,19,26
03115100,HERITAGE COLLEGE                        ,OK,73119-0000,Proprietary  ,43,186,229,249,1044,1293
03124800,PLATT COLLEGE                           ,OK,73501-3808,Proprietary  ,13,33,46,61,240,301
03126200,GREEN COUNTRY AREA VOC TECH SCHOOL      ,OK,74447-1217,Public       ,1,13,14,31,93,124
03198400,MID-DEL AREA VOCATIONAL & TECH SCH      ,OK,73110-4825,Public       ,1,10,11,14,65,79
03329400,PRYOR BEAUTY COLLEGE                    ,OK,74361-0000,Proprietary  ,1,8,9,4,29,33
03329401,PRYOR BEAUTY COLLEGE - GROVE BEAUTY COLL,OK,74345-0009,Proprietary  ,2,4,6,11,23,34
03329402,PRYOR BEAUTY COLLEGE - NORTH EAST OKLAHO,OK,74338-0000,Proprietary  ,1,5,6,5,25,30
03367400,COMMUNITY CARE COLLEGE                  ,OK,74145-6420,Proprietary  ,58,240,298,355,1319,1674
03396300,OKLAHOMA HEALTH ACADEMY                 ,OK,74105-6220,Proprietary  ,10,58,68,43,211,254
03396400,OKLAHOMA HEALTH ACADEMY                 ,OK,73160-3667,Proprietary  ,12,39,51,44,233,277
03453400,SHAWNEE BEAUTY COLLEGE                  ,OK,74801-7014,Proprietary  ,0,8,8,11,42,53
03676300,FAMILY OF FAITH COLLEGE                 ,OK,74802-1805,Private      ,1,4,5,9,14,23
03831300,INSTITUTE OF HAIR DESIGN                ,OK,74804-0000,Proprietary  ,1,13,14,11,51,62
03928300,CENTRAL STATE MASSAGE ACADEMY           ,OK,73162-6007,Proprietary  ,4,9,13,20,114,134
04027300,4-STATES ACADEMY OF COSMETOLOGY         ,OK,74354-0000,Proprietary  ,2,9,11,11,47,58
04060300,AMERICAN INSTITUTE OF MEDICAL TECHNOLOGY,OK,74136-5700,Proprietary  ,3,16,19,19,87,106
04062300,OKLAHOMA TECHNOLOGY INSTITUTE           ,OK,73114-6318,Proprietary  ,1,11,12,20,73,93
04121300,4-STATES OKMULGEE ACADEMY OF COSMETOLOGY,OK,74447-0000,Proprietary  ,3,7,10,16,34,50
04133600,CUTTER'S EDGE SCHOOL OF COSMETOLOGY     ,OK,74023-2905,Proprietary  ,0,0,0,2,10,12
00163700,BETHANY THEOLOGICAL SEMINARY            ,IN,47374-0000,Private      ,0,1,1,1,27,28
00178400,ANCILLA COLLEGE-FINANCIAL AID OFFC      ,IN,46513-0001,Private      ,11,52,63,459,479,938
00178500,ANDERSON UNIVERSITY                     ,IN,46012-3495,Private      ,22,49,71,2751,937,3688
00178600,BALL STATE UNIVERSITY                   ,IN,47306-0880,Public       ,196,290,486,18521,7756,26277
00178700,BETHEL COLLEGE INC                      ,IN,46545-5591,Private      ,12,77,89,1444,1274,2718
00178800,BUTLER UNIVERSITY                       ,IN,46208-3487,Private      ,31,57,88,5591,1237,6828
00178900,CHRISTIAN THEOLOGICAL SEMINARY          ,IN,46208-0000,Private      ,0,8,8,5,231,236
00179200,DEPAUW UNIVERSITY                       ,IN,46135-0037,Private      ,23,2,25,2834,56,2890
00179300,EARLHAM COLLEGE                         ,IN,47374-4095,Private      ,14,4,18,1560,134,1694
00179301,EARLHAM SCHOOL OF RELIGION              ,IN,47374-0000,Private      ,0,3,3,20,59,79
00179500,UNIVERSITY OF EVANSVILLE                ,IN,47722-0002,Private      ,19,14,33,3496,523,4019
00179800,FRANKLIN COLLEGE OF INDIANA             ,IN,46131-2623,Private      ,8,7,15,1729,135,1864
00179900,GOSHEN COLLEGE                          ,IN,46526-4794,Private      ,6,20,26,966,341,1307
00180000,GRACE COLLEGE & THEO SEMINARY           ,IN,46590-1224,Private      ,10,18,28,1443,700,2143
00180100,HANOVER COLLEGE                         ,IN,47243-0108,Private      ,9,0,9,1606,44,1650
00180300,HUNTINGTON UNIVERSITY                   ,IN,46750-1299,Private      ,5,22,27,1260,292,1552
00180400,UNIVERSITY OF INDIANAPOLIS              ,IN,46227-3697,Private      ,37,153,190,4565,2835,7400
00180500,INDIANA INSTITUTE OF TECHNOLOGY         ,IN,46803-1297,Private      ,23,277,300,1424,2747,4171
00180700,INDIANA STATE UNIVERSITY                ,IN,47809-2501,Public       ,99,213,312,8303,5500,13803
00180800,UNIVERSITY OF SOUTHERN INDIANA          ,IN,47712-3596,Public       ,88,149,237,7978,2992,10970
00180900,INDIANA UNIVERSITY-BLOOMINGTON          ,IN,47405-1223,Public       ,335,282,617,28284,10211,38495
00181100,INDIANA UNIV-EAST                       ,IN,47374-1289,Public       ,36,131,167,1097,1802,2899
00181300,INDIANA UNIV-PURDUE UNIV INDPLS         ,IN,46202-5145,Public       ,225,772,997,14239,18200,32439
00181301,INDIANA UNIVERSITY - PURDUE UNIVERSITY I,IN,47203-1769,Public       ,28,81,109,1097,1242,2339
00181400,INDIANA UNIV KOKOMO                     ,IN,46902-3557,Public       ,28,88,116,1399,1708,3107
00181500,INDIANA UNIV-NORTHWEST                  ,IN,46408-1197,Public       ,68,206,274,2406,3774,6180
00181600,INDIANA UNIVERSITY - SOUTH BEND         ,IN,46615-0000,Public       ,93,290,383,3796,4500,8296
00181700,INDIANA UNIVERSITY-SOUTHEAST            ,IN,47150-6405,Public       ,70,185,255,3393,3401,6794
00182000,MANCHESTER COLLEGE                      ,IN,46962-1276,Private      ,14,4,18,2093,111,2204
00182100,MARIAN COLLEGE  (INDIANAPOLIS)          ,IN,46222-1997,Private      ,24,74,98,1818,1600,3418
00182200,INDIANA WESLEYAN UNIVERSITY             ,IN,46953-4974,Private      ,42,1527,1569,3911,12684,16595
00182300,ASSOCIATED MENNONITE BIBLICAL SEM       ,IN,46517-1999,Private      ,0,1,1,1,84,85
00182400,OAKLAND CITY UNIVERSITY                 ,IN,47660-1099,Private      ,3,28,31,697,1974,2671
00182500,PURDUE UNIVERSITY                       ,IN,47907-2050,Public       ,251,196,447,29916,6566,36482
00182600,PURDUE UNIV NORTH CENTRAL CAMPUS        ,IN,46391-9528,Public       ,52,103,155,2238,2497,4735
00182700,PURDUE UNIV CALUMET                     ,IN,46323-2094,Public       ,116,219,335,5109,4853,9962
00182800,INDIANA UNIV-PURDUE UNIV FORT WAYNE     ,IN,46805-1499,Public       ,104,339,443,7627,6710,14337
00183000,ROSE HULMAN INSTITUTE OF TECHNOLOGY     ,IN,47803-3999,Private      ,5,4,9,2822,79,2901
00183200,UNIVERSITY OF SAINT FRANCIS             ,IN,46808-3994,Private      ,20,63,83,2059,1521,3580
00183300,ST JOSEPH'S COLLEGE                     ,IN,47978-0000,Private      ,15,5,20,1282,123,1405
00183400,CALUMET COLLEGE OF SAINT JOSEPH         ,IN,46394-2195,Private      ,13,64,77,453,873,1326
00183500,SAINT MARY-OF-THE-WOODS COLLEGE         ,IN,47876-0067,Private      ,4,102,106,431,1368,1799
00183600,ST MARY'S COLLEGE                       ,IN,46556-5007,Private      ,13,3,16,1763,52,1815
00183800,TAYLOR UNIVERSITY                       ,IN,46989-1001,Private      ,14,3,17,2231,174,2405
00183801,TAYLOR UNIVERSITY - FORT WAYNE          ,IN,46807-0000,Private      ,5,8,13,556,289,845
00183900,TRINE UNIVERSITY                        ,IN,46703-1764,Private      ,12,49,61,2205,676,2881
00184000,UNIVERSITY OF NOTRE DAME                ,IN,46556-5602,Private      ,79,59,138,11467,3110,14577
00184200,VALPARAISO UNIVERSITY                   ,IN,46383-6493,Private      ,27,37,64,3975,2000,5975
00184300,VINCENNES UNIVERSITY                    ,IN,47591-1523,Public       ,100,195,295,5346,3167,8513
00184400,WABASH COLLEGE                          ,IN,47933-0352,Private      ,6,2,8,1162,36,1198
00224905,DAVENPORT UNIVERSITY-MERRILLVILLE       ,IN,46410-0000,Private      ,0,15,15,64,448,512
00420300,GOOD SAMARITAN HOSP RADIOGRAPHY PRG     ,IN,47591-0000,Public       ,0,0,0,10,8,18
00457900,INTERNATIONAL BUSINESS COLLEGE          ,IN,46804-0000,Proprietary  ,14,32,46,669,275,944
00457901,INTERNATIONAL BUSINESS COLLEGE          ,IN,46256-0000,Proprietary  ,13,23,36,436,155,591
00458300,BROWN MACKIE COLLEGE-SOUTH BEND         ,IN,46617-3123,Proprietary  ,99,571,670,804,4224,5028
00458301,BROWN MACKIE COLLEGE-SOUTH BEND - BROWN ,IN,46805-0000,Proprietary  ,10,67,77,15,98,113
00512730,BROWN MACKIE COLLEGE-MERRILLVILLE       ,IN,46410-0000,Proprietary  ,5,24,29,265,1388,1653
00512731,BROWN MACKIE COLLEGE-CINCINNATI - BROWN ,IN,46360-4362,Proprietary  ,3,18,21,4,31,35
00625700,SAINT ELIZABETH SCHOOL OF NURSING       ,IN,47904-2198,Private      ,2,3,5,137,210,347
00726300,HOLY CROSS COLLEGE                      ,IN,46556-0308,Private      ,9,0,9,565,83,648
00727600,SAINT MEINRAD SCHOOL OF THEOLOGY        ,IN,47577-1002,Private      ,0,3,3,5,115,120
00732700,ITT TECHNICAL INSTITUTE                 ,IN,47630-7430,Proprietary  ,336,902,1238,2218,4514,6732
00732900,ITT TECHNICAL INSTITUTE                 ,IN,46268-1119,Proprietary  ,456,1793,2249,2650,9123,11773
00736200,MEDTECH COLLEGE                         ,IN,46250-3970,Proprietary  ,19,205,224,108,1042,1150
00736201,STUART SCHOOL OF BUSINESS ADMINISTRATION,IN,46250-2876,Proprietary  ,0,0,0,7,83,90
00736202,MEDTECH COLLEGE - STUART SCHOOL OF BUSIN,IN,46143-6478,Proprietary  ,23,120,143,82,540,622
00736204,MEDTECH COLLEGE - THE STUART SCHOOL     ,IN,46804-2209,Proprietary  ,7,99,106,15,173,188
00793800,LINCOLN COLLEGE OF TECHNOLOGY           ,IN,46202-0000,Proprietary  ,215,263,478,2224,1198,3422
00832900,ITT TECHNICAL INSTITUTE                 ,IN,46825-2393,Proprietary  ,287,759,1046,1926,4070,5996
00842300,IVY TECH COMMUNITY COLLEGE OF INDIANA - ,IN,46601-3892,Public       ,122,920,1042,2059,6723,8782
00854600,NOT FOR STUDENT USE                     ,IN,46208-4700,Public       ,0,3,3,1085,1657,2742
00854700,IVY TECH COMMUNITY COLLEGE OF INDIANA - ,IN,47802-4898,Public       ,96,418,514,1904,4535,6439
00951500,J MICHAEL HARROLD BEAUTY ACADEMY        ,IN,47807-3390,Proprietary  ,1,10,11,23,49,72
00961200,"APEX SCHOOL OF BEAUTY CULTURE, INC      ",IN,46016-0000,Proprietary  ,1,1,2,15,23,38
00961300,MERRILLVILLE BEAUTY COLLEGE             ,IN,46410-3401,Proprietary  ,7,31,38,40,125,165
00967300,RUDAE'S SCHOOL OF BEAUTY CULTURE        ,IN,46825-5444,Proprietary  ,12,26,38,82,170,252
00967301,RUDAE'S SCHOOL OF BEAUTY CULTURE - FORT ,IN,46825-5444,Proprietary  ,0,0,0,24,31,55
00977700,KAPLAN COLLEGE                          ,IN,46278-1736,Proprietary  ,99,438,537,498,1934,2432
00977701,KAPLAN COLLEGE - ADDITIONAL CLASSROOM   ,IN,46278-1734,Proprietary  ,0,0,0,5,29,34
00977702,KAPLAN COLLEGE - TEMPORARY FACILITY EXPA,IN,46268-4111,Proprietary  ,3,11,14,6,47,53
00977703,KAPLAN COLLEGE -  SE INDY               ,IN,46227-0000,Proprietary  ,3,16,19,3,16,19
00991700,IVY TECH COMMUNITY COLLEGE OF INDIANA - ,IN,46208-1763,Public       ,368,1438,1806,6180,13342,19522
00992300,IVY TECH COMMUNITY COLLEGE OF INDIANA - ,IN,47250-1881,Public       ,46,233,279,803,2006,2809
00992400,IVY TECH COMMUNITY COLLEGE OF INDIANA - ,IN,47302-9448,Public       ,141,614,755,2792,6127,8919
00992500,IVY TECH COMMUNITY COLLEGE OF INDIANA - ,IN,47710-3398,Public       ,74,329,403,1870,4041,5911
00992600,IVY TECH COMMUNITY COLLEGE OF INDIANA- R,IN,46805-1489,Public       ,198,862,1060,3492,8077,11569
01003700,IVY TECH STATE COLLEGE - REGION 9       ,IN,47374-1220,Public       ,62,332,394,872,3022,3894
01003800,IVY TECH COMMUNITY COLLEGE OF INDIANA - ,IN,47203-1868,Public       ,67,377,444,1185,3019,4204
01003900,IVY TECH COMMUNITY COLLEGE OF INDIANA - ,IN,47903-6299,Public       ,89,386,475,2630,4276,6906
01004000,IVY TECH COMMUNITY COLLEGE OF INDIANA - ,IN,46409-1303,Public       ,190,651,841,2059,5983,8042
01004100,IVY TECH STATE COLLEGE - REGION 5       ,IN,46903-1373,Public       ,73,460,533,1298,4200,5498
01010900,IVY TECH COMMUNITY COLLEGE OF INDIANA - ,IN,47172-1897,Public       ,62,238,300,1102,2745,3847
01015100,VINCENNES BEAUTY COLLEGE                ,IN,47591-1297,Proprietary  ,1,5,6,30,52,82
01040900,LAFAYETTE BEAUTY ACADEMY                ,IN,47901-1149,Proprietary  ,4,7,11,41,74,115
01061800,MID-AMERICA CLG FUNERAL SERVICE         ,IN,47130-9990,Private      ,4,15,19,47,92,139
01150500,CREATIVE HAIR STYLING ACADEMY           ,IN,46322-1554,Proprietary  ,5,7,12,51,75,126
02084800,RAVENSCROFT BEAUTY COLLEGE              ,IN,46815-0000,Proprietary  ,8,45,53,51,189,240
02087600,CONCORDIA THEOLOGICAL SEMINARY          ,IN,46825-0000,Private      ,0,10,10,3,273,276
02100402,EVEREST INSTITUTE - EVEREST COLLEGE     ,IN,46410-5683,Proprietary  ,44,227,271,273,1258,1531
02118900,EVANSVILLE TRI STATE BEAUTY COLLEGE     ,IN,47715-0000,Proprietary  ,0,0,0,15,16,31
02140800,MARTIN UNIVERSITY                       ,IN,46218-0000,Private      ,7,101,108,154,1270,1424
02158400,HARRISON COLLEGE                        ,IN,46204-2611,Proprietary  ,64,405,469,681,2968,3649
02158401,HARRISON COLLEGE - COLUMBUS             ,IN,47203-1843,Proprietary  ,7,52,59,95,416,511
02158402,HARRISON COLLEGE - LAFAYETTE            ,IN,47905-4859,Proprietary  ,8,43,51,136,472,608
02158404,HARRISON COLLEGE - MARION               ,IN,46952-0000,Proprietary  ,1,16,17,48,213,261
02158405,HARRISON COLLEGE - TERRE HAUTE          ,IN,47802-0000,Proprietary  ,6,42,48,84,466,550
02158407,HARRISON COLLEGE - ANDERSON             ,IN,46013-0000,Proprietary  ,4,50,54,97,400,497
02158409,HARRISON COLLEGE - EVANSVILLE           ,IN,47715-3901,Proprietary  ,4,32,36,116,445,561
02158410,HARRISON COLLEGE - EAST                 ,IN,46239-8903,Proprietary  ,16,97,113,200,957,1157
02158412,HARRISON COLLEGE - FORT WAYNE           ,IN,46825-0000,Proprietary  ,15,100,115,233,853,1086
02158413,HARRISON COLLEGE - NORTHWEST            ,IN,46278-0000,Proprietary  ,10,36,46,174,411,585
02158800,DON ROBERTS BEAUTY SCHOOLS              ,IN,46383-0000,Proprietary  ,5,10,15,22,37,59
02164300,DON ROBERTS SCHOOL OF HAIR DESIGN       ,IN,46375-9999,Proprietary  ,5,10,15,27,74,101
02201800,KAPLAN COLLEGE                          ,IN,46410-0000,Proprietary  ,16,83,99,135,690,825
02201802,KAPLAN COLLEGE - HAMMOND                ,IN,46324-3347,Proprietary  ,24,160,184,208,1014,1222
02241700,PJ'S COLLEGE OF COSMETOLOGY             ,IN,47129-0000,Proprietary  ,11,34,45,45,156,201
02302700,J EVERETT LIGHT CAREER CENTER           ,IN,46240-0000,Public       ,5,11,16,37,188,225
02304800,PJ'S COLLEGE OF COSMETOLOGY             ,IN,47374-0000,Proprietary  ,3,9,12,19,51,70
02308900,MASTER'S OF COSMETOLOGY COLLEGE         ,IN,46809-0000,Proprietary  ,4,9,13,56,63,119
02339600,ROGER'S ACADEMY OF HAIR DESIGN          ,IN,47712-0000,Proprietary  ,13,26,39,91,174,265
02345200,EMPIRE BEAUTY SCHOOL                    ,IN,46237-0000,Proprietary  ,13,43,56,111,286,397
02351300,KNOX BEAUTY COLLEGE                     ,IN,46534-0000,Proprietary  ,2,3,5,8,20,28
02490500,HAIR FASHIONS BY KAYE BEAUTY CLG        ,IN,46250-0000,Proprietary  ,2,5,7,26,62,88
02490800,HAIR FASHIONS BY KAYE BEAUTY CLG        ,IN,46060-0000,Proprietary  ,7,38,45,51,226,277
02607000,HAIR ARTS ACADEMY                       ,IN,47404-3581,Proprietary  ,4,7,11,26,56,82
02615800,COLLEGE OF COURT REPORTING              ,IN,46342-5969,Proprietary  ,2,22,24,22,348,370
02616203,BROWN MACKIE COLLEGE-FINDLAY - INDIANAPO,IN,46204-1017,Proprietary  ,43,221,264,164,1036,1200
03009700,HARRISON COLLEGE                        ,IN,47303-6413,Proprietary  ,7,36,43,108,422,530
03009701,HARRISON COLLEGE - MUNCIE - ELKHART     ,IN,46516-9795,Proprietary  ,3,73,76,85,373,458
03084601,THE ART INSTITUTE OF INDIANAPOLIS       ,IN,46268-1170,Proprietary  ,61,127,188,1009,987,1996
03100600,MARION COMM TUCKER AREA VOC SCHOOL      ,IN,46952-3831,Public       ,0,10,10,50,120,170
03176300,AMERICAN TRANS AIR AVIATION ACADEMY     ,IN,46241-1445,Proprietary  ,8,60,68,52,278,330
03262300,DAVID DEMUTH INSTITUTE OF COSM          ,IN,47374-4101,Proprietary  ,0,7,7,23,43,66
03456700,CROSSROADS BIBLE COLLEGE                ,IN,46219-4912,Private      ,1,16,17,58,220,278
03521300,IVY TECH COMMUNITY COLLEGE OF INDIANA - ,IN,47404-9772,Public       ,103,347,450,2660,3843,6503
03538300,ALEXANDRIA SCH OF SCIENTIFIC THERAP     ,IN,46001-0287,Proprietary  ,0,1,1,24,53,77
04038700,IDEAL BEAUTY ACADEMY                    ,IN,47130-4215,Proprietary  ,5,15,20,17,67,84
04100300,SUCCESS SCHOOLS                         ,IN,46410-5310,Proprietary  ,3,23,26,27,124,151
04119700,MOLER HAIRSTYLING COLLEGE               ,IN,46406-1745,Proprietary  ,0,0,0,4,51,55
04121000,TECHSKILLS - INDIANAPOLIS               ,IN,46240-4302,Proprietary  ,2,54,56,13,195,208
04130900,HONORS BEAUTY COLLEGE                   ,IN,46256-3317,Proprietary  ,4,28,32,55,163,218
00163203,AQUINAS INSTITUTE OF THEOLOGY - MINISTRY,KS,66109-3718,Private      ,0,0,0,0,4,4
00190100,ALLEN COUNTY COMMUNITY COLLEGE          ,KS,66749-1607,Public       ,46,113,159,860,1133,1993
00190200,COWLEY COUNTY COMMUNITY COLLEGE & AREA V,KS,67005-2662,Public       ,81,189,270,1474,2115,3589
00190300,BAKER UNIVERSITY                        ,KS,66006-0065,Private      ,25,316,341,1486,2784,4270
00190400,BETHANY COLLEGE                         ,KS,67456-1897,Private      ,8,2,10,804,109,913
00190500,BETHEL COLLEGE                          ,KS,67117-0531,Private      ,4,0,4,510,136,646
00190600,BUTLER COUNTY COMMUNITY COLLEGE         ,KS,67042-3280,Public       ,152,323,475,3056,3744,6800
00190700,CENTRAL BAPTIST THEOLOGY SEMINARY       ,KS,66226-3513,Private      ,0,2,2,0,33,33
00190800,CENTRAL CHRISTIAN COLLEGE OF KANSAS     ,KS,67460-5799,Private      ,2,0,2,442,62,504
00190900,CLOUD COUNTY COMMUNITY COLLEGE          ,KS,66901-1002,Public       ,20,87,107,699,827,1526
00191000,COFFEYVILLE COMMUNITY COLLEGE           ,KS,67337-5064,Public       ,58,33,91,975,382,1357
00191100,COLBY COMMUNITY COLLEGE                 ,KS,67701-4099,Public       ,23,31,54,600,335,935
00191300,DODGE CITY COMMUNITY COLLEGE            ,KS,67801-2399,Public       ,48,48,96,528,407,935
00191400,DONNELLY COLLEGE                        ,KS,66102-4298,Private      ,18,125,143,218,742,960
00191500,FORT HAYS STATE UNIVERSITY              ,KS,67601-4099,Public       ,43,166,209,3274,3479,6753
00191600,FORT SCOTT COMMUNITY COLLEGE            ,KS,66701-3199,Public       ,42,50,92,1106,728,1834
00191700,BARCLAY COLLEGE                         ,KS,67059-0288,Private      ,3,5,8,109,62,171
00191800,FRIENDS UNIVERSITY                      ,KS,67213-3397,Private      ,19,172,191,1211,2626,3837
00191900,GARDEN CITY COMMUNITY COLLEGE           ,KS,67846-6398,Public       ,43,47,90,809,536,1345
00192000,HESSTON COLLEGE                         ,KS,67062-2093,Private      ,5,4,9,437,163,600
00192100,HIGHLAND COMMUNITY COLLEGE              ,KS,66035-4062,Public       ,43,72,115,1113,893,2006
00192114,HIGHLAND COMMUNITY COLLEGE - NOTHEAST KA,KS,66002-1513,Public       ,3,8,11,74,137,211
00192300,HUTCHINSON COMMUNITY COLLEGE            ,KS,67501-5894,Public       ,77,147,224,1749,1808,3557
00192400,INDEPENDENCE COMMUNITY COLLEGE          ,KS,67301-0000,Public       ,32,39,71,472,306,778
00192500,KANSAS CITY KANSAS COMMUNITY CLG        ,KS,66112-9978,Public       ,115,329,444,1483,3283,4766
00192502,"KANSAS CITY KS AREA TECH SCHOOL, KS     ",KS,66104-0000,Public       ,7,25,32,146,354,500
00192600,PITTSBURG STATE UNIVERSITY              ,KS,66762-7500,Public       ,89,97,186,4293,2436,6729
00192700,EMPORIA STATE UNIVERSITY                ,KS,66801-5087,Public       ,51,96,147,3298,2580,5878
00192800,KANSAS STATE UNIVERSITY                 ,KS,66506-1104,Public       ,213,203,416,14176,5412,19588
00192900,KANSAS WESLEYAN UNIVERSITY              ,KS,67401-6196,Private      ,11,13,24,850,377,1227
00193000,LABETTE COMMUNITY COLLEGE               ,KS,67357-4299,Public       ,18,57,75,548,718,1266
00193100,MANHATTAN CHRISTIAN COLLEGE             ,KS,66502-4081,Private      ,4,7,11,339,124,463
00193300,MCPHERSON COLLEGE                       ,KS,67460-3899,Private      ,11,9,20,665,145,810
00193600,NEOSHO COUNTY COMMUNITY COLLEGE         ,KS,66720-2699,Public       ,12,60,72,568,716,1284
00193700,OTTAWA UNIVERSITY                       ,KS,66067-3399,Private      ,23,349,372,1049,2471,3520
00193800,PRATT COMMUNITY COLLEGE                 ,KS,67124-8432,Public       ,15,38,53,522,441,963
00193900,NEWMAN UNIVERSITY                       ,KS,67213-2084,Private      ,18,65,83,883,1236,2119
00194000,SOUTHWESTERN COLLEGE                    ,KS,67156-2499,Private      ,7,104,111,673,1133,1806
00194300,UNIVERSITY OF ST MARY                   ,KS,66048-5023,Private      ,7,46,53,555,565,1120
00194500,STERLING COLLEGE                        ,KS,67579-1533,Private      ,9,10,19,825,166,991
00194600,TABOR COLLEGE                           ,KS,67063-1799,Private      ,12,19,31,675,172,847
00194800,UNIVERSITY OF KANSAS                    ,KS,66045-7535,Public       ,265,252,517,15003,8847,23850
00194900,WASHBURN UNIVERSITY                     ,KS,66621-1110,Public       ,74,171,245,3073,4152,7225
00195000,WICHITA STATE UNIVERSITY                ,KS,67208-0001,Public       ,154,283,437,6018,6806,12824
00460800,BARTON COUNTY COMMUNITY COLLEGE         ,KS,67530-9283,Public       ,27,127,154,736,1134,1870
00526400,FLINT HILLS TECHNICAL COLLEGE           ,KS,66801-5999,Public       ,7,14,21,188,325,513
00526500,NORTH CENTRAL KANSAS TECH COLG          ,KS,67420-0000,Public       ,7,8,15,330,196,526
00526700,NORTHWEST KANSAS TECHNICAL SCHOOL       ,KS,67735-3441,Public       ,4,2,6,202,94,296
00549800,WICHITA AREA TECHNICAL COLLEGE          ,KS,67211-2099,Public       ,49,217,266,440,1536,1976
00549900,SALINA AREA TECHNICAL COLLEGE           ,KS,67401-8195,Public       ,5,2,7,151,116,267
00550000,MANHATTAN AREA TECHNICAL COLLEGE        ,KS,66503-2499,Public       ,10,21,31,259,308,567
00675500,BROWN MACKIE COLLEGE (THE)              ,KS,67401-7307,Proprietary  ,23,182,205,287,1333,1620
00703200,MID AMERICA NAZARENE UNIVERSITY         ,KS,66062-1899,Private      ,9,69,78,1018,906,1924
00817200,SOUTHWEST KANSAS TECHNICAL SCHOOL       ,KS,67905-2013,Public       ,0,0,0,40,15,55
00822800,SEWARD CO COMM CO/AREA TECHNICAL SCHOOL ,KS,67905-0000,Public       ,19,30,49,388,361,749
00824400,JOHNSON COUNTY COMMUNITY COLLEGE        ,KS,66210-1299,Public       ,167,339,506,4378,5411,9789
00833200,B-STREET DESIGN SCHOOL OF INTERNATIONAL ,KS,66502-6082,Proprietary  ,3,11,14,28,78,106
00868200,ACADEMY OF HAIR DESIGN                  ,KS,67401-2803,Proprietary  ,3,8,11,28,44,72
01025600,BENEDICTINE COLLEGE                     ,KS,66002-1499,Private      ,18,8,26,1755,145,1900
01043800,HASKELL INDIAN NATIONS UNIVERSITY       ,KS,66046-4800,Public       ,29,38,67,817,631,1448
01050300,WICHITA TECHNICAL INSTITUTE             ,KS,67213-1927,Proprietary  ,58,476,534,361,2287,2648
01068900,KAW AREA TECHNICAL SCHOOL               ,KS,66604-2199,Public       ,7,19,26,164,387,551
02090700,CLEVELAND CHIROPRACTIC COLLEGE          ,KS,66210-1613,Private      ,2,13,15,55,584,639
02134800,OLD TOWN BARBER AND BEAUTY COLLEGE      ,KS,67211-0000,Proprietary  ,6,11,17,23,89,112
02196400,CAPITOL CITY HAIR DESIGN COLLEGE        ,KS,66102-0000,Proprietary  ,11,35,46,39,196,235
02257700,HAYS ACADEMY OF HAIR DESIGN             ,KS,67601-0000,Proprietary  ,1,2,3,34,47,81
02303500,AMERICAN INSTITUTE OF BAKING            ,KS,66502-0000,Private      ,1,1,2,7,12,19
02340700,LABARON HAIRDRESSING ACADEMY            ,KS,66204-0000,Proprietary  ,2,12,14,16,65,81
02590900,WRIGHT CAREER COLLEGE                   ,KS,66212-0000,Private      ,58,359,417,262,1974,2236
02599709,VATTEROTT COLLEGE - WICHITA             ,KS,67226-1304,Proprietary  ,14,90,104,75,508,583
02603100,XENON INTERNATIONAL ACADEMY             ,KS,67203-5428,Proprietary  ,22,33,55,159,193,352
02606300,VERNON'S KANSAS SCHOOL OF COSMETOLOGY   ,KS,67217-2803,Proprietary  ,9,16,25,26,67,93
02611005,HERITAGE COLLEGE - WICHITA              ,KS,67210-1879,Proprietary  ,61,248,309,180,760,940
02613000,PINNACLE CAREER INSTITUTE               ,KS,66046-2703,Proprietary  ,7,43,50,61,282,343
03031300,XENON INTERNATIONAL ACADEMY IV          ,KS,66061-3765,Proprietary  ,8,18,26,42,82,124
03066200,BRYAN COLLEGE                           ,KS,66604-2496,Proprietary  ,3,43,46,53,296,349
03450300,B-STREET DESIGN SCHOOL OF INTERNATIONAL ,KS,66611-2373,Proprietary  ,11,19,30,47,106,153
03450301,B-STREET DESIGN SCHOOL OF INTERNATIONAL ,KS,67207-5148,Proprietary  ,7,25,32,35,90,125
03450302,B-STREET DESIGN SCHOOL OF INTERNATIONAL ,KS,66212-5451,Proprietary  ,10,31,41,63,127,190
03529300,SIDNEY'S HAIRDRESSING COLLEGE           ,KS,67501-7094,Proprietary  ,9,6,15,36,61,97
03862300,BMSI INSTITUTE                          ,KS,66212-3388,Proprietary  ,0,1,1,1,12,13
04132900,Z HAIR ACADEMY                          ,KS,66046-4040,Proprietary  ,4,6,10,17,35,52
00203300,UNIVERSITY OF MAINE-PRESQUE ISLE        ,ME,04769-2888,Public       ,12,14,26,716,442,1158
00203500,BANGOR THEOLOGICAL SEMINARY             ,ME,04402-0411,Private      ,0,0,0,1,87,88
00203600,BATES COLLEGE                           ,ME,04240-6028,Private      ,25,0,25,2746,42,2788
00203800,BOWDOIN COLLEGE                         ,ME,04011-8451,Private      ,30,0,30,3478,49,3527
00203900,COLBY COLLEGE                           ,ME,04901-8841,Private      ,15,1,16,2719,40,2759
00204000,UNIVERSITY OF MAINE-FARMINGTON          ,ME,04938-1990,Public       ,14,7,21,2651,412,3063
00204100,UNIVERSITY OF MAINE-FORT KENT           ,ME,04743-1292,Public       ,10,8,18,488,284,772
00204300,HUSSON UNIVERSITY                       ,ME,04401-2999,Private      ,29,39,68,2230,921,3151
00204400,MAINE MARITIME ACADEMY                  ,ME,04420-0001,Public       ,6,4,10,893,117,1010
00205000,UNIVERSITY OF NEW ENGLAND               ,ME,04005-9599,Private      ,27,78,105,3590,2210,5800
00205100,SAINT JOSEPH'S COLLEGE                  ,ME,04084-5263,Private      ,13,52,65,1641,427,2068
00205200,THOMAS COLLEGE                          ,ME,04901-5097,Private      ,6,10,16,920,153,1073
00205300,UNIVERSITY OF MAINE                     ,ME,04469-0001,Public       ,80,75,155,10595,2861,13456
00205400,UNIVERSITY OF SOUTHERN MAINE            ,ME,04104-0000,Public       ,84,127,211,6172,4455,10627
00205500,UNIVERSITY OF MAINE-MACHIAS             ,ME,04654-1397,Public       ,11,12,23,542,255,797
00520400,BEAL COLLEGE                            ,ME,04401-6896,Proprietary  ,6,63,69,197,524,721
00527600,CENTRAL MAINE COMMUNITY COLLEGE         ,ME,04210-6498,Public       ,26,37,63,1386,1275,2661
00527700,EASTERN MAINE COMMUNITY COLLEGE         ,ME,04401-4280,Public       ,21,32,53,1409,1041,2450
00552500,SOUTHERN MAINE COMMUNITY  COLLEGE       ,ME,04106-1698,Public       ,82,89,171,2746,2389,5135
00576000,NORTHERN MAINE COMMUNITY COLLEGE        ,ME,04769-2016,Public       ,11,63,74,500,610,1110
00577600,MERCY HOSP SCH OF RADIOLOGIC TECH       ,ME,04101-3795,Private      ,0,3,3,8,32,40
00630501,CENTRAL MAINE MEDICAL CENTER - COLLEGE O,ME,04240-4500,Private      ,1,4,5,32,192,224
00676000,UNIVERSITY OF MAINE-AUGUSTA             ,ME,04330-9410,Public       ,31,113,144,1632,4415,6047
00685800,UNITY COLLEGE                           ,ME,04988-9502,Private      ,4,1,5,850,76,926
00903800,MR BERNARD'S SCH HAIR FASHION INC       ,ME,04243-1163,Proprietary  ,7,22,29,42,127,169
00923100,WASHINGTON COUNTY COMMUNITY COLLEGE     ,ME,04619-9704,Public       ,8,13,21,238,225,463
00929200,ANDOVER COLLEGE                         ,ME,04106-2415,Proprietary  ,26,119,145,216,802,1018
00929201,ANDOVER COLLEGE -                       ,ME,04240-0000,Proprietary  ,34,158,192,196,943,1139
00945900,PIERRE'S SCHOOL OF COSMETOLOGY          ,ME,04101-3348,Proprietary  ,24,51,75,201,320,521
00945901,PIERRE'S SCHOOL OF COSMETOLOGY - SANFORD,ME,04073-3564,Proprietary  ,0,0,0,1,4,5
00945902,PIERRE'S SCHOOL OF COSMETOLOGY - CARIBOU,ME,04736-2020,Proprietary  ,1,2,3,8,5,13
00945903,PIERRE'S SCHOOL OF COSMETOLOGY - BANGOR ,ME,04401-6534,Proprietary  ,2,3,5,20,24,44
00982600,KENNEBEC VALLEY  COMMUNITY  COLLEGE     ,ME,04937-1367,Public       ,11,53,64,664,1353,2017
01138500,COLLEGE OF THE ATLANTIC                 ,ME,04609-1105,Private      ,1,1,2,445,60,505
01167300,MAINE COLLEGE OF ART                    ,ME,04101-3987,Private      ,6,3,9,545,156,701
02104400,SPA TECH INSTITUTE                      ,ME,04102-0000,Proprietary  ,17,72,89,181,469,650
02347100,NEW ENGLAND SCHOOL OF COMMUNICATIONS    ,ME,04401-0000,Private      ,6,0,6,496,87,583
02361300,LANDING SCHOOL OF BOATBUILDING & DESIGN ,ME,04046-1490,Private      ,0,0,0,30,35,65
03122900,YORK COUNTY COMMUNITY COLLEGE           ,ME,04090-0529,Public       ,17,41,58,431,474,905
03429300,SEACOAST CAREER SCHOOLS                 ,ME,04073-0000,Proprietary  ,36,215,251,162,776,938
03612300,BIRTHWISE MIDWIFERY SCHOOL              ,ME,04009-1110,Proprietary  ,0,1,1,6,41,47
00209300,ST JOHN'S COLLEGE                       ,NM,87505-4599,Private      ,5,10,15,489,199,688
00264900,COLLEGE OF SANTA FE                     ,NM,87505-7634,Private      ,8,39,47,771,708,1479
00265000,UNIVERSITY OF THE SOUTHWEST             ,NM,88240-9129,Private      ,7,28,35,324,414,738
00265100,EASTERN NEW MEXICO UNIV PORTALES        ,NM,88130-6000,Public       ,65,133,198,2416,2153,4569
00265101,EASTERN NEW MEXICO UNIV-ROSWELL CAM     ,NM,88202-0000,Public       ,45,98,143,953,1366,2319
00265300,NEW MEXICO HIGHLANDS UNIVERSITY         ,NM,87701-4436,Public       ,40,69,109,1514,1932,3446
00265400,NEW MEXICO INST OF MINING & TECH        ,NM,87801-4796,Public       ,32,15,47,980,303,1283
00265500,NEW MEXICO JUNIOR COLLEGE               ,NM,88240-9123,Public       ,28,59,87,677,753,1430
00265600,NEW MEXICO MILITARY INSTITUTE           ,NM,88201-5173,Public       ,3,0,3,294,22,316
00265700,NEW MEXICO STATE UNIVERSITY             ,NM,88003-8001,Public       ,258,357,615,9746,7727,17473
00265701,NEW MEXICO STATE UNIV-ALAMOGORDO        ,NM,88311-0000,Public       ,13,91,104,398,1028,1426
00265702,NEW MEXICO STATE UNIV.-DONA ANA CLG     ,NM,88003-0000,Public       ,95,166,261,1805,2768,4573
00265703,NEW MEXICO STATE UNIV-CARLSBAD          ,NM,88220-0000,Public       ,21,54,75,297,644,941
00265704,NEW MEXICO STATE UNIV-GRANTS            ,NM,87020-0000,Public       ,18,40,58,187,388,575
00266000,SAN JUAN COLLEGE                        ,NM,87402-4699,Public       ,91,235,326,1365,2600,3965
00266300,THE UNIVERSITY OF NEW MEXICO            ,NM,87131-0001,Public       ,493,719,1212,12428,13469,25897
00266301,UNIV OF NEW MEXICO - GALLUP BRANCH      ,NM,87301-5697,Public       ,23,52,75,399,730,1129
00266302,UNIV OF NEW MEXICO - VALENCIA BRANCH    ,NM,87031-0000,Public       ,17,42,59,295,405,700
00266303,UNIV OF NEW MEXICO - LOS ALAMOS         ,NM,87544-0000,Public       ,7,16,23,99,106,205
00266304,UNIVERSITY OF NEW MEXICO                ,NM,87571-6401,Public       ,9,16,25,12,31,43
00266400,WESTERN NEW MEXICO UNIVERSITY           ,NM,88061-5417,Public       ,29,192,221,957,1618,2575
00369109,MIDDLEBURY COLLEGE - INSTITUTE OF AMERIC,NM,87505-0000,Private      ,0,0,0,1,0,1
00405701,NATIONAL AMERICAN UNIVERSITY            ,NM,87110-0000,Proprietary  ,1,19,20,24,346,370
00474200,CENTRAL NEW MEXICO COMMUNITY COLLEGE    ,NM,87106-4096,Public       ,370,1360,1730,5793,12779,18572
00474300,CLOVIS COMMUNITY COLLEGE                ,NM,88101-8381,Public       ,43,144,187,546,1457,2003
00996200,LUNA COMMUNITY COLLEGE                  ,NM,87701-0000,Public       ,20,44,64,380,484,864
01063200,DEWOLFF CLG HAIRSTYLING/COSMETOLOGY     ,NM,87112-4113,Proprietary  ,3,25,28,41,134,175
01300500,OLYMPIAN UNIVERSITY OF COSMETOLOGY      ,NM,88310-5051,Proprietary  ,62,141,203,393,925,1318
02083900,NORTHERN NEW MEXICO COLLEGE             ,NM,87530-0000,Public       ,30,60,90,547,924,1471
02146400,INSTITUTE OF AMERICAN INDIAN ARTS       ,NM,87508-0000,Public       ,4,5,9,176,206,382
02151102,ATI COLLEGE OF HEALTH - ATI CAREER TRAIN,NM,87109-2016,Proprietary  ,1,8,9,12,45,57
02218808,IIA COLLEGE - ALBUQUERQUE               ,NM,87105-1649,Proprietary  ,1,1,2,1,1,2
02278100,SANTA FE COMMUNITY COLLEGE              ,NM,87507-0000,Public       ,42,113,155,642,1320,1962
02357600,CROWNPOINT INSTITUTE OF TECHNOLOGY      ,NM,87313-0000,Public       ,29,70,99,238,486,724
02491501,THE ART CENTER DESIGN COLLEGE- ALBQ     ,NM,87110-0000,Proprietary  ,0,0,0,42,22,64
02511000,SOUTHWESTERN INDIAN POLYTECH INST       ,NM,87184-0000,Public       ,25,58,83,291,389,680
02572003,COMPUTER CAREER CENTER - LAS CRUCES CAMP,NM,88011-8220,Proprietary  ,5,53,58,6,68,74
02622000,SOUTHWEST ACUPUNCTURE COLLEGE           ,NM,87505-0000,Proprietary  ,0,6,6,5,301,306
03076100,SOUTHWESTERN COLLEGE                    ,NM,87507-0000,Private      ,0,9,9,2,157,159
03128200,KAPLAN CAREER INSTITUTE                 ,NM,87109-2072,Proprietary  ,0,0,0,10,37,47
03128201,KAPLAN CAREER INSTITUTE                 ,NM,87109-0000,Proprietary  ,0,0,0,2,10,12
03206300,MESALANDS COMMUNITY COLLEGE             ,NM,88401-3352,Public       ,11,26,37,151,237,388
03430300,UNIVERSAL THERAPEUTIC MASSAGE INSTITUTE ,NM,87107-4403,Proprietary  ,8,36,44,41,138,179
03678300,PIMA MEDICAL INSTITUTE                  ,NM,87110-4127,Proprietary  ,3,25,28,43,107,150
03944300,MASSAGE THERAPY TRAINING INSTITUTE      ,NM,88007-0000,Proprietary  ,1,4,5,26,39,65
00223400,ADRIAN COLLEGE                          ,MI,49221-2575,Private      ,23,9,32,2525,224,2749
00223500,ALBION COLLEGE                          ,MI,49224-1831,Private      ,17,4,21,2295,69,2364
00223600,ALMA COLLEGE                            ,MI,48801-1599,Private      ,11,4,15,2166,104,2270
00223700,ALPENA COMMUNITY COLLEGE                ,MI,49707-1495,Public       ,43,84,127,1078,1167,2245
00223800,ANDREWS UNIVERSITY                      ,MI,49104-0750,Private      ,46,54,100,1627,1190,2817
00223900,AQUINAS COLLEGE                         ,MI,49506-1799,Private      ,17,40,57,2208,679,2887
00224000,BAY DE NOC COMMUNITY COLLEGE            ,MI,49829-2524,Public       ,32,81,113,1149,1336,2485
00224100,CALVIN COLLEGE                          ,MI,49546-4388,Private      ,38,12,50,4010,280,4290
00224200,CALVIN THEOLOGICAL SEMINARY             ,MI,49546-4387,Private      ,0,1,1,14,178,192
00224300,CENTRAL MICHIGAN UNIVERSITY             ,MI,48859-0001,Public       ,259,542,801,19488,9304,28792
00224600,CLEARY UNIVERSITY                       ,MI,48105-2659,Private      ,11,80,91,213,804,1017
00224700,CONCORDIA UNIVERSITY-ANN ARBOR          ,MI,48105-2797,Private      ,7,43,50,550,516,1066
00224800,CRANBROOK ACADEMY OF ART                ,MI,48303-0000,Private      ,0,3,3,19,226,245
00224900,DAVENPORT UNIVERSITY                    ,MI,49503-0000,Private      ,119,1073,1192,3249,13017,16266
00225100,DELTA COLLEGE                           ,MI,48710-0001,Public       ,183,619,802,5711,7335,13046
00225400,MICHIGAN STATE UNIVERSITY COLLEGE OF LAW,MI,48824-1300,Private      ,5,13,18,333,1573,1906
00225900,EASTERN MICHIGAN UNIVERSITY             ,MI,48197-2214,Public       ,319,552,871,13618,10941,24559
00226000,FERRIS STATE UNIVERSITY                 ,MI,49307-2251,Public       ,162,214,376,11925,5785,17710
00226100,CHARLES STEWART MOTT COMMUNITY CLG      ,MI,48503-2089,Public       ,262,928,1190,5201,9800,15001
00226200,KETTERING UNIVERSITY                    ,MI,48504-4898,Private      ,35,34,69,2310,337,2647
00226300,GLEN OAKS COMMUNITY COLLEGE             ,MI,49032-9784,Public       ,24,120,144,530,1027,1557
00226400,GOGEBIC COMMUNITY COLLEGE               ,MI,49938-1365,Public       ,15,36,51,552,564,1116
00226500,GRACE BIBLE COLLEGE                     ,MI,49509-1998,Private      ,5,1,6,228,60,288
00226600,CORNERSTONE UNIVERSITY                  ,MI,49525-5897,Private      ,14,175,189,1453,1769,3222
00226700,GRAND RAPIDS COMMUNITY COLLEGE          ,MI,49503-3295,Public       ,255,806,1061,8906,9333,18239
00226800,GRAND VALLEY STATE UNIVERSITY           ,MI,49401-9403,Public       ,214,301,515,19906,7044,26950
00226900,GREAT LAKES CHRISTIAN COLLEGE           ,MI,48917-1299,Private      ,3,4,7,181,148,329
00227000,HENRY FORD COMMUNITY COLLEGE            ,MI,48128-1495,Public       ,392,802,1194,8399,11953,20352
00227300,HOPE COLLEGE                            ,MI,49423-3607,Private      ,19,4,23,3867,154,4021
00227400,JACKSON COMMUNITY COLLEGE               ,MI,49201-8399,Public       ,126,578,704,3403,5416,8819
00227500,KALAMAZOO COLLEGE                       ,MI,49006-3295,Private      ,14,6,20,1777,90,1867
00227600,KELLOGG COMMUNITY COLLEGE               ,MI,49017-3397,Public       ,79,383,462,2168,4454,6622
00227700,LAKE MICHIGAN COLLEGE                   ,MI,49022-1899,Public       ,60,267,327,1510,2647,4157
00227800,LANSING COMMUNITY COLLEGE               ,MI,48933-1293,Public       ,305,869,1174,7170,10915,18085
00227900,LAWRENCE TECHNOLOGICAL UNIVERSITY       ,MI,48075-1058,Private      ,27,132,159,1803,1505,3308
00228200,MADONNA UNIVERSITY                      ,MI,48150-1173,Private      ,26,178,204,1394,2671,4065
00228400,MARYGROVE COLLEGE                       ,MI,48221-2599,Private      ,21,247,268,671,2995,3666
00228800,ROCHESTER COLLEGE                       ,MI,48307-2764,Private      ,15,49,64,636,688,1324
00228801,ROCHESTER COLLEGE - MACOMB COMMUNITY COL,MI,48038-1139,Private      ,22,48,70,76,159,235
00228802,ROCHESTER COLLEGE - MOTT COMMUNITY COLLE,MI,48503-2089,Private      ,14,37,51,25,79,104
00228803,ROCHESTER COLLEGE  - SPECS HOWARD       ,MI,48075-3953,Private      ,0,5,5,2,9,11
00229000,MICHIGAN STATE UNIVERSITY               ,MI,48824-1113,Public       ,523,465,988,32520,10834,43354
00229200,MICHIGAN TECHNOLOGICAL UNIV             ,MI,49931-1295,Public       ,44,30,74,5782,870,6652
00229300,LAKE SUPERIOR STATE UNIVERSITY          ,MI,49783-1691,Public       ,22,28,50,2343,912,3255
00229400,MONROE COUNTY COMMUNITY CLG             ,MI,48161-9746,Public       ,47,179,226,1363,1937,3300
00229500,MONTCALM COMMUNITY COLLEGE              ,MI,48885-9723,Public       ,32,143,175,895,1927,2822
00229700,MUSKEGON COMMUNITY COLLEGE              ,MI,49442-1432,Public       ,105,375,480,2754,3429,6183
00229900,NORTH CENTRAL MICHIGAN COLLEGE          ,MI,49770-8740,Public       ,30,91,121,979,1722,2701
00230100,NORTHERN MICHIGAN UNIVERSITY            ,MI,49855-5316,Public       ,98,120,218,7377,2730,10107
00230200,NORTHWESTERN MICHIGAN COLLEGE           ,MI,49686-3061,Public       ,87,171,258,2364,2654,5018
00230300,OAKLAND COMMUNITY COLLEGE               ,MI,48304-2266,Public       ,0,15,15,305,432,737
00230301,OAKLAND COMMUNITY COLLEGE - ORCHARD RIDG,MI,48334-4579,Public       ,87,217,304,1749,2447,4196
00230302,OAKLAND COMMUNITY COLLEGE - ROYAL OAK CA,MI,48067-3898,Public       ,99,308,407,2415,4336,6751
00230303,OAKLAND COMMUNITY COLLEGE - SOUTHFIELD C,MI,48075-4793,Public       ,127,380,507,1065,2719,3784
00230304,OAKLAND COMMUNITY COLLEGE - AUBURN HILLS,MI,48323-2845,Public       ,96,402,498,2335,3697,6032
00230305,OAKLAND COMMUNITY COLLEGE - HIGHLAND LAK,MI,48327-4187,Public       ,47,183,230,1223,2173,3396
00230700,OAKLAND UNIVERSITY                      ,MI,48309-4401,Public       ,280,452,732,11038,7436,18474
00230800,OLIVET COLLEGE                          ,MI,49076-9902,Private      ,15,7,22,1460,307,1767
00231000,ST. CLAIR COUNTY COMMUNITY COLLEGE      ,MI,48061-0000,Public       ,60,285,345,1922,3021,4943
00231100,KUYPER COLLEGE                          ,MI,49525-9749,Private      ,3,3,6,338,125,463
00231300,SACRED HEART MAJOR SEMINARY             ,MI,48206-1799,Private      ,0,6,6,14,164,178
00231400,SAGINAW VALLEY STATE UNIV               ,MI,48710-0001,Public       ,95,202,297,7858,3588,11446
00231500,SCHOOLCRAFT COLLEGE                     ,MI,48152-2696,Public       ,184,503,687,4635,6448,11083
00231600,SIENA HEIGHTS UNIVERSITY                ,MI,49221-1796,Private      ,10,83,93,1040,1512,2552
00231700,SOUTHWESTERN MICHIGAN COLLEGE           ,MI,49047-9793,Public       ,49,246,295,1197,2033,3230
00231800,SPRING ARBOR UNIVERSITY                 ,MI,49283-9984,Private      ,18,308,326,2139,3477,5616
00232200,FINLANDIA UNIVERSITY                    ,MI,49930-1882,Private      ,4,14,18,507,266,773
00232300,UNIVERSITY OF DETROIT MERCY             ,MI,48221-3038,Private      ,50,145,195,3080,3702,6782
00232301,UNIVERSITY OF DETROIT MERCY- DENTAL SCH ,MI,48219-3580,Private      ,0,0,0,41,172,213
00232303,UNIV OF DETROIT MERCY - LAW SCHOOL      ,MI,48226-0000,Private      ,1,12,13,25,938,963
00232330,UNIV OF DETROIT MERCY - DENTAL SCHOOL   ,MI,48208-2576,Private      ,1,8,9,35,287,322
00232500,UNIVERSITY OF MICHIGAN - ANN ARBOR      ,MI,48109-1316,Public       ,320,268,588,25588,10499,36087
00232501,UNIVERSITY OF MICHIGAN-MEDICAL SCH      ,MI,48109-0000,Public       ,6,11,17,161,1037,1198
00232503,UNIVERSITY OF MICHIGAN LAW SCHOOL       ,MI,48109-0000,Public       ,1,10,11,37,2974,3011
00232600,UNIVERSITY OF MICHIGAN-DEARBORN         ,MI,48128-2406,Public       ,138,236,374,4766,4331,9097
00232700,UNIVERSITY OF MICHIGAN-FLINT            ,MI,48502-1950,Public       ,111,278,389,3629,5137,8766
00232800,WASHTENAW COMMUNITY COLLEGE             ,MI,48106-0000,Public       ,218,625,843,4119,6670,10789
00232900,WAYNE STATE UNIVERSITY                  ,MI,48202-0000,Public       ,512,902,1414,15908,19112,35020
00232901,WAYNE STATE UNIV SCH OF MEDICINE        ,MI,48201-3359,Public       ,8,19,27,208,1436,1644
00232902,WAYNE STATE UNIVERSITY - LAW SCHOOL     ,MI,48202-3424,Public       ,4,31,35,144,1385,1529
00233000,WESTERN MICHIGAN UNIVERSITY             ,MI,49008-3899,Public       ,288,275,563,17576,7870,25446
00233100,WESTERN THEOLOGICAL SEMINARY            ,MI,49423-0000,Private      ,0,4,4,0,121,121
00407100,WALSH COLLEGE OF ACCT & BUS ADMN        ,MI,48007-7006,Private      ,13,235,248,258,2304,2562
00407200,NORTHWOOD UNIVERSITY                    ,MI,48640-2398,Private      ,29,108,137,2402,1696,4098
00467300,BAKER COLLEGE - FLINT                   ,MI,48507-5508,Private      ,165,968,1133,2322,7369,9691
00467301,BAKER COLLEGE OF CADILLAC               ,MI,49601-0000,Private      ,50,259,309,523,1952,2475
00467302,BAKER COLLEGE OF CLINTON TOWNSHIP       ,MI,48035-0000,Private      ,132,587,719,2311,5821,8132
00467303,BAKER COLLEGE OF MUSKEGON               ,MI,49442-0000,Private      ,147,623,770,2723,5080,7803
00467304,BAKER COLLEGE OF OWOSSO                 ,MI,48867-0000,Private      ,75,302,377,1691,2393,4084
00467305,BAKER COLLEGE OF AUBURN HILLS           ,MI,48326-0000,Private      ,96,465,561,1289,3950,5239
00467306,BAKER COLLEGE OF PORT HURON             ,MI,48060-0000,Private      ,44,242,286,637,1822,2459
00467309,BAKER COLLEGE OF JACKSON                ,MI,49202-0000,Private      ,56,286,342,687,2270,2957
00467311,BAKER COLLEGE-CASS CITY                 ,MI,48726-0000,Private      ,17,102,119,197,546,743
00467313,BAKER COLLEGE - GRADUATE ON-LINE        ,MI,48507-0000,Private      ,33,490,523,367,5352,5719
00467317,BAKER COLLEGE-ALLEN PARK                ,MI,48101-0000,Private      ,66,330,396,985,2938,3923
00469200,DORSEY SCHOOL OF BUSINESS               ,MI,48195-2334,Proprietary  ,18,95,113,81,368,449
00469201,DORSEY SCHOOL OF BUSINESS               ,MI,48184-0000,Proprietary  ,8,65,73,70,369,439
00469202,DORSEY SCHOOL OF BUSINESS               ,MI,48071-0000,Proprietary  ,12,67,79,81,319,400
00469204,DORSEY SCHOOL OF BUSINESS               ,MI,48066-0000,Proprietary  ,36,133,169,151,767,918
00469205,DORSEY BUSINESS SCHOOL - FARMINGTON HILL,MI,48334-3385,Proprietary  ,9,26,35,27,129,156
00469206,DORSEY BUSINESS SCHOOL - ROSEVILLE CULIN,MI,48066-4555,Proprietary  ,11,48,59,29,123,152
00491003,KAPLAN CAREER INSTITUTE - DEARBORN      ,MI,48228-0000,Proprietary  ,5,29,34,5,29,34
00676800,MID MICHIGAN COMMUNITY COLLEGE          ,MI,48625-9447,Public       ,69,201,270,2346,2879,5225
00677100,COLLEGE FOR CREATIVE STUDIES            ,MI,48202-4034,Private      ,25,16,41,1492,495,1987
00694900,KALAMAZOO VALLEY COMMUNITY COLLEGE      ,MI,49003-4070,Public       ,172,501,673,4914,5819,10733
00717100,KIRTLAND COMMUNITY COLLEGE              ,MI,48653-0000,Public       ,29,142,171,854,1660,2514
00761700,CARNEGIE INSTITUTE                      ,MI,48083-1159,Proprietary  ,6,61,67,71,509,580
00795000,WEST SHORE COMMUNITY COLLEGE            ,MI,49454-0000,Public       ,15,34,49,525,789,1314
00817800,CHIC UNIVERSITY OF COSMETOLOGY          ,MI,49525-2440,Proprietary  ,40,104,144,306,544,850
00817801,CHIC UNIVERSITY OF COSMETOLOGY - KALAMAZ,MI,49024-2694,Proprietary  ,0,3,3,12,26,38
00890600,MACOMB COMMUNITY COLLEGE                ,MI,48088-3896,Public       ,368,1020,1388,8517,11005,19522
00894600,PORT HURON COSMETOLOGY COLLEGE          ,MI,48329-1618,Proprietary  ,6,21,27,25,91,116
00923000,WAYNE COUNTY COMMUNITY CLG-DISTRICT     ,MI,48226-3095,Public       ,653,1997,2650,8661,23952,32613
00973200,VIRGINIA FARRELL BEAUTY SCHOOL          ,MI,48080-1448,Proprietary  ,11,12,23,40,69,109
00973400,VIRGINIA FARRELL BEAUTY SCHOOL          ,MI,48220-1739,Proprietary  ,9,38,47,103,224,327
00982800,EVEREST INSTITUTE                       ,MI,48033-4400,Proprietary  ,93,347,440,554,2030,2584
00982801,EVEREST INSTITUTE- DEARBORN             ,MI,48124-1927,Proprietary  ,109,375,484,535,1767,2302
00982803,EVEREST INSTITUTE - DETROIT             ,MI,48207-4291,Proprietary  ,77,230,307,388,1153,1541
01047000,KALAMAZOO BEAUTY ACADEMY                ,MI,49002-5220,Proprietary  ,2,10,12,21,47,68
01062700,ITT TECHNICAL INSTITUTE                 ,MI,49519-0000,Proprietary  ,199,580,779,1409,2983,4392
01082700,DAVID PRESSLEY PROF SCH OF COSMTLGY     ,MI,48067-3219,Proprietary  ,25,27,52,129,135,264
01109800,FLINT INSTITUTE OF BARBERING            ,MI,48504-4395,Proprietary  ,4,14,18,25,119,144
01164600,VIRGINIA FARRELL BEAUTY SCHOOL          ,MI,48185-3091,Proprietary  ,5,18,23,54,141,195
01229100,WRIGHT BEAUTY ACADEMY                   ,MI,49015-2696,Proprietary  ,2,16,18,28,94,122
01262700,THOMAS M. COOLEY LAW SCHOOL             ,MI,48901-1586,Private      ,1,169,170,11,4975,4986
01321800,M J MURPHY BTY CLG MT PLEASANT          ,MI,48858-2502,Proprietary  ,7,19,26,47,86,133
02060300,MICHIGAN INSTITUTE OF AERONAUTICS       ,MI,48111-0000,Proprietary  ,33,205,238,451,873,1324
02068700,ADRIAN BEAUTY ACADEMY                   ,MI,49221-0000,Proprietary  ,1,3,4,21,51,72
02099700,ROSS MEDICAL EDUCATION CENTER           ,MI,48532-0000,Proprietary  ,29,259,288,241,1358,1599
02099701,ROSS MEDICAL EDUCATION CENTER-SAGINAW   ,MI,48603-5227,Proprietary  ,0,9,9,7,56,63
02099702,ROSS MEDICAL EDUCATION CENTER-PORT HURON,MI,48060-1958,Proprietary  ,0,7,7,3,33,36
02099703,ROSS MEDICAL EDUCATION CENTER-ROOSEVELT ,MI,49441-4156,Proprietary  ,2,5,7,3,14,17
02100400,EVEREST INSTITUTE                       ,MI,49525-2301,Proprietary  ,50,285,335,306,1512,1818
02100401,EVEREST INSTITUTE - KALAMAZOO           ,MI,49009-3307,Proprietary  ,36,236,272,191,1033,1224
02100403,EVEREST INSTITUTE - SOUTHFIELD          ,MI,48076-4492,Proprietary  ,0,0,0,31,147,178
02125600,MICHIGAN COLLEGE OF BEAUTY              ,MI,48083-0000,Proprietary  ,21,55,76,169,363,532
02152103,ACADEMY OF COURT REPORTING & TECHNOLOGY ,MI,48017-1495,Proprietary  ,4,62,66,12,112,124
02158600,MR BELA'S SCHOOL OF COSMETOLOGY         ,MI,48092-4637,Proprietary  ,8,13,21,36,71,107
02160303,INTERNATIONAL ACADEMY OF DESIGN AND TECH,MI,48083-2160,Proprietary  ,41,84,125,847,881,1728
02180100,ROSS MEDICAL EDUCATION CENTER           ,MI,48092-0000,Proprietary  ,27,139,166,139,631,770
02180105,ROSS MEDICAL EDUCATION CENTER-REDFORD   ,MI,48239-1260,Proprietary  ,1,5,6,7,34,41
02198900,MICHIGAN SCHOOL OF PROFESSIONAL PSYCHOLO,MI,48334-4512,Private      ,0,5,5,4,155,159
02209200,TAYLORTOWN SCHOOL OF BEAUTY             ,MI,48180-0000,Proprietary  ,4,3,7,31,102,133
02237800,SPECS HOWARD SCHL OF BROADCAST ARTS     ,MI,48075-0000,Proprietary  ,54,101,155,531,649,1180
02285700,BAYSHIRE BEAUTY ACADEMY                 ,MI,48708-5614,Proprietary  ,5,15,20,32,98,130
02289801,KAPLAN INSTITUTE - DETROIT CAMPUS       ,MI,48202-0000,Proprietary  ,58,258,316,256,1204,1460
02324500,MICHIGAN COLLEGE OF BEAUTY              ,MI,48161-0000,Proprietary  ,11,29,40,83,163,246
02339700,ROSS MEDICAL EDUCATION CENTER           ,MI,48116-0000,Proprietary  ,44,222,266,160,983,1143
02339701,ROSS MEDICAL EDUCATION CENTER-ANN ARBOR ,MI,48108-1411,Proprietary  ,0,4,4,7,31,38
02361500,MICHIGAN BARBER COLLEGE                 ,MI,48204-2244,Private      ,10,46,56,100,288,388
02363800,YESHIVA GEDOLAH OF GREATER DETROIT      ,MI,48237-0000,Private      ,9,0,9,23,3,26
02491000,WEST MI COLG OF BARBERING & BEAUTY      ,MI,49008-0000,Proprietary  ,7,28,35,24,114,138
02495800,FOCUS:HOPE                              ,MI,48238-0000,Private      ,0,0,0,1,3,4
02498300,VIRGINIA FARRELL BEAUTY SCHOOL          ,MI,48154-0000,Proprietary  ,12,11,23,79,142,221
02533600,ROSS MEDICAL EDUCATION CENTER           ,MI,48917-2108,Proprietary  ,33,160,193,162,738,900
02533601,ROSS MEDICAL EDUCATION CENTER - GRAND RA,MI,49546-2430,Proprietary  ,1,13,14,8,67,75
02588200,DOUGLAS J AVEDA INSTITUTE               ,MI,48823-4351,Proprietary  ,44,69,113,407,480,887
02588201,DOUGLAS J AVEDA INSTITUTE - ANN ARBOR   ,MI,48104-2211,Proprietary  ,9,5,14,81,102,183
02595700,HILLSDALE BEAUTY COLLEGE                ,MI,49242-0000,Proprietary  ,4,4,8,36,19,55
02618400,MICHIGAN CAREER & TECHNICAL INST        ,MI,49080-9254,Public       ,33,18,51,209,116,325
03005700,DETROIT BUSINESS INST. DOWNRIVER        ,MI,48193-6761,Proprietary  ,12,42,54,94,295,389
03028500,LAWTON SCHOOL                           ,MI,48075-5406,Proprietary  ,16,52,68,65,229,294
03066600,BAY MILLS COMMUNITY COLLEGE             ,MI,49715-9750,Public       ,7,36,43,148,356,504
03075200,TWIN CITY BEAUTY COLLEGE                ,MI,49085-3305,Proprietary  ,15,51,66,69,213,282
03075201,TWIN CITY BEAUTY COLLEGE - TRAVERSE CITY,MI,49686-5119,Proprietary  ,3,1,4,9,15,24
03090000,SHARP'S ACADEMY OF HAIRSTYLING INC.     ,MI,48433-0000,Proprietary  ,3,7,10,20,56,76
03109700,HOUGHTON LAKE INST OF COSMETOLOGY       ,MI,48629-9702,Proprietary  ,0,0,0,12,10,22
03110300,THE SCHOOL OF CREATIVE HAIR DESIGN      ,MI,49036-1139,Proprietary  ,4,9,13,19,64,83
03124000,NORTHWESTERN TECHNOLOGICAL INST         ,MI,48075-2412,Proprietary  ,23,87,110,119,474,593
03135300,MICHIGAN THEOLOGICAL SEMINARY           ,MI,48170-4399,Private      ,0,11,11,2,121,123
03284300,MICHIGAN JEWISH INSTITUTE               ,MI,48237-0000,Private      ,168,49,217,735,144,879
03490300,PAUL MITCHELL THE SCHOOL ESCANABA       ,MI,49829-0000,Proprietary  ,5,4,9,18,24,42
03588300,IRENE'S MYOMASSOLOGY INSTITUTE          ,MI,48033-2404,Proprietary  ,9,57,66,73,385,458
03691400,AVE MARIA SCHOOL OF LAW                 ,MI,48105-0000,Private      ,0,5,5,2,597,599
03704300,BLUE WATER COLLEGE OF COSMETOLOGY       ,MI,48040-0000,Proprietary  ,8,15,23,43,56,99
03772300,SAGINAW CHIPPEWA TRIBAL COLLEGE         ,MI,48858-0000,Public       ,2,7,9,11,44,55
03815300,IN SESSION-ARTS OF COSMETOLOGY BEAU     ,MI,48609-0000,Proprietary  ,3,23,26,40,126,166
03907300,PAUL MITCHELL THE SCHOOL GREAT LAKES    ,MI,48060-0000,Proprietary  ,13,20,33,78,86,164
03915300,CAREER QUEST LEARNING CENTER            ,MI,48910-4732,Proprietary  ,17,104,121,51,550,601
03968300,LAKEWOOD SCHOOL OF THERAPEUTIC MASSAGE  ,MI,48060-0000,Proprietary  ,2,7,9,15,43,58
03976500,ANN ARBOR INSTITUTE OF MASSAGE THERAPY  ,MI,48103-0000,Proprietary  ,1,18,19,29,88,117
04002400,ECUMENICAL THEOLOGICAL SEMINARY         ,MI,48201-3035,Private      ,0,1,1,3,91,94
04006300,NUVO COLLEGE OF COSMETOLOGY             ,MI,49441-3822,Proprietary  ,4,12,16,24,71,95
04014300,P&A SCHOLARS BEAUTY SCHOOL              ,MI,48204-0000,Proprietary  ,7,21,28,67,191,258
04055300,CREATIVE HAIR SCHOOL OF COSMETOLOGY     ,MI,48504-1234,Proprietary  ,0,0,0,26,57,83
04094300,ROBERT B. MILLER COLLEGE (THE)          ,MI,49017-3306,Private      ,2,7,9,36,255,291
04121100,GALLERY COLLEGE OF BEAUTY (THE)         ,MI,48036-3591,Proprietary  ,6,18,24,46,122,168
04136300,FOCUS:  HOPE INFORMATION TECHNOLOGIES CE,MI,48238-2949,Private      ,2,12,14,16,56,72
04138400,SCHOOL OF DESIGNING ARTS                ,MI,49037-7995,Proprietary  ,3,4,7,15,41,56
04139600,REGAL BEAUTY SCHOOL                     ,MI,48150-4013,Proprietary  ,1,15,16,1,24,25
04140900,INTERNATIONAL COSMETOLOGY ACADEMY       ,MI,49508-1308,Proprietary  ,1,23,24,6,85,91
04141100,FRENCH ACADEMY OF COSMETOLOGY           ,MI,49456-3207,Proprietary  ,5,10,15,12,26,38
00233200,ANOKA-RAMSEY CC-CAMBRIDGE/COONRAPID     ,MN,55433-3499,Public       ,126,229,355,2920,3265,6185
00233400,AUGSBURG COLLEGE                        ,MN,55454-1351,Private      ,23,130,153,2438,2062,4500
00233500,RIVERLAND COMMUNITY COLLEGE             ,MN,55912-1473,Public       ,30,113,143,1014,1503,2517
00233600,BEMIDJI STATE UNIVERSITY                ,MN,56601-2699,Public       ,48,89,137,3034,1659,4693
00233700,BETHANY LUTHERAN COLLEGE INC            ,MN,56001-6163,Private      ,1,2,3,662,44,706
00233900,CENTRAL LAKES COLG-BRAINERD/STAPLES     ,MN,56401-3900,Public       ,50,126,176,1482,1755,3237
00234000,CARLETON COLLEGE                        ,MN,55057-4001,Private      ,19,1,20,3009,34,3043
00234100,COLLEGE OF ST BENEDICT                  ,MN,56374-2099,Private      ,15,1,16,2076,42,2118
00234200,COLLEGE OF ST CATHERINE                 ,MN,55105-1789,Private      ,34,104,138,2189,3051,5240
00234300,COLLEGE OF ST SCHOLASTICA               ,MN,55811-4199,Private      ,15,88,103,2331,1587,3918
00234500,UNIVERSITY OF ST THOMAS                 ,MN,55105-1096,Private      ,56,192,248,6015,3810,9825
00234600,CONCORDIA COLLEGE-MOORHEAD              ,MN,56562-0001,Private      ,19,8,27,3283,156,3439
00234700,"CONCORDIA UNIVERSITY, ST PAUL, MN       ",MN,55104-5494,Private      ,15,229,244,1261,1764,3025
00235000,VERMILION COMMUNITY COLLEGE             ,MN,55731-1996,Public       ,5,8,13,464,143,607
00235200,FERGUS FALLS COMMUNITY COLLEGE          ,MN,56537-1000,Public       ,0,0,0,41,39,80
00235300,GUSTAVUS ADOLPHUS COLLEGE               ,MN,56082-1498,Private      ,20,2,22,3099,42,3141
00235400,HAMLINE UNIVERSITY                      ,MN,55104-1284,Private      ,23,159,182,2588,3057,5645
00235500,HIBBING COMMUNITY COLLEGE               ,MN,55746-3300,Public       ,29,69,98,689,964,1653
00235600,ITASCA COMMUNITY COLLEGE                ,MN,55744-3397,Public       ,19,45,64,713,522,1235
00235700,LUTHER SEMINARY                         ,MN,55108-0000,Private      ,0,7,7,2,433,435
00235800,MACALESTER COLLEGE                      ,MN,55105-1899,Private      ,15,0,15,3323,82,3405
00236000,"MINNESOTA STATE UNIVERSITY, MANKATO     ",MN,56002-0000,Public       ,133,123,256,10145,3589,13734
00236100,MARTIN LUTHER COLLEGE                   ,MN,56073-3965,Private      ,2,2,4,658,61,719
00236200,MINNEAPOLIS COMM AND TECH COLLEGE       ,MN,55403-1779,Public       ,148,503,651,3939,8282,12221
00236500,MINNEAPOLIS COLLEGE OF ART & DESIGN     ,MN,55404-4343,Private      ,11,10,21,904,342,1246
00236600,CROSSROADS COLLEGE                      ,MN,55902-2382,Private      ,1,8,9,122,94,216
00236700,MINNESOTA STATE UNIVERSITY MOORHEAD     ,MN,56563-0001,Public       ,55,75,130,5196,2077,7273
00236900,NORTH CENTRAL UNIVERSITY                ,MN,55404-1391,Private      ,12,15,27,1109,358,1467
00237000,NORTH HENNEPIN COMMUNITY COLLEGE        ,MN,55445-2299,Public       ,105,228,333,2419,3888,6307
00237100,NORTHWESTERN COLLEGE                    ,MN,55113-1598,Private      ,19,49,68,2274,784,3058
00237300,ROCHESTER COMMUNITY/TECH COLLEGE        ,MN,55904-4999,Public       ,62,158,220,2652,2708,5360
00237500,SOUTHWEST MINNESOTA STATE UNIVERSITY    ,MN,56258-1598,Public       ,24,33,57,2022,960,2982
00237700,ST CLOUD STATE UNIVERSITY               ,MN,56301-4498,Public       ,141,193,334,9658,4211,13869
00237900,SAINT JOHNS UNIVERSITY                  ,MN,56321-0000,Private      ,19,2,21,1798,95,1893
00238000,SAINT MARY'S UNIVERSITY                 ,MN,55987-1399,Private      ,11,180,191,1561,2880,4441
00238200,ST OLAF COLLEGE                         ,MN,55057-1098,Private      ,17,1,18,3777,58,3835
00238300,CROWN COLLEGE                           ,MN,55375-9001,Private      ,8,56,64,754,644,1398
00238500,NORTHLAND COMMUNITY & TECHNICAL CLG     ,MN,56701-2598,Public       ,51,115,166,1559,1963,3522
00238600,UNITED THEOLGCL SEMINRY TWIN CITIES     ,MN,55112-0000,Private      ,0,1,1,1,103,104
00238800,"UNIVERSITY OF MINNESOTA, DULUTH         ",MN,55812-2496,Public       ,94,53,147,8888,1847,10735
00238900,"UNIVERSITY OF MINNESOTA, MORRIS         ",MN,56267-2113,Public       ,11,9,20,1686,215,1901
00239100,WILLIAM MITCHELL COLLEGE OF LAW         ,MN,55105-0000,Private      ,0,8,8,6,1301,1307
00239300,MINNESOTA STATE COLLEGE-SE TECH         ,MN,55987-0409,Public       ,40,106,146,818,1285,2103
00239400,WINONA STATE UNIVERSITY                 ,MN,55987-5838,Public       ,84,60,144,6588,1255,7843
00396900,UNIVERSITY OF MINNESOTA-TWIN CITIES     ,MN,55455-0422,Public       ,373,612,985,26264,16831,43095
00396903,UNIVERSITY OF MINNESOTA - ROCHESTER     ,MN,55904-0000,Public       ,0,0,0,0,2,2
00400900,MESABI RANGE CMNTY & TECH COLLEGE       ,MN,55792-0000,Public       ,23,34,57,601,647,1248
00405708,NATIONAL AMERICAN UNIVERSITY            ,MN,55113-0000,Proprietary  ,3,35,38,54,317,371
00405715,NATIONAL AMERICAN UNIVERSITY - BLOOMINGT,MN,55425-5550,Proprietary  ,2,25,27,17,208,225
00406900,UNIVERSITY OF MINNESOTA-CROOKSTON       ,MN,56716-5001,Public       ,13,34,47,971,359,1330
00438600,VETERAN'S MEDICAL CTR- SCH RAD TECH     ,MN,55417-2399,Public       ,0,1,1,3,9,12
00464100,DUNWOODY COLLEGE OF TECHNOLOGY          ,MN,55403-1192,Private      ,47,106,153,1018,1258,2276
00464200,GLOBE UNIVERSITY                        ,MN,55128-0000,Proprietary  ,98,417,515,782,1953,2735
00464500,MINNEAPOLIS BUSINESS COLLEGE            ,MN,55113-4036,Proprietary  ,1,4,5,463,123,586
00464600,MINNESOTA SCHOOL OF BUSINESS            ,MN,55423-0000,Proprietary  ,240,769,1009,2735,6267,9002
00464800,RASMUSSEN COLLEGE - EAGAN               ,MN,55122-1346,Proprietary  ,28,161,189,254,1098,1352
00484602,RASMUSSEN COLLEGE - MOORHEAD            ,MN,56560-4513,Proprietary  ,0,0,0,0,1,1
00525200,RIDGEWATER COLLEGE                      ,MN,56201-2098,Public       ,53,123,176,2021,1781,3802
00526300,MINNESOTA WEST CMNTY & TECH COLG        ,MN,56241-1096,Public       ,27,107,134,979,1328,2307
00553300,"SAINT PAUL COLLEGE, COMMUNITY/TECHNICAL ",MN,55102-1800,Public       ,82,283,365,2068,4460,6528
00553400,ST CLOUD TECHNICAL COLLEGE              ,MN,56303-1240,Public       ,61,97,158,2315,1763,4078
00553500,PINE TECHNICAL COLLEGE                  ,MN,55063-2198,Public       ,6,33,39,195,548,743
00553700,SOUTH CENTRAL COLLEGE                   ,MN,56003-0000,Public       ,54,102,156,1570,1688,3258
00554100,MINNESOTA STATE COMMUNITY AND TECHNICAL ,MN,56573-1405,Public       ,83,145,228,2505,2994,5499
00554400,ALEXANDRIA TECHNICAL COLLEGE            ,MN,56308-3799,Public       ,18,33,51,1230,738,1968
00575700,LAKE SUPERIOR COLLEGE                   ,MN,55811-3399,Public       ,79,152,231,1956,2290,4246
00575900,NORTHWEST TECHNICAL COLLEGE - BEMIDJI   ,MN,56601-4907,Public       ,21,47,68,440,934,1374
00677500,RAINY RIVER COMMUNITY COLLEGE           ,MN,56649-2187,Public       ,2,11,13,114,127,241
00735000,ANOKA-HENNEPIN TECHNICAL COLLEGE        ,MN,55303-1590,Public       ,38,119,157,785,1605,2390
00735100,BROWN COLLEGE                           ,MN,55120-1004,Proprietary  ,51,103,154,1198,1224,2422
00746200,COLLEGE OF VISUAL ARTS                  ,MN,55102-2199,Private      ,1,2,3,206,61,267
00795400,NORMANDALE COMMUNITY COLLEGE            ,MN,55431-4399,Public       ,129,252,381,3780,4073,7853
00826700,NORTHWEST TECHNICAL INSTITUTE           ,MN,55121-5001,Proprietary  ,8,9,17,135,44,179
00869400,RASMUSSEN COLLEGE ST. CLOUD             ,MN,56301-3713,Proprietary  ,28,149,177,344,1271,1615
00869401,RASMUSSEN COLLEGE - SAINT CLOUD - BROOKL,MN,55445-1512,Proprietary  ,42,189,231,312,1401,1713
00905800,BETHEL UNIVERSITY                       ,MN,55112-6999,Private      ,29,158,187,2971,1958,4929
00960000,COSMETOLOGY CAREERS UNLTD-DULUTH        ,MN,55802-2031,Proprietary  ,2,6,8,24,43,67
00972200,EMPIRE BEAUTY SCHOOL                    ,MN,55119-7003,Proprietary  ,9,55,64,84,225,309
00974000,INVER HILLS COMMUNITY COLLEGE           ,MN,55076-3224,Public       ,93,190,283,1879,2598,4477
00983100,MODEL COLLEGE OF HAIR DESIGN            ,MN,56301-4280,Proprietary  ,7,16,23,83,61,144
00987000,SCOT LEWIS SCHOOL - BLOOMINGTON         ,MN,55420-2919,Proprietary  ,9,22,31,137,233,370
00989200,"DULUTH BUSINESS UNIV, INC.              ",MN,55807-0000,Proprietary  ,9,68,77,153,453,606
00999200,OAK HILLS CHRISTIAN COLLEGE             ,MN,56601-0000,Private      ,1,3,4,117,77,194
01024800,ART INSTITUTES INTL MINNESOTA           ,MN,55402-3137,Proprietary  ,50,108,158,1708,1119,2827
01035602,EVEREST INSTITUTE - EAGAN               ,MN,55121-1696,Proprietary  ,38,231,269,196,1167,1363
01037400,METROPOLITAN STATE UNIVERSITY           ,MN,55106-5000,Public       ,29,211,240,1551,5432,6983
01040200,DAKOTA COUNTY TECHNICAL COLLEGE         ,MN,55068-2999,Public       ,42,112,154,1122,1563,2685
01049000,REGENCY BEAUTY INSTITUTE                ,MN,55428-0000,Proprietary  ,413,705,1118,2604,4087,6691
01049100,HENNEPIN TECHNICAL COLLEGE              ,MN,55445-2399,Public       ,50,230,280,1553,3576,5129
01054600,CENTURY COMMUNITY AND TECHNICAL CLG     ,MN,55110-1894,Public       ,162,340,502,3953,5067,9020
01101700,HERZING COLLEGE                         ,MN,55428-3548,Proprietary  ,18,32,50,187,327,514
01168600,RASMUSSEN COLLEGE - EDEN PRAIRIE        ,MN,55344-7220,Proprietary  ,26,335,361,243,1880,2123
01173200,"MAYO CLINIC, COLLEGE OF MEDICINE        ",MN,55905-0000,Private      ,0,7,7,35,322,357
01173201,MAYO SCHOOL OF HEALTH-RELATED SCIEN     ,MN,55905-0000,Private      ,2,3,5,38,120,158
01173206,MAYO GRAD SCHOOL                        ,MN,55901-0000,Private      ,0,4,4,0,40,40
01173207,MAYO MEDICAL SCHOOL                     ,MN,55901-0000,Private      ,0,2,2,1,163,164
01232800,NORTHWESTERN HEALTH SCIENCES UNIV       ,MN,55431-1599,Private      ,3,21,24,56,897,953
02050300,ACADEMY COLLEGE                         ,MN,55420-1554,Proprietary  ,3,24,27,55,214,269
02123200,AVEDA INSTITUTE                         ,MN,55414-0000,Proprietary  ,23,52,75,375,328,703
02159800,COSMETOLOGY CAREERS UNLTD - HIBBING     ,MN,55746-0000,Proprietary  ,3,5,8,22,23,45
02160901,"SALON PROFESSIONAL ACADEMY, THE - THE SA",MN,55428-4928,Proprietary  ,3,6,9,55,68,123
02179901,ARGOSY UNIVERSITY - TWIN CITIES         ,MN,55121-1756,Proprietary  ,0,0,0,47,133,180
02238100,MINNESOTA SCHOOL OF COSMETOLOGY         ,MN,55125-0000,Proprietary  ,7,12,19,94,180,274
02260500,SUMMIT ACAD OPPORTUNITIES IND CTR       ,MN,55405-0000,Private      ,21,90,111,42,309,351
02263102,HIGH-TECH INSTITUTE - MINNEAPOLIS       ,MN,55416-2467,Proprietary  ,4,3,7,17,43,60
02284500,PILLSBURY BAPTIST BIBLE COLLEGE         ,MN,55060-0000,Private      ,0,0,0,132,20,152
02503300,RASMUSSEN COLLEGE - MANKATO             ,MN,56001-8658,Proprietary  ,16,133,149,279,971,1250
02503302,RASMUSSEN COLLEGE - MANKATO -  LAKE ELMO,MN,55042-8624,Proprietary  ,27,111,138,190,730,920
02504200,WALDEN UNIVERSITY                       ,MN,55401-2511,Proprietary  ,11,3950,3961,75,34655,34730
02514100,AMERICAN INDIAN OPPORTUNITIES CTR       ,MN,55404-0000,Private      ,0,24,24,4,129,133
02543600,INGENUE                                 ,MN,56560-0000,Proprietary  ,3,3,6,21,10,31
02551200,EAST METRO OIC                          ,MN,55104-3435,Private      ,1,24,25,25,177,202
03001200,MCNALLY SMITH COLLEGE OF MUSIC          ,MN,55101-2220,Proprietary  ,15,11,26,630,222,852
03051900,ALFRED ADLER GRADUATE SCHOOL            ,MN,55305-0000,Private      ,0,37,37,0,256,256
03096400,LEECH LAKE TRIBAL COLLEGE               ,MN,56633-0000,Public       ,6,17,23,50,246,296
03129100,FOND DU LAC TRIBAL & COMMUNITY CLG      ,MN,55720-2984,Public       ,31,67,98,448,841,1289
03267300,CAPELLA UNIVERSITY                      ,MN,55402-3389,Proprietary  ,13,3685,3698,81,36186,36267
03833300,AMERICAN ACADEMY OF ACUPUNCTURE AND ORIE,MN,55113-0000,Proprietary  ,0,8,8,4,90,94
03921400,WHITE EARTH TRIBAL AND COMMUNITY COLLEGE,MN,56557-0478,Private      ,3,19,22,21,96,117
04044300,HAZELDEN GRADUATE SCHOOL OF ADDICTION ST,MN,55012-0000,Private      ,0,5,5,0,88,88
04130200,INST. OF PRODUCTION AND RECORDING       ,MN,55401-1315,Proprietary  ,32,15,47,63,43,106
00239600,ALCORN STATE UNIVERSITY                 ,MS,39096-7500,Public       ,118,131,249,3253,2868,6121
00239700,BELHAVEN COLLEGE                        ,MS,39202-1789,Private      ,23,259,282,1265,3114,4379
00239800,BLUE MOUNTAIN COLLEGE                   ,MS,38610-9370,Private      ,7,21,28,338,321,659
00240100,COAHOMA COMMUNITY COLLEGE               ,MS,38614-9799,Public       ,113,255,368,1436,2372,3808
00240200,COPIAH-LINCOLN COMMUNITY COLLEGE        ,MS,39191-0649,Public       ,113,157,270,1951,2217,4168
00240300,DELTA STATE UNIVERSITY                  ,MS,38733-0000,Public       ,61,130,191,2865,3053,5918
00240400,EAST CENTRAL COMMUNITY COLLEGE          ,MS,39327-0129,Public       ,71,157,228,1496,1870,3366
00240500,EAST MISSISSIPPI COMM COLLEGE           ,MS,39358-0000,Public       ,146,269,415,2257,3170,5427
00240700,HINDS COMMUNITY COLLEGE                 ,MS,39154-9799,Public       ,366,551,917,6193,8230,14423
00240800,HOLMES COMMUNITY COLLEGE                ,MS,39079-0000,Public       ,153,336,489,3040,4895,7935
00240900,ITAWAMBA COMMUNITY COLLEGE              ,MS,38843-1099,Public       ,154,511,665,3338,5530,8868
00241000,JACKSON STATE UNIVERSITY                ,MS,39217-0001,Public       ,199,330,529,7963,8411,16374
00241100,JONES COUNTY JUNIOR COLLEGE             ,MS,39437-3999,Public       ,149,201,350,3250,2541,5791
00241300,MERIDIAN COMMUNITY COLLEGE              ,MS,39307-5890,Public       ,86,202,288,2054,2523,4577
00241400,MILLSAPS COLLEGE                        ,MS,39201-0000,Private      ,23,14,37,1331,389,1720
00241500,MISSISSIPPI COLLEGE                     ,MS,39058-0001,Private      ,45,124,169,2251,2925,5176
00241501,MISSISSIPPI COLLEGE SCHOOL OF LAW       ,MS,39201-0000,Private      ,0,8,8,27,830,857
00241502,MISSISSIPPI COLLEGE - RANKIN CAMPUS     ,MS,39042-0000,Private      ,1,3,4,12,50,62
00241600,MISSISSIPPI DELTA CMTY COLLEGE          ,MS,38761-0000,Public       ,98,149,247,1937,2377,4314
00241700,MISSISSIPPI GULF CST CLG-PERKINSTON     ,MS,39573-0000,Public       ,45,34,79,1282,687,1969
00241701,MISSISSIPPI GULF CST CLG-JEFF DAVIS     ,MS,39507-0000,Public       ,62,169,231,1398,2513,3911
00241702,MISSISSIPPI GULF CST CLG-JACKSON CN     ,MS,39553-0000,Public       ,60,114,174,1276,1823,3099
00242200,MISSISSIPPI UNIV FOR WOMEN              ,MS,39701-5818,Public       ,37,69,106,1440,1652,3092
00242300,MISSISSIPPI STATE UNIVERSITY            ,MS,39762-9698,Public       ,234,207,441,10628,5901,16529
00242400,MISSISSIPPI VALLEY STATE UNIVERSITY     ,MS,38941-1400,Public       ,74,123,197,2874,3513,6387
00242600,NORTHEAST MS CMNTY COLLEGE              ,MS,38829-1731,Public       ,78,136,214,2219,2099,4318
00242700,NORTHWEST MISSISSIPPI COMMUNITY CLG     ,MS,38668-1703,Public       ,152,262,414,4327,4406,8733
00243000,PEARL RIVER COMMUNITY COLLEGE           ,MS,39470-2201,Public       ,134,188,322,2687,3021,5708
00243300,RUST COLLEGE                            ,MS,38635-2328,Private      ,31,17,48,1399,482,1881
00243500,SOUTHEASTERN BAPTIST COLLEGE            ,MS,39440-0000,Private      ,2,1,3,31,68,99
00243600,SOUTHWEST MISSISSIPPI CMNTY CLG         ,MS,39666-8099,Public       ,34,58,92,1318,1279,2597
00243900,TOUGALOO COLLEGE                        ,MS,39174-9799,Private      ,29,17,46,1526,477,2003
00244000,UNIVERSITY OF MISSISSIPPI               ,MS,38677-1848,Public       ,250,204,454,8507,5405,13912
00244001,UNIVERSITY OF MISSISSIPPI - MED CTR     ,MS,39216-0000,Public       ,7,32,39,368,1532,1900
00244100,UNIVERSITY OF SOUTHERN MISSISSIPPI      ,MS,39406-0001,Public       ,269,394,663,9687,8065,17752
00244700,WILLIAM CAREY UNIVERSITY                ,MS,39401-5499,Private      ,54,196,250,1129,2897,4026
01146100,WESLEY COLLEGE                          ,MS,39073-1070,Private      ,2,6,8,65,84,149
01289101,ANTONELLI COLLEGE - JACKSON             ,MS,39208-4526,Proprietary  ,17,123,140,137,575,712
01289102,ANTONELLI COLLEGE - HATTIESBURG         ,MS,39401-3056,Proprietary  ,16,95,111,134,705,839
02074900,CHRIS' BEAUTY COLLEGE                   ,MS,39501-0000,Proprietary  ,3,16,19,30,112,142
02160500,NORTH MISSISSIPPI MED CTR MED TECH      ,MS,38801-0000,Private      ,0,2,2,9,30,39
02235900,ACADEMY OF HAIR DESIGN #4               ,MS,39208-0000,Proprietary  ,5,15,20,30,109,139
02244300,ACADEMY OF HAIR DESIGN #1               ,MS,38901-0000,Proprietary  ,11,52,63,72,270,342
02249900,DELTA BEAUTY COLLEGE                    ,MS,38701-0000,Proprietary  ,1,5,6,32,82,114
02251600,ACADEMY OF HAIR DESIGN #6               ,MS,39401-7581,Proprietary  ,13,41,54,52,164,216
02251700,FOSTER'S COSMETOLOGY COLLEGE            ,MS,38663-0000,Proprietary  ,0,9,9,8,57,65
02302800,MISSISSIPPI COLLEGE OF BEAUTY CULT      ,MS,39440-0000,Proprietary  ,6,14,20,21,53,74
02320800,MAGNOLIA COLLEGE OF COSMETOLOGY         ,MS,39206-0000,Proprietary  ,6,22,28,63,204,267
02361200,MAGNOLIA BIBLE COLLEGE                  ,MS,39090-0000,Private      ,0,3,3,10,40,50
02490200,"ICS, THE WRIGHT BEAUTY COLLEGE          ",MS,38834-0000,Proprietary  ,0,0,0,7,34,41
02502100,CREATIONS COLLEGE OF COSMETOLOGY        ,MS,38803-0000,Proprietary  ,2,11,13,22,109,131
02516200,WESLEY BIBLICAL SEMINARY                ,MS,39206-0000,Private      ,0,4,4,0,107,107
02554600,GIBSON'S BARBER AND BEAUTY COLLEGE      ,MS,39773-0000,Proprietary  ,6,9,15,28,67,95
02586000,J & J HAIR DESIGN COLLEGE               ,MS,39051-3716,Proprietary  ,3,36,39,27,154,181
03004000,FINAL TOUCH BEAUTY SCHOOL               ,MS,39307-2934,Proprietary  ,4,15,19,25,84,109
03010401,CRESCENT CITY BARTENDING SCHOOL         ,MS,39501-0000,Proprietary  ,0,4,4,3,26,29
03010404,CRESCENT CITY SCHOOL OF GAMING & BARTEND,MS,38664-1903,Proprietary  ,0,0,0,2,6,8
03010603,VIRGINIA COLLEGE - JACKSON              ,MS,39206-5602,Proprietary  ,32,232,264,108,647,755
03010610,VIRGINIA COLLEGE - BILOXI               ,MS,39532-2124,Proprietary  ,15,84,99,42,275,317
03263300,TRAXLER'S SCHOOL OF HAIR                ,MS,39212-2529,Proprietary  ,7,14,21,19,71,90
03464300,ACADEMY OF HAIR DESIGN                  ,MS,39562-0000,Proprietary  ,1,18,19,14,77,91
03525300,BLUE CLIFF COLLEGE                      ,MS,39507-0000,Proprietary  ,15,47,62,94,294,388
03848300,DAY SPA CAREER COLLEGE                  ,MS,39564-0000,Proprietary  ,2,7,9,14,72,86
03963300,HEALING TOUCH SCHOOL OF MASSAGE THERAPY ,MS,39402-1300,Proprietary  ,1,2,3,10,39,49
04131300,CORINTH ACADEMY OF COSMETOLOGY          ,MS,38834-4813,Proprietary  ,2,8,10,15,58,73
04140200,"MISSISSIPPI INSTITUTE OF AESTHETICS, NAI",MS,39056-5628,Proprietary  ,0,5,5,0,5,5
00252600,CARROLL COLLEGE                         ,MT,59625-0002,Private      ,19,7,26,1497,221,1718
00252700,UNIVERSITY OF GREAT FALLS               ,MT,59405-4996,Private      ,4,28,32,465,517,982
00252800,MILES COMMUNITY COLLEGE                 ,MT,59301-4799,Public       ,8,15,23,295,231,526
00252900,DAWSON COMMUNITY COLLEGE                ,MT,59330-1405,Public       ,10,8,18,245,119,364
00253000,MONTANA STATE UNIVERSITY - BILLINGS     ,MT,59101-0298,Public       ,85,162,247,2458,3136,5594
00253100,MONTANA TECH OF THE UNIV OF MONTANA     ,MT,59701-8997,Public       ,26,44,70,1378,1018,2396
00253200,MONTANA STATE UNIVERSITY - BOZEMAN      ,MT,59717-0001,Public       ,147,168,315,7775,3652,11427
00253300,MONTANA STATE UNIVERSITY-NORTHERN       ,MT,59501-3148,Public       ,18,60,78,680,786,1466
00253400,ROCKY MOUNTAIN COLLEGE                  ,MT,59102-1796,Private      ,8,16,24,846,340,1186
00253600,UNIVERSITY OF MONTANA (THE)             ,MT,59812-0001,Public       ,203,284,487,7814,6580,14394
00253700,UNIVERSITY OF MONTANA WESTERN (THE)     ,MT,59725-3598,Public       ,17,19,36,966,468,1434
00442500,BENEFIS HEALTHCARE SCH RAD TECH         ,MT,59405-4324,Private      ,0,0,0,8,12,20
00677700,FLATHEAD VALLEY COMMUNITY COLLEGE       ,MT,59901-2699,Public       ,56,181,237,675,1098,1773
00757000,HELENA COLLEGE OF TECHNOLOGY            ,MT,59601-3098,Public       ,17,51,68,384,699,1083
00790000,BUTTE ACADEMY OF BEAUTY CULTURE         ,MT,59701-9197,Proprietary  ,4,5,9,25,39,64
00894700,"DAHL'S COLLEGE OF BEAUTY,INC            ",MT,59401-3731,Proprietary  ,5,4,9,24,35,59
00931400,MSU COLLEGE OF TECH-GREAT FALLS         ,MT,59405-4907,Public       ,33,118,151,613,1380,1993
02143400,SALISH KOOTENAI COLLEGE                 ,MT,59855-0000,Public       ,21,82,103,294,825,1119
02286600,LITTLE BIG HORN COLLEGE                 ,MT,59022-0000,Public       ,10,48,58,97,239,336
02343000,FT PECK COMMUNITY COLLEGE               ,MT,59255-0000,Public       ,16,40,56,83,271,354
02510600,BLACKFEET COMMUNITY COLLEGE             ,MT,59417-0000,Private      ,24,133,157,165,530,695
02517500,FORT BELKNAP COLLEGE                    ,MT,59526-0000,Public       ,3,15,18,54,125,179
02545200,CHIEF DULL KNIFE COLLEGE                ,MT,59043-0098,Public       ,4,37,41,62,159,221
02610900,STONE CHILD COLLEGE                     ,MT,59521-9796,Public       ,11,70,81,76,268,344
02621300,ACADEMY OF COSMETOLOGY                  ,MT,59715-3544,Proprietary  ,4,1,5,32,34,66
03205300,MODERN BEAUTY SCHOOL                    ,MT,59801-8386,Proprietary  ,2,5,7,49,43,92
03763400,"ACADEMY OF NAIL, SKIN & HAIR            ",MT,59101-0000,Proprietary  ,8,17,25,59,104,163
03778300,HEALTH WORKS INSTITUTE                  ,MT,59715-0000,Proprietary  ,3,5,8,16,25,41
00253900,CHADRON STATE COLLEGE                   ,NE,69337-2690,Public       ,27,48,75,1594,905,2499
00254000,COLLEGE OF ST MARY                      ,NE,68106-2606,Private      ,4,49,53,414,1002,1416
00254100,CONCORDIA UNIVERSITY                    ,NE,68434-1594,Private      ,6,26,32,1305,224,1529
00254200,CREIGHTON UNIVERSITY                    ,NE,68178-0001,Private      ,42,88,130,4649,4383,9032
00254300,DANA COLLEGE                            ,NE,68008-9905,Private      ,6,2,8,848,83,931
00254400,DOANE COLLEGE                           ,NE,68333-2421,Private      ,19,68,87,1339,912,2251
00254700,GRACE UNIVERSITY                        ,NE,68108-3629,Private      ,0,9,9,327,264,591
00254800,HASTINGS COLLEGE                        ,NE,68901-7621,Private      ,10,5,15,1487,119,1606
00255100,UNIVERSITY OF NEBRASKA AT KEARNEY       ,NE,68849-0001,Public       ,44,100,144,3921,1531,5452
00255300,MIDLAND LUTHERAN COLLEGE                ,NE,68025-4254,Private      ,7,18,25,869,226,1095
00255400,UNIVERSITY OF NEBRASKA-OMAHA            ,NE,68182-0001,Public       ,153,210,363,7516,5225,12741
00255500,NEBRASKA WESLEYAN UNIVERSITY            ,NE,68504-2796,Private      ,19,17,36,1884,499,2383
00255700,MID-PLAINS COMM COLLEGE - NORTH PLATTE  ,NE,69101-9420,Public       ,15,53,68,431,585,1016
00255701,MID-PLAINS COMMUNITY COLLEGE - MCCOOK   ,NE,69001-2631,Public       ,6,15,21,257,164,421
00255900,PERU STATE COLLEGE                      ,NE,68421-0010,Public       ,13,52,65,918,1010,1928
00256000,WESTERN NEBRASKA COMMUNITY COLLEGE      ,NE,69361-1815,Public       ,30,66,96,698,900,1598
00256300,UNION COLLEGE                           ,NE,68506-4387,Private      ,13,3,16,779,280,1059
00256500,UNIVERSITY OF NEBRASKA-LINCOLN          ,NE,68588-0419,Public       ,153,152,305,14288,4705,18993
00256596,UNIVERSITY OF NEBRASKA - CURTIS         ,NE,69025-9522,Public       ,2,1,3,212,30,242
00256600,WAYNE STATE COLLEGE                     ,NE,68787-1172,Public       ,25,37,62,2599,836,3435
00256700,YORK COLLEGE                            ,NE,68467-2699,Private      ,8,5,13,442,95,537
00443100,MARY LANNING MEM HOSP SCH RAD TECH      ,NE,68901-4497,Private      ,0,2,2,11,6,17
00443600,REGNL WST MEDCL CTR SCHL RAD            ,NE,69361-0000,Private      ,0,1,1,11,8,19
00458608,KAPLAN UNIVERSITY - OMAHA               ,NE,68134-1002,Proprietary  ,32,232,264,233,1470,1703
00458609,KAPLAN UNIVERSITY - LINCOLN             ,NE,68508-2668,Proprietary  ,24,168,192,180,990,1170
00639900,BRYANLGH COLLEGE OF HEALTH SCIENCES     ,NE,68506-1398,Private      ,3,3,6,281,234,515
00640400,NEBR METHODIST CLG OF NURS ALLD HLTH    ,NE,68114-2852,Private      ,12,19,31,364,512,876
00689500,UNIVERSITY OF NEBRASKA-MED CTR          ,NE,68198-4265,Public       ,4,31,35,535,2098,2633
00750100,VATTEROTT COLLEGE                       ,NE,68137-1237,Proprietary  ,24,114,138,196,853,1049
00849200,ALEGENT HEALTH SCHOOLS                  ,NE,68114-2767,Private      ,0,6,6,22,69,91
00952300,BAHNER COLLEGE OF HAIRSTYLING           ,NE,68025-3297,Proprietary  ,3,8,11,45,33,78
00961700,CAPITOL BEAUTY SCHOOL                   ,NE,68144-3873,Proprietary  ,6,15,21,112,86,198
00974300,BELLEVUE UNIVERSITY                     ,NE,68005-0000,Private      ,57,935,992,833,6635,7468
00986200,CLARKSON COLLEGE                        ,NE,68131-2739,Private      ,9,37,46,414,660,1074
01151900,JOSEPH'S COLLEGE OF BEAUTY/ALL CAMPUSES ,NE,68510-2226,Proprietary  ,14,41,55,180,319,499
01151909,JOSEPH'S COLLEGE OF BEAUTY - OMAHA      ,NE,68131-0000,Proprietary  ,0,1,1,5,6,11
01166700,NORTHEAST COMMUNITY COLLEGE             ,NE,68702-0000,Public       ,39,86,125,1461,1090,2551
01181400,GATEWAY ELECTRONICS INST                ,NE,68114-0000,Proprietary  ,0,0,0,0,1,1
01258600,METROPOLITAN COMMUNITY COLLEGE          ,NE,68103-0000,Public       ,197,821,1018,3519,7603,11122
01297600,NEBRASKA CHRISTIAN COLLEGE              ,NE,68046-4256,Private      ,1,0,1,136,41,177
02079700,COLLEGE OF HAIR DESIGN                  ,NE,68508-0000,Proprietary  ,18,15,33,207,106,313
02099500,CENTRAL COMMUNITY COLLEGE- GI           ,NE,68801-0000,Public       ,19,94,113,587,1106,1693
02099501,CENTRAL COMMUNITY COLLEGE - HASTINGS    ,NE,68902-0000,Public       ,22,47,69,861,611,1472
02099502,CENTRAL COMMUNITY COLLEGE - COLUMBUS    ,NE,68602-0000,Public       ,17,30,47,416,383,799
02508300,SOUTHEAST COMM. COLLEGE-ALL CAMPUSES    ,NE,68520-0000,Public       ,198,345,543,4601,4502,9103
02550800,NEBRASKA INDIAN COMMUNITY COLLEGE       ,NE,68039-0000,Private      ,2,23,25,18,92,110
02610500,XENON INTERNATIONAL ACADEMY II          ,NE,68127-3522,Proprietary  ,13,23,36,204,162,366
03127300,OMAHA SCHOOL OF MASSAGE THERAPY         ,NE,68127-5002,Proprietary  ,6,14,20,72,120,192
03164300,THE CREATIVE CENTER                     ,NE,68164-2911,Proprietary  ,0,1,1,149,27,176
03279300,MYOTHERAPY INSTITUTE                    ,NE,68516-3641,Proprietary  ,3,0,3,34,31,65
03323300,LITTLE PRIEST TRIBAL COLLEGE            ,NE,68071-0000,Private      ,3,11,14,30,80,110
03821400,UNIVERSAL COLLEGE OF HEALING ARTS       ,NE,68112-1810,Proprietary  ,0,4,4,15,51,66
00256800,UNIVERSITY OF NEVADA RENO               ,NV,89557-0002,Public       ,230,221,451,6581,4124,10705
00256900,UNIVERSITY OF NEVADA-LAS VEGAS          ,NV,89154-1001,Public       ,363,554,917,10686,12061,22747
00697700,GREAT BASIN COLLEGE                     ,NV,89801-3348,Public       ,35,92,127,434,908,1342
00736700,MARINELLO SCHOOLS OF BEAUTY             ,NV,89110-3563,Proprietary  ,32,62,94,131,398,529
00737100,MARINELLO SCHOOL OF BEAUTY              ,NV,89502-5982,Proprietary  ,11,30,41,65,141,206
00844103,ANTHEM INSTITUTE - MORRISON UNIVERSITY  ,NV,89521-4826,Proprietary  ,1,3,4,1,3,4
00919200,SIERRA NEVADA COLLEGE                   ,NV,89451-0000,Private      ,8,64,72,266,512,778
01036200,COLLEGE OF SOUTHERN NEVADA              ,NV,89030-4296,Public       ,583,1285,1868,6841,14046,20887
01036300,WESTERN NEVADA COLLEGE                  ,NV,89703-0000,Public       ,52,148,200,763,1715,2478
01323200,ACADEMY OF HAIR DESIGN                  ,NV,89102-0000,Proprietary  ,26,50,76,123,209,332
02107700,TRUCKEE MEADOWS COMMUNITY CLG           ,NV,89512-0000,Public       ,177,432,609,2249,4222,6471
02237500,LAS VEGAS COLLEGE                       ,NV,89103-0000,Proprietary  ,57,192,249,400,1067,1467
02338509,NEVADA CAREER INSTITUTE                 ,NV,89121-0000,Proprietary  ,10,59,69,41,188,229
02361001,ITT TECHNICAL INSTITUTE                 ,NV,89014-0000,Proprietary  ,98,153,251,476,1017,1493
02616703,SCOTTSDALE CULINARY INSTITUTE - LE CORDO,NV,89144-7047,Proprietary  ,13,20,33,109,222,331
02621500,CAREER COLLEGE OF NORTHERN NEVADA       ,NV,89502-2331,Proprietary  ,26,109,135,137,551,688
03030603,UTAH CLG OF MASSAGE THERAPY-NSMT        ,NV,89123-0000,Proprietary  ,37,102,139,189,460,649
03031405,INTERNATIONAL ACADEMY OF DESIGN AND TECH,NV,89074-7750,Proprietary  ,43,69,112,309,453,762
03043200,KAPLAN COLLEGE                          ,NV,89102-8618,Proprietary  ,39,187,226,191,874,1065
03076404,HIGH-TECH INSTITUTE - LAS VEGAS         ,NV,89102-4514,Proprietary  ,1,10,11,47,106,153
03084600,THE ART INSTITUTE OF LAS VEGAS          ,NV,89074-7737,Proprietary  ,83,142,225,1252,1454,2706
03088200,CARSON CITY BEAUTY ACADEMY              ,NV,89706-0000,Proprietary  ,6,19,25,28,126,154
03110000,ACADEMY OF HEALING ARTS                 ,NV,89106-4031,Proprietary  ,69,219,288,239,982,1221
03232306,EUPHORIA INSTITUTE - SUMMERLIN          ,NV,89117-8803,Proprietary  ,19,47,66,142,240,382
03232307,EUPHORIA INSTITUTE - GREEN VALLEY       ,NV,89052-4964,Proprietary  ,29,36,65,142,230,372
03232308,EUPHORIA INSTITUTE - ALIANTE            ,NV,89131-1036,Proprietary  ,18,53,71,65,133,198
03787300,EXPERTISE SCHOOL OF BEAUTY              ,NV,89106-2516,Private      ,4,44,48,43,180,223
03838500,NORTHWEST HEALTH CAREERS                ,NV,89128-0000,Proprietary  ,6,43,49,44,192,236
03975300,INSTITUTE OF PROFESSIONAL CAREERS       ,NV,89119-7825,Proprietary  ,1,12,13,14,67,81
04065300,UNIVERSITY OF SOUTHERN NEVADA           ,NV,89014-2333,Private      ,9,20,29,134,1157,1291
04114300,NEVADA STATE COLLEGE                    ,NV,89002-9455,Public       ,29,80,109,685,1212,1897
04147600,AVEDA INSTITUTE LAS VEGAS               ,NV,89119-6103,Proprietary  ,2,9,11,2,9,11
00257200,COLBY-SAWYER COLLEGE                    ,NH,03257-4648,Private      ,16,1,17,1876,42,1918
00257300,DARTMOUTH COLLEGE                       ,NH,03755-3529,Private      ,71,16,87,9107,1806,10913
00257500,FRANKLIN PIERCE COLLEGE                 ,NH,03461-0060,Private      ,21,66,87,3089,950,4039
00257900,NEW ENGLAND COLLEGE                     ,NH,03242-3293,Private      ,12,134,146,1495,808,2303
00258000,SOUTHERN NEW HAMPSHIRE UNIVERSITY       ,NH,03106-1045,Private      ,63,326,389,3930,3665,7595
00258100,NHTI  - CONCORD'S COMMUNITY COLLEGE     ,NH,03301-7412,Public       ,57,60,117,2036,1235,3271
00258200,MANCHESTER COMMUNITY COLLEGE            ,NH,03102-8518,Public       ,22,75,97,878,956,1834
00258202,NEW HAMPSHIRE COMMUNITY TECHNICAL COLLEG,NH,03038-0000,Public       ,0,0,0,39,14,53
00258300,GREAT BAY COMMUNITY COLLEGE             ,NH,03885-0000,Public       ,22,20,42,648,656,1304
00258600,RIVIER COLLEGE                          ,NH,03060-5086,Private      ,11,43,54,1341,838,2179
00258700,SAINT ANSELM COLLEGE                    ,NH,03102-1310,Private      ,23,0,23,3752,67,3819
00258900,UNIVERSITY OF NEW HAMPSHIRE             ,NH,03824-2511,Public       ,147,63,210,18283,2853,21136
00259000,KEENE STATE COLLEGE                     ,NH,03431-0000,Public       ,65,19,84,6762,536,7298
00259100,PLYMOUTH STATE UNIVERSITY               ,NH,03264-1595,Public       ,62,50,112,6000,841,6841
00301004,ANTIOCH UNIVERSITY                      ,NH,03431-0000,Private      ,0,7,7,3,817,820
00472900,HESSER COLLEGE                          ,NH,03103-7230,Proprietary  ,85,167,252,907,1239,2146
00472901,HESSER COLLEGE - NASHUA CAMPUS          ,NH,03063-1286,Proprietary  ,25,81,106,211,561,772
00472904,HESSER COLLEGE - PORTSMOUTH CAMPUS      ,NH,03801-3245,Proprietary  ,33,90,123,176,534,710
00472905,HESSER COLLEGE - SALEM CAMPUS           ,NH,03079-2842,Proprietary  ,32,76,108,274,650,924
00472906,HESSER COLLEGE - CONCORD CAMPUS         ,NH,03301-3415,Proprietary  ,19,100,119,121,510,631
00473000,MCINTOSH COLLEGE INC                    ,NH,03820-3990,Proprietary  ,1,1,2,268,208,476
00473100,DANIEL WEBSTER COLLEGE                  ,NH,03063-1300,Private      ,6,21,27,1106,249,1355
00473300,CHESTER COLLEGE OF NEW ENGLAND          ,NH,03036-4331,Private      ,2,2,4,295,32,327
00529100,WHITE MOUNTAINS COMMUNITY COLLEGE       ,NH,03570-3799,Public       ,14,37,51,291,537,828
00702500,LEBANON COLLEGE                         ,NH,03766-0000,Private      ,0,4,4,34,62,96
00755500,LAKES REGION COMMUNITY COLLEGE          ,NH,03246-1326,Public       ,13,23,36,536,399,935
00756000,RIVER VALLEY COMMUNITY COLLEGE          ,NH,03743-9707,Public       ,9,23,32,231,549,780
00849300,CONTINENTAL ACADEMIE OF HAIR DESIGN     ,NH,03103-4901,Proprietary  ,4,4,8,17,16,33
00864500,EMPIRE BEAUTY SCHOOL                    ,NH,03220-0000,Proprietary  ,16,31,47,134,124,258
00923600,NASHUA COMMUNITY COLLEGE                ,NH,03063-2052,Public       ,25,31,56,685,640,1325
01318900,CONTINENTAL ACADEMIE OF HAIR DESIGN     ,NH,03051-3754,Proprietary  ,7,8,15,32,27,59
02097900,FRANKLIN PIERCE LAW CENTER              ,NH,03301-0000,Private      ,0,11,11,13,781,794
02140400,ST JOSEPH SCH OF PRAC NRSG              ,NH,03060-0000,Private      ,4,7,11,39,92,131
02174800,MICHAEL'S SCHOOL OF HAIR DESIGN & ESTHET,NH,03110-0000,Proprietary  ,15,12,27,82,71,153
02179600,EMPIRE BEAUTY SCHOOL                    ,NH,03878-0000,Proprietary  ,25,33,58,124,187,311
02211600,PORTSMOUTH BTY SCH OF HAIR DESIGN       ,NH,03801-4084,Proprietary  ,1,1,2,27,10,37
02223300,MAGDALEN COLLEGE                        ,NH,03278-4012,Private      ,13,0,13,16,2,18
02245400,KEENE BEAUTY ACADEMY                    ,NH,03431-0000,Proprietary  ,5,5,10,45,37,82
02247000,NEW ENGLAND SCHOOL OF HAIR DESIGN       ,NH,03784-0000,Proprietary  ,6,7,13,39,54,93
02300200,CONCORD ACADEMY OF HAIR DESIGN          ,NH,03301-0000,Proprietary  ,0,1,1,7,12,19
03043100,THOMAS MORE COLLEGE OF LIBERAL ARTS     ,NH,03054-4818,Private      ,0,0,0,100,11,111
03101300,GRANITE STATE COLLEGE                   ,NH,03301-6400,Public       ,10,103,113,224,1282,1506
03182300,NEW HAMPSHIRE INSTITUTE OF ART          ,NH,03104-4858,Private      ,3,3,6,468,90,558
03305300,SECOND START                            ,NH,03301-5706,Private      ,0,0,0,0,1,1
03437300,UPPER VALLEY TEACHER INSTITUTE          ,NH,03766-1358,Private      ,0,2,2,5,43,48
03729300,NH INSTITUTE FOR THERAPEUTIC ARTS       ,NH,03051-4906,Proprietary  ,1,3,4,10,42,52
00267000,BAPTIST BIBLE COLG OF PENNSYLVANIA      ,PA,18411-1297,Private      ,5,9,14,653,157,810
00322800,BRYN ATHYN COLLEGE OF THE NEW CHURCH    ,PA,19009-0717,Private      ,7,1,8,85,14,99
00322900,ALBRIGHT COLLEGE                        ,PA,19612-5234,Private      ,46,55,101,3302,829,4131
00323000,ALLEGHENY COLLEGE                       ,PA,16335-3902,Private      ,20,3,23,3461,62,3523
00323100,COMM CLG OF ALLEGHENY-ALLEGHENY CMP     ,PA,15212-0000,Public       ,123,286,409,2364,4320,6684
00323101,"COMM CLG OF ALLEGHENY, BOYCE CAMPUS     ",PA,15146-0000,Public       ,48,177,225,1223,1886,3109
00323102,"COMM CLG OF ALLEGHENY, NORTH CAMPUS     ",PA,15237-0000,Public       ,33,77,110,1043,1082,2125
00323103,"COMM CLG OF ALLEGHENY, SOUTH CAMPUS     ",PA,15122-0000,Public       ,62,116,178,1645,1963,3608
00323300,ALVERNIA UNIVERSITY                     ,PA,19607-1799,Private      ,22,68,90,1909,1362,3271
00323500,ARCADIA UNIVERSITY                      ,PA,19038-3295,Private      ,30,82,112,3954,1609,5563
00323700,BRYN MAWR COLLEGE                       ,PA,19010-2899,Private      ,11,6,17,1525,474,1999
00323800,BUCKNELL UNIVERSITY                     ,PA,17837-2122,Private      ,25,2,27,5117,127,5244
00323900,BUCKS COUNTY COMMUNITY COLLEGE          ,PA,18940-1320,Public       ,125,274,399,3120,2665,5785
00324000,BUTLER COUNTY COMMUNITY COLLEGE         ,PA,16001-0000,Public       ,36,115,151,1627,1593,3220
00324100,CABRINI COLLEGE                         ,PA,19087-3698,Private      ,13,144,157,3032,1311,4343
00324200,CARNEGIE MELLON UNIVERSITY              ,PA,15213-3890,Private      ,70,25,95,9516,1172,10688
00324201,CARNEGIE MELLON UNIV- THE HEINZ SCH     ,PA,15213-0000,Private      ,6,5,11,309,472,781
00324202,CARNEGIE MELLON- TEPPER SCHOOL OF BUSINE,PA,15213-0000,Private      ,0,9,9,270,543,813
00324300,CEDAR CREST COLLEGE                     ,PA,18104-6196,Private      ,11,50,61,1396,1089,2485
00324400,CHATHAM UNIVERSITY                      ,PA,15232-2826,Private      ,8,25,33,762,1346,2108
00324500,CHESTNUT HILL COLLEGE                   ,PA,19118-2693,Private      ,5,55,60,1480,1450,2930
00324700,MISERICORDIA  UNIVERSITY                ,PA,18612-1008,Private      ,8,45,53,1945,936,2881
00324900,COMMUNITY COLLEGE OF PHILADELPHIA       ,PA,19130-3991,Public       ,284,823,1107,9822,15700,25522
00325100,CURTIS INSTITUTE OF MUSIC               ,PA,19103-6187,Private      ,2,1,3,260,61,321
00325200,DELAWARE VALLEY COLLEGE                 ,PA,18901-2697,Private      ,8,53,61,2241,345,2586
00325300,DICKINSON COLLEGE                       ,PA,17013-2896,Private      ,31,1,32,3102,64,3166
00325400,DICKINSON SCHOOL OF LAW                 ,PA,17013-2899,Private      ,0,1,1,25,1587,1612
00325600,DREXEL UNIVERSITY                       ,PA,19104-2875,Private      ,290,673,963,19751,12634,32385
00325800,DUQUESNE UNIVERSITY                     ,PA,15282-0001,Private      ,53,101,154,7141,3963,11104
00325900,EASTERN UNIVERSITY                      ,PA,19087-3696,Private      ,17,116,133,2149,2309,4458
00325908,EASTERN BAPTIST THEOLGCL SEMINARY       ,PA,19096-0000,Private      ,0,4,4,2,77,79
00326200,ELIZABETHTOWN COLLEGE                   ,PA,17022-2298,Private      ,12,31,43,2920,407,3327
00326300,EVANGELICAL SCHOOL OF THEOLOGY          ,PA,17067-0000,Private      ,0,0,0,0,107,107
00326500,FRANKLIN & MARSHALL COLLEGE             ,PA,17604-0000,Private      ,15,3,18,3032,71,3103
00326600,GANNON UNIVERSITY                       ,PA,16541-0001,Private      ,23,37,60,3469,1331,4800
00326700,GENEVA COLLEGE                          ,PA,15010-3599,Private      ,10,56,66,1872,909,2781
00326800,GETTYSBURG COLLEGE                      ,PA,17325-1486,Private      ,33,2,35,4053,63,4116
00326900,GROVE CITY COLLEGE                      ,PA,16127-0000,Private      ,12,0,12,1812,33,1845
00327000,GWYNEDD-MERCY COLLEGE                   ,PA,19437-0901,Private      ,10,93,103,1743,1152,2895
00327200,HARCUM COLLEGE                          ,PA,19010-3476,Private      ,10,35,45,501,869,1370
00327300,HARRISBURG AREA COMMUNITY COLLEGE       ,PA,17110-2999,Public       ,248,724,972,7446,11207,18653
00327400,HAVERFORD COLLEGE                       ,PA,19041-1392,Private      ,16,1,17,2062,29,2091
00327500,HOLY FAMILY UNIVERSITY                  ,PA,19114-2094,Private      ,18,50,68,2021,1770,3791
00327600,IMMACULATA UNIVERSITY                   ,PA,19345-0647,Private      ,4,94,98,1470,1494,2964
00327700,INDIANA UNIVERSITY OF PENNSYLVANIA      ,PA,15705-1097,Public       ,148,89,237,12906,3403,16309
00327900,JUNIATA COLLEGE                         ,PA,16652-2196,Private      ,12,4,16,2368,72,2440
00328000,KEYSTONE COLLEGE                        ,PA,18440-0200,Private      ,14,36,50,1646,738,2384
00328200,KINGS COLLEGE                           ,PA,18711-0801,Private      ,22,9,31,2867,442,3309
00328300,LACKAWANNA COLLEGE                      ,PA,18509-9961,Private      ,47,52,99,1410,819,2229
00328400,LAFAYETTE COLLEGE                       ,PA,18042-1768,Private      ,17,0,17,3711,59,3770
00328500,LANCASTER BIBLE COLLEGE                 ,PA,17601-5036,Private      ,4,21,25,566,322,888
00328600,LANCASTER THEOLOGICAL SEMINARY          ,PA,17603-0000,Private      ,0,3,3,0,111,111
00328700,LASALLE UNIVERSITY                      ,PA,19141-1199,Private      ,57,104,161,5402,2883,8285
00328800,LEBANON VALLEY COLLEGE                  ,PA,17003-1400,Private      ,13,7,20,2364,197,2561
00328900,LEHIGH UNIVERSITY                       ,PA,18015-1588,Private      ,54,29,83,8384,648,9032
00329000,LINCOLN UNIVERSITY                      ,PA,19352-0999,Public       ,67,21,88,3924,1087,5011
00329100,LUTHERAN THEOLOG SEMINARY-GETTYSBRG     ,PA,17325-0000,Private      ,0,2,2,0,145,145
00329200,LUTHERAN THEOLOGICAL SEMINARY           ,PA,19119-0000,Private      ,0,4,4,0,176,176
00329300,LYCOMING COLLEGE                        ,PA,17701-5192,Private      ,7,2,9,1825,81,1906
00329400,MANOR COLLEGE                           ,PA,19046-3399,Private      ,7,23,30,582,536,1118
00329600,MARYWOOD UNIVERSITY                     ,PA,18509-1598,Private      ,20,28,48,2569,1550,4119
00329700,MERCYHURST COLLEGE                      ,PA,16546-0001,Private      ,53,132,185,4133,1604,5737
00329800,MESSIAH COLLEGE                         ,PA,17027-0800,Private      ,17,2,19,3431,123,3554
00330000,MOORE COLLEGE OF ART & DESIGN           ,PA,19103-1179,Private      ,4,15,19,717,222,939
00330100,MORAVIAN COLLEGE                        ,PA,18018-6650,Private      ,11,7,18,2163,219,2382
00330101,MORAVIAN THEOLOGICAL SEMINARY           ,PA,18018-0000,Private      ,0,5,5,11,63,74
00330200,MOUNT ALOYSIUS COLLEGE                  ,PA,16630-1999,Private      ,15,26,41,1248,864,2112
00330300,CARLOW COLLEGE                          ,PA,15213-3165,Private      ,7,53,60,1182,1633,2815
00330400,MUHLENBERG COLLEGE                      ,PA,18104-5586,Private      ,17,19,36,3376,224,3600
00330600,VALLEY FORGE CHRISTIAN COLLEGE          ,PA,19460-2399,Private      ,9,9,18,841,218,1059
00330900,PEIRCE COLLEGE                          ,PA,19102-4699,Private      ,18,168,186,310,2301,2611
00331100,PENNSYLVANIA COLLEGE OF OPTOMETRY       ,PA,19027-1598,Private      ,0,4,4,10,851,861
00331300,WIDENER UNIVERSITY                      ,PA,19013-5792,Private      ,40,61,101,4192,2057,6249
00331302,WIDENER UNIV SCH OF LAW- HARRISBURG     ,PA,17106-9381,Private      ,0,4,4,3,848,851
00331500,BLOOMSBURG UNIVERSITY OF PA             ,PA,17815-1301,Public       ,128,42,170,10409,1649,12058
00331600,CALIFORNIA UNIV OF PENNSYLVANIA         ,PA,15419-1394,Public       ,59,128,187,6574,3891,10465
00331700,CHEYNEY UNIVERSITY OF PENNSYLVANIA      ,PA,19319-0200,Public       ,44,49,93,2287,880,3167
00331800,CLARION UNIVERSITY OF PENNSYLVANIA      ,PA,16214-1232,Public       ,47,58,105,5387,2086,7473
00332000,EAST STROUDSBURG UNIVERSITY             ,PA,18301-2999,Public       ,78,49,127,7508,1494,9002
00332100,EDINBORO UNIVERSITY OF PENNSYLVANIA     ,PA,16444-0001,Public       ,81,106,187,5861,3092,8953
00332200,KUTZTOWN UNIVERSITY OF PENNSYLVANIA     ,PA,19530-9339,Public       ,90,64,154,9986,1725,11711
00332300,LOCK HAVEN UNIV OF PENNSYLVANIA         ,PA,17745-2439,Public       ,54,42,96,5555,1141,6696
00332400,MANSFIELD UNIVERSITY                    ,PA,16933-1123,Public       ,42,33,75,3060,1045,4105
00332500,MILLERSVILLE UNIVERSITY OF PA           ,PA,17551-1800,Public       ,56,43,99,7935,1785,9720
00332600,SHIPPENSBURG UNIVERSITY                 ,PA,17257-2299,Public       ,84,42,126,7447,1312,8759
00332700,SLIPPERY ROCK UNIVERSITY                ,PA,16057-1326,Public       ,67,65,132,8016,2001,10017
00332800,WEST CHESTER UNIVERSITY                 ,PA,19383-0001,Public       ,142,91,233,13445,3133,16578
00332900,PENN STATE UNIVERSITY                   ,PA,16802-1503,Public       ,1120,710,1830,67677,17026,84703
00332901,PENN STATE UNIV-HERSHEY MEDCL CTR       ,PA,17033-0000,Public       ,5,5,10,82,1059,1141
00335000,UNIVERSITY OF THE ARTS (THE)            ,PA,19102-9493,Private      ,22,11,33,3289,594,3883
00335100,PHILADELPHIA BIBLICAL UNIVERSITY        ,PA,19047-2942,Private      ,5,34,39,939,566,1505
00335200,PHILADELPHIA CLG OSTEOPATHIC MED        ,PA,19131-0000,Private      ,0,18,18,15,2612,2627
00335300,UNIVERSITY OF THE SCIENCES IN PHILADELPH,PA,19104-4495,Private      ,35,26,61,3377,860,4237
00335400,PHILADELPHIA UNIVERSITY                 ,PA,19144-5497,Private      ,34,52,86,3913,997,4910
00335600,PITTSBURGH THEOLOGICAL SEMINARY         ,PA,15206-0000,Private      ,0,7,7,1,209,210
00335700,POINT PARK UNIVERSITY                   ,PA,15222-1912,Private      ,32,104,136,3058,2170,5228
00335800,REFORMED PRESBYTERIAN THEOL SEMINAR     ,PA,15208-0000,Private      ,0,1,1,0,27,27
00335900,ROBERT MORRIS UNIVERSITY                ,PA,15108-1189,Private      ,35,79,114,3857,1957,5814
00336000,ROSEMONT COLLEGE                        ,PA,19010-1699,Private      ,6,21,27,523,493,1016
00336200,SETON HILL UNIVERSITY                   ,PA,15601-1599,Private      ,16,27,43,1789,805,2594
00336400,ST. CHARLES BORROMEO SEMINARY           ,PA,19096-0000,Private      ,2,2,4,28,55,83
00336600,SAINT FRANCIS UNIVERSITY                ,PA,15940-0600,Private      ,10,24,34,1936,534,2470
00336700,SAINT JOSEPH'S UNIVERSITY               ,PA,19131-1395,Private      ,51,164,215,5957,2038,7995
00336800,ST VINCENT COLLEGE                      ,PA,15650-2690,Private      ,15,8,23,2129,316,2445
00336900,SUSQUEHANNA UNIVERSITY                  ,PA,17870-1001,Private      ,19,2,21,2773,96,2869
00337000,SWARTHMORE COLLEGE                      ,PA,19081-1397,Private      ,18,3,21,3607,46,3653
00337100,TEMPLE UNIV - MAIN CAMPUS               ,PA,19122-6003,Private      ,326,256,582,26491,7181,33672
00337101,TEMPLE UNIV - SCHOOL OF LAW             ,PA,19122-0000,Private      ,2,25,27,52,2620,2672
00337102,TEMPLE UNIV - SCHOOL OF MEDICINE        ,PA,19140-0000,Private      ,8,10,18,129,1259,1388
00337103,TEMPLE UNIV - SCHOOL OF DENTISTRY       ,PA,19140-0000,Private      ,3,2,5,30,577,607
00337104,TEMPLE UNIV - AMBLER CAMPUS             ,PA,19002-0000,Private      ,21,23,44,826,636,1462
00337105,TEMPLE UNIV - SCH OF ALLIED HEALTH      ,PA,19140-0000,Private      ,2,15,17,324,420,744
00337106,TEMPLE UNIV - SCHOOL OF PHARMACY        ,PA,19140-0000,Private      ,1,5,6,212,673,885
00337107,TEMPLE UNIV - TYLER SCHOOL OF ART       ,PA,19122-0000,Private      ,4,2,6,723,241,964
00337108,TEMPLE UNIV - GRAD DIV HEALTH SCI       ,PA,19140-0000,Private      ,1,11,12,84,460,544
00337109,TEMPLE UNIV - GRADUATE DIVISION         ,PA,19122-0000,Private      ,5,99,104,189,2752,2941
00337111,TEMPLE UNIV-SCH OF PODIATRIC MED        ,PA,19107-0000,Private      ,0,2,2,9,367,376
00337600,THIEL COLLEGE                           ,PA,16125-2181,Private      ,27,3,30,1556,141,1697
00337800,UNIVERSITY OF PENNSYLVANIA              ,PA,19104-6216,Private      ,118,206,324,15037,11853,26890
00337900,UNIVERSITY OF PITTSBURGH                ,PA,15260-0000,Public       ,229,295,524,25416,9980,35396
00337906,UNIV OF PITTSBURGH-SCH OF MEDICINE      ,PA,15261-0000,Public       ,1,4,5,53,888,941
00337907,UNIV OF PITTSBURGH-DENTAL MEDICINE      ,PA,15261-0000,Public       ,0,3,3,25,340,365
00338400,UNIVERSITY OF SCRANTON                  ,PA,18510-4622,Private      ,43,124,167,6648,1618,8266
00338500,URSINUS COLLEGE                         ,PA,19426-2562,Private      ,19,2,21,3763,86,3849
00338600,VALLEY FORGE MILITARY COLLEGE           ,PA,19087-3695,Private      ,4,2,6,237,14,251
00338800,VILLANOVA UNIVERSITY                    ,PA,19085-1699,Private      ,67,90,157,11410,1831,13241
00338801,VILLANOVA UNIV SCH OF LAW               ,PA,19085-0000,Private      ,1,14,15,21,1696,1717
00338900,WASHINGTON & JEFFERSON COLLEGE          ,PA,15301-4801,Private      ,23,2,25,2612,45,2657
00339100,WAYNESBURG UNIVERSITY                   ,PA,15370-1222,Private      ,13,77,90,1930,937,2867
00339200,WESTMINSTER COLLEGE                     ,PA,16172-0002,Private      ,12,4,16,2192,104,2296
00339300,WESTMINSTER THEOLOGICAL SEMINARY        ,PA,19038-0000,Private      ,0,0,0,3,273,276
00339400,WILKES UNIVERSITY                       ,PA,18766-0998,Private      ,26,53,79,3237,956,4193
00339500,PENNSYLVANIA COLLEGE OF TECHNOLOGY      ,PA,17701-5779,Public       ,44,29,73,5554,2151,7705
00339600,WILSON COLLEGE                          ,PA,17201-1285,Private      ,2,26,28,398,406,804
00339900,YORK COLLEGE OF PENNSYLVANIA            ,PA,17405-7199,Private      ,81,40,121,6120,1056,7176
00398600,DESALES UNIVERSITY                      ,PA,18034-9568,Private      ,10,55,65,2246,1039,3285
00398700,LA ROCHE COLLEGE                        ,PA,15237-5898,Private      ,11,17,28,1078,376,1454
00398800,NEUMANN COLLEGE                         ,PA,19014-1298,Private      ,29,41,70,2706,953,3659
00405800,GRATZ COLLEGE                           ,PA,19027-3097,Private      ,0,19,19,1,140,141
00445200,MONTGOMERY COUNTY COMMUNITY COLLEGE     ,PA,19422-6300,Public       ,123,307,430,3479,3787,7266
00488700,BRANDYWINE SCHOOL OF NURSING            ,PA,19320-1536,Proprietary  ,2,0,2,44,87,131
00488900,CAMBRIA-ROWE BUSINESS COLLEGE           ,PA,15902-2494,Proprietary  ,10,36,46,195,315,510
00489000,CENTRAL PENNSYLVANIA COLLEGE            ,PA,17093-0309,Proprietary  ,35,53,88,859,860,1719
00489300,DU BOIS BUSINESS COLLEGE                ,PA,15801-2401,Proprietary  ,8,30,38,210,318,528
00489400,ERIE BUSINESS CENTER                    ,PA,16501-1305,Proprietary  ,3,50,53,96,437,533
00489401,ERIE BUSINESS CENTER SOUTH              ,PA,16101-0000,Proprietary  ,3,9,12,26,88,114
00489800,MCCANN SCHOOL OF BUSINESS & TECHNOL     ,PA,17901-1335,Proprietary  ,84,325,409,1001,2314,3315
00489900,MERCY HOSP SCH OF NURSING               ,PA,15219-5166,Private      ,1,4,5,96,72,168
00490100,NEWPORT BUSINESS INSTITUTE              ,PA,15068-3929,Proprietary  ,5,13,18,51,72,123
00490200,PENN COMMERCIAL BUSINESS/TECHNICAL SCHL ,PA,15301-2871,Proprietary  ,20,71,91,282,501,783
00491000,KAPLAN CAREER INSTITUTE                 ,PA,17111-3571,Proprietary  ,42,227,269,288,806,1094
00491001,THOMPSON INSTITUTE-PHILADEPHIA CAMPUS   ,PA,19104-3386,Proprietary  ,56,272,328,302,1173,1475
00491400,NEWPORT BUSINESS INSTITUTE              ,PA,17701-5855,Proprietary  ,3,50,53,49,165,214
00500701,WEST VIRGINIA CAREER INSTITUTE          ,PA,15456-0000,Proprietary  ,4,31,35,61,157,218
00531000,PITTSBURGH INST OF AERONAUTICS          ,PA,15236-0000,Private      ,5,10,15,257,127,384
00533000,FAYETTE CNTY AREA VOC TECH PRC NRSG     ,PA,15401-0000,Public       ,3,2,5,30,121,151
00533500,CENTRAL PENN INST OF SCI & TECH PNP     ,PA,16823-0000,Public       ,1,3,4,41,111,152
00534100,UPPER BUCKS CO AREA VOC-TECH SCHOOL     ,PA,18944-0000,Public       ,0,0,0,1,3,4
00536500,YORK CO AREA VOC-TECH SCH-PRAC NSG      ,PA,17402-0000,Public       ,4,11,15,24,135,159
00594200,UPMC PRESBYTERIAN SCH OF RADIOLOGIC     ,PA,15213-2582,Private      ,0,2,2,25,37,62
00594600,SCHOOL OF RADIOLOGIC TECHNOLOGY AT ST. C,PA,19134-1995,Proprietary  ,0,3,3,23,46,69
00653400,CITIZENS SCHOOL OF NURSING              ,PA,15068-6591,Private      ,2,0,2,84,140,224
00653700,CONEMAUGH VLY MEM HOSP SCH NRSNG        ,PA,15905-4398,Private      ,0,1,1,91,132,223
00653702,CONEMAUGH HOSP- SCH HISTOTECHNOLOGY     ,PA,15905-0000,Private      ,0,1,1,5,7,12
00653704,CONEMAUGH VLY MEM HOSP SCH RAD TECH     ,PA,15905-0000,Private      ,0,0,0,23,11,34
00653706,CONEMAUGH VLY MEM HOSP SCH  MED TECH    ,PA,15905-4398,Private      ,0,0,0,8,3,11
00653900,EPISCOPAL HOSPITAL SCHL OF NURSING      ,PA,19125-1000,Private      ,1,3,4,13,105,118
00655100,ST MARGARET SCHL OF NURSING             ,PA,15238-3205,Private      ,3,11,14,70,163,233
00656000,OHIO VALLEY HOSP SCH OF NURSING         ,PA,15136-1694,Private      ,0,2,2,46,63,109
00656500,READING HOSPITAL SCHOOL OF HEALTH SCIENC,PA,19611-1744,Private      ,0,9,9,204,336,540
00657400,"ST LUKE'S HOSPITAL OF BETHLEHEM, PA     ",PA,18015-1065,Private      ,0,0,0,81,136,217
00657600,SEWICKLEY VALLEY HOSP SCH NRSNG         ,PA,15143-1498,Private      ,0,2,2,54,71,125
00657700,UPMC SHADYSIDE SCHOOL OF NURSING        ,PA,15232-1381,Private      ,13,40,53,123,328,451
00657800,SHARON REGIONAL SCHOOL OF NURSING       ,PA,16146-3395,Private      ,0,3,3,19,57,76
00658200,WASHINGTON HOSP SCH OF NURSING          ,PA,15301-3398,Private      ,0,4,4,60,147,207
00658202,WASHINGTON HOSP SCH OF RAD TECH         ,PA,15301-3398,Private      ,0,1,1,18,19,37
00658300,WESTERN PENN HOSP-SCH OF NURSING        ,PA,15224-1790,Private      ,1,5,6,107,136,243
00680700,COMMUNITY COLLEGE OF BEAVER COUNTY      ,PA,15061-2588,Public       ,32,59,91,1189,1307,2496
00681000,LEHIGH CARBON COMMUNITY COLLEGE         ,PA,18078-2598,Public       ,68,180,248,2647,2797,5444
00681100,LUZERNE COUNTY COMMUNITY COLLEGE        ,PA,18634-3899,Public       ,91,180,271,3062,2852,5914
00708700,ABINGTON MEM HOSP SCHL OF NURSING       ,PA,19090-1284,Private      ,3,3,6,97,263,360
00709000,METHODIST HOSPITAL SCH OF NURSING       ,PA,19148-3594,Private      ,0,0,0,4,17,21
00709100,EVEREST INSTITUTE                       ,PA,15222-1320,Proprietary  ,44,157,201,229,966,1195
00711000,DELAWARE COUNTY COMMUNITY COLLEGE       ,PA,19063-1094,Public       ,127,273,400,3785,4570,8355
00719100,NORTHAMPTON COMMUNITY COLLEGE           ,PA,18020-7599,Public       ,149,373,522,4556,4152,8708
00739802,KATHERINE GIBBS-PHILADELPHIA            ,PA,19403-2422,Proprietary  ,0,1,1,169,292,461
00743000,ANTONELLI INST OF ART & PHOTOGRAPHY     ,PA,19038-8242,Proprietary  ,0,0,0,245,19,264
00743600,KAPLAN CAREER INSTITUTE - ICM CAMPUS    ,PA,15222-1977,Proprietary  ,48,152,200,537,1174,1711
00743700,PITTSBURGH TECHNICAL INSTITUTE          ,PA,15071-3205,Proprietary  ,38,65,103,2386,878,3264
00746900,"HUSSIAN SCHOOL OF ART, INC.             ",PA,19106-0000,Proprietary  ,1,0,1,141,26,167
00747000,"ART INSTITUTE OF PITTSBURGH, THE        ",PA,15219-1328,Proprietary  ,703,4516,5219,6581,21282,27863
00752900,CTR ART TCH BRDYWN CMPS PRC NRS PRG     ,PA,19320-2459,Public       ,0,5,5,26,137,163
00775900,LINCOLN TECHNICAL INSTITUTE             ,PA,18104-3298,Proprietary  ,55,138,193,450,723,1173
00777900,LANSDALE SCHOOL OF BUSINESS             ,PA,19454-4148,Proprietary  ,15,64,79,126,453,579
00778000,NEW CASTLE SCHOOL OF TRADES             ,PA,16143-9721,Proprietary  ,38,124,162,291,647,938
00778100,CHI INSTITUTE/RETS CAMPUS               ,PA,19008-3516,Proprietary  ,57,140,197,334,803,1137
00783200,LINCOLN TECH INSTITUTE                  ,PA,19136-1595,Proprietary  ,75,95,170,539,476,1015
00783900,TRIANGLE TECH                           ,PA,15214-3897,Proprietary  ,16,23,39,177,176,353
00791200,THADDEUS STEVENS CLG OF TECHNOLOGY      ,PA,17602-0000,Public       ,3,10,13,929,287,1216
00791600,FRANKLIN CNTY CAREER & TECH CTR-PNP     ,PA,17201-0000,Public       ,0,1,1,14,37,51
00820000,JAMESON MEMORIAL HOSP SCH NURSING       ,PA,16105-2595,Private      ,0,2,2,33,102,135
00826301,AWARD BEAUTY SCHOOL - CHAMBERSBURG BEAUT,PA,17201-2435,Proprietary  ,2,0,2,4,3,7
00835000,ART INSTITUTE OF PHILADELPHIA           ,PA,19103-5198,Proprietary  ,133,185,318,3950,2262,6212
00844100,ANTHEM INSTITUTE                        ,PA,19064-1243,Proprietary  ,61,166,227,484,892,1376
00856800,MEDIAN SCHOOL                           ,PA,15222-3400,Proprietary  ,0,0,0,304,126,430
00865300,JEFFERSON CO DUBOIS VOC TECH-PR NSG     ,PA,15851-0000,Public       ,0,1,1,20,60,80
00888900,LEHIGH VALLEY COLLEGE                   ,PA,18034-8447,Proprietary  ,1,2,3,216,231,447
00895500,PRUONTOS HAIR DESIGN INSTITUTE & BEAUTY ,PA,16602-0000,Proprietary  ,1,3,4,17,32,49
00915705,WYOMING TECHNICAL INSTITUTE - BLAIRSVILL,PA,15717-8060,Proprietary  ,84,52,136,329,158,487
00918600,DEAN INSTITUTE OF TECHNOLOGY            ,PA,15226-1197,Proprietary  ,7,28,35,49,138,187
00944900,PENNCO TECH                             ,PA,19007-0000,Proprietary  ,47,104,151,321,502,823
00966400,EMPIRE BEAUTY SCHOOL                    ,PA,18052-5730,Proprietary  ,20,55,75,161,301,462
00966500,EMPIRE BEAUTY SCHOOL                    ,PA,17109-2210,Proprietary  ,15,35,50,68,256,324
00966600,EMPIRE BEAUTY SCHOOL                    ,PA,19605-2803,Proprietary  ,16,60,76,137,270,407
00972100,BRADFORD SCHOOL                         ,PA,15219-2602,Proprietary  ,2,0,2,662,134,796
00972300,FRANKFORD HOSP SCH OF NURSING           ,PA,19124-2696,Private      ,3,5,8,210,288,498
00978300,GORDON PHILLIPS SCH OF BEAUTY CULT      ,PA,19135-0000,Proprietary  ,30,64,94,251,356,607
00986301,LANCASTER INSTITUTE FOR HEALTH EDUC     ,PA,17602-4955,Private      ,7,7,14,287,500,787
01000600,GREATER JOHNSTOWN AREA VOC TECH SCH     ,PA,15904-0000,Public       ,5,23,28,62,251,313
01005500,CRAWFORD CNTY AREA VO-TECH PRAC NUR     ,PA,16335-0000,Public       ,0,0,0,8,26,34
01017600,WESTMORELAND COUNTY COMMUNITY CLG       ,PA,15697-1895,Public       ,81,249,330,2452,2967,5419
01038800,READING AREA COMMUNITY COLLEGE          ,PA,19603-1706,Public       ,129,324,453,1843,3330,5173
01054100,EMPIRE BEAUTY SCHOOL                    ,PA,15146-2229,Proprietary  ,21,54,75,168,301,469
01054200,EMPIRE BEAUTY SCHOOL                    ,PA,18701-0000,Proprietary  ,23,43,66,187,256,443
01054300,EMPIRE BEAUTY SCHOOL                    ,PA,17701-3914,Proprietary  ,14,38,52,114,205,319
01081400,PITTSBURGH INST MORTUARY SCIENCE        ,PA,15206-3706,Private      ,4,10,14,74,191,265
01086000,GREATER ALTOONA CAREER/TECH CENTER      ,PA,16602-0000,Public       ,0,3,3,62,168,230
01096300,GREENE COUNTY VOC-TECH SCHOOL           ,PA,15370-0000,Public       ,0,0,0,8,26,34
01097000,EMPIRE BEAUTY SCHOOL                    ,PA,17042-5209,Proprietary  ,1,11,12,29,47,76
01099800,PENNSYLVANIA INSTITUTE OF TECH          ,PA,19063-4098,Private      ,51,114,165,600,1024,1624
01102000,EMPIRE BEAUTY SCHOOL                    ,PA,17604-4335,Proprietary  ,15,50,65,73,129,202
01102100,EMPIRE BEAUTY SCHOOL                    ,PA,17402-2862,Proprietary  ,23,112,135,173,493,666
01162100,AUTOMOTIVE TRAINING CENTER              ,PA,19341-1310,Proprietary  ,61,41,102,571,226,797
01162200,WELDER TRAINING & TESTING INST          ,PA,18109-3253,Proprietary  ,11,26,37,38,68,106
01163800,EMPIRE BEAUTY SCHOOL                    ,PA,17876-0000,Proprietary  ,2,11,13,39,70,109
01171500,POTTSVILLE HOSPITAL SCHOOL OF NURSING   ,PA,17901-3692,Private      ,0,0,0,49,50,99
01191900,BEAVER FALLS BEAUTY ACADEMY             ,PA,15010-4208,Proprietary  ,5,14,19,22,53,75
01205000,ROSEDALE TECHNICAL INSTITUTE            ,PA,15205-9791,Private      ,18,26,44,184,171,355
01239300,THOMAS JEFF UNIV-CLG ALLIED HEALTH      ,PA,19107-0000,Private      ,1,17,18,361,888,1249
01239301,JEFFERSON MED CLG-T. JEFFERSON UNIV     ,PA,19107-5587,Private      ,0,10,10,137,1442,1579
01239303,THOMAS JEFFERSON UNIV-GRADUATE COLG     ,PA,19107-0000,Private      ,2,23,25,184,962,1146
01246104,LINCOLN TECHNICAL INSTITUTE             ,PA,19104-0202,Proprietary  ,78,241,319,416,941,1357
01246105,LINCOLN TECHNICAL INSTITUTE             ,PA,19116-4202,Proprietary  ,41,91,132,240,409,649
01252300,TALMUDICAL YESHIVA OF PHILA             ,PA,19131-1296,Private      ,4,0,4,27,2,29
01260500,EMPIRE BEAUTY SCHOOL                    ,PA,17331-2405,Proprietary  ,6,14,20,52,92,144
01260600,EMPIRE BEAUTY SCHOOL                    ,PA,17901-2505,Proprietary  ,16,66,82,148,407,555
01260700,EMPIRE BEAUTY SCHOOL                    ,PA,16801-5218,Proprietary  ,2,4,6,20,29,49
01292900,SOUTH HILLS BEAUTY ACADEMY              ,PA,15216-2335,Proprietary  ,5,18,23,45,84,129
01301500,GORDON PHILLIPS SCH BEAUTY CULTURE      ,PA,19102-2701,Proprietary  ,27,74,101,226,511,737
01313400,YESHIVATH BETH MOSHE                    ,PA,18505-2196,Private      ,1,0,1,44,1,45
01321400,ROXBOROUGH MEM HOSP SCH OF NURSING      ,PA,19128-0000,Proprietary  ,0,3,3,60,210,270
01326300,SOUTH HILLS SCH OF BUS & TECHNOLOGY     ,PA,16801-4516,Proprietary  ,1,3,4,492,427,919
01326304,SOUTH HILLS SCHOOL OF BUSINESS & TECHNOL,PA,16602-1188,Proprietary  ,0,2,2,32,28,60
02061000,VENUS BEAUTY ACADEMY                    ,PA,19079-0000,Proprietary  ,5,7,12,74,58,132
02068300,DOUGLAS SCHOOL OF BUSINESS              ,PA,15062-0000,Proprietary  ,13,26,39,229,251,480
02068301,DOUGLAS EDUCATION CENTER - DOUGLAS SCHOO,PA,15062-9901,Proprietary  ,0,0,0,22,24,46
02090200,TRIANGLE TECH                           ,PA,16502-0000,Proprietary  ,12,20,32,135,173,308
02092500,LAUREL TECHNICAL INSTITUTE              ,PA,16146-0000,Proprietary  ,6,41,47,49,250,299
02092502,BUSINESS INSTITUTE OF PENNSYLVANIA      ,PA,16335-0000,Proprietary  ,0,0,0,5,19,24
02107300,PENNSYLVANIA ACADEMY OF FINE ARTS       ,PA,19102-1424,Private      ,1,5,6,206,249,455
02112200,GREAT LAKES INSTITUTE OF TECHNOLOGY     ,PA,16509-0000,Proprietary  ,11,67,78,283,491,774
02114200,JOHNSON COLLEGE                         ,PA,18508-0000,Private      ,2,3,5,416,155,571
02116001,SANFORD-BROWN INSTITUTE - TREVOSE       ,PA,19053-4700,Proprietary  ,51,202,253,501,1356,1857
02118000,LEVITTOWN BEAUTY ACADEMY LLC            ,PA,19054-1713,Proprietary  ,5,8,13,28,41,69
02119300,PA ACAD OF COSMETOLOGY ARTS & SCI       ,PA,15904-0000,Proprietary  ,10,15,25,74,102,176
02119301,PA ACAD OF COSMTLGY ARTS & SCI          ,PA,15801-0000,Proprietary  ,0,0,0,1,0,1
02120800,"YORKTOWNE BUSINESS INSTITUTE, INC.      ",PA,17404-0000,Proprietary  ,11,34,45,124,222,346
02127400,YORK TECHNICAL INSTITUTE                ,PA,17402-0000,Proprietary  ,70,229,299,1140,1330,2470
02129000,TRIANGLE TECH                           ,PA,15601-0000,Proprietary  ,28,43,71,291,281,572
02129001,TRIANGLE TECH - BUSINESS CAREERS INSTITU,PA,15601-3304,Proprietary  ,0,0,0,2,3,5
02144000,"VISION ACADEMY, THE                     ",PA,18103-0000,Proprietary  ,9,33,42,72,120,192
02147800,SCHUYLKILL INST BUSINESS & TECHNLGY     ,PA,17901-0000,Proprietary  ,0,0,0,0,1,1
02149000,EMPIRE BEAUTY SCHOOL                    ,PA,19341-2804,Proprietary  ,13,22,35,89,136,225
02151500,CENTRAL SUSQUEHANNA LPN CENTER          ,PA,17847-0000,Public       ,0,3,3,27,151,178
02152105,ACADEMY OF COURT REPORTING & TECHNOLOGY ,PA,15222-1710,Proprietary  ,8,34,42,21,76,97
02153500,OAKBRIDGE ACADEMY OF ARTS               ,PA,15068-0000,Proprietary  ,2,2,4,73,19,92
02158300,JUNIATA-MIFFLIN CO AREA VOC TECH        ,PA,17044-0000,Public       ,6,14,20,21,73,94
02161400,NORTHEASTERN HOSP SCH OF NRSG           ,PA,19134-0000,Private      ,1,3,4,56,145,201
02169600,CLEARFIELD CTY CAREER AND TECH CNTR     ,PA,16830-0000,Public       ,1,7,8,44,120,164
02174400,TRIANGLE TECH                           ,PA,15801-0000,Proprietary  ,27,65,92,342,296,638
02178900,ACADEMY OF HAIR DESIGN                  ,PA,18202-1465,Proprietary  ,4,2,6,19,30,49
02183000,ORLEANS TECHNICAL INSTITUTE             ,PA,19111-0000,Private      ,47,140,187,227,727,954
02192800,WALNUT HILL COLLEGE                     ,PA,19104-0000,Proprietary  ,21,23,44,467,225,692
02202300,SANFORD-BROWN INSTITUTE                 ,PA,15219-1907,Proprietary  ,37,125,162,410,1003,1413
02202301,SANFORD-BROWN INSTITUTE                 ,PA,15146-2141,Proprietary  ,25,110,135,210,674,884
02203900,ERIE INSTITUTE OF TECHNOLOGY            ,PA,16565-1002,Proprietary  ,11,46,57,128,254,382
02206200,AMBLER BEAUTY ACADEMY                   ,PA,19002-0000,Proprietary  ,19,29,48,38,83,121
02206300,STROUDSBURG SCHOOL OF COSMETOLOGY       ,PA,18360-0000,Proprietary  ,2,3,5,17,22,39
02212700,LANCASTER SCHOOL OF COSMETOLOGY         ,PA,17602-0000,Proprietary  ,8,42,50,46,139,185
02213400,PROFESSIONAL SKILLS CAREER ACADEMY      ,PA,16148-0000,Proprietary  ,0,0,0,5,7,12
02234200,ACADEMY OF MEDICAL ARTS & BUSINESS      ,PA,17112-0000,Proprietary  ,7,39,46,92,220,312
02251200,SCHUYLKILL COUNTY AREA VOC TECH SCH     ,PA,17931-0000,Public       ,7,17,24,33,102,135
02251202,SCHUYLKILL COUNTY AREA VOC TECH SCH     ,PA,17931-0000,Public       ,2,6,8,17,32,49
02253900,BERKS TECHNICAL INSTITUTE               ,PA,19610-0000,Proprietary  ,40,102,142,467,719,1186
02255200,PENNSYLVANIA SCHOOL OF BUSINESS         ,PA,18101-1604,Proprietary  ,52,116,168,198,614,812
02269900,PENNSYLVANIA COLLEGE OF ART & DESIGN    ,PA,17603-3528,Private      ,1,2,3,348,66,414
02270500,BUCKS COUNTY SCHOOL OF BEAUTY CULT      ,PA,19053-0000,Proprietary  ,7,7,14,49,39,88
02273400,RECONSTRUCTIONIST RABBINICAL COLLEG     ,PA,19095-0000,Private      ,0,0,0,0,28,28
02276600,HANOVER PUBLIC SCH DIST PRAC NURSG      ,PA,17331-0000,Public       ,0,4,4,10,41,51
02282500,LENAPE SCHOOL OF PRACTICAL NURSING      ,PA,16226-0000,Public       ,2,22,24,34,178,212
02288800,EMPIRE BEAUTY SCHOOL                    ,PA,18974-4508,Proprietary  ,7,12,19,56,73,129
02289500,PACE INSTITUTE                          ,PA,19601-0000,Proprietary  ,14,48,62,86,375,461
02289600,CONSOLIDATED SCHOOL OF BUSINESS         ,PA,17404-0000,Proprietary  ,4,14,18,51,163,214
02289700,ACADEMY OF CREATIVE HAIR DESIGN         ,PA,18702-0000,Proprietary  ,13,23,36,51,75,126
02289800,CHI INSTITUTE - FRANKLIN MILLS          ,PA,19154-0000,Proprietary  ,87,174,261,524,1332,1856
02290400,"ALTOONA BEAUTY SCHOOL, INC              ",PA,16602-0000,Proprietary  ,4,18,22,42,74,116
02292700,LANSDALE SCHOOL OF COSMETOLOGY          ,PA,19446-0000,Proprietary  ,5,7,12,31,34,65
02299300,TRINITY EPISCOPAL SCHOOL MINISTRY       ,PA,15003-0000,Private      ,0,2,2,1,67,68
02301300,PJA SCHOOL (THE)                        ,PA,19082-1917,Proprietary  ,13,53,66,116,392,508
02304400,YTI CAREER INSTITUTE - MECHANICSBURG    ,PA,17055-0000,Proprietary  ,6,45,51,170,277,447
02306200,VENANGO COUNTY AREA VOC TECH SCHOOL     ,PA,16301-0000,Public       ,1,1,2,9,33,42
02310800,LANCASTER COUNTY CAREER & TECH CTR      ,PA,17584-0000,Public       ,18,50,68,155,561,716
02330300,LEBANON CO CAREER & TECHNOLOGY CTR      ,PA,17042-0000,Public       ,0,3,3,18,101,119
02330600,PENNSYLVANIA GUNSMITH SCHOOL            ,PA,15202-0000,Proprietary  ,1,7,8,36,45,81
02350100,WESTERN AREA CAREER & TECHNOLOGY CT     ,PA,15317-0000,Public       ,1,2,3,18,55,73
02350200,INDIANA COUNTY TECH CTR SCH PR NSG      ,PA,15701-1465,Public       ,1,13,14,23,57,80
02353100,NORTHERN TIER CAREER CENTER             ,PA,18848-0000,Public       ,0,2,2,18,50,68
02361002,ITT TECHNICAL INSTITUTE                 ,PA,19406-0000,Proprietary  ,49,100,149,362,499,861
02362300,MERCER COUNTY AREA VOC TECH SCHOOL      ,PA,16137-0000,Public       ,0,4,4,16,83,99
02492500,DELAWARE VLY ACAD MED DNTL ASSTS        ,PA,19114-0000,Proprietary  ,8,22,30,50,123,173
02492600,EASTERN CTR ARTS AND TECH PR NSG        ,PA,19090-0000,Public       ,5,24,29,20,178,198
02495500,ALL-STATE CAREER SCHOOL                 ,PA,19029-0000,Proprietary  ,49,263,312,265,1114,1379
02529800,WILKES BARRE AREA CAREER AND TECHNICAL C,PA,18705-0000,Public       ,6,27,33,58,205,263
02536600,COMMONWEALTH TECH INSTIT @ HIRAM G      ,PA,15905-0000,Public       ,28,15,43,241,126,367
02539900,STAR TECHNICAL INSTITUTE                ,PA,19082-0000,Proprietary  ,0,0,0,26,123,149
02544300,BUTLER BEAUTY SCHOOL                    ,PA,16001-0000,Proprietary  ,7,23,30,54,122,176
02545000,LAWRENCE COUNTY CAREER AND TECHNICAL CEN,PA,16101-0000,Public       ,5,6,11,15,74,89
02546200,LAUREL BUSINESS INSTITUTE               ,PA,15401-0877,Proprietary  ,13,40,53,193,314,507
02550000,CLARION CO AREA VOC-TECH PRAC NRSG      ,PA,16254-0000,Public       ,0,2,2,12,46,58
02554500,HAZLETON AREA VOC TECH SCH PR NSG       ,PA,18201-1597,Public       ,1,2,3,16,41,57
02557800,ART INSTITUTE OF YORK (THE) - PENNSYLVAN,PA,17402-9012,Proprietary  ,24,24,48,771,261,1032
02566400,ALBERT EINSTEIN MED CTR DEPT DNTL       ,PA,19141-3098,Private      ,1,2,3,7,22,29
02574800,PENNSYLVANIA INSTITUTE OF TAXIDERMY     ,PA,15931-0000,Proprietary  ,0,3,3,8,23,31
02609500,CAREER TRAINING ACADEMY                 ,PA,15068-6308,Proprietary  ,11,44,55,70,246,316
02609501,CAREER TRAINING ACADEMY                 ,PA,15146-0000,Proprietary  ,0,0,0,3,4,7
02615400,STAR TECHNICAL INSTITUTE                ,PA,19114-2204,Proprietary  ,0,0,0,83,393,476
02616100,JEAN MADELINE ED CTR FOR COSM           ,PA,19147-1542,Proprietary  ,20,33,53,316,263,579
03006800,PENNSYLVANIA CULINARY INSTITUTE         ,PA,15222-3511,Proprietary  ,39,89,128,1050,1116,2166
03010800,TRI-STATE BUSINESS INSTITUTE            ,PA,16506-1013,Proprietary  ,127,400,527,826,2358,3184
03011500,ALLIED MEDICAL AND TECHNICAL INSTITUTE  ,PA,18702-0000,Proprietary  ,29,91,120,199,407,606
03011600,ALLIED MEDICAL AND TECHNICAL INSTITUTE  ,PA,18509-2903,Proprietary  ,28,98,126,227,423,650
03029900,CONSOLIDATED SCHOOL OF BUSINESS         ,PA,17603-2389,Proprietary  ,4,20,24,54,191,245
03031600,DPT BUSINESS SCHOOL                     ,PA,19116-3961,Proprietary  ,20,148,168,90,564,654
03031601,DPT BUSINESS SCHOOL                     ,PA,19106-0000,Proprietary  ,22,108,130,71,338,409
03067000,ANTONELLI MEDICAL & PROF INST           ,PA,19464-9244,Proprietary  ,1,22,23,10,58,68
03072400,ALL-STATE CAREER SCHOOL                 ,PA,15122-1000,Proprietary  ,4,55,59,17,186,203
03072600,DCI CAREER INSTITUTE                    ,PA,15061-2307,Proprietary  ,13,41,54,51,200,251
03081900,YTI CAREER INSTITUTE - ALTOONA          ,PA,16602-4457,Proprietary  ,25,56,81,158,345,503
03090800,LAKE ERIE COLL OF OSTEOPATHIC MED       ,PA,16509-0000,Private      ,1,6,7,82,2532,2614
03098600,CAREER TECH CTR OF LACKAWANNA CNTY      ,PA,18508-0000,Public       ,0,0,0,32,113,145
03101500,BIDWELL TRAINING CENTER                 ,PA,15233-2233,Private      ,4,23,27,19,51,70
03103300,JNA INSTITUTE OF CULINARY ARTS          ,PA,19146-3119,Proprietary  ,3,15,18,69,129,198
03109100,METROPOLITAN CAREER CENTER              ,PA,19144-0000,Private      ,6,24,30,44,211,255
03110700,AVIATION INSTITUTE OF MAINTENANCE       ,PA,19114-1017,Proprietary  ,16,49,65,142,354,496
03120400,REGIONAL CAREER & TECHNICAL CENTER      ,PA,16509-4699,Public       ,0,0,0,4,6,10
03126000,CENTER FOR INNOVATIVE TRAINING & ED     ,PA,19106-4414,Proprietary  ,0,0,0,1,4,5
03128400,DELAWARE COUNTY TECHNICAL SCHOOL        ,PA,19032-1998,Public       ,3,18,21,25,185,210
03180400,PENNSYLVANIA HIGHLANDS COMMUNITY COLLEGE,PA,15904-2927,Public       ,16,66,82,592,736,1328
03236400,LT INTERNATIONAL BEAUTY SCHOOL          ,PA,19130-2235,Proprietary  ,5,32,37,23,117,140
03353300,ACADEMY OF VOCAL ARTS                   ,PA,19103-6685,Private      ,0,0,0,4,33,37
03380301,CULINARY ACADEMY OF LONG ISLAND - STAR P,PA,19114-2204,Proprietary  ,25,78,103,32,104,136
03439400,NAWCC SCHOOL OF HOROLOGY                ,PA,17512-2130,Private      ,0,0,0,2,6,8
03503300,WINNER INSTITUTE OF ARTS & SCIENCES     ,PA,16154-1811,Private      ,0,0,0,9,4,13
03535300,HUNTINGDON COUNTY CAREER AND TECHNO     ,PA,17060-0905,Public       ,0,1,1,10,35,45
03561400,SUSQUEHANNA COUNTY CAREER & TECHNOL     ,PA,18816-0100,Public       ,0,1,1,6,12,18
03766300,PENNSYLVANIA SCHOOL OF MUSCLE THERAPY   ,PA,19406-3101,Proprietary  ,2,25,27,40,118,158
03899300,CALVARY BAPTIST THEOLOGICAL SEMINARY    ,PA,19446-4718,Private      ,0,1,1,0,11,11
03923300,PRECISION MANUFACTURING INSTITUTE       ,PA,16335-8380,Private      ,4,13,17,17,56,73
03948300,HARRISBURG UNIVERSITY OF SCIENCE AND TEC,PA,17101-2116,Private      ,4,9,13,163,138,301
03949300,WON INSTITUTE OF GRADUATE STUDIES       ,PA,19038-4535,Private      ,0,0,0,0,35,35
03950500,NORTHWEST REGIONAL TECHNOLOGY INSTITUTE ,PA,16508-2820,Proprietary  ,1,11,12,7,55,62
03952300,NATIONAL MASSAGE THERAPY INSTITUTE      ,PA,19116-3965,Proprietary  ,30,161,191,171,652,823
04119900,PENNSYLVANIA MYOTHERAPY INSTITUTE       ,PA,17350-8426,Proprietary  ,2,7,9,6,22,28
04127500,CAREER DEVELOPMENT & EMPLOYMENT         ,PA,18702-5253,Proprietary  ,0,7,7,2,33,35
04137100,KIMBERLY'S BEAUTY SCHOOL                ,PA,19134-0000,Proprietary  ,0,2,2,0,2,2
04138300,INTERNATIONAL BEAUTY ACADEMY            ,PA,19149-2710,Proprietary  ,1,7,8,2,10,12
00267813,BRYANT & STRATTON COLLEGE - MIL DOWNTOWN,WI,53203-2608,Proprietary  ,52,190,242,610,2102,2712
00383200,ALVERNO COLLEGE                         ,WI,53234-3922,Private      ,27,58,85,1475,2134,3609
00383500,BELOIT COLLEGE                          ,WI,53511-5595,Private      ,8,0,8,1933,76,2009
00383700,CARDINAL STRITCH UNIVERSITY             ,WI,53217-9884,Private      ,37,541,578,967,4593,5560
00383800,CARROLL UNIVERSITY                      ,WI,53186-5593,Private      ,22,26,48,3101,680,3781
00383900,CARTHAGE COLLEGE                        ,WI,53141-0000,Private      ,21,48,69,3793,594,4387
00384000,WESTERN TECHNICAL COLLEGE               ,WI,54601-0908,Public       ,76,164,240,1769,2195,3964
00384200,CONCORDIA UNIVERSITY WISCONSIN          ,WI,53097-2402,Private      ,26,313,339,2050,3222,5272
00384800,EDGEWOOD COLLEGE                        ,WI,53711-1958,Private      ,19,64,83,1578,950,2528
00385000,SILVER LAKE COLLEGE                     ,WI,54220-9319,Private      ,2,22,24,194,404,598
00385400,LAKELAND COLLEGE                        ,WI,53082-0000,Private      ,10,112,122,1169,1890,3059
00385600,LAWRENCE UNIVERSITY                     ,WI,54912-0599,Private      ,13,1,14,2239,61,2300
00386100,MARIAN UNIVERSITY                       ,WI,54935-4699,Private      ,18,77,95,1251,1229,2480
00386300,MARQUETTE UNIVERSITY                    ,WI,53201-0000,Private      ,76,89,165,10872,3940,14812
00386600,MILWAUKEE AREA TECH COLLEGE             ,WI,53233-1443,Public       ,346,852,1198,5195,12826,18021
00386800,MILWAUKEE SCHOOL OF ENGINEERING         ,WI,53202-3109,Private      ,23,35,58,2596,598,3194
00386900,MOUNT MARY COLLEGE                      ,WI,53222-4597,Private      ,20,46,66,796,1270,2066
00387400,NASHOTAH HOUSE                          ,WI,53058-0000,Private      ,0,2,2,0,44,44
00387500,NORTHLAND COLLEGE                       ,WI,54806-3999,Private      ,9,2,11,801,140,941
00388400,RIPON COLLEGE                           ,WI,54971-0248,Private      ,11,2,13,1277,55,1332
00389200,ST. NORBERT COLLEGE                     ,WI,54115-2002,Private      ,20,4,24,2249,104,2353
00389500,UNIVERSITY OF WISCONSIN-MADISON         ,WI,53715-1382,Public       ,309,203,512,21332,10143,31475
00389600,UNIVERSITY OF WISCONSIN-MILWAUKEE       ,WI,53201-3165,Public       ,314,402,716,16476,9977,26453
00389700,UNIVERSITY OF WISCONSIN COLLEGES        ,WI,53708-8680,Public       ,71,77,148,1664,1250,2914
00389701,UNIVERSITY OF WISCONSIN-BARABOO         ,WI,53913-1098,Public       ,6,4,10,283,159,442
00389702,UNIVERSITY OF WISCONSIN-BARRON          ,WI,54868-2497,Public       ,7,3,10,218,129,347
00389703,UNIVERSITY OF WISCONSIN-FOND DU LAC     ,WI,54935-2998,Public       ,12,11,23,439,186,625
00389704,UNIVERSITY OF WISCONSIN-FOX VALLEY      ,WI,54952-1297,Public       ,29,30,59,774,404,1178
00389705,UNIVERSITY OF WISCONSIN-MANITOWOC       ,WI,54220-6699,Public       ,11,3,14,277,113,390
00389706,UNIVERSITY OF WISCONSIN-MARATHON        ,WI,54401-5396,Public       ,30,19,49,754,316,1070
00389707,UNIVERSITY OF WISCONSIN-MARINETTE       ,WI,54143-4299,Public       ,4,8,12,235,113,348
00389708,UNIVERSITY OF WISCONSIN-MARSHFIELD      ,WI,54449-3310,Public       ,3,5,8,272,153,425
00389709,UNIVERSITY OF WISCONSIN-RICHLAND        ,WI,53581-1399,Public       ,4,8,12,251,76,327
00389710,UNIVERSITY OF WISCONSIN COLLEGES - ROCK ,WI,53546-5699,Public       ,22,20,42,488,314,802
00389711,UNIVERSITY OF WISCONSIN-SHEBOYGAN       ,WI,53081-4789,Public       ,18,19,37,336,223,559
00389712,UNIVERSITY OF WISCONSIN-WASHINGTON      ,WI,53095-3699,Public       ,14,7,21,441,170,611
00389713,UNIVERSITY OF WISCONSIN-WAUKESHA        ,WI,53188-2799,Public       ,36,23,59,908,350,1258
00389900,UNIVERSITY OF WISCONSIN-GREEN BAY       ,WI,54311-7001,Public       ,50,63,113,4172,1634,5806
00391100,VITERBO UNIVERSITY                      ,WI,54601-4777,Private      ,11,52,63,1543,1048,2591
00391500,UNIVERSITY OF WISCONSIN-STOUT           ,WI,54751-0790,Public       ,92,99,191,5773,1826,7599
00391700,UNIVERSITY OF WISCONSIN-EAU CLAIRE      ,WI,54702-4004,Public       ,115,58,173,8066,1596,9662
00391900,UNIVERSITY OF WISCONSIN-LA CROSSE       ,WI,54601-3742,Public       ,93,74,167,6932,1589,8521
00392000,UNIVERSITY OF WISCONSIN-OSHKOSH         ,WI,54901-8604,Public       ,118,143,261,6988,2889,9877
00392100,UNIVERSITY OF WISCONSIN-PLATTEVILLE     ,WI,53818-3099,Public       ,69,84,153,5108,1493,6601
00392300,UNIVERSITY OF WISCONSIN-RIVER FALLS     ,WI,54022-5013,Public       ,64,63,127,4793,1156,5949
00392400,UNIVERSITY OF WISCONSIN-STEVENS POINT   ,WI,54481-3871,Public       ,99,62,161,6581,1668,8249
00392500,UNIVERSITY OF WISCONSIN-SUPERIOR        ,WI,54880-2898,Public       ,35,61,96,1532,1261,2793
00392600,UNIVERSITY OF WISCONSIN-WHITEWATER      ,WI,53190-1792,Public       ,111,92,203,7643,2114,9757
00400700,MADISON AREA TECHNICAL COLLEGE          ,WI,53704-2599,Public       ,196,274,470,3901,5074,8975
00501500,UNIVERSITY OF WISCONSIN-PARKSIDE        ,WI,53141-2000,Public       ,88,92,180,3231,1903,5134
00529400,WAUKESHA COUNTY TECHNICAL COLLEGE       ,WI,53072-4696,Public       ,71,129,200,1268,2039,3307
00530100,NORTHEAST WISCONSIN TECHNICAL COLLEGE   ,WI,54307-9042,Public       ,73,246,319,2110,3706,5816
00530400,CHIPPEWA VALLEY TECHNICAL COLLEGE       ,WI,54701-6162,Public       ,56,86,142,2251,2939,5190
00538000,MID-STATE TECHNICAL COLLEGE             ,WI,54494-5512,Public       ,51,105,156,834,1621,2455
00538400,NICOLET AREA TECHNICAL COLLEGE          ,WI,54501-0000,Public       ,20,58,78,453,715,1168
00538700,NORTHCENTRAL TECHNICAL COLLEGE          ,WI,54401-1899,Public       ,47,160,207,901,1903,2804
00538900,GATEWAY TECHNICAL COLLEGE               ,WI,53144-1690,Public       ,57,225,282,1581,4982,6563
00539000,BLACKHAWK TECHNICAL COLLEGE             ,WI,53547-5009,Public       ,27,182,209,799,2262,3061
00610800,BELLIN HOSP SCH OF RAD TECH             ,WI,54305-3505,Private      ,0,0,0,11,2,13
00611500,MERCY MED CTR SCH OF RAD TECH           ,WI,54904-3370,Private      ,0,0,0,13,8,21
00612601,ST LUKE'S MEDCL CTR SCHL RAD TECH       ,WI,53215-4330,Private      ,0,1,1,3,16,19
00612603,ST LUKE'S MED CTR SCH OF SONOGRAPHY     ,WI,53215-0000,Private      ,0,1,1,3,10,13
00613100,THEDA CLARK REG MED CTR SCH RAD TEC     ,WI,54957-0000,Private      ,0,1,1,3,13,16
00663900,BELLIN COLLEGE                          ,WI,54305-3400,Private      ,4,2,6,214,128,342
00766900,SOUTHWEST WISCONSIN TECH COLLEGE        ,WI,53809-0000,Public       ,10,39,49,663,724,1387
00777400,SCIENTIFIC COLLEGE OF BEAUTY/BARBER     ,WI,54601-0000,Proprietary  ,0,0,0,13,26,39
00821700,WISCONSIN COLLEGE OF COSMETOLOGY        ,WI,54304-5531,Proprietary  ,3,5,8,52,42,94
00919400,LAKESHORE TECHNICAL COLLEGE             ,WI,53015-1412,Public       ,16,69,85,513,1414,1927
00925600,MORAINE PARK TECHNICAL COLLEGE          ,WI,54936-0000,Public       ,24,104,128,801,1903,2704
00941900,STATE CLG OF BEAUTY CULT-WAUSAU         ,WI,54403-4667,Proprietary  ,7,11,18,50,54,104
00962100,HERZING COLLEGE                         ,WI,53718-4236,Proprietary  ,39,488,527,626,3183,3809
00974400,FOX VALLEY TECHNICAL COLLEGE            ,WI,54913-0000,Public       ,77,187,264,2311,3485,5796
01091300,MADISON MEDIA INSTITUTE                 ,WI,53718-6787,Proprietary  ,15,14,29,338,179,517
01148400,ADVANCED INSTITUTE OF HAIR DESIGN       ,WI,53225-0000,Proprietary  ,19,19,38,161,156,317
01182400,WISCONSIN INDIANHEAD TECH CLG WITC      ,WI,54871-9300,Public       ,42,84,126,1066,1942,3008
01290600,MADISON COSMETOLOGY COLLEGE             ,WI,53711-1030,Proprietary  ,0,0,0,8,19,27
02077100,MILWAUKEE INST OF ART & DESIGN          ,WI,53202-0000,Private      ,10,3,13,764,157,921
02078000,SACRED HEART SCHOOL OF THEOLOGY         ,WI,53130-0000,Private      ,0,0,0,0,7,7
02136600,WISCONSIN LUTHERAN COLLEGE              ,WI,53226-0000,Private      ,4,1,5,819,74,893
02201803,KAPLAN COLLEGE - MILWAUKEE              ,WI,53212-3939,Proprietary  ,48,216,264,203,913,1116
02239204,HIGH-TECH INSTITUTE - MILWAUKEE         ,WI,53005-4207,Proprietary  ,3,4,7,14,32,46
02271300,WI SCH OF PROFESSIONAL PSYCHOLOGY       ,WI,53225-0000,Private      ,0,3,3,4,66,70
02317200,MARANATHA BAPTIST BIBLE COLLEGE         ,WI,53094-0000,Private      ,26,6,32,714,107,821
02324700,MARTIN'S COLLEGE OF COSMETOLOGY         ,WI,53717-0000,Proprietary  ,1,19,20,91,167,258
02332100,MARTIN'S SCH HAIR DESIGN MANITOWOC      ,WI,54220-0000,Proprietary  ,13,29,42,105,139,244
02332101,MARTIN'S COLLEGE OF COSMETOLOGY -       ,WI,54914-4644,Proprietary  ,0,3,3,7,12,19
02453500,MEDICAL COLLEGE OF WISCONSIN            ,WI,53226-0000,Private      ,1,6,7,16,1130,1146
02494300,GILL-TECH ACADEMY OF HAIR DESIGN        ,WI,54911-0000,Proprietary  ,7,8,15,68,51,119
02503303,RASMUSSEN COLLEGE - MANKATO - GREEN BAY ,WI,54303-2349,Proprietary  ,25,119,144,169,655,824
02532200,LAC COURTE OREILLES OJIBWA CMTY CLG     ,WI,54843-0000,Public       ,14,57,71,90,404,494
03007400,LAKESIDE SCHOOL OF MASSAGE THERAPY      ,WI,53719-1103,Private      ,4,16,20,45,130,175
03061200,MIDWEST COLLEGE OF ORIENTAL MEDICINE    ,WI,53403-9747,Proprietary  ,0,7,7,8,228,236
03077600,MARTIN'S COLLEGE OF COSMETOLOGY         ,WI,54304-4838,Proprietary  ,25,72,97,203,374,577
03087500,ITT TECHNICAL INSTITUTE                 ,WI,53220-4612,Proprietary  ,256,520,776,1518,2962,4480
03125100,COLLEGE OF MENOMINEE NATION             ,WI,54135-0000,Private      ,18,79,97,134,490,624
03125102,COLLEGE OF  THE MENOMINEE NATION - GREEN,WI,54304-4964,Private      ,2,3,5,17,80,97
03220300,PROFESSIONAL HAIR DESIGN ACADEMY        ,WI,54701-7633,Proprietary  ,6,9,15,84,84,168
03309300,MONTESSORI INSTITUTE OF MILWAUKEE       ,WI,53207-0000,Private      ,1,0,1,3,12,15
03808300,INSTITUTE OF BEAUTY AND WELLNESS (THE)  ,WI,53202-5715,Proprietary  ,16,11,27,79,87,166
03822300,FOUR SEASONS SALON & DAY SPA            ,WI,53566-0000,Proprietary  ,1,0,1,13,22,35
03872500,NORTHLAND INTERNATIONAL UNIVERSITY      ,WI,54119-9285,Private      ,23,1,24,415,50,465
03925300,BLUE SKY SCHOOL OF PROFESSIONAL MASSAGE ,WI,53024-2624,Private      ,7,24,31,49,118,167
04117400,MILWAUKEE CAREER COLLEGE                ,WI,53222-4305,Proprietary  ,21,117,138,92,523,615
04118600,ACADEMY OF COSMETOLOGY                  ,WI,53548-3307,Proprietary  ,4,9,13,35,64,99
04124800,VISIONS IN HAIR DESIGN INSTITUTE OF COSM,WI,53210-1120,Proprietary  ,2,2,4,3,3,6
04132600,WISCONSIN ACADEMY (THE)                 ,WI,54157-1726,Proprietary  ,1,3,4,21,34,55
04138200,SALON PROFESSIONAL ACADEMY (THE)        ,WI,54914-3921,Proprietary  ,3,7,10,19,25,44
00290500,NORTH CAROLINA A&T STATE UNIV           ,NC,27411-0001,Public       ,205,151,356,12601,4431,17032
00290600,APPALACHIAN STATE UNIVERSITY            ,NC,28608-2059,Public       ,174,95,269,13807,3417,17224
00290700,UNIVERSITY OF NC AT ASHEVILLE           ,NC,28804-3299,Public       ,28,39,67,2952,1263,4215
00290800,BARTON COLLEGE                          ,NC,27893-3104,Private      ,15,24,39,1441,674,2115
00291000,BELMONT ABBEY COLLEGE                   ,NC,28012-1802,Private      ,15,36,51,1094,1049,2143
00291100,BENNETT COLLEGE                         ,NC,27401-3239,Private      ,15,4,19,1092,262,1354
00291200,BREVARD COLLEGE                         ,NC,28712-3306,Private      ,17,4,21,933,116,1049
00291300,CAMPBELL UNIVERSITY                     ,NC,27506-0036,Private      ,58,90,148,4029,2888,6917
00291400,CATAWBA COLLEGE                         ,NC,28144-2488,Private      ,20,19,39,1421,546,1967
00291500,CENTRAL PIEDMONT COMMUNITY COLLEGE      ,NC,28204-2297,Public       ,229,799,1028,5706,11760,17466
00291600,CHOWAN UNIVERSITY                       ,NC,27855-1850,Private      ,23,10,33,1571,259,1830
00291700,COLLEGE OF THE ALBEMARLE                ,NC,27909-2327,Public       ,20,75,95,635,1411,2046
00291800,DAVIDSON COLLEGE                        ,NC,28035-7157,Private      ,29,6,35,2737,74,2811
00291900,DAVIDSON COUNTY COMMUNITY COLLEGE       ,NC,27293-0000,Public       ,46,205,251,1032,2804,3836
00292000,DUKE UNIVERSITY                         ,NC,27708-0397,Private      ,136,36,172,12288,1225,13513
00292001,DUKE UNIV - SCHOOL OF MEDICINE          ,NC,27710-0000,Private      ,3,12,15,88,1235,1323
00292002,DUKE UNIV - SCHOOL OF LAW               ,NC,27708-0000,Private      ,1,39,40,40,2876,2916
00292003,DUKE UNIV - GRAD SCH ARTS & SCIENCE     ,NC,27708-0000,Private      ,2,15,17,66,754,820
00292004,DUKE UNIV - FUQUA SCH OF BUSINESS       ,NC,27708-0000,Private      ,2,44,46,53,1138,1191
00292005,DUKE UNIV/NICHOLAS SCH OF ENVIRON.      ,NC,27708-0000,Private      ,0,3,3,13,288,301
00292006,DUKE UNIV - DIVINITY SCHOOL             ,NC,27708-0000,Private      ,1,4,5,80,631,711
00292007,DUKE UNIV - SCHOOL OF NURSING           ,NC,27710-0000,Private      ,5,17,22,63,484,547
00292300,EAST CAROLINA UNIVERSITY                ,NC,27858-1818,Public       ,261,334,595,18012,9965,27977
00292600,ELIZABETH CITY STATE UNIVERSITY         ,NC,27909-7806,Public       ,60,55,115,3616,1303,4919
00292700,ELON UNIVERSITY                         ,NC,27244-2010,Private      ,64,30,94,5875,808,6683
00292800,FAYETTEVILLE STATE UNIVERSITY           ,NC,28301-4298,Public       ,90,195,285,5366,5683,11049
00292900,GARDNER-WEBB UNIVERSITY                 ,NC,28017-0000,Private      ,34,98,132,2164,2144,4308
00293000,GREENSBORO COLLEGE                      ,NC,27401-1875,Private      ,25,44,69,1303,737,2040
00293100,GUILFORD COLLEGE                        ,NC,27410-4171,Private      ,30,102,132,2448,2191,4639
00293300,HIGH POINT UNIVERSITY                   ,NC,27262-4221,Private      ,45,83,128,3110,1482,4592
00293400,ISOTHERMAL COMMUNITY COLLEGE            ,NC,28160-0804,Public       ,21,133,154,796,1623,2419
00293500,JOHN WESLEY COLLEGE                     ,NC,27265-0000,Private      ,3,15,18,44,135,179
00293600,JOHNSON C SMITH UNIVERSITY              ,NC,28216-5398,Private      ,52,25,77,3502,799,4301
00293700,KING'S COLLEGE-CHARLOTTE                ,NC,28204-2435,Proprietary  ,28,52,80,675,351,1026
00293900,LEES MCRAE COLLEGE                      ,NC,28604-0000,Private      ,11,10,21,970,296,1266
00294000,LENOIR COMMUNITY COLLEGE                ,NC,28502-0188,Public       ,25,125,150,797,2245,3042
00294100,LENOIR-RHYNE COLLEGE                    ,NC,28603-0000,Private      ,10,14,24,1976,492,2468
00294200,LIVINGSTONE COLLEGE                     ,NC,28144-5298,Private      ,25,10,35,1304,379,1683
00294300,LOUISBURG COLLEGE                       ,NC,27549-2398,Private      ,17,3,20,970,100,1070
00294400,MARS HILL COLLEGE                       ,NC,28754-0000,Private      ,9,22,31,1396,443,1839
00294500,MEREDITH COLLEGE                        ,NC,27607-5298,Private      ,15,24,39,1896,850,2746
00294600,METHODIST UNIVERSITY                    ,NC,28311-1420,Private      ,29,57,86,2115,1225,3340
00294700,MITCHELL COMMUNITY COLLEGE              ,NC,28677-5264,Public       ,27,136,163,796,2117,2913
00294800,MONTREAT COLLEGE                        ,NC,28757-1267,Private      ,12,112,124,636,995,1631
00294900,MOUNT OLIVE COLLEGE                     ,NC,28365-1299,Private      ,14,208,222,1013,3324,4337
00295000,NORTH CAROLINA CENTRAL UNIVERSITY       ,NC,27707-3198,Public       ,110,157,267,7669,6769,14438
00295100,NORTH CAROLINA WESLEYAN COLLEGE         ,NC,27804-8699,Private      ,18,54,72,1111,977,2088
00295300,PEACE COLLEGE                           ,NC,27604-1194,Private      ,5,6,11,850,238,1088
00295400,UNIV OF NORTH CAROLINA AT PEMBROKE      ,NC,28372-1510,Public       ,102,127,229,4961,3464,8425
00295500,PFEIFFER UNIVERSITY                     ,NC,28109-0000,Private      ,7,69,76,973,1255,2228
00295600,PIEDMONT BAPTIST COLLEGE AND GRADUATE SC,NC,27101-5025,Private      ,5,8,13,208,182,390
00295700,QUEENS UNIVERSITY OF CHARLOTTE          ,NC,28274-0001,Private      ,22,109,131,1602,1635,3237
00295800,ROCKINGHAM COMMUNITY COLLEGE            ,NC,27375-0000,Public       ,18,95,113,669,1341,2010
00296000,SALEM COLLEGE                           ,NC,27108-0000,Private      ,12,48,60,508,611,1119
00296100,SANDHILLS COMMUNITY COLLEGE             ,NC,28374-8283,Public       ,47,174,221,1269,2681,3950
00296200,SHAW UNIVERSITY                         ,NC,27601-2393,Private      ,45,71,116,3038,2431,5469
00296300,SOUTHEASTERN BAPTIST THEOL SEMINARY     ,NC,27588-0000,Private      ,2,5,7,29,110,139
00296400,SOUTHEASTERN COMMUNITY COLLEGE          ,NC,28472-5422,Public       ,50,138,188,700,1517,2217
00296700,ST ANDREWS PRESBYTERIAN COLLEGE         ,NC,28352-9979,Private      ,11,6,17,795,118,913
00296800,ST AUGUSTINES COLLEGE                   ,NC,27610-2298,Private      ,32,18,50,1915,609,2524
00297000,SURRY COMMUNITY COLLEGE                 ,NC,27017-0304,Public       ,28,104,132,1056,1395,2451
00297200,NORTH CAROLINA STATE UNIV-RALEIGH       ,NC,27695-1751,Public       ,240,223,463,19740,7077,26817
00297300,GASTON COLLEGE                          ,NC,28034-1499,Public       ,64,352,416,1455,3602,5057
00297400,UNIVERSITY OF N C-CHAPEL HILL           ,NC,27514-0000,Public       ,209,335,544,17774,10832,28606
00297500,UNIVERSITY OF NC AT CHARLOTTE           ,NC,28223-0001,Public       ,231,459,690,14472,9483,23955
00297600,UNIVERSITY OF N C - GREENSBORO          ,NC,27412-0001,Public       ,154,217,371,13133,7630,20763
00297800,WAKE FOREST UNIV - UNDERGRADUATE        ,NC,27109-7246,Private      ,59,6,65,5260,212,5472
00297801,WAKE FOREST UNIV - SCH OF MEDICINE      ,NC,27157-1090,Private      ,3,5,8,35,932,967
00297803,WAKE FOREST UNIV - MBA                  ,NC,27109-7659,Private      ,0,14,14,18,512,530
00297805,WAKE FOREST UNIV - SCH OF LAW           ,NC,27109-7206,Private      ,1,4,5,17,1295,1312
00297806,WAKE FOREST UNIV - GRAD A&S/DIVINITY    ,NC,27109-7246,Private      ,3,8,11,51,389,440
00297900,WARREN WILSON COLLEGE                   ,NC,28815-0000,Private      ,8,7,15,1129,304,1433
00298000,WAYNE COMMUNITY COLLEGE                 ,NC,27533-0000,Public       ,43,144,187,1095,2332,3427
00298100,WESTERN CAROLINA UNIVERSITY             ,NC,28723-9731,Public       ,148,113,261,6256,2907,9163
00298200,WESTERN PIEDMONT COMMUNITY COLLEGE      ,NC,28655-4504,Public       ,35,144,179,932,1916,2848
00298300,WILKES COMMUNITY COLLEGE                ,NC,28697-2100,Public       ,44,90,134,880,1350,2230
00298400,UNIVERSITY OF N C-WILMINGTON            ,NC,28403-3297,Public       ,125,104,229,10018,3455,13473
00298500,WINGATE UNIVERSITY                      ,NC,28174-0159,Private      ,29,41,70,2122,803,2925
00298600,WINSTON-SALEM STATE UNIVERSITY          ,NC,27102-0000,Public       ,108,122,230,7141,3842,10983
00398100,NORTH CAROLINA SCHOOL OF THE ARTS       ,NC,27127-2188,Public       ,15,5,20,1100,265,1365
00403300,ASHEVILLE BUNCOMBE TECH CMTY CLG        ,NC,28801-4897,Public       ,62,198,260,1354,2788,4142
00406200,PITT COMMUNITY COLLEGE                  ,NC,28590-0000,Public       ,75,216,291,2681,4190,6871
00483500,CALDWELL COMMUNITY CLG & TECH INST      ,NC,28638-2626,Public       ,48,151,199,1168,2050,3218
00483800,GUILFORD TECHNICAL COMMUNITY CLG        ,NC,27282-0309,Public       ,143,423,566,4287,7805,12092
00484400,WAKE TECHNICAL COMMUNITY COLLEGE        ,NC,27603-5696,Public       ,160,436,596,3753,6986,10739
00484500,WILSON COMMUNITY COLLEGE                ,NC,27893-3310,Public       ,25,114,139,468,1638,2106
00499201,MILLER-MOTTE TECHNICAL COLLEGE - CARY   ,NC,27511-9209,Proprietary  ,24,211,235,155,1074,1229
00499202,MILLER-MOTTE TECHNICAL COLLEGE - MILLER-,NC,27604-6072,Proprietary  ,21,67,88,64,248,312
00531600,COASTAL CAROLINA COMMUNITY COLLEGE      ,NC,28546-6816,Public       ,59,243,302,1073,3172,4245
00531700,FORSYTH TECHNICAL COMMUNITY COLLEGE     ,NC,27103-5197,Public       ,79,343,422,2053,5322,7375
00531800,CATAWBA VALLEY COMMUNITY COLLEGE        ,NC,28602-8302,Public       ,53,243,296,1502,2932,4434
00532000,CAPE FEAR COMMUNITY COLLEGE             ,NC,28401-3910,Public       ,112,262,374,2629,3567,6196
00544700,RANDOLPH COMMUNITY COLLEGE              ,NC,27204-1009,Public       ,29,124,153,680,1494,2174
00544800,DURHAM TECHNICAL CMNTY COLLEGE          ,NC,27703-5023,Public       ,41,204,245,989,3512,4501
00544900,CENTRAL CAROLINA COMMUNITY COLLEGE      ,NC,27330-9000,Public       ,37,208,245,991,2791,3782
00546300,ALAMANCE COMMUNITY COLLEGE              ,NC,27253-0000,Public       ,51,234,285,1058,2729,3787
00546400,RICHMOND COMMUNITY COLLEGE              ,NC,28345-4522,Public       ,27,64,91,560,1608,2168
00575400,ROWAN-CABARRUS COMMUNITY COLLEGE        ,NC,28145-1595,Public       ,66,307,373,1613,3782,5395
00647700,CABARRUS COLLEGE OF HEALTH SCIENCES     ,NC,28025-0000,Private      ,11,15,26,287,437,724
00647800,MERCY HOSP SCH OF NURSING               ,NC,28207-0000,Public       ,4,32,36,113,390,503
00648300,WATTS SCHOOL OF NURSING                 ,NC,27704-0000,Private      ,0,6,6,58,184,242
00679900,CRAVEN COMMUNITY COLLEGE                ,NC,28562-0000,Public       ,36,165,201,674,2218,2892
00703100,PAMLICO COMMUNITY COLLEGE               ,NC,28529-0000,Public       ,7,24,31,85,293,378
00764000,FAYETTEVILLE TECHNICAL CMTY COLLEGE     ,NC,28303-0236,Public       ,104,665,769,2731,10016,12747
00768700,JAMES SPRUNT COMMUNITY COLLEGE          ,NC,28349-0398,Public       ,21,52,73,340,907,1247
00781400,BROOKSTONE COLLEGE OF BUSINESS          ,NC,28262-0000,Proprietary  ,12,67,79,77,366,443
00781401,BROOKSTONE COLLEGE OF BUSINESS          ,NC,27409-0000,Proprietary  ,7,95,102,51,419,470
00789200,SAMPSON COMMUNITY COLLEGE               ,NC,28328-0000,Public       ,8,41,49,471,1153,1624
00798500,SOUTH PIEDMONT COMMUNITY COLLEGE        ,NC,28135-9703,Public       ,19,103,122,639,1741,2380
00798600,HALIFAX COMMUNITY COLLEGE               ,NC,27890-0089,Public       ,23,70,93,523,1226,1749
00798700,BLADEN COMMUNITY COLLEGE                ,NC,28332-0266,Public       ,35,105,140,427,1414,1841
00798800,MARTIN COMMUNITY COLLEGE                ,NC,27892-8307,Public       ,12,34,46,210,607,817
00808100,CARTERET COMMUNITY COLLEGE              ,NC,28557-2989,Public       ,27,62,89,473,1119,1592
00808200,CLEVELAND COMMUNITY COLLEGE             ,NC,28150-0000,Public       ,46,207,253,780,2238,3018
00808300,HAYWOOD COMMUNITY COLLEGE               ,NC,28721-0000,Public       ,32,85,117,509,961,1470
00808500,MCDOWELL TECHNICAL COMMUNITY CLG        ,NC,28752-8728,Public       ,18,77,95,279,797,1076
00808700,MONTGOMERY COMMUNITY COLLEGE            ,NC,27371-0787,Public       ,10,32,42,235,653,888
00846600,SOUTHWESTERN COMMUNITY COLLEGE          ,NC,28779-8581,Public       ,28,85,113,657,1207,1864
00855700,NASH COMMUNITY COLLEGE                  ,NC,27804-0488,Public       ,22,115,137,745,1689,2434
00855800,BEAUFORT COUNTY COMMUNITY COLLEGE       ,NC,27889-7889,Public       ,11,63,74,465,1285,1750
00861200,ROBESON COMMUNITY COLLEGE               ,NC,28359-2151,Public       ,21,99,120,874,2616,3490
00861300,ROANOKE-CHOWAN COMMUNITY COLLEGE        ,NC,27910-9522,Public       ,14,36,50,278,640,918
00885500,EDGECOMBE COMMUNITY COLLEGE             ,NC,27886-9399,Public       ,47,165,212,500,1912,2412
00885501,EDGECOMBE COMMUNITY COLLEGE             ,NC,27801-0000,Public       ,0,0,0,108,484,592
00902500,SOUTH EASTERN CLG OF BEAUTY CULTURE     ,NC,28204-0000,Proprietary  ,15,61,76,145,417,562
00933600,JOHNSTON COMMUNITY COLLEGE              ,NC,27577-0000,Public       ,35,121,156,928,2078,3006
00943000,TRI-COUNTY COMMUNITY COLLEGE            ,NC,28906-7919,Public       ,25,69,94,285,710,995
00964600,PIEDMONT COMMUNITY COLLEGE              ,NC,27573-1197,Public       ,28,98,126,453,1192,1645
00968400,BLUE RIDGE COMMUNITY COLLEGE            ,NC,28731-9624,Public       ,32,79,111,523,873,1396
00974701,GORDON-CONWELL THEO SEM - CHARLOTTE     ,NC,28273-0000,Private      ,0,5,5,2,160,162
00990300,VANCE-GRANVILLE CMTY COLLEGE            ,NC,27536-0917,Public       ,48,137,185,1074,2673,3747
01026400,SOUTH COLLEGE                           ,NC,28803-3152,Proprietary  ,13,118,131,73,516,589
01119400,STANLY COMMUNITY COLLEGE                ,NC,28001-7458,Public       ,26,114,140,534,1557,2091
01119700,MAYLAND COMMUNITY COLLEGE               ,NC,28777-2777,Public       ,14,50,64,283,513,796
01179900,PAUL MITCHELL THE SCHOOL FAYETTEVILLE   ,NC,28303-5364,Proprietary  ,2,22,24,12,87,99
01192600,LEON'S BEAUTY SCHOOL                    ,NC,27403-2812,Proprietary  ,6,26,32,95,180,275
02056500,MITCHELL'S HAIR STYLING ACADEMY         ,NC,27893-0000,Proprietary  ,10,17,27,71,123,194
02056501,MITCHELL'S HAIR STYLING ACADEMY - MITCHE,NC,27606-3326,Proprietary  ,1,5,6,20,41,61
02110500,ART INSTITUTE OF CHARLOTTE (THE)        ,NC,28217-0000,Proprietary  ,131,324,455,1827,2050,3877
02170700,BRUNSWICK COMMUNITY COLLEGE             ,NC,28422-0000,Public       ,12,65,77,478,731,1209
02205000,COLLEGE OF WILMINGTON                   ,NC,28403-0000,Proprietary  ,2,19,21,30,167,197
02210400,FAYETTEVILLE BEAUTY COLLEGE             ,NC,28303-0000,Proprietary  ,3,14,17,34,129,163
02227800,MITCHELL'S HAIR STYLING ACADEMY         ,NC,27534-0000,Proprietary  ,0,0,0,1,10,11
02227900,MITCHELL'S HAIR STYLING ACADEMY         ,NC,27858-0000,Proprietary  ,0,0,0,11,24,35
02238700,HAIRSTYLING INSTITUTE OF CHARLOTTE      ,NC,28204-0000,Proprietary  ,5,16,21,54,135,189
02280900,ROANOKE BIBLE COLLEGE                   ,NC,27909-0000,Private      ,3,4,7,109,98,207
02286300,CAROLINA BEAUTY COLLEGE                 ,NC,27262-0000,Proprietary  ,22,127,149,149,832,981
02560600,PINNACLE INSTITUTE OF COSMETOLOGY       ,NC,28115-8020,Proprietary  ,8,9,17,35,55,90
02614201,MILLER-MOTTE BUSINESS COLLEGE           ,NC,28403-0000,Proprietary  ,51,357,408,300,1319,1619
03009500,WINSTON-SALEM BARBER SCHOOL             ,NC,27107-0000,Proprietary  ,2,23,25,46,102,148
03064400,COSM INST OF BEAUTY ARTS & SCIENCES     ,NC,27127-7150,Proprietary  ,0,2,2,31,111,142
03089300,HERITAGE BIBLE COLLEGE                  ,NC,28335-0000,Private      ,0,11,11,23,109,132
03104200,CAROLINAS COLLEGE OF HEALTH SCIENCE     ,NC,28232-2861,Public       ,3,47,50,255,582,837
03104201,CHS NURSE ANESTHESIA PROGRAM / UNCC     ,NC,28232-2861,Public       ,0,0,0,305,248,553
03109000,SCHOOL OF COMMUNICATION ARTS            ,NC,27614-7076,Proprietary  ,29,86,115,457,330,787
03361300,MEDICAL ARTS MASSAGE SCHOOL             ,NC,27616-6453,Proprietary  ,5,33,38,32,192,224
03513400,APEX SCHOOL OF THEOLOGY                 ,NC,27703-8024,Private      ,1,19,20,7,245,252
03555300,SOUTHEASTERN INSTITUTE                  ,NC,28217-0000,Proprietary  ,14,77,91,73,325,398
03555400,SOUTHEASTERN SCHOOL OF NEUROMUSCULAR  MA,NC,29406-0000,Proprietary  ,10,40,50,36,147,183
03570300,CAROLINA CHRISTIAN COLLEGE              ,NC,27105-3241,Private      ,0,6,6,6,49,55
03663300,HOOD THEOLOGICAL SEMINARY               ,NC,28144-5768,Private      ,0,12,12,2,224,226
03748500,LA SHE'S BEAUTY ACADEMY                 ,NC,27707-3569,Proprietary  ,1,40,41,26,140,166
03777300,CAROLINA ACAD OF COSMETIC ART & SCI     ,NC,28054-0460,Proprietary  ,13,36,49,84,228,312
03827300,NEW LIFE THEOLOGICAL SEMINARY           ,NC,28205-1648,Private      ,1,7,8,5,83,88
04098300,TECHSKILLS - CHARLOTTE                  ,NC,28217-0000,Proprietary  ,0,18,18,8,76,84
04101300,CAROLINA SCHOOL OF BROADCASTING         ,NC,28214-8085,Proprietary  ,0,17,17,32,120,152
04115700,REGINA'S COLLEGE OF BEAUTY              ,NC,28110-2831,Proprietary  ,2,10,12,14,41,55
04120300,ASHEBORO BEAUTY SCHOOL OF RANDOLPH      ,NC,27203-6406,Proprietary  ,1,6,7,12,37,49
04140700,AVEDA INSTITUTE CHAPEL HILL             ,NC,27516-2559,Proprietary  ,28,18,46,54,50,104
04143500,CHARLOTTE SCHOOL OF LAW                 ,NC,28208-2816,Proprietary  ,0,168,168,0,168,168
00298800,BISMARCK STATE COLLEGE                  ,ND,58501-1299,Public       ,47,98,145,1997,1460,3457
00298900,DICKINSON STATE UNIVERSITY              ,ND,58601-4896,Public       ,19,25,44,1286,720,2006
00299000,JAMESTOWN COLLEGE                       ,ND,58405-3401,Private      ,9,4,13,953,141,1094
00299100,LAKE REGION STATE COLLEGE               ,ND,58301-1598,Public       ,15,30,45,339,363,702
00299200,UNIVERSITY OF MARY                      ,ND,58504-9652,Private      ,11,84,95,1584,1407,2991
00299300,MAYVILLE STATE UNIVERSITY               ,ND,58257-1299,Public       ,6,10,16,434,205,639
00299400,MINOT STATE UNIVERSITY                  ,ND,58707-0002,Public       ,18,62,80,1503,1470,2973
00299500,MINOT STATE UNIV-BOTTINEAU CAMPUS       ,ND,58318-1159,Public       ,8,17,25,250,250,500
00299600,NORTH DAKOTA STATE CLG OF SCIENCE       ,ND,58076-0002,Public       ,33,36,69,1421,688,2109
00299700,NORTH DAKOTA STATE UNIVERSITY           ,ND,58108-6050,Public       ,128,122,250,8775,2487,11262
00300500,UNIVERSITY OF NORTH DAKOTA              ,ND,58202-8193,Public       ,114,171,285,7336,3993,11329
00300700,WILLISTON STATE COLLEGE                 ,ND,58802-1326,Public       ,9,27,36,265,379,644
00300800,VALLEY CITY STATE UNIVERSITY            ,ND,58072-0000,Public       ,6,18,24,576,260,836
00484600,RASMUSSEN COLLEGE                       ,ND,58103-7196,Proprietary  ,35,149,184,431,1549,1980
00484601,RASMUSSEN COLLEGE - BISMARCK            ,ND,58503-0000,Proprietary  ,17,81,98,110,276,386
00775600,JOSEF'S SCHOOL OF HAIR DESIGN INC       ,ND,58102-4977,Proprietary  ,7,4,11,81,61,142
00935400,MEDCENTER ONE COLLEGE OF NURSING        ,ND,58501-4494,Private      ,1,3,4,61,68,129
01040600,JOSEF'S SCHOOL OF HAIR DESIGN           ,ND,58201-6394,Proprietary  ,5,9,14,48,74,122
01205900,TRINITY BIBLE COLLEGE                   ,ND,58436-7150,Private      ,5,4,9,233,128,361
01229500,R D HAIRSTYLING COLLEGE                 ,ND,58501-4001,Proprietary  ,4,1,5,47,30,77
02188200,SITTING BULL COLLEGE                    ,ND,58538-9721,Public       ,4,33,37,71,370,441
02236500,LITTLE HOOP COMMUNITY COLLEGE           ,ND,58335-0000,Public       ,7,39,46,30,194,224
02242900,UNITED TRIBES TECHNICAL COLLEGE         ,ND,58504-0000,Private      ,13,40,53,183,685,868
02298200,HEADQUARTERS ACADEMY OF HAIR DESIGN     ,ND,58701-0000,Proprietary  ,2,6,8,21,45,66
02301100,TURTLE MTN CMNTY COLG-FIN AID OFC       ,ND,58316-0000,Private      ,35,71,106,210,478,688
02553700,FORT BERTHOLD COMMUNITY COLLEGE         ,ND,58763-0000,Public       ,5,34,39,44,113,157
03087200,MOLER BARBER CLG OF HAIRSTYLING         ,ND,58103-0000,Proprietary  ,0,3,3,4,10,14
04031300,SALON PROFESSIONAL ACADEMY (THE)        ,ND,58103-3337,Proprietary  ,4,3,7,74,48,122
04139400,HAIR ACADEMY (THE)                      ,ND,58501-4929,Proprietary  ,5,7,12,22,23,45
00301005,ANTIOCH UNIV/SEATTLE                    ,WA,98121-0000,Private      ,0,81,81,35,1152,1187
00376900,BELLEVUE COMMUNITY COLLEGE              ,WA,98007-6484,Public       ,181,540,721,2872,4332,7204
00377000,BIG BEND COMMUNITY COLLEGE              ,WA,98837-3299,Public       ,73,205,278,977,1420,2397
00377100,"CENTRAL WASHINGTON UNIV., FIN AID       ",WA,98926-7495,Public       ,203,172,375,8238,3858,12096
00377200,CENTRALIA COLLEGE                       ,WA,98531-4099,Public       ,40,258,298,912,1511,2423
00377300,CLARK COLLEGE                           ,WA,98663-3598,Public       ,291,813,1104,3652,6672,10324
00377400,COLUMBIA BASIN COLLEGE                  ,WA,99301-3379,Public       ,121,387,508,2210,3587,5797
00377500,EASTERN WASHINGTON UNIVERSITY           ,WA,99004-2447,Public       ,170,262,432,7828,5517,13345
00377600,EVERETT COMMUNITY COLLEGE               ,WA,98201-1352,Public       ,155,554,709,1741,4347,6088
00377700,HERITAGE UNIVERSITY                     ,WA,98948-9562,Private      ,4,58,62,382,1445,1827
00377800,GONZAGA UNIVERSITY                      ,WA,99258-0083,Private      ,64,202,266,6197,3382,9579
00377900,GRAYS HARBOR COLLEGE                    ,WA,98520-7599,Public       ,54,244,298,684,1401,2085
00378000,GREEN RIVER COMMUNITY COLLEGE           ,WA,98092-3622,Public       ,157,523,680,2154,3651,5805
00378100,HIGHLINE COMMUNITY COLLEGE              ,WA,98198-9800,Public       ,159,538,697,2228,4198,6426
00378200,LOWER COLUMBIA COLLEGE                  ,WA,98632-0310,Public       ,70,390,460,925,2683,3608
00378300,NORTHWEST UNIVERSITY                    ,WA,98083-0000,Private      ,20,61,81,1062,708,1770
00378400,OLYMPIC COLLEGE                         ,WA,98337-1600,Public       ,87,369,456,1441,3684,5125
00378500,PACIFIC LUTHERAN UNIVERSITY             ,WA,98447-0003,Private      ,48,57,105,4031,1437,5468
00378600,PENINSULA COLLEGE                       ,WA,98362-6660,Public       ,36,197,233,511,1409,1920
00378700,SEATTLE CENTRAL COMMUNITY COLLEGE       ,WA,98122-2413,Public       ,152,530,682,2247,4927,7174
00378703,SEATTLE VOCATIONAL INSTITUTE            ,WA,98144-0000,Public       ,17,110,127,78,455,533
00378800,SEATTLE PACIFIC UNIVERSITY              ,WA,98119-1997,Private      ,50,87,137,4280,1691,5971
00379000,SEATTLE UNIVERSITY                      ,WA,98122-1090,Private      ,97,186,283,6379,5971,12350
00379100,SHORELINE COMMUNITY COLLEGE             ,WA,98133-5696,Public       ,114,333,447,1550,2946,4496
00379200,SKAGIT VALLEY COLLEGE                   ,WA,98273-5899,Public       ,82,310,392,1091,2614,3705
00379300,SPOKANE COMMUNITY COLLEGE               ,WA,99207-5399,Public       ,229,1043,1272,3147,8351,11498
00379400,ST MARTIN'S UNIVERSITY                  ,WA,98503-7500,Private      ,12,40,52,1210,932,2142
00379600,TACOMA COMMUNITY COLLEGE                ,WA,98466-6100,Public       ,149,650,799,2321,6131,8452
00379700,UNIVERSITY OF PUGET SOUND               ,WA,98416-1039,Private      ,48,31,79,4586,896,5482
00379800,UNIVERSITY OF WASHINGTON                ,WA,98195-5880,Public       ,556,714,1270,25522,21947,47469
00379900,WALLA WALLA UNIVERSITY                  ,WA,99324-1198,Private      ,15,19,34,1380,662,2042
00380000,WASHINGTON STATE UNIVERSITY             ,WA,99164-1035,Public       ,343,377,720,17446,10160,27606
00380100,WENATCHEE VALLEY COLLEGE                ,WA,98801-1799,Public       ,56,244,300,1222,2385,3607
00380200,WESTERN WASHINGTON UNIVERSITY           ,WA,98225-5946,Public       ,254,137,391,13235,3783,17018
00380300,WHITMAN COLLEGE                         ,WA,99362-2067,Private      ,19,1,20,2624,58,2682
00380400,WHITWORTH UNIVERSITY                    ,WA,99251-0001,Private      ,31,55,86,3465,972,4437
00380500,YAKIMA VALLEY COMMUNITY COLLEGE         ,WA,98907-2520,Public       ,97,372,469,2186,4198,6384
00499900,BELLINGHAM TECHNICAL COLLEGE            ,WA,98225-0000,Public       ,47,193,240,576,1563,2139
00500000,PIERCE COLLEGE                          ,WA,98498-1919,Public       ,144,554,698,2313,5411,7724
00500100,EDMONDS COMMUNITY COLLEGE               ,WA,98036-5999,Public       ,126,505,631,1617,3436,5053
00500600,WALLA WALLA COMMUNITY COLLEGE           ,WA,99362-9267,Public       ,60,198,258,1365,2191,3556
00530600,BATES TECHNICAL COLLEGE                 ,WA,98405-0000,Public       ,41,350,391,555,2384,2939
00530601,BATES TECHNICAL COLLEGE - SOUTH CAMPUS  ,WA,98409-5847,Public       ,2,5,7,2,5,7
00537200,SOUTH PUGET SOUND COMMUNITY COLLEGE     ,WA,98512-6292,Public       ,101,365,466,1704,3388,5092
00537300,LAKE WASHINGTON TECHNICAL COLLEGE       ,WA,98034-8505,Public       ,40,269,309,465,1683,2148
00575200,CLOVER PARK TECHNICAL COLLEGE           ,WA,98499-0000,Public       ,109,546,655,1026,3872,4898
00815500,EVERGREEN STATE COLLEGE (THE)           ,WA,98505-0002,Public       ,86,141,227,3462,3226,6688
00844300,ITT TECHNICAL INSTITUTE                 ,WA,98168-3334,Proprietary  ,73,269,342,546,1446,1992
00907901,EVEREST COLLEGE                         ,WA,98684-6950,Proprietary  ,13,85,98,103,530,633
00938700,PERRY TECHNICAL INSTITUTE               ,WA,98903-1239,Private      ,38,95,133,432,682,1114
00954400,SPOKANE FALLS COMMUNITY COLLEGE         ,WA,99224-5204,Public       ,179,590,769,3302,5280,8582
00970400,NORTH SEATTLE COMMUNITY COLLEGE         ,WA,98103-3599,Public       ,71,400,471,1107,3068,4175
00970600,SOUTH SEATTLE COMMUNITY COLLEGE         ,WA,98106-1499,Public       ,88,321,409,1333,2638,3971
00973900,GLEN DOW ACAD OF HAIR DESIGN            ,WA,99201-0209,Proprietary  ,14,22,36,123,151,274
01036400,WHATCOM COMMUNITY COLLEGE               ,WA,98226-8003,Public       ,72,193,265,1408,1812,3220
01043400,RENTON TECHNICAL COLLEGE                ,WA,98056-0000,Public       ,58,268,326,593,1933,2526
01148100,DIVERS INSTITUTE OF TECHNOLOGY          ,WA,98107-0667,Proprietary  ,17,76,93,114,397,511
01231500,CORNISH COLLEGE OF THE ARTS             ,WA,98121-4604,Private      ,13,8,21,1060,272,1332
01249600,GREENWOOD BEAUTY SCHOOL                 ,WA,98103-0000,Proprietary  ,10,19,29,39,102,141
01302200,CITY UNIVERSITY OF SEATTLE              ,WA,98005-3030,Private      ,6,201,207,117,2492,2609
01309400,BELLINGHAM BEAUTY SCHOOL                ,WA,98225-0000,Proprietary  ,4,9,13,27,51,78
02091701,KAPLAN COLLEGE - SEATTLE                ,WA,98055-4910,Proprietary  ,21,78,99,84,316,400
02105300,BELLEVUE BEAUTY SCHOOL                  ,WA,98007-0000,Proprietary  ,6,8,14,24,38,62
02106700,TRINITY LUTHERAN COLLEGE                ,WA,98201-3569,Private      ,2,3,5,101,47,148
02180000,NORTHWEST INDIAN COLLEGE                ,WA,98226-9278,Public       ,9,79,88,115,548,663
02184200,PAROBA COLLEGE OF COSMETOLOGY           ,WA,98208-0000,Proprietary  ,3,17,20,35,90,125
02202200,STYLEMASTERS COLLEGE OF HAIR DESIGN     ,WA,98632-0000,Proprietary  ,5,16,21,34,82,116
02203300,GENE JUAREZ ACADEMY OF BEAUTY           ,WA,98125-0000,Proprietary  ,44,92,136,380,531,911
02203301,GENE JUAREZ ACADEMY OF BEAUTY           ,WA,98003-0000,Proprietary  ,2,12,14,60,77,137
02222900,INTERNATIONAL AIR & HOSPITALITY ACADEMY ,WA,98661-4835,Proprietary  ,48,43,91,297,242,539
02236800,PROFESSIONAL BEAUTY SCHOOL              ,WA,98902-0000,Proprietary  ,7,14,21,54,64,118
02242500,BASTYR UNIVERSITY                       ,WA,98028-0000,Private      ,3,22,25,112,1112,1224
02263107,CAMBRIDGE COLLEGE-BELLEVUE              ,WA,98007-0000,Proprietary  ,1,0,1,5,16,21
02291300,ART INSTITUTE OF SEATTLE                ,WA,98121-1622,Proprietary  ,126,132,258,2137,1660,3797
02300100,EVEREST COLLEGE                         ,WA,98367-1835,Proprietary  ,27,83,110,111,429,540
02300103,EVEREST COLLEGE - EVERETT               ,WA,98208-2610,Proprietary  ,46,168,214,178,583,761
02300104,EVEREST COLLEGE - TACOMA                ,WA,98402-3004,Proprietary  ,29,150,179,143,742,885
02326500,INTERFACE COLLEGE                       ,WA,99201-3209,Proprietary  ,7,50,57,15,276,291
02331400,NORTHWEST HAIR ACADEMY                  ,WA,98273-0000,Proprietary  ,19,31,50,101,140,241
02331402,NORTHWEST HAIR ACADEMY - EVERETT        ,WA,98204-0000,Proprietary  ,4,4,8,21,20,41
02345100,PHAGAN'S ORCHARDS BEAUTY SCHOOL         ,WA,98662-0000,Proprietary  ,0,0,0,6,19,25
02504900,ACADEMY OF HAIR DESIGN (THE)            ,WA,98801-0000,Proprietary  ,3,7,10,31,56,87
02541900,BJ'S BEAUTY AND BARBER COLLEGE          ,WA,98409-0000,Proprietary  ,9,23,32,33,138,171
02602100,NORTHWEST COLLEGE OF ART                ,WA,98370-8625,Proprietary  ,3,1,4,125,29,154
02606200,EVEREST COLLEGE                         ,WA,98055-2990,Proprietary  ,49,188,237,191,710,901
02617500,EVEREST COLLEGE                         ,WA,98133-9018,Proprietary  ,22,49,71,87,210,297
02617501,EVEREST COLLEGE - FIFE                  ,WA,98424-2647,Proprietary  ,19,57,76,117,338,455
02617503,EVEREST COLLEGE - VANCOUVER             ,WA,98684-6951,Proprietary  ,17,45,62,104,306,410
02617505,ASHMEAD COLLEGE - NEW EVERETT CAMPUS    ,WA,98201-4022,Proprietary  ,0,0,0,2,6,8
03031406,INTERNATIONAL ACADEMY OF DESIGN AND TECH,WA,98188-3319,Proprietary  ,25,10,35,262,301,563
03065000,CLARE'S BEAUTY COLLEGE                  ,WA,99301-5505,Proprietary  ,3,9,12,21,61,82
03071800,ITT TECHNICAL INSTITUTE                 ,WA,99216-1589,Proprietary  ,92,304,396,542,1542,2084
03099000,CORTIVA INSTITUTE - SEATTLE             ,WA,98109-5474,Proprietary  ,12,50,62,111,287,398
03139500,MONTESSORI SCHOOLS OF WASHINGTON        ,WA,98203-6600,Private      ,0,0,0,0,1,1
03280300,SEATTLE INST OF ORIENTAL MEDICINE       ,WA,98115-0000,Proprietary  ,0,5,5,4,53,57
03283300,NORTHWEST HVAC/R ASSOCIATION & TRAINING ,WA,99202-2125,Private      ,0,3,3,6,54,60
03361600,SEATTLE MIDWIFERY SCHOOL                ,WA,98144-0000,Private      ,0,1,1,6,56,62
03466400,MARS HILL GRADUATE SCHOOL               ,WA,98121-0000,Private      ,0,4,4,2,259,261
03483500,CASCADIA COMMUNITY COLLEGE              ,WA,98011-9510,Public       ,59,112,171,654,877,1531
03490400,EMIL FRIES PIANO HOSPITAL & TRAININ     ,WA,98661-4323,Private      ,0,1,1,3,11,14
03631500,CORTIVA INSTITUTE - BRIAN UTTING SCHOOL ,WA,98109-5211,Proprietary  ,0,0,0,9,13,22
03689400,FAITH EVANGELICAL SEMINARY              ,WA,98407-2607,Private      ,0,15,15,5,190,195
03707500,CHETTA'S ACADEMY OF HAIR AND NAILS      ,WA,98362-4310,Proprietary  ,3,7,10,9,19,28
03724300,DIGIPEN INSTITUTE OF TECHNOLOGY         ,WA,98052-5170,Proprietary  ,7,1,8,659,239,898
03917300,EVERGREEN BEAUTY AND BARBER COLLEGE     ,WA,98208-3759,Proprietary  ,13,28,41,62,161,223
03932500,TOTAL COSMETOLOGY TRAINING CENTER       ,WA,99217-6231,Proprietary  ,6,20,26,35,118,153
03953300,YAKIMA BEAUTY SCHOOL;BEAUTYWORKS        ,WA,98901-2202,Proprietary  ,3,4,7,31,52,83
04043400,ALPINE COLLEGE                          ,WA,99206-5097,Proprietary  ,0,41,41,25,175,200
04120000,SUNNYSIDE BEAUTY ACADEMY                ,WA,98944-8711,Proprietary  ,1,2,3,11,14,25
04127200,VICTORIA'S ACADEMY OF COSMETOLOGY       ,WA,99336-3826,Proprietary  ,6,9,15,44,89,133
04130500,PACIFIC NORTHWEST UNIV OF HEALTH SCIENCE,WA,98901-1471,Private      ,0,2,2,0,3,3
04130800,CASCADE BEAUTY COLLEGE                  ,WA,98002-5504,Proprietary  ,0,8,8,15,30,45
04132800,INLAND MASSAGE INSTITUTE                ,WA,99208-5923,Proprietary  ,2,15,17,9,39,48
00340100,BROWN UNIVERSITY                        ,RI,02912-9127,Private      ,125,12,137,13121,326,13447
00340101,BROWN UNIVERSITY - GRADUATE SCHOOL      ,RI,02912-1827,Private      ,1,18,19,46,1386,1432
00340102,BROWN MEDICAL SCHOOL                    ,RI,02912-0000,Private      ,0,4,4,24,412,436
00340200,BRYANT UNIVERSITY                       ,RI,02917-1284,Private      ,55,23,78,5885,350,6235
00340400,JOHNSON & WALES UNIVERSITY              ,RI,02903-3703,Private      ,286,147,433,18095,3498,21593
00340600,PROVIDENCE COLLEGE                      ,RI,02918-0001,Private      ,51,24,75,7363,518,7881
00340700,RHODE ISLAND COLLEGE                    ,RI,02908-1991,Public       ,96,95,191,6784,3031,9815
00340800,COMMUNITY COLLEGE OF RI - WARWICK       ,RI,02906-0000,Public       ,163,269,432,4239,5003,9242
00340801,COMMUNITY COLLEGE OF RI - LINCOLN       ,RI,02865-4585,Public       ,62,83,145,1660,1854,3514
00340802,COMMUNITY COLLEGE OF RI- PROVIDENCE     ,RI,02905-2313,Public       ,31,70,101,1404,1967,3371
00340900,RHODE ISLAND SCHOOL OF DESIGN           ,RI,02903-2784,Private      ,44,20,64,2711,1153,3864
00341000,ROGER WILLIAMS UNIVERSITY               ,RI,02809-2921,Private      ,58,29,87,7392,1370,8762
00341100,SALVE REGINA UNIVERSITY                 ,RI,02840-4192,Private      ,25,19,44,4777,331,5108
00341400,UNIVERSITY OF RHODE ISLAND              ,RI,02881-0000,Public       ,236,142,378,17356,3393,20749
00659100,ST. JOSEPH HOSP SCH OF NURSING          ,RI,02904-5199,Private      ,2,2,4,42,142,184
00784400,GIBBS COLLEGE                           ,RI,02920-7807,Proprietary  ,1,2,3,245,386,631
00784500,NEW ENGLAND INSTITUTE OF TECHNOLOGY     ,RI,02886-2266,Private      ,139,199,338,2698,2105,4803
01115900,"SAWYER SCHOOL,THE                       ",RI,02860-4117,Proprietary  ,71,245,316,332,1489,1821
02071900,ARTHUR ANGELO SCH COSMET&HAIR DSGN      ,RI,02903-0000,Proprietary  ,12,30,42,125,223,348
02176900,WARWICK ACADEMY OF BEAUTY CULTURE       ,RI,02886-1534,Proprietary  ,8,24,32,92,159,251
02584400,NEW ENGLAND TRACTOR TRAILER TRAINING SCH,RI,02860-1752,Proprietary  ,24,217,241,89,790,879
03080000,NEWPORT SCHOOL OF HAIRDRESSING          ,RI,02860-4038,Proprietary  ,4,12,16,19,87,106
03115200,MOTORING TECHNICAL TRAINING INST        ,RI,02914-5022,Proprietary  ,20,36,56,152,249,401
03232300,LINCOLN TECHNICAL INSTITUTE             ,RI,02865-4211,Proprietary  ,72,189,261,496,928,1424
03570500,ZION BIBLE COLLEGE                      ,RI,02806-1246,Private      ,4,5,9,143,107,250
03732300,INTERNATIONAL YACHT RESTORATION SCH     ,RI,02840-6720,Private      ,0,0,0,9,22,31
00341700,ALLEN UNIVERSITY                        ,SC,29204-1085,Private      ,32,19,51,1027,442,1469
00341800,ANDERSON UNIVERSITY                     ,SC,29621-4035,Private      ,20,50,70,1730,709,2439
00341900,CHARLESTON SOUTHERN UNIVERSITY          ,SC,29406-2160,Private      ,43,65,108,3495,1732,5227
00342000,BENEDICT COLLEGE                        ,SC,29204-1086,Private      ,82,44,126,3837,1302,5139
00342100,BOB JONES UNIVERSITY                    ,SC,29614-1000,Proprietary  ,68,20,88,2993,325,3318
00342200,SOUTHERN WESLEYAN UNIVERSITY            ,SC,29630-1020,Private      ,10,227,237,930,2458,3388
00342300,THE CITADEL                             ,SC,29409-0002,Public       ,28,58,86,2123,889,3012
00342400,CLAFLIN UNIVERSITY                      ,SC,29115-4498,Private      ,63,29,92,2479,985,3464
00342500,CLEMSON UNIVERSITY                      ,SC,29634-0001,Public       ,191,103,294,13856,2984,16840
00342600,UNIV OF SC AT SUMTER                    ,SC,29150-2498,Public       ,11,30,41,737,587,1324
00342700,COKER COLLEGE                           ,SC,29550-3797,Private      ,13,45,58,936,972,1908
00342800,COLLEGE OF CHARLESTON                   ,SC,29424-0100,Public       ,108,68,176,8413,2106,10519
00342900,COLUMBIA INTERNATIONAL UNIVERSITY       ,SC,29203-1599,Private      ,5,25,30,510,654,1164
00343000,COLUMBIA COLLEGE                        ,SC,29203-5998,Private      ,15,70,85,1353,1140,2493
00343100,CONVERSE COLLEGE                        ,SC,29302-0006,Private      ,7,39,46,747,649,1396
00343200,ERSKINE COLLEGE                         ,SC,29639-0000,Private      ,8,5,13,746,39,785
00343201,ERSKINE THEOLOGICAL SEMINARY            ,SC,29639-0000,Private      ,0,7,7,7,164,171
00343400,FURMAN UNIVERSITY                       ,SC,29613-5253,Private      ,36,22,58,3118,334,3452
00343500,LANDER UNIVERSITY                       ,SC,29649-2099,Public       ,32,27,59,2673,814,3487
00343600,LIMESTONE COLLEGE                       ,SC,29340-3799,Private      ,17,151,168,1082,3081,4163
00343700,LUTHERAN THEOLOGICAL SOUTHERN SEM       ,SC,29203-5898,Private      ,0,2,2,0,134,134
00343800,MEDICAL UNIV OF SOUTH CAROLINA - FA     ,SC,29425-1760,Public       ,8,43,51,231,2728,2959
00343900,MORRIS COLLEGE                          ,SC,29150-3599,Private      ,33,21,54,1445,512,1957
00344000,NEWBERRY COLLEGE                        ,SC,29108-2197,Private      ,13,4,17,1550,181,1731
00344100,NORTH GREENVILLE COLLEGE                ,SC,29688-1892,Private      ,18,17,35,2103,315,2418
00344500,PRESBYTERIAN COLLEGE                    ,SC,29325-2503,Private      ,20,0,20,1411,27,1438
00344600,SOUTH CAROLINA STATE UNIVERSITY         ,SC,29117-4427,Public       ,92,90,182,7091,2736,9827
00344700,SPARTANBURG METHODIST COLLEGE           ,SC,29301-5899,Private      ,16,4,20,1158,138,1296
00344800,UNIVERSITY OF SOUTH CAROLINA            ,SC,29208-3999,Public       ,257,299,556,17975,10546,28521
00344900,UNIVERSITY OF SOUTH CAROLINA AIKEN      ,SC,29801-6399,Public       ,37,45,82,2749,1233,3982
00345000,UNIV OF SC AT BEAUFORT                  ,SC,29902-4602,Public       ,18,33,51,973,850,1823
00345100,COASTAL CAROLINA UNIVERSITY             ,SC,29528-0000,Public       ,135,87,222,9042,1875,10917
00345300,UNIV OF SC AT LANCASTER                 ,SC,29721-0889,Public       ,17,37,54,808,642,1450
00345400,UNIV OF SC SYSTEM SALKEHATCHIE          ,SC,29810-0617,Public       ,25,30,55,501,524,1025
00345500,VOORHEES COLLEGE                        ,SC,29042-0000,Private      ,21,18,39,651,394,1045
00345600,WINTHROP UNIVERSITY                     ,SC,29733-0001,Public       ,72,65,137,5564,2010,7574
00345700,WOFFORD COLLEGE                         ,SC,29303-3663,Private      ,17,3,20,1625,93,1718
00399000,FLORENCE-DARLINGTON TECH COLLEGE        ,SC,29501-0548,Public       ,105,265,370,2616,4394,7010
00399100,GREENVILLE TECHNICAL COLLEGE            ,SC,29607-2439,Public       ,266,840,1106,7154,11939,19093
00399200,PIEDMONT TECHNICAL COLLEGE              ,SC,29648-1467,Public       ,100,417,517,2143,4785,6928
00399300,MIDLANDS TECHNICAL COLLEGE              ,SC,29202-0000,Public       ,201,644,845,6619,10506,17125
00399400,SPARTANBURG COMMUNITY COLLEGE           ,SC,29305-4386,Public       ,119,350,469,2796,4567,7363
00399500,CENTRAL CAROLINA TECHNICAL COLLEGE      ,SC,29150-2499,Public       ,79,338,417,1307,3605,4912
00399600,YORK TECHNICAL COLLEGE                  ,SC,29730-3395,Public       ,93,551,644,2508,5167,7675
00492000,TRIDENT TECHNICAL COLLEGE               ,SC,29423-8067,Public       ,245,644,889,6281,10307,16588
00492300,CLINTON JR COLLEGE                      ,SC,29730-5152,Private      ,4,2,6,115,45,160
00492400,FORREST JUNIOR COLLEGE                  ,SC,29624-2405,Proprietary  ,4,32,36,30,181,211
00492500,HORRY-GEORGETOWN TECH COLLEGE           ,SC,29526-9521,Public       ,146,382,528,2940,5455,8395
00492600,TRI-COUNTY TECHNICAL COLLEGE            ,SC,29670-9133,Public       ,108,267,375,3142,3826,6968
00492700,UNIV OF SC AT UNION                     ,SC,29379-0729,Public       ,11,22,33,236,206,442
00536300,DENMARK TECHNICAL COLLEGE               ,SC,29042-0000,Public       ,80,126,206,911,940,1851
00681500,ORANGEBURG-CALHOUN TECHNICAL COLG       ,SC,29118-8299,Public       ,50,157,207,1339,2449,3788
00695100,UNIVERSITY OF SOUTH CAROLINA UPSTATE    ,SC,29303-9972,Public       ,64,81,145,4427,2456,6883
00760200,NORTHEASTERN TECHNICAL COLLEGE          ,SC,29520-7015,Public       ,27,76,103,515,1150,1665
00922600,FRANCIS MARION UNIVERSITY               ,SC,29501-0000,Public       ,70,48,118,4027,1475,5502
00932200,WILLIAMSBURG TECHNICAL COLLEGE          ,SC,29556-4197,Public       ,32,72,104,334,738,1072
00991000,TECHNICAL COLLEGE OF THE LOWCOUNTRY     ,SC,29902-5441,Public       ,52,180,232,843,2248,3091
00991100,UNIV OF SC-REGIONAL CAMPUSES ADMIN      ,SC,29208-0001,Public       ,5,4,9,154,95,249
01005600,AIKEN TECHNICAL COLLEGE                 ,SC,29802-0696,Public       ,85,237,322,1728,3298,5026
01209200,KENNETH SHULER SCHOOL OF COSMETOLOGY    ,SC,29730-3552,Proprietary  ,2,14,16,18,85,103
01303907,SOUTH UNIVERSITY                        ,SC,29203-6400,Proprietary  ,40,200,240,355,1907,2262
02063700,SHERMAN CLG STRAIGHT CHIROPRACTIC       ,SC,29316-0000,Private      ,1,2,3,10,293,303
02189800,NO AMER INST OF AVIATION OF SO CAR      ,SC,29527-0000,Proprietary  ,0,0,0,4,8,12
02329600,BETTY STEVENS COSMETOLOGY INSTITUTE     ,SC,29501-0000,Proprietary  ,0,0,0,1,0,1
02338600,CHARZANNE BEAUTY COLLEGE                ,SC,29649-0000,Proprietary  ,1,19,20,22,93,115
02341100,KENNETH SHULER SCHOOL OF COSMETOLOGY & N,SC,29210-0000,Proprietary  ,14,108,122,193,629,822
02356600,CHARLESTON COSMETOLOGY INSTITUTE        ,SC,29420-0000,Proprietary  ,10,29,39,70,127,197
02552400,ACADEMY OF HAIR TECHNOLOGY              ,SC,29615-2363,Proprietary  ,6,19,25,62,131,193
02567600,SUMTER BEAUTY COLLEGE                   ,SC,29150-0000,Proprietary  ,3,14,17,36,110,146
02614202,MILLER-MOTTE TECHNICAL COLLEGE          ,SC,29406-0000,Proprietary  ,43,165,208,342,1155,1497
03010614,VIRGINIA COLLEGE - GOLF ACADEMY OF AMERI,SC,29579-0000,Proprietary  ,10,21,31,224,263,487
03052300,KENNETH SHULER SCH COSM & HAIR DESG     ,SC,29841-2013,Proprietary  ,10,23,33,49,152,201
03088300,ACADEMY OF COSMETOLOGY                  ,SC,29418-5667,Proprietary  ,10,32,42,47,121,168
03258300,SOUTHERN METHODIST COLLEGE              ,SC,29116-1027,Private      ,0,0,0,8,24,32
03293300,STRAND COLLEGE OF HAIR DESIGN           ,SC,29572-4310,Proprietary  ,7,16,23,26,91,117
03304300,CENTURA COLLEGE                         ,SC,29406-9235,Proprietary  ,20,130,150,106,618,724
03513300,LACY COSMETOLOGY SCHOOL                 ,SC,29803-9084,Proprietary  ,4,15,19,17,68,85
03513301,LACY COSMETOLOGY SCHOOL -               ,SC,29072-0000,Proprietary  ,1,9,10,10,61,71
03513302,LACY COSMETOLOGY SCHOOL -               ,SC,29445-0000,Proprietary  ,0,4,4,11,45,56
03595300,CHARLESTON SCHOOL OF MASSAGE            ,SC,29412-8270,Proprietary  ,0,2,2,6,39,45
03746300,LEGRAND INSTITUTE OF COSMETOLOGY        ,SC,29020-0000,Proprietary  ,4,8,12,21,49,70
03746400,SOUTHEASTERN INSTITUTE                  ,SC,29210-0000,Proprietary  ,8,32,40,85,253,338
03768400,STYLETRENDS BARBER AND HAIRSTYLING ACADE,SC,29730-4511,Proprietary  ,1,5,6,7,57,64
03856400,W. L. BONNER COLLEGE                    ,SC,29203-0000,Private      ,2,9,11,6,76,82
03892300,HARLEY'S BEAUTY & BARBER CAREER INST.   ,SC,29204-1919,Proprietary  ,0,6,6,13,69,82
04096300,CHARLESTON SCHOOL OF LAW                ,SC,29402-0535,Proprietary  ,1,18,19,11,972,983
00345800,AUGUSTANA COLLEGE                       ,SD,57197-0001,Private      ,7,8,15,1704,204,1908
00345900,BLACK HILLS STATE UNIVERSITY            ,SD,57799-9670,Public       ,37,57,94,2107,1549,3656
00346100,DAKOTA WESLEYAN UNIVERSITY              ,SD,57301-4398,Private      ,7,10,17,611,301,912
00346300,DAKOTA STATE UNIVERSITY                 ,SD,57042-1799,Public       ,12,27,39,1171,604,1775
00346500,MOUNT MARTY COLLEGE                     ,SD,57078-3724,Private      ,3,12,15,556,489,1045
00346600,NORTHERN STATE UNIVERSITY               ,SD,57401-7198,Public       ,13,28,41,1502,648,2150
00346700,PRESENTATION COLLEGE                    ,SD,57401-1299,Private      ,0,14,14,366,547,913
00346900,UNIVERSITY OF SIOUX FALLS               ,SD,57105-1699,Private      ,12,29,41,1342,461,1803
00347000,SOUTH DAKOTA SCH OF MINES & TECH        ,SD,57701-3995,Public       ,17,17,34,1315,522,1837
00347100,SOUTH DAKOTA STATE UNIVERSITY           ,SD,57007-2298,Public       ,105,93,198,7625,2845,10470
00347400,UNIVERSITY OF SOUTH DAKOTA              ,SD,57069-2390,Public       ,58,120,178,4530,4037,8567
00405600,SIOUX FALLS SEMINARY                    ,SD,57105-0000,Private      ,0,6,6,1,95,96
00405700,NATIONAL AMERICAN UNIVERSITY            ,SD,57701-3692,Proprietary  ,103,1026,1129,653,6162,6815
00405707,NATIONAL AMERICAN UNIVERSITY            ,SD,57105-0000,Proprietary  ,3,27,30,58,288,346
00492900,MCKENNAN HOSP-RADOLOGICAL TECH          ,SD,57101-0000,Private      ,0,0,0,19,8,27
00530900,LAKE AREA TECHNICAL INSTITUTE           ,SD,57201-2869,Public       ,10,21,31,766,408,1174
00598700,AVERA SACRED HEART HOSPITAL SCHOOL OF RA,SD,57078-3899,Private      ,0,0,0,8,3,11
00776400,SOUTHEAST TECHNICAL INST                ,SD,57107-0000,Public       ,40,63,103,1382,1077,2459
00828400,MITCHELL TECHNICAL INSTITUTE            ,SD,57301-2002,Public       ,4,18,22,498,261,759
01013800,STEWART SCHOOL                          ,SD,57104-0000,Proprietary  ,6,9,15,97,59,156
01014804,COLORADO TECHNICAL UNIVERSITY           ,SD,57108-2272,Proprietary  ,19,119,138,317,1116,1433
01017000,WESTERN DAKOTA TECHNICAL INSTITUTE      ,SD,57701-4018,Public       ,18,41,59,473,863,1336
01147701,SIOUX VALLEY HOSP-MEDICAL TECH          ,SD,57117-5039,Private      ,0,0,0,17,12,29
01465900,OGLALA LAKOTA COLLEGE                   ,SD,57752-0490,Public       ,58,232,290,309,1425,1734
02137100,BLACK HILLS BEAUTY COLLEGE              ,SD,57701-0000,Proprietary  ,6,8,14,65,68,133
02143700,SINTE GLESKA UNIVERSITY                 ,SD,57570-0000,Public       ,26,121,147,150,704,854
02144600,KILIAN COMMUNITY COLLEGE                ,SD,57103-7020,Private      ,8,37,45,97,398,495
02277300,SISSETON WAHPETON COLLEGE               ,SD,57262-0000,Public       ,4,34,38,46,196,242
02297800,HEADLINES ACADEMY                       ,SD,57701-0000,Proprietary  ,2,14,16,38,89,127
00347700,AQUINAS COLLEGE                         ,TN,37205-2086,Private      ,2,30,32,261,728,989
00347701,AQUINAS COLLEGE -  PRIMETIME PROGRAM    ,TN,37214-3644,Private      ,2,44,46,12,307,319
00347800,AUSTIN PEAY STATE UNIVERSITY            ,TN,37044-0002,Public       ,106,404,510,6192,6619,12811
00347900,BELMONT UNIVERSITY                      ,TN,37212-3757,Private      ,67,109,176,4810,2206,7016
00348000,BETHEL COLLEGE                          ,TN,38201-1705,Private      ,22,301,323,1220,2858,4078
00348100,CARSON-NEWMAN COLLEGE                   ,TN,37760-2204,Private      ,29,26,55,2834,569,3403
00348200,CHRISTIAN BROTHERS UNIVERSITY           ,TN,38104-5581,Private      ,41,85,126,1999,1437,3436
00348300,COLUMBIA STATE COMMUNITY COLLEGE        ,TN,38401-5653,Public       ,76,185,261,2439,2704,5143
00348500,CUMBERLAND UNIVERSITY                   ,TN,37087-3554,Private      ,21,43,64,1308,790,2098
00348600,LIPSCOMB UNIVERSITY                     ,TN,37204-3951,Private      ,31,86,117,2740,1225,3965
00348700,EAST TENNESSEE STATE UNIV - MAIN CAMPUS ,TN,37614-2857,Public       ,91,263,354,9656,6259,15915
00348701,EAST TENNESSEE STATE UNIV - MEDICINE    ,TN,37614-1708,Public       ,5,5,10,143,366,509
00348709,EAST TENNESSEE STATE UNIV - PHARMACY    ,TN,37614-1704,Public       ,3,2,5,88,276,364
00349000,FISK UNIVERSITY                         ,TN,37208-3045,Private      ,20,8,28,1466,349,1815
00349200,FREED-HARDEMAN UNIVERSITY               ,TN,38340-2399,Private      ,19,49,68,1715,893,2608
00349400,HIWASSEE COLLEGE                        ,TN,37354-4001,Private      ,0,0,0,309,68,377
00349500,JOHNSON BIBLE COLLEGE                   ,TN,37998-9775,Private      ,4,4,8,563,292,855
00349600,KING COLLEGE                            ,TN,37620-2699,Private      ,10,58,68,1167,962,2129
00349800,LAMBUTH UNIVERSITY                      ,TN,38301-5296,Private      ,21,11,32,1236,342,1578
00349900,LANE COLLEGE                            ,TN,38301-4598,Private      ,48,26,74,2969,989,3958
00350000,LEE UNIVERSITY                          ,TN,37320-0000,Private      ,43,54,97,3368,1156,4524
00350100,LEMOYNE-OWEN COLLEGE                    ,TN,38126-6510,Private      ,30,61,91,789,1022,1811
00350200,LINCOLN MEMORIAL UNIVERSITY             ,TN,37752-7920,Private      ,17,61,78,1361,2794,4155
00350400,MARTIN METHODIST COLLEGE                ,TN,38478-2799,Private      ,8,23,31,855,421,1276
00350500,MARYVILLE COLLEGE                       ,TN,37804-5907,Private      ,23,6,29,1835,194,2029
00350600,MEHARRY MEDICAL COLLEGE                 ,TN,37208-0000,Private      ,1,15,16,39,1195,1234
00350700,MEMPHIS COLLEGE OF ART                  ,TN,38104-2764,Private      ,10,12,22,555,200,755
00350900,UNIVERSITY OF MEMPHIS (THE)             ,TN,38152-4611,Public       ,337,531,868,14210,14595,28805
00351000,MIDDLE TENNESSEE STATE UNIV             ,TN,37130-0000,Public       ,306,394,700,19962,9720,29682
00351100,MILLIGAN COLLEGE                        ,TN,37682-4001,Private      ,11,32,43,1003,481,1484
00351700,SOUTHERN COLLEGE OF OPTOMETRY           ,TN,38104-2222,Private      ,2,1,3,16,579,595
00351800,SOUTHERN ADVENTIST UNIVERSITY           ,TN,37315-0370,Private      ,37,27,64,2164,616,2780
00351900,RHODES COLLEGE                          ,TN,38112-1690,Private      ,36,8,44,2381,226,2607
00352200,TENNESSEE STATE UNIVERSITY              ,TN,37209-1561,Public       ,206,273,479,10165,7248,17413
00352201,TENNESSEE STATE UNIVERSITY - AVON WILLIA,TN,37203-3401,Public       ,20,40,60,94,307,401
00352300,TENNESSEE TECHNOLOGICAL UNIV            ,TN,38505-0001,Public       ,67,145,212,8028,3570,11598
00352400,TENNESSEE TEMPLE UNIVERSITY             ,TN,37404-3587,Private      ,9,34,43,520,371,891
00352500,TENNESSEE WESLEYAN COLLEGE              ,TN,37371-0040,Private      ,10,23,33,1029,450,1479
00352600,TREVECCA NAZARENE UNIVERSITY            ,TN,37210-2877,Private      ,19,124,143,1149,1954,3103
00352700,TUSCULUM COLLEGE                        ,TN,37743-0001,Private      ,25,117,142,1846,2004,3850
00352800,UNION UNIVERSITY                        ,TN,38305-3697,Private      ,29,170,199,2291,2255,4546
00352900,UNIVERSITY OF TENNESSEE-CHATTANOOGA     ,TN,37403-2598,Public       ,145,135,280,10025,3692,13717
00353000,UNIVERSITY OF TENNESSEE-KNOXVILLE       ,TN,37996-0150,Public       ,313,224,537,24452,8628,33080
00353006,UNIVERSITY OF TENNESSEE-HEALTH SCI CTR  ,TN,38103-0000,Public       ,8,46,54,331,2959,3290
00353100,UNIVERSITY OF TENNESSEE-MARTIN          ,TN,38238-0002,Public       ,95,140,235,6882,2900,9782
00353400,UNIVERSITY OF THE SOUTH                 ,TN,37383-1000,Private      ,23,10,33,1593,77,1670
00353500,VANDERBILT UNIVERSITY                   ,TN,37240-0001,Private      ,124,105,229,10735,5381,16116
00353501,VANDERBILT UNIV MED CTR ALLIEDHEAL      ,TN,37232-5510,Private      ,1,3,4,36,197,233
00353502,VANDERBILT UNIV - SCH OF MED            ,TN,37232-0000,Private      ,4,3,7,76,875,951
00353600,BRYAN COLLEGE                           ,TN,37321-7000,Private      ,8,50,58,1002,504,1506
00399800,CHATTANOOGA STATE TECH CMTY CLG         ,TN,37406-1097,Public       ,169,526,695,4283,6732,11015
00399900,CLEVELAND STATE COMMUNITY COLLEGE       ,TN,37312-2858,Public       ,44,117,161,1482,2119,3601
00402500,TN TECHNOLOGY CTR AT KNOXVILLE          ,TN,37919-2327,Public       ,19,103,122,406,1186,1592
00402600,TENNESSEE TECH. CNTR AT CROSSVILLE      ,TN,38555-4142,Public       ,14,47,61,236,542,778
00461700,NATIONAL COLLEGE OF BUSINESS & TECH     ,TN,37211-6605,Proprietary  ,63,420,483,345,2376,2721
00493400,DRAUGHONS JR CLG OF BUSINESS            ,TN,37217-1056,Proprietary  ,81,445,526,550,2982,3532
00493700,JACKSON STATE COMMUNITY COLLEGE         ,TN,38301-3797,Public       ,68,177,245,2514,3257,5771
00493800,SOUTH COLLEGE                           ,TN,37909-3323,Proprietary  ,30,292,322,392,1780,2172
00494700,WEST TENNESSEE BUSINESS COLLEGE         ,TN,38301-3256,Proprietary  ,14,87,101,121,618,739
00528000,TN TECHNOLOGY CTR AT COVINGTON          ,TN,38019-0249,Public       ,8,32,40,133,349,482
00528100,TN TECHNOLOGY CTR AT ELIZABETHTON       ,TN,37643-0789,Public       ,30,115,145,253,888,1141
00528200,TN TECHNOLOGY CTR AT HARTSVILLE         ,TN,37074-0000,Public       ,5,31,36,171,351,522
00528300,TN TECHNOLOGY CTR AT NEWBERN            ,TN,38059-1198,Public       ,6,51,57,126,430,556
00530700,TN TECHNOLOGY CTR AT MCMINNVILLE        ,TN,37110-1322,Public       ,8,22,30,145,370,515
00535100,TENNESSEE TECHNOLOGY CENTER AT MORRISTOW,TN,37813-2094,Public       ,26,86,112,418,1039,1457
00535200,TN TECHNOLOGY CENTER AT MCKENZIE        ,TN,38201-1620,Public       ,6,35,41,164,415,579
00535300,TN TECHNOLOGY CENTER AT LIVINGSTON      ,TN,38570-0219,Public       ,15,61,76,228,463,691
00535400,TN TECHNOLOGY CTR AT JACKSON            ,TN,38301-0000,Public       ,6,37,43,412,984,1396
00535600,TENNESSEE TECHNOLOGY CENTER AT HOHENWALD,TN,38462-0000,Public       ,16,65,81,241,502,743
00535700,TENNESSEE TECHNOLOGY CENTER AT CRUMP    ,TN,38327-3402,Public       ,13,43,56,197,435,632
00535800,TN TECHNOLOGY CENTER AT ATHENS          ,TN,37371-0848,Public       ,6,20,26,204,425,629
00535900,TENNESSEE TECHNOLOGY CENTER AT NASHVILLE,TN,37209-0000,Public       ,23,138,161,424,1250,1674
00536000,TENNESSEE TECHNOLOGY CENTER AT MEMPHIS  ,TN,38105-3604,Public       ,42,153,195,797,1978,2775
00537800,NORTHEAST STATE TECH CMNTY COLG         ,TN,37617-0246,Public       ,90,251,341,2723,3665,6388
00537900,TN TECHNOLOGY CTR AT SHELBYVILLE        ,TN,37160-3697,Public       ,9,39,48,373,761,1134
00683500,DYERSBURG STATE COMMUNITY COLLEGE       ,TN,38024-0000,Public       ,40,141,181,1403,2140,3543
00683600,MOTLOW STATE COMMUNITY COLLEGE          ,TN,37388-7972,Public       ,106,160,266,2377,2630,5007
00743900,FOUNTAINHEAD COLLEGE OF TECHNOLOGY      ,TN,37918-2583,Proprietary  ,9,25,34,91,267,358
00744000,NASHVILLE AUTO DIESEL COLLEGE           ,TN,37206-3298,Proprietary  ,321,130,451,2757,960,3717
00778200,TENNESSEE TECHNOLOGY CENTER AT DICKSON  ,TN,37055-0000,Public       ,18,111,129,307,796,1103
00778300,MIDDLE TENNESSEE SCH OF ANESTHESIA      ,TN,37116-0417,Private      ,0,1,1,16,155,171
00814500,NASHVILLE STATE TECH CMNTY COLLEGE      ,TN,37209-0000,Public       ,120,351,471,2683,5363,8046
00865500,GENESIS CAREER COLLEGE OF COOKEVILLE    ,TN,38501-1959,Proprietary  ,7,30,37,39,158,197
00885900,JOHN A GUPTON COLLEGE                   ,TN,37203-2934,Private      ,6,15,21,71,137,208
00886300,WALTERS STATE COMMUNITY COLLEGE         ,TN,37813-6899,Public       ,88,285,373,3455,3838,7293
00946400,TN TECHNOLOGY CTR AT PULASKI            ,TN,38478-4541,Public       ,15,72,87,152,363,515
00956700,TENNESSEE SCHOOL OF BEAUTY              ,TN,37921-3303,Proprietary  ,12,45,57,117,296,413
00971000,TENNESSEE TECHNOLOGY CENTER AT ONEIDA/HU,TN,37756-4149,Public       ,4,37,41,75,292,367
00991200,VOLUNTEER STATE COMMUNITY COLLEGE       ,TN,37066-3188,Public       ,98,327,425,3169,3988,7157
00991400,ROANE STATE COMMUNITY COLLEGE           ,TN,37748-8664,Public       ,88,198,286,2995,3532,6527
00998200,CRICHTON COLLEGE                        ,TN,38111-4745,Private      ,16,79,95,581,1517,2098
01021700,INTERNATIONAL ACADEMY OF DESIGN & TECH  ,TN,37212-0000,Proprietary  ,38,73,111,542,701,1243
01032600,TN TECHNOLOGY CTR AT HARRIMAN           ,TN,37748-1109,Public       ,12,61,73,160,367,527
01043900,SOUTHWEST TENNESSEE COMMUNITY COLLG     ,TN,38104-3322,Public       ,236,748,984,5857,11517,17374
01044700,"PLAZA BEAUTY SCHOOL, INC.               ",TN,38117-4822,Proprietary  ,4,22,26,43,157,200
01046000,AMERICAN BAPTIST THEOLOGICAL SEMINA     ,TN,37207-4994,Private      ,1,11,12,25,114,139
01052900,MEMPHIS THEOLOGICAL SEMINARY            ,TN,38104-0000,Private      ,0,16,16,2,209,211
01070000,TN TECHNOLOGY CENTER AT JACKSBORO       ,TN,37757-2461,Public       ,14,20,34,145,233,378
01155300,WM R MOORE COLLEGE OF TECHNOLOGY        ,TN,38104-0000,Private      ,4,16,20,61,139,200
01216400,TENNESSEE TECHNICAL CNTR AT RIPLEY      ,TN,38063-7359,Public       ,3,34,37,59,303,362
01254700,EMMANUEL SCHOOL OF RELIGION             ,TN,37601-0000,Private      ,0,6,6,1,61,62
01269300,PELLISSIPPI STATE COMMUNITY COLLEGE     ,TN,37933-0990,Public       ,186,295,481,4488,4264,8752
02092800,TENNESSEE TECHNOLOGY CENTER AT WHITEVILL,TN,38075-0000,Public       ,6,22,28,143,300,443
02103500,TN TECHNOLOGY CTR AT MURFREESBORO       ,TN,37129-0000,Public       ,7,40,47,231,478,709
02106400,O'MORE COLLEGE OF DESIGN                ,TN,37064-0000,Private      ,1,1,2,191,75,266
02125300,NASHVILLE CLG OF MEDICAL CAREERS        ,TN,37115-0000,Proprietary  ,11,54,65,54,299,353
02153100,JON NAVE UNIVERSITY OF COSMETOLOGY      ,TN,37013-3347,Proprietary  ,21,37,58,161,242,403
02157100,CONCORDE CAREER COLLEGE                 ,TN,38137-0000,Proprietary  ,53,282,335,367,1915,2282
02188300,CHURCH OF GOD THEOLOGICAL SEMINARY      ,TN,37320-0000,Private      ,0,16,16,2,219,221
02204200,"CHATTANOOGA COLLEGE - MEDICAL, DENTAL AN",TN,37411-0000,Proprietary  ,14,79,93,86,445,531
02237900,TN TECHNOLOGY CENTER AT PARIS           ,TN,38242-0000,Public       ,5,29,34,187,630,817
02257400,ARNOLD'S BEAUTY SCHOOL                  ,TN,38358-0000,Proprietary  ,2,13,15,42,63,105
02263104,HIGH-TECH INSTITUTE - NASHVILLE         ,TN,37214-2531,Proprietary  ,8,15,23,89,115,204
02275500,REUBEN-ALLEN COLLEGE                    ,TN,37922-0000,Proprietary  ,3,6,9,30,45,75
02278700,MR WAYNES SCH OF UNISEX HAIR DESIGN     ,TN,38501-0000,Proprietary  ,3,5,8,18,35,53
02293900,VOLUNTEER BEAUTY ACADEMY-NASHVILLE      ,TN,37115-2112,Proprietary  ,7,24,31,26,110,136
02294000,VOLUNTEER BEAUTY ACADEMY-DYERSBURG      ,TN,38024-1622,Proprietary  ,4,22,26,35,107,142
02326200,KAPLAN CAREER INSTITUTE                 ,TN,37217-1342,Proprietary  ,34,217,251,199,1058,1257
02326202,KAPLAN CAREER INSTITUTE - THOMPSON LANE ,TN,37204-3692,Proprietary  ,1,14,15,12,76,88
02326300,MEDVANCE INSTITUTE                      ,TN,38501-4305,Proprietary  ,21,105,126,251,964,1215
02335900,VOLUNTEER BEAUTY ACADEMY-NASHVILLE      ,TN,37209-3033,Proprietary  ,3,5,8,23,69,92
02359800,ITT TECHNICAL INSTITUTE                 ,TN,37214-3717,Proprietary  ,227,493,720,1352,2929,4281
02498000,NEW WAVE HAIR ACADEMY                   ,TN,38128-0000,Proprietary  ,4,30,34,53,215,268
02539800,QUEEN CITY COLLEGE                      ,TN,37042-0000,Proprietary  ,3,34,37,38,220,258
02540000,TENNESSEE ACADEMY OF COSMETOLOGY        ,TN,38133-0000,Proprietary  ,5,32,37,31,132,163
02578200,NOSSI COLLEGE OF ART                    ,TN,37072-0000,Proprietary  ,18,23,41,288,349,637
02595000,FAYETTEVILLE BEAUTY SCHOOL              ,TN,37334-2909,Proprietary  ,5,15,20,32,79,111
02597600,NEW WAVE HAIR ACADEMY                   ,TN,38301-3812,Proprietary  ,6,35,41,46,231,277
02599710,VATTEROTT COLLEGE - MEMPHIS             ,TN,38132-1714,Proprietary  ,22,117,139,162,983,1145
02605501,REMINGTON COLLEGE - MEMPHIS CAMPUS      ,TN,38132-0000,Proprietary  ,49,255,304,347,1574,1921
02609204,VATTEROTT COLLEGE - VATTEROTT CAREER COL,TN,38133-4727,Proprietary  ,12,40,52,12,40,52
02614200,MILLER MOTTE BUSINESS COLLEGE           ,TN,37040-6023,Proprietary  ,29,130,159,235,938,1173
02614203,MILLER-MOTTE TECHNICAL COLLEGE          ,TN,37421-0000,Proprietary  ,25,139,164,283,1042,1325
02614204,MILLER - MOTTE TECHNICAL COLLEGE - GOODL,TN,37072-1870,Proprietary  ,16,51,67,69,382,451
03001800,FREE WILL BAPTIST BIBLE COLLEGE         ,TN,37205-2498,Private      ,1,13,14,236,139,375
03008800,FRANKLIN ACADEMY                        ,TN,37312-3939,Private      ,8,24,32,29,78,107
03010606,VIRGINIA COLLEGE - SCH OF BUSNSS & HLTH ,TN,37411-5600,Proprietary  ,1,16,17,62,188,250
03012500,NEW WAVE HAIR ACADEMY                   ,TN,38111-4253,Proprietary  ,10,53,63,134,427,561
03024900,TENNESSEE ACADEMY OF COSMETOLOGY        ,TN,38125-3442,Proprietary  ,9,32,41,49,152,201
03061100,GENESIS CAREER COLLEGE OF LEBANON       ,TN,37087-2718,Proprietary  ,13,85,98,86,369,455
03073400,ITT TECHNICAL INSTITUTE                 ,TN,37932-3343,Proprietary  ,298,590,888,1678,3232,4910
03076405,HIGH-TECH INSTITUTE - MEMPHIS           ,TN,38134-7345,Proprietary  ,5,10,15,77,190,267
03079100,NORTH CENTRAL INSTITUTE                 ,TN,37042-3116,Proprietary  ,5,7,12,18,62,80
03088800,WATKINS INSTITUTE COLLEGE OF ART & DESIG,TN,37228-1306,Private      ,11,8,19,377,250,627
03126900,STYLES & PROFILES BEAUTY COLLEGE        ,TN,38375-2109,Proprietary  ,1,3,4,13,27,40
03149300,NEW DIRECTIONS HAIR ACADEMY             ,TN,37209-0000,Proprietary  ,11,48,59,103,337,440
03355400,RICHMONT GRADUATE UNIVERSITY            ,TN,37404-0000,Private      ,0,10,10,12,134,146
03440300,BAPTIST MEMORIAL COLLEGE OF HEALTH      ,TN,38104-3104,Private      ,15,29,44,671,1312,1983
03454300,TENNESSEE CAREER COLLEGE                ,TN,37214-2945,Proprietary  ,0,0,0,4,7,11
03480303,MEDVANCE INSTITUTE - NASHVILLE          ,TN,37203-1536,Proprietary  ,18,134,152,131,620,751
03513500,WILLIAMSON CHRISTIAN COLLEGE            ,TN,37067-8237,Private      ,2,6,8,16,56,72
03647300,NEW CONCEPTS SCHOOL OF COSMETOLOGY      ,TN,37311-7373,Proprietary  ,3,15,18,12,43,55
03683300,INTERNATIONAL BARBER & STYLE COLLEGE    ,TN,37218-2205,Proprietary  ,6,50,56,35,168,203
03701300,MEMPHIS INSTITUTE OF BARBERING          ,TN,38107-4334,Proprietary  ,8,21,29,30,100,130
03774400,SHEAR ACADEMY                           ,TN,38555-4177,Proprietary  ,3,6,9,14,32,46
03830300,SAE INSTITUTE OF TECHNOLOGY             ,TN,37203-4310,Proprietary  ,19,12,31,180,227,407
03841300,CAREER BEAUTY COLLEGE                   ,TN,38464-3634,Proprietary  ,3,5,8,15,35,50
03920300,INSTITUTE OF HAIR DESIGN                ,TN,38310-1801,Proprietary  ,2,2,4,20,50,70
03930300,BUCHANAN BEAUTY COLLEGE                 ,TN,37160-2741,Proprietary  ,4,28,32,9,56,65
03982300,VISIBLE SCHOOL - MUSIC AND WORSHIPS ARTS,TN,38002-9755,Private      ,0,1,1,74,38,112
04025300,LAST MINUTE CUTS SCHOOL OF BARBERING AND,TN,38109-7709,Proprietary  ,0,21,21,22,114,136
04035300,NAVE COSMETOLOGY ACADEMY                ,TN,38401-6335,Proprietary  ,8,35,43,54,154,208
04037400,MASON ACADEMY OF COSMETOLOGY            ,TN,38049-7048,Proprietary  ,0,0,0,0,2,2
04124100,ELITE COLLEGE OF COSMETOLOGY            ,TN,38351-1431,Proprietary  ,3,16,19,21,84,105
00353700,ABILENE CHRISTIAN UNIVERSITY            ,TX,79699-3701,Private      ,58,89,147,4114,1473,5587
00353900,ALVIN COMMUNITY COLLEGE                 ,TX,77511-4807,Public       ,32,103,135,822,1636,2458
00354000,AMARILLO COLLEGE                        ,TX,79109-2446,Public       ,114,389,503,2717,5388,8105
00354100,ANGELO STATE UNIVERSITY                 ,TX,76909-5069,Public       ,115,103,218,5512,2133,7645
00354300,AUSTIN COLLEGE                          ,TX,75090-4440,Private      ,27,5,32,1712,143,1855
00354400,AUSTIN PRESBYTERIAN THEOLOGICAL SEM     ,TX,78705-5797,Private      ,0,1,1,2,135,137
00354500,BAYLOR UNIVERSITY                       ,TX,76798-1458,Private      ,335,97,432,15305,3755,19060
00354600,COASTAL BEND COLLEGE                    ,TX,78102-2197,Public       ,78,162,240,1472,2217,3689
00354900,BLINN COLLEGE                           ,TX,77833-4098,Public       ,237,174,411,7914,3372,11286
00355300,CISCO JUNIOR COLLEGE                    ,TX,76437-9803,Public       ,59,93,152,1627,2009,3636
00355400,CLARENDON COLLEGE                       ,TX,79226-0000,Public       ,16,50,66,454,376,830
00355600,COMMONWEALTH INST OF FUNERAL SVC        ,TX,77090-5918,Private      ,4,15,19,53,144,197
00355700,CONCORDIA UNIVERSITY TEXAS              ,TX,78726-4141,Private      ,17,160,177,1097,1999,3096
00355800,NORTH CENTRAL TEXAS COLLEGE             ,TX,76240-4699,Public       ,117,208,325,2170,2862,5032
00356000,DALLAS BAPTIST UNIVERSITY               ,TX,75211-9299,Private      ,36,276,312,2365,3637,6002
00356100,CEDAR VALLEY COLLEGE                    ,TX,75134-0000,Public       ,68,264,332,1588,3117,4705
00356200,DALLAS THEOLOGICAL SEM                  ,TX,75204-0000,Private      ,0,23,23,14,582,596
00356300,DEL MAR COLLEGE                         ,TX,78404-3897,Public       ,129,315,444,4411,6179,10590
00356400,EAST TEXAS BAPTIST UNIVERSITY           ,TX,75670-1423,Private      ,9,11,20,1465,308,1773
00356500,TEXAS A&M UNIVERSITY - COMMERCE         ,TX,75429-3011,Public       ,91,247,338,3677,5282,8959
00356600,EPISCOPAL THEOL SEM OF THE STHWST       ,TX,78768-0000,Private      ,0,0,0,0,13,13
00356800,FRANK PHILLIPS COLLEGE                  ,TX,79008-0000,Public       ,21,50,71,371,499,870
00357000,GRAYSON COUNTY COLLEGE                  ,TX,75020-8299,Public       ,31,142,173,1362,2427,3789
00357100,HARDIN-SIMMONS UNIVERSITY               ,TX,79698-6050,Private      ,21,22,43,2104,895,2999
00357200,TRINITY VALLEY COMMUNITY COLLEGE        ,TX,75751-2734,Public       ,86,233,319,1746,3017,4763
00357300,HILL COLLEGE                            ,TX,76645-2711,Public       ,24,66,90,662,789,1451
00357301,HILL COLLEGE                            ,TX,76031-0000,Public       ,31,88,119,565,1174,1739
00357400,HOWARD COLLEGE                          ,TX,79720-0213,Public       ,42,120,162,1046,1741,2787
00357500,HOWARD PAYNE UNIVERSITY                 ,TX,76801-2794,Private      ,11,16,27,1346,383,1729
00357600,HOUSTON BAPTIST UNIVERSITY              ,TX,77074-3298,Private      ,78,73,151,3302,1872,5174
00357700,HUSTON - TILLOTSON UNIVERSITY           ,TX,78702-2795,Private      ,14,27,41,830,564,1394
00357800,UNIVERSITY OF THE INCARNATE WORD        ,TX,78209-6398,Private      ,75,162,237,4400,4209,8609
00357900,JACKSONVILLE COLLEGE                    ,TX,75766-4759,Private      ,5,12,17,211,128,339
00358000,KILGORE COLLEGE                         ,TX,75662-3299,Public       ,78,146,224,2449,3229,5678
00358100,LAMAR UNIVERSITY-BEAUMONT               ,TX,77710-0042,Public       ,188,374,562,6571,4975,11546
00358200,LAREDO COMMUNITY COLLEGE                ,TX,78040-4395,Public       ,114,143,257,4677,3659,8336
00358300,LEE COLLEGE                             ,TX,77520-4796,Public       ,48,175,223,1187,2959,4146
00358400,LETOURNEAU UNIVERSITY                   ,TX,75607-0000,Private      ,12,329,341,1494,3149,4643
00358500,LON MORRIS COLLEGE                      ,TX,75766-2900,Private      ,11,10,21,351,98,449
00358600,LUBBOCK CHRISTIAN UNIVERSITY            ,TX,79407-2099,Private      ,23,50,73,1385,1080,2465
00358800,UNIVERSITY OF MARY HARDIN-BAYLOR        ,TX,76513-2599,Private      ,54,39,93,2725,1303,4028
00359000,MCLENNAN COMMUNITY COLLEGE              ,TX,76708-1498,Public       ,101,228,329,3289,5586,8875
00359100,MCMURRY UNIVERSITY                      ,TX,79697-0001,Private      ,35,25,60,1717,662,2379
00359200,MIDWESTERN STATE UNIVERSITY             ,TX,76308-2099,Public       ,100,101,201,3528,2610,6138
00359300,NAVARRO COLLEGE                         ,TX,75110-4818,Public       ,133,264,397,3138,3961,7099
00359400,UNIVERSITY OF NORTH TEXAS               ,TX,76203-1370,Public       ,485,640,1125,22927,15862,38789
00359500,OBLATE SCHOOL OF THEOLOGY               ,TX,78216-0000,Private      ,0,3,3,0,12,12
00359600,ODESSA COLLEGE                          ,TX,79764-7127,Public       ,55,142,197,1306,2121,3427
00359800,OUR LADY OF THE LAKE UNIVERSITY         ,TX,78207-4689,Private      ,22,103,125,2103,2618,4721
00359900,UNIVERSITY OF TEXAS - PAN AMERICAN      ,TX,78541-2999,Public       ,371,329,700,13455,8848,22303
00360000,PANOLA COLLEGE                          ,TX,75633-2397,Public       ,34,78,112,793,1097,1890
00360100,PARIS JR COLLEGE                        ,TX,75460-6298,Public       ,82,236,318,1495,2529,4024
00360200,PAUL QUINN COLLEGE                      ,TX,75241-4398,Private      ,13,33,46,521,790,1311
00360300,RANGER COLLEGE                          ,TX,76470-3298,Public       ,13,15,28,444,296,740
00360400,RICE UNIVERSITY                         ,TX,77251-1892,Private      ,106,60,166,6711,1835,8546
00360600,SAM HOUSTON STATE UNIVERSITY            ,TX,77340-0000,Public       ,223,213,436,12754,5738,18492
00360700,ALAMO CMTY CLG DISTRICT PROGRAM         ,TX,78207-0000,Public       ,19,34,53,316,494,810
00360800,ST PHILLIPS COLLEGE                     ,TX,78203-2098,Public       ,150,523,673,4149,8477,12626
00360900,SAN JACINTO CLG-CENTRAL-NORTH-SOUTH     ,TX,77501-0000,Public       ,307,566,873,6037,8437,14474
00361000,SCHREINER UNIVERSITY                    ,TX,78028-5697,Private      ,14,30,44,1233,412,1645
00361100,SOUTH PLAINS COLLEGE                    ,TX,79336-6504,Public       ,135,219,354,4299,4400,8699
00361200,UNIV OF HOUSTON-DOWNTOWN                ,TX,77002-1001,Public       ,162,326,488,5825,8536,14361
00361300,SOUTHERN METHODIST UNIVERSITY           ,TX,75275-0181,Private      ,78,134,212,5278,4662,9940
00361400,SOUTHWEST TEXAS JR COLLEGE              ,TX,78801-6221,Public       ,111,169,280,2226,2736,4962
00361500,TEXAS STATE UNIVERSITY--SAN MARCOS      ,TX,78666-4602,Public       ,483,458,941,21598,11542,33140
00361600,SOUTHWESTERN ASSEMBLIES OF GOD UNIV     ,TX,75165-2397,Private      ,34,45,79,1405,1012,2417
00361700,SOUTHWESTERN BAPTIST THEOL SEMINARY     ,TX,76122-0000,Private      ,5,4,9,48,177,225
00361800,SOUTHWESTERN CHRISTIAN COLLEGE          ,TX,75160-3400,Private      ,6,5,11,210,86,296
00361900,SOUTHWESTERN ADVENTIST UNIVERSITY       ,TX,76059-1922,Private      ,6,19,25,654,380,1034
00362000,SOUTHWESTERN UNIVERSITY                 ,TX,78626-6111,Private      ,21,5,26,1829,152,1981
00362100,ST EDWARDS UNIVERSITY                   ,TX,78704-0000,Private      ,63,84,147,4258,2561,6819
00362300,ST MARY'S UNIV OF SAN ANTONIO           ,TX,78228-8500,Private      ,49,67,116,3438,2738,6176
00362400,STEPHEN F AUSTIN STATE UNIVERSITY       ,TX,75962-0001,Public       ,238,189,427,10514,4003,14517
00362500,SUL ROSS STATE UNIVERSITY               ,TX,79832-0113,Public       ,48,113,161,1379,1843,3222
00362600,TARRANT COUNTY COLLEGE                  ,TX,76102-6599,Public       ,495,1159,1654,10825,16793,27618
00362700,TEMPLE COLLEGE                          ,TX,76504-7435,Public       ,58,208,266,1851,3710,5561
00362800,TEXARKANA COLLEGE                       ,TX,75599-0001,Public       ,50,147,197,1552,2193,3745
00363000,PRAIRIE VIEW A&M UNIVERSITY             ,TX,77446-2967,Public       ,156,215,371,9178,5142,14320
00363100,TARLETON STATE UNIVERSITY               ,TX,76402-0000,Public       ,126,183,309,5533,4690,10223
00363200,TEXAS A&M UNIVERSITY                    ,TX,77842-0000,Public       ,679,234,913,31443,7371,38814
00363204,TEXAS A&M UNIVERSITY - GALVESTON        ,TX,77553-1675,Public       ,3,0,3,3,0,3
00363400,TEXAS STATE TECHNICAL CLG AT WACO       ,TX,76705-1695,Public       ,133,202,335,2599,2934,5533
00363500,TEXAS CHIROPRACTIC COLLEGE              ,TX,77505-1699,Private      ,0,8,8,21,430,451
00363600,TEXAS CHRISTIAN UNIVERSITY              ,TX,76129-0001,Private      ,140,98,238,7916,2570,10486
00363700,JARVIS CHRISTIAN COLLEGE                ,TX,75765-1470,Private      ,22,9,31,766,253,1019
00363800,TEXAS COLLEGE                           ,TX,75702-4500,Private      ,12,35,47,750,588,1338
00363900,TEXAS A&M UNIVERSITY-KINGSVILLE         ,TX,78363-8203,Public       ,138,210,348,5276,4307,9583
00364100,TEXAS LUTHERAN UNIVERSITY               ,TX,78155-5999,Private      ,14,7,21,1826,262,2088
00364200,TEXAS SOUTHERN UNIVERSITY               ,TX,77004-4598,Public       ,188,304,492,9070,9823,18893
00364300,TEXAS SOUTHMOST COLLEGE                 ,TX,78520-4992,Public       ,6,10,16,182,337,519
00364400,TEXAS TECH UNIVERSITY                   ,TX,79409-0000,Public       ,438,265,703,18969,8550,27519
00364500,TEXAS WESLEYAN UNIVERSITY               ,TX,76105-1536,Private      ,25,61,86,1142,3532,4674
00364600,TEXAS WOMAN'S UNIVERSITY                ,TX,76204-5587,Public       ,93,308,401,5035,8856,13891
00364700,TRINITY UNIVERSITY                      ,TX,78212-7200,Private      ,34,14,48,2912,493,3405
00364800,TYLER JUNIOR COLLEGE                    ,TX,75701-3436,Public       ,155,212,367,5565,4935,10500
00365100,UNIVERSITY OF DALLAS                    ,TX,75062-4799,Private      ,21,60,81,1788,1244,3032
00365200,UNIVERSITY OF HOUSTON                   ,TX,77204-2010,Public       ,570,643,1213,24531,19647,44178
00365400,UNIVERSITY OF ST THOMAS                 ,TX,77006-4626,Private      ,33,65,98,1411,1198,2609
00365600,UNIVERSITY OF TEXAS-ARLINGTON           ,TX,76019-0000,Public       ,304,650,954,14133,15400,29533
00365800,UNIVERSITY OF TEXAS-AUSTIN              ,TX,78713-7758,Public       ,580,410,990,36281,17006,53287
00365900,UT HEALTH CENTER-SAN ANTONIO            ,TX,78229-3900,Public       ,24,57,81,544,2886,3430
00366100,UNIVERSITY OF TEXAS-EL PASO             ,TX,79968-0629,Public       ,277,412,689,11508,10165,21673
00366200,VICTORIA COLLEGE (THE)                  ,TX,77901-4494,Public       ,48,128,176,1174,2089,3263
00366300,WAYLAND BAPTIST UNIVERSITY              ,TX,79072-6998,Private      ,19,230,249,1036,3196,4232
00366400,WEATHERFORD COLLEGE                     ,TX,76086-5699,Public       ,67,122,189,1623,1969,3592
00366500,WEST TEXAS A&M UNIVERSITY               ,TX,79016-0000,Public       ,108,108,216,4480,3368,7848
00366800,WHARTON COUNTY JR COLLEGE               ,TX,77488-3298,Public       ,75,104,179,1965,2032,3997
00366900,WILEY COLLEGE                           ,TX,75670-5199,Private      ,19,40,59,815,671,1486
00400300,CENTRAL TEXAS COLLEGE                   ,TX,76540-4199,Public       ,90,909,999,2036,9648,11684
00407221,NORTHWOOD UNIVERSITY                    ,TX,75104-0000,Private      ,12,57,69,630,737,1367
00445300,EL CENTRO COLLEGE                       ,TX,75202-0000,Public       ,109,493,602,2528,5944,8472
00481102,EVEREST INSTITUTE - EVEREST COLLEGE     ,TX,76011-6750,Proprietary  ,46,171,217,252,1022,1274
00494800,TEXAS A&M UNIV SYSTEM HEALTH SCI CT     ,TX,77840-7896,Public       ,13,10,23,188,1112,1300
00494801,TEXAS A&M UNIV SYSTEMS-HSC              ,TX,77843-1114,Public       ,0,0,0,287,341,628
00494900,BAYLOR COLLEGE OF MEDICINE              ,TX,77030-0000,Private      ,9,21,30,212,1299,1511
00495100,UNIV OF TEXAS HEALTH SCIENCE CENTER     ,TX,77225-0000,Public       ,7,50,57,348,2581,2929
00495200,UNIV OF TEXAS MEDICAL BRANCH            ,TX,77550-0000,Public       ,5,34,39,275,2014,2289
00497200,GALVESTON COLLEGE                       ,TX,77550-7447,Public       ,42,90,132,878,1312,2190
00497700,SOUTH TEXAS COLLEGE OF LAW              ,TX,77002-0000,Private      ,0,19,19,27,2017,2044
00520307,REMINGTON COLLEGE - DALLAS CAMPUS       ,TX,75041-9935,Proprietary  ,3,13,16,50,153,203
00660600,BAPTIST HS SCHOOL OF HEALTH PROFESSIONS ,TX,78229-3234,Proprietary  ,5,40,45,49,290,339
00661200,COVENANT SCH OF NSG & ALLIED HEALTH     ,TX,79410-0000,Private      ,2,6,8,99,277,376
00666100,ANGELINA COLLEGE                        ,TX,75902-0000,Public       ,69,189,258,1851,2781,4632
00694100,DALLAS CHRISTIAN COLLEGE                ,TX,75234-7229,Private      ,4,18,22,217,305,522
00709600,COLLEGE OF THE MAINLAND                 ,TX,77591-2499,Public       ,42,160,202,832,2053,2885
00728700,BRAZOSPORT COLLEGE                      ,TX,77566-3199,Public       ,51,82,133,782,1137,1919
00732907,ITT TECHNICAL INSTITUTE                 ,TX,77063-3751,Proprietary  ,3,40,43,130,299,429
00754805,WESTWOOD COLLEGE OF TECHNOLOGY          ,TX,77074-0000,Proprietary  ,55,100,155,381,589,970
00758602,REMINGTON COLLEGE - FORT WORTH CAMPUS   ,TX,76112-1280,Proprietary  ,51,177,228,292,949,1241
00835300,LINCOLN COLLEGE OF TECHNOLOGY           ,TX,75052-0000,Proprietary  ,279,276,555,1278,1392,2670
00849800,MIMS CLASSIC BEAUTY COLLEGE             ,TX,78216-0000,Proprietary  ,0,10,10,33,79,112
00850300,MOUNTAIN VIEW COLLEGE                   ,TX,75211-6599,Public       ,111,351,462,2405,4051,6456
00850400,RICHLAND COLLEGE                        ,TX,75243-2199,Public       ,156,433,589,3288,4943,8231
00851000,EASTFIELD COLLEGE                       ,TX,75150-2099,Public       ,113,330,443,2771,4965,7736
00907905,EVEREST COLLEGE                         ,TX,75206-5209,Proprietary  ,63,272,335,444,1669,2113
00908200,INTERNATIONAL BUSINESS COLLEGE          ,TX,79903-0000,Proprietary  ,51,155,206,214,722,936
00916300,SAN ANTONIO COLLEGE                     ,TX,78212-4299,Public       ,418,945,1363,9915,15032,24947
00922500,TEXAS STATE TECHNICAL COLLEGE  HARLINGEN,TX,78550-3697,Public       ,136,238,374,3051,3392,6443
00946600,KAPLAN CAREER INSTITUTE                 ,TX,78216-1899,Proprietary  ,68,286,354,380,1608,1988
00946607,SAN ANT COL OF MED & DENTAL - MCALLEN   ,TX,78503-1622,Proprietary  ,72,246,318,469,1237,1706
00946609,CAREER CENTERS OF TX - CORPUS CHRISTI   ,TX,78416-9900,Proprietary  ,46,237,283,246,1213,1459
00946610,KAPLAN CAREER INSTITUTE - CAREER CENTERS,TX,76103-2310,Proprietary  ,36,202,238,226,865,1091
00954900,WESTERN TEXAS COLLEGE                   ,TX,79549-9501,Public       ,11,29,40,481,338,819
00965100,TEXAS A&M INTERNATIONAL UNIVERSITY      ,TX,78041-1900,Public       ,83,101,184,3993,2847,6840
00974100,UNIVERSITY OF TEXAS AT DALLAS           ,TX,75083-0000,Public       ,161,343,504,6296,7368,13664
00976800,UNIVERSITY OF NORTH TEXAS HEALTH SCIENCE,TX,76107-2699,Public       ,8,28,36,86,1347,1433
00979700,MIDLAND COLLEGE                         ,TX,79705-6397,Public       ,31,121,152,1364,2102,3466
00982802,EVEREST INSTITUTE- AUSTIN               ,TX,78754-0000,Proprietary  ,87,398,485,365,1596,1961
00993000,UNIVERSITY OF TEXAS-PERMIAN BASIN       ,TX,79762-0001,Public       ,34,71,105,1527,1973,3500
00993200,TEXAS STATE TECH CLG-WEST TEXAS         ,TX,79556-4108,Public       ,25,88,113,477,908,1385
00993201,TEXAS STATE TECH COLLEGE-ABILENE        ,TX,79601-0000,Public       ,11,34,45,174,397,571
00993204,TEXAS STATE TECH CLG-BRECKENRIDGE       ,TX,76424-0000,Public       ,1,13,14,32,183,215
00993205,TEXAS STATE TECH COLLEGE-BROWNWOOD      ,TX,76801-0000,Public       ,5,34,39,135,360,495
01001900,UNIV OF TEXAS SOUTHWESTERN MED CTR      ,TX,75390-9096,Public       ,4,25,29,138,1615,1753
01005700,AMERICAN COMMERCIAL COLLEGE             ,TX,79602-1399,Proprietary  ,5,65,70,69,395,464
01005900,AMERICAN COMMERCIAL COLLEGE             ,TX,79761-0000,Proprietary  ,10,41,51,62,365,427
01005901,AMERICAN COMMERCIAL COLLEGE - AMERICAN C,TX,76310-2303,Proprietary  ,6,53,59,49,309,358
01006000,VERNON COLLEGE                          ,TX,76384-4092,Public       ,35,101,136,908,1911,2819
01011500,UNIVERSITY OF TEXAS-SAN ANTONIO         ,TX,78249-0600,Public       ,396,465,861,23128,14437,37565
01013000,WADE COLLEGE                            ,TX,75207-3199,Proprietary  ,16,13,29,217,210,427
01038700,EL PASO COMMUNITY COLLEGE               ,TX,79998-0000,Public       ,426,827,1253,11699,12594,24293
01050900,HALLMARK COLLEGE OF AERONAUTICS         ,TX,78214-0000,Proprietary  ,68,253,321,337,1088,1425
01062400,CENTRAL TEXAS COMMERCIAL COLLEGE        ,TX,75231-5033,Proprietary  ,3,25,28,31,73,104
01063300,HOUSTON COMMUNITY COLLEGE               ,TX,77002-0000,Public       ,858,2252,3110,9398,19079,28477
01063303,HOUSTON COMMUNITY COLLEGE - CENTRAL     ,TX,77004-0000,Public       ,0,0,0,1221,2683,3904
01063304,HOUSTON COMMUNITY COLLEGE - RICE AVIATIO,TX,77061-5001,Public       ,0,0,0,666,1176,1842
01063305,HOUSTON COMMUNITY COLLEGE - NORTHEAST CO,TX,77066-5221,Public       ,0,0,0,870,1446,2316
01063306,HOUSTON COMMUNITY COLLEGE - CENTRAL COLL,TX,77088-6372,Public       ,0,0,0,646,967,1613
01063339,HOUSTON COMMUNITY COLLEGE - STAFFORD    ,TX,77477-0000,Public       ,0,0,0,675,783,1458
01063347,HOUSTON COMMUNITY COLLEGE - SOUTHWEST   ,TX,77081-7849,Public       ,0,0,0,1312,1894,3206
01063348,HOUSTON COMMUNITY COLLEGE - COLEMAN     ,TX,77030-0000,Public       ,0,0,0,219,927,1146
01067400,TEXAS TECH U HEALTH SCIENCES CENTER     ,TX,79430-0000,Public       ,15,52,67,584,2561,3145
01076100,DALLAS INSTITUTE OF FUNERAL SERVICE     ,TX,75227-4314,Private      ,4,30,34,61,190,251
01114500,LONE STAR COLLEGE SYSTEM DISTRICT       ,TX,77073-3499,Public       ,195,462,657,4308,7179,11487
01114501,LONE STAR COLLEGE-KINGWOOD              ,TX,77339-0000,Public       ,66,227,293,1307,2525,3832
01114502,LONE STAR COLLEGE-TOMBALL               ,TX,77375-0000,Public       ,43,119,162,1004,1815,2819
01114503,LONE STAR COLLEGE-MONTGOMERY            ,TX,77384-0000,Public       ,89,198,287,1599,2936,4535
01114504,LONE STAR COLLEGE-CY-FAIR               ,TX,77433-1383,Public       ,103,200,303,1946,2674,4620
01116100,TEXAS A&M UNIV CORPUS CHRISTI           ,TX,78412-5599,Public       ,149,154,303,7154,4250,11404
01116300,UNIVERSITY OF TEXAS AT TYLER            ,TX,75799-6699,Public       ,69,110,179,3541,3549,7090
01171100,UNIVERSITY OF HOUSTON-CLEAR LAKE        ,TX,77058-1002,Public       ,53,205,258,1602,5771,7373
01201500,AUSTIN COMMUNITY COLLEGE                ,TX,78752-4390,Public       ,495,1317,1812,10713,16614,27327
01202000,VICTORIA BEAUTY COLLEGE                 ,TX,77901-6233,Proprietary  ,5,24,29,37,139,176
01226800,BALDWIN BEAUTY SCHOOL #5                ,TX,78704-4785,Proprietary  ,11,37,48,56,156,212
01229700,LAREDO BEAUTY COLLEGE                   ,TX,78040-1051,Proprietary  ,8,49,57,63,304,367
01248200,ATI TECHNICAL TRAINING CENTER           ,TX,75235-4622,Proprietary  ,157,586,743,738,2428,3166
01248209,ATI CAREER TRAINING CENTER - GARLAND    ,TX,75041-2497,Proprietary  ,2,10,12,10,33,43
01248300,COSMETOLOGY CAREER CENTER               ,TX,75006-2566,Proprietary  ,46,74,120,219,420,639
01248800,INTERNATIONAL BEAUTY COLLEGE NO 3       ,TX,75040-0000,Proprietary  ,6,12,18,27,87,114
01276400,METROPLEX BEAUTY SCHOOL                 ,TX,75149-0000,Proprietary  ,9,21,30,40,118,158
01293000,CHARLES & SUE'S SCH OF HAIR DESIGN      ,TX,77801-0000,Proprietary  ,3,10,13,38,75,113
01293100,VELMA B'S BEAUTY ACADEMY                ,TX,75216-1511,Proprietary  ,0,0,0,11,52,63
01293200,INTERNATIONAL BEAUTY COLLEGE            ,TX,75061-4235,Proprietary  ,1,10,11,15,78,93
01300300,NEILSON BEAUTY COLLEGE                  ,TX,75208-4637,Proprietary  ,2,17,19,15,73,88
01301600,OGLE SCHOOL HAIR SKIN NAILS             ,TX,76013-7401,Proprietary  ,20,49,69,171,290,461
01323100,UNIVERSITY OF HOUSTON-VICTORIA          ,TX,77901-5731,Public       ,15,132,147,376,2289,2665
02058600,CONLEE'S COLLEGE OF COSMETOLOGY         ,TX,78028-0000,Proprietary  ,4,7,11,11,33,44
02069302,VATTEROTT COLLEGE - VATTEROTT EDUCATION ,TX,75220-5441,Proprietary  ,18,88,106,113,391,504
02074100,CAPITOL CITY TRADE & TECHNICAL SCH      ,TX,78704-0000,Proprietary  ,52,182,234,248,740,988
02077400,NORTH LAKE COLLEGE                      ,TX,75038-0000,Public       ,102,220,322,1787,2868,4655
02078100,STEPHENVILLE BEAUTY COLLEGE             ,TX,76401-0000,Proprietary  ,2,3,5,18,36,54
02081400,ARLINGTON BAPTIST COLLEGE               ,TX,76012-0000,Private      ,5,8,13,93,140,233
02093600,SOUTHWEST SCHOOL OF ELECTRONIC          ,TX,78735-0000,Proprietary  ,3,9,12,16,48,64
02098300,WESTERN TECHNICAL COLLEGE               ,TX,79927-2105,Proprietary  ,136,277,413,848,1204,2052
02100200,BROOKHAVEN COLLEGE                      ,TX,75244-0000,Public       ,127,297,424,1801,3619,5420
02113610,AMERICAN INTERCONTINENTAL UNIV - HOUSTON,TX,77042-4516,Proprietary  ,13,86,99,173,741,914
02116008,SANFORD-BROWN COLLEGE - HOUSTON         ,TX,77036-8507,Proprietary  ,65,228,293,320,1148,1468
02116012,SANFORD-BROWN INSTITUTE - HOUSTON NORTH ,TX,77008-1058,Proprietary  ,28,105,133,139,595,734
02117100,ART INSTITUTE OF HOUSTON                ,TX,77056-0000,Proprietary  ,166,256,422,2403,2130,4533
02119200,COURT REPORTING INSTITUTE OF DALLAS     ,TX,75247-6913,Proprietary  ,15,97,112,171,1225,1396
02119202,COURT REPORTING INSTIUTE OF HOUSTON     ,TX,77040-6315,Proprietary  ,10,61,71,41,245,286
02128302,INSTITUTE FOR BUSINESS & TECHNOLOGY - LA,TX,78230-2520,Proprietary  ,27,79,106,93,329,422
02136800,AMERICAN COMMERCIAL COLLEGE             ,TX,76904-0000,Proprietary  ,8,33,41,35,208,243
02144800,BRADFORD SCHOOL OF BUSINESS             ,TX,77027-9881,Proprietary  ,15,13,28,153,159,312
02176100,PIPO ACADEMY OF HAIR DESIGN             ,TX,79903-0000,Proprietary  ,1,15,16,22,74,96
02188600,AUSTIN BUSINESS COLLEGE                 ,TX,78741-0000,Proprietary  ,0,0,0,8,21,29
02200800,AMERICAN COMMERCIAL COLLEGE             ,TX,79411-0000,Proprietary  ,14,98,112,63,414,477
02218300,SOUTHWEST SCHOOL OF BUSINESS & TECHNICAL,TX,78221-0000,Proprietary  ,33,117,150,185,706,891
02218305,SOUTHWEST SCHOOL OF BUSINESS AND TECHNIC,TX,78501-6053,Proprietary  ,9,34,43,68,210,278
02218306,SOUTHWEST SCHOOL OF BUSINESS AND TECHNIC,TX,78413-2045,Proprietary  ,9,31,40,26,145,171
02224600,TRI-STATE BEAUTY SCHOOL #1              ,TX,79915-0000,Proprietary  ,21,62,83,140,381,521
02230500,OGLE SCHOOL HAIR SKIN NAILS             ,TX,76132-3638,Proprietary  ,55,95,150,265,476,741
02230600,OGLE SCHOOL HAIR SKIN NAILS             ,TX,76053-0000,Proprietary  ,14,26,40,96,164,260
02239100,CENTRAL TEXAS BEAUTY COLLEGE #2         ,TX,78664-0000,Proprietary  ,8,62,70,44,225,269
02248200,MILAN INSTITUTE OF COSMETOLOGY          ,TX,79103-0000,Proprietary  ,99,343,442,544,1583,2127
02254800,TEXAS VOCATIONAL SCHOOLS                ,TX,77901-0000,Proprietary  ,10,28,38,50,146,196
02259400,AMBERTON UNIVERSITY                     ,TX,75041-0000,Private      ,2,18,20,23,210,233
02261300,EVEREST INSTITUTE                       ,TX,78213-3841,Proprietary  ,69,334,403,310,1541,1851
02261302,EVEREST INSTITUTE - HOUSTON GREENSPOINT ,TX,77060-3249,Proprietary  ,79,395,474,370,1608,1978
02261303,EVEREST INSTITUTE - HOUSTON HOBBY       ,TX,77087-2737,Proprietary  ,63,251,314,253,1215,1468
02267100,EXPOSITO SCHOOL OF HAIR DESIGN          ,TX,79109-0000,Proprietary  ,2,15,17,30,87,117
02276000,FRANKLIN BEAUTY SCHOOL #2               ,TX,77021-0000,Proprietary  ,2,26,28,45,155,200
02285900,UNIVERSITY OF COSMETOLOGY ARTS&SCI      ,TX,78504-0000,Proprietary  ,31,133,164,173,542,715
02294800,CAPITOL CITY CAREERS                    ,TX,78745-0000,Proprietary  ,1,42,43,23,208,231
02298501,EVEREST COLLEGE- FORT WORTH             ,TX,76137-2472,Proprietary  ,54,187,241,224,934,1158
02305300,PARKER COLLEGE OF CHIROPRACTIC          ,TX,75229-0000,Private      ,0,18,18,67,1215,1282
02306700,FORT WORTH BEAUTY SCHOOL                ,TX,76116-3299,Proprietary  ,4,40,44,44,250,294
02312200,TEXAS SCHOOL OF BUSINESS                ,TX,77073-6032,Proprietary  ,63,179,242,309,877,1186
02312201,TEXAS SCHOOL OF BUSINESS - SOUTHWEST CAM,TX,77057-0000,Proprietary  ,36,130,166,224,781,1005
02312202,TEXAS SCHOOL OF BUSINESS - FRIENDSWOOD C,TX,77546-8938,Proprietary  ,17,140,157,91,599,690
02312203,TEXAS SCHOOL OF BUSINESS - EAST CAMPUS  ,TX,77029-1916,Proprietary  ,55,155,210,222,748,970
02313901,WESTWOOD COLLEGE - DALLAS               ,TX,75243-0000,Proprietary  ,55,159,214,503,908,1411
02315400,NORTHEAST TEXAS COMMUNITY COLLEGE       ,TX,75456-0000,Public       ,25,67,92,1027,1368,2395
02318200,"KD STUDIO, ACTOR'S CONSERVATORY         ",TX,75207-2111,Proprietary  ,12,23,35,119,148,267
02320200,HOUSTON GRADUATE SCHOOL OF THEOLOGY     ,TX,77004-0000,Private      ,0,13,13,0,158,158
02326000,SAN ANTONIO BEAUTY COLLEGE NO 3         ,TX,78217-0000,Proprietary  ,9,15,24,58,115,173
02328600,ITT TECHNICAL INSTITUTE                 ,TX,76011-0000,Proprietary  ,127,241,368,627,1141,1768
02331200,BAPTIST MISSIONARY ASSN THEOL SEM       ,TX,75766-0000,Private      ,0,3,3,3,28,31
02331300,INTERACTIVE LEARNING SYSTEMS            ,TX,75247-0000,Proprietary  ,0,2,2,1,75,76
02331301,INTERACTIVE LEARNING SYSTEMS            ,TX,77081-0000,Proprietary  ,26,105,131,64,373,437
02331303,INTERACTIVE LEARNING SYSTEMS            ,TX,77502-0000,Proprietary  ,3,75,78,24,296,320
02331304,INTERACTIVE LEARNING SYSTEMS            ,TX,77060-0000,Proprietary  ,2,30,32,14,195,209
02341300,PALO ALTO COLLEGE                       ,TX,78224-0000,Public       ,177,369,546,4065,5575,9640
02348500,LAMAR STATE COLLEGE-PORT ARTHUR         ,TX,77640-0000,Public       ,38,74,112,747,1222,1969
02357700,ACADEMY OF HAIR DESIGN                  ,TX,77090-0000,Proprietary  ,12,22,34,123,158,281
02358200,LAMAR STATE COLLEGE-ORANGE              ,TX,77630-0000,Public       ,29,103,132,640,1547,2187
02361400,COLLIN COUNTY COMMUNITY COLLEGE         ,TX,75071-0000,Public       ,218,492,710,4101,5587,9688
02362000,UNIVERSAL TECHNICAL INSTITUTE           ,TX,77073-0000,Proprietary  ,295,315,610,4602,2267,6869
02362800,AUSTIN GRADUATE SCHOOL OF THEOLOGY      ,TX,78752-1333,Private      ,0,1,1,5,57,62
02521200,ARLINGTON CAREER INSTITUTE              ,TX,75050-0000,Proprietary  ,4,63,67,73,461,534
02521800,SEGUIN BEAUTY SCHOOL                    ,TX,78155-0000,Proprietary  ,8,16,24,43,88,131
02527500,HOUSTON TRAINING SCHOOLS                ,TX,77020-0000,Proprietary  ,24,187,211,144,846,990
02530700,SEBRING CAREER SCHOOLS                  ,TX,77083-1510,Proprietary  ,2,18,20,27,101,128
02539600,ART INSTITUTE OF DALLAS                 ,TX,75231-5993,Proprietary  ,113,189,302,2043,1623,3666
02548800,SOUTH TEXAS VO-TECH INSTITUTE           ,TX,78596-0000,Proprietary  ,91,350,441,502,1614,2116
02548802,SOUTH TEXAS VOCATIONAL TECHNICAL INSTITU,TX,78520-8710,Proprietary  ,0,0,0,18,29,47
02549400,SOUTH TEXAS VO-TECH INSTITUTE           ,TX,78501-0000,Proprietary  ,174,431,605,561,1310,1871
02549402,SOUTH TEXAS VOCATIONAL TECHNICAL INSTITU,TX,78416-1141,Proprietary  ,0,3,3,0,3,3
02555400,UNIV OF TX MD ANDERSON CANCER CTR       ,TX,77030-0000,Public       ,2,7,9,71,234,305
02557400,STAR COLLEGE OF COSMETOLOGY             ,TX,75961-0000,Proprietary  ,0,0,0,2,5,7
02568100,TEXAS BARBER COLLEGES & HAIRSTYLING     ,TX,75208-0000,Proprietary  ,64,222,286,292,1099,1391
02569300,TEXAS CULINARY ACADEMY                  ,TX,78758-3403,Proprietary  ,231,909,1140,1370,2916,4286
02572000,COMPUTER CAREER CENTER                  ,TX,79925-2021,Proprietary  ,41,226,267,179,893,1072
02572004,COMPUTER CAREER CENTER - AMARILLO CAMPUS,TX,79101-2404,Proprietary  ,7,43,50,9,53,62
02572005,COMPUTER CAREER CENTER - LUBBOCK CAMPUS ,TX,79414-3517,Proprietary  ,2,17,19,2,17,19
02572100,"CAREER ACADEMY, INC.                    ",TX,75501-0000,Proprietary  ,0,1,1,10,42,52
02580100,IVERSON BUSINESS SCH & COURT REPORT     ,TX,76011-1344,Proprietary  ,23,98,121,121,561,682
02591100,CAREER POINT INSTITUTE                  ,TX,78201-2027,Proprietary  ,120,588,708,468,2942,3410
02591900,CAREER CENTERS OF TEXAS - EL PASO       ,TX,79907-1525,Proprietary  ,99,281,380,568,1566,2134
02591905,CAREER CENTERS OF TEXAS-BROWNSVILLE     ,TX,78521-9905,Proprietary  ,55,127,182,294,779,1073
02596400,REDSTONE COLLEGE - LOS ANGELES          ,TX,77061-0000,Proprietary  ,40,53,93,287,328,615
02596412,WESTWOOD COLLEGE OF AVIATION TECHNOLOGY ,TX,77061-5114,Proprietary  ,0,1,1,23,34,57
02596500,ATI CAREER TRAINING CENTER              ,TX,76180-1599,Proprietary  ,147,482,629,728,1998,2726
02596600,ATI-CAREER TRAINING CENTER              ,TX,75220-4443,Proprietary  ,142,550,692,780,2855,3635
02596601,ATI CAREER TRAINING CENTER - RICHARDSON ,TX,75081-6745,Proprietary  ,1,10,11,18,42,60
02596602,ATI CAREER TRAINING CENTER - DALLAS (STE,TX,75247-6103,Proprietary  ,0,10,10,0,10,10
02600200,OCEAN CORPORATION (THE)                 ,TX,77099-3479,Proprietary  ,22,105,127,148,632,780
02604700,CENTER FOR ADVANCED LEGAL STUDIES       ,TX,77098-4151,Proprietary  ,3,39,42,24,266,290
02606202,EVEREST COLLEGE - EVEREST INSTITUTE - BI,TX,77036-8014,Proprietary  ,133,381,514,500,1593,2093
02615000,SANFORD-BROWN INSTITUTE                 ,TX,75247-6931,Proprietary  ,115,408,523,581,2153,2734
03009400,SW SCH BUS & TECH CAREERS               ,TX,78212-2840,Proprietary  ,8,21,29,27,112,139
03010000,VANGUARD INSTITUTE OF TECHNOLOGY        ,TX,78539-0000,Proprietary  ,0,0,0,2,1,3
03010604,VIRGINIA COLLEGE - VIRGINIA COLLEGE AT A,TX,78723-0000,Proprietary  ,28,215,243,198,957,1155
03011800,SAN ANTONIO BEAUTY COLLEGE #4           ,TX,78226-1160,Proprietary  ,1,17,18,37,103,140
03019800,PCI HEALTH TRAINING CENTER              ,TX,75247-4720,Proprietary  ,98,211,309,449,916,1365
03021500,SW SCH BUS & TECH CAREERS               ,TX,78852-4859,Proprietary  ,4,26,30,48,135,183
03023800,AIMS ACADEMY                            ,TX,75050-0000,Proprietary  ,0,0,0,9,27,36
03025000,TEXAS COLLEGE OF COSMETOLOGY            ,TX,79605-2001,Proprietary  ,12,51,63,61,197,258
03026500,REMINGTON COLLEGE - HOUSTON CAMPUS      ,TX,77082-1849,Proprietary  ,111,373,484,616,1946,2562
03026501,REMINGTON COLLEGE - NORTH HOUSTON CAMPUS,TX,77067-1849,Proprietary  ,6,20,26,43,153,196
03028800,CIRCLE J BEAUTY SCHOOL                  ,TX,77587-3714,Proprietary  ,10,34,44,57,211,268
03031408,INTERNATIONAL ACADEMY OF DESIGN AND TECH,TX,78229-2263,Proprietary  ,44,69,113,329,517,846
03032300,SCHOOL OF AUTOMOTIVE MACHINISTS         ,TX,77055-1803,Proprietary  ,8,18,26,79,120,199
03035200,JONES BEAUTY COLLEGE                    ,TX,75229-3734,Proprietary  ,3,21,24,22,123,145
03035300,SOUTHERN CAREERS INSTITUTE              ,TX,78704-5252,Proprietary  ,173,681,854,599,1986,2585
03035301,SOUTHERN CAREERS INSTITUTE              ,TX,78577-0000,Proprietary  ,62,195,257,250,643,893
03035302,SOUTHERN CAREERS INSTITUTE - CORPUS CHRI,TX,78414-2904,Proprietary  ,24,113,137,153,451,604
03035303,SOUTHERN CAREERS INSTITUTE - #1         ,TX,78221-4351,Proprietary  ,73,324,397,222,1029,1251
03035304,SOUTHERN CAREERS INSTITUTE-LAREDO       ,TX,78041-0000,Proprietary  ,0,0,0,9,20,29
03061800,STAR COLLEGE OF COSMETOLOGY             ,TX,75702-8214,Proprietary  ,6,21,27,65,143,208
03064600,UNIVERSITY OF TEXAS AT BROWNSVILLE      ,TX,78520-4993,Public       ,195,273,468,6784,7212,13996
03071400,ITT TECHNICAL INSTITUTE                 ,TX,78249-3303,Proprietary  ,46,113,159,429,802,1231
03075400,ICC TECHNICAL INSTITUTE                 ,TX,77004-2930,Private      ,9,16,25,25,80,105
03076403,HIGH-TECH INSTITUTE - DALLAS            ,TX,75038-4201,Proprietary  ,6,17,23,59,90,149
03079201,WESTWOOD COLLEGE OF TECHNOLOGY          ,TX,76180-0000,Proprietary  ,31,118,149,297,515,812
03091200,CAREERS UNLIMITED                       ,TX,75702-7110,Proprietary  ,0,0,0,6,28,34
03103400,SOUTH TEXAS COLLEGE                     ,TX,78501-6699,Public       ,521,761,1282,9913,11007,20920
03104700,TEXAS COLLEGE OF COSMETOLOGY            ,TX,76903-4708,Proprietary  ,9,46,55,46,159,205
03108700,ROYAL BEAUTY CAREERS                    ,TX,77069-4611,Proprietary  ,26,60,86,136,394,530
03111000,MID-CITIES BARBER COLLEGE               ,TX,75051-4810,Proprietary  ,3,14,17,47,137,184
03115800,TEXAS CAREERS                           ,TX,78213-3792,Proprietary  ,35,237,272,183,1305,1488
03115802,TEXAS CAREERS - LAREDO                  ,TX,78041-6181,Proprietary  ,28,99,127,139,404,543
03115803,TEXAS CAREERS - BEAUMONT                ,TX,77701-3706,Proprietary  ,47,111,158,185,603,788
03115804,TEXAS CAREERS - LUBBOCK                 ,TX,79401-2601,Proprietary  ,44,162,206,192,762,954
03128100,ACADEMY OF HEALTH CARE PROFESSIONS      ,TX,77092-8108,Proprietary  ,68,213,281,344,1169,1513
03144300,NATIONAL BEAUTY COLLEGE                 ,TX,75041-3433,Proprietary  ,4,15,19,17,62,79
03153300,AMER COLL OF ACUPUNCTURE & O.M.         ,TX,77063-4104,Proprietary  ,0,8,8,4,100,104
03156400,ACADEMY OF ORIENTAL MEDICINE AT AUSTIN  ,TX,78757-1132,Proprietary  ,0,9,9,7,241,248
03159300,ARLINGTON MEDICAL INSTITUTE             ,TX,76011-2645,Proprietary  ,3,32,35,63,175,238
03170300,TEXAS A&M UNIVERSITY-TEXARKANA          ,TX,75501-0000,Public       ,12,52,64,312,1154,1466
03179500,TEXAS COLG TRADITIONAL CHINESE MED      ,TX,78704-6748,Proprietary  ,0,3,3,4,112,116
03189400,COLLEGE OF SAINT THOMAS MORE            ,TX,76109-2323,Private      ,0,3,3,23,15,38
03237400,FARIS COMPUTER SCHOOL                   ,TX,77627-3829,Proprietary  ,0,4,4,5,41,46
03272300,SOUTHEASTERN CAREER INSTITUTE           ,TX,75234-7288,Proprietary  ,11,98,109,92,473,565
03272301,SOUTHEASTERN CAREER INSTITUTE - MIDLAND ,TX,79703-5531,Proprietary  ,36,170,206,131,539,670
03275300,TOUCH OF CLASS SCHOOL OF COSM           ,TX,75402-6314,Proprietary  ,5,16,21,29,90,119
03276300,ACADEMY OF HAIR DESIGN                  ,TX,75901-4900,Proprietary  ,8,24,32,46,133,179
03277300,ACADEMY OF HAIR DESIGN                  ,TX,77701-4650,Proprietary  ,6,21,27,24,91,115
03303300,NORTHWEST EDUCATIONAL CENTER            ,TX,77092-7055,Proprietary  ,11,88,99,35,367,402
03371300,TONI&GUY HAIRDRESSING ACADEMY           ,TX,75006-2351,Proprietary  ,17,17,34,128,136,264
03372300,NORTHWEST VISTA COLLEGE                 ,TX,78251-4217,Public       ,208,385,593,5561,6024,11585
03396500,TEXAS STATE TECHNICAL COLG/MARSHALL     ,TX,75672-7402,Public       ,14,43,57,366,453,819
03400300,CAREER QUEST                            ,TX,78229-3539,Proprietary  ,11,141,152,39,476,515
03412300,ADVANCED BARBER COLLEGE & HAIR DESI     ,TX,78596-0000,Proprietary  ,6,31,37,37,136,173
03416500,DALLAS NURSING INSTITUTE                ,TX,75243-5502,Proprietary  ,9,146,155,127,1070,1197
03422300,MILAN INSTITUTE                         ,TX,78238-3327,Proprietary  ,64,133,197,411,730,1141
03422400,COLLEGE OF BIBLICAL STUDIES-HOUSTON     ,TX,77036-3211,Private      ,3,28,31,46,541,587
03424400,MEDVANCE INSTITUTE                      ,TX,77057-7386,Proprietary  ,64,221,285,218,861,1079
03424401,MEDVANCE INSTITUTE -                    ,TX,77060-3551,Proprietary  ,1,12,13,46,167,213
03426300,CAREER ADVANCEMENT CENTER               ,TX,78752-1470,Proprietary  ,6,79,85,55,364,419
03480304,MEDVANCE INSTITUTE OF BATON ROUGE - GRAN,TX,75050-2342,Proprietary  ,21,103,124,47,238,285
03509400,CORYELL COSMETOLOGY COLLEGE             ,TX,76528-2036,Proprietary  ,1,5,6,6,24,30
03520300,LUBBOCK HAIR ACADEMY                    ,TX,79410-3524,Proprietary  ,2,12,14,31,86,117
03541300,BEHOLD! BEAUTY ACADEMY                  ,TX,77016-3725,Proprietary  ,0,0,0,3,8,11
03542300,CONCORDE CAREER INSTITUTE               ,TX,76011-4016,Proprietary  ,43,232,275,252,1555,1807
03551400,STATE BEAUTY ACADEMY                    ,TX,75116-3501,Proprietary  ,3,5,8,24,67,91
03556400,KUSSAD INSTITUTE OF COURT REPORTING     ,TX,78704-5712,Proprietary  ,0,3,3,8,40,48
03563300,ACADEMY OF COSEMTOLOGY                  ,TX,78745-2858,Proprietary  ,1,4,5,20,75,95
03573300,AVIATION INSTITUTE OF MAINTENANCE       ,TX,75209-3017,Proprietary  ,32,145,177,162,628,790
03610300,MJ'S BEAUTY ACADEMY INC                 ,TX,75224-4409,Proprietary  ,3,10,13,22,64,86
03612400,VALLEY GRANDE INSTITUTE FOR ACADEMI     ,TX,78596-0000,Private      ,17,117,134,139,583,722
03627300,LAMAR INSTITUTE OF TECHNOLOGY           ,TX,77705-4142,Public       ,63,96,159,1287,1866,3153
03676400,HEALTHY HAIR ACADEMY                    ,TX,75227-0000,Proprietary  ,12,76,88,43,225,268
03680300,JAY'S TECHNICAL INSTITUTE               ,TX,77031-3509,Proprietary  ,8,75,83,36,187,223
03682400,DALLAS BARBER & STYLIST COLLEGE         ,TX,75231-0000,Proprietary  ,11,34,45,55,212,267
03714300,TREND BARBER COLLEGE                    ,TX,77071-2104,Proprietary  ,10,63,73,63,244,307
03723300,CULINARY INST ALAIN & MARIE LENOTRE     ,TX,77022-4322,Proprietary  ,14,27,41,107,202,309
03727600,CULINARY ACADEMY OF AUSTIN              ,TX,78752-0000,Proprietary  ,6,14,20,82,121,203
03733300,BAPTIST UNIVERSITY OF THE AMERICAS      ,TX,78224-1336,Private      ,5,15,20,70,196,266
03756300,ANAMARC EDUCATIONAL INSTITUTE           ,TX,79930-6230,Proprietary  ,21,112,133,126,768,894
03885400,COMPUTER LABS                           ,TX,79906-5924,Proprietary  ,0,0,0,2,7,9
03885700,HOUSTON'S TRAINING AND EDUCATION CENTER ,TX,77036-2021,Proprietary  ,1,20,21,7,102,109
03922300,SOUTH TEXAS BARBER COLLEGE              ,TX,78415-3463,Proprietary  ,2,13,15,21,61,82
03926300,AMESED                                  ,TX,75081-0000,Proprietary  ,0,0,0,11,26,37
03944400,PROFESSIONAL CAREERS INSTITUTE          ,TX,77036-2252,Proprietary  ,2,20,22,23,121,144
03970300,HANDS ON THERAPY                        ,TX,75149-2294,Proprietary  ,12,48,60,12,48,60
03984300,ALLIED CAREER CENTER                    ,TX,75007-0000,Proprietary  ,0,0,0,1,6,7
03987300,TEXAS HEALTH SCHOOL                     ,TX,77079-2106,Proprietary  ,6,43,49,53,199,252
04036300,SOUTHEAST TEXAS CAREER INSTITUTE        ,TX,77656-8601,Proprietary  ,6,10,16,32,88,120
04045300,NORTHWEST BEAUTY SCHOOL                 ,TX,77091-1208,Proprietary  ,1,12,13,13,65,78
04045400,MAI-TRIX BEAUTY COLLEGE                 ,TX,77040-0000,Proprietary  ,1,6,7,21,70,91
04089400,CCI TRAINING CENTER                     ,TX,76011-4857,Proprietary  ,6,56,62,29,264,293
04117900,CHAMPION BEAUTY COLLEGE                 ,TX,77069-4611,Proprietary  ,2,12,14,26,88,114
04122100,BENCHMARK CAREER INSTITUTE              ,TX,75080-7426,Proprietary  ,0,0,0,0,2,2
04125400,ACADEMY AT AUSTIN (THE)                 ,TX,78660-3287,Proprietary  ,14,26,40,90,159,249
04125500,MANUEL AND THERESA'S SCHOOL OF HAIR DESI,TX,77803-3236,Proprietary  ,3,2,5,22,32,54
04129800,MEDIATECH INSTITUTE DALLAS              ,TX,75039-3105,Proprietary  ,12,33,45,76,106,182
04129801,MEDIATECH INSTITUTE AUSTIN              ,TX,78704-8933,Proprietary  ,10,10,20,27,32,59
04129802,MEDIATECH INSTITUTE HOUSTON             ,TX,77042-4712,Proprietary  ,12,23,35,26,43,69
04131700,SOUTHWEST CAREER INSTITUTE              ,TX,79925-6230,Proprietary  ,37,146,183,158,385,543
04136500,PCCENTER                                ,TX,75115-4214,Proprietary  ,1,13,14,2,28,30
04142300,AVEDA INSTITUTE SAN ANTONIO             ,TX,78215-1260,Proprietary  ,27,48,75,37,71,108
04146600,360 DEGREES BEAUTY ACADEMY              ,TX,77084-2714,Proprietary  ,1,12,13,1,12,13
00367000,BRIGHAM YOUNG UNIVERSITY                ,UT,84602-8406,Private      ,635,857,1492,10040,12106,22146
00367100,DIXIE STATE COLLEGE OF UTAH             ,UT,84770-3876,Public       ,126,293,419,2027,2743,4770
00367200,LDS BUSINESS COLLEGE                    ,UT,84101-3500,Private      ,42,51,93,501,506,1007
00367400,STEVENS HENAGER COLLEGE                 ,UT,84401-1420,Proprietary  ,164,1083,1247,787,4327,5114
00367500,UNIVERSITY OF UTAH                      ,UT,84112-9055,Public       ,350,687,1037,7844,13297,21141
00367600,COLLEGE OF EASTERN UTAH                 ,UT,84501-2699,Public       ,50,66,116,678,692,1370
00367700,UTAH STATE UNIVERSITY                   ,UT,84322-1400,Public       ,213,459,672,6234,8576,14810
00367800,SOUTHERN UTAH UNIVERSITY                ,UT,84720-2470,Public       ,145,177,322,3148,2639,5787
00367900,SNOW COLLEGE                            ,UT,84627-1299,Public       ,81,70,151,1580,673,2253
00368000,WEBER STATE UNIVERSITY                  ,UT,84408-1136,Public       ,243,509,752,4236,9110,13346
00368100,WESTMINSTER COLLEGE                     ,UT,84105-3697,Private      ,36,67,103,1655,1468,3123
00402700,UTAH VALLEY UNIVERSITY                  ,UT,84058-5999,Public       ,494,935,1429,6450,12378,18828
00522000,SALT LAKE COMMUNITY COLLEGE             ,UT,84123-0000,Public       ,480,1127,1607,5444,11368,16812
00943300,SHERMAN KENDALL'S ACADEMY OF BEAUTY     ,UT,84106-1836,Proprietary  ,4,9,13,27,59,86
01009800,NEUMONT UNIVERSITY                      ,UT,84095-0000,Proprietary  ,16,23,39,324,226,550
01116500,UINTAH BASIN APPLIED TECHNOLOGY CLG     ,UT,84066-0000,Public       ,3,6,9,6,56,62
01116600,UTAH CAREER COLLEGE                     ,UT,84088-4021,Proprietary  ,76,212,288,436,1335,1771
02078800,SHERMAN KENDALL'S ACADEMY OF BEAUTY     ,UT,84047-0000,Proprietary  ,5,6,11,15,31,46
02115400,BRIDGERLAND APPLIED TECHNOLOGY COLLEGE  ,UT,84321-0000,Public       ,20,99,119,149,606,755
02156600,DAVIS APPLIED TECHNOLOGY COLLEGE        ,UT,84037-0000,Public       ,27,159,186,206,911,1117
02178500,EAGLE GATE COLLEGE                      ,UT,84123-0000,Proprietary  ,49,215,264,307,1254,1561
02270800,AMERITECH COLLEGE                       ,UT,84604-6927,Proprietary  ,10,31,41,60,355,415
02270802,AMERITECH COLLEGE - DRAPER              ,UT,84020-6545,Proprietary  ,1,6,7,12,116,128
02298500,EVEREST COLLEGE                         ,UT,84119-2668,Proprietary  ,48,184,232,170,785,955
02346500,OGDEN-WEBER APPLIED TECHNOLOGY COLG     ,UT,84404-0000,Public       ,26,181,207,187,1058,1245
02360800,PROVO COLLEGE                           ,UT,84601-0000,Proprietary  ,38,131,169,275,681,956
02361000,ITT TECHNICAL INSTITUTE                 ,UT,84123-0000,Proprietary  ,34,146,180,218,869,1087
02504000,MARINELLO SCHOOL OF BEAUTY              ,UT,84041-0000,Proprietary  ,13,20,33,52,114,166
02516100,STACEY'S HANDS OF CHAMPIONS BTY CLG     ,UT,84405-0000,Proprietary  ,10,18,28,46,121,167
02531800,VON CURTIS ACADEMY OF HAIR DESIGN       ,UT,84606-0000,Proprietary  ,161,187,348,859,892,1751
02556800,HAIRITAGE COLLEGE OF BEAUTY             ,UT,84117-7204,Proprietary  ,21,27,48,102,126,228
02557700,PREMIER HAIR ACADEMY                    ,UT,84120-3603,Proprietary  ,1,12,13,10,51,61
02572700,EVANS HAIRSTYLING COLLEGE               ,UT,84770-0000,Proprietary  ,2,7,9,18,32,50
02572800,VISTA COLLEGE                           ,UT,84015-0000,Proprietary  ,5,19,24,21,98,119
02572801,CERTIFIED CAREERS INSTITUTE             ,UT,84015-0000,Proprietary  ,3,21,24,23,139,162
02573100,EVANS HAIRSTYLING COLLEGE               ,UT,84720-0000,Proprietary  ,0,4,4,27,34,61
02612200,MARINELLO SCHOOL OF BEAUTY              ,UT,84604-1585,Proprietary  ,4,4,8,83,72,155
03030600,UTAH COLLEGE OF MASSAGE THERAPY         ,UT,84111-1606,Proprietary  ,50,95,145,415,607,1022
03030601,UTAH CLG OF MASSAGE THER-PROVO CMPS     ,UT,84042-0000,Proprietary  ,23,39,62,131,194,325
03082100,MYOTHERAPY COLLEGE OF UTAH              ,UT,84115-2522,Proprietary  ,6,15,21,21,89,110
03108200,ECHELON EDGE ACADEMY OF HAIR SKIN & NAIL,UT,84070-2004,Proprietary  ,4,13,17,21,54,75
03110400,HAIRITAGE HAIR ACADEMY                  ,UT,84770-5233,Proprietary  ,3,8,11,20,38,58
03339400,WESTERN GOVERNORS UNIVERSITY            ,UT,84107-2533,Private      ,72,2370,2442,363,15411,15774
03413300,MOUNTAINLAND APPLIED TECHNOLOGY COLLEGE ,UT,84058-5857,Public       ,4,26,30,56,179,235
03463300,CAREERS UNLIMITED                       ,UT,84058-0000,Proprietary  ,0,3,3,39,87,126
03617300,HEALING MOUNTAIN MASSAGE SCHOOL         ,UT,84111-3232,Proprietary  ,2,8,10,20,56,76
03829500,SKINWORKS SCHOOL OF ADVANCED SKINCARE   ,UT,84115-0000,Proprietary  ,5,5,10,24,66,90
03838300,OGDEN INSTITUTE OF MASSAGE THERAPY      ,UT,84403-0000,Proprietary  ,2,1,3,14,40,54
03902300,RENAISSANCE SCHOOL OF THERAPEUTIC MASSAG,UT,84010-2835,Proprietary  ,1,4,5,4,13,17
03909300,MAXIMUM STYLE TEC SCHOOL OF COSMETOLOGY ,UT,84323-4679,Proprietary  ,5,5,10,19,46,65
03921300,CAMEO COLLEGE OF ESSENTIAL BEAUTY       ,UT,84115-0000,Proprietary  ,13,43,56,93,234,327
04054300,SOUTHWEST APPLIED TECHNOLOGY COLLEGE    ,UT,84720-6608,Public       ,2,18,20,16,81,97
04072300,DALLAS ROBERTS ACADEMY OF HAIR DESIGN & ,UT,84604-1008,Proprietary  ,3,6,9,49,55,104
04118100,IMAGEWORKS ACADEMY OF HAIR DESIGN       ,UT,84660-1210,Proprietary  ,6,11,17,25,46,71
04121700,DIXIE APPLIED TECHNOLOGY COLLEGE        ,UT,84770-3025,Public       ,9,15,24,175,161,336
04145500,SKIN SCIENCE INSTITUTE (THE)            ,UT,84115-0000,Proprietary  ,5,12,17,5,12,17
00368200,BENNINGTON COLLEGE                      ,VT,05201-6001,Private      ,11,6,17,969,294,1263
00368300,CASTLETON STATE COLLEGE                 ,VT,05735-0000,Public       ,25,12,37,2698,381,3079
00368400,CHAMPLAIN COLLEGE                       ,VT,05401-3950,Private      ,21,46,67,3188,802,3990
00368402,WOODBURY COLLEGE                        ,VT,05602-0000,Private      ,0,1,1,9,182,191
00368500,COLLEGE OF ST JOSEPH                    ,VT,05701-3899,Private      ,2,15,17,185,233,418
00368600,GODDARD COLLEGE                         ,VT,05667-0000,Private      ,12,48,60,95,957,1052
00368700,GREEN MOUNTAIN COLLEGE                  ,VT,05764-1199,Private      ,14,12,26,1241,179,1420
00368800,JOHNSON STATE COLLEGE                   ,VT,05656-9898,Public       ,19,39,58,1448,941,2389
00368900,LYNDON STATE COLLEGE                    ,VT,05851-0919,Public       ,24,12,36,1633,310,1943
00369000,MARLBORO COLLEGE                        ,VT,05344-0300,Private      ,3,11,14,478,101,579
00369100,MIDDLEBURY COLLEGE                      ,VT,05753-0000,Private      ,28,11,39,3562,476,4038
00369106,MIDDLEBURY COLLEGE - BREAD LOAF SCHOOL O,VT,05753-0000,Private      ,0,2,2,0,3,3
00369200,NORWICH UNIVERSITY                      ,VT,05663-1035,Private      ,34,168,202,2603,1836,4439
00369300,SOUTHERN VERMONT COLLEGE                ,VT,05201-6002,Private      ,4,9,13,581,166,747
00369400,ST MICHAELS COLLEGE                     ,VT,05439-0001,Private      ,19,12,31,3392,201,3593
00369600,UNIVERSITY OF VERMONT                   ,VT,05405-0160,Public       ,129,63,192,15931,2666,18597
00369800,VERMONT TECHNICAL COLLEGE               ,VT,05061-0000,Public       ,23,11,34,1186,612,1798
00857500,SALON PROFESSIONAL ACADEMY (THE)        ,VT,05495-4001,Proprietary  ,3,11,14,64,66,130
00865800,O'BRIEN'S TRAINING CENTER               ,VT,05403-7747,Proprietary  ,1,6,7,24,41,65
00886000,SIT                                     ,VT,05301-4801,Private      ,0,13,13,18,562,580
01116700,COMMUNITY COLLEGE OF VERMONT            ,VT,05676-1552,Public       ,96,289,385,1547,3640,5187
01193400,VERMONT LAW SCHOOL                      ,VT,05068-0000,Private      ,0,5,5,1,1057,1058
01218300,BURLINGTON COLLEGE                      ,VT,05401-8477,Private      ,3,2,5,137,128,265
02143500,STERLING COLLEGE                        ,VT,05827-0000,Private      ,0,1,1,140,28,168
02254000,NEW ENGLAND CULINARY INSTITUTE          ,VT,05602-0000,Proprietary  ,14,23,37,530,362,892
02532600,LANDMARK COLLEGE                        ,VT,05346-0000,Private      ,22,0,22,384,39,423
03708300,BURLINGTON TECHNICAL CENTER             ,VT,05401-2721,Public       ,0,0,0,7,9,16
00392800,CASPER COLLEGE                          ,WY,82601-4612,Public       ,51,77,128,1160,1177,2337
00392900,EASTERN WYOMING COLLEGE                 ,WY,82240-1603,Public       ,8,25,33,381,306,687
00393000,SHERIDAN COLLEGE                        ,WY,82801-9133,Public       ,32,53,85,729,744,1473
00393100,NORTHWEST COLLEGE                       ,WY,82435-1895,Public       ,28,34,62,796,538,1334
00393200,UNIVERSITY OF WYOMING                   ,WY,82071-3663,Public       ,135,148,283,5948,4068,10016
00393300,WESTERN WYOMING COMMUNITY COLLEGE       ,WY,82902-0000,Public       ,33,57,90,721,797,1518
00728900,CENTRAL WYOMING COLLEGE                 ,WY,82501-0000,Public       ,31,61,92,478,665,1143
00915700,WYOMING TECHNICAL INSTITUTE             ,WY,82072-9519,Proprietary  ,126,103,229,4017,1736,5753
00925900,LARAMIE COUNTY COMMUNITY CLG            ,WY,82007-3299,Public       ,51,136,187,1129,1740,2869
02211900,CHEEKS INTERNATIONAL ACDMY              ,WY,82001-0000,Proprietary  ,16,34,50,73,169,242
03291300,BUSINESS SKILLS INSTITUTE A DEPARTMENT O,WY,82930-0000,Public       ,0,0,0,3,5,8
00393500,UNIV OF GUAM                            ,GU,96923-0000,Public       ,144,102,246,1808,1365,3173
01536100,GUAM COMMUNITY COLLEGE                  ,GU,96921-0000,Public       ,70,96,166,848,1089,1937
03438300,PACIFIC ISLANDS BIBLE COLLEGE           ,GU,96913-2619,Private      ,12,10,22,127,75,202
00393600,PONTIFICAL CATHOLIC UNIV OF PR          ,PR,00717-0777,Private      ,91,276,367,5174,4868,10042
00393700,UNIVERSITY OF THE SACRED HEART          ,PR,00914-0383,Private      ,99,178,277,3262,2101,5363
00393800,INTER-AMER UNIV PR-CNTRL ADMN           ,PR,00936-0000,Private      ,120,418,538,3683,6859,10542
00393801,INTER-AMER UNIV PR SCHL LAW             ,PR,00936-8351,Private      ,0,1,1,17,344,361
00393802,INTER AMERICAN UNIVERSITY OF PUERTO RICO,PR,00926-0000,Private      ,12,50,62,67,232,299
00393803,INTER AMERICAN UNIVERSITY OF PR         ,PR,00683-0000,Private      ,85,153,238,3832,2240,6072
00393804,INTER-AMER UNIV PR-RECINTO AGUADILA     ,PR,00605-2000,Private      ,88,199,287,2578,2559,5137
00393805,INTER-AMER UNIV PR-ARECIBO CAMPUS       ,PR,00614-4050,Private      ,72,202,274,2924,2660,5584
00393806,INTER-AMER UNIV PR-BARRANQUITAS REG     ,PR,00794-0517,Private      ,110,97,207,1583,1190,2773
00393807,INTER-AMER UNIV PR-FAJARDO REGIONAL     ,PR,00738-0000,Private      ,36,88,124,1280,1239,2519
00393808,INTER-AMER UNIV PR - GUAYAMA CAMPUS     ,PR,00785-4004,Private      ,37,118,155,1172,1488,2660
00393809,INTER-AMER UNIV PR-PONCE REGIONAL       ,PR,00715-0000,Private      ,71,255,326,3529,3586,7115
00393810,INTER-AMER UNIV PR - SCH OF OPTOMETRY   ,PR,00918-0000,Private      ,0,0,0,5,59,64
00393811,INTER-AMER UNIV PR-BAYAMON REG CLG      ,PR,00959-0000,Private      ,81,134,215,4240,1994,6234
00394100,COLEGIO UNIVERSITARIO DEL ESTE          ,PR,00983-0000,Private      ,221,890,1111,5754,8836,14590
00394200,UNIVERSITY OF PR-CENTRAL ADMINISTRATION ,PR,00936-4984,Public       ,5,7,12,741,378,1119
00394201,UNIVERSITY OF PR-RIO PIEDRAS CAMPUS     ,PR,00931-3300,Public       ,114,158,272,8860,2724,11584
00394202,UNIV OF PUERTO RICO-MAYAGUEZ CAMPUS     ,PR,00681-5000,Public       ,126,90,216,9132,1662,10794
00394203,"UNIVERSITY OF PR, MED. SCIENCES CAMPUS  ",PR,00936-5067,Public       ,3,32,35,496,1363,1859
00394204,"UNIVERSITY OF PUERTO RICO, CAYEY CAMPUS ",PR,00736-0000,Public       ,12,21,33,3001,571,3572
00394205,"UNIVERSITY OF PR, HUMACAO CAMPUS        ",PR,00791-4057,Public       ,39,20,59,3534,626,4160
00394206,UNIVERSITY OF PR-AGUADILLA CAMPUS       ,PR,00604-6150,Public       ,20,14,34,2584,527,3111
00394207,UNIVERSITY OF PUERTO RICO-ARECIBO CAMPUS,PR,00614-0000,Public       ,32,24,56,3698,543,4241
00394208,UNIVERSITY OF PUERTO RICO-BAYAMON CAMPUS,PR,00959-0000,Public       ,33,28,61,3842,575,4417
00394209,UNIVERSITY OF PUERTO RICO-CAROLINA      ,PR,00984-4800,Public       ,28,33,61,3202,544,3746
00394210,UNIVERSITY OF PUERTO RICO-PONCE         ,PR,00732-0000,Public       ,11,19,30,3043,447,3490
00394211,"UNIVERSITY OF PR, UTUADO CAMPUS         ",PR,00641-0000,Public       ,10,9,19,1488,270,1758
00501900,UNIV ADVENTISTA DE LAS ANTILLAS         ,PR,00681-0118,Private      ,14,26,40,549,362,911
00502200,BAYAMON CENTRAL UNIVERSITY              ,PR,00960-0000,Private      ,21,101,122,960,1297,2257
00890200,COLUMBIA CENTRO UNIVERSITARIO           ,PR,00726-0000,Proprietary  ,56,166,222,664,1248,1912
01056700,COLEGIO TECNOLOGICO DE SAN JUAN         ,PR,00918-2973,Public       ,49,114,163,617,852,1469
01072400,CARLOS ALBIZU UNIVERSITY                ,PR,00902-3711,Private      ,3,22,25,91,732,823
01081900,CONSERVATORIO DE MUSICA DE PUERTO RICO  ,PR,00907-3373,Public       ,0,6,6,267,90,357
01120300,RYDER MEMORIAL HOSP SCH OF NURSING      ,PR,00792-0000,Private      ,0,2,2,14,24,38
01171900,UNIVERSIDAD DEL TURABO                  ,PR,00778-0000,Private      ,217,1039,1256,7208,11160,18368
01194000,ICPR JUNIOR COLLEGE                     ,PR,00919-0000,Proprietary  ,163,345,508,938,1334,2272
01194100,AMERICAN UNIVERSITY OF PUERTO RICO      ,PR,00960-2037,Private      ,45,67,112,944,810,1754
01194101,AMERICAN UNIVERSITY OF PUERTO RICO      ,PR,00674-0000,Private      ,49,84,133,759,774,1533
01252500,CARIBBEAN UNIVERSITY                    ,PR,00960-0493,Private      ,162,317,479,2349,3510,5859
01314800,RAMIREZ COLLEGE OF BUS & TECH           ,PR,00918-0000,Proprietary  ,43,80,123,272,553,825
02063100,MBTI BUSINESS TRNG INSTITUTE            ,PR,00907-3917,Proprietary  ,68,178,246,340,742,1082
02100000,POLYTECHNIC UNIVERSITY OF PR            ,PR,00917-0000,Private      ,75,191,266,3143,2305,5448
02163300,UNIVERSIDAD CENTRAL DEL CARIBE          ,PR,00960-0000,Private      ,1,3,4,137,445,582
02165100,EDP COLLEGE OF PUERTO RICO              ,PR,00919-0000,Proprietary  ,61,203,264,818,1588,2406
02166400,INSTITUTO DE BANCA Y COMERCIO           ,PR,00925-0000,Proprietary  ,994,1868,2862,9218,11725,20943
02170300,INST EDUC TECNIA OCUP LA REINA          ,PR,00674-0000,Proprietary  ,69,135,204,349,457,806
02170301,INST EDUC TECNICA OCUPLA LA REINA       ,PR,00603-0000,Proprietary  ,0,0,0,2,0,2
02189100,CENTRO DE ESTUDIOS MULTIDISCIPLIN       ,PR,00926-0000,Private      ,114,202,316,1174,1592,2766
02189300,EMMA'S BEAUTY ACADEMY                   ,PR,00680-0000,Proprietary  ,20,33,53,237,247,484
02195400,MODERN HAIRSTYLING INSTITUTE            ,PR,00960-0000,Proprietary  ,72,140,212,552,550,1102
02195500,MODERN HAIRSTYLING INSTITUTE            ,PR,00612-0000,Proprietary  ,0,1,1,6,1,7
02195800,LICEO E ARTE Y TECNOLGIA                ,PR,00919-0000,Private      ,65,92,157,793,646,1439
02195900,MODERN HAIRSTYLING INSTITUTE            ,PR,00980-0000,Proprietary  ,0,0,0,6,5,11
02234900,ANTILLES SCHOOL OF TECH CAREERS         ,PR,00909-0000,Proprietary  ,15,51,66,132,233,365
02241901,COMMONWEALTH OF PR DEPT OF EDUC - CARLOS,PR,00986-0000,Public       ,2,4,6,37,44,81
02241902,COMMONWEALTH OF PR DEPT OF EDUC - TOMAS ,PR,00613-0000,Public       ,1,0,1,13,17,30
02241904,COMMONWEALTH OF PR DEPT OF EDUC - ITPR R,PR,00655-0000,Public       ,16,21,37,539,276,815
02241905,COMMONWEALTH OF PR DEPT OF EDUC - JOSE A,PR,00674-0000,Public       ,0,0,0,568,137,705
02241907,COMMONWEALTH OF PR DEPT OF EDUC - ITPR R,PR,00928-0000,Public       ,15,7,22,505,206,711
02241908,COMMONWEALTH OF PR DEPT OF EDUC - ITPR R,PR,00732-0000,Public       ,3,5,8,550,248,798
02241909,COMMONWEALTH OF PR DEPT OF EDUC - TROQUE,PR,00959-0000,Public       ,0,1,1,36,6,42
02241910,COMMONWEALTH OF PR DEPT OF EDUC - ITPR R,PR,00701-1091,Public       ,5,5,10,425,139,564
02260600,NATIONAL COLLEGE OF BUSINESS & TECH     ,PR,00960-2036,Proprietary  ,236,546,782,3714,4816,8530
02260601,NATIONAL COLLEGE OF BUSINESS & TECHNOLOG,PR,00612-0000,Proprietary  ,1,4,5,52,29,81
02260602,NATIONAL COLLEGE OF BUSINESS & TECHNOLOG,PR,00745-9903,Proprietary  ,1,1,2,20,14,34
02260800,HUERTAS JUNIOR COLLEGE                  ,PR,00726-0000,Proprietary  ,78,163,241,1129,1429,2558
02297700,AUTOMECA TECHNICAL COLLEGE              ,PR,00957-0000,Proprietary  ,113,126,239,1203,765,1968
02303800,AMERICAN EDUCATIONAL COLLEGE            ,PR,00961-0000,Proprietary  ,79,116,195,548,830,1378
02335500,COLEGIO BIBLICO PENTECOSTAL DE PR       ,PR,00978-0000,Private      ,2,12,14,18,150,168
02340600,HUMACAO COMMUNITY COLLEGE               ,PR,00792-0000,Private      ,28,68,96,392,499,891
02343600,INSTITUTE OF BEAUTY CAREERS             ,PR,00613-0000,Proprietary  ,37,99,136,357,522,879
02482400,PONCE SCHOOL OF MEDICINE                ,PR,00716-2347,Private      ,0,22,22,17,634,651
02502400,SERBIA'S SCHOOL OF BEAUTY CULTURE       ,PR,00785-0000,Proprietary  ,35,60,95,224,265,489
02504500,INSTITUCION CHAVIANO DE MAYAGUEZ        ,PR,00708-0000,Proprietary  ,10,39,49,29,183,212
02505400,ATLANTIC COLLEGE                        ,PR,00970-0000,Private      ,43,38,81,924,493,1417
02534900,PONCE PARAMEDICAL COLLEGE (POPAC)       ,PR,00731-0000,Proprietary  ,166,219,385,2092,1696,3788
02549700,ACADEMIA MAISON D'ESTHETIQUE            ,PR,00907-0000,Proprietary  ,10,31,41,144,304,448
02552300,COLEGIO MAYOR DE TECHNOLOGIA            ,PR,00714-0000,Proprietary  ,33,52,85,285,354,639
02562500,INTERNATIONAL TECHNICAL COLLEGE         ,PR,00918-0000,Proprietary  ,12,38,50,61,144,205
02563500,ROGIES SCHOOL OF BEAUTY CULTURE         ,PR,00910-0000,Proprietary  ,30,56,86,145,191,336
02566800,PUERTO RICO TECH JUNIOR COLLEGE         ,PR,00917-0000,Proprietary  ,0,0,0,4,2,6
02569400,ESCUELA DE ARTES PLASTICAS              ,PR,00902-1112,Public       ,5,10,15,333,165,498
02570400,EDUCATIONAL TECHNICAL COLLEGE           ,PR,00925-3404,Proprietary  ,55,206,261,515,966,1481
02576100,ESCUELA TECNICA DE ELECTRICIDAD         ,PR,00731-0000,Proprietary  ,31,66,97,380,419,799
02587500,UNIVERSIDAD METROPOLITANA               ,PR,00928-1150,Private      ,204,1008,1212,4984,9076,14060
02588600,SEMINARIO EVANGELICO DE PUERTO RICO     ,PR,00925-0000,Private      ,0,4,4,1,39,40
02593700,HISPANIC AMERICAN COLLEGE               ,PR,00725-0000,Proprietary  ,18,50,68,147,207,354
02611100,INSTITUTO MERLIX                        ,PR,00961-0000,Proprietary  ,19,41,60,75,194,269
03021900,EDIC COLLEGE                            ,PR,00726-0000,Proprietary  ,50,144,194,660,970,1630
03025500,MECH TECH COLLEGE                       ,PR,00725-6118,Proprietary  ,233,263,496,2548,1253,3801
03025900,"LICEO DE ARTE, DISENOS Y COMERCIO       ",PR,00726-0000,Proprietary  ,22,67,89,344,526,870
03029700,"UNIVERSAL TECHNOLOGY CLG OF PR, INC     ",PR,00605-1955,Private      ,73,182,255,799,1479,2278
03061900,COLEGIO TECHNOLOGICO Y COMERCIAL        ,PR,00602-0000,Proprietary  ,1,9,10,24,68,92
03068400,STAR BEAUTY ACADEMY                     ,PR,00961-6312,Proprietary  ,12,24,36,55,90,145
03070500,D'MART INSTITUTE                        ,PR,00794-3517,Proprietary  ,98,189,287,939,1107,2046
03075600,EMMA'S BEAUTY ACADEMY                   ,PR,00795-0000,Proprietary  ,32,54,86,299,274,573
03076000,PUERTO RICO BARBER COLLEGE              ,PR,00738-4632,Proprietary  ,10,41,51,32,95,127
03085700,PROFESSIONAL TECHNICAL INSTITUTION      ,PR,00960-7061,Proprietary  ,21,28,49,287,211,498
03104400,PROFESSIONAL ELECTRIC SCHOOL            ,PR,00674-1797,Proprietary  ,2,3,5,74,75,149
03106900,ESCUELA DE PERITOS ELECTRICITAS         ,PR,00662-0457,Proprietary  ,1,10,11,30,69,99
03112100,JOHN DEWEY COLLEGE                      ,PR,00915-9538,Private      ,355,799,1154,2391,4597,6988
03112101,JOHN DEWEY COLLEGE                      ,PR,00986-0000,Private      ,75,124,199,625,799,1424
03112102,JOHN DEWEY COLLEGE-BAYAMON CAMPUS       ,PR,00959-0000,Private      ,83,154,237,405,650,1055
03112104,JOHN DEWEY COLLEGE - YABUCOA LRNING SITE,PR,00767-0767,Private      ,24,50,74,126,279,405
03112105,JOHN DEWEY COLLEGE - FAJARDO BRANCH     ,PR,00738-0738,Private      ,44,81,125,186,277,463
03112106,JOHN DEWEY COLLEGE - ARROYO BRANCH      ,PR,00714-0714,Private      ,9,22,31,144,267,411
03112107,JOHN DEWEY COLLEGE - JUANA DIAZ BRANCH  ,PR,00795-0000,Private      ,24,47,71,261,393,654
03115900,TRINITY COLLEGE OF PUERTO RICO          ,PR,00734-0000,Private      ,10,27,37,100,179,279
03122500,ACADEMIA SERRANT INC.                   ,PR,00717-1568,Proprietary  ,18,60,78,117,265,382
03123100,GLOBELLE TECHNICAL INSTITUTE            ,PR,00693-4218,Proprietary  ,3,10,13,54,73,127
03124200,NOVA COLLEGE DE PUERTO RICO             ,PR,00960-4016,Proprietary  ,17,52,69,98,334,432
03157600,"COLEGIO DE CINEMATOGRAFIA, ARTES Y TELEV",PR,00961-6345,Proprietary  ,47,47,94,355,185,540
03177300,SAN JUAN BAUTISTA SCH OF MEDICINE       ,PR,00726-0000,Private      ,0,1,1,2,285,287
03326300,UNIVERSAL CAREER COMMUNITY COLLEGE      ,PR,00907-0000,Proprietary  ,70,164,234,455,735,1190
03336300,CENTURY COLLEGE                         ,PR,00603-4802,Proprietary  ,12,25,37,110,162,272
03414300,MONTECLARO                              ,PR,00745-9612,Private      ,1,0,1,8,0,8
03452300,INSTITUTO PRE-VOCACIONAL E INDUSTRI     ,PR,00613-1800,Private      ,5,20,25,46,123,169
03469300,IVAEM COLLEGE                           ,PR,00725-0000,Proprietary  ,4,5,9,130,74,204
03531300,COLEGIO PENTECOSTAL MIZPA               ,PR,00928-0966,Private      ,0,25,25,13,232,245
03544300,ATENAS COLLEGE                          ,PR,00674-0000,Private      ,49,170,219,698,1166,1864
03552300,LESTON COLLEGE                          ,PR,00961-6309,Proprietary  ,24,37,61,80,165,245
03608300,CARIBBEAN FORENSIC & TECHNICAL COLL     ,PR,00926-0000,Proprietary  ,7,20,27,52,104,156
03638300,ROSSLYN TRAINING ACADEMY OF COSMETOLOGY ,PR,00602-3225,Proprietary  ,0,11,11,5,27,32
03735400,"CHARLIES GUARD,DETECTIVE BUREAU&ACA     ",PR,00605-0000,Proprietary  ,9,18,27,76,149,225
03751300,ESCUELA HOTELERA DE SAN JUAN            ,PR,00917-0091,Proprietary  ,26,32,58,409,263,672
03758300,BAYAMON COMMUNITY COLLEGE               ,PR,00960-0000,Proprietary  ,10,45,55,75,224,299
03781400,INDUSTRIAL TECHNICAL COLLEGE            ,PR,00792-0000,Proprietary  ,12,23,35,114,174,288
03785300,J.G. GUAYNABO TECHNICAL COLLEGE         ,PR,00960-0000,Proprietary  ,8,15,23,22,53,75
03800300,COLEGIO TECNICO DE ELECTRICIDAD GALLOSA ,PR,00602-0000,Proprietary  ,1,16,17,27,62,89
03800400,INSTITUTE OF BEAUTY OCCUPATIONS AND TECH,PR,00676-5071,Proprietary  ,17,34,51,65,128,193
03843300,ADVANCED TECH COLLEGE                   ,PR,00961-6321,Proprietary  ,10,45,55,30,165,195
03849300,AGUADILLA TECHNICAL COLLEGE             ,PR,00603-0000,Proprietary  ,0,9,9,16,46,62
03965400,MYRANGEL BEAUTY INSTITUTE               ,PR,00754-3917,Proprietary  ,18,47,65,64,136,200
04030300,ASPIRA  DE PUERTO RICO                  ,PR,00987-0000,Private      ,0,4,4,1,20,21
04107300,CARIB TECHNOLOGICAL INSTITUTE           ,PR,00960-0000,Proprietary  ,10,17,27,47,83,130
04117200,INSTITUTO EDUCATIVO PREMIER             ,PR,00731-0000,Proprietary  ,5,20,25,34,99,133
00394600,UNIVERSITY OF THE VIRGIN ISLANDS        ,VI,00802-6000,Public       ,27,29,56,938,700,1638
00394601,UNIV OF THE VIRGIN ISLANDS-ST CROIX     ,VI,00850-0000,Public       ,13,16,29,419,434,853
00667400,CANADIAN THEOLOGICAL SEMINARY           ,CN,00000-0000,Private      ,0,0,0,2,0,2
00667700,MCGILL UNIVERSITY                       ,CN,00000-0000,Public       ,25,10,35,1758,371,2129
00667900,QUEEN'S UNIVERSITY AT KINGSTON          ,CN,00000-0000,Public       ,2,0,2,115,27,142
00668100,ST FRANCIS XAVIER UNIVERSITY            ,CN,00000-0000,Public       ,1,1,2,36,10,46
00668200,ST THOMAS UNIVERSITY                    ,CN,00000-0000,Public       ,0,0,0,14,2,16
00668300,UNIVERSITY OF GUELPH                    ,CN,00000-0000,Public       ,0,0,0,35,50,85
00668400,UNIVERSITY OF MANITOBA                  ,CN,00000-0000,Public       ,0,0,0,18,21,39
00668500,UNIVERSITY OF NEW BRUNSWICK (THE)       ,CN,00000-0000,Public       ,0,0,0,14,20,34
00668600,UNIVERSITY OF OTTAWA                    ,CN,00000-0000,Public       ,0,0,0,37,25,62
00668800,UNIVERSITY OF TORONTO                   ,CN,00000-0000,Public       ,6,10,16,269,393,662
00668900,UNIVERSITY OF WINDSOR                   ,CN,00000-0000,Public       ,0,2,2,19,59,78
00683700,UNIVERSITE LAVAL                        ,CN,00000-0000,Public       ,0,1,1,5,17,22
00683800,DALHOUSIE UNIVERSITY                    ,CN,00000-0000,Public       ,2,1,3,122,63,185
00685200,BISHOP'S UNIVERSITY                     ,CN,00000-0000,Private      ,0,0,0,27,1,28
00685300,MCMASTER UNIVERSITY                     ,CN,00000-0000,Public       ,0,1,1,14,24,38
00767900,YORK UNIVERSITY                         ,CN,00000-0000,Public       ,1,2,3,95,104,199
00787400,UNIVERSITY AT CALGARY (THE)             ,CN,00000-0000,Public       ,0,3,3,16,47,63
00814800,UNIVERSITY OF WINNIPEG                  ,CN,00000-0000,Public       ,1,0,1,7,5,12
00836200,UNIVERSITY OF ALBERTA (THE)             ,CN,00000-0000,Public       ,0,2,2,23,44,67
00836300,MOUNT SAINT VINCENT UNIVERSITY          ,CN,00000-0000,Private      ,0,0,0,5,5,10
00836400,SAINT MARY'S UNIVERSITY                 ,CN,00000-0000,Public       ,0,0,0,29,8,37
00836500,CONCORDIA UNIVERSITY - SIR GEORGE W     ,CN,00000-0000,Public       ,2,3,5,245,144,389
00836600,UNIVERSITE DE MONTREAL                  ,CN,00000-0000,Public       ,1,1,2,11,37,48
00836800,CARLETON UNIVERSITY                     ,CN,00000-0000,Public       ,0,2,2,46,35,81
00836900,UNIVERSITY OF BRITISH COLUMBIA          ,CN,00000-0000,Public       ,11,15,26,676,447,1123
00837000,"SAFA, UNIVERSITY OF VICTORIA            ",CN,00000-0000,Public       ,2,1,3,97,57,154
00844400,SIMON FRASER UNIVERSITY                 ,CN,00000-0000,Public       ,2,7,9,72,108,180
00844600,UNIVERSITY OF WESTERN ONTARIO (THE)     ,CN,00000-0000,Public       ,1,0,1,38,42,80
00844800,UNIVERSITY OF REGINA                    ,CN,00000-0000,Public       ,0,0,0,5,11,16
00844900,ACADIA UNIVERSITY                       ,CN,00000-0000,Public       ,2,2,4,58,10,68
00852600,UNIVERSITY OF WATERLOO                  ,CN,00000-0000,Public       ,0,0,0,37,15,52
00858200,WILFRID LAURIER UNIVERSITY              ,CN,00000-0000,Public       ,0,1,1,9,7,16
00891300,LAKEHEAD UNIVERSITY                     ,CN,00000-0000,Public       ,0,0,0,3,3,6
00911900,UNIVERSITE DE MONCTON                   ,CN,00000-0000,Public       ,0,0,0,0,1,1
00918000,LAURENTIAN UNIVERSITY OF SUDBURY        ,CN,00000-0000,Public       ,0,0,0,0,2,2
00925200,BROCK UNIVERSITY                        ,CN,00000-0000,Public       ,1,0,1,15,11,26
00936700,UNIVERSITY OF PRINCE EDWARD ISLAND      ,CN,00000-0000,Public       ,0,0,0,11,97,108
00942100,BRANDON UNIVERSITY                      ,CN,00000-0000,Public       ,2,0,2,7,6,13
00948600,TRINITY WESTERN UNIVERSITY              ,CN,00000-0000,Private      ,5,2,7,325,52,377
00950000,MEMORIAL UNIVERSITY OF NEWFOUNDLAND     ,CN,00000-0000,Public       ,0,0,0,4,4,8
00950100,UNIVERSITY OF KING'S COLLEGE            ,CN,00000-0000,Public       ,0,0,0,21,1,22
00950300,MOUNT ALLISON UNIVERSITY                ,CN,00000-0000,Public       ,0,0,0,33,2,35
00950500,TRENT UNIVERSITY                        ,CN,00000-0000,Public       ,0,1,1,12,7,19
00969700,LETHBRIDGE COLLEGE                      ,CN,00000-0000,Public       ,0,1,1,8,3,11
00969800,MEDICINE HAT COLLEGE                    ,CN,00000-0000,Public       ,0,1,1,1,6,7
00970100,SENECA COLG OF APPLIED ARTS & TECH      ,CN,00000-0000,Public       ,0,0,0,17,10,27
01012300,NOVA SCOTIA COLLEGE OF ART & DESIGN     ,CN,00000-0000,Public       ,1,0,1,11,17,28
01022100,SAINT PAUL UNIVERSITY                   ,CN,00000-0000,Public       ,0,0,0,2,3,5
01045800,SHERIDAN COLLEGE OF APPLIED ARTS AN     ,CN,00000-0000,Public       ,0,1,1,15,12,27
01067500,REGENT COLLEGE                          ,CN,00000-0000,Private      ,1,4,5,3,120,123
01070300,UNIVERSITY OF LETHBRIDGE                ,CN,00000-0000,Public       ,0,1,1,6,4,10
01072000,RYERSON UNIVERSITY                      ,CN,00000-0000,Public       ,2,3,5,54,62,116
01172200,BRIERCREST BIBLE COLLEGE                ,CN,00000-0000,Private      ,0,0,0,17,11,28
01221100,ALGONQUIN CLG OF APPLIED ARTS &TECH     ,CN,00000-0000,Public       ,0,0,0,5,8,13
01222800,HUMBER COLLEGE                          ,CN,00000-0000,Public       ,0,1,1,10,16,26
01227400,PROVIDENCE COLLEGE                      ,CN,00000-0000,Private      ,0,1,1,14,6,20
02102100,BETHANY BIBLE COLLEGE                   ,CN,00000-0000,Private      ,1,1,2,73,27,100
02167000,PRAIRIE BIBLE INST                      ,CN,00000-0000,Private      ,1,1,2,31,15,46
02184600,INSTITUTE FOR CHRISTIAN STUDIES         ,CN,00000-0000,Private      ,0,0,0,0,5,5
02195600,LASALLE COLLEGE                         ,CN,00000-0000,Private      ,0,0,0,8,19,27
02195700,TAYLOR UNIVERSITY COLLEGE AND SEMINARY  ,CN,00000-0000,Private      ,1,0,1,7,1,8
02201100,COLUMBIA BIBLE COLLEGE                  ,CN,00000-0000,Private      ,1,0,1,25,4,29
02209700,UNIVERSITE DU QUEBEC (UNIVERSITY OF     ,CN,00000-0000,Public       ,0,0,0,1,6,7
02216400,TYNDALE COLLEGE & SEMINARY              ,CN,00000-0000,Private      ,1,1,2,4,9,13
02219000,ST. LAWRENCE COLLEGE                    ,CN,00000-0000,Public       ,0,0,0,5,2,7
02219200,UNIVERSITY OF SASKATCHEWAN              ,CN,00000-0000,Public       ,0,0,0,7,13,20
02338800,EMILY CARR UNIVERSITY OF ART AND DESIGN ,CN,00000-0000,Public       ,3,0,3,62,27,89
02354700,RED DEER COLLEGE                        ,CN,00000-0000,Public       ,0,1,1,2,2,4
02577200,SALVATION ARMY WM & CATHERINE BOOTH     ,CN,00000-0000,Private      ,0,0,0,1,1,2
02592600,NEW BRUNSWICK COMMUNITY COLLEGE         ,CN,00000-0000,Public       ,0,0,0,2,0,2
02593800,CONCORDIA UNIVERSITY COLLEGE            ,CN,00000-0000,Private      ,0,1,1,4,4,8
02611900,THE KING'S UNIVERSITY COLLEGE           ,CN,00000-0000,Private      ,0,1,1,3,2,5
03018300,ROCKY MOUNTAIN COLLEGE: CENTRE FOR      ,CN,00000-0000,Private      ,0,1,1,3,1,4
03033200,SAINT PHILIP'S SEMINARY                 ,CN,00000-0000,Private      ,0,0,0,0,1,1
03033800,UNIVERSITY COLLEGE OF CAPE BRETON       ,CN,00000-0000,Public       ,0,0,0,4,3,7
03078300,VANCOUVER SCHOOL OF THEOLOGY            ,CN,00000-0000,Private      ,0,0,0,1,4,5
03273300,CANADIAN COLLEGE OF NATUROPATHIC ME     ,CN,00000-0000,Private      ,0,1,1,1,25,26
03298300,ALBERTA COLLEGE OF ART & DESIGN         ,CN,00000-0000,Public       ,0,0,0,22,10,32
03332500,KWANTLEN UNIVERSITY COLLEGE             ,CN,00000-0000,Public       ,0,1,1,4,8,12
03335400,CANADIAN UNIVERSITY COLLEGE             ,CN,00000-0000,Private      ,1,1,2,36,3,39
03339300,ST. STEPHENS UNIVERSITY                 ,CN,00000-0000,Private      ,0,0,0,6,2,8
03348500,REDEEMER UNIVERSITY COLLEGE             ,CN,00000-0000,Private      ,0,0,0,10,2,12
03408300,CANDIAN NAZARENE UNIVERSITY COLLEGE     ,CN,00000-0000,Private      ,0,0,0,4,3,7
03420300,HOLLAND COLLEGE                         ,CN,00000-0000,Public       ,0,0,0,1,1,2
03421300,LOYALIST COLLEGE OF APPLIED ARTS &      ,CN,00000-0000,Public       ,0,0,0,4,0,4
03435400,ROYAL ROADS UNIVERSITY                  ,CN,00000-0000,Public       ,0,0,0,1,1,2
03465300,NIPISSING UNIVERSITY                    ,CN,00000-0000,Public       ,0,0,0,1,1,2
03511300,CN CLG ACUPUNCTURE & ORIENTAL MED       ,CN,00000-0000,Private      ,0,1,1,0,10,10
03551300,INTERNATIONAL BIBLE COLLEGE             ,CN,00000-0000,Private      ,0,0,0,2,2,4
03560400,NIAGARA COLLEGE-WELLAND CAMPUS          ,CN,00000-0000,Public       ,0,0,0,5,5,10
03613300,UNIV OF NORTHERN BRITISH COLUMBIA       ,CN,00000-0000,Public       ,0,0,0,8,2,10
03644400,CANADIAN MENNONITE UNIVERSITY           ,CN,00000-0000,Private      ,0,0,0,10,2,12
03674400,CANADIAN SOUTHERN BAPTIST SEMINARY      ,CN,00000-0000,Private      ,0,1,1,0,3,3
03711300,CAPILANO UNIVERSITY                     ,CN,00000-0000,Public       ,2,1,3,10,12,22
03745300,BRITISH COLUMBIA INSTITUTE OF TECHNOLOGY,CN,00000-0000,Public       ,1,0,1,5,7,12
03846300,PACIFIC LIFE BIBLE COLLEGE              ,CN,00000-0000,Private      ,1,0,1,8,3,11
03847300,ATLANTIC BAPTIST UNIVERSITY             ,CN,00000-0000,Private      ,0,1,1,7,2,9
00814700,UNIVERSIDAD AUTONOMA DE GUADALAJARA     ,MX,00000-0000,Private      ,0,23,23,52,1121,1173
01041800,INST TEC Y DE ESTSUPER DE MONTERRE      ,MX,00000-0000,Private      ,2,0,2,75,50,125
01067600,UNIVERSIDAD DE MONTERREY                ,MX,00000-0000,Private      ,2,1,3,21,32,53
01093800,UNIVERSIDAD DE GUANAJUATO               ,MX,00000-0000,Public       ,0,1,1,13,17,30
01097600,INSTITUTO ALLENDE                       ,MX,00000-0000,Private      ,0,1,1,4,7,11
02053300,CENTRO DE ESTUDIOS UNIVERSITARIOS D     ,MX,00000-0000,Private      ,13,10,23,162,216,378
02283100,UNIVERSIDAD TECNOLOGICA DE MEXICO       ,MX,00000-0000,Proprietary  ,0,0,0,17,27,44
01001000,AMERICAN SAMOA CMNTY COLLEGE            ,AS,96799-2609,Public       ,147,56,203,1506,343,1849
01034300,COLLEGE OF MICRONESIA - FSM             ,FM,96941-0159,Public       ,174,138,312,2169,736,2905
01100900,PALAU COMMUNITY COLLEGE                 ,PW,96940-0009,Public       ,71,29,100,774,320,1094
03022400,COLLEGE OF THE MARSHALL ISLANDS         ,MH,96960-1258,Public       ,84,45,129,693,339,1032
03033000,NORTHERN MARIANAS COLLEGE               ,MP,96950-0000,Public       ,50,52,102,386,320,706
