OPE ID,School,State,Zip Code,School Type,20082009Qtr6_Dependent Students,20082009Qtr6_Independent Students,Quarterly Total,YTD_20082009Qtr6_Dependent Students,YTD_20082009Qtr6_Independent Students,Award Year To Date Total
00100200,ALABAMA AGRCLTL & MECHL UNIV            ,AL,35762-1357,Public       ,34,60,94,5395,2896,8291
00100300,FAULKNER UNIVERSITY                     ,AL,36109-3398,Private      ,8,94,102,1374,3542,4916
00100400,UNIVERSITY OF MONTEVALLO                ,AL,35115-6000,Public       ,5,23,28,1840,1135,2975
00100500,ALABAMA STATE UNIVERSITY                ,AL,36101-0000,Public       ,66,100,166,7764,4310,12074
00100700,CENTRAL ALABAMA COMMUNITY COLLEGE       ,AL,35011-0000,Public       ,39,155,194,1094,1919,3013
00100800,ATHENS STATE UNIVERSITY                 ,AL,35611-1999,Public       ,12,83,95,577,2706,3283
00100900,AUBURN UNIVERSITY                       ,AL,36849-5113,Public       ,123,100,223,13566,4954,18520
00101200,BIRMINGHAM SOUTHERN COLLEGE             ,AL,35254-0002,Private      ,5,4,9,1603,280,1883
00101300,CALHOUN COMMUNITY COLLEGE               ,AL,35609-2216,Public       ,92,303,395,3720,6028,9748
00101500,ENTERPRISE-OZARK COMMUNITY COLLEGE      ,AL,36331-1300,Public       ,31,94,125,1050,1573,2623
00101600,UNIVERSITY OF NORTH ALABAMA             ,AL,35632-0001,Public       ,37,53,90,3697,2263,5960
00101700,GADSDEN STATE COMMUNITY COLLEGE         ,AL,35903-2269,Public       ,77,286,363,2532,4667,7199
00101800,GEORGE C WALLACE COMMUNITY COLLEGE      ,AL,36303-0943,Public       ,56,184,240,1585,3311,4896
00101900,HUNTINGDON COLLEGE                      ,AL,36106-2148,Private      ,7,11,18,1056,459,1515
00102000,JACKSONVILLE STATE UNIVERSITY           ,AL,36265-1602,Public       ,38,104,142,5620,4737,10357
00102100,JEFFERSON DAVIS COMMUNITY COLLEGE       ,AL,36427-2790,Public       ,36,47,83,518,848,1366
00102200,JEFFERSON STATE COMMUNITY COLLEGE       ,AL,35215-3098,Public       ,65,272,337,3140,5971,9111
00102300,JUDSON COLLEGE                          ,AL,36756-2504,Private      ,0,4,4,305,121,426
00102400,UNIVERSITY OF WEST ALABAMA              ,AL,35470-0000,Public       ,15,204,219,1730,4475,6205
00102600,MARION MILITARY INSTITUTE               ,AL,36756-3214,Public       ,2,0,2,473,45,518
00102800,MILES COLLEGE                           ,AL,35064-2697,Private      ,20,25,45,2313,1284,3597
00102900,UNIVERSITY OF MOBILE                    ,AL,36663-0220,Private      ,5,36,41,1280,1502,2782
00103000,BISHOP STATE COMMUNITY COLLEGE          ,AL,36603-5898,Public       ,49,247,296,1481,3648,5129
00103001,BISHOP STATE COMM COLG-CARVER CMPS      ,AL,36617-0000,Public       ,10,25,35,134,300,434
00103002,BISHOP STAT COMM CLG-SW CMPS            ,AL,36605-0000,Public       ,3,12,15,77,158,235
00103100,NORTHEAST ALABAMA STATE CMNTY COLG      ,AL,35986-0159,Public       ,42,192,234,1137,1976,3113
00103300,OAKWOOD COLLEGE                         ,AL,35896-0001,Private      ,3,6,9,1762,651,2413
00103400,ALABAMA SOUTHERN COMMUNITY COLLEGE      ,AL,36460-5698,Public       ,44,78,122,892,1096,1988
00103600,SAMFORD UNIVERSITY                      ,AL,35229-7000,Private      ,7,48,55,2657,2373,5030
00103700,SELMA UNIVERSITY                        ,AL,36701-0000,Private      ,0,0,0,0,1,1
00103800,SNEAD STATE COMMUNITY COLLEGE           ,AL,35957-0734,Public       ,17,64,81,918,1614,2532
00104000,SOUTHERN UNION STATE COMMUNITY CLG      ,AL,36276-0000,Public       ,32,150,182,2448,2661,5109
00104100,SPRING HILL COLLEGE                     ,AL,36608-1791,Private      ,3,13,16,1660,514,2174
00104400,STILLMAN COLLEGE                        ,AL,35403-1430,Private      ,15,9,24,2039,432,2471
00104600,TALLADEGA COLLEGE                       ,AL,35160-2354,Private      ,3,9,12,547,266,813
00104700,TROY STATE UNIVERSITY                   ,AL,36082-0001,Public       ,84,792,876,6851,22614,29465
00105000,TUSKEGEE UNIVERSITY                     ,AL,36088-1645,Private      ,28,12,40,4680,1020,5700
00105100,UNIVERSITY OF ALABAMA (THE)             ,AL,35487-0120,Public       ,100,198,298,14379,7432,21811
00105200,UNIVERSITY OF ALABAMA AT BIRMINGHAM     ,AL,35294-1150,Public       ,54,177,231,6939,8690,15629
00105500,UNIVERSITY OF ALABAMA IN HUNTSVILLE     ,AL,35899-0001,Public       ,27,69,96,3698,3127,6825
00105700,UNIVERSITY OF SOUTH ALABAMA             ,AL,36688-0002,Public       ,82,215,297,6173,8067,14240
00105900,LAWSON STATE COMMUNITY COLLEGE          ,AL,35221-1798,Public       ,61,220,281,2055,3527,5582
00105901,LAWSON STATE COMMUNITY COLLEGE - BESSEME,AL,35021-0308,Public       ,3,37,40,359,773,1132
00106000,FAULKNER STATE COMMUNITY COLLEGE        ,AL,36507-2698,Public       ,53,128,181,2038,2514,4552
00526000,J.F. DRAKE STATE TECH COLLEGE           ,AL,35811-1584,Public       ,23,96,119,395,1309,1704
00569100,SHELTON STATE COMMUNITY CLG             ,AL,35405-4017,Public       ,109,175,284,3207,3160,6367
00569200,REID STATE TECHNICAL COLLEGE            ,AL,36401-0000,Public       ,25,67,92,317,668,985
00569700,NORTHWEST- SHOALS COMMUNITY COLLEGE     ,AL,35661-0000,Public       ,112,137,249,1938,2268,4206
00569702,NORTHWEST-SHOALS C.C.-PHIL CAMPBELL     ,AL,35581-0000,Public       ,14,9,23,218,195,413
00569900,GEORGE C WALLACE STATE CMTY COLLEGE     ,AL,36703-0000,Public       ,68,102,170,1101,1775,2876
00573300,BEVILL STATE CMTY COLLEGE-WALKER        ,AL,35148-0000,Public       ,44,166,210,1172,2170,3342
00573301,BEVILL STATE COMMUNITY COLLEGE - FAYETTE,AL,35555-0000,Public       ,9,20,29,422,589,1011
00573302,BEVILL STATE CMTY CLG-HAMILTON CAMP     ,AL,35570-0000,Public       ,6,20,26,160,312,472
00573305,BEVILL STATE CMTY CLG-WALKER CLG        ,AL,35501-0000,Public       ,7,15,22,318,441,759
00573400,H. COUNCILL TRENHOLM STATE TECH COLLEGE ,AL,36108-0020,Public       ,35,177,212,610,1706,2316
00573401,H. C. TRENHOLM ST TECH COL-PATTERSON CAM,AL,36116-2612,Public       ,10,32,42,259,562,821
00787100,GEORGE C WALLACE STATE CMTY CLG         ,AL,35077-2000,Public       ,90,224,314,2573,3828,6401
00831000,AUBURN UNIVERSITY-MONTGOMERY            ,AL,36124-0000,Public       ,39,119,158,2810,3853,6663
00898800,LURLEEN B WALLACE COMMUNITY COLLEGE     ,AL,36420-0418,Public       ,38,97,135,764,1216,1980
01019300,HERZING COLLEGE                         ,AL,35209-4816,Proprietary  ,6,42,48,147,875,1022
01055400,CONCORDIA COLLEGE                       ,AL,36701-3323,Private      ,7,7,14,520,431,951
01218200,CHATTAHOOCHEE VALLEY CMTY CLG           ,AL,36869-7917,Public       ,25,93,118,727,1639,2366
01303906,SOUTH UNIVERSITY - MONTGOMERY           ,AL,36116-1120,Proprietary  ,12,40,52,290,1101,1391
02170600,UNITED STATES SPORTS ACADEMY            ,AL,36526-7055,Private      ,0,32,32,31,876,907
02199700,HERITAGE CHRISTIAN UNIVERSITY           ,AL,35630-0000,Private      ,0,1,1,14,66,80
02270400,SOUTHEASTERN BIBLE COLLEGE              ,AL,35244-2083,Private      ,0,1,1,103,161,264
02296000,PRINCE INSTITUTE OF PROFESSIONAL STUDIES,AL,36117-0000,Proprietary  ,0,3,3,25,146,171
02341000,FORTIS COLLEGE                          ,AL,36609-0000,Proprietary  ,37,89,126,434,1180,1614
02341002,CAPPS COLLEGE - MONTGOMERY              ,AL,36109-3624,Proprietary  ,1,7,8,30,135,165
02341004,FORTIS COLLEGE - SCHOOL OF COSMETOLOGY  ,AL,36609-1981,Proprietary  ,3,2,5,20,48,68
02503400,AMRIDGE UNIVERSITY                      ,AL,36124-0000,Private      ,1,21,22,30,838,868
02605500,REMINGTON COLLEGE - MOBILE CAMPUS       ,AL,36609-5593,Proprietary  ,40,257,297,536,2379,2915
03010600,VIRGINIA COLLEGE                        ,AL,35209-5154,Proprietary  ,174,1931,2105,2202,20394,22596
03010602,VIRGINIA COLLEGE - HUNTSVILLE           ,AL,35805-0000,Proprietary  ,14,90,104,180,807,987
03010605,VA COLG TECHNICAL AT PELHAM             ,AL,35124-0000,Proprietary  ,0,0,0,2,7,9
03010607,VIRGINIA COLLEGE - MOBILE               ,AL,36606-4748,Proprietary  ,0,28,28,53,358,411
03010616,VIRGINIA COLLEGE - MONTGOMERY           ,AL,36117-2802,Proprietary  ,8,33,41,123,553,676
03032500,ALABAMA STATE CLG BARBER STYLING        ,AL,35215-8308,Proprietary  ,0,3,3,24,57,81
03361400,FORTIS COLLEGE                          ,AL,36535-3547,Proprietary  ,3,20,23,63,362,425
03459300,SOUTHEASTERN SCHOOL OF COSMETOLOGY      ,AL,35228-0000,Private      ,3,25,28,38,230,268
03783300,BLUE CLIFF CAREER COLLEGE               ,AL,63306-4749,Proprietary  ,1,16,17,69,259,328
03894300,HUNTSVILLE BIBLE COLLEGE                ,AL,35811-0000,Private      ,0,1,1,6,55,61
04067300,SELMA UNIVERSITY                        ,AL,36701-0000,Private      ,1,9,10,20,127,147
04116500,MIMI'S BEAUTY ACADEMY OF COSMETOLOGY    ,AL,35810-3453,Proprietary  ,0,3,3,12,47,59
04121500,COLUMBIA SOUTHERN UNIVERSITY            ,AL,36561-3815,Proprietary  ,5,183,188,96,2607,2703
04125200,TONI LOVE'S COSMETOLOGY TRAINING CENTER ,AL,35474-0005,Proprietary  ,0,0,0,2,18,20
04149200,XCELL ACADEMY-A PAUL MITCHELL PARTNER SC,AL,35216-4990,Proprietary  ,14,20,34,14,21,35
00111100,ALLAN HANCOCK COLLEGE                   ,CA,93454-6399,Public       ,25,49,74,2866,3651,6517
00111300,ANTELOPE VALLEY COLLEGE                 ,CA,93536-5426,Public       ,120,382,502,4468,8000,12468
00111600,ART CENTER COLLEGE OF DESIGN            ,CA,91103-1999,Private      ,5,6,11,1223,1240,2463
00111700,AZUSA PACIFIC UNIVERSITY                ,CA,91702-7000,Private      ,25,121,146,5958,6029,11987
00111800,BAKERSFIELD COLLEGE                     ,CA,93305-1299,Public       ,95,338,433,7091,8652,15743
00111900,BARSTOW COMMUNITY COLLEGE               ,CA,92311-6608,Public       ,27,193,220,597,2957,3554
00112000,AMER BAPT SEM OF THE WEST-BERKELEY      ,CA,94704-0000,Private      ,0,0,0,2,53,55
00112100,BETHANY UNIVERSITY /  ASSEMBLIES OF GOD ,CA,95066-2896,Private      ,1,1,2,432,346,778
00112200,BIOLA UNIVERSITY                        ,CA,90639-0001,Private      ,8,24,32,4713,2023,6736
00112300,BROOKS INSTITUTE                        ,CA,93103-1809,Proprietary  ,5,20,25,1429,777,2206
00112400,CABRILLO COLLEGE                        ,CA,95003-3194,Public       ,48,93,141,3146,4261,7407
00112500,CALIFORNIA BAPTIST UNIVERSITY           ,CA,92504-3297,Private      ,7,56,63,3249,2506,5755
00112700,CALIFORNIA COLLEGE OF THE ARTS          ,CA,94107-2206,Private      ,3,7,10,1569,1364,2933
00113100,CALIFORNIA INSTITUTE OF TECHNOLOGY      ,CA,91125-0001,Private      ,3,5,8,2535,381,2916
00113200,CALIFORNIA INSTITUTE OF THE ARTS        ,CA,91355-2397,Private      ,2,0,2,1478,1211,2689
00113300,CALIFORNIA LUTHERAN UNIVERSITY          ,CA,91360-2787,Private      ,1,36,37,2686,1454,4140
00113400,CALIFORNIA MARITIME ACADEMY             ,CA,94590-8181,Public       ,1,1,2,619,216,835
00113700,CALIF STATE UNIV-FULLERTON              ,CA,92831-3599,Public       ,90,90,180,31218,14651,45869
00113800,"CALIFORNIA STATE UNIVERSITY, EAST BAY   ",CA,94542-3000,Public       ,20,92,112,7909,8921,16830
00113900,CALIF STATE UNIV-LONG BEACH             ,CA,90840-0006,Public       ,49,59,108,36484,16656,53140
00114000,CALIF STATE UNIV-LOS ANGELES            ,CA,90032-4226,Public       ,54,108,162,20495,15602,36097
00114100,"CALIF STATE UNIV, DOMINGUEZ HILLS       ",CA,90747-0001,Public       ,75,111,186,9827,9741,19568
00114200,CALIF STATE UNIV SAN BERNARDINO         ,CA,92407-2397,Public       ,27,91,118,13363,11513,24876
00114300,CAL POLY STATE UNIVERSITY               ,CA,93407-0001,Public       ,74,25,99,25201,3491,28692
00114400,CALIF STATE POLYTECHNIC UNIV POMONA     ,CA,91768-2500,Public       ,66,59,125,20923,7323,28246
00114600,CALIF STATE UNIV - CHICO                ,CA,95929-0001,Public       ,22,29,51,13822,5648,19470
00114700,CALIF STATE UNIV - FRESNO               ,CA,93740-8026,Public       ,19,55,74,17295,10104,27399
00114900,HUMBOLDT STATE UNIVERSITY               ,CA,95521-8299,Public       ,19,21,40,8416,3841,12257
00115000,CALIF STATE UNIV-SACRAMENTO             ,CA,95819-6044,Public       ,36,80,116,20400,14902,35302
00115100,SAN DIEGO STATE UNIVERSITY              ,CA,92182-1690,Public       ,71,89,160,37757,15107,52864
00115300,CALIF STATE UNIV-NORTHRIDGE             ,CA,91330-8307,Public       ,39,97,136,27109,16130,43239
00115400,SAN FRANCISCO STATE UNIVERSITY          ,CA,94132-1740,Public       ,91,120,211,26156,16248,42404
00115500,SAN JOSE STATE UNIVERSITY               ,CA,95192-0036,Public       ,31,58,89,22675,13869,36544
00115600,SONOMA STATE UNIVERSITY                 ,CA,94928-3609,Public       ,6,22,28,8032,3060,11092
00115700,CALIF STATE UNIV-STANISLAUS             ,CA,95382-0299,Public       ,7,35,42,6438,5073,11511
00115800,UNITED STATES INTERNATIONAL UNIV        ,CA,92131-1799,Private      ,0,0,0,5,135,140
00116100,CERRITOS COLLEGE                        ,CA,90650-6296,Public       ,139,247,386,9393,8040,17433
00116200,CHABOT COLLEGE                          ,CA,94545-2400,Public       ,40,162,202,3598,4910,8508
00116300,CHAFFEY COLLEGE                         ,CA,91737-9400,Public       ,60,155,215,7371,9578,16949
00116400,CHAPMAN UNIVERSITY                      ,CA,92866-1099,Private      ,19,239,258,5914,9108,15022
00116453,CHAPMAN UNIVERSITY SCHOOL OF LAW        ,CA,92866-0000,Private      ,0,2,2,122,1878,2000
00116500,CHURCH DIV SCH OF THE PACIFIC           ,CA,94709-0000,Private      ,0,0,0,0,72,72
00116600,CITRUS COLLEGE                          ,CA,91741-1899,Public       ,88,131,219,5099,4278,9377
00116900,CLAREMONT GRADUATE UNIVERSITY           ,CA,91711-0000,Private      ,0,22,22,14,1762,1776
00117000,CLAREMONT MCKENNA COLLEGE               ,CA,91711-6400,Private      ,2,0,2,2636,87,2723
00117100,HARVEY MUDD COLLEGE                     ,CA,91711-5990,Private      ,1,0,1,1792,24,1816
00117200,PITZER COLLEGE                          ,CA,91711-6101,Private      ,1,0,1,2594,131,2725
00117300,POMONA COLLEGE                          ,CA,91711-6301,Private      ,1,0,1,3969,80,4049
00117400,SCRIPPS COLLEGE                         ,CA,91711-3948,Private      ,0,0,0,1495,43,1538
00117600,WEST HILLS COMMUNITY COLLEGE            ,CA,93210-1399,Public       ,6,18,24,1166,1328,2494
00117700,COGSWELL POLYTECHNICAL COLLEGE          ,CA,94089-1210,Private      ,1,4,5,141,63,204
00117800,COLLEGE OF MARIN                        ,CA,94904-2590,Public       ,6,22,28,653,1594,2247
00117801,COLG OF MARIN-INDIAN VALLEY CMPS        ,CA,94949-0000,Public       ,0,1,1,20,74,94
00117900,NOTRE DAME DE NAMUR UNIVERSITY          ,CA,94002-1997,Private      ,4,8,12,799,809,1608
00118100,COLLEGE OF SAN MATEO                    ,CA,94402-3784,Public       ,28,62,90,1599,1864,3463
00118200,COLLEGE OF THE DESERT                   ,CA,92260-9305,Public       ,29,75,104,3094,3456,6550
00118300,HOLY NAMES UNIVERSITY                   ,CA,94619-1699,Private      ,2,6,8,606,689,1295
00118500,COLLEGE OF THE REDWOODS                 ,CA,95501-9300,Public       ,24,73,97,2291,3880,6171
00118600,COLLEGE OF THE SEQUOIAS                 ,CA,93277-2234,Public       ,81,168,249,4740,6208,10948
00118700,COLLEGE OF THE SISKIYOUS                ,CA,96094-2899,Public       ,10,42,52,882,1093,1975
00118701,COLLEGE OF THE SISKIYOUS - YREKA CENTER ,CA,96097-9538,Public       ,1,4,5,41,95,136
00119000,CONTRA COSTA COLLEGE                    ,CA,94806-3195,Public       ,26,88,114,1524,2735,4259
00119100,DIABLO VALLEY COLLEGE                   ,CA,94523-1544,Public       ,50,82,132,3417,3554,6971
00119200,CUESTA COLLEGE                          ,CA,93403-8106,Public       ,25,83,108,2953,2947,5900
00119300,CYPRESS COLLEGE                         ,CA,90630-5897,Public       ,44,91,135,4340,4942,9282
00119600,DOMINICAN UNIVERSITY OF CALIFORNIA      ,CA,94901-2298,Private      ,0,5,5,2131,1159,3290
00119700,EL CAMINO COLLEGE                       ,CA,90506-0002,Public       ,118,207,325,7603,7561,15164
00119701,COMPTON COMMUNITY COLLEGE               ,CA,90221-5393,Public       ,37,129,166,1158,2900,4058
00119900,FOOTHILL COLLEGE                        ,CA,94022-4597,Public       ,25,85,110,1451,2315,3766
00120000,FULLER THEOLOGICAL SEMINARY             ,CA,91182-0000,Private      ,0,16,16,7,2066,2073
00120100,FULLERTON COLLEGE                       ,CA,92832-2095,Public       ,89,110,199,6753,5017,11770
00120200,GAVILAN COLLEGE                         ,CA,95020-9599,Public       ,38,56,94,1293,1655,2948
00120300,GLENDALE COMMUNITY COLLEGE              ,CA,91208-2894,Public       ,67,118,185,5793,5706,11499
00120400,GOLDEN GATE BAPT THEOL SEMINARY         ,CA,94941-0000,Private      ,0,0,0,1,55,56
00120500,GOLDEN GATE UNIVERSITY                  ,CA,94105-2967,Private      ,2,86,88,76,3486,3562
00120600,GOLDEN WEST COLLEGE                     ,CA,92647-2748,Public       ,34,70,104,4649,4481,9130
00120700,GRADUATE THEOLOGICAL UNION              ,CA,94709-0000,Private      ,0,0,0,1,354,355
00120800,GROSSMONT COLLEGE                       ,CA,92020-1798,Public       ,63,135,198,5181,5895,11076
00120900,HARTNELL COMMUNITY COLLEGE              ,CA,93901-1697,Public       ,57,101,158,2371,2490,4861
00121200,HUMPHREYS COLLEGE                       ,CA,95207-3896,Private      ,4,8,12,200,953,1153
00121400,IMPERIAL VALLEY COLLEGE                 ,CA,92251-9787,Public       ,49,67,116,3926,3562,7488
00121500,LA SIERRA UNIVERSITY                    ,CA,92515-3332,Private      ,10,7,17,1669,783,2452
00121600,UNIVERSITY OF LA VERNE                  ,CA,91750-4443,Private      ,11,112,123,2391,6330,8721
00121700,LASSEN COLLEGE                          ,CA,96130-3000,Public       ,4,27,31,390,733,1123
00121800,LOMA LINDA UNIVERSITY                   ,CA,92350-0001,Private      ,3,15,18,736,4537,5273
00121900,LONG BEACH CITY COLLEGE                 ,CA,90808-1780,Public       ,104,339,443,9220,11703,20923
00122000,MASTER'S COLLEGE & SEMINARY (THE)       ,CA,91321-1200,Private      ,2,5,7,1038,352,1390
00122300,LOS ANGELES CITY COLLEGE                ,CA,90029-3588,Public       ,66,215,281,4602,8381,12983
00122400,LOS ANGELES HARBOR COLLEGE              ,CA,90744-2397,Public       ,21,75,96,2330,3350,5680
00122600,LOS ANGELES PIERCE COLLEGE              ,CA,91371-0001,Public       ,69,100,169,6183,5292,11475
00122700,LOS ANGELES TRADE TECH COLLEGE          ,CA,90015-4181,Public       ,47,164,211,3128,6866,9994
00122800,LOS ANGELES VALLEY COLLEGE              ,CA,91401-4096,Public       ,42,93,135,4695,5774,10469
00122900,SO CA UNIV  HEALTH SCIENCES             ,CA,90604-4051,Private      ,2,25,27,24,551,575
00123000,SOUTHERN CA COLLEGE OF OPTOMETRY        ,CA,92831-1699,Private      ,0,0,0,13,460,473
00123200,AMERICAN RIVER COLLEGE                  ,CA,95841-4286,Public       ,62,315,377,7816,14457,22273
00123300,SACRAMENTO CITY COLLEGE                 ,CA,95822-1386,Public       ,77,214,291,8134,10877,19011
00123600,MENLO COLLEGE                           ,CA,94027-4301,Private      ,2,2,4,755,156,911
00123700,MERCED COMMUNITY COLLEGE                ,CA,95348-2898,Public       ,31,64,95,4561,4842,9403
00123800,MILLS COLLEGE                           ,CA,94613-1301,Private      ,0,4,4,1383,1294,2677
00123900,MIRACOSTA COLLEGE                       ,CA,92056-3899,Public       ,21,59,80,1959,2961,4920
00124000,MODESTO JUNIOR COLLEGE                  ,CA,95350-5800,Public       ,81,325,406,7047,8979,16026
00124200,MONTEREY PENINSULA COLLEGE              ,CA,93940-4799,Public       ,18,54,72,1425,1826,3251
00124300,MOUNT ST MARYS COLLEGE                  ,CA,90049-1599,Private      ,2,23,25,1957,1656,3613
00124500,MT. SAN ANTONIO COLLEGE                 ,CA,91789-1399,Public       ,100,132,232,10817,8706,19523
00124600,MT SAN JACINTO COLLEGE                  ,CA,92583-2399,Public       ,85,270,355,4781,7806,12587
00124700,NAPA VALLEY COLLEGE                     ,CA,94558-6236,Public       ,16,45,61,1417,1939,3356
00124900,OCCIDENTAL COLLEGE                      ,CA,90041-3314,Private      ,2,0,2,4085,182,4267
00125000,ORANGE COAST COLLEGE - FIN AID OFF      ,CA,92628-5005,Public       ,51,101,152,7993,5945,13938
00125100,OTIS COLLEGE OF ART AND DESIGN          ,CA,90045-3505,Private      ,1,2,3,1457,575,2032
00125200,HOPE INTERNATIONAL UNIVERSITY           ,CA,92631-0000,Private      ,3,15,18,563,656,1219
00125300,FRESNO PACIFIC UNIVERSITY               ,CA,93702-4798,Private      ,4,69,73,1456,1927,3383
00125302,FRESNO PACIFIC UNIVERSITY - VISALIA CENT,CA,93277-8341,Private      ,0,6,6,32,219,251
00125303,FRESNO PACIFIC UNIVERSITY - BAKERSFIELD ,CA,93301-4533,Private      ,0,6,6,38,200,238
00125400,PACIFIC LUTHERAN THEOLOGICAL SEM        ,CA,94708-0000,Private      ,0,1,1,2,95,97
00125500,PACIFIC OAKS COLLEGE                    ,CA,91103-3592,Private      ,0,5,5,15,739,754
00125600,PACIFIC SCHOOL OF RELIGION              ,CA,94709-0000,Private      ,0,0,0,1,182,183
00125800,PACIFIC UNION COLLEGE                   ,CA,94508-9797,Private      ,5,3,8,1310,428,1738
00125900,PALO VERDE COLLEGE                      ,CA,92225-0000,Public       ,1,2,3,200,482,682
00126000,PALOMAR COLLEGE                         ,CA,92069-1486,Public       ,38,102,140,5163,5423,10586
00126100,PASADENA CITY COLLEGE                   ,CA,91106-2003,Public       ,75,149,224,11589,7804,19393
00126200,POINT LOMA NAZARENE UNIVERSITY          ,CA,92106-2899,Private      ,5,60,65,3146,1345,4491
00126600,LANEY COLLEGE                           ,CA,94607-4893,Public       ,37,160,197,2776,5825,8601
00126700,MERRITT COLLEGE                         ,CA,94619-3196,Public       ,14,84,98,1275,3307,4582
00126800,PORTERVILLE COLLEGE                     ,CA,93257-6059,Public       ,20,60,80,1503,2262,3765
00126900,RIO HONDO COLLEGE                       ,CA,90601-1699,Public       ,56,99,155,5622,4790,10412
00127000,RIVERSIDE COMMUNITY COLLEGE             ,CA,92506-1299,Public       ,176,497,673,14550,17972,32522
00127200,SAN BERNARDINO VALLEY COLLEGE           ,CA,92410-2798,Public       ,82,348,430,4391,8824,13215
00127300,SAN DIEGO CITY COLLEGE                  ,CA,92101-4787,Public       ,112,423,535,5291,9742,15033
00127500,SAN DIEGO MESA COLLEGE                  ,CA,92111-4996,Public       ,56,195,251,5980,6998,12978
00127800,SAN FRANCISCO CONSERVATORY OF MUSIC     ,CA,94122-4498,Private      ,1,2,3,250,328,578
00127900,SAN FRANCISCO THEOLOGICAL SEMINARY      ,CA,94960-0000,Private      ,0,4,4,0,89,89
00128000,SAN JOAQUIN DELTA COLLEGE               ,CA,95207-6370,Public       ,114,374,488,7400,10507,17907
00128100,WILLIAM JESSUP UNIVERSITY               ,CA,95765-3707,Private      ,2,7,9,461,288,749
00128200,SAN JOSE CITY COLLEGE                   ,CA,95128-2797,Public       ,22,122,144,2702,4367,7069
00128400,SANTA ANA COLLEGE                       ,CA,92706-3398,Public       ,55,105,160,4619,4702,9321
00128500,SANTA BARBARA CITY COLLEGE              ,CA,93109-2394,Public       ,118,119,237,4738,3560,8298
00128600,SANTA MONICA COLLEGE                    ,CA,90405-1644,Public       ,97,178,275,10092,6823,16915
00128700,SANTA ROSA JUNIOR COLLEGE               ,CA,95401-4395,Public       ,22,58,80,3821,5296,9117
00128800,CLAREMONT SCHOOL OF THEOLOGY            ,CA,91711-0000,Private      ,0,0,0,5,168,173
00128900,SHASTA COLLEGE                          ,CA,96049-7692,Public       ,40,134,174,3288,5008,8296
00129000,SIERRA COLLEGE                          ,CA,95677-3397,Public       ,70,172,242,4947,6370,11317
00129100,SIMPSON UNIVERSITY                      ,CA,96003-8606,Private      ,0,6,6,1127,820,1947
00129200,SOLANO COMMUNITY COLLEGE                ,CA,94534-3197,Public       ,20,84,104,2390,4660,7050
00129300,VANGUARD UNIVERSITY OF SOUTHERN CA      ,CA,92626-6597,Private      ,6,21,27,1962,911,2873
00129400,SOUTHWESTERN COLLEGE                    ,CA,91910-7299,Public       ,54,99,153,6737,5457,12194
00129500,SOUTHWESTERN LAW SCHOOL                 ,CA,90010-1106,Private      ,1,4,5,22,2600,2622
00129600,DOMINICAN SCH PHILOSOPHY & THEOLOGY     ,CA,94709-0000,Private      ,0,0,0,3,35,38
00129900,ST JOHN'S SEMINARY COLLEGE              ,CA,93010-0000,Private      ,0,0,0,0,2,2
00130200,SAINT MARY'S COLLEGE OF CALIFORNIA      ,CA,94556-2744,Private      ,4,25,29,3554,1339,4893
00130500,STANFORD UNIVERSITY                     ,CA,94305-6106,Private      ,16,28,44,17009,3237,20246
00130501,STANFORD UNIV SCHOOL OF MEDICINE        ,CA,94305-5404,Private      ,0,4,4,105,713,818
00130502,STANFORD UNIV GRAD SCH OF BUS           ,CA,94305-5015,Private      ,1,7,8,59,1047,1106
00130503,STANFORD UNIV LAW SCHOOL                ,CA,94305-8610,Private      ,0,1,1,49,2131,2180
00130700,FRESNO CITY COLLEGE                     ,CA,93741-0002,Public       ,106,375,481,11937,13971,25908
00130800,REEDLEY COLLEGE                         ,CA,93654-2099,Public       ,50,115,165,4744,4849,9593
00130900,TAFT COLLEGE                            ,CA,93268-2317,Public       ,7,37,44,712,943,1655
00131200,UNIVERSITY OF CALIFORNIA-BERKELEY       ,CA,94720-1520,Public       ,107,107,214,44681,17452,62133
00131300,UNIVERSITY OF CALIFORNIA-DAVIS          ,CA,95616-8558,Public       ,43,43,86,40465,12004,52469
00131400,UNIVERSITY OF CALIFORNIA-IRVINE         ,CA,92697-2825,Public       ,138,85,223,42057,8659,50716
00131500,UNIVERSITY OF CALIFORNIA (UCLA)         ,CA,90095-9000,Public       ,54,120,174,53928,23340,77268
00131502,UNIV OF CALIFORNIA LOS ANG SCH MED      ,CA,90095-0000,Public       ,0,2,2,183,786,969
00131503,UNIV OF CALIFORNIA LOS ANG DENTAL       ,CA,90095-0000,Public       ,1,2,3,32,126,158
00131600,UNIVERSITY OF CALIFORNIA-RIVERSIDE      ,CA,92521-0209,Public       ,37,26,63,25411,5894,31305
00131700,UNIVERSITY OF CALIFORNIA-SAN DIEGO      ,CA,92093-0013,Public       ,42,38,80,39515,7741,47256
00131900,UNIVERSITY OF CALIFORNIA-SFRANCISCO     ,CA,94143-0246,Public       ,2,8,10,626,3181,3807
00132000,UNIVERSITY OF CALIFORNIA-SANTA BARB     ,CA,93106-3180,Public       ,201,67,268,39534,5674,45208
00132100,UNIVERSITY OF CALIFORNIA-SANTA CRUZ     ,CA,95064-0001,Public       ,33,47,80,24980,3490,28470
00132200,UNIVERSITY OF REDLANDS                  ,CA,92373-0999,Private      ,3,88,91,3898,2496,6394
00132500,UNIVERSITY OF SAN FRANCISCO             ,CA,94117-1080,Private      ,10,109,119,7432,6931,14363
00132600,SANTA CLARA UNIVERSITY                  ,CA,95053-4956,Private      ,12,44,56,7472,4165,11637
00132800,UNIVERSITY OF SOUTHERN CALIFORNIA       ,CA,90089-0914,Private      ,35,92,127,27182,18767,45949
00132900,UNIVERSITY OF THE PACIFIC               ,CA,95211-0197,Private      ,6,10,16,5572,2626,8198
00132901,UNIV OF THE PACIFIC MCGEORGE LAW        ,CA,95817-0000,Private      ,0,3,3,12,2284,2296
00132902,UNIV OF THE PACIFIC SCH OF DENT         ,CA,94115-0000,Private      ,1,1,2,23,550,573
00133400,VENTURA COLLEGE                         ,CA,93003-3899,Public       ,49,101,150,4020,3360,7380
00133500,VICTOR VALLEY COLLEGE                   ,CA,92395-5849,Public       ,115,399,514,4464,8805,13269
00133800,WEST VALLEY COLLEGE                     ,CA,95070-5697,Public       ,41,74,115,1703,2105,3808
00134100,WESTMONT COLLEGE                        ,CA,93108-1099,Private      ,2,0,2,2106,53,2159
00134200,WHITTIER COLLEGE                        ,CA,90601-4413,Private      ,8,3,11,2127,326,2453
00134201,WHITTIER LAW SCHOOL                     ,CA,92626-0000,Private      ,0,3,3,7,1171,1178
00134300,WOODBURY UNIVERSITY                     ,CA,91510-7846,Private      ,5,19,24,1062,863,1925
00134400,YUBA COLLEGE                            ,CA,95901-7699,Public       ,166,188,354,3382,5502,8884
00177212,TRINITY INTERNATIONAL UNIV-CA           ,CA,92705-0000,Private      ,0,2,2,5,206,211
00274100,AMERICAN JEWISH UNIVERSITY              ,CA,90077-1599,Private      ,0,0,0,86,136,222
00301002,ANTIOCH UNIV/LOS ANGELES                ,CA,90230-7615,Private      ,0,12,12,26,929,955
00301003,ANTIOCH  UNIV/SANTA BARBARA             ,CA,93101-0000,Private      ,0,4,4,363,473,836
00369110,MONTEREY INST OF INTERNATL STUDIES      ,CA,93940-2691,Private      ,0,3,3,26,870,896
00394700,UC-HASTINGS COLLEGE OF THE LAW          ,CA,94102-0000,Public       ,0,2,2,13,3880,3893
00394800,SAN FRANCISCO ART INSTITUTE             ,CA,94133-2299,Private      ,6,7,13,1067,889,1956
00405500,HEBREW UNION COLLEGE - JEWISH INSTITUTE ,CA,90007-3796,Private      ,0,0,0,0,87,87
00408000,STARR KING SCHOOL FOR THE MINISTRY      ,CA,94709-1299,Private      ,0,2,2,1,69,70
00448000,DE ANZA COLLEGE                         ,CA,95014-5793,Public       ,82,138,220,5198,4224,9422
00448100,OHLONE COLLEGE                          ,CA,94539-5847,Public       ,40,53,93,1981,1890,3871
00448101,OHLONE COLLEGE - NEWARK CENTER FOR HEALT,CA,94560-4902,Public       ,1,4,5,2,4,6
00448400,JOHN F. KENNEDY UNIVERSITY              ,CA,94523-4817,Private      ,0,22,22,20,1645,1665
00449000,PATTEN UNIVERSITY                       ,CA,94601-2699,Private      ,3,31,34,237,458,695
00449400,EVEREST COLLEGE                         ,CA,92408-3752,Proprietary  ,61,161,222,474,1295,1769
00450200,CITY COLLEGE OF SAN FRANCISCO           ,CA,94112-0000,Public       ,102,378,480,7097,10278,17375
00563800,DOWNEY ADULT SCHOOL                     ,CA,90241-5610,Public       ,1,3,4,32,83,115
00565500,HACIENDA LA PUENTE ADULT EDUC CTR       ,CA,91746-0000,Public       ,7,46,53,117,561,678
00616500,LA CNTY CLG OF NURSING & ALLD HLTH      ,CA,90033-1018,Public       ,0,2,2,91,353,444
00672000,COLLEGE OF ALAMEDA                      ,CA,94501-2109,Public       ,18,59,77,1467,2067,3534
00673100,CASA LOMA COLLEGE                       ,CA,91405-4523,Private      ,10,26,36,245,540,785
00686300,VENTURA COUNTY CMTY CLG DISTRICT        ,CA,93010-8552,Public       ,0,1,1,27,23,50
00697300,CANADA COLLEGE                          ,CA,94061-1099,Public       ,13,37,50,548,1152,1700
00697500,LINCOLN UNIVERSITY                      ,CA,94612-2801,Private      ,0,4,4,12,57,69
00701200,SAMUEL MERRITT COLLEGE                  ,CA,94609-3108,Private      ,1,18,19,266,1987,2253
00704700,LOS ANGELES SOUTHWEST COLLEGE           ,CA,90047-4810,Public       ,24,110,134,1937,5253,7190
00705000,BAY VISTA COLLEGE OF BEAUTY             ,CA,91950-3616,Proprietary  ,8,27,35,95,201,296
00711500,MOORPARK COLLEGE                        ,CA,93021-1695,Public       ,47,72,119,2605,2152,4757
00713000,NEWBERRY SCHOOLS OF BEAUTY              ,CA,91344-7404,Proprietary  ,7,8,15,80,102,182
00714200,LYLE'S COLLEGE OF BEAUTY                ,CA,93710-3948,Proprietary  ,7,20,27,78,192,270
00714201,LYLE'S CLG OF BTY BAKERSFIELD           ,CA,93301-0000,Proprietary  ,0,1,1,42,43,85
00716400,BRYAN COLLEGE                           ,CA,90057-0000,Proprietary  ,5,70,75,111,820,931
00717801,WESTERN SEMINARY - BAY AREA CENTER      ,CA,95032-0000,Private      ,0,0,0,1,14,15
00717804,WESTERN SEMINARY - SACRAMENTO           ,CA,95821-3939,Private      ,0,0,0,10,45,55
00718700,NORTH ADRIAN'S COLLEGE OF BEAUTY        ,CA,95350-2381,Proprietary  ,15,16,31,135,215,350
00719000,WYOTECH                                 ,CA,94539-7663,Proprietary  ,33,95,128,933,1622,2555
00719001,WYOTECH - SIERRA CAMPUS                 ,CA,94621-4523,Proprietary  ,0,0,0,72,75,147
00720300,SALON SUCCESS ACADEMY                   ,CA,91786-4060,Proprietary  ,5,13,18,71,110,181
00720400,MODERN BEAUTY ACADEMY                   ,CA,93030-7016,Proprietary  ,1,4,5,39,53,92
00722900,WESTERN BEAUTY INSTITUTE                ,CA,91402-3104,Proprietary  ,17,56,73,230,744,974
00723400,HEALD COLLEGE                           ,CA,94105-2206,Proprietary  ,42,137,179,469,1237,1706
00723600,ART INST OF CALIFORNIA-LOS ANGELES      ,CA,90405-3035,Proprietary  ,73,120,193,5263,4057,9320
00725300,FEDERICO BEAUTY INSTITUTE               ,CA,95834-1905,Proprietary  ,5,20,25,156,247,403
00729600,COLEMAN COLLEGE                         ,CA,92123-0000,Private      ,7,41,48,174,655,829
00745600,MARINELLO SCH BTY BUENA PRK             ,CA,90620-0000,Proprietary  ,0,0,0,3,2,5
00746501,AMERICAN ACADEMY OF DRAMATIC ARTS - HOLL,CA,90028-7504,Private      ,2,2,4,187,84,271
00747600,MARINELLO SCHOOLS OF BEAUTY             ,CA,90023-2666,Proprietary  ,59,184,243,915,1988,2903
00747602,MARINELLO SCHOOLS OF BEAUTY - SPA ACADEM,CA,90048-5101,Proprietary  ,0,1,1,37,34,71
00747603,MARINELLO SCHOOLS OF BEAUTY - INGLEWOOD ,CA,90301-2306,Proprietary  ,1,1,2,19,22,41
00747604,MARINELLO SCHOOLS OF BEAUTY - RESEDA    ,CA,91335-4218,Proprietary  ,0,0,0,8,7,15
00747605,MARINELLO SCHOOLS OF BEAUTY - NORTH HOLL,CA,91606-3210,Proprietary  ,0,2,2,15,22,37
00747606,MARINELLO SCHOOLS OF BEAUTY - WEST COVIN,CA,91790-2805,Proprietary  ,0,0,0,17,16,33
00747607,MARINELLO SCHOOLS OF BEAUTY - SAN BERNAR,CA,92410-3261,Proprietary  ,1,0,1,27,41,68
00747608,MARINELLO SCHOOLS OF BEAUTY - ONTARIO   ,CA,91762-2113,Proprietary  ,1,1,2,31,60,91
00747609,MARINELLO SCHOOLS OF BEAUTY - WHITTIER  ,CA,90601-4107,Proprietary  ,0,1,1,16,9,25
00747611,MARINELLO SCHOOLS OF BEAUTY - SAN DIEGO ,CA,92126-4217,Proprietary  ,1,3,4,31,56,87
00747700,"HEALD COLLEGE,SCHOOLS OF BUS & TECH     ",CA,95670-6005,Proprietary  ,30,145,175,375,1424,1799
00753100,ACADEMY OF ART UNIVERSITY               ,CA,94105-3410,Proprietary  ,150,396,546,6060,9851,15911
00753600,COSUMNES RIVER COLLEGE                  ,CA,95823-5799,Public       ,23,86,109,4408,5166,9574
00754802,WESTWOOD COLLEGE OF TECHNOLOGY          ,CA,92801-0000,Proprietary  ,25,28,53,1108,696,1804
00754803,WESTWOOD COLLEGE OF TECHNOLOGY          ,CA,91786-0000,Proprietary  ,41,64,105,1086,929,2015
00760600,EVEREST COLLEGE                         ,CA,90010-2221,Proprietary  ,35,90,125,383,874,1257
00760700,CONCORDE CAREER INSTITUTE               ,CA,91606-3134,Proprietary  ,38,52,90,425,763,1188
00770700,COLUMBIA COLLEGE                        ,CA,95370-8580,Public       ,9,29,38,784,983,1767
00771300,SKYLINE COLLEGE                         ,CA,94066-1698,Public       ,32,63,95,1877,1878,3755
00793000,CONCORDE CAREER INSTITUTE               ,CA,92108-0000,Proprietary  ,26,97,123,348,1030,1378
00799300,CALIF STATE UNIV BAKERSFIELD            ,CA,93311-1022,Public       ,19,58,77,5650,5264,10914
00807100,CONCORDE CAREER INSTITUTE               ,CA,92840-9201,Proprietary  ,14,54,68,362,915,1277
00807300,BUTTE COMMUNITY COLLEGE                 ,CA,95965-0000,Public       ,34,107,141,4727,6166,10893
00809000,EVEREST COLLEGE                         ,CA,91803-1310,Proprietary  ,46,95,141,394,794,1188
00809300,HEALD COLLEGE                           ,CA,93704-1706,Proprietary  ,18,84,102,736,1781,2517
00853200,HEALD COLLEGE                           ,CA,94545-2352,Proprietary  ,61,155,216,773,1723,2496
00853700,CONCORDE CAREER INSTITUTE               ,CA,92401-0000,Proprietary  ,44,80,124,480,1213,1693
00859600,WEST LOS ANGELES COLLEGE                ,CA,90230-3500,Public       ,38,88,126,2001,4355,6356
00859700,FEATHER RIVER COLLEGE                   ,CA,95971-9124,Public       ,4,21,25,637,435,1072
00884400,CALIFORNIA CHRISTIAN COLLEGE            ,CA,93703-3599,Private      ,0,1,1,33,35,68
00884600,WRIGHT INSTITUTE                        ,CA,94704-0000,Private      ,0,4,4,0,442,442
00890300,COLLEGE OF THE CANYONS                  ,CA,91355-1899,Public       ,32,89,121,2921,2767,5688
00891800,SADDLEBACK COLLEGE                      ,CA,92692-3699,Public       ,32,106,138,2439,3272,5711
00902200,ASSOCIATED TECHNICAL COLLEGE            ,CA,90017-0000,Proprietary  ,30,104,134,185,780,965
00903200,EMPIRE COLLEGE                          ,CA,95403-2122,Proprietary  ,8,18,26,141,514,655
00915706,WYOMING TECHNICAL INSTITUTE - WEST SACRA,CA,95605-1507,Proprietary  ,22,63,85,377,675,1052
00927200,CRAFTON HILLS COLLEGE                   ,CA,92399-1799,Public       ,35,71,106,2044,2405,4449
00932500,ABRAM FRIEDMAN OCCUP CTR                ,CA,90015-3507,Public       ,0,2,2,33,67,100
00950900,SKILLS & BUSINESS EDUCATION CENTER      ,CA,95824-1529,Public       ,5,47,52,201,1514,1715
00974800,WESTERN CAREER COLLEGE                  ,CA,95826-3203,Proprietary  ,31,135,166,1066,2875,3941
00974801,WESTERN CAREER COLLEGE - SAN LEANDRO CAM,CA,94578-3711,Proprietary  ,31,78,109,397,930,1327
00974802,WESTERN CAREER COLLEGE - PLEASANT HILL C,CA,94523-1984,Proprietary  ,19,56,75,270,664,934
00974803,WESTERN CAREER COLLEGE - STOCKTON       ,CA,95207-5509,Proprietary  ,18,39,57,317,547,864
00974804,WESTERN CAREER COLLEGE - CITRUS HEIGHTS ,CA,95621-5577,Proprietary  ,15,55,70,352,930,1282
00974806,WESTERN CAREER COLLEGE -  ANTIOCH/WALNUT,CA,94531-1604,Proprietary  ,20,61,81,308,712,1020
00974807,WESTERN CAREER COLLEGE - SAN JOSE       ,CA,95119-1325,Proprietary  ,43,88,131,488,973,1461
00974808,WESTERN CAREER COLLEGE - EMERYVILLE     ,CA,94608-3006,Proprietary  ,12,55,67,61,175,236
00974809,WESTERN CAREER COLLEGE -  EMERYVILLE SHE,CA,94608-3006,Proprietary  ,0,0,0,92,249,341
00974810,WESTERN CAREER COLLEGE - CONCORD        ,CA,94520-5671,Proprietary  ,1,1,2,15,26,41
00998900,SANTA BARBARA BUSINESS COLLEGE          ,CA,93111-0000,Proprietary  ,13,39,52,260,603,863
01011100,CERRO-COSO COMMUNITY COLLEGE            ,CA,93555-9571,Public       ,15,65,80,598,1592,2190
01014225,TOURO CLG OSEOPATHIC MEDICINE           ,CA,94592-1115,Private      ,0,4,4,11,456,467
01014900,PEPPERDINE UNIVERSITY                   ,CA,90263-0000,Private      ,18,129,147,6157,6538,12695
01033300,JESUIT SCHOOL OF THEOLOGY - BERKELEY    ,CA,94709-1193,Private      ,0,0,0,0,47,47
01034000,LOS MEDANOS COLLEGE                     ,CA,94565-5197,Public       ,35,85,120,1919,3093,5012
01036500,CHARLES R DREW UNIV OF MED & SCI        ,CA,90059-0000,Private      ,0,2,2,60,461,521
01036800,MENNONITE BRETHREN BIBLICAL SEM         ,CA,93727-0000,Private      ,0,0,0,1,58,59
01037500,HARBOR OCCUPATIONAL CENTER              ,CA,90731-0000,Public       ,1,2,3,26,43,69
01039500,UNIVERSITY OF SAN DIEGO                 ,CA,92110-2492,Private      ,14,63,77,11912,3457,15369
01039501,UNIVERSITY OF SAN DIEGO - SCHOOL OF LAW ,CA,92110-2492,Private      ,0,12,12,112,3240,3352
01044100,PARDEE RAND GRADUATE SCHOOL             ,CA,90407-2138,Private      ,0,1,1,0,38,38
01047400,MARYMOUNT COLLEGE OF PALOS VERDES       ,CA,90275-0000,Private      ,1,0,1,587,65,652
01057900,WEST VALLEY OCCUPATIONAL CTR            ,CA,91367-0000,Public       ,0,1,1,51,85,136
01083100,NEW COLLEGE OF CALIFORNIA               ,CA,94102-0000,Private      ,0,0,0,13,146,159
01083200,WESTERN STATE UNIV COLLEGE OF LAW       ,CA,92831-3014,Proprietary  ,0,1,1,6,1006,1012
01085400,THOMAS JEFFERSON SCHOOL OF LAW          ,CA,92110-0000,Private      ,0,11,11,16,1953,1969
01102400,EVEREST COLLEGE                         ,CA,94103-2091,Proprietary  ,33,62,95,331,684,1015
01110700,EVEREST  COLLEGE                        ,CA,92801-5231,Proprietary  ,44,142,186,417,1072,1489
01110900,EVEREST COLLEGE                         ,CA,91335-4631,Proprietary  ,52,95,147,516,815,1331
01111200,FIDM-FASHION INSTITUTE OF DESIGN        ,CA,90015-1421,Proprietary  ,33,21,54,6062,2080,8142
01111700,ALLIANT INTERNATIONAL UNIVERSITY        ,CA,92131-1799,Private      ,3,24,27,84,2419,2503
01111705,ALLIANT INTERNATIONAL UNIVERSITY - LOS A,CA,91803-1360,Private      ,0,4,4,5,628,633
01111706,ALLIANT INTERNATIONAL UNIVERSITY - SAN F,CA,94133-1221,Private      ,0,5,5,7,661,668
01111707,ALLIANT INTERNATIONAL UNIVERSITY - FRESN,CA,93727-2014,Private      ,0,3,3,24,401,425
01112100,EVEREST COLLEGE                         ,CA,94541-4007,Proprietary  ,19,73,92,230,841,1071
01112300,EVEREST COLLEGE                         ,CA,90247-4163,Proprietary  ,25,123,148,350,1067,1417
01146000,NATIONAL UNIVERSITY                     ,CA,92037-1011,Private      ,13,925,938,414,15959,16373
01162600,PRACTICAL SCHOOLS                       ,CA,92805-0000,Proprietary  ,19,42,61,496,834,1330
01164900,LOYOLA MARYMOUNT UNIVERSITY             ,CA,90045-0000,Private      ,24,30,54,9241,3031,12272
01164901,LOYOLA LAW SCHOOL                       ,CA,90015-0000,Private      ,0,3,3,31,3546,3577
01167200,MENDOCINO COMMUNITY COLLEGE             ,CA,95482-3000,Public       ,13,35,48,936,1373,2309
01169600,NATIONAL POLYTECHNIC COLLEGE OF SCIENCE ,CA,90744-6399,Private      ,1,20,21,82,384,466
01170700,NORTH-WEST COLLEGE                      ,CA,91790-2097,Proprietary  ,32,83,115,259,572,831
01179200,FRANCISCAN SCHOOL OF THEOLOGY           ,CA,94709-0000,Private      ,0,0,0,1,31,32
01182000,SAN DIEGO MIRAMAR COLLEGE               ,CA,92126-0000,Public       ,25,105,130,2325,3420,5745
01186500,CALIFORNIA HAIR DESIGN ACADEMY          ,CA,92115-0000,Proprietary  ,8,11,19,78,125,203
01186600,LU ROSS ACADEMY                         ,CA,93001-2927,Proprietary  ,4,14,18,9,17,26
01202600,JE BOUTIQUE COLLEGE OF BEAUTY           ,CA,92021-6247,Proprietary  ,4,15,19,55,124,179
01202700,GALEN COLLEGE OF CALIFORNIA             ,CA,93728-2381,Proprietary  ,2,15,17,72,147,219
01203100,SAN DIEGO CHRISTIAN COLLEGE             ,CA,92019-1157,Private      ,0,2,2,470,190,660
01206100,EVEREST COLLEGE                         ,CA,95128-3908,Proprietary  ,21,68,89,213,624,837
01215400,CALIFORNIA INST OF INTEGRAL STUDIES     ,CA,94103-2557,Private      ,0,7,7,6,1205,1211
01231600,MANCHESTER BEAUTY COLLEGE               ,CA,93726-5306,Proprietary  ,6,24,30,89,226,315
01231700,TULARE BEAUTY COLLEGE                   ,CA,93274-3432,Proprietary  ,0,1,1,10,31,41
01244600,UNIVERSAL COLLEGE OF BEAUTY             ,CA,90044-0044,Proprietary  ,2,9,11,42,109,151
01245200,EVERGREEN VALLEY COLLEGE                ,CA,95135-1598,Public       ,23,51,74,3073,3105,6178
01255000,LOS ANGELES MISSION COLLEGE             ,CA,91342-3200,Public       ,26,65,91,2351,3081,5432
01265000,MARINELLO SCHOOL OF BEAUTY              ,CA,91502-2828,Proprietary  ,4,23,27,107,248,355
01265100,MARINELLO SCHOOL OF BEAUTY              ,CA,91748-1674,Proprietary  ,4,13,17,48,174,222
01284200,OXNARD COLLEGE                          ,CA,93030-0000,Public       ,37,121,158,2091,2774,4865
01287200,NORTH-WEST COLLEGE                      ,CA,91768-3199,Proprietary  ,13,31,44,171,505,676
01287300,WYOTECH                                 ,CA,90810-3800,Proprietary  ,125,253,378,1288,2404,3692
01287301,WYOTECH - EVEREST  COLLEGE              ,CA,90034-3158,Proprietary  ,24,103,127,256,897,1153
01287302,WYOTECH - EVEREST  COLLEGE              ,CA,91746-3412,Proprietary  ,58,136,194,561,1227,1788
01290700,LAKE TAHOE COMMUNITY COLLEGE            ,CA,96150-4524,Public       ,9,38,47,443,647,1090
01291100,MARINELLO SCHOOL OF BEAUTY              ,CA,92646-2552,Proprietary  ,1,9,10,56,115,171
01291200,MTI COLLEGE                             ,CA,95841-0000,Proprietary  ,32,88,120,447,1257,1704
01294200,ROSEMEAD BEAUTY SCHOOL                  ,CA,91770-1639,Proprietary  ,3,26,29,45,217,262
01298400,PROFESSIONAL INSTITUTE OF BEAUTY        ,CA,91731-2613,Proprietary  ,0,7,7,19,111,130
01298500,HAIR CALIFORNIA BEAUTY ACADEMY          ,CA,92867-7127,Proprietary  ,0,0,0,8,15,23
01298900,OCEANSIDE COLLEGE OF BEAUTY             ,CA,92054-5393,Proprietary  ,0,3,3,37,62,99
01301000,LANCASTER BEAUTY SCHOOL                 ,CA,93534-3098,Proprietary  ,1,12,13,85,160,245
01307400,AMERICAN BEAUTY COLLEGE                 ,CA,90706-5417,Proprietary  ,0,2,2,25,88,113
01309500,SALON SUCCESS ACADEMY                   ,CA,92879-6561,Proprietary  ,13,10,23,136,162,298
01310300,CALIFORNIA WESTERN SCHOOL OF LAW        ,CA,92101-0000,Private      ,0,7,7,22,2146,2168
01324000,LYTLE'S REDWOOD EMPIRE BEAUTY CLG       ,CA,95403-0000,Proprietary  ,5,5,10,81,116,197
02054900,MARINELLO SCHOOL OF BEAUTY              ,CA,92630-0000,Proprietary  ,8,12,20,62,108,170
02059800,PARIS BEAUTY COLLEGE                    ,CA,94520-2611,Proprietary  ,6,10,16,62,146,208
02063500,COASTLINE COMMUNITY COLLEGE             ,CA,92708-0000,Public       ,6,74,80,753,3403,4156
02064300,SIERRA COLLEGE OF BEAUTY                ,CA,95340-0000,Proprietary  ,4,10,14,74,112,186
02065500,BROOKS COLLEGE                          ,CA,90804-3289,Proprietary  ,0,0,0,86,66,152
02065501,BROOKS COLLEGE - SUNNYVALE              ,CA,94086-5303,Proprietary  ,0,0,0,19,11,30
02065700,CALIFORNIA BEAUTY COLLEGE               ,CA,95354-0000,Proprietary  ,2,4,6,78,84,162
02070500,CONCORDIA UNIVERSITY                    ,CA,92612-0000,Private      ,4,27,31,1764,1220,2984
02075800,SOUTHERN CA INST OF ARCHITECTURE        ,CA,90013-0000,Private      ,2,2,4,161,521,682
02086400,MARINELLO SCHOOL OF BEAUTY              ,CA,95050-0000,Proprietary  ,36,61,97,122,269,391
02091200,ELEGANCE INTERNATIONAL                  ,CA,90028-0000,Proprietary  ,2,13,15,76,125,201
02091700,KAPLAN COLLEGE                          ,CA,92123-1509,Proprietary  ,22,106,128,602,1731,2333
02096100,FIELDING INSTITUTE                      ,CA,93105-0000,Private      ,0,23,23,3,1264,1267
02099200,AMERICAN CONSERVATORY THEATER           ,CA,94108-0000,Private      ,0,2,2,15,185,200
02110200,COLUMBIA COLLEGE                        ,CA,91356-0000,Private      ,1,1,2,306,157,463
02110800,CALIFORNIA COLLEGE SAN DIEGO            ,CA,92108-3821,Proprietary  ,16,99,115,416,1206,1622
02111300,CUYAMACA COLLEGE                        ,CA,92019-0000,Public       ,25,66,91,2187,2878,5065
02113601,AMERICAN INTERCONTINENTAL UNIV - LOS ANG,CA,90066-7008,Proprietary  ,1,8,9,288,553,841
02119100,MISSION COLLEGE                         ,CA,95054-1897,Public       ,21,74,95,1675,3172,4847
02120600,SAYBROOK GRADUATE SCHOOL                ,CA,94111-1920,Private      ,0,4,4,1,563,564
02120700,SAN JOAQUIN VALLEY COLLEGE              ,CA,93291-0000,Proprietary  ,168,427,595,2504,5595,8099
02120900,ITT TECHNICAL INSTITUTE                 ,CA,95670-6034,Proprietary  ,41,105,146,727,1480,2207
02125000,CAREER ACADEMY OF BEAUTY                ,CA,92845-0000,Proprietary  ,2,18,20,53,171,224
02128200,"VICTOR VALLEY BEAUTY COLLEGE, INC       ",CA,92392-0000,Proprietary  ,7,7,14,135,145,280
02128300,INSTITUTE FOR BUSINESS & TECHNOLOGY     ,CA,95050-0000,Proprietary  ,9,73,82,258,873,1131
02128301,INSTITUTE FOR BUSINESS & TECHNOLOGY     ,CA,95610-0000,Proprietary  ,4,17,21,120,519,639
02138300,PACIFIC GRADUATE SCHOOL OF PSYCHOLO     ,CA,94303-4232,Private      ,0,1,1,10,512,522
02147400,CLEVELAND CHIROPRACTIC COLLEGE          ,CA,90004-0000,Private      ,1,9,10,37,405,442
02161800,MUSICIANS INSTITUTE                     ,CA,90028-6157,Proprietary  ,18,17,35,1248,945,2193
02167800,ESTES INSTITUTE OF COSMETOLOGY          ,CA,93291-0000,Proprietary  ,3,4,7,113,88,201
02174600,MARINELLO SCHOOL OF BEAUTY              ,CA,90201-0000,Proprietary  ,9,9,18,65,156,221
02180600,BRIDGES  ACADEMY OF BEAUTY              ,CA,92311-2327,Proprietary  ,2,1,3,11,13,24
02184900,PALMER COLLEGE OF CHIROPRACTIC WEST     ,CA,95134-0000,Private      ,0,1,1,10,332,342
02185800,MOLER BARBER COLLEGE                    ,CA,94611-0000,Proprietary  ,0,6,6,17,45,62
02187500,"HEALD COLLEGE, SCH OF BUS & TECH        ",CA,94520-0000,Proprietary  ,38,97,135,652,1558,2210
02188400,SIERRA VALLEY COLLEGE OF COURT REPORTING,CA,93726-0000,Proprietary  ,3,1,4,90,224,314
02208600,MADERA BEAUTY COLLEGE                   ,CA,93637-3519,Proprietary  ,1,4,5,44,35,79
02211000,HAIRMASTERS UNIVERSITY OF BEAUTY        ,CA,92405-0000,Proprietary  ,3,6,9,44,71,115
02220000,COLLEEN O'HARA BEAUTY ACADEMY           ,CA,92701-0000,Proprietary  ,8,16,24,113,287,400
02220200,CALIFORNIA CULINARY ACADEMY             ,CA,94102-3336,Proprietary  ,11,19,30,768,902,1670
02221300,MARINELLO SCHOOL OF BEAUTY              ,CA,92553-0000,Proprietary  ,8,29,37,145,328,473
02222000,AMERICAN FILM INSTITUTE                 ,CA,90027-0000,Private      ,0,2,2,113,507,620
02226000,EAST LOS ANGELES COLLEGE                ,CA,91754-0000,Public       ,73,100,173,7649,7204,14853
02228500,LIFE CHIROPRACTIC COLLEGE-WEST          ,CA,94545-0000,Private      ,0,2,2,7,443,450
02230900,FREDRICK & CHARLES BEAUTY COLLEGE       ,CA,95501-0000,Proprietary  ,1,3,4,46,70,116
02231900,GEMOLOGICAL INSTITUTE OF AMERICA        ,CA,92008-4698,Private      ,0,4,4,44,228,272
02234300,FASHION CAREERS OF CALIFORNIA           ,CA,92110-0000,Proprietary  ,2,2,4,135,122,257
02236400,"THANH LE COLG, SCH OF COSMETOLOGY       ",CA,92840-0000,Proprietary  ,0,10,10,9,76,85
02237200,PHILLIPS GRADUATE INSTITUTE             ,CA,91316-0000,Private      ,0,2,2,2,389,391
02241600,SAN DIEGO CONTINUING EDUCATION          ,CA,92113-0000,Public       ,3,30,33,75,430,505
02241800,AMERICAN CAREER COLLEGE                 ,CA,90004-0000,Proprietary  ,161,353,514,2167,4666,6833
02242700,BERKELEY CITY COLLEGE                   ,CA,94704-0000,Public       ,12,57,69,1266,2341,3607
02250602,EVEREST COLLEGE                         ,CA,91761-8525,Proprietary  ,23,74,97,398,1071,1469
02255400,INTERNATIONAL SCHOOL OF COSMETOLOGY     ,CA,90250-0000,Proprietary  ,1,1,2,38,39,77
02255600,MARINELLO SCHOOL OF BEAUTY              ,CA,90723-0000,Proprietary  ,6,10,16,110,230,340
02258600,ALAMEDA BEAUTY COLLEGE                  ,CA,94501-0000,Proprietary  ,6,13,19,104,182,286
02262400,YESHIVA OHR ELCHONON CHABAD             ,CA,90046-0000,Private      ,12,0,12,87,1,88
02263101,ANTHEM COLLEGE - HIGH-TECH INSTITUTE - S,CA,95827-0000,Proprietary  ,2,4,6,84,86,170
02267600,INSTITUTE OF TRANSPERSONAL PSYCHLGY     ,CA,94303-4624,Private      ,0,2,2,2,460,462
02270600,LIFE PACIFIC COLLEGE                    ,CA,91773-0000,Private      ,1,5,6,321,173,494
02276800,WESTMINSTER SEMINARY CALIFORNIA         ,CA,92027-0000,Private      ,0,0,0,3,135,138
02277400,SOUTH COAST COLLEGE                     ,CA,92868-2616,Proprietary  ,4,30,34,126,400,526
02282300,ALHAMBRA BEAUTY COLLEGE                 ,CA,91802-0000,Proprietary  ,4,21,25,29,133,162
02285100,HILLTOP BEAUTY SCHOOL                   ,CA,94014-0000,Proprietary  ,1,16,17,26,174,200
02291500,ITT TECHNICAL INSTITUTE                 ,CA,91773-0000,Proprietary  ,78,94,172,1010,1468,2478
02291600,ITT TECHNICAL INSTITUTE                 ,CA,92123-0000,Proprietary  ,44,129,173,915,2033,2948
02298000,DESIGN INSTITUTE OF SAN DIEGO           ,CA,92121-0000,Proprietary  ,2,4,6,162,282,444
02304300,"PLATT COLLEGE, SAN DIEGO                ",CA,92115-0000,Proprietary  ,10,13,23,211,308,519
02306300,KAPLAN COLLEGE                          ,CA,95368-0000,Proprietary  ,45,89,134,561,1142,1703
02306302,KAPLAN COLLEGE - FRESNO                 ,CA,93612-3802,Proprietary  ,20,61,81,302,661,963
02309500,CLOVIS ADULT EDUC                       ,CA,93611-0000,Public       ,0,6,6,44,260,304
02312400,LA COLLEGE INTERNATIONAL                ,CA,90010-0000,Proprietary  ,3,102,105,55,704,759
02321800,ITT TECHNICAL INSTITUTE                 ,CA,91342-3664,Proprietary  ,58,113,171,976,1556,2532
02321900,ITT TECHNICAL INSTITUTE                 ,CA,92801-0000,Proprietary  ,72,177,249,711,1283,1994
02327600,ART INST OF CALIFORNIA-SAN DIEGO        ,CA,92108-4401,Proprietary  ,46,70,116,2897,2486,5383
02330500,LAGUNA COLLEGE OF ART AND DESIGN        ,CA,92651-0000,Private      ,0,0,0,384,154,538
02332800,CENTER FOR EMPLOYMENT TRAINING          ,CA,95110-0000,Private      ,63,435,498,582,3290,3872
02338500,GLENDALE CAREER COLLEGE                 ,CA,91201-0000,Proprietary  ,6,21,27,129,233,362
02338700,MARINELLO SCHOOL OF BEAUTY              ,CA,94103-0000,Proprietary  ,7,15,22,55,154,209
02342400,ACADEMY OF RADIO BROADCASTING           ,CA,92647-3809,Proprietary  ,5,18,23,49,201,250
02343400,"BELLUS ACADEMY, THE ACADEMY OF BEAUTY AN",CA,92064-4633,Proprietary  ,14,30,44,128,240,368
02345800,MONTEBELLO BEAUTY COLLEGE               ,CA,90640-0000,Proprietary  ,4,8,12,43,84,127
02351900,KAPLAN COLLEGE                          ,CA,95660-5512,Proprietary  ,25,75,100,272,917,1189
02351901,KAPLAN COLLEGE - BAKERSFIELD            ,CA,93304-0000,Proprietary  ,19,105,124,384,1034,1418
02358000,THOMAS AQUINAS COLLEGE                  ,CA,93060-9622,Private      ,0,0,0,321,21,342
02359300,SHASTA BIBLE COLLEGE                    ,CA,96002-0000,Private      ,0,2,2,36,51,87
02482700,WESTERN UNIVERSITY OF HEALTH S          ,CA,91766-1854,Private      ,0,5,5,50,3432,3482
02494800,LOLA BEAUTY COLLEGE                     ,CA,92641-0000,Proprietary  ,1,7,8,2,42,44
02497300,TRINITY COLLEGE                         ,CA,93277-0000,Proprietary  ,22,92,114,272,983,1255
02500000,SAN JOAQUIN COLLEGE OF LAW              ,CA,93612-0000,Private      ,1,0,1,11,279,290
02518400,THE NATIONAL HISPANIC UNIVERSITY        ,CA,95127-0000,Private      ,4,12,16,200,401,601
02519800,AVANCE BEAUTY COLLEGE                   ,CA,92154-0000,Proprietary  ,1,8,9,54,96,150
02520200,CALIFORNIA CAREER SCHOOLS               ,CA,92805-0000,Proprietary  ,0,10,10,25,62,87
02520300,INTERIOR DESIGNERS INSTITUTE            ,CA,92660-0000,Proprietary  ,9,14,23,61,166,227
02520400,ADRIAN'S BEAUTY COLLEGE OF TURLOCK      ,CA,95382-0000,Proprietary  ,7,17,24,101,182,283
02537200,PALOMAR INSTITUTE OF COSMETOLOGY        ,CA,92069-0000,Proprietary  ,9,14,23,144,188,332
02539100,KAPLAN COLLEGE                          ,CA,91606-3231,Proprietary  ,18,75,93,575,1316,1891
02539102,KAPLAN COLLEGE -  RIVERSIDE             ,CA,92507-4223,Proprietary  ,43,91,134,453,1017,1470
02539500,IRVINE VALLEY COLLEGE                   ,CA,92620-0000,Public       ,41,84,125,2092,2304,4396
02542300,NATIONAL HOLISTIC INSTITUTE             ,CA,94608-0000,Proprietary  ,8,6,14,197,546,743
02543400,BROWNSON TECHNICAL SCHOOL               ,CA,92805-0000,Proprietary  ,2,20,22,40,194,234
02545900,HYPNOSIS MOTIVATION INSTITUTE           ,CA,91356-0000,Private      ,0,26,26,6,202,208
02546400,MTI BUSINESS COLLEGE INC                ,CA,95207-0000,Proprietary  ,2,25,27,36,280,316
02549000,KAPLAN COLLEGE                          ,CA,92083-7736,Proprietary  ,62,128,190,567,1326,1893
02549005,KAPLAN COLLEGE -  PALM SPRINGS          ,CA,92262-7011,Proprietary  ,23,100,123,305,781,1086
02553500,ASSOCIATED TECHNICAL COLLEGE            ,CA,92101-0000,Proprietary  ,16,47,63,89,329,418
02553600,DIVERSIFIED LANGUAGE INSTITUTE          ,CA,90017-0000,Proprietary  ,2,116,118,13,1177,1190
02559300,UNITED EDUCATION INSTITUTE              ,CA,90020-0000,Proprietary  ,440,1007,1447,2875,6264,9139
02559400,INTERCOAST COLLEGES                     ,CA,92868-1656,Proprietary  ,35,361,396,179,2025,2204
02565400,KAPLAN COLLEGE                          ,CA,95207-6216,Proprietary  ,24,69,93,316,793,1109
02570300,LOS ANGELES ORT TECHNICAL INSTITUTE     ,CA,90048-0000,Private      ,14,117,131,157,925,1082
02577900,SANTA BARBARA BUSINESS COLLEGE          ,CA,93309-1664,Proprietary  ,38,86,124,430,981,1411
02578000,SANTA BARBARA BUSINESS COLLEGE          ,CA,93454-6943,Proprietary  ,8,50,58,143,468,611
02584200,NEWBRIDGE COLLEGE                       ,CA,92701-0000,Proprietary  ,27,62,89,258,906,1164
02591600,NORTH-WEST COLLEGE                      ,CA,91101-1744,Proprietary  ,7,36,43,46,139,185
02593100,HEALD COLLEGE                           ,CA,95678-5303,Proprietary  ,33,111,144,385,1394,1779
02593200,HEALD COLLEGE                           ,CA,95035-8008,Proprietary  ,31,73,104,507,1366,1873
02593300,HEALD COLLEGE                           ,CA,95210-5667,Proprietary  ,16,86,102,757,1743,2500
02595600,ASIAN AMERICAN INTERNATIONAL BTY CG     ,CA,92683-4043,Proprietary  ,1,13,14,13,84,97
02597300,SOUTH BAYLO UNIVERSITY                  ,CA,92801-1701,Private      ,0,11,11,7,212,219
02602300,CENTRAL COAST COLLEGE                   ,CA,93901-3301,Proprietary  ,5,20,25,148,262,410
02608900,PINNACLE COLLEGE                        ,CA,91803-8842,Proprietary  ,3,12,15,78,169,247
02608901,PINNACLE COLLEGE - SACRAMENTO           ,CA,95826-2581,Proprietary  ,12,12,24,19,26,45
02609000,EMPERORS COLG OF TRAD ORIENTAL MED      ,CA,90403-5609,Proprietary  ,0,10,10,4,184,188
02612800,LOS ANGELES RECORDING SCHOOL            ,CA,90028-3112,Proprietary  ,13,13,26,737,748,1485
02619300,SAMRA UNIV OF ORIENTAL MEDICINE         ,CA,90015-1019,Private      ,0,3,3,2,75,77
02620300,PLATT COLLEGE                           ,CA,92647-3017,Proprietary  ,0,0,0,12,12,24
03010611,VIRGINIA COLLEGE - GOLF ACADEMY OF AMERI,CA,92008-6512,Proprietary  ,1,9,10,126,193,319
03011300,"CALIF STATE UNIV, SAN MARCOS            ",CA,92096-0001,Public       ,60,48,108,7861,4464,12325
03019900,ADELANTE CAREER INSTITUTE               ,CA,91402-4924,Proprietary  ,0,8,8,25,126,151
03025600,DELL'ARTE SCH OF PHYSICAL THEATRE       ,CA,95525-0816,Private      ,0,0,0,4,41,45
03027700,PACIFIC COLLEGE OF ORIENTAL MED         ,CA,92108-4408,Proprietary  ,0,10,10,15,505,520
03029600,POMONA ADULT SCHOOL                     ,CA,91766-0000,Public       ,0,4,4,104,281,385
03031409,INTERNATIONAL ACADEMY OF DESIGN AND TECH,CA,95834-9664,Proprietary  ,24,41,65,153,190,343
03034000,HEALD COLLEGE                           ,CA,93906-5100,Proprietary  ,41,102,143,586,1198,1784
03035700,LAS POSITAS COLLEGE                     ,CA,94551-6750,Public       ,18,56,74,1367,1510,2877
03039900,FREMONT COLLEGE                         ,CA,90703-5342,Proprietary  ,11,25,36,113,250,363
03043900,NEWSCHOOL OF ARCHITECTURE & DESIGN      ,CA,92101-6634,Proprietary  ,2,7,9,253,455,708
03044500,KAPLAN COLLEGE                          ,CA,91402-4222,Proprietary  ,17,45,62,138,409,547
03054100,ROYALE COLLEGE OF BEAUTY                ,CA,92590-2525,Proprietary  ,1,9,10,45,91,136
03062300,WESTECH COLLEGE                         ,CA,91764-4988,Proprietary  ,16,72,88,188,777,965
03062400,MT DIABLO ADULT EDUC LOMA VISTA CTR     ,CA,94518-1122,Public       ,0,1,1,42,147,189
03062700,PLATT COLLEGE                           ,CA,90041-0000,Proprietary  ,4,19,23,141,191,332
03062701,PLATT COLLEGE                           ,CA,91764-0000,Proprietary  ,15,44,59,206,350,556
03063400,MODERN TECHNOLOGY SCHOOL                ,CA,92708-9821,Proprietary  ,2,18,20,60,212,272
03067400,BALDWIN PARK ADULT SCHOOL               ,CA,91706-4897,Public       ,3,17,20,77,253,330
03067500,INSTITUTE OF TECHNOLOGY                 ,CA,93612-3217,Proprietary  ,97,384,481,1028,3174,4202
03069500,SAGE COLLEGE                            ,CA,92557-6720,Proprietary  ,7,26,33,135,564,699
03070400,ITT TECHNICAL INSTITUTE                 ,CA,92408-3519,Proprietary  ,63,131,194,1140,1731,2871
03072300,EVEREST COLLEGE                         ,CA,91761-3222,Proprietary  ,43,95,138,451,1040,1491
03072700,WESTWOOD COLLEGE - LOS ANGELES          ,CA,90010-1577,Proprietary  ,80,260,340,1262,1830,3092
03074900,MARTINEZ ADULT CENTER                   ,CA,94553-3298,Public       ,0,3,3,6,64,70
03078200,AMERICAN CLG TRADITIONAL CHINESE MD     ,CA,94107-2813,Private      ,0,2,2,6,299,305
03084700,VENTURA ADULT\CONTINUING EDUCATION      ,CA,93003-7313,Public       ,4,28,32,41,195,236
03087400,ITT TECHNICAL INSTITUTE                 ,CA,90502-1356,Proprietary  ,69,174,243,1069,2305,3374
03094400,ELITE PROGRESSIVE SCHOOL OF COSM        ,CA,95841-2909,Proprietary  ,15,28,43,256,296,552
03097700,CENTRAL CALIF SCH CONTINUING EDUC       ,CA,93401-6739,Proprietary  ,1,7,8,43,223,266
03098200,YO SAN UNIV TRADITIONAL CHINESE MED     ,CA,90066-1103,Private      ,0,9,9,1,162,163
03105700,MONTEREY PARK COLLEGE                   ,CA,91754-2416,Proprietary  ,0,0,0,27,17,44
03108100,SUMMIT CAREER COLLEGE                   ,CA,92324-3956,Proprietary  ,19,140,159,401,1679,2080
03109500,DONGGUK ROYAL UNIVERSITY                ,CA,90020-1765,Private      ,0,4,4,3,105,108
03113300,MCED CAREER COLLEGE                     ,CA,93727-1620,Proprietary  ,5,18,23,91,1441,1532
03113600,SOUTHERN CALIFORNIA INST OF TECHNOL     ,CA,92805-3758,Proprietary  ,10,112,122,123,1179,1302
03115400,LYLE'S FRESNO COLLEGE OF BEAUTY         ,CA,93710-0000,Proprietary  ,0,0,0,23,7,30
03116600,EAST SAN GABRIEL VLY REG OCCUP PROG     ,CA,91790-2105,Public       ,16,126,142,66,532,598
03125300,JOHN WESLEY INTER. BARBER & BTY CLG     ,CA,90813-4321,Proprietary  ,7,9,16,33,85,118
03125400,ART INSTITUTE OF CALIFORNIA-HOLLYWOOD (T,CA,90010-1014,Proprietary  ,35,56,91,1273,1199,2472
03125800,PREMIERE CAREER COLLEGE                 ,CA,91706-3746,Proprietary  ,25,49,74,165,443,608
03126800,PACIFICA GRADUATE INSTITUTE             ,CA,93013-0000,Proprietary  ,0,5,5,2,906,908
03128700,MT SIERRA COLLEGE                       ,CA,91016-3414,Proprietary  ,5,8,13,253,381,634
03131300,FIVE BRANCHES UNIVERSITY                ,CA,95062-4669,Private      ,2,4,6,17,343,360
03144400,AMERICAN CLG OF HEALTH PROFESSIONS      ,CA,92374-0000,Proprietary  ,1,0,1,11,28,39
03150500,VIRGINIA SEWING MACHINES & SCH CTR      ,CA,90015-3535,Proprietary  ,0,10,10,1,84,85
03162300,FOUR-D SUCCESS ACADEMY                  ,CA,92324-4218,Proprietary  ,16,85,101,194,918,1112
03163300,PACIFIC STATES UNIVERSITY               ,CA,90006-4298,Private      ,0,0,0,15,29,44
03195400,EVEREST COLLEGE                         ,CA,90501-2867,Proprietary  ,12,26,38,100,199,299
03210300,CALIFORNIA SCHOOL OF CULINARY ARTS      ,CA,91101-5221,Proprietary  ,39,93,132,1625,2211,3836
03225300,AMERICAN UNIVERSITY OF HEALTH SCIENCES  ,CA,90755-3612,Proprietary  ,3,6,9,59,108,167
03242300,CAREER NETWORK INSTITUTE                ,CA,92868-4710,Proprietary  ,15,61,76,194,705,899
03250300,COMMUNITY BASED EDUCATION AND DEVEL     ,CA,90036-1137,Private      ,8,45,53,46,392,438
03260300,CALIFORNIA STATE U-MONTEREY BAY         ,CA,93955-8001,Public       ,2,47,49,5850,2099,7949
03266300,BETHESDA CHRISTIAN UNIVERSITY           ,CA,92801-4132,Private      ,0,1,1,6,36,42
03278300,CLARITA CAREER COLLEGE                  ,CA,91351-5432,Proprietary  ,49,148,197,441,1309,1750
03282300,KIM ANH ACADEMY OF BEAUTY               ,CA,92683-4605,Proprietary  ,2,34,36,12,223,235
03288300,ACAD CHINESE CULTURE & HEALTH SCIS      ,CA,94512-0000,Private      ,0,0,0,7,96,103
03299300,PACIFIC COLLEGE                         ,CA,92626-3160,Proprietary  ,3,25,28,72,403,475
03308300,KENSINGTON COLLEGE                      ,CA,92705-8708,Proprietary  ,0,5,5,2,68,70
03321300,SCRIPPS RESEARCH INSTITUTE (THE)        ,CA,92037-0000,Private      ,0,0,0,9,44,53
03327400,ACUPUNCTURE AND INTEGRATIVE MEDICINE COL,CA,94704-2724,Private      ,0,7,7,3,202,205
03332300,SOUTHERN CA BIBLE CLG & SEMINARY        ,CA,92019-1109,Private      ,0,10,10,9,162,171
03359300,ST. FRANCIS CAREER COLLEGE              ,CA,90262-2659,Private      ,7,27,34,83,339,422
03367300,PROFESSIONAL GOLFERS CAREER COLLEGE     ,CA,92591-6013,Proprietary  ,5,13,18,210,303,513
03383300,CALIFORNIA RECORDING INSTITUTE          ,CA,94103-3921,Proprietary  ,0,0,0,0,1,1
03394300,REMINGTON COLLEGE - SAN DIEGO CAMPUS    ,CA,92108-3002,Proprietary  ,20,71,91,369,798,1167
03395300,INTERNATIONAL CAREER DEVELOPMENT        ,CA,90027-5794,Proprietary  ,150,305,455,980,2396,3376
03399300,NORTHWESTERN TECHNICAL COLLEGE          ,CA,95670-4443,Proprietary  ,12,52,64,151,545,696
03403300,TRINITY LIFE BIBLE COLLEGE              ,CA,95842-3546,Private      ,2,2,4,91,253,344
03413400,ENGLISH CENTER  (THE)                   ,CA,94607-3734,Private      ,4,30,34,27,202,229
03427400,CAREER COLLEGES OF AMERICA              ,CA,90280-7420,Proprietary  ,42,252,294,517,2383,2900
03427500,ANTELOPE VALLEY MEDICAL COLLEGE         ,CA,93534-3324,Proprietary  ,21,63,84,353,817,1170
03440400,MARIAN HEALTH CAREERS CENTER            ,CA,90010-1728,Proprietary  ,21,26,47,100,199,299
03441400,VALLEY CAREER COLLEGE                   ,CA,92020-3057,Proprietary  ,9,35,44,157,598,755
03455900,VALLECITOS CENTER FOR EMPLOYMENT TR     ,CA,94541-5027,Private      ,0,1,1,5,32,37
03458300,MY LE'S BEAUTY COLLEGE                  ,CA,95824-3039,Proprietary  ,2,17,19,46,197,243
03467300,MARINELLO SCHOOL OF BEAUTY              ,CA,92545-3661,Proprietary  ,18,48,66,132,279,411
03467301,CALIFORNIA BEAUTY COLLEGE - DESERT HOT S,CA,92240-1307,Proprietary  ,0,0,0,6,7,13
03474700,OPPORTUNITIES INDUSTRIALIZATION CEN     ,CA,94025-1413,Private      ,0,0,0,2,2,4
03479300,PROFESSIONAL CAREER INSTITUTE           ,CA,90703-2522,Proprietary  ,2,18,20,55,243,298
03479400,DONALD VOCATIONAL SCHOOL                ,CA,90010-1718,Proprietary  ,0,0,0,3,1,4
03485400,JAMES ALBERT SCHOOL OF COSMETOLOGY      ,CA,92627-3831,Proprietary  ,5,8,13,71,130,201
03485401,JAMES ALBERT SCHOOL OF COSMETOLOGY - ANA,CA,92804-5384,Proprietary  ,0,0,0,7,12,19
03516300,THE KING'S COLLEGE AND SEMINARY         ,CA,91405-2233,Private      ,1,4,5,52,311,363
03532400,ADVANCED TRAINING ASSOCIATES            ,CA,92020-1236,Proprietary  ,3,1,4,12,50,62
03542400,COPPER MOUNTAIN COLLEGE                 ,CA,92252-6102,Public       ,2,23,25,493,1558,2051
03577300,COBA ACADEMY                            ,CA,92866-1407,Proprietary  ,5,7,12,48,70,118
03590400,NTMA TRAINING CENTERS OF SOUTHERN C     ,CA,90650-6099,Private      ,17,100,117,125,654,779
03592400,CITY OF HOPE GRADUATE SCHOOL            ,CA,91010-0000,Private      ,0,0,0,1,14,15
03598300,AVALON BEAUTY COLLEGE                   ,CA,93103-3137,Proprietary  ,3,7,10,81,51,132
03614300,UNITED BEAUTY COLLEGE                   ,CA,91733-0000,Proprietary  ,2,6,8,14,72,86
03621300,LIBERTY TRAINING INSTITUTE              ,CA,90057-3202,Proprietary  ,7,43,50,62,220,282
03636300,HEARTWOOD INSTITUTE                     ,CA,95542-9446,Proprietary  ,0,0,0,1,1,2
03639300,WEST COAST ULTRASOUND INSTITUTE         ,CA,90211-3312,Proprietary  ,3,17,20,193,800,993
03646300,DESIGN'S SCHOOL OF COSMETOLOGY          ,CA,93446-1471,Proprietary  ,1,5,6,74,177,251
03681300,CALIFORNIA HEALING ARTS COLLEGE         ,CA,90025-2589,Proprietary  ,4,16,20,47,150,197
03695300,COMMUNITY ENHANCEMENT SERVICES          ,CA,91205-2395,Private      ,5,12,17,9,127,136
03695400,SALVATION ARMY CRESTMONT COLLEGE (THE)  ,CA,90275-5301,Private      ,0,0,0,2,1,3
03695700,SANTIAGO CANYON COLLEGE                 ,CA,92869-4512,Public       ,20,27,47,1569,1269,2838
03696300,UNIVERSITY OF THE WEST                  ,CA,91770-3709,Private      ,0,1,1,13,50,63
03698300,WEST COAST UNIVERSITY                   ,CA,90004-6818,Proprietary  ,30,127,157,339,2080,2419
03698400,CA COLLEGE OF VOCATIONAL CAREER         ,CA,93301-1800,Proprietary  ,2,9,11,39,120,159
03736300,ADVANCE BEAUTY COLLEGE                  ,CA,92843-4752,Proprietary  ,2,42,44,39,360,399
03740400,ATI COLLEGE                             ,CA,90650-0000,Proprietary  ,6,21,27,69,271,340
03759300,COMPUTER TUTOR BUSINESS & TECH INST     ,CA,95356-0000,Proprietary  ,1,12,13,27,129,156
03786300,ADVANCED COLLEGE                        ,CA,90280-5255,Proprietary  ,12,40,52,64,286,350
03797400,CAREER CARE INSTITUTE                   ,CA,93534-0000,Proprietary  ,8,33,41,181,709,890
03806300,LAKE COLLEGE                            ,CA,96002-0926,Proprietary  ,0,0,0,41,325,366
03810300,SILICON VALLEY UNIVERSITY               ,CA,95131-1868,Private      ,0,3,3,17,39,56
03814400,SOKA UNIVERSITY OF AMERICA              ,CA,92656-8081,Private      ,0,0,0,325,31,356
03838400,WALTER JAY M.D. INSTITUTE AN EDUCATIONAL,CA,90057-0000,Proprietary  ,1,3,4,14,140,154
03852500,CIT COLLEGE OF INFOMEDICAL TECHNOLOGY   ,CA,92831-3703,Proprietary  ,3,59,62,44,466,510
03853300,KECK GRADUATE INSTITUTE OF APPLIED LIFE ,CA,91711-4817,Private      ,0,0,0,0,75,75
03853400,LADERA CAREER PATHS TRAINING CENTERS    ,CA,90045-1931,Proprietary  ,0,0,0,4,16,20
03868300,WORLD MISSION UNIVERSITY                ,CA,90020-1789,Private      ,0,0,0,2,63,65
03868400,LOS ANGELES MUSIC ACADEMY               ,CA,91105-2540,Proprietary  ,0,0,0,58,65,123
03871300,FOLSOM LAKE COLLEGE                     ,CA,95630-6798,Public       ,11,49,60,1436,2132,3568
03874300,CAMBRIDGE JUNIOR COLLEGE                ,CA,95993-0000,Proprietary  ,9,5,14,80,239,319
03874400,COMMMUNITY CHRISTIAN COLLEGE            ,CA,92373-4465,Private      ,0,0,0,44,92,136
03889300,STANBRIDGE COLLEGE                      ,CA,92612-0000,Proprietary  ,12,53,65,110,517,627
03901300,PACIFIC COAST TRADE SCHOOL              ,CA,93033-2441,Proprietary  ,5,28,33,41,203,244
03910400,NATIONAL POLYTECHNIC COLLEGE            ,CA,90040-3066,Proprietary  ,10,35,45,61,238,299
03933300,MUELLER COLLEGE OF HOLISTIC STUDIES     ,CA,92116-2630,Proprietary  ,2,10,12,40,177,217
03933301,MUELLER COLLEGE OF HOLISTIC STUDIES -   ,CA,92120-3449,Proprietary  ,0,2,2,0,2,2
03962300,AMERICAN INSTITUTE OF MASSAGE THERAPY   ,CA,92705-5463,Proprietary  ,0,1,1,18,33,51
03964400,INTERNATIONAL SCHOOL OF BEAUTY          ,CA,92260-2740,Proprietary  ,0,11,11,52,142,194
03969600,AMERICAN AUTO INSTITUTE                 ,CA,90703-2637,Proprietary  ,6,10,16,60,103,163
03971300,AMERICAN CAREER COLLEGE                 ,CA,91764-4906,Proprietary  ,53,153,206,618,1470,2088
03973300,EX'PRESSION COLLEGE FOR DIGITAL ARTS    ,CA,94608-1021,Proprietary  ,17,18,35,764,634,1398
03974500,CALIFORNIA CAREER COLLEGE               ,CA,91303-2006,Proprietary  ,4,8,12,32,95,127
03976400,CALIFORNIA INSTITUTE OF THE HEALING ARTS,CA,95825-8551,Proprietary  ,0,0,0,10,22,32
03980300,CALIFORNIA STATE UNIVERSITY CHANNEL ISLA,CA,93012-8599,Public       ,8,10,18,3843,1818,5661
03995300,UNIVERSITY OF EAST-WEST MEDICINE        ,CA,94087-6106,Proprietary  ,0,0,0,7,55,62
03999300,BEAUMONT ADULT SCHOOL                   ,CA,92223-1927,Public       ,0,1,1,30,126,156
04001300,PALACE BEAUTY COLLEGE                   ,CA,90006-4233,Proprietary  ,1,5,6,35,103,138
04001400,MOJAVE BARBER COLLEGE                   ,CA,92395-3201,Proprietary  ,5,5,10,22,99,121
04003300,CSI CAREER COLLEGE                      ,CA,95687-3100,Proprietary  ,7,25,32,191,541,732
04004300,THUY PRINCESS BEAUTY COLLEGE            ,CA,91766-0000,Proprietary  ,1,17,18,6,68,74
04005300,INTERAMERICAN COLLEGE                   ,CA,91950-4437,Private      ,0,10,10,13,131,144
04014400,PALLADIUM TECHNICAL ACADEMY             ,CA,91731-2429,Proprietary  ,3,12,15,25,88,113
04023400,PROTEUS                                 ,CA,93291-3014,Private      ,0,2,2,2,22,24
04037300,LOS ANGELES FILM SCHOOL (THE)           ,CA,90028-7300,Proprietary  ,6,13,19,592,607,1199
04049300,MAXINE WATERS EMPLOYMENT PREPARATION CEN,CA,90059-1023,Public       ,1,3,4,22,66,88
04056300,CAREER COLLEGE OF CALIFORNIA            ,CA,92705-5805,Proprietary  ,1,8,9,9,32,41
04057300,TECHSKILLS OF SACRAMENTO                ,CA,95815-4025,Proprietary  ,2,11,13,70,374,444
04071300,AMERICAN PACIFIC COLLEGE                ,CA,91405-6232,Proprietary  ,0,3,3,14,60,74
04076400,GNOMON SCHOOL OF VISUAL EFFECTS         ,CA,90038-2616,Proprietary  ,0,3,3,22,91,113
04092300,COASTLINE BEAUTY COLLEGE                ,CA,92708-3847,Proprietary  ,2,20,22,14,169,183
04092400,MAKE-UP DESIGNORY                       ,CA,91502-1322,Proprietary  ,4,5,9,196,166,362
04100400,TAFT UNIVERSITY SYSTEM (THE)            ,CA,92704-6954,Proprietary  ,0,13,13,0,68,68
04109300,ACADEMY OF BARBERING ARTS (THE)         ,CA,91324-3406,Proprietary  ,6,12,18,54,109,163
04111300,WEST HILLS COLLEGE LEMOORE              ,CA,93245-9248,Public       ,18,77,95,1180,2201,3381
04114500,VALLEY COLLEGE OF MEDICAL CAREERS       ,CA,91304-2354,Proprietary  ,9,29,38,65,207,272
04115300,COACHELLA VALLEY BEAUTY COLLEGE         ,CA,92253-2051,Proprietary  ,0,5,5,28,61,89
04115600,MAYFIELD COLLEGE                        ,CA,92234-7014,Proprietary  ,1,12,13,13,60,73
04115800,MERIDIAN INSTITUTE                      ,CA,90010-3606,Proprietary  ,0,0,0,1,14,15
04116000,VIDEO SYMPHONY ENTERTRAINING            ,CA,91502-3253,Proprietary  ,0,3,3,58,225,283
04119200,CAREER COLLEGE CONSULTANTS              ,CA,90041-2088,Proprietary  ,3,19,22,13,81,94
04126400,CHAMPION INSTITUTE OF COSMETOLOGY       ,CA,92264-7458,Proprietary  ,0,2,2,4,19,23
04126500,COAST CAREER INSTITUTE                  ,CA,90015-3040,Proprietary  ,18,94,112,22,131,153
04127100,"UNIVERSITY OF CALIFORNIA, MERCED        ",CA,95343-5001,Public       ,35,15,50,7249,711,7960
04127800,HEALTHY HAIR ACADEMY                    ,CA,90303-3137,Proprietary  ,7,20,27,55,193,248
04127900,TUI UNIVERSITY                          ,CA,90630-5023,Proprietary  ,0,73,73,28,1741,1769
04129700,INTERNATIONAL POLYTECHNIC INSTITUTE     ,CA,92231-1737,Private      ,2,11,13,2,12,14
04132300,INSTITUTE OF MEDICAL EDUCATION          ,CA,95113-2207,Proprietary  ,9,59,68,43,272,315
04132400,ACADEMY OF ESTHETICS AND COSMETOLOGY    ,CA,91342-3373,Proprietary  ,0,1,1,1,10,11
04132700,INFOTECH CAREER COLLEGE                 ,CA,90706-5579,Proprietary  ,4,22,26,23,116,139
04133000,BIOHEALTH COLLEGE                       ,CA,95134-2033,Proprietary  ,1,35,36,10,131,141
04134500,CAREER COLLEGE OF SAN DIEGO             ,CA,92102-3348,Proprietary  ,3,40,43,18,141,159
04134700,INTERNATL PROFESSIONAL SCHL OF BODYWORK ,CA,92123-1520,Proprietary  ,2,17,19,6,66,72
04137200,BORNER'S BARBER COLLEGE                 ,CA,90047-3856,Proprietary  ,0,6,6,2,28,30
04138700,CAO INSTITUTE OF AESTHETICS (THE)       ,CA,91801-3903,Proprietary  ,8,8,16,41,63,104
04141300,SAN FRANCISCO INSTITUTE OF ESTHETICS    ,CA,94103-4083,Proprietary  ,5,5,10,30,37,67
04141400,LAURUS COLLEGE                          ,CA,93401-5405,Proprietary  ,6,46,52,23,129,152
04141700,HEALING HANDS SCHOOL OF HOLISTIC HEALTH ,CA,92025-1722,Proprietary  ,1,7,8,3,14,17
04144200,CAREER DEVELOPMENT INSTITUTE            ,CA,90035-4364,Proprietary  ,1,5,6,1,5,6
00184600,BRIAR CLIFF UNIVERSITY                  ,IA,51104-2100,Private      ,1,4,5,1182,463,1645
00184700,BUENA VISTA UNIVERSITY                  ,IA,50588-9987,Private      ,6,60,66,1762,1732,3494
00184800,SOUTHEASTERN COMMUNITY COLLEGE          ,IA,52655-0000,Public       ,25,115,140,1120,2042,3162
00185000,CENTRAL COLLEGE                         ,IA,50219-1999,Private      ,1,0,1,2151,85,2236
00185200,CLARKE COLLEGE                          ,IA,52001-3198,Private      ,2,5,7,989,473,1462
00185400,COE COLLEGE                             ,IA,52402-5092,Private      ,1,1,2,1785,154,1939
00185500,DES MOINES UNIV-OSTEOPATHIC MED CTR     ,IA,50312-0000,Private      ,0,16,16,19,1701,1720
00185600,CORNELL COLLEGE                         ,IA,52314-1098,Private      ,2,0,2,1733,75,1808
00185700,SOUTHWESTERN COMMUNITY COLLEGE          ,IA,50801-1098,Public       ,5,30,35,528,669,1197
00185800,DIVINE WORD COLLEGE                     ,IA,52045-0380,Private      ,0,0,0,12,20,32
00185900,DORDT COLLEGE                           ,IA,51250-1697,Private      ,1,1,2,1401,88,1489
00186000,DRAKE UNIVERSITY                        ,IA,50311-4505,Private      ,3,23,26,4159,2355,6514
00186200,ELLSWORTH COMMUNITY COLLEGE             ,IA,50126-1199,Public       ,1,10,11,648,320,968
00186400,IOWA LAKES COMMUNITY COLLEGE            ,IA,51334-2234,Public       ,12,76,88,1217,1194,2411
00186500,IOWA CENTRAL COMMUNITY COLLEGE          ,IA,50501-0000,Public       ,14,108,122,2448,2170,4618
00186600,GRACELAND UNIVERSITY                    ,IA,50140-1699,Private      ,2,29,31,998,1185,2183
00186700,GRAND VIEW UNIVERSITY                   ,IA,50316-1599,Private      ,5,19,24,1642,1016,2658
00186800,GRINNELL COLLEGE                        ,IA,50112-1690,Private      ,0,0,0,2328,35,2363
00186900,IOWA STATE UNIV SCIENCE & TECHNOLOG     ,IA,50011-2028,Public       ,58,60,118,19210,5070,24280
00187100,IOWA WESLEYAN COLLEGE                   ,IA,52641-1398,Private      ,2,7,9,747,426,1173
00187300,LORAS COLLEGE                           ,IA,52004-0178,Private      ,3,0,3,1831,158,1989
00187400,LUTHER COLLEGE                          ,IA,52101-1045,Private      ,4,0,4,2779,81,2860
00187500,MARSHALLTOWN COMMUNITY COLLEGE          ,IA,50158-4760,Public       ,6,38,44,650,858,1508
00187700,NORTH IOWA AREA COMMUNITY COLLEGE       ,IA,50401-7299,Public       ,19,51,70,1729,1121,2850
00187900,MORNINGSIDE COLLEGE                     ,IA,51106-1751,Private      ,2,22,24,1519,469,1988
00188000,MOUNT MERCY COLLEGE                     ,IA,52402-4797,Private      ,2,24,26,1013,744,1757
00188100,ASHFORD UNIVERSITY                      ,IA,52732-3997,Proprietary  ,286,6708,6994,2736,54481,57217
00188300,NORTHWESTERN COLLEGE                    ,IA,51041-1996,Private      ,1,4,5,1509,111,1620
00188700,SIMPSON COLLEGE                         ,IA,50125-1297,Private      ,1,19,20,2141,536,2677
00188900,ST AMBROSE UNIVERSITY                   ,IA,52803-2898,Private      ,6,27,33,2687,1272,3959
00189000,UNIVERSITY OF NORTHERN IOWA             ,IA,50614-0705,Public       ,19,76,95,10059,2996,13055
00189100,UNIVERSITY OF DUBUQUE                   ,IA,52001-5099,Private      ,5,9,14,1622,519,2141
00189200,UNIVERSITY OF IOWA                      ,IA,52242-1316,Public       ,35,90,125,16870,9082,25952
00189300,UPPER IOWA UNIVERSITY                   ,IA,52142-9206,Private      ,8,177,185,1368,4739,6107
00189400,VENNARD COLLEGE                         ,IA,52595-0029,Private      ,0,0,0,61,20,81
00189500,WALDORF COLLEGE                         ,IA,50436-1700,Private      ,0,4,4,660,90,750
00189600,WARTBURG COLLEGE                        ,IA,50677-2200,Private      ,1,0,1,2418,73,2491
00189700,WARTBURG THEOLOGICAL SEMINARY           ,IA,52004-5004,Private      ,0,0,0,5,149,154
00190000,WILLIAM PENN UNIVERSITY                 ,IA,52577-1799,Private      ,7,44,51,1049,1466,2515
00396300,AIB COLLEGE OF BUSINESS                 ,IA,50321-1799,Private      ,4,19,23,668,683,1351
00407500,ESTRN IOWA COMMUNITY COLLEGE DIST       ,IA,52801-1221,Public       ,1,8,9,50,95,145
00407501,CLINTON COMMUNITY COLLEGE               ,IA,52732-0000,Public       ,6,32,38,426,612,1038
00407502,MUSCATINE COMMUNITY COLLEGE             ,IA,52761-0000,Public       ,9,23,32,459,533,992
00407503,SCOTT COMMUNITY COLLEGE                 ,IA,52722-0000,Public       ,17,130,147,1277,2641,3918
00407600,KIRKWOOD COMMUNITY COLLEGE              ,IA,52406-2068,Public       ,72,398,470,6721,6469,13190
00423300,MERCY/ST. LUKE'S SCH RAD TECH           ,IA,52402-0000,Private      ,1,1,2,7,11,18
00458600,KAPLAN UNIVERSITY                       ,IA,52807-2095,Proprietary  ,779,13359,14138,7467,123324,130791
00458604,KAPLAN UNIVERSITY - CEDAR RAPIDS        ,IA,52404-2998,Proprietary  ,14,80,94,223,1180,1403
00458605,KAPLAN UNIVERSITY - DES MOINES          ,IA,50323-5702,Proprietary  ,21,111,132,351,1548,1899
00458606,KAPLAN UNIVERSITY - MASON CITY          ,IA,50401-4665,Proprietary  ,3,43,46,132,698,830
00458607,KAPLAN UNIVERSITY - CEDAR FALLS         ,IA,50613-6309,Proprietary  ,12,86,98,211,1115,1326
00458610,KAPLAN UNIVERSITY - COUNCIL BLUFFS      ,IA,51503-5289,Proprietary  ,5,56,61,71,590,661
00458700,NORTHEAST IOWA COMMUNITY COLLEGE        ,IA,52132-0400,Public       ,17,59,76,736,825,1561
00458701,NORTHEAST IOWA COMMUNITY COLLEGE        ,IA,52068-0000,Public       ,16,73,89,1075,1222,2297
00459500,HAWKEYE COMMUNITY COLLEGE               ,IA,50701-0000,Public       ,33,100,133,3067,2500,5567
00459800,IOWA WESTERN CMTY CLG-COUNCIL BLUFF     ,IA,51502-0000,Public       ,32,84,116,2487,2200,4687
00460000,NORTHWEST IOWA COMMUNITY COLLEGE        ,IA,51201-1046,Public       ,8,8,16,477,329,806
00626700,IOWA METHODIST MEDICAL CENTER SCHOOLS   ,IA,50309-1499,Private      ,0,0,0,15,34,49
00627300,MERCY COLLEGE OF HEALTH SCIENCES        ,IA,50309-1239,Private      ,9,41,50,416,746,1162
00712000,DES MOINES AREA CMTY COLLEGE            ,IA,50021-0000,Public       ,82,491,573,5635,7978,13613
00712100,FAITH BAPTIST BIBLE CLG & THEOL SEM     ,IA,50021-0000,Private      ,1,3,4,318,83,401
00729100,ST LUKE'S COLLEGE                       ,IA,51104-0263,Private      ,0,1,1,101,100,201
00731600,WESTERN IOWA TECH COMMUNITY COLLEGE     ,IA,51106-0000,Public       ,31,102,133,1485,2597,4082
00758800,CAPRI COLLEGE                           ,IA,52004-0873,Proprietary  ,1,0,1,184,207,391
00761100,EQ SCHOOL OF HAIR DESIGN                ,IA,51503-0813,Proprietary  ,3,5,8,44,57,101
00765600,AMERICAN COLLEGE OF HARISTYLING -CR     ,IA,52402-0000,Proprietary  ,1,2,3,7,29,36
00765800,AMER COLL OF HAIRSTYLING-DES MOINES     ,IA,50309-5446,Proprietary  ,0,5,5,11,46,57
00765900,LA JAMES COLLEGE OF HAIRSTYLING         ,IA,50401-3308,Proprietary  ,0,4,4,101,83,184
00771700,CAPRI COLLEGE                           ,IA,52807-2622,Proprietary  ,1,2,3,50,58,108
00794100,COLLEGE OF HAIR DESIGN                  ,IA,50703-1834,Proprietary  ,0,4,4,20,60,80
00811600,DAYTON'S SCHOOL OF HAIR DESIGN          ,IA,52601-0000,Proprietary  ,2,1,3,7,32,39
00826000,IOWA SCHOOL OF BEAUTY INC               ,IA,50322-0000,Proprietary  ,8,16,24,73,153,226
00840300,INDIAN HILLS COMMUNITY COLLEGE          ,IA,52501-1398,Public       ,28,124,152,1733,2202,3935
00840301,INDIAN HILLS COMMUNITY COLLEGE          ,IA,52544-0000,Public       ,8,22,30,229,305,534
00842400,LA JAMES INTERNATIONAL COLLEGE          ,IA,50501-5577,Proprietary  ,2,12,14,97,89,186
00959300,LA'JAMES COLLEGE OF HAIRSTYLING         ,IA,52240-0000,Proprietary  ,4,11,15,96,77,173
01111300,MAHARISHI UNIV OF MANAGEMENT            ,IA,52557-0001,Private      ,1,0,1,146,247,393
01206400,HAMILTON TECHNICAL COLLEGE              ,IA,52807-2653,Proprietary  ,3,20,23,118,317,435
01230000,PALMER COLLEGE OF CHIROPRACTIC          ,IA,52803-5287,Private      ,2,3,5,89,2471,2560
01300600,LA' JAMES INTERNATIONAL COLLEGE-CF      ,IA,50613-5242,Proprietary  ,4,1,5,97,70,167
02090300,CAPRI COLLEGE                           ,IA,52404-0000,Proprietary  ,4,3,7,68,70,138
02134500,LA JAMES INTERNATIONAL COLLEGE - DAV    ,IA,52806-3952,Proprietary  ,6,1,7,56,75,131
02160900,"SALON PROFESSIONAL ACADEMY, THE         ",IA,50010-0000,Proprietary  ,1,1,2,134,41,175
02262500,FAUST INSTITUTE OF COSMETOLOGY          ,IA,50588-0000,Proprietary  ,0,4,4,37,45,82
02274100,LA' JAMES INTERNATIONAL COLLEGE - DM    ,IA,50131-0000,Proprietary  ,9,18,27,155,182,337
02289000,AMERICAN HAIR ACADEMY                   ,IA,52627-4530,Proprietary  ,0,0,0,18,24,42
02306900,IOWA SCHOOL OF BEAUTY                   ,IA,52501-0000,Proprietary  ,5,5,10,32,53,85
02328900,EMMAUS BIBLE COLLEGE                    ,IA,52001-0000,Private      ,0,0,0,213,26,239
02330900,IOWA SCHOOL OF BEAUTY                   ,IA,50158-0000,Proprietary  ,0,8,8,16,33,49
02333200,DAYTON'S SCHOOL OF HAIR DESIGN          ,IA,52632-0000,Proprietary  ,0,1,1,3,17,20
02609200,VATTEROTT COLLEGE                       ,IA,50321-4704,Proprietary  ,3,27,30,146,644,790
03069100,ALLEN COLLEGE                           ,IA,50703-1916,Private      ,0,4,4,260,275,535
03441300,IOWA SCHOOL OF BEAUTY                   ,IA,51106-5111,Proprietary  ,1,2,3,34,41,75
03607400,TOTAL LOOK SCHOOL OF COSMETOLOGY AND MAS,IA,52136-1053,Proprietary  ,0,0,0,7,8,15
03720300,CARLSON COLLEGE OF MASSAGE THERAPY      ,IA,52205-7519,Proprietary  ,0,1,1,24,40,64
04089300,BIO-CHI INSTITUTE OF MASSAGE THERAPY    ,IA,51103-2138,Proprietary  ,0,0,0,3,27,30
00259600,ATLANTIC COMMUNITY COLLEGE              ,NJ,08330-2699,Public       ,35,108,143,3428,3666,7094
00259700,BLOOMFIELD COLLEGE                      ,NJ,07003-3425,Private      ,5,22,27,2322,1272,3594
00259800,CALDWELL COLLEGE                        ,NJ,07006-6195,Private      ,3,30,33,1401,943,2344
00259900,CENTENARY COLLEGE                       ,NJ,07840-2184,Private      ,8,43,51,1596,1066,2662
00260000,COLLEGE OF SAINT ELIZABETH              ,NJ,07960-6989,Private      ,2,16,18,708,670,1378
00260100,CUMBERLAND COUNTY COLLEGE               ,NJ,08362-0517,Public       ,6,23,29,2004,2302,4306
00260300,DREW UNIVERSITY                         ,NJ,07940-4063,Private      ,2,5,7,3368,532,3900
00260700,FAIRLEIGH DICKINSON UNIV-TEANECK        ,NJ,07666-1996,Private      ,13,48,61,2713,2104,4817
00260701,FAIRLEIGH DICKINSON UNIV-FLORHAM        ,NJ,07940-0000,Private      ,1,2,3,2192,512,2704
00260702,FAIRLEIGH DICKINSON UNIV-ED WMS CLG     ,NJ,07601-0000,Private      ,0,4,4,136,112,248
00260703,FAIRLEIGH DICKINSON UNIVERSITY          ,NJ,07940-0000,Private      ,5,6,11,1595,666,2261
00260800,GEORGIAN COURT UNIVERSITY               ,NJ,08701-2697,Private      ,2,15,17,1388,1588,2976
00260900,ROWAN UNIVERSITY                        ,NJ,08028-1702,Public       ,18,45,63,10887,3251,14138
00261000,FELICIAN COLLEGE                        ,NJ,07644-2198,Private      ,6,25,31,1680,1132,2812
00261300,NEW JERSEY CITY UNIVERSITY              ,NJ,07305-1597,Public       ,12,69,81,4429,4627,9056
00261500,MIDDLESEX COUNTY COLLEGE                ,NJ,08818-3050,Public       ,38,72,110,5544,3625,9169
00261600,MONMOUTH UNIVERSITY                     ,NJ,07764-1898,Private      ,13,43,56,6927,2023,8950
00261700,MONTCLAIR STATE UNIVERSITY              ,NJ,07043-9987,Public       ,40,74,114,14673,5509,20182
00261900,NEW BRUNSWICK THEOLOGICAL SEMINARY      ,NJ,08901-0000,Private      ,0,2,2,23,108,131
00262100,NEW JERSEY INST OF TECHNOLOGY           ,NJ,07102-1982,Public       ,17,25,42,4470,1959,6429
00262200,KEAN UNIVERSITY                         ,NJ,07083-7131,Public       ,42,60,102,9444,6094,15538
00262400,OCEAN COUNTY COLLEGE                    ,NJ,08754-2001,Public       ,29,59,88,4573,2871,7444
00262500,WILLIAM PATERSON UNIVERSITY             ,NJ,07470-2152,Public       ,30,44,74,9185,3247,12432
00262600,PRINCETON THEOLOGICAL SEMINARY          ,NJ,08542-0000,Private      ,0,1,1,8,579,587
00262700,PRINCETON UNIVERSITY                    ,NJ,08544-0001,Private      ,6,10,16,12808,1277,14085
00262800,RIDER UNIVERSITY                        ,NJ,08648-3099,Private      ,12,24,36,6395,1449,7844
00262900,"RUTGERS, THE STATE UNIVERSITY OF NJ     ",NJ,08901-1281,Public       ,98,180,278,39624,17565,57189
00263200,SETON HALL UNIVERSITY                   ,NJ,07079-2697,Private      ,17,30,47,9229,3181,12410
00263201,SETON HALL UNIVERSITY - SCHOOL OF LAW   ,NJ,07079-5210,Private      ,0,5,5,190,2119,2309
00263800,ST PETER'S COLLEGE                      ,NJ,07306-5997,Private      ,6,34,40,3236,1036,4272
00263900,STEVENS INSTITUTE OF TECHNOLOGY         ,NJ,07030-5370,Private      ,5,8,13,3024,470,3494
00264200,COLLEGE OF NEW JERSEY (THE)             ,NJ,08628-0718,Public       ,15,34,49,9620,1008,10628
00264300,UNION COUNTY COLLEGE                    ,NJ,07016-1598,Public       ,50,157,207,4329,5761,10090
00473600,BERGEN COMMUNITY COLLEGE                ,NJ,07652-1595,Public       ,31,77,108,6134,3777,9911
00474000,MERCER COUNTY COMMUNITY COLLEGE         ,NJ,08690-0000,Public       ,37,111,148,2847,3753,6600
00539900,MONMOUTH COUNTY VOCATIONAL SCH DIST     ,NJ,07728-5033,Public       ,0,0,0,40,72,112
00545200,TETERBORO SCH OF AERONAUTICS            ,NJ,07608-1083,Proprietary  ,0,3,3,82,98,180
00546000,SOMERSET COUNTY TECHNICAL INSTITUTE     ,NJ,08807-0350,Public       ,0,1,1,47,131,178
00546100,SALEM COMMUNITY COLLEGE                 ,NJ,08069-2799,Public       ,6,14,20,553,647,1200
00641000,C E GREGORY SCHOOL OF NURSING           ,NJ,08857-0000,Private      ,0,0,0,22,31,53
00641700,HOLY NAME HOSPITAL SCH OF NURSING       ,NJ,07666-4254,Private      ,1,0,1,86,143,229
00642000,MOUNTAINSIDE HOSP SCH NRSG              ,NJ,07042-4898,Proprietary  ,0,0,0,39,142,181
00642100,MUHLENBERG SNYDER SCHOOLS               ,NJ,07061-3399,Private      ,0,2,2,129,446,575
00642900,ST FRANCIS MEDICAL CTR SCH NURSING      ,NJ,08629-1986,Private      ,0,1,1,24,54,78
00642902,ST FRANCIS MED CTR RAD TECH             ,NJ,08629-0000,Private      ,1,0,1,6,9,15
00686500,CAMDEN COUNTY COLLEGE                   ,NJ,08012-3240,Public       ,49,182,231,5980,7065,13045
00690100,GLOUCESTER COUNTY COLLEGE               ,NJ,08080-4249,Public       ,17,52,69,2724,2063,4787
00710700,ESSEX COUNTY COLLEGE                    ,NJ,07102-1798,Public       ,40,140,180,4815,6786,11601
00736203,STUART SCHOOL OF BUSINESS ADMINISTRATION,NJ,07719-3970,Proprietary  ,0,0,0,7,60,67
00750200,BERKELEY COLLEGE                        ,NJ,07424-3367,Proprietary  ,13,25,38,1758,1643,3401
00750201,BERKELEY COLLEGE                        ,NJ,07095-0000,Proprietary  ,9,7,16,674,528,1202
00750202,BERKELEY COLLEGE - PARAMUS              ,NJ,07652-2931,Proprietary  ,2,4,6,480,370,850
00750600,LINCOLN TECHNICAL INSTITUTE             ,NJ,07083-5032,Proprietary  ,67,143,210,994,1291,2285
00750601,LINCOLN TECHNICAL INSTITUTE             ,NJ,07430-0000,Proprietary  ,30,49,79,644,499,1143
00750700,GIBBS COLLEGE                           ,NJ,07039-1611,Proprietary  ,0,1,1,340,498,838
00750701,KATHARINE GIBBS - PISCATAWAY            ,NJ,08854-0000,Proprietary  ,0,0,0,94,133,227
00759300,PARISIAN BEAUTY ACADEMY                 ,NJ,07601-5509,Proprietary  ,7,6,13,131,148,279
00772900,COUNTY COLLEGE OF MORRIS                ,NJ,07869-0000,Public       ,27,24,51,2885,1356,4241
00773000,BURLINGTON COUNTY COLLEGE               ,NJ,08068-1599,Public       ,35,98,133,3236,3090,6326
00773100,RARITAN VALLEY COMMUNITY COLLEGE        ,NJ,08876-1265,Public       ,16,50,66,1846,1409,3255
00780401,CAREER ACADEMY OF NEW YORK - STAR LAKEWO,NJ,08701-5900,Proprietary  ,3,34,37,31,144,175
00780402,CAREER ACADEMY OF NEW YORK - STAR EGG HA,NJ,08234-4863,Proprietary  ,4,30,34,28,150,178
00794700,BETH MEDRASH GOVOHA OF AMERICA          ,NJ,08701-0000,Private      ,51,103,154,376,1835,2211
00840400,BROOKDALE COMMUNITY COLLEGE             ,NJ,07738-1597,Public       ,40,88,128,5324,3456,8780
00844101,ANTHEM INSTITUTE                        ,NJ,08002-0000,Proprietary  ,1,2,3,16,47,63
00849400,HO HO KUS SCHL OF TRADE & TECH SCIENCES ,NJ,07513-1402,Proprietary  ,7,27,34,95,234,329
00860900,RABBINICAL COLLEGE OF AMERICA           ,NJ,07960-3600,Private      ,8,1,9,93,10,103
00907800,CAPRI INSTITUTE OF HAIR DESIGN          ,NJ,07011-2111,Proprietary  ,10,15,25,88,150,238
00934400,RAMAPO COLLEGE OF NEW JERSEY            ,NJ,07430-1680,Public       ,8,10,18,5842,862,6704
00934500,RICHARD STOCKTON COLLEGE OF NJ          ,NJ,08240-0195,Public       ,10,22,32,6788,2347,9135
00982804,EVEREST INSTITUTE - SOUTH PLAINFIELD    ,NJ,07080-1125,Proprietary  ,17,78,95,175,589,764
00999400,PASSAIC COUNTY COMMUNITY COLLEGE        ,NJ,07505-1179,Public       ,46,161,207,3057,3877,6934
01039400,UNIV OF MEDICINE & DENTISTRY OF NJ      ,NJ,07107-0000,Public       ,6,39,45,207,4425,4632
01062900,P B COSMETOLOGY EDUCATION CENTRE        ,NJ,08030-1750,Proprietary  ,2,6,8,126,121,247
01085100,ANTHEM INSTITUTE                        ,NJ,07054-3409,Proprietary  ,40,115,155,859,1636,2495
01085101,ANTHEM INSTITUTE                        ,NJ,07306-0000,Proprietary  ,2,3,5,51,59,110
01085102,ANTHEM INSTITUTE                        ,NJ,08902-0000,Proprietary  ,1,0,1,35,56,91
01090300,RIZZIERI INSTITUTE                      ,NJ,08053-1800,Proprietary  ,0,5,5,102,115,217
01152300,MORRIS COUNTY SCHOOL OF TECHNOLOGY      ,NJ,07834-0000,Public       ,0,0,0,42,37,79
01170800,NATURAL MOTION INST OF HAIR DESIGN      ,NJ,07306-5496,Proprietary  ,3,6,9,57,121,178
01198900,TALMUDICAL ACADEMY                      ,NJ,07710-0000,Private      ,1,1,2,37,2,39
01209000,REIGNBOW BEAUTY ACADEMY                 ,NJ,08861-4118,Proprietary  ,6,19,25,54,189,243
01234600,DOVER BUSINESS COLLEGE                  ,NJ,07652-0000,Proprietary  ,6,19,25,308,775,1083
01234602,DOVER BUSINESS COLLEGE                  ,NJ,07801-4643,Proprietary  ,2,12,14,132,376,508
01246100,LINCOLN TECHNICAL INSTITUTE             ,NJ,08820-2896,Proprietary  ,19,51,70,472,796,1268
01246102,LINCOLN TECHNICAL INSTITUTE             ,NJ,08054-0000,Proprietary  ,17,72,89,265,947,1212
01246103,LINCOLN TECHNICAL INSTITUTE             ,NJ,07652-2106,Proprietary  ,17,68,85,367,788,1155
01246200,HOHOKUS - HACKENSACK SCHOOL OF BUSINESS ,NJ,07601-7197,Proprietary  ,14,84,98,200,923,1123
01295400,HUDSON COUNTY COMMUNITY COLLEGE         ,NJ,07306-4012,Public       ,39,111,150,3869,5026,8895
02053700,EASTWICK COLLEGE                        ,NJ,07446-0000,Proprietary  ,15,39,54,295,850,1145
02061800,ROMAN ACADEMY OF BEAUTY CULTURE         ,NJ,07506-0000,Proprietary  ,4,12,16,41,48,89
02092300,HOHOKUS SCHOOL - RETS/NUTLEY            ,NJ,07110-0000,Proprietary  ,14,72,86,249,559,808
02103700,CAPRI INSTITUTE OF HAIR DESIGN          ,NJ,07652-0000,Proprietary  ,3,7,10,58,92,150
02104000,HARRIS SCHOOL OF BUSINESS               ,NJ,08002-2983,Proprietary  ,34,170,204,342,1715,2057
02106601,FOX INSTITUTE OF BUSINESS - CLIFTON     ,NJ,07011-2345,Proprietary  ,16,46,62,90,281,371
02131100,DU CRET SCHOOL OF THE ARTS              ,NJ,07060-0000,Private      ,3,0,3,28,13,41
02131600,PENNCO TECH                             ,NJ,08012-0000,Proprietary  ,21,52,73,460,794,1254
02132300,BERDAN INSTITUTE                        ,NJ,07512-0000,Proprietary  ,10,57,67,268,531,799
02146800,JOE KUBERT SCH OF CARTOON & GRAPHIC     ,NJ,07801-0000,Proprietary  ,0,0,0,63,38,101
02149800,EMPIRE BEAUTY SCHOOL                    ,NJ,08021-0000,Proprietary  ,12,37,49,164,466,630
02149801,EMPIRE BEAUTY SCHOOL - BORDENTOWN       ,NJ,08505-1513,Proprietary  ,0,0,0,5,7,12
02154000,DIVERS ACAD OF EASTERN SEABOARD         ,NJ,08081-1139,Proprietary  ,10,19,29,84,207,291
02183600,CAPRI INSTITUTE OF HAIR DESIGN          ,NJ,07033-0000,Proprietary  ,8,9,17,66,125,191
02192200,THOMAS EDISON STATE COLLEGE             ,NJ,08608-0000,Public       ,1,107,108,283,4466,4749
02219600,OMEGA INSTITUTE                         ,NJ,08109-0000,Proprietary  ,2,18,20,58,185,243
02223700,NEW HORIZON INST OF COSMETOLOGY         ,NJ,07093-0000,Proprietary  ,1,22,23,25,203,228
02223900,DRAKE COLLEGE OF BUSINESS               ,NJ,07201-0000,Proprietary  ,86,451,537,543,3850,4393
02232500,UNION COUNTY VOCATIONAL TECH INST       ,NJ,07076-0000,Public       ,2,7,9,69,97,166
02234600,SHORE BEAUTY SCHOOL                     ,NJ,08232-0000,Proprietary  ,3,11,14,58,104,162
02246000,ROSS UNIVERSITY - MEDICAL SCHOOL        ,NJ,08837-0000,Proprietary  ,3,59,62,26,4225,4251
02248600,COOPER HEALTH SYS-CTR ALLIED HEALTH     ,NJ,08103-0000,Private      ,0,1,1,18,67,85
02252700,CONCORDE SCHOOL OF HAIR DESIGN          ,NJ,07712-0000,Proprietary  ,7,44,51,132,307,439
02252701,CONCORDE SCHOOL OF HAIR DESIGN - BLOOMFI,NJ,07003-2517,Proprietary  ,0,1,1,1,15,16
02261800,EUROPEAN ACADEMY OF COSMETOLOGY         ,NJ,07083-0000,Proprietary  ,2,17,19,56,176,232
02265500,CAPRI INSTITUTE OF HAIR DESIGN          ,NJ,08724-0000,Proprietary  ,0,3,3,91,122,213
02277900,ROSS UNIV - SCH OF VETERINARY MED       ,NJ,08837-0000,Proprietary  ,0,15,15,4,1015,1019
02291000,ENGINE CITY TECHNICAL INSTITUTE         ,NJ,07080-2424,Proprietary  ,4,20,24,141,110,251
02312000,BERGEN COUNTY TECHNICAL SCHOOLS         ,NJ,07601-6110,Public       ,0,0,0,44,69,113
02344200,EMPIRE BEAUTY SCHOOL                    ,NJ,08002-0000,Proprietary  ,10,22,32,151,301,452
02503900,WARREN COUNTY COMMUNITY COLLEGE         ,NJ,07882-0000,Public       ,2,4,6,593,441,1034
02523700,OCEAN COUNTY VOCATIONAL-TECH SCHOOL     ,NJ,08753-0000,Public       ,0,3,3,118,180,298
02525900,ARTISTIC ACADEMY OF HAIR DESIGN         ,NJ,07950-1409,Proprietary  ,0,5,5,110,75,185
02528200,REIGNBOW BEAUTY ACADEMY                 ,NJ,07060-0000,Proprietary  ,5,8,13,41,103,144
02539903,STAR TECHNICAL INSTITUTE-EGG HARBOR     ,NJ,08234-0000,Proprietary  ,0,0,0,34,158,192
02558700,PRISM CAREER INSTITUTE                  ,NJ,08037-0000,Proprietary  ,20,152,172,250,1244,1494
02568800,SUSSEX COUNTY COMMUNITY COLLEGE         ,NJ,07860-1149,Public       ,4,22,26,1387,799,2186
02586900,HARRIS SCHOOL OF BUSINESS               ,NJ,08084-1520,Proprietary  ,8,76,84,71,402,473
02586901,STAR TECHNICAL INSTITUTE - LAKEWOOD     ,NJ,08701-0000,Proprietary  ,0,0,0,56,179,235
02615401,STAR TECHNICAL INSTITUTE -              ,NJ,07102-4599,Proprietary  ,0,0,0,58,429,487
02616402,SANFORD-BROWN INSTITUTE - ISELIN        ,NJ,08830-0000,Proprietary  ,32,101,133,491,1335,1826
03077500,RABBI JACOB JOSEPH SCHOOL               ,NJ,08817-4494,Private      ,0,0,0,12,0,12
03122600,EASTERN INTERNATIONAL COLLEGE           ,NJ,07306-3906,Proprietary  ,16,58,74,168,507,675
03187300,STENOTECH CAREER INSTITUTE              ,NJ,07004-3490,Proprietary  ,0,2,2,33,78,111
03197300,INSTITUTE FOR HEALTH EDUCATION(THE)     ,NJ,07306-2929,Proprietary  ,1,18,19,27,163,190
03324300,CENTRAL CAREER SCHOOL                   ,NJ,07080-2408,Proprietary  ,1,11,12,11,82,93
03380302,CULINARY ACADEMY OF LONG ISLAND - STAR N,NJ,07102-4510,Proprietary  ,13,53,66,39,188,227
03389300,ACADEMY OF MASSAGE THERAPY              ,NJ,07631-0000,Proprietary  ,3,19,22,40,196,236
03424500,NEW COMMUNITY WORKFORCE DEVELOPMENT     ,NJ,07103-2402,Private      ,6,29,35,36,424,460
03530300,"KEY SKILLS LEARNING, INC.               ",NJ,07013-1900,Proprietary  ,1,4,5,6,49,55
03536300,INSTITUTE FOR THERAPEUTIC MASSAGE       ,NJ,07420-1452,Proprietary  ,1,12,13,34,195,229
03574400,CORTIVA INSTITUTE - SOMERSET SCHOOL OF M,NJ,08854-3908,Proprietary  ,3,9,12,36,143,179
03625300,PERFORMANCE TRAINING INSTITUTE          ,NJ,08753-0000,Proprietary  ,0,0,0,3,7,10
03629300,HELMA INSTITUTE OF MASSAGE THERAPY      ,NJ,07663-6200,Proprietary  ,0,0,0,0,2,2
03637300,METRO AUTO ELECTRONICS TRAINING INSTITUT,NJ,07033-1798,Proprietary  ,4,6,10,52,80,132
03650600,PC AGE                                  ,NJ,07306-3936,Proprietary  ,2,24,26,17,130,147
03650603,PC AGE                                  ,NJ,08817-2842,Proprietary  ,0,0,0,7,24,31
03666300,SOMERSET CHRISTIAN COLLEGE              ,NJ,08890-9035,Private      ,0,18,18,51,244,295
03769300,PC TECH LEARNING CENTER                 ,NJ,07306-9900,Proprietary  ,6,59,65,50,335,385
03803300,HEALTHCARE TRAINING INSTITUTE           ,NJ,07083-3504,Proprietary  ,4,20,24,48,282,330
03811300,EASTERN SCHOOL OF ACUPUNCTURE AND TRADIT,NJ,07042-3562,Proprietary  ,0,3,3,3,50,53
04081300,BAIS MEDRASH TORAS CHESED               ,NJ,08701-0000,Private      ,0,0,0,25,2,27
04123400,YESHIVAS BE'ER YITZCHOK                 ,NJ,07208-2380,Private      ,1,1,2,3,13,16
04125000,GENTLE HEALING SCHOOL OF MASSAGE        ,NJ,08512-3600,Proprietary  ,2,0,2,6,29,35
04131100,YESHIVA TORAS CHAIM                     ,NJ,08701-2120,Private      ,1,0,1,44,0,44
04131200,TOTAL IMAGE BEAUTY ACADEMY              ,NJ,07307-2943,Proprietary  ,0,8,8,1,14,15
04134100,CENTER FOR ALLIED HEALTH & NURSING EDUCA,NJ,07601-5801,Proprietary  ,2,22,24,46,295,341
04136400,AMERICAN INSTITUTE OF MEDICAL SCIENCES &,NJ,07080-1183,Proprietary  ,0,10,10,5,50,55
        ,BROOKLYN LAW SCHOOL                     ,NY,11201-0000,Private      ,0,0,0,41,3249,3290
00266500,VAUGHN COLLEGE OF AERONAUTICS AND TECHNO,NY,11369-9997,Private      ,5,1,6,853,535,1388
00266600,ADELPHI UNIVERSITY                      ,NY,11530-4299,Private      ,17,27,44,6800,4552,11352
00266700,DOWLING COLLEGE                         ,NY,11769-1999,Private      ,8,25,33,2613,2275,4888
00266800,ALFRED UNIVERSITY                       ,NY,14802-1205,Private      ,5,4,9,3083,549,3632
00266900,BANK STREET COLLEGE OF EDUCATION        ,NY,10025-0000,Private      ,0,14,14,6,847,853
00267100,BARD COLLEGE                            ,NY,12504-5000,Private      ,0,3,3,2793,553,3346
00267700,BROOKLYN LAW SCHOOL                     ,NY,11201-0000,Private      ,0,32,32,3,48,51
00267800,BRYANT & STRATTON COLLEGE               ,NY,14203-1713,Proprietary  ,124,672,796,1965,7806,9771
00267803,BRYANT & STRATTON COLLEGE - GREECE      ,NY,14606-4227,Proprietary  ,10,98,108,276,1109,1385
00267805,BRYANT & STRATTON COLLEGE - SYRACUSE    ,NY,13203-2502,Proprietary  ,36,103,139,680,1724,2404
00267807,BRYANT & STRATTON COLLEGE - ALBANY      ,NY,12205-5230,Proprietary  ,12,70,82,290,906,1196
00268100,CANISIUS COLLEGE                        ,NY,14208-1098,Private      ,9,20,29,4361,1525,5886
00268500,CAZENOVIA COLLEGE                       ,NY,13035-1085,Private      ,3,1,4,1722,117,1839
00268700,CUNY-BROOKLYN COLLEGE                   ,NY,11210-2814,Public       ,68,49,117,13720,8457,22177
00268800,CITY COLLEGE-CUNY                       ,NY,10031-9198,Public       ,67,39,106,14879,6804,21683
00268900,CUNY-HUNTER COLLEGE                     ,NY,10021-5024,Public       ,84,87,171,21478,10614,32092
00269000,QUEENS COLLEGE-CUNY                     ,NY,11367-1597,Public       ,62,54,116,12810,6783,19593
00269100,CUNY- BOROUGH OF MANHATTAN CMTY CLG     ,NY,10007-1047,Public       ,86,126,212,16605,11617,28222
00269200,CUNY BRONX COMMUNITY COLLEGE            ,NY,10453-3102,Public       ,31,33,64,7603,6785,14388
00269300,CUNY-JOHN JAY CLG CRIMINAL JUSTICE      ,NY,10019-1093,Public       ,35,32,67,12243,5799,18042
00269400,KINGSBOROUGH COMMUNITY COLLEGE          ,NY,11235-2398,Public       ,56,41,97,9157,5139,14296
00269600,NY CITY COLLEGE OF TECHNOLOGY-CUNY      ,NY,11201-2983,Public       ,52,48,100,11603,6463,18066
00269700,QUEENSBOROUGH COMMUNITY COLLEGE         ,NY,11364-1497,Public       ,48,36,84,7940,3912,11852
00269800,CUNY THE COLLEGE OF STATEN ISLAND       ,NY,10314-6600,Public       ,74,19,93,8898,3814,12712
00269900,CLARKSON UNIVERSITY                     ,NY,13699-5615,Private      ,2,1,3,3886,270,4156
00270000,COLGATE ROCHESTER CROZER DIVINITY S     ,NY,14620-0000,Private      ,0,0,0,7,83,90
00270100,COLGATE UNIVERSITY                      ,NY,13346-1386,Private      ,4,0,4,4664,58,4722
00270300,COLLEGE OF MOUNT SAINT VINCENT          ,NY,10471-1093,Private      ,1,4,5,2213,333,2546
00270400,COLLEGE OF NEW ROCHELLE                 ,NY,10805-2339,Private      ,5,63,68,1258,5521,6779
00270500,COLLEGE OF SAINT ROSE                   ,NY,12203-1490,Private      ,3,12,15,4042,2128,6170
00270700,COLUMBIA UNIVERSITY                     ,NY,10027-0000,Private      ,3,39,42,3971,3296,7267
00270701,COLUMBIA UNIV ARCHITECTURE              ,NY,10027-0000,Private      ,0,2,2,42,722,764
00270702,COLUMBIA UNIV SCHOOL OF THE ARTS        ,NY,10027-0000,Private      ,0,2,2,96,1281,1377
00270703,COLUMBIA UNIV BUSINESS GRAD             ,NY,10027-0000,Private      ,0,15,15,35,1565,1600
00270704,COLUMBIA UNIV SCHOOL ENGIN-UNDERGRA     ,NY,10027-0000,Private      ,1,2,3,1856,61,1917
00270705,COLUMBIA UNIV SCHOOL GENERAL STUDIE     ,NY,10027-0000,Private      ,0,9,9,414,1149,1563
00270706,COLUMBIA UNIV GRAD SCHL ARTS & SCI      ,NY,10027-0000,Private      ,1,18,19,32,1631,1663
00270707,COLUMBIA UNIV SCH INTL PUB AFFAIRS      ,NY,10027-0000,Private      ,0,14,14,14,1381,1395
00270708,COLUMBIA UNIV JOURNALISM GRAD           ,NY,10027-0000,Private      ,0,3,3,18,455,473
00270710,COLUMBIA UNIV COLUMBIA COLLEGE          ,NY,10027-0000,Private      ,4,4,8,8201,303,8504
00270711,COLUMBIA UNIV SCHOOL OF LAW             ,NY,10027-0000,Private      ,0,1,1,31,4136,4167
00270712,COLUMBIA UNIV SOCIAL WORK               ,NY,10025-0000,Private      ,0,2,2,15,908,923
00270713,COLUMBIA UNIV SCHL DENT & ORAL SURG     ,NY,10032-0000,Private      ,0,1,1,4,328,332
00270714,COLUMBIA UNIV INST HUMAN NUTRITION      ,NY,10032-0000,Private      ,0,0,0,3,56,59
00270715,COLUMBIA UNIV NURSING                   ,NY,10032-0000,Private      ,1,2,3,114,716,830
00270716,COLUMBIA UNIV COLL PHYS & SURGEONS      ,NY,10032-0000,Private      ,0,3,3,22,1100,1122
00270717,COLUMBIA UNIV PHYSICAL THERAPY          ,NY,10032-0000,Private      ,0,0,0,6,121,127
00270718,COLUMBIA UNIV OCCUPATIONAL THERAPY      ,NY,10032-0000,Private      ,0,0,0,5,109,114
00270719,COLUMBIA UNIV PUBLIC HEALTH             ,NY,10032-0000,Private      ,0,2,2,6,1001,1007
00270720,COLUMBIA UNIV - ENGINEERING (GRAD)      ,NY,10027-0000,Private      ,0,3,3,49,333,382
00270721,COLUMBIA UNIV-CONT ED & SP PROGMS       ,NY,10027-0000,Private      ,1,6,7,16,315,331
00270800,BARNARD COLLEGE-COLUMBIA UNIV           ,NY,10027-6598,Private      ,6,0,6,3449,113,3562
00270900,CONCORDIA COLLEGE                       ,NY,10708-1998,Private      ,1,4,5,817,217,1034
00271000,COOPER UNION                            ,NY,10003-7120,Private      ,4,1,5,1613,144,1757
00271100,CORNELL UNIVERSITY                      ,NY,14853-2801,Private      ,27,39,66,23468,5449,28917
00271200,D'YOUVILLE COLLEGE                      ,NY,14201-1084,Private      ,1,5,6,1471,1483,2954
00271300,DOMINICAN COLLEGE                       ,NY,10962-1299,Private      ,7,24,31,1546,828,2374
00271800,ELMIRA COLLEGE                          ,NY,14901-2099,Private      ,3,12,15,2025,567,2592
00272200,FORDHAM UNIVERSITY                      ,NY,10458-5157,Private      ,27,57,84,18635,8937,27572
00272600,GENERAL THEOLOGICAL SEMINARY            ,NY,10011-0000,Private      ,0,0,0,0,118,118
00272800,HAMILTON COLLEGE                        ,NY,13323-1218,Private      ,1,0,1,2713,31,2744
00272900,HARTWICK COLLEGE                        ,NY,13820-4020,Private      ,3,1,4,2521,65,2586
00273100,HOBART & WILLIAM SMITH COLLEGES         ,NY,14456-3397,Private      ,2,1,3,3166,49,3215
00273200,HOFSTRA UNIVERSITY                      ,NY,11549-1010,Private      ,46,25,71,15148,5834,20982
00273400,HOUGHTON COLLEGE                        ,NY,14744-0128,Private      ,2,3,5,1499,258,1757
00273500,HILBERT COLLEGE                         ,NY,14075-1597,Private      ,3,1,4,1008,328,1336
00273700,IONA COLLEGE                            ,NY,10801-1890,Private      ,6,7,13,6176,1163,7339
00273900,ITHACA COLLEGE                          ,NY,14850-7130,Private      ,6,1,7,12171,685,12856
00274000,JEWISH THEOLOGICAL SEMINARY OF AMER     ,NY,10027-4649,Private      ,0,2,2,122,187,309
00274200,THE JUILLIARD SCHOOL                    ,NY,10023-6588,Private      ,4,0,4,1151,569,1720
00274400,KEUKA COLLEGE                           ,NY,14478-0000,Private      ,1,18,19,1327,1043,2370
00274800,LEMOYNE COLLEGE                         ,NY,13214-1399,Private      ,5,4,9,3988,974,4962
00274900,NEW YORK COLLEGE OF PODIATRIC MED       ,NY,10035-0000,Private      ,2,1,3,60,387,447
00275100,LONG ISLAND UNIVERSITY                  ,NY,11548-1326,Private      ,43,111,154,10990,9754,20744
00275101,LONG ISLAND UNIVERSITY - BRENTWOOD CAMPU,NY,11717-5326,Private      ,0,0,0,12,41,53
00275102,LONG ISLAND UNIVERSITY - ROCKLAND CAMPUS,NY,10962-0000,Private      ,0,0,0,5,21,26
00275104,LONG ISLAND UNIVERSITY - NEW YORK UNIVER,NY,10011-0000,Private      ,0,0,0,114,52,166
00275105,LONG ISLAND UNIVERSITY - WEST POINT CAMP,NY,10966-0000,Private      ,0,0,0,59,4,63
00275106,LONG ISLAND UNIVERSITY - JEWISH BOARD OF,NY,10019-0000,Private      ,0,0,0,8,2,10
00275107,LONG ISLAND UNIVERSITY - QUEENS DISTRICT,NY,11364-0000,Private      ,0,0,0,8,3,11
00275108,LONG ISLAND UNIVERSITY - FREEPORT PUBLIC,NY,11520-3144,Private      ,0,0,0,5,1,6
00275109,LONG ISLAND UNIVERSITY - LOCUST VALLEY H,NY,11560-1105,Private      ,0,0,0,1,1,2
00275110,LONG ISLAND UNIVERSITY - WESTBURY SENIOR,NY,11568-1619,Private      ,0,0,0,119,24,143
00275111,LONG ISLAND UNIVERSITY - BABYLON SENIOR ,NY,11702-2222,Private      ,0,0,0,5,0,5
00275112,LONG ISLAND UNIVERSITY - HARBORFIELDS HI,NY,11740-1432,Private      ,0,0,0,1,0,1
00275113,LONG ISLAND UNIVERSITY - SOUTH SIDE HIGH,NY,11570-2248,Private      ,0,0,0,0,2,2
00275115,LONG ISLAND UNIVERSITY - SOUTHAMPTON COL,NY,11548-1326,Private      ,0,0,0,182,33,215
00275116,LONG ISLAND UNIV-BROOKLYN CAMPUS        ,NY,11548-1326,Private      ,0,0,0,645,138,783
00275800,MANHATTAN COLLEGE                       ,NY,10471-4098,Private      ,11,11,22,5219,391,5610
00275900,MANHATTAN SCHOOL OF MUSIC               ,NY,10027-4698,Private      ,0,0,0,668,739,1407
00276000,MANHATTANVILLE COLLEGE                  ,NY,10577-2132,Private      ,5,11,16,2855,984,3839
00276300,MARIA COLLEGE                           ,NY,12208-1798,Private      ,0,8,8,231,700,931
00276500,MARIST COLLEGE                          ,NY,12601-1387,Private      ,5,26,31,8493,1050,9543
00276900,MARYMOUNT MANHATTAN COLLEGE             ,NY,10021-4597,Private      ,6,1,7,2909,273,3182
00277200,MERCY COLLEGE                           ,NY,10522-1189,Private      ,35,182,217,2908,7108,10016
00277500,MOLLOY COLLEGE                          ,NY,11570-1100,Private      ,9,16,25,2524,1644,4168
00277700,MEDAILLE COLLEGE                        ,NY,14214-2695,Private      ,5,20,25,1516,1486,3002
00277800,MOUNT SAINT MARY COLLEGE                ,NY,12550-3494,Private      ,4,10,14,2327,1039,3366
00277900,NAZARETH COLLEGE OF ROCHESTER           ,NY,14618-3790,Private      ,2,12,14,3013,1514,4527
00278200,NEW YORK INSTITUTE OF TECHNOLOGY        ,NY,11568-8000,Private      ,17,29,46,4750,3876,8626
00278202,NY INSTITUTE OF TECHNOLOGY-OSTEOPATHIC M,NY,11568-0000,Private      ,1,0,1,75,1209,1284
00278300,NEW YORK LAW SCHOOL                     ,NY,10013-0000,Private      ,1,5,6,27,3303,3330
00278400,NEW YORK MEDICAL COLLEGE                ,NY,10595-0000,Private      ,0,1,1,14,1929,1943
00278500,NEW YORK UNIVERSITY                     ,NY,10012-1091,Private      ,41,123,164,32672,24808,57480
00278800,NIAGARA UNIVERSITY                      ,NY,14109-2010,Private      ,4,10,14,3777,776,4553
00279000,NYACK COLLEGE                           ,NY,10960-3698,Private      ,4,64,68,1314,2308,3622
00279100,PACE UNIVERSITY - NEW YORK              ,NY,10038-1598,Private      ,8,54,62,7414,2910,10324
00279101,PACE UNIVERSITY-PLEASANTVILLE           ,NY,10570-0000,Private      ,8,19,27,3284,1040,4324
00279102,PACE UNIVERSITY - WHITE PLAINS          ,NY,10603-0000,Private      ,2,13,15,272,2157,2429
00279500,PAUL SMITHS CLG OF ARTS & SCIENCES      ,NY,12970-0000,Private      ,2,0,2,1151,133,1284
00279600,POLYTECHNIC INTSTITUTE OF NEW YORK UNIV ,NY,11201-3840,Private      ,5,6,11,1899,751,2650
00279800,PRATT INSTITUTE                         ,NY,11205-3899,Private      ,11,6,17,4442,2316,6758
00280300,RENSSELAER POLYTECHNIC INSTITUTE        ,NY,12180-3590,Private      ,3,5,8,9420,569,9989
00280500,ROBERTS WESLEYAN COLLEGE                ,NY,14624-1997,Private      ,0,37,37,1532,1252,2784
00280600,ROCHESTER INSTITUTE OF TECHNOLOGY       ,NY,14623-5608,Private      ,21,19,40,13693,2792,16485
00280700,ROCKEFELLER UNIVERSITY                  ,NY,10021-0000,Private      ,0,0,0,20,17,37
00280800,DAEMEN COLLEGE                          ,NY,14226-3592,Private      ,2,11,13,1902,889,2791
00281000,THE SAGE COLLEGES                       ,NY,12180-4199,Private      ,6,7,13,1267,1582,2849
00281200,TROCAIRE COLLEGE                        ,NY,14220-2094,Private      ,6,21,27,552,1208,1760
00281300,SARAH LAWRENCE COLLEGE                  ,NY,10708-5999,Private      ,2,3,5,2201,659,2860
00281400,SKIDMORE COLLEGE                        ,NY,12866-1632,Private      ,5,1,6,4247,106,4353
00281401,SKIDMORE COLL-UNIV WITHOUT WALLS        ,NY,12866-0000,Private      ,0,0,0,23,40,63
00281500,ST BERNARDS SCH THEOLOGY & MINISTRY     ,NY,14618-3822,Private      ,0,1,1,1,50,51
00281600,SIENA COLLEGE                           ,NY,12211-1462,Private      ,5,0,5,5445,211,5656
00281700,ST BONAVENTURE UNIVERSITY               ,NY,14778-2284,Private      ,1,2,3,2345,523,2868
00282000,ST FRANCIS COLLEGE                      ,NY,11201-4398,Private      ,8,4,12,2065,479,2544
00282100,ST JOHN FISHER COLLEGE                  ,NY,14618-3597,Private      ,3,14,17,4284,1563,5847
00282200,CHRIST THE KING SEMINARY                ,NY,14052-0607,Private      ,0,0,0,0,11,11
00282300,ST JOHN'S UNIVERSITY                    ,NY,11439-1343,Private      ,27,36,63,21448,5977,27425
00282500,ST JOSEPH'S COLLEGE                     ,NY,11205-3688,Private      ,3,7,10,964,634,1598
00282501,ST JOSEPH'S COLLEGE-SUFFOLK CAMPUS      ,NY,11772-0000,Private      ,9,8,17,3031,1234,4265
00282900,ST LAWRENCE UNIVERSITY                  ,NY,13617-1455,Private      ,3,1,4,3020,108,3128
00283200,ST THOMAS AQUINAS COLLEGE               ,NY,10976-1050,Private      ,8,1,9,1789,303,2092
00283300,ST VLADIMIR ORTHODOX THEOL SEM          ,NY,10707-0000,Private      ,0,0,0,0,64,64
00283400,EXCELSIOR COLLEGE                       ,NY,12203-5159,Private      ,10,245,255,173,5285,5458
00283500,SUNY AT ALBANY                          ,NY,12222-0001,Public       ,47,34,81,20122,5064,25186
00283600,BINGHAMTON UNIVERSITY (SUNY)            ,NY,13902-6000,Public       ,27,13,40,21333,2632,23965
00283700,SUNY AT BUFFALO                         ,NY,14260-0001,Public       ,42,29,71,20667,9791,30458
00283800,SUNY AT STONY BROOK                     ,NY,11794-0001,Public       ,55,73,128,21384,6550,27934
00283900,SUNY-DOWNSTATE MEDICAL CENTER           ,NY,11203-2098,Public       ,1,4,5,120,1846,1966
00284000,SUNY UPSTATE MEDICAL UNIVERSITY         ,NY,13210-2375,Public       ,1,4,5,190,1178,1368
00284100,SUNY BROCKPORT - FIN AID OFF            ,NY,14420-2914,Public       ,14,29,43,8624,2700,11324
00284200,BUFFALO STATE COLLEGE - SUNY            ,NY,14222-1095,Public       ,44,55,99,10906,4934,15840
00284300,SUNY COLLEGE-CORTLAND                   ,NY,13045-0900,Public       ,9,12,21,10405,1641,12046
00284400,SUNY AT FREDONIA                        ,NY,14063-1145,Public       ,15,6,21,6958,959,7917
00284500,SUNY GENESEO                            ,NY,14454-1401,Public       ,13,4,17,9164,554,9718
00284600,SUNY COLLEGE-NEW PALTZ                  ,NY,12561-2499,Public       ,24,13,37,10539,2032,12571
00284700,SUNY COLLEGE-ONEONTA                    ,NY,13820-4015,Public       ,18,8,26,9843,667,10510
00284800,SUNY OSWEGO                             ,NY,13126-3599,Public       ,14,10,24,9612,2026,11638
00284900,SUNY COLLEGE AT PLATTSBURGH             ,NY,12901-2681,Public       ,13,12,25,6607,1399,8006
00285000,SUNY COLLEGE-POTSDAM                    ,NY,13676-2294,Public       ,8,11,19,4462,1047,5509
00285100,SUNY COLLEGE OF ENVIRONMENT SCIENCE AND ,NY,13210-2778,Public       ,1,1,2,1870,510,2380
00285300,SUNY MARITIME COLLEGE                   ,NY,10465-4198,Public       ,2,4,6,1294,259,1553
00285400,SUNY COLLEGE OF TECHNOLOGY-ALFRED       ,NY,14802-9951,Public       ,5,4,9,3542,739,4281
00285500,SUNY CANTON COLG OF TECHNOLOGY          ,NY,13617-1098,Public       ,8,7,15,2613,1124,3737
00285600,SUNY AG & TECH COLLEGE-COBLESKILL       ,NY,12043-9986,Public       ,10,2,12,3013,411,3424
00285700,SUNY DELHI                              ,NY,13753-1190,Public       ,5,3,8,3368,654,4022
00285800,SUNY FARMINGDALE                        ,NY,11735-1021,Public       ,25,18,43,4961,1734,6695
00285900,SUNY COLLEGE OF AG & TECH AT MORRISVILLE,NY,13408-0901,Public       ,6,3,9,3476,927,4403
00286000,ADIRONDACK COMMUNITY COLLEGE            ,NY,12804-2004,Public       ,9,11,20,1780,1279,3059
00286100,CAYUGA COMMUNITY COLLEGE                ,NY,13021-3099,Public       ,20,61,81,1692,1759,3451
00286200,BROOME COMMUNITY COLLEGE                ,NY,13902-1398,Public       ,10,28,38,3542,2445,5987
00286300,CORNING COMMUNITY COLLEGE               ,NY,14830-3297,Public       ,25,103,128,1869,2072,3941
00286400,DUTCHESS COMMUNITY COLLEGE              ,NY,12601-1595,Public       ,46,64,110,2756,1835,4591
00286600,FASHION INSTITUTE OF TECHNOLOGY         ,NY,10001-5992,Public       ,7,16,23,6837,2431,9268
00286700,SUNY FULTON MONTGOMERY COMM CLG         ,NY,12095-3790,Public       ,7,14,21,1245,903,2148
00286800,HUDSON VALLEY COMMUNITY COLLEGE         ,NY,12180-6096,Public       ,31,25,56,6346,3611,9957
00286900,JAMESTOWN COMMUNITY COLLEGE             ,NY,14701-1999,Public       ,12,7,19,2299,1789,4088
00287000,JEFFERSON COMMUNITY COLLEGE             ,NY,13601-1897,Public       ,6,48,54,1339,1788,3127
00287100,"SUNY, MOHAWK VALLEY COMMUNITY CLG       ",NY,13501-5394,Public       ,13,29,42,3862,2343,6205
00287200,MONROE COMMUNITY COLLEGE                ,NY,14623-5780,Public       ,53,86,139,9423,7579,17002
00287300,NASSAU COMMUNITY COLLEGE                ,NY,11530-6793,Public       ,81,76,157,9941,4867,14808
00287400,NIAGARA COUNTY COMMUNITY COLLEGE        ,NY,14132-9460,Public       ,17,31,48,3555,2976,6531
00287500,ONONDAGA COMMUNITY COLLEGE              ,NY,13215-4585,Public       ,41,82,123,5651,3600,9251
00287600,ORANGE COUNTY COMMUNITY COLLEGE         ,NY,10940-6441,Public       ,34,51,85,2610,1885,4495
00287700,ROCKLAND COMMUNITY COLLEGE              ,NY,10901-3611,Public       ,11,16,27,2233,1657,3890
00287800,SUFFOLK COMMUNITY COLLEGE               ,NY,11784-2899,Public       ,54,38,92,6001,2842,8843
00287801,SUFFOLK COMMUNITY CLG-W. CAMPUS         ,NY,11717-0000,Public       ,29,18,47,2904,2116,5020
00287803,SUFFOLK COMMUNITY CLG-EASTRN CAMPUS     ,NY,11901-0000,Public       ,4,7,11,987,799,1786
00287900,SULLIVAN COUNTY COMMUNITY COLLEGE       ,NY,12759-5151,Public       ,4,5,9,1345,652,1997
00288000,ULSTER COUNTY COMMUNITY COLLEGE         ,NY,12484-0557,Public       ,11,20,31,1237,891,2128
00288100,SUNY WESTCHESTER COMMUNITY COLLEGE      ,NY,10595-1698,Public       ,33,79,112,4357,3596,7953
00288200,SYRACUSE UNIVERSITY                     ,NY,13244-2130,Private      ,33,132,165,19676,5380,25056
00288300,UTICA COLLEGE OF SYRACUSE UNIV          ,NY,13502-4892,Private      ,4,14,18,3109,1362,4471
00288500,ALBANY COLLEGE OF PHARMACY AND HEALTH SC,NY,12208-3492,Private      ,0,0,0,1618,707,2325
00288600,ALBANY LAW SCHOOL                       ,NY,12208-0000,Private      ,1,1,2,22,1443,1465
00288700,ALBANY MEDICAL COLLEGE                  ,NY,12208-0000,Private      ,0,5,5,42,985,1027
00288900,UNION COLLEGE                           ,NY,12308-2311,Private      ,6,1,7,3278,79,3357
00289000,UNION THEOLOGICAL SEMINARY              ,NY,10027-0000,Private      ,0,2,2,1,310,311
00289200,UNITED STATES MERCHANT MARINE ACADEMY   ,NY,11024-1699,Public       ,1,1,2,404,12,416
00289400,UNIVERSITY OF ROCHESTER                 ,NY,14627-9000,Private      ,12,73,85,7503,1644,9147
00289401,EASTMAN SCH OF MUSIC/UNIV ROCHESTER     ,NY,14604-0000,Private      ,1,3,4,776,360,1136
00289402,UNIV OF ROCHESTER SCHL OF MEDICINE      ,NY,14642-0000,Private      ,0,6,6,47,735,782
00289500,VASSAR COLLEGE                          ,NY,12604-0008,Private      ,1,0,1,4562,71,4633
00289600,VILLA MARIA COLLEGE-BUFFALO             ,NY,14225-3999,Private      ,2,1,3,448,249,697
00289900,WAGNER COLLEGE                          ,NY,10301-4495,Private      ,4,3,7,2887,329,3216
00290000,WEBB INSTITUTE                          ,NY,11542-1398,Private      ,0,0,0,56,1,57
00290100,WELLS COLLEGE                           ,NY,13026-0500,Private      ,1,0,1,971,70,1041
00290300,YESHIVA UNIVERSITY                      ,NY,10033-3201,Private      ,6,6,12,2029,3132,5161
00290302,YESHIVA UNIVERSITY - BRONX CAMPUS       ,NY,10461-1975,Private      ,0,9,9,15,1160,1175
00397400,MESIVTHA TIFERETH JERUSALEM OF AMER     ,NY,10002-6382,Private      ,0,0,0,33,2,35
00397600,RABBINICAL ACAD MESIVTA RABBI CHAIM     ,NY,11230-4715,Private      ,2,1,3,21,2,23
00397700,RABBINICAL COLLEGE CH'SAN SOFER         ,NY,11204-1252,Private      ,0,0,0,16,26,42
00397800,RABBINICAL SEMINARY OF AMERICA          ,NY,11375-0000,Private      ,8,2,10,31,38,69
00397900,COLUMBIA UNIV TEACHERS COLLEGE          ,NY,10027-0000,Private      ,0,143,143,28,4277,4305
00405400,HEBREW UNION COL-JEWISH INST OF REL     ,NY,10012-0000,Private      ,0,2,2,0,93,93
00455301,ITT TECHNICAL INSTITUTE                 ,NY,12205-0000,Proprietary  ,10,67,77,217,503,720
00475900,"CUNY, YORK COLLEGE                      ",NY,11451-0001,Public       ,29,19,48,6545,3668,10213
00476200,WEILL CORNELL MEDICAL COLLEGE AND GRADUA,NY,10021-0000,Private      ,0,6,6,16,890,906
00476500,CUNY GRADUATE SCH & UNIV CTR            ,NY,10016-4309,Public       ,2,36,38,53,2372,2425
00477600,CENTRAL YESHIVA TOMCHEI TMIMIM LUBA     ,NY,11230-2798,Private      ,90,8,98,421,50,471
00478800,HERKIMER COUNTY COMMUNITY COLLEGE       ,NY,13350-1598,Public       ,18,12,30,2379,1116,3495
00479800,MIRRER YESHIVA CENTRAL INST             ,NY,11223-2010,Private      ,4,8,12,86,59,145
00479900,MONROE COLLEGE                          ,NY,10468-4305,Proprietary  ,89,310,399,3505,6610,10115
00479901,MONROE COLLEGE                          ,NY,10801-0000,Proprietary  ,0,0,0,58,28,86
00481100,EVEREST INSTITUTE                       ,NY,14621-3007,Proprietary  ,39,156,195,452,2063,2515
00506401,ST JAMES MERCY HOSP SCH OF RAD          ,NY,14843-2197,Private      ,0,0,0,14,14,28
00506600,FAXTON ST. LUKE'S SCHOOL OF RADIOGRAPHY ,NY,13502-4856,Private      ,0,0,0,15,19,34
00520800,THE COLLEGE OF WESTCHESTER              ,NY,10602-0000,Proprietary  ,30,39,69,966,914,1880
00587700,ROBERT J HOCHSTIM SCHOOL OF RADIOG      ,NY,11572-1151,Private      ,0,0,0,0,2,2
00643501,ARNOT OGDEN MEDICAL CENTER              ,NY,14905-1676,Private      ,0,0,0,28,49,77
00643800,PHILLIPS BETH ISRAEL SCH OF NURSING     ,NY,10001-6354,Private      ,0,0,0,102,293,395
00644300,COCHRAN SCH NSG-ST JOHN RVSDE HOSP      ,NY,10701-1399,Private      ,0,1,1,68,380,448
00644500,CROUSE HOSP SCH OF NURSING              ,NY,13210-1690,Private      ,0,1,1,142,251,393
00644800,ELLIS HOSPITAL SCHOOL OF NURSING        ,NY,12308-0000,Private      ,0,1,1,49,110,159
00646101,ST ELIZABETH COLLEGE OF NURSING         ,NY,13501-2998,Private      ,0,1,1,113,166,279
00646102,ST ELIZABETH SCH OF RADIOGRAPHY         ,NY,13501-0000,Private      ,0,0,0,8,17,25
00646700,SAINT JOSEPH'S COLLEGE OF NURSING       ,NY,13203-1806,Private      ,1,1,2,168,229,397
00678200,GENESEE COMMUNITY COLLEGE               ,NY,14020-9704,Public       ,10,50,60,2613,2160,4773
00678500,SCHENECTADY COUNTY COMMUNITY CLG        ,NY,12305-2294,Public       ,5,15,20,1892,1672,3564
00678700,CLINTON COMMUNITY COLLEGE               ,NY,12901-5690,Public       ,10,12,22,1170,628,1798
00678800,TOMPKINS CORTLAND COMMUNITY COLLEGE     ,NY,13053-8504,Public       ,7,15,22,2291,1316,3607
00678900,COLUMBIA-GREENE COMMUNITY COLLEGE       ,NY,12534-9543,Public       ,9,14,23,970,693,1663
00679100,SUNY AT PURCHASE                        ,NY,10577-1400,Public       ,14,3,17,6565,878,7443
00702200,CUNY-LEHMAN COLLEGE                     ,NY,10468-1589,Public       ,24,40,64,10183,7203,17386
00702600,"MT SINAI SCH OF MEDICINE, NY UNIV       ",NY,10029-0000,Private      ,0,5,5,7,1111,1118
00710900,SUNY COLLEGE-OLD WESTBURY               ,NY,11568-0210,Public       ,17,16,33,4445,1474,5919
00711100,NORTH COUNTRY COMMUNITY COLLEGE         ,NY,12983-2046,Public       ,3,5,8,723,562,1285
00726400,MESIFTA TORAH VODAATH RABBINCAL SEM     ,NY,11218-5209,Private      ,0,6,6,19,37,56
00727300,CUNY-BERNARD BARUCH COLLEGE             ,NY,10010-5518,Public       ,63,60,123,15055,6411,21466
00730400,CULINARY INSTITUTE OF AMERICA           ,NY,12538-1499,Private      ,22,27,49,3079,1346,4425
00737200,AUSTIN'S SCHOOL OF SPA TECHNOLOGY       ,NY,12206-1513,Proprietary  ,18,47,65,134,304,438
00737500,ISLAND DRAFTING & TECHNICAL INST        ,NY,11701-2704,Proprietary  ,2,4,6,81,93,174
00738700,LONG ISLAND BEAUTY SCHOOL               ,NY,11788-4346,Proprietary  ,4,16,20,97,130,227
00738800,LONG ISLAND BEAUTY SCHOOL               ,NY,11550-3704,Proprietary  ,3,12,15,53,160,213
00739100,BEAUTY SCHOOL OF MIDDLETOWN             ,NY,10940-6574,Proprietary  ,2,9,11,42,113,155
00739400,BERKELEY COLLEGE                        ,NY,10017-0000,Proprietary  ,18,35,53,2497,2309,4806
00739402,BERKELEY COLLEGE-WESTCHESTER CAMPUS     ,NY,10601-1533,Proprietary  ,4,3,7,772,311,1083
00739800,KATHARINE GIBBS SCHOOL                  ,NY,10018-2602,Proprietary  ,0,3,3,402,702,1104
00740100,MANDL SCHOOL                            ,NY,10019-5516,Proprietary  ,15,82,97,159,804,963
00740500,WOOD TOBE-COBURN SCHOOL                 ,NY,10016-0102,Proprietary  ,0,0,0,551,108,659
00746500,AMERICAN ACADEMY OF DRAMATIC ARTS       ,NY,10016-7089,Private      ,0,1,1,301,118,419
00746600,LABORATORY INST. OF MERCHANDISING       ,NY,10022-5268,Proprietary  ,6,3,9,1482,143,1625
00746800,SCHOOL OF VISUAL ARTS                   ,NY,10010-3994,Proprietary  ,2,7,9,3555,1181,4736
00750602,LINCOLN TECHNICAL INSTITUTE             ,NY,11357-6092,Proprietary  ,34,36,70,637,331,968
00751800,APEX TECHNICAL SCHOOL                   ,NY,10011-2008,Proprietary  ,85,240,325,1058,2303,3361
00752200,CONTINENTAL SCH OF BEAUTY CULTURE       ,NY,14623-3231,Proprietary  ,15,61,76,218,574,792
00753200,FINGER LAKES COMMUNITY COLLEGE          ,NY,14424-8395,Public       ,10,26,36,3009,1903,4912
00757200,AMERICAN MUSICAL AND DRAMATIC ACAD      ,NY,10023-2106,Private      ,6,5,11,1636,297,1933
00757300,LEARNING INSTITUTE FOR BEAUTY SCIENCES  ,NY,11103-4028,Proprietary  ,8,17,25,76,247,323
00780400,CAREER ACADEMY OF NEW YORK              ,NY,10011-7307,Proprietary  ,19,82,101,301,888,1189
00818900,CONTINENTAL SCH OF BEAUTY CULTURE       ,NY,14223-0000,Proprietary  ,0,0,0,6,14,20
00818902,CONTINENTAL SCHOOL OF BEAUTY CULTURE  - ,NY,14224-3402,Proprietary  ,0,0,0,5,7,12
00843500,INTERBORO INSTITUTE                     ,NY,10019-3604,Proprietary  ,0,0,0,0,1,1
00843700,CHAMPLAIN VALLEY - TEC/PRN              ,NY,12901-0000,Public       ,0,0,0,12,37,49
00849500,JAMESTOWN BUSINESS COLLEGE              ,NY,14702-0429,Proprietary  ,2,28,30,136,313,449
00861100,"CUNY, HOSTOS CMTY COLLEGE               ",NY,10451-1499,Public       ,11,28,39,3647,4317,7964
00861400,RABBINICAL CLG BOBOVER YESHIVA BNEI     ,NY,11219-3293,Private      ,13,10,23,141,48,189
00861700,RABBINICAL SEM MKOR CHAIM-YESHIVA       ,NY,11219-4300,Private      ,6,0,6,20,0,20
00878800,SUNY-STUDENT LOAN SERVICE CENTER        ,NY,12144-3440,Public       ,0,0,0,22,7,29
00900300,OLEAN BUSINESS INSTITUTE INC            ,NY,14760-2691,Proprietary  ,2,2,4,38,73,111
00902900,NEIGHBORHOOD PLAYHOUSE                  ,NY,10022-5017,Private      ,0,0,0,21,25,46
00904300,ELMIRA BUSINESS INSTITUTE               ,NY,14901-2731,Proprietary  ,15,67,82,156,843,999
00907700,UTICA SCHOOL OF COMMERCE                ,NY,13501-2280,Proprietary  ,1,3,4,158,384,542
00924800,SAMARITAN HOSPITAL SCH NURSING          ,NY,12180-2475,Private      ,1,2,3,48,163,211
00928300,MIDWAY-PARIS BEAUTY SCHOOL              ,NY,11385-3453,Proprietary  ,3,9,12,30,93,123
00928400,LEARNING INST FOR BEAUTY SCIENCES       ,NY,11756-1345,Proprietary  ,12,36,48,103,329,432
00933500,MESIVTA EASTERN PKWY RABBINICAL CLG     ,NY,11218-5559,Private      ,4,0,4,25,6,31
00947900,SAINT VINCENTS CMC SI NURSING SCHOOL    ,NY,10304-3850,Private      ,0,0,0,52,126,178
00976900,METROPOLITAN COLLEGE OF NEW YORK        ,NY,10013-1919,Private      ,0,10,10,168,1553,1721
00992900,SUNY COLLEGE OF OPTOMETRY               ,NY,10036-8003,Public       ,0,2,2,17,335,352
01005100,LA GUARDIA CMTY COLLEGE - CUNY          ,NY,11101-3083,Public       ,53,45,98,8806,6921,15727
01005200,JEFFERSON-LEWIS BOCES PRAC NRSGPRG      ,NY,13601-9509,Public       ,0,0,0,17,98,115
01009700,CUNY-MEDGAR W EVERS COLLEGE             ,NY,11225-2010,Public       ,16,20,36,3819,4738,8557
01014200,TOURO COLLEGE                           ,NY,10010-4202,Private      ,56,107,163,3186,11316,14502
01014700,WESTERN SUFFOLK BOCES                   ,NY,11768-3499,Public       ,2,0,2,67,311,378
01015300,HELENE FULD COL OF NRSNG/N GEN HOSP     ,NY,10035-0000,Private      ,1,44,45,29,481,510
01028600,EMPIRE STATE COLLEGE                    ,NY,12866-4391,Public       ,9,133,142,745,10704,11449
01037800,RABBINICAL COLLEGE OF LONG ISLAND       ,NY,11561-3244,Private      ,2,0,2,46,0,46
01054900,KEHILATH YAKOV RABBINICAL SEMINARY      ,NY,10562-1001,Private      ,9,12,21,38,24,62
01055100,NEW YORK SCH MED & DENTAL ASSISTANT     ,NY,11101-2327,Proprietary  ,4,12,16,212,416,628
01064100,SOUTHERN WESTCHESTER BOCES              ,NY,10543-0000,Public       ,1,0,1,13,121,134
01068400,ERIE COMMUNITY COLLEGE-ALL CAMPUSES     ,NY,14203-2698,Public       ,47,60,107,7863,6599,14462
01081300,AMERICAN ACAD MCALLISTER INST           ,NY,10019-3604,Private      ,2,2,4,72,261,333
01083700,SIMMONS INST OF FUNERAL SERVICE         ,NY,13207-2098,Proprietary  ,0,0,0,27,27,54
01093000,SUBURBAN TECHNICAL SCHOOL               ,NY,11550-3771,Proprietary  ,31,154,185,151,634,785
01094300,RABBINICAL COLLEGE BETH SHRAGA          ,NY,10952-3033,Private      ,8,0,8,15,0,15
01095200,PNW BOCES LPN PROGRAM                   ,NY,10598-0000,Public       ,0,0,0,9,82,91
01103100,TECHNICAL CAREER INSTITUTE              ,NY,10001-2789,Proprietary  ,210,431,641,2883,5207,8090
01118900,UNITED TALMUDICAL SEMINARY              ,NY,11211-7984,Private      ,42,133,175,634,564,1198
01161400,CHAMPLAIN VALLEY HOSP SCH RAD TECH      ,NY,12901-1490,Private      ,0,0,0,18,8,26
01161700,NEW YORK METHODIST HOSPITAL             ,NY,11229-9023,Private      ,1,0,1,33,88,121
01164700,SBI CAMPUS - AN AFFILIATE OF SANFORD-BRO,NY,11747-3785,Proprietary  ,26,52,78,441,660,1101
01167000,YESHIVA OF NITRA RABBINICAL COLLEGE     ,NY,11211-7108,Private      ,18,12,30,99,30,129
01167700,MEMORIAL SLOAN KETTERING CANCER CTR     ,NY,10021-6094,Private      ,0,0,0,1,13,14
01167800,SUNY INST OF TECHNOLOGY UTICA ROME      ,NY,13504-3050,Public       ,6,7,13,1616,1086,2702
01182100,YESHIVATH ZICHRON MOSHE                 ,NY,12779-0580,Private      ,5,0,5,89,6,95
01183000,BERK TRADE AND BUSINESS SCHOOL          ,NY,11101-0000,Proprietary  ,5,24,29,48,133,181
01185900,WORD OF LIFE BIBLE INSTITUTE            ,NY,12860-0129,Private      ,2,0,2,511,71,582
01186000,MERCY MED CNTR SCHL OF RADIOGRAPHY      ,NY,11570-1098,Private      ,0,0,0,1,4,5
01192100,WESTCHESTER SCH OF BEAUTY CULTURE       ,NY,10550-2295,Proprietary  ,0,1,1,14,58,72
01192200,BETH HATALMUD RABBINICAL CLG            ,NY,11214-2594,Private      ,8,0,8,40,0,40
01198400,OHR HAMEIR THEOLOGICAL SEMINARY         ,NY,10566-0990,Private      ,5,0,5,71,2,73
01201100,TALMUDICAL SEM OHOLEI TORAH             ,NY,11213-3310,Private      ,18,0,18,214,0,214
01207200,PHILLIPS HAIRSTYLING INSTITUTE          ,NY,13210-1509,Proprietary  ,1,2,3,40,123,163
01210700,INSTITUTE OF DESIGN & CONSTRUCTION      ,NY,11201-5380,Private      ,0,0,0,35,112,147
01220300,MEMORIAL HOSPITAL SCH OF NURSING        ,NY,12204-1083,Private      ,0,3,3,42,123,165
01227700,NEW YORK CHIROPRACTIC COLLEGE           ,NY,13148-0800,Private      ,0,4,4,14,739,753
01229300,VEEB NASSAU CNTY SCHL OF PRACT NURS     ,NY,11553-3037,Public       ,0,0,0,41,202,243
01235800,PLAZA COLLEGE                           ,NY,11372-6300,Proprietary  ,42,99,141,649,1199,1848
01236400,SAINT VINCENTS CATHOLIC MEDICAL CENTERS ,NY,11365-1535,Private      ,1,2,3,46,158,204
01240700,SCHUYLER-CHEMUNG-TIOGA BOCES            ,NY,14903-1089,Public       ,0,1,1,24,127,151
01240701,STEUBEN SCHUYLER CHEMUNG TIOGA ALLEGANY ,NY,14870-9518,Public       ,0,0,0,1,2,3
01256100,FIVE TOWNS COLLEGE                      ,NY,11746-5871,Proprietary  ,12,4,16,1424,273,1697
01258900,ERIE 1 BOCES                            ,NY,14224-0000,Public       ,3,6,9,57,271,328
01265200,ONONDAGA CORTLAND MADISON BOCES         ,NY,13090-4500,Public       ,0,1,1,176,644,820
01278300,OSWEGO COUNTY BOCES ADULT CAREERS       ,NY,13114-4498,Public       ,0,2,2,32,102,134
01292700,CENTRAL TECH NURSING PROGRAM            ,NY,13202-3092,Public       ,0,0,0,17,79,96
01302600,MACHZIKEI HADATH RABBINICAL COLLEGE     ,NY,11204-1805,Private      ,10,12,22,34,15,49
01302700,YESHIVATH VIZNITZ                       ,NY,10952-3021,Private      ,26,39,65,137,62,199
01302900,BORICUA COLLEGE                         ,NY,10032-1599,Private      ,3,6,9,393,1241,1634
02056400,CAPRI COSMETOLOGY LEARNING CENTER       ,NY,10954-0000,Proprietary  ,2,15,17,87,160,247
02066200,THE NEW SCHOOL                          ,NY,10011-0000,Private      ,11,34,45,4929,5350,10279
02069000,NEW YORK SCHOOL OF INTERIOR DESIGN      ,NY,10021-0000,Private      ,1,3,4,164,262,426
02075700,BRIARCLIFFE COLLEGE                     ,NY,11714-0000,Proprietary  ,1,2,3,1088,703,1791
02075702,BRIARCLIFFE COLLEGE - PATCHOGUE         ,NY,11772-3019,Proprietary  ,0,0,0,729,524,1253
02092400,RIDLEY-LOWELL SCHOOL OF BUSINESS        ,NY,13905-0000,Proprietary  ,3,33,36,42,274,316
02093700,LONG ISLAND BUSINESS INSTITUTE          ,NY,11725-0000,Proprietary  ,59,118,177,539,1456,1995
02098400,HERKIMER COUNTY BOCES                   ,NY,13350-0000,Public       ,0,0,0,43,87,130
02104300,OTSEGO AREA SCHOOL OF PRAC NURSING      ,NY,13820-0000,Public       ,0,0,0,10,33,43
02105900,HAIR DESIGN INSTITUTE AT FIFTH AVE      ,NY,11220-0000,Proprietary  ,1,8,9,22,79,101
02106800,BRAMSON ORT COLLEGE                     ,NY,11375-0000,Private      ,1,3,4,405,611,1016
02110900,CATTARAUGUS/ALLEGANY BOCES              ,NY,14760-0000,Public       ,0,0,0,26,102,128
02116011,SANFORD-BROWN INSTITUTE - NEW YORK      ,NY,10003-2103,Proprietary  ,54,165,219,735,2083,2818
02118700,LONG ISLAND COLLEGE HOSPITAL - SCHOOL OF,NY,11201-6001,Private      ,1,3,4,119,297,416
02118702,LONG ISLAND COLLEGE HOSPITAL - SCHOOL OF,NY,11201-6001,Private      ,0,1,1,52,45,97
02124000,ORANGE ULSTER BOCES SCH OF PRAC NRS     ,NY,10924-9401,Public       ,0,0,0,18,99,117
02125500,CIRCLE IN THE SQUARE THEATRE SCHOOL     ,NY,10019-0000,Private      ,0,3,3,51,63,114
02126300,MADISON-ONEIDA BOCES PRAC NRS           ,NY,13478-0000,Public       ,1,6,7,26,185,211
02138500,BOCES RENSSELAER SCH OF PRAC NRSG       ,NY,12033-3221,Public       ,0,0,0,12,74,86
02145800,CAYUGA ONONDAGA BOCES                   ,NY,13021-9430,Public       ,0,0,0,15,60,75
02146000,WAYNE-FINGER LAKES BOCES                ,NY,14513-0000,Public       ,0,0,0,29,146,175
02152000,YESHIVA SHAAR HATORAH ITRI TORAH        ,NY,11418-0000,Private      ,7,0,7,10,0,10
02153600,BROOME-TIOGA BOCES PN PROG              ,NY,13905-0000,Public       ,0,0,0,22,81,103
02157900,ROCHESTER GENERAL HOSPITAL              ,NY,14621-3001,Private      ,0,0,0,17,117,134
02158200,WSHNGTN-SARTGA-WARN-HMLTN-ESX BOCES     ,NY,12839-1051,Public       ,0,0,0,25,118,143
02160100,GENEVA GENERAL HOSPITAL                 ,NY,14456-0000,Private      ,0,1,1,28,71,99
02163400,NEW YORK CAREER INSTITUTE               ,NY,10007-2801,Proprietary  ,3,3,6,204,624,828
02169100,DAVIS COLLEGE                           ,NY,13790-0000,Private      ,0,0,0,190,109,299
02170000,SWEDISH INSTITUTE                       ,NY,10001-0000,Proprietary  ,6,32,38,102,628,730
02170200,ALBANY SCHOHARIE SCHENECTADY            ,NY,12205-0000,Public       ,0,1,1,31,134,165
02171900,AILEY SCHOOL (THE)                      ,NY,10019-4402,Private      ,1,0,1,70,18,88
02172100,HAMILTON-FULTON-MONTGOMERY BOCES        ,NY,12095-0000,Public       ,0,0,0,31,49,80
02172800,DUTCHESS COUNTY BOCES SCH PRAC NURS     ,NY,12601-0000,Public       ,0,0,0,27,147,174
02173200,EMPIRE BEAUTY SCHOOL                    ,NY,10001-0000,Proprietary  ,40,64,104,481,903,1384
02173201,LEARNING INSTITUTES FOR BEAUTY SCIENCES-,NY,11214-4347,Proprietary  ,0,0,0,0,7,7
02173900,ULSTER COUNTY BOCES PRACTICAL NRSG      ,NY,12466-0000,Public       ,0,2,2,27,124,151
02176000,CHERYL FELL'S SCHOOL OF BUSINESS        ,NY,14304-0000,Proprietary  ,0,4,4,9,46,55
02179400,EASTERN SUFFOLK BOCES                   ,NY,11713-0000,Public       ,1,2,3,126,467,593
02182200,NEW SCHOOL OF RADIO & TELEVISION        ,NY,12206-1106,Proprietary  ,1,9,10,26,35,61
02187300,DARKEI NOAM RABBINICAL COLLEGE          ,NY,11210-0000,Private      ,0,0,0,0,1,1
02191600,TORAH TEMIMAH TALMUDICAL SEMINARY       ,NY,11218-0000,Private      ,10,0,10,42,0,42
02192500,BELLEVUE HOSP CTR SCH RAD TECH          ,NY,10016-0000,Public       ,0,1,1,5,30,35
02193700,SAINT LAWRENCE LEWIS COUNTY BOCES       ,NY,13617-0000,Public       ,0,1,1,67,24,91
02193701,SAINT LAWRENCE LEWIS COUNTY BOCES - NORT,NY,13669-0798,Public       ,0,0,0,2,2,4
02193702,SAINT LAWRENCE LEWIS COUNTY BOCES - SOUT,NY,13642-0342,Public       ,0,0,0,2,1,3
02193703,SAINT LAWRENCE LEWIS COUNTY BOCES - ADUL,NY,13668-3238,Public       ,0,0,0,1,4,5
02199300,ORLEANS-NIAGARA BOCES                   ,NY,14132-0000,Public       ,1,5,6,15,73,88
02206000,HUNTER BUSINESS SCHOOL                  ,NY,11756-0000,Proprietary  ,9,56,65,154,715,869
02206001,HUNTER BUSINESS SCHOOL -                ,NY,11763-0000,Proprietary  ,1,0,1,24,8,32
02217800,D.HOPFER SCH NURSING AT MT.VRN HOSP     ,NY,10550-0000,Private      ,1,1,2,16,259,275
02219500,MILDRED ELLEY                           ,NY,12206-1513,Proprietary  ,18,109,127,288,1226,1514
02235600,ERIE 2-CHAUTAUQUA-CATTARAUGUS BOCES     ,NY,14006-0000,Public       ,0,2,2,28,152,180
02265100,YESHIVA DERECH CHAIM                    ,NY,11218-0000,Private      ,5,0,5,33,11,44
02265200,GLOBAL BUSINESS INSTITUTE               ,NY,11691-0000,Private      ,34,94,128,496,1135,1631
02272900,ROCKLAND COUNTY BOCES PRAC NRSG SCH     ,NY,10994-0000,Public       ,0,0,0,18,75,93
02275900,"MODERN WELDING SCHOOL, INC.             ",NY,12304-0000,Proprietary  ,3,13,16,63,110,173
02287800,NATIONAL TRACTOR TRAILER SCHOOL         ,NY,13088-2505,Proprietary  ,3,66,69,34,524,558
02294900,INSTITUTE OF AUDIO RESEARCH             ,NY,10003-0000,Proprietary  ,20,23,43,482,436,918
02306500,PROFESSIONAL BUSINESS INSTITUTE         ,NY,10002-0000,Private      ,23,31,54,567,838,1405
02314200,NORTHERN WESTCHESTER SCH COSMETOL       ,NY,10566-0000,Proprietary  ,4,2,6,19,31,50
02320100,OHR SOMAYACH TANENBAUM EDUCATIONAL CENTE,NY,10952-0000,Private      ,0,0,0,3,0,3
02325600,NEW YORK INSTITUTE OF ENGLISH & BUS     ,NY,10001-0000,Private      ,8,27,35,100,367,467
02349700,RABBINICAL SEMINARY ADAS YEREIM         ,NY,11211-0000,Private      ,4,14,18,5,34,39
02350600,YESHIVA AND KOLLEL HARBOTZAS TORAH      ,NY,11230-0000,Private      ,0,0,0,0,16,16
02454300,NEW YORK UNIVERSITY SCHOOL OF MEDICINE  ,NY,10016-6497,Private      ,1,2,3,219,1249,1468
02491400,SPANISH AMERICAN INSTITUTE              ,NY,10036-0000,Private      ,1,7,8,7,26,33
02505800,YESHIVA KARLIN STOLIN RAB INSTITUTE     ,NY,11204-0000,Private      ,7,6,13,24,32,56
02505900,SH-OR YOSHUV RABBINICAL COLLEGE         ,NY,11691-0000,Private      ,0,0,0,27,13,40
02506000,ASSOCIATED BETH RIVKAH SCHOOLS          ,NY,11225-0000,Private      ,0,0,0,61,7,68
02506100,CITY UNIV OF NEW YORK-CENTRAL           ,NY,10021-0000,Public       ,3,2,5,545,330,875
02506200,MERCE CUNNINGHAM STUDIO                 ,NY,10014-0000,Private      ,0,1,1,1,7,8
02506800,YESHIVAT MIKDASH MELECH                 ,NY,11230-0000,Private      ,13,7,20,25,16,41
02511500,JOFFREY BALLET SCHOOL                   ,NY,10011-0000,Proprietary  ,2,0,2,50,4,54
02513500,MAR JON SCHOOL OF BEAUTY CULTURE        ,NY,14150-0000,Proprietary  ,0,1,1,20,60,80
02525600,ART INSTITUTE OF NEW YORK CITY(THE)     ,NY,10013-1917,Proprietary  ,27,22,49,1983,1181,3164
02540800,"GLOBE INSTITUTE OF TECHNOLOGY, INC.     ",NY,10007-0000,Proprietary  ,1,1,2,383,440,823
02546000,TRI-STATE COLLEGE OF ACUPUNCTURE        ,NY,10011-0000,Proprietary  ,1,1,2,5,150,155
02546300,YESHIVA OF THE TELSHE ALUMNI            ,NY,10471-0000,Private      ,11,0,11,26,0,26
02550600,TALMUDICAL INST OF UPSTATE NY           ,NY,14607-0000,Private      ,1,0,1,7,3,10
02556700,SEMINAR L'MOROS BAIS YAAKOV             ,NY,11219-0000,Private      ,3,0,3,255,1,256
02572900,BUSINESS INFORMATICS CENTER             ,NY,11580-0000,Proprietary  ,4,4,8,51,112,163
02575400,FRENCH CULINARY INSTITUTE               ,NY,10013-2618,Proprietary  ,3,20,23,250,577,827
02587600,ORLO SCH HAIR DESIGN & COSMETOLOGY      ,NY,12206-1723,Proprietary  ,3,3,6,100,106,206
02599400,NEW YORK COLLEGE OF HEALTH PROFESSIONS  ,NY,11791-4413,Private      ,1,5,6,192,722,914
02600100,NEW YORK ACADEMY OF ART (THE)           ,NY,10013-2911,Private      ,0,1,1,63,140,203
02614900,SANFORD-BROWN INSTITUTE                 ,NY,10604-2910,Proprietary  ,13,65,78,201,688,889
02615001,SANFORD-BROWN INSTITUTE - GARDEN CITY   ,NY,11530-4734,Proprietary  ,0,1,1,15,36,51
02616600,SHEAR EGO INTL SCH OF HAIR DESIGN       ,NY,14617-3501,Proprietary  ,2,12,14,57,131,188
02617000,CONTINENTAL SCH OF BEAUTY CULTURE       ,NY,14020-1908,Proprietary  ,3,13,16,63,160,223
02617001,CONTINENTAL SCHOOL OF BEAUTY CULTURE - O,NY,14760-2618,Proprietary  ,0,0,0,1,4,5
02622900,BAIS MEDRASH ELYON                      ,NY,10952-3013,Private      ,1,0,1,15,2,17
03000100,YESHIVA GEDOLAH IMREI YOSEF DSPINKA     ,NY,11219-4696,Private      ,0,9,9,12,95,107
03007200,DANCE THEATRE OF HARLEM                 ,NY,10031-0000,Private      ,0,0,0,16,1,17
03027701,PACIFIC COLLEGE OF ORIENTAL MEDICINE - N,NY,10010-7108,Proprietary  ,0,21,21,12,353,365
03081600,DELAWARE CHENANGO MADISON OT. BOCES     ,NY,13815-9554,Public       ,0,0,0,17,82,99
03088500,NEW YORK INTERNATIONAL BEAUTY SCH       ,NY,10019-0000,Proprietary  ,4,25,29,64,227,291
03089700,COMPUTER CAREER CENTER                  ,NY,11530-3334,Proprietary  ,38,190,228,412,1754,2166
03095500,ASA INST BUSINESS & COMPUTER TECH       ,NY,11201-5208,Proprietary  ,66,189,255,1667,4465,6132
03096200,CHARLES STUART SCHOOL                   ,NY,11229-2004,Proprietary  ,0,0,0,9,45,54
03097801,CARSTEN INSTITUTE                       ,NY,10003-1901,Proprietary  ,0,0,0,5,13,18
03099100,SUNBRIDGE COLLEGE                       ,NY,10977-0000,Private      ,0,0,0,2,50,52
03103700,ADIRONDACK BEAUTY SCHOOL                ,NY,12801-3158,Proprietary  ,0,9,9,20,39,59
03104900,SULLIVAN COUNTY BOCES                   ,NY,12754-2116,Public       ,0,0,0,19,49,68
03111100,NEW YORK PARALEGAL SCHOOL               ,NY,10007-1901,Proprietary  ,0,0,0,18,43,61
03115300,GENESEE VALLEY BOCES                    ,NY,14020-1099,Public       ,5,38,43,27,186,213
03120700,NEW YORK CONSERVATORY FOR DRAMATIC ARTS ,NY,10011-4225,Proprietary  ,2,1,3,392,93,485
03127100,YESHIVAS NOVOMINSK                      ,NY,11219-0000,Private      ,4,0,4,32,1,33
03129200,RABBINICAL CLG OHR SHIMAR YISROEL       ,NY,11211-8102,Private      ,2,0,2,57,74,131
03169300,STUDIO JEWELERS                         ,NY,10016-4112,Proprietary  ,0,1,1,4,13,17
03172400,CALIBER TRAINING INSTITUTE              ,NY,10018-6504,Proprietary  ,0,0,0,21,66,87
03181400,MERKAZ BNOS                             ,NY,11204-0000,Private      ,2,27,29,16,332,348
03191300,CUNY SCHOOL OF LAW @ QUEENS COLLEGE     ,NY,11367-0000,Public       ,2,4,6,184,1139,1323
03193300,MANHATTAN SCHOOL OF COMPUTER TECH       ,NY,11230-1617,Private      ,11,62,73,70,402,472
03203300,NEW YORK INSTITUTE OF MASSAGE           ,NY,14221-6021,Proprietary  ,0,0,0,57,147,204
03216300,UNIFICATION THEOLOGICAL SEMINARY        ,NY,12507-5021,Private      ,0,1,1,1,16,17
03315300,HARLEM SCHOOL OF TECHNOLOGY             ,NY,10027-4426,Proprietary  ,0,1,1,11,43,54
03328300,FRANKLIN CAREER INSTITUTE               ,NY,11550-3003,Private      ,22,62,84,303,685,988
03342400,AMERICAN BARBER INSTITUTE               ,NY,10001-5271,Proprietary  ,13,18,31,85,184,269
03358300,ALLEN SCHOOL                            ,NY,11432-4901,Proprietary  ,42,214,256,404,1762,2166
03361500,WILLSEY INSTITUTE                       ,NY,10301-1989,Proprietary  ,0,0,0,16,68,84
03380300,CULINARY ACADEMY OF LONG ISLAND         ,NY,11791-5311,Proprietary  ,2,14,16,109,238,347
03419400,NORTHEASTERN SEMINARY                   ,NY,14624-1997,Private      ,0,3,3,2,105,107
03426400,ANTHEM INSTITUTE                        ,NY,10018-0000,Proprietary  ,24,59,83,523,816,1339
03433500,LIA SCHORR INSTITUTE OF COSMETIC SK     ,NY,10022-2614,Proprietary  ,0,3,3,6,66,72
03443300,NEW YORK COLLEGE OF TRADITIONAL CHINESE ,NY,11501-0000,Private      ,0,1,1,1,65,66
03496300,YESHIVA SHAAREI TORAH OF ROCKLAND       ,NY,10901-4003,Private      ,0,0,0,5,1,6
03537300,NEW YORK AUTOMOTIVE & DIESEL INSTIT     ,NY,11101-0000,Proprietary  ,30,74,104,198,339,537
03568300,LEON STUDIO ONE SCHOOL OF HAIR DESI     ,NY,14221-5323,Proprietary  ,3,6,9,51,86,137
03651300,SAINT JOSEPH'S MEDICAL CENTER SCHOO     ,NY,10701-4080,Private      ,0,0,0,13,16,29
03652300,METROPOLITAN LEARNING INSTITUTE         ,NY,11375-0000,Private      ,6,73,79,27,694,721
03691300,USA BEAUTY SCHOOL INTERNATIONAL         ,NY,10013-3530,Proprietary  ,0,26,26,27,420,447
03713300,BEIS MEDRASH HEICHAL DOVID              ,NY,11691-4433,Private      ,1,0,1,19,11,30
03773300,CENTER FOR NATURAL WELLNESS SCHOOL OF MA,NY,12205-1601,Proprietary  ,0,4,4,30,134,164
03802300,UTA MESIVTA OF KIRYAS JOEL              ,NY,10950-2169,Private      ,74,109,183,544,489,1033
03809400,MICROPOWER CAREER INSTITUTE             ,NY,10001-2812,Proprietary  ,10,101,111,30,317,347
03819400,HUDSON VALLEY SCHOOL OF ADVANCED AESTHET,NY,12561-1401,Proprietary  ,1,2,3,22,31,53
03839300,AVEDA INSTITUTE NEW YORK                ,NY,10013-1522,Proprietary  ,3,7,10,107,219,326
03881300,UNION GRADUATE COLLEGE                  ,NY,12308-3103,Private      ,1,5,6,30,182,212
03903400,AMERICAN BEAUTY SCHOOL                  ,NY,10462-8003,Proprietary  ,10,37,47,86,317,403
03941400,ELITE ACADEMY OF BEAUTY ARTS            ,NY,11223-1630,Proprietary  ,5,20,25,26,112,138
03983300,"SCHOOL OF PROFESSIONAL HORTICULTURE, AT ",NY,10458-5126,Private      ,0,0,0,0,15,15
04043300,ACE COMPUTER TRAINING CENTER            ,NY,11375-5337,Proprietary  ,0,1,1,8,40,48
04095300,KING'S COLLEGE (THE)                    ,NY,10018-0110,Private      ,1,0,1,295,21,316
04102300,NEW AGE TRAINING                        ,NY,10018-0000,Proprietary  ,0,0,0,12,65,77
04115500,TALMUDICAL SEMINARY OF BOBOV            ,NY,11219-3826,Private      ,13,5,18,62,49,111
04117700,"MONROE 2-ORLEANS BOCES, CENTER FOR WORK ",NY,14624-1119,Public       ,0,1,1,14,34,48
04123200,INSTITUTE OF ALLIED MEDICAL PROFESSIONS ,NY,11373-5541,Private      ,9,48,57,130,668,798
04123300,HUDSON VALLEY SCHOOL OF MASSAGE THERAPY ,NY,12528-1426,Proprietary  ,2,8,10,11,50,61
04125600,CAREER SCHOOL OF NY                     ,NY,10301-2416,Private      ,7,5,12,34,42,76
04134000,"JOHN PAUL'S HAIR, NAIL & SKIN CARE INSTI",NY,12020-1245,Proprietary  ,3,13,16,9,41,50
04137700,ANN MARIE'S WORLD OF BEAUTY SCHOOL      ,NY,13901-2308,Proprietary  ,0,1,1,3,8,11
00267808,BRYANT & STRATTON COLLEGE - PARMA       ,OH,44130-0000,Proprietary  ,51,185,236,700,3364,4064
00301000,ANTIOCH UNIVERSITY                      ,OH,45387-1608,Private      ,1,28,29,110,183,293
00301001,ANTIOCH UNIVERSITY MCGREGOR             ,OH,45387-0000,Private      ,0,0,0,12,673,685
00301010,ANTIOCH UNIVERSITY                      ,OH,45387-0000,Private      ,0,0,0,13,115,128
00301100,ART ACADEMY OF CINCINNATI               ,OH,45202-7106,Private      ,0,0,0,262,69,331
00301200,ASHLAND UNIVERSITY                      ,OH,44805-3799,Private      ,2,66,68,3258,3059,6317
00301300,ATHENAEUM OF OHIO                       ,OH,45230-2000,Private      ,0,0,0,2,8,10
00301400,BALDWIN-WALLACE COLLEGE                 ,OH,44017-2088,Private      ,5,18,23,4307,1457,5764
00301600,BLUFFTON UNIVERSITY                     ,OH,45817-2104,Private      ,1,3,4,1398,332,1730
00301800,BOWLING GREEN STATE UNIVERSITY          ,OH,43403-0001,Public       ,28,51,79,16420,5345,21765
00302300,CAPITAL UNIVERSITY                      ,OH,43209-2394,Private      ,8,36,44,3703,2573,6276
00302400,CASE WESTERN RESERVE UNIV               ,OH,44106-0000,Private      ,3,10,13,5998,973,6971
00302401,CASE WESTERN RESERVE UNIV - MED         ,OH,44106-0000,Private      ,1,2,3,44,1055,1099
00302402,CASE WESTERN RESERVE UNIV - DENTAL      ,OH,44106-0000,Private      ,0,0,0,15,298,313
00302403,CASE WESTERN RESERVE UNIV - LAW         ,OH,44106-0000,Private      ,0,1,1,8,1307,1315
00302404,CASE WESTERN RESERVE UNIV - UG          ,OH,44106-0000,Private      ,0,0,0,514,63,577
00302405,CASE WESTERN RESERVE UNIV - MSASS       ,OH,44106-0000,Private      ,0,0,0,6,424,430
00302406,CASE WESTERN RESERVE UNIV - NURS UG     ,OH,44106-0000,Private      ,0,0,0,209,126,335
00302407,CASE WESTERN RESERVE UNIV - WSOM        ,OH,44106-0000,Private      ,0,4,4,15,302,317
00302408,CASE WESTERN RESERVE UNIV -A&S GRAD     ,OH,44106-0000,Private      ,0,4,4,13,329,342
00302409,CASE WESTERN RESERVE UNIV -ENG GRAD     ,OH,44106-0000,Private      ,0,1,1,22,93,115
00302410,CASE WESTERN RESERVE UNIV -NURS GRD     ,OH,44106-0000,Private      ,0,2,2,6,321,327
00302500,CEDARVILLE UNIVERSITY                   ,OH,45314-8564,Private      ,6,1,7,3607,188,3795
00302600,CENTRAL STATE UNIVERSITY                ,OH,45384-1004,Public       ,11,18,29,3540,1239,4779
00302900,CINCINNATI CHRISTIAN UNIVERSITY         ,OH,45204-3200,Private      ,1,5,6,544,592,1136
00303000,OHIO CHRISTIAN UNIVERSITY               ,OH,43113-9487,Private      ,3,45,48,364,881,1245
00303100,CLEVELAND INSTITUTE OF MUSIC            ,OH,44106-1776,Private      ,1,0,1,445,334,779
00303200,CLEVELAND STATE UNIVERSITY              ,OH,44115-2214,Public       ,50,255,305,7231,12902,20133
00303300,COLLEGE OF MT ST JOSEPH                 ,OH,45233-1670,Private      ,4,14,18,1552,1060,2612
00303500,OHIO DOMINICAN UNIVERSITY               ,OH,43219-2099,Private      ,6,47,53,2436,2525,4961
00303600,FRANCISCAN UNIV OF STEUBENVILLE         ,OH,43952-1763,Private      ,3,6,9,2152,681,2833
00303700,COLLEGE OF WOOSTER                      ,OH,44691-2363,Private      ,1,0,1,2867,59,2926
00303900,COLUMBUS COLLEGE OF ART AND DESIGN      ,OH,43215-1758,Private      ,0,4,4,1746,389,2135
00304000,CUYAHOGA COMMUNITY COLLEGE              ,OH,44115-2878,Public       ,45,324,369,5991,17274,23265
00304001,CUYAHOGA COMMUNITY CLG-EASTERN CAM      ,OH,44122-6195,Public       ,2,18,20,530,1101,1631
00304002,CUYAHOGA COMMUNITY CLG-METRO CAMPUS     ,OH,44115-0000,Public       ,6,29,35,859,2262,3121
00304003,CUYAHOGA COMMUNITY CLG-WESTERN CMPS     ,OH,44130-0000,Public       ,3,34,37,1351,1499,2850
00304100,"DEFIANCE COLLEGE, THE                   ",OH,43512-1695,Private      ,2,6,8,1204,364,1568
00304200,DENISON UNIVERSITY                      ,OH,43023-1329,Private      ,0,1,1,2773,38,2811
00304300,CHANCELLOR UNIVERSITY                   ,OH,44114-1096,Private      ,1,51,52,55,641,696
00304400,TRINITY LUTHERAN SEMINARY               ,OH,43209-0000,Private      ,0,1,1,0,154,154
00304500,UNIVERSITY OF FINDLAY                   ,OH,45840-3695,Private      ,3,22,25,3132,1418,4550
00304600,FRANKLIN UNIVERSITY                     ,OH,43215-5399,Private      ,6,98,104,910,8399,9309
00304606,FRANKLIN UNIVERSITY - NORTHWEST         ,OH,43019-5331,Private      ,0,0,0,5,35,40
00304608,FRANKLIN UNIVERSITY - NORTHEAST         ,OH,43081-1111,Private      ,0,0,0,11,39,50
00304700,HEBREW UNION COLLEGE MAIN CAMPUS        ,OH,45220-0000,Private      ,0,0,0,0,114,114
00304800,HEIDELBERG UNIVERSITY                   ,OH,44883-2462,Private      ,2,4,6,1929,322,2251
00304900,HIRAM COLLEGE                           ,OH,44234-1808,Private      ,2,9,11,1708,310,2018
00305000,JOHN CARROLL UNIVERSITY                 ,OH,44118-4581,Private      ,6,25,31,4109,939,5048
00305100,KENT STATE UNIV - KENT CAMPUS           ,OH,44242-0001,Public       ,27,75,102,18396,8938,27334
00305101,KENT STATE UNIV - GEAUGA CAMPUS         ,OH,44021-0000,Public       ,0,5,5,320,453,773
00305102,KENT STATE UNIV - STARK CAMPUS          ,OH,44720-0000,Public       ,7,11,18,2055,1941,3996
00305103,KENT STATE UNIV - TUSCARAWAS CAMPUS     ,OH,44663-0000,Public       ,2,8,10,877,1148,2025
00305104,KENT STATE UNIV - TRUMBULL CAMPUS       ,OH,44483-0000,Public       ,2,21,23,842,1450,2292
00305105,KENT STATE UNIV - ASHTABULA CAMPUS      ,OH,44004-0000,Public       ,2,20,22,699,1279,1978
00305106,KENT STATE UNIV -E.LIVERPOOL CAMPUS     ,OH,43920-0000,Public       ,0,9,9,357,613,970
00305107,KENT STATE UNIV - SALEM CAMPUS          ,OH,44460-0000,Public       ,1,6,7,672,845,1517
00306500,KENYON COLLEGE                          ,OH,43022-9623,Private      ,0,0,0,2539,38,2577
00306600,LAKE ERIE COLLEGE                       ,OH,44077-3389,Private      ,2,2,4,1158,389,1547
00306800,LORAIN COUNTY COMMUNITY COLLEGE         ,OH,44035-1691,Public       ,25,165,190,3194,6515,9709
00306900,LOURDES COLLEGE                         ,OH,43560-2898,Private      ,6,14,20,697,1788,2485
00307200,MALONE UNIVERSITY                       ,OH,44709-3897,Private      ,3,13,16,2041,1241,3282
00307300,MARIETTA COLLEGE                        ,OH,45750-4033,Private      ,1,5,6,2501,299,2800
00307500,METHODIST THEOLOGICAL SCH IN OHIO       ,OH,43015-0000,Private      ,0,0,0,0,221,221
00307600,MIAMI-JACOBS COLLEGE                    ,OH,45401-0000,Proprietary  ,9,115,124,164,1587,1751
00307602,MIAMI - JACOBS CAREER COLLEGE - SPRINGBO,OH,45066-1115,Proprietary  ,12,59,71,145,755,900
00307603,MIAMI - JACOBS CAREER COLLEGE - TROY    ,OH,45373-3837,Proprietary  ,11,88,99,175,906,1081
00307700,MIAMI UNIVERSITY                        ,OH,45056-1831,Public       ,46,108,154,16842,5638,22480
00307800,WRIGHT STATE UNIVERSITY                 ,OH,45435-0002,Public       ,37,92,129,11885,9011,20896
00308300,MOUNT UNION COLLEGE                     ,OH,44601-3993,Private      ,3,1,4,3196,162,3358
00308400,MUSKINGUM COLLEGE                       ,OH,43762-1199,Private      ,1,14,15,2291,606,2897
00308500,NOTRE DAME COLLEGE OF OHIO              ,OH,44121-4293,Private      ,3,18,21,1263,1151,2414
00308600,OBERLIN COLLEGE                         ,OH,44074-1090,Private      ,3,0,3,4626,127,4753
00308800,OHIO COLLEGE OF PODIATRIC MEDICINE      ,OH,44131-7304,Private      ,0,0,0,6,425,431
00308900,OHIO NORTHERN UNIVERSITY                ,OH,45810-1555,Private      ,1,3,4,4000,1208,5208
00309000,OHIO STATE UNIVERSITY-ALL CAMPUSES      ,OH,43210-1358,Public       ,82,155,237,42810,24173,66983
00310000,OHIO UNIVERSITY                         ,OH,45701-2979,Public       ,47,59,106,18382,5018,23400
00310002,"OHIO UNIVERSITY, ZANESVILLE CAMPUS      ",OH,43701-0000,Public       ,1,14,15,1024,1286,2310
00310003,"OHIO UNIVERSITY, LANCASTER CAMPUS       ",OH,43130-0000,Public       ,3,18,21,923,1173,2096
00310004,"OHIO UNIVERSITY, SOUTHERN CAMPUS        ",OH,45638-0000,Public       ,8,22,30,799,1499,2298
00310005,"OHIO UNIVERSITY, CHILLICOTHE CAMPUS     ",OH,45601-0000,Public       ,8,22,30,875,1707,2582
00310006,"OHIO UNIVERSITY, EASTERN CAMPUS         ",OH,43950-0000,Public       ,3,5,8,439,244,683
00310008,OHIO UNIV COLL OF OSTEOPATHIC MED       ,OH,45701-0000,Public       ,0,0,0,8,463,471
00310900,OHIO WESLEYAN UNIVERSITY                ,OH,43015-2398,Private      ,3,1,4,2743,116,2859
00311000,OTTERBEIN COLLEGE                       ,OH,43081-2006,Private      ,3,9,12,3864,1011,4875
00311300,PONTIFICAL COLLEGE JOSEPHINUM           ,OH,43235-1498,Private      ,0,0,0,29,28,57
00311401,FIRELANDS REGIONAL MEDICAL CENTER       ,OH,44870-4788,Private      ,0,1,1,70,124,194
00311500,RABBINICAL COLLEGE OF TELSHE            ,OH,44092-2584,Private      ,0,0,0,15,14,29
00311600,UNIV OF RIO GRANDE                      ,OH,45674-3131,Private      ,4,14,18,1745,1517,3262
00311601,UNIVERSITY OF RIO GRANDE                ,OH,45674-9989,Private      ,3,11,14,13,30,43
00311602,UNIVERSITY OF RIO GRANDE - MEIGS CENTER ,OH,45760-0000,Private      ,0,0,0,0,1,1
00311603,UNIVERSITY OF RIO GRANDE - CHILLICOTHE G,OH,45601-0000,Private      ,0,1,1,0,2,2
00311605,UNIVERSITY OF RIO GRANDE - COLUMBUS GRAD,OH,43215-0000,Private      ,0,2,2,0,4,4
00311607,UNIVERSITY OF RIO GRANDE -              ,OH,45764-0000,Private      ,0,0,0,0,1,1
00311900,SINCLAIR COMMUNITY COLLEGE              ,OH,45402-1460,Public       ,36,268,304,7091,15036,22127
00312100,TIFFIN UNIVERSITY                       ,OH,44883-2161,Private      ,10,39,49,1939,2012,3951
00312200,UNITED THEOLOGICAL SEMINARY             ,OH,45406-0000,Private      ,0,1,1,0,178,178
00312300,UNIVERSITY OF AKRON                     ,OH,44325-6211,Public       ,39,89,128,17897,12781,30678
00312500,UNIVERSITY OF CINCINNATI                ,OH,45221-0125,Public       ,98,355,453,21268,18091,39359
00312504,UNIV OF CINCINNATI-CLG MEDICINE         ,OH,45267-0552,Public       ,1,1,2,115,860,975
00312700,UNIVERSITY OF DAYTON                    ,OH,45469-0002,Private      ,15,86,101,9771,3729,13500
00313100,UNIVERSITY OF TOLEDO                    ,OH,43606-3390,Public       ,39,86,125,16031,8082,24113
00313101,UNIVERSITY OF TOLEDO - HEALTH SCIENCE CA,OH,43614-2598,Public       ,0,15,15,521,1635,2156
00313300,URBANA UNIVERSITY                       ,OH,43078-2091,Private      ,3,6,9,917,574,1491
00313400,URSULINE COLLEGE                        ,OH,44124-4398,Private      ,2,36,38,793,1219,2012
00313500,WALSH UNIVERSITY                        ,OH,44720-3396,Private      ,2,14,16,2434,1024,3458
00314100,WILBERFORCE UNIVERSITY                  ,OH,45384-1001,Private      ,4,6,10,1278,573,1851
00314200,WILMINGTON COLLEGE                      ,OH,45177-2499,Private      ,4,8,12,1961,520,2481
00314300,WITTENBERG UNIVERSITY                   ,OH,45501-2199,Private      ,3,3,6,2905,224,3129
00314400,XAVIER UNIVERSITY                       ,OH,45207-1035,Private      ,16,51,67,4982,2835,7817
00314500,YOUNGSTOWN STATE UNIVERSITY             ,OH,44555-0001,Public       ,13,72,85,8752,6959,15711
00398200,CLEVELAND INSTITUTE OF ART              ,OH,44106-1700,Private      ,0,2,2,743,186,929
00406000,WINEBRENNER THEOLOGICAL SEMINARY        ,OH,45840-0000,Private      ,0,1,1,0,65,65
00485200,CLARK STATE COMMUNITY COLLEGE           ,OH,45505-4795,Public       ,11,60,71,1349,3973,5322
00485300,BRADFORD SCHOOL                         ,OH,43219-0000,Proprietary  ,1,1,2,641,536,1177
00485500,DAVIS COLLEGE                           ,OH,43623-4307,Proprietary  ,2,22,24,140,826,966
00486100,UNIVERSITY OF NORTHWESTERN OHIO         ,OH,45805-1498,Private      ,20,30,50,3812,1241,5053
00486600,STAUTZENBERGER COLLEGE                  ,OH,43537-4007,Proprietary  ,9,44,53,412,1437,1849
00510200,SCH OF DIAGNOSTIC IMAGING-CLEVELAND     ,OH,44119-0000,Private      ,0,1,1,8,40,48
00512700,BROWN MACKIE COLLEGE-CINCINNATI         ,OH,45215-1107,Proprietary  ,97,477,574,1908,7574,9482
00512728,BROWN MACKIE COLLEGE-CINCINNATI - LANDMA,OH,45215-1231,Proprietary  ,0,1,1,8,56,64
00521000,CLEVELAND INSTITUTE OF ELECTRONICS      ,OH,44114-0000,Proprietary  ,1,11,12,10,273,283
00531300,NORTH CENTRAL STATE COLLEGE             ,OH,44901-0000,Public       ,7,33,40,1225,2730,3955
00575300,OWENS STATE COMMUNITY COLLEGE           ,OH,43699-0000,Public       ,34,170,204,5752,11223,16975
00648700,AULTMAN COLLEGE OF NURSING AND HEALTH SC,OH,44710-1799,Private      ,0,0,0,139,294,433
00648900,CHRIST HOSP SCH OF NURSING              ,OH,45219-2989,Private      ,0,0,0,30,30,60
00649400,GOOD SAMARITAN COLG-NURSING/HEALTH      ,OH,45220-2489,Private      ,1,4,5,191,343,534
00649800,MERIDIA HURON SCHOOL OF NURSING         ,OH,44112-4308,Private      ,0,4,4,54,433,487
00650700,TRINIT HEALTH SYSTEM SCH OF NURSING     ,OH,43952-2667,Private      ,0,0,0,50,92,142
00680400,LAKELAND COMMUNITY COLLEGE              ,OH,44094-5198,Public       ,18,88,106,2764,5533,8297
00686700,COLUMBUS STATE COMMUNITY COLLEGE        ,OH,43215-1786,Public       ,65,333,398,11216,21697,32913
00703500,KETTERING COLLEGE OF MEDICAL ARTS       ,OH,45429-1299,Private      ,6,20,26,441,759,1200
00708500,MOUNT VERNON NAZARENE UNIVERSITY        ,OH,43050-9500,Private      ,0,6,6,1626,581,2207
00708501,MOUNT VERNON NAZARENE UNIV - AGS        ,OH,43050-0000,Private      ,1,14,15,48,970,1018
00727500,JEFFERSON COMMUNITY COLLEGE             ,OH,43952-3598,Public       ,4,14,18,821,1167,1988
00747300,CHOFFIN CAREER & TECHNICAL CENTER       ,OH,44503-1628,Public       ,0,3,3,45,217,262
00759800,HOCKING TECHNICAL COLLEGE               ,OH,45764-9582,Public       ,18,74,92,3535,3610,7145
00777700,REMINGTON COLLEGE - CLEVELAND CAMPUS    ,OH,44125-1957,Proprietary  ,23,154,177,306,1676,1982
00777704,REMINGTON COLLEGE-CLEVELAND WEST CAMPUS ,OH,44070-3129,Proprietary  ,11,50,61,167,587,754
00812900,ADULT AND COMMUNITY EDUCATION @ HUDSON  ,OH,43211-2017,Public       ,0,27,27,29,398,427
00813200,TOLEDO SCHOOL OF PRACTICAL NURSING      ,OH,43613-5110,Public       ,3,7,10,97,445,542
00813300,ZANE STATE COLLEGE                      ,OH,43701-2626,Public       ,5,21,26,1104,2241,3345
00819400,AKRON SCHOOL OF PRACTICAL NRSG          ,OH,44311-0000,Public       ,0,1,1,53,180,233
00827800,TERRA COMMUNITY COLLEGE                 ,OH,43420-9670,Public       ,12,80,92,765,1762,2527
00867700,NORTHWEST STATE COMMUNITY COLLEGE       ,OH,43502-9542,Public       ,2,32,34,1038,2370,3408
00888600,PORTAGE LAKES CAREER CENTER             ,OH,44232-0000,Public       ,0,0,0,30,127,157
00908800,ITT TECHNICAL INSTITUTE                 ,OH,45414-3456,Proprietary  ,43,141,184,783,2039,2822
00915600,WAYNE COUNTY SCHOOLS CAREER CENTER      ,OH,44677-9672,Public       ,0,2,2,42,227,269
00917200,SPRINGFIELD REGIONAL SCHOOL OF NURSING  ,OH,45501-1228,Private      ,0,7,7,67,201,268
00941200,NATIONAL INSTITUTE OF TECHNOLOGY        ,OH,44221-2998,Proprietary  ,29,74,103,342,883,1225
00945101,BROWN MACKIE COLLEGE-NORTH CANTON       ,OH,44720-0000,Proprietary  ,1,33,34,156,969,1125
00953000,GERBER AKRON BEAUTY SCHOOL              ,OH,44333-3714,Proprietary  ,1,7,8,17,103,120
00953100,SPA SCHOOL (THE)                        ,OH,43214-1524,Proprietary  ,0,5,5,26,118,144
00966000,TIFFIN ACADEMY OF HAIR DESIGN           ,OH,44883-2833,Proprietary  ,4,9,13,41,96,137
00983700,ITT TECHNICAL INSTITUTE                 ,OH,44509-4098,Proprietary  ,35,110,145,897,1936,2833
00994100,BELMONT TECHNICAL COLLEGE               ,OH,43950-9766,Public       ,3,24,27,921,1543,2464
00994200,SHAWNEE STATE UNIVERSITY                ,OH,45662-4344,Public       ,15,24,39,3686,2024,5710
01001700,PAYNE THEOLOGICAL SEMINARY              ,OH,45384-0474,Private      ,0,2,2,1,130,131
01002700,JAMES A. RHODES STATE COLLEGE           ,OH,45804-3597,Public       ,5,40,45,1618,3076,4694
01016800,NATIONWIDE BEAUTY ACADEMY               ,OH,43228-1000,Proprietary  ,4,21,25,200,452,652
01028000,OHIO STATE BEAUTY ACADEMY               ,OH,45801-4950,Proprietary  ,0,0,0,92,141,233
01032300,HANNAH E MULLINS SCH-PRAC NRSG          ,OH,44460-2906,Public       ,0,0,0,19,113,132
01034500,CINCINNATI STATE TECH & COMM CLG        ,OH,45223-2690,Public       ,79,246,325,4326,8539,12865
01045300,WASHINGTON STATE CMTY COLLEGE           ,OH,45750-9225,Public       ,10,46,56,936,1605,2541
01063000,NORTHERN INSTITUTE OF COSMETOLOGY       ,OH,44052-1803,Proprietary  ,0,6,6,13,71,84
01073600,MARION TECHNICAL COLLEGE                ,OH,43302-5694,Public       ,6,24,30,664,1749,2413
01088000,CHATFIELD COLLEGE                       ,OH,45118-9705,Private      ,2,5,7,52,211,263
01088100,STARK STATE COLLEGE OF TECHNOLOGY       ,OH,44720-7299,Public       ,15,80,95,3076,7014,10090
01090600,CINCINNATI CLG OF MORTUARY SCIENCE      ,OH,45224-1428,Private      ,0,2,2,77,139,216
01092300,UNION INSTITUTE & UNIVERSITY            ,OH,45206-1925,Private      ,1,73,74,48,2181,2229
01096200,MOORE UNIV OF HAIR DESIGN               ,OH,45213-0000,Proprietary  ,0,1,1,5,31,36
01099300,HOBART INSTITUTE OF WELDING TECHNOLOGY  ,OH,45373-2400,Private      ,3,8,11,193,187,380
01100500,KAPLAN COLLEGE                          ,OH,43232-4827,Proprietary  ,12,94,106,249,1094,1343
01104600,CENTRAL OHIO TECHNICAL COLLEGE          ,OH,43055-1767,Public       ,13,51,64,1472,4567,6039
01170300,PENTA COUNTY JOINT VOCATIONAL SCH       ,OH,43551-0000,Public       ,0,1,1,24,101,125
01174400,NATIONAL BEAUTY COLLEGE                 ,OH,44720-0000,Proprietary  ,1,5,6,46,138,184
01174500,OHIO TECHNICAL COLLEGE                  ,OH,44103-1228,Proprietary  ,21,45,66,1211,516,1727
01182500,OHIO STATE SCHOOL OF COSMETOLOGY        ,OH,43224-1107,Proprietary  ,2,6,8,50,116,166
01212800,SOUTHWESTERN COLLEGE                    ,OH,45402-3003,Proprietary  ,56,271,327,319,1748,2067
01212802,SOUTHWESTERN COLLEGE                    ,OH,45005-2267,Proprietary  ,6,51,57,76,600,676
01212803,SOUTHWESTERN COLLEGE                    ,OH,45202-4304,Proprietary  ,19,120,139,215,1361,1576
01212804,SOUTHWESTERN COLLEGE                    ,OH,45246-3121,Proprietary  ,30,174,204,336,1980,2316
01216600,CAROUSEL BEAUTY COLLEGE                 ,OH,45402-8935,Proprietary  ,3,9,12,60,188,248
01224800,CENTRAL SCHOOL OF PRACTICAL NURSING     ,OH,44103-4371,Private      ,1,0,1,50,302,352
01267200,CAROUSEL BEAUTY COLLEGE                 ,OH,45044-5113,Proprietary  ,0,2,2,23,42,65
01267400,CAROUSEL OF MIAMI VALLEY BEAUTY CLG     ,OH,45424-2063,Proprietary  ,0,1,1,0,9,9
01275000,EDISON COMMUNITY COLLEGE                ,OH,45356-9239,Public       ,2,36,38,936,2057,2993
01283800,LAURA AND ALVIN SIEGAL COLLEGE OF JUDAIC,OH,44122-7197,Private      ,0,1,1,0,8,8
01284800,MOLER-HOLLYWOOD BEAUTY COLLEGE          ,OH,45202-2577,Proprietary  ,4,8,12,28,149,177
01287000,SOUTHERN STATE COMMUNITY COLLEGE        ,OH,45133-9406,Public       ,7,31,38,949,2304,3253
01289100,ANTONELLI COLLEGE                       ,OH,45202-2592,Proprietary  ,14,36,50,249,741,990
01289600,VIRGINIA MARTI COLLEGE OF ART AND DESIGN,OH,44107-0778,Proprietary  ,2,2,4,237,198,435
01313200,INTERNATIONAL CLG OF BROADCASTING       ,OH,45431-1898,Proprietary  ,0,3,3,67,140,207
02052000,OHIO INST OF PHOTOGRAPHY & TECHNOLOGY   ,OH,45439-1984,Proprietary  ,11,105,116,398,1214,1612
02054300,TRUMBULL BUSINESS COLLEGE               ,OH,44484-0000,Proprietary  ,1,10,11,104,516,620
02056800,DAYMAR COLLEGE                          ,OH,45601-1038,Proprietary  ,8,79,87,90,838,928
02056802,DAYMAR COLLEGE - LANCASTER              ,OH,43130-0000,Proprietary  ,0,1,1,6,28,34
02056803,DAYMAR COLLEGE - NEW BOSTON             ,OH,45662-4900,Proprietary  ,0,0,0,2,7,9
02056804,DAYMAR COLLEGE - JACKSON                ,OH,45640-1728,Proprietary  ,0,2,2,3,20,23
02066100,OHIO STATE COLLEGE/BARBER STYLING       ,OH,43213-0000,Proprietary  ,1,16,17,66,257,323
02069500,AKRON INSTITUTE                         ,OH,44306-0000,Proprietary  ,8,86,94,243,1246,1489
02073300,GALLIA-JACKSON-VINTON SCH ADULT ED      ,OH,45674-0000,Public       ,0,1,1,49,192,241
02077800,CENTURY SCHOOL OF COSMETOLOGY           ,OH,43952-0000,Proprietary  ,0,0,0,1,2,3
02110700,CLEVELAND INST OF DENTAL-MED ASST       ,OH,44115-2285,Proprietary  ,16,74,90,195,811,1006
02116009,SANFORD-BROWN COLLEGE - MIDDLEBURG HEIGH,OH,44130-8362,Proprietary  ,26,121,147,424,1768,2192
02116900,UPPER VALLEY JVS                        ,OH,45356-0000,Public       ,1,13,14,24,314,338
02117300,GREAT OAKS INSTITUTE OF TECHNOLOGY      ,OH,45241-1581,Public       ,3,16,19,209,962,1171
02128600,THE ART INSTITUTE OF CINCINNATI         ,OH,45246-0000,Proprietary  ,0,3,3,239,111,350
02140700,COMMUNITY EDUCATIONAL SERVICES          ,OH,44702-1710,Public       ,0,1,1,26,190,216
02152100,ACADEMY OF COURT REPORTING              ,OH,44115-0000,Proprietary  ,1,36,37,189,1747,1936
02152101,ACADEMY OF COURT REPORTING & TECHNOLOGY ,OH,43215-3902,Proprietary  ,5,51,56,23,218,241
02152102,ACADEMY OF COURT REPORTING - MIAMI-JACOB,OH,44313-3607,Proprietary  ,0,23,23,5,99,104
02152104,ACADEMY OF COURT REPORTING & TECHNOLOGY ,OH,45202-2123,Proprietary  ,1,14,15,11,100,111
02158500,OHIO BUSINESS COLLEGE                   ,OH,44055-0000,Proprietary  ,4,17,21,83,560,643
02158501,OHIO BUSINESS COLLEGE                   ,OH,44870-9953,Proprietary  ,1,7,8,85,445,530
02163900,BEATRICE ACADEMY OF BEAUTY              ,OH,44106-0000,Proprietary  ,0,0,0,14,40,54
02168100,TRI-COUNTY JOINT VOCATIONAL SCHOOL      ,OH,45764-0000,Public       ,2,8,10,22,111,133
02187900,ASHTABULA CO JOINT VOC SCH ADULT ED     ,OH,44047-0000,Public       ,1,1,2,30,194,224
02189000,ADULT CENTER FOR EDUCATION              ,OH,43701-0000,Public       ,1,13,14,55,317,372
02190700,RETS TECH CENTER                        ,OH,45459-0000,Proprietary  ,28,196,224,366,2260,2626
02192100,BUTLER TECHNOLOGY AND CAREER DEVELOPMENT,OH,45011-0000,Public       ,4,21,25,188,645,833
02196300,COLLINS CAREER CENTER                   ,OH,45619-0000,Public       ,0,6,6,183,509,692
02210800,MEDINA COUNTY CAREER CENTER             ,OH,44256-0000,Public       ,3,9,12,33,120,153
02215400,OHIO STATE SCHOOL OF COSMETOLOGY        ,OH,43207-0000,Proprietary  ,0,3,3,49,99,148
02220500,GOD'S BIBLE SCHOOL & COLLEGE            ,OH,45210-0000,Private      ,2,0,2,166,61,227
02220800,CAREER & TECHNOLOGY EDUCATION CENTERS OF,OH,43055-0000,Public       ,0,5,5,29,165,194
02239800,PIONEER CAREER & TECHNOLOGY CENTER      ,OH,44875-0000,Public       ,1,0,1,6,43,49
02245600,WARREN COUNTY CAREER CENTER             ,OH,45036-0000,Public       ,2,9,11,29,155,184
02246300,INSTITUTE OF MEDICAL-DENTAL TECH        ,OH,45246-3317,Proprietary  ,3,27,30,65,236,301
02263700,MIAMI VALLEY CAREER TECHNOLOGY CTR      ,OH,45315-0000,Public       ,1,5,6,76,401,477
02269400,EASTERN HILLS ACAD OF HAIR DESIGN       ,OH,45255-0000,Proprietary  ,0,2,2,28,95,123
02269500,WESTERN HILLS SCHOOL OF BEAUTY & HAIR DE,OH,45211-0000,Proprietary  ,3,9,12,61,340,401
02270100,OHIO HI-POINT CAREER CENTER             ,OH,43311-0000,Public       ,0,5,5,36,209,245
02272700,COLUMBIANA COUNTY CAREER CENTER         ,OH,44432-0000,Public       ,0,1,1,30,212,242
02287900,RAPHAEL'S SCHOOL OF BEAUTY CULTURE      ,OH,44446-0000,Proprietary  ,2,10,12,72,198,270
02289802,KAPLAN COLLEGE                          ,OH,45203-0000,Proprietary  ,15,120,135,79,610,689
02301400,OHIO VALLEY COLLEGE OF TECHNOLOGY       ,OH,43920-0000,Proprietary  ,7,15,22,70,249,319
02303600,BOHECKER'S BUSINESS COLLEGE             ,OH,44266-0000,Proprietary  ,8,59,67,237,776,1013
02304700,TRI-RIVERS CAREER CENTER                ,OH,43302-0000,Public       ,1,4,5,41,240,281
02311200,AMERICAN SCHOOL OF TECHNOLOGY           ,OH,43229-0000,Proprietary  ,6,70,76,50,620,670
02315500,TOLEDO ACADEMY OF BEAUTY CULTURE - EAST ,OH,43612-0000,Proprietary  ,0,6,6,42,153,195
02328500,MOLER-PICKENS BEAUTY COLLEGE            ,OH,45014-0000,Proprietary  ,2,6,8,19,61,80
02334300,INTERNATIONAL ACAD OF HAIR DESIGN       ,OH,45239-0000,Proprietary  ,2,4,6,73,69,142
02336300,KNOX COUNTY CAREER CENTER               ,OH,43050-4298,Public       ,0,1,1,39,217,256
02336700,CUYAHOGA VALLEY CAREER CENTER           ,OH,44141-1296,Public       ,1,2,3,43,208,251
02337700,PROFESSIONAL SKILLS INSTITUTE           ,OH,43607-0000,Proprietary  ,1,15,16,108,742,850
02351500,WILLOUGHBY EASTLAKE SCH OF PRAC NSG     ,OH,44094-0000,Public       ,0,0,0,14,129,143
02352800,POLARIS CAREER CENTER-ADULT ED DEPT     ,OH,44130-0000,Public       ,1,3,4,47,212,259
02354200,SCIOTO COUNTY JOINT VOCATIONAL SCH      ,OH,45648-0000,Public       ,1,6,7,81,308,389
02454400,NORTHEASTERN OHIO UNIVS COL OF MED      ,OH,44272-0000,Public       ,0,0,0,94,698,792
02497800,GREENE COUNTY CAREER CENTER             ,OH,45385-0000,Public       ,1,8,9,26,170,196
02512600,ADULT VOCATIONAL SERVICES               ,OH,44308-0000,Public       ,0,0,0,4,44,48
02519300,OHIO STATE SCH COSMETOLOGY              ,OH,43068-0000,Proprietary  ,0,0,0,10,32,42
02522700,EASTLAND-FAIRFIELD CAREER AND TECHNICAL ,OH,43125-0000,Public       ,1,11,12,77,285,362
02528300,TDDS TECHNICAL INSTITUTE                ,OH,44429-0000,Proprietary  ,0,19,19,66,571,637
02529500,HAMRICK SCHOOL                          ,OH,44256-0000,Proprietary  ,3,32,35,27,248,275
02541400,TOLEDO ACADEMY OF BEAUTY CULTURE-SO     ,OH,43614-0000,Proprietary  ,2,17,19,47,195,242
02545800,INNER STATE BEAUTY SCHOOLS              ,OH,44124-0000,Proprietary  ,2,6,8,52,255,307
02553000,SCHOOL OF ADVERTISING ART               ,OH,45440-0000,Proprietary  ,0,0,0,238,25,263
02560000,CASAL AVEDA INSTITUTE                   ,OH,44515-0000,Proprietary  ,5,13,18,119,126,245
02560700,PICKAWAY ROSS CO JOINT VOC TECH SCH     ,OH,45601-0000,Public       ,0,4,4,58,340,398
02562300,APOLLO CAREER CENTER-ADULT EDUC         ,OH,45806-0000,Public       ,0,13,13,75,519,594
02563000,RAPHAELS SCHOOL OF BEAUTY CULTURE       ,OH,44601-2847,Proprietary  ,3,10,13,61,146,207
02568600,MAHONING COUNTY CAREER & TECH CENTR     ,OH,44406-0000,Public       ,0,1,1,12,71,83
02582900,KAPLAN CAREER INSTITUTE                 ,OH,44129-6810,Proprietary  ,28,132,160,246,1093,1339
02586400,TRUMBULL CAREER & TECH CENTER-ADULT     ,OH,44483-1997,Public       ,0,4,4,57,328,385
02588500,OHIO STATE SCHOOL OF COSMETOLOGY        ,OH,43081-0000,Proprietary  ,2,3,5,67,86,153
02599711,VATTEROTT COLLEGE - CLEVELAND           ,OH,44147-3502,Proprietary  ,2,20,22,56,531,587
02603800,LORAIN COUNTY JVS ADULT CAREER CTR      ,OH,44074-9799,Public       ,0,2,2,26,148,174
02616200,BROWN MACKIE COLLEGE-FINDLAY            ,OH,45840-6848,Proprietary  ,70,274,344,885,3142,4027
02616201,BROWN MACKIE COLLEGE-FINDLAY - ART INSTI,OH,45249-3317,Proprietary  ,0,0,0,27,12,39
02620000,SANDUSKY CAREER CENTER                  ,OH,44870-4786,Public       ,0,4,4,31,185,216
03007900,GALLIPOLIS CAREER COLLEGE               ,OH,45631-2600,Proprietary  ,1,9,10,28,244,272
03015100,ALLIANCE HIGH SCH-CMTY SERVICES DIV     ,OH,44601-2899,Public       ,0,1,1,42,179,221
03015300,EHOVE CAREER CENTER                     ,OH,44846-9500,Public       ,2,15,17,69,367,436
03023700,MADISON ADULT CAREER CENTER             ,OH,44905-2718,Public       ,1,3,4,20,137,157
03024300,VALLEY BEAUTY SCHOOL                    ,OH,43725-2332,Proprietary  ,1,12,13,32,89,121
03027100,FAIRVIEW ACADEMY                        ,OH,44126-2214,Proprietary  ,1,3,4,13,57,70
03034200,WASHINGTON COUNTY CAREER CENTER ADULT TE,OH,45750-9290,Public       ,0,5,5,55,241,296
03051400,AUBURN CAREER CENTER                    ,OH,44077-9723,Public       ,1,2,3,41,186,227
03051500,US GRANT JOINT VOCATIONAL SCHOOL        ,OH,45106-9502,Public       ,0,0,0,1,32,33
03065800,OHIO INSTITUTE OF HEALTH CAREERS        ,OH,44035-2394,Proprietary  ,2,12,14,130,436,566
03065900,BUCKEYE CAREER CENTER                   ,OH,44663-9437,Public       ,1,1,2,57,208,265
03067600,RAPHAEL'S SCHOOL OF BEAUTY CULTURE      ,OH,44512-2222,Proprietary  ,1,5,6,18,67,85
03068200,OHIO CENTER FOR BROADCASTING            ,OH,44125-4220,Proprietary  ,2,24,26,192,553,745
03068202,OHIO CENTER FOR BROADCASTING - COLUMBUS ,OH,43213-2571,Proprietary  ,3,1,4,4,15,19
03071900,MOUNT CARMEL COLLEGE OF NURSING         ,OH,43222-1598,Private      ,1,8,9,573,712,1285
03072303,EVEREST INSTITUTE - COLUMBUS            ,OH,43230-6653,Proprietary  ,21,164,185,198,1342,1540
03078000,OHIO CENTER FOR BROADCASTING            ,OH,45227-1509,Proprietary  ,0,1,1,33,102,135
03079000,ETI TECHNICAL COLLEGE                   ,OH,44446-4398,Proprietary  ,2,38,40,104,389,493
03084800,DELAWARE AREA CAREER CENTER             ,OH,43015-8969,Public       ,0,1,1,6,21,27
03084801,DELAWARE AREA CAREER CENTER -           ,OH,43015-9001,Public       ,0,1,1,4,17,21
03095600,VANTAGE CAREER CENTER                   ,OH,45891-1378,Public       ,0,2,2,19,169,188
03097000,MERCY COLLEGE OF NORTHWEST OHIO         ,OH,43604-1132,Private      ,0,9,9,466,736,1202
03100100,PARAMOUNT BEAUTY ACADEMY                ,OH,45662-4136,Proprietary  ,4,2,6,46,93,139
03105400,CLEVELAND EXTENSION HIGH SCH-WEST       ,OH,44102-2298,Public       ,3,3,6,25,224,249
03116200,DAYTON BARBER COLLEGE                   ,OH,45402-2310,Proprietary  ,1,12,13,44,151,195
03116300,OHIO COLLEGE OF MASSOTHERAPY            ,OH,44321-1363,Private      ,0,2,2,72,195,267
03116400,VANGUARD-SENTINELL VOC SCH DISTRICT     ,OH,43420-1197,Public       ,0,0,0,6,37,43
03117000,ASHLAND COUNTY-W HOLMES CAREER CTR      ,OH,44805-0000,Public       ,0,4,4,15,129,144
03319300,CREATIVE IMAGES-A CERTIFIED MATRIX      ,OH,45414-2557,Proprietary  ,3,19,22,69,240,309
03319301,CREATIVE IMAGES-A CERTIFIED MATRIX      ,OH,45459-0000,Proprietary  ,1,7,8,63,167,230
03416400,VALLEY BEAUTY SCHOOL                    ,OH,43701-3624,Proprietary  ,1,5,6,20,53,73
03425300,ROSEDALE BIBLE COLLEGE                  ,OH,43029-9517,Private      ,0,0,0,77,8,85
03457300,ALLEGHENY WESLEYAN COLLEGE              ,OH,44460-9598,Private      ,0,2,2,35,14,49
03468400,NATIONAL INSTITUTE OF MASSOTHERAPY      ,OH,44319-2100,Proprietary  ,1,2,3,24,110,134
03468500,ATS INSTITUTE OF TECHNOLOGY             ,OH,44143-2216,Proprietary  ,6,31,37,61,707,768
03475400,TRI-STATE BIBLE COLLEGE                 ,OH,45680-8402,Private      ,0,0,0,9,17,26
03534400,AMERICAN INST OF ALTERNATIVE MEDICI     ,OH,43229-1113,Proprietary  ,2,14,16,37,217,254
03578300,TRI-STATE COLLEGE                       ,OH,44452-8535,Proprietary  ,0,3,3,22,58,80
03586400,MED CENTRAL COLLEGE OF NURSING          ,OH,44903-2265,Private      ,1,10,11,286,274,560
03626300,BROWN AVEDA INSTITUTE                   ,OH,44060-6212,Proprietary  ,6,10,16,180,228,408
03693300,CARNEGIE INST OF INTEGRATIVE MED/MASSOTH,OH,44260-9608,Private      ,0,9,9,9,99,108
03700300,REGENCY BEAUTY INSTITUTE - CLEVELAND    ,OH,44094-0000,Proprietary  ,9,8,17,62,144,206
03726300,TEMPLE BAPTIST COLLEGE                  ,OH,45240-0000,Private      ,0,3,3,4,22,26
03747300,BEXLEY HALL SEMINARY                    ,OH,43209-2325,Private      ,0,0,0,0,7,7
03776400,HEALING ARTS INSTITUTE                  ,OH,43551-3138,Proprietary  ,0,2,2,22,59,81
03837300,AVEDA FREDRIC'S INSTITUTE               ,OH,45208-1304,Proprietary  ,6,3,9,84,57,141
03882300,OREGON CAREER CENTER                    ,OH,43616-2631,Public       ,0,0,0,6,38,44
04050400,DESIGNER'S BEAUTY ACADEMY               ,OH,43920-0000,Proprietary  ,3,3,6,14,41,55
04074300,HONDROS COLLEGE                         ,OH,43081-3855,Proprietary  ,1,27,28,132,1016,1148
04116700,NEWLIFE TECHNICAL INSTITUTE             ,OH,43920-2920,Private      ,0,1,1,7,18,25
04117300,DAYTON SCHOOL OF MEDICAL MASSAGE        ,OH,45429-1111,Proprietary  ,17,47,64,252,767,1019
04118300,NORTHCOAST MEDICAL TRAINING ACADEMY     ,OH,44240-4174,Proprietary  ,2,16,18,103,236,339
04124500,TECHSKILLS                              ,OH,43231-0000,Proprietary  ,0,21,21,15,256,271
04125700,CUT BEAUTY SCHOOL (THE)                 ,OH,44118-2918,Proprietary  ,1,5,6,25,152,177
04137800,AVEDA INSTITUTE COLUMBUS                ,OH,43201-2333,Proprietary  ,25,12,37,75,59,134
04138000,INSTITUTE OF THERAPEUTIC MASSAGE        ,OH,45875-0350,Proprietary  ,0,4,4,9,64,73
04149100,CINCINNATI ACADEMY A PAUL MITCHELL PARTN,OH,45241-1702,Proprietary  ,6,6,12,6,6,12
        ,INVALID SCHOOL CODE                     ,  ,00000-0000,,108,352,460,7223,10625,17848
00134500,ADAMS STATE COLLEGE                     ,CO,81102-2373,Public       ,10,57,67,2095,1837,3932
00134600,ARAPAHOE COMMUNITY COLLEGE              ,CO,80160-9002,Public       ,46,211,257,1701,4006,5707
00134700,COLORADO COLLEGE                        ,CO,80903-3294,Private      ,6,3,9,2713,275,2988
00134800,COLORADO SCHOOL OF MINES                ,CO,80401-1887,Public       ,6,4,10,3885,721,4606
00134900,UNIVERSITY OF NORTHERN COLORADO         ,CO,80639-0001,Public       ,29,97,126,8502,3572,12074
00135000,COLORADO STATE UNIVERSITY               ,CO,80523-0100,Public       ,79,137,216,17411,7403,24814
00135200,DENVER  SEMINARY                        ,CO,80120-2192,Private      ,0,7,7,1,598,599
00135300,FORT LEWIS COLLEGE                      ,CO,81301-3999,Public       ,9,16,25,3401,1167,4568
00135400,ILIFF SCHOOL OF THEOLOGY                ,CO,80210-0000,Private      ,0,1,1,1,198,199
00135500,LAMAR COMMUNITY COLLEGE                 ,CO,81052-3999,Public       ,3,25,28,378,432,810
00135800,MESA STATE COLLEGE                      ,CO,81501-7682,Public       ,27,93,120,3801,2589,6390
00135900,COLORADO NORTHWESTERN COMMUNITY COLLEGE ,CO,81648-3598,Public       ,1,10,11,318,299,617
00136000,METROPOLITAN STATE CLG OF DENVER        ,CO,80204-0000,Public       ,103,350,453,9300,12528,21828
00136100,NORTHEASTERN JUNIOR COLLEGE             ,CO,80751-2399,Public       ,11,25,36,1046,475,1521
00136200,OTERO JUNIOR COLLEGE                    ,CO,81050-3346,Public       ,3,38,41,600,808,1408
00136300,REGIS UNIVERSITY                        ,CO,80221-1099,Private      ,0,177,177,2144,8482,10626
00136500,COLORADO STATE UNIVERSITY-PUEBLO        ,CO,81001-4901,Public       ,13,80,93,3619,2689,6308
00136800,TRINIDAD STATE JR COLLEGE               ,CO,81082-2396,Public       ,20,72,92,664,1156,1820
00137000,UNIVERSITY OF COLORADO-BOULDER          ,CO,80309-0077,Public       ,94,78,172,20236,8122,28358
00137100,UNIVERSITY OF DENVER                    ,CO,80208-2000,Private      ,26,136,162,5513,8906,14419
00137200,WESTERN STATE COLLEGE                   ,CO,81231-0000,Public       ,5,9,14,2057,425,2482
00163202,AQUINAS INSTITUTE OF THEOLOGY - AQUINAS ,CO,80903-1498,Private      ,0,0,0,2,7,9
00405702,NATIONAL AMERICAN UNIVERSITY            ,CO,80918-0000,Proprietary  ,0,2,2,20,174,194
00405703,NATIONAL AMERICAN UNIVERSITY            ,CO,80222-0000,Proprietary  ,1,3,4,24,197,221
00450300,EVEREST COLLEGE                         ,CO,80916-3548,Proprietary  ,31,149,180,187,1140,1327
00450600,COLORADO MOUNTAIN COLLEGE               ,CO,81602-0000,Public       ,12,49,61,1101,800,1901
00450700,EVEREST COLLEGE                         ,CO,80229-4339,Proprietary  ,36,147,183,238,1344,1582
00450701,"EVEREST COLLEGE- EVEREST COLLEGE, AURORA",CO,80012-5692,Proprietary  ,15,61,76,161,825,986
00450800,UNIVERSITY OF CO ANSCHUTZ MED CAMPUS    ,CO,80045-0000,Public       ,2,43,45,333,2909,3242
00450824,UNIVERSITY OF COLORADO DENVER - AURARIA ,CO,80217-3364,Public       ,31,102,133,5126,8740,13866
00450900,UNIV OF COLORADO AT COLO SPRINGS        ,CO,80918-3735,Public       ,14,47,61,4876,4217,9093
00559600,EMILY GRIFFITH OPPORTUNITY SCH          ,CO,80204-2197,Public       ,12,88,100,328,1301,1629
00729700,REDSTONE COLLEGE                        ,CO,80020-9988,Proprietary  ,11,36,47,354,706,1060
00754700,LINCOLN COLLEGE OF TECHNOLOGY           ,CO,80223-2013,Proprietary  ,80,82,162,1059,742,1801
00754800,WESTWOOD COLLEGE - DENVER NORTH         ,CO,80221-3653,Proprietary  ,83,310,393,2495,10631,13126
00754801,WESTWOOD COLLEGE - DENVER SOUTH         ,CO,80227-3653,Proprietary  ,13,48,61,323,1020,1343
00758200,AIMS COMMUNITY COLLEGE                  ,CO,80632-0000,Public       ,34,144,178,1589,2790,4379
00764900,ROCKY MOUNTAIN COLG OF ART & DESIGN     ,CO,80214-0000,Proprietary  ,1,3,4,678,218,896
00793300,FRONT RANGE COMMUNITY COLLEGE           ,CO,80031-2199,Public       ,96,326,422,4781,8395,13176
00863500,INTELLITEC MEDICAL INSTITUTE            ,CO,80909-1570,Proprietary  ,4,28,32,82,414,496
00887100,CONCORDE CAREER INSTITUTE               ,CO,80203-0000,Proprietary  ,11,104,115,255,1179,1434
00889600,PIKES PEAK COMMUNITY COLLEGE            ,CO,80906-5498,Public       ,90,564,654,3714,8513,12227
00940100,COLORADO CHRISTIAN UNIVERSITY           ,CO,80226-7449,Private      ,3,43,46,1254,1993,3247
00954200,COMMUNITY COLLEGE OF DENVER             ,CO,80217-2026,Public       ,54,285,339,2924,6285,9209
00954300,RED ROCKS COMMUNITY COLLEGE             ,CO,80228-1255,Public       ,53,221,274,1932,3698,5630
00985500,YESHIVA TORAS CHAIM TALMUDICAL SEM      ,CO,80204-0067,Private      ,0,0,0,1,3,4
00998100,MORGAN COMMUNITY COLLEGE                ,CO,80701-4399,Public       ,16,41,57,296,826,1122
01014800,COLORADO TECHNICAL UNIVERSITY           ,CO,80907-3896,Proprietary  ,26,442,468,582,7707,8289
01014802,COLORADO TECHNICAL UNIV - DENVER        ,CO,80111-3201,Proprietary  ,8,55,63,178,975,1153
01014805,COLORADO TECH UNIV - ON LINE            ,CO,80907-0000,Proprietary  ,142,3201,3343,1838,38062,39900
01014806,COLORADO TECH UNIV - FED EXPRESS        ,CO,80921-3800,Proprietary  ,0,4,4,12,64,76
01014807,COLORADO TECH UNIV - MCI WORLD COM      ,CO,80919-3172,Proprietary  ,0,0,0,6,21,27
01014808,COLORADO TECH UNIV - USAA               ,CO,80920-1005,Proprietary  ,0,1,1,8,14,22
01014809,COLORADO TECH UNIV - SCHRIEVER AFB      ,CO,80912-7298,Proprietary  ,0,0,0,0,2,2
01014810,COLORADO TECH UNIV - PETERSON AFB       ,CO,80914-1586,Proprietary  ,0,0,0,1,3,4
01014811,COLORADO TECH UNIV-HEWLETT PACKARD      ,CO,80919-2303,Proprietary  ,0,0,0,3,11,14
01014812,COLORADO TECHNICAL UNIVERSITY - WESTMINS,CO,80021-3498,Proprietary  ,12,64,76,202,1138,1340
01014813,COLORADO TECH UNIV - ORACLE             ,CO,80921-3660,Proprietary  ,0,1,1,0,15,15
01014815,COLORADO TECHNCL UNIV PUEBLO            ,CO,81003-2315,Proprietary  ,1,11,12,79,539,618
01070900,ARTISTIC BEAUTY COLLEGES-LAKEWOOD       ,CO,80215-0000,Proprietary  ,3,11,14,50,147,197
01073200,SAN JUAN BASINTECHNICAL COLLEGE         ,CO,81328-9196,Public       ,0,11,11,43,126,169
01157200,COLORADO SCHOOL OF TRADES               ,CO,80215-2996,Proprietary  ,2,3,5,82,181,263
01267000,BEL-REA INST OF ANIMAL TECH             ,CO,80247-3048,Proprietary  ,4,6,10,415,668,1083
01285000,INTERNATIONAL SALON AND SPA ACADEMY     ,CO,80918-3684,Proprietary  ,10,18,28,108,235,343
01287500,PICKENS TECHNICAL COLLEGE               ,CO,80011-9307,Public       ,3,13,16,225,558,783
01300700,NAZARENE BIBLE COLLEGE                  ,CO,80910-3717,Private      ,1,15,16,50,748,798
02072200,ARTISTIC BEAUTY COLLEGES-DENVER         ,CO,80212-0000,Proprietary  ,5,9,14,51,135,186
02078900,ART INSTITUTE OF COLORADO (THE)         ,CO,80203-2983,Proprietary  ,31,62,93,1906,1874,3780
02116300,PUEBLO COMMUNITY COLLEGE                ,CO,81004-0000,Public       ,61,279,340,1644,5253,6897
02117500,NAROPA UNIVERSITY                       ,CO,80302-0000,Private      ,1,1,2,346,1156,1502
02133100,COLORADO CENTER FOR MEDICAL LABORATORY S,CO,80218-0000,Private      ,0,0,0,15,40,55
02141100,ARTISTIC BEAUTY COLGS-WESTMINSTER       ,CO,80030-0000,Proprietary  ,7,18,25,112,197,309
02141102,ARTISTIC BEAUTY COLLEGES-LITTLETON      ,CO,80123-3480,Proprietary  ,0,0,0,13,24,37
02141103,ARTISTIC BEAUTY COLLEGES-AURORA         ,CO,80017-3194,Proprietary  ,3,15,18,42,99,141
02156200,DELTA - MONTROSE TECHNICAL COLLEGE      ,CO,81416-0000,Public       ,2,5,7,72,172,244
02160600,EMPIRE BEAUTY SCHOOL -THORNTON          ,CO,80241-1659,Proprietary  ,10,21,31,104,176,280
02165200,SALON PROFESSIONAL ACADEMY (THE)        ,CO,81504-5309,Proprietary  ,3,5,8,44,74,118
02167600,KAPLAN COLLEGE                          ,CO,80229-5309,Proprietary  ,13,64,77,131,655,786
02188700,DENVER ACAD OF COURT REPORTING          ,CO,80030-0000,Proprietary  ,1,15,16,19,119,138
02211901,CHEEKS INTERNATIONAL ACADEMY OF BEAUTY C,CO,80525-3053,Proprietary  ,0,1,1,8,17,25
02211902,CHEEKS INTERNATIONAL ACDMY BTY CULT     ,CO,80631-0000,Proprietary  ,0,2,2,4,9,13
02253700,INTELLITEC COLLEGE                      ,CO,80909-0000,Proprietary  ,8,69,77,148,659,807
02267500,GLENWOOD BEAUTY ACADEMY                 ,CO,81601-0000,Proprietary  ,3,3,6,26,51,77
02276900,COMMUNITY COLLEGE OF AURORA             ,CO,80011-9036,Public       ,36,267,303,1606,4058,5664
02321700,ITT TECHNICAL INSTITUTE                 ,CO,80229-5338,Proprietary  ,33,115,148,478,1394,1872
02518500,HAIR DYNAMICS EDUCATION CENTER          ,CO,80525-0000,Proprietary  ,1,7,8,86,153,239
02594300,COLLEGE AMERICA - DENVER                ,CO,80222-3380,Proprietary  ,41,254,295,445,2515,2960
02611000,HERITAGE COLLEGE                        ,CO,80212-7413,Proprietary  ,23,116,139,283,949,1232
03006300,INST OF BUSINESS & MEDICAL CAREERS      ,CO,80525-3044,Proprietary  ,19,88,107,194,950,1144
03012100,REMINGTON COLLEGE - COLORADO SPRINGS CAM,CO,80215-0000,Proprietary  ,2,19,21,47,295,342
03013100,BOULDER COLLEGE OF MASSAGE THERAPY      ,CO,80301-3295,Private      ,0,0,0,88,242,330
03014900,PLATT COLLEGE                           ,CO,80014-3141,Proprietary  ,0,7,7,50,199,249
03027400,XENON INTERNATIONAL ACADEMY III         ,CO,80014-1193,Proprietary  ,4,12,16,55,95,150
03030606,UTAH COLLEGE OF MASSAGE THERAPY - DENVER,CO,80031-2921,Proprietary  ,6,37,43,171,328,499
03030607,UTAH COLLEGE OF MASSAGE THERAPY - DENVER,CO,80012-2523,Proprietary  ,10,19,29,111,254,365
03031603,DPT BUSINESS SCHOOL                     ,CO,80223-0000,Proprietary  ,0,0,0,4,14,18
03066900,INTELLITEC COLLEGE                      ,CO,81506-3994,Proprietary  ,24,102,126,226,816,1042
03068201,OHIO CENTER FOR BROADCASTING - COLORADO ,CO,80214-4129,Proprietary  ,4,18,22,51,166,217
03076401,BRYMAN SCHOOL OF ARIZONA (THE) - ANTHEM ,CO,80014-2622,Proprietary  ,0,0,0,18,58,76
03289300,TEIKYO LORETTO HEIGHTS UNIVERSITY       ,CO,80236-2711,Private      ,0,4,4,10,144,154
03306300,MONTESSORI EDUC CRT OF THE ROCKIES      ,CO,80301-2587,Private      ,0,0,0,3,37,40
03534300,JONES INTERNATIONAL UNIVERSITY          ,CO,80112-3446,Proprietary  ,7,301,308,80,3310,3390
03545300,UNIVERSITY OF THE ROCKIES               ,CO,80903-3612,Proprietary  ,0,152,152,19,578,597
03584400,COLORADO SCHOOL OF HEALING ARTS         ,CO,80226-4332,Proprietary  ,1,5,6,63,281,344
03670300,TONI & GUY HAIRDRESSING ACADEMY         ,CO,80911-1713,Proprietary  ,1,11,12,54,116,170
03686300,COLORADO SCHOOL OF TRADITIONAL CHINESE M,CO,80206-2127,Proprietary  ,0,11,11,3,117,120
03972300,CUTTIN' UP BEAUTY ACADEMY               ,CO,80220-0000,Proprietary  ,1,12,13,17,86,103
03976300,MASSAGE THERAPY INSTITUTE OF COLORADO   ,CO,80206-2127,Proprietary  ,0,9,9,27,93,120
04080300,ASPEN UNIVERSITY                        ,CO,80246-1930,Proprietary  ,0,10,10,0,16,16
04093300,ACADEMY OF NATURAL THERAPY              ,CO,80631-3425,Proprietary  ,0,4,4,17,64,81
04121200,INSTITUTE OF TAOIST EDUCATION AND ACUPUN,CO,80027-1028,Private      ,0,0,0,0,17,17
04125100,MONTESSORI CENTRE INTERNATIONAL DENVER  ,CO,80111-5263,Private      ,0,2,2,1,11,12
04139300,NATIONAL BEAUTY COLLEGE                 ,CO,80221-0000,Proprietary  ,1,6,7,17,94,111
04148300,DENVER SCHOOL OF NURSING                ,CO,80202-1213,Proprietary  ,3,30,33,3,30,33
00267811,BRYANT & STRATTON COLLEGE - VIRGINIA BEA,VA,23462-4417,Proprietary  ,21,106,127,418,1860,2278
00370200,AVERETT UNIVERSITY                      ,VA,24541-3692,Private      ,6,127,133,1376,1929,3305
00370300,BLUEFIELD COLLEGE                       ,VA,24605-1799,Private      ,0,6,6,514,618,1132
00370400,BRIDGEWATER COLLEGE                     ,VA,22812-1599,Private      ,1,1,2,2642,108,2750
00370500,COLLEGE OF WILLIAM & MARY               ,VA,23187-8795,Public       ,11,20,31,8556,3756,12312
00370600,CHRISTOPHER NEWPORT UNIVERSITY          ,VA,23606-2998,Public       ,13,12,25,6209,810,7019
00370700,RICHARD BLAND COLLEGE                   ,VA,23805-7100,Public       ,5,8,13,890,369,1259
00370800,EASTERN MENNONITE UNIVERSITY            ,VA,22802-2462,Private      ,1,10,11,974,389,1363
00370900,EMORY & HENRY COLLEGE                   ,VA,24327-0010,Private      ,1,1,2,1316,101,1417
00371100,FERRUM COLLEGE                          ,VA,24088-2612,Private      ,7,1,8,2382,191,2573
00371200,TIDEWATER COMMUNITY COLLEGE             ,VA,23510-1910,Public       ,157,662,819,8391,16334,24725
00371300,HAMPDEN-SYDNEY COLLEGE                  ,VA,23943-0128,Private      ,2,0,2,1054,26,1080
00371400,HAMPTON UNIVERSITY                      ,VA,23668-0099,Private      ,21,17,38,9869,2535,12404
00371500,HOLLINS UNIVERSITY                      ,VA,24020-0000,Private      ,4,5,9,912,567,1479
00371900,LONGWOOD UNIVERSITY                     ,VA,23909-1899,Public       ,5,18,23,4409,647,5056
00372000,LYNCHBURG COLLEGE                       ,VA,24501-3199,Private      ,6,6,12,2948,586,3534
00372100,JAMES MADISON UNIVERSITY                ,VA,22807-3780,Public       ,18,11,29,17593,1933,19526
00372300,MARY BALDWIN COLLEGE                    ,VA,24401-3610,Private      ,5,28,33,1249,881,2130
00372400,MARYMOUNT UNIVERSITY                    ,VA,22207-4224,Private      ,7,25,32,2237,1898,4135
00372600,NATIONAL COLLEGE                        ,VA,24153-4524,Proprietary  ,55,329,384,1026,7495,8521
00372700,NORTHERN VA CMTY CLG                    ,VA,22003-3743,Public       ,182,501,683,8626,11082,19708
00372800,OLD DOMINION UNIVERSITY                 ,VA,23529-0052,Public       ,43,165,208,14972,11005,25977
00373200,RADFORD UNIVERSITY                      ,VA,24142-6905,Public       ,9,21,30,7920,1882,9802
00373300,RANDOLPH-MACON COLLEGE                  ,VA,23005-5505,Private      ,5,0,5,2096,90,2186
00373400,RANDOLPH COLLEGE                        ,VA,24503-1526,Private      ,0,1,1,1037,97,1134
00373500,VIRGINIA COMMONWEALTH UNIVERSITY        ,VA,23284-9004,Public       ,71,123,194,19414,11685,31099
00373600,ROANOKE COLLEGE                         ,VA,24153-3794,Private      ,2,0,2,2582,172,2754
00373700,SHENANDOAH UNIVERSITY                   ,VA,22601-5195,Private      ,3,14,17,2203,1741,3944
00373800,SOUTHERN VIRGINIA UNIVERSITY            ,VA,24416-3038,Private      ,5,3,8,815,195,1010
00373900,ST PAULS COLLEGE                        ,VA,23868-1299,Private      ,1,2,3,685,401,1086
00374200,SWEET BRIAR COLLEGE                     ,VA,24595-9998,Private      ,1,0,1,740,51,791
00374300,UNION THEO SEMINARY & PRESBYTRN SCH     ,VA,23227-0000,Private      ,0,0,0,2,100,102
00374400,UNIVERSITY OF RICHMOND                  ,VA,23173-0001,Private      ,6,18,24,4627,2274,6901
00374500,UNIVERSITY OF VIRGINIA - SFS            ,VA,22903-0000,Public       ,44,44,88,15756,8864,24620
00374600,UNIVERSITY OF MARY WASHINGTON           ,VA,22401-5358,Public       ,8,27,35,4154,950,5104
00374700,UNIV OF VIRGINIA'S COLLEGE AT WISE      ,VA,24293-4412,Public       ,2,2,4,1747,416,2163
00374800,EASTERN SHORE COMMUNITY COLLEGE         ,VA,23410-3000,Public       ,5,24,29,350,593,943
00374900,GEORGE MASON UNIVERSITY                 ,VA,22030-4444,Public       ,65,138,203,13770,11490,25260
00375100,PATRICK HENRY COMMUNITY COLLEGE         ,VA,24112-5311,Public       ,13,146,159,1004,2270,3274
00375200,VIRGINIA INTERMONT COLLEGE              ,VA,24201-4298,Private      ,0,3,3,532,311,843
00375300,VIRGINIA MILITARY INSTITUTE             ,VA,24450-2138,Public       ,4,0,4,1382,52,1434
00375400,VIRGINIA POLYTECH INST & STATE UNIV     ,VA,24061-2000,Public       ,45,61,106,22614,4262,26876
00375800,DANVILLE COMMUNITY COLLEGE              ,VA,24541-4004,Public       ,23,130,153,1229,2577,3806
00375900,J. SARGEANT REYNOLDS COMMUNITY CLG      ,VA,23285-0000,Public       ,39,210,249,3425,6895,10320
00376000,VIRGINIA WESTERN CMTY COLLEGE           ,VA,24038-0000,Public       ,50,153,203,2054,3507,5561
00376100,WYTHEVILLE COMMUNITY COLLEGE            ,VA,24382-3308,Public       ,34,128,162,1083,1719,2802
00376200,VIRGINIA UNIVERSITY OF LYNCHBURG        ,VA,24501-6400,Private      ,0,8,8,84,259,343
00376400,VIRGINIA STATE UNIVERSITY               ,VA,23806-0001,Public       ,28,31,59,8891,2255,11146
00376500,NORFOLK STATE UNIVERSITY                ,VA,23504-8000,Public       ,24,60,84,8266,4993,13259
00376600,VIRGINIA UNION UNIVERSITY               ,VA,23220-1711,Private      ,15,6,21,2389,863,3252
00376700,VIRGINIA WESLEYAN COLLEGE               ,VA,23502-5599,Private      ,4,4,8,1908,498,2406
00376800,WASHINGTON & LEE UNIVERSITY             ,VA,24450-0303,Private      ,1,1,2,2130,1252,3382
00400400,JOHN TYLER COMMUNITY COLLEGE            ,VA,23831-5316,Public       ,33,165,198,2280,4167,6447
00450301,"EVEREST COLLEGE- EVEREST COLLEGE, MCLEAN",VA,22102-3000,Proprietary  ,10,53,63,170,508,678
00450702,"EVEREST COLLEGE- EVEREST COLLEGE, ARLING",VA,22203-1905,Proprietary  ,23,92,115,419,1306,1725
00498800,CENTRAL VIRGINIA COMMUNITY COLLEGE      ,VA,24502-2498,Public       ,14,57,71,1248,1755,3003
00499200,MILLER-MOTTE TECHNICAL COLLEGE          ,VA,24505-0000,Proprietary  ,9,61,70,166,506,672
00499600,DABNEY S LANCASTER COMMUNITY CLG        ,VA,24422-1000,Public       ,6,24,30,455,524,979
00522300,NEW RIVER COMMUNITY COLLEGE             ,VA,24084-1127,Public       ,7,92,99,1342,1784,3126
00607500,ROANOKE MEM HOSP SCH RAD ONCOLOGY       ,VA,24033-0000,Private      ,0,0,0,3,4,7
00607501,ROANOKE MEM HOSP SCH RAD TECH           ,VA,24014-1850,Private      ,0,0,0,6,8,14
00662200,COLLEGE OF HEALTH SCIENCES - CHRV       ,VA,24031-0000,Private      ,5,16,21,474,909,1383
00681900,BLUE RIDGE COMMUNITY COLLEGE            ,VA,24486-0080,Public       ,16,60,76,1514,1585,3099
00687100,THOMAS NELSON COMMUNITY COLLEGE         ,VA,23670-0000,Public       ,48,242,290,2730,5813,8543
00709900,VIRGINIA HIGHLANDS COMMUNITY CLG        ,VA,24210-4210,Public       ,7,21,28,1106,1316,2422
00726000,SOUTHWEST VIRGINIA COMMUNITY CLG        ,VA,24641-1510,Public       ,7,37,44,1166,1729,2895
00859200,LOUISE OBICI SCHOOL OF NURSING          ,VA,23434-8038,Private      ,0,2,2,9,39,48
00859202,SUFFOLK PUB SCH-LOUISE OBICI SCH PN     ,VA,23434-0000,Private      ,0,0,0,3,8,11
00865900,LORD FAIRFAX COMMUNITY COLLEGE          ,VA,22645-0047,Public       ,36,122,158,1403,1947,3350
00866000,GERMANNA COMMUNITY COLLEGE              ,VA,22508-0339,Public       ,29,88,117,1368,2230,3598
00866100,SOUTHSIDE VIRGINIA CMTY CLG             ,VA,23821-2930,Public       ,53,292,345,1554,3145,4699
00915900,PAUL D CAMP COMMUNITY COLLEGE           ,VA,23851-0737,Public       ,15,65,80,420,1100,1520
00916000,RAPPAHANNOCK COMMUNITY COLLEGE          ,VA,23149-2616,Public       ,6,39,45,643,953,1596
00926700,EVEREST COLLEGE                         ,VA,23606-4203,Proprietary  ,13,110,123,149,1031,1180
00926701,EVEREST COLLEGE - CHESAPEAKE            ,VA,23320-2637,Proprietary  ,24,133,157,210,1306,1516
00942000,SANFORD-BROWN COLLEGE                   ,VA,22182-3913,Proprietary  ,37,84,121,501,822,1323
00953500,STAUNTON SCHOOL OF COSMETOLOGY          ,VA,24401-4323,Proprietary  ,2,3,5,23,38,61
00953700,VIRGINIA SCH OF HAIR DESIGN             ,VA,23669-0000,Proprietary  ,3,10,13,29,139,168
00962900,MOUNTAIN EMPIRE COMMUNITY COLLEGE       ,VA,24219-0700,Public       ,4,29,33,1112,1712,2824
00992800,PIEDMONT VIRGINIA COMMUNITY COLLEGE     ,VA,22902-7589,Public       ,16,79,95,1154,1723,2877
01004300,BON SECOURS MEMORIAL SCH OF NURSING     ,VA,23227-4612,Private      ,1,5,6,112,429,541
01019800,ECPI COLLEGE OF TECHNOLOGY              ,VA,23462-6542,Proprietary  ,78,384,462,3180,10435,13615
01033800,EASTERN VIRGINIA MEDICAL SCHOOL         ,VA,23501-1980,Private      ,0,0,0,21,1166,1187
01159600,RALPH'S VIRGINIA SCH OF COSMETOLOGY     ,VA,24501-2652,Proprietary  ,1,1,2,15,40,55
01162601,WESTWOOD COLLEGE - SOUTH BAY - ARLINGTON,VA,22203-4167,Proprietary  ,11,24,35,362,482,844
01162602,WESTWOOD COLLEGE - SOUTH BAY - ANNANDALE,VA,22003-2602,Proprietary  ,1,14,15,236,509,745
01274401,SOUTHSIDE REGIONAL MED CTR              ,VA,23803-5133,Proprietary  ,0,2,2,52,247,299
01274402,SOUTHSIDE REG MED CTR SCH RAD TECH      ,VA,23803-0000,Proprietary  ,0,0,0,8,23,31
02053000,LIBERTY UNIVERSITY                      ,VA,24502-0000,Private      ,75,1552,1627,14767,26973,41740
02108800,WARDS CORNER BEAUTY ACADEMY             ,VA,23505-0000,Proprietary  ,4,44,48,66,341,407
02111600,DANVILLE REGIONAL MEDICAL CENTER SCHOOL ,VA,24541-0000,Proprietary  ,0,2,2,37,83,120
02128700,CENTRAL SCHOOL OF PRACTICAL NURSING     ,VA,23502-2230,Public       ,0,0,0,25,73,98
02140000,RIVERSIDE SCHOOL OF HEALTH CAREERS      ,VA,23608-3802,Private      ,0,7,7,110,459,569
02175800,LYNCHBURG GENERAL HOSP SCH OF NURSG     ,VA,24501-0000,Private      ,0,0,0,86,146,232
02197600,WOODROW WILSON REHABILITATION CTR       ,VA,22939-0000,Public       ,0,0,0,39,35,74
02223100,HERITAGE INSTITUTE                      ,VA,22046-4400,Proprietary  ,0,0,0,4,4,8
02242400,HENRICO CTY ST MARYS HOSP PRAC NRSG     ,VA,23075-0000,Public       ,0,2,2,20,37,57
02247200,MEDSPA CAREERS INSTITUTE                ,VA,23606-0000,Proprietary  ,0,5,5,238,765,1003
02304500,HERITAGE INSTITUTE                      ,VA,20111-0000,Proprietary  ,12,58,70,129,545,674
02320900,TIDEWATER TECH                          ,VA,23517-0000,Proprietary  ,12,48,60,126,582,708
02334400,CENTURA COLLEGE                         ,VA,23452-0000,Proprietary  ,50,418,468,624,4824,5448
02340000,COLONIAL HEIGHTS BEAUTY ACADEMY         ,VA,23834-0000,Proprietary  ,0,0,0,12,49,61
02342700,FORTIS COLLEGE                          ,VA,23502-4101,Proprietary  ,2,29,31,142,439,581
02342701,FORTIS COLLEGE - RICHMOND CAMPUS        ,VA,23236-3472,Proprietary  ,9,37,46,118,403,521
02535400,ECPI TECHNICAL COLLEGE                  ,VA,23236-0000,Proprietary  ,6,15,21,385,625,1010
02538800,SUFFOLK BEAUTY ACADEMY                  ,VA,23434-0000,Proprietary  ,5,5,10,19,66,85
02541200,STRATFORD UNIVERSITY                    ,VA,22043-0000,Proprietary  ,11,67,78,138,644,782
02541201,STRATFORD UNIVERSITY-WOODBRIDGE         ,VA,22192-0000,Proprietary  ,1,9,10,38,161,199
02605900,TESST COLLEGE OF TECHNOLOGY             ,VA,22312-6342,Proprietary  ,0,0,0,13,41,54
02610100,WASHINGTON COUNTY ADULT SKILL CTR       ,VA,24210-2346,Public       ,1,7,8,24,136,160
03002400,GRAHAM WEBB INTERNATIONAL ACAD HAIR     ,VA,22209-2129,Proprietary  ,2,8,10,51,93,144
03010700,BAR PALMA BEAUTY CAREERS  ACADEMY       ,VA,24014-2255,Proprietary  ,3,9,12,32,92,124
03042800,"VIRGINIA BEACH CITY SCHOOLS, SCH.-PR.NSG",VA,23456-0038,Public       ,1,0,1,13,44,57
03091100,ACT COLLEGE                             ,VA,22209-2297,Proprietary  ,8,57,65,147,572,719
03091300,REGENT UNIVERSITY                       ,VA,23464-9800,Private      ,4,122,126,582,5538,6120
03092700,ECPI TECHNICAL COLLEGE-ROANOKE          ,VA,24012-1603,Proprietary  ,6,28,34,153,551,704
03096500,SPRINGFIELD BEAUTY ACADEMY              ,VA,22003-3016,Proprietary  ,1,19,20,15,124,139
03106500,SENTARA NORFOLK GENERAL HOSPITAL        ,VA,23320-2843,Private      ,2,5,7,145,562,707
03116900,BAPTIST THEOLOGICAL SEM.-RICHMOND       ,VA,23227-0000,Private      ,0,0,0,2,42,44
03126300,TIDEWATER TECH AVIATION                 ,VA,23320-5987,Proprietary  ,19,44,63,118,444,562
03126400,CENTURA COLLEGE                         ,VA,23235-5230,Proprietary  ,13,59,72,157,637,794
03126401,CENTURA COLLEGE - WEST                  ,VA,23294-0000,Proprietary  ,0,2,2,6,50,56
03127500,ADVANCED TECHNOLOGY INSTITUTE           ,VA,23462-2409,Proprietary  ,7,11,18,450,475,925
03280400,VIRGINIA SCHOOL OF MASSAGE              ,VA,22903-0000,Proprietary  ,1,18,19,74,199,273
03409500,RICHMOND SCHOOL OF HEALTH AND TECH      ,VA,23227-0000,Proprietary  ,10,84,94,161,915,1076
03455300,CRESCENT COSMETOLOGY UNIVERSITY         ,VA,23666-3115,Proprietary  ,0,1,1,5,11,16
03559300,APPALACHIAN SCHOOL OF LAW               ,VA,24614-0000,Private      ,0,0,0,3,865,868
03638400,TAP THIS VALLEY WORKS CTR FOR EMPLO     ,VA,24016-1901,Private      ,0,1,1,0,20,20
03645400,RUDY & KELLY ACADEMY OF HAIR AND NA     ,VA,23464-6857,Proprietary  ,4,12,16,79,143,222
03654300,CAREER TRAINING SOLUTIONS               ,VA,22406-1014,Proprietary  ,8,41,49,65,366,431
03709300,EDWARD VIA VIRGINIA CLG OSTEOPATHIC MED ,VA,24060-6360,Private      ,0,0,0,11,670,681
03872400,INSTITUTE FOR THE PSYCHOLOGICAL SCIENCES,VA,22202-3609,Private      ,0,2,2,0,80,80
03876300,CULPEPER COSMETOLOGY TRAINING CENTER    ,VA,22701-3155,Public       ,0,2,2,12,46,58
03883400,AVIATION INSTITUTE OF MAINTENANCE       ,VA,20110-4156,Proprietary  ,6,25,31,74,298,372
04038400,AVI CAREER INSTITUTE                    ,VA,22066-1839,Proprietary  ,0,12,12,5,59,64
04124000,DOMINION SCHOOL OF HAIR DESIGN          ,VA,23062-2221,Proprietary  ,0,3,3,12,26,38
04133400,CENTURA COLLEGE                         ,VA,22312-2670,Proprietary  ,0,14,14,27,108,135
04133800,SOUTHEAST CULINARY & HOSPITALITY COLLEGE,VA,24201-4159,Proprietary  ,1,2,3,22,47,69
04140000,GLOBAL HEALTH NURSE TRAINING SERVICES   ,VA,22314-4585,Proprietary  ,0,9,9,4,57,61
00107000,THUNDERBIRD SCHOOL OF GLOBAL MANAGEMENT ,AZ,85306-6000,Private      ,0,3,3,3,788,791
00107100,ARIZONA WESTERN COLLEGE                 ,AZ,85366-0000,Public       ,88,99,187,3265,3668,6933
00107200,COCHISE COLLEGE                         ,AZ,85607-6190,Public       ,25,63,88,1176,2091,3267
00107300,EASTERN ARIZONA COLLEGE                 ,AZ,85552-0769,Public       ,11,37,48,1127,1130,2257
00107400,GRAND CANYON UNIVERSITY                 ,AZ,85017-3030,Proprietary  ,22,845,867,2014,34235,36249
00107600,GLENDALE COMMUNITY COLLEGE              ,AZ,85302-3090,Public       ,108,279,387,5980,8096,14076
00107700,MESA COMMUNITY COLLEGE                  ,AZ,85202-4866,Public       ,130,409,539,7086,10867,17953
00107800,PHOENIX COLLEGE                         ,AZ,85013-4234,Public       ,55,286,341,3288,7116,10404
00107900,YAVAPAI COLLEGE                         ,AZ,86301-3297,Public       ,15,77,92,1526,2572,4098
00108100,ARIZONA STATE UNIV (ALL CAMPUSES)       ,AZ,85287-0412,Public       ,374,467,841,33850,26408,60258
00108200,NORTHERN ARIZONA UNIVERSITY             ,AZ,86011-0001,Public       ,60,252,312,15003,10732,25735
00108300,UNIVERSITY OF ARIZONA                   ,AZ,85721-0066,Public       ,177,147,324,21452,12499,33951
00165701,MIDWESTERN UNIVERSITY                   ,AZ,85308-0000,Private      ,0,5,5,72,2407,2479
00446700,TUCSON COLLEGE                          ,AZ,85710-0000,Proprietary  ,12,68,80,163,768,931
00711300,SOUTHWESTERN COLLEGE                    ,AZ,85032-7097,Private      ,0,5,5,350,193,543
00726600,PIMA COUNTY COMMUNITY COLLEGE           ,AZ,85709-5000,Public       ,143,392,535,7794,12141,19935
00728300,CENTRAL ARIZONA COLLEGE                 ,AZ,85228-9779,Public       ,37,140,177,1626,2791,4417
00822100,UNIVERSAL TECHNICAL INSTITUTE           ,AZ,85323-7946,Proprietary  ,253,318,571,9801,5536,15337
00824600,DINè COLLEGE                            ,AZ,86556-0126,Public       ,15,40,55,662,1113,1775
00830300,GATEWAY COMMUNITY COLLEGE               ,AZ,85034-1795,Public       ,25,188,213,1117,4414,5531
00830302,MARICOPA SKILL CENTER                   ,AZ,85034-0000,Public       ,12,106,118,341,1343,1684
00830400,SCOTTSDALE COMMUNITY COLLEGE            ,AZ,85250-0000,Public       ,40,121,161,2581,3355,5936
00886400,ARIZONA ACADEMY OF BEAUTY               ,AZ,85712-5021,Proprietary  ,1,11,12,37,70,107
00886500,ARTISTIC BEAUTY COLLEGES-TUCSON         ,AZ,85716-3999,Proprietary  ,15,41,56,192,375,567
00886501,ARTISTIC BEAUTY COLLEGES - TUCSON  - NOR,AZ,85705-1665,Proprietary  ,1,0,1,17,10,27
00945100,BROWN MACKIE COLLEGE                    ,AZ,85712-5300,Proprietary  ,41,219,260,496,2605,3101
01084700,ARIZONA AUTOMOTIVE INSTITUTE            ,AZ,85301-3503,Proprietary  ,41,134,175,558,1291,1849
01085800,EARLS ACADEMY OF BEAUTY                 ,AZ,85210-4010,Proprietary  ,18,44,62,159,314,473
01157000,PIMA MEDICAL INSTITUTE-MESA             ,AZ,85202-2950,Proprietary  ,0,0,0,84,308,392
01168900,REFRIGERATION SCHOOL                    ,AZ,85034-0000,Proprietary  ,11,84,95,141,811,952
01180200,ARIZONA ACADEMY OF BEAUTY-NORTH         ,AZ,85705-2720,Proprietary  ,2,3,5,30,83,113
01180800,ARTISTIC BEAUTY COLLEGES-FLAGSTAFF      ,AZ,86004-5119,Proprietary  ,14,37,51,187,411,598
01180801,CLG OF BEAUTY ARTS & SCI/CHANDLER       ,AZ,85224-0000,Proprietary  ,0,0,0,40,130,170
01180802,CLG OF BEAUTY ARTS & SCI/PRESCOTT       ,AZ,86303-0000,Proprietary  ,1,0,1,19,29,48
01186200,NORTHLAND PIONEER COLLEGE               ,AZ,86025-2996,Public       ,16,48,64,479,1504,1983
01186400,MOHAVE COMMUNITY COLLEGE                ,AZ,86409-1238,Public       ,42,221,263,1220,4828,6048
01218400,INTERNATIONAL ACAD OF HAIR DESIGN       ,AZ,85225-7198,Proprietary  ,4,9,13,94,185,279
01234300,ARTISTIC BEAUTY COLLEGES-PHOENIX        ,AZ,85304-0000,Proprietary  ,13,10,23,221,392,613
01234301,EMPIRE BEAUTY SCHOOL - AVONDALE         ,AZ,85323-2352,Proprietary  ,0,1,1,31,51,82
01293700,ARTISTIC BEAUTY COLLEGES - PARADISE VALL,AZ,85257-0000,Proprietary  ,3,5,8,64,85,149
02065200,ITT TECHNICAL INSTITUTE                 ,AZ,85282-0000,Proprietary  ,63,188,251,904,2614,3518
02065300,PRESCOTT COLLEGE                        ,AZ,86301-0000,Private      ,2,22,24,425,1096,1521
02071200,KAPLAN COLLEGE                          ,AZ,85029-4349,Proprietary  ,37,126,163,355,1519,1874
02098800,UNIVERSITY OF PHOENIX                   ,AZ,85040-0000,Proprietary  ,2745,51960,54705,28013,507367,535380
02100500,UNIVERSAL TECHNICAL INSTITUTE           ,AZ,85027-0000,Proprietary  ,197,357,554,7829,8116,15945
02100600,APOLLO COLLEGE                          ,AZ,85015-0000,Proprietary  ,95,432,527,2079,6792,8871
02113800,ROBERTO-VENN SCH OF LUTHIERY            ,AZ,85040-0000,Proprietary  ,0,1,1,42,57,99
02146600,SOUTH MOUNTAIN COMMUNITY COLLEGE        ,AZ,85040-0000,Public       ,34,96,130,1355,2451,3806
02171500,WESTERN INTERNATIONAL UNIVERSITY        ,AZ,85021-0000,Proprietary  ,4,181,185,68,2501,2569
02174900,COLLINS COLLEGE                         ,AZ,85040-4000,Proprietary  ,10,15,25,1542,1241,2783
02177500,RIO SALADO COMMUNITY COLLEGE            ,AZ,85281-0000,Public       ,43,718,761,1173,10038,11211
02192300,MARICOPA BEAUTY COLLEGE                 ,AZ,85323-0000,Proprietary  ,0,4,4,54,78,132
02199900,AMERICAN INDIAN CLG-ASSEMBLIES GOD      ,AZ,85021-0000,Private      ,0,0,0,57,72,129
02217100,PIMA MEDICAL INSTITUTE                  ,AZ,85716-0000,Proprietary  ,178,632,810,2351,7659,10010
02218800,IIA COLLEGE                             ,AZ,85019-1600,Proprietary  ,65,280,345,477,2573,3050
02218804,IIA COLLEGE - MESA                      ,AZ,85204-4448,Proprietary  ,1,15,16,2,19,21
02218805,IIA COLLEGE - TUCSON                    ,AZ,85711-5444,Proprietary  ,5,20,25,5,20,25
02220300,ARTISTIC BEAUTY COLLEGES-GLENDALE       ,AZ,85051-0000,Proprietary  ,16,43,59,129,363,492
02263100,ANTHEM COLLEGE                          ,AZ,85014-0000,Proprietary  ,51,216,267,1112,3755,4867
02280500,CHARLES OF ITALY BEAUTY COLLEGE         ,AZ,86403-0000,Proprietary  ,4,7,11,39,86,125
02295000,EVEREST COLLEGE                         ,AZ,85021-1610,Proprietary  ,109,859,968,909,7655,8564
02295002,EVEREST COLLEGE - MESA                  ,AZ,85206-4704,Proprietary  ,18,86,104,192,816,1008
02317800,AMERICAN INSTITUTE OF TECHNOLOGY        ,AZ,85043-0000,Proprietary  ,3,208,211,48,1381,1429
02361100,ITT TECHNICAL INSTITUTE                 ,AZ,85704-0000,Proprietary  ,90,178,268,808,1772,2580
02491500,THE ART CENTER DESIGN COLLEGE           ,AZ,85716-0000,Proprietary  ,4,13,17,276,477,753
02521500,LAMSON COLLEGE                          ,AZ,85284-1141,Proprietary  ,9,61,70,159,774,933
02533200,FRANK LLOYD WRIGHT SCHOOL OF ARCHITECTUR,AZ,85261-4430,Private      ,0,1,1,3,5,8
02559000,UNIVERSITY OF ADVANCING TECHNOLOGY      ,AZ,85283-0000,Proprietary  ,11,15,26,1072,662,1734
02561900,TONI AND GUY HAIRDRESSING ACADEMY       ,AZ,85251-3301,Proprietary  ,11,12,23,181,157,338
02582700,CORTIVA INSTITUTE - TUCSON              ,AZ,85710-3503,Proprietary  ,4,9,13,57,219,276
02616700,SCOTTSDALE CULINARY INSTITUTE           ,AZ,85251-2729,Proprietary  ,17,46,63,1114,2021,3135
02623600,PARADISE VALLEY COMMUNITY COLLEGE       ,AZ,85032-1210,Public       ,37,82,119,2078,2998,5076
02623800,CORTIVA INSTITUTE - SCOTTSDALE          ,AZ,85257-4218,Proprietary  ,3,9,12,57,183,240
03005000,SAFFORD COLLEGE OF BEAUTY CULTURE       ,AZ,85546-3309,Proprietary  ,2,10,12,13,49,62
03010613,VIRGINIA COLLEGE - GOLF ACADEMY OF ARIZO,AZ,85225-6742,Proprietary  ,8,12,20,118,203,321
03030604,UTAH COLLEGE OF MASSAGE THERAPY - ARIZON,AZ,85282-0000,Proprietary  ,14,59,73,236,421,657
03030605,UTAH COLLEGE OF MASSAGE THERAPY - ARIZON,AZ,85051-3470,Proprietary  ,15,19,34,224,436,660
03034400,CONSERVATORY RECORDING ARTS & SCIS      ,AZ,85282-1707,Proprietary  ,12,11,23,580,650,1230
03072200,CHANDLER-GILBERT COMMUNITY COLLEGE      ,AZ,85225-2499,Public       ,44,116,160,2682,3570,6252
03076400,BRYMAN SCHOOL OF ARIZONA                ,AZ,85029-4919,Proprietary  ,143,450,593,1736,4505,6241
03076406,BRYMAN SCHOOL OF ARIZONA (THE) - TEMPE  ,AZ,85284-0000,Proprietary  ,0,0,0,7,9,16
03097800,CARSTEN INSTITUTE OF HAIR & BEAUTY      ,AZ,85282-5404,Proprietary  ,5,21,26,125,159,284
03100400,COCONINO COUNTY COMMUNITY COLLEGE       ,AZ,86001-2701,Public       ,12,41,53,964,1460,2424
03107000,SOUTHWEST CLG OF NATUROPATHIC MED       ,AZ,85282-0000,Private      ,0,2,2,4,457,461
03115000,ARIZONA COLLEGE OF ALLIED HEALTH        ,AZ,85302-3843,Proprietary  ,5,73,78,158,787,945
03120300,COLLEGE AMERICA                         ,AZ,86004-3936,Proprietary  ,19,77,96,170,612,782
03156300,ESTRELLA MOUNTAIN COMMUNITY COLLEGE     ,AZ,85392-1010,Public       ,50,101,151,1759,2752,4511
03156301,ESTRELLA MOUNTAIN COMMUNITY COLLEGE - SO,AZ,85392-1010,Public       ,14,37,51,482,937,1419
03347300,INTERNATIONAL BAPTIST COLLEGE           ,AZ,85282-7504,Private      ,0,0,0,46,21,67
03445300,HDS TRUCK DRIVING INSTITUTE             ,AZ,85731-0000,Proprietary  ,0,15,15,6,193,199
03478400,PHOENIX SEMINARY                        ,AZ,85018-7611,Private      ,0,0,0,1,75,76
03572300,EAST VALLEY INSTITUTE OF TECHNOLOGY     ,AZ,85201-6910,Public       ,3,1,4,91,115,206
03593300,SOUTHWEST INSTITUTE OF HEALING ARTS     ,AZ,85281-3658,Proprietary  ,6,25,31,100,575,675
03617500,PHOENIX INSTITUTE OF HERBAL MEDICINE & A,AZ,85012-0000,Proprietary  ,0,3,3,7,143,150
03695500,ARIZONA SCHOOL OF ACUPUNCTURE AND ORIENT,AZ,85712-1100,Proprietary  ,0,0,0,5,64,69
03740500,ART INSTITUTE OF TUCSON (THE)           ,AZ,85712-2732,Proprietary  ,6,20,26,212,290,502
03784400,TOHONO O'ODHAM COMMUNITY COLLEGE        ,AZ,85634-3129,Public       ,1,3,4,17,86,103
03814300,TURNING POINT BEAUTY COLLEGE            ,AZ,85222-4229,Proprietary  ,2,12,14,18,60,78
04051300,ART INSTITUTE OF PHOENIX (THE)          ,AZ,85021-2859,Proprietary  ,28,63,91,1208,1210,2418
04059300,TUCSON COLLEGE OF BEAUTY                ,AZ,85705-2451,Proprietary  ,7,14,21,74,85,159
04120900,ARIZONA CULINARY INSTITUTE              ,AZ,85259-4939,Proprietary  ,2,7,9,166,242,408
04131400,PHOENIX SCHOOL OF LAW                   ,AZ,85012-3330,Proprietary  ,0,5,5,8,446,454
04138800,MODERN TECHNIQUES BEAUTY COLLEGE        ,AZ,86403-2974,Proprietary  ,2,2,4,7,9,16
04152900,STUDIO ACADEMY OF BEAUTY (THE)          ,AZ,85224-3600,Proprietary  ,2,4,6,2,4,6
00142800,DELAWARE STATE UNIVERSITY               ,DE,19901-2277,Public       ,28,17,45,6233,1636,7869
00142900,GOLDEY BEACOM COLLEGE                   ,DE,19808-1993,Private      ,4,13,17,492,383,875
00143100,UNIVERSITY OF DELAWARE                  ,DE,19716-0099,Public       ,31,29,60,20864,2407,23271
00143300,WESLEY COLLEGE                          ,DE,19901-3875,Private      ,5,10,15,1943,401,2344
00143301,WESLEY COLLEGE-CTR FOR ADULT STUDIE     ,DE,19720-0000,Private      ,0,6,6,41,425,466
00331301,WIDENER UNIV SCHOOL OF LAW - DE         ,DE,19803-0000,Private      ,1,8,9,40,1695,1735
00705300,DELAWARE TECH & CMTY COLLEGE-OWENS      ,DE,19947-0000,Public       ,13,85,98,1695,2481,4176
00794800,WILMINGTON UNIVERSITY                   ,DE,19720-6491,Private      ,20,144,164,1860,5502,7362
01172700,DELAWARE TECH & CMTY CLG-TERRY          ,DE,19901-8736,Public       ,13,85,98,1562,2159,3721
01195002,DELAWARE COLLEGE OF ART & DESIGN        ,DE,19801-0000,Private      ,0,0,0,265,44,309
02125200,BEEBE SCHOOL OF NURSING                 ,DE,19958-1462,Private      ,1,1,2,32,48,80
02144900,DELAWARE TECH & CMTY CLG-STANTN/WLM     ,DE,19801-0000,Public       ,39,105,144,2728,3184,5912
02190400,SCHILLING DOUGLAS SCH OF HAIR DSGN      ,DE,19711-0000,Proprietary  ,3,6,9,74,155,229
02586902,STAR TECHNICAL INSTITUTE -              ,DE,19901-4615,Proprietary  ,0,1,1,28,215,243
03025800,DAWN TRAINING CENTRE                    ,DE,19805-1511,Proprietary  ,5,66,71,69,559,628
03543300,HARRIS SCHOOL OF BUSINESS               ,DE,19803-5341,Proprietary  ,17,75,92,175,616,791
03702300,DELAWARE LEARNING INSTITUTE OF COSMETOLO,DE,19939-9759,Proprietary  ,2,5,7,44,124,168
04130700,ACADEMY OF MASSAGE AND BODYWORK         ,DE,19701-1321,Proprietary  ,1,3,4,14,34,48
04139800,DELAWARE COLLEGE OF ART & DESIGN        ,DE,19801-3007,Private      ,1,0,1,54,28,82
        ,FEDERAL STUDENT AID USE ONLY            ,DC,20202-0000,,0,0,0,11,1740,1751
00143400,AMERICAN UNIVERSITY                     ,DC,20016-8020,Private      ,13,23,36,11455,9525,20980
00143700,CATHOLIC UNIVERSITY OF AMERICA          ,DC,20064-0002,Private      ,8,26,34,4741,2324,7065
00143711,"CATHOLIC UNIV AMERICA, LAW SCHOOL       ",DC,20064-0000,Private      ,0,0,0,30,1625,1655
00144100,UNIV OF THE DISTRICT OF COLUMBIA        ,DC,20008-0000,Public       ,15,79,94,1928,4135,6063
00144102,UNIV OF DIST OF COLUMBIA LAW SCH        ,DC,20008-0000,Public       ,0,5,5,39,675,714
00144300,GALLAUDET UNIVERSITY                    ,DC,20002-3695,Private      ,4,3,7,768,751,1519
00144400,GEORGE WASHINGTON UNIVERSITY            ,DC,20052-2353,Private      ,20,159,179,11286,9147,20433
00144402,GEORGE WASHINGTON UNIV LAW SCHL         ,DC,20052-0000,Private      ,0,2,2,26,4559,4585
00144403,GEORGE WASHINGTON UNIV SCH MED          ,DC,20052-0000,Private      ,0,1,1,33,1242,1275
00144500,GEORGETOWN UNIVERSITY                   ,DC,20057-1252,Private      ,14,45,59,12148,5525,17673
00144501,"GEORGETOWN UNIV, SCH OF MEDICINE        ",DC,20007-0000,Private      ,0,0,0,29,1196,1225
00144502,GEORGETOWN UNIVERSITY - GRADUATE SCHOOL ,DC,20057-0004,Private      ,2,43,45,2,54,56
00144503,GEORGETOWN UNIV LAW CENTER              ,DC,20001-0000,Private      ,0,4,4,29,5506,5535
00144800,HOWARD UNIVERSITY                       ,DC,20059-0001,Private      ,35,47,82,13925,8242,22167
00145600,SOUTHEASTERN UNIVERSITY                 ,DC,20024-2788,Private      ,0,9,9,177,904,1081
00145900,STRAYER UNIVERSITY                      ,DC,20005-2603,Proprietary  ,102,1897,1999,2085,47980,50065
00146000,TRINITY UNIVERSITY                      ,DC,20017-1004,Private      ,1,41,42,994,1670,2664
00146400,WESLEY THEOLOGICAL SEMINARY             ,DC,20016-0000,Private      ,0,4,4,1,289,290
00207701,JOHNS HOPKINS UNIV SCH ADV INTL STU     ,DC,20036-0000,Private      ,0,5,5,60,1286,1346
01006500,WASHINGTON THEOLOGICAL UNION            ,DC,20012-0000,Private      ,0,0,0,0,38,38
01195000,THE CORCORAN COLLEGE OF ART & DESIG     ,DC,20006-4804,Private      ,1,1,2,429,294,723
01266500,HARRISON CTR FOR CAREER EDUCATION       ,DC,20001-5303,Private      ,0,0,0,4,14,18
01280300,DOMINICAN HOUSE OF STUDIES              ,DC,20017-1584,Private      ,0,0,0,1,13,14
02132800,NAT'L CONSERVATORY DRAMATIC ARTS        ,DC,20007-2758,Private      ,2,1,3,8,25,33
02279200,DUDLEY BEAUTY COLG-WASHINGTON           ,DC,20018-0000,Proprietary  ,4,10,14,60,160,220
02588900,SANZ SCHOOL                             ,DC,20006-0000,Proprietary  ,47,202,249,351,1601,1952
03104300,CAREER BLAZERS LEARNING CENTER OF WASHIN,DC,20037-1881,Proprietary  ,12,69,81,152,958,1110
03218300,POTOMAC COLLEGE                         ,DC,20016-1860,Proprietary  ,8,55,63,69,710,779
03409600,BENNETT CAREER INSTITUTE                ,DC,20017-1754,Proprietary  ,2,26,28,75,301,376
03750300,TECHNICAL LEARNING CENTERS              ,DC,20005-3415,Proprietary  ,9,50,59,38,323,361
00154100,ABRAHAM BALDWIN AGRICULTURAL CLG        ,GA,31794-0000,Public       ,23,33,56,3410,1693,5103
00154200,AGNES SCOTT COLLEGE                     ,GA,30030-3797,Private      ,1,5,6,1189,318,1507
00154300,DARTON COLLEGE                          ,GA,31707-3098,Public       ,66,216,282,2586,4958,7544
00154400,ALBANY STATE UNIVERSITY                 ,GA,31705-2796,Public       ,43,89,132,6762,3746,10508
00154500,ANDREW COLLEGE                          ,GA,39840-1313,Private      ,7,0,7,453,49,502
00154600,ARMSTRONG ATLANTIC STATE UNIVERSITY     ,GA,31419-1997,Public       ,43,132,175,4186,5418,9604
00154700,ATLANTA CHRISTIAN COLLEGE               ,GA,30344-1999,Private      ,2,31,33,398,535,933
00155200,AUGUSTA STATE UNIVERSITY                ,GA,30904-2200,Public       ,39,92,131,4495,4822,9317
00155400,BERRY COLLEGE                           ,GA,30149-5007,Private      ,4,8,12,2305,237,2542
00155500,THOMAS UNIVERSITY                       ,GA,31792-7499,Private      ,7,44,51,330,1154,1484
00155600,BRENAU UNIVERSITY                       ,GA,30501-3668,Private      ,11,109,120,1071,2692,3763
00155700,BREWTON PARKER COLLEGE                  ,GA,30445-0000,Private      ,14,14,28,710,724,1434
00155800,COASTAL GEORGIA COMMUNITY COLLEGE       ,GA,31520-3644,Public       ,22,98,120,1383,2572,3955
00155900,CLARK ATLANTA UNIVERSITY                ,GA,30314-4385,Private      ,36,45,81,13726,4369,18095
00156000,COLUMBIA THEOLOGICAL SEMINARY           ,GA,30031-0000,Private      ,1,0,1,5,192,197
00156100,COLUMBUS STATE UNIVERSITY               ,GA,31907-5645,Public       ,43,98,141,5255,4796,10051
00156200,GEORGIA PERIMETER COLLEGE               ,GA,30021-0000,Public       ,207,522,729,12813,17352,30165
00156300,EMMANUEL COLLEGE                        ,GA,30639-0000,Private      ,2,1,3,707,213,920
00156400,EMORY UNIVERSITY                        ,GA,30322-1960,Private      ,25,98,123,10569,8698,19267
00156600,FORT VALLEY STATE UNIVERSITY            ,GA,31030-3298,Public       ,45,37,82,5151,1673,6824
00156700,GAINESVILLE STATE COLLEGE               ,GA,30503-0000,Public       ,59,89,148,5321,2744,8065
00156800,INTERDENOMINATIONAL THEOLOGY CENTER     ,GA,30314-0000,Private      ,0,3,3,3,548,551
00156900,GEORGIA INSTITUTE OF TECHNOLOGY         ,GA,30332-0002,Public       ,110,74,184,13468,3834,17302
00157000,SOUTHERN POLYTECHNIC STATE UNIV         ,GA,30060-2896,Public       ,17,75,92,2732,2235,4967
00157100,GEORGIA MILITARY COLLEGE                ,GA,31061-3398,Public       ,74,144,218,3348,4324,7672
00157200,GEORGIA SOUTHERN UNIVERSITY             ,GA,30460-8065,Public       ,267,176,443,16965,5675,22640
00157300,GEORGIA SOUTHWESTERN STATE UNIV         ,GA,31709-4693,Public       ,16,62,78,1972,1766,3738
00157400,GEORGIA STATE UNIVERSITY                ,GA,30303-3010,Public       ,130,482,612,21208,22398,43606
00157500,GORDON COLLEGE                          ,GA,30204-1762,Public       ,42,49,91,3756,2282,6038
00157700,KENNESAW STATE UNIVERSITY               ,GA,30144-5591,Public       ,118,320,438,12481,11852,24333
00157800,LAGRANGE COLLEGE                        ,GA,30240-2999,Private      ,6,74,80,1150,669,1819
00157900,MEDICAL COLLEGE OF GEORGIA              ,GA,30912-0004,Public       ,20,30,50,567,2488,3055
00158000,MERCER UNIVERSITY                       ,GA,31207-0003,Private      ,30,172,202,4027,7603,11630
00158100,MIDDLE GEORGIA COLLEGE                  ,GA,31014-1599,Public       ,38,77,115,3362,1930,5292
00158200,MOREHOUSE COLLEGE                       ,GA,30314-3773,Private      ,10,8,18,5078,936,6014
00158500,NORTH GEORGIA COLLEGE & STATE UNIV      ,GA,30597-0001,Public       ,40,65,105,3432,1832,5264
00158600,OGLETHORPE UNIVERSITY                   ,GA,30319-2737,Private      ,1,9,10,1632,478,2110
00158700,PAINE COLLEGE                           ,GA,30901-3182,Private      ,14,7,21,1636,516,2152
00158800,PIEDMONT COLLEGE                        ,GA,30535-5644,Private      ,8,218,226,820,2590,3410
00158900,REINHARDT COLLEGE                       ,GA,30183-2981,Private      ,7,4,11,957,358,1315
00159000,SAVANNAH STATE UNIVERSITY               ,GA,31404-5298,Public       ,55,49,104,5706,2307,8013
00159100,SHORTER COLLEGE                         ,GA,30165-4298,Private      ,10,148,158,1493,3250,4743
00159200,SOUTH GEORGIA COLLEGE                   ,GA,31533-8104,Public       ,27,41,68,1561,1156,2717
00159400,SPELMAN COLLEGE                         ,GA,30314-4399,Private      ,24,19,43,6142,1075,7217
00159600,TOCCOA FALLS COLLEGE                    ,GA,30598-0001,Private      ,1,2,3,947,223,1170
00159700,TRUETT MCCONNELL COLLEGE                ,GA,30528-1264,Private      ,0,1,1,482,82,564
00159800,UNIVERSITY OF GEORGIA                   ,GA,30602-6114,Public       ,171,218,389,20469,10470,30939
00159900,VALDOSTA STATE UNIVERSITY               ,GA,31698-0001,Public       ,89,134,223,10989,5036,16025
00160000,WESLEYAN COLLEGE                        ,GA,31210-4407,Private      ,1,10,11,417,507,924
00160100,UNIV OF WEST GEORGIA                    ,GA,30118-0002,Public       ,65,167,232,9081,4860,13941
00160200,GEORGIA COLLEGE & STATE UNIVERSITY      ,GA,31061-0490,Public       ,77,47,124,5202,2010,7212
00160400,YOUNG HARRIS COLLEGE                    ,GA,30582-4137,Private      ,10,2,12,818,59,877
00348400,COVENANT COLLEGE                        ,GA,30750-4164,Private      ,2,19,21,1261,453,1714
00395600,DALTON STATE COLLEGE                    ,GA,30720-3797,Public       ,40,134,174,2755,3287,6042
00402300,APPALACHIAN TECHNICAL COLLEGE           ,GA,30143-0000,Public       ,8,25,33,310,888,1198
00402400,COOSA VALLEY TECHNICAL COLLEGE          ,GA,30161-6757,Public       ,17,69,86,1144,3282,4426
00402403,NORTHWESTERN TECHNICAL COLLEGE          ,GA,30739-0569,Public       ,2,24,26,982,3365,4347
00411700,GRADY HEALTH SYSTEM                     ,GA,30303-3050,Public       ,1,5,6,80,271,351
00525400,LANIER TECHNICAL COLLEGE                ,GA,30566-3499,Public       ,13,67,80,813,2703,3516
00525500,MOULTRIE TECHNICAL COLLEGE              ,GA,31768-0000,Public       ,14,84,98,710,2511,3221
00525600,VALDOSTA TECHNICAL COLLEGE              ,GA,31603-0000,Public       ,28,101,129,928,2977,3905
00551100,OKEFENOKEE TECHNICAL COLLEGE            ,GA,31501-4016,Public       ,12,38,50,447,1625,2072
00559900,AUGUSTA TECHNICAL COLLEGE               ,GA,30906-3399,Public       ,26,91,117,2038,6027,8065
00560000,ATHENS TECHNICAL COLLEGE                ,GA,30601-1579,Public       ,18,77,95,2104,4528,6632
00560100,ALBANY TECHNICAL COLLEGE                ,GA,31701-2648,Public       ,28,100,128,1282,4488,5770
00561300,FLINT RIVER TECHNICAL INSTITUTE         ,GA,30286-0014,Public       ,16,71,87,263,1216,1479
00561401,WEST GEORGIA TECHNICAL COLLEGE - ROOSEVE,GA,31830-0268,Public       ,0,0,0,2,2,4
00561500,SOUTHWEST GEORGIA TECHNICAL COLLEGE     ,GA,31792-2622,Public       ,7,28,35,641,2085,2726
00561600,SWAINSBORO TECHNICAL COLLEGE            ,GA,30401-5700,Public       ,10,33,43,241,813,1054
00561700,SOUTH GEORGIA TECHNICAL COLLEGE         ,GA,31709-8167,Public       ,43,136,179,974,1977,2951
00561800,SAVANNAH TECHNICAL COLLEGE              ,GA,31405-5594,Public       ,60,171,231,2303,8135,10438
00561900,NORTH GEORGIA TECHNICAL COLLEGE         ,GA,30523-0000,Public       ,27,84,111,967,2276,3243
00562000,CHATTAHOOCHEE TECHNICAL COLLEGE         ,GA,30060-3398,Public       ,30,105,135,2377,5279,7656
00562100,GRIFFIN TECHNICAL COLLEGE               ,GA,30223-2097,Public       ,28,97,125,1354,4241,5595
00562200,DEKALB TECHNICAL COLLEGE                ,GA,30021-0000,Public       ,38,213,251,1768,7365,9133
00562400,COLUMBUS TECHNICAL COLLEGE              ,GA,31904-6572,Public       ,19,101,120,1312,4329,5641
00576300,CENTRAL GEORGIA TECHNICAL COLLEGE       ,GA,31206-3628,Public       ,63,211,274,1863,7524,9387
00772800,MACON STATE COLLEGE                     ,GA,31206-5145,Public       ,74,167,241,3411,5606,9017
00854300,ATLANTA TECHNICAL COLLEGE               ,GA,30310-4499,Public       ,24,209,233,1852,6212,8064
00897600,CLAYTON STATE UNIVERSITY                ,GA,30260-0285,Public       ,47,176,223,4805,7802,12607
00918300,EAST CENTRAL TECHNICAL COLLEGE          ,GA,31750-0000,Public       ,9,54,63,329,1373,1702
00927000,ART INSTITUTE OF ATLANTA                ,GA,30328-1649,Proprietary  ,136,206,342,7576,5715,13291
00950700,GEORGIA HIGHLANDS COLLEGE               ,GA,30162-0000,Public       ,33,49,82,2867,2676,5543
01031903,MEDIX SCHOOL                            ,GA,30080-7630,Proprietary  ,22,80,102,292,1168,1460
01035601,EVEREST INSTITUTE - DEKALB              ,GA,30035-3420,Proprietary  ,43,185,228,377,1320,1697
01048700,WEST GEORGIA TECHNICAL COLLEGE          ,GA,30182-6476,Public       ,24,107,131,1543,4196,5739
01048704,WEST GEORGIA TECHNICAL COLLEGE          ,GA,30240-5957,Public       ,8,70,78,630,1865,2495
01077100,GUPTON JONES COLLEGE                    ,GA,30035-4022,Private      ,2,7,9,119,288,407
01099700,EAST GEORGIA COLLEGE                    ,GA,30401-2699,Public       ,36,36,72,2293,1199,3492
01107400,BAINBRIDGE COLLEGE                      ,GA,39819-8400,Public       ,83,219,302,1267,3481,4748
01110901,EVEREST COLLEGE - EVEREST INSTITUTE     ,GA,30067-8340,Proprietary  ,14,134,148,207,1020,1227
01112301,EVEREST COLLEGE - EVEREST INSTITUTE- NOR,GA,30093-2813,Proprietary  ,42,170,212,300,1569,1869
01157400,BAUDER COLLEGE                          ,GA,30313-2439,Proprietary  ,18,74,92,788,1410,2198
01205100,PRO WAY HAIR SCHOOL                     ,GA,30083-2884,Proprietary  ,6,31,37,86,388,474
01216500,ATLANTA METROPOLITAN COLLEGE            ,GA,30310-4498,Public       ,37,108,145,2127,3550,5677
01303900,SOUTH UNIVERSITY                        ,GA,31406-4881,Proprietary  ,167,2385,2552,1734,21409,23143
02055000,WAYCROSS COLLEGE                        ,GA,31503-0000,Public       ,20,40,60,558,778,1336
02060900,BROWN CLG OF COURT REPORTING & M.T.     ,GA,30318-2570,Proprietary  ,0,7,7,30,364,394
02074800,LIFE UNIVERSITY                         ,GA,30060-0000,Private      ,2,27,29,296,2196,2492
02089700,HERZING COLLEGE                         ,GA,30326-1332,Proprietary  ,3,54,57,281,1111,1392
02110501,ART INSTITUTE OF CHARLOTTE (THE) - BROWN,GA,30328-1635,Proprietary  ,1,0,1,64,59,123
02113604,AMERICAN INTERCONTINENTAL UNIV - DUNWOOD,GA,30328-1649,Proprietary  ,0,0,0,652,1996,2648
02116000,SANFORD-BROWN COLLEGE                   ,GA,30328-4803,Proprietary  ,23,132,155,386,2162,2548
02141500,SAVANNAH COLLEGE OF ART & DESIGN        ,GA,31402-3146,Private      ,26,22,48,8411,3477,11888
02202800,AUGUSTA AREA DIET INTERN UNIV HOSP      ,GA,30901-0000,Private      ,0,0,0,2,26,28
02205300,SAVANNAH RIVER COLLEGE                  ,GA,30909-0000,Proprietary  ,0,3,3,54,411,465
02217200,PORTFOLIO CENTER                        ,GA,30309-0000,Proprietary  ,1,1,2,20,144,164
02263105,ANTHEM COLLEGE - HIGH-TECH INSTITUTE - M,GA,30324-3398,Proprietary  ,0,3,3,28,46,74
02266200,AMERICAN PROFESSIONAL INSTITUTE         ,GA,31201-0000,Proprietary  ,44,283,327,380,1938,2318
02279500,HEART OF GEORGIA TECHNICAL COLLEGE      ,GA,31021-0000,Public       ,14,26,40,448,1429,1877
02284300,INTERACTIVE COLLEGE OF TECHNOLOGY       ,GA,30341-0000,Proprietary  ,25,233,258,276,2089,2365
02284308,INTERACTIVE LEARNING SYSTEMS            ,GA,30260-0000,Proprietary  ,5,39,44,64,365,429
02284309,INTERACTIVE COLLEGE OF TECHNOLOGY       ,GA,30501-0000,Proprietary  ,6,56,62,47,355,402
02285500,"CREATIVE CIRCUS, THE                    ",GA,30324-0000,Proprietary  ,1,3,4,78,274,352
02288400,GWINNETT TECHNICAL INSTITUTE            ,GA,30043-5702,Public       ,33,189,222,2598,6591,9189
02313902,WESTWOOD COLLEGE - O'HARE AIRPORT - ATLA,GA,30345-2807,Proprietary  ,14,22,36,329,564,893
02318600,GEORGIA MEDICAL INSTITUTE               ,GA,30303-0000,Proprietary  ,0,0,0,68,134,202
02321400,ROFFLER-MOLER HAIRSTYLING COLLEGE       ,GA,30062-0000,Proprietary  ,3,12,15,56,133,189
02354500,SOUTHEASTERN BEAUTY SCHOOLS             ,GA,31906-0000,Proprietary  ,5,11,16,29,159,188
02482100,MOREHOUSE SCHOOL OF MEDICINE            ,GA,30310-0000,Private      ,1,1,2,127,604,731
02502700,ADVANCED CAREER TRAINING                ,GA,30329-0000,Proprietary  ,32,160,192,216,1275,1491
02502701,ADVANCED CAREER TRAINING-RIVERDALE      ,GA,30274-0000,Proprietary  ,38,127,165,247,890,1137
02508600,MIDDLE GEORGIA TECHNICAL COLLEGE        ,GA,31088-0000,Public       ,15,58,73,857,2571,3428
02520000,INTERNATIONAL SCH SKIN & NAILCARE       ,GA,30342-0000,Proprietary  ,3,33,36,54,330,384
02577000,ARNOLD / PADRICKS  UNIV OF COSM         ,GA,30297-0000,Proprietary  ,5,9,14,88,235,323
02577700,BEAUTY COLLEGE OF AMERICA               ,GA,30297-0000,Proprietary  ,0,6,6,38,116,154
02578300,INTERNATIONAL CITY BEAUTY COLLEGE       ,GA,31093-3631,Proprietary  ,0,0,0,9,29,38
02580200,ATLANTA SCHOOL OF MASSAGE               ,GA,30338-0000,Proprietary  ,1,24,25,77,347,424
02583000,GWINNETT COLLEGE OF BUSINESS            ,GA,30047-3447,Proprietary  ,5,20,25,156,800,956
02607600,CAPELLI LEARNING CTR FOR COSM           ,GA,30324-0000,Proprietary  ,9,20,29,79,273,352
03005400,ARTISTIC BEAUTY COLLEGE                 ,GA,30013-2076,Proprietary  ,26,97,123,286,908,1194
03022601,WESTERN CULINARY INSTITUTE - LE CORDON B,GA,30084-5893,Proprietary  ,3,3,6,149,223,372
03029000,NORTH METRO TECHNICAL COLLEGE           ,GA,30102-3129,Public       ,18,22,40,1565,2975,4540
03030000,OGEECHEE TECHNICAL COLLEGE              ,GA,30458-8049,Public       ,22,61,83,1326,2706,4032
03032100,ALTAMAHA TECHNICAL COLLEGE              ,GA,31545-4465,Public       ,6,16,22,295,1029,1324
03042700,LAURUSTECHNICAL INSTITUTE               ,GA,30030-1506,Proprietary  ,9,60,69,124,696,820
03066500,SOUTHEASTERN TECHNICAL COLLEGE          ,GA,30474-8817,Public       ,7,13,20,398,1365,1763
03072304,EVEREST COLLEGE - EVEREST INSTITUTE     ,GA,30236-0000,Proprietary  ,32,194,226,456,1595,2051
03076300,BEULAH HEIGHTS BIBLE COLLEGE            ,GA,30316-1873,Private      ,1,26,27,42,729,771
03079202,WESTWOOD COLLEGE - ATLANTA MIDTOWN      ,GA,30309-2848,Proprietary  ,6,30,36,644,1027,1671
03081500,SOUTHEASTERN BEAUTY SCHOOL              ,GA,31917-0000,Proprietary  ,5,14,19,32,171,203
03089100,GEORGIA INSTITUTE OF COSMETOLOGY        ,GA,30606-3152,Proprietary  ,11,25,36,111,332,443
03090600,COBB BEAUTY COLLEGE                     ,GA,30144-2828,Proprietary  ,1,7,8,23,57,80
03100900,LUTHER RICE UNIVERSITY                  ,GA,30038-2454,Private      ,0,8,8,19,683,702
03102000,RIVERTOWN SCHOOL OF BEAUTY              ,GA,31904-4747,Proprietary  ,5,12,17,58,194,252
03104500,ATLANTA INSTITUTE OF MUSIC              ,GA,30096-4988,Proprietary  ,3,5,8,147,164,311
03116100,VOGUE BEAUTY SCHOOL                     ,GA,30141-2226,Proprietary  ,1,11,12,32,123,155
03155500,SANDERSVILLE REGIONAL TECH INST         ,GA,31082-6179,Public       ,14,34,48,243,719,962
03173300,ATLANTA'S JOHN MARSHALL LAW SCHOOL      ,GA,30309-0000,Proprietary  ,0,7,7,17,1124,1141
03232304,LINCOLN COLLEGE OF TECHNOLOGY           ,GA,30067-8638,Proprietary  ,24,64,88,263,809,1072
03251300,BEACON UNIVERSITY                       ,GA,31909-4663,Private      ,0,2,2,32,237,269
03355402,PSYCHOLOGICAL STUDIES INSTITUTE -       ,GA,30327-2921,Private      ,0,0,0,13,161,174
03391300,ROSS MEDICAL EDUCATION CENTER           ,GA,30033-3105,Proprietary  ,0,0,0,10,38,48
03418300,GWINNETT COLLEGE-SANDY SPRINGS          ,GA,30328-3161,Proprietary  ,4,15,19,37,200,237
03445500,FAYETTE BEAUTY ACADEMY                  ,GA,30214-1191,Proprietary  ,1,3,4,13,75,88
03522300,POWDER SPRINGS BEAUTY COLLEGE           ,GA,30127-2926,Proprietary  ,0,0,0,4,28,32
03523300,AVIATION INSTITUTE OF MAINTENANCE       ,GA,30045-6716,Proprietary  ,17,74,91,198,731,929
03753400,MICHAEL'S SCHOOL OF BEAUTY              ,GA,31211-1493,Proprietary  ,3,15,18,41,179,220
03804400,JAVELIN TECHNICAL TRAINING CENTER       ,GA,30339-6040,Proprietary  ,61,279,340,470,2018,2488
03804401,JAVELIN TECHNICAL TRAINING CENTER -     ,GA,30260-1756,Proprietary  ,1,4,5,12,54,66
03804402,JAVELIN TECHNICAL TRAINING CENTER -     ,GA,30084-5252,Proprietary  ,0,1,1,9,50,59
03812300,OMNITECH INSTITUTE                      ,GA,30035-1206,Proprietary  ,23,40,63,199,533,732
04021300,AUGUSTA SCHOOL OF MASSAGE               ,GA,30809-0000,Proprietary  ,2,5,7,23,54,77
04091300,SAVANNAH SCHOOL OF MASSAGE THERAPY      ,GA,31406-2711,Proprietary  ,0,0,0,28,82,110
04105300,NIGHTINGALE MEDICAL INSTITUTE           ,GA,30084-4036,Proprietary  ,0,0,0,80,264,344
04126800,ACADEMY OF SOMATIC HEALING ARTS (ASHA)  ,GA,30071-1024,Proprietary  ,3,16,19,33,161,194
04128500,SOUTHERN CATHOLIC COLLEGE               ,GA,30534-3111,Private      ,1,0,1,200,21,221
04142900,GEORGIA GWINNETT COLLEGE                ,GA,30043-7409,Public       ,33,58,91,393,462,855
04147000,PAUL MITCHELL THE SCHOOL ATLANTA        ,GA,30318-5241,Proprietary  ,11,13,24,25,40,65
        ,CHICAGO THEOLOGICAL SEMINARY            ,IL,60637-0000,Private      ,0,0,0,3,141,144
00162800,AMERICAN ACADEMY OF ART                 ,IL,60604-4302,Proprietary  ,1,2,3,512,131,643
00163300,AUGUSTANA COLLEGE                       ,IL,61201-2296,Private      ,7,2,9,3408,145,3553
00163400,AURORA UNIVERSITY                       ,IL,60506-4892,Private      ,3,58,61,2279,2481,4760
00163600,SOUTHWESTERN ILLINOIS COLLEGE           ,IL,62221-5899,Public       ,66,302,368,3555,6350,9905
00163800,BLACK HAWK COLLEGE                      ,IL,61265-5899,Public       ,13,86,99,1942,2754,4696
00163900,BLACKBURN COLLEGE                       ,IL,62626-1498,Private      ,1,0,1,879,124,1003
00164000,PRAIRIE STATE COLLEGE                   ,IL,60411-8226,Public       ,28,137,165,2006,3806,5812
00164100,BRADLEY UNIVERSITY                      ,IL,61625-0002,Private      ,8,7,15,6121,1009,7130
00164300,SPOON RIVER COLLEGE                     ,IL,61520-8907,Public       ,5,27,32,706,747,1453
00164700,CITY COLLEGES OF CHICAGO                ,IL,60606-6998,Public       ,8,12,20,385,616,1001
00164800,TRUMAN COLLEGE                          ,IL,60640-5691,Public       ,42,142,184,2283,4198,6481
00164900,RICHARD J DALEY COLLEGE                 ,IL,60652-1299,Public       ,31,103,134,2230,3824,6054
00165000,CITY COLLEGES OF CHICAGO-MALCOLM X      ,IL,60612-3197,Public       ,30,186,216,2198,5585,7783
00165200,HAROLD WASHINGTON COLLEGE               ,IL,60601-2403,Public       ,59,161,220,4407,5878,10285
00165400,KENNEDY KING COLLEGE                    ,IL,60621-3798,Public       ,44,331,375,3193,8405,11598
00165500,WRIGHT COLLEGE                          ,IL,60634-1591,Public       ,46,116,162,3927,4361,8288
00165700,MIDWESTERN UNIVERSITY                   ,IL,60515-1200,Private      ,0,3,3,122,2620,2742
00165900,ROSALIND FRANKLIN UNIVERSITY OF MEDICINE,IL,60064-3095,Private      ,0,3,3,17,2040,2057
00166100,CHICAGO THEOLOGICAL SEMINARY            ,IL,60637-0000,Private      ,0,1,1,0,4,4
00166300,SPERTUS COLLEGE                         ,IL,60605-1995,Private      ,0,8,8,0,90,90
00166400,UNIVERSITY OF ST FRANCIS                ,IL,60435-6188,Private      ,5,27,32,1373,1695,3068
00166500,COLUMBIA COLLEGE                        ,IL,60605-1996,Private      ,64,58,122,11718,4591,16309
00166600,CONCORDIA UNIVERSITY                    ,IL,60305-1499,Private      ,1,76,77,1451,3187,4638
00166900,DANVILLE AREA COMMUNITY COLLEGE         ,IL,61832-5199,Public       ,4,28,32,798,1464,2262
00167100,DEPAUL UNIVERSITY                       ,IL,60604-2287,Private      ,60,275,335,15346,14172,29518
00167400,EASTERN ILLINOIS UNIVERSITY             ,IL,61920-3099,Public       ,40,76,116,9648,3210,12858
00167500,ELGIN COMMUNITY COLLEGE                 ,IL,60123-7193,Public       ,18,52,70,2451,2841,5292
00167600,ELMHURST COLLEGE                        ,IL,60126-3296,Private      ,3,6,9,3335,1084,4419
00167800,EUREKA COLLEGE                          ,IL,61530-9976,Private      ,0,0,0,871,212,1083
00168100,HIGHLAND COMMUNITY COLLEGE              ,IL,61032-9341,Public       ,7,55,62,818,1109,1927
00168200,GARRETT-EVANGELICAL THEOLOGICAL SEM     ,IL,60201-0000,Private      ,0,1,1,1,190,191
00168400,GREENVILLE COLLEGE                      ,IL,62246-1199,Private      ,2,19,21,1534,757,2291
00168500,HEBREW THEOLOGICAL COLLEGE              ,IL,60077-3263,Private      ,6,0,6,366,16,382
00168800,ILLINOIS COLLEGE                        ,IL,62650-2299,Private      ,0,0,0,1272,82,1354
00168900,ILLINOIS COLLEGE OF OPTOMETRY           ,IL,60616-3878,Private      ,0,2,2,16,671,687
00169100,ILLINOIS INSTITUTE OF TECHNOLOGY        ,IL,60616-0000,Private      ,8,18,26,2571,2103,4674
00169103,CHICAGO KENT COLLEGE OF LAW             ,IL,60661-0000,Private      ,1,5,6,17,1949,1966
00169200,ILLINOIS STATE UNIVERSITY               ,IL,61790-1000,Public       ,34,56,90,17262,4283,21545
00169300,NORTHEASTERN ILLINOIS UNIV              ,IL,60625-4699,Public       ,31,72,103,5122,6190,11312
00169400,CHICAGO STATE UNIVERSITY                ,IL,60628-1598,Public       ,37,127,164,5769,9855,15624
00169600,ILLINOIS WESLEYAN UNIVERSITY            ,IL,61701-0000,Private      ,0,1,1,2776,83,2859
00169800,JOHN MARSHALL LAW SCHOOL                ,IL,60604-0000,Private      ,0,10,10,18,2482,2500
00169900,JOLIET JUNIOR COLLEGE                   ,IL,60431-8938,Public       ,51,143,194,4493,4724,9217
00170000,JUDSON UNIVERSITY                       ,IL,60123-1498,Private      ,1,37,38,830,816,1646
00170100,KASKASKIA COLLEGE                       ,IL,62801-7878,Public       ,26,115,141,1296,2248,3544
00170300,KENDALL COLLEGE                         ,IL,60622-4278,Proprietary  ,7,27,34,1015,1972,2987
00170400,KNOX COLLEGE                            ,IL,61401-4999,Private      ,2,0,2,2310,74,2384
00170500,ILLINOIS VALLEY COMMUNITY COLLEGE       ,IL,61348-9692,Public       ,21,90,111,1139,1475,2614
00170600,LAKE FOREST COLLEGE                     ,IL,60045-2399,Private      ,3,0,3,1713,110,1823
00170700,LEWIS UNIVERSITY                        ,IL,60446-2200,Private      ,15,71,86,3658,2734,6392
00170800,LINCOLN CHRISTIAN COLLEGE               ,IL,62656-2167,Private      ,1,4,5,484,594,1078
00170900,LINCOLN COLLEGE                         ,IL,62656-1699,Private      ,7,20,27,1253,493,1746
00171000,LOYOLA UNIVERSITY CHICAGO               ,IL,60626-0000,Private      ,43,132,175,15292,9302,24594
00171002,LOYOLA STRITCH SCHOOL OF MEDICINE       ,IL,60153-0000,Private      ,0,1,1,11,1081,1092
00171200,LUTHERAN SCHOOL OF THEOL AT CHICAGO     ,IL,60615-0000,Private      ,0,2,2,0,145,145
00171600,MACCORMAC COLLEGE                       ,IL,60602-4405,Private      ,1,6,7,58,146,204
00171700,MACMURRAY COLLEGE                       ,IL,62650-2590,Private      ,1,0,1,699,230,929
00172100,MCCORMICK THEOLOGICAL SEMINARY          ,IL,60615-5108,Private      ,0,2,2,1,128,129
00172200,MCKENDREE UNIVERSITY                    ,IL,62254-1299,Private      ,4,34,38,1640,1546,3186
00172300,MEADVILLE LOMBARD THEOLOGICAL SCHOOL    ,IL,60637-1602,Private      ,0,1,1,0,64,64
00172400,MILLIKIN UNIVERSITY                     ,IL,62522-2084,Private      ,3,4,7,2663,798,3461
00172500,MONMOUTH COLLEGE                        ,IL,61462-1963,Private      ,1,0,1,1854,82,1936
00172800,MORTON COLLEGE                          ,IL,60804-4398,Public       ,30,63,93,1459,1981,3440
00173200,NATIONAL UNIV OF HEALTH SCIENCES        ,IL,60148-4583,Private      ,3,16,19,60,855,915
00173300,NATIONAL-LOUIS UNIVERSITY               ,IL,60603-3032,Private      ,3,266,269,279,7694,7973
00173400,NORTH CENTRAL COLLEGE                   ,IL,60540-4690,Private      ,6,10,16,2860,700,3560
00173500,NORTH PARK UNIVERSITY                   ,IL,60625-4895,Private      ,6,27,33,2294,1482,3776
00173600,NORTHERN BAPTIST THEOL SEMINARY         ,IL,60148-0000,Private      ,0,0,0,1,15,16
00173700,NORTHERN ILLINOIS UNIVERSITY            ,IL,60115-2854,Public       ,53,119,172,18553,8460,27013
00173900,NORTHWESTERN UNIV                       ,IL,60208-0001,Private      ,16,56,72,15489,9942,25431
00174100,OLIVET NAZARENE UNIVERSITY              ,IL,60914-2271,Private      ,5,28,33,2820,2143,4963
00174200,IL EASTERN COMM COLGS-OLNEY CENTRAL     ,IL,62450-1099,Public       ,11,42,53,609,749,1358
00174500,QUINCY UNIVERSITY                       ,IL,62301-2699,Private      ,2,45,47,1339,819,2158
00174600,ROBERT MORRIS UNIVERSITY ILLINOIS       ,IL,60605-1225,Private      ,24,80,104,4634,5603,10237
00174700,ROCK VALLEY COLLEGE                     ,IL,61114-5699,Public       ,28,130,158,2545,4381,6926
00174800,ROCKFORD COLLEGE                        ,IL,61108-2393,Private      ,1,22,23,947,1101,2048
00174900,ROOSEVELT UNIVERSITY                    ,IL,60605-1394,Private      ,20,99,119,3566,7285,10851
00175000,DOMINICAN UNIVERSITY                    ,IL,60305-1066,Private      ,4,22,26,2139,1540,3679
00175200,SAUK VALLEY COMMUNITY COLLEGE           ,IL,61021-9112,Public       ,21,67,88,1006,1231,2237
00175300,SCHOOL OF ART INSTITUTE OF CHICAGO      ,IL,60603-3017,Private      ,8,9,17,2880,2028,4908
00175400,SEABURY-WESTERN THEO SEMINARY           ,IL,60201-0000,Private      ,0,0,0,0,27,27
00175600,SHIMER COLLEGE                          ,IL,60616-3893,Private      ,1,0,1,113,61,174
00175700,SOUTHEASTERN ILLINOIS COLLEGE           ,IL,62946-4925,Public       ,17,36,53,610,810,1420
00175800,SOUTHERN ILL UNIV-CARBONDALE            ,IL,62901-0000,Public       ,42,152,194,14165,8312,22477
00175900,SOUTHERN ILL UNIV-EDWARDSVILLE          ,IL,62026-1060,Public       ,38,96,134,9643,5172,14815
00175924,SO IL UNIV-SCHL OF DENTAL MEDICINE      ,IL,62002-0000,Public       ,0,0,0,6,202,208
00176100,SPRINGFIELD COLLEGE IN ILLINOIS         ,IL,62702-2694,Private      ,1,6,7,433,616,1049
00176500,UNIVERSITY OF ST MARY OF THE LAKE       ,IL,60060-0000,Private      ,0,0,0,0,12,12
00176700,BENEDICTINE UNIVERSITY                  ,IL,60532-0900,Private      ,6,94,100,2256,3460,5716
00176800,ST XAVIER UNIVERSITY                    ,IL,60655-3199,Private      ,4,39,43,3691,3491,7182
00176900,SOUTH SUBURBAN COLLEGE                  ,IL,60473-9978,Public       ,54,218,272,2493,6097,8590
00177100,TRINITY CHRISTIAN COLLEGE               ,IL,60463-0929,Private      ,2,3,5,1198,739,1937
00177200,TRINITY INTERNATIONAL UNIVERSITY        ,IL,60015-1283,Private      ,2,17,19,864,1209,2073
00177300,TRITON COLLEGE                          ,IL,60171-1995,Public       ,32,160,192,2988,4103,7091
00177400,UNIVERSITY OF CHICAGO                   ,IL,60637-1476,Private      ,13,18,31,9838,2260,12098
00177401,UNIV OF CHICAGO PRITZKER SCH OF MED     ,IL,60637-0000,Private      ,0,0,0,30,657,687
00177403,"UNIV OF CHICAGO, GRAD SCH OF BUS        ",IL,60637-0000,Private      ,0,19,19,23,1396,1419
00177405,UNIVERSITY OF CHICAGO GRADUATE          ,IL,60637-0000,Private      ,0,26,26,101,5448,5549
00177500,UNIV OF ILLINOIS @ URBANA-CHAMPAIGN     ,IL,61820-5796,Public       ,50,119,169,24989,8086,33075
00177600,UNIV OF ILLINOIS AT CHICAGO             ,IL,60607-7163,Public       ,49,126,175,17167,13235,30402
00177800,VANDERCOOK COLLEGE OF MUSIC             ,IL,60616-3731,Private      ,1,4,5,149,92,241
00177900,IL EASTERN COMM COLGS-WABASH VALLEY     ,IL,62863-2699,Public       ,3,13,16,441,399,840
00178000,WESTERN ILLINOIS UNIVERSITY             ,IL,61455-1390,Public       ,28,47,75,9945,3574,13519
00178100,WHEATON COLLEGE                         ,IL,60187-5535,Private      ,4,2,6,2481,600,3081
00178300,WORSHAM COLLEGE OF MORTUARY SCIENCE     ,IL,60090-2646,Proprietary  ,0,1,1,55,123,178
00396100,HARPER COLLEGE                          ,IL,60067-7398,Public       ,57,140,197,4082,3499,7581
00418100,ADVOCATE TRINITY HOSPITAL SCHOOL OF RADI,IL,60617-3982,Private      ,0,1,1,24,91,115
00456000,GEM CITY COLLEGE                        ,IL,62301-4949,Proprietary  ,2,3,5,13,44,57
00456800,MIDSTATE COLLEGE                        ,IL,61614-3558,Proprietary  ,5,62,67,77,937,1014
00457100,SPARKS COLLEGE                          ,IL,62565-2241,Proprietary  ,0,0,0,7,16,23
00512732,BROWN MACKIE COLLEGE-MERRILLVILLE - BROW,IL,61265-7062,Proprietary  ,1,5,6,6,32,38
00621400,BLESSING RIEMAN COLLEGE OF NURSING      ,IL,62301-0000,Private      ,0,2,2,63,78,141
00621401,BLESSING HOSP SCH MED LAB TECH          ,IL,62301-0000,Private      ,0,0,0,0,4,4
00621402,BLESSING HOSP SCH OF RAD TECH           ,IL,62301-2852,Private      ,0,0,0,8,12,20
00621403,BLESSING HOSPITAL - COLLEGE OF NURSING  ,IL,62305-7005,Private      ,0,0,0,13,16,29
00622501,TRINITY COLLEGE OF NURSING & HEALTH SCIE,IL,61201-5317,Private      ,0,2,2,80,207,287
00622800,METHODIST MED CTR OF ILL SCH NRSNG      ,IL,61636-0000,Private      ,0,2,2,75,157,232
00624000,ST FRANCIS MED CLG OF NRSG              ,IL,61603-3783,Private      ,0,2,2,161,309,470
00665600,COLLEGE OF DUPAGE                       ,IL,60137-6599,Public       ,85,247,332,6241,6304,12545
00675300,ILLINOIS CENTRAL COLLEGE                ,IL,61635-0001,Public       ,57,211,268,3502,4866,8368
00693100,WAUBONSEE COMMUNITY COLLEGE             ,IL,60554-0000,Public       ,30,91,121,1617,2336,3953
00711800,PARKLAND COLLEGE                        ,IL,61821-1899,Public       ,35,119,154,3683,3224,6907
00711900,REND LAKE COLLEGE                       ,IL,62846-9801,Public       ,18,57,75,1215,1580,2795
00717000,LINCOLN LAND COMMUNITY COLLEGE          ,IL,62794-9256,Public       ,14,45,59,2128,3222,5350
00726500,CARL SANDBURG COLLEGE                   ,IL,61401-9576,Public       ,14,70,84,926,1527,2453
00754900,COYNE AMERICAN INSTITUTE                ,IL,60607-1300,Proprietary  ,25,85,110,476,1386,1862
00764400,LAKE LAND COLLEGE                       ,IL,61938-9366,Public       ,24,125,149,2066,2132,4198
00768400,KISHWAUKEE COLLEGE                      ,IL,60150-9699,Public       ,14,42,56,1435,1413,2848
00769000,KANKAKEE COMMUNITY COLLEGE              ,IL,60901-6505,Public       ,26,86,112,1164,2079,3243
00769100,MCHENRY COUNTY COLLEGE                  ,IL,60012-2761,Public       ,16,45,61,1322,1491,2813
00769200,MORAINE VALLEY COMMUNITY COLLEGE        ,IL,60465-0937,Public       ,51,133,184,4202,3937,8139
00769300,SHAWNEE COMMUNITY COLLEGE               ,IL,62992-9725,Public       ,23,65,88,703,1508,2211
00769400,COLLEGE OF LAKE COUNTY                  ,IL,60030-1198,Public       ,65,233,298,2931,4025,6956
00793700,MS ROBERTS ACADEMY OF BEAUTY CULT       ,IL,60181-2930,Proprietary  ,1,12,13,28,89,117
00807600,JOHN A LOGAN COLLEGE                    ,IL,62918-2500,Public       ,38,75,113,2007,2684,4691
00814604,EVEREST UNIVERSITY - EVEREST  COLLEGE   ,IL,60803-4517,Proprietary  ,13,134,147,232,1385,1617
00825900,EDUCATORS OF BEAUTY                     ,IL,61081-3611,Proprietary  ,1,20,21,53,193,246
00825901,EDUCATORS OF BEAUTY                     ,IL,61104-0000,Proprietary  ,1,0,1,39,143,182
00832800,ALVAREITA'S COLLEGE OF COSMETOLOGY      ,IL,62025-2041,Proprietary  ,4,8,12,37,87,124
00854500,ROCKFORD BUSINESS COLLEGE               ,IL,61103-0000,Proprietary  ,6,67,73,201,1008,1209
00869402,RASMUSSEN COLLEGE - SAINT CLOUD - ROCKFO,IL,61108-2513,Proprietary  ,12,63,75,239,1058,1297
00869403,RASMUSSEN COLLEGE - SAINT CLOUD - AURORA,IL,60506-0000,Proprietary  ,5,34,39,44,177,221
00869404,RASMUSSEN COLLEGE - SAINT CLOUD - ROMEOV,IL,60446-0000,Proprietary  ,0,2,2,0,4,4
00888000,MORRISON INSTITUTE OF TECHNOLOGY        ,IL,61270-2959,Private      ,0,0,0,136,18,154
00893800,GRAHAM HOSPITAL SCH OF NURSING          ,IL,61520-2497,Private      ,0,1,1,24,56,80
00893900,CANNELLA SCHOOL OF HAIR DESIGN          ,IL,60406-2130,Proprietary  ,0,13,13,28,128,156
00914500,GOVERNORS STATE UNIVERSITY              ,IL,60466-0975,Public       ,15,138,153,749,5360,6109
00923200,CATHOLIC THEOLOGICAL UNION              ,IL,60615-0000,Private      ,0,1,1,0,52,52
00933300,UNIV OF ILLINOIS AT SPRINGFIELD         ,IL,62703-5407,Public       ,7,60,67,1710,2652,4362
00947500,EDUCATORS OF BEAUTY                     ,IL,61301-2404,Proprietary  ,6,1,7,27,54,81
00959500,CANNELLA SCHOOL OF HAIR DESIGN          ,IL,60617-4303,Proprietary  ,0,6,6,30,110,140
00976700,OLIVE-HARVEY COLLEGE                    ,IL,60628-1696,Public       ,22,109,131,1181,3491,4672
00978600,IL EASTERN COMM COLGS-LINCOLN TRAIL     ,IL,62454-5708,Public       ,4,28,32,355,436,791
00980000,RUSH UNIVERSITY                         ,IL,60612-3806,Private      ,1,12,13,162,2013,2175
00989600,OAKTON COMMUNITY COLLEGE                ,IL,60016-1268,Public       ,26,48,74,2560,2244,4804
00998700,SAINT ANTHONY COLLEGE OF NURSING        ,IL,61108-2468,Private      ,0,1,1,99,214,313
01002000,LEWIS AND CLARK COMMUNITY COLLEGE       ,IL,62035-2466,Public       ,24,95,119,1900,2699,4599
01031600,LINCOLN COLLEGE OF TECHNOLOGY           ,IL,60160-1605,Proprietary  ,57,129,186,1032,1406,2438
01050100,LAKEVIEW  COLLEGE OF NURSING            ,IL,61832-3781,Private      ,0,0,0,130,172,302
01069500,TRI-COUNTY BEAUTY ACADEMY               ,IL,62056-2036,Proprietary  ,1,3,4,13,44,57
01071000,CAPITAL AREA SCH OF PRAC NRSG           ,IL,62707-0000,Public       ,0,5,5,43,374,417
01072700,DEVRY UNIVERSITY                        ,IL,60618-5994,Proprietary  ,542,3288,3830,23256,72467,95723
01073700,ADVOCATE IL MASONIC SCH OF RAD TECH     ,IL,60657-5193,Private      ,0,0,0,12,32,44
01083600,PIVOT POINT INTNL CSMTLGY RSRCH CTR     ,IL,60626-0000,Proprietary  ,6,31,37,389,520,909
01087900,RICHLAND COMMUNITY COLLEGE              ,IL,62521-8513,Public       ,30,126,156,838,1715,2553
01102401,EVEREST COLLEGE - CHICAGO               ,IL,60604-2052,Proprietary  ,36,205,241,695,2515,3210
01151002,EVEREST INSTITUTE - EVEREST COLLEGE     ,IL,60542-1610,Proprietary  ,16,65,81,171,647,818
01181000,TAYLOR BUSINESS INSTITUTE               ,IL,60606-5111,Proprietary  ,3,18,21,64,311,375
01185800,EVEREST COLLEGE                         ,IL,60077-1074,Proprietary  ,38,151,189,356,1304,1660
01185802,EVEREST COLLEGE - BURR RIDGE            ,IL,60527-7826,Proprietary  ,20,110,130,227,883,1110
01236200,NORTHWESTERN COLLEGE                    ,IL,60630-2298,Proprietary  ,16,87,103,1202,3232,4434
01238500,BLOOMINGTON-NORMAL SCH RADIOGRAPHY      ,IL,61761-4604,Private      ,0,1,1,11,13,24
01258400,ILLINOIS INSTITUTE OF ART (THE)         ,IL,60654-1593,Proprietary  ,68,135,203,4564,3212,7776
01258401,ILLINOIS INSTITUTE OF ART (THE) - THE IL,IL,60173-4913,Proprietary  ,0,0,0,88,45,133
01281300,JOHN WOOD COMMUNITY COLLEGE             ,IL,62305-0401,Public       ,19,85,104,1191,1499,2690
01308700,CAPRI GARFIELD RIDGE SCH OF BTY CLR     ,IL,60629-1613,Proprietary  ,2,7,9,59,235,294
01308800,CAPRI OAK FOREST COLLEGE OF BEAUTY      ,IL,60452-2798,Proprietary  ,3,6,9,153,184,337
02055200,HARRINGTON COLLEGE OF DESIGN            ,IL,60606-3433,Proprietary  ,9,23,32,794,1016,1810
02068100,ADLER SCH OF PROFESSIONAL PSYCHLGY      ,IL,60601-0000,Private      ,0,3,3,12,827,839
02069300,VATTEROTT COLLEGE                       ,IL,62305-5938,Proprietary  ,2,1,3,156,598,754
02073200,TELSHE YESHIVA-CHICAGO                  ,IL,60625-0000,Private      ,0,0,0,32,8,40
02074400,IL EASTERN COMM COLGS-FRONTIER          ,IL,62837-0000,Public       ,6,29,35,196,396,592
02075400,KELLER GRADUATE SCHOOL OF MGMT.         ,IL,60181-0000,Proprietary  ,0,690,690,30,16115,16145
02113600,AMERICAN INTERCONTINENTAL UNIVERSITY    ,IL,60192-3713,Proprietary  ,229,3460,3689,3837,41597,45434
02117400,BECK AREA CAREER CENTER                 ,IL,62278-0000,Public       ,0,1,1,21,129,150
02124400,UNIVERSITY OF SPA & COSMETOLOGY ART     ,IL,62704-0000,Proprietary  ,5,14,19,112,190,302
02150600,COSMETOLOGY AND SPA INSTITUTE (THE)     ,IL,60014-4003,Proprietary  ,5,5,10,98,162,260
02155300,THE CHICAGO SCHOOL OF PROF PSYCHOLOGY   ,IL,60610-4705,Private      ,0,65,65,18,2707,2725
02160300,INTERNATIONAL ACAD OF DESIGN & TECH     ,IL,60602-3319,Proprietary  ,18,18,36,1571,1649,3220
02160304,INTERNATIONAL ACADEMY OF DESIGN AND TECH,IL,60173-5160,Proprietary  ,5,9,14,172,255,427
02168600,EAST WEST UNIVERSITY                    ,IL,60605-0000,Private      ,16,27,43,755,1815,2570
02179900,ARGOSY UNIVERSITY                       ,IL,60601-7757,Proprietary  ,46,673,719,1377,26120,27497
02185400,ST AUGUSTINE COLLEGE                    ,IL,60640-0000,Private      ,0,2,2,387,1614,2001
02192400,MR JOHNS SCHOOL OF COSMETOLOGY          ,IL,62521-0000,Proprietary  ,1,12,13,20,125,145
02202600,CANNELLA SCHOOL OF HAIR DESIGN          ,IL,60181-1321,Proprietary  ,1,3,4,9,56,65
02214100,WEST SUBURBAN COLLEGE OF NURSING        ,IL,60302-2519,Private      ,0,2,2,125,366,491
02228100,MAC DANIEL'S BEAUTY SCHOOL              ,IL,60640-0000,Proprietary  ,0,10,10,20,90,110
02261200,HAIR PROFESSIONALS ACAD COSMETOLOGY     ,IL,60118-0000,Proprietary  ,13,25,38,106,215,321
02261201,HAIR PROFESSIONALS ACADEMY OF COSMETOLOG,IL,60118-9333,Proprietary  ,0,0,0,6,6,12
02262100,HAIR PROFESSIONALS SCH COSMETOLOGY      ,IL,60543-0000,Proprietary  ,1,4,5,42,92,134
02291200,CANNELLA SCHOOL OF HAIR DESIGN          ,IL,60639-0000,Proprietary  ,3,12,15,43,131,174
02295500,CANNELLA SCHOOL OF HAIR DESIGN          ,IL,60120-0000,Proprietary  ,0,7,7,14,72,86
02297500,OEHRLEIN SCHOOL OF COSMETOLOGY          ,IL,61611-0000,Proprietary  ,3,6,9,58,96,154
02312300,LA' JAMES COLLEGE HAIRSTYLING           ,IL,61244-0000,Proprietary  ,4,5,9,24,42,66
02313900,WESTWOOD COLLEGE - O'HARE AIRPORT       ,IL,60631-2801,Proprietary  ,10,30,40,614,899,1513
02317300,CONCEPT COLLEGE OF COSMETOLOGY          ,IL,61832-0000,Proprietary  ,1,5,6,37,114,151
02319200,LAKE FOREST GRAD SCHL OF MGMT           ,IL,60045-4824,Private      ,0,13,13,1,345,346
02323300,PROFESSIONAL'S CHOICE HAIR DSN ACAD     ,IL,60435-0000,Proprietary  ,0,1,1,19,50,69
02332200,HAIR PROFESSIONALS CAREER COLLEGE       ,IL,60178-0000,Proprietary  ,0,6,6,41,73,114
02337800,THE COLLEGE OF OFFICE TECHNOLOGY        ,IL,60622-0000,Proprietary  ,7,25,32,118,658,776
02349400,ALVAREITA'S COLLEGE OF COSMETOLOGY      ,IL,62035-0000,Proprietary  ,0,0,0,40,35,75
02349500,CANNELLA SCHOOL OF HAIR DESIGN          ,IL,60632-0000,Proprietary  ,1,11,12,49,191,240
02352200,COOKING & HOSPITALITY INSTITUTE         ,IL,60610-3050,Proprietary  ,11,35,46,762,1375,2137
02498200,HAIR PROFESSIONALS ACAD COSMETOLOGY     ,IL,60187-0000,Proprietary  ,7,18,25,49,159,208
02498201,HAIR PROFESSIONALS ACADEMY OF COSMETOLOG,IL,60563-0000,Proprietary  ,0,1,1,15,19,34
02522800,FOX COLLEGE                             ,IL,60453-0000,Proprietary  ,4,1,5,292,172,464
02527600,LEXINGTON COLLEGE                       ,IL,60607-0000,Private      ,0,0,0,70,40,110
02536700,BELL MAR BEAUTY COLLEGE                 ,IL,60650-0000,Proprietary  ,0,13,13,10,76,86
02538100,REGENCY BEAUTY INSTITUTE                ,IL,61820-0000,Proprietary  ,0,0,0,17,28,45
02556100,ENVIRONMENTAL TECHNICAL INSTITUTE       ,IL,60143-0000,Proprietary  ,9,23,32,225,435,660
02556600,NILES SCHOOL OF COSMETOLOGY             ,IL,60714-0000,Proprietary  ,1,5,6,30,53,83
02570305,LOS ANGELES ORT TECHNICAL INSTITUTE -D/B,IL,60077-0000,Private      ,0,0,0,2,4,6
02573700,INSTITUTE FOR CLINICAL SOCIAL WORK      ,IL,60601-0000,Private      ,0,0,0,6,82,88
02579200,INGALLS MEMORIAL HOSPITAL               ,IL,60426-0000,Private      ,0,1,1,4,20,24
02584900,"FIRST INSTITUTE, INC.                   ",IL,60014-7489,Proprietary  ,0,6,6,45,166,211
02587700,HAIR PROFESSIONALS CAREER COLLEGE       ,IL,60465-1929,Proprietary  ,4,9,13,48,128,176
02599500,HANOVER PARK COLLEGE OF BEAUTY CULT     ,IL,60133-5421,Proprietary  ,4,6,10,80,93,173
02622700,KNOWLEDGE SYSTEMS INSTITUTE             ,IL,60076-0000,Private      ,0,0,0,0,3,3
03002000,HAIRMASTERS INST OF COSMETOLOGY         ,IL,61701-5547,Proprietary  ,3,6,9,30,82,112
03027702,PACIFIC COLLEGE OF ORIENTAL MED         ,IL,60613-0000,Proprietary  ,0,11,11,3,206,209
03065300,TREND SETTERS COLL OF COSMETOLOGY       ,IL,60915-2101,Proprietary  ,4,12,16,132,176,308
03072701,WESTWOOD COLLEGE OF TECHNOLOGY          ,IL,60409-0000,Proprietary  ,8,24,32,375,1143,1518
03072702,WESTWOOD COLLEGE OF TECHNOLOGY          ,IL,60602-0000,Proprietary  ,6,20,26,723,1295,2018
03078400,CAMEO BEAUTY ACADEMY                    ,IL,60453-3196,Proprietary  ,3,5,8,59,92,151
03079200,WESTWOOD COLLEGE - DUPAGE               ,IL,60517-2321,Proprietary  ,9,20,29,527,617,1144
03082900,ROSEL SCHOOL OF COSMETOLOGY             ,IL,60659-1913,Proprietary  ,1,17,18,30,174,204
03083800,HEARTLAND COMMUNITY COLLEGE             ,IL,61761-9446,Public       ,24,78,102,1562,2040,3602
03098000,ST JOHN'S COLLEGE OF NURSING            ,IL,62702-5321,Private      ,0,0,0,46,59,105
03098002,ST JOHN'S HOSP SCH MED TECH             ,IL,62769-5324,Private      ,0,0,0,4,9,13
03099700,CAIN'S BARBER COLLEGE                   ,IL,60615-3510,Proprietary  ,3,21,24,71,311,382
03099800,ILLINOIS SCHOOL OF HEALTH CAREERS       ,IL,60604-0000,Proprietary  ,17,101,118,308,1077,1385
03101800,ILLINOIS CENTER FOR BROADCASTING        ,IL,60148-7015,Proprietary  ,10,19,29,106,299,405
03128300,PYRAMID CAREER INSTITUTE                ,IL,60657-4207,Proprietary  ,0,0,0,2,4,6
03128500,NATIONAL LATINO EDUCATION INSTITUTE     ,IL,60609-2205,Private      ,3,20,23,57,131,188
03199300,CHRISTIAN LIFE COLLEGE                  ,IL,60056-2522,Private      ,0,0,0,23,19,42
03368300,MIDWEST TECHNICAL INSTITUTE             ,IL,62707-8805,Proprietary  ,36,202,238,363,1565,1928
03416300,COMPUTER SYSTEMS INSTITUTE              ,IL,60077-0000,Proprietary  ,29,128,157,195,870,1065
03448300,BIR TRAINING CENTER                     ,IL,60659-1298,Proprietary  ,2,33,35,41,537,578
03455700,CORTIVA INSTITUTE - CHICAGO             ,IL,60602-3315,Proprietary  ,8,36,44,197,497,694
03472300,CHICAGO URBAN LEAGUE COMPUTER TRAIN     ,IL,60604-2198,Private      ,0,0,0,1,2,3
03510300,ERIKSON INSTITUTE                       ,IL,60654-4510,Private      ,0,3,3,1,286,287
03623300,VEE'S SCHOOL OF BEAUTY CULTURE          ,IL,62205-2326,Proprietary  ,0,3,3,3,28,31
03643300,MR. JOHN'S SCHOOL OF COSMETOLOGY &      ,IL,62650-3488,Proprietary  ,0,1,1,12,46,58
03684300,NORTHSHORE UNIVERSITY HEALTHSYSTEM SCHOO,IL,60201-9872,Private      ,0,0,0,2,25,27
03721400,AMERICAN CAREER COLLEGE                 ,IL,60402-0000,Proprietary  ,1,5,6,24,103,127
03881400,EUROPEAN MASSAGE THERAPY SCHOOL         ,IL,60077-2269,Proprietary  ,2,15,17,22,138,160
03891300,SOMA INSTITUTE - THE NATIONAL SCHOOL OF ,IL,60604-4466,Proprietary  ,0,9,9,104,262,366
03914300,"CALC, INSTITUTE OF TECHNOLOGY           ",IL,62002-5931,Proprietary  ,1,18,19,30,280,310
03955400,MIDWEST INSTITUTE OF MASSAGE THERAPY    ,IL,62223-0000,Proprietary  ,0,0,0,1,13,14
04117500,SOLEX MEDICAL ACADEMY                   ,IL,60090-3104,Proprietary  ,0,0,0,9,18,27
04136900,UNIVERSITY OF AESTHETICS (THE)          ,IL,60622-2151,Proprietary  ,0,1,1,1,20,21
04137000,UNIVERSITY OF AESTHETICS (THE)          ,IL,60515-5602,Proprietary  ,0,2,2,4,9,13
04137500,TRICOCI UNIVERSITY OF BEAUTY CULTURE    ,IL,60656-1805,Proprietary  ,7,28,35,22,64,86
04141000,AVEDA INSTITUTE CHICAGO                 ,IL,60647-0000,Proprietary  ,1,3,4,1,3,4
04147300,TRICOCI UNIVERSITY OF BEAUTY CULTURE    ,IL,60139-3119,Proprietary  ,4,9,13,16,20,36
04147400,TRICOCI UNIVERSITY OF BEAUTY CULTURE    ,IL,61614-4831,Proprietary  ,1,0,1,7,10,17
04147500,TRICOCI UNIVERSITY OF BEAUTY CULTURE    ,IL,61108-2337,Proprietary  ,2,3,5,13,25,38
        ,ASBURY THEOLOGICAL SEMINARY             ,KY,40390-0000,Private      ,0,0,0,17,1313,1330
00195100,ALICE LLOYD COLLEGE                     ,KY,41844-9703,Private      ,0,1,1,937,106,1043
00195200,ASBURY COLLEGE                          ,KY,40390-1198,Private      ,4,4,8,1517,416,1933
00195300,ASBURY THEOLOGICAL SEMINARY             ,KY,40390-0000,Private      ,0,6,6,0,38,38
00195400,BELLARMINE UNIVERSITY                   ,KY,40205-1877,Private      ,13,50,63,2916,1260,4176
00195500,BEREA COLLEGE                           ,KY,40403-0000,Private      ,4,0,4,2575,470,3045
00195800,BRESCIA UNIVERSITY                      ,KY,42301-3023,Private      ,0,10,10,568,356,924
00195900,CAMPBELLSVILLE UNIVERSITY               ,KY,42718-2799,Private      ,2,26,28,2092,1218,3310
00196000,SPALDING UNIVERSITY                     ,KY,40203-2188,Private      ,4,34,38,616,2071,2687
00196100,CENTRE COLLEGE                          ,KY,40422-1394,Private      ,2,0,2,1929,52,1981
00196200,UNIVERSITY OF THE CUMBERLANDS           ,KY,40769-1372,Private      ,2,35,37,2096,1107,3203
00196300,EASTERN KENTUCKY UNIVERSITY             ,KY,40475-3102,Public       ,48,211,259,10618,7796,18414
00196400,GEORGETOWN COLLEGE                      ,KY,40324-1628,Private      ,3,41,44,2000,674,2674
00196500,KENTUCKY CHRISTIAN UNIVERSITY           ,KY,41143-2205,Private      ,1,1,2,747,182,929
00196800,KENTUCKY STATE UNIVERSITY               ,KY,40601-2355,Public       ,12,16,28,3185,1438,4623
00196900,KENTUCKY WESLEYAN COLLEGE               ,KY,42302-1039,Private      ,0,2,2,1189,220,1409
00197000,LEES COLLEGE                            ,KY,41339-0000,Private      ,0,0,0,2,6,8
00197100,LEXINGTON THEOLOGICAL SEMINARY          ,KY,40508-0000,Private      ,0,3,3,2,68,70
00197200,LINDSEY WILSON COLLEGE                  ,KY,42728-1223,Private      ,4,10,14,1639,1446,3085
00197400,LOUISVILLE PRESBYTERIAN THEOL SEM       ,KY,40205-0000,Private      ,0,0,0,5,138,143
00197500,MIDWAY COLLEGE                          ,KY,40347-1120,Private      ,3,46,49,516,1262,1778
00197600,MOREHEAD STATE UNIVERSITY               ,KY,40351-1689,Public       ,54,137,191,6040,5005,11045
00197700,MURRAY STATE UNIVERSITY                 ,KY,42071-0009,Public       ,30,72,102,6046,3621,9667
00197900,WEST KENTUCKY CMNTY & TECHNICAL COLG    ,KY,42002-7380,Public       ,29,102,131,1466,2961,4427
00198000,PIKEVILLE COLLEGE                       ,KY,41501-1194,Private      ,1,1,2,1168,389,1557
00198001,PIKEVILLE CLG-SCH OSTEOPATHIC MEDIC     ,KY,41501-0000,Private      ,0,0,0,9,287,296
00198200,SOUTHERN BAPTIST THEOL SEMINARY         ,KY,40280-0000,Private      ,0,1,1,53,195,248
00198300,ST. CATHARINE COLLEGE                   ,KY,40061-9499,Private      ,3,15,18,601,372,973
00198700,TRANSYLVANIA UNIVERSITY                 ,KY,40508-1797,Private      ,1,1,2,1650,99,1749
00198800,UNION COLLEGE                           ,KY,40906-1499,Private      ,4,41,45,1188,1136,2324
00198900,UNIVERSITY OF KENTUCKY                  ,KY,40506-0054,Public       ,41,73,114,15234,7777,23011
00198901,UNIV OF KY-COLLEGE OF DENTISTRY         ,KY,40536-0000,Public       ,0,1,1,10,204,214
00198902,UNIV OF KY-COLLEGE OF MEDICINE          ,KY,40536-0000,Public       ,0,4,4,27,416,443
00199000,ASHLAND COMMUNITY AND TECHNICAL COLLEGE ,KY,41101-3683,Public       ,15,81,96,1372,2406,3778
00199100,ELIZABETHTOWN COMMUNITY  AND TECHNICAL C,KY,42701-3081,Public       ,19,154,173,2056,4187,6243
00199300,HENDERSON COMMUNITY COLLEGE             ,KY,42420-4699,Public       ,16,50,66,512,1327,1839
00199400,HOPKINSVILLE COMMUNITY COLLEGE          ,KY,42241-2621,Public       ,13,117,130,1042,3567,4609
00199600,BIG SANDY COMMUNITY AND TECHNICAL COLG  ,KY,41653-1815,Public       ,17,49,66,1623,2027,3650
00199700,SOMERSET COMMUNITY COLLEGE              ,KY,42501-2973,Public       ,30,178,208,2474,5350,7824
00199800,SOUTHEAST KENTUCKY COMMUNITY AND TECHNIC,KY,40823-1099,Public       ,15,48,63,1110,1583,2693
00199802,CUMBERLAND VLY TEC CLG MIDDLESBORO      ,KY,40965-2265,Public       ,0,1,1,30,27,57
00199804,SOUTHEAST COMMUNITY COLLEGE             ,KY,40831-1796,Public       ,0,1,1,87,138,225
00199900,UNIVERSITY OF LOUISVILLE                ,KY,40292-0000,Public       ,39,151,190,12248,10827,23075
00200100,THOMAS MORE COLLEGE                     ,KY,41017-3495,Private      ,4,38,42,1269,946,2215
00200200,WESTERN KENTUCKY UNIVERSITY             ,KY,42101-3576,Public       ,77,166,243,13193,8228,21421
00461800,SPENCERIAN COLLEGE                      ,KY,40216-2605,Proprietary  ,35,120,155,834,2445,3279
00461900,SULLIVAN UNIVERSITY                     ,KY,40205-3000,Proprietary  ,83,235,318,2261,5427,7688
00512729,BROWN MACKIE COLLEGE-CINCINNATI - 279 BU,KY,41017-2136,Proprietary  ,0,0,0,12,49,61
00524400,BLUEGRASS COMMUNITY & TECHNICAL COLLEGE ,KY,40506-0235,Public       ,54,278,332,4208,7999,12207
00527100,BOWLING GREEN TECHNICAL COLLEGE         ,KY,42101-3601,Public       ,16,76,92,783,1705,2488
00527300,GATEWAY COMMUNITY & TECHNOLOGY COLL     ,KY,41011-0000,Public       ,25,135,160,1003,2841,3844
00696000,MAYSVILLE CMNTY & TECHNCL COLG          ,KY,41056-8910,Public       ,19,129,148,843,2327,3170
00696100,JEFFERSON COMMUNITY AND TECHNICAL COLLEG,KY,40202-2005,Public       ,43,222,265,5167,9288,14455
00696200,HAZARD COMMUNITY COLLEGE                ,KY,41701-2402,Public       ,8,54,62,1288,1837,3125
00696203,KY TECH-KNOTT CO. TECHNOLOGY CTR        ,KY,41822-0000,Public       ,0,0,0,5,4,9
00696204,KY TECH-LESLIE COUNTY AREA TECH CTR     ,KY,41749-0000,Public       ,0,0,0,2,2,4
00696205,KY TECH-LEE COUNTY AREA TECH CTR        ,KY,41311-0000,Public       ,0,0,0,1,4,5
00696206,KY TECH-LETCHER CNTY AREA TECH CTR      ,KY,41858-0000,Public       ,0,0,0,15,13,28
00696207,KY TECH-BREATHITT COUNTY VOC ED CTR     ,KY,41339-0000,Public       ,0,0,0,8,20,28
00842500,DAYMAR COLLEGE                          ,KY,42001-0000,Proprietary  ,3,33,36,83,635,718
00901000,MADISONVILLE COMMUNITY COLLEGE          ,KY,42431-9199,Public       ,11,63,74,1077,2378,3455
00927500,NORTHERN KENTUCKY UNIVERSITY            ,KY,41099-0001,Public       ,25,133,158,8254,6801,15055
00931300,DAYMAR COLLEGE                          ,KY,42301-5830,Proprietary  ,31,199,230,339,2400,2739
00931302,DAYMAR COLLEGE - LOUISVILLE CAMPUS      ,KY,40219-1973,Proprietary  ,1,7,8,35,151,186
01042400,SALON PROFESSIONAL ACADEMY THE          ,KY,40502-1776,Proprietary  ,2,3,5,68,122,190
01048900,NATIONAL COLLEGE                        ,KY,40508-0000,Proprietary  ,30,162,192,596,4857,5453
01172500,COLLINS SCHOOL OF COSMETOLOGY           ,KY,40965-2809,Proprietary  ,2,3,5,26,62,88
01208800,SULLIVAN COLLEGE OF TECHNOLOGY AND DESIG,KY,40218-4528,Proprietary  ,10,34,44,516,519,1035
01208801,LOUISVILLE TECHNICAL INSTITUTE -        ,KY,40218-4528,Proprietary  ,0,0,0,45,33,78
01212801,SOUTHWESTERN COLLEGE                    ,KY,41042-1466,Proprietary  ,12,69,81,137,740,877
01240400,LEXINGTON BEAUTY COLLEGE                ,KY,40503-1819,Proprietary  ,0,4,4,24,76,100
01272300,KY TECH-WAYNE COUNTY AREA TECH CTR      ,KY,42633-1088,Public       ,0,0,0,1,2,3
01291400,HAIR DESIGN SCHOOL (THE)                ,KY,40218-0000,Proprietary  ,4,16,20,174,318,492
01291500,HAIR DESIGN SCHOOL (THE)                ,KY,41042-5113,Proprietary  ,3,8,11,100,190,290
01291600,HAIR DESIGN SCHOOL (THE)                ,KY,40216-4212,Proprietary  ,2,24,26,49,171,220
01291700,HAIR DESIGN SCHOOL (THE)                ,KY,40160-0000,Proprietary  ,2,3,5,97,244,341
01296800,HAIR DESIGN SCHOOL (THE)                ,KY,40207-2695,Proprietary  ,6,9,15,96,137,233
02159100,"APPALACHIAN BEAUTY SCHOOL, INC.         ",KY,41503-0000,Proprietary  ,0,1,1,16,33,49
02177100,HAIR DESIGN SCHOOL (THE)                ,KY,40204-0000,Proprietary  ,4,16,20,88,173,261
02251500,TREND SETTERS ACAD OF BEAUTY CULT       ,KY,40258-0000,Proprietary  ,4,18,22,46,186,232
02275000,JENNY LEA ACADEMY OF COSMETOLOGY        ,KY,40831-0000,Proprietary  ,4,14,18,72,186,258
02279800,ELIZABETHTOWN BEAUTY SCHOOL             ,KY,42701-0000,Proprietary  ,0,0,0,19,34,53
02284306,INTERACTIVE LEARNING SYSTEMS            ,KY,41042-0000,Proprietary  ,1,14,15,16,144,160
02323700,PAT WILSON'S BEAUTY COLLEGE             ,KY,42420-0000,Proprietary  ,0,3,3,9,58,67
02337200,PJ'S COLLEGE OF COSMETOLOGY             ,KY,42101-0000,Proprietary  ,7,72,79,109,564,673
02340800,PAUL MITCHELL THE SCHOOL LEXINGTON      ,KY,40601-0000,Proprietary  ,2,4,6,20,71,91
02351700,DONTA SCHOOL OF BEAUTY CULTURE          ,KY,40203-0000,Proprietary  ,2,5,7,25,81,106
02491100,BECKFIELD COLLEGE                       ,KY,41042-0000,Proprietary  ,3,28,31,232,1134,1366
02518900,BARRETT & COMPANY SCH HAIR DESIGN       ,KY,40356-0000,Proprietary  ,0,5,5,51,130,181
02526100,JENNY LEA ACADEMY OF COSMETOLOGY        ,KY,41858-0000,Proprietary  ,0,1,1,14,28,42
02535600,CLEAR CREEK BAPTIST BIBLE COLLEGE       ,KY,40977-0000,Private      ,0,0,0,34,141,175
02551100,PJ'S COLLEGE OF COSMETOLOGY             ,KY,42121-0000,Proprietary  ,1,20,21,30,96,126
02560800,SOUTHEAST SCHOOL OF COSMETOLOGY         ,KY,40962-0000,Proprietary  ,0,1,1,21,74,95
02576200,MID-CONTINENT UNIVERSITY                ,KY,42066-9007,Private      ,1,44,45,279,2430,2709
02616204,BROWN MACKIE COLLEGE-FINDLAY - BROWN MAC,KY,40219-1916,Proprietary  ,2,19,21,255,1102,1357
02616205,BROWN MACKIE COLLEGE-LOUISVILLE - BROWN ,KY,42240-3579,Proprietary  ,0,9,9,6,64,70
03002100,KENTUCKY MOUNTAIN BIBLE COLLEGE         ,KY,41385-0010,Private      ,0,0,0,50,24,74
03007000,FRONTIER SCH OF MIDWIFERY&FAMILY NU     ,KY,41749-0000,Private      ,0,10,10,1,687,688
03026200,HEAD'S WEST KENTUCKY BEAUTY COLLEGE     ,KY,42431-0000,Proprietary  ,0,4,4,10,48,58
03029200,NU-TEK ACADEMY OF BEAUTY                ,KY,40353-9767,Proprietary  ,0,3,3,14,37,51
03034500,OWENSBORO COMMUNITY & TECHNICAL COLLEGE ,KY,42303-1899,Public       ,20,177,197,1405,2748,4153
03083700,GALEN HEALTH INSTITUTES                 ,KY,40207-1047,Proprietary  ,16,147,163,538,3014,3552
03103500,MR JIM'S BEAUTY COLLEGE                 ,KY,42301-2646,Proprietary  ,0,4,4,17,47,64
03106700,MOTIF BEAUTY ACADEMY                    ,KY,40391-1958,Proprietary  ,0,0,0,3,8,11
03516500,EZELL'S COSMETOLOGY SCHOOL              ,KY,42071-2530,Proprietary  ,3,10,13,26,45,71
03611300,BRIGHTON CENTER'S CENTER FOR EMPLOY     ,KY,41071-1968,Private      ,1,40,41,12,195,207
03804300,BELLEFONTE ACADEMY OF BEAUTY            ,KY,41169-2015,Proprietary  ,1,10,11,37,104,141
03885300,EMPLOYMENT SOLUTIONS                    ,KY,40517-3260,Private      ,5,36,41,22,180,202
03886300,REGENCY SCHOOL OF HAIR DESIGN           ,KY,41653-1278,Proprietary  ,0,4,4,8,42,50
04038300,ATA CAREER EDUCATION                    ,KY,40223-3832,Proprietary  ,8,63,71,151,969,1120
04123900,LEXINGTON HEALING ARTS ACADEMY          ,KY,40503-1932,Proprietary  ,1,5,6,25,114,139
00200300,CENTENARY COLLEGE OF LOUISIANA          ,LA,71104-3396,Private      ,2,3,5,1101,182,1283
00200400,DILLARD UNIVERSITY                      ,LA,70122-3097,Private      ,35,6,41,1651,584,2235
00200500,NICHOLLS STATE UNIVERSITY               ,LA,70310-0001,Public       ,21,49,70,5054,2524,7578
00200600,GRAMBLING STATE UNIVERSITY              ,LA,71245-2215,Public       ,199,61,260,7147,2985,10132
00200700,LOUISIANA COLLEGE                       ,LA,71359-0000,Private      ,3,66,69,933,537,1470
00200800,LOUISIANA TECH UNIVERSITY               ,LA,71272-0001,Public       ,31,60,91,6351,2789,9140
00201000,LOUISIANA STATE UNIV & A&M COLG         ,LA,70803-5710,Public       ,54,56,110,20374,6705,27079
00201100,LOUISIANA STATE UNIV-ALEXANDRIA         ,LA,71302-9121,Public       ,13,62,75,1370,2100,3470
00201200,LOUISIANA STATE UNIV-EUNICE             ,LA,70535-6726,Public       ,47,39,86,1863,1633,3496
00201300,LOUISIANA STATE UNIV-SHREVEPORT         ,LA,71115-2399,Public       ,21,63,84,2408,2756,5164
00201400,LA STATE UNIV HEALTH SCIENCES CTR       ,LA,70112-2223,Public       ,4,23,27,440,1842,2282
00201500,UNIVERSITY OF NEW ORLEANS               ,LA,70148-0001,Public       ,39,141,180,6079,6340,12419
00201600,LOYOLA UNIVERSITY NEW ORLEANS           ,LA,70118-6195,Private      ,9,54,63,2816,2350,5166
00201700,MCNEESE STATE UNIVERSITY                ,LA,70609-4510,Public       ,42,85,127,4988,3362,8350
00201900,NEW ORLEANS BAPTIST THEOL SEMINARY      ,LA,70126-0000,Private      ,0,1,1,32,112,144
00202000,UNIVERSITY OF LOUISIANA AT MONROE       ,LA,71209-9001,Public       ,33,98,131,6003,4354,10357
00202100,NORTHWESTERN STATE UNIVERSITY           ,LA,71497-0001,Public       ,76,142,218,5802,5031,10833
00202200,NOTRE DAME SEMINARY                     ,LA,70118-0000,Private      ,0,0,0,1,6,7
00202300,OUR LADY OF HOLY CROSS COLLEGE          ,LA,70131-7399,Private      ,5,17,22,615,1062,1677
00202400,SOUTHEASTERN LOUISIANA UNIV             ,LA,70402-0001,Public       ,64,105,169,10531,5346,15877
00202500,SOUTHERN UNIVERSITY A & M COLLEGE       ,LA,70813-9374,Public       ,67,80,147,7993,6156,14149
00202600,SOUTHERN UNIV NEW ORLEANS               ,LA,70126-0002,Public       ,16,55,71,1387,3393,4780
00202700,ST JOSEPH SEMINARY COLLEGE              ,LA,70457-9990,Private      ,0,0,0,25,19,44
00202900,TULANE UNIVERSITY                       ,LA,70118-5698,Private      ,18,73,91,9267,5802,15069
00203100,UNIV OF LOUISIANA AT LAFAYETTE          ,LA,70504-0001,Public       ,59,48,107,11093,4655,15748
00203200,XAVIER UNIVERSITY OF LOUISIANA          ,LA,70125-1098,Private      ,15,14,29,4254,1470,5724
00462100,AYERS CAREER COLLEGE                    ,LA,71108-5845,Proprietary  ,2,17,19,76,442,518
00462500,DELGADO COMMUNITY COLLEGE               ,LA,70119-0000,Public       ,95,360,455,6089,11307,17396
00520300,REMINGTON COLLEGE - LAFAYETTE CAMPUS    ,LA,70508-5760,Proprietary  ,23,221,244,706,2281,2987
00520306,REMINGTON COLLEGE - BATON ROUGE CAMPUS  ,LA,70816-4040,Proprietary  ,9,56,65,180,674,854
00546700,SOWELA TECHNICAL COMMUNITY COLLEGE      ,LA,70616-6950,Public       ,21,58,79,780,1161,1941
00548800,LOUISIANA TECH COLG-BATON ROUGE         ,LA,70807-0000,Public       ,23,53,76,392,849,1241
00548802,LOUISIANA TECH COLG-ACADIAN CMPS        ,LA,70526-0000,Public       ,6,6,12,94,176,270
00548803,LOUISIANA TECH COLG-ALEXANDRIA CMPS     ,LA,71302-3137,Public       ,9,35,44,184,547,731
00548804,LOUISIANA TECH COLG-ASCENSION CMPS      ,LA,70778-3007,Public       ,4,8,12,100,147,247
00548805,LA TECH COLLEGE-AVOYELLES CAMPUS        ,LA,71327-0000,Public       ,9,9,18,78,117,195
00548806,LA TECHNICAL COLG-BASTROP CMPS          ,LA,71221-0000,Public       ,4,10,14,46,155,201
00548808,LA TECH COLG CHARLES B COREILCMPS       ,LA,70586-0000,Public       ,6,9,15,98,191,289
00548809,LA TECHNICAL COLG-DELTA-OUACHITA        ,LA,71292-9064,Public       ,8,45,53,174,421,595
00548810,EVANGELINE TECHNICAL INST               ,LA,70582-3104,Public       ,2,20,22,57,165,222
00548811,LA TECHN COLLEGE - FLORIDA PARISHES     ,LA,70441-0000,Public       ,2,6,8,55,118,173
00548812,LOUISIANA TECH COLG-FOLKES CAMPUS       ,LA,70748-0000,Public       ,3,1,4,19,65,84
00548813,LA TECHNICAL INST-GULF AREA CMPS        ,LA,70510-0878,Public       ,19,19,38,173,256,429
00548814,LOUISIANA TECH COLG-HAMMOND CMPS        ,LA,70404-0000,Public       ,17,21,38,179,367,546
00548815,LA TECH COLG-HUEY P. LONG CAMPUS        ,LA,71483-0000,Public       ,5,15,20,75,156,231
00548816,LA TECH COLLEGE-JEFFERSON CAMPUS        ,LA,70001-5605,Public       ,4,23,27,66,245,311
00548817,LOUISIANA TEC CLG-JUMONVILLE MEM CP     ,LA,70760-0000,Public       ,0,8,8,40,115,155
00548818,LA TECH COLLEGE-LAFAYETTE CAMPUS        ,LA,70506-0000,Public       ,20,33,53,449,842,1291
00548819,LOUISIANA TECHNICAL COLLEGE-LAFOURC     ,LA,70301-4336,Public       ,7,14,21,101,216,317
00548820,LOUISIANA TEC CLG-LAMAR SALTER CMPS     ,LA,71446-0000,Public       ,1,18,19,62,188,250
00548822,LOUISIANA TECHNICAL CLG-MANSFIELD       ,LA,71052-1236,Public       ,4,4,8,51,135,186
00548823,LA. TECH COLG.-MORGAN SMITH CAMPUS      ,LA,70546-0000,Public       ,2,5,7,42,108,150
00548824,LOUISIANA TEC CLG-NATCHITOCHES CMPS     ,LA,71458-0000,Public       ,4,18,22,87,277,364
00548825,LOUISIANA TECH COLG-NORTH CTRL CMPS     ,LA,71241-0000,Public       ,4,24,28,50,140,190
00548826,LOUISIANA TECH CLG-NORTHEAST LA CMP     ,LA,71295-2999,Public       ,6,20,26,59,189,248
00548827,LOUISIANA TEC CLG-NW LOUISIANA CMPS     ,LA,71058-0000,Public       ,11,25,36,196,457,653
00548828,LA TECHNICAL COLG-OAKDALE CMPS          ,LA,71463-0000,Public       ,1,11,12,49,113,162
00548829,LTC-RIVER PARISHES CAMPUS               ,LA,70084-0000,Public       ,5,20,25,186,368,554
00548830,LOUISIANA TECHNICAL COLLEGE-RUSTON      ,LA,71273-0000,Public       ,5,18,23,238,249,487
00548831,LTC - SABINE VALLEY CAMPUS              ,LA,71449-3839,Public       ,0,16,16,51,131,182
00548832,LOUISIANA TECH COLG-SHELBY JACKSON      ,LA,71334-0000,Public       ,6,19,25,58,210,268
00548833,LA TECH COLG SHREVEPORT-BOSSIER         ,LA,71137-0000,Public       ,7,67,74,275,1096,1371
00548837,LOUISIANA TECH COLG-SULLIVAN CAMPUS     ,LA,70427-5866,Public       ,7,20,27,160,415,575
00548838,LOUISIANA TECHNICAL COLG - TALLULAH     ,LA,71284-0000,Public       ,6,14,20,91,254,345
00548839,LA TECH COLG-TECHE AREA CAMPUS          ,LA,70562-0000,Public       ,10,25,35,224,305,529
00548840,LOUISIANA TECH COLG-T.H.HARRIS CMPS     ,LA,70570-6113,Public       ,14,34,48,336,399,735
00548841,LOUISIANA TECH COLG W JEFFERSON CMP     ,LA,70058-0000,Public       ,3,9,12,45,154,199
00548842,LOUISIANA TECHNICAL COLLEGE - WESTSIDE C,LA,70765-0733,Public       ,0,3,3,23,86,109
00548843,LTC-YOUNG MEMORIAL CAMPUS               ,LA,70381-0000,Public       ,13,52,65,123,324,447
00576100,L. E. FLETCHER TECHNICAL COMMUNITY COLLE,LA,70360-2863,Public       ,8,21,29,514,676,1190
00768600,SOUTHERN UNIV AT SHREVEPORT/BOSSIER     ,LA,71107-4795,Public       ,26,66,92,1187,2642,3829
00806700,LSU HEALTH SCIENCES CENTR-SHREVEPOR     ,LA,71130-3932,Public       ,3,13,16,233,919,1152
00989800,DEMMON SCHOOL OF BEAUTY                 ,LA,70607-2128,Proprietary  ,0,5,5,14,71,85
01005701,AMERICAN COMMERCIAL COLLEGE             ,LA,71105-2502,Proprietary  ,2,15,17,32,243,275
01109700,CLOYD'S BEAUTY SCHOOL #1                ,LA,71291-3131,Proprietary  ,2,15,17,47,159,206
01163100,"D-JAY'S SCHL OF BEAUTY, ARTS & SCI      ",LA,70806-0000,Proprietary  ,3,7,10,37,129,166
01184100,JOHN JAY BEAUTY COLLEGE                 ,LA,70124-2592,Proprietary  ,4,1,5,28,26,54
01261100,RONNIE & DORMANS SCHOOL HAIR DESIGN     ,LA,70501-0000,Proprietary  ,1,2,3,8,34,42
01282300,PAT GOINS RUSTON BEAUTY SCHOOL          ,LA,71270-4301,Proprietary  ,0,3,3,23,42,65
01287900,PAT GOINS BENTON ROAD BEAUTY SCHOOL     ,LA,71111-4838,Proprietary  ,0,9,9,22,78,100
01288000,PAT GOINS BEAUTY SCHOOL                 ,LA,71201-5167,Proprietary  ,0,0,0,10,28,38
02055400,BOSSIER PARISH COMMUNITY COLLEGE        ,LA,71111-0000,Public       ,28,68,96,2179,3113,5292
02055500,DELTA SCH OF BUSINESS & TECHNOLOGY      ,LA,70601-0000,Proprietary  ,3,16,19,111,446,557
02089711,HERZING COLLEGE                         ,LA,70062-8727,Proprietary  ,8,32,40,58,273,331
02117800,AVEDA INSTITUTE LAFAYETTE               ,LA,70503-3246,Proprietary  ,4,8,12,105,150,255
02166100,NUNEZ COMMUNITY COLLEGE                 ,LA,70043-0000,Public       ,10,49,59,476,1073,1549
02166200,ITI TECHNICAL COLLEGE                   ,LA,70817-0000,Proprietary  ,0,7,7,313,553,866
02197500,BATON ROUGE SCHOOL OF COMPUTERS         ,LA,70816-0000,Proprietary  ,0,4,4,35,60,95
02234000,CAMERON COLLEGE                         ,LA,70119-0000,Proprietary  ,5,26,31,46,202,248
02258400,AVEDA INSTITUTE BATON ROUGE             ,LA,70816-2246,Proprietary  ,9,12,21,126,136,262
02260200,DIESEL DRIVING ACADEMY                  ,LA,71109-5617,Proprietary  ,9,57,66,54,493,547
02263600,BASTROP BEAUTY SCHOOL #1                ,LA,71220-0000,Proprietary  ,1,3,4,7,32,39
02265600,JOHN JAY KENNER ACADEMY                 ,LA,70062-0000,Proprietary  ,2,6,8,67,105,172
02269300,STEVENSON'S ACADEMY OF HAIR DESIGN      ,LA,70116-0000,Proprietary  ,3,11,14,70,121,191
02323100,PAT GOINS SHREVEPORT BEAUTY SCHOOL      ,LA,71108-4354,Proprietary  ,0,0,0,2,1,3
02327800,PINEVILLE BEAUTY SCHOOL                 ,LA,71360-0000,Proprietary  ,0,3,3,17,70,87
02335701,BATON ROUGE GEN MED CTR SCH NSG         ,LA,70821-0000,Private      ,0,0,0,68,161,229
02335702,BATON ROUGE GEN MED CTR-RAD TECH        ,LA,70806-0000,Private      ,1,1,2,28,49,77
02338000,"CLOYD'S BEAUTY SCHOOL #2, INC           ",LA,71202-3539,Proprietary  ,3,14,17,44,155,199
02352500,"CLOYD'S BEAUTY SCHOOL #3, INC           ",LA,71201-3211,Proprietary  ,2,14,16,49,159,208
02358600,"STAGE ONE THE HAIR SCHOOL, INC.         ",LA,70605-0000,Proprietary  ,3,9,12,72,113,185
02493400,ALEXANDRIA ACADEMY OF BEAUTY CULT       ,LA,71301-0000,Proprietary  ,0,0,0,11,22,33
02518300,SOUTH LOUISIANA BEAUTY COLLEGE          ,LA,70363-0000,Proprietary  ,4,5,9,36,74,110
02536400,LOUISIANA ACADEMY OF BEAUTY             ,LA,70535-0000,Proprietary  ,0,2,2,18,34,52
02538300,DELTA COLLEGE OF ARTS & TECH INC        ,LA,70806-1529,Proprietary  ,13,29,42,135,510,645
02538301,DELTA COLLEGE OF ARTS & TECHNOLOGY - LAF,LA,70508-6831,Proprietary  ,1,3,4,40,163,203
02548500,COSMETOLOGY TRAINING CENTER             ,LA,70503-0000,Proprietary  ,1,3,4,54,66,120
02554800,VANGUARD COLLEGE OF COSMETOLOGY         ,LA,70458-8823,Proprietary  ,6,13,19,113,152,265
02582200,"GUY'S ACADEMY HAIR, SKIN & NAILS        ",LA,71105-2404,Proprietary  ,3,14,17,61,170,231
02600900,AVEDA INSTITUTE                         ,LA,70433-2922,Proprietary  ,24,40,64,519,793,1312
02601000,AMERICAN SCHOOL OF BUSINESS             ,LA,71105-5646,Proprietary  ,0,9,9,10,101,111
02601100,OPELOUSAS SCHOOL OF COSMETOLOGY         ,LA,70570-6156,Proprietary  ,0,4,4,18,43,61
02606800,CAREER TRAINING SPECIALISTS             ,LA,71201-6046,Proprietary  ,19,73,92,349,1071,1420
02606801,CAREER TECHNICAL COLLEGE - SHREVEPORT   ,LA,71105-2405,Proprietary  ,6,54,60,94,577,671
02617100,BATON ROUGE COLLEGE                     ,LA,70816-2246,Proprietary  ,0,9,9,34,90,124
02619200,DENHAM SPRINGS BEAUTY COLLEGE           ,LA,70726-3829,Proprietary  ,1,7,8,32,82,114
03010400,CRESCENT CITY SCH GAMING & BARTENDG     ,LA,70119-5507,Proprietary  ,13,108,121,62,951,1013
03023500,CAMELOT CAREER COLLEGE                  ,LA,70805-7539,Proprietary  ,14,36,50,115,286,401
03030900,DIESEL DRIVING ACADEMY                  ,LA,70815-8109,Proprietary  ,9,103,112,64,753,817
03061400,ASCENSION COLLEGE                       ,LA,70737-2912,Proprietary  ,11,21,32,96,211,307
03095100,GRETNA CAREER COLLEGE                   ,LA,70053-2436,Proprietary  ,6,33,39,53,316,369
03106200,OUR LADY OF THE LAKE COLLEGE            ,LA,70808-4398,Private      ,7,35,42,864,1814,2678
03253300,JONESVILLE BEAUTY SCHOOL                ,LA,71343-0000,Proprietary  ,7,9,16,46,108,154
03294300,BLUE CLIFF SCH THERAPEUTIC MASSAGE      ,LA,70002-3458,Proprietary  ,37,83,120,245,712,957
03332600,DELTA COLLEGE                           ,LA,70433-9042,Proprietary  ,1,14,15,71,315,386
03332601,DELTA COLLEGE - SLIDELL                 ,LA,70460-2624,Proprietary  ,2,13,15,53,247,300
03356300,MEDICAL TRAINING COLLEGE                ,LA,70816-5820,Proprietary  ,5,24,29,109,308,417
03422500,BLUE CLIFF COLLEGE                      ,LA,71107-6520,Proprietary  ,4,36,40,142,487,629
03422600,BLUE CLIFF COLLEGE                      ,LA,70508-3858,Proprietary  ,8,53,61,176,614,790
03480300,MEDVANCE INSTITUTE                      ,LA,70809-1908,Proprietary  ,10,50,60,414,1474,1888
03498400,OMEGA INSTITUTE OF COSMETOLOGY          ,LA,70360-0000,Proprietary  ,0,5,5,47,64,111
03727500,BLUE CLIFF COLLEGE-BATON ROUGE          ,LA,70808-4191,Proprietary  ,5,5,10,34,76,110
03730300,BATON ROUGE COMMUNITY COLLEGE           ,LA,78806-4129,Public       ,56,85,141,3863,4178,8041
03752400,SCHOOL OF URBAN MISSIONS                ,LA,70053-0000,Private      ,0,1,1,56,77,133
03789300,UNITECH TRAINING ACADEMY                ,LA,70503-5132,Proprietary  ,20,114,134,162,831,993
03789400,RIVER PARISHES COMMUNITY COLLEGE        ,LA,70778-0310,Public       ,5,16,21,388,520,908
03810500,COURT REPORTING INSTITUTE OF LOUISI     ,LA,70816-0000,Proprietary  ,1,1,2,13,59,72
03858300,RAY'S FAITH ACADEMY OF BEAUTY EDUCATION ,LA,70737-0000,Proprietary  ,0,0,0,0,8,8
03956300,SOUTH LOUISIANA COMMUNITY COLLEGE       ,LA,70506-0000,Public       ,34,62,96,1197,1327,2524
04040300,COMPASS CAREER COLLEGE                  ,LA,70403-0653,Proprietary  ,1,5,6,36,219,255
04112300,LOUISIANA CULINARY INSTITUTE            ,LA,70816-4109,Proprietary  ,2,5,7,81,89,170
04120700,ALDEN'S SCHOOL OF COSMETOLOGY           ,LA,70714-1502,Proprietary  ,1,7,8,14,49,63
04130100,LOUISIANA DELTA COMMUNITY COLLEGE       ,LA,71203-3618,Public       ,12,27,39,659,796,1455
00143600,CAPITOL COLLEGE                         ,MD,20708-9759,Private      ,0,3,3,268,285,553
00146200,WASHINGTON BIBLE COLLEGE                ,MD,20706-3599,Private      ,0,4,4,99,335,434
00205700,ALLEGANY COLLEGE OF MARYLAND            ,MD,21502-2596,Public       ,10,18,28,2110,1609,3719
00205800,ANNE ARUNDEL COMMUNITY COLLEGE          ,MD,21012-1895,Public       ,57,173,230,3421,4972,8393
00206000,BALTIMORE HEBREW UNIVERSITY             ,MD,21215-3996,Private      ,0,2,2,6,41,47
00206100,BALTIMORE CITY COMMUNITY COLLEGE        ,MD,21215-7893,Public       ,28,181,209,2815,7399,10214
00206200,BOWIE STATE UNIVERSITY                  ,MD,20715-9465,Public       ,15,36,51,7182,3860,11042
00206300,COMMUNITY COLLEGE OF BALTIMORE COUNTY   ,MD,21228-5381,Public       ,68,253,321,6126,10329,16455
00206400,COLLEGE OF SOUTHERN MARYLAND            ,MD,20646-0910,Public       ,11,53,64,2368,3002,5370
00206401,COLLEGE OF SOUTHERN MARYLAND - PRINCE FR,MD,20676-9702,Public       ,1,3,4,2,6,8
00206402,COLLEGE OF SOUTHERN MARYLAND - LEONARDTO,MD,20650-1758,Public       ,2,6,8,4,9,13
00206477,COLLEGE OF SOUTHERN MARYLAND - WALDORF C,MD,20602-3223,Public       ,1,3,4,1,3,4
00206500,CLG NOTRE DAME OF MARYLAND              ,MD,21210-2476,Private      ,2,13,15,697,1204,1901
00206700,COLUMBIA UNION COLLEGE                  ,MD,20912-7796,Private      ,2,14,16,821,775,1596
00206800,COPPIN STATE UNIVERSITY                 ,MD,21216-3698,Public       ,14,28,42,3840,3685,7525
00207100,FREDERICK COMMUNITY COLLEGE             ,MD,21702-9745,Public       ,16,73,89,1403,1964,3367
00207200,FROSTBURG STATE UNIVERSITY              ,MD,21532-1099,Public       ,6,6,12,5914,1069,6983
00207300,GOUCHER COLLEGE                         ,MD,21204-2794,Private      ,3,7,10,3071,467,3538
00207400,HAGERSTOWN COMMUNITY COLLEGE            ,MD,21742-6590,Public       ,15,97,112,1399,2064,3463
00207500,HARFORD COMMUNITY COLLEGE               ,MD,21015-1696,Public       ,8,55,63,1599,1865,3464
00207600,HOOD COLLEGE                            ,MD,21701-8575,Private      ,1,11,12,2017,815,2832
00207700,JOHNS HOPKINS UNIVERSITY                ,MD,21218-2693,Private      ,2,21,23,6764,1349,8113
00207702,JOHNS HOPKINS UNIV SCH ARTS/SCI/ENG     ,MD,21218-0000,Private      ,4,22,26,4034,1647,5681
00207703,JOHNS HOPKINS UNIV SCH OF BUS/ED        ,MD,21046-0000,Private      ,2,19,21,32,1477,1509
00207705,JOHNS HOPKINS BLOOMBERG SCH OF PH       ,MD,21205-0000,Private      ,1,8,9,22,1230,1252
00207706,JOHNS HOPKINS UNIV SCH OF MEDICINE      ,MD,21205-0000,Private      ,0,2,2,85,1071,1156
00207707,JOHNS HOPKINS UNIV SCH OF NURSING       ,MD,21205-0000,Private      ,1,6,7,206,763,969
00207708,JOHNS HOPKINS UNIV PEABODY CONSERV      ,MD,21202-2397,Private      ,1,1,2,560,425,985
00207800,LOYOLA UNIVERSITY MARYLAND              ,MD,21210-2699,Private      ,5,24,29,5769,1698,7467
00208000,MARYLAND INST COLLEGE OF ART            ,MD,21217-4191,Private      ,2,3,5,2397,560,2957
00208300,MORGAN STATE UNIVERSITY                 ,MD,21251-0002,Public       ,31,32,63,10488,4210,14698
00208600,MOUNT SAINT MARY'S UNIVERSITY           ,MD,21727-7799,Private      ,0,6,6,2596,291,2887
00208700,NER ISRAEL RABBINICAL COLLEGE           ,MD,21208-1198,Private      ,6,4,10,94,52,146
00208900,PRINCE GEORGES COMMUNITY COLLEGE        ,MD,20774-2199,Public       ,38,175,213,4209,6893,11102
00209100,SALISBURY UNIVERSITY                    ,MD,21801-6862,Public       ,10,12,22,8796,1457,10253
00209200,ST JOHN'S COLLEGE                       ,MD,21404-0000,Private      ,0,5,5,656,171,827
00209500,ST. MARY'S COLLEGE OF MARYLAND          ,MD,20686-3001,Public       ,1,1,2,2773,166,2939
00209600,ST MARY'S SEMINARY & UNIV               ,MD,21210-1994,Private      ,0,1,1,31,25,56
00209900,TOWSON UNIVERSITY                       ,MD,21252-0002,Public       ,34,64,98,18583,5640,24223
00210200,UNIVERSITY OF BALTIMORE                 ,MD,21201-5779,Public       ,5,41,46,1266,5714,6980
00210300,"UNIVERSITY OF MARYLAND, COLLEGE PARK    ",MD,20742-5145,Public       ,54,172,226,28471,11341,39812
00210400,"UNIVERSITY OF MARYLAND, BALTIMORE       ",MD,21201-1691,Public       ,6,38,44,2145,8392,10537
00210500,UMBC                                    ,MD,21250-0002,Public       ,17,24,41,7933,3455,11388
00210600,UNIVERSITY MARYLAND EASTERN SHORE       ,MD,21853-4053,Public       ,16,10,26,5067,1300,6367
00210700,STEVENSON UNIVERSITY                    ,MD,21153-0641,Private      ,6,7,13,3907,977,4884
00210800,WASHINGTON COLLEGE                      ,MD,21620-1197,Private      ,1,1,2,2367,72,2439
00210900,MCDANIEL COLLEGE                        ,MD,21157-4390,Private      ,2,6,8,2785,569,3354
00465000,CHESAPEAKE COLLEGE                      ,MD,21679-0008,Public       ,11,42,53,945,1276,2221
00691100,MONTGOMERY COLLEGE                      ,MD,20850-1195,Public       ,50,137,187,8005,7521,15526
00734100,INTERNATIONAL BEAUTY SCHOOL             ,MD,21502-2370,Proprietary  ,1,51,52,72,328,400
00744700,DEL-MAR-VA BEAUTY ACADEMY               ,MD,21804-0000,Proprietary  ,1,1,2,41,76,117
00749100,TESST COLLEGE OF TECHNOLOGY             ,MD,21227-1063,Proprietary  ,39,154,193,496,1716,2212
00793600,LINCOLN TECHNICAL INSTITUTE             ,MD,21046-1544,Proprietary  ,68,90,158,1017,1155,2172
00794600,KAPLAN COLLEGE                          ,MD,21742-2797,Proprietary  ,26,89,115,395,1081,1476
00794601,KAPLAN COLLEGE -  CAREER TECHNOLOGY CENT,MD,21742-2797,Proprietary  ,0,1,1,16,37,53
00794602,KAPLAN COLLEGE - FREDERICK              ,MD,21704-8307,Proprietary  ,5,29,34,76,327,403
00817500,HOWARD COMMUNITY COLLEGE                ,MD,21044-3197,Public       ,18,36,54,2324,2595,4919
00826300,AWARD BEAUTY SCHOOL                     ,MD,21740-5624,Proprietary  ,11,35,46,106,344,450
00830800,CECIL COLLEGE                           ,MD,21901-1999,Public       ,7,19,26,772,855,1627
00907906,EVEREST COLLEGE- EVEREST INSTITUTE      ,MD,20910-3737,Proprietary  ,23,70,93,325,799,1124
01001400,GARRETT COMMUNITY COLLEGE               ,MD,21541-1265,Public       ,2,13,15,631,314,945
01031900,MEDIX SCHOOL                            ,MD,21204-2538,Proprietary  ,49,211,260,582,2203,2785
01041000,TESST COLLEGE OF TECHNOLOGY             ,MD,21286-2201,Proprietary  ,19,84,103,219,631,850
01164400,UNIV OF MARYLAND UNIVERSITY COLLEGE     ,MD,20783-8078,Public       ,30,785,815,1890,22108,23998
01164402,U OF MD UNIVERSITY COLLEGE - EUROPE     ,MD,20832-0000,Public       ,3,47,50,328,2062,2390
01164404,U OF MD UNIVERSITY COLLEGE - ASIA       ,MD,31207-0000,Public       ,4,32,36,122,1046,1168
02073900,WOR-WIC COMMUNITY COLLEGE               ,MD,21804-0000,Public       ,26,67,93,1296,2350,3646
02083600,TESST COLLEGE OF TECHNOLOGY             ,MD,20705-2698,Proprietary  ,37,73,110,419,726,1145
02116005,SANFORD-BROWN INSTITUTE - LANDOVER      ,MD,20785-2287,Proprietary  ,17,114,131,195,1149,1344
02127900,SOJOURNER DOUGLASS COLLEGE              ,MD,21205-0000,Private      ,1,17,18,154,2424,2578
02155100,MARYLAND COLLEGE OF ART AND DESIGN      ,MD,20902-0000,Private      ,0,1,1,77,36,113
02269700,INTERNATIONAL BEAUTY SCHOOL             ,MD,21014-0000,Proprietary  ,0,7,7,30,73,103
02314800,BALTIMORE INTERNATIONAL COLLEGE         ,MD,21202-0000,Private      ,2,6,8,615,468,1083
02331000,MARYLAND BEAUTY ACADEMY OF ESSEX        ,MD,21221-0000,Proprietary  ,3,14,17,52,133,185
02333000,HAIR ACADEMY                            ,MD,20784-0000,Proprietary  ,21,51,72,173,462,635
02343800,MONTGOMERY BEAUTY SCHOOL                ,MD,20901-0000,Proprietary  ,5,15,20,63,197,260
02494700,BALTIMORE STUDIO OF HAIR DESIGN         ,MD,21201-0000,Proprietary  ,3,28,31,62,225,287
02495000,ROBERT PAUL ACAD COSMTGY ARTS & SCI     ,MD,21093-0000,Proprietary  ,2,0,2,64,60,124
02495100,MARYLAND BEAUTY ACADEMY                 ,MD,21136-0000,Proprietary  ,3,8,11,15,46,61
02545400,NORTH AMERICAN TRADE SCHOOLS            ,MD,21244-0069,Proprietary  ,9,78,87,240,1068,1308
02573800,"L' ACADEMIE DE CUISINE, INC.            ",MD,20877-0000,Proprietary  ,0,0,0,30,108,138
02578400,TAI SOPHIA INSTITUTE                    ,MD,20723-6010,Private      ,0,5,5,2,262,264
03027200,BLADES SCHOOL OF HAIR DESIGN            ,MD,20619-0226,Proprietary  ,4,10,14,34,79,113
03064900,AARON'S ACADEMY OF BEAUTY               ,MD,20602-2715,Proprietary  ,1,7,8,26,77,103
03097200,AESTHETICS INSTITUTE OF COSMETOLOGY     ,MD,20877-1305,Proprietary  ,2,1,3,7,52,59
03100700,CARROLL COMMUNITY COLLEGE               ,MD,21157-6913,Public       ,7,16,23,838,797,1635
03148300,AMERICAN BEAUTY ACADEMY                 ,MD,20902-1911,Proprietary  ,25,88,113,255,602,857
03296300,BALTIMORE SCHOOL OF MASSAGE             ,MD,21090-2261,Proprietary  ,17,71,88,192,666,858
03327300,NEW CREATIONS ACADEMY OF HAIR DSN       ,MD,20746-2960,Proprietary  ,0,6,6,9,50,59
03455500,NATIONAL LABOR COLLEGE                  ,MD,20903-1790,Private      ,0,1,1,0,1,1
03493300,ALL-STATE CAREER SCHOOL                 ,MD,21224-6658,Proprietary  ,58,345,403,527,2516,3043
03771300,AMERICAN CAREER INSTITUTE               ,MD,20902-4637,Proprietary  ,9,21,30,35,221,256
03822400,MAPLE SPRINGS BAPTIST BIBLE COLLEGE & SE,MD,20743-5711,Private      ,0,0,0,0,45,45
03937300,YESHIVA COLLEGE OF THE NATION'S CAPITAL ,MD,20902-1700,Private      ,2,2,4,2,2,4
03965500,HAIR EXPRESSIONS ACADEMY                ,MD,20852-1729,Proprietary  ,5,7,12,37,85,122
04121600,FILA ACADEMY (THE)                      ,MD,21061-1634,Proprietary  ,2,7,9,59,147,206
04139700,FREDERICK SCHOOL OF COSMETOLOGY         ,MD,21701-0000,Proprietary  ,0,2,2,3,5,8
04141600,OMEGA STUDIOS' SCHOOL OF APPLIED RECORDI,MD,20852-1731,Proprietary  ,2,2,4,2,2,4
        ,MGH INSTITUTE OF HEALTH PROFESSION      ,MA,02129-0000,Private      ,0,0,0,30,858,888
00211400,AMERICAN INTERNATIONAL COLLEGE          ,MA,01109-3189,Private      ,5,32,37,2106,2072,4178
00211500,AMHERST COLLEGE                         ,MA,01002-5000,Private      ,1,0,1,4631,137,4768
00211600,ANDOVER NEWTON THEOLOGICAL SCHOOL       ,MA,02459-0000,Private      ,0,0,0,0,202,202
00211700,ANNA MARIA COLLEGE                      ,MA,01612-1198,Private      ,5,15,20,1266,400,1666
00211800,ASSUMPTION COLLEGE                      ,MA,01615-1294,Private      ,1,2,3,4088,463,4551
00211900,ATLANTIC UNION COLLEGE                  ,MA,01561-1000,Private      ,1,3,4,276,245,521
00212000,MERRIMACK COLLEGE                       ,MA,01845-5800,Private      ,5,2,7,3739,165,3904
00212100,BABSON COLLEGE                          ,MA,02457-0310,Private      ,0,12,12,2353,881,3234
00212200,BAY PATH COLLEGE                        ,MA,01106-2212,Private      ,1,23,24,766,1591,2357
00212300,BECKER COLLEGE-WORCESTER                ,MA,01615-0071,Private      ,8,30,38,2065,935,3000
00212400,BENTLEY UNIVERSITY                      ,MA,02452-4705,Private      ,6,32,38,5978,769,6747
00212600,BERKLEE COLLEGE OF MUSIC                ,MA,02215-3693,Private      ,27,11,38,3630,896,4526
00212800,BOSTON COLLEGE                          ,MA,02467-3800,Private      ,6,17,23,18389,6456,24845
00212900,BOSTON CONSERVATORY OF MUSIC            ,MA,02215-9830,Private      ,0,0,0,964,270,1234
00213000,BOSTON UNIVERSITY                       ,MA,02215-1789,Private      ,21,116,137,29236,15522,44758
00213300,BRANDEIS UNIVERSITY                     ,MA,02453-2700,Private      ,2,5,7,4837,1012,5849
00213900,CLARK UNIVERSITY                        ,MA,01610-1473,Private      ,1,2,3,4201,526,4727
00214000,ELMS COLLEGE                            ,MA,01013-2839,Private      ,1,5,6,1036,469,1505
00214100,COLLEGE OF THE HOLY CROSS               ,MA,01610-2395,Private      ,1,0,1,5534,65,5599
00214300,CURRY COLLEGE                           ,MA,02186-2395,Private      ,6,10,16,3773,908,4681
00214400,DEAN COLLEGE                            ,MA,02038-1994,Private      ,3,3,6,1587,127,1714
00214500,EASTERN NAZARENE COLLEGE                ,MA,02170-2999,Private      ,2,7,9,833,466,1299
00214507,EASTERN NAZARENE CLG - LEAD PROGRAM     ,MA,02170-0000,Private      ,0,2,2,13,77,90
00214600,EMERSON COLLEGE                         ,MA,02116-4624,Private      ,2,5,7,6359,1338,7697
00214700,EMMANUEL COLLEGE                        ,MA,02115-5798,Private      ,4,7,11,4201,388,4589
00214800,ENDICOTT COLLEGE                        ,MA,01915-2098,Private      ,1,4,5,3956,293,4249
00214900,EPISCOPAL DIVINITY SCHOOL               ,MA,02138-0000,Private      ,0,4,4,0,81,81
00215000,FISHER COLLEGE                          ,MA,02116-1500,Private      ,4,26,30,1240,957,2197
00215100,BENJAMIN FRANKLIN INSTITUTE OF TECH     ,MA,02116-6296,Public       ,1,1,2,587,258,845
00215300,GORDON COLLEGE                          ,MA,01984-1899,Private      ,1,0,1,1939,94,2033
00215400,HELLENIC COLLEGE                        ,MA,02445-7496,Private      ,0,2,2,38,89,127
00215500,HARVARD UNIVERSITY                      ,MA,02138-3800,Private      ,10,16,26,6038,962,7000
00215501,AMRCN REPERTORY THTR INST ADV THTR      ,MA,02138-0000,Private      ,0,0,0,2,108,110
00215502,HARVARD BUSINESS SCHOOL                 ,MA,02163-0000,Private      ,1,12,13,222,1711,1933
00215503,HARVARD EXTENSION SCHOOL                ,MA,02138-0000,Private      ,3,23,26,131,1037,1168
00215504,HARVARD SCH OF DENTAL MEDICINE          ,MA,02115-0000,Private      ,0,2,2,11,180,191
00215505,HARVARD UNIV GRAD SCH DESIGN            ,MA,02138-0000,Private      ,0,0,0,7,852,859
00215506,HARVARD DIVINITY SCHOOL                 ,MA,02138-0000,Private      ,0,0,0,13,664,677
00215507,HARVARD UNIV GRAD SCH ED                ,MA,02138-0000,Private      ,0,1,1,16,1153,1169
00215508,HARVARD UNIV GRAD S OF ARTS & SCIEN     ,MA,02138-0000,Private      ,0,5,5,110,856,966
00215509,HARVARD JOHN F KENNEDY SCHL OF GOVT     ,MA,02138-0000,Private      ,0,1,1,23,1208,1231
00215510,HARVARD LAW SCHOOL                      ,MA,02138-0000,Private      ,0,3,3,84,4098,4182
00215511,HARVARD UNIV MEDICAL SCHOOL             ,MA,02115-0000,Private      ,0,1,1,110,1134,1244
00215512,HARVARD UNIV SCH PUBLIC HEALTH          ,MA,02115-0000,Private      ,0,3,3,51,678,729
00215513,HARVARD UNIVERSITY-HARVARD COLLEGE      ,MA,02138-0000,Private      ,5,3,8,13458,351,13809
00215700,HEBREW COLLEGE                          ,MA,02459-2237,Private      ,0,1,1,1,75,76
00215800,LASELL COLLEGE                          ,MA,02466-2716,Private      ,2,4,6,2497,133,2630
00216000,LESLEY UNIVERSITY                       ,MA,02138-2790,Private      ,6,233,239,2310,5377,7687
00216100,UMASS LOWELL                            ,MA,01854-3089,Public       ,20,46,66,8558,3598,12156
00216400,NEW ENGLAND COLLEGE OF OPTOMETRY        ,MA,02115-1129,Private      ,0,1,1,6,426,432
00216500,MASS. COLLEGE OF PHARMACY  & HEALTH SCIE,MA,02115-5804,Private      ,2,8,10,3692,2057,5749
00216700,BERKSHIRE COMMUNITY COLLEGE             ,MA,01201-5786,Public       ,3,17,20,790,924,1714
00216800,CAPE COD COMMUNITY COLLEGE              ,MA,02668-1599,Public       ,7,10,17,1439,1606,3045
00216900,GREENFIELD COMMUNITY COLLEGE            ,MA,01301-9739,Public       ,7,11,18,775,1256,2031
00217000,HOLYOKE COMMUNITY COLLEGE               ,MA,01040-1099,Public       ,26,54,80,3245,3434,6679
00217100,MASSACHUSETTS BAY COMMUNITY COLLEGE     ,MA,02181-0000,Public       ,12,30,42,1783,1902,3685
00217200,MOUNT WACHUSETT COMMUNITY COLLEGE       ,MA,01440-1000,Public       ,17,47,64,1646,2545,4191
00217300,NORTH SHORE COMMUNITY COLLEGE           ,MA,01923-4093,Public       ,14,41,55,2829,3291,6120
00217400,NORTHERN ESSEX COMMUNITY COLLEGE        ,MA,01830-2399,Public       ,34,114,148,2519,3475,5994
00217500,QUINSIGAMOND COMMUNITY COLLEGE          ,MA,01606-2092,Public       ,32,97,129,3173,3374,6547
00217600,BRISTOL COMMUNITY COLLEGE               ,MA,02720-7399,Public       ,25,71,96,3268,3497,6765
00217700,MASSASOIT COMMUNITY COLLEGE             ,MA,02302-3996,Public       ,11,23,34,2747,2794,5541
00217800,MASSACHUSETTS INST OF TECHNOLOGY        ,MA,02139-4307,Private      ,5,18,23,9070,2578,11648
00218000,MASSACHUSETTS COLLEGE OF ART AND DESIGN ,MA,02115-5803,Public       ,5,4,9,2080,674,2754
00218100,MASSACHUSETTS MARITIME ACADEMY          ,MA,02532-3400,Public       ,2,0,2,1100,81,1181
00218300,BRIDGEWATER STATE COLLEGE               ,MA,02325-0001,Public       ,22,22,44,10057,2417,12474
00218400,FITCHBURG STATE COLLEGE                 ,MA,01420-2697,Public       ,5,16,21,4884,1213,6097
00218500,FRAMINGHAM STATE COLLEGE                ,MA,01702-2471,Public       ,5,9,14,4850,950,5800
00218700,MASSACHUSETTS CLG OF LIBERAL ARTS       ,MA,01247-4100,Public       ,2,5,7,1708,450,2158
00218800,SALEM STATE COLLEGE                     ,MA,01970-5353,Public       ,14,43,57,8199,2806,11005
00218900,WESTFIELD STATE COLLEGE                 ,MA,01086-1630,Public       ,10,6,16,6490,970,7460
00219000,WORCESTER STATE COLLEGE                 ,MA,01602-2597,Public       ,7,23,30,4879,1663,6542
00219200,MOUNT HOLYOKE COLLEGE                   ,MA,01075-1492,Private      ,3,2,5,2439,258,2697
00219300,MOUNT IDA COLLEGE                       ,MA,02459-3323,Private      ,3,3,6,2212,292,2504
00219400,NEW ENGLAND CONSERVATORY OF MUSIC       ,MA,02115-5018,Private      ,2,0,2,648,467,1115
00219700,NICHOLS COLLEGE                         ,MA,01571-6346,Private      ,3,6,9,2008,293,2301
00219900,NORTHEASTERN UNIVERSITY                 ,MA,02115-5000,Private      ,31,138,169,30136,8644,38780
00220100,PINE MANOR COLLEGE                      ,MA,02167-0000,Private      ,0,0,0,593,137,730
00220200,BLESSED JOHN XXIII NATIONAL SEMINARY    ,MA,02493-0000,Private      ,0,0,0,0,2,2
00220500,QUINCY COLLEGE                          ,MA,02169-4501,Public       ,13,67,80,1132,2278,3410
00220600,REGIS COLLEGE                           ,MA,02193-0000,Private      ,3,7,10,1638,544,2182
00220800,SIMMONS COLLEGE                         ,MA,02115-5898,Private      ,1,20,21,2991,2989,5980
00220900,SMITH COLLEGE                           ,MA,01063-2936,Private      ,2,1,3,3353,894,4247
00221000,UNIV OF MASSACHUSETTS-DARTMOUTH         ,MA,02747-2300,Public       ,15,14,29,10287,1859,12146
00221100,SPRINGFIELD COLLEGE                     ,MA,01109-3797,Private      ,2,140,142,3663,3978,7641
00221400,ST JOHN'S SEMINARY                      ,MA,02135-8839,Private      ,3,6,9,14,66,80
00221700,STONEHILL COLLEGE                       ,MA,02357-6110,Private      ,0,1,1,5919,104,6023
00221800,SUFFOLK UNIVERSITY                      ,MA,02108-2770,Private      ,10,20,30,8783,2264,11047
00221802,SUFFOLK UNIVERSITY LAW SCHOOL           ,MA,02108-0000,Private      ,0,1,1,140,2940,3080
00221900,TUFTS UNIVERSITY                        ,MA,02155-5808,Private      ,4,6,10,9222,2268,11490
00221901,TUFTS UNIV SCH OF DENTAL MEDICINE       ,MA,02111-0000,Private      ,1,1,2,14,786,800
00221902,TUFTS UNIVERSITY - CUMMINGS SCHOOL OF VE,MA,01536-0000,Private      ,0,1,1,33,407,440
00221904,TUFTS UNIV SCHOOL OF MEDICINE           ,MA,02111-0000,Private      ,0,4,4,40,1565,1605
00222100,UNIV OF MASSACHUSETTS-AMHERST           ,MA,01003-0000,Public       ,25,37,62,30654,5936,36590
00222200,UNIV OF MASSACHUSETTS-BOSTON            ,MA,02125-3393,Public       ,31,84,115,8461,7642,16103
00222400,WELLESLEY COLLEGE                       ,MA,02481-8203,Private      ,2,1,3,3230,162,3392
00222500,WENTWORTH INSTITUTE OF TECHNOLOGY       ,MA,02115-5998,Private      ,14,11,25,4141,524,4665
00222600,WESTERN NEW ENGLAND COLLEGE             ,MA,01119-2654,Private      ,3,8,11,4879,1566,6445
00222700,WHEATON COLLEGE                         ,MA,02766-2322,Private      ,4,0,4,2681,34,2715
00222800,WHEELOCK COLLEGE                        ,MA,02215-4176,Private      ,3,2,5,1324,548,1872
00222900,WILLIAMS COLLEGE                        ,MA,01267-2600,Private      ,0,0,0,3987,84,4071
00223300,WORCESTER POLYTECHNIC INSTITUTE         ,MA,01609-2280,Private      ,1,4,5,5149,353,5502
00396500,BAY STATE COLLEGE                       ,MA,02116-2901,Proprietary  ,13,19,32,1227,476,1703
00396600,BOSTON ARCHITECTURAL COLLEGE            ,MA,02115-2795,Private      ,2,2,4,507,1021,1528
00466100,HAMPSHIRE COLLEGE                       ,MA,01002-3359,Private      ,0,1,1,2417,94,2511
00466600,SALTER COLLEGE                          ,MA,01583-1700,Proprietary  ,68,292,360,820,3158,3978
00466700,SCHOOL OF MUSEUM OF FINE ARTS           ,MA,02115-5534,Private      ,2,0,2,907,274,1181
00466900,UPPER CAPE COD REGIONAL VOC TECH        ,MA,02532-3310,Public       ,0,0,0,10,80,90
00527900,GREATER LOWELL REGNL VOC TECH SCH       ,MA,01879-0000,Public       ,0,0,0,19,75,94
00551900,DIMAN REGIONAL VOC TECH INST            ,MA,02723-3519,Public       ,0,0,0,17,71,88
00552300,BLUE HILLS REGIONAL VOC TECH            ,MA,02021-1398,Public       ,0,1,1,30,115,145
00555700,MCCANN TECHNICAL SCHOOL                 ,MA,01247-0000,Public       ,1,0,1,23,58,81
00613600,NATIONAL AVIATION ACADEMY - NEW ENGLAND ,MA,01730-2620,Proprietary  ,8,13,21,116,132,248
00632200,BROCKTON HOSPITAL SCH OF NURSING        ,MA,02302-0000,Private      ,0,1,1,129,358,487
00632400,LABOURE COLLEGE                         ,MA,02124-5698,Private      ,3,11,14,170,671,841
00633100,LAWRENCE MEM HOSPITAL SCH OF NRSNG      ,MA,02155-1643,Private      ,1,1,2,64,362,426
00687300,MARIAN COURT COLLEGE                    ,MA,01907-2896,Private      ,2,2,4,216,102,318
00748100,GIBBS COLLEGE                           ,MA,02116-2904,Proprietary  ,8,20,28,136,249,385
00748400,NEWBURY COLLEGE                         ,MA,02445-5796,Private      ,4,2,6,1566,228,1794
00748600,THE NEW ENGLAND INSTITUTE OF ART        ,MA,02445-7295,Proprietary  ,18,7,25,2026,662,2688
00748800,KAPLAN CAREER INSTITUTE                 ,MA,02129-1644,Proprietary  ,27,109,136,249,746,995
00807800,SPRINGFIELD TECHNICAL COMMUNITY CLG     ,MA,01105-0000,Public       ,15,30,45,2416,4062,6478
00809002,EVEREST COLLEGE - EVEREST INSTITUTE     ,MA,02150-2333,Proprietary  ,12,66,78,201,566,767
00891600,NEW ENGLAND SCHOOL OF LAW               ,MA,02116-0000,Private      ,0,0,0,12,2263,2275
00964500,BARD COLLEGE AT SIMON'S ROCK            ,MA,01230-9702,Private      ,2,0,2,444,10,454
00974700,GORDON-CONWELL THEOLOGICAL SEMINARY     ,MA,01982-0000,Private      ,0,2,2,5,627,632
00975600,UNIVERSITY OF MASS MEDICAL CENTER       ,MA,01655-0000,Public       ,0,7,7,24,717,741
00987700,HENRI'S SCHOOL OF HAIR DESIGN           ,MA,01420-5675,Proprietary  ,0,1,1,32,39,71
00989900,LOWELL ACADEMY HAIRSTYLING INST         ,MA,01852-1909,Proprietary  ,0,3,3,57,56,113
00993600,MIDDLESEX COMMUNITY COLLEGE             ,MA,01730-1197,Public       ,16,44,60,1260,1034,2294
00993602,"MIDDLESEX COMMUNITY COLLEGE, LOWELL     ",MA,01852-0000,Public       ,21,46,67,2164,1771,3935
01121000,BUNKER HILL COMMUNITY COLLEGE           ,MA,02129-2991,Public       ,14,56,70,3592,5365,8957
01151000,EVEREST INSTITUTE                       ,MA,02135-7638,Proprietary  ,12,62,74,272,708,980
01193000,ROXBURY COMMUNITY COLLEGE               ,MA,02120-3400,Public       ,9,25,34,916,2388,3304
01204200,MANSFIELD BEAUTY SCHOOLS                ,MA,02169-5061,Proprietary  ,1,8,9,44,115,159
01206800,MANSFIELD BEAUTY SCHOOL                 ,MA,01103-1410,Proprietary  ,3,3,6,11,71,82
01238600,SOUTHEASTERN TECHNICAL INSTITUTE        ,MA,02375-1780,Public       ,0,1,1,46,158,204
01288100,MONTACHUSETT REG VOC TECH SCH           ,MA,01420-4649,Public       ,0,1,1,7,51,58
01292100,"BLAINE, THE BEAUTY CAREER SCHOOLS       ",MA,02215-0000,Proprietary  ,21,42,63,244,369,613
01292101,"BLAINE, THE BEAUTY CAREER SCHOOLS - HYAN",MA,02601-2022,Proprietary  ,3,0,3,14,12,26
01294800,ROB ROY ACADEMY                         ,MA,02721-5330,Proprietary  ,2,14,16,66,118,184
02063000,MONTSERRAT COLLEGE OF ART               ,MA,01915-0000,Private      ,0,0,0,496,51,547
02063800,BUTERA SCHOOL OF ART                    ,MA,02116-0000,Proprietary  ,0,0,0,53,13,66
02076700,"BLAINE, THE BEAUTY CAREER SCHOOL        ",MA,02148-0000,Proprietary  ,8,16,24,106,221,327
02079400,BLAINE THE BEAUTY CAREER SCHOOL         ,MA,02453-0000,Proprietary  ,4,9,13,84,199,283
02092100,MASSACHUSETTS SCHOOL OF BARBERING       ,MA,02169-0000,Proprietary  ,0,9,9,25,105,130
02092200,BLAINE THE BEAUTY CAREER SCHOOLS        ,MA,01852-0000,Proprietary  ,9,21,30,87,193,280
02122000,NEW ENGLAND HAIR ACADEMY                ,MA,02148-0000,Proprietary  ,1,4,5,51,97,148
02137000,ROB ROY ACADEMY                         ,MA,02780-0000,Proprietary  ,1,3,4,31,45,76
02137200,MASS GEN HOSP DIETETIC INTERNSHIP       ,MA,02114-0000,Private      ,0,0,0,2,14,16
02143000,LONGY SCHOOL OF MUSIC                   ,MA,02138-3599,Private      ,0,0,0,37,128,165
02161300,WESTON JESUIT SCHOOL OF THEOLOGY        ,MA,02138-0000,Private      ,0,0,0,0,19,19
02163500,NEW ENGLAND SCHOOL OF PHOTOGRAPHY       ,MA,02215-0000,Proprietary  ,0,0,0,131,107,238
02163600,MASS SCH OF PROFESSIONAL PSYCHOLOGY     ,MA,02132-0000,Private      ,0,2,2,6,519,525
02169900,ASSABET VALLEY REGIONAL VOC SCHOOL      ,MA,01752-0000,Public       ,0,0,0,13,51,64
02181600,ROB ROY ACADEMY                         ,MA,01609-0000,Proprietary  ,5,18,23,94,180,274
02182900,CAMBRIDGE COLLEGE                       ,MA,02138-5304,Private      ,12,267,279,291,5347,5638
02197900,NORTH BENNET STREET SCHOOL              ,MA,02113-0000,Private      ,0,0,0,24,95,119
02215100,HALLMARK INSTITUTE OF PHOTOGRAPHY       ,MA,01376-0000,Proprietary  ,1,0,1,182,150,332
02219501,MILDRED ELLEY                           ,MA,01201-0000,Proprietary  ,0,0,0,3,18,21
02220400,CATHERINE HINDS INST OF ESTHETICS       ,MA,01801-0000,Proprietary  ,0,9,9,41,150,191
02231600,MGH INSTITUTE OF HEALTH PROFESSION      ,MA,02129-0000,Private      ,5,12,17,11,55,66
02237100,JOSEPH P KEEFE TECHNICAL SCHOOL         ,MA,01701-5698,Public       ,0,0,0,2,0,2
02274300,CONWAY SCHOOL OF LANDSCAPE DESIGN       ,MA,01341-0179,Private      ,0,0,0,0,22,22
02325700,LABARON HAIRDRESSING ACADEMY            ,MA,02740-0000,Proprietary  ,0,8,8,17,57,74
02325800,LABARON HAIRDRESSING ACAD-BROCKTON      ,MA,02301-0000,Proprietary  ,1,4,5,21,50,71
02337400,BANCROFT SCHOOL OF MASSAGE THERAPY      ,MA,01604-4614,Proprietary  ,1,2,3,17,46,63
02338200,BAY STATE SCHOOL OF TECHNOLOGY          ,MA,02021-0000,Proprietary  ,1,42,43,70,291,361
02339400,ROB ROY ACADEMY                         ,MA,02746-0000,Proprietary  ,2,1,3,19,19,38
02491700,CORTIVA INSTITUTE -  BOSTON             ,MA,02472-2577,Proprietary  ,0,15,15,39,293,332
02523900,ELIZABETH GRADY SCHOOL OF ESTHETICS     ,MA,02155-0000,Proprietary  ,0,4,4,45,101,146
02579800,NEW ENGLAND SCHOOL OF ACUPUNCTURE       ,MA,02458-0000,Private      ,1,4,5,1,158,159
03006802,PENNSYLVANIA CULINARY INSTITUTE - LE COR,MA,02142-1221,Proprietary  ,12,45,57,141,395,536
03066700,AILANO SCHOOL OF COSMETOLOGY            ,MA,02303-4740,Proprietary  ,0,2,2,27,52,79
03104000,SHAWSHEEN ADULT TECHNICAL INSTITUTE     ,MA,01821-5499,Public       ,0,0,0,10,35,45
03120800,KAY HARVEY HAIRDRESSING ACADEMY         ,MA,01089-2701,Proprietary  ,1,6,7,25,81,106
03127700,SOUTHERN NEW ENGLAND SCHOOL OF LAW      ,MA,02747-1252,Private      ,0,1,1,3,279,282
03130500,URBAN COLLEGE OF BOSTON                 ,MA,02111-1093,Private      ,0,4,4,36,626,662
03194300,BOSTON GRAD SCH OF PSYCHOANALYSIS       ,MA,02446-4602,Private      ,0,0,0,2,73,75
03196300,LINCOLN TECHNICAL INSTITUTE             ,MA,02145-1102,Proprietary  ,48,82,130,410,824,1234
03196302,LINCOLN TECHNICAL INSTITUTE             ,MA,01852-5119,Proprietary  ,27,60,87,310,575,885
03205400,JOLIE HAIR & BEAUTY ACADEMY             ,MA,01056-2769,Proprietary  ,4,14,18,30,90,120
03232302,LINCOLN TECHNICAL INSTITUTE             ,MA,02401-1818,Proprietary  ,37,94,131,270,592,862
03235300,MASSACHUSETTS SCHOOL OF LAW             ,MA,01810-1094,Private      ,0,3,3,2,642,644
03240300,HAIR IN MOTION BEAUTY ACADEMY           ,MA,01604-2213,Proprietary  ,0,1,1,12,24,36
03248300,BOSTON BAPTIST COLLEGE                  ,MA,02136-4000,Private      ,0,0,0,82,39,121
03316400,FUNERAL INSTITUTE OF THE NORTHEAST      ,MA,02062-4766,Proprietary  ,1,0,1,19,96,115
03504300,NATL GRAD SCH OF QUALITY SYSTM MGMT     ,MA,02540-0000,Private      ,0,9,9,0,43,43
03763300,MEDICAL PROFESSIONAL INSTITUTE          ,MA,02148-8143,Proprietary  ,1,11,12,24,153,177
03859300,E.I.N.E.                                ,MA,01876-4709,Proprietary  ,0,0,0,5,33,38
03946300,FRANKLIN W. OLIN COLLEGE OF ENGINEERING ,MA,02492-1200,Private      ,1,0,1,408,8,416
03965300,NEW ENGLAND COLLEGE OF FINANCE          ,MA,02110-1605,Proprietary  ,3,14,17,3,18,21
04039300,SULLIVAN AND COGLIANO TRAINING CENTER   ,MA,02301-1822,Proprietary  ,9,249,258,83,1262,1345
04116900,DIGRIGOLI SCHOOL OF COSMETOLOGY         ,MA,01089-4623,Proprietary  ,1,1,2,27,41,68
04128000,MILLENNIUM TRAINING INSTITUTE           ,MA,01801-6386,Proprietary  ,2,16,18,5,48,53
04128900,CENTRAL MASS SCHOOL OF MASSAGE AND THERA,MA,01562-1712,Proprietary  ,0,1,1,15,25,40
00324204,CARNEGIE MELLON UNIVERSITY - QATAR      ,FC,00000-0000,Private      ,0,1,1,3,3,6
00324206,CARNEGIE MELLON UNIVERSITY  - THE HEINZ ,FC,00000-0000,Private      ,0,0,0,0,3,3
00337112,TEMPLE UNIVERSITY - JAPAN               ,FC,00000-0000,Private      ,0,1,1,0,1,1
00369102,MIDDLEBURY COLLEGE - GERMANY            ,FC,00000-0000,Private      ,0,0,0,0,1,1
00369103,MIDDLEBURY COLLEGE - ITALY              ,FC,00000-0000,Private      ,0,0,0,0,1,1
00369104,MIDDLEBURY COLLEGE - SPAIN              ,FC,00000-0000,Private      ,0,0,0,0,4,4
00369105,MIDDLEBURY COLLEGE - RUSSIA             ,FC,00000-0000,Private      ,0,0,0,0,3,3
00401000,INSTITUT INTERNAT'L D'ETUDES FRANCA     ,FC,00000-0000,Public       ,0,0,0,1,3,4
00401200,HEBREW UNIVERSITY OF JERUSALEM (THE)    ,FC,00000-0000,Public       ,0,1,1,62,114,176
00403000,UNIVERSITY OF CAMBRIDGE                 ,FC,00000-0000,Public       ,0,0,0,2,60,62
00503400,AMERICAN UNIVERSITY OF CAIRO            ,FC,00000-0000,Private      ,0,1,1,82,217,299
00667100,KATHOLIEKE UNIVERSITEIT LEUVEN          ,FC,00000-0000,Private      ,0,0,0,1,37,38
00669000,UNIVERSITY OF COPENHAGEN                ,FC,00000-0000,Public       ,0,0,0,1,3,4
00669100,UNIVERSITY OF CAMBRIDGE - PEMBROKE      ,FC,00000-0000,Public       ,0,0,0,1,11,12
00669200,UNIVERSITY OF LEEDS                     ,FC,00000-0000,Public       ,0,1,1,14,85,99
00669300,UNIV OF LONDON-LONDON SCHOOL ECON       ,FC,00000-0000,Public       ,0,3,3,20,482,502
00669400,SCH OF ORIENTAL & AFRICAN STUDIES       ,FC,00000-0000,Public       ,0,1,1,7,147,154
00669500,UNIV OF LONDON-UNIVERSITY COLLEGE       ,FC,00000-0000,Public       ,0,0,0,16,274,290
00669600,UNIV OF LONDON-SCH ADVANCED STUDY       ,FC,00000-0000,Public       ,0,0,0,1,17,18
00669700,"QUEEN MARY, UNIVERSITY OF LONDON        ",FC,00000-0000,Public       ,0,0,0,19,103,122
00669900,UNIVERSITY OF SUSSEX                    ,FC,00000-0000,Public       ,0,0,0,14,70,84
00670000,"UNIVERSITY OF YORK, THE                 ",FC,00000-0000,Public       ,0,1,1,11,88,99
00670400,UNIVERSITY COLLEGE CORK                 ,FC,00000-0000,Public       ,0,0,0,9,56,65
00671300,UPPSALA UNIVERSITY                      ,FC,00000-0000,Public       ,0,0,0,0,21,21
00671500,UNIVERSITY OF GENEVA                    ,FC,00000-0000,Public       ,0,1,1,5,59,64
00683900,UNIVERSITY OF EDINBURGH                 ,FC,00000-0000,Public       ,0,1,1,114,497,611
00684200,UNIVERSITY OF DUBLIN TRINITY COLLEG     ,FC,00000-0000,Public       ,1,1,2,45,139,184
00685000,UNIVERSITY OF CAMBRIDGE - DOWNING C     ,FC,00000-0000,Public       ,0,0,0,0,5,5
00685100,INTERNATIONAL CHRISTIAN UNIVERSITY      ,FC,00000-0000,Private      ,0,0,0,10,7,17
00763200,UNIVERSITY OF BRISTOL                   ,FC,00000-0000,Public       ,1,1,2,10,73,83
00768100,COLLEGE OF EUROPE                       ,FC,00000-0000,Private      ,0,0,0,1,6,7
00770500,ROYAL COLLEGE OF SURGEONS IN IRELAN     ,FC,00000-0000,Private      ,0,0,0,7,62,69
00788100,AMERICAN UNIVERSITY OF PARIS            ,FC,00000-0000,Private      ,0,2,2,280,209,489
00837100,AMERICAN UNIVERSITY OF BEIRUT           ,FC,00000-0000,Private      ,0,1,1,71,78,149
00837300,TEL-AVIV UNIVERSITY                     ,FC,00000-0000,Public       ,0,0,0,16,63,79
00837600,VRIJE UNIVERSITEIT AMSTERDAM            ,FC,00000-0000,Public       ,0,0,0,0,5,5
00837700,UNIVERSITEIT VAN AMSTERDAM(UNIVERSI     ,FC,00000-0000,Public       ,0,0,0,9,113,122
00838000,UNIVERSITY OF WARWICK                   ,FC,00000-0000,Public       ,0,0,0,9,60,69
00838300,UNIVERSITY OF GLASGOW                   ,FC,00000-0000,Public       ,0,1,1,35,331,366
00838600,UNIVERSITY OF HELSINKI                  ,FC,00000-0000,Public       ,0,0,0,2,5,7
00839300,UNIVERSITY OF OSLO                      ,FC,00000-0000,Public       ,0,0,0,3,15,18
00839400,UNIVERSITY OF OXFORD                    ,FC,00000-0000,Public       ,0,1,1,14,165,179
00839800,UNIVERSITY OF SHEFFIELD (THE)           ,FC,00000-0000,Public       ,0,1,1,11,69,80
00839900,UNIVERSITY OF SOUTHAMPTON               ,FC,00000-0000,Public       ,0,0,0,5,39,44
00845000,KASTURBA MEDICAL COLLEGE (A CONSTITENT I,FC,00000-0000,Private      ,0,0,0,25,66,91
00845200,ABERYSTWYTH UNIVERSITY                  ,FC,00000-0000,Public       ,0,0,0,7,22,29
00846000,UNIVERSITY OF NEWCASTLE UPON TYNE       ,FC,00000-0000,Public       ,0,0,0,7,57,64
00846100,UNIVERSITY OF SAINT ANDREWS             ,FC,00000-0000,Public       ,0,1,1,139,135,274
00846200,UNIVERSIDAD DE SALAMANCA                ,FC,00000-0000,Public       ,0,0,0,3,38,41
00850500,UNIVERSITY OF MELBOURNE                 ,FC,00000-0000,Public       ,0,1,1,12,140,152
00858600,SWANSEA UNIVERSITY                      ,FC,00000-0000,Public       ,0,0,0,10,35,45
00858700,UNIVERSITY OF DURHAM                    ,FC,00000-0000,Public       ,0,1,1,9,109,118
00866500,UNIVERSITY OF KENT AT CANTERBURY (THE)  ,FC,00000-0000,Public       ,1,0,1,16,144,160
00866600,UNIVERSITY OF HONG KONG                 ,FC,00000-0000,Public       ,0,0,0,13,40,53
00867000,UNIVERSITY OF NEW SOUTH WALES           ,FC,00000-0000,Public       ,0,0,0,10,114,124
00868700,UNIVERSITY OF ESSEX                     ,FC,00000-0000,Public       ,0,0,0,7,58,65
00869200,LEIDEN UNIVERSITY                       ,FC,00000-0000,Public       ,0,0,0,0,8,8
00869300,CITY UNIVERSITY                         ,FC,00000-0000,Public       ,0,1,1,6,117,123
00890800,THE UNIVERSITY OF BIRMINGHAM            ,FC,00000-0000,Public       ,0,0,0,6,103,109
00891000,UNIVERSITY OF HULL                      ,FC,00000-0000,Public       ,0,0,0,7,16,23
00892000,UNIVERSITY OF NOTTINGHAM                ,FC,00000-0000,Public       ,0,0,0,17,95,112
00900600,UNIVERSITY OF SALFORD (THE)             ,FC,00000-0000,Public       ,0,0,0,0,11,11
00908400,"UNIV OF LONDON, BIRKBECK                ",FC,00000-0000,Public       ,0,0,0,2,77,79
00908500,UNIV OF LONDON KING'S COLLEGE           ,FC,00000-0000,Public       ,0,0,0,21,227,248
00908600,UNIVERSITY OF LONDON - ROYAL HOLLOWAY   ,FC,00000-0000,Public       ,1,1,2,10,57,67
00914300,BAR-ILAN UNIVERSITY                     ,FC,00000-0000,Private      ,0,0,0,9,12,21
00924700,ARCHITECTURAL ASSOC SCH OF ARCHITEC     ,FC,00000-0000,Private      ,0,1,1,4,26,30
00924900,UNIVERSITY OF LIVERPOOL                 ,FC,00000-0000,Public       ,0,2,2,14,76,90
00936800,UNIVERSITY OF ABERDEEN                  ,FC,00000-0000,Public       ,0,0,0,43,130,173
00942300,ROYAL COLLEGE OF ART                    ,FC,00000-0000,Public       ,0,1,1,4,32,36
00942400,ROYAL ACADEMY OF DRAMATIC ART           ,FC,00000-0000,Private      ,0,0,0,9,3,12
00942800,TECHNION-ISRAEL INST OF TECHLGY         ,FC,00000-0000,Public       ,0,0,0,0,73,73
00944200,UNIVERSITY OF EXETER                    ,FC,00000-0000,Public       ,0,0,0,6,89,95
00944400,UNIVERSITY OF LANCASTER                 ,FC,00000-0000,Public       ,0,1,1,2,38,40
00963400,UNIVERSITY OF OXFORD ST CATHERINE'S     ,FC,00000-0000,Public       ,0,0,0,2,13,15
00980800,UNIVERSITY OF STRATHCLYDE               ,FC,00000-0000,Public       ,0,0,0,3,32,35
00981700,UNIVERSITY OF SANTO TOMAS               ,FC,00000-0000,Private      ,0,0,0,2,3,5
00986000,UNIVERSITY OF SURREY                    ,FC,00000-0000,Public       ,0,0,0,5,17,22
00990600,PONTIFICAL NORTH AMERICAN COLLEGE       ,FC,00000-0000,Private      ,0,0,0,1,9,10
00992700,UNIVERSITY OF CAMBRIDGE - FITZWILLI     ,FC,00000-0000,Public       ,0,1,1,1,10,11
01006700,LUND UNIVERSITY                         ,FC,00000-0000,Public       ,0,1,1,5,67,72
01008400,UNIVERSITY OF CAPE TOWN                 ,FC,00000-0000,Private      ,0,2,2,8,59,67
01008700,UNIVERSITY OF OXFORD ST PETER'S COL     ,FC,00000-0000,Public       ,0,0,0,1,6,7
01008800,UNIVERSITY OF OXFORD - CORPUS CHRIS     ,FC,00000-0000,Public       ,0,0,0,0,9,9
01008900,CENTRAL SCHOOL OF SPEECH AND DRAMA      ,FC,00000-0000,Private      ,0,0,0,9,45,54
01009000,UNIVERSITY OF OXFORD - BALLIOL COLL     ,FC,00000-0000,Public       ,0,0,0,1,20,21
01014300,UNIVERSITY OF READING                   ,FC,00000-0000,Public       ,0,0,0,8,38,46
01015700,CARDIFF UNIVERSITY                      ,FC,00000-0000,Public       ,0,0,0,7,58,65
01015900,PONTIFICIA UNIVERSITA GREGORIANA        ,FC,00000-0000,Private      ,0,0,0,0,9,9
01018800,UNIVERSITY COLLEGE DUBLIN               ,FC,00000-0000,Public       ,0,1,1,18,153,171
01019000,UNIVERSITY OF CAMBRIDGE CHURCHILL C     ,FC,00000-0000,Public       ,0,0,0,2,9,11
01022800,UNIVERSITY OF STIRLING                  ,FC,00000-0000,Public       ,0,0,0,14,27,41
01033200,UNIVERSITY OF CAMBRIDGE - CLARE COL     ,FC,00000-0000,Public       ,0,0,0,1,12,13
01045600,UNIVERSITY OF HAIFA                     ,FC,00000-0000,Public       ,0,0,0,12,12,24
01047200,INST EUROPEEN OPEEN D'ADMINISTRATIO     ,FC,00000-0000,Private      ,0,0,0,0,102,102
01049300,CRANFIELD UNIVERSITY                    ,FC,00000-0000,Public       ,0,0,0,1,12,13
01052000,TRINITY LABAN                           ,FC,00000-0000,Public       ,0,0,0,2,6,8
01052001,LABAN CENTER FOR MOVEMENT & DANCE       ,FC,00000-0000,Public       ,0,0,0,0,6,6
01052500,UNIVERSITY OF HERTFORDSHIRE             ,FC,00000-0000,Public       ,0,0,0,5,9,14
01057400,LONDON INTRNTL FILM SCHOOL              ,FC,00000-0000,Private      ,0,2,2,6,40,46
01058400,VRIJE UNIVERSITEIT BRUSSELS             ,FC,00000-0000,Private      ,0,0,0,1,1,2
01058600,INSTITUTE OF SOCIAL STUDIES             ,FC,00000-0000,Private      ,0,0,0,0,14,14
01058800,AUSTRALIAN NATIONAL UNIVERSITY          ,FC,00000-0000,Public       ,0,0,0,8,55,63
01058900,BANGOR UNIVERSITY                       ,FC,00000-0000,Public       ,0,0,0,12,33,45
01059400,"RICHMOND, THE AMERICAN INT UNI IN LONDON",FC,00000-0000,Private      ,0,0,0,336,34,370
01059900,INST D'ETUDES POLITIQUES DE PARIS       ,FC,00000-0000,Public       ,0,0,0,7,37,44
01068100,MACQUARIE UNIVERSITY                    ,FC,00000-0000,Public       ,0,1,1,22,92,114
01069200,UNIVERSITY OF QUEENSLAND (THE)          ,FC,00000-0000,Public       ,0,0,0,20,125,145
01070400,SILLIMAN UNIVERSITY                     ,FC,00000-0000,Private      ,0,0,0,2,5,7
01078900,UNIVERSITY OF OXFORD - WORCESTER CO     ,FC,00000-0000,Public       ,0,0,0,0,5,5
01079200,CITY AND GUILDS OF LONDON INSTITUTE     ,FC,00000-0000,Private      ,0,0,0,0,1,1
01079700,"NATIONAL UNIVERSITY OF IRELAND, MAY     ",FC,00000-0000,Public       ,0,0,0,2,4,6
01080300,SEMMELWEIS UNIVERSITY OF BUDAPEST       ,FC,00000-0000,Public       ,0,1,1,3,41,44
01081600,KINGSTON UNIVERSITY                     ,FC,00000-0000,Public       ,0,0,0,27,38,65
01083800,UNIVERSITITY OF BERGEN (UOB)            ,FC,00000-0000,Public       ,0,0,0,0,3,3
01086400,UNIV OF DUNDEE                          ,FC,00000-0000,Public       ,0,0,0,3,35,38
01086600,UNIVERSITY OF OXFORD - MAGDALEN COLLEGE ,FC,00000-0000,Public       ,0,0,0,1,11,12
01086700,UNIVERSITY OF OXFORD ST JOHN'S COLL     ,FC,00000-0000,Public       ,0,0,0,3,4,7
01091400,MONASH UNIVERSITY                       ,FC,00000-0000,Public       ,0,0,0,7,36,43
01091500,UNIV OF EAST ANGLIA                     ,FC,00000-0000,Public       ,0,0,0,12,57,69
01094200,UNIVERSITY OF OXFORD - ST HUGH'S CO     ,FC,00000-0000,Public       ,0,0,0,0,6,6
01097700,UNIVERSIDAD CENTRAL DEL ESTE            ,FC,00000-0000,Private      ,0,10,10,86,791,877
01098000,SOMERVILLE COLLEGE                      ,FC,00000-0000,Public       ,0,0,0,0,3,3
01099900,UNIV OF OXFORD - WADHAM COLLEGE         ,FC,00000-0000,Public       ,0,0,0,1,1,2
01104400,PONTIFICIA UNIVERSITA SAN TOMMASO       ,FC,00000-0000,Private      ,0,0,0,0,15,15
01105300,UNIVERSITY OF OXFORD - ST HILDA'S C     ,FC,00000-0000,Public       ,0,0,0,2,10,12
01105400,UNIVERSITY OF OXFORD - ST ANNE'S CO     ,FC,00000-0000,Public       ,0,0,0,2,11,13
01105500,UNIV OF OXFORD - LADY MARGARET HALL     ,FC,00000-0000,Public       ,0,0,0,1,11,12
01105600,UNIVERSITY OF OXFORD - UNIVERSITY C     ,FC,00000-0000,Public       ,0,0,0,2,14,16
01105700,UNIVERSITY OF OXFORD - TRINITY COLL     ,FC,00000-0000,Public       ,2,0,2,3,12,15
01105800,UNIVERSITY OF OXFORD-ST EDMUND HALL     ,FC,00000-0000,Public       ,0,0,0,1,16,17
01105900,UNIVERSITY OF OXFORD ST ANTONY'S CO     ,FC,00000-0000,Public       ,0,1,1,0,36,36
01106000,UNIVERSITY OF OXFORD - QUEEN'S COLL     ,FC,00000-0000,Public       ,0,0,0,0,2,2
01106100,UNIVERSITY OF OXFORD - PEMBROKE COL     ,FC,00000-0000,Public       ,0,0,0,0,5,5
01106200,UNIVERSITY OF OXFORD - ORIEL COLLEG     ,FC,00000-0000,Public       ,0,0,0,1,5,6
01106300,UNIVERSITY OF OXFORD - NUFFIELD COL     ,FC,00000-0000,Public       ,0,0,0,0,9,9
01106400,UNIVERSITY OF OXFORD - NEW COLLEGE      ,FC,00000-0000,Public       ,0,0,0,1,11,12
01106500,UNIVERSITY OF OXFORD MERTON COLLEGE     ,FC,00000-0000,Public       ,0,0,0,1,8,9
01106600,UNIVERSITY OF OXFORD - LINCOLN COLL     ,FC,00000-0000,Public       ,0,1,1,2,11,13
01106700,UNIVERSITY OF OXFORD - KEBLE COLLEG     ,FC,00000-0000,Public       ,0,0,0,1,7,8
01106800,UNIVERSITY OF OXFORD - JESUS COLLEG     ,FC,00000-0000,Public       ,0,0,0,1,8,9
01106900,UNIVERSITY OF OXFORD - HERTFORD COL     ,FC,00000-0000,Public       ,0,0,0,0,9,9
01107000,UNIVERSITY OF OXFORD EXETER COLLEGE     ,FC,00000-0000,Public       ,0,0,0,1,22,23
01107100,UNIV OF OXFORD - CHRIST CHURCH          ,FC,00000-0000,Public       ,0,0,0,1,22,23
01107200,UNIVERSITY OF OXFORD - BRASENOSE CO     ,FC,00000-0000,Public       ,0,0,0,1,7,8
01109100,FLINDERS UNIVERSITY OF S AUSTRALIA      ,FC,00000-0000,Public       ,0,1,1,5,23,28
01109400,UNIVERSITY OF WESTERN AUSTRALIA (THE)   ,FC,00000-0000,Public       ,0,0,0,2,18,20
01156700,"IMPERIAL COLLEGE OF SCIENCE, TECHNOLOGY ",FC,00000-0000,Public       ,0,1,1,5,50,55
01167900,UNIVERSITY OF BATH                      ,FC,00000-0000,Public       ,0,1,1,2,23,25
01168300,FRANKLIN COLLEGE  SWITZERLAND           ,FC,00000-0000,Private      ,1,0,1,378,12,390
01175800,UNIV OF CAMBRIDGE - PETERHOUSE          ,FC,00000-0000,Public       ,0,0,0,0,8,8
01176400,ROYAL ACADEMY OF MUSIC                  ,FC,00000-0000,Public       ,0,0,0,11,13,24
01176500,GOLDSMITHS' COLLEGE-UNIV OF LONDON      ,FC,00000-0000,Public       ,0,0,0,22,126,148
01176600,UNIV OF LONDON - INST OF EDUC           ,FC,00000-0000,Public       ,0,0,0,0,19,19
01177900,STOCKHOLM SCHOOL OF ECONOMICS           ,FC,00000-0000,Private      ,0,0,0,0,5,5
01178000,BRUNEL UNIVERSITY                       ,FC,00000-0000,Public       ,0,0,0,0,4,4
01178400,UNIVERSITY OF WARSAW                    ,FC,00000-0000,Public       ,0,0,0,4,9,13
01207500,UNIVERSITY CAMBRIDGE - TRINITY COLL     ,FC,00000-0000,Public       ,0,0,0,0,16,16
01207800,VICTORIA UNIV OF WELLINGTON             ,FC,00000-0000,Public       ,0,0,0,20,49,69
01210100,UNIVERSITY OF CAMBRIDGE - GIRTON CO     ,FC,00000-0000,Public       ,0,0,0,1,2,3
01213600,VICTORIA UNIV OF MANCHESTER (THE)       ,FC,00000-0000,Public       ,0,0,0,13,65,78
01219800,UNIVERSITY OF BRADFORD                  ,FC,00000-0000,Public       ,0,0,0,2,26,28
01220100,UNIVERSITY OF OXFORD - REGENT'S PAR     ,FC,00000-0000,Public       ,0,0,0,2,6,8
01220600,JAMES COOK UNIVERSITY                   ,FC,00000-0000,Public       ,0,0,0,23,72,95
01221300,PONTIFICIA BOLIVARIANA UNIVERSITY       ,FC,00000-0000,Private      ,0,0,0,4,3,7
01221500,BIRMINGHAM CITY UNIVERSITY              ,FC,00000-0000,Public       ,0,0,0,4,11,15
01222300,JAGIELLONIAN UNIVERSITY COLLEGIUM M     ,FC,00000-0000,Public       ,0,1,1,2,64,66
01222500,UNIVERSITY OF SZEGED FACULTY OF MEDICINE,FC,00000-0000,Public       ,0,0,0,1,8,9
01223400,KOREA UNIVERSITY                        ,FC,00000-0000,Private      ,0,0,0,2,5,7
01225800,ASTON UNIVERSITY                        ,FC,00000-0000,Public       ,0,0,0,2,11,13
01227500,UNIVERSITY OF OXFORD - WOLFSON COLL     ,FC,00000-0000,Public       ,0,0,0,0,14,14
01230200,GONVILLE & CAIUS COLLEGE                ,FC,00000-0000,Public       ,0,0,0,1,4,5
01233300,UNIV OF THE ARTS LONDON- CAMBERWELL COLL,FC,00000-0000,Public       ,0,0,0,12,21,33
01233500,ROYAL COLLEGE OF MUSIC                  ,FC,00000-0000,Public       ,0,0,0,3,11,14
01233700,WROCLAW UNIVERSITY OF MEDICINE          ,FC,00000-0000,Public       ,0,0,0,3,8,11
01234100,UNIVERSITY OF WALES - ST DAVID'S UN     ,FC,00000-0000,Public       ,0,0,0,3,38,41
01236000,EDINBURGH COLLEGE OF ART                ,FC,00000-0000,Public       ,0,0,0,1,10,11
01242100,UNIV OF AUCKLAND                        ,FC,00000-0000,Public       ,1,0,1,28,75,103
01253900,UNIVERSITY OF THE ARTS LONDON IDO - CENT,FC,00000-0000,Public       ,0,0,0,57,59,116
01254000,UNIVERSIDAD DE NAVARRA                  ,FC,00000-0000,Private      ,0,1,1,11,26,37
01276500,UNIVERSITY OF OXFORD - LINACRE COLL     ,FC,00000-0000,Public       ,0,0,0,0,11,11
01276600,"NATIONAL UNIVERSITY IRELAND, GALWAY     ",FC,00000-0000,Public       ,0,1,1,14,75,89
01280200,PONTIFICIA UNIV CATOLICA MAD Y MAES     ,FC,00000-0000,Private      ,10,1,11,92,134,226
01281100,INST TECNOLOGICO DE SANTO DOMINGO       ,FC,00000-0000,Private      ,0,1,1,17,93,110
01283900,UNIVERSITY OF CAMBRIDGE - SAINT JOH     ,FC,00000-0000,Public       ,0,0,0,0,14,14
01286200,MOUNTVIEW ACADEMY OF THEATRE ARTS       ,FC,00000-0000,Private      ,0,0,0,2,5,7
01297800,UNIVERSITY OF HUDDERSFIELD (THE)        ,FC,00000-0000,Public       ,0,0,0,1,3,4
01315300,MASSEY UNIVERSITY                       ,FC,00000-0000,Public       ,0,0,0,14,109,123
01322500,COLLEGE OF LAW                          ,FC,00000-0000,Private      ,0,0,0,2,20,22
02052400,DARWIN COLLEGE                          ,FC,00000-0000,Public       ,0,0,0,0,18,18
02082400,UNIVERSITY OF CAMBRIDGE - QUEEN'S C     ,FC,00000-0000,Public       ,0,0,0,0,14,14
02083400,UNIVERSITY OF CAMBRIDGE - WOLFSON C     ,FC,00000-0000,Public       ,0,0,0,0,17,17
02087400,UNIVERSITY OF CAMBRIDGE - NEWNHAM C     ,FC,00000-0000,Public       ,0,0,0,0,3,3
02087900,OXFORD BROOKES UNIVERSITY               ,FC,00000-0000,Public       ,0,1,1,9,45,54
02094100,BEN-GURION UNIV                         ,FC,00000-0000,Public       ,0,0,0,3,158,161
02094400,UNIV OF CAMBRIDGE - ST EDMUND'S HOU     ,FC,00000-0000,Public       ,0,0,0,1,9,10
02095500,LONDON BUS SCHOOL                       ,FC,00000-0000,Private      ,0,3,3,2,169,171
02098700,FATIMA COLLEGE OF MEDICINE              ,FC,00000-0000,Private      ,0,2,2,6,53,59
02101900,ROEHAMPTON UNIVERSITY                   ,FC,00000-0000,Public       ,0,0,0,18,54,72
02108600,LONDON ACADEMY OF MUSIC & DRAMATIC      ,FC,00000-0000,Private      ,1,0,1,12,11,23
02115900,UNIVERSITY OF PORTSMOUTH                ,FC,00000-0000,Public       ,0,0,0,7,8,15
02116700,UNIVERSITY OF CAMBRIDGE - LUCY CAVE     ,FC,00000-0000,Public       ,0,0,0,0,9,9
02120000,UNIV OF LONDON - COURTALD INST OF A     ,FC,00000-0000,Public       ,1,0,1,1,22,23
02133400,UNIVERSITY OF CAMBRIDGE - SIDNEY SU     ,FC,00000-0000,Public       ,0,0,0,1,8,9
02142000,UNIVERSITY OF CAMBRIDGE - HOMERTON      ,FC,00000-0000,Public       ,0,0,0,0,7,7
02149700,UNIVERSITY OF WINCHESTER (THE)          ,FC,00000-0000,Public       ,0,0,0,7,5,12
02156800,UNIV OF OTAGO                           ,FC,00000-0000,Public       ,0,1,1,5,37,42
02162300,"IESE BUSINESS SCH, UNIV OF NAVARRA      ",FC,00000-0000,Private      ,0,0,0,2,73,75
02167400,UNIVERSITY OF CAMBRIDGE - CORPUS CH     ,FC,00000-0000,Public       ,0,0,0,0,7,7
02175700,OHR SOMAYACH INSTITUTIONS               ,FC,00000-0000,Private      ,0,0,0,6,7,13
02177700,KING'S COLLEGE- UNIV OF CAMBRIDGE       ,FC,00000-0000,Public       ,0,0,0,2,33,35
02180500,MIDDLESEX UNIVERSITY                    ,FC,00000-0000,Public       ,0,0,0,10,45,55
02181000,UNIVERSITY OF SOUTH AUSTRALIA           ,FC,00000-0000,Public       ,0,0,0,5,17,22
02183500,UNIV OF OXFORD - WYCLIFFE HALL          ,FC,00000-0000,Public       ,0,0,0,0,7,7
02186000,UNIVERSITY OF CAMBRIDGE - MAGDALENE     ,FC,00000-0000,Public       ,0,0,0,0,9,9
02186100,UNIVERSITY OF CAMBRIDGE - EMMANUEL      ,FC,00000-0000,Public       ,0,0,0,0,7,7
02189600,UNIVERSITY OF GRONINGEN                 ,FC,00000-0000,Public       ,0,1,1,4,7,11
02194800,UNIVERSITY OF THE WEST OF ENGLAND -     ,FC,00000-0000,Public       ,0,0,0,6,10,16
02195100,UNIV OF WESTMINSTER                     ,FC,00000-0000,Public       ,1,0,1,26,112,138
02196700,GUILDHALL SCHOOL OF MUSIC & DRAMA       ,FC,00000-0000,Public       ,0,0,0,7,16,23
02197000,INT'L GRAD PROGRAMME STOCKHOLM UNIV     ,FC,00000-0000,Public       ,0,0,0,0,19,19
02207300,UNIVERSITY OF CAMBRIDGE - CHRIST'S      ,FC,00000-0000,Public       ,0,0,0,1,4,5
02207400,CHINESE UNIVERSITY OF HONG KONG (THE)   ,FC,00000-0000,Public       ,0,1,1,3,7,10
02209500,UNIVERSITEIT UTRECHT                    ,FC,00000-0000,Public       ,0,0,0,11,46,57
02210000,UNIV OF LONDON - LONDON SCHOOL OF H     ,FC,00000-0000,Public       ,0,1,1,0,46,46
02212300,UNIVERSITY OF CAMBRIDGE - ROBINSON      ,FC,00000-0000,Public       ,0,0,0,0,1,1
02216300,UNIVERSIDAD DE CHILE                    ,FC,00000-0000,Public       ,0,0,0,1,4,5
02225300,UNIV OF CANTERBURY                      ,FC,00000-0000,Public       ,0,0,0,7,35,42
02229100,UNIVERSITY OF LEICESTER                 ,FC,00000-0000,Public       ,0,0,0,8,56,64
02229600,SACKLER SCHOOL OF MEDICINE              ,FC,00000-0000,Public       ,0,0,0,0,197,197
02232100,UNIVERSITY OF CAMBRIDGE                 ,FC,00000-0000,Public       ,1,0,1,3,11,14
02233300,"ST GEORGE'S UNIV, SCH OF MEDICINE       ",FC,00000-0000,Proprietary  ,0,37,37,20,2881,2901
02235300,LONDON METROPOLITAN UNIVERSITY          ,FC,00000-0000,Public       ,0,1,1,36,146,182
02240900,AISH HATORAH CLG OF JEWISH STUDIES      ,FC,00000-0000,Private      ,0,0,0,3,2,5
02244400,AMERICAN UNIV OF THE CARIBBEAN          ,FC,00000-0000,Proprietary  ,0,24,24,5,1212,1217
02257100,COVENTRY UNIVERSITY                     ,FC,00000-0000,Public       ,0,0,0,6,8,14
02266600,UNIVERSITY OF LONDON - SAINT GEORGE     ,FC,00000-0000,Public       ,0,0,0,0,6,6
02271700,UNIVERSITY OF CAMBRIDGE - CLARE HAL     ,FC,00000-0000,Public       ,0,1,1,0,10,10
02271800,UNIV OF OXFORD - CAMPION HALL           ,FC,00000-0000,Public       ,0,0,0,0,1,1
02271900,UNIVERSITY OF OXFORD - BLACKFRIARS      ,FC,00000-0000,Public       ,0,0,0,1,2,3
02272100,UNIV OF OXFORD - GREYFRIARS             ,FC,00000-0000,Public       ,0,0,0,0,1,1
02272200,UNIV OF CAMBRIDGE - NEW HALL            ,FC,00000-0000,Public       ,0,0,0,3,7,10
02273600,QUEEN'S UNIV OF BELFAST (THE)           ,FC,00000-0000,Public       ,0,0,0,4,18,22
02273900,HERIOT WATT UNIVERSITY                  ,FC,00000-0000,Public       ,0,1,1,5,27,32
02276700,NYENRODE BUSINESS UNIVERSITEIT          ,FC,00000-0000,Private      ,0,0,0,0,3,3
02279700,UNIVERSITY OF MANCHESTER - INSTITUT     ,FC,00000-0000,Public       ,0,0,0,14,100,114
02293400,ECOLE DES HAUTES ETUDES COMERCIALS      ,FC,00000-0000,Public       ,0,0,0,0,52,52
02296300,UNIVERSITY OF CAMBRIDGE - JESUS COL     ,FC,00000-0000,Public       ,0,0,0,0,8,8
02310500,DE MONTFORT UNIVERSITY                  ,FC,00000-0000,Public       ,0,0,0,4,12,16
02320500,ROYAL NORTHERN COLLEGE OF MUSIC         ,FC,00000-0000,Public       ,0,0,0,2,6,8
02335100,UNIV OF CAMBRIDGE - TRINITY HALL        ,FC,00000-0000,Public       ,0,0,0,1,13,14
02338900,UNIVERSITY  FOR THE CREATIVE ARTS       ,FC,00000-0000,Public       ,0,0,0,3,2,5
02338903,KENT INSTITUTE OF ART & DESIGN          ,FC,00000-0000,Public       ,0,0,0,2,0,2
02339300,ERASMUS UNIV ROTTERDAM                  ,FC,00000-0000,Public       ,0,0,0,1,13,14
02347300,ESCUELA AUTONOMA DE CIENCIAS MEDICA     ,FC,00000-0000,Private      ,0,0,0,11,26,37
02351800,UNIVERSIDAD IBEROAMERICANA (UNIBE       ,FC,00000-0000,Private      ,6,19,25,118,1064,1182
02352100,UNIVERSITY OF PLYMOUTH                  ,FC,00000-0000,Public       ,0,0,0,1,0,1
02355200,ECOLE SUPERIEURE DE CUISINE FRANCAISE-FE,FC,00000-0000,Public       ,0,0,0,4,19,23
02363000,GSA CONSERVATOIRE                       ,FC,00000-0000,Private      ,0,0,0,5,3,8
02493000,ESCUELA SUPERIOR ADMINISTRACION Y D     ,FC,00000-0000,Private      ,0,0,0,2,15,17
02496600,UNIVERSITY OF STELLENBOSCH              ,FC,00000-0000,Public       ,0,0,0,4,8,12
02502600,PECSI ORVOSTUDOMANYI EGYETEM (PECS      ,FC,00000-0000,Public       ,0,0,0,1,15,16
02545700,GLASGOW SCHOOL OF ART                   ,FC,00000-0000,Public       ,0,0,0,13,32,45
02579600,MURDOCH UNIVERSITY                      ,FC,00000-0000,Public       ,0,0,0,5,68,73
02588000,UNIVERSITY OF ULSTER                    ,FC,00000-0000,Public       ,0,0,0,6,18,24
02591800,CURTIN UNIVERSITY OF TECHNOLOGY         ,FC,00000-0000,Public       ,0,0,0,2,20,22
02592300,MILLTOWN INST OF THEOLOGY & PHILOSO     ,FC,00000-0000,Private      ,0,0,0,0,3,3
02604300,AALBORG UNIVERSITY                      ,FC,00000-0000,Public       ,0,0,0,1,18,19
02611500,HELSINKI SCH OF ECONOMICS & BUS ADM     ,FC,00000-0000,Public       ,0,0,0,0,2,2
02611600,ECOL NATIONAL DES PONTS ET CHAUSSEE     ,FC,00000-0000,Public       ,0,0,0,1,5,6
02611700,DUBLIN CITY UNIVERSITY                  ,FC,00000-0000,Public       ,0,0,0,18,32,50
02622500,DENMARKS TEKNISKE UNIVERSITET           ,FC,00000-0000,Public       ,0,0,0,0,5,5
02623200,UNIVERSITY OF NEWCASTLE (THE)           ,FC,00000-0000,Public       ,1,0,1,12,24,36
03012700,UNIVERSITY OF BUCKINGHAM                ,FC,00000-0000,Private      ,0,0,0,2,13,15
03029400,KEELE UNIVERSITY                        ,FC,00000-0000,Public       ,0,0,0,1,8,9
03029500,NORTHUMBRIA UNIVERSITY                  ,FC,00000-0000,Public       ,0,0,0,5,22,27
03029800,NORGES HANDELSHOYSKOLE                  ,FC,00000-0000,Public       ,0,0,0,0,5,5
03033300,MANCHESTER METROPOLITAN UNIV            ,FC,00000-0000,Public       ,0,0,0,17,27,44
03045000,UNIVERSITY OF EAST LONDON               ,FC,00000-0000,Public       ,0,1,1,13,34,47
03050100,STUDIO ART CENTERS INTERNATIONAL        ,FC,00000-0000,Private      ,0,1,1,22,60,82
03066800,PONTIFICIO ATENEO DELLA SANTA CROCE     ,FC,00000-0000,Private      ,0,0,0,0,11,11
03067200,UNIVERSITY OF SYDNEY                    ,FC,00000-0000,Public       ,0,1,1,32,230,262
03073800,UNIV OF DEBRECEN MED & HEALTH SCI       ,FC,00000-0000,Public       ,0,0,0,3,20,23
03078700,UNIVERSITA COMMERCIALE L BOCCONI        ,FC,00000-0000,Public       ,0,0,0,5,37,42
03080300,SHEFFIELD HALLAM UNIVERSITY             ,FC,00000-0000,Public       ,0,0,0,4,5,9
03084300,UNIVERSITY OF LIMERICK                  ,FC,00000-0000,Public       ,0,0,0,21,25,46
03086900,AMERN GRAD SCHL OF BUS THE INST OF      ,FC,00000-0000,Private      ,0,0,0,0,2,2
03088700,ROYAL SCOTTISH ACAD MUSIC & DRAMA       ,FC,00000-0000,Public       ,0,0,0,13,16,29
03091400,UNIVERSITY OF WOLLONGONG                ,FC,00000-0000,Public       ,0,0,0,10,15,25
03091500,UNIVERSITY OF CANBERRA                  ,FC,00000-0000,Public       ,0,0,0,2,7,9
03091700,KAROL MARCINKOWSKI UNIV OF MED SCI      ,FC,00000-0000,Public       ,0,1,1,8,183,191
03092500,NOTTINGHAM TRENT UNIVERSITY             ,FC,00000-0000,Public       ,0,0,0,5,26,31
03095000,RMIT UNIVERSITY                         ,FC,00000-0000,Public       ,0,0,0,7,36,43
03095400,BOND UNIVERSITY                         ,FC,00000-0000,Private      ,1,2,3,43,79,122
03095900,ESSEC BUSINESS SCHOOL                   ,FC,00000-0000,Private      ,0,1,1,0,18,18
03096100,LA TROBE UNIVERSITY                     ,FC,00000-0000,Public       ,0,0,0,11,39,50
03096900,DEAKIN UNIVERSITY                       ,FC,00000-0000,Public       ,0,0,0,5,11,16
03097100,UNIVERSITY OF WESTERN SYDNEY            ,FC,00000-0000,Public       ,0,1,1,6,8,14
03097300,VICTORIA UNIVERSITY OF TECHNOLOGY       ,FC,00000-0000,Public       ,0,0,0,1,7,8
03097500,CENTRAL QUEENSLAND UNIVERSITY           ,FC,00000-0000,Public       ,0,0,0,2,9,11
03100000,UNIVERSITY OF ADELAIDE (THE)            ,FC,00000-0000,Public       ,0,0,0,4,33,37
03101600,ASIAN INSTITUTE OF MANAGEMENT           ,FC,00000-0000,Private      ,0,0,0,1,4,5
03102500,AMERICAN UNIVERSITY OF ROME             ,FC,00000-0000,Private      ,1,0,1,119,58,177
03102800,ROBERT GORDON UNIVERSITY (THE)          ,FC,00000-0000,Public       ,0,1,1,3,23,26
03104800,GRIFFITH UNIVERSITY                     ,FC,00000-0000,Public       ,0,0,0,24,35,59
03106100,ROSKILDE UNIV ROSKILDE UNIVERSITY C     ,FC,00000-0000,Public       ,0,0,0,2,0,2
03123500,HOGESCHOOL VAN AMSTERDAM                ,FC,00000-0000,Private      ,0,0,0,3,9,12
03136300,AUSTRALIAN CATHOLIC UNIVERSITY          ,FC,00000-0000,Public       ,0,0,0,1,8,9
03137400,CHARLES STURT UNIVERSITY                ,FC,00000-0000,Public       ,0,0,0,0,1,1
03140300,EDITH COWAN UNIVERSITY                  ,FC,00000-0000,Public       ,0,0,0,6,17,23
03140400,NORTHERN TERRITORY UNIVERSITY           ,FC,00000-0000,Public       ,0,0,0,0,4,4
03140500,QUEENSLAND UNIVERSITY OF TECHNOLOGY     ,FC,00000-0000,Public       ,0,0,0,6,35,41
03140600,SOUTHERN CROSS UNIVERSITY               ,FC,00000-0000,Public       ,0,0,0,3,15,18
03140700,SWINBURNE UNIVERSITY OF TECHNOLOGY      ,FC,00000-0000,Public       ,0,0,0,2,12,14
03140900,UNIVERSITY OF BALLARAT                  ,FC,00000-0000,Public       ,0,0,0,0,1,1
03150300,UNIVERSITY OF TASMANIA                  ,FC,00000-0000,Public       ,0,0,0,6,12,18
03274300,"KUNGLIGA TEKNISKA HOGSKOLAN, KTH        ",FC,00000-0000,Public       ,0,0,0,1,16,17
03287300,LIVERPOOL INSTITUTE FOR PERFORMING ARTS ,FC,00000-0000,Public       ,0,0,0,11,12,23
03300300,"2ND SCHOOL OF MEDICINE, CHARLES UNI     ",FC,00000-0000,Public       ,1,0,1,4,9,13
03300400,"FIRST FACULTY OF MEDICINE, CHARLES UNIV.",FC,00000-0000,Public       ,1,0,1,3,38,41
03329300,JOHN CABOT UNIVERSITY                   ,FC,00000-0000,Private      ,0,0,0,99,20,119
03332400,AGRICULTURE UNIVERSITY OF WROCLAW       ,FC,00000-0000,Public       ,0,0,0,1,3,4
03333300,MEDICAL UNIVERSITY SCHOOL OF LUBLIN     ,FC,00000-0000,Public       ,0,5,5,25,213,238
03334300,UNIVERSIDAD NORDESTANA                  ,FC,00000-0000,Private      ,0,1,1,4,31,35
03335300,MEDICAL UNIVERSITY OF SILESIA           ,FC,00000-0000,Public       ,0,5,5,8,128,136
03349400,"QUEEN MARGARET UNIVERSITY COLLEGE, EDINB",FC,00000-0000,Public       ,0,0,0,2,10,12
03350300,BOURNEMOUTH UNIVERSITY                  ,FC,00000-0000,Public       ,0,0,0,6,23,29
03352300,LONDON SOUTH BANK UNIVERSITY            ,FC,00000-0000,Private      ,0,0,0,6,24,30
03363300,THE ARTS EDUCATIONAL SCHOOLS LONDON     ,FC,00000-0000,Private      ,0,0,0,1,0,1
03364300,"FACULTY OF MEDICINE, PALACKY UNIVER     ",FC,00000-0000,Public       ,0,0,0,0,3,3
03365400,AUCKLAND INSTITUTE OF TECHNOLOGY        ,FC,00000-0000,Public       ,0,0,0,7,16,23
03366300,TROPICAL AGRICULTURE RESEARCH AND H     ,FC,00000-0000,Private      ,0,0,0,0,2,2
03377300,"UNIVERSITY OF WALES INSTITUTE, CARD     ",FC,00000-0000,Public       ,0,0,0,4,4,8
03378300,"THE 3RD FACULTY OF MEDICINE, CHARLE     ",FC,00000-0000,Public       ,1,0,1,2,9,11
03386300,CHARLES UNIVERSITY-MEDICAL FACULTY      ,FC,00000-0000,Public       ,0,0,0,1,17,18
03406300,"THE SCHOOL OF PHARMACY, UNIVERSITY      ",FC,00000-0000,Public       ,0,0,0,1,6,7
03418400,NAPIER UNIVERSITY                       ,FC,00000-0000,Public       ,0,1,1,9,14,23
03435300,ANGLIA POLYTECHNIC UNIVERSITY HIGHE     ,FC,00000-0000,Public       ,0,0,0,1,5,6
03456600,ANGELES UNIVERSITY FOUNDATION           ,FC,00000-0000,Private      ,0,0,0,2,0,2
03460300,INTERNATIONALES THEOLOGISCHES INSTI     ,FC,00000-0000,Private      ,0,0,0,3,13,16
03462400,UNIV OF ARTS LONDON - LON COLL OF COMMUN,FC,00000-0000,Public       ,1,0,1,22,38,60
03466300,INSTITUTO CENTROAMERICANO DE ADMINI     ,FC,00000-0000,Private      ,0,0,0,0,7,7
03473300,UNIV OF ARTS LONDON - LON COLL FASHION  ,FC,00000-0000,Public       ,0,0,0,44,58,102
03475300,UNIV OF THE ARTS  LONDON - CHELSEA COLL ,FC,00000-0000,Public       ,0,0,0,8,15,23
03478300,WELSH COLLEGE OF MUSIC AND DRAMA        ,FC,00000-0000,Public       ,0,0,0,0,4,4
03492400,UNIV OF CAMBRIDGE-ST CATHERINE'S CG     ,FC,00000-0000,Public       ,0,0,0,1,4,5
03494400,UNIV OF CAMBRIDGE-SELWYN COLLEGE        ,FC,00000-0000,Public       ,0,0,0,0,6,6
03494500,UNIV OF OXFORD-SAINT BENET'S HALL       ,FC,00000-0000,Public       ,0,0,0,0,1,1
03494600,UNIV OF OXFORD-HARRIS MANCHESTER        ,FC,00000-0000,Public       ,1,0,1,2,5,7
03500300,WIMBLEDON COLLEGE OF ART                ,FC,00000-0000,Public       ,0,0,0,11,7,18
03501400,LEEDS METROPOLITAN UNIVERSITY           ,FC,00000-0000,Public       ,0,0,0,5,16,21
03507300,UNIVERSITY OF SUNDERLAND                ,FC,00000-0000,Public       ,0,0,0,2,14,16
03515300,UNIVERSITY OF CENTRAL LANCASHIRE        ,FC,00000-0000,Public       ,0,0,0,1,14,15
03517300,UNIVERSITY OF BRIGHTON                  ,FC,00000-0000,Public       ,0,0,0,5,24,29
03518300,EUROPEAN GRADUATE SCHOOL                ,FC,00000-0000,Private      ,0,8,8,0,106,106
03526300,INST CENTROAMERICANO DE ADM DE EMP      ,FC,00000-0000,Private      ,0,0,0,1,5,6
03527300,SOFIA UNIVERSITY ST. KLIMENT OHRIDSKI   ,FC,00000-0000,Public       ,0,0,0,2,4,6
03533300,BATH SPA UNIVERSITY                     ,FC,00000-0000,Public       ,0,0,0,7,23,30
03547300,UNIVERSITY OF GLAMORGAN                 ,FC,00000-0000,Public       ,0,0,0,1,7,8
03580300,LIVERPOOL JOHN MOORES UNIVERSITY        ,FC,00000-0000,Public       ,0,0,0,6,9,15
03589400,THE ARTS INSTITUTE AT BOURNEMOUTH       ,FC,00000-0000,Public       ,0,0,0,2,1,3
03594300,GROUP ESC GRENOBLE GRAD SCH OF BUS.     ,FC,00000-0000,Private      ,0,0,0,1,35,36
03597300,JAGIELLONIAN UNIVERSITY                 ,FC,00000-0000,Public       ,0,0,0,2,34,36
03601300,UNIVERSITAT JAUME I DE CASTELLO/UJI     ,FC,00000-0000,Public       ,0,0,0,0,9,9
03603300,LEEDS COLLEGE OF MUSIC                  ,FC,00000-0000,Public       ,0,0,0,1,2,3
03619300,UNIVERSITY OF GREENWICH                 ,FC,00000-0000,Public       ,0,0,0,17,26,43
03653400,UNIVERSIDAD DE IBEROAMERICA - UNIBE     ,FC,00000-0000,Private      ,0,1,1,5,27,32
03674300,UNIVERSITY OF ABERTAY DUNDEE            ,FC,00000-0000,Public       ,0,0,0,3,8,11
03684400,UNIVERSITY OF LINCOLN                   ,FC,00000-0000,Public       ,0,0,0,2,7,9
03684500,MEDICAL UNIVERSITY OF GDANSK            ,FC,00000-0000,Public       ,0,0,0,1,17,18
03684600,POMERANIAN MEDICAL UNIVERSITY           ,FC,00000-0000,Public       ,0,0,0,0,1,1
03685300,UNIVERSITAT POMPEU FABRA                ,FC,00000-0000,Public       ,0,0,0,0,3,3
03697300,NATIONAL FILM & TELEVISION SCHOOL       ,FC,00000-0000,Private      ,0,0,0,0,1,1
03716300,"UNIVERSITY OF WALES, NEWPORT            ",FC,00000-0000,Public       ,0,0,0,2,11,13
03721300,WRITTLE COLLEGE                         ,FC,00000-0000,Public       ,0,0,0,1,1,2
03727400,UNIVERSITY OF WAIKATO (THE)             ,FC,00000-0000,Public       ,0,0,0,6,10,16
03738300,LONDON SCHOOL OF THEOLOGY               ,FC,00000-0000,Private      ,0,2,2,0,7,7
03770300,NAZARENE THEOLOGICAL COLLEGE            ,FC,00000-0000,Private      ,0,1,1,1,10,11
03794400,ANGLO EUROPEAN COLLEGE OF CHIROPRACTIC  ,FC,00000-0000,Private      ,0,0,0,0,1,1
03816400,AMERICAN GRAD SCH OF INTERNTL REL & DIPL,FC,00000-0000,Private      ,0,0,0,5,57,62
03818300,LEIPZIG GRADUATE SCHOOL OF MANAGEMENT   ,FC,00000-0000,Private      ,0,1,1,0,9,9
03824300,"ROYAL VETERINARY COLLEGE (THE), UNIVERSI",FC,00000-0000,Public       ,0,0,0,1,100,101
03850500,MEDICAL UNIVERSITY OF LODZ              ,FC,00000-0000,Public       ,0,1,1,5,72,77
03859400,UNIVERSITY COLLEGE FALMOUTH             ,FC,00000-0000,Public       ,0,0,0,7,10,17
03897400,INTERNATIONAL SPACE UNIVERSITY          ,FC,00000-0000,Private      ,0,0,0,0,5,5
03926400,NATIONAL COLLEGE OF ART AND DESIGN      ,FC,00000-0000,Public       ,0,0,0,5,5,10
03941301,AVE MARIA UNIVERSITY - LATIN AMERICA    ,FC,00000-0000,Private      ,3,0,3,175,48,223
03978300,SPURGEON'S COLLEGE                      ,FC,00000-0000,Private      ,0,0,0,0,1,1
04021400,"AMERICAN COLLEGE, DUBLIN LIMITED (THE)  ",FC,00000-0000,Private      ,2,0,2,7,8,15
04021500,CENTRAL EUROPEAN UNIVERSITY             ,FC,00000-0000,Private      ,0,0,0,0,20,20
04046300,HK UNIVERSITY OF SCI & TECH (HKUST)     ,FC,00000-0000,Public       ,0,0,0,0,1,1
04070300,"RAPHAEL RECANATI INTERNATIONAL SCHOOL, T",FC,00000-0000,Private      ,2,0,2,55,30,85
04085400,NEW ZEALAND COLLEGE OF CHIROPRACTIC     ,FC,00000-0000,Private      ,0,0,0,0,6,6
04116300,EDHEC BUSINESS SCHOOL                   ,FC,00000-0000,Private      ,0,0,0,0,2,2
04121400,ISAPZURICH (INTERNATIONAL SCHOOL OF ANAL,FC,00000-0000,Private      ,0,0,0,0,3,3
00380600,ALDERSON-BROADDUS COLLEGE               ,WV,26416-1051,Private      ,0,0,0,813,346,1159
00380700,MOUNTAIN STATE UNIVERSITY               ,WV,25801-5624,Private      ,20,272,292,1243,6367,7610
00380800,BETHANY COLLEGE                         ,WV,26032-0417,Private      ,0,0,0,1356,67,1423
00380900,BLUEFIELD STATE COLLEGE                 ,WV,24701-2198,Public       ,4,22,26,1299,1573,2872
00381000,CONCORD UNIVERSITY                      ,WV,24712-0000,Public       ,4,17,21,2949,976,3925
00381100,DAVIS & ELKINS COLLEGE                  ,WV,26241-3996,Private      ,1,2,3,588,270,858
00381200,FAIRMONT STATE UNIVERSITY               ,WV,26554-2470,Public       ,4,56,60,4709,3273,7982
00381300,GLENVILLE STATE COLLEGE                 ,WV,26351-1292,Public       ,2,4,6,1339,458,1797
00381500,MARSHALL UNIVERSITY                     ,WV,25755-3300,Public       ,26,120,146,8206,6268,14474
00381600,SOUTHERN WV COMMUNITY COLLEGE           ,WV,25637-2900,Public       ,2,15,17,1161,1287,2448
00381800,UNIVERSITY OF CHARLESTON                ,WV,25304-1099,Private      ,1,0,1,1577,723,2300
00381900,OHIO VALLEY COLLEGE                     ,WV,26105-8000,Private      ,1,10,11,454,212,666
00382000,SALEM INTERNATIONAL UNIVERSITY          ,WV,26426-0500,Proprietary  ,2,76,78,267,630,897
00382200,SHEPHERD UNIVERSITY                     ,WV,25443-3210,Public       ,3,13,16,3192,1185,4377
00382300,WEST LIBERTY STATE COLLEGE              ,WV,26074-0295,Public       ,5,6,11,2558,658,3216
00382600,WEST VIRGINIA STATE UNIVERSITY          ,WV,25112-0000,Public       ,6,19,25,2472,2525,4997
00382700,WEST VIRGINIA UNIVERSITY                ,WV,26506-6201,Public       ,51,108,159,22825,8088,30913
00382711,WEST VIRGINIA UNIVERSITY - POTOMAC STATE,WV,26726-3000,Public       ,3,3,6,1490,356,1846
00382721,WEST VIRGINIA UNIV INST OF TECH         ,WV,25136-2436,Public       ,2,0,2,1302,463,1765
00382800,WEST VIRGINIA UNIV AT PARKERSBURG       ,WV,26101-9577,Public       ,7,80,87,1458,2422,3880
00383000,WEST VIRGINIA WESLEYAN COLLEGE          ,WV,26201-2600,Private      ,2,0,2,1711,164,1875
00383100,WHEELING JESUIT UNIVERSITY              ,WV,26003-6243,Private      ,1,30,31,1176,640,1816
00500700,WEST VIRGINIA JUNIOR COLLEGE            ,WV,26505-5596,Proprietary  ,0,1,1,125,211,336
00500800,MOUNTAIN STATE COLLEGE                  ,WV,26101-3993,Proprietary  ,0,13,13,38,252,290
00754400,APPALACHIAN BIBLE COLLEGE               ,WV,25818-1353,Private      ,0,0,0,235,71,306
00757800,HUNTINGTON SCHOOL OF BEAUTY CULTURE     ,WV,25705-2030,Proprietary  ,0,5,5,39,121,160
00760000,INTERNATIONAL BEAUTY SCHOOL             ,WV,25401-3231,Proprietary  ,1,15,16,33,84,117
00835500,JAMES RUMSEY TECHNICAL INSTITUTE        ,WV,25403-0259,Public       ,0,2,2,57,145,202
00895900,CLARKSBURG BEAUTY ACADEMY               ,WV,26301-2903,Proprietary  ,4,19,23,57,115,172
00904700,HUNTINGTON JUNIOR COLLEGE               ,WV,25701-2004,Proprietary  ,16,62,78,214,1326,1540
00905400,WEST VIRGINIA NORTHERN CMTY COLLEGE     ,WV,26003-0000,Public       ,4,52,56,968,2028,2996
01014000,MINERAL COUNTY VOCATIONAL TECH CTR      ,WV,26726-0000,Public       ,0,0,0,12,36,48
01035600,EVEREST INSTITUTE                       ,WV,25313-1304,Proprietary  ,21,72,93,185,739,924
01057300,WEST VIRGINIA JUNIOR COLLEGE            ,WV,25322-0000,Proprietary  ,4,16,20,172,358,530
01057302,WEST VIRGINIA JUNIOR COLLEGE            ,WV,26330-0000,Proprietary  ,5,17,22,144,292,436
01086100,WEST VIRGINIA BUSINESS COLLEGE          ,WV,26301-0000,Proprietary  ,2,11,13,28,174,202
01124500,WEST VIRGINIA SCH OSTEOPATHIC MED       ,WV,24901-1128,Public       ,0,0,0,9,776,785
01174900,WOOD COUNTY SCH OF PRAC NURSING         ,WV,26101-6424,Public       ,0,0,0,12,40,52
01235900,B M SPURR SCHOOL OF PRAC NURSING        ,WV,26038-1660,Private      ,0,0,0,9,17,26
01257300,WEST VIRGINIA UNIV-HOSP-RAD TECH        ,WV,26506-8062,Private      ,0,0,0,64,37,101
01274300,BENJAMIN FRANKLIN CAREER&TECH           ,WV,25064-0000,Public       ,0,0,0,61,114,175
01290400,MONONGALIA CNTY TECH ED CTR             ,WV,26501-6841,Public       ,0,0,0,37,85,122
01290500,ACADEMY OF CAREERS AND TECHNOLOGY       ,WV,25801-0000,Public       ,0,1,1,68,198,266
02057400,ROANE-JACKSON TECHNICAL CENTER          ,WV,25252-0000,Public       ,0,0,0,16,58,74
02068000,UNITED TECHNICAL CENTER                 ,WV,26301-0000,Public       ,0,4,4,37,111,148
02070100,BECKLEY BEAUTY ACADEMY                  ,WV,25801-0000,Proprietary  ,1,7,8,43,73,116
02073400,CARVER CAREER TECH ED CTR               ,WV,25306-6397,Public       ,2,2,4,125,214,339
02145100,SCOTT COLLEGE OF COSMETOLOGY            ,WV,26003-0000,Proprietary  ,1,4,5,46,54,100
02178200,CHARLESTON SCHOOL OF BEAUTY CULTURE     ,WV,25301-0000,Proprietary  ,5,20,25,35,129,164
02218200,GARNET CAREER CENTER                    ,WV,25301-0000,Public       ,1,16,17,69,272,341
02275300,CABELL COUNTY CAREER TECHNOLOGY CTR     ,WV,25705-0000,Public       ,0,6,6,41,110,151
02524500,RALPH R WILLIS VOCATIONAL CENTER        ,WV,25601-0000,Public       ,0,2,2,12,30,42
02534800,FRED W EBERLE TECHNICAL CENTER          ,WV,26201-0000,Public       ,1,2,3,43,98,141
02535500,MERCER COUNTY TECH EDUC CNTR            ,WV,24740-0000,Public       ,0,0,0,51,131,182
02579900,NORTH CENTRAL OPPORTUNITIES IND CTR     ,WV,26554-2936,Private      ,1,5,6,30,75,105
02609400,VALLEY COLLEGE                          ,WV,25404-5711,Proprietary  ,0,9,9,19,168,187
03052000,MEREDITH MANOR EQUESTRIAN CENTRE        ,WV,26184-9707,Proprietary  ,3,4,7,132,76,208
03076500,FAYETTE INSTITUTE OF TECHNOLOGY         ,WV,25901-2174,Public       ,0,1,1,15,47,62
03084200,VALLEY COLLEGE                          ,WV,24740-3141,Proprietary  ,0,5,5,11,69,80
03084400,VALLEY COLLEGE                          ,WV,25801-2643,Proprietary  ,0,5,5,21,105,126
03098300,PUTNAM CAREER & TECHNICAL CENTER        ,WV,25070-0000,Public       ,0,0,0,23,55,78
03099200,"MOUNTAINEER BEAUTY COLLEGE, INC         ",WV,25177-2917,Proprietary  ,0,1,1,19,55,74
03102100,MORGANTOWN BEAUTY COLLEGE               ,WV,26505-5430,Proprietary  ,2,5,7,55,84,139
03123200,STANLEY TECHNICAL INSTITUTE             ,WV,26505-3751,Private      ,0,1,1,10,59,69
03327500,SOUTH BRANCH VOCATIONAL TECH CENTER     ,WV,26847-1698,Public       ,0,0,0,9,17,26
03734300,JOHN D. ROCKEFELLER IV CAREER CENTER    ,WV,26047-9424,Public       ,0,0,0,6,25,31
03819300,AMERICAN PUBLIC UNIVERSITY SYSTEM       ,WV,25414-1621,Proprietary  ,9,488,497,211,8364,8575
03957300,BLUE RIDGE COMMUNITY AND TECHNICAL COLLE,WV,25401-3244,Public       ,13,36,49,471,925,1396
03960300,NEW RIVER COMMUNITY AND TECHNICAL COLLEG,WV,25801-2636,Public       ,8,73,81,871,1773,2644
04028300,MOUNTAIN STATE SCHOOL OF MASSAGE        ,WV,25304-2025,Proprietary  ,0,0,0,19,49,68
04038500,PIERPONT COMMUNITY & TECHNICAL COLLEGE  ,WV,26554-2451,Public       ,1,23,24,504,542,1046
04038600,WEST VIRGINIA STATE COMMUNITY AND TECHNI,WV,25112-1000,Public       ,2,10,12,503,970,1473
04041400,MARSHALL COMMUNITY AND TECHNICAL COLLEGE,WV,25755-3300,Public       ,6,31,37,735,1045,1780
04047300,COMM AND TECH COLLEGE AT WVU TECH       ,WV,25136-2437,Public       ,1,1,2,304,231,535
00106100,ALASKA PACIFIC UNIVERSITY               ,AK,99508-4672,Private      ,2,7,9,631,579,1210
00106300,UNIVERSITY OF ALASKA FAIRBANKS          ,AK,99775-7500,Public       ,20,66,86,2301,2843,5144
00106500,UNIVERSITY OF ALASKA SOUTHEAST          ,AK,99801-8680,Public       ,7,41,48,499,1009,1508
00884300,ALASKA BIBLE COLLEGE                    ,AK,99588-0000,Private      ,0,0,0,17,16,33
01146200,UNIVERSITY OF ALASKA  ANCHORAGE         ,AK,99514-1608,Public       ,49,153,202,4695,6384,11079
02541000,CAREER ACADEMY                          ,AK,99507-0000,Proprietary  ,9,33,42,111,531,642
02576900,CHARTER COLLEGE                         ,AK,99508-0000,Proprietary  ,28,122,150,277,1534,1811
03160300,ALASKA VOCATIONAL TECHNICAL CENTER      ,AK,99664-0889,Public       ,1,4,5,156,225,381
03461300,ILISAGVIK COLLEGE                       ,AK,99723-0749,Public       ,0,2,2,17,55,72
04138600,ALASKA CHRISTIAN COLLEGE                ,AK,99669-9755,Private      ,5,1,6,19,3,22
00108500,UNIV ARKANSAS MONTICELLO                ,AR,71656-0000,Public       ,23,58,81,1903,1988,3891
00108501,GREAT RIVERS TECHNICAL INSTITUTE        ,AR,71654-0000,Public       ,0,0,0,2,9,11
00108502,FOREST ECHOES TECHNICAL INSTITUTE       ,AR,71635-0000,Public       ,0,0,0,5,8,13
00108600,UNIV OF ARKANSAS AT PINE BLUFF          ,AR,71601-2790,Public       ,43,21,64,3703,1817,5520
00108700,ARKANSAS BAPTIST COLLEGE                ,AR,72202-6099,Private      ,9,14,23,592,671,1263
00108800,LYON COLLEGE                            ,AR,72501-3699,Private      ,1,1,2,662,95,757
00108900,ARKANSAS TECH UNIVERSITY                ,AR,72801-2222,Public       ,16,35,51,4418,3225,7643
00109000,ARKANSAS STATE UNIVERSITY               ,AR,72467-0000,Public       ,63,256,319,7121,8208,15329
00109006,DELTA TECHNICAL INSTITUTE               ,AR,72365-9558,Public       ,0,1,1,40,81,121
00109100,ARKANSAS STATE UNIVERSITY - BEEBE       ,AR,72012-1000,Public       ,20,62,82,1542,2617,4159
00109200,UNIVERSITY OF CENTRAL ARKANSAS          ,AR,72035-0001,Public       ,44,83,127,7567,4263,11830
00109300,CENTRAL BAPTIST COLLEGE                 ,AR,72034-6470,Private      ,0,5,5,371,288,659
00109400,UNIVERSITY OF THE OZARKS                ,AR,72830-2880,Private      ,1,1,2,620,122,742
00109500,CROWLEYS RIDGE COLLEGE                  ,AR,72450-9775,Private      ,1,2,3,141,53,194
00109700,HARDING UNIVERSITY                      ,AR,72149-0001,Private      ,22,52,74,3234,1564,4798
00109800,HENDERSON STATE UNIVERSITY              ,AR,71999-0001,Public       ,14,30,44,2977,1651,4628
00109900,HENDRIX COLLEGE                         ,AR,72032-3080,Private      ,1,1,2,1892,75,1967
00110000,JOHN BROWN UNIVERSITY                   ,AR,72761-2747,Private      ,3,14,17,1235,1074,2309
00110100,UNIV ARKANSAS LITTLE ROCK               ,AR,72204-1099,Public       ,40,212,252,4132,9233,13365
00110200,OUACHITA BAPTIST UNIVERSITY             ,AR,71998-0001,Private      ,4,1,5,1427,149,1576
00110300,PHILANDER SMITH COLLEGE                 ,AR,72202-3718,Private      ,3,13,16,684,585,1269
00110400,PHILLIPS COUNTY COMMUNITY COLLEGE       ,AR,72342-0000,Public       ,12,40,52,461,1091,1552
00110401,RICE BELT TECH INST                     ,AR,72042-0000,Public       ,0,0,0,6,6,12
00110600,WILLIAMS BAPTIST COLLEGE                ,AR,72476-4661,Private      ,0,1,1,506,154,660
00110700,SOUTHERN ARKANSAS UNIVERSITY            ,AR,71754-0000,Public       ,19,36,55,2041,1591,3632
00110800,UNIV ARKANSAS FAYETTEVILLE              ,AR,72701-0000,Public       ,79,100,179,9467,5441,14908
00110900,UNIV OF ARKANSAS FOR MEDCL SCIENCES     ,AR,72205-7102,Public       ,2,14,16,409,1729,2138
00110901,UNIV OF ARKANSAS COLG OF MEDICINE       ,AR,72205-0000,Public       ,1,3,4,43,630,673
00111000,UNIVERSITY OF ARKANSAS-FORT SMITH       ,AR,72904-7397,Public       ,29,146,175,3247,4008,7255
00524500,U OF A COMM COLLEGE AT MORRILTON        ,AR,72110-9601,Public       ,7,57,64,961,1583,2544
00570700,SEARK COLLEGE                           ,AR,71603-0000,Public       ,8,109,117,672,2157,2829
00573200,UNIV AR COMMUNITY COLLEGE AT HOPE       ,AR,71801-0000,Public       ,11,56,67,458,1125,1583
00704400,CROWLEYS RIDGE TECHNICAL INSTITUTE      ,AR,72336-0000,Public       ,0,7,7,96,279,375
00773800,SOUTHERN ARKANSAS UNIVERSITY TECH       ,AR,71701-1900,Public       ,12,17,29,379,661,1040
00792100,FAYETTEVILLE BEAUTY COLLEGE             ,AR,72701-0000,Proprietary  ,2,3,5,48,91,139
00997600,OUACHITA TECHNICAL COLLEGE              ,AR,72104-0816,Public       ,5,24,29,334,882,1216
01074100,MELLIE'S BEAUTY COLLEGE                 ,AR,72901-3886,Proprietary  ,1,8,9,54,148,202
01210500,NATIONAL PARK COMMUNITY COLLEGE         ,AR,71913-9174,Public       ,13,93,106,937,2252,3189
01226000,EAST ARKANSAS COMMUNITY COLLEGE         ,AR,72335-2204,Public       ,7,25,32,502,860,1362
01226100,NORTH ARKANSAS COLLEGE                  ,AR,72601-5508,Public       ,7,31,38,869,1638,2507
01286000,ARKANSAS NORTHEASTERN COLLEGE           ,AR,72316-1109,Public       ,26,73,99,691,1635,2326
02052200,BLACK RIVER TECHNICAL COLLEGE           ,AR,72455-0000,Public       ,8,57,65,665,1591,2256
02073500,UNIV OF AR CMNTY CLG-BATESVILLE         ,AR,72503-0000,Public       ,16,61,77,441,1303,1744
02073700,NORTHWEST TECHNICAL INSTITUTE           ,AR,72765-0000,Public       ,0,8,8,122,318,440
02074600,SOUTH ARKANSAS COMMUNITY COLLEGE        ,AR,71731-0000,Public       ,10,65,75,472,1397,1869
02075300,PULASKI TECHNICAL COLLEGE               ,AR,72118-0000,Public       ,45,196,241,2671,10105,12776
02087000,OZARKA COLLEGE                          ,AR,72556-0000,Public       ,2,21,23,313,999,1312
02111100,RICH MOUNTAIN COMMUNITY COLLEGE         ,AR,71953-0000,Public       ,0,14,14,374,568,942
02202400,PROFESSIONAL COSMETOLOGY EDUC CTR       ,AR,71730-5828,Proprietary  ,1,3,4,20,51,71
02220900,COSSATOT COMMUNITY COLLEGE              ,AR,71832-0000,Public       ,6,27,33,398,991,1389
02260400,BEE JAY'S HAIRSTYLING ACADEMY           ,AR,72212-0000,Proprietary  ,0,3,3,17,56,73
02260401,BEE JAY'S HAIRSTYLING ACADEMY - BATESVIL,AR,72501-6709,Proprietary  ,1,4,5,2,17,19
02272400,EASTERN COLLEGE OF HEALTH VOCATIONS     ,AR,72209-0000,Proprietary  ,24,84,108,200,821,1021
02284200,NEW TYLER BARBER COLLEGE INC            ,AR,72114-0000,Proprietary  ,0,10,10,27,105,132
02287400,MARSHA KAY BEAUTY COLLEGE               ,AR,72653-0000,Proprietary  ,0,2,2,10,36,46
02321701,ITT TECHNICAL INSTITUTE                 ,AR,72204-9925,Proprietary  ,30,62,92,363,895,1258
02330800,JEFFERSON SCHOOL OF NURSING             ,AR,71603-0000,Private      ,0,1,1,32,94,126
02339800,SOUTHERN INSTITUTE OF COSMETOLOGY       ,AR,72301-0000,Proprietary  ,1,3,4,18,70,88
02341700,CAREER ACADEMY OF HAIR DESIGN           ,AR,72764-4304,Proprietary  ,3,25,28,75,197,272
02341701,CAREER ACADEMY OF HAIR DESIGN - ROGERS  ,AR,72756-2028,Proprietary  ,0,1,1,0,1,1
02348200,MID-SOUTH COMMUNITY COLLEGE             ,AR,72301-0000,Public       ,23,101,124,643,1678,2321
02363500,ARTHUR'S BEAUTY COLLEGE                 ,AR,72901-0000,Proprietary  ,0,7,7,23,84,107
02525800,LEE'S SCHOOL OF COSMETOLOGY             ,AR,72114-0000,Proprietary  ,2,5,7,34,67,101
02538500,ARTHUR'S BEAUTY COLLEGE                 ,AR,72076-0000,Proprietary  ,2,15,17,85,234,319
02569600,SEARCY BEAUTY COLLEGE                   ,AR,72143-0000,Proprietary  ,1,9,10,23,72,95
03005100,ARKANSAS BEAUTY SCHOOL                  ,AR,72209-5116,Proprietary  ,0,6,6,33,105,138
03007100,HOT SPRINGS BEAUTY COLLEGE              ,AR,71901-5432,Proprietary  ,3,4,7,34,84,118
03007600,ARKANSAS BEAUTY SCHOOL-CONWAY           ,AR,72032-4354,Proprietary  ,4,5,9,38,73,111
03023400,ARKANSAS COLLEGE OF BARBERING           ,AR,72114-5615,Proprietary  ,1,15,16,40,188,228
03030903,DIESEL DRIVING ACADEMY - LITTLE ROCK    ,AR,72117-9624,Proprietary  ,0,0,0,1,4,5
03063300,NORTHWEST ARKANSAS COMMUNITY COLLEG     ,AR,72712-5190,Public       ,27,145,172,1931,3798,5729
03065100,ABC BEAUTY COLLEGE                      ,AR,71923-4206,Proprietary  ,1,6,7,27,75,102
03066302,BRYAN COLLEGE -                         ,AR,72756-1825,Proprietary  ,8,27,35,69,271,340
03105200,BAPTIST HEALTH SCHOOLS LITTLE ROCK      ,AR,72210-0000,Private      ,1,12,13,342,1242,1584
03116800,"DELUXE BEAUTY SCHOOL, L.L.C.            ",AR,71603-0000,Proprietary  ,0,1,1,15,24,39
03124900,IMAGINE -  PAUL MITCHELL PARTNER SCHOOL ,AR,72117-2516,Proprietary  ,8,10,18,79,116,195
03127200,ASKINS VO-TECH                          ,AR,72908-8028,Proprietary  ,0,8,8,3,43,46
03212300,BLYTHEVILLE ACADEMY OF COSMETOLOGY      ,AR,72315-3424,Proprietary  ,0,0,0,5,33,38
03214300,VELVATEX COLLEGE OF BEAUTY CULTURE      ,AR,72202-5452,Proprietary  ,2,0,2,8,38,46
03254300,MARGARET'S HAIR ACADEMY                 ,AR,71655-4905,Proprietary  ,2,2,4,22,77,99
03519400,LYNNDALE FUNDAMENTALS OF BEAUTY SCH     ,AR,71730-4804,Proprietary  ,0,0,0,13,42,55
03855300,ECCLESIA COLLEGE                        ,AR,72762-8159,Private      ,1,1,2,70,30,100
03912300,CROSSETT SCHOOL OF COSMETOLOGY          ,AR,71635-0000,Proprietary  ,1,5,6,20,32,52
03997300,ARKANSAS BEAUTY COLLEGE                 ,AR,72801-3741,Proprietary  ,0,7,7,16,63,79
00133900,CORBAN COLLEGE                          ,OR,97301-9392,Private      ,0,6,6,1095,449,1544
00316505,CASCADE COLLEGE                         ,OR,97216-0000,Private      ,1,4,5,340,142,482
00318600,BLUE MOUNTAIN COMMUNITY COLLEGE         ,OR,97801-0000,Public       ,10,33,43,880,1540,2420
00318800,CENTRAL OREGON COMMUNITY COLLEGE        ,OR,97701-5998,Public       ,33,92,125,2282,3989,6271
00318900,CLATSOP COMMUNITY COLLEGE               ,OR,97103-3698,Public       ,3,24,27,379,605,984
00319100,CONCORDIA UNIVERSITY                    ,OR,97211-6099,Private      ,2,26,28,1124,1471,2595
00319300,EASTERN OREGON UNIVERSITY               ,OR,97850-2899,Public       ,6,32,38,1955,2401,4356
00319400,GEORGE FOX UNIVERSITY                   ,OR,97132-2697,Private      ,0,47,47,2342,1945,4287
00319600,LANE COMMUNITY COLLEGE                  ,OR,97405-0640,Public       ,49,135,184,4973,9237,14210
00319700,LEWIS & CLARK COLLEGE                   ,OR,97219-7899,Private      ,2,10,12,4304,3134,7438
00319800,LINFIELD COLLEGE                        ,OR,97128-6894,Private      ,2,6,8,2798,601,3399
00319801,LINFIELD COLLEGE - PORTLAND CAMPUS      ,OR,97210-0000,Private      ,0,3,3,298,647,945
00319900,MARYLHURST UNIVERSITY                   ,OR,97036-7036,Private      ,0,72,72,166,1792,1958
00320300,MOUNT ANGEL SEMINARY                    ,OR,97373-0505,Private      ,0,0,0,15,19,34
00320400,MOUNT HOOD COMMUNITY COLLEGE            ,OR,97030-3300,Public       ,50,112,162,3285,5174,8459
00320600,MULTNOMAH BIBLE COLLEGE/SEMINARY        ,OR,97220-5898,Private      ,0,7,7,548,658,1206
00320700,PACIFIC NORTHWEST COLLEGE OF ART        ,OR,97209-3023,Private      ,4,2,6,604,452,1056
00320800,NORTHWEST CHRISTIAN UNIVERSITY          ,OR,97401-3727,Private      ,0,2,2,559,539,1098
00320900,WESTERN OREGON UNIVERSITY               ,OR,97361-1394,Public       ,9,29,38,5067,2015,7082
00321000,OREGON STATE UNIVERSITY                 ,OR,97331-8507,Public       ,46,58,104,16306,7635,23941
00321100,OREGON INSTITUTE OF TECHNOLOGY          ,OR,97601-8801,Public       ,3,20,23,1862,1639,3501
00321200,PACIFIC UNIVERSITY                      ,OR,97116-1797,Private      ,5,20,25,2500,2735,5235
00321300,PORTLAND COMMUNITY COLLEGE              ,OR,97219-7198,Public       ,209,760,969,8646,19957,28603
00321600,PORTLAND STATE UNIVERSITY               ,OR,97207-0000,Public       ,88,330,418,11418,17798,29216
00321700,REED COLLEGE                            ,OR,97202-8199,Private      ,1,4,5,2703,301,3004
00321800,CHEMEKETA COMMUNITY COLLEGE             ,OR,97309-1500,Public       ,30,148,178,3922,8665,12587
00321900,SOUTHERN OREGON UNIVERSITY              ,OR,97520-5010,Public       ,14,71,85,4261,2650,6911
00322000,SOUTHWESTERN OREGON COMMUNITY CLG       ,OR,97420-2956,Public       ,5,15,20,1347,1306,2653
00322100,TREASURE VALLEY COMMUNITY COLLEGE       ,OR,97914-3423,Public       ,23,106,129,1319,2153,3472
00322200,UMPQUA COMMUNITY COLLEGE                ,OR,97470-0226,Public       ,12,48,60,1122,2481,3603
00322300,UNIVERSITY OF OREGON                    ,OR,97403-1226,Public       ,77,129,206,17969,8968,26937
00322400,UNIVERSITY OF PORTLAND                  ,OR,97203-5798,Private      ,5,15,20,6518,1493,8011
00322500,WARNER PACIFIC COLLEGE                  ,OR,97215-4099,Private      ,3,79,82,595,1333,1928
00322700,WILLAMETTE UNIVERSITY                   ,OR,97301-3930,Private      ,2,7,9,3485,1495,4980
00487800,CLACKAMAS COMMUNITY COLLEGE             ,OR,97045-7998,Public       ,32,68,100,2382,3394,5776
00488200,OREGON HEALTH & SCIENCE UNIVERSITY      ,OR,97239-0000,Public       ,2,12,14,383,2945,3328
00488230,OREGON GRAD INST OF SCIENCE & TECH      ,OR,97006-0000,Public       ,0,0,0,9,31,40
00693800,LINN BENTON COMMUNITY COLLEGE           ,OR,97321-3774,Public       ,29,64,93,2987,3808,6795
00717800,WESTERN SEMINARY                        ,OR,97215-0000,Private      ,0,6,6,5,317,322
00723402,HEALD COLLEGE - PORTLAND                ,OR,97205-3432,Proprietary  ,5,33,38,255,888,1143
00781900,ART INSTITUTE OF PORTLAND (THE)         ,OR,97209-2911,Proprietary  ,17,26,43,1663,1527,3190
00888700,CONCORDE CAREER INSTITUTE               ,OR,97232-2242,Proprietary  ,19,98,117,340,1154,1494
00907900,EVEREST COLLEGE                         ,OR,97204-2296,Proprietary  ,26,86,112,261,1127,1388
00958100,SPRINGFIELD COLLEGE OF BEAUTY           ,OR,97477-5474,Proprietary  ,4,3,7,72,141,213
01012200,PHAGANS' MEDFORD BEAUTY SCHOOL          ,OR,97504-5297,Proprietary  ,3,8,11,64,154,218
01018200,ROGUE COMMUNITY COLLEGE                 ,OR,97527-0000,Public       ,14,49,63,1999,4519,6518
01050700,ACADEMY OF HAIR DESIGN                  ,OR,97301-3526,Proprietary  ,1,3,4,57,107,164
01185200,ITT TECHNICAL INSTITUTE                 ,OR,97220-0000,Proprietary  ,22,113,135,725,1544,2269
01230900,WESTERN STATES CHIROPRACTIC COLLEGE     ,OR,97230-3099,Private      ,0,2,2,26,492,518
01234700,PHAGANS CENTRAL OREGON BEAUTY CLG       ,OR,97701-5175,Proprietary  ,5,10,15,75,217,292
01234800,PHAGANS BEAUTY COLLEGE                  ,OR,97333-4716,Proprietary  ,2,6,8,65,87,152
01235000,PHAGANS SCHOOL OF HAIR DESIGN           ,OR,97267-4808,Proprietary  ,2,5,7,46,107,153
01235100,PHAGANS SCHOOL OF BEAUTY                ,OR,97301-4732,Proprietary  ,4,5,9,54,129,183
01300800,PHAGANS TIGARD BEAUTY SCHOOL            ,OR,97223-0000,Proprietary  ,0,1,1,25,73,98
02101000,NORTHWEST COLLEGE OF HAIR DESIGN        ,OR,97086-7702,Proprietary  ,3,30,33,111,230,341
02101002,NORTHWEST COLLEGE                       ,OR,97007-3954,Proprietary  ,0,0,0,10,18,28
02104900,COLLEGE OF LEGAL ARTS                   ,OR,97219-9998,Proprietary  ,4,25,29,47,298,345
02106100,COLLEGE OF COSMETOLOGY                  ,OR,97601-0000,Proprietary  ,1,10,11,33,98,131
02154400,BEAU MONDE CLG OF HAIR DESIGN           ,OR,97205-0000,Proprietary  ,3,22,25,109,216,325
02159700,EUGENE BIBLE COLLEGE                    ,OR,97405-0000,Private      ,0,0,0,91,109,200
02201900,PHAGANS' SCHOOL OF HAIR DESIGN          ,OR,97232-0000,Proprietary  ,2,22,24,128,291,419
02239203,ALLIED COLLEGE - ANTHEM COLLEGE         ,OR,97005-0000,Proprietary  ,1,4,5,41,92,133
02330100,PIONEER PACIFIC COLLEGE                 ,OR,97070-0000,Proprietary  ,12,108,120,372,1265,1637
02330102,PIONEER PACIFIC COLLEGE                 ,OR,97403-0000,Proprietary  ,8,94,102,149,920,1069
02337900,COLLEGE OF HAIR DESIGN CAREERS          ,OR,97301-0000,Proprietary  ,3,7,10,70,96,166
02344100,ROSEBURG BEAUTY COLLEGE                 ,OR,97470-0000,Proprietary  ,0,0,0,32,82,114
02534000,NATIONAL COLLEGE OF NATURAL MEDICINE    ,OR,97201-0000,Private      ,0,5,5,12,615,627
02578800,NORTHWEST NANNIES INSTITUTE             ,OR,97035-0000,Proprietary  ,2,0,2,34,20,54
02603700,OREGON COL OF ORIENTAL MEDICINE         ,OR,97216-0000,Private      ,0,1,1,5,349,354
02617506,EVEREST COLLEGE - EVEREST INSTITUTE     ,OR,97223-6581,Proprietary  ,9,38,47,96,329,425
03007300,OREGON COLLEGE OF ART & CRAFT           ,OR,97225-6399,Private      ,1,0,1,104,230,334
03022600,WESTERN CULINARY INSTITUTE              ,OR,97205-2793,Proprietary  ,40,86,126,1826,2431,4257
03042500,APOLLO COLLEGE                          ,OR,97232-1302,Proprietary  ,50,155,205,567,2087,2654
03074400,PHAGANS NEWPORT ACAD CSMTLGY CAREER     ,OR,97365-4963,Proprietary  ,1,7,8,34,75,109
03074500,EAST-WEST COLLEGE OF THE HEALING ARTS   ,OR,97232-2765,Proprietary  ,0,5,5,102,398,500
03185300,PHAGANS GRANTS PASS COLLEGE OF BTY      ,OR,97527-3039,Proprietary  ,2,0,2,51,96,147
03428300,KLAMATH COMMUNITY COLLEGE               ,OR,97603-7121,Public       ,7,17,24,413,1150,1563
03642300,VALLEY MEDICAL COLLEGE                  ,OR,97305-1373,Proprietary  ,1,5,6,43,210,253
03668300,BIRTHINGWAY COLLEGE OF MIDWIFERY        ,OR,97266-4042,Private      ,0,1,1,16,121,137
03783400,ABDILL CAREER COLLEGE                   ,OR,97504-7137,Proprietary  ,1,10,11,34,191,225
00137400,ALBERTUS MAGNUS COLLEGE                 ,CT,06511-1189,Private      ,1,13,14,811,1088,1899
00137403,ALBERTUS MAGNUS CLG-NEW DIMENSIONS      ,CT,06511-0000,Private      ,0,12,12,48,872,920
00137800,CENTRAL CONNECTICUT STATE UNIV          ,CT,06050-2490,Public       ,17,37,54,8619,3708,12327
00137900,CONNECTICUT COLLEGE                     ,CT,06320-4196,Private      ,1,1,2,2586,68,2654
00138000,WESTERN CONNECTICUT STATE UNIV          ,CT,06810-6826,Public       ,10,14,24,5022,1316,6338
00138500,FAIRFIELD UNIVERSITY                    ,CT,06430-0000,Private      ,6,23,29,6261,812,7073
00138700,HARTFORD SEMINARY                       ,CT,06105-0000,Private      ,0,0,0,10,25,35
00138900,HOLY APOSTLES COLLEGE & SEMINARY        ,CT,06416-2005,Private      ,0,1,1,9,56,65
00139200,MANCHESTER COMMUNITY COLLEGE            ,CT,06045-1046,Public       ,10,28,38,2717,2487,5204
00139300,MITCHELL COLLEGE                        ,CT,06320-4498,Private      ,1,3,4,1013,190,1203
00139700,UNIVERSITY OF NEW HAVEN                 ,CT,06516-1999,Private      ,8,29,37,5467,1673,7140
00139800,NORTHWESTERN CT COMMUNITY COLLEGE       ,CT,06098-1747,Public       ,2,8,10,482,468,950
00139900,NORWALK COMMUNITY TECHNICAL COLLEGE     ,CT,06854-1655,Public       ,5,11,16,1591,1843,3434
00140100,POST UNIVERSITY                         ,CT,06723-3240,Proprietary  ,10,52,62,1054,1376,2430
00140200,QUINNIPIAC UNIVERSITY                   ,CT,06518-1908,Private      ,23,10,33,12239,1365,13604
00140201,QUINNIPIAC UNIVERSITY SCHOOL OF LAW     ,CT,06518-0000,Private      ,0,3,3,128,1097,1225
00140300,SACRED HEART UNIVERSITY                 ,CT,06825-1000,Private      ,11,25,36,6901,1371,8272
00140600,SOUTHERN CONNECTICUT STATE UNIV         ,CT,06515-1355,Public       ,13,44,57,8794,4484,13278
00140900,SAINT JOSEPH COLLEGE                    ,CT,06117-2791,Private      ,1,17,18,1157,1004,2161
00141400,TRINITY COLLEGE                         ,CT,06106-3100,Private      ,7,6,13,2825,239,3064
00141600,UNIVERSITY OF BRIDGEPORT                ,CT,06601-5650,Private      ,8,18,26,2211,2346,4557
00141700,UNIVERSITY OF CONNECTICUT-STORRS        ,CT,06269-2151,Public       ,29,64,93,23930,5092,29022
00141702,UNIV CONN STAMFORD                      ,CT,06901-0000,Public       ,1,2,3,406,233,639
00141703,UNIV OF CONNECTICUT - TORINGTON         ,CT,06790-0000,Public       ,0,0,0,164,62,226
00141706,UNIV OF CONNECTICUT SCH LAW             ,CT,06105-0000,Public       ,0,1,1,28,1153,1181
00141707,UNIV OF CT - SCH OF SOCIAL WORK         ,CT,06117-0000,Public       ,0,4,4,68,480,548
00141708,UNIVERSITY OF CONNECTICUT - SCHOOL OF ME,CT,06030-1920,Public       ,0,1,1,14,481,495
00141709,UNIVERSITY OF CONNECTICUT - SCHOOL OF DE,CT,06030-1920,Public       ,0,0,0,5,183,188
00142200,UNIVERSITY OF HARTFORD                  ,CT,06117-1599,Private      ,6,13,19,9501,1557,11058
00142400,WESLEYAN UNIVERSITY                     ,CT,06459-3208,Private      ,1,0,1,4416,154,4570
00142500,EASTERN CONNECTICUT STATE UNIV          ,CT,06226-2295,Public       ,9,10,19,4982,1187,6169
00142600,YALE UNIVERSITY                         ,CT,06520-8288,Private      ,6,12,18,13833,6438,20271
00142601,YALE UNIV PHYSICIANS ASSOC PROG         ,CT,06510-0000,Private      ,0,0,0,4,88,92
00142602,YALE UNIV EPIDEMIOLOGY & PUB HLTH       ,CT,06510-0000,Private      ,0,0,0,6,278,284
00142603,YALE UNIV SCHOOL MEDICINE               ,CT,06510-0000,Private      ,0,2,2,36,810,846
00280301,RENSSELAER POLYTECHNIC INSTITUTE-RENSSEL,CT,06120-2991,Private      ,0,9,9,14,103,117
00451300,HOUSATONIC COMMUNITY COLLEGE            ,CT,06604-4704,Public       ,8,20,28,2068,3147,5215
00618100,BRIDGEPORT HOSP SCHL OF NURSING         ,CT,06610-2896,Private      ,1,2,3,76,263,339
00619100,ST. VINCENT'S COLLEGE                   ,CT,06606-9966,Private      ,1,4,5,218,501,719
00698200,NAUGATUCK VALLEY COMM-TECH COLG         ,CT,06708-3089,Public       ,8,21,29,2218,2371,4589
00730000,ELI WHITNEY TECHNICAL HIGH SCHOOL       ,CT,06514-0000,Public       ,0,0,0,19,81,100
00730300,LINCOLN TECHNICAL INSTITUTE             ,CT,06051-0000,Proprietary  ,28,86,114,1062,2195,3257
00730500,PORTER AND CHESTER INSTITUTE OF BRANFORD,CT,06405-4022,Proprietary  ,13,33,46,258,318,576
00731100,WINDHAM TECHNICAL HIGH SCHOOL           ,CT,06226-2100,Public       ,0,1,1,10,33,43
00745900,PAIER COLLEGE OF ART                    ,CT,06514-3902,Proprietary  ,0,0,0,163,53,216
00763500,CAPITAL COMMUNITY COLLEGE               ,CT,06103-1207,Public       ,4,16,20,1543,3467,5010
00803700,GATEWAY COMMUNITY-TECHNICAL COLLEGE     ,CT,06511-0000,Public       ,2,22,24,2296,3397,5693
00803800,MIDDLESEX COMMUNITY CLG                 ,CT,06457-4889,Public       ,4,13,17,927,1105,2032
00887200,RENASCI ACADEMY OF HAIR                 ,CT,06460-4160,Proprietary  ,2,3,5,15,28,43
00887300,PAUL MITCHELL THE SCHOOL                ,CT,06810-6716,Proprietary  ,2,5,7,82,72,154
00887400,BRIO ACADEMY OF COSMETOLOGY             ,CT,06450-4836,Proprietary  ,11,31,42,159,359,518
00887403,BRIO ACADEMY OF COSMETOLOGY - WILLIMANTI,CT,06226-1940,Proprietary  ,0,0,0,8,9,17
00906500,THE HARTFORD CONSERVATORY               ,CT,06105-2891,Private      ,0,0,0,49,19,68
00927700,E C GOODWIN TECHNICAL HIGH SCHOOL       ,CT,06053-0000,Public       ,0,0,0,19,39,58
00929100,J M WRIGHT TECHNICAL HIGH SCHOOL        ,CT,06904-0000,Public       ,0,0,0,11,21,32
00940700,BRIARWOOD COLLEGE                       ,CT,06489-1057,Proprietary  ,2,6,8,594,433,1027
00976400,TUNXIS COMMUNITY COLLEGE                ,CT,06032-3187,Public       ,10,44,54,1319,1602,2921
00976500,THREE RIVERS COMMUNITY TECH COLLEGE     ,CT,06360-0000,Public       ,6,54,60,1242,1996,3238
00982200,ALBERT I PRINCE TECHNICAL HIGH SCHOOL   ,CT,06106-3799,Public       ,0,0,0,14,49,63
01041700,BRIO ACADEMY OF EAST HARTFORD           ,CT,06108-2220,Proprietary  ,3,16,19,75,176,251
01053000,QUINEBAUG VALLEY COMMUNITY COLLEGE      ,CT,06239-1440,Public       ,0,3,3,683,1063,1746
01077900,PORTER AND CHESTER INSTITUTE-ALLCAMPUSES,CT,06615-7158,Proprietary  ,68,228,296,1363,2286,3649
01115000,ASNUNTUCK COMMUNITY COLLEGE             ,CT,06082-3800,Public       ,2,10,12,414,574,988
01149600,BULLARD HAVENS VOC TECH SCHOOL          ,CT,06610-3499,Public       ,0,0,0,9,78,87
01169700,VINAL REGIONAL VOC TECH SCHOOL          ,CT,06457-4918,Public       ,0,0,0,15,41,56
01184300,NORWICH TECHNICAL HIGH SCHOOL           ,CT,06360-7097,Public       ,0,0,0,8,36,44
01218500,H C WILCOX TECHNICAL HIGH SCHOOL        ,CT,06450-0000,Public       ,0,0,0,9,12,21
01242500,STONE ACADEMY                           ,CT,06514-4125,Proprietary  ,11,75,86,258,1425,1683
01242503,STONE ACADEMY -WATERBURY                ,CT,06705-3823,Proprietary  ,1,0,1,17,43,60
01242504,STONE ACADEMY -  EAST HARTFORD          ,CT,06118-0000,Proprietary  ,0,1,1,1,3,4
01287700,GIBBS COLLEGE                           ,CT,06855-1436,Proprietary  ,1,1,2,226,337,563
01291300,LEON INSTITUTE OF HAIR DESIGN           ,CT,06604-4226,Proprietary  ,0,7,7,15,73,88
01326400,HENRY ABBOTT TECHNICAL HIGH SCHOOL      ,CT,06811-4881,Public       ,0,0,0,10,37,47
02058900,HARVARD H ELLIS TECHNICAL HIGH SCHOOL   ,CT,06239-0000,Public       ,0,0,0,14,12,26
02074000,BRANFORD HALL CAREER INSTITUTE          ,CT,06405-0000,Proprietary  ,104,525,629,1198,5168,6366
02106600,FOX INSTITUTE OF BUSINESS               ,CT,06110-0000,Proprietary  ,3,56,59,123,462,585
02112300,RIDLEY LOWELL BUSINESS & TECH INST      ,CT,06320-0000,Proprietary  ,4,59,63,124,759,883
02112700,NORTH HAVEN ACADEMY                     ,CT,06473-3108,Proprietary  ,3,3,6,162,101,263
02115100,BUTLER BUSINESS SCHOOL                  ,CT,06604-0000,Proprietary  ,10,27,37,84,388,472
02148700,CONNECTICUT INST OF HAIR DESIGN         ,CT,06716-0000,Proprietary  ,0,2,2,34,45,79
02202500,NEW ENGLAND TRACTOR TRAILER SCH         ,CT,06071-2036,Proprietary  ,15,169,184,126,1181,1307
02213000,ELLA T GRASSO SOUTHEASTERN TECHNICAL HIG,CT,06340-0000,Public       ,0,0,0,3,10,13
02228800,BARAN INSTITUTE OF TECHNOLOGY           ,CT,06088-9631,Proprietary  ,25,32,57,1057,620,1677
02244900,GOODWIN COLLEGE                         ,CT,06118-9980,Private      ,25,155,180,558,2417,2975
02245300,HOWELL CHENEY TECHNICAL HIGH SCHOOL     ,CT,06040-0000,Public       ,0,0,0,4,20,24
02265900,WINDHAM COMMUNITY MEM HOSP-RAD TECH     ,CT,06226-0000,Private      ,0,1,1,9,15,24
02296100,YALE-NEW HAVEN HOSP DIETETIC INTERN     ,CT,06510-8900,Private      ,0,0,0,10,4,14
02300000,W F KAYNOR TECHNICAL HIGH SCHOOL        ,CT,06708-0000,Public       ,0,0,0,11,46,57
02316600,CONNECTICUT CTR FOR MASSAGE THERAPY     ,CT,06111-3975,Proprietary  ,1,19,20,56,314,370
02316601,CONNECTICUT CENTER FOR MASSAGE THERAPY -,CT,06880-4619,Proprietary  ,2,8,10,42,185,227
02316603,CONNECTICUT CENTER FOR MASSAGE THERAPY -,CT,06340-4619,Proprietary  ,1,7,8,41,146,187
02562400,EMMETT O BRIEN REG VOC TECH SCHOOL      ,CT,06401-2500,Public       ,0,0,0,1,2,3
02565000,PLATT TECHNICAL HIGH SCHOOL             ,CT,06460-2105,Public       ,0,0,0,8,20,28
03079400,LYME ACADEMY COLLEGE OF FINE ARTS       ,CT,06371-2333,Private      ,0,0,0,82,37,119
03094800,INDUSTRIAL MANAGEMENT & TRAINING        ,CT,06706-1211,Proprietary  ,0,0,0,47,176,223
03231400,OLIVER WOLCOTT TECHNICAL HIGH SCHOOL    ,CT,06790-3859,Public       ,0,0,0,5,2,7
03234300,CHARTER OAK STATE COLLEGE               ,CT,06053-2150,Public       ,0,20,20,77,928,1005
03316300,CONNECTICUT CULINARY INSTITUTE          ,CT,06105-3630,Proprietary  ,2,5,7,495,398,893
03381300,CONNECTICUT TRAINING CENTER             ,CT,06108-2705,Private      ,6,37,43,64,371,435
03927300,ALBERT SCHOOL (THE)                     ,CT,06357-2447,Proprietary  ,4,9,13,76,115,191
04053300,CLEMENS COLLEGE                         ,CT,06078-0000,Proprietary  ,1,0,1,111,19,130
04104300,ACADEMY DI CAPELLI - SCHOOL OF COSMETOLO,CT,06492-0000,Proprietary  ,1,4,5,30,50,80
04128800,BRANFORD ACADEMY OF HAIR & COSMETOLOGY  ,CT,06405-0000,Proprietary  ,2,3,5,21,43,64
00146600,BARRY UNIVERSITY                        ,FL,33161-6695,Private      ,38,93,131,4164,7672,11836
00146601,BARRY UNIVERSITY SCHOOL OF LAW          ,FL,32807-0000,Private      ,1,10,11,50,1398,1448
00146700,BETHUNE COOKMAN UNIVERSITY              ,FL,32114-3099,Private      ,51,14,65,7111,1343,8454
00146800,ST THOMAS UNIVERSITY                    ,FL,33054-0000,Private      ,11,61,72,1214,2755,3969
00146900,FLORIDA INSTITUTE OF TECHNOLOGY         ,FL,32901-6988,Private      ,29,321,350,3316,4658,7974
00147000,BREVARD COMMUNITY COLLEGE               ,FL,32922-6503,Public       ,117,353,470,4418,7031,11449
00147100,CENTRAL FLORIDA COMMUNITY COLLEGE       ,FL,34478-1388,Public       ,76,253,329,3589,5536,9125
00147200,CHIPOLA  COLLEGE                        ,FL,32446-2053,Public       ,8,27,35,861,1061,1922
00147300,CLEARWATER CHRISTIAN COLLEGE            ,FL,33759-0000,Private      ,3,1,4,796,92,888
00147500,DAYTONA STATE COLLEGE                   ,FL,32114-2800,Public       ,133,430,563,5990,10482,16472
00147700,EDISON COLLEGE                          ,FL,33906-6210,Public       ,76,266,342,5080,6461,11541
00147800,EDWARD WATERS COLLEGE                   ,FL,32209-6199,Private      ,9,12,21,1311,682,1993
00147900,EMBRY-RIDDLE AERONAUTICAL UNIV          ,FL,32114-3900,Private      ,44,183,227,6599,4929,11528
00148000,FLORIDA A & M UNIVERSITY                ,FL,32307-3100,Public       ,218,84,302,14428,6906,21334
00148100,FLORIDA ATLANTIC UNIVERSITY             ,FL,33431-6498,Public       ,170,234,404,14172,10993,25165
00148101,FLORIDA ATLANTIC UNIVERSITY/DAVIE       ,FL,33314-0000,Public       ,9,44,53,837,2360,3197
00148103,FLORIDA ATLANTIC UNIV-JUPITER/PSL       ,FL,33458-0000,Public       ,6,10,16,435,564,999
00148200,FLORIDA COLLEGE                         ,FL,33617-5578,Private      ,1,3,4,431,40,471
00148400,FLORIDA COMMUNITY COLLEGE AT JAX        ,FL,32202-4030,Public       ,208,708,916,9501,19022,28523
00148500,FLORIDA KEYS COMMUNITY COLLEGE          ,FL,33040-4397,Public       ,7,41,48,358,741,1099
00148600,FLORIDA MEMORIAL UNIVERSITY             ,FL,33054-6199,Private      ,38,23,61,2357,1336,3693
00148700,ECKERD COLLEGE                          ,FL,33711-4744,Private      ,5,18,23,2504,892,3396
00148800,FLORIDA SOUTHERN COLLEGE                ,FL,33801-5698,Private      ,13,21,34,2180,761,2941
00148900,FLORIDA STATE UNIVERSITY                ,FL,32306-2430,Public       ,484,210,694,30269,14550,44819
00149000,GULF COAST COMMUNITY COLLEGE            ,FL,32401-1058,Public       ,35,160,195,1881,3560,5441
00149300,INDIAN RIVER STATE COLLEGE              ,FL,34981-5596,Public       ,108,327,435,4548,7282,11830
00149500,JACKSONVILLE UNIVERSITY                 ,FL,32211-3394,Private      ,31,139,170,3470,3011,6481
00149700,JONES COLLEGE                           ,FL,32211-5588,Private      ,2,22,24,107,962,1069
00149900,EVEREST UNIVERSITY                      ,FL,32810-5601,Proprietary  ,50,267,317,1090,8289,9379
00149901,EVEREST UNIVERSITY - ORLANDO SOUTH      ,FL,32819-7666,Proprietary  ,170,852,1022,1309,6788,8097
00149902,EVEREST UNIVERSITY - MELBOURNE          ,FL,32905-6609,Proprietary  ,39,220,259,315,2200,2515
00150000,BROWARD COLLEGE- DOWNTOWN CTR           ,FL,33301-2208,Public       ,169,414,583,6047,9605,15652
00150001,BROWARD COLLEGE - DAVIE CAMPUS          ,FL,33314-0000,Public       ,128,170,298,6284,6187,12471
00150002,BROWARD COLLEGE- NORTH CAMPUS           ,FL,33066-0000,Public       ,62,133,195,1977,2264,4241
00150003,BROWARD COLLEGE- SOUTH CAMPUS           ,FL,33024-0000,Public       ,74,121,195,2216,2471,4687
00150100,LAKE CITY COMMUNITY COLLEGE             ,FL,32025-2007,Public       ,23,112,135,948,2201,3149
00150200,LAKE SUMTER COMMUNITY COLLEGE           ,FL,34788-8751,Public       ,32,87,119,1582,2305,3887
00150400,MANATEE COMMUNITY COLLEGE               ,FL,34207-3596,Public       ,137,357,494,4437,6755,11192
00150500,LYNN UNIVERSITY                         ,FL,33431-5598,Private      ,8,19,27,1449,635,2084
00150600,MIAMI DADE COLLEGE ADMINISTRATION ONLY  ,FL,33176-3393,Public       ,14,43,57,662,849,1511
00150601,MIAMI DADE COLLEGE - NORTH CAMPUS       ,FL,33167-3495,Public       ,212,484,696,9551,12125,21676
00150602,MIAMI DADE COLLEGE - KENDALL CAMPUS     ,FL,33176-3393,Public       ,426,494,920,13362,10709,24071
00150603,MIAMI DADE COLLEGE - WOLFSON CAMPUS     ,FL,33132-2297,Public       ,215,307,522,5797,6457,12254
00150604,MIAMI DADE COLLEGE - MEDICAL CAMPUS     ,FL,33127-4693,Public       ,31,115,146,1296,3574,4870
00150605,MIAMI DADE COLLEGE - HOMESTEAD CAMPUS   ,FL,33030-6009,Public       ,61,104,165,1514,2153,3667
00150606,MIAMI DADE COLLEGE -INTERAMERICAN CAMPUS,FL,33135-0000,Public       ,96,216,312,2845,5063,7908
00150607,MIAMI DADE COLLEGE - HIALEAH CAMPUS     ,FL,33012-2918,Public       ,62,97,159,1841,2433,4274
00150800,NORTH FLORIDA COMMUNITY COLLEGE         ,FL,32340-1699,Public       ,9,18,27,493,770,1263
00150900,NOVA SOUTHEASTERN UNIVERSITY            ,FL,33314-7796,Private      ,50,907,957,4442,30979,35421
00151000,NORTHWEST FLORIDA STATE COLLEGE         ,FL,32578-1295,Public       ,32,129,161,1705,3688,5393
00151200,PALM BEACH COMMUNITY COLLEGE            ,FL,33461-4796,Public       ,201,437,638,8981,10712,19693
00151300,PENSACOLA JR COLLEGE                    ,FL,32504-8998,Public       ,101,269,370,3832,6777,10609
00151400,POLK COMMUNITY COLLEGE                  ,FL,33881-4299,Public       ,64,201,265,2851,4456,7307
00151500,ROLLINS COLLEGE                         ,FL,32789-4499,Private      ,15,21,36,2239,1270,3509
00151900,SANTA FE COLLEGE                        ,FL,32606-6200,Public       ,137,192,329,7328,5919,13247
00152000,SEMINOLE COMMUNITY COLLEGE              ,FL,32773-6199,Public       ,142,507,649,5339,8873,14212
00152100,SOUTHEASTERN UNIVERSITY                 ,FL,33801-6099,Private      ,7,28,35,2679,1366,4045
00152200,SOUTH FLORIDA COMMUNITY COLLEGE         ,FL,33825-9399,Public       ,16,69,85,1107,1754,2861
00152300,ST JOHNS RIVER COMMUNITY COLLEGE        ,FL,32177-3897,Public       ,40,142,182,1851,3082,4933
00152600,SAINT LEO UNIVERSITY                    ,FL,33574-6665,Private      ,23,420,443,2989,11115,14104
00152800,ST. PETERSBURG COLLEGE                  ,FL,33760-3768,Public       ,160,649,809,6782,15196,21978
00153100,STETSON UNIVERSITY                      ,FL,32723-3761,Private      ,16,40,56,2728,735,3463
00153101,STETSON UNIVERSITY - COLLEGE OF LAW     ,FL,33707-3299,Private      ,1,5,6,45,1838,1883
00153300,TALLAHASSEE COMMUNITY COLLEGE           ,FL,32304-2895,Public       ,106,288,394,7855,7322,15177
00153400,EVEREST UNIVERSITY                      ,FL,33614-5801,Proprietary  ,81,376,457,1003,9606,10609
00153408,EVEREST UNIVERSITY - TAMPA BRANDON CAMPU,FL,33619-1354,Proprietary  ,156,1770,1926,975,8993,9968
00153409,EVEREST UNIVERSITY - ORANGE PARK        ,FL,32073-1111,Proprietary  ,46,153,199,440,2075,2515
00153500,UNIVERSITY OF FLORIDA                   ,FL,32611-3150,Public       ,446,199,645,30351,16642,46993
00153600,UNIVERSITY OF MIAMI                     ,FL,33146-6531,Private      ,47,69,116,14313,4999,19312
00153601,UNIV OF MIAMI SCHOOL OF LAW             ,FL,33124-0000,Private      ,1,4,5,68,1725,1793
00153602,UNIV OF MIAMI-SCH OF MEDICINE           ,FL,33136-0000,Private      ,1,4,5,519,1184,1703
00153700,UNIVERSITY OF SOUTH FLORIDA             ,FL,33620-6960,Public       ,409,377,786,27912,19822,47734
00153701,UNIV OF SOUTH FLORIDA-ST PETERSBURG     ,FL,33701-0000,Public       ,9,11,20,703,826,1529
00153702,UNIV OF SOUTH FLORIDA-SARASOTA          ,FL,34243-0000,Public       ,2,12,14,242,618,860
00153705,UNIV OF SOUTH FLORIDA                   ,FL,33803-0000,Public       ,3,9,12,527,538,1065
00153706,UNIV OF SOUTH FLORIDA- MEDICINE         ,FL,33612-0000,Public       ,8,6,14,796,1020,1816
00153800,UNIVERSITY OF TAMPA                     ,FL,33606-1490,Private      ,26,58,84,6588,1861,8449
00154000,WEBBER INTERNATIONAL UNIVERSITY         ,FL,33827-0096,Private      ,3,2,5,648,185,833
00173308,NATIONAL-LOUIS UNIVERSITY               ,FL,33609-0000,Private      ,0,3,3,3,75,78
00177201,TRINITY INTERNATIONAL UNIVERSITY - SOUTH,FL,33324-4611,Private      ,0,16,16,32,401,433
00395400,UNIV OF CENTRAL FLORIDA                 ,FL,32816-0001,Public       ,607,369,976,37387,17935,55322
00395500,UNIVERSITY OF WEST FLORIDA              ,FL,32514-5750,Public       ,36,136,172,5306,5071,10377
00407215,NORTHWOOD UNIVERSITY                    ,FL,33409-0000,Private      ,5,8,13,559,287,846
00558500,LIVELY TECHNICAL CENTER                 ,FL,32304-0000,Public       ,4,25,29,336,1207,1543
00558501,LIVELY TECHNICAL CENTER - AVIATION SCHOO,FL,32304-8723,Public       ,0,1,1,15,51,66
00558600,LINDSEY HOPKINS TECHNICAL ED CENTER     ,FL,33127-4692,Public       ,19,64,83,240,933,1173
00559400,D G ERWIN TECHNICAL CENTER              ,FL,33610-8255,Public       ,15,75,90,514,1947,2461
00560500,PINELLAS TECH ED CTR-CLEARWATER         ,FL,33760-2194,Public       ,10,39,49,260,868,1128
00560700,SARASOTA COUNTY TECHNICAL INSTITUTE     ,FL,34233-0000,Public       ,5,16,21,176,690,866
00560800,TRAVISS TECHNICAL CENTER                ,FL,33803-0000,Public       ,2,17,19,218,851,1069
00561200,MANATEE TECHNICAL INSTITUTE             ,FL,34210-0000,Public       ,6,28,34,276,899,1175
00561201,MANATEE TECHNICAL INSTITUTE-EAST        ,FL,34211-0000,Public       ,2,14,16,149,671,820
00675000,VALENCIA COMMUNITY COLLEGE              ,FL,32802-3028,Public       ,437,635,1072,19259,17338,36597
00752500,SUWANNEE-HAMILTON AREA VOC TECH CTR     ,FL,32060-0000,Public       ,0,2,2,50,226,276
00752600,WASHINGTON HOLMES TECHNICAL CENTER      ,FL,32428-1699,Public       ,6,23,29,140,528,668
00755800,LEE COUNTY HIGH TECH CENTER CENTRAL     ,FL,33916-2299,Public       ,9,20,29,298,775,1073
00758600,REMINGTON COLLEGE - TAMPA CAMPUS        ,FL,33612-8410,Proprietary  ,12,40,52,177,677,854
00758604,REMINGTON COLLEGE-LARGO CAMPUS          ,FL,33771-0000,Proprietary  ,0,1,1,8,54,62
00758605,REMINGTON COLLEGE-JACKSONVILLE CAMPUS   ,FL,32256-6932,Proprietary  ,0,0,0,7,15,22
00787000,HILLSBOROUGH COMMUNITY COLLEGE          ,FL,33606-3572,Public       ,194,491,685,10693,14077,24770
00789300,FLAGLER COLLEGE                         ,FL,32085-1027,Private      ,7,5,12,2734,482,3216
00789301,FLAGLER COLLEGE - TALLAHASSEE COMMUNITY ,FL,32304-2895,Private      ,3,8,11,116,335,451
00807500,ST JOHN VIANNEY COLLEGE SEMINARY        ,FL,33165-3244,Private      ,0,0,0,17,5,22
00814600,EVEREST UNIVERSITY - POMPANO BEACH      ,FL,33062-2522,Proprietary  ,57,265,322,643,3212,3855
00822300,ST VINCENT DE PAUL REGIONL SEMINARY     ,FL,33436-0000,Private      ,0,1,1,0,8,8
00841700,STENOTYPE INST OF JACKSONVILLE          ,FL,32207-0000,Proprietary  ,3,27,30,87,489,576
00850100,RASMUSSEN COLLEGE                       ,FL,34471-7051,Proprietary  ,46,213,259,422,2237,2659
00850103,RASMUSSEN COLLEGE-HOLIDAY               ,FL,34690-0000,Proprietary  ,10,47,57,185,919,1104
00850106,RASMUSSEN COLLEGE - FORT MYERS          ,FL,33905-7805,Proprietary  ,12,28,40,107,383,490
00884800,WARNER SOUTHERN COLLEGE                 ,FL,33859-8725,Private      ,4,25,29,591,809,1400
00884900,PALM BEACH ATLANTIC UNIVERSITY          ,FL,33401-6505,Private      ,5,42,47,2427,2138,4565
00887800,MIAMI INTERNATIONAL UNIV ART&DESIGN     ,FL,33132-1418,Proprietary  ,64,87,151,3099,2460,5559
00910400,RIVERSIDE HAIRSTYLING ACADEMY           ,FL,32207-3810,Proprietary  ,2,5,7,23,97,120
00963500,FLORIDA INTERNATIONAL UNIVERSITY        ,FL,33199-0001,Public       ,554,416,970,23045,20676,43721
00984100,UNIVERSITY OF NORTH FLORIDA             ,FL,32224-2645,Public       ,310,176,486,10010,6887,16897
00990200,SHERIDAN TECHNICAL CENTER               ,FL,33021-3399,Public       ,26,64,90,555,1736,2291
01016100,"LORAINE'S ACADEMY, INC                  ",FL,33710-0000,Proprietary  ,9,29,38,51,233,284
01019500,ART INSTITUTE OF FT LAUDERDALE          ,FL,33316-3000,Proprietary  ,32,70,102,2397,2270,4667
01065200,PASCO-HERNANDO COMMUNITY CLG            ,FL,34654-5199,Public       ,96,257,353,3402,5600,9002
01072401,CARLOS ALBIZU UNIVERSITY                ,FL,33172-0000,Private      ,4,47,51,122,1261,1383
01082600,TOM P. HANEY TECHNICAL CENTER           ,FL,32405-5099,Public       ,3,21,24,120,591,711
01112700,GOODING INST OF NUR ANES BAY MED CT     ,FL,32401-0000,Public       ,0,0,0,3,58,61
01226300,ATLANTIC TECHNICAL CENTER               ,FL,33063-3902,Public       ,9,61,70,446,1302,1748
01254400,FIRST COAST TECHNICAL COLLEGE           ,FL,32084-1921,Public       ,4,17,21,194,675,869
01254401,FIRST COAST TECHNICAL INSTITUTE - PUTNAM,FL,32077-6830,Public       ,1,3,4,47,105,152
01257400,RINGLING SCHOOL OF ART AND DESIGN       ,FL,34234-5895,Private      ,4,1,5,1488,283,1771
01303904,SOUTH UNIVERSITY                        ,FL,33409-5149,Proprietary  ,11,83,94,344,1592,1936
01323400,LORENZO WALKER INST OF TECHNOLOGY       ,FL,34104-4405,Public       ,8,22,30,244,577,821
02052002,FLORIDA EDUCATION CENTER - LAUDERHILL   ,FL,33313-5857,Proprietary  ,0,1,1,112,440,552
02089600,CONCORDE CAREER INSTITUTE               ,FL,32211-0000,Proprietary  ,14,68,82,214,1176,1390
02089709,HERZING COLLEGE                         ,FL,32792-5509,Proprietary  ,0,9,9,27,99,126
02113609,AMERICAN INTERCONTINENTAL UNIV - WESTON ,FL,33326-3233,Proprietary  ,3,22,25,563,1129,1692
02115300,PINELLAS TECHNICAL EDUCATION CENTERS - S,FL,33711-0000,Public       ,7,52,59,198,990,1188
02116006,SANFORD-BROWN INSTITUTE - FT. LAUDERDALE,FL,33309-1906,Proprietary  ,5,43,48,320,1119,1439
02121800,EVEREST INSTITUTE                       ,FL,33169-4759,Proprietary  ,52,155,207,515,1558,2073
02121801,EVEREST INSTITUTE  - HIALEAH            ,FL,33012-7193,Proprietary  ,53,128,181,683,1321,2004
02148200,FASHION FOCUS HAIR ACADEMY              ,FL,34231-0000,Proprietary  ,3,4,7,24,61,85
02148300,MANHATTAN BEAUTY SCHOOL                 ,FL,33611-0000,Proprietary  ,17,89,106,162,812,974
02149900,PAUL MITCHELL THE SCHOOL-JACKSONVILLE   ,FL,32205-0000,Proprietary  ,6,12,18,135,274,409
02151100,ATI COLLEGE OF HEALTH                   ,FL,33169-0000,Proprietary  ,60,166,226,486,2172,2658
02151900,KEISER  UNIVERSITY                      ,FL,33309-0000,Proprietary  ,216,1013,1229,4477,15703,20180
02156300,MARGATE SCHOOL OF BEAUTY                ,FL,33063-0000,Proprietary  ,14,91,105,14,91,105
02156700,FLORIDA CHRISTIAN COLLEGE               ,FL,34744-0000,Private      ,0,1,1,202,142,344
02159600,BAPTIST COLLEGE OF FLORIDA (THE)        ,FL,32440-0000,Private      ,0,2,2,289,297,586
02172700,CONCORDE CAREER INSTITUTE               ,FL,33607-0000,Proprietary  ,21,74,95,207,895,1102
02188900,HOBE SOUND BIBLE COLLEGE                ,FL,33475-0000,Private      ,0,0,0,88,50,138
02200100,BRADENTON BEAUTY & BARBER ACADEMY       ,FL,34209-0000,Proprietary  ,7,19,26,49,234,283
02215900,ATI CAREER TRAINING CENTER              ,FL,33309-1785,Proprietary  ,28,123,151,207,761,968
02218700,FLORIDA TECHNICAL COLLEGE               ,FL,32826-2707,Proprietary  ,25,103,128,447,1842,2289
02218707,FLORIDA TECHNICAL COLLEGE - LAKELAND    ,FL,33813-2101,Proprietary  ,5,54,59,19,202,221
02218709,FLORIDA TECHNICAL COLLEGE - DELAND      ,FL,32720-7415,Proprietary  ,0,3,3,22,83,105
02228300,LAKE TECHNICAL CENTER                   ,FL,32726-0000,Public       ,4,12,16,192,696,888
02245500,CENTRAL FLORIDA COLLEGE                 ,FL,32789-4679,Proprietary  ,13,99,112,232,1043,1275
02257900,INTERNATIONAL ACADEMY                   ,FL,32119-3541,Proprietary  ,9,26,35,115,314,429
02275100,CONCORDE CAREER INSTITUTE               ,FL,33025-0000,Proprietary  ,15,72,87,132,669,801
02278800,SOUTHWEST FLORIDA COLLEGE               ,FL,33907-0000,Private      ,31,137,168,578,1730,2308
02278801,SOUTHWEST FLORIDA COLLEGE - TAMPA       ,FL,33619-1344,Private      ,22,40,62,290,657,947
02278802,SOUTHWEST FLORIDA COLLEGE - INSTITUTUE O,FL,33928-9469,Private      ,0,0,0,0,1,1
02278803,SOUTHWEST FLORIDA COLLEGE - PORT CHARLOT,FL,33953-3100,Private      ,4,21,25,10,59,69
02279600,CORTIVA INSTITUTE - FLORIDA             ,FL,33781-0000,Proprietary  ,1,7,8,44,197,241
02280800,NEW ENGLAND INST TECH-PALM BEACH        ,FL,33407-0000,Proprietary  ,60,164,224,909,2120,3029
02283800,BEAUTY SCHOOLS OF AMERICA               ,FL,33012-3322,Proprietary  ,90,293,383,589,2545,3134
02286500,ITT TECHNICAL INSTITUTE                 ,FL,33634-7515,Proprietary  ,98,247,345,1414,3021,4435
02287100,LA BELLE BEAUTY SCHOOL                  ,FL,33012-0000,Proprietary  ,7,36,43,51,360,411
02293200,ATI CAREER TRAINING CENTER              ,FL,33309-0000,Proprietary  ,116,366,482,874,2660,3534
02293201,ATI CAREER TRAINING CENTER - MIAMI      ,FL,33122-0000,Proprietary  ,1,6,7,31,80,111
02293600,ADVANCED TECHNICAL CENTERS              ,FL,33266-1597,Private      ,1,1,2,5,27,32
02297000,CHARLOTTE TECHNICAL CENTER              ,FL,33948-0000,Public       ,1,8,9,146,472,618
02300900,WITHLACOOCHEE TECHNICAL INSTITUTE       ,FL,34450-0000,Public       ,5,15,20,198,533,731
02305700,GULF COAST COLLEGE                      ,FL,33619-0000,Proprietary  ,1,19,20,74,371,445
02305800,FLORIDA CAREER COLLEGE                  ,FL,33012-7028,Proprietary  ,227,613,840,2181,4725,6906
02307400,GEORGE STONE AREA VOCATIONAL TECHNICAL  ,FL,32526-0000,Public       ,11,56,67,171,756,927
02314100,SCHILLER INTERNATIONAL UNIVERSITY       ,FL,33770-3716,Proprietary  ,1,3,4,74,122,196
02316200,MIAMI LAKES TECHNICAL EDUCATION CTR     ,FL,33014-0000,Public       ,19,67,86,308,807,1115
02321200,ORANGE TECH EDUC CTR- WESTSIDE TECH     ,FL,34787-0000,Public       ,10,30,40,231,534,765
02325100,KEY COLLEGE                             ,FL,33004-3046,Proprietary  ,0,6,6,19,106,125
02326303,MEDVANCE INSTITUTE - WEST PALM          ,FL,33461-2171,Proprietary  ,44,107,151,389,953,1342
02326306,MEDVANCE INSTITUTE - MIAMI              ,FL,33173-3431,Proprietary  ,5,25,30,130,475,605
02326800,RESORT & SPA SCHOOLS INTERNATIONAL      ,FL,34233-0000,Proprietary  ,4,59,63,61,339,400
02326900,SUNSTATE ACADEMY OF HAIR DESIGN         ,FL,33907-1415,Proprietary  ,13,20,33,167,305,472
02329900,FLORIDA INSTITUTE OF ULTRASOUND         ,FL,32514-0000,Proprietary  ,0,5,5,32,141,173
02337000,SUNCOAST II THE TAMPA BAY SCHOOL OF MASS,FL,33607-3802,Proprietary  ,0,0,0,4,8,12
02338400,FT PIERCE BEAUTY ACADEMY                ,FL,34982-0000,Proprietary  ,9,59,68,124,450,574
02341001,FORTIS COLLEGE - DBA FORTIS INSTITUTE   ,FL,32504-7322,Proprietary  ,0,3,3,17,92,109
02346200,WYOTECH                                 ,FL,32174-1010,Proprietary  ,18,53,71,592,830,1422
02362100,FULL SAIL UNIVERSITY                    ,FL,32792-0000,Proprietary  ,103,326,429,8166,6231,14397
02499000,ACADEMY OF COSMETOLOGY                  ,FL,32953-3311,Proprietary  ,5,24,29,41,206,247
02501500,"O*TEC, MID-FLORIDA TECH                 ",FL,32809-0000,Public       ,9,31,40,339,710,1049
02502702,ADVANCED CAREER TRAINING-JACKSONVIL     ,FL,32256-0000,Proprietary  ,0,0,0,51,278,329
02504600,WINTER PARK TECH                        ,FL,32789-0000,Public       ,5,22,27,151,611,762
02508900,TALMUDIC COLLEGE OF FLORIDA             ,FL,33139-0000,Private      ,0,1,1,11,8,19
02511700,RIDGE TECHNICAL CENTER                  ,FL,33881-0000,Public       ,6,16,22,169,577,746
02513200,ORLANDO TECHNICAL CENTER                ,FL,32801-0000,Public       ,4,21,25,272,1025,1297
02515400,CITY COLLEGE                            ,FL,33309-3073,Private      ,22,136,158,400,1595,1995
02517100,SARASOTA SCHOOL OF MASSAGE THERAPY      ,FL,34243-6130,Proprietary  ,0,8,8,43,132,175
02524000,SUNSTATE ACADEMY OF HAIR DESIGN         ,FL,34624-0000,Proprietary  ,17,25,42,127,215,342
02524200,ROBERT MORGAN EDUCATIONAL CENTER        ,FL,33177-0000,Public       ,24,87,111,470,920,1390
02547600,FLORIDA NATIONAL COLLEGE                ,FL,33012-0000,Proprietary  ,73,220,293,1049,3471,4520
02554200,RADFORD LOCKLIN TECH CENTER             ,FL,32570-0000,Public       ,1,4,5,30,151,181
02573200,LA BELLE BEAUTY ACADEMY                 ,FL,33135-0000,Proprietary  ,7,54,61,47,285,332
02586200,FLORIDA CAREER COLLEGE                  ,FL,33759-3924,Proprietary  ,17,69,86,323,944,1267
02586201,FLORIDA CAREER COLLEGE -                ,FL,33569-2553,Proprietary  ,0,1,1,8,25,33
02597100,HERITAGE INSTITUTE                      ,FL,33912-7132,Proprietary  ,28,129,157,337,1272,1609
02598200,FLORIDA TECHNICAL CLG JACKSONVILLE      ,FL,32211-5123,Proprietary  ,4,34,38,99,439,538
02599800,EVEREST UNIVERSITY                      ,FL,33759-1359,Proprietary  ,46,160,206,343,1957,2300
02599801,EVEREST UNIVERSITY - TAMPA LAKELAND CAMP,FL,33801-3801,Proprietary  ,28,148,176,306,1807,2113
02599805,EVEREST UNIVERSITY - JACKSONVILLE       ,FL,32256-0000,Proprietary  ,45,174,219,521,2363,2884
02601600,HENRY W BREWSTER TECHNICAL CENTER       ,FL,33602-0000,Public       ,2,32,34,84,551,635
02612700,DARLYNE MCGEE'S ACAD OF COSMETOLOGY     ,FL,32905-2805,Proprietary  ,1,12,13,25,143,168
02616400,SANFORD-BROWN INSTITUTE                 ,FL,32256-3520,Proprietary  ,37,221,258,555,2432,2987
02616401,SANFORD-BROWN INSTITUTE - TAMPA         ,FL,33610-8304,Proprietary  ,5,55,60,252,1324,1576
03003200,EVEREST INSTITUTE                       ,FL,33186-1410,Proprietary  ,59,109,168,503,1110,1613
03003201,EVEREST INSTITUTE - FT. LAUDERDALE      ,FL,33304-2522,Proprietary  ,15,59,74,244,722,966
03003600,MCFATTER TECHNICAL CENTER               ,FL,33317-7499,Public       ,13,72,85,303,935,1238
03006801,PENNSYLVANIA CULINARY INSTITUTE - LE COR,FL,33025-3929,Proprietary  ,7,32,39,303,912,1215
03008600,FLORIDA COLLEGE OF NATURAL HEALTH       ,FL,33064-1342,Proprietary  ,13,71,84,351,1253,1604
03010608,VIRGINIA COLLEGE - PENSACOLA            ,FL,32501-5650,Proprietary  ,0,23,23,70,544,614
03010612,VIRGINIA COLLEGE - GOLF ACADEMY OF AMERI,FL,32701-0000,Proprietary  ,3,9,12,127,189,316
03012300,ASM BEAUTY WORLD ACADEMY                ,FL,33021-0000,Proprietary  ,2,13,15,21,176,197
03018500,BENE'S INTERNATIONAL SCHOOL OF BEAUTY   ,FL,34652-1637,Proprietary  ,1,20,21,108,283,391
03028200,TRINITY COLLEGE OF FLORIDA              ,FL,34655-4401,Private      ,3,2,5,138,129,267
03031400,INTERNATIONAL ACAD OF DESIGN & TECH     ,FL,33634-6313,Proprietary  ,80,225,305,3063,5105,8168
03031402,INTERNATIONAL ACADEMY OF DESIGN AND TECH,FL,32809-4633,Proprietary  ,15,20,35,648,629,1277
03031403,IADT - ORLANDO CULINARY ACADEMY         ,FL,32819-0000,Proprietary  ,3,7,10,329,384,713
03035800,HERITAGE INSTITUTE                      ,FL,32216-0948,Proprietary  ,17,87,104,131,618,749
03035900,NATIONAL AVIATION ACADEMY               ,FL,33760-3931,Proprietary  ,11,34,45,207,553,760
03037500,HODGES UNIVERSITY                       ,FL,34119-7932,Private      ,43,260,303,542,2785,3327
03054200,TECHNICAL CAREER INSTITUTE              ,FL,33144-2373,Proprietary  ,42,77,119,551,729,1280
03071600,COLLEGE OF BUSINESS & TECHNOLOGY        ,FL,33176-1412,Proprietary  ,18,155,173,175,1361,1536
03071601,COLLEGE OF BUSINESS & TECHNOLOGY -      ,FL,33144-2072,Proprietary  ,0,3,3,22,26,48
03071602,COLLEGE OF BUSINESS & TECHNOLOGY -      ,FL,33012-3436,Proprietary  ,0,0,0,4,9,13
03076402,HIGH-TECH INSTITUTE - ORLANDO           ,FL,32803-3509,Proprietary  ,2,8,10,118,227,345
03079800,GEORGE T BAKER AVIATION                 ,FL,33142-5687,Public       ,12,26,38,203,229,432
03079900,CITY COLLEGE                            ,FL,32707-5342,Private      ,4,41,45,56,347,403
03087600,ITT TECHNICAL INSTITUTE                 ,FL,32746-1607,Proprietary  ,73,185,258,1428,3167,4595
03089200,NOUVELLE INSTITUTE                      ,FL,33125-4141,Proprietary  ,6,57,63,50,548,598
03096300,FLORIDA CAREER INSTITUTE                ,FL,33860-0000,Proprietary  ,7,21,28,64,292,356
03099600,MERCY HOSPITAL SCHOOL OF PRACTICAL NSG  ,FL,33133-4237,Private      ,2,7,9,41,139,180
03100800,TAYLOR TECHNICAL INSTITUTE              ,FL,32348-0894,Public       ,3,10,13,96,231,327
03101900,TRINITY BAPTIST COLLEGE                 ,FL,32221-1398,Private      ,0,0,0,205,122,327
03103900,MARION COUNTY COMMUNITY TECH & ADUL     ,FL,34474-3172,Public       ,3,12,15,165,549,714
03108500,EVERGLADES UNIVERSITY                   ,FL,33431-0000,Private      ,7,78,85,164,1364,1528
03108600,COM-PU-MED VOCATIONAL CAREERS           ,FL,33012-4861,Proprietary  ,11,105,116,91,704,795
03113400,ACADEMY OF HEALING ARTS                 ,FL,33463-2113,Proprietary  ,4,14,18,42,135,177
03114700,PRAXIS INSTITUTE                        ,FL,33135-2657,Proprietary  ,8,59,67,72,588,660
03115500,FLORIDA HOSPITAL COLG OF HEALTH SCI     ,FL,32803-1237,Private      ,18,62,80,766,2124,2890
03123900,KEISER CAREER INSTITUTE                 ,FL,33413-0000,Proprietary  ,34,120,154,465,1609,2074
03125600,MIAMI AD SCHOOL                         ,FL,33139-5203,Proprietary  ,2,2,4,70,301,371
03127900,TECHNICAL EDUCATION CTR OSCEOLA         ,FL,34744-4459,Public       ,7,21,28,214,582,796
03139600,DELTA CONNECTION ACADEMY                ,FL,32773-9683,Proprietary  ,0,1,1,43,100,143
03158300,LEE COUNTY HIGH TECH CENTER NORTH       ,FL,33993-2479,Public       ,1,13,14,114,440,554
03171300,UNIVERSITY OF ST. AUGUSTINE FOR HEALTH S,FL,32084-4215,Proprietary  ,0,256,256,0,320,320
03178400,CORAL RIDGE NURSES ASST TRAINING        ,FL,33306-0000,Proprietary  ,0,0,0,7,65,72
03224300,NEW PROFESSIONS TECHNICAL INSTITUTE     ,FL,33134-1640,Proprietary  ,17,108,125,100,856,956
03230300,OKALOOSA APPLIED TECHNOLOGY CENTER      ,FL,32547-1299,Public       ,1,16,17,94,510,604
03238300,FLORIDA COLLEGE OF INTEGRATIVE MED      ,FL,32809-5721,Proprietary  ,0,2,2,23,175,198
03255300,FLORIDA GULF COAST UNIVERSITY           ,FL,33965-6565,Public       ,67,75,142,7177,3160,10337
03256300,YESHIVA GEDOLAH RABBINICAL COLLEGE      ,FL,33139-4708,Private      ,3,0,3,19,3,22
03264300,SOUTH FLORIDA BIBLE COLLEGE AND THEOLOGI,FL,33441-5768,Private      ,0,0,0,4,21,25
03346300,ACAD FOR PRAC NURSING & HEALTH OCCP     ,FL,33417-4574,Private      ,7,23,30,119,852,971
03348400,PROFESSIONAL TRAINING CENTERS           ,FL,33184-0000,Proprietary  ,11,68,79,131,647,778
03370300,AUDIO RECORDING TECHNOLOGY INSTITUTE    ,FL,32811-0000,Proprietary  ,3,4,7,88,98,186
03373300,BEACON COLLEGE                          ,FL,34748-5224,Private      ,0,0,0,83,28,111
03374300,FLORIDA COASTAL SCHOOL OF LAW           ,FL,32256-0000,Proprietary  ,0,4,4,19,2765,2784
03382300,BRADFORD-UNION AREA CAREERTECHNICAL CENT,FL,32091-2434,Public       ,0,4,4,44,204,248
03390300,AMERICARE SCHOOL OF NURSING             ,FL,32730-2351,Proprietary  ,10,78,88,109,665,774
03390301,AMERICARE SCHOOL OF NURSING - ST. PETERS,FL,33709-3142,Proprietary  ,0,0,0,8,15,23
03411400,INTERNATIONAL TRAINING CAREERS          ,FL,33155-1462,Private      ,1,65,66,49,460,509
03414500,SOUTHEAST INSTITUTE OF ORIENTAL MED     ,FL,33176-1509,Proprietary  ,2,10,12,16,165,181
03425400,CENTRAL FLORIDA INSTITUTE               ,FL,34684-4436,Proprietary  ,5,72,77,222,916,1138
03429600,ATLANTIC INST OF ORIENTAL MEDICINE      ,FL,33316-0000,Private      ,0,3,3,6,111,117
03429700,EAST WEST COLLG OF NATURAL MEDICINE     ,FL,34236-4959,Proprietary  ,1,1,2,7,138,145
03433400,NEW CONCEPT MASSAGE AND BEAUTY SCHO     ,FL,33135-0000,Proprietary  ,1,16,17,12,103,115
03434300,NORTH FLORIDA INSTITUTE                 ,FL,32073-2999,Proprietary  ,32,69,101,191,818,1009
03459400,SAINT PETERSBURG THEOLOGICAL SEMINA     ,FL,33708-3116,Private      ,0,2,2,8,60,68
03480301,MEDVANCE INSTITUTE - FORT LAUDERDALE    ,FL,33313-7261,Proprietary  ,17,81,98,200,895,1095
03480302,MEDVANCE INSTITUTE - STUART             ,FL,34994-3000,Proprietary  ,0,6,6,99,464,563
03491400,AMERICAN ADVANCED TECHNICIANS INST      ,FL,33014-4430,Proprietary  ,2,3,5,25,73,98
03549300,ULTIMATE MEDICAL ACADEMY                ,FL,33756-5802,Proprietary  ,59,295,354,452,2457,2909
03553300,KEISER CAREER COLLEGE                   ,FL,32216-0000,Proprietary  ,2,20,22,37,138,175
03557300,NORTH FLORIDA COSMETOLOGY INSTITUTE     ,FL,32312-0000,Proprietary  ,2,17,19,51,187,238
03564300,SUPERIOR CAREER INSTITUTE               ,FL,33311-1141,Proprietary  ,5,27,32,27,203,230
03570400,ENGLISH CENTER (THE)                    ,FL,33133-2703,Public       ,2,31,33,25,220,245
03595400,ANGLEY COLLEGE                          ,FL,32720-4257,Proprietary  ,11,68,79,70,437,507
03611400,FLORIDA BARBER ACADEMY                  ,FL,33441-0000,Proprietary  ,4,28,32,49,196,245
03618300,FLORIDA INSTITUTE OF ANIMAL ARTS        ,FL,32792-1740,Proprietary  ,10,11,21,90,220,310
03627400,JACKSONVILLE BEAUTY INSTITUTE           ,FL,32208-1885,Proprietary  ,7,55,62,44,386,430
03627600,FLORIDA EDUCATION INSTITUTE             ,FL,33144-5036,Proprietary  ,9,49,58,86,437,523
03661400,SOUTH FLORIDA INSTITUTE OF TECHNOLO     ,FL,33135-0000,Proprietary  ,20,149,169,98,855,953
03696400,SABER                                   ,FL,33134-1604,Private      ,3,57,60,20,422,442
03706300,AMERICAN INSTITUTE                      ,FL,33319-5613,Proprietary  ,12,94,106,155,658,813
03757300,ADVANCE SCIENCE INSTITUTE               ,FL,33012-0000,Proprietary  ,5,27,32,33,169,202
03801400,BEAUTY INSTITUTE (THE)                  ,FL,33409-2972,Proprietary  ,2,10,12,34,163,197
03801401,BEAUTY INSTITUTE (THE) - MARGATE        ,FL,33068-5704,Proprietary  ,0,0,0,5,18,23
03816300,ARTISTIC NAILS & BEAUTY ACADEMY         ,FL,33605-5919,Proprietary  ,9,41,50,73,325,398
03823300,FLORIDA ACADEMY OF HEALTH & BEAUTY      ,FL,33311-0000,Proprietary  ,2,7,9,10,73,83
03832300,DADE MEDICAL COLLEGE                    ,FL,33125-4013,Proprietary  ,21,68,89,216,785,1001
03842500,CAMBRIDGE INSTITUTE OF ALLIED HEALTH    ,FL,32750-0000,Proprietary  ,3,22,25,28,191,219
03856300,UNIVERSAL BEAUTY SCHOOL                 ,FL,33174-4406,Proprietary  ,2,16,18,20,155,175
03866300,GALIANO CAREER ACADEMY                  ,FL,32701-0000,Proprietary  ,15,63,78,128,625,753
03875300,MEDICAL CAREER INSTITUTE OF SOUTH FLORID,FL,33407-2103,Proprietary  ,4,43,47,62,438,500
03888300,DRAGON RISES COLLEGE OF ORIENTAL MEDICIN,FL,32601-5089,Proprietary  ,0,2,2,7,55,62
03903500,SOUTHERN TECHNICAL COLLEGE              ,FL,32809-0000,Proprietary  ,15,120,135,177,827,1004
03906300,CAREER INSTITUTE OF FLORIDA             ,FL,33773-3434,Proprietary  ,1,36,37,36,386,422
03911300,TOTAL INTERNATIONAL CAREER INSTITUTE    ,FL,33012-0000,Proprietary  ,3,45,48,13,145,158
03939300,WOLFORD COLLEGE                         ,FL,34108-1931,Private      ,0,0,0,6,251,257
03939400,CENTURA INSTITUTE                       ,FL,32807-3566,Proprietary  ,5,28,33,53,274,327
03939600,DAYTONA COLLEGE                         ,FL,32174-8445,Proprietary  ,3,15,18,49,126,175
03941300,AVE MARIA UNIVERSITY                    ,FL,34142-9505,Private      ,4,2,6,595,138,733
03957400,NEW COLLEGE OF FLORIDA                  ,FL,34243-2109,Public       ,3,2,5,1173,137,1310
03985300,COMMERCIAL DIVING ACADEMY               ,FL,32208-0000,Proprietary  ,12,30,42,167,545,712
03985400,SPACE COAST HEALTH INSTITUTE            ,FL,32904-8771,Proprietary  ,0,0,0,10,51,61
03986300,ARI BEN AVIATOR                         ,FL,34946-0000,Proprietary  ,1,2,3,21,42,63
04016500,AMERICAN INSTITUTE OF BEAUTY            ,FL,33773-0000,Proprietary  ,11,29,40,59,226,285
04029300,TRENDSETTERS OF FLORIDA SCHOOL OF BEAUTY,FL,32205-0000,Proprietary  ,2,2,4,20,70,90
04058300,HEALTH OPPORTUNITY TECHNICAL CENTER     ,FL,33169-4517,Proprietary  ,0,4,4,11,214,225
04083400,INSTITUTE OF ALLIED MEDICAL PROFESSIONS ,FL,33484-6543,Proprietary  ,2,10,12,2,10,12
04105400,PENSACOLA SCHOOL OF MASSAGE THERAPY & HE,FL,32504-7337,Proprietary  ,2,11,13,40,166,206
04106300,PALM BEACH ACADEMY OF HEALTH & BEAUTY   ,FL,33403-2130,Proprietary  ,2,2,4,37,115,152
04116600,PROFESSIONAL HEALTH TRAINING ACADEMY    ,FL,34480-8714,Proprietary  ,2,2,4,22,215,237
04119400,AVEDA INSTITUTE - SAINT PETERSBURG      ,FL,33701-4242,Proprietary  ,31,43,74,240,302,542
04120400,HI-TECH SCHOOL OF COSMETOLOGY           ,FL,33174-0000,Proprietary  ,2,6,8,64,119,183
04120500,ACADEMY OF PROFESSIONAL CAREERS         ,FL,32792-4433,Proprietary  ,0,1,1,29,43,72
04126900,ACADEMY OF CAREER TRAINING              ,FL,34741-4644,Proprietary  ,5,11,16,79,204,283
04127400,DIGITAL MEDIA ARTS COLLEGE              ,FL,33431-5919,Proprietary  ,9,4,13,320,202,522
04128400,MANAGEMENT RESOURCES INSTITUTE          ,FL,33134-1586,Proprietary  ,0,48,48,9,264,273
04129900,FLORIDA SCHOOL OF MASSAGE               ,FL,32608-5419,Proprietary  ,11,18,29,55,182,237
04130400,SHEAR EXCELLENCE INTERNATIONAL HAIR ACAD,FL,33614-2783,Private      ,2,16,18,15,100,115
04131900,FASTTRAIN OF MIAMI                      ,FL,33134-1065,Proprietary  ,9,44,53,78,346,424
04132000,FASTTRAIN OF FORT LAUDERDALE            ,FL,33311-1506,Proprietary  ,1,19,20,19,146,165
04132100,FASTTRAIN OF TAMPA                      ,FL,33607-4153,Proprietary  ,2,24,26,27,191,218
04132200,FASTTRAIN OF JACKSONVILLE               ,FL,32256-4843,Proprietary  ,0,23,23,23,174,197
04133500,ACADEMY FOR FIVE ELEMENT ACUPUNCTURE    ,FL,32601-6811,Private      ,0,6,6,4,71,75
04134800,AVEDA INSTITUTE - TALLAHASSEE           ,FL,32304-3186,Proprietary  ,5,6,11,71,89,160
04134900,ORANGE PARK BEAUTY ACADEMY              ,FL,32073-5524,Proprietary  ,1,16,17,8,59,67
04135000,COZMO THE SCHOOL                        ,FL,34135-4810,Proprietary  ,3,13,16,25,78,103
04135900,ALLIED HEALTH INSTITUTE                 ,FL,33309-1900,Proprietary  ,2,44,46,12,214,226
04140800,NORTH FLORIDA ACADEMY                   ,FL,32065-7758,Proprietary  ,3,4,7,8,12,20
04143100,PROFESSIONAL HANDS INSTITUTE            ,FL,33135-1939,Proprietary  ,4,29,33,4,29,33
04145900,CELEBRITY SCHOOL OF BEAUTY              ,FL,33144-4153,Proprietary  ,1,44,45,1,44,45
04148500,MEDICAL INSTITUTE OF PALM BEACH         ,FL,33460-5042,Proprietary  ,0,1,1,0,1,1
00160500,CHAMINADE UNIV OF HONOLULU              ,HI,96816-1578,Private      ,6,32,38,1370,1501,2871
00160600,BRIGHAM YOUNG UNIV-HAWAII CAMPUS        ,HI,96762-1294,Private      ,7,14,21,929,683,1612
00161000,UNIVERSITY OF HAWAII AT MANOA           ,HI,96822-2399,Public       ,30,55,85,9887,6919,16806
00161100,UNIVERSITY OF HAWAII AT HILO            ,HI,96720-4091,Public       ,11,7,18,2873,1932,4805
00161200,HONOLULU COMMUNITY COLLEGE              ,HI,96817-4598,Public       ,2,17,19,1224,1295,2519
00161300,KAPIOLANI COMMUNITY COLLEGE             ,HI,96816-4421,Public       ,23,41,64,2082,2155,4237
00161400,KAUAI COMMUNITY COLLEGE                 ,HI,96766-9591,Public       ,2,5,7,282,370,652
00161500,MAUI COMMUNITY COLLEGE                  ,HI,96732-1644,Public       ,8,30,38,1051,1677,2728
00454900,LEEWARD COMMUNITY COLLEGE               ,HI,96782-3393,Public       ,16,28,44,1745,1942,3687
00525800,HAWAII COMMUNITY COLLEGE                ,HI,96720-4075,Public       ,5,13,18,1145,1490,2635
00723401,HEALD COLLEGE - HONOLULU                ,HI,96814-0000,Proprietary  ,41,66,107,832,1103,1935
00727900,HAWAII PACIFIC UNIVERSITY               ,HI,96813-2882,Private      ,9,43,52,3627,3060,6687
00777500,HOLLYWOOD BEAUTY COLLEGE                ,HI,96701-4100,Proprietary  ,0,0,0,4,10,14
01122000,WINDWARD COMMUNITY COLLEGE              ,HI,96744-0000,Public       ,11,14,25,595,828,1423
02100300,MED-ASSIST SCHOOL OF HAWAII             ,HI,96813-0000,Proprietary  ,3,8,11,64,126,190
02107800,UNIVERSITY OF HAWAII - WEST OAHU        ,HI,96782-0000,Public       ,3,8,11,547,859,1406
02139500,HAWAII INSTITUTE OF HAIR DESIGN         ,HI,96817-5195,Proprietary  ,2,8,10,30,119,149
02208704,SAN DIEGO GOLF ACADEMY - THE GOLF ACADEM,HI,96744-3724,Proprietary  ,0,0,0,4,4,8
02321300,HAWAI'I THEOLOGICAL SEMINARY            ,HI,96817-0000,Private      ,0,0,0,2,7,9
03017800,TRAVEL INSTITUTE OF THE PACIFIC         ,HI,96814-1946,Proprietary  ,3,12,15,52,190,242
03020800,NEW YORK TECHNICAL INST OF HAWAII       ,HI,96817-4415,Proprietary  ,0,0,0,15,22,37
03072500,WORLD MEDICINE INSTITUTE                ,HI,96826-0000,Private      ,0,0,0,12,63,75
03649300,HAWAII TECHNOLOGY INSTITUTE             ,HI,96813-3036,Private      ,0,0,0,25,56,81
03735300,INST OF CLINICAL ACUPUNCTURE & ORIENT MD,HI,96813-2307,Proprietary  ,0,0,0,1,37,38
03999400,TRADITIONAL CHINESE MEDICAL COLLEGE OF H,HI,96743-8324,Private      ,0,0,0,2,38,40
00161600,BOISE STATE UNIVERSITY                  ,ID,83725-1000,Public       ,57,192,249,9631,11613,21244
00161700,"COLLEGE OF IDAHO, THE                   ",ID,83605-4432,Private      ,0,8,8,1185,263,1448
00161900,COLLEGE OF SOUTHERN IDAHO               ,ID,83301-0000,Public       ,36,143,179,2575,3640,6215
00161908,COLLEGE OF WESTERN IDAHO                ,ID,83687-1515,Public       ,6,56,62,6,56,62
00162000,IDAHO STATE UNIVERSITY                  ,ID,83209-5377,Public       ,36,113,149,4519,8104,12623
00162100,LEWIS-CLARK STATE COLLEGE               ,ID,83501-2698,Public       ,2,26,28,1947,1929,3876
00162300,NORTH IDAHO COLLEGE                     ,ID,83814-2199,Public       ,18,89,107,2156,2702,4858
00162400,NORTHWEST NAZARENE UNIVERSITY           ,ID,83686-5897,Private      ,3,32,35,1313,1111,2424
00162500,BRIGHAM YOUNG UNIVERSITY-IDAHO          ,ID,83460-1650,Private      ,198,246,444,7912,6828,14740
00162600,UNIVERSITY OF IDAHO                     ,ID,83844-4291,Public       ,22,41,63,7776,3940,11716
00455300,ITT TECHNICAL INSTITUTE                 ,ID,83713-1529,Proprietary  ,49,161,210,885,2089,2974
00458304,BROWN MACKIE COLLEGE-SOUTH BEND - BROWN ,ID,83709-2746,Proprietary  ,18,73,91,69,311,380
00987300,MR JUAN'S CLG OF HAIR DESIGN            ,ID,83301-4154,Proprietary  ,0,1,1,20,45,65
01113300,EASTERN IDAHO TECHNICAL COLLEGE         ,ID,83404-5788,Public       ,4,22,26,259,1002,1261
02210700,CAREER BEAUTY COLLEGE                   ,ID,83440-0000,Proprietary  ,1,1,2,36,45,81
02218000,APOLLO COLLEGE                          ,ID,83704-0000,Proprietary  ,18,99,117,378,1367,1745
02234500,BOISE BIBLE COLLEGE                     ,ID,83714-1220,Private      ,1,1,2,163,59,222
02275800,MR LEONS SCHOOL OF HAIR DESIGN          ,ID,83843-8384,Proprietary  ,6,4,10,48,61,109
02275801,MR. LEON'S SCHOOL OF HAIR DESIGN        ,ID,83501-1910,Proprietary  ,0,1,1,1,2,3
02314000,SCHOOL OF HAIRSTYLING (THE)             ,ID,83202-0000,Proprietary  ,0,0,0,39,66,105
02319800,HEADMASTERS SCHOOL OF HAIR DESIGN       ,ID,83814-0000,Proprietary  ,9,10,19,115,181,296
02349200,HEADMASTERS SCHOOL OF HAIR DESIGN       ,ID,83501-0000,Proprietary  ,1,2,3,47,45,92
02559500,RAZZLE DAZZLE CLG OF HAIR DESIGN        ,ID,83686-5104,Proprietary  ,1,8,9,45,151,196
02607100,SCOT LEWIS SCHOOLS                      ,ID,83709-1662,Proprietary  ,5,6,11,124,168,292
03098700,ACADEMY OF COURT REPORTING              ,ID,83704-8320,Proprietary  ,16,105,121,337,1177,1514
03832400,COSMETOLOGY SCHOOL OF ARTS & SCIENCES   ,ID,83318-1327,Proprietary  ,1,3,4,16,56,72
04134300,EVANS HAIRSTYLING COLLEGE               ,ID,83440-5277,Proprietary  ,1,1,2,20,15,35
04144500,HAIR ACDMY PAUL MITCHELL PARTNER SCHOOL ,ID,83440-2600,Proprietary  ,3,7,10,31,49,80
00163200,AQUINAS INSTITUTE OF THEOLOGY           ,MO,63108-3323,Private      ,0,1,1,0,74,74
00244900,AVILA COLLEGE                           ,MO,64145-1698,Private      ,4,34,38,1040,1311,2351
00245000,CALVARY BIBLE COLLEGE                   ,MO,64147-1341,Private      ,1,6,7,179,172,351
00245200,CENTRAL BIBLE COLLEGE                   ,MO,65803-1096,Private      ,2,6,8,502,299,801
00245300,CENTRAL METHODIST UNIVERSITY            ,MO,65248-1198,Private      ,10,14,24,1280,642,1922
00245301,CENTRAL METHODIST UNIVERSITY            ,MO,63601-0000,Private      ,0,8,8,57,223,280
00245302,CENTRAL METHODIST UNIVERSITY- UNION     ,MO,63084-0000,Private      ,0,0,0,30,46,76
00245400,UNIVERSITY OF CENTRAL MISSOURI          ,MO,64093-5178,Public       ,24,100,124,7132,4009,11141
00245600,COLUMBIA COLLEGE                        ,MO,65216-4581,Private      ,35,429,464,2727,14188,16915
00245700,CONCORDIA SEMINARY                      ,MO,63105-3199,Private      ,1,5,6,4,556,560
00245800,COTTEY COLLEGE                          ,MO,64772-2790,Private      ,2,0,2,355,32,387
00245900,CROWDER COLLEGE                         ,MO,64850-9165,Public       ,34,85,119,1676,2246,3922
00246000,CULVER STOCKTON COLLEGE                 ,MO,63435-1299,Private      ,3,1,4,1136,140,1276
00246100,DRURY UNIVERSITY                        ,MO,65802-3791,Private      ,12,85,97,2207,3597,5804
00246200,EDEN THEOLOGICAL SEMINARY               ,MO,63119-0000,Private      ,0,0,0,2,128,130
00246300,EVANGEL UNIVERSITY                      ,MO,65802-2125,Private      ,5,24,29,1778,727,2505
00246400,FONTBONNE UNIVERSITY                    ,MO,63105-3098,Private      ,3,76,79,1221,2904,4125
00246600,HARRIS-STOWE STATE COLLEGE              ,MO,63103-2199,Public       ,7,20,27,1613,1890,3503
00246700,CONCEPTION SEMINARY COLLEGE             ,MO,64433-0000,Private      ,2,0,2,46,18,64
00246800,JEFFERSON COLLEGE                       ,MO,63050-2441,Public       ,43,115,158,2383,2319,4702
00247100,ST LOUIS COMMUNITY COLLEGE              ,MO,63102-0000,Public       ,120,519,639,8426,13373,21799
00247104,SAINT LOUIS COMMUNITY COLLEGE - WILDWOOD,MO,63040-1168,Public       ,0,0,0,24,44,68
00247300,KANSAS CITY ART INSTITUTE               ,MO,64111-1874,Private      ,4,3,7,944,214,1158
00247400,KANSAS CITY UNIV OF MED & BIOSCIENCES   ,MO,64106-0000,Private      ,1,0,1,34,1163,1197
00247600,KENRICK-GLENNON SEMINARY                ,MO,63119-0000,Private      ,0,0,0,8,5,13
00247700,A.T. STILL UNIV OF HEALTH SCIENCES      ,MO,63501-0000,Private      ,0,39,39,5,2594,2599
00247900,LINCOLN UNIVERSITY                      ,MO,65101-3500,Public       ,14,29,43,2606,1556,4162
00248000,LINDENWOOD UNIVERSITY                   ,MO,63301-1695,Private      ,24,182,206,4358,6423,10781
00248200,MARYVILLE UNIVERSITY                    ,MO,63141-7299,Private      ,9,38,47,2141,2038,4179
00248400,METROPOLITAN COMMUNITY COLLEGE          ,MO,64111-2408,Public       ,180,566,746,7853,11604,19457
00248500,MIDWESTERN BAPTIST THEOL SEMINARY       ,MO,64118-4697,Private      ,1,4,5,62,221,283
00248600,MINERAL AREA COLLEGE                    ,MO,63601-1000,Public       ,36,62,98,1591,1960,3551
00248800,MISSOURI SOUTHERN STATE UNIVERSITY      ,MO,64801-1595,Public       ,27,42,69,3373,3223,6596
00248900,MISSOURI VALLEY COLLEGE                 ,MO,65340-3197,Private      ,3,4,7,1512,350,1862
00249000,MISSOURI WESTERN STATE UNIVERSITY       ,MO,64507-2294,Public       ,10,41,51,4088,2248,6336
00249100,MOBERLY AREA COMMUNITY COLLEGE          ,MO,65270-1304,Public       ,10,28,38,2230,2262,4492
00249400,NAZARENE THEOLOGICAL SEMINARY           ,MO,64131-1246,Private      ,1,0,1,5,155,160
00249500,TRUMAN STATE UNIVERSITY                 ,MO,63501-4221,Public       ,21,4,25,5208,432,5640
00249600,NORTHWEST MISSOURI STATE UNIV           ,MO,64468-6001,Public       ,20,42,62,6079,1223,7302
00249800,PARK UNIVERSITY                         ,MO,64152-3795,Private      ,10,226,236,1318,7529,8847
00249900,ROCKHURST UNIVERSITY                    ,MO,64110-2561,Private      ,6,32,38,1895,1305,3200
00250000,COLLEGE OF THE OZARKS                   ,MO,65726-2502,Private      ,0,1,1,2734,302,3036
00250100,SOUTHEAST MISSOURI STATE UNIV           ,MO,63701-4799,Public       ,28,68,96,6909,3596,10505
00250200,SOUTHWEST BAPTIST UNIVERSITY            ,MO,65613-2597,Private      ,4,33,37,1932,1597,3529
00250300,MISSOURI STATE UNIVERSITY               ,MO,65897-0094,Public       ,55,127,182,12333,6408,18741
00250400,ST LOUIS COLLEGE OF PHARMACY            ,MO,63110-1088,Private      ,0,2,2,748,494,1242
00250600,SAINT LOUIS UNIVERSITY                  ,MO,63103-2097,Private      ,16,120,136,7961,6742,14703
00250900,SAINT PAUL SCHOOL OF THEOLOGY           ,MO,64127-2499,Private      ,0,3,3,3,174,177
00251200,STEPHENS COLLEGE                        ,MO,65215-0001,Private      ,4,7,11,944,443,1387
00251400,NORTH CENTRAL MISSOURI COLLEGE          ,MO,64683-1824,Public       ,18,49,67,729,882,1611
00251600,UNIVERSITY OF MISSOURI-COLUMBIA         ,MO,65211-1600,Public       ,95,116,211,20017,7254,27271
00251700,MISSOURI UNIVERSITY OF SCIENCE & TECHNOL,MO,65409-0250,Public       ,16,11,27,4266,987,5253
00251800,UNIVERSITY OF MISSOURI-KANSAS CITY      ,MO,64110-2497,Public       ,33,128,161,5901,8089,13990
00251900,UNIVERSITY OF MISSOURI-ST LOUIS         ,MO,63121-4499,Public       ,31,118,149,5177,8130,13307
00252000,WASHINGTON UNIVERSITY                   ,MO,63130-4899,Private      ,14,31,45,11872,5102,16974
00252001,WASHINGTON UNIV-SCHOOL OF MEDICINE      ,MO,63110-0000,Private      ,0,1,1,62,1262,1324
00252100,WEBSTER UNIVERSITY                      ,MO,63119-3194,Private      ,6,175,181,3155,13282,16437
00252200,WENTWORTH MILITARY ACADEMY              ,MO,64067-1799,Private      ,11,9,20,165,211,376
00252300,WESTMINSTER COLLEGE                     ,MO,65251-1299,Private      ,2,3,5,1066,87,1153
00252400,WILLIAM JEWELL COLLEGE                  ,MO,64068-1896,Private      ,2,11,13,1417,247,1664
00252500,WILLIAM WOODS UNIVERSITY                ,MO,65251-2388,Private      ,3,124,127,941,2528,3469
00405704,NATIONAL AMERICAN UNIVERSITY            ,MO,64057-1791,Proprietary  ,1,12,13,37,343,380
00441300,ST JOHNS HOSP SCH RAD TECH              ,MO,65802-0000,Private      ,0,1,1,36,53,89
00470300,LOGAN COLLEGE OF CHIROPRACTIC           ,MO,63006-1065,Private      ,1,9,10,69,1241,1310
00470700,COVENANT THEOLOGICAL SEMINARY           ,MO,63141-8697,Private      ,0,1,1,4,506,510
00471100,LINN STATE TECHNICAL COLLEGE            ,MO,65051-9607,Public       ,8,6,14,990,316,1306
00471300,THREE RIVERS COMMUNITY COLLEGE          ,MO,63901-2393,Public       ,47,99,146,1649,2429,4078
00528800,KIRKSVILLE AREA TECHNICAL CENTER        ,MO,63501-0000,Public       ,1,0,1,24,62,86
00528900,WAYNESVILLE TECHNICAL ACADEMY           ,MO,65583-0000,Public       ,0,2,2,18,112,130
00542400,SOUTH CENTRAL CAREER CENTER             ,MO,65775-3334,Public       ,1,1,2,39,124,163
00542600,SIKESTON CAREER AND TECHNOLOGY CTR      ,MO,63801-0000,Public       ,0,1,1,26,128,154
00542900,ROLLA TECHNICAL INSTITUTE               ,MO,65401-3601,Public       ,2,0,2,230,310,540
00543000,POPLAR BLUFF TECHNICAL CAREER CNTR      ,MO,63901-0000,Public       ,0,2,2,34,97,131
00543800,SALINE COUNTY CAREER CENTER             ,MO,65340-0000,Public       ,0,0,0,14,75,89
00544500,TRUMAN MEDICAL CENTER SCHOOL OF NURSE AN,MO,64108-2677,Private      ,0,3,3,29,79,108
00553100,GRAND RIVER TECHNICAL SCHOOL            ,MO,64601-1299,Public       ,0,0,0,62,33,95
00553200,CAPE GIRARDEAU CAREER & TECHNOLOGY CENTE,MO,63703-7511,Public       ,2,3,5,83,275,358
00638500,CHAMBERLAIN COLLEGE OF NURSING          ,MO,63139-3297,Proprietary  ,4,237,241,628,4727,5355
00638900,BARNES JEWISH COLLEGE OF NURSING AND ALL,MO,63110-1091,Private      ,0,7,7,238,667,905
00639200,RESEARCH COLLEGE OF NURSING             ,MO,64132-1199,Proprietary  ,0,4,4,45,153,198
00639201,RESEARCH MEDICAL CENTER - COLLEGE OF NUR,MO,64132-1199,Proprietary  ,0,0,0,5,15,20
00639202,RESEARCH MED CTR SCHL OF RAD TECH       ,MO,64132-0000,Proprietary  ,0,0,0,0,4,4
00666600,LUTHERAN  SCHOOL OF NURSING             ,MO,63118-3909,Proprietary  ,0,0,0,72,298,370
00754000,MISSOURI BAPTIST UNIVERSITY             ,MO,63141-8698,Private      ,3,60,63,1228,1921,3149
00755700,ITT TECHNICAL INSTITUTE                 ,MO,63045-1122,Proprietary  ,119,327,446,1832,4013,5845
00808000,STATE FAIR COMMUNITY COLLEGE            ,MO,65301-0000,Public       ,26,109,135,1831,2237,4068
00826900,HILLYARD TECHNICAL CENTER               ,MO,64506-0000,Public       ,0,4,4,88,156,244
00855200,PATRICIA STEVENS COLLEGE                ,MO,63102-2334,Proprietary  ,2,2,4,83,153,236
00860600,TRI-COUNTY TECHNICAL SCHOOL             ,MO,65026-0000,Public       ,0,2,2,16,55,71
00886200,EAST CENTRAL COLLEGE                    ,MO,63084-0529,Public       ,40,85,125,1713,1720,3433
00908900,HANNIBAL-LAGRANGE COLLEGE               ,MO,63401-1999,Private      ,3,6,9,787,508,1295
00952000,NATIONAL ACADEMY OF BEAUTY ARTS         ,MO,63128-1307,Proprietary  ,8,21,29,203,426,629
00959000,INDEPENDENCE COLLEGE OF COSMETOLOGY     ,MO,64055-1105,Proprietary  ,0,9,9,44,87,131
00960700,HOUSE OF HEAVILIN BEAUTY COLLEGE        ,MO,64110-2826,Proprietary  ,2,9,11,30,98,128
00978200,SAINT LUKE'S COLLEGE                    ,MO,64114-3237,Private      ,0,1,1,69,145,214
00979500,MISSOURI COLLEGE                        ,MO,63144-2901,Proprietary  ,23,85,108,373,1010,1383
01014814,COLORADO TECHNL UNIV NORTH KANSAS CITY  ,MO,64116-3614,Proprietary  ,12,61,73,243,1174,1417
01027900,HICKEY COLLEGE                          ,MO,63146-0000,Proprietary  ,2,2,4,385,182,567
01040500,PINNACLE CAREER INSTITUTE               ,MO,64131-3367,Proprietary  ,8,140,148,239,1823,2062
01040501,PINNACLE CAREER INSTITUTE - NORTH KANSAS,MO,64153-1151,Proprietary  ,1,20,21,33,191,224
01050303,WICHITA TECHNICAL INSTITUTE - WTI JOPLIN,MO,64801-2970,Proprietary  ,0,1,1,0,1,1
01102600,WARRENSBURG AREA VOC TECH SCH           ,MO,64093-0000,Public       ,0,0,0,25,62,87
01173500,PIKE/LINCOLN TECHNICAL CENTER           ,MO,63344-0000,Public       ,0,0,0,29,68,97
01212000,ASSEMBLIES OF GOD THEO. SEMINARY        ,MO,65802-0000,Private      ,0,3,3,8,282,290
01250000,RANKEN TECHNICAL COLLEGE                ,MO,63113-2811,Private      ,16,9,25,1159,953,2112
01258000,ST LOUIS CHRISTIAN COLLEGE              ,MO,63033-6499,Private      ,1,4,5,136,231,367
01320800,BAPTIST BIBLE COLLEGE                   ,MO,65803-3498,Private      ,0,3,3,378,221,599
02056100,FOUR RIVERS CAREER CENTER               ,MO,63090-0000,Public       ,0,0,0,13,39,52
02066900,NICHOLS CAREER CENTER                   ,MO,65101-2814,Public       ,1,0,1,67,102,169
02068200,COX HEALTH - COX COLLEGE                ,MO,65802-0000,Private      ,4,24,28,197,566,763
02068202,COX HEALTH - RADIOLOGIC TECHNOLOGY      ,MO,65802-0000,Private      ,0,0,0,26,58,84
02068204,COX HEALTH - MEDICAL TECHNOLOGY         ,MO,65807-0000,Private      ,0,1,1,5,18,23
02073600,KENNETT CAREER & TECHNOLOGY CENTER      ,MO,63857-0000,Public       ,0,0,0,13,49,62
02090400,BOONSLICK TECHNICAL EDUCATION CTR       ,MO,65233-0000,Public       ,0,0,0,12,51,63
02121100,MIDWEST INSTITUTE                       ,MO,63122-0000,Proprietary  ,2,33,35,61,303,364
02124500,FRANKLIN TECHNOLOGY CENTER              ,MO,64801-0000,Public       ,0,4,4,84,299,383
02142200,LEX LA RAY TECHNICAL CENTER             ,MO,64067-0000,Public       ,0,0,0,23,72,95
02151000,HANNIBAL CAREER AND TECHNICAL CENTE     ,MO,63401-2285,Public       ,2,1,3,23,84,107
02164200,FOREST INST PROFESSIONAL PSYCHOLOGY     ,MO,65807-0000,Private      ,0,3,3,0,277,277
02165900,CHILLICOTHE BEAUTY ACADEMY              ,MO,64601-0000,Proprietary  ,1,1,2,12,24,36
02180200,METRO BUSINESS COLLEGE                  ,MO,63701-0000,Proprietary  ,14,55,69,225,864,1089
02188100,NORTHLAND CAREER CENTER                 ,MO,64079-8333,Public       ,0,0,0,17,55,72
02202700,OZARK CHRISTIAN COLLEGE                 ,MO,64801-0000,Private      ,2,1,3,509,182,691
02203400,NEVADA REGIONAL TECHNICAL CENTER        ,MO,64772-0000,Public       ,0,1,1,18,64,82
02205200,SANFORD-BROWN COLLEGE                   ,MO,63026-7305,Proprietary  ,10,43,53,612,2850,3462
02205203,SANFORD BROWN COLLEGE-ST. PETERS        ,MO,63301-4042,Proprietary  ,10,46,56,263,1239,1502
02205205,SANFORD BROWN COLLEGE-HAZELWOOD         ,MO,63042-2708,Proprietary  ,0,0,0,138,963,1101
02214500,SALEM COLLEGE OF HAIRSTYLING            ,MO,65401-0000,Proprietary  ,0,4,4,15,52,67
02239200,ALLIED COLLEGE - NORTH                  ,MO,63043-0000,Proprietary  ,61,180,241,791,1856,2647
02239202,ALLIED COLLEGE - METRO SOUTH            ,MO,63026-0000,Proprietary  ,0,7,7,33,50,83
02242800,GIBSON TECHNICAL CENTER                 ,MO,65737-0169,Public       ,0,0,0,2,47,49
02250600,EVEREST COLLEGE                         ,MO,65807-2446,Proprietary  ,17,68,85,197,1126,1323
02263106,HIGH-TECH INSTITUTE - KANSAS CITY       ,MO,64114-0000,Proprietary  ,0,4,4,23,42,65
02263400,LAKE CAREER AND TECHNICAL CENTER        ,MO,65020-0000,Public       ,0,0,0,14,20,34
02266400,CENTRAL CHRISTIAN CLG OF THE BIBLE      ,MO,65270-0000,Private      ,0,0,0,288,183,471
02277500,HOUSE OF HEAVILIN OF BLUE SPRINGS       ,MO,64014-3953,Proprietary  ,8,5,13,52,118,170
02289200,COLUMBIA AREA CAREER CENTER             ,MO,65203-0000,Public       ,0,0,0,44,157,201
02295700,MISSOURI BEAUTY ACADEMY                 ,MO,63640-1827,Proprietary  ,3,11,14,66,173,239
02300105,EVEREST COLLEGE - EARTH CITY            ,MO,63045-1100,Proprietary  ,26,135,161,224,1334,1558
02304000,MISSOURI TECH                           ,MO,63132-0000,Proprietary  ,0,5,5,50,134,184
02309100,AMERICAN COLLEGE OF HAIR DESIGN         ,MO,65301-2144,Proprietary  ,0,2,2,18,60,78
02311100,ABBOTT ACADEMY OF COSMETIC ARTS/SCI     ,MO,63376-0000,Proprietary  ,0,0,0,5,3,8
02313000,CASS CAREER CENTER                      ,MO,64701-0000,Public       ,0,0,0,9,52,61
02340500,ST LOUIS COLLEGE OF HEALTH CAREERS      ,MO,63110-0000,Proprietary  ,16,83,99,154,796,950
02340501,ST LOUIS COLLEGE OF HEALTH              ,MO,63129-0000,Proprietary  ,1,0,1,8,29,37
02342100,CAREER & TECHNOLOGY CTR AT FT OSAGE     ,MO,64058-0000,Public       ,1,0,1,10,14,24
02361600,CONCORDE CAREER COLLEGE                 ,MO,64111-0000,Proprietary  ,10,94,104,199,1241,1440
02497500,CLINTON TECHNICAL SCHOOL                ,MO,64735-2966,Public       ,0,0,0,2,8,10
02520800,MERRELL UNIV OF BTY ARTS & SCIENCES     ,MO,65109-0000,Proprietary  ,4,9,13,88,163,251
02530600,SAINT CHARLES COMMUNITY COLLEGE         ,MO,63376-0975,Public       ,25,77,102,3177,2477,5654
02543800,PARIS II EDUCATIONAL CENTER (THE)       ,MO,64118-0000,Proprietary  ,3,11,14,43,129,172
02555300,PATSY AND ROB'S ACADEMY OF BEAUTY       ,MO,63074-0000,Proprietary  ,2,15,17,52,147,199
02564700,ELAINE STEVEN BEAUTY COLLEGE            ,MO,63136-0000,Proprietary  ,5,17,22,68,185,253
02564701,ELAINE STEVEN BEAUTY COLLEGE - ADVANCE B,MO,63383-2006,Proprietary  ,0,0,0,0,8,8
02564702,ELAINE STEVEN BEAUTY COLLEGE - ADVANCE B,MO,63401-2269,Proprietary  ,0,0,0,3,9,12
02568500,GRABBER SCHOOL OF HAIR DESIGN           ,MO,63011-0000,Proprietary  ,1,7,8,60,82,142
02599700,VATTEROTT COLLEGE                       ,MO,63134-2900,Proprietary  ,6,12,18,361,1619,1980
02599701,VATTEROTT COLLEGE - KANSAS CITY         ,MO,64129-1692,Proprietary  ,5,69,74,214,1212,1426
02599702,VATTEROTT COLLEGE - SPRINGFIELD LOCATION,MO,65807-5340,Proprietary  ,5,7,12,154,805,959
02599703,VATTEROTT COLLEGE - JOPLIN              ,MO,64801-5033,Proprietary  ,0,7,7,102,608,710
02599705,VATTEROTT COLLEGE - SUNSET HILLS        ,MO,63127-1516,Proprietary  ,1,6,7,206,1025,1231
02599712,VATTEROTT COLLEGE - O'FALLON            ,MO,63366-2748,Proprietary  ,1,13,14,122,390,512
02608000,NEOSHO BEAUTY COLLEGE                   ,MO,64850-1525,Proprietary  ,0,0,0,17,41,58
02608001,NEOSHO BEAUTY COLLEGE - CLASS ACT I COSM,MO,64801-2314,Proprietary  ,0,0,0,3,4,7
02609202,VATTEROTT COLLEGE-ST JOSEPH             ,MO,64501-2911,Proprietary  ,7,42,49,131,553,684
02609203,VATTEROTT COLLEGE - L'ECOLE CULINAIRE   ,MO,63124-1103,Proprietary  ,2,15,17,272,765,1037
02611004,HERITAGE COLLEGE-KANSAS CITY            ,MO,64131-4203,Proprietary  ,20,107,127,248,835,1083
03042400,LEBANON TECHNOLOGY & CAREER CENTER      ,MO,65536-3296,Public       ,1,0,1,34,115,149
03066300,BRYAN CAREER COLLEGE                    ,MO,65806-2507,Proprietary  ,4,29,33,69,288,357
03068600,NORTH COUNTY TECH SPECIAL SCH DIST      ,MO,63033-6498,Public       ,1,5,6,59,495,554
03070200,CENTRAL COLLEGE OF COSMETOLOGY          ,MO,65583-0000,Proprietary  ,1,5,6,30,103,133
03070900,SE MO HOSP CLG NURSING & HEALTH SCI     ,MO,63703-4507,Private      ,1,1,2,68,229,297
03077200,COSMETOLOGY CONCEPTS INSTITUTE          ,MO,65202-1972,Proprietary  ,1,3,4,43,69,112
03083000,OZARKS TECHNICAL COMMUNITY COLLEGE      ,MO,65802-3601,Public       ,80,290,370,5630,7264,12894
03092600,MESSENGER COLLEGE                       ,MO,64804-4909,Private      ,0,3,3,44,57,101
03097600,ST LOUIS HAIR ACADEMY                   ,MO,63107-1737,Proprietary  ,0,5,5,12,57,69
03101000,NEW DIMENSION SCHOOL OF HAIR DESIGN     ,MO,64801-5017,Proprietary  ,2,2,4,27,46,73
03106000,MISSOURI STATE UNIVERSITY - WEST PLAINS ,MO,65775-2715,Public       ,22,42,64,993,1128,2121
03110900,HOUSE OF HEAVILIN BEAUTY COLLEGE        ,MO,64030-1154,Proprietary  ,2,12,14,20,78,98
03166300,MOBERLY AREA TECHNICAL CENTER           ,MO,65270-1904,Public       ,0,0,0,13,14,27
03174300,HERNDON CAREER CENTER                   ,MO,64138-2695,Public       ,0,0,0,19,13,32
03519300,MISSOURI COLLEGE OF COSMETOLOGY NORTH   ,MO,65803-1235,Proprietary  ,2,7,9,108,230,338
03528300,MIDWEST UNIVERSITY                      ,MO,63385-2905,Private      ,0,3,3,3,41,44
03579300,TEXAS COUNTY TECHNICAL INSTITUTE        ,MO,65483-2700,Private      ,2,13,15,50,336,386
03616300,AVIATION INSTITUTE OF MAINTENANCE       ,MO,64129-1811,Proprietary  ,5,20,25,65,299,364
03663400,UNIVERSITY OF COSMETOLOGY               ,MO,63080-1910,Proprietary  ,1,2,3,20,34,54
03817300,ST. CHARLES SCHOOL OF MASSAGE THERAPY   ,MO,63303-5607,Proprietary  ,0,0,0,6,18,24
03878300,PROFESSIONAL MASSAGE TRAINING CENTER    ,MO,65803-2939,Proprietary  ,3,8,11,41,106,147
03916300,ECLIPS SCHOOL OF COSMETOLOGY AND BARBERI,MO,63703-5809,Proprietary  ,0,6,6,20,72,92
03924300,HAIR ACADEMY 110 (THE)                  ,MO,63501-2915,Proprietary  ,1,1,2,10,25,35
03970400,MTTI-WELLSPRING CENTER FOR NATURAL HEALT,MO,64114-3313,Proprietary  ,2,11,13,47,170,217
04037500,ACADEMY OF HAIR DESIGN                  ,MO,65804-2303,Proprietary  ,2,7,9,69,153,222
04048300,DIVAS UNLIMITED ACADEMY                 ,MO,63114-2625,Proprietary  ,0,0,0,12,31,43
04127000,PEMISCOT COUNTY SPECIAL SCHOOL DISTRICT ,MO,63851-1666,Public       ,0,2,2,7,25,32
04130600,HEALING ARTS CENTER                     ,MO,63143-2103,Proprietary  ,1,9,10,8,50,58
04133300,TREND SETTERS SCHOOL OF COSMETOLOGY     ,MO,63702-7607,Proprietary  ,2,4,6,45,72,117
04145700,THE SYSTEM A PAUL MITCHELL PARTNER SCHL ,MO,65807-5969,Proprietary  ,4,6,10,11,16,27
04146100,URSHAN GRADUATE SCHOOL OF THEOLOGY      ,MO,63031-7526,Private      ,0,1,1,0,1,1
00163201,AQUINAS INSTITUTE OF THEOLOGY - MINISTRY,OK,73123-0380,Private      ,0,0,0,0,7,7
00314600,WESTERN OKLAHOMA STATE COLLEGE          ,OK,73521-1397,Public       ,8,43,51,553,915,1468
00314700,BACONE COLLEGE                          ,OK,74403-1597,Private      ,6,18,24,770,745,1515
00314900,SOUTHERN NAZARENE UNIVERSITY            ,OK,73008-2694,Private      ,4,83,87,1194,1682,2876
00315000,CAMERON UNIVERSITY                      ,OK,73505-6377,Public       ,29,108,137,1860,3279,5139
00315100,OKLAHOMA WESLEYAN UNIVERSITY            ,OK,74006-6299,Private      ,0,19,19,517,874,1391
00315200,UNIV OF CENTRAL OKLAHOMA                ,OK,73034-5209,Public       ,43,111,154,7251,6328,13579
00315300,CONNORS STATE COLLEGE                   ,OK,74469-9700,Public       ,19,39,58,925,1236,2161
00315400,EAST CENTRAL UNIVERSITY                 ,OK,74820-6999,Public       ,13,84,97,2202,2602,4804
00315500,EASTERN OKLAHOMA STATE COLLEGE          ,OK,74578-4999,Public       ,21,46,67,814,1154,1968
00315600,REDLANDS COMMUNITY COLLEGE              ,OK,73036-5304,Public       ,11,45,56,644,1101,1745
00315700,LANGSTON UNIVERSITY                     ,OK,73050-0000,Public       ,20,45,65,2135,2066,4201
00315800,MURRAY STATE COLLEGE                    ,OK,73460-3137,Public       ,33,75,108,1119,1763,2882
00316000,NORTHEASTERN OKLAHOMA A & M COLLEGE     ,OK,74354-6497,Public       ,22,48,70,1294,962,2256
00316100,NORTHEASTERN STATE UNIVERSITY           ,OK,74464-2399,Public       ,34,104,138,4426,5682,10108
00316200,NORTHERN OKLAHOMA COLLEGE               ,OK,74653-0310,Public       ,29,71,100,1737,2027,3764
00316300,NORTHWESTERN OKLAHOMA STATE UNIV        ,OK,73717-2799,Public       ,7,28,35,1045,911,1956
00316400,OKLAHOMA BAPTIST UNIVERSITY             ,OK,74801-2590,Private      ,5,4,9,1660,320,1980
00316500,OKLAHOMA CHRISTIAN UNIVERSITY           ,OK,73131-0000,Private      ,6,7,13,1931,604,2535
00316600,OKLAHOMA CITY UNIVERSITY                ,OK,73106-1493,Private      ,8,25,33,1982,2262,4244
00316700,UNIV OF SCIENCE & ARTS OF OKLAHOMA      ,OK,73018-5322,Public       ,6,6,12,759,479,1238
00316800,ROGERS STATE UNIVERSITY                 ,OK,74017-3252,Public       ,24,57,81,2062,2554,4616
00317000,OKLAHOMA STATE UNIVERSITY               ,OK,74078-1015,Public       ,69,98,167,12660,6614,19274
00317200,OKLAHOMA STATE UNIVERSITY-OKMULGEE      ,OK,74447-3901,Public       ,23,49,72,1465,1336,2801
00317400,OKLAHOMA PANHANDLE STATE UNIVERSITY     ,OK,73939-0000,Public       ,10,6,16,773,400,1173
00317600,CARL ALBERT STATE COLLEGE               ,OK,74953-5208,Public       ,4,22,26,1158,1811,2969
00317800,SEMINOLE STATE COLLEGE                  ,OK,74818-1902,Public       ,15,55,70,829,1185,2014
00317900,SOUTHEASTERN OKLAHOMA STATE UNIV        ,OK,74701-0609,Public       ,25,64,89,2293,2010,4303
00318000,SOUTHWESTERN CHRISTIAN UNIVERSITY       ,OK,73008-2335,Private      ,1,1,2,157,220,377
00318100,SOUTHWESTERN OKLAHOMA STATE UNIV        ,OK,73096-3098,Public       ,20,43,63,2602,1710,4312
00318101,SOUTHWESTERN OK STATE UNIV AT SAYRE     ,OK,73662-0000,Public       ,2,9,11,127,226,353
00318300,ST GREGORY'S UNIVERSITY                 ,OK,74804-2499,Private      ,1,30,31,335,477,812
00318308,SAINT GREGORY'S UNIVERSITY - IPD TULSA  ,OK,74135-2499,Private      ,0,2,2,30,167,197
00318400,UNIVERSITY OF OKLAHOMA                  ,OK,73019-4078,Public       ,72,133,205,14184,9068,23252
00318401,UNIVERSITY OF OKLAHOMA-HLTH SCI CTR     ,OK,73190-0000,Public       ,1,14,15,407,3262,3669
00318500,UNIVERSITY OF TULSA                     ,OK,74104-3189,Private      ,8,23,31,2741,1824,4565
00398500,ORAL ROBERTS UNIVERSITY                 ,OK,74171-0001,Private      ,7,30,37,2499,1389,3888
00458305,BROWN MACKIE COLLEGE-SOUTH BEND - BROWN ,OK,74146-5234,Proprietary  ,7,34,41,25,159,184
00531100,TULSA COUNTY AREA VOC TECH SCHOOL       ,OK,74145-0000,Public       ,2,22,24,178,731,909
00531200,RED RIVER TECHNOLOGY CENTER             ,OK,73533-2700,Public       ,0,7,7,29,178,207
00533900,METRO TECHNOLOGY CENTERS SCH DIST22     ,OK,73111-0000,Public       ,2,64,66,181,1070,1251
00533903,METRO TECHNOLOGY CENTERS SCH DIST22     ,OK,73129-0000,Public       ,0,13,13,59,266,325
00694200,MID-AMERICA CHRISTIAN UNIVERSITY        ,OK,73170-4504,Private      ,1,17,18,462,1006,1468
00767800,SPARTAN COLLEGE OF AERONAUTICS AND TECHN,OK,74115-5800,Proprietary  ,20,35,55,1134,949,2083
00791100,VIRGILS BEAUTY COLLEGE                  ,OK,74401-6802,Proprietary  ,2,1,3,17,50,67
00834300,AUTRY TECHNOLOGY CENTER                 ,OK,73703-2598,Public       ,0,5,5,53,249,302
00861900,TRI COUNTY TECHNOLOGY CENTER            ,OK,74006-6029,Public       ,0,0,0,106,146,252
00918500,ROSE STATE COLLEGE                      ,OK,73110-2799,Public       ,29,157,186,1986,4642,6628
00920400,KIAMICHI AREA VOC TECH SCHOOL           ,OK,74578-0548,Public       ,6,21,27,277,1057,1334
00920408,KIAMICHI AREA VOC TECH SCHOOL           ,OK,74953-0000,Public       ,2,4,6,38,108,146
00961800,TULSA WELDING SCHOOL                    ,OK,74104-0000,Proprietary  ,144,315,459,1084,1936,3020
00964700,"OKLAHOMA STATE UNIV, OKLA CITY          ",OK,73107-6159,Public       ,34,185,219,1694,4535,6229
00970800,EVES COLLEGE OF HAIRSTYLING             ,OK,73501-4359,Proprietary  ,6,19,25,35,136,171
00976300,TULSA COMMUNITY COLLEGE                 ,OK,74135-6198,Public       ,87,401,488,6491,9711,16202
00996300,CADDO KIOWA VOC TECH CENTER             ,OK,73038-0000,Public       ,6,5,11,81,363,444
00996400,CENTRAL OKLAHOMA AREA VOC TECH SCH      ,OK,74030-9613,Public       ,1,6,7,56,213,269
00996500,CANADIAN VALLEY TECHNOLOGY CENTER       ,OK,73036-9117,Public       ,2,10,12,74,333,407
00996800,GORDON COOPER TECHNOLOGY CENTER         ,OK,74804-9913,Public       ,0,6,6,71,335,406
01005300,INDIAN CAPITAL TECHNOLGY CENTER #4      ,OK,74403-9907,Public       ,1,7,8,157,539,696
01026600,HILLSDALE FREE WILL BAPTIST COLLEGE     ,OK,73153-0000,Private      ,2,0,2,227,65,292
01034200,SOUTHERN OKLAHOMA TECHNOLOGY CENTER     ,OK,73401-2100,Public       ,0,0,0,78,218,296
01039100,OKLAHOMA CITY COMMUNITY COLLEGE         ,OK,73159-4444,Public       ,58,319,377,3641,6951,10592
01071700,GREAT PLAINS TECHNOLOGY CENTER SCHOOL DI,OK,73505-8399,Public       ,3,8,11,82,380,462
01076200,WESTERN OK AREA VOC TECH SCH DIST12     ,OK,73624-1469,Public       ,0,0,0,37,98,135
01120600,PIONEER TECHNOLOGY CENTER               ,OK,74601-1106,Public       ,0,2,2,29,166,195
01128200,OKLAHOMA STATE UNV CLG OSTEOPTHC MD     ,OK,74107-0000,Public       ,0,2,2,38,519,557
01153700,MID-AMERICA TECHNOLOGY CENTER           ,OK,73095-0210,Public       ,0,0,0,28,65,93
01227200,MOORE-NORMAN TECHNOLOGY CENTER          ,OK,73069-8399,Public       ,1,21,22,142,649,791
02052700,NORTHEAST TECHNOLOGY CENTER             ,OK,74361-0487,Public       ,1,16,17,84,452,536
02052701,NORTHEAST TECHNOLOGY CENTER -           ,OK,74362-0825,Public       ,1,7,8,3,15,18
02060800,MERIDIAN TECHNOLOGY CENTER              ,OK,74074-0000,Public       ,2,8,10,107,256,363
02069301,VATTEROTT COLLEGE                       ,OK,73127-2103,Proprietary  ,0,6,6,46,559,605
02126500,ENID BEAUTY COLLEGE                     ,OK,73701-0000,Proprietary  ,6,4,10,26,66,92
02177900,STATE BARBER AND HAIR DESIGN CLG        ,OK,73108-0000,Proprietary  ,0,0,0,13,87,100
02184400,SAND SPRINGS BEAUTY COLLEGE             ,OK,74063-0000,Proprietary  ,2,6,8,39,137,176
02197300,HOLLYWOOD COSMETOLOGY CENTER            ,OK,73189-0000,Proprietary  ,2,2,4,10,40,50
02222700,FRANCIS TUTTLE TECHNOLOGY CENTER        ,OK,73142-0000,Public       ,3,44,47,236,1085,1321
02238500,CENTRAL STATE BEAUTY ACADEMY            ,OK,73162-6007,Proprietary  ,9,18,27,67,251,318
02250900,E OK COUNTY AREA VO-TECH                ,OK,73020-0000,Public       ,0,3,3,25,80,105
02256200,"BROKEN ARROW BEAUTY COLLEGE, INC        ",OK,74012-0000,Proprietary  ,1,3,4,61,122,183
02282100,HIGH PLAINS AREA VOC-TECH               ,OK,73801-0000,Public       ,3,11,14,27,78,105
02306800,PLATT COLLEGE                           ,OK,74145-0000,Proprietary  ,28,212,240,366,2390,2756
02510300,BEAUTY TECHNICAL COLLEGE                ,OK,74465-0000,Proprietary  ,3,3,6,11,33,44
02531200,WOODWARD BEAUTY COLLEGE                 ,OK,73801-0000,Proprietary  ,0,2,2,14,19,33
02554300,AMERICAN BEAUTY INSTITUTE               ,OK,74501-0000,Proprietary  ,1,3,4,16,30,46
02556500,YUKON BEAUTY COLLEGE                    ,OK,73099-4108,Proprietary  ,1,3,4,11,29,40
02560200,PHILLIPS THEOLOGICAL SEMINARY -         ,OK,74116-5612,Private      ,0,1,1,2,97,99
02581100,CLAREMORE BEAUTY COLLEGE                ,OK,74017-7034,Proprietary  ,2,2,4,11,18,29
02581200,CC'S COSMETOLOGY COLLEGE                ,OK,74129-0000,Proprietary  ,7,34,41,13,262,275
02591101,CAREER POINT INSTITUTE                  ,OK,74146-0000,Proprietary  ,0,1,1,11,65,76
02596501,ATI-CAREER TRAINING CENTER - OKLAHOMA CI,OK,73107-2442,Proprietary  ,0,2,2,5,38,43
02597400,PONTOTOC TECHNOLOGY CENTER SCHOOL       ,OK,74820-8621,Public       ,0,0,0,46,169,215
02599706,VATTEROTT COLLEGE - TULSA               ,OK,74146-2205,Proprietary  ,1,4,5,58,369,427
02600000,NORTHWEST TECHNOLOG CTR SCH DIST 10     ,OK,73717-9600,Public       ,0,0,0,22,45,67
02600500,WES WATKINS TECHNOLOGY CENTER           ,OK,74883-9660,Public       ,0,3,3,42,185,227
03008700,SOUTHWEST TECHNOLOGY CENTER             ,OK,73521-1527,Public       ,0,1,1,26,123,149
03010300,POTEAU BEAUTY COLLEGE                   ,OK,74953-5400,Proprietary  ,0,5,5,32,113,145
03024700,STILLWATER BEAUTY ACADEMY               ,OK,74075-3467,Proprietary  ,0,6,6,20,37,57
03030700,OKLAHOMA SCHOOL OF PHOTOGRAPHY          ,OK,73160-3320,Proprietary  ,0,3,3,20,46,66
03030800,AMERICAN BROADCASTING SCHOOL            ,OK,73115-3334,Proprietary  ,6,33,39,62,294,356
03051100,CHISHOLM TRAIL TECHNOLOGY CENTER        ,OK,73764-9720,Public       ,0,2,2,11,59,70
03078500,TECH INST OF COSMETOLOGY ARTS & SCI     ,OK,74120-3610,Proprietary  ,1,3,4,12,52,64
03089400,SCHOOL OF HAIR DESIGN                   ,OK,74745-3447,Proprietary  ,0,0,0,5,19,24
03103800,SOUTHERN SCHOOL OF BEAUTY               ,OK,74701-5008,Proprietary  ,2,3,5,16,53,69
03109800,PONCA CITY BEAUTY COLLEGE               ,OK,74601-4201,Proprietary  ,0,11,11,0,31,31
03109801,BARTLESVILLE BEAUTY COLLEGE             ,OK,74003-2835,Proprietary  ,0,5,5,7,24,31
03115100,HERITAGE COLLEGE                        ,OK,73119-0000,Proprietary  ,27,111,138,276,1155,1431
03124800,PLATT COLLEGE                           ,OK,73501-3808,Proprietary  ,2,15,17,63,255,318
03126200,GREEN COUNTRY AREA VOC TECH SCHOOL      ,OK,74447-1217,Public       ,0,1,1,31,94,125
03198400,MID-DEL AREA VOCATIONAL & TECH SCH      ,OK,73110-4825,Public       ,1,4,5,15,69,84
03329400,PRYOR BEAUTY COLLEGE                    ,OK,74361-0000,Proprietary  ,0,3,3,4,32,36
03329401,PRYOR BEAUTY COLLEGE - GROVE BEAUTY COLL,OK,74345-0009,Proprietary  ,1,1,2,12,24,36
03329402,PRYOR BEAUTY COLLEGE - NORTH EAST OKLAHO,OK,74338-0000,Proprietary  ,0,2,2,5,27,32
03367400,COMMUNITY CARE COLLEGE                  ,OK,74145-6420,Proprietary  ,28,110,138,383,1429,1812
03396300,OKLAHOMA HEALTH ACADEMY                 ,OK,74105-6220,Proprietary  ,2,27,29,45,238,283
03396400,OKLAHOMA HEALTH ACADEMY                 ,OK,73160-3667,Proprietary  ,7,35,42,51,268,319
03453400,SHAWNEE BEAUTY COLLEGE                  ,OK,74801-7014,Proprietary  ,5,5,10,16,47,63
03676300,FAMILY OF FAITH COLLEGE                 ,OK,74802-1805,Private      ,0,1,1,9,15,24
03831300,INSTITUTE OF HAIR DESIGN                ,OK,74804-0000,Proprietary  ,1,5,6,12,56,68
03928300,CENTRAL STATE MASSAGE ACADEMY           ,OK,73162-6007,Proprietary  ,2,11,13,22,125,147
04027300,4-STATES ACADEMY OF COSMETOLOGY         ,OK,74354-0000,Proprietary  ,1,4,5,12,51,63
04060300,AMERICAN INSTITUTE OF MEDICAL TECHNOLOGY,OK,74136-5700,Proprietary  ,0,2,2,19,89,108
04062300,OKLAHOMA TECHNOLOGY INSTITUTE           ,OK,73114-6318,Proprietary  ,0,8,8,20,81,101
04121300,4-STATES OKMULGEE ACADEMY OF COSMETOLOGY,OK,74447-0000,Proprietary  ,1,0,1,17,34,51
04133600,CUTTER'S EDGE SCHOOL OF COSMETOLOGY     ,OK,74023-2905,Proprietary  ,1,3,4,3,13,16
04144400,ACADEMY OF HAIR DESIGN (THE)            ,OK,73120-6808,Proprietary  ,0,2,2,0,2,2
00163700,BETHANY THEOLOGICAL SEMINARY            ,IN,47374-0000,Private      ,0,0,0,1,27,28
00178400,ANCILLA COLLEGE-FINANCIAL AID OFFC      ,IN,46513-0001,Private      ,4,9,13,463,488,951
00178500,ANDERSON UNIVERSITY                     ,IN,46012-3495,Private      ,2,15,17,2753,952,3705
00178600,BALL STATE UNIVERSITY                   ,IN,47306-0880,Public       ,41,118,159,18562,7874,26436
00178700,BETHEL COLLEGE INC                      ,IN,46545-5591,Private      ,1,25,26,1445,1299,2744
00178800,BUTLER UNIVERSITY                       ,IN,46208-3487,Private      ,1,13,14,5592,1250,6842
00178900,CHRISTIAN THEOLOGICAL SEMINARY          ,IN,46208-0000,Private      ,0,1,1,5,232,237
00179200,DEPAUW UNIVERSITY                       ,IN,46135-0037,Private      ,1,0,1,2835,56,2891
00179300,EARLHAM COLLEGE                         ,IN,47374-4095,Private      ,2,0,2,1562,134,1696
00179301,EARLHAM SCHOOL OF RELIGION              ,IN,47374-0000,Private      ,0,0,0,20,59,79
00179500,UNIVERSITY OF EVANSVILLE                ,IN,47722-0002,Private      ,1,5,6,3497,528,4025
00179800,FRANKLIN COLLEGE OF INDIANA             ,IN,46131-2623,Private      ,0,2,2,1729,137,1866
00179900,GOSHEN COLLEGE                          ,IN,46526-4794,Private      ,1,2,3,967,343,1310
00180000,GRACE COLLEGE & THEO SEMINARY           ,IN,46590-1224,Private      ,1,5,6,1444,705,2149
00180100,HANOVER COLLEGE                         ,IN,47243-0108,Private      ,1,0,1,1607,44,1651
00180300,HUNTINGTON UNIVERSITY                   ,IN,46750-1299,Private      ,0,2,2,1260,294,1554
00180400,UNIVERSITY OF INDIANAPOLIS              ,IN,46227-3697,Private      ,10,55,65,4575,2890,7465
00180500,INDIANA INSTITUTE OF TECHNOLOGY         ,IN,46803-1297,Private      ,5,50,55,1429,2797,4226
00180700,INDIANA STATE UNIVERSITY                ,IN,47809-2501,Public       ,18,90,108,8321,5590,13911
00180800,UNIVERSITY OF SOUTHERN INDIANA          ,IN,47712-3596,Public       ,14,45,59,7992,3037,11029
00180900,INDIANA UNIVERSITY-BLOOMINGTON          ,IN,47405-1223,Public       ,60,115,175,28344,10326,38670
00181100,INDIANA UNIV-EAST                       ,IN,47374-1289,Public       ,15,51,66,1112,1853,2965
00181300,INDIANA UNIV-PURDUE UNIV INDPLS         ,IN,46202-5145,Public       ,38,303,341,14277,18503,32780
00181301,INDIANA UNIVERSITY - PURDUE UNIVERSITY I,IN,47203-1769,Public       ,1,25,26,1098,1267,2365
00181400,INDIANA UNIV KOKOMO                     ,IN,46902-3557,Public       ,4,31,35,1403,1739,3142
00181500,INDIANA UNIV-NORTHWEST                  ,IN,46408-1197,Public       ,19,92,111,2425,3866,6291
00181600,INDIANA UNIVERSITY - SOUTH BEND         ,IN,46615-0000,Public       ,22,119,141,3818,4619,8437
00181700,INDIANA UNIVERSITY-SOUTHEAST            ,IN,47150-6405,Public       ,16,63,79,3409,3464,6873
00182000,MANCHESTER COLLEGE                      ,IN,46962-1276,Private      ,1,0,1,2094,111,2205
00182100,MARIAN COLLEGE  (INDIANAPOLIS)          ,IN,46222-1997,Private      ,3,32,35,1821,1632,3453
00182200,INDIANA WESLEYAN UNIVERSITY             ,IN,46953-4974,Private      ,9,465,474,3920,13149,17069
00182300,ASSOCIATED MENNONITE BIBLICAL SEM       ,IN,46517-1999,Private      ,0,0,0,1,84,85
00182400,OAKLAND CITY UNIVERSITY                 ,IN,47660-1099,Private      ,0,14,14,697,1988,2685
00182500,PURDUE UNIVERSITY                       ,IN,47907-2050,Public       ,32,65,97,29948,6631,36579
00182600,PURDUE UNIV NORTH CENTRAL CAMPUS        ,IN,46391-9528,Public       ,10,31,41,2248,2528,4776
00182700,PURDUE UNIV CALUMET                     ,IN,46323-2094,Public       ,26,72,98,5135,4925,10060
00182800,INDIANA UNIV-PURDUE UNIV FORT WAYNE     ,IN,46805-1499,Public       ,18,142,160,7645,6852,14497
00183000,ROSE HULMAN INSTITUTE OF TECHNOLOGY     ,IN,47803-3999,Private      ,3,1,4,2825,80,2905
00183200,UNIVERSITY OF SAINT FRANCIS             ,IN,46808-3994,Private      ,3,32,35,2062,1553,3615
00183300,ST JOSEPH'S COLLEGE                     ,IN,47978-0000,Private      ,2,1,3,1284,124,1408
00183400,CALUMET COLLEGE OF SAINT JOSEPH         ,IN,46394-2195,Private      ,4,20,24,457,893,1350
00183500,SAINT MARY-OF-THE-WOODS COLLEGE         ,IN,47876-0067,Private      ,2,32,34,433,1400,1833
00183600,ST MARY'S COLLEGE                       ,IN,46556-5007,Private      ,1,1,2,1764,53,1817
00183800,TAYLOR UNIVERSITY                       ,IN,46989-1001,Private      ,0,5,5,2231,179,2410
00183801,TAYLOR UNIVERSITY - FORT WAYNE          ,IN,46807-0000,Private      ,0,3,3,556,292,848
00183900,TRINE UNIVERSITY                        ,IN,46703-1764,Private      ,0,13,13,2205,689,2894
00184000,UNIVERSITY OF NOTRE DAME                ,IN,46556-5602,Private      ,7,9,16,11474,3119,14593
00184200,VALPARAISO UNIVERSITY                   ,IN,46383-6493,Private      ,4,22,26,3979,2022,6001
00184300,VINCENNES UNIVERSITY                    ,IN,47591-1523,Public       ,26,85,111,5372,3252,8624
00184400,WABASH COLLEGE                          ,IN,47933-0352,Private      ,1,0,1,1163,36,1199
00224905,DAVENPORT UNIVERSITY-MERRILLVILLE       ,IN,46410-0000,Private      ,0,5,5,64,453,517
00420300,GOOD SAMARITAN HOSP RADIOGRAPHY PRG     ,IN,47591-0000,Public       ,0,0,0,10,8,18
00457900,INTERNATIONAL BUSINESS COLLEGE          ,IN,46804-0000,Proprietary  ,0,4,4,669,279,948
00457901,INTERNATIONAL BUSINESS COLLEGE          ,IN,46256-0000,Proprietary  ,2,1,3,438,156,594
00458300,BROWN MACKIE COLLEGE-SOUTH BEND         ,IN,46617-3123,Proprietary  ,22,211,233,826,4435,5261
00458301,BROWN MACKIE COLLEGE-SOUTH BEND - BROWN ,IN,46805-0000,Proprietary  ,11,85,96,26,183,209
00512730,BROWN MACKIE COLLEGE-MERRILLVILLE       ,IN,46410-0000,Proprietary  ,1,4,5,266,1392,1658
00512731,BROWN MACKIE COLLEGE-CINCINNATI - BROWN ,IN,46360-4362,Proprietary  ,2,21,23,6,52,58
00625700,SAINT ELIZABETH SCHOOL OF NURSING       ,IN,47904-2198,Private      ,0,1,1,137,211,348
00726300,HOLY CROSS COLLEGE                      ,IN,46556-0308,Private      ,3,0,3,568,83,651
00727600,SAINT MEINRAD SCHOOL OF THEOLOGY        ,IN,47577-1002,Private      ,0,1,1,5,116,121
00732700,ITT TECHNICAL INSTITUTE                 ,IN,47630-7430,Proprietary  ,153,379,532,2371,4893,7264
00732900,ITT TECHNICAL INSTITUTE                 ,IN,46268-1119,Proprietary  ,198,918,1116,2848,10041,12889
00736200,MEDTECH COLLEGE                         ,IN,46250-3970,Proprietary  ,8,80,88,116,1122,1238
00736201,STUART SCHOOL OF BUSINESS ADMINISTRATION,IN,46250-2876,Proprietary  ,0,0,0,7,83,90
00736202,MEDTECH COLLEGE - STUART SCHOOL OF BUSIN,IN,46143-6478,Proprietary  ,8,38,46,90,578,668
00736204,MEDTECH COLLEGE - THE STUART SCHOOL     ,IN,46804-2209,Proprietary  ,4,43,47,19,216,235
00793800,LINCOLN COLLEGE OF TECHNOLOGY           ,IN,46202-0000,Proprietary  ,77,159,236,2301,1357,3658
00832900,ITT TECHNICAL INSTITUTE                 ,IN,46825-2393,Proprietary  ,101,385,486,2027,4455,6482
00842300,IVY TECH COMMUNITY COLLEGE OF INDIANA - ,IN,46601-3892,Public       ,45,413,458,2104,7136,9240
00854600,NOT FOR STUDENT USE                     ,IN,46208-4700,Public       ,0,1,1,1085,1658,2743
00854700,IVY TECH COMMUNITY COLLEGE OF INDIANA - ,IN,47802-4898,Public       ,30,189,219,1934,4724,6658
00951500,J MICHAEL HARROLD BEAUTY ACADEMY        ,IN,47807-3390,Proprietary  ,5,6,11,28,55,83
00961200,"APEX SCHOOL OF BEAUTY CULTURE, INC      ",IN,46016-0000,Proprietary  ,0,2,2,15,25,40
00961300,MERRILLVILLE BEAUTY COLLEGE             ,IN,46410-3401,Proprietary  ,1,6,7,41,131,172
00967300,RUDAE'S SCHOOL OF BEAUTY CULTURE        ,IN,46825-5444,Proprietary  ,7,6,13,89,176,265
00967301,RUDAE'S SCHOOL OF BEAUTY CULTURE - FORT ,IN,46825-5444,Proprietary  ,0,0,0,24,31,55
00977700,KAPLAN COLLEGE                          ,IN,46278-1736,Proprietary  ,52,182,234,550,2116,2666
00977701,KAPLAN COLLEGE - ADDITIONAL CLASSROOM   ,IN,46278-1734,Proprietary  ,0,0,0,5,29,34
00977702,KAPLAN COLLEGE - TEMPORARY FACILITY EXPA,IN,46268-4111,Proprietary  ,0,0,0,6,47,53
00977703,KAPLAN COLLEGE -  SE INDY               ,IN,46227-0000,Proprietary  ,8,69,77,11,85,96
00991700,IVY TECH COMMUNITY COLLEGE OF INDIANA - ,IN,46208-1763,Public       ,110,601,711,6290,13943,20233
00992300,IVY TECH COMMUNITY COLLEGE OF INDIANA - ,IN,47250-1881,Public       ,23,119,142,826,2125,2951
00992400,IVY TECH COMMUNITY COLLEGE OF INDIANA - ,IN,47302-9448,Public       ,44,287,331,2836,6414,9250
00992500,IVY TECH COMMUNITY COLLEGE OF INDIANA - ,IN,47710-3398,Public       ,26,172,198,1896,4213,6109
00992600,IVY TECH COMMUNITY COLLEGE OF INDIANA- R,IN,46805-1489,Public       ,74,477,551,3566,8554,12120
01003700,IVY TECH STATE COLLEGE - REGION 9       ,IN,47374-1220,Public       ,16,228,244,888,3250,4138
01003800,IVY TECH COMMUNITY COLLEGE OF INDIANA - ,IN,47203-1868,Public       ,23,175,198,1208,3194,4402
01003900,IVY TECH COMMUNITY COLLEGE OF INDIANA - ,IN,47903-6299,Public       ,26,220,246,2656,4496,7152
01004000,IVY TECH COMMUNITY COLLEGE OF INDIANA - ,IN,46409-1303,Public       ,44,337,381,2103,6320,8423
01004100,IVY TECH STATE COLLEGE - REGION 5       ,IN,46903-1373,Public       ,20,230,250,1318,4430,5748
01010900,IVY TECH COMMUNITY COLLEGE OF INDIANA - ,IN,47172-1897,Public       ,19,124,143,1121,2869,3990
01015100,VINCENNES BEAUTY COLLEGE                ,IN,47591-1297,Proprietary  ,0,2,2,30,54,84
01040900,LAFAYETTE BEAUTY ACADEMY                ,IN,47901-1149,Proprietary  ,3,2,5,44,76,120
01061800,MID-AMERICA CLG FUNERAL SERVICE         ,IN,47130-9990,Private      ,2,2,4,49,94,143
01150500,CREATIVE HAIR STYLING ACADEMY           ,IN,46322-1554,Proprietary  ,0,5,5,51,80,131
02084800,RAVENSCROFT BEAUTY COLLEGE              ,IN,46815-0000,Proprietary  ,8,29,37,59,218,277
02087600,CONCORDIA THEOLOGICAL SEMINARY          ,IN,46825-0000,Private      ,1,6,7,4,279,283
02100402,EVEREST INSTITUTE - EVEREST COLLEGE     ,IN,46410-5683,Proprietary  ,13,132,145,286,1390,1676
02118900,EVANSVILLE TRI STATE BEAUTY COLLEGE     ,IN,47715-0000,Proprietary  ,0,0,0,15,16,31
02140800,MARTIN UNIVERSITY                       ,IN,46218-0000,Private      ,11,70,81,165,1340,1505
02158400,HARRISON COLLEGE                        ,IN,46204-2611,Proprietary  ,7,68,75,688,3036,3724
02158401,HARRISON COLLEGE - COLUMBUS             ,IN,47203-1843,Proprietary  ,2,6,8,97,422,519
02158402,HARRISON COLLEGE - LAFAYETTE            ,IN,47905-4859,Proprietary  ,2,5,7,138,477,615
02158404,HARRISON COLLEGE - MARION               ,IN,46952-0000,Proprietary  ,0,0,0,48,213,261
02158405,HARRISON COLLEGE - TERRE HAUTE          ,IN,47802-0000,Proprietary  ,0,9,9,84,475,559
02158407,HARRISON COLLEGE - ANDERSON             ,IN,46013-0000,Proprietary  ,1,13,14,98,413,511
02158409,HARRISON COLLEGE - EVANSVILLE           ,IN,47715-3901,Proprietary  ,2,12,14,118,457,575
02158410,HARRISON COLLEGE - EAST                 ,IN,46239-8903,Proprietary  ,3,16,19,203,973,1176
02158412,HARRISON COLLEGE - FORT WAYNE           ,IN,46825-0000,Proprietary  ,2,11,13,235,864,1099
02158413,HARRISON COLLEGE - NORTHWEST            ,IN,46278-0000,Proprietary  ,3,7,10,177,418,595
02158800,DON ROBERTS BEAUTY SCHOOLS              ,IN,46383-0000,Proprietary  ,0,3,3,22,40,62
02164300,DON ROBERTS SCHOOL OF HAIR DESIGN       ,IN,46375-9999,Proprietary  ,0,0,0,27,74,101
02201800,KAPLAN COLLEGE                          ,IN,46410-0000,Proprietary  ,5,53,58,140,743,883
02201802,KAPLAN COLLEGE - HAMMOND                ,IN,46324-3347,Proprietary  ,9,90,99,217,1104,1321
02241700,PJ'S COLLEGE OF COSMETOLOGY             ,IN,47129-0000,Proprietary  ,4,29,33,49,185,234
02302700,J EVERETT LIGHT CAREER CENTER           ,IN,46240-0000,Public       ,0,3,3,37,191,228
02304800,PJ'S COLLEGE OF COSMETOLOGY             ,IN,47374-0000,Proprietary  ,1,6,7,20,57,77
02308900,MASTER'S OF COSMETOLOGY COLLEGE         ,IN,46809-0000,Proprietary  ,1,1,2,57,64,121
02339600,ROGER'S ACADEMY OF HAIR DESIGN          ,IN,47712-0000,Proprietary  ,10,10,20,101,184,285
02345200,EMPIRE BEAUTY SCHOOL                    ,IN,46237-0000,Proprietary  ,6,28,34,117,314,431
02351300,KNOX BEAUTY COLLEGE                     ,IN,46534-0000,Proprietary  ,0,1,1,8,21,29
02490500,HAIR FASHIONS BY KAYE BEAUTY CLG        ,IN,46250-0000,Proprietary  ,0,5,5,26,67,93
02490800,HAIR FASHIONS BY KAYE BEAUTY CLG        ,IN,46060-0000,Proprietary  ,5,19,24,56,245,301
02607000,HAIR ARTS ACADEMY                       ,IN,47404-3581,Proprietary  ,1,1,2,27,57,84
02615800,COLLEGE OF COURT REPORTING              ,IN,46342-5969,Proprietary  ,0,9,9,22,357,379
02616203,BROWN MACKIE COLLEGE-FINDLAY - INDIANAPO,IN,46204-1017,Proprietary  ,4,62,66,168,1098,1266
03009700,HARRISON COLLEGE                        ,IN,47303-6413,Proprietary  ,3,2,5,111,424,535
03009701,HARRISON COLLEGE - MUNCIE - ELKHART     ,IN,46516-9795,Proprietary  ,0,14,14,85,387,472
03084601,THE ART INSTITUTE OF INDIANAPOLIS       ,IN,46268-1170,Proprietary  ,19,39,58,1028,1026,2054
03100600,MARION COMM TUCKER AREA VOC SCHOOL      ,IN,46952-3831,Public       ,0,1,1,50,121,171
03176300,AMERICAN TRANS AIR AVIATION ACADEMY     ,IN,46241-1445,Proprietary  ,7,34,41,59,312,371
03262300,DAVID DEMUTH INSTITUTE OF COSM          ,IN,47374-4101,Proprietary  ,0,6,6,23,49,72
03456700,CROSSROADS BIBLE COLLEGE                ,IN,46219-4912,Private      ,0,8,8,58,228,286
03521300,IVY TECH COMMUNITY COLLEGE OF INDIANA - ,IN,47404-9772,Public       ,20,135,155,2680,3978,6658
03538300,ALEXANDRIA SCH OF SCIENTIFIC THERAP     ,IN,46001-0287,Proprietary  ,0,0,0,24,53,77
04038700,IDEAL BEAUTY ACADEMY                    ,IN,47130-4215,Proprietary  ,1,7,8,18,74,92
04100300,SUCCESS SCHOOLS                         ,IN,46410-5310,Proprietary  ,2,8,10,29,132,161
04119700,MOLER HAIRSTYLING COLLEGE               ,IN,46406-1745,Proprietary  ,0,0,0,4,51,55
04121000,TECHSKILLS - INDIANAPOLIS               ,IN,46240-4302,Proprietary  ,0,23,23,13,218,231
04130900,HONORS BEAUTY COLLEGE                   ,IN,46256-3317,Proprietary  ,3,5,8,58,168,226
00163203,AQUINAS INSTITUTE OF THEOLOGY - MINISTRY,KS,66109-3718,Private      ,0,0,0,0,4,4
00190100,ALLEN COUNTY COMMUNITY COLLEGE          ,KS,66749-1607,Public       ,15,106,121,875,1239,2114
00190200,COWLEY COUNTY COMMUNITY COLLEGE & AREA V,KS,67005-2662,Public       ,22,98,120,1496,2213,3709
00190300,BAKER UNIVERSITY                        ,KS,66006-0065,Private      ,3,67,70,1489,2851,4340
00190400,BETHANY COLLEGE                         ,KS,67456-1897,Private      ,2,0,2,806,109,915
00190500,BETHEL COLLEGE                          ,KS,67117-0531,Private      ,1,0,1,511,136,647
00190600,BUTLER COUNTY COMMUNITY COLLEGE         ,KS,67042-3280,Public       ,50,142,192,3106,3886,6992
00190700,CENTRAL BAPTIST THEOLOGY SEMINARY       ,KS,66226-3513,Private      ,0,0,0,0,33,33
00190800,CENTRAL CHRISTIAN COLLEGE OF KANSAS     ,KS,67460-5799,Private      ,2,0,2,444,62,506
00190900,CLOUD COUNTY COMMUNITY COLLEGE          ,KS,66901-1002,Public       ,6,30,36,705,857,1562
00191000,COFFEYVILLE COMMUNITY COLLEGE           ,KS,67337-5064,Public       ,28,12,40,1003,394,1397
00191100,COLBY COMMUNITY COLLEGE                 ,KS,67701-4099,Public       ,12,10,22,612,345,957
00191300,DODGE CITY COMMUNITY COLLEGE            ,KS,67801-2399,Public       ,21,28,49,549,435,984
00191400,DONNELLY COLLEGE                        ,KS,66102-4298,Private      ,16,63,79,234,805,1039
00191500,FORT HAYS STATE UNIVERSITY              ,KS,67601-4099,Public       ,12,99,111,3286,3578,6864
00191600,FORT SCOTT COMMUNITY COLLEGE            ,KS,66701-3199,Public       ,23,27,50,1129,755,1884
00191700,BARCLAY COLLEGE                         ,KS,67059-0288,Private      ,0,1,1,109,63,172
00191800,FRIENDS UNIVERSITY                      ,KS,67213-3397,Private      ,1,36,37,1212,2662,3874
00191900,GARDEN CITY COMMUNITY COLLEGE           ,KS,67846-6398,Public       ,9,25,34,818,561,1379
00192000,HESSTON COLLEGE                         ,KS,67062-2093,Private      ,1,0,1,438,163,601
00192100,HIGHLAND COMMUNITY COLLEGE              ,KS,66035-4062,Public       ,21,34,55,1134,927,2061
00192114,HIGHLAND COMMUNITY COLLEGE - NOTHEAST KA,KS,66002-1513,Public       ,0,2,2,74,139,213
00192300,HUTCHINSON COMMUNITY COLLEGE            ,KS,67501-5894,Public       ,30,109,139,1779,1917,3696
00192400,INDEPENDENCE COMMUNITY COLLEGE          ,KS,67301-0000,Public       ,28,27,55,500,333,833
00192500,KANSAS CITY KANSAS COMMUNITY CLG        ,KS,66112-9978,Public       ,22,137,159,1505,3420,4925
00192502,"KANSAS CITY KS AREA TECH SCHOOL, KS     ",KS,66104-0000,Public       ,2,4,6,148,358,506
00192600,PITTSBURG STATE UNIVERSITY              ,KS,66762-7500,Public       ,13,60,73,4306,2496,6802
00192700,EMPORIA STATE UNIVERSITY                ,KS,66801-5087,Public       ,8,26,34,3306,2606,5912
00192800,KANSAS STATE UNIVERSITY                 ,KS,66506-1104,Public       ,46,96,142,14222,5508,19730
00192900,KANSAS WESLEYAN UNIVERSITY              ,KS,67401-6196,Private      ,2,2,4,852,379,1231
00193000,LABETTE COMMUNITY COLLEGE               ,KS,67357-4299,Public       ,10,27,37,558,745,1303
00193100,MANHATTAN CHRISTIAN COLLEGE             ,KS,66502-4081,Private      ,0,2,2,339,126,465
00193300,MCPHERSON COLLEGE                       ,KS,67460-3899,Private      ,1,3,4,666,148,814
00193600,NEOSHO COUNTY COMMUNITY COLLEGE         ,KS,66720-2699,Public       ,5,35,40,573,751,1324
00193700,OTTAWA UNIVERSITY                       ,KS,66067-3399,Private      ,9,118,127,1058,2589,3647
00193800,PRATT COMMUNITY COLLEGE                 ,KS,67124-8432,Public       ,3,13,16,525,454,979
00193900,NEWMAN UNIVERSITY                       ,KS,67213-2084,Private      ,2,19,21,885,1255,2140
00194000,SOUTHWESTERN COLLEGE                    ,KS,67156-2499,Private      ,3,54,57,676,1187,1863
00194300,UNIVERSITY OF ST MARY                   ,KS,66048-5023,Private      ,1,19,20,556,584,1140
00194500,STERLING COLLEGE                        ,KS,67579-1533,Private      ,0,7,7,825,173,998
00194600,TABOR COLLEGE                           ,KS,67063-1799,Private      ,1,4,5,676,176,852
00194800,UNIVERSITY OF KANSAS                    ,KS,66045-7535,Public       ,75,115,190,15078,8962,24040
00194900,WASHBURN UNIVERSITY                     ,KS,66621-1110,Public       ,20,60,80,3093,4212,7305
00195000,WICHITA STATE UNIVERSITY                ,KS,67208-0001,Public       ,41,156,197,6059,6962,13021
00460800,BARTON COUNTY COMMUNITY COLLEGE         ,KS,67530-9283,Public       ,7,39,46,743,1173,1916
00526400,FLINT HILLS TECHNICAL COLLEGE           ,KS,66801-5999,Public       ,1,1,2,189,326,515
00526500,NORTH CENTRAL KANSAS TECH COLG          ,KS,67420-0000,Public       ,0,5,5,330,201,531
00526700,NORTHWEST KANSAS TECHNICAL SCHOOL       ,KS,67735-3441,Public       ,0,0,0,202,94,296
00549800,WICHITA AREA TECHNICAL COLLEGE          ,KS,67211-2099,Public       ,17,82,99,457,1618,2075
00549900,SALINA AREA TECHNICAL COLLEGE           ,KS,67401-8195,Public       ,0,2,2,151,118,269
00550000,MANHATTAN AREA TECHNICAL COLLEGE        ,KS,66503-2499,Public       ,2,11,13,261,319,580
00675500,BROWN MACKIE COLLEGE (THE)              ,KS,67401-7307,Proprietary  ,13,102,115,300,1435,1735
00703200,MID AMERICA NAZARENE UNIVERSITY         ,KS,66062-1899,Private      ,0,40,40,1018,946,1964
00817200,SOUTHWEST KANSAS TECHNICAL SCHOOL       ,KS,67905-2013,Public       ,0,0,0,40,15,55
00822800,SEWARD CO COMM CO/AREA TECHNICAL SCHOOL ,KS,67905-0000,Public       ,1,17,18,389,378,767
00824400,JOHNSON COUNTY COMMUNITY COLLEGE        ,KS,66210-1299,Public       ,54,210,264,4432,5621,10053
00833200,B-STREET DESIGN SCHOOL OF INTERNATIONAL ,KS,66502-6082,Proprietary  ,4,13,17,32,91,123
00868200,ACADEMY OF HAIR DESIGN                  ,KS,67401-2803,Proprietary  ,1,5,6,29,49,78
01025600,BENEDICTINE COLLEGE                     ,KS,66002-1499,Private      ,2,2,4,1757,147,1904
01043800,HASKELL INDIAN NATIONS UNIVERSITY       ,KS,66046-4800,Public       ,7,9,16,824,640,1464
01050300,WICHITA TECHNICAL INSTITUTE             ,KS,67213-1927,Proprietary  ,15,78,93,376,2365,2741
01050305,WICHITA TECHNICAL INSTITUTE - EAST CAMPU,KS,67208-4243,Proprietary  ,0,1,1,0,1,1
01068900,KAW AREA TECHNICAL SCHOOL               ,KS,66604-2199,Public       ,0,4,4,164,391,555
02090700,CLEVELAND CHIROPRACTIC COLLEGE          ,KS,66210-1613,Private      ,2,6,8,57,590,647
02134800,OLD TOWN BARBER AND BEAUTY COLLEGE      ,KS,67211-0000,Proprietary  ,2,10,12,25,99,124
02196400,CAPITOL CITY HAIR DESIGN COLLEGE        ,KS,66102-0000,Proprietary  ,3,30,33,42,226,268
02257700,HAYS ACADEMY OF HAIR DESIGN             ,KS,67601-0000,Proprietary  ,0,4,4,34,51,85
02303500,AMERICAN INSTITUTE OF BAKING            ,KS,66502-0000,Private      ,0,0,0,7,12,19
02340700,LABARON HAIRDRESSING ACADEMY            ,KS,66204-0000,Proprietary  ,0,8,8,16,73,89
02590900,WRIGHT CAREER COLLEGE                   ,KS,66212-0000,Private      ,35,239,274,297,2213,2510
02599709,VATTEROTT COLLEGE - WICHITA             ,KS,67226-1304,Proprietary  ,2,26,28,77,534,611
02603100,XENON INTERNATIONAL ACADEMY             ,KS,67203-5428,Proprietary  ,6,13,19,165,206,371
02606300,VERNON'S KANSAS SCHOOL OF COSMETOLOGY   ,KS,67217-2803,Proprietary  ,9,12,21,35,79,114
02611005,HERITAGE COLLEGE - WICHITA              ,KS,67210-1879,Proprietary  ,55,206,261,235,966,1201
02613000,PINNACLE CAREER INSTITUTE               ,KS,66046-2703,Proprietary  ,8,31,39,69,313,382
03031300,XENON INTERNATIONAL ACADEMY IV          ,KS,66061-3765,Proprietary  ,4,8,12,46,90,136
03066200,BRYAN COLLEGE                           ,KS,66604-2496,Proprietary  ,1,15,16,54,311,365
03450300,B-STREET DESIGN SCHOOL OF INTERNATIONAL ,KS,66611-2373,Proprietary  ,2,17,19,49,123,172
03450301,B-STREET DESIGN SCHOOL OF INTERNATIONAL ,KS,67207-5148,Proprietary  ,4,8,12,39,98,137
03450302,B-STREET DESIGN SCHOOL OF INTERNATIONAL ,KS,66212-5451,Proprietary  ,5,12,17,68,139,207
03529300,SIDNEY'S HAIRDRESSING COLLEGE           ,KS,67501-7094,Proprietary  ,0,4,4,36,65,101
03862300,BMSI INSTITUTE                          ,KS,66212-3388,Proprietary  ,1,0,1,2,12,14
04132900,Z HAIR ACADEMY                          ,KS,66046-4040,Proprietary  ,1,3,4,18,38,56
00203300,UNIVERSITY OF MAINE-PRESQUE ISLE        ,ME,04769-2888,Public       ,1,2,3,717,444,1161
00203500,BANGOR THEOLOGICAL SEMINARY             ,ME,04402-0411,Private      ,0,1,1,1,88,89
00203600,BATES COLLEGE                           ,ME,04240-6028,Private      ,3,0,3,2749,42,2791
00203800,BOWDOIN COLLEGE                         ,ME,04011-8451,Private      ,0,2,2,3478,51,3529
00203900,COLBY COLLEGE                           ,ME,04901-8841,Private      ,2,0,2,2721,40,2761
00204000,UNIVERSITY OF MAINE-FARMINGTON          ,ME,04938-1990,Public       ,3,6,9,2654,418,3072
00204100,UNIVERSITY OF MAINE-FORT KENT           ,ME,04743-1292,Public       ,0,4,4,488,288,776
00204300,HUSSON UNIVERSITY                       ,ME,04401-2999,Private      ,3,13,16,2233,934,3167
00204400,MAINE MARITIME ACADEMY                  ,ME,04420-0001,Public       ,2,1,3,895,118,1013
00205000,UNIVERSITY OF NEW ENGLAND               ,ME,04005-9599,Private      ,1,18,19,3591,2228,5819
00205100,SAINT JOSEPH'S COLLEGE                  ,ME,04084-5263,Private      ,2,15,17,1643,442,2085
00205200,THOMAS COLLEGE                          ,ME,04901-5097,Private      ,1,0,1,921,153,1074
00205300,UNIVERSITY OF MAINE                     ,ME,04469-0001,Public       ,10,28,38,10605,2889,13494
00205400,UNIVERSITY OF SOUTHERN MAINE            ,ME,04104-0000,Public       ,8,19,27,6180,4474,10654
00205500,UNIVERSITY OF MAINE-MACHIAS             ,ME,04654-1397,Public       ,1,5,6,543,260,803
00520400,BEAL COLLEGE                            ,ME,04401-6896,Proprietary  ,4,14,18,201,538,739
00527600,CENTRAL MAINE COMMUNITY COLLEGE         ,ME,04210-6498,Public       ,5,7,12,1391,1282,2673
00527700,EASTERN MAINE COMMUNITY COLLEGE         ,ME,04401-4280,Public       ,4,3,7,1413,1044,2457
00552500,SOUTHERN MAINE COMMUNITY  COLLEGE       ,ME,04106-1698,Public       ,17,11,28,2763,2400,5163
00576000,NORTHERN MAINE COMMUNITY COLLEGE        ,ME,04769-2016,Public       ,0,5,5,500,615,1115
00577600,MERCY HOSP SCH OF RADIOLOGIC TECH       ,ME,04101-3795,Private      ,0,0,0,8,32,40
00630501,CENTRAL MAINE MEDICAL CENTER - COLLEGE O,ME,04240-4500,Private      ,0,2,2,32,194,226
00676000,UNIVERSITY OF MAINE-AUGUSTA             ,ME,04330-9410,Public       ,3,24,27,1635,4439,6074
00685800,UNITY COLLEGE                           ,ME,04988-9502,Private      ,1,0,1,851,76,927
00903800,MR BERNARD'S SCH HAIR FASHION INC       ,ME,04243-1163,Proprietary  ,0,5,5,42,132,174
00923100,WASHINGTON COUNTY COMMUNITY COLLEGE     ,ME,04619-9704,Public       ,1,3,4,239,228,467
00929200,ANDOVER COLLEGE                         ,ME,04106-2415,Proprietary  ,9,54,63,225,856,1081
00929201,ANDOVER COLLEGE -                       ,ME,04240-0000,Proprietary  ,6,55,61,202,998,1200
00945900,PIERRE'S SCHOOL OF COSMETOLOGY          ,ME,04101-3348,Proprietary  ,11,23,34,212,343,555
00945901,PIERRE'S SCHOOL OF COSMETOLOGY - SANFORD,ME,04073-3564,Proprietary  ,0,0,0,1,4,5
00945902,PIERRE'S SCHOOL OF COSMETOLOGY - CARIBOU,ME,04736-2020,Proprietary  ,0,0,0,8,5,13
00945903,PIERRE'S SCHOOL OF COSMETOLOGY - BANGOR ,ME,04401-6534,Proprietary  ,0,0,0,20,24,44
00982600,KENNEBEC VALLEY  COMMUNITY  COLLEGE     ,ME,04937-1367,Public       ,1,19,20,665,1372,2037
01138500,COLLEGE OF THE ATLANTIC                 ,ME,04609-1105,Private      ,0,0,0,445,60,505
01167300,MAINE COLLEGE OF ART                    ,ME,04101-3987,Private      ,2,1,3,547,157,704
02104400,SPA TECH INSTITUTE                      ,ME,04102-0000,Proprietary  ,8,24,32,189,493,682
02347100,NEW ENGLAND SCHOOL OF COMMUNICATIONS    ,ME,04401-0000,Private      ,3,0,3,499,87,586
02361300,LANDING SCHOOL OF BOATBUILDING & DESIGN ,ME,04046-1490,Private      ,0,1,1,30,36,66
03122900,YORK COUNTY COMMUNITY COLLEGE           ,ME,04090-0529,Public       ,4,27,31,435,501,936
03429300,SEACOAST CAREER SCHOOLS                 ,ME,04073-0000,Proprietary  ,22,107,129,184,883,1067
03612300,BIRTHWISE MIDWIFERY SCHOOL              ,ME,04009-1110,Proprietary  ,0,0,0,6,41,47
00209300,ST JOHN'S COLLEGE                       ,NM,87505-4599,Private      ,2,2,4,491,201,692
00264900,COLLEGE OF SANTA FE                     ,NM,87505-7634,Private      ,2,3,5,773,711,1484
00265000,UNIVERSITY OF THE SOUTHWEST             ,NM,88240-9129,Private      ,1,14,15,325,428,753
00265100,EASTERN NEW MEXICO UNIV PORTALES        ,NM,88130-6000,Public       ,5,42,47,2421,2195,4616
00265101,EASTERN NEW MEXICO UNIV-ROSWELL CAM     ,NM,88202-0000,Public       ,11,37,48,964,1403,2367
00265300,NEW MEXICO HIGHLANDS UNIVERSITY         ,NM,87701-4436,Public       ,4,15,19,1518,1947,3465
00265400,NEW MEXICO INST OF MINING & TECH        ,NM,87801-4796,Public       ,4,7,11,984,310,1294
00265500,NEW MEXICO JUNIOR COLLEGE               ,NM,88240-9123,Public       ,24,40,64,701,793,1494
00265600,NEW MEXICO MILITARY INSTITUTE           ,NM,88201-5173,Public       ,0,1,1,294,23,317
00265700,NEW MEXICO STATE UNIVERSITY             ,NM,88003-8001,Public       ,53,154,207,9799,7881,17680
00265701,NEW MEXICO STATE UNIV-ALAMOGORDO        ,NM,88311-0000,Public       ,4,38,42,402,1066,1468
00265702,NEW MEXICO STATE UNIV.-DONA ANA CLG     ,NM,88003-0000,Public       ,22,84,106,1827,2852,4679
00265703,NEW MEXICO STATE UNIV-CARLSBAD          ,NM,88220-0000,Public       ,2,25,27,299,669,968
00265704,NEW MEXICO STATE UNIV-GRANTS            ,NM,87020-0000,Public       ,4,17,21,191,405,596
00266000,SAN JUAN COLLEGE                        ,NM,87402-4699,Public       ,26,120,146,1391,2720,4111
00266300,THE UNIVERSITY OF NEW MEXICO            ,NM,87131-0001,Public       ,101,279,380,12529,13748,26277
00266301,UNIV OF NEW MEXICO - GALLUP BRANCH      ,NM,87301-5697,Public       ,7,13,20,406,743,1149
00266302,UNIV OF NEW MEXICO - VALENCIA BRANCH    ,NM,87031-0000,Public       ,1,9,10,296,414,710
00266303,UNIV OF NEW MEXICO - LOS ALAMOS         ,NM,87544-0000,Public       ,0,4,4,99,110,209
00266304,UNIVERSITY OF NEW MEXICO                ,NM,87571-6401,Public       ,0,2,2,12,33,45
00266400,WESTERN NEW MEXICO UNIVERSITY           ,NM,88061-5417,Public       ,9,43,52,966,1661,2627
00369109,MIDDLEBURY COLLEGE - INSTITUTE OF AMERIC,NM,87505-0000,Private      ,0,0,0,1,0,1
00405701,NATIONAL AMERICAN UNIVERSITY            ,NM,87110-0000,Proprietary  ,1,12,13,25,358,383
00474200,CENTRAL NEW MEXICO COMMUNITY COLLEGE    ,NM,87106-4096,Public       ,223,1066,1289,6016,13845,19861
00474300,CLOVIS COMMUNITY COLLEGE                ,NM,88101-8381,Public       ,7,48,55,553,1505,2058
00996200,LUNA COMMUNITY COLLEGE                  ,NM,87701-0000,Public       ,4,14,18,384,498,882
01063200,DEWOLFF CLG HAIRSTYLING/COSMETOLOGY     ,NM,87112-4113,Proprietary  ,4,22,26,45,156,201
01300500,OLYMPIAN UNIVERSITY OF COSMETOLOGY      ,NM,88310-5051,Proprietary  ,35,98,133,428,1023,1451
02083900,NORTHERN NEW MEXICO COLLEGE             ,NM,87530-0000,Public       ,3,33,36,550,957,1507
02146400,INSTITUTE OF AMERICAN INDIAN ARTS       ,NM,87508-0000,Public       ,0,1,1,176,207,383
02151102,ATI COLLEGE OF HEALTH - ATI CAREER TRAIN,NM,87109-2016,Proprietary  ,0,5,5,12,50,62
02218808,IIA COLLEGE - ALBUQUERQUE               ,NM,87105-1649,Proprietary  ,4,38,42,5,39,44
02278100,SANTA FE COMMUNITY COLLEGE              ,NM,87507-0000,Public       ,12,65,77,654,1385,2039
02357600,CROWNPOINT INSTITUTE OF TECHNOLOGY      ,NM,87313-0000,Public       ,3,16,19,241,502,743
02491501,THE ART CENTER DESIGN COLLEGE- ALBQ     ,NM,87110-0000,Proprietary  ,0,0,0,42,22,64
02511000,SOUTHWESTERN INDIAN POLYTECH INST       ,NM,87184-0000,Public       ,20,20,40,311,409,720
02572003,COMPUTER CAREER CENTER - LAS CRUCES CAMP,NM,88011-8220,Proprietary  ,5,56,61,11,124,135
02622000,SOUTHWEST ACUPUNCTURE COLLEGE           ,NM,87505-0000,Proprietary  ,0,7,7,5,308,313
03076100,SOUTHWESTERN COLLEGE                    ,NM,87507-0000,Private      ,0,1,1,2,158,160
03128200,KAPLAN CAREER INSTITUTE                 ,NM,87109-2072,Proprietary  ,0,0,0,10,37,47
03128201,KAPLAN CAREER INSTITUTE                 ,NM,87109-0000,Proprietary  ,0,0,0,2,10,12
03206300,MESALANDS COMMUNITY COLLEGE             ,NM,88401-3352,Public       ,1,19,20,152,256,408
03430300,UNIVERSAL THERAPEUTIC MASSAGE INSTITUTE ,NM,87107-4403,Proprietary  ,2,8,10,43,146,189
03678300,PIMA MEDICAL INSTITUTE                  ,NM,87110-4127,Proprietary  ,3,2,5,46,109,155
03944300,MASSAGE THERAPY TRAINING INSTITUTE      ,NM,88007-0000,Proprietary  ,0,1,1,26,40,66
00223400,ADRIAN COLLEGE                          ,MI,49221-2575,Private      ,4,6,10,2529,230,2759
00223500,ALBION COLLEGE                          ,MI,49224-1831,Private      ,1,0,1,2296,69,2365
00223600,ALMA COLLEGE                            ,MI,48801-1599,Private      ,2,1,3,2168,105,2273
00223700,ALPENA COMMUNITY COLLEGE                ,MI,49707-1495,Public       ,10,30,40,1088,1197,2285
00223800,ANDREWS UNIVERSITY                      ,MI,49104-0750,Private      ,6,22,28,1633,1212,2845
00223900,AQUINAS COLLEGE                         ,MI,49506-1799,Private      ,2,20,22,2210,699,2909
00224000,BAY DE NOC COMMUNITY COLLEGE            ,MI,49829-2524,Public       ,6,30,36,1155,1366,2521
00224100,CALVIN COLLEGE                          ,MI,49546-4388,Private      ,3,5,8,4013,285,4298
00224200,CALVIN THEOLOGICAL SEMINARY             ,MI,49546-4387,Private      ,0,0,0,14,178,192
00224300,CENTRAL MICHIGAN UNIVERSITY             ,MI,48859-0001,Public       ,41,172,213,19529,9476,29005
00224600,CLEARY UNIVERSITY                       ,MI,48105-2659,Private      ,2,20,22,215,824,1039
00224700,CONCORDIA UNIVERSITY-ANN ARBOR          ,MI,48105-2797,Private      ,0,13,13,550,529,1079
00224800,CRANBROOK ACADEMY OF ART                ,MI,48303-0000,Private      ,0,0,0,19,226,245
00224900,DAVENPORT UNIVERSITY                    ,MI,49503-0000,Private      ,39,481,520,3288,13498,16786
00225100,DELTA COLLEGE                           ,MI,48710-0001,Public       ,55,190,245,5766,7525,13291
00225400,MICHIGAN STATE UNIVERSITY COLLEGE OF LAW,MI,48824-1300,Private      ,1,6,7,334,1579,1913
00225900,EASTERN MICHIGAN UNIVERSITY             ,MI,48197-2214,Public       ,113,282,395,13731,11223,24954
00226000,FERRIS STATE UNIVERSITY                 ,MI,49307-2251,Public       ,36,94,130,11961,5879,17840
00226100,CHARLES STEWART MOTT COMMUNITY CLG      ,MI,48503-2089,Public       ,78,454,532,5279,10254,15533
00226200,KETTERING UNIVERSITY                    ,MI,48504-4898,Private      ,7,9,16,2317,346,2663
00226300,GLEN OAKS COMMUNITY COLLEGE             ,MI,49032-9784,Public       ,10,48,58,540,1075,1615
00226400,GOGEBIC COMMUNITY COLLEGE               ,MI,49938-1365,Public       ,4,21,25,556,585,1141
00226500,GRACE BIBLE COLLEGE                     ,MI,49509-1998,Private      ,0,2,2,228,62,290
00226600,CORNERSTONE UNIVERSITY                  ,MI,49525-5897,Private      ,1,29,30,1454,1798,3252
00226700,GRAND RAPIDS COMMUNITY COLLEGE          ,MI,49503-3295,Public       ,104,354,458,9010,9687,18697
00226800,GRAND VALLEY STATE UNIVERSITY           ,MI,49401-9403,Public       ,51,131,182,19957,7175,27132
00226900,GREAT LAKES CHRISTIAN COLLEGE           ,MI,48917-1299,Private      ,1,0,1,182,148,330
00227000,HENRY FORD COMMUNITY COLLEGE            ,MI,48128-1495,Public       ,109,386,495,8508,12339,20847
00227300,HOPE COLLEGE                            ,MI,49423-3607,Private      ,4,1,5,3871,155,4026
00227400,JACKSON COMMUNITY COLLEGE               ,MI,49201-8399,Public       ,45,321,366,3448,5737,9185
00227500,KALAMAZOO COLLEGE                       ,MI,49006-3295,Private      ,0,6,6,1777,96,1873
00227600,KELLOGG COMMUNITY COLLEGE               ,MI,49017-3397,Public       ,27,195,222,2195,4649,6844
00227700,LAKE MICHIGAN COLLEGE                   ,MI,49022-1899,Public       ,13,118,131,1523,2765,4288
00227800,LANSING COMMUNITY COLLEGE               ,MI,48933-1293,Public       ,136,662,798,7306,11577,18883
00227900,LAWRENCE TECHNOLOGICAL UNIVERSITY       ,MI,48075-1058,Private      ,6,60,66,1809,1565,3374
00228200,MADONNA UNIVERSITY                      ,MI,48150-1173,Private      ,4,49,53,1398,2720,4118
00228400,MARYGROVE COLLEGE                       ,MI,48221-2599,Private      ,1,161,162,672,3156,3828
00228800,ROCHESTER COLLEGE                       ,MI,48307-2764,Private      ,0,10,10,636,698,1334
00228801,ROCHESTER COLLEGE - MACOMB COMMUNITY COL,MI,48038-1139,Private      ,9,23,32,85,182,267
00228802,ROCHESTER COLLEGE - MOTT COMMUNITY COLLE,MI,48503-2089,Private      ,2,14,16,27,93,120
00228803,ROCHESTER COLLEGE  - SPECS HOWARD       ,MI,48075-3953,Private      ,1,1,2,3,10,13
00229000,MICHIGAN STATE UNIVERSITY               ,MI,48824-1113,Public       ,128,286,414,32648,11120,43768
00229200,MICHIGAN TECHNOLOGICAL UNIV             ,MI,49931-1295,Public       ,11,5,16,5793,875,6668
00229300,LAKE SUPERIOR STATE UNIVERSITY          ,MI,49783-1691,Public       ,3,13,16,2346,925,3271
00229400,MONROE COUNTY COMMUNITY CLG             ,MI,48161-9746,Public       ,14,67,81,1377,2004,3381
00229500,MONTCALM COMMUNITY COLLEGE              ,MI,48885-9723,Public       ,12,74,86,907,2001,2908
00229700,MUSKEGON COMMUNITY COLLEGE              ,MI,49442-1432,Public       ,19,135,154,2773,3564,6337
00229900,NORTH CENTRAL MICHIGAN COLLEGE          ,MI,49770-8740,Public       ,1,29,30,980,1751,2731
00230100,NORTHERN MICHIGAN UNIVERSITY            ,MI,49855-5316,Public       ,24,55,79,7401,2785,10186
00230200,NORTHWESTERN MICHIGAN COLLEGE           ,MI,49686-3061,Public       ,17,48,65,2381,2702,5083
00230300,OAKLAND COMMUNITY COLLEGE               ,MI,48304-2266,Public       ,0,0,0,305,432,737
00230301,OAKLAND COMMUNITY COLLEGE - ORCHARD RIDG,MI,48334-4579,Public       ,33,111,144,1782,2558,4340
00230302,OAKLAND COMMUNITY COLLEGE - ROYAL OAK CA,MI,48067-3898,Public       ,34,151,185,2449,4487,6936
00230303,OAKLAND COMMUNITY COLLEGE - SOUTHFIELD C,MI,48075-4793,Public       ,25,122,147,1090,2841,3931
00230304,OAKLAND COMMUNITY COLLEGE - AUBURN HILLS,MI,48323-2845,Public       ,40,171,211,2375,3868,6243
00230305,OAKLAND COMMUNITY COLLEGE - HIGHLAND LAK,MI,48327-4187,Public       ,19,79,98,1242,2252,3494
00230700,OAKLAND UNIVERSITY                      ,MI,48309-4401,Public       ,56,183,239,11094,7619,18713
00230800,OLIVET COLLEGE                          ,MI,49076-9902,Private      ,25,7,32,1485,314,1799
00231000,ST. CLAIR COUNTY COMMUNITY COLLEGE      ,MI,48061-0000,Public       ,12,102,114,1934,3123,5057
00231100,KUYPER COLLEGE                          ,MI,49525-9749,Private      ,0,0,0,338,125,463
00231300,SACRED HEART MAJOR SEMINARY             ,MI,48206-1799,Private      ,0,2,2,14,166,180
00231400,SAGINAW VALLEY STATE UNIV               ,MI,48710-0001,Public       ,16,57,73,7874,3645,11519
00231500,SCHOOLCRAFT COLLEGE                     ,MI,48152-2696,Public       ,43,167,210,4678,6615,11293
00231600,SIENA HEIGHTS UNIVERSITY                ,MI,49221-1796,Private      ,4,43,47,1044,1555,2599
00231700,SOUTHWESTERN MICHIGAN COLLEGE           ,MI,49047-9793,Public       ,8,91,99,1205,2124,3329
00231800,SPRING ARBOR UNIVERSITY                 ,MI,49283-9984,Private      ,1,58,59,2140,3535,5675
00232200,FINLANDIA UNIVERSITY                    ,MI,49930-1882,Private      ,3,4,7,510,270,780
00232300,UNIVERSITY OF DETROIT MERCY             ,MI,48221-3038,Private      ,7,61,68,3087,3763,6850
00232301,UNIVERSITY OF DETROIT MERCY- DENTAL SCH ,MI,48219-3580,Private      ,0,0,0,41,172,213
00232303,UNIV OF DETROIT MERCY - LAW SCHOOL      ,MI,48226-0000,Private      ,1,0,1,26,938,964
00232330,UNIV OF DETROIT MERCY - DENTAL SCHOOL   ,MI,48208-2576,Private      ,0,6,6,35,293,328
00232500,UNIVERSITY OF MICHIGAN - ANN ARBOR      ,MI,48109-1316,Public       ,176,101,277,25764,10600,36364
00232501,UNIVERSITY OF MICHIGAN-MEDICAL SCH      ,MI,48109-0000,Public       ,1,0,1,162,1037,1199
00232503,UNIVERSITY OF MICHIGAN LAW SCHOOL       ,MI,48109-0000,Public       ,0,3,3,37,2977,3014
00232600,UNIVERSITY OF MICHIGAN-DEARBORN         ,MI,48128-2406,Public       ,31,94,125,4797,4425,9222
00232700,UNIVERSITY OF MICHIGAN-FLINT            ,MI,48502-1950,Public       ,13,88,101,3642,5225,8867
00232800,WASHTENAW COMMUNITY COLLEGE             ,MI,48106-0000,Public       ,76,346,422,4195,7016,11211
00232900,WAYNE STATE UNIVERSITY                  ,MI,48202-0000,Public       ,96,401,497,16004,19513,35517
00232901,WAYNE STATE UNIV SCH OF MEDICINE        ,MI,48201-3359,Public       ,1,11,12,209,1447,1656
00232902,WAYNE STATE UNIVERSITY - LAW SCHOOL     ,MI,48202-3424,Public       ,0,13,13,144,1398,1542
00233000,WESTERN MICHIGAN UNIVERSITY             ,MI,49008-3899,Public       ,58,107,165,17634,7977,25611
00233100,WESTERN THEOLOGICAL SEMINARY            ,MI,49423-0000,Private      ,0,1,1,0,122,122
00407100,WALSH COLLEGE OF ACCT & BUS ADMN        ,MI,48007-7006,Private      ,6,77,83,264,2381,2645
00407200,NORTHWOOD UNIVERSITY                    ,MI,48640-2398,Private      ,3,33,36,2405,1729,4134
00467300,BAKER COLLEGE - FLINT                   ,MI,48507-5508,Private      ,60,415,475,2382,7784,10166
00467301,BAKER COLLEGE OF CADILLAC               ,MI,49601-0000,Private      ,16,69,85,539,2021,2560
00467302,BAKER COLLEGE OF CLINTON TOWNSHIP       ,MI,48035-0000,Private      ,33,195,228,2344,6016,8360
00467303,BAKER COLLEGE OF MUSKEGON               ,MI,49442-0000,Private      ,37,248,285,2760,5328,8088
00467304,BAKER COLLEGE OF OWOSSO                 ,MI,48867-0000,Private      ,31,128,159,1722,2521,4243
00467305,BAKER COLLEGE OF AUBURN HILLS           ,MI,48326-0000,Private      ,31,167,198,1320,4117,5437
00467306,BAKER COLLEGE OF PORT HURON             ,MI,48060-0000,Private      ,9,93,102,646,1915,2561
00467309,BAKER COLLEGE OF JACKSON                ,MI,49202-0000,Private      ,21,101,122,708,2371,3079
00467311,BAKER COLLEGE-CASS CITY                 ,MI,48726-0000,Private      ,5,42,47,202,588,790
00467313,BAKER COLLEGE - GRADUATE ON-LINE        ,MI,48507-0000,Private      ,12,172,184,379,5524,5903
00467317,BAKER COLLEGE-ALLEN PARK                ,MI,48101-0000,Private      ,16,121,137,1001,3059,4060
00469200,DORSEY SCHOOL OF BUSINESS               ,MI,48195-2334,Proprietary  ,6,20,26,87,388,475
00469201,DORSEY SCHOOL OF BUSINESS               ,MI,48184-0000,Proprietary  ,7,34,41,77,403,480
00469202,DORSEY SCHOOL OF BUSINESS               ,MI,48071-0000,Proprietary  ,5,29,34,86,348,434
00469204,DORSEY SCHOOL OF BUSINESS               ,MI,48066-0000,Proprietary  ,12,74,86,163,841,1004
00469205,DORSEY BUSINESS SCHOOL - FARMINGTON HILL,MI,48334-3385,Proprietary  ,2,11,13,29,140,169
00469206,DORSEY BUSINESS SCHOOL - ROSEVILLE CULIN,MI,48066-4555,Proprietary  ,5,24,29,34,147,181
00491003,KAPLAN CAREER INSTITUTE - DEARBORN      ,MI,48228-0000,Proprietary  ,7,79,86,12,108,120
00676800,MID MICHIGAN COMMUNITY COLLEGE          ,MI,48625-9447,Public       ,22,98,120,2368,2977,5345
00677100,COLLEGE FOR CREATIVE STUDIES            ,MI,48202-4034,Private      ,7,4,11,1499,499,1998
00694900,KALAMAZOO VALLEY COMMUNITY COLLEGE      ,MI,49003-4070,Public       ,60,277,337,4974,6096,11070
00717100,KIRTLAND COMMUNITY COLLEGE              ,MI,48653-0000,Public       ,12,53,65,866,1713,2579
00761700,CARNEGIE INSTITUTE                      ,MI,48083-1159,Proprietary  ,5,12,17,76,521,597
00795000,WEST SHORE COMMUNITY COLLEGE            ,MI,49454-0000,Public       ,2,9,11,527,798,1325
00817800,CHIC UNIVERSITY OF COSMETOLOGY          ,MI,49525-2440,Proprietary  ,11,41,52,317,585,902
00817801,CHIC UNIVERSITY OF COSMETOLOGY - KALAMAZ,MI,49024-2694,Proprietary  ,0,0,0,12,26,38
00890600,MACOMB COMMUNITY COLLEGE                ,MI,48088-3896,Public       ,83,381,464,8600,11386,19986
00894600,PORT HURON COSMETOLOGY COLLEGE          ,MI,48329-1618,Proprietary  ,1,7,8,26,98,124
00923000,WAYNE COUNTY COMMUNITY CLG-DISTRICT     ,MI,48226-3095,Public       ,277,1280,1557,8938,25232,34170
00973200,VIRGINIA FARRELL BEAUTY SCHOOL          ,MI,48080-1448,Proprietary  ,1,9,10,41,78,119
00973400,VIRGINIA FARRELL BEAUTY SCHOOL          ,MI,48220-1739,Proprietary  ,5,20,25,108,244,352
00982800,EVEREST INSTITUTE                       ,MI,48033-4400,Proprietary  ,46,148,194,600,2178,2778
00982801,EVEREST INSTITUTE- DEARBORN             ,MI,48124-1927,Proprietary  ,41,177,218,576,1944,2520
00982803,EVEREST INSTITUTE - DETROIT             ,MI,48207-4291,Proprietary  ,27,126,153,415,1279,1694
01047000,KALAMAZOO BEAUTY ACADEMY                ,MI,49002-5220,Proprietary  ,4,1,5,25,48,73
01062700,ITT TECHNICAL INSTITUTE                 ,MI,49519-0000,Proprietary  ,74,214,288,1483,3197,4680
01082700,DAVID PRESSLEY PROF SCH OF COSMTLGY     ,MI,48067-3219,Proprietary  ,7,6,13,136,141,277
01109800,FLINT INSTITUTE OF BARBERING            ,MI,48504-4395,Proprietary  ,1,4,5,26,123,149
01164600,VIRGINIA FARRELL BEAUTY SCHOOL          ,MI,48185-3091,Proprietary  ,0,8,8,54,149,203
01229100,WRIGHT BEAUTY ACADEMY                   ,MI,49015-2696,Proprietary  ,6,13,19,34,107,141
01262700,THOMAS M. COOLEY LAW SCHOOL             ,MI,48901-1586,Private      ,1,47,48,12,5022,5034
01321800,M J MURPHY BTY CLG MT PLEASANT          ,MI,48858-2502,Proprietary  ,3,15,18,50,101,151
02060300,MICHIGAN INSTITUTE OF AERONAUTICS       ,MI,48111-0000,Proprietary  ,16,64,80,467,937,1404
02068700,ADRIAN BEAUTY ACADEMY                   ,MI,49221-0000,Proprietary  ,2,0,2,23,51,74
02099700,ROSS MEDICAL EDUCATION CENTER           ,MI,48532-0000,Proprietary  ,17,130,147,258,1488,1746
02099701,ROSS MEDICAL EDUCATION CENTER-SAGINAW   ,MI,48603-5227,Proprietary  ,0,1,1,7,57,64
02099702,ROSS MEDICAL EDUCATION CENTER-PORT HURON,MI,48060-1958,Proprietary  ,0,0,0,3,33,36
02099703,ROSS MEDICAL EDUCATION CENTER-ROOSEVELT ,MI,49441-4156,Proprietary  ,0,1,1,3,15,18
02100400,EVEREST INSTITUTE                       ,MI,49525-2301,Proprietary  ,21,166,187,327,1678,2005
02100401,EVEREST INSTITUTE - KALAMAZOO           ,MI,49009-3307,Proprietary  ,13,114,127,204,1147,1351
02100403,EVEREST INSTITUTE - SOUTHFIELD          ,MI,48076-4492,Proprietary  ,0,0,0,31,147,178
02125600,MICHIGAN COLLEGE OF BEAUTY              ,MI,48083-0000,Proprietary  ,8,17,25,177,380,557
02152103,ACADEMY OF COURT REPORTING & TECHNOLOGY ,MI,48017-1495,Proprietary  ,5,21,26,17,133,150
02158600,MR BELA'S SCHOOL OF COSMETOLOGY         ,MI,48092-4637,Proprietary  ,1,12,13,37,83,120
02160303,INTERNATIONAL ACADEMY OF DESIGN AND TECH,MI,48083-2160,Proprietary  ,11,25,36,858,906,1764
02180100,ROSS MEDICAL EDUCATION CENTER           ,MI,48092-0000,Proprietary  ,16,77,93,155,708,863
02180105,ROSS MEDICAL EDUCATION CENTER-REDFORD   ,MI,48239-1260,Proprietary  ,0,1,1,7,35,42
02198900,MICHIGAN SCHOOL OF PROFESSIONAL PSYCHOLO,MI,48334-4512,Private      ,0,0,0,4,155,159
02209200,TAYLORTOWN SCHOOL OF BEAUTY             ,MI,48180-0000,Proprietary  ,0,3,3,31,105,136
02237800,SPECS HOWARD SCHL OF BROADCAST ARTS     ,MI,48075-0000,Proprietary  ,13,31,44,544,680,1224
02285700,BAYSHIRE BEAUTY ACADEMY                 ,MI,48708-5614,Proprietary  ,2,2,4,34,100,134
02289801,KAPLAN INSTITUTE - DETROIT CAMPUS       ,MI,48202-0000,Proprietary  ,34,134,168,290,1338,1628
02324500,MICHIGAN COLLEGE OF BEAUTY              ,MI,48161-0000,Proprietary  ,6,13,19,89,176,265
02339700,ROSS MEDICAL EDUCATION CENTER           ,MI,48116-0000,Proprietary  ,17,121,138,177,1104,1281
02339701,ROSS MEDICAL EDUCATION CENTER-ANN ARBOR ,MI,48108-1411,Proprietary  ,0,1,1,7,32,39
02361500,MICHIGAN BARBER COLLEGE                 ,MI,48204-2244,Private      ,1,8,9,101,296,397
02363800,YESHIVA GEDOLAH OF GREATER DETROIT      ,MI,48237-0000,Private      ,0,0,0,23,3,26
02491000,WEST MI COLG OF BARBERING & BEAUTY      ,MI,49008-0000,Proprietary  ,0,6,6,24,120,144
02495800,FOCUS:HOPE                              ,MI,48238-0000,Private      ,0,0,0,1,3,4
02498300,VIRGINIA FARRELL BEAUTY SCHOOL          ,MI,48154-0000,Proprietary  ,4,13,17,83,155,238
02533600,ROSS MEDICAL EDUCATION CENTER           ,MI,48917-2108,Proprietary  ,10,100,110,172,838,1010
02533601,ROSS MEDICAL EDUCATION CENTER - GRAND RA,MI,49546-2430,Proprietary  ,0,3,3,8,70,78
02588200,DOUGLAS J AVEDA INSTITUTE               ,MI,48823-4351,Proprietary  ,12,16,28,419,496,915
02588201,DOUGLAS J AVEDA INSTITUTE - ANN ARBOR   ,MI,48104-2211,Proprietary  ,0,0,0,81,102,183
02595700,HILLSDALE BEAUTY COLLEGE                ,MI,49242-0000,Proprietary  ,0,0,0,36,19,55
02618400,MICHIGAN CAREER & TECHNICAL INST        ,MI,49080-9254,Public       ,16,4,20,225,120,345
03005700,DETROIT BUSINESS INST. DOWNRIVER        ,MI,48193-6761,Proprietary  ,8,16,24,102,311,413
03028500,LAWTON SCHOOL                           ,MI,48075-5406,Proprietary  ,8,30,38,73,259,332
03066600,BAY MILLS COMMUNITY COLLEGE             ,MI,49715-9750,Public       ,3,15,18,151,371,522
03075200,TWIN CITY BEAUTY COLLEGE                ,MI,49085-3305,Proprietary  ,5,19,24,74,232,306
03075201,TWIN CITY BEAUTY COLLEGE - TRAVERSE CITY,MI,49686-5119,Proprietary  ,0,0,0,9,15,24
03090000,SHARP'S ACADEMY OF HAIRSTYLING INC.     ,MI,48433-0000,Proprietary  ,3,3,6,23,59,82
03109700,HOUGHTON LAKE INST OF COSMETOLOGY       ,MI,48629-9702,Proprietary  ,0,0,0,12,10,22
03110300,THE SCHOOL OF CREATIVE HAIR DESIGN      ,MI,49036-1139,Proprietary  ,4,5,9,23,69,92
03124000,NORTHWESTERN TECHNOLOGICAL INST         ,MI,48075-2412,Proprietary  ,14,80,94,133,554,687
03135300,MICHIGAN THEOLOGICAL SEMINARY           ,MI,48170-4399,Private      ,0,1,1,2,122,124
03284300,MICHIGAN JEWISH INSTITUTE               ,MI,48237-0000,Private      ,68,20,88,803,164,967
03490300,PAUL MITCHELL THE SCHOOL ESCANABA       ,MI,49829-0000,Proprietary  ,2,3,5,20,27,47
03588300,IRENE'S MYOMASSOLOGY INSTITUTE          ,MI,48033-2404,Proprietary  ,4,10,14,77,395,472
03691400,AVE MARIA SCHOOL OF LAW                 ,MI,48105-0000,Private      ,0,1,1,2,598,600
03704300,BLUE WATER COLLEGE OF COSMETOLOGY       ,MI,48040-0000,Proprietary  ,2,4,6,45,60,105
03772300,SAGINAW CHIPPEWA TRIBAL COLLEGE         ,MI,48858-0000,Public       ,0,1,1,11,45,56
03815300,IN SESSION-ARTS OF COSMETOLOGY BEAU     ,MI,48609-0000,Proprietary  ,6,9,15,46,135,181
03907300,PAUL MITCHELL THE SCHOOL GREAT LAKES    ,MI,48060-0000,Proprietary  ,4,7,11,82,93,175
03915300,CAREER QUEST LEARNING CENTER            ,MI,48910-4732,Proprietary  ,7,69,76,58,619,677
03968300,LAKEWOOD SCHOOL OF THERAPEUTIC MASSAGE  ,MI,48060-0000,Proprietary  ,0,0,0,15,43,58
03976500,ANN ARBOR INSTITUTE OF MASSAGE THERAPY  ,MI,48103-0000,Proprietary  ,0,0,0,29,88,117
04002400,ECUMENICAL THEOLOGICAL SEMINARY         ,MI,48201-3035,Private      ,0,5,5,3,96,99
04006300,NUVO COLLEGE OF COSMETOLOGY             ,MI,49441-3822,Proprietary  ,2,9,11,26,80,106
04014300,P&A SCHOLARS BEAUTY SCHOOL              ,MI,48204-0000,Proprietary  ,7,8,15,74,199,273
04055300,CREATIVE HAIR SCHOOL OF COSMETOLOGY     ,MI,48504-1234,Proprietary  ,0,0,0,26,57,83
04094300,ROBERT B. MILLER COLLEGE (THE)          ,MI,49017-3306,Private      ,0,12,12,36,267,303
04121100,GALLERY COLLEGE OF BEAUTY (THE)         ,MI,48036-3591,Proprietary  ,6,4,10,52,126,178
04136300,FOCUS:  HOPE INFORMATION TECHNOLOGIES CE,MI,48238-2949,Private      ,1,5,6,17,61,78
04138400,SCHOOL OF DESIGNING ARTS                ,MI,49037-7995,Proprietary  ,2,4,6,17,45,62
04139600,REGAL BEAUTY SCHOOL                     ,MI,48150-4013,Proprietary  ,0,0,0,1,24,25
04140900,INTERNATIONAL COSMETOLOGY ACADEMY       ,MI,49508-1308,Proprietary  ,0,2,2,6,87,93
04141100,FRENCH ACADEMY OF COSMETOLOGY           ,MI,49456-3207,Proprietary  ,0,2,2,12,28,40
00233200,ANOKA-RAMSEY CC-CAMBRIDGE/COONRAPID     ,MN,55433-3499,Public       ,40,130,170,2960,3395,6355
00233400,AUGSBURG COLLEGE                        ,MN,55454-1351,Private      ,7,29,36,2445,2091,4536
00233500,RIVERLAND COMMUNITY COLLEGE             ,MN,55912-1473,Public       ,16,58,74,1030,1561,2591
00233600,BEMIDJI STATE UNIVERSITY                ,MN,56601-2699,Public       ,5,57,62,3039,1716,4755
00233700,BETHANY LUTHERAN COLLEGE INC            ,MN,56001-6163,Private      ,0,0,0,662,44,706
00233900,CENTRAL LAKES COLG-BRAINERD/STAPLES     ,MN,56401-3900,Public       ,18,55,73,1500,1810,3310
00234000,CARLETON COLLEGE                        ,MN,55057-4001,Private      ,2,0,2,3011,34,3045
00234100,COLLEGE OF ST BENEDICT                  ,MN,56374-2099,Private      ,3,0,3,2079,42,2121
00234200,COLLEGE OF ST CATHERINE                 ,MN,55105-1789,Private      ,9,37,46,2198,3088,5286
00234300,COLLEGE OF ST SCHOLASTICA               ,MN,55811-4199,Private      ,5,72,77,2336,1659,3995
00234500,UNIVERSITY OF ST THOMAS                 ,MN,55105-1096,Private      ,14,103,117,6029,3913,9942
00234600,CONCORDIA COLLEGE-MOORHEAD              ,MN,56562-0001,Private      ,6,6,12,3289,162,3451
00234700,"CONCORDIA UNIVERSITY, ST PAUL, MN       ",MN,55104-5494,Private      ,3,68,71,1264,1832,3096
00235000,VERMILION COMMUNITY COLLEGE             ,MN,55731-1996,Public       ,4,2,6,468,145,613
00235200,FERGUS FALLS COMMUNITY COLLEGE          ,MN,56537-1000,Public       ,0,0,0,41,39,80
00235300,GUSTAVUS ADOLPHUS COLLEGE               ,MN,56082-1498,Private      ,8,2,10,3107,44,3151
00235400,HAMLINE UNIVERSITY                      ,MN,55104-1284,Private      ,1,38,39,2589,3095,5684
00235500,HIBBING COMMUNITY COLLEGE               ,MN,55746-3300,Public       ,8,25,33,697,989,1686
00235600,ITASCA COMMUNITY COLLEGE                ,MN,55744-3397,Public       ,3,5,8,716,527,1243
00235700,LUTHER SEMINARY                         ,MN,55108-0000,Private      ,0,0,0,2,433,435
00235800,MACALESTER COLLEGE                      ,MN,55105-1899,Private      ,0,2,2,3323,84,3407
00236000,"MINNESOTA STATE UNIVERSITY, MANKATO     ",MN,56002-0000,Public       ,57,90,147,10202,3679,13881
00236100,MARTIN LUTHER COLLEGE                   ,MN,56073-3965,Private      ,1,0,1,659,61,720
00236200,MINNEAPOLIS COMM AND TECH COLLEGE       ,MN,55403-1779,Public       ,55,265,320,3994,8547,12541
00236500,MINNEAPOLIS COLLEGE OF ART & DESIGN     ,MN,55404-4343,Private      ,0,5,5,904,347,1251
00236600,CROSSROADS COLLEGE                      ,MN,55902-2382,Private      ,1,0,1,123,94,217
00236700,MINNESOTA STATE UNIVERSITY MOORHEAD     ,MN,56563-0001,Public       ,10,40,50,5206,2117,7323
00236900,NORTH CENTRAL UNIVERSITY                ,MN,55404-1391,Private      ,1,0,1,1110,358,1468
00237000,NORTH HENNEPIN COMMUNITY COLLEGE        ,MN,55445-2299,Public       ,42,158,200,2461,4046,6507
00237100,NORTHWESTERN COLLEGE                    ,MN,55113-1598,Private      ,5,18,23,2279,802,3081
00237300,ROCHESTER COMMUNITY/TECH COLLEGE        ,MN,55904-4999,Public       ,28,100,128,2680,2808,5488
00237500,SOUTHWEST MINNESOTA STATE UNIVERSITY    ,MN,56258-1598,Public       ,4,7,11,2026,967,2993
00237700,ST CLOUD STATE UNIVERSITY               ,MN,56301-4498,Public       ,49,105,154,9707,4316,14023
00237900,SAINT JOHNS UNIVERSITY                  ,MN,56321-0000,Private      ,4,2,6,1802,97,1899
00238000,SAINT MARY'S UNIVERSITY                 ,MN,55987-1399,Private      ,1,50,51,1562,2930,4492
00238200,ST OLAF COLLEGE                         ,MN,55057-1098,Private      ,2,0,2,3779,58,3837
00238300,CROWN COLLEGE                           ,MN,55375-9001,Private      ,0,12,12,754,656,1410
00238500,NORTHLAND COMMUNITY & TECHNICAL CLG     ,MN,56701-2598,Public       ,9,53,62,1568,2016,3584
00238600,UNITED THEOLGCL SEMINRY TWIN CITIES     ,MN,55112-0000,Private      ,0,0,0,1,103,104
00238800,"UNIVERSITY OF MINNESOTA, DULUTH         ",MN,55812-2496,Public       ,14,25,39,8902,1872,10774
00238900,"UNIVERSITY OF MINNESOTA, MORRIS         ",MN,56267-2113,Public       ,6,7,13,1692,222,1914
00239100,WILLIAM MITCHELL COLLEGE OF LAW         ,MN,55105-0000,Private      ,0,5,5,6,1306,1312
00239300,MINNESOTA STATE COLLEGE-SE TECH         ,MN,55987-0409,Public       ,6,42,48,824,1327,2151
00239400,WINONA STATE UNIVERSITY                 ,MN,55987-5838,Public       ,16,22,38,6604,1277,7881
00396900,UNIVERSITY OF MINNESOTA-TWIN CITIES     ,MN,55455-0422,Public       ,74,293,367,26338,17124,43462
00396903,UNIVERSITY OF MINNESOTA - ROCHESTER     ,MN,55904-0000,Public       ,0,0,0,0,2,2
00400900,MESABI RANGE CMNTY & TECH COLLEGE       ,MN,55792-0000,Public       ,8,16,24,609,663,1272
00405708,NATIONAL AMERICAN UNIVERSITY            ,MN,55113-0000,Proprietary  ,0,7,7,54,324,378
00405715,NATIONAL AMERICAN UNIVERSITY - BLOOMINGT,MN,55425-5550,Proprietary  ,1,2,3,18,210,228
00406900,UNIVERSITY OF MINNESOTA-CROOKSTON       ,MN,56716-5001,Public       ,4,9,13,975,368,1343
00438600,VETERAN'S MEDICAL CTR- SCH RAD TECH     ,MN,55417-2399,Public       ,0,1,1,3,10,13
00464100,DUNWOODY COLLEGE OF TECHNOLOGY          ,MN,55403-1192,Private      ,10,13,23,1028,1271,2299
00464200,GLOBE UNIVERSITY                        ,MN,55128-0000,Proprietary  ,20,114,134,802,2067,2869
00464500,MINNEAPOLIS BUSINESS COLLEGE            ,MN,55113-4036,Proprietary  ,0,2,2,463,125,588
00464600,MINNESOTA SCHOOL OF BUSINESS            ,MN,55423-0000,Proprietary  ,43,134,177,2778,6401,9179
00464800,RASMUSSEN COLLEGE - EAGAN               ,MN,55122-1346,Proprietary  ,11,40,51,265,1138,1403
00484602,RASMUSSEN COLLEGE - MOORHEAD            ,MN,56560-4513,Proprietary  ,0,0,0,0,1,1
00525200,RIDGEWATER COLLEGE                      ,MN,56201-2098,Public       ,35,83,118,2056,1864,3920
00526300,MINNESOTA WEST CMNTY & TECH COLG        ,MN,56241-1096,Public       ,22,38,60,1001,1366,2367
00553300,"SAINT PAUL COLLEGE, COMMUNITY/TECHNICAL ",MN,55102-1800,Public       ,55,229,284,2123,4689,6812
00553400,ST CLOUD TECHNICAL COLLEGE              ,MN,56303-1240,Public       ,28,87,115,2343,1850,4193
00553500,PINE TECHNICAL COLLEGE                  ,MN,55063-2198,Public       ,6,18,24,201,566,767
00553700,SOUTH CENTRAL COLLEGE                   ,MN,56003-0000,Public       ,6,53,59,1576,1741,3317
00554100,MINNESOTA STATE COMMUNITY AND TECHNICAL ,MN,56573-1405,Public       ,26,93,119,2531,3087,5618
00554400,ALEXANDRIA TECHNICAL COLLEGE            ,MN,56308-3799,Public       ,5,23,28,1235,761,1996
00575700,LAKE SUPERIOR COLLEGE                   ,MN,55811-3399,Public       ,16,71,87,1972,2361,4333
00575900,NORTHWEST TECHNICAL COLLEGE - BEMIDJI   ,MN,56601-4907,Public       ,8,40,48,448,974,1422
00677500,RAINY RIVER COMMUNITY COLLEGE           ,MN,56649-2187,Public       ,0,5,5,114,132,246
00735000,ANOKA-HENNEPIN TECHNICAL COLLEGE        ,MN,55303-1590,Public       ,12,73,85,797,1678,2475
00735100,BROWN COLLEGE                           ,MN,55120-1004,Proprietary  ,6,31,37,1204,1255,2459
00746200,COLLEGE OF VISUAL ARTS                  ,MN,55102-2199,Private      ,0,1,1,206,62,268
00795400,NORMANDALE COMMUNITY COLLEGE            ,MN,55431-4399,Public       ,37,156,193,3817,4229,8046
00826700,NORTHWEST TECHNICAL INSTITUTE           ,MN,55121-5001,Proprietary  ,0,0,0,135,44,179
00869400,RASMUSSEN COLLEGE ST. CLOUD             ,MN,56301-3713,Proprietary  ,11,62,73,355,1333,1688
00869401,RASMUSSEN COLLEGE - SAINT CLOUD - BROOKL,MN,55445-1512,Proprietary  ,15,62,77,327,1463,1790
00905800,BETHEL UNIVERSITY                       ,MN,55112-6999,Private      ,6,47,53,2977,2005,4982
00960000,COSMETOLOGY CAREERS UNLTD-DULUTH        ,MN,55802-2031,Proprietary  ,5,5,10,29,48,77
00972200,EMPIRE BEAUTY SCHOOL                    ,MN,55119-7003,Proprietary  ,7,21,28,91,246,337
00974000,INVER HILLS COMMUNITY COLLEGE           ,MN,55076-3224,Public       ,24,90,114,1903,2688,4591
00983100,MODEL COLLEGE OF HAIR DESIGN            ,MN,56301-4280,Proprietary  ,6,3,9,89,64,153
00987000,SCOT LEWIS SCHOOL - BLOOMINGTON         ,MN,55420-2919,Proprietary  ,4,14,18,141,247,388
00989200,"DULUTH BUSINESS UNIV, INC.              ",MN,55807-0000,Proprietary  ,0,10,10,153,463,616
00999200,OAK HILLS CHRISTIAN COLLEGE             ,MN,56601-0000,Private      ,0,0,0,117,77,194
01024800,ART INSTITUTES INTL MINNESOTA           ,MN,55402-3137,Proprietary  ,17,34,51,1725,1153,2878
01035602,EVEREST INSTITUTE - EAGAN               ,MN,55121-1696,Proprietary  ,18,118,136,214,1285,1499
01037400,METROPOLITAN STATE UNIVERSITY           ,MN,55106-5000,Public       ,9,119,128,1560,5551,7111
01040200,DAKOTA COUNTY TECHNICAL COLLEGE         ,MN,55068-2999,Public       ,27,68,95,1149,1631,2780
01049000,REGENCY BEAUTY INSTITUTE                ,MN,55428-0000,Proprietary  ,159,335,494,2763,4422,7185
01049100,HENNEPIN TECHNICAL COLLEGE              ,MN,55445-2399,Public       ,22,152,174,1575,3728,5303
01054600,CENTURY COMMUNITY AND TECHNICAL CLG     ,MN,55110-1894,Public       ,61,263,324,4014,5330,9344
01101700,HERZING COLLEGE                         ,MN,55428-3548,Proprietary  ,11,18,29,198,345,543
01168600,RASMUSSEN COLLEGE - EDEN PRAIRIE        ,MN,55344-7220,Proprietary  ,26,168,194,269,2048,2317
01173200,"MAYO CLINIC, COLLEGE OF MEDICINE        ",MN,55905-0000,Private      ,1,2,3,36,324,360
01173201,MAYO SCHOOL OF HEALTH-RELATED SCIEN     ,MN,55905-0000,Private      ,1,0,1,39,120,159
01173206,MAYO GRAD SCHOOL                        ,MN,55901-0000,Private      ,0,0,0,0,40,40
01173207,MAYO MEDICAL SCHOOL                     ,MN,55901-0000,Private      ,0,0,0,1,163,164
01232800,NORTHWESTERN HEALTH SCIENCES UNIV       ,MN,55431-1599,Private      ,3,5,8,59,902,961
02050300,ACADEMY COLLEGE                         ,MN,55420-1554,Proprietary  ,4,16,20,59,230,289
02123200,AVEDA INSTITUTE                         ,MN,55414-0000,Proprietary  ,7,17,24,382,345,727
02159800,COSMETOLOGY CAREERS UNLTD - HIBBING     ,MN,55746-0000,Proprietary  ,0,3,3,22,26,48
02160901,"SALON PROFESSIONAL ACADEMY, THE - THE SA",MN,55428-4928,Proprietary  ,2,6,8,57,74,131
02179901,ARGOSY UNIVERSITY - TWIN CITIES         ,MN,55121-1756,Proprietary  ,0,0,0,47,133,180
02238100,MINNESOTA SCHOOL OF COSMETOLOGY         ,MN,55125-0000,Proprietary  ,1,10,11,95,190,285
02260500,SUMMIT ACAD OPPORTUNITIES IND CTR       ,MN,55405-0000,Private      ,16,71,87,58,380,438
02263102,HIGH-TECH INSTITUTE - MINNEAPOLIS       ,MN,55416-2467,Proprietary  ,0,2,2,17,45,62
02284500,PILLSBURY BAPTIST BIBLE COLLEGE         ,MN,55060-0000,Private      ,0,0,0,132,20,152
02503300,RASMUSSEN COLLEGE - MANKATO             ,MN,56001-8658,Proprietary  ,6,54,60,285,1025,1310
02503302,RASMUSSEN COLLEGE - MANKATO -  LAKE ELMO,MN,55042-8624,Proprietary  ,4,48,52,194,778,972
02504200,WALDEN UNIVERSITY                       ,MN,55401-2511,Proprietary  ,2,1691,1693,77,36346,36423
02514100,AMERICAN INDIAN OPPORTUNITIES CTR       ,MN,55404-0000,Private      ,1,10,11,5,139,144
02543600,INGENUE                                 ,MN,56560-0000,Proprietary  ,1,1,2,22,11,33
02551200,EAST METRO OIC                          ,MN,55104-3435,Private      ,2,21,23,27,198,225
03001200,MCNALLY SMITH COLLEGE OF MUSIC          ,MN,55101-2220,Proprietary  ,3,2,5,633,224,857
03051900,ALFRED ADLER GRADUATE SCHOOL            ,MN,55305-0000,Private      ,0,9,9,0,265,265
03096400,LEECH LAKE TRIBAL COLLEGE               ,MN,56633-0000,Public       ,0,0,0,50,246,296
03129100,FOND DU LAC TRIBAL & COMMUNITY CLG      ,MN,55720-2984,Public       ,12,25,37,460,866,1326
03267300,CAPELLA UNIVERSITY                      ,MN,55402-3389,Proprietary  ,9,1955,1964,90,38141,38231
03833300,AMERICAN ACADEMY OF ACUPUNCTURE AND ORIE,MN,55113-0000,Proprietary  ,0,3,3,4,93,97
03921400,WHITE EARTH TRIBAL AND COMMUNITY COLLEGE,MN,56557-0478,Private      ,0,0,0,21,96,117
04044300,HAZELDEN GRADUATE SCHOOL OF ADDICTION ST,MN,55012-0000,Private      ,0,1,1,0,89,89
04130200,INST. OF PRODUCTION AND RECORDING       ,MN,55401-1315,Proprietary  ,5,2,7,68,45,113
00239600,ALCORN STATE UNIVERSITY                 ,MS,39096-7500,Public       ,100,60,160,3353,2928,6281
00239700,BELHAVEN COLLEGE                        ,MS,39202-1789,Private      ,6,134,140,1271,3248,4519
00239800,BLUE MOUNTAIN COLLEGE                   ,MS,38610-9370,Private      ,4,11,15,342,332,674
00240100,COAHOMA COMMUNITY COLLEGE               ,MS,38614-9799,Public       ,25,20,45,1461,2392,3853
00240200,COPIAH-LINCOLN COMMUNITY COLLEGE        ,MS,39191-0649,Public       ,47,55,102,1998,2272,4270
00240300,DELTA STATE UNIVERSITY                  ,MS,38733-0000,Public       ,30,77,107,2895,3130,6025
00240400,EAST CENTRAL COMMUNITY COLLEGE          ,MS,39327-0129,Public       ,34,60,94,1530,1930,3460
00240500,EAST MISSISSIPPI COMM COLLEGE           ,MS,39358-0000,Public       ,143,158,301,2400,3328,5728
00240700,HINDS COMMUNITY COLLEGE                 ,MS,39154-9799,Public       ,127,260,387,6320,8490,14810
00240800,HOLMES COMMUNITY COLLEGE                ,MS,39079-0000,Public       ,77,148,225,3117,5043,8160
00240900,ITAWAMBA COMMUNITY COLLEGE              ,MS,38843-1099,Public       ,66,211,277,3404,5741,9145
00241000,JACKSON STATE UNIVERSITY                ,MS,39217-0001,Public       ,121,153,274,8084,8564,16648
00241100,JONES COUNTY JUNIOR COLLEGE             ,MS,39437-3999,Public       ,71,86,157,3321,2627,5948
00241300,MERIDIAN COMMUNITY COLLEGE              ,MS,39307-5890,Public       ,36,97,133,2090,2620,4710
00241400,MILLSAPS COLLEGE                        ,MS,39201-0000,Private      ,3,7,10,1334,396,1730
00241500,MISSISSIPPI COLLEGE                     ,MS,39058-0001,Private      ,5,42,47,2256,2967,5223
00241501,MISSISSIPPI COLLEGE SCHOOL OF LAW       ,MS,39201-0000,Private      ,1,2,3,28,832,860
00241502,MISSISSIPPI COLLEGE - RANKIN CAMPUS     ,MS,39042-0000,Private      ,0,2,2,12,52,64
00241600,MISSISSIPPI DELTA CMTY COLLEGE          ,MS,38761-0000,Public       ,39,44,83,1976,2421,4397
00241700,MISSISSIPPI GULF CST CLG-PERKINSTON     ,MS,39573-0000,Public       ,40,25,65,1322,712,2034
00241701,MISSISSIPPI GULF CST CLG-JEFF DAVIS     ,MS,39507-0000,Public       ,35,105,140,1433,2618,4051
00241702,MISSISSIPPI GULF CST CLG-JACKSON CN     ,MS,39553-0000,Public       ,31,135,166,1307,1958,3265
00242200,MISSISSIPPI UNIV FOR WOMEN              ,MS,39701-5818,Public       ,15,50,65,1455,1702,3157
00242300,MISSISSIPPI STATE UNIVERSITY            ,MS,39762-9698,Public       ,101,120,221,10729,6021,16750
00242400,MISSISSIPPI VALLEY STATE UNIVERSITY     ,MS,38941-1400,Public       ,97,59,156,2971,3572,6543
00242600,NORTHEAST MS CMNTY COLLEGE              ,MS,38829-1731,Public       ,23,65,88,2242,2164,4406
00242700,NORTHWEST MISSISSIPPI COMMUNITY CLG     ,MS,38668-1703,Public       ,52,131,183,4379,4537,8916
00243000,PEARL RIVER COMMUNITY COLLEGE           ,MS,39470-2201,Public       ,57,114,171,2744,3135,5879
00243300,RUST COLLEGE                            ,MS,38635-2328,Private      ,5,9,14,1404,491,1895
00243500,SOUTHEASTERN BAPTIST COLLEGE            ,MS,39440-0000,Private      ,0,0,0,31,68,99
00243600,SOUTHWEST MISSISSIPPI CMNTY CLG         ,MS,39666-8099,Public       ,23,31,54,1341,1310,2651
00243900,TOUGALOO COLLEGE                        ,MS,39174-9799,Private      ,12,11,23,1538,488,2026
00244000,UNIVERSITY OF MISSISSIPPI               ,MS,38677-1848,Public       ,84,124,208,8591,5529,14120
00244001,UNIVERSITY OF MISSISSIPPI - MED CTR     ,MS,39216-0000,Public       ,2,12,14,370,1544,1914
00244100,UNIVERSITY OF SOUTHERN MISSISSIPPI      ,MS,39406-0001,Public       ,99,209,308,9786,8274,18060
00244700,WILLIAM CAREY UNIVERSITY                ,MS,39401-5499,Private      ,11,102,113,1140,2999,4139
01146100,WESLEY COLLEGE                          ,MS,39073-1070,Private      ,1,0,1,66,84,150
01289101,ANTONELLI COLLEGE - JACKSON             ,MS,39208-4526,Proprietary  ,7,64,71,144,639,783
01289102,ANTONELLI COLLEGE - HATTIESBURG         ,MS,39401-3056,Proprietary  ,10,55,65,144,760,904
02074900,CHRIS' BEAUTY COLLEGE                   ,MS,39501-0000,Proprietary  ,0,11,11,30,123,153
02160500,NORTH MISSISSIPPI MED CTR MED TECH      ,MS,38801-0000,Private      ,0,1,1,9,31,40
02235900,ACADEMY OF HAIR DESIGN #4               ,MS,39208-0000,Proprietary  ,3,17,20,33,126,159
02244300,ACADEMY OF HAIR DESIGN #1               ,MS,38901-0000,Proprietary  ,12,26,38,84,296,380
02249900,DELTA BEAUTY COLLEGE                    ,MS,38701-0000,Proprietary  ,3,1,4,35,83,118
02251600,ACADEMY OF HAIR DESIGN #6               ,MS,39401-7581,Proprietary  ,4,5,9,56,169,225
02251700,FOSTER'S COSMETOLOGY COLLEGE            ,MS,38663-0000,Proprietary  ,0,4,4,8,61,69
02302800,MISSISSIPPI COLLEGE OF BEAUTY CULT      ,MS,39440-0000,Proprietary  ,2,1,3,23,54,77
02320800,MAGNOLIA COLLEGE OF COSMETOLOGY         ,MS,39206-0000,Proprietary  ,3,18,21,66,222,288
02361200,MAGNOLIA BIBLE COLLEGE                  ,MS,39090-0000,Private      ,1,0,1,11,40,51
02490200,"ICS, THE WRIGHT BEAUTY COLLEGE          ",MS,38834-0000,Proprietary  ,0,0,0,7,34,41
02502100,CREATIONS COLLEGE OF COSMETOLOGY        ,MS,38803-0000,Proprietary  ,2,7,9,24,116,140
02516200,WESLEY BIBLICAL SEMINARY                ,MS,39206-0000,Private      ,0,1,1,0,108,108
02554600,GIBSON'S BARBER AND BEAUTY COLLEGE      ,MS,39773-0000,Proprietary  ,3,1,4,31,68,99
02586000,J & J HAIR DESIGN COLLEGE               ,MS,39051-3716,Proprietary  ,3,15,18,30,169,199
03004000,FINAL TOUCH BEAUTY SCHOOL               ,MS,39307-2934,Proprietary  ,0,1,1,25,85,110
03010401,CRESCENT CITY BARTENDING SCHOOL         ,MS,39501-0000,Proprietary  ,0,1,1,3,27,30
03010404,CRESCENT CITY SCHOOL OF GAMING & BARTEND,MS,38664-1903,Proprietary  ,0,0,0,2,6,8
03010603,VIRGINIA COLLEGE - JACKSON              ,MS,39206-5602,Proprietary  ,17,109,126,125,756,881
03010610,VIRGINIA COLLEGE - BILOXI               ,MS,39532-2124,Proprietary  ,11,44,55,53,319,372
03263300,TRAXLER'S SCHOOL OF HAIR                ,MS,39212-2529,Proprietary  ,1,6,7,20,77,97
03464300,ACADEMY OF HAIR DESIGN                  ,MS,39562-0000,Proprietary  ,1,8,9,15,85,100
03525300,BLUE CLIFF COLLEGE                      ,MS,39507-0000,Proprietary  ,12,39,51,106,333,439
03848300,DAY SPA CAREER COLLEGE                  ,MS,39564-0000,Proprietary  ,1,8,9,15,80,95
03963300,HEALING TOUCH SCHOOL OF MASSAGE THERAPY ,MS,39402-1300,Proprietary  ,1,0,1,11,39,50
04131300,CORINTH ACADEMY OF COSMETOLOGY          ,MS,38834-4813,Proprietary  ,1,6,7,16,64,80
04140200,"MISSISSIPPI INSTITUTE OF AESTHETICS, NAI",MS,39056-5628,Proprietary  ,6,5,11,6,10,16
00252600,CARROLL COLLEGE                         ,MT,59625-0002,Private      ,1,0,1,1498,221,1719
00252700,UNIVERSITY OF GREAT FALLS               ,MT,59405-4996,Private      ,6,9,15,471,526,997
00252800,MILES COMMUNITY COLLEGE                 ,MT,59301-4799,Public       ,1,3,4,296,234,530
00252900,DAWSON COMMUNITY COLLEGE                ,MT,59330-1405,Public       ,0,2,2,245,121,366
00253000,MONTANA STATE UNIVERSITY - BILLINGS     ,MT,59101-0298,Public       ,9,58,67,2467,3194,5661
00253100,MONTANA TECH OF THE UNIV OF MONTANA     ,MT,59701-8997,Public       ,1,5,6,1379,1023,2402
00253200,MONTANA STATE UNIVERSITY - BOZEMAN      ,MT,59717-0001,Public       ,24,97,121,7799,3749,11548
00253300,MONTANA STATE UNIVERSITY-NORTHERN       ,MT,59501-3148,Public       ,1,22,23,681,808,1489
00253400,ROCKY MOUNTAIN COLLEGE                  ,MT,59102-1796,Private      ,3,4,7,849,344,1193
00253600,UNIVERSITY OF MONTANA (THE)             ,MT,59812-0001,Public       ,19,76,95,7833,6656,14489
00253700,UNIVERSITY OF MONTANA WESTERN (THE)     ,MT,59725-3598,Public       ,1,4,5,967,472,1439
00442500,BENEFIS HEALTHCARE SCH RAD TECH         ,MT,59405-4324,Private      ,0,0,0,8,12,20
00677700,FLATHEAD VALLEY COMMUNITY COLLEGE       ,MT,59901-2699,Public       ,8,62,70,683,1160,1843
00757000,HELENA COLLEGE OF TECHNOLOGY            ,MT,59601-3098,Public       ,4,17,21,388,716,1104
00790000,BUTTE ACADEMY OF BEAUTY CULTURE         ,MT,59701-9197,Proprietary  ,0,2,2,25,41,66
00894700,"DAHL'S COLLEGE OF BEAUTY,INC            ",MT,59401-3731,Proprietary  ,0,0,0,24,35,59
00931400,MSU COLLEGE OF TECH-GREAT FALLS         ,MT,59405-4907,Public       ,8,57,65,621,1437,2058
02143400,SALISH KOOTENAI COLLEGE                 ,MT,59855-0000,Public       ,2,18,20,296,843,1139
02286600,LITTLE BIG HORN COLLEGE                 ,MT,59022-0000,Public       ,0,1,1,97,240,337
02343000,FT PECK COMMUNITY COLLEGE               ,MT,59255-0000,Public       ,1,2,3,84,273,357
02510600,BLACKFEET COMMUNITY COLLEGE             ,MT,59417-0000,Private      ,0,3,3,165,533,698
02517500,FORT BELKNAP COLLEGE                    ,MT,59526-0000,Public       ,0,0,0,54,125,179
02545200,CHIEF DULL KNIFE COLLEGE                ,MT,59043-0098,Public       ,0,0,0,62,159,221
02610900,STONE CHILD COLLEGE                     ,MT,59521-9796,Public       ,2,5,7,78,273,351
02621300,ACADEMY OF COSMETOLOGY                  ,MT,59715-3544,Proprietary  ,1,0,1,33,34,67
03205300,MODERN BEAUTY SCHOOL                    ,MT,59801-8386,Proprietary  ,0,1,1,49,44,93
03763400,"ACADEMY OF NAIL, SKIN & HAIR            ",MT,59101-0000,Proprietary  ,0,11,11,59,115,174
03778300,HEALTH WORKS INSTITUTE                  ,MT,59715-0000,Proprietary  ,0,1,1,16,26,42
00253900,CHADRON STATE COLLEGE                   ,NE,69337-2690,Public       ,3,24,27,1597,929,2526
00254000,COLLEGE OF ST MARY                      ,NE,68106-2606,Private      ,2,27,29,416,1029,1445
00254100,CONCORDIA UNIVERSITY                    ,NE,68434-1594,Private      ,0,3,3,1305,227,1532
00254200,CREIGHTON UNIVERSITY                    ,NE,68178-0001,Private      ,4,21,25,4653,4404,9057
00254300,DANA COLLEGE                            ,NE,68008-9905,Private      ,1,3,4,849,86,935
00254400,DOANE COLLEGE                           ,NE,68333-2421,Private      ,0,66,66,1339,978,2317
00254700,GRACE UNIVERSITY                        ,NE,68108-3629,Private      ,2,4,6,329,268,597
00254800,HASTINGS COLLEGE                        ,NE,68901-7621,Private      ,1,2,3,1488,121,1609
00255100,UNIVERSITY OF NEBRASKA AT KEARNEY       ,NE,68849-0001,Public       ,3,71,74,3924,1602,5526
00255300,MIDLAND LUTHERAN COLLEGE                ,NE,68025-4254,Private      ,0,6,6,869,232,1101
00255400,UNIVERSITY OF NEBRASKA-OMAHA            ,NE,68182-0001,Public       ,25,107,132,7541,5332,12873
00255500,NEBRASKA WESLEYAN UNIVERSITY            ,NE,68504-2796,Private      ,5,4,9,1889,503,2392
00255700,MID-PLAINS COMM COLLEGE - NORTH PLATTE  ,NE,69101-9420,Public       ,5,21,26,436,606,1042
00255701,MID-PLAINS COMMUNITY COLLEGE - MCCOOK   ,NE,69001-2631,Public       ,2,5,7,259,169,428
00255900,PERU STATE COLLEGE                      ,NE,68421-0010,Public       ,5,29,34,923,1039,1962
00256000,WESTERN NEBRASKA COMMUNITY COLLEGE      ,NE,69361-1815,Public       ,11,34,45,709,934,1643
00256300,UNION COLLEGE                           ,NE,68506-4387,Private      ,0,0,0,779,280,1059
00256500,UNIVERSITY OF NEBRASKA-LINCOLN          ,NE,68588-0419,Public       ,35,70,105,14323,4775,19098
00256596,UNIVERSITY OF NEBRASKA - CURTIS         ,NE,69025-9522,Public       ,2,0,2,214,30,244
00256600,WAYNE STATE COLLEGE                     ,NE,68787-1172,Public       ,5,26,31,2604,862,3466
00256700,YORK COLLEGE                            ,NE,68467-2699,Private      ,3,0,3,445,95,540
00443100,MARY LANNING MEM HOSP SCH RAD TECH      ,NE,68901-4497,Private      ,0,0,0,11,6,17
00443600,REGNL WST MEDCL CTR SCHL RAD            ,NE,69361-0000,Private      ,0,0,0,11,8,19
00458608,KAPLAN UNIVERSITY - OMAHA               ,NE,68134-1002,Proprietary  ,15,126,141,248,1596,1844
00458609,KAPLAN UNIVERSITY - LINCOLN             ,NE,68508-2668,Proprietary  ,14,80,94,194,1070,1264
00639900,BRYANLGH COLLEGE OF HEALTH SCIENCES     ,NE,68506-1398,Private      ,0,1,1,281,235,516
00640400,NEBR METHODIST CLG OF NURS ALLD HLTH    ,NE,68114-2852,Private      ,4,8,12,368,520,888
00689500,UNIVERSITY OF NEBRASKA-MED CTR          ,NE,68198-4265,Public       ,2,8,10,537,2106,2643
00750100,VATTEROTT COLLEGE                       ,NE,68137-1237,Proprietary  ,0,10,10,196,863,1059
00849200,ALEGENT HEALTH SCHOOLS                  ,NE,68114-2767,Private      ,0,0,0,22,69,91
00952300,BAHNER COLLEGE OF HAIRSTYLING           ,NE,68025-3297,Proprietary  ,7,2,9,52,35,87
00961700,CAPITOL BEAUTY SCHOOL                   ,NE,68144-3873,Proprietary  ,3,4,7,115,90,205
00974300,BELLEVUE UNIVERSITY                     ,NE,68005-0000,Private      ,23,395,418,856,7030,7886
00986200,CLARKSON COLLEGE                        ,NE,68131-2739,Private      ,2,10,12,416,670,1086
01151900,JOSEPH'S COLLEGE OF BEAUTY/ALL CAMPUSES ,NE,68510-2226,Proprietary  ,4,37,41,184,356,540
01151909,JOSEPH'S COLLEGE OF BEAUTY - OMAHA      ,NE,68131-0000,Proprietary  ,0,2,2,5,8,13
01166700,NORTHEAST COMMUNITY COLLEGE             ,NE,68702-0000,Public       ,7,31,38,1468,1121,2589
01181400,GATEWAY ELECTRONICS INST                ,NE,68114-0000,Proprietary  ,0,0,0,0,1,1
01258600,METROPOLITAN COMMUNITY COLLEGE          ,NE,68103-0000,Public       ,41,146,187,3560,7749,11309
01297600,NEBRASKA CHRISTIAN COLLEGE              ,NE,68046-4256,Private      ,0,0,0,136,41,177
02079700,COLLEGE OF HAIR DESIGN                  ,NE,68508-0000,Proprietary  ,2,7,9,209,113,322
02099500,CENTRAL COMMUNITY COLLEGE- GI           ,NE,68801-0000,Public       ,5,56,61,592,1162,1754
02099501,CENTRAL COMMUNITY COLLEGE - HASTINGS    ,NE,68902-0000,Public       ,1,21,22,862,632,1494
02099502,CENTRAL COMMUNITY COLLEGE - COLUMBUS    ,NE,68602-0000,Public       ,3,9,12,419,392,811
02508300,SOUTHEAST COMM. COLLEGE-ALL CAMPUSES    ,NE,68520-0000,Public       ,39,80,119,4640,4582,9222
02550800,NEBRASKA INDIAN COMMUNITY COLLEGE       ,NE,68039-0000,Private      ,1,7,8,19,99,118
02610500,XENON INTERNATIONAL ACADEMY II          ,NE,68127-3522,Proprietary  ,8,10,18,212,172,384
03127300,OMAHA SCHOOL OF MASSAGE THERAPY         ,NE,68127-5002,Proprietary  ,3,11,14,75,131,206
03164300,THE CREATIVE CENTER                     ,NE,68164-2911,Proprietary  ,0,0,0,149,27,176
03279300,MYOTHERAPY INSTITUTE                    ,NE,68516-3641,Proprietary  ,1,0,1,35,31,66
03323300,LITTLE PRIEST TRIBAL COLLEGE            ,NE,68071-0000,Private      ,0,0,0,30,80,110
03821400,UNIVERSAL COLLEGE OF HEALING ARTS       ,NE,68112-1810,Proprietary  ,0,3,3,15,54,69
00256800,UNIVERSITY OF NEVADA RENO               ,NV,89557-0002,Public       ,29,54,83,6610,4178,10788
00256900,UNIVERSITY OF NEVADA-LAS VEGAS          ,NV,89154-1001,Public       ,79,210,289,10765,12271,23036
00697700,GREAT BASIN COLLEGE                     ,NV,89801-3348,Public       ,3,11,14,437,919,1356
00736700,MARINELLO SCHOOLS OF BEAUTY             ,NV,89110-3563,Proprietary  ,9,35,44,140,433,573
00737100,MARINELLO SCHOOL OF BEAUTY              ,NV,89502-5982,Proprietary  ,2,11,13,67,152,219
00844103,ANTHEM INSTITUTE - MORRISON UNIVERSITY  ,NV,89521-4826,Proprietary  ,0,5,5,1,8,9
00919200,SIERRA NEVADA COLLEGE                   ,NV,89451-0000,Private      ,1,22,23,267,534,801
01036200,COLLEGE OF SOUTHERN NEVADA              ,NV,89030-4296,Public       ,133,526,659,6974,14572,21546
01036300,WESTERN NEVADA COLLEGE                  ,NV,89703-0000,Public       ,16,69,85,779,1784,2563
01323200,ACADEMY OF HAIR DESIGN                  ,NV,89102-0000,Proprietary  ,16,20,36,139,229,368
02107700,TRUCKEE MEADOWS COMMUNITY CLG           ,NV,89512-0000,Public       ,33,156,189,2282,4378,6660
02237500,LAS VEGAS COLLEGE                       ,NV,89103-0000,Proprietary  ,37,123,160,437,1190,1627
02338509,NEVADA CAREER INSTITUTE                 ,NV,89121-0000,Proprietary  ,2,20,22,43,208,251
02361001,ITT TECHNICAL INSTITUTE                 ,NV,89014-0000,Proprietary  ,53,94,147,529,1111,1640
02616703,SCOTTSDALE CULINARY INSTITUTE - LE CORDO,NV,89144-7047,Proprietary  ,3,5,8,112,227,339
02621500,CAREER COLLEGE OF NORTHERN NEVADA       ,NV,89502-2331,Proprietary  ,12,65,77,149,616,765
03030603,UTAH CLG OF MASSAGE THERAPY-NSMT        ,NV,89123-0000,Proprietary  ,12,56,68,201,516,717
03031405,INTERNATIONAL ACADEMY OF DESIGN AND TECH,NV,89074-7750,Proprietary  ,22,25,47,331,478,809
03043200,KAPLAN COLLEGE                          ,NV,89102-8618,Proprietary  ,22,94,116,213,968,1181
03076404,HIGH-TECH INSTITUTE - LAS VEGAS         ,NV,89102-4514,Proprietary  ,1,5,6,48,111,159
03084600,THE ART INSTITUTE OF LAS VEGAS          ,NV,89074-7737,Proprietary  ,17,63,80,1269,1517,2786
03088200,CARSON CITY BEAUTY ACADEMY              ,NV,89706-0000,Proprietary  ,0,5,5,28,131,159
03110000,ACADEMY OF HEALING ARTS                 ,NV,89106-4031,Proprietary  ,38,138,176,277,1120,1397
03232306,EUPHORIA INSTITUTE - SUMMERLIN          ,NV,89117-8803,Proprietary  ,4,23,27,146,263,409
03232307,EUPHORIA INSTITUTE - GREEN VALLEY       ,NV,89052-4964,Proprietary  ,4,9,13,146,239,385
03232308,EUPHORIA INSTITUTE - ALIANTE            ,NV,89131-1036,Proprietary  ,5,14,19,70,147,217
03787300,EXPERTISE SCHOOL OF BEAUTY              ,NV,89106-2516,Private      ,2,12,14,45,192,237
03838500,NORTHWEST HEALTH CAREERS                ,NV,89128-0000,Proprietary  ,3,21,24,47,213,260
03975300,INSTITUTE OF PROFESSIONAL CAREERS       ,NV,89119-7825,Proprietary  ,0,1,1,14,68,82
04065300,UNIVERSITY OF SOUTHERN NEVADA           ,NV,89014-2333,Private      ,0,4,4,134,1161,1295
04114300,NEVADA STATE COLLEGE                    ,NV,89002-9455,Public       ,4,40,44,689,1252,1941
04147600,AVEDA INSTITUTE LAS VEGAS               ,NV,89119-6103,Proprietary  ,9,11,20,11,20,31
00257200,COLBY-SAWYER COLLEGE                    ,NH,03257-4648,Private      ,1,0,1,1877,42,1919
00257300,DARTMOUTH COLLEGE                       ,NH,03755-3529,Private      ,5,6,11,9112,1812,10924
00257500,FRANKLIN PIERCE COLLEGE                 ,NH,03461-0060,Private      ,2,19,21,3091,969,4060
00257900,NEW ENGLAND COLLEGE                     ,NH,03242-3293,Private      ,1,39,40,1496,847,2343
00258000,SOUTHERN NEW HAMPSHIRE UNIVERSITY       ,NH,03106-1045,Private      ,9,113,122,3939,3778,7717
00258100,NHTI  - CONCORD'S COMMUNITY COLLEGE     ,NH,03301-7412,Public       ,13,13,26,2049,1248,3297
00258200,MANCHESTER COMMUNITY COLLEGE            ,NH,03102-8518,Public       ,8,26,34,886,982,1868
00258202,NEW HAMPSHIRE COMMUNITY TECHNICAL COLLEG,NH,03038-0000,Public       ,1,0,1,40,14,54
00258300,GREAT BAY COMMUNITY COLLEGE             ,NH,03885-0000,Public       ,3,11,14,651,667,1318
00258600,RIVIER COLLEGE                          ,NH,03060-5086,Private      ,2,15,17,1343,853,2196
00258700,SAINT ANSELM COLLEGE                    ,NH,03102-1310,Private      ,2,0,2,3754,67,3821
00258900,UNIVERSITY OF NEW HAMPSHIRE             ,NH,03824-2511,Public       ,12,10,22,18295,2863,21158
00259000,KEENE STATE COLLEGE                     ,NH,03431-0000,Public       ,2,1,3,6764,537,7301
00259100,PLYMOUTH STATE UNIVERSITY               ,NH,03264-1595,Public       ,4,7,11,6004,848,6852
00301004,ANTIOCH UNIVERSITY                      ,NH,03431-0000,Private      ,0,3,3,3,820,823
00472900,HESSER COLLEGE                          ,NH,03103-7230,Proprietary  ,26,99,125,933,1338,2271
00472901,HESSER COLLEGE - NASHUA CAMPUS          ,NH,03063-1286,Proprietary  ,14,39,53,225,600,825
00472904,HESSER COLLEGE - PORTSMOUTH CAMPUS      ,NH,03801-3245,Proprietary  ,13,40,53,189,574,763
00472905,HESSER COLLEGE - SALEM CAMPUS           ,NH,03079-2842,Proprietary  ,10,29,39,284,679,963
00472906,HESSER COLLEGE - CONCORD CAMPUS         ,NH,03301-3415,Proprietary  ,6,39,45,127,549,676
00473000,MCINTOSH COLLEGE INC                    ,NH,03820-3990,Proprietary  ,0,0,0,268,208,476
00473100,DANIEL WEBSTER COLLEGE                  ,NH,03063-1300,Private      ,0,5,5,1106,254,1360
00473300,CHESTER COLLEGE OF NEW ENGLAND          ,NH,03036-4331,Private      ,0,0,0,295,32,327
00529100,WHITE MOUNTAINS COMMUNITY COLLEGE       ,NH,03570-3799,Public       ,5,11,16,296,548,844
00702500,LEBANON COLLEGE                         ,NH,03766-0000,Private      ,1,4,5,35,66,101
00755500,LAKES REGION COMMUNITY COLLEGE          ,NH,03246-1326,Public       ,5,3,8,541,402,943
00756000,RIVER VALLEY COMMUNITY COLLEGE          ,NH,03743-9707,Public       ,1,8,9,232,557,789
00849300,CONTINENTAL ACADEMIE OF HAIR DESIGN     ,NH,03103-4901,Proprietary  ,2,0,2,19,16,35
00864500,EMPIRE BEAUTY SCHOOL                    ,NH,03220-0000,Proprietary  ,10,15,25,144,139,283
00923600,NASHUA COMMUNITY COLLEGE                ,NH,03063-2052,Public       ,2,15,17,687,655,1342
01318900,CONTINENTAL ACADEMIE OF HAIR DESIGN     ,NH,03051-3754,Proprietary  ,2,1,3,34,28,62
02097900,FRANKLIN PIERCE LAW CENTER              ,NH,03301-0000,Private      ,0,1,1,13,782,795
02140400,ST JOSEPH SCH OF PRAC NRSG              ,NH,03060-0000,Private      ,3,7,10,42,99,141
02174800,MICHAEL'S SCHOOL OF HAIR DESIGN & ESTHET,NH,03110-0000,Proprietary  ,5,5,10,87,76,163
02179600,EMPIRE BEAUTY SCHOOL                    ,NH,03878-0000,Proprietary  ,7,21,28,131,208,339
02211600,PORTSMOUTH BTY SCH OF HAIR DESIGN       ,NH,03801-4084,Proprietary  ,1,1,2,28,11,39
02223300,MAGDALEN COLLEGE                        ,NH,03278-4012,Private      ,2,0,2,18,2,20
02245400,KEENE BEAUTY ACADEMY                    ,NH,03431-0000,Proprietary  ,0,3,3,45,40,85
02247000,NEW ENGLAND SCHOOL OF HAIR DESIGN       ,NH,03784-0000,Proprietary  ,0,2,2,39,56,95
02300200,CONCORD ACADEMY OF HAIR DESIGN          ,NH,03301-0000,Proprietary  ,0,0,0,7,12,19
03043100,THOMAS MORE COLLEGE OF LIBERAL ARTS     ,NH,03054-4818,Private      ,0,0,0,100,11,111
03101300,GRANITE STATE COLLEGE                   ,NH,03301-6400,Public       ,4,22,26,228,1304,1532
03182300,NEW HAMPSHIRE INSTITUTE OF ART          ,NH,03104-4858,Private      ,3,0,3,471,90,561
03305300,SECOND START                            ,NH,03301-5706,Private      ,0,0,0,0,1,1
03437300,UPPER VALLEY TEACHER INSTITUTE          ,NH,03766-1358,Private      ,0,1,1,5,44,49
03729300,NH INSTITUTE FOR THERAPEUTIC ARTS       ,NH,03051-4906,Proprietary  ,0,0,0,10,42,52
00267000,BAPTIST BIBLE COLG OF PENNSYLVANIA      ,PA,18411-1297,Private      ,3,13,16,656,170,826
00322800,BRYN ATHYN COLLEGE OF THE NEW CHURCH    ,PA,19009-0717,Private      ,0,0,0,85,14,99
00322900,ALBRIGHT COLLEGE                        ,PA,19612-5234,Private      ,3,18,21,3305,847,4152
00323000,ALLEGHENY COLLEGE                       ,PA,16335-3902,Private      ,3,1,4,3464,63,3527
00323100,COMM CLG OF ALLEGHENY-ALLEGHENY CMP     ,PA,15212-0000,Public       ,52,151,203,2416,4471,6887
00323101,"COMM CLG OF ALLEGHENY, BOYCE CAMPUS     ",PA,15146-0000,Public       ,16,67,83,1239,1953,3192
00323102,"COMM CLG OF ALLEGHENY, NORTH CAMPUS     ",PA,15237-0000,Public       ,11,62,73,1054,1144,2198
00323103,"COMM CLG OF ALLEGHENY, SOUTH CAMPUS     ",PA,15122-0000,Public       ,23,59,82,1668,2022,3690
00323300,ALVERNIA UNIVERSITY                     ,PA,19607-1799,Private      ,3,43,46,1912,1405,3317
00323500,ARCADIA UNIVERSITY                      ,PA,19038-3295,Private      ,3,27,30,3957,1636,5593
00323700,BRYN MAWR COLLEGE                       ,PA,19010-2899,Private      ,1,4,5,1526,478,2004
00323800,BUCKNELL UNIVERSITY                     ,PA,17837-2122,Private      ,5,0,5,5122,127,5249
00323900,BUCKS COUNTY COMMUNITY COLLEGE          ,PA,18940-1320,Public       ,40,97,137,3160,2762,5922
00324000,BUTLER COUNTY COMMUNITY COLLEGE         ,PA,16001-0000,Public       ,22,76,98,1649,1669,3318
00324100,CABRINI COLLEGE                         ,PA,19087-3698,Private      ,2,125,127,3034,1436,4470
00324200,CARNEGIE MELLON UNIVERSITY              ,PA,15213-3890,Private      ,9,11,20,9525,1183,10708
00324201,CARNEGIE MELLON UNIV- THE HEINZ SCH     ,PA,15213-0000,Private      ,0,6,6,309,478,787
00324202,CARNEGIE MELLON- TEPPER SCHOOL OF BUSINE,PA,15213-0000,Private      ,0,4,4,270,547,817
00324300,CEDAR CREST COLLEGE                     ,PA,18104-6196,Private      ,3,27,30,1399,1116,2515
00324400,CHATHAM UNIVERSITY                      ,PA,15232-2826,Private      ,1,22,23,763,1368,2131
00324500,CHESTNUT HILL COLLEGE                   ,PA,19118-2693,Private      ,5,39,44,1485,1489,2974
00324700,MISERICORDIA  UNIVERSITY                ,PA,18612-1008,Private      ,3,11,14,1948,947,2895
00324900,COMMUNITY COLLEGE OF PHILADELPHIA       ,PA,19130-3991,Public       ,142,512,654,9964,16212,26176
00325100,CURTIS INSTITUTE OF MUSIC               ,PA,19103-6187,Private      ,0,0,0,260,61,321
00325200,DELAWARE VALLEY COLLEGE                 ,PA,18901-2697,Private      ,5,9,14,2246,354,2600
00325300,DICKINSON COLLEGE                       ,PA,17013-2896,Private      ,7,0,7,3109,64,3173
00325400,DICKINSON SCHOOL OF LAW                 ,PA,17013-2899,Private      ,0,0,0,25,1587,1612
00325600,DREXEL UNIVERSITY                       ,PA,19104-2875,Private      ,25,185,210,19776,12819,32595
00325800,DUQUESNE UNIVERSITY                     ,PA,15282-0001,Private      ,12,63,75,7153,4026,11179
00325900,EASTERN UNIVERSITY                      ,PA,19087-3696,Private      ,5,46,51,2154,2355,4509
00325908,EASTERN BAPTIST THEOLGCL SEMINARY       ,PA,19096-0000,Private      ,0,0,0,2,77,79
00326200,ELIZABETHTOWN COLLEGE                   ,PA,17022-2298,Private      ,0,4,4,2920,411,3331
00326300,EVANGELICAL SCHOOL OF THEOLOGY          ,PA,17067-0000,Private      ,0,0,0,0,107,107
00326500,FRANKLIN & MARSHALL COLLEGE             ,PA,17604-0000,Private      ,6,1,7,3038,72,3110
00326600,GANNON UNIVERSITY                       ,PA,16541-0001,Private      ,3,18,21,3472,1349,4821
00326700,GENEVA COLLEGE                          ,PA,15010-3599,Private      ,0,12,12,1872,921,2793
00326800,GETTYSBURG COLLEGE                      ,PA,17325-1486,Private      ,2,0,2,4055,63,4118
00326900,GROVE CITY COLLEGE                      ,PA,16127-0000,Private      ,0,0,0,1812,33,1845
00327000,GWYNEDD-MERCY COLLEGE                   ,PA,19437-0901,Private      ,3,29,32,1746,1181,2927
00327200,HARCUM COLLEGE                          ,PA,19010-3476,Private      ,6,10,16,507,879,1386
00327300,HARRISBURG AREA COMMUNITY COLLEGE       ,PA,17110-2999,Public       ,100,469,569,7546,11676,19222
00327400,HAVERFORD COLLEGE                       ,PA,19041-1392,Private      ,0,0,0,2062,29,2091
00327500,HOLY FAMILY UNIVERSITY                  ,PA,19114-2094,Private      ,4,10,14,2025,1780,3805
00327600,IMMACULATA UNIVERSITY                   ,PA,19345-0647,Private      ,5,56,61,1475,1550,3025
00327700,INDIANA UNIVERSITY OF PENNSYLVANIA      ,PA,15705-1097,Public       ,94,72,166,13000,3475,16475
00327900,JUNIATA COLLEGE                         ,PA,16652-2196,Private      ,0,0,0,2368,72,2440
00328000,KEYSTONE COLLEGE                        ,PA,18440-0200,Private      ,8,30,38,1654,768,2422
00328200,KINGS COLLEGE                           ,PA,18711-0801,Private      ,3,10,13,2870,452,3322
00328300,LACKAWANNA COLLEGE                      ,PA,18509-9961,Private      ,17,17,34,1427,836,2263
00328400,LAFAYETTE COLLEGE                       ,PA,18042-1768,Private      ,1,0,1,3712,59,3771
00328500,LANCASTER BIBLE COLLEGE                 ,PA,17601-5036,Private      ,1,5,6,567,327,894
00328600,LANCASTER THEOLOGICAL SEMINARY          ,PA,17603-0000,Private      ,0,0,0,0,111,111
00328700,LASALLE UNIVERSITY                      ,PA,19141-1199,Private      ,9,76,85,5411,2959,8370
00328800,LEBANON VALLEY COLLEGE                  ,PA,17003-1400,Private      ,3,0,3,2367,197,2564
00328900,LEHIGH UNIVERSITY                       ,PA,18015-1588,Private      ,5,11,16,8389,659,9048
00329000,LINCOLN UNIVERSITY                      ,PA,19352-0999,Public       ,21,12,33,3945,1099,5044
00329100,LUTHERAN THEOLOG SEMINARY-GETTYSBRG     ,PA,17325-0000,Private      ,0,0,0,0,145,145
00329200,LUTHERAN THEOLOGICAL SEMINARY           ,PA,19119-0000,Private      ,0,2,2,0,178,178
00329300,LYCOMING COLLEGE                        ,PA,17701-5192,Private      ,0,1,1,1825,82,1907
00329400,MANOR COLLEGE                           ,PA,19046-3399,Private      ,3,3,6,585,539,1124
00329600,MARYWOOD UNIVERSITY                     ,PA,18509-1598,Private      ,3,24,27,2572,1574,4146
00329700,MERCYHURST COLLEGE                      ,PA,16546-0001,Private      ,8,4,12,4141,1608,5749
00329800,MESSIAH COLLEGE                         ,PA,17027-0800,Private      ,2,1,3,3433,124,3557
00330000,MOORE COLLEGE OF ART & DESIGN           ,PA,19103-1179,Private      ,2,6,8,719,228,947
00330100,MORAVIAN COLLEGE                        ,PA,18018-6650,Private      ,0,4,4,2163,223,2386
00330101,MORAVIAN THEOLOGICAL SEMINARY           ,PA,18018-0000,Private      ,0,0,0,11,63,74
00330200,MOUNT ALOYSIUS COLLEGE                  ,PA,16630-1999,Private      ,4,12,16,1252,876,2128
00330300,CARLOW COLLEGE                          ,PA,15213-3165,Private      ,4,13,17,1186,1646,2832
00330400,MUHLENBERG COLLEGE                      ,PA,18104-5586,Private      ,4,7,11,3380,231,3611
00330600,VALLEY FORGE CHRISTIAN COLLEGE          ,PA,19460-2399,Private      ,1,3,4,842,221,1063
00330900,PEIRCE COLLEGE                          ,PA,19102-4699,Private      ,6,82,88,316,2383,2699
00331100,PENNSYLVANIA COLLEGE OF OPTOMETRY       ,PA,19027-1598,Private      ,0,4,4,10,855,865
00331300,WIDENER UNIVERSITY                      ,PA,19013-5792,Private      ,7,22,29,4199,2079,6278
00331302,WIDENER UNIV SCH OF LAW- HARRISBURG     ,PA,17106-9381,Private      ,0,1,1,3,849,852
00331500,BLOOMSBURG UNIVERSITY OF PA             ,PA,17815-1301,Public       ,27,20,47,10436,1669,12105
00331600,CALIFORNIA UNIV OF PENNSYLVANIA         ,PA,15419-1394,Public       ,13,28,41,6587,3919,10506
00331700,CHEYNEY UNIVERSITY OF PENNSYLVANIA      ,PA,19319-0200,Public       ,15,16,31,2302,896,3198
00331800,CLARION UNIVERSITY OF PENNSYLVANIA      ,PA,16214-1232,Public       ,15,20,35,5402,2106,7508
00332000,EAST STROUDSBURG UNIVERSITY             ,PA,18301-2999,Public       ,25,26,51,7533,1520,9053
00332100,EDINBORO UNIVERSITY OF PENNSYLVANIA     ,PA,16444-0001,Public       ,12,44,56,5873,3136,9009
00332200,KUTZTOWN UNIVERSITY OF PENNSYLVANIA     ,PA,19530-9339,Public       ,14,16,30,10000,1741,11741
00332300,LOCK HAVEN UNIV OF PENNSYLVANIA         ,PA,17745-2439,Public       ,15,23,38,5570,1164,6734
00332400,MANSFIELD UNIVERSITY                    ,PA,16933-1123,Public       ,38,32,70,3098,1077,4175
00332500,MILLERSVILLE UNIVERSITY OF PA           ,PA,17551-1800,Public       ,15,12,27,7950,1797,9747
00332600,SHIPPENSBURG UNIVERSITY                 ,PA,17257-2299,Public       ,18,35,53,7465,1347,8812
00332700,SLIPPERY ROCK UNIVERSITY                ,PA,16057-1326,Public       ,19,43,62,8035,2044,10079
00332800,WEST CHESTER UNIVERSITY                 ,PA,19383-0001,Public       ,75,53,128,13520,3186,16706
00332900,PENN STATE UNIVERSITY                   ,PA,16802-1503,Public       ,401,273,674,68078,17299,85377
00332901,PENN STATE UNIV-HERSHEY MEDCL CTR       ,PA,17033-0000,Public       ,1,4,5,83,1063,1146
00335000,UNIVERSITY OF THE ARTS (THE)            ,PA,19102-9493,Private      ,2,5,7,3291,599,3890
00335100,PHILADELPHIA BIBLICAL UNIVERSITY        ,PA,19047-2942,Private      ,0,7,7,939,573,1512
00335200,PHILADELPHIA CLG OSTEOPATHIC MED        ,PA,19131-0000,Private      ,0,9,9,15,2621,2636
00335300,UNIVERSITY OF THE SCIENCES IN PHILADELPH,PA,19104-4495,Private      ,0,6,6,3377,866,4243
00335400,PHILADELPHIA UNIVERSITY                 ,PA,19144-5497,Private      ,6,26,32,3919,1023,4942
00335600,PITTSBURGH THEOLOGICAL SEMINARY         ,PA,15206-0000,Private      ,0,3,3,1,212,213
00335700,POINT PARK UNIVERSITY                   ,PA,15222-1912,Private      ,6,52,58,3064,2222,5286
00335800,REFORMED PRESBYTERIAN THEOL SEMINAR     ,PA,15208-0000,Private      ,0,0,0,0,27,27
00335900,ROBERT MORRIS UNIVERSITY                ,PA,15108-1189,Private      ,17,57,74,3874,2014,5888
00336000,ROSEMONT COLLEGE                        ,PA,19010-1699,Private      ,1,12,13,524,505,1029
00336200,SETON HILL UNIVERSITY                   ,PA,15601-1599,Private      ,2,8,10,1791,813,2604
00336400,ST. CHARLES BORROMEO SEMINARY           ,PA,19096-0000,Private      ,0,0,0,28,55,83
00336600,SAINT FRANCIS UNIVERSITY                ,PA,15940-0600,Private      ,5,21,26,1941,555,2496
00336700,SAINT JOSEPH'S UNIVERSITY               ,PA,19131-1395,Private      ,14,102,116,5971,2140,8111
00336800,ST VINCENT COLLEGE                      ,PA,15650-2690,Private      ,4,1,5,2133,317,2450
00336900,SUSQUEHANNA UNIVERSITY                  ,PA,17870-1001,Private      ,3,0,3,2776,96,2872
00337000,SWARTHMORE COLLEGE                      ,PA,19081-1397,Private      ,2,0,2,3609,46,3655
00337100,TEMPLE UNIV - MAIN CAMPUS               ,PA,19122-6003,Private      ,59,84,143,26550,7265,33815
00337101,TEMPLE UNIV - SCHOOL OF LAW             ,PA,19122-0000,Private      ,1,11,12,53,2631,2684
00337102,TEMPLE UNIV - SCHOOL OF MEDICINE        ,PA,19140-0000,Private      ,0,4,4,129,1263,1392
00337103,TEMPLE UNIV - SCHOOL OF DENTISTRY       ,PA,19140-0000,Private      ,0,0,0,30,577,607
00337104,TEMPLE UNIV - AMBLER CAMPUS             ,PA,19002-0000,Private      ,0,6,6,826,642,1468
00337105,TEMPLE UNIV - SCH OF ALLIED HEALTH      ,PA,19140-0000,Private      ,0,5,5,324,425,749
00337106,TEMPLE UNIV - SCHOOL OF PHARMACY        ,PA,19140-0000,Private      ,0,3,3,212,676,888
00337107,TEMPLE UNIV - TYLER SCHOOL OF ART       ,PA,19122-0000,Private      ,0,1,1,723,242,965
00337108,TEMPLE UNIV - GRAD DIV HEALTH SCI       ,PA,19140-0000,Private      ,1,5,6,85,465,550
00337109,TEMPLE UNIV - GRADUATE DIVISION         ,PA,19122-0000,Private      ,1,43,44,190,2795,2985
00337111,TEMPLE UNIV-SCH OF PODIATRIC MED        ,PA,19107-0000,Private      ,0,0,0,9,367,376
00337600,THIEL COLLEGE                           ,PA,16125-2181,Private      ,4,2,6,1560,143,1703
00337800,UNIVERSITY OF PENNSYLVANIA              ,PA,19104-6216,Private      ,19,71,90,15056,11924,26980
00337900,UNIVERSITY OF PITTSBURGH                ,PA,15260-0000,Public       ,52,145,197,25468,10125,35593
00337906,UNIV OF PITTSBURGH-SCH OF MEDICINE      ,PA,15261-0000,Public       ,0,0,0,53,888,941
00337907,UNIV OF PITTSBURGH-DENTAL MEDICINE      ,PA,15261-0000,Public       ,0,0,0,25,340,365
00338400,UNIVERSITY OF SCRANTON                  ,PA,18510-4622,Private      ,3,57,60,6651,1675,8326
00338500,URSINUS COLLEGE                         ,PA,19426-2562,Private      ,0,1,1,3763,87,3850
00338600,VALLEY FORGE MILITARY COLLEGE           ,PA,19087-3695,Private      ,2,0,2,239,14,253
00338800,VILLANOVA UNIVERSITY                    ,PA,19085-1699,Private      ,9,44,53,11419,1875,13294
00338801,VILLANOVA UNIV SCH OF LAW               ,PA,19085-0000,Private      ,0,0,0,21,1696,1717
00338900,WASHINGTON & JEFFERSON COLLEGE          ,PA,15301-4801,Private      ,1,0,1,2613,45,2658
00339100,WAYNESBURG UNIVERSITY                   ,PA,15370-1222,Private      ,1,24,25,1931,961,2892
00339200,WESTMINSTER COLLEGE                     ,PA,16172-0002,Private      ,3,2,5,2195,106,2301
00339300,WESTMINSTER THEOLOGICAL SEMINARY        ,PA,19038-0000,Private      ,0,1,1,3,274,277
00339400,WILKES UNIVERSITY                       ,PA,18766-0998,Private      ,5,17,22,3242,973,4215
00339500,PENNSYLVANIA COLLEGE OF TECHNOLOGY      ,PA,17701-5779,Public       ,12,11,23,5566,2162,7728
00339600,WILSON COLLEGE                          ,PA,17201-1285,Private      ,0,12,12,398,418,816
00339900,YORK COLLEGE OF PENNSYLVANIA            ,PA,17405-7199,Private      ,11,14,25,6131,1070,7201
00398600,DESALES UNIVERSITY                      ,PA,18034-9568,Private      ,4,37,41,2250,1076,3326
00398700,LA ROCHE COLLEGE                        ,PA,15237-5898,Private      ,7,18,25,1085,394,1479
00398800,NEUMANN COLLEGE                         ,PA,19014-1298,Private      ,9,22,31,2715,975,3690
00405800,GRATZ COLLEGE                           ,PA,19027-3097,Private      ,0,9,9,1,149,150
00445200,MONTGOMERY COUNTY COMMUNITY COLLEGE     ,PA,19422-6300,Public       ,47,170,217,3526,3957,7483
00488700,BRANDYWINE SCHOOL OF NURSING            ,PA,19320-1536,Proprietary  ,0,1,1,44,88,132
00488900,CAMBRIA-ROWE BUSINESS COLLEGE           ,PA,15902-2494,Proprietary  ,2,20,22,197,335,532
00489000,CENTRAL PENNSYLVANIA COLLEGE            ,PA,17093-0309,Proprietary  ,8,6,14,867,866,1733
00489300,DU BOIS BUSINESS COLLEGE                ,PA,15801-2401,Proprietary  ,0,10,10,210,328,538
00489400,ERIE BUSINESS CENTER                    ,PA,16501-1305,Proprietary  ,3,20,23,99,457,556
00489401,ERIE BUSINESS CENTER SOUTH              ,PA,16101-0000,Proprietary  ,2,13,15,28,101,129
00489800,MCCANN SCHOOL OF BUSINESS & TECHNOL     ,PA,17901-1335,Proprietary  ,63,190,253,1064,2504,3568
00489900,MERCY HOSP SCH OF NURSING               ,PA,15219-5166,Private      ,0,1,1,96,73,169
00490100,NEWPORT BUSINESS INSTITUTE              ,PA,15068-3929,Proprietary  ,2,2,4,53,74,127
00490200,PENN COMMERCIAL BUSINESS/TECHNICAL SCHL ,PA,15301-2871,Proprietary  ,4,8,12,286,509,795
00491000,KAPLAN CAREER INSTITUTE                 ,PA,17111-3571,Proprietary  ,15,78,93,303,884,1187
00491001,THOMPSON INSTITUTE-PHILADEPHIA CAMPUS   ,PA,19104-3386,Proprietary  ,30,161,191,332,1334,1666
00491400,NEWPORT BUSINESS INSTITUTE              ,PA,17701-5855,Proprietary  ,1,17,18,50,182,232
00500701,WEST VIRGINIA CAREER INSTITUTE          ,PA,15456-0000,Proprietary  ,2,1,3,63,158,221
00531000,PITTSBURGH INST OF AERONAUTICS          ,PA,15236-0000,Private      ,1,4,5,258,131,389
00533000,FAYETTE CNTY AREA VOC TECH PRC NRSG     ,PA,15401-0000,Public       ,1,1,2,31,122,153
00533500,CENTRAL PENN INST OF SCI & TECH PNP     ,PA,16823-0000,Public       ,0,1,1,41,112,153
00534100,UPPER BUCKS CO AREA VOC-TECH SCHOOL     ,PA,18944-0000,Public       ,0,0,0,1,3,4
00536500,YORK CO AREA VOC-TECH SCH-PRAC NSG      ,PA,17402-0000,Public       ,0,6,6,24,141,165
00594200,UPMC PRESBYTERIAN SCH OF RADIOLOGIC     ,PA,15213-2582,Private      ,0,0,0,25,37,62
00594600,SCHOOL OF RADIOLOGIC TECHNOLOGY AT ST. C,PA,19134-1995,Proprietary  ,0,1,1,23,47,70
00653400,CITIZENS SCHOOL OF NURSING              ,PA,15068-6591,Private      ,2,0,2,86,140,226
00653700,CONEMAUGH VLY MEM HOSP SCH NRSNG        ,PA,15905-4398,Private      ,1,0,1,92,132,224
00653702,CONEMAUGH HOSP- SCH HISTOTECHNOLOGY     ,PA,15905-0000,Private      ,0,0,0,5,7,12
00653704,CONEMAUGH VLY MEM HOSP SCH RAD TECH     ,PA,15905-0000,Private      ,0,0,0,23,11,34
00653706,CONEMAUGH VLY MEM HOSP SCH  MED TECH    ,PA,15905-4398,Private      ,0,0,0,8,3,11
00653900,EPISCOPAL HOSPITAL SCHL OF NURSING      ,PA,19125-1000,Private      ,0,1,1,13,106,119
00655100,ST MARGARET SCHL OF NURSING             ,PA,15238-3205,Private      ,0,0,0,70,163,233
00656000,OHIO VALLEY HOSP SCH OF NURSING         ,PA,15136-1694,Private      ,0,0,0,46,63,109
00656500,READING HOSPITAL SCHOOL OF HEALTH SCIENC,PA,19611-1744,Private      ,1,4,5,205,340,545
00657400,"ST LUKE'S HOSPITAL OF BETHLEHEM, PA     ",PA,18015-1065,Private      ,1,3,4,82,139,221
00657600,SEWICKLEY VALLEY HOSP SCH NRSNG         ,PA,15143-1498,Private      ,0,2,2,54,73,127
00657700,UPMC SHADYSIDE SCHOOL OF NURSING        ,PA,15232-1381,Private      ,0,4,4,123,332,455
00657800,SHARON REGIONAL SCHOOL OF NURSING       ,PA,16146-3395,Private      ,0,0,0,19,57,76
00658200,WASHINGTON HOSP SCH OF NURSING          ,PA,15301-3398,Private      ,0,0,0,60,147,207
00658202,WASHINGTON HOSP SCH OF RAD TECH         ,PA,15301-3398,Private      ,0,0,0,18,19,37
00658300,WESTERN PENN HOSP-SCH OF NURSING        ,PA,15224-1790,Private      ,1,1,2,108,137,245
00680700,COMMUNITY COLLEGE OF BEAVER COUNTY      ,PA,15061-2588,Public       ,12,69,81,1201,1376,2577
00681000,LEHIGH CARBON COMMUNITY COLLEGE         ,PA,18078-2598,Public       ,19,70,89,2666,2867,5533
00681100,LUZERNE COUNTY COMMUNITY COLLEGE        ,PA,18634-3899,Public       ,26,59,85,3088,2911,5999
00708700,ABINGTON MEM HOSP SCHL OF NURSING       ,PA,19090-1284,Private      ,0,1,1,97,264,361
00709000,METHODIST HOSPITAL SCH OF NURSING       ,PA,19148-3594,Private      ,0,0,0,4,17,21
00709100,EVEREST INSTITUTE                       ,PA,15222-1320,Proprietary  ,31,95,126,260,1061,1321
00711000,DELAWARE COUNTY COMMUNITY COLLEGE       ,PA,19063-1094,Public       ,49,162,211,3834,4732,8566
00719100,NORTHAMPTON COMMUNITY COLLEGE           ,PA,18020-7599,Public       ,47,122,169,4603,4274,8877
00739802,KATHERINE GIBBS-PHILADELPHIA            ,PA,19403-2422,Proprietary  ,0,1,1,169,293,462
00743000,ANTONELLI INST OF ART & PHOTOGRAPHY     ,PA,19038-8242,Proprietary  ,2,0,2,247,19,266
00743600,KAPLAN CAREER INSTITUTE - ICM CAMPUS    ,PA,15222-1977,Proprietary  ,24,78,102,561,1252,1813
00743700,PITTSBURGH TECHNICAL INSTITUTE          ,PA,15071-3205,Proprietary  ,10,17,27,2396,895,3291
00746900,"HUSSIAN SCHOOL OF ART, INC.             ",PA,19106-0000,Proprietary  ,0,0,0,141,26,167
00747000,"ART INSTITUTE OF PITTSBURGH, THE        ",PA,15219-1328,Proprietary  ,356,2488,2844,6937,23770,30707
00752900,CTR ART TCH BRDYWN CMPS PRC NRS PRG     ,PA,19320-2459,Public       ,0,1,1,26,138,164
00775900,LINCOLN TECHNICAL INSTITUTE             ,PA,18104-3298,Proprietary  ,21,83,104,471,806,1277
00777900,LANSDALE SCHOOL OF BUSINESS             ,PA,19454-4148,Proprietary  ,0,32,32,126,485,611
00778000,NEW CASTLE SCHOOL OF TRADES             ,PA,16143-9721,Proprietary  ,14,76,90,305,723,1028
00778100,CHI INSTITUTE/RETS CAMPUS               ,PA,19008-3516,Proprietary  ,17,79,96,351,882,1233
00783200,LINCOLN TECH INSTITUTE                  ,PA,19136-1595,Proprietary  ,43,59,102,582,535,1117
00783900,TRIANGLE TECH                           ,PA,15214-3897,Proprietary  ,17,26,43,194,202,396
00791200,THADDEUS STEVENS CLG OF TECHNOLOGY      ,PA,17602-0000,Public       ,5,1,6,934,288,1222
00791600,FRANKLIN CNTY CAREER & TECH CTR-PNP     ,PA,17201-0000,Public       ,0,0,0,14,37,51
00820000,JAMESON MEMORIAL HOSP SCH NURSING       ,PA,16105-2595,Private      ,0,0,0,33,102,135
00826301,AWARD BEAUTY SCHOOL - CHAMBERSBURG BEAUT,PA,17201-2435,Proprietary  ,0,0,0,4,3,7
00835000,ART INSTITUTE OF PHILADELPHIA           ,PA,19103-5198,Proprietary  ,31,48,79,3981,2310,6291
00844100,ANTHEM INSTITUTE                        ,PA,19064-1243,Proprietary  ,34,89,123,518,981,1499
00856800,MEDIAN SCHOOL                           ,PA,15222-3400,Proprietary  ,1,0,1,305,126,431
00865300,JEFFERSON CO DUBOIS VOC TECH-PR NSG     ,PA,15851-0000,Public       ,0,1,1,20,61,81
00888900,LEHIGH VALLEY COLLEGE                   ,PA,18034-8447,Proprietary  ,0,0,0,216,231,447
00895500,PRUONTOS HAIR DESIGN INSTITUTE & BEAUTY ,PA,16602-0000,Proprietary  ,0,1,1,17,33,50
00915705,WYOMING TECHNICAL INSTITUTE - BLAIRSVILL,PA,15717-8060,Proprietary  ,4,1,5,333,159,492
00918600,DEAN INSTITUTE OF TECHNOLOGY            ,PA,15226-1197,Proprietary  ,2,6,8,51,144,195
00944900,PENNCO TECH                             ,PA,19007-0000,Proprietary  ,10,31,41,331,533,864
00966400,EMPIRE BEAUTY SCHOOL                    ,PA,18052-5730,Proprietary  ,25,27,52,186,328,514
00966500,EMPIRE BEAUTY SCHOOL                    ,PA,17109-2210,Proprietary  ,5,28,33,73,284,357
00966600,EMPIRE BEAUTY SCHOOL                    ,PA,19605-2803,Proprietary  ,5,21,26,142,291,433
00972100,BRADFORD SCHOOL                         ,PA,15219-2602,Proprietary  ,4,0,4,666,134,800
00972300,FRANKFORD HOSP SCH OF NURSING           ,PA,19124-2696,Private      ,1,3,4,211,291,502
00978300,GORDON PHILLIPS SCH OF BEAUTY CULT      ,PA,19135-0000,Proprietary  ,10,28,38,261,384,645
00986301,LANCASTER INSTITUTE FOR HEALTH EDUC     ,PA,17602-4955,Private      ,0,5,5,287,505,792
01000600,GREATER JOHNSTOWN AREA VOC TECH SCH     ,PA,15904-0000,Public       ,1,0,1,63,251,314
01005500,CRAWFORD CNTY AREA VO-TECH PRAC NUR     ,PA,16335-0000,Public       ,0,0,0,8,26,34
01017600,WESTMORELAND COUNTY COMMUNITY CLG       ,PA,15697-1895,Public       ,43,199,242,2495,3166,5661
01038800,READING AREA COMMUNITY COLLEGE          ,PA,19603-1706,Public       ,45,176,221,1888,3506,5394
01054100,EMPIRE BEAUTY SCHOOL                    ,PA,15146-2229,Proprietary  ,14,29,43,182,330,512
01054200,EMPIRE BEAUTY SCHOOL                    ,PA,18701-0000,Proprietary  ,7,21,28,194,277,471
01054300,EMPIRE BEAUTY SCHOOL                    ,PA,17701-3914,Proprietary  ,0,22,22,114,227,341
01081400,PITTSBURGH INST MORTUARY SCIENCE        ,PA,15206-3706,Private      ,0,0,0,74,191,265
01086000,GREATER ALTOONA CAREER/TECH CENTER      ,PA,16602-0000,Public       ,0,1,1,62,169,231
01096300,GREENE COUNTY VOC-TECH SCHOOL           ,PA,15370-0000,Public       ,0,0,0,8,26,34
01097000,EMPIRE BEAUTY SCHOOL                    ,PA,17042-5209,Proprietary  ,0,7,7,29,54,83
01099800,PENNSYLVANIA INSTITUTE OF TECH          ,PA,19063-4098,Private      ,15,41,56,615,1065,1680
01102000,EMPIRE BEAUTY SCHOOL                    ,PA,17604-4335,Proprietary  ,13,25,38,86,154,240
01102100,EMPIRE BEAUTY SCHOOL                    ,PA,17402-2862,Proprietary  ,14,52,66,187,545,732
01162100,AUTOMOTIVE TRAINING CENTER              ,PA,19341-1310,Proprietary  ,33,19,52,604,245,849
01162200,WELDER TRAINING & TESTING INST          ,PA,18109-3253,Proprietary  ,1,2,3,39,70,109
01163800,EMPIRE BEAUTY SCHOOL                    ,PA,17876-0000,Proprietary  ,0,9,9,39,79,118
01171500,POTTSVILLE HOSPITAL SCHOOL OF NURSING   ,PA,17901-3692,Private      ,0,0,0,49,50,99
01191900,BEAVER FALLS BEAUTY ACADEMY             ,PA,15010-4208,Proprietary  ,3,10,13,25,63,88
01205000,ROSEDALE TECHNICAL INSTITUTE            ,PA,15205-9791,Private      ,10,19,29,194,190,384
01239300,THOMAS JEFF UNIV-CLG ALLIED HEALTH      ,PA,19107-0000,Private      ,2,4,6,363,892,1255
01239301,JEFFERSON MED CLG-T. JEFFERSON UNIV     ,PA,19107-5587,Private      ,0,5,5,137,1447,1584
01239303,THOMAS JEFFERSON UNIV-GRADUATE COLG     ,PA,19107-0000,Private      ,0,4,4,184,966,1150
01246104,LINCOLN TECHNICAL INSTITUTE             ,PA,19104-0202,Proprietary  ,32,143,175,448,1084,1532
01246105,LINCOLN TECHNICAL INSTITUTE             ,PA,19116-4202,Proprietary  ,15,42,57,255,451,706
01252300,TALMUDICAL YESHIVA OF PHILA             ,PA,19131-1296,Private      ,0,0,0,27,2,29
01260500,EMPIRE BEAUTY SCHOOL                    ,PA,17331-2405,Proprietary  ,8,8,16,60,100,160
01260600,EMPIRE BEAUTY SCHOOL                    ,PA,17901-2505,Proprietary  ,9,34,43,157,441,598
01260700,EMPIRE BEAUTY SCHOOL                    ,PA,16801-5218,Proprietary  ,0,2,2,20,31,51
01292900,SOUTH HILLS BEAUTY ACADEMY              ,PA,15216-2335,Proprietary  ,2,5,7,47,89,136
01301500,GORDON PHILLIPS SCH BEAUTY CULTURE      ,PA,19102-2701,Proprietary  ,21,62,83,247,573,820
01313400,YESHIVATH BETH MOSHE                    ,PA,18505-2196,Private      ,0,0,0,44,1,45
01321400,ROXBOROUGH MEM HOSP SCH OF NURSING      ,PA,19128-0000,Proprietary  ,1,2,3,61,212,273
01326300,SOUTH HILLS SCH OF BUS & TECHNOLOGY     ,PA,16801-4516,Proprietary  ,0,0,0,492,427,919
01326304,SOUTH HILLS SCHOOL OF BUSINESS & TECHNOL,PA,16602-1188,Proprietary  ,0,1,1,32,29,61
02061000,VENUS BEAUTY ACADEMY                    ,PA,19079-0000,Proprietary  ,2,2,4,76,60,136
02068300,DOUGLAS SCHOOL OF BUSINESS              ,PA,15062-0000,Proprietary  ,10,12,22,239,263,502
02068301,DOUGLAS EDUCATION CENTER - DOUGLAS SCHOO,PA,15062-9901,Proprietary  ,0,0,0,22,24,46
02090200,TRIANGLE TECH                           ,PA,16502-0000,Proprietary  ,9,25,34,144,198,342
02092500,LAUREL TECHNICAL INSTITUTE              ,PA,16146-0000,Proprietary  ,8,30,38,57,280,337
02092502,BUSINESS INSTITUTE OF PENNSYLVANIA      ,PA,16335-0000,Proprietary  ,0,1,1,5,20,25
02107300,PENNSYLVANIA ACADEMY OF FINE ARTS       ,PA,19102-1424,Private      ,1,1,2,207,250,457
02112200,GREAT LAKES INSTITUTE OF TECHNOLOGY     ,PA,16509-0000,Proprietary  ,8,40,48,291,531,822
02114200,JOHNSON COLLEGE                         ,PA,18508-0000,Private      ,1,2,3,417,157,574
02116001,SANFORD-BROWN INSTITUTE - TREVOSE       ,PA,19053-4700,Proprietary  ,29,114,143,530,1470,2000
02118000,LEVITTOWN BEAUTY ACADEMY LLC            ,PA,19054-1713,Proprietary  ,0,2,2,28,43,71
02119300,PA ACAD OF COSMETOLOGY ARTS & SCI       ,PA,15904-0000,Proprietary  ,10,11,21,84,113,197
02119301,PA ACAD OF COSMTLGY ARTS & SCI          ,PA,15801-0000,Proprietary  ,0,0,0,1,0,1
02120800,"YORKTOWNE BUSINESS INSTITUTE, INC.      ",PA,17404-0000,Proprietary  ,1,1,2,125,223,348
02127400,YORK TECHNICAL INSTITUTE                ,PA,17402-0000,Proprietary  ,38,112,150,1178,1442,2620
02129000,TRIANGLE TECH                           ,PA,15601-0000,Proprietary  ,28,16,44,319,297,616
02129001,TRIANGLE TECH - BUSINESS CAREERS INSTITU,PA,15601-3304,Proprietary  ,0,0,0,2,3,5
02144000,"VISION ACADEMY, THE                     ",PA,18103-0000,Proprietary  ,4,9,13,76,129,205
02147800,SCHUYLKILL INST BUSINESS & TECHNLGY     ,PA,17901-0000,Proprietary  ,0,0,0,0,1,1
02149000,EMPIRE BEAUTY SCHOOL                    ,PA,19341-2804,Proprietary  ,7,10,17,96,146,242
02151500,CENTRAL SUSQUEHANNA LPN CENTER          ,PA,17847-0000,Public       ,0,2,2,27,153,180
02152105,ACADEMY OF COURT REPORTING & TECHNOLOGY ,PA,15222-1710,Proprietary  ,3,29,32,24,105,129
02153500,OAKBRIDGE ACADEMY OF ARTS               ,PA,15068-0000,Proprietary  ,0,0,0,73,19,92
02158300,JUNIATA-MIFFLIN CO AREA VOC TECH        ,PA,17044-0000,Public       ,0,0,0,21,73,94
02161400,NORTHEASTERN HOSP SCH OF NRSG           ,PA,19134-0000,Private      ,2,2,4,58,147,205
02169600,CLEARFIELD CTY CAREER AND TECH CNTR     ,PA,16830-0000,Public       ,0,1,1,44,121,165
02174400,TRIANGLE TECH                           ,PA,15801-0000,Proprietary  ,26,43,69,368,339,707
02178900,ACADEMY OF HAIR DESIGN                  ,PA,18202-1465,Proprietary  ,1,4,5,20,34,54
02183000,ORLEANS TECHNICAL INSTITUTE             ,PA,19111-0000,Private      ,19,68,87,246,795,1041
02192800,WALNUT HILL COLLEGE                     ,PA,19104-0000,Proprietary  ,5,5,10,472,230,702
02202300,SANFORD-BROWN INSTITUTE                 ,PA,15219-1907,Proprietary  ,12,47,59,422,1050,1472
02202301,SANFORD-BROWN INSTITUTE                 ,PA,15146-2141,Proprietary  ,4,26,30,214,700,914
02203900,ERIE INSTITUTE OF TECHNOLOGY            ,PA,16565-1002,Proprietary  ,6,19,25,134,273,407
02206200,AMBLER BEAUTY ACADEMY                   ,PA,19002-0000,Proprietary  ,6,19,25,44,102,146
02206300,STROUDSBURG SCHOOL OF COSMETOLOGY       ,PA,18360-0000,Proprietary  ,1,0,1,18,22,40
02212700,LANCASTER SCHOOL OF COSMETOLOGY         ,PA,17602-0000,Proprietary  ,2,17,19,48,156,204
02213400,PROFESSIONAL SKILLS CAREER ACADEMY      ,PA,16148-0000,Proprietary  ,0,0,0,5,7,12
02234200,ACADEMY OF MEDICAL ARTS & BUSINESS      ,PA,17112-0000,Proprietary  ,9,28,37,101,248,349
02251200,SCHUYLKILL COUNTY AREA VOC TECH SCH     ,PA,17931-0000,Public       ,0,0,0,33,102,135
02251202,SCHUYLKILL COUNTY AREA VOC TECH SCH     ,PA,17931-0000,Public       ,0,7,7,17,39,56
02253900,BERKS TECHNICAL INSTITUTE               ,PA,19610-0000,Proprietary  ,12,42,54,479,761,1240
02255200,PENNSYLVANIA SCHOOL OF BUSINESS         ,PA,18101-1604,Proprietary  ,13,49,62,211,663,874
02269900,PENNSYLVANIA COLLEGE OF ART & DESIGN    ,PA,17603-3528,Private      ,1,0,1,349,66,415
02270500,BUCKS COUNTY SCHOOL OF BEAUTY CULT      ,PA,19053-0000,Proprietary  ,1,2,3,50,41,91
02273400,RECONSTRUCTIONIST RABBINICAL COLLEG     ,PA,19095-0000,Private      ,0,1,1,0,29,29
02276600,HANOVER PUBLIC SCH DIST PRAC NURSG      ,PA,17331-0000,Public       ,0,0,0,10,41,51
02282500,LENAPE SCHOOL OF PRACTICAL NURSING      ,PA,16226-0000,Public       ,0,0,0,34,178,212
02288800,EMPIRE BEAUTY SCHOOL                    ,PA,18974-4508,Proprietary  ,6,12,18,62,85,147
02289500,PACE INSTITUTE                          ,PA,19601-0000,Proprietary  ,9,28,37,95,403,498
02289600,CONSOLIDATED SCHOOL OF BUSINESS         ,PA,17404-0000,Proprietary  ,0,1,1,51,164,215
02289700,ACADEMY OF CREATIVE HAIR DESIGN         ,PA,18702-0000,Proprietary  ,5,6,11,56,81,137
02289800,CHI INSTITUTE - FRANKLIN MILLS          ,PA,19154-0000,Proprietary  ,40,109,149,564,1441,2005
02290400,"ALTOONA BEAUTY SCHOOL, INC              ",PA,16602-0000,Proprietary  ,0,1,1,42,75,117
02292700,LANSDALE SCHOOL OF COSMETOLOGY          ,PA,19446-0000,Proprietary  ,1,3,4,32,37,69
02299300,TRINITY EPISCOPAL SCHOOL MINISTRY       ,PA,15003-0000,Private      ,0,0,0,1,67,68
02301300,PJA SCHOOL (THE)                        ,PA,19082-1917,Proprietary  ,4,18,22,120,410,530
02304400,YTI CAREER INSTITUTE - MECHANICSBURG    ,PA,17055-0000,Proprietary  ,6,25,31,176,302,478
02306200,VENANGO COUNTY AREA VOC TECH SCHOOL     ,PA,16301-0000,Public       ,0,2,2,9,35,44
02310800,LANCASTER COUNTY CAREER & TECH CTR      ,PA,17584-0000,Public       ,5,5,10,160,566,726
02330300,LEBANON CO CAREER & TECHNOLOGY CTR      ,PA,17042-0000,Public       ,0,1,1,18,102,120
02330600,PENNSYLVANIA GUNSMITH SCHOOL            ,PA,15202-0000,Proprietary  ,0,0,0,36,45,81
02350100,WESTERN AREA CAREER & TECHNOLOGY CT     ,PA,15317-0000,Public       ,0,0,0,18,55,73
02350200,INDIANA COUNTY TECH CTR SCH PR NSG      ,PA,15701-1465,Public       ,1,4,5,24,61,85
02353100,NORTHERN TIER CAREER CENTER             ,PA,18848-0000,Public       ,0,1,1,18,51,69
02361002,ITT TECHNICAL INSTITUTE                 ,PA,19406-0000,Proprietary  ,27,45,72,389,544,933
02362300,MERCER COUNTY AREA VOC TECH SCHOOL      ,PA,16137-0000,Public       ,0,0,0,16,83,99
02492500,DELAWARE VLY ACAD MED DNTL ASSTS        ,PA,19114-0000,Proprietary  ,4,16,20,54,139,193
02492600,EASTERN CTR ARTS AND TECH PR NSG        ,PA,19090-0000,Public       ,0,1,1,20,179,199
02495500,ALL-STATE CAREER SCHOOL                 ,PA,19029-0000,Proprietary  ,24,172,196,289,1286,1575
02529800,WILKES BARRE AREA CAREER AND TECHNICAL C,PA,18705-0000,Public       ,1,0,1,59,205,264
02536600,COMMONWEALTH TECH INSTIT @ HIRAM G      ,PA,15905-0000,Public       ,11,1,12,252,127,379
02539900,STAR TECHNICAL INSTITUTE                ,PA,19082-0000,Proprietary  ,0,0,0,26,123,149
02544300,BUTLER BEAUTY SCHOOL                    ,PA,16001-0000,Proprietary  ,8,12,20,62,134,196
02545000,LAWRENCE COUNTY CAREER AND TECHNICAL CEN,PA,16101-0000,Public       ,1,0,1,16,74,90
02546200,LAUREL BUSINESS INSTITUTE               ,PA,15401-0877,Proprietary  ,10,17,27,203,331,534
02550000,CLARION CO AREA VOC-TECH PRAC NRSG      ,PA,16254-0000,Public       ,0,1,1,12,47,59
02554500,HAZLETON AREA VOC TECH SCH PR NSG       ,PA,18201-1597,Public       ,0,0,0,16,41,57
02557800,ART INSTITUTE OF YORK (THE) - PENNSYLVAN,PA,17402-9012,Proprietary  ,6,6,12,777,267,1044
02566400,ALBERT EINSTEIN MED CTR DEPT DNTL       ,PA,19141-3098,Private      ,0,0,0,7,22,29
02574800,PENNSYLVANIA INSTITUTE OF TAXIDERMY     ,PA,15931-0000,Proprietary  ,0,0,0,8,23,31
02609500,CAREER TRAINING ACADEMY                 ,PA,15068-6308,Proprietary  ,3,15,18,73,261,334
02609501,CAREER TRAINING ACADEMY                 ,PA,15146-0000,Proprietary  ,0,0,0,3,4,7
02615400,STAR TECHNICAL INSTITUTE                ,PA,19114-2204,Proprietary  ,0,0,0,83,393,476
02616100,JEAN MADELINE ED CTR FOR COSM           ,PA,19147-1542,Proprietary  ,14,8,22,330,271,601
03006800,PENNSYLVANIA CULINARY INSTITUTE         ,PA,15222-3511,Proprietary  ,8,19,27,1058,1135,2193
03010800,TRI-STATE BUSINESS INSTITUTE            ,PA,16506-1013,Proprietary  ,61,206,267,887,2564,3451
03011500,ALLIED MEDICAL AND TECHNICAL INSTITUTE  ,PA,18702-0000,Proprietary  ,9,66,75,208,473,681
03011600,ALLIED MEDICAL AND TECHNICAL INSTITUTE  ,PA,18509-2903,Proprietary  ,15,47,62,242,470,712
03029900,CONSOLIDATED SCHOOL OF BUSINESS         ,PA,17603-2389,Proprietary  ,0,1,1,54,192,246
03031600,DPT BUSINESS SCHOOL                     ,PA,19116-3961,Proprietary  ,17,83,100,107,647,754
03031601,DPT BUSINESS SCHOOL                     ,PA,19106-0000,Proprietary  ,7,59,66,78,397,475
03067000,ANTONELLI MEDICAL & PROF INST           ,PA,19464-9244,Proprietary  ,0,7,7,10,65,75
03072400,ALL-STATE CAREER SCHOOL                 ,PA,15122-1000,Proprietary  ,4,32,36,21,218,239
03072600,DCI CAREER INSTITUTE                    ,PA,15061-2307,Proprietary  ,2,19,21,53,219,272
03081900,YTI CAREER INSTITUTE - ALTOONA          ,PA,16602-4457,Proprietary  ,5,35,40,163,380,543
03090800,LAKE ERIE COLL OF OSTEOPATHIC MED       ,PA,16509-0000,Private      ,0,1,1,82,2533,2615
03098600,CAREER TECH CTR OF LACKAWANNA CNTY      ,PA,18508-0000,Public       ,0,0,0,32,113,145
03101500,BIDWELL TRAINING CENTER                 ,PA,15233-2233,Private      ,1,1,2,20,52,72
03103300,JNA INSTITUTE OF CULINARY ARTS          ,PA,19146-3119,Proprietary  ,1,13,14,70,142,212
03109100,METROPOLITAN CAREER CENTER              ,PA,19144-0000,Private      ,3,14,17,47,225,272
03110700,AVIATION INSTITUTE OF MAINTENANCE       ,PA,19114-1017,Proprietary  ,6,34,40,148,388,536
03120400,REGIONAL CAREER & TECHNICAL CENTER      ,PA,16509-4699,Public       ,0,0,0,4,6,10
03126000,CENTER FOR INNOVATIVE TRAINING & ED     ,PA,19106-4414,Proprietary  ,0,0,0,1,4,5
03128400,DELAWARE COUNTY TECHNICAL SCHOOL        ,PA,19032-1998,Public       ,1,0,1,26,185,211
03180400,PENNSYLVANIA HIGHLANDS COMMUNITY COLLEGE,PA,15904-2927,Public       ,11,34,45,603,770,1373
03236400,LT INTERNATIONAL BEAUTY SCHOOL          ,PA,19130-2235,Proprietary  ,2,8,10,25,125,150
03353300,ACADEMY OF VOCAL ARTS                   ,PA,19103-6685,Private      ,0,1,1,4,34,38
03380301,CULINARY ACADEMY OF LONG ISLAND - STAR P,PA,19114-2204,Proprietary  ,6,44,50,38,148,186
03439400,NAWCC SCHOOL OF HOROLOGY                ,PA,17512-2130,Private      ,0,0,0,2,6,8
03503300,WINNER INSTITUTE OF ARTS & SCIENCES     ,PA,16154-1811,Private      ,0,0,0,9,4,13
03535300,HUNTINGDON COUNTY CAREER AND TECHNO     ,PA,17060-0905,Public       ,0,0,0,10,35,45
03561400,SUSQUEHANNA COUNTY CAREER & TECHNOL     ,PA,18816-0100,Public       ,0,0,0,6,12,18
03766300,PENNSYLVANIA SCHOOL OF MUSCLE THERAPY   ,PA,19406-3101,Proprietary  ,2,6,8,42,124,166
03899300,CALVARY BAPTIST THEOLOGICAL SEMINARY    ,PA,19446-4718,Private      ,0,0,0,0,11,11
03923300,PRECISION MANUFACTURING INSTITUTE       ,PA,16335-8380,Private      ,1,3,4,18,59,77
03948300,HARRISBURG UNIVERSITY OF SCIENCE AND TEC,PA,17101-2116,Private      ,1,9,10,164,147,311
03949300,WON INSTITUTE OF GRADUATE STUDIES       ,PA,19038-4535,Private      ,0,2,2,0,37,37
03950500,NORTHWEST REGIONAL TECHNOLOGY INSTITUTE ,PA,16508-2820,Proprietary  ,1,14,15,8,69,77
03952300,NATIONAL MASSAGE THERAPY INSTITUTE      ,PA,19116-3965,Proprietary  ,23,99,122,194,751,945
04119900,PENNSYLVANIA MYOTHERAPY INSTITUTE       ,PA,17350-8426,Proprietary  ,1,0,1,7,22,29
04127500,CAREER DEVELOPMENT & EMPLOYMENT         ,PA,18702-5253,Proprietary  ,0,5,5,2,38,40
04137100,KIMBERLY'S BEAUTY SCHOOL                ,PA,19134-0000,Proprietary  ,0,4,4,0,6,6
04138300,INTERNATIONAL BEAUTY ACADEMY            ,PA,19149-2710,Proprietary  ,0,11,11,2,21,23
00267813,BRYANT & STRATTON COLLEGE - MIL DOWNTOWN,WI,53203-2608,Proprietary  ,13,61,74,623,2163,2786
00383200,ALVERNO COLLEGE                         ,WI,53234-3922,Private      ,4,10,14,1479,2144,3623
00383500,BELOIT COLLEGE                          ,WI,53511-5595,Private      ,0,1,1,1933,77,2010
00383700,CARDINAL STRITCH UNIVERSITY             ,WI,53217-9884,Private      ,7,214,221,974,4807,5781
00383800,CARROLL UNIVERSITY                      ,WI,53186-5593,Private      ,3,3,6,3104,683,3787
00383900,CARTHAGE COLLEGE                        ,WI,53141-0000,Private      ,3,9,12,3796,603,4399
00384000,WESTERN TECHNICAL COLLEGE               ,WI,54601-0908,Public       ,14,57,71,1783,2252,4035
00384200,CONCORDIA UNIVERSITY WISCONSIN          ,WI,53097-2402,Private      ,4,128,132,2054,3350,5404
00384800,EDGEWOOD COLLEGE                        ,WI,53711-1958,Private      ,1,16,17,1579,966,2545
00385000,SILVER LAKE COLLEGE                     ,WI,54220-9319,Private      ,0,1,1,194,405,599
00385400,LAKELAND COLLEGE                        ,WI,53082-0000,Private      ,10,84,94,1179,1974,3153
00385600,LAWRENCE UNIVERSITY                     ,WI,54912-0599,Private      ,3,0,3,2242,61,2303
00386100,MARIAN UNIVERSITY                       ,WI,54935-4699,Private      ,5,59,64,1256,1288,2544
00386300,MARQUETTE UNIVERSITY                    ,WI,53201-0000,Private      ,13,32,45,10885,3972,14857
00386600,MILWAUKEE AREA TECH COLLEGE             ,WI,53233-1443,Public       ,28,137,165,5223,12963,18186
00386800,MILWAUKEE SCHOOL OF ENGINEERING         ,WI,53202-3109,Private      ,3,7,10,2599,605,3204
00386900,MOUNT MARY COLLEGE                      ,WI,53222-4597,Private      ,2,7,9,798,1277,2075
00387400,NASHOTAH HOUSE                          ,WI,53058-0000,Private      ,0,1,1,0,45,45
00387500,NORTHLAND COLLEGE                       ,WI,54806-3999,Private      ,1,0,1,802,140,942
00388400,RIPON COLLEGE                           ,WI,54971-0248,Private      ,1,0,1,1278,55,1333
00389200,ST. NORBERT COLLEGE                     ,WI,54115-2002,Private      ,4,1,5,2253,105,2358
00389500,UNIVERSITY OF WISCONSIN-MADISON         ,WI,53715-1382,Public       ,37,49,86,21369,10192,31561
00389600,UNIVERSITY OF WISCONSIN-MILWAUKEE       ,WI,53201-3165,Public       ,59,186,245,16535,10163,26698
00389700,UNIVERSITY OF WISCONSIN COLLEGES        ,WI,53708-8680,Public       ,12,36,48,1676,1286,2962
00389701,UNIVERSITY OF WISCONSIN-BARABOO         ,WI,53913-1098,Public       ,2,0,2,285,159,444
00389702,UNIVERSITY OF WISCONSIN-BARRON          ,WI,54868-2497,Public       ,1,3,4,219,132,351
00389703,UNIVERSITY OF WISCONSIN-FOND DU LAC     ,WI,54935-2998,Public       ,0,3,3,439,189,628
00389704,UNIVERSITY OF WISCONSIN-FOX VALLEY      ,WI,54952-1297,Public       ,6,6,12,780,410,1190
00389705,UNIVERSITY OF WISCONSIN-MANITOWOC       ,WI,54220-6699,Public       ,0,0,0,277,113,390
00389706,UNIVERSITY OF WISCONSIN-MARATHON        ,WI,54401-5396,Public       ,2,2,4,756,318,1074
00389707,UNIVERSITY OF WISCONSIN-MARINETTE       ,WI,54143-4299,Public       ,1,2,3,236,115,351
00389708,UNIVERSITY OF WISCONSIN-MARSHFIELD      ,WI,54449-3310,Public       ,1,1,2,273,154,427
00389709,UNIVERSITY OF WISCONSIN-RICHLAND        ,WI,53581-1399,Public       ,2,2,4,253,78,331
00389710,UNIVERSITY OF WISCONSIN COLLEGES - ROCK ,WI,53546-5699,Public       ,3,8,11,491,322,813
00389711,UNIVERSITY OF WISCONSIN-SHEBOYGAN       ,WI,53081-4789,Public       ,1,6,7,337,229,566
00389712,UNIVERSITY OF WISCONSIN-WASHINGTON      ,WI,53095-3699,Public       ,0,6,6,441,176,617
00389713,UNIVERSITY OF WISCONSIN-WAUKESHA        ,WI,53188-2799,Public       ,9,7,16,917,357,1274
00389900,UNIVERSITY OF WISCONSIN-GREEN BAY       ,WI,54311-7001,Public       ,10,16,26,4182,1650,5832
00391100,VITERBO UNIVERSITY                      ,WI,54601-4777,Private      ,3,33,36,1546,1081,2627
00391500,UNIVERSITY OF WISCONSIN-STOUT           ,WI,54751-0790,Public       ,16,49,65,5789,1875,7664
00391700,UNIVERSITY OF WISCONSIN-EAU CLAIRE      ,WI,54702-4004,Public       ,21,31,52,8087,1627,9714
00391900,UNIVERSITY OF WISCONSIN-LA CROSSE       ,WI,54601-3742,Public       ,11,12,23,6943,1601,8544
00392000,UNIVERSITY OF WISCONSIN-OSHKOSH         ,WI,54901-8604,Public       ,20,27,47,7008,2916,9924
00392100,UNIVERSITY OF WISCONSIN-PLATTEVILLE     ,WI,53818-3099,Public       ,14,25,39,5122,1518,6640
00392300,UNIVERSITY OF WISCONSIN-RIVER FALLS     ,WI,54022-5013,Public       ,14,27,41,4807,1183,5990
00392400,UNIVERSITY OF WISCONSIN-STEVENS POINT   ,WI,54481-3871,Public       ,22,16,38,6603,1684,8287
00392500,UNIVERSITY OF WISCONSIN-SUPERIOR        ,WI,54880-2898,Public       ,3,12,15,1535,1273,2808
00392600,UNIVERSITY OF WISCONSIN-WHITEWATER      ,WI,53190-1792,Public       ,18,45,63,7661,2159,9820
00400700,MADISON AREA TECHNICAL COLLEGE          ,WI,53704-2599,Public       ,22,65,87,3923,5139,9062
00501500,UNIVERSITY OF WISCONSIN-PARKSIDE        ,WI,53141-2000,Public       ,15,31,46,3246,1934,5180
00529400,WAUKESHA COUNTY TECHNICAL COLLEGE       ,WI,53072-4696,Public       ,4,27,31,1272,2066,3338
00530100,NORTHEAST WISCONSIN TECHNICAL COLLEGE   ,WI,54307-9042,Public       ,29,89,118,2139,3795,5934
00530400,CHIPPEWA VALLEY TECHNICAL COLLEGE       ,WI,54701-6162,Public       ,9,19,28,2260,2958,5218
00538000,MID-STATE TECHNICAL COLLEGE             ,WI,54494-5512,Public       ,9,41,50,843,1662,2505
00538400,NICOLET AREA TECHNICAL COLLEGE          ,WI,54501-0000,Public       ,7,24,31,460,739,1199
00538700,NORTHCENTRAL TECHNICAL COLLEGE          ,WI,54401-1899,Public       ,11,43,54,912,1946,2858
00538900,GATEWAY TECHNICAL COLLEGE               ,WI,53144-1690,Public       ,11,63,74,1592,5045,6637
00539000,BLACKHAWK TECHNICAL COLLEGE             ,WI,53547-5009,Public       ,9,77,86,808,2339,3147
00610800,BELLIN HOSP SCH OF RAD TECH             ,WI,54305-3505,Private      ,0,0,0,11,2,13
00611500,MERCY MED CTR SCH OF RAD TECH           ,WI,54904-3370,Private      ,0,0,0,13,8,21
00612601,ST LUKE'S MEDCL CTR SCHL RAD TECH       ,WI,53215-4330,Private      ,0,1,1,3,17,20
00612603,ST LUKE'S MED CTR SCH OF SONOGRAPHY     ,WI,53215-0000,Private      ,0,0,0,3,10,13
00613100,THEDA CLARK REG MED CTR SCH RAD TEC     ,WI,54957-0000,Private      ,1,0,1,4,13,17
00663900,BELLIN COLLEGE                          ,WI,54305-3400,Private      ,2,2,4,216,130,346
00766900,SOUTHWEST WISCONSIN TECH COLLEGE        ,WI,53809-0000,Public       ,1,1,2,664,725,1389
00777400,SCIENTIFIC COLLEGE OF BEAUTY/BARBER     ,WI,54601-0000,Proprietary  ,0,0,0,13,26,39
00821700,WISCONSIN COLLEGE OF COSMETOLOGY        ,WI,54304-5531,Proprietary  ,1,1,2,53,43,96
00919400,LAKESHORE TECHNICAL COLLEGE             ,WI,53015-1412,Public       ,4,14,18,517,1428,1945
00925600,MORAINE PARK TECHNICAL COLLEGE          ,WI,54936-0000,Public       ,7,37,44,808,1940,2748
00941900,STATE CLG OF BEAUTY CULT-WAUSAU         ,WI,54403-4667,Proprietary  ,3,6,9,53,60,113
00962100,HERZING COLLEGE                         ,WI,53718-4236,Proprietary  ,25,340,365,651,3523,4174
00974400,FOX VALLEY TECHNICAL COLLEGE            ,WI,54913-0000,Public       ,16,99,115,2327,3584,5911
01091300,MADISON MEDIA INSTITUTE                 ,WI,53718-6787,Proprietary  ,1,2,3,339,181,520
01148400,ADVANCED INSTITUTE OF HAIR DESIGN       ,WI,53225-0000,Proprietary  ,9,8,17,170,164,334
01182400,WISCONSIN INDIANHEAD TECH CLG WITC      ,WI,54871-9300,Public       ,6,50,56,1072,1992,3064
01290600,MADISON COSMETOLOGY COLLEGE             ,WI,53711-1030,Proprietary  ,0,0,0,8,19,27
02077100,MILWAUKEE INST OF ART & DESIGN          ,WI,53202-0000,Private      ,2,0,2,766,157,923
02078000,SACRED HEART SCHOOL OF THEOLOGY         ,WI,53130-0000,Private      ,0,0,0,0,7,7
02136600,WISCONSIN LUTHERAN COLLEGE              ,WI,53226-0000,Private      ,1,0,1,820,74,894
02201803,KAPLAN COLLEGE - MILWAUKEE              ,WI,53212-3939,Proprietary  ,21,153,174,224,1066,1290
02239204,HIGH-TECH INSTITUTE - MILWAUKEE         ,WI,53005-4207,Proprietary  ,1,2,3,15,34,49
02271300,WI SCH OF PROFESSIONAL PSYCHOLOGY       ,WI,53225-0000,Private      ,0,0,0,4,66,70
02317200,MARANATHA BAPTIST BIBLE COLLEGE         ,WI,53094-0000,Private      ,4,0,4,718,107,825
02324700,MARTIN'S COLLEGE OF COSMETOLOGY         ,WI,53717-0000,Proprietary  ,7,12,19,98,179,277
02332100,MARTIN'S SCH HAIR DESIGN MANITOWOC      ,WI,54220-0000,Proprietary  ,3,15,18,108,154,262
02332101,MARTIN'S COLLEGE OF COSMETOLOGY -       ,WI,54914-4644,Proprietary  ,0,0,0,7,12,19
02453500,MEDICAL COLLEGE OF WISCONSIN            ,WI,53226-0000,Private      ,0,3,3,16,1133,1149
02494300,GILL-TECH ACADEMY OF HAIR DESIGN        ,WI,54911-0000,Proprietary  ,2,7,9,70,58,128
02503303,RASMUSSEN COLLEGE - MANKATO - GREEN BAY ,WI,54303-2349,Proprietary  ,5,45,50,174,700,874
02532200,LAC COURTE OREILLES OJIBWA CMTY CLG     ,WI,54843-0000,Public       ,1,6,7,91,410,501
03007400,LAKESIDE SCHOOL OF MASSAGE THERAPY      ,WI,53719-1103,Private      ,0,3,3,45,133,178
03061200,MIDWEST COLLEGE OF ORIENTAL MEDICINE    ,WI,53403-9747,Proprietary  ,0,5,5,8,233,241
03077600,MARTIN'S COLLEGE OF COSMETOLOGY         ,WI,54304-4838,Proprietary  ,13,27,40,216,401,617
03087500,ITT TECHNICAL INSTITUTE                 ,WI,53220-4612,Proprietary  ,94,285,379,1612,3247,4859
03125100,COLLEGE OF MENOMINEE NATION             ,WI,54135-0000,Private      ,1,6,7,135,496,631
03125102,COLLEGE OF  THE MENOMINEE NATION - GREEN,WI,54304-4964,Private      ,0,4,4,17,84,101
03220300,PROFESSIONAL HAIR DESIGN ACADEMY        ,WI,54701-7633,Proprietary  ,0,1,1,84,85,169
03309300,MONTESSORI INSTITUTE OF MILWAUKEE       ,WI,53207-0000,Private      ,0,3,3,3,15,18
03808300,INSTITUTE OF BEAUTY AND WELLNESS (THE)  ,WI,53202-5715,Proprietary  ,4,0,4,83,87,170
03822300,FOUR SEASONS SALON & DAY SPA            ,WI,53566-0000,Proprietary  ,0,0,0,13,22,35
03872500,NORTHLAND INTERNATIONAL UNIVERSITY      ,WI,54119-9285,Private      ,6,1,7,421,51,472
03925300,BLUE SKY SCHOOL OF PROFESSIONAL MASSAGE ,WI,53024-2624,Private      ,1,2,3,50,120,170
04117400,MILWAUKEE CAREER COLLEGE                ,WI,53222-4305,Proprietary  ,22,59,81,114,582,696
04118600,ACADEMY OF COSMETOLOGY                  ,WI,53548-3307,Proprietary  ,2,3,5,37,67,104
04124800,VISIONS IN HAIR DESIGN INSTITUTE OF COSM,WI,53210-1120,Proprietary  ,1,2,3,4,5,9
04132600,WISCONSIN ACADEMY (THE)                 ,WI,54157-1726,Proprietary  ,0,3,3,21,37,58
04138200,SALON PROFESSIONAL ACADEMY (THE)        ,WI,54914-3921,Proprietary  ,0,0,0,19,25,44
00290500,NORTH CAROLINA A&T STATE UNIV           ,NC,27411-0001,Public       ,42,55,97,12643,4486,17129
00290600,APPALACHIAN STATE UNIVERSITY            ,NC,28608-2059,Public       ,41,47,88,13848,3464,17312
00290700,UNIVERSITY OF NC AT ASHEVILLE           ,NC,28804-3299,Public       ,7,11,18,2959,1274,4233
00290800,BARTON COLLEGE                          ,NC,27893-3104,Private      ,4,6,10,1445,680,2125
00291000,BELMONT ABBEY COLLEGE                   ,NC,28012-1802,Private      ,5,14,19,1099,1063,2162
00291100,BENNETT COLLEGE                         ,NC,27401-3239,Private      ,2,2,4,1094,264,1358
00291200,BREVARD COLLEGE                         ,NC,28712-3306,Private      ,0,1,1,933,117,1050
00291300,CAMPBELL UNIVERSITY                     ,NC,27506-0036,Private      ,9,42,51,4038,2930,6968
00291400,CATAWBA COLLEGE                         ,NC,28144-2488,Private      ,3,3,6,1424,549,1973
00291500,CENTRAL PIEDMONT COMMUNITY COLLEGE      ,NC,28204-2297,Public       ,98,460,558,5804,12220,18024
00291600,CHOWAN UNIVERSITY                       ,NC,27855-1850,Private      ,5,8,13,1576,267,1843
00291700,COLLEGE OF THE ALBEMARLE                ,NC,27909-2327,Public       ,4,29,33,639,1440,2079
00291800,DAVIDSON COLLEGE                        ,NC,28035-7157,Private      ,0,0,0,2737,74,2811
00291900,DAVIDSON COUNTY COMMUNITY COLLEGE       ,NC,27293-0000,Public       ,12,110,122,1044,2914,3958
00292000,DUKE UNIVERSITY                         ,NC,27708-0397,Private      ,15,9,24,12303,1234,13537
00292001,DUKE UNIV - SCHOOL OF MEDICINE          ,NC,27710-0000,Private      ,2,1,3,90,1236,1326
00292002,DUKE UNIV - SCHOOL OF LAW               ,NC,27708-0000,Private      ,0,18,18,40,2894,2934
00292003,DUKE UNIV - GRAD SCH ARTS & SCIENCE     ,NC,27708-0000,Private      ,0,3,3,66,757,823
00292004,DUKE UNIV - FUQUA SCH OF BUSINESS       ,NC,27708-0000,Private      ,0,9,9,53,1147,1200
00292005,DUKE UNIV/NICHOLAS SCH OF ENVIRON.      ,NC,27708-0000,Private      ,0,0,0,13,288,301
00292006,DUKE UNIV - DIVINITY SCHOOL             ,NC,27708-0000,Private      ,1,2,3,81,633,714
00292007,DUKE UNIV - SCHOOL OF NURSING           ,NC,27710-0000,Private      ,0,5,5,63,489,552
00292300,EAST CAROLINA UNIVERSITY                ,NC,27858-1818,Public       ,72,246,318,18084,10211,28295
00292600,ELIZABETH CITY STATE UNIVERSITY         ,NC,27909-7806,Public       ,9,17,26,3625,1320,4945
00292700,ELON UNIVERSITY                         ,NC,27244-2010,Private      ,3,19,22,5878,827,6705
00292800,FAYETTEVILLE STATE UNIVERSITY           ,NC,28301-4298,Public       ,13,77,90,5379,5760,11139
00292900,GARDNER-WEBB UNIVERSITY                 ,NC,28017-0000,Private      ,3,42,45,2167,2186,4353
00293000,GREENSBORO COLLEGE                      ,NC,27401-1875,Private      ,7,23,30,1310,760,2070
00293100,GUILFORD COLLEGE                        ,NC,27410-4171,Private      ,10,49,59,2458,2240,4698
00293300,HIGH POINT UNIVERSITY                   ,NC,27262-4221,Private      ,26,16,42,3136,1498,4634
00293400,ISOTHERMAL COMMUNITY COLLEGE            ,NC,28160-0804,Public       ,7,53,60,803,1676,2479
00293500,JOHN WESLEY COLLEGE                     ,NC,27265-0000,Private      ,0,5,5,44,140,184
00293600,JOHNSON C SMITH UNIVERSITY              ,NC,28216-5398,Private      ,8,10,18,3510,809,4319
00293700,KING'S COLLEGE-CHARLOTTE                ,NC,28204-2435,Proprietary  ,1,3,4,676,354,1030
00293900,LEES MCRAE COLLEGE                      ,NC,28604-0000,Private      ,3,1,4,973,297,1270
00294000,LENOIR COMMUNITY COLLEGE                ,NC,28502-0188,Public       ,17,81,98,814,2326,3140
00294100,LENOIR-RHYNE COLLEGE                    ,NC,28603-0000,Private      ,1,3,4,1977,495,2472
00294200,LIVINGSTONE COLLEGE                     ,NC,28144-5298,Private      ,2,1,3,1306,380,1686
00294300,LOUISBURG COLLEGE                       ,NC,27549-2398,Private      ,10,3,13,980,103,1083
00294400,MARS HILL COLLEGE                       ,NC,28754-0000,Private      ,6,3,9,1402,446,1848
00294500,MEREDITH COLLEGE                        ,NC,27607-5298,Private      ,7,14,21,1903,864,2767
00294600,METHODIST UNIVERSITY                    ,NC,28311-1420,Private      ,7,18,25,2122,1243,3365
00294700,MITCHELL COMMUNITY COLLEGE              ,NC,28677-5264,Public       ,16,94,110,812,2211,3023
00294800,MONTREAT COLLEGE                        ,NC,28757-1267,Private      ,1,26,27,637,1021,1658
00294900,MOUNT OLIVE COLLEGE                     ,NC,28365-1299,Private      ,9,64,73,1022,3388,4410
00295000,NORTH CAROLINA CENTRAL UNIVERSITY       ,NC,27707-3198,Public       ,27,94,121,7696,6863,14559
00295100,NORTH CAROLINA WESLEYAN COLLEGE         ,NC,27804-8699,Private      ,3,23,26,1114,1000,2114
00295300,PEACE COLLEGE                           ,NC,27604-1194,Private      ,5,0,5,855,238,1093
00295400,UNIV OF NORTH CAROLINA AT PEMBROKE      ,NC,28372-1510,Public       ,60,71,131,5021,3535,8556
00295500,PFEIFFER UNIVERSITY                     ,NC,28109-0000,Private      ,2,40,42,975,1295,2270
00295600,PIEDMONT BAPTIST COLLEGE AND GRADUATE SC,NC,27101-5025,Private      ,0,0,0,208,182,390
00295700,QUEENS UNIVERSITY OF CHARLOTTE          ,NC,28274-0001,Private      ,7,77,84,1609,1712,3321
00295800,ROCKINGHAM COMMUNITY COLLEGE            ,NC,27375-0000,Public       ,6,47,53,675,1388,2063
00296000,SALEM COLLEGE                           ,NC,27108-0000,Private      ,0,16,16,508,627,1135
00296100,SANDHILLS COMMUNITY COLLEGE             ,NC,28374-8283,Public       ,21,84,105,1290,2765,4055
00296200,SHAW UNIVERSITY                         ,NC,27601-2393,Private      ,11,13,24,3049,2444,5493
00296300,SOUTHEASTERN BAPTIST THEOL SEMINARY     ,NC,27588-0000,Private      ,0,2,2,29,112,141
00296400,SOUTHEASTERN COMMUNITY COLLEGE          ,NC,28472-5422,Public       ,13,58,71,713,1575,2288
00296700,ST ANDREWS PRESBYTERIAN COLLEGE         ,NC,28352-9979,Private      ,0,2,2,795,120,915
00296800,ST AUGUSTINES COLLEGE                   ,NC,27610-2298,Private      ,11,8,19,1926,617,2543
00297000,SURRY COMMUNITY COLLEGE                 ,NC,27017-0304,Public       ,14,60,74,1070,1455,2525
00297200,NORTH CAROLINA STATE UNIV-RALEIGH       ,NC,27695-1751,Public       ,40,90,130,19780,7167,26947
00297300,GASTON COLLEGE                          ,NC,28034-1499,Public       ,24,190,214,1479,3792,5271
00297400,UNIVERSITY OF N C-CHAPEL HILL           ,NC,27514-0000,Public       ,44,186,230,17818,11018,28836
00297500,UNIVERSITY OF NC AT CHARLOTTE           ,NC,28223-0001,Public       ,68,224,292,14540,9707,24247
00297600,UNIVERSITY OF N C - GREENSBORO          ,NC,27412-0001,Public       ,20,92,112,13153,7722,20875
00297800,WAKE FOREST UNIV - UNDERGRADUATE        ,NC,27109-7246,Private      ,8,3,11,5268,215,5483
00297801,WAKE FOREST UNIV - SCH OF MEDICINE      ,NC,27157-1090,Private      ,1,4,5,36,936,972
00297803,WAKE FOREST UNIV - MBA                  ,NC,27109-7659,Private      ,0,5,5,18,517,535
00297805,WAKE FOREST UNIV - SCH OF LAW           ,NC,27109-7206,Private      ,0,1,1,17,1296,1313
00297806,WAKE FOREST UNIV - GRAD A&S/DIVINITY    ,NC,27109-7246,Private      ,0,6,6,51,395,446
00297900,WARREN WILSON COLLEGE                   ,NC,28815-0000,Private      ,2,1,3,1131,305,1436
00298000,WAYNE COMMUNITY COLLEGE                 ,NC,27533-0000,Public       ,14,102,116,1109,2434,3543
00298100,WESTERN CAROLINA UNIVERSITY             ,NC,28723-9731,Public       ,61,59,120,6317,2966,9283
00298200,WESTERN PIEDMONT COMMUNITY COLLEGE      ,NC,28655-4504,Public       ,13,95,108,945,2011,2956
00298300,WILKES COMMUNITY COLLEGE                ,NC,28697-2100,Public       ,6,48,54,886,1398,2284
00298400,UNIVERSITY OF N C-WILMINGTON            ,NC,28403-3297,Public       ,30,61,91,10048,3516,13564
00298500,WINGATE UNIVERSITY                      ,NC,28174-0159,Private      ,4,13,17,2126,816,2942
00298600,WINSTON-SALEM STATE UNIVERSITY          ,NC,27102-0000,Public       ,13,42,55,7154,3884,11038
00398100,NORTH CAROLINA SCHOOL OF THE ARTS       ,NC,27127-2188,Public       ,1,2,3,1101,267,1368
00403300,ASHEVILLE BUNCOMBE TECH CMTY CLG        ,NC,28801-4897,Public       ,24,138,162,1378,2926,4304
00406200,PITT COMMUNITY COLLEGE                  ,NC,28590-0000,Public       ,36,140,176,2717,4330,7047
00483500,CALDWELL COMMUNITY CLG & TECH INST      ,NC,28638-2626,Public       ,21,92,113,1189,2142,3331
00483800,GUILFORD TECHNICAL COMMUNITY CLG        ,NC,27282-0309,Public       ,41,215,256,4328,8020,12348
00484400,WAKE TECHNICAL COMMUNITY COLLEGE        ,NC,27603-5696,Public       ,51,206,257,3804,7192,10996
00484500,WILSON COMMUNITY COLLEGE                ,NC,27893-3310,Public       ,26,121,147,494,1759,2253
00499201,MILLER-MOTTE TECHNICAL COLLEGE - CARY   ,NC,27511-9209,Proprietary  ,8,88,96,163,1162,1325
00499202,MILLER-MOTTE TECHNICAL COLLEGE - MILLER-,NC,27604-6072,Proprietary  ,10,64,74,74,312,386
00531600,COASTAL CAROLINA COMMUNITY COLLEGE      ,NC,28546-6816,Public       ,18,124,142,1091,3296,4387
00531700,FORSYTH TECHNICAL COMMUNITY COLLEGE     ,NC,27103-5197,Public       ,39,164,203,2092,5486,7578
00531800,CATAWBA VALLEY COMMUNITY COLLEGE        ,NC,28602-8302,Public       ,17,82,99,1519,3014,4533
00532000,CAPE FEAR COMMUNITY COLLEGE             ,NC,28401-3910,Public       ,32,137,169,2661,3704,6365
00544700,RANDOLPH COMMUNITY COLLEGE              ,NC,27204-1009,Public       ,7,60,67,687,1554,2241
00544800,DURHAM TECHNICAL CMNTY COLLEGE          ,NC,27703-5023,Public       ,21,154,175,1010,3666,4676
00544900,CENTRAL CAROLINA COMMUNITY COLLEGE      ,NC,27330-9000,Public       ,12,84,96,1003,2875,3878
00546300,ALAMANCE COMMUNITY COLLEGE              ,NC,27253-0000,Public       ,25,123,148,1083,2852,3935
00546400,RICHMOND COMMUNITY COLLEGE              ,NC,28345-4522,Public       ,6,55,61,566,1663,2229
00575400,ROWAN-CABARRUS COMMUNITY COLLEGE        ,NC,28145-1595,Public       ,25,233,258,1638,4015,5653
00647700,CABARRUS COLLEGE OF HEALTH SCIENCES     ,NC,28025-0000,Private      ,0,8,8,287,445,732
00647800,MERCY HOSP SCH OF NURSING               ,NC,28207-0000,Public       ,1,11,12,114,401,515
00648300,WATTS SCHOOL OF NURSING                 ,NC,27704-0000,Private      ,0,4,4,58,188,246
00679900,CRAVEN COMMUNITY COLLEGE                ,NC,28562-0000,Public       ,6,65,71,680,2283,2963
00703100,PAMLICO COMMUNITY COLLEGE               ,NC,28529-0000,Public       ,0,1,1,85,294,379
00764000,FAYETTEVILLE TECHNICAL CMTY COLLEGE     ,NC,28303-0236,Public       ,19,159,178,2750,10175,12925
00768700,JAMES SPRUNT COMMUNITY COLLEGE          ,NC,28349-0398,Public       ,3,31,34,343,938,1281
00781400,BROOKSTONE COLLEGE OF BUSINESS          ,NC,28262-0000,Proprietary  ,3,38,41,80,404,484
00781401,BROOKSTONE COLLEGE OF BUSINESS          ,NC,27409-0000,Proprietary  ,1,42,43,52,461,513
00789200,SAMPSON COMMUNITY COLLEGE               ,NC,28328-0000,Public       ,1,11,12,472,1164,1636
00798500,SOUTH PIEDMONT COMMUNITY COLLEGE        ,NC,28135-9703,Public       ,9,62,71,648,1803,2451
00798600,HALIFAX COMMUNITY COLLEGE               ,NC,27890-0089,Public       ,8,31,39,531,1257,1788
00798700,BLADEN COMMUNITY COLLEGE                ,NC,28332-0266,Public       ,6,21,27,433,1435,1868
00798800,MARTIN COMMUNITY COLLEGE                ,NC,27892-8307,Public       ,1,17,18,211,624,835
00808100,CARTERET COMMUNITY COLLEGE              ,NC,28557-2989,Public       ,6,45,51,479,1164,1643
00808200,CLEVELAND COMMUNITY COLLEGE             ,NC,28150-0000,Public       ,9,77,86,789,2315,3104
00808300,HAYWOOD COMMUNITY COLLEGE               ,NC,28721-0000,Public       ,9,37,46,518,998,1516
00808500,MCDOWELL TECHNICAL COMMUNITY CLG        ,NC,28752-8728,Public       ,15,50,65,294,847,1141
00808700,MONTGOMERY COMMUNITY COLLEGE            ,NC,27371-0787,Public       ,3,20,23,238,673,911
00846600,SOUTHWESTERN COMMUNITY COLLEGE          ,NC,28779-8581,Public       ,10,35,45,667,1242,1909
00855700,NASH COMMUNITY COLLEGE                  ,NC,27804-0488,Public       ,7,74,81,752,1763,2515
00855800,BEAUFORT COUNTY COMMUNITY COLLEGE       ,NC,27889-7889,Public       ,4,39,43,469,1324,1793
00861200,ROBESON COMMUNITY COLLEGE               ,NC,28359-2151,Public       ,9,67,76,883,2683,3566
00861300,ROANOKE-CHOWAN COMMUNITY COLLEGE        ,NC,27910-9522,Public       ,0,1,1,278,641,919
00885500,EDGECOMBE COMMUNITY COLLEGE             ,NC,27886-9399,Public       ,17,122,139,517,2034,2551
00885501,EDGECOMBE COMMUNITY COLLEGE             ,NC,27801-0000,Public       ,0,0,0,108,484,592
00902500,SOUTH EASTERN CLG OF BEAUTY CULTURE     ,NC,28204-0000,Proprietary  ,6,34,40,151,451,602
00933600,JOHNSTON COMMUNITY COLLEGE              ,NC,27577-0000,Public       ,3,41,44,931,2119,3050
00943000,TRI-COUNTY COMMUNITY COLLEGE            ,NC,28906-7919,Public       ,8,33,41,293,743,1036
00964600,PIEDMONT COMMUNITY COLLEGE              ,NC,27573-1197,Public       ,10,69,79,463,1261,1724
00968400,BLUE RIDGE COMMUNITY COLLEGE            ,NC,28731-9624,Public       ,8,44,52,531,917,1448
00974701,GORDON-CONWELL THEO SEM - CHARLOTTE     ,NC,28273-0000,Private      ,0,4,4,2,164,166
00990300,VANCE-GRANVILLE CMTY COLLEGE            ,NC,27536-0917,Public       ,31,133,164,1105,2806,3911
01026400,SOUTH COLLEGE                           ,NC,28803-3152,Proprietary  ,11,62,73,84,578,662
01119400,STANLY COMMUNITY COLLEGE                ,NC,28001-7458,Public       ,9,80,89,543,1637,2180
01119700,MAYLAND COMMUNITY COLLEGE               ,NC,28777-2777,Public       ,8,25,33,291,538,829
01179900,PAUL MITCHELL THE SCHOOL FAYETTEVILLE   ,NC,28303-5364,Proprietary  ,2,10,12,14,97,111
01192600,LEON'S BEAUTY SCHOOL                    ,NC,27403-2812,Proprietary  ,2,8,10,97,188,285
02056500,MITCHELL'S HAIR STYLING ACADEMY         ,NC,27893-0000,Proprietary  ,6,12,18,77,135,212
02056501,MITCHELL'S HAIR STYLING ACADEMY - MITCHE,NC,27606-3326,Proprietary  ,1,0,1,21,41,62
02110500,ART INSTITUTE OF CHARLOTTE (THE)        ,NC,28217-0000,Proprietary  ,36,167,203,1863,2217,4080
02170700,BRUNSWICK COMMUNITY COLLEGE             ,NC,28422-0000,Public       ,3,22,25,481,753,1234
02205000,COLLEGE OF WILMINGTON                   ,NC,28403-0000,Proprietary  ,2,9,11,32,176,208
02210400,FAYETTEVILLE BEAUTY COLLEGE             ,NC,28303-0000,Proprietary  ,1,6,7,35,135,170
02227800,MITCHELL'S HAIR STYLING ACADEMY         ,NC,27534-0000,Proprietary  ,1,0,1,2,10,12
02227900,MITCHELL'S HAIR STYLING ACADEMY         ,NC,27858-0000,Proprietary  ,0,0,0,11,24,35
02238700,HAIRSTYLING INSTITUTE OF CHARLOTTE      ,NC,28204-0000,Proprietary  ,0,6,6,54,141,195
02280900,ROANOKE BIBLE COLLEGE                   ,NC,27909-0000,Private      ,0,0,0,109,98,207
02286300,CAROLINA BEAUTY COLLEGE                 ,NC,27262-0000,Proprietary  ,11,54,65,160,886,1046
02560600,PINNACLE INSTITUTE OF COSMETOLOGY       ,NC,28115-8020,Proprietary  ,1,1,2,36,56,92
02614201,MILLER-MOTTE BUSINESS COLLEGE           ,NC,28403-0000,Proprietary  ,23,170,193,323,1489,1812
02614205,MILLER - MOTTE TECHNICAL COLLEGE - MILLE,NC,27834-5052,Proprietary  ,7,79,86,7,79,86
03009500,WINSTON-SALEM BARBER SCHOOL             ,NC,27107-0000,Proprietary  ,1,3,4,47,105,152
03064400,COSM INST OF BEAUTY ARTS & SCIENCES     ,NC,27127-7150,Proprietary  ,0,0,0,31,111,142
03089300,HERITAGE BIBLE COLLEGE                  ,NC,28335-0000,Private      ,0,2,2,23,111,134
03104200,CAROLINAS COLLEGE OF HEALTH SCIENCE     ,NC,28232-2861,Public       ,5,19,24,260,601,861
03104201,CHS NURSE ANESTHESIA PROGRAM / UNCC     ,NC,28232-2861,Public       ,0,0,0,305,248,553
03109000,SCHOOL OF COMMUNICATION ARTS            ,NC,27614-7076,Proprietary  ,10,40,50,467,370,837
03361300,MEDICAL ARTS MASSAGE SCHOOL             ,NC,27616-6453,Proprietary  ,2,13,15,34,205,239
03513400,APEX SCHOOL OF THEOLOGY                 ,NC,27703-8024,Private      ,0,1,1,7,246,253
03555300,SOUTHEASTERN INSTITUTE                  ,NC,28217-0000,Proprietary  ,9,47,56,82,372,454
03555400,SOUTHEASTERN SCHOOL OF NEUROMUSCULAR  MA,NC,29406-0000,Proprietary  ,5,21,26,41,168,209
03570300,CAROLINA CHRISTIAN COLLEGE              ,NC,27105-3241,Private      ,0,0,0,6,49,55
03663300,HOOD THEOLOGICAL SEMINARY               ,NC,28144-5768,Private      ,0,1,1,2,225,227
03748500,LA SHE'S BEAUTY ACADEMY                 ,NC,27707-3569,Proprietary  ,2,16,18,28,156,184
03777300,CAROLINA ACAD OF COSMETIC ART & SCI     ,NC,28054-0460,Proprietary  ,5,16,21,89,244,333
03827300,NEW LIFE THEOLOGICAL SEMINARY           ,NC,28205-1648,Private      ,0,11,11,5,94,99
04098300,TECHSKILLS - CHARLOTTE                  ,NC,28217-0000,Proprietary  ,0,15,15,8,91,99
04101300,CAROLINA SCHOOL OF BROADCASTING         ,NC,28214-8085,Proprietary  ,1,3,4,33,123,156
04115700,REGINA'S COLLEGE OF BEAUTY              ,NC,28110-2831,Proprietary  ,2,6,8,16,47,63
04120300,ASHEBORO BEAUTY SCHOOL OF RANDOLPH      ,NC,27203-6406,Proprietary  ,1,3,4,13,40,53
04140700,AVEDA INSTITUTE CHAPEL HILL             ,NC,27516-2559,Proprietary  ,17,12,29,71,62,133
04143500,CHARLOTTE SCHOOL OF LAW                 ,NC,28208-2816,Proprietary  ,0,39,39,0,207,207
04146400,DAOIST TRADITIONS COLLEGE OF CHINESE MED,NC,28801-1060,Proprietary  ,0,10,10,0,10,10
00298800,BISMARCK STATE COLLEGE                  ,ND,58501-1299,Public       ,10,38,48,2007,1498,3505
00298900,DICKINSON STATE UNIVERSITY              ,ND,58601-4896,Public       ,2,8,10,1288,728,2016
00299000,JAMESTOWN COLLEGE                       ,ND,58405-3401,Private      ,0,4,4,953,145,1098
00299100,LAKE REGION STATE COLLEGE               ,ND,58301-1598,Public       ,1,14,15,340,377,717
00299200,UNIVERSITY OF MARY                      ,ND,58504-9652,Private      ,5,34,39,1589,1441,3030
00299300,MAYVILLE STATE UNIVERSITY               ,ND,58257-1299,Public       ,5,8,13,439,213,652
00299400,MINOT STATE UNIVERSITY                  ,ND,58707-0002,Public       ,3,33,36,1506,1503,3009
00299500,MINOT STATE UNIV-BOTTINEAU CAMPUS       ,ND,58318-1159,Public       ,2,6,8,252,256,508
00299600,NORTH DAKOTA STATE CLG OF SCIENCE       ,ND,58076-0002,Public       ,6,19,25,1427,707,2134
00299700,NORTH DAKOTA STATE UNIVERSITY           ,ND,58108-6050,Public       ,24,42,66,8799,2529,11328
00300500,UNIVERSITY OF NORTH DAKOTA              ,ND,58202-8193,Public       ,20,66,86,7356,4059,11415
00300700,WILLISTON STATE COLLEGE                 ,ND,58802-1326,Public       ,0,14,14,265,393,658
00300800,VALLEY CITY STATE UNIVERSITY            ,ND,58072-0000,Public       ,2,13,15,578,273,851
00484600,RASMUSSEN COLLEGE                       ,ND,58103-7196,Proprietary  ,8,44,52,439,1593,2032
00484601,RASMUSSEN COLLEGE - BISMARCK            ,ND,58503-0000,Proprietary  ,6,44,50,116,320,436
00775600,JOSEF'S SCHOOL OF HAIR DESIGN INC       ,ND,58102-4977,Proprietary  ,5,6,11,86,67,153
00935400,MEDCENTER ONE COLLEGE OF NURSING        ,ND,58501-4494,Private      ,0,0,0,61,68,129
01040600,JOSEF'S SCHOOL OF HAIR DESIGN           ,ND,58201-6394,Proprietary  ,2,2,4,50,76,126
01205900,TRINITY BIBLE COLLEGE                   ,ND,58436-7150,Private      ,0,1,1,233,129,362
01229500,R D HAIRSTYLING COLLEGE                 ,ND,58501-4001,Proprietary  ,1,4,5,48,34,82
02188200,SITTING BULL COLLEGE                    ,ND,58538-9721,Public       ,1,9,10,72,379,451
02236500,LITTLE HOOP COMMUNITY COLLEGE           ,ND,58335-0000,Public       ,0,9,9,30,203,233
02242900,UNITED TRIBES TECHNICAL COLLEGE         ,ND,58504-0000,Private      ,1,4,5,184,689,873
02298200,HEADQUARTERS ACADEMY OF HAIR DESIGN     ,ND,58701-0000,Proprietary  ,0,4,4,21,49,70
02301100,TURTLE MTN CMNTY COLG-FIN AID OFC       ,ND,58316-0000,Private      ,3,23,26,213,501,714
02553700,FORT BERTHOLD COMMUNITY COLLEGE         ,ND,58763-0000,Public       ,1,1,2,45,114,159
03087200,MOLER BARBER CLG OF HAIRSTYLING         ,ND,58103-0000,Proprietary  ,0,0,0,4,10,14
04031300,SALON PROFESSIONAL ACADEMY (THE)        ,ND,58103-3337,Proprietary  ,2,5,7,76,53,129
04139400,HAIR ACADEMY (THE)                      ,ND,58501-4929,Proprietary  ,0,2,2,22,25,47
00301005,ANTIOCH UNIV/SEATTLE                    ,WA,98121-0000,Private      ,0,14,14,35,1166,1201
00376900,BELLEVUE COMMUNITY COLLEGE              ,WA,98007-6484,Public       ,25,111,136,2897,4443,7340
00377000,BIG BEND COMMUNITY COLLEGE              ,WA,98837-3299,Public       ,16,37,53,993,1457,2450
00377100,"CENTRAL WASHINGTON UNIV., FIN AID       ",WA,98926-7495,Public       ,42,78,120,8280,3936,12216
00377200,CENTRALIA COLLEGE                       ,WA,98531-4099,Public       ,12,69,81,924,1580,2504
00377300,CLARK COLLEGE                           ,WA,98663-3598,Public       ,47,164,211,3699,6836,10535
00377400,COLUMBIA BASIN COLLEGE                  ,WA,99301-3379,Public       ,18,100,118,2228,3687,5915
00377500,EASTERN WASHINGTON UNIVERSITY           ,WA,99004-2447,Public       ,26,77,103,7854,5594,13448
00377600,EVERETT COMMUNITY COLLEGE               ,WA,98201-1352,Public       ,19,101,120,1760,4448,6208
00377700,HERITAGE UNIVERSITY                     ,WA,98948-9562,Private      ,5,25,30,387,1470,1857
00377800,GONZAGA UNIVERSITY                      ,WA,99258-0083,Private      ,14,77,91,6211,3459,9670
00377900,GRAYS HARBOR COLLEGE                    ,WA,98520-7599,Public       ,2,41,43,686,1442,2128
00378000,GREEN RIVER COMMUNITY COLLEGE           ,WA,98092-3622,Public       ,40,179,219,2194,3830,6024
00378100,HIGHLINE COMMUNITY COLLEGE              ,WA,98198-9800,Public       ,32,160,192,2260,4358,6618
00378200,LOWER COLUMBIA COLLEGE                  ,WA,98632-0310,Public       ,9,54,63,934,2737,3671
00378300,NORTHWEST UNIVERSITY                    ,WA,98083-0000,Private      ,2,10,12,1064,718,1782
00378400,OLYMPIC COLLEGE                         ,WA,98337-1600,Public       ,17,68,85,1458,3752,5210
00378500,PACIFIC LUTHERAN UNIVERSITY             ,WA,98447-0003,Private      ,4,12,16,4035,1449,5484
00378600,PENINSULA COLLEGE                       ,WA,98362-6660,Public       ,9,38,47,520,1447,1967
00378700,SEATTLE CENTRAL COMMUNITY COLLEGE       ,WA,98122-2413,Public       ,36,146,182,2283,5073,7356
00378703,SEATTLE VOCATIONAL INSTITUTE            ,WA,98144-0000,Public       ,13,37,50,91,492,583
00378800,SEATTLE PACIFIC UNIVERSITY              ,WA,98119-1997,Private      ,12,34,46,4292,1725,6017
00379000,SEATTLE UNIVERSITY                      ,WA,98122-1090,Private      ,13,30,43,6392,6001,12393
00379100,SHORELINE COMMUNITY COLLEGE             ,WA,98133-5696,Public       ,11,56,67,1561,3002,4563
00379200,SKAGIT VALLEY COLLEGE                   ,WA,98273-5899,Public       ,11,39,50,1102,2653,3755
00379300,SPOKANE COMMUNITY COLLEGE               ,WA,99207-5399,Public       ,63,280,343,3210,8631,11841
00379400,ST MARTIN'S UNIVERSITY                  ,WA,98503-7500,Private      ,2,2,4,1212,934,2146
00379600,TACOMA COMMUNITY COLLEGE                ,WA,98466-6100,Public       ,23,203,226,2344,6334,8678
00379700,UNIVERSITY OF PUGET SOUND               ,WA,98416-1039,Private      ,7,10,17,4593,906,5499
00379800,UNIVERSITY OF WASHINGTON                ,WA,98195-5880,Public       ,83,139,222,25605,22086,47691
00379900,WALLA WALLA UNIVERSITY                  ,WA,99324-1198,Private      ,11,15,26,1391,677,2068
00380000,WASHINGTON STATE UNIVERSITY             ,WA,99164-1035,Public       ,63,109,172,17509,10269,27778
00380100,WENATCHEE VALLEY COLLEGE                ,WA,98801-1799,Public       ,17,67,84,1239,2452,3691
00380200,WESTERN WASHINGTON UNIVERSITY           ,WA,98225-5946,Public       ,35,35,70,13270,3818,17088
00380300,WHITMAN COLLEGE                         ,WA,99362-2067,Private      ,2,0,2,2626,58,2684
00380400,WHITWORTH UNIVERSITY                    ,WA,99251-0001,Private      ,3,15,18,3468,987,4455
00380500,YAKIMA VALLEY COMMUNITY COLLEGE         ,WA,98907-2520,Public       ,18,85,103,2204,4283,6487
00499900,BELLINGHAM TECHNICAL COLLEGE            ,WA,98225-0000,Public       ,7,37,44,583,1600,2183
00500000,PIERCE COLLEGE                          ,WA,98498-1919,Public       ,22,90,112,2335,5501,7836
00500100,EDMONDS COMMUNITY COLLEGE               ,WA,98036-5999,Public       ,23,76,99,1640,3512,5152
00500600,WALLA WALLA COMMUNITY COLLEGE           ,WA,99362-9267,Public       ,10,74,84,1375,2265,3640
00530600,BATES TECHNICAL COLLEGE                 ,WA,98405-0000,Public       ,13,110,123,568,2494,3062
00530601,BATES TECHNICAL COLLEGE - SOUTH CAMPUS  ,WA,98409-5847,Public       ,3,28,31,5,33,38
00537200,SOUTH PUGET SOUND COMMUNITY COLLEGE     ,WA,98512-6292,Public       ,34,112,146,1738,3500,5238
00537300,LAKE WASHINGTON TECHNICAL COLLEGE       ,WA,98034-8505,Public       ,11,49,60,476,1732,2208
00575200,CLOVER PARK TECHNICAL COLLEGE           ,WA,98499-0000,Public       ,17,96,113,1043,3968,5011
00815500,EVERGREEN STATE COLLEGE (THE)           ,WA,98505-0002,Public       ,7,28,35,3469,3254,6723
00844300,ITT TECHNICAL INSTITUTE                 ,WA,98168-3334,Proprietary  ,22,89,111,568,1535,2103
00907901,EVEREST COLLEGE                         ,WA,98684-6950,Proprietary  ,6,34,40,109,564,673
00938700,PERRY TECHNICAL INSTITUTE               ,WA,98903-1239,Private      ,10,20,30,442,702,1144
00954400,SPOKANE FALLS COMMUNITY COLLEGE         ,WA,99224-5204,Public       ,41,166,207,3343,5446,8789
00970400,NORTH SEATTLE COMMUNITY COLLEGE         ,WA,98103-3599,Public       ,17,141,158,1124,3209,4333
00970600,SOUTH SEATTLE COMMUNITY COLLEGE         ,WA,98106-1499,Public       ,19,89,108,1352,2727,4079
00973900,GLEN DOW ACAD OF HAIR DESIGN            ,WA,99201-0209,Proprietary  ,5,16,21,128,167,295
01036400,WHATCOM COMMUNITY COLLEGE               ,WA,98226-8003,Public       ,16,50,66,1424,1862,3286
01043400,RENTON TECHNICAL COLLEGE                ,WA,98056-0000,Public       ,3,55,58,596,1988,2584
01148100,DIVERS INSTITUTE OF TECHNOLOGY          ,WA,98107-0667,Proprietary  ,11,23,34,125,420,545
01231500,CORNISH COLLEGE OF THE ARTS             ,WA,98121-4604,Private      ,2,1,3,1062,273,1335
01249600,GREENWOOD BEAUTY SCHOOL                 ,WA,98103-0000,Proprietary  ,1,6,7,40,108,148
01302200,CITY UNIVERSITY OF SEATTLE              ,WA,98005-3030,Private      ,1,67,68,118,2559,2677
01309400,BELLINGHAM BEAUTY SCHOOL                ,WA,98225-0000,Proprietary  ,1,3,4,28,54,82
02091701,KAPLAN COLLEGE - SEATTLE                ,WA,98055-4910,Proprietary  ,10,58,68,94,374,468
02105300,BELLEVUE BEAUTY SCHOOL                  ,WA,98007-0000,Proprietary  ,0,5,5,24,43,67
02106700,TRINITY LUTHERAN COLLEGE                ,WA,98201-3569,Private      ,0,0,0,101,47,148
02180000,NORTHWEST INDIAN COLLEGE                ,WA,98226-9278,Public       ,6,19,25,121,567,688
02184200,PAROBA COLLEGE OF COSMETOLOGY           ,WA,98208-0000,Proprietary  ,0,2,2,35,92,127
02202200,STYLEMASTERS COLLEGE OF HAIR DESIGN     ,WA,98632-0000,Proprietary  ,3,7,10,37,89,126
02203300,GENE JUAREZ ACADEMY OF BEAUTY           ,WA,98125-0000,Proprietary  ,34,35,69,414,566,980
02203301,GENE JUAREZ ACADEMY OF BEAUTY           ,WA,98003-0000,Proprietary  ,0,2,2,60,79,139
02222900,INTERNATIONAL AIR & HOSPITALITY ACADEMY ,WA,98661-4835,Proprietary  ,13,22,35,310,264,574
02222906,INTERNATIONAL AIR & HOSPITALITY ACADEMY ,WA,98661-3805,Proprietary  ,0,1,1,0,1,1
02236800,PROFESSIONAL BEAUTY SCHOOL              ,WA,98902-0000,Proprietary  ,12,7,19,66,71,137
02242500,BASTYR UNIVERSITY                       ,WA,98028-0000,Private      ,1,5,6,113,1117,1230
02263107,CAMBRIDGE COLLEGE-BELLEVUE              ,WA,98007-0000,Proprietary  ,0,0,0,5,16,21
02291300,ART INSTITUTE OF SEATTLE                ,WA,98121-1622,Proprietary  ,21,24,45,2158,1684,3842
02300100,EVEREST COLLEGE                         ,WA,98367-1835,Proprietary  ,11,48,59,122,477,599
02300103,EVEREST COLLEGE - EVERETT               ,WA,98208-2610,Proprietary  ,9,70,79,187,653,840
02300104,EVEREST COLLEGE - TACOMA                ,WA,98402-3004,Proprietary  ,13,106,119,156,848,1004
02326500,INTERFACE COLLEGE                       ,WA,99201-3209,Proprietary  ,2,31,33,17,307,324
02331400,NORTHWEST HAIR ACADEMY                  ,WA,98273-0000,Proprietary  ,5,14,19,106,154,260
02331402,NORTHWEST HAIR ACADEMY - EVERETT        ,WA,98204-0000,Proprietary  ,1,2,3,22,22,44
02345100,PHAGAN'S ORCHARDS BEAUTY SCHOOL         ,WA,98662-0000,Proprietary  ,0,0,0,6,19,25
02504900,ACADEMY OF HAIR DESIGN (THE)            ,WA,98801-0000,Proprietary  ,0,3,3,31,59,90
02541900,BJ'S BEAUTY AND BARBER COLLEGE          ,WA,98409-0000,Proprietary  ,2,10,12,35,148,183
02602100,NORTHWEST COLLEGE OF ART                ,WA,98370-8625,Proprietary  ,1,0,1,126,29,155
02606200,EVEREST COLLEGE                         ,WA,98055-2990,Proprietary  ,29,90,119,220,800,1020
02617500,EVEREST COLLEGE                         ,WA,98133-9018,Proprietary  ,8,21,29,95,231,326
02617501,EVEREST COLLEGE - FIFE                  ,WA,98424-2647,Proprietary  ,8,31,39,125,369,494
02617503,EVEREST COLLEGE - VANCOUVER             ,WA,98684-6951,Proprietary  ,3,15,18,107,321,428
02617505,ASHMEAD COLLEGE - NEW EVERETT CAMPUS    ,WA,98201-4022,Proprietary  ,0,0,0,2,6,8
03031406,INTERNATIONAL ACADEMY OF DESIGN AND TECH,WA,98188-3319,Proprietary  ,5,5,10,267,306,573
03065000,CLARE'S BEAUTY COLLEGE                  ,WA,99301-5505,Proprietary  ,2,10,12,23,71,94
03071800,ITT TECHNICAL INSTITUTE                 ,WA,99216-1589,Proprietary  ,46,176,222,588,1718,2306
03099000,CORTIVA INSTITUTE - SEATTLE             ,WA,98109-5474,Proprietary  ,5,16,21,116,303,419
03110800,BAKKE GRADUATE UNIVERSITY               ,WA,98104-1222,Private      ,0,2,2,0,2,2
03139500,MONTESSORI SCHOOLS OF WASHINGTON        ,WA,98203-6600,Private      ,0,0,0,0,1,1
03280300,SEATTLE INST OF ORIENTAL MEDICINE       ,WA,98115-0000,Proprietary  ,0,0,0,4,53,57
03283300,NORTHWEST HVAC/R ASSOCIATION & TRAINING ,WA,99202-2125,Private      ,1,1,2,7,55,62
03361600,SEATTLE MIDWIFERY SCHOOL                ,WA,98144-0000,Private      ,0,1,1,6,57,63
03466400,MARS HILL GRADUATE SCHOOL               ,WA,98121-0000,Private      ,0,1,1,2,260,262
03483500,CASCADIA COMMUNITY COLLEGE              ,WA,98011-9510,Public       ,7,8,15,661,885,1546
03490400,EMIL FRIES PIANO HOSPITAL & TRAININ     ,WA,98661-4323,Private      ,0,0,0,3,11,14
03631500,CORTIVA INSTITUTE - BRIAN UTTING SCHOOL ,WA,98109-5211,Proprietary  ,0,0,0,9,13,22
03689400,FAITH EVANGELICAL SEMINARY              ,WA,98407-2607,Private      ,0,8,8,5,198,203
03707500,CHETTA'S ACADEMY OF HAIR AND NAILS      ,WA,98362-4310,Proprietary  ,2,4,6,11,23,34
03724300,DIGIPEN INSTITUTE OF TECHNOLOGY         ,WA,98052-5170,Proprietary  ,1,2,3,660,241,901
03917300,EVERGREEN BEAUTY AND BARBER COLLEGE     ,WA,98208-3759,Proprietary  ,4,12,16,66,173,239
03932500,TOTAL COSMETOLOGY TRAINING CENTER       ,WA,99217-6231,Proprietary  ,1,6,7,36,124,160
03953300,YAKIMA BEAUTY SCHOOL;BEAUTYWORKS        ,WA,98901-2202,Proprietary  ,0,0,0,31,52,83
04043400,ALPINE COLLEGE                          ,WA,99206-5097,Proprietary  ,1,22,23,26,197,223
04120000,SUNNYSIDE BEAUTY ACADEMY                ,WA,98944-8711,Proprietary  ,0,2,2,11,16,27
04127200,VICTORIA'S ACADEMY OF COSMETOLOGY       ,WA,99336-3826,Proprietary  ,3,11,14,47,100,147
04130500,PACIFIC NORTHWEST UNIV OF HEALTH SCIENCE,WA,98901-1471,Private      ,0,1,1,0,4,4
04130800,CASCADE BEAUTY COLLEGE                  ,WA,98002-5504,Proprietary  ,0,0,0,15,30,45
04132800,INLAND MASSAGE INSTITUTE                ,WA,99208-5923,Proprietary  ,0,0,0,9,39,48
00340100,BROWN UNIVERSITY                        ,RI,02912-9127,Private      ,1,3,4,13122,329,13451
00340101,BROWN UNIVERSITY - GRADUATE SCHOOL      ,RI,02912-1827,Private      ,0,7,7,46,1393,1439
00340102,BROWN MEDICAL SCHOOL                    ,RI,02912-0000,Private      ,0,0,0,24,412,436
00340200,BRYANT UNIVERSITY                       ,RI,02917-1284,Private      ,5,4,9,5890,354,6244
00340400,JOHNSON & WALES UNIVERSITY              ,RI,02903-3703,Private      ,37,25,62,18132,3523,21655
00340600,PROVIDENCE COLLEGE                      ,RI,02918-0001,Private      ,5,2,7,7368,520,7888
00340700,RHODE ISLAND COLLEGE                    ,RI,02908-1991,Public       ,4,11,15,6788,3042,9830
00340800,COMMUNITY COLLEGE OF RI - WARWICK       ,RI,02906-0000,Public       ,13,30,43,4252,5033,9285
00340801,COMMUNITY COLLEGE OF RI - LINCOLN       ,RI,02865-4585,Public       ,4,11,15,1664,1865,3529
00340802,COMMUNITY COLLEGE OF RI- PROVIDENCE     ,RI,02905-2313,Public       ,3,8,11,1407,1975,3382
00340900,RHODE ISLAND SCHOOL OF DESIGN           ,RI,02903-2784,Private      ,2,3,5,2713,1156,3869
00341000,ROGER WILLIAMS UNIVERSITY               ,RI,02809-2921,Private      ,3,6,9,7395,1376,8771
00341100,SALVE REGINA UNIVERSITY                 ,RI,02840-4192,Private      ,3,4,7,4780,335,5115
00341400,UNIVERSITY OF RHODE ISLAND              ,RI,02881-0000,Public       ,21,22,43,17377,3415,20792
00659100,ST. JOSEPH HOSP SCH OF NURSING          ,RI,02904-5199,Private      ,0,0,0,42,142,184
00784400,GIBBS COLLEGE                           ,RI,02920-7807,Proprietary  ,0,2,2,245,388,633
00784500,NEW ENGLAND INSTITUTE OF TECHNOLOGY     ,RI,02886-2266,Private      ,13,16,29,2711,2121,4832
01115900,"SAWYER SCHOOL,THE                       ",RI,02860-4117,Proprietary  ,38,168,206,370,1657,2027
02071900,ARTHUR ANGELO SCH COSMET&HAIR DSGN      ,RI,02903-0000,Proprietary  ,4,15,19,129,238,367
02176900,WARWICK ACADEMY OF BEAUTY CULTURE       ,RI,02886-1534,Proprietary  ,1,10,11,93,169,262
02584400,NEW ENGLAND TRACTOR TRAILER TRAINING SCH,RI,02860-1752,Proprietary  ,13,119,132,102,909,1011
03080000,NEWPORT SCHOOL OF HAIRDRESSING          ,RI,02860-4038,Proprietary  ,0,5,5,19,92,111
03115200,MOTORING TECHNICAL TRAINING INST        ,RI,02914-5022,Proprietary  ,9,20,29,161,269,430
03232300,LINCOLN TECHNICAL INSTITUTE             ,RI,02865-4211,Proprietary  ,24,92,116,520,1020,1540
03570500,ZION BIBLE COLLEGE                      ,RI,02806-1246,Private      ,0,2,2,143,109,252
03732300,INTERNATIONAL YACHT RESTORATION SCH     ,RI,02840-6720,Private      ,0,0,0,9,22,31
00341700,ALLEN UNIVERSITY                        ,SC,29204-1085,Private      ,6,5,11,1033,447,1480
00341800,ANDERSON UNIVERSITY                     ,SC,29621-4035,Private      ,1,13,14,1731,722,2453
00341900,CHARLESTON SOUTHERN UNIVERSITY          ,SC,29406-2160,Private      ,19,27,46,3514,1759,5273
00342000,BENEDICT COLLEGE                        ,SC,29204-1086,Private      ,15,12,27,3852,1314,5166
00342100,BOB JONES UNIVERSITY                    ,SC,29614-1000,Proprietary  ,17,7,24,3010,332,3342
00342200,SOUTHERN WESLEYAN UNIVERSITY            ,SC,29630-1020,Private      ,3,98,101,933,2556,3489
00342300,THE CITADEL                             ,SC,29409-0002,Public       ,9,27,36,2132,916,3048
00342400,CLAFLIN UNIVERSITY                      ,SC,29115-4498,Private      ,10,8,18,2489,993,3482
00342500,CLEMSON UNIVERSITY                      ,SC,29634-0001,Public       ,38,55,93,13894,3039,16933
00342600,UNIV OF SC AT SUMTER                    ,SC,29150-2498,Public       ,4,7,11,741,594,1335
00342700,COKER COLLEGE                           ,SC,29550-3797,Private      ,1,15,16,937,987,1924
00342800,COLLEGE OF CHARLESTON                   ,SC,29424-0100,Public       ,21,18,39,8434,2124,10558
00342900,COLUMBIA INTERNATIONAL UNIVERSITY       ,SC,29203-1599,Private      ,1,6,7,511,660,1171
00343000,COLUMBIA COLLEGE                        ,SC,29203-5998,Private      ,7,48,55,1360,1188,2548
00343100,CONVERSE COLLEGE                        ,SC,29302-0006,Private      ,1,9,10,748,658,1406
00343200,ERSKINE COLLEGE                         ,SC,29639-0000,Private      ,2,1,3,748,40,788
00343201,ERSKINE THEOLOGICAL SEMINARY            ,SC,29639-0000,Private      ,0,2,2,7,166,173
00343400,FURMAN UNIVERSITY                       ,SC,29613-5253,Private      ,5,8,13,3123,342,3465
00343500,LANDER UNIVERSITY                       ,SC,29649-2099,Public       ,10,11,21,2683,825,3508
00343600,LIMESTONE COLLEGE                       ,SC,29340-3799,Private      ,6,60,66,1088,3141,4229
00343700,LUTHERAN THEOLOGICAL SOUTHERN SEM       ,SC,29203-5898,Private      ,0,0,0,0,134,134
00343800,MEDICAL UNIV OF SOUTH CAROLINA - FA     ,SC,29425-1760,Public       ,1,17,18,232,2745,2977
00343900,MORRIS COLLEGE                          ,SC,29150-3599,Private      ,5,7,12,1450,519,1969
00344000,NEWBERRY COLLEGE                        ,SC,29108-2197,Private      ,3,13,16,1553,194,1747
00344100,NORTH GREENVILLE COLLEGE                ,SC,29688-1892,Private      ,2,1,3,2105,316,2421
00344500,PRESBYTERIAN COLLEGE                    ,SC,29325-2503,Private      ,1,1,2,1412,28,1440
00344600,SOUTH CAROLINA STATE UNIVERSITY         ,SC,29117-4427,Public       ,98,48,146,7189,2784,9973
00344700,SPARTANBURG METHODIST COLLEGE           ,SC,29301-5899,Private      ,7,3,10,1165,141,1306
00344800,UNIVERSITY OF SOUTH CAROLINA            ,SC,29208-3999,Public       ,75,169,244,18050,10715,28765
00344900,UNIVERSITY OF SOUTH CAROLINA AIKEN      ,SC,29801-6399,Public       ,11,19,30,2760,1252,4012
00345000,UNIV OF SC AT BEAUFORT                  ,SC,29902-4602,Public       ,4,19,23,977,869,1846
00345100,COASTAL CAROLINA UNIVERSITY             ,SC,29528-0000,Public       ,29,41,70,9071,1916,10987
00345300,UNIV OF SC AT LANCASTER                 ,SC,29721-0889,Public       ,10,12,22,818,654,1472
00345400,UNIV OF SC SYSTEM SALKEHATCHIE          ,SC,29810-0617,Public       ,7,14,21,508,538,1046
00345500,VOORHEES COLLEGE                        ,SC,29042-0000,Private      ,11,4,15,662,398,1060
00345600,WINTHROP UNIVERSITY                     ,SC,29733-0001,Public       ,12,44,56,5576,2054,7630
00345700,WOFFORD COLLEGE                         ,SC,29303-3663,Private      ,3,0,3,1628,93,1721
00399000,FLORENCE-DARLINGTON TECH COLLEGE        ,SC,29501-0548,Public       ,47,168,215,2663,4562,7225
00399100,GREENVILLE TECHNICAL COLLEGE            ,SC,29607-2439,Public       ,113,484,597,7267,12423,19690
00399200,PIEDMONT TECHNICAL COLLEGE              ,SC,29648-1467,Public       ,58,252,310,2201,5037,7238
00399300,MIDLANDS TECHNICAL COLLEGE              ,SC,29202-0000,Public       ,111,426,537,6730,10932,17662
00399400,SPARTANBURG COMMUNITY COLLEGE           ,SC,29305-4386,Public       ,60,193,253,2856,4760,7616
00399500,CENTRAL CAROLINA TECHNICAL COLLEGE      ,SC,29150-2499,Public       ,30,174,204,1337,3779,5116
00399600,YORK TECHNICAL COLLEGE                  ,SC,29730-3395,Public       ,50,267,317,2558,5434,7992
00492000,TRIDENT TECHNICAL COLLEGE               ,SC,29423-8067,Public       ,120,446,566,6401,10753,17154
00492300,CLINTON JR COLLEGE                      ,SC,29730-5152,Private      ,0,1,1,115,46,161
00492400,FORREST JUNIOR COLLEGE                  ,SC,29624-2405,Proprietary  ,0,7,7,30,188,218
00492500,HORRY-GEORGETOWN TECH COLLEGE           ,SC,29526-9521,Public       ,53,231,284,2993,5686,8679
00492600,TRI-COUNTY TECHNICAL COLLEGE            ,SC,29670-9133,Public       ,42,181,223,3184,4007,7191
00492700,UNIV OF SC AT UNION                     ,SC,29379-0729,Public       ,1,4,5,237,210,447
00536300,DENMARK TECHNICAL COLLEGE               ,SC,29042-0000,Public       ,16,42,58,927,982,1909
00681500,ORANGEBURG-CALHOUN TECHNICAL COLG       ,SC,29118-8299,Public       ,34,123,157,1373,2572,3945
00695100,UNIVERSITY OF SOUTH CAROLINA UPSTATE    ,SC,29303-9972,Public       ,18,30,48,4445,2486,6931
00760200,NORTHEASTERN TECHNICAL COLLEGE          ,SC,29520-7015,Public       ,25,67,92,540,1217,1757
00922600,FRANCIS MARION UNIVERSITY               ,SC,29501-0000,Public       ,17,28,45,4044,1503,5547
00932200,WILLIAMSBURG TECHNICAL COLLEGE          ,SC,29556-4197,Public       ,30,49,79,364,787,1151
00991000,TECHNICAL COLLEGE OF THE LOWCOUNTRY     ,SC,29902-5441,Public       ,21,134,155,864,2382,3246
00991100,UNIV OF SC-REGIONAL CAMPUSES ADMIN      ,SC,29208-0001,Public       ,0,4,4,154,99,253
01005600,AIKEN TECHNICAL COLLEGE                 ,SC,29802-0696,Public       ,30,125,155,1758,3423,5181
01209200,KENNETH SHULER SCHOOL OF COSMETOLOGY    ,SC,29730-3552,Proprietary  ,2,10,12,20,95,115
01303907,SOUTH UNIVERSITY                        ,SC,29203-6400,Proprietary  ,10,86,96,365,1993,2358
02063700,SHERMAN CLG STRAIGHT CHIROPRACTIC       ,SC,29316-0000,Private      ,0,2,2,10,295,305
02189800,NO AMER INST OF AVIATION OF SO CAR      ,SC,29527-0000,Proprietary  ,0,0,0,4,8,12
02329600,BETTY STEVENS COSMETOLOGY INSTITUTE     ,SC,29501-0000,Proprietary  ,0,0,0,1,0,1
02338600,CHARZANNE BEAUTY COLLEGE                ,SC,29649-0000,Proprietary  ,0,3,3,22,96,118
02341100,KENNETH SHULER SCHOOL OF COSMETOLOGY & N,SC,29210-0000,Proprietary  ,6,49,55,199,678,877
02356600,CHARLESTON COSMETOLOGY INSTITUTE        ,SC,29420-0000,Proprietary  ,4,9,13,74,136,210
02552400,ACADEMY OF HAIR TECHNOLOGY              ,SC,29615-2363,Proprietary  ,2,8,10,64,139,203
02567600,SUMTER BEAUTY COLLEGE                   ,SC,29150-0000,Proprietary  ,0,5,5,36,115,151
02614202,MILLER-MOTTE TECHNICAL COLLEGE          ,SC,29406-0000,Proprietary  ,21,104,125,363,1259,1622
03010614,VIRGINIA COLLEGE - GOLF ACADEMY OF AMERI,SC,29579-0000,Proprietary  ,7,10,17,231,273,504
03052300,KENNETH SHULER SCH COSM & HAIR DESG     ,SC,29841-2013,Proprietary  ,3,8,11,52,160,212
03088300,ACADEMY OF COSMETOLOGY                  ,SC,29418-5667,Proprietary  ,3,14,17,50,135,185
03258300,SOUTHERN METHODIST COLLEGE              ,SC,29116-1027,Private      ,0,0,0,8,24,32
03293300,STRAND COLLEGE OF HAIR DESIGN           ,SC,29572-4310,Proprietary  ,0,6,6,26,97,123
03304300,CENTURA COLLEGE                         ,SC,29406-9235,Proprietary  ,14,70,84,120,688,808
03513300,LACY COSMETOLOGY SCHOOL                 ,SC,29803-9084,Proprietary  ,4,4,8,21,72,93
03513301,LACY COSMETOLOGY SCHOOL -               ,SC,29072-0000,Proprietary  ,2,4,6,12,65,77
03513302,LACY COSMETOLOGY SCHOOL -               ,SC,29445-0000,Proprietary  ,1,6,7,12,51,63
03595300,CHARLESTON SCHOOL OF MASSAGE            ,SC,29412-8270,Proprietary  ,0,1,1,6,40,46
03746300,LEGRAND INSTITUTE OF COSMETOLOGY        ,SC,29020-0000,Proprietary  ,1,1,2,22,50,72
03746400,SOUTHEASTERN INSTITUTE                  ,SC,29210-0000,Proprietary  ,5,24,29,90,277,367
03768400,STYLETRENDS BARBER AND HAIRSTYLING ACADE,SC,29730-4511,Proprietary  ,0,6,6,7,63,70
03856400,W. L. BONNER COLLEGE                    ,SC,29203-0000,Private      ,0,0,0,6,76,82
03892300,HARLEY'S BEAUTY & BARBER CAREER INST.   ,SC,29204-1919,Proprietary  ,0,5,5,13,74,87
04096300,CHARLESTON SCHOOL OF LAW                ,SC,29402-0535,Proprietary  ,0,4,4,11,976,987
00345800,AUGUSTANA COLLEGE                       ,SD,57197-0001,Private      ,0,3,3,1704,207,1911
00345900,BLACK HILLS STATE UNIVERSITY            ,SD,57799-9670,Public       ,4,20,24,2111,1569,3680
00346100,DAKOTA WESLEYAN UNIVERSITY              ,SD,57301-4398,Private      ,1,4,5,612,305,917
00346300,DAKOTA STATE UNIVERSITY                 ,SD,57042-1799,Public       ,1,6,7,1172,610,1782
00346500,MOUNT MARTY COLLEGE                     ,SD,57078-3724,Private      ,1,7,8,557,496,1053
00346600,NORTHERN STATE UNIVERSITY               ,SD,57401-7198,Public       ,2,3,5,1504,651,2155
00346700,PRESENTATION COLLEGE                    ,SD,57401-1299,Private      ,5,9,14,371,556,927
00346900,UNIVERSITY OF SIOUX FALLS               ,SD,57105-1699,Private      ,2,5,7,1344,466,1810
00347000,SOUTH DAKOTA SCH OF MINES & TECH        ,SD,57701-3995,Public       ,0,3,3,1315,525,1840
00347100,SOUTH DAKOTA STATE UNIVERSITY           ,SD,57007-2298,Public       ,13,17,30,7638,2862,10500
00347400,UNIVERSITY OF SOUTH DAKOTA              ,SD,57069-2390,Public       ,7,32,39,4537,4069,8606
00405600,SIOUX FALLS SEMINARY                    ,SD,57105-0000,Private      ,0,0,0,1,95,96
00405700,NATIONAL AMERICAN UNIVERSITY            ,SD,57701-3692,Proprietary  ,27,253,280,680,6415,7095
00405707,NATIONAL AMERICAN UNIVERSITY            ,SD,57105-0000,Proprietary  ,1,2,3,59,290,349
00492900,MCKENNAN HOSP-RADOLOGICAL TECH          ,SD,57101-0000,Private      ,0,1,1,19,9,28
00530900,LAKE AREA TECHNICAL INSTITUTE           ,SD,57201-2869,Public       ,6,6,12,772,414,1186
00598700,AVERA SACRED HEART HOSPITAL SCHOOL OF RA,SD,57078-3899,Private      ,0,0,0,8,3,11
00776400,SOUTHEAST TECHNICAL INST                ,SD,57107-0000,Public       ,8,31,39,1390,1108,2498
00828400,MITCHELL TECHNICAL INSTITUTE            ,SD,57301-2002,Public       ,0,0,0,498,261,759
01013800,STEWART SCHOOL                          ,SD,57104-0000,Proprietary  ,3,4,7,100,63,163
01014804,COLORADO TECHNICAL UNIVERSITY           ,SD,57108-2272,Proprietary  ,7,33,40,324,1149,1473
01017000,WESTERN DAKOTA TECHNICAL INSTITUTE      ,SD,57701-4018,Public       ,3,33,36,476,896,1372
01147701,SIOUX VALLEY HOSP-MEDICAL TECH          ,SD,57117-5039,Private      ,0,0,0,17,12,29
01465900,OGLALA LAKOTA COLLEGE                   ,SD,57752-0490,Public       ,1,11,12,310,1436,1746
02137100,BLACK HILLS BEAUTY COLLEGE              ,SD,57701-0000,Proprietary  ,0,0,0,65,68,133
02143700,SINTE GLESKA UNIVERSITY                 ,SD,57570-0000,Public       ,3,18,21,153,722,875
02144600,KILIAN COMMUNITY COLLEGE                ,SD,57103-7020,Private      ,0,5,5,97,403,500
02277300,SISSETON WAHPETON COLLEGE               ,SD,57262-0000,Public       ,1,4,5,47,200,247
02297800,HEADLINES ACADEMY                       ,SD,57701-0000,Proprietary  ,1,10,11,39,99,138
00347700,AQUINAS COLLEGE                         ,TN,37205-2086,Private      ,1,8,9,262,736,998
00347701,AQUINAS COLLEGE -  PRIMETIME PROGRAM    ,TN,37214-3644,Private      ,0,24,24,12,331,343
00347800,AUSTIN PEAY STATE UNIVERSITY            ,TN,37044-0002,Public       ,22,153,175,6214,6772,12986
00347900,BELMONT UNIVERSITY                      ,TN,37212-3757,Private      ,10,47,57,4820,2253,7073
00348000,BETHEL COLLEGE                          ,TN,38201-1705,Private      ,3,117,120,1223,2975,4198
00348100,CARSON-NEWMAN COLLEGE                   ,TN,37760-2204,Private      ,4,3,7,2838,572,3410
00348200,CHRISTIAN BROTHERS UNIVERSITY           ,TN,38104-5581,Private      ,4,31,35,2003,1468,3471
00348300,COLUMBIA STATE COMMUNITY COLLEGE        ,TN,38401-5653,Public       ,16,99,115,2455,2803,5258
00348500,CUMBERLAND UNIVERSITY                   ,TN,37087-3554,Private      ,5,16,21,1313,806,2119
00348600,LIPSCOMB UNIVERSITY                     ,TN,37204-3951,Private      ,5,40,45,2745,1265,4010
00348700,EAST TENNESSEE STATE UNIV - MAIN CAMPUS ,TN,37614-2857,Public       ,32,124,156,9688,6383,16071
00348701,EAST TENNESSEE STATE UNIV - MEDICINE    ,TN,37614-1708,Public       ,0,1,1,143,367,510
00348709,EAST TENNESSEE STATE UNIV - PHARMACY    ,TN,37614-1704,Public       ,0,1,1,88,277,365
00349000,FISK UNIVERSITY                         ,TN,37208-3045,Private      ,4,3,7,1470,352,1822
00349200,FREED-HARDEMAN UNIVERSITY               ,TN,38340-2399,Private      ,1,17,18,1716,910,2626
00349400,HIWASSEE COLLEGE                        ,TN,37354-4001,Private      ,0,0,0,309,68,377
00349500,JOHNSON BIBLE COLLEGE                   ,TN,37998-9775,Private      ,3,0,3,566,292,858
00349600,KING COLLEGE                            ,TN,37620-2699,Private      ,1,15,16,1168,977,2145
00349800,LAMBUTH UNIVERSITY                      ,TN,38301-5296,Private      ,0,3,3,1236,345,1581
00349900,LANE COLLEGE                            ,TN,38301-4598,Private      ,10,11,21,2979,1000,3979
00350000,LEE UNIVERSITY                          ,TN,37320-0000,Private      ,8,34,42,3376,1190,4566
00350100,LEMOYNE-OWEN COLLEGE                    ,TN,38126-6510,Private      ,3,12,15,792,1034,1826
00350200,LINCOLN MEMORIAL UNIVERSITY             ,TN,37752-7920,Private      ,3,84,87,1364,2878,4242
00350400,MARTIN METHODIST COLLEGE                ,TN,38478-2799,Private      ,3,4,7,858,425,1283
00350500,MARYVILLE COLLEGE                       ,TN,37804-5907,Private      ,2,1,3,1837,195,2032
00350600,MEHARRY MEDICAL COLLEGE                 ,TN,37208-0000,Private      ,2,4,6,41,1199,1240
00350700,MEMPHIS COLLEGE OF ART                  ,TN,38104-2764,Private      ,3,2,5,558,202,760
00350900,UNIVERSITY OF MEMPHIS (THE)             ,TN,38152-4611,Public       ,59,223,282,14269,14818,29087
00351000,MIDDLE TENNESSEE STATE UNIV             ,TN,37130-0000,Public       ,57,214,271,20019,9934,29953
00351100,MILLIGAN COLLEGE                        ,TN,37682-4001,Private      ,0,11,11,1003,492,1495
00351700,SOUTHERN COLLEGE OF OPTOMETRY           ,TN,38104-2222,Private      ,0,1,1,16,580,596
00351800,SOUTHERN ADVENTIST UNIVERSITY           ,TN,37315-0370,Private      ,11,2,13,2175,618,2793
00351900,RHODES COLLEGE                          ,TN,38112-1690,Private      ,1,4,5,2382,230,2612
00352200,TENNESSEE STATE UNIVERSITY              ,TN,37209-1561,Public       ,40,138,178,10205,7386,17591
00352201,TENNESSEE STATE UNIVERSITY - AVON WILLIA,TN,37203-3401,Public       ,4,12,16,98,319,417
00352300,TENNESSEE TECHNOLOGICAL UNIV            ,TN,38505-0001,Public       ,18,101,119,8046,3671,11717
00352400,TENNESSEE TEMPLE UNIVERSITY             ,TN,37404-3587,Private      ,1,10,11,521,381,902
00352500,TENNESSEE WESLEYAN COLLEGE              ,TN,37371-0040,Private      ,2,17,19,1031,467,1498
00352600,TREVECCA NAZARENE UNIVERSITY            ,TN,37210-2877,Private      ,2,37,39,1151,1991,3142
00352700,TUSCULUM COLLEGE                        ,TN,37743-0001,Private      ,4,35,39,1850,2039,3889
00352800,UNION UNIVERSITY                        ,TN,38305-3697,Private      ,2,91,93,2293,2346,4639
00352900,UNIVERSITY OF TENNESSEE-CHATTANOOGA     ,TN,37403-2598,Public       ,24,61,85,10049,3753,13802
00353000,UNIVERSITY OF TENNESSEE-KNOXVILLE       ,TN,37996-0150,Public       ,59,115,174,24511,8743,33254
00353006,UNIVERSITY OF TENNESSEE-HEALTH SCI CTR  ,TN,38103-0000,Public       ,2,30,32,333,2989,3322
00353100,UNIVERSITY OF TENNESSEE-MARTIN          ,TN,38238-0002,Public       ,18,56,74,6900,2956,9856
00353400,UNIVERSITY OF THE SOUTH                 ,TN,37383-1000,Private      ,2,11,13,1595,88,1683
00353500,VANDERBILT UNIVERSITY                   ,TN,37240-0001,Private      ,9,29,38,10744,5410,16154
00353501,VANDERBILT UNIV MED CTR ALLIEDHEAL      ,TN,37232-5510,Private      ,1,0,1,37,197,234
00353502,VANDERBILT UNIV - SCH OF MED            ,TN,37232-0000,Private      ,0,1,1,76,876,952
00353600,BRYAN COLLEGE                           ,TN,37321-7000,Private      ,0,16,16,1002,520,1522
00399800,CHATTANOOGA STATE TECH CMTY CLG         ,TN,37406-1097,Public       ,46,283,329,4329,7015,11344
00399900,CLEVELAND STATE COMMUNITY COLLEGE       ,TN,37312-2858,Public       ,11,88,99,1493,2207,3700
00402500,TN TECHNOLOGY CTR AT KNOXVILLE          ,TN,37919-2327,Public       ,12,43,55,418,1229,1647
00402600,TENNESSEE TECH. CNTR AT CROSSVILLE      ,TN,38555-4142,Public       ,13,18,31,249,560,809
00461700,NATIONAL COLLEGE OF BUSINESS & TECH     ,TN,37211-6605,Proprietary  ,12,83,95,357,2459,2816
00493400,DRAUGHONS JR CLG OF BUSINESS            ,TN,37217-1056,Proprietary  ,32,196,228,582,3178,3760
00493700,JACKSON STATE COMMUNITY COLLEGE         ,TN,38301-3797,Public       ,17,83,100,2531,3340,5871
00493800,SOUTH COLLEGE                           ,TN,37909-3323,Proprietary  ,8,106,114,400,1886,2286
00494700,WEST TENNESSEE BUSINESS COLLEGE         ,TN,38301-3256,Proprietary  ,3,29,32,124,647,771
00528000,TN TECHNOLOGY CTR AT COVINGTON          ,TN,38019-0249,Public       ,5,5,10,138,354,492
00528100,TN TECHNOLOGY CTR AT ELIZABETHTON       ,TN,37643-0789,Public       ,9,56,65,262,944,1206
00528200,TN TECHNOLOGY CTR AT HARTSVILLE         ,TN,37074-0000,Public       ,1,8,9,172,359,531
00528300,TN TECHNOLOGY CTR AT NEWBERN            ,TN,38059-1198,Public       ,3,19,22,129,449,578
00530700,TN TECHNOLOGY CTR AT MCMINNVILLE        ,TN,37110-1322,Public       ,0,8,8,145,378,523
00535100,TENNESSEE TECHNOLOGY CENTER AT MORRISTOW,TN,37813-2094,Public       ,2,16,18,420,1055,1475
00535200,TN TECHNOLOGY CENTER AT MCKENZIE        ,TN,38201-1620,Public       ,2,5,7,166,420,586
00535300,TN TECHNOLOGY CENTER AT LIVINGSTON      ,TN,38570-0219,Public       ,5,13,18,233,476,709
00535400,TN TECHNOLOGY CTR AT JACKSON            ,TN,38301-0000,Public       ,3,20,23,415,1004,1419
00535600,TENNESSEE TECHNOLOGY CENTER AT HOHENWALD,TN,38462-0000,Public       ,25,40,65,266,542,808
00535700,TENNESSEE TECHNOLOGY CENTER AT CRUMP    ,TN,38327-3402,Public       ,1,3,4,198,438,636
00535800,TN TECHNOLOGY CENTER AT ATHENS          ,TN,37371-0848,Public       ,1,9,10,205,434,639
00535900,TENNESSEE TECHNOLOGY CENTER AT NASHVILLE,TN,37209-0000,Public       ,7,88,95,431,1338,1769
00536000,TENNESSEE TECHNOLOGY CENTER AT MEMPHIS  ,TN,38105-3604,Public       ,13,49,62,810,2027,2837
00537800,NORTHEAST STATE TECH CMNTY COLG         ,TN,37617-0246,Public       ,20,142,162,2743,3807,6550
00537900,TN TECHNOLOGY CTR AT SHELBYVILLE        ,TN,37160-3697,Public       ,1,14,15,374,775,1149
00683500,DYERSBURG STATE COMMUNITY COLLEGE       ,TN,38024-0000,Public       ,9,63,72,1412,2203,3615
00683600,MOTLOW STATE COMMUNITY COLLEGE          ,TN,37388-7972,Public       ,21,86,107,2398,2716,5114
00743900,FOUNTAINHEAD COLLEGE OF TECHNOLOGY      ,TN,37918-2583,Proprietary  ,2,7,9,93,274,367
00744000,NASHVILLE AUTO DIESEL COLLEGE           ,TN,37206-3298,Proprietary  ,57,63,120,2814,1023,3837
00778200,TENNESSEE TECHNOLOGY CENTER AT DICKSON  ,TN,37055-0000,Public       ,2,16,18,309,812,1121
00778300,MIDDLE TENNESSEE SCH OF ANESTHESIA      ,TN,37116-0417,Private      ,0,1,1,16,156,172
00814500,NASHVILLE STATE TECH CMNTY COLLEGE      ,TN,37209-0000,Public       ,53,233,286,2736,5596,8332
00865500,GENESIS CAREER COLLEGE OF COOKEVILLE    ,TN,38501-1959,Proprietary  ,6,9,15,45,167,212
00885900,JOHN A GUPTON COLLEGE                   ,TN,37203-2934,Private      ,0,3,3,71,140,211
00886300,WALTERS STATE COMMUNITY COLLEGE         ,TN,37813-6899,Public       ,26,118,144,3481,3956,7437
00946400,TN TECHNOLOGY CTR AT PULASKI            ,TN,38478-4541,Public       ,4,28,32,156,391,547
00956700,TENNESSEE SCHOOL OF BEAUTY              ,TN,37921-3303,Proprietary  ,7,16,23,124,312,436
00971000,TENNESSEE TECHNOLOGY CENTER AT ONEIDA/HU,TN,37756-4149,Public       ,1,2,3,76,294,370
00991200,VOLUNTEER STATE COMMUNITY COLLEGE       ,TN,37066-3188,Public       ,36,164,200,3205,4152,7357
00991400,ROANE STATE COMMUNITY COLLEGE           ,TN,37748-8664,Public       ,22,98,120,3017,3630,6647
00998200,CRICHTON COLLEGE                        ,TN,38111-4745,Private      ,2,18,20,583,1535,2118
01021700,INTERNATIONAL ACADEMY OF DESIGN & TECH  ,TN,37212-0000,Proprietary  ,14,25,39,556,726,1282
01032600,TN TECHNOLOGY CTR AT HARRIMAN           ,TN,37748-1109,Public       ,19,27,46,179,394,573
01043900,SOUTHWEST TENNESSEE COMMUNITY COLLG     ,TN,38104-3322,Public       ,81,409,490,5938,11926,17864
01044700,"PLAZA BEAUTY SCHOOL, INC.               ",TN,38117-4822,Proprietary  ,4,14,18,47,171,218
01046000,AMERICAN BAPTIST THEOLOGICAL SEMINA     ,TN,37207-4994,Private      ,0,1,1,25,115,140
01052900,MEMPHIS THEOLOGICAL SEMINARY            ,TN,38104-0000,Private      ,0,1,1,2,210,212
01070000,TN TECHNOLOGY CENTER AT JACKSBORO       ,TN,37757-2461,Public       ,1,6,7,146,239,385
01155300,WM R MOORE COLLEGE OF TECHNOLOGY        ,TN,38104-0000,Private      ,1,3,4,62,142,204
01216400,TENNESSEE TECHNICAL CNTR AT RIPLEY      ,TN,38063-7359,Public       ,1,8,9,60,311,371
01254700,EMMANUEL SCHOOL OF RELIGION             ,TN,37601-0000,Private      ,0,1,1,1,62,63
01269300,PELLISSIPPI STATE COMMUNITY COLLEGE     ,TN,37933-0990,Public       ,43,157,200,4531,4421,8952
02092800,TENNESSEE TECHNOLOGY CENTER AT WHITEVILL,TN,38075-0000,Public       ,0,6,6,143,306,449
02103500,TN TECHNOLOGY CTR AT MURFREESBORO       ,TN,37129-0000,Public       ,2,8,10,233,486,719
02106400,O'MORE COLLEGE OF DESIGN                ,TN,37064-0000,Private      ,1,0,1,192,75,267
02125300,NASHVILLE CLG OF MEDICAL CAREERS        ,TN,37115-0000,Proprietary  ,0,26,26,54,325,379
02153100,JON NAVE UNIVERSITY OF COSMETOLOGY      ,TN,37013-3347,Proprietary  ,11,16,27,172,258,430
02157100,CONCORDE CAREER COLLEGE                 ,TN,38137-0000,Proprietary  ,19,178,197,386,2093,2479
02188300,CHURCH OF GOD THEOLOGICAL SEMINARY      ,TN,37320-0000,Private      ,0,3,3,2,222,224
02204200,"CHATTANOOGA COLLEGE - MEDICAL, DENTAL AN",TN,37411-0000,Proprietary  ,8,57,65,94,502,596
02237900,TN TECHNOLOGY CENTER AT PARIS           ,TN,38242-0000,Public       ,0,4,4,187,634,821
02257400,ARNOLD'S BEAUTY SCHOOL                  ,TN,38358-0000,Proprietary  ,2,6,8,44,69,113
02263104,HIGH-TECH INSTITUTE - NASHVILLE         ,TN,37214-2531,Proprietary  ,4,3,7,93,118,211
02275500,REUBEN-ALLEN COLLEGE                    ,TN,37922-0000,Proprietary  ,2,7,9,32,52,84
02278700,MR WAYNES SCH OF UNISEX HAIR DESIGN     ,TN,38501-0000,Proprietary  ,2,6,8,20,41,61
02293900,VOLUNTEER BEAUTY ACADEMY-NASHVILLE      ,TN,37115-2112,Proprietary  ,4,8,12,30,118,148
02294000,VOLUNTEER BEAUTY ACADEMY-DYERSBURG      ,TN,38024-1622,Proprietary  ,1,9,10,36,116,152
02326200,KAPLAN CAREER INSTITUTE                 ,TN,37217-1342,Proprietary  ,16,112,128,215,1170,1385
02326202,KAPLAN CAREER INSTITUTE - THOMPSON LANE ,TN,37204-3692,Proprietary  ,1,2,3,13,78,91
02326300,MEDVANCE INSTITUTE                      ,TN,38501-4305,Proprietary  ,8,39,47,259,1003,1262
02335900,VOLUNTEER BEAUTY ACADEMY-NASHVILLE      ,TN,37209-3033,Proprietary  ,0,6,6,23,75,98
02359800,ITT TECHNICAL INSTITUTE                 ,TN,37214-3717,Proprietary  ,89,257,346,1441,3186,4627
02498000,NEW WAVE HAIR ACADEMY                   ,TN,38128-0000,Proprietary  ,0,14,14,53,229,282
02539800,QUEEN CITY COLLEGE                      ,TN,37042-0000,Proprietary  ,2,21,23,40,241,281
02540000,TENNESSEE ACADEMY OF COSMETOLOGY        ,TN,38133-0000,Proprietary  ,4,17,21,35,149,184
02578200,NOSSI COLLEGE OF ART                    ,TN,37072-0000,Proprietary  ,9,14,23,297,363,660
02595000,FAYETTEVILLE BEAUTY SCHOOL              ,TN,37334-2909,Proprietary  ,0,4,4,32,83,115
02597600,NEW WAVE HAIR ACADEMY                   ,TN,38301-3812,Proprietary  ,4,16,20,50,247,297
02599710,VATTEROTT COLLEGE - MEMPHIS             ,TN,38132-1714,Proprietary  ,7,56,63,169,1039,1208
02605501,REMINGTON COLLEGE - MEMPHIS CAMPUS      ,TN,38132-0000,Proprietary  ,22,127,149,369,1701,2070
02609204,VATTEROTT COLLEGE - VATTEROTT CAREER COL,TN,38133-4727,Proprietary  ,3,27,30,15,67,82
02614200,MILLER MOTTE BUSINESS COLLEGE           ,TN,37040-6023,Proprietary  ,18,68,86,253,1006,1259
02614203,MILLER-MOTTE TECHNICAL COLLEGE          ,TN,37421-0000,Proprietary  ,18,86,104,301,1128,1429
02614204,MILLER - MOTTE TECHNICAL COLLEGE - GOODL,TN,37072-1870,Proprietary  ,8,53,61,77,435,512
03001800,FREE WILL BAPTIST BIBLE COLLEGE         ,TN,37205-2498,Private      ,1,1,2,237,140,377
03008800,FRANKLIN ACADEMY                        ,TN,37312-3939,Private      ,4,15,19,33,93,126
03010606,VIRGINIA COLLEGE - SCH OF BUSNSS & HLTH ,TN,37411-5600,Proprietary  ,2,7,9,64,195,259
03012500,NEW WAVE HAIR ACADEMY                   ,TN,38111-4253,Proprietary  ,5,19,24,139,446,585
03024900,TENNESSEE ACADEMY OF COSMETOLOGY        ,TN,38125-3442,Proprietary  ,3,10,13,52,162,214
03061100,GENESIS CAREER COLLEGE OF LEBANON       ,TN,37087-2718,Proprietary  ,14,47,61,100,416,516
03073400,ITT TECHNICAL INSTITUTE                 ,TN,37932-3343,Proprietary  ,117,254,371,1795,3486,5281
03076405,HIGH-TECH INSTITUTE - MEMPHIS           ,TN,38134-7345,Proprietary  ,2,5,7,79,195,274
03079100,NORTH CENTRAL INSTITUTE                 ,TN,37042-3116,Proprietary  ,0,7,7,18,69,87
03088800,WATKINS INSTITUTE COLLEGE OF ART & DESIG,TN,37228-1306,Private      ,2,3,5,379,253,632
03126900,STYLES & PROFILES BEAUTY COLLEGE        ,TN,38375-2109,Proprietary  ,0,2,2,13,29,42
03149300,NEW DIRECTIONS HAIR ACADEMY             ,TN,37209-0000,Proprietary  ,4,25,29,107,362,469
03355400,RICHMONT GRADUATE UNIVERSITY            ,TN,37404-0000,Private      ,0,0,0,12,134,146
03440300,BAPTIST MEMORIAL COLLEGE OF HEALTH      ,TN,38104-3104,Private      ,3,3,6,674,1315,1989
03454300,TENNESSEE CAREER COLLEGE                ,TN,37214-2945,Proprietary  ,0,0,0,4,7,11
03480303,MEDVANCE INSTITUTE - NASHVILLE          ,TN,37203-1536,Proprietary  ,11,59,70,142,679,821
03513500,WILLIAMSON CHRISTIAN COLLEGE            ,TN,37067-8237,Private      ,0,3,3,16,59,75
03647300,NEW CONCEPTS SCHOOL OF COSMETOLOGY      ,TN,37311-7373,Proprietary  ,1,2,3,13,45,58
03683300,INTERNATIONAL BARBER & STYLE COLLEGE    ,TN,37218-2205,Proprietary  ,4,25,29,39,193,232
03701300,MEMPHIS INSTITUTE OF BARBERING          ,TN,38107-4334,Proprietary  ,2,11,13,32,111,143
03774400,SHEAR ACADEMY                           ,TN,38555-4177,Proprietary  ,0,0,0,14,32,46
03830300,SAE INSTITUTE OF TECHNOLOGY             ,TN,37203-4310,Proprietary  ,0,1,1,180,228,408
03841300,CAREER BEAUTY COLLEGE                   ,TN,38464-3634,Proprietary  ,0,3,3,15,38,53
03920300,INSTITUTE OF HAIR DESIGN                ,TN,38310-1801,Proprietary  ,3,3,6,23,53,76
03930300,BUCHANAN BEAUTY COLLEGE                 ,TN,37160-2741,Proprietary  ,4,8,12,13,64,77
03982300,VISIBLE SCHOOL - MUSIC AND WORSHIPS ARTS,TN,38002-9755,Private      ,0,0,0,74,38,112
04025300,LAST MINUTE CUTS SCHOOL OF BARBERING AND,TN,38109-7709,Proprietary  ,0,4,4,22,118,140
04035300,NAVE COSMETOLOGY ACADEMY                ,TN,38401-6335,Proprietary  ,3,18,21,57,172,229
04037400,MASON ACADEMY OF COSMETOLOGY            ,TN,38049-7048,Proprietary  ,0,0,0,0,2,2
04124100,ELITE COLLEGE OF COSMETOLOGY            ,TN,38351-1431,Proprietary  ,1,4,5,22,88,110
00353700,ABILENE CHRISTIAN UNIVERSITY            ,TX,79699-3701,Private      ,11,50,61,4125,1523,5648
00353900,ALVIN COMMUNITY COLLEGE                 ,TX,77511-4807,Public       ,16,77,93,838,1713,2551
00354000,AMARILLO COLLEGE                        ,TX,79109-2446,Public       ,31,200,231,2748,5588,8336
00354100,ANGELO STATE UNIVERSITY                 ,TX,76909-5069,Public       ,35,54,89,5547,2187,7734
00354300,AUSTIN COLLEGE                          ,TX,75090-4440,Private      ,4,1,5,1716,144,1860
00354400,AUSTIN PRESBYTERIAN THEOLOGICAL SEM     ,TX,78705-5797,Private      ,0,0,0,2,135,137
00354500,BAYLOR UNIVERSITY                       ,TX,76798-1458,Private      ,122,44,166,15427,3799,19226
00354600,COASTAL BEND COLLEGE                    ,TX,78102-2197,Public       ,47,70,117,1519,2287,3806
00354900,BLINN COLLEGE                           ,TX,77833-4098,Public       ,97,78,175,8011,3450,11461
00355300,CISCO JUNIOR COLLEGE                    ,TX,76437-9803,Public       ,9,16,25,1636,2025,3661
00355400,CLARENDON COLLEGE                       ,TX,79226-0000,Public       ,9,26,35,463,402,865
00355600,COMMONWEALTH INST OF FUNERAL SVC        ,TX,77090-5918,Private      ,2,5,7,55,149,204
00355700,CONCORDIA UNIVERSITY TEXAS              ,TX,78726-4141,Private      ,9,123,132,1106,2122,3228
00355800,NORTH CENTRAL TEXAS COLLEGE             ,TX,76240-4699,Public       ,32,131,163,2202,2993,5195
00356000,DALLAS BAPTIST UNIVERSITY               ,TX,75211-9299,Private      ,17,125,142,2382,3762,6144
00356100,CEDAR VALLEY COLLEGE                    ,TX,75134-0000,Public       ,20,135,155,1608,3252,4860
00356200,DALLAS THEOLOGICAL SEM                  ,TX,75204-0000,Private      ,0,17,17,14,599,613
00356300,DEL MAR COLLEGE                         ,TX,78404-3897,Public       ,53,211,264,4464,6390,10854
00356400,EAST TEXAS BAPTIST UNIVERSITY           ,TX,75670-1423,Private      ,3,5,8,1468,313,1781
00356500,TEXAS A&M UNIVERSITY - COMMERCE         ,TX,75429-3011,Public       ,21,157,178,3698,5439,9137
00356600,EPISCOPAL THEOL SEM OF THE STHWST       ,TX,78768-0000,Private      ,0,0,0,0,13,13
00356800,FRANK PHILLIPS COLLEGE                  ,TX,79008-0000,Public       ,8,33,41,379,532,911
00357000,GRAYSON COUNTY COLLEGE                  ,TX,75020-8299,Public       ,28,96,124,1390,2523,3913
00357100,HARDIN-SIMMONS UNIVERSITY               ,TX,79698-6050,Private      ,7,8,15,2111,903,3014
00357200,TRINITY VALLEY COMMUNITY COLLEGE        ,TX,75751-2734,Public       ,30,110,140,1776,3127,4903
00357300,HILL COLLEGE                            ,TX,76645-2711,Public       ,13,36,49,675,825,1500
00357301,HILL COLLEGE                            ,TX,76031-0000,Public       ,7,61,68,572,1235,1807
00357400,HOWARD COLLEGE                          ,TX,79720-0213,Public       ,23,67,90,1069,1808,2877
00357500,HOWARD PAYNE UNIVERSITY                 ,TX,76801-2794,Private      ,2,3,5,1348,386,1734
00357600,HOUSTON BAPTIST UNIVERSITY              ,TX,77074-3298,Private      ,19,27,46,3321,1899,5220
00357700,HUSTON - TILLOTSON UNIVERSITY           ,TX,78702-2795,Private      ,4,14,18,834,578,1412
00357800,UNIVERSITY OF THE INCARNATE WORD        ,TX,78209-6398,Private      ,14,56,70,4414,4265,8679
00357900,JACKSONVILLE COLLEGE                    ,TX,75766-4759,Private      ,2,4,6,213,132,345
00358000,KILGORE COLLEGE                         ,TX,75662-3299,Public       ,19,77,96,2468,3306,5774
00358100,LAMAR UNIVERSITY-BEAUMONT               ,TX,77710-0042,Public       ,45,210,255,6616,5185,11801
00358200,LAREDO COMMUNITY COLLEGE                ,TX,78040-4395,Public       ,40,77,117,4717,3736,8453
00358300,LEE COLLEGE                             ,TX,77520-4796,Public       ,15,59,74,1202,3018,4220
00358400,LETOURNEAU UNIVERSITY                   ,TX,75607-0000,Private      ,4,198,202,1498,3347,4845
00358500,LON MORRIS COLLEGE                      ,TX,75766-2900,Private      ,4,2,6,355,100,455
00358600,LUBBOCK CHRISTIAN UNIVERSITY            ,TX,79407-2099,Private      ,3,22,25,1388,1102,2490
00358800,UNIVERSITY OF MARY HARDIN-BAYLOR        ,TX,76513-2599,Private      ,6,27,33,2731,1330,4061
00359000,MCLENNAN COMMUNITY COLLEGE              ,TX,76708-1498,Public       ,39,153,192,3328,5739,9067
00359100,MCMURRY UNIVERSITY                      ,TX,79697-0001,Private      ,5,14,19,1722,676,2398
00359200,MIDWESTERN STATE UNIVERSITY             ,TX,76308-2099,Public       ,26,60,86,3554,2670,6224
00359300,NAVARRO COLLEGE                         ,TX,75110-4818,Public       ,53,167,220,3191,4128,7319
00359400,UNIVERSITY OF NORTH TEXAS               ,TX,76203-1370,Public       ,127,266,393,23054,16128,39182
00359500,OBLATE SCHOOL OF THEOLOGY               ,TX,78216-0000,Private      ,0,0,0,0,12,12
00359600,ODESSA COLLEGE                          ,TX,79764-7127,Public       ,18,88,106,1324,2209,3533
00359800,OUR LADY OF THE LAKE UNIVERSITY         ,TX,78207-4689,Private      ,10,55,65,2113,2673,4786
00359900,UNIVERSITY OF TEXAS - PAN AMERICAN      ,TX,78541-2999,Public       ,180,179,359,13635,9027,22662
00360000,PANOLA COLLEGE                          ,TX,75633-2397,Public       ,12,53,65,805,1150,1955
00360100,PARIS JR COLLEGE                        ,TX,75460-6298,Public       ,44,168,212,1539,2697,4236
00360200,PAUL QUINN COLLEGE                      ,TX,75241-4398,Private      ,6,5,11,527,795,1322
00360300,RANGER COLLEGE                          ,TX,76470-3298,Public       ,4,8,12,448,304,752
00360400,RICE UNIVERSITY                         ,TX,77251-1892,Private      ,8,16,24,6719,1851,8570
00360600,SAM HOUSTON STATE UNIVERSITY            ,TX,77340-0000,Public       ,70,126,196,12824,5864,18688
00360700,ALAMO CMTY CLG DISTRICT PROGRAM         ,TX,78207-0000,Public       ,3,18,21,319,512,831
00360800,ST PHILLIPS COLLEGE                     ,TX,78203-2098,Public       ,84,335,419,4233,8812,13045
00360900,SAN JACINTO CLG-CENTRAL-NORTH-SOUTH     ,TX,77501-0000,Public       ,133,346,479,6170,8783,14953
00361000,SCHREINER UNIVERSITY                    ,TX,78028-5697,Private      ,3,9,12,1236,421,1657
00361100,SOUTH PLAINS COLLEGE                    ,TX,79336-6504,Public       ,34,126,160,4333,4526,8859
00361200,UNIV OF HOUSTON-DOWNTOWN                ,TX,77002-1001,Public       ,47,164,211,5872,8700,14572
00361300,SOUTHERN METHODIST UNIVERSITY           ,TX,75275-0181,Private      ,19,48,67,5297,4710,10007
00361400,SOUTHWEST TEXAS JR COLLEGE              ,TX,78801-6221,Public       ,56,81,137,2282,2817,5099
00361500,TEXAS STATE UNIVERSITY--SAN MARCOS      ,TX,78666-4602,Public       ,184,176,360,21782,11718,33500
00361600,SOUTHWESTERN ASSEMBLIES OF GOD UNIV     ,TX,75165-2397,Private      ,6,21,27,1411,1033,2444
00361700,SOUTHWESTERN BAPTIST THEOL SEMINARY     ,TX,76122-0000,Private      ,0,1,1,48,178,226
00361800,SOUTHWESTERN CHRISTIAN COLLEGE          ,TX,75160-3400,Private      ,2,0,2,212,86,298
00361900,SOUTHWESTERN ADVENTIST UNIVERSITY       ,TX,76059-1922,Private      ,4,6,10,658,386,1044
00362000,SOUTHWESTERN UNIVERSITY                 ,TX,78626-6111,Private      ,6,0,6,1835,152,1987
00362100,ST EDWARDS UNIVERSITY                   ,TX,78704-0000,Private      ,9,37,46,4267,2598,6865
00362300,ST MARY'S UNIV OF SAN ANTONIO           ,TX,78228-8500,Private      ,12,21,33,3450,2759,6209
00362400,STEPHEN F AUSTIN STATE UNIVERSITY       ,TX,75962-0001,Public       ,116,95,211,10630,4098,14728
00362500,SUL ROSS STATE UNIVERSITY               ,TX,79832-0113,Public       ,10,63,73,1389,1906,3295
00362600,TARRANT COUNTY COLLEGE                  ,TX,76102-6599,Public       ,207,739,946,11032,17532,28564
00362700,TEMPLE COLLEGE                          ,TX,76504-7435,Public       ,30,162,192,1881,3872,5753
00362800,TEXARKANA COLLEGE                       ,TX,75599-0001,Public       ,25,76,101,1577,2269,3846
00363000,PRAIRIE VIEW A&M UNIVERSITY             ,TX,77446-2967,Public       ,65,85,150,9243,5227,14470
00363100,TARLETON STATE UNIVERSITY               ,TX,76402-0000,Public       ,36,135,171,5569,4825,10394
00363200,TEXAS A&M UNIVERSITY                    ,TX,77842-0000,Public       ,241,134,375,31684,7505,39189
00363204,TEXAS A&M UNIVERSITY - GALVESTON        ,TX,77553-1675,Public       ,7,4,11,10,4,14
00363400,TEXAS STATE TECHNICAL CLG AT WACO       ,TX,76705-1695,Public       ,76,191,267,2675,3125,5800
00363500,TEXAS CHIROPRACTIC COLLEGE              ,TX,77505-1699,Private      ,0,4,4,21,434,455
00363600,TEXAS CHRISTIAN UNIVERSITY              ,TX,76129-0001,Private      ,25,32,57,7941,2602,10543
00363700,JARVIS CHRISTIAN COLLEGE                ,TX,75765-1470,Private      ,24,7,31,790,260,1050
00363800,TEXAS COLLEGE                           ,TX,75702-4500,Private      ,3,22,25,753,610,1363
00363900,TEXAS A&M UNIVERSITY-KINGSVILLE         ,TX,78363-8203,Public       ,33,98,131,5309,4405,9714
00364100,TEXAS LUTHERAN UNIVERSITY               ,TX,78155-5999,Private      ,4,7,11,1830,269,2099
00364200,TEXAS SOUTHERN UNIVERSITY               ,TX,77004-4598,Public       ,62,128,190,9132,9951,19083
00364300,TEXAS SOUTHMOST COLLEGE                 ,TX,78520-4992,Public       ,3,9,12,185,346,531
00364400,TEXAS TECH UNIVERSITY                   ,TX,79409-0000,Public       ,96,124,220,19065,8674,27739
00364500,TEXAS WESLEYAN UNIVERSITY               ,TX,76105-1536,Private      ,8,31,39,1150,3563,4713
00364600,TEXAS WOMAN'S UNIVERSITY                ,TX,76204-5587,Public       ,21,133,154,5056,8989,14045
00364700,TRINITY UNIVERSITY                      ,TX,78212-7200,Private      ,4,2,6,2916,495,3411
00364800,TYLER JUNIOR COLLEGE                    ,TX,75701-3436,Public       ,61,133,194,5626,5068,10694
00365100,UNIVERSITY OF DALLAS                    ,TX,75062-4799,Private      ,4,21,25,1792,1265,3057
00365200,UNIVERSITY OF HOUSTON                   ,TX,77204-2010,Public       ,149,286,435,24680,19933,44613
00365400,UNIVERSITY OF ST THOMAS                 ,TX,77006-4626,Private      ,10,32,42,1421,1230,2651
00365600,UNIVERSITY OF TEXAS-ARLINGTON           ,TX,76019-0000,Public       ,67,208,275,14200,15608,29808
00365800,UNIVERSITY OF TEXAS-AUSTIN              ,TX,78713-7758,Public       ,83,108,191,36364,17114,53478
00365900,UT HEALTH CENTER-SAN ANTONIO            ,TX,78229-3900,Public       ,2,17,19,546,2903,3449
00366100,UNIVERSITY OF TEXAS-EL PASO             ,TX,79968-0629,Public       ,76,161,237,11584,10326,21910
00366200,VICTORIA COLLEGE (THE)                  ,TX,77901-4494,Public       ,28,70,98,1202,2159,3361
00366300,WAYLAND BAPTIST UNIVERSITY              ,TX,79072-6998,Private      ,5,110,115,1041,3306,4347
00366400,WEATHERFORD COLLEGE                     ,TX,76086-5699,Public       ,20,101,121,1643,2070,3713
00366500,WEST TEXAS A&M UNIVERSITY               ,TX,79016-0000,Public       ,75,87,162,4555,3455,8010
00366800,WHARTON COUNTY JR COLLEGE               ,TX,77488-3298,Public       ,37,87,124,2002,2119,4121
00366900,WILEY COLLEGE                           ,TX,75670-5199,Private      ,14,20,34,829,691,1520
00400300,CENTRAL TEXAS COLLEGE                   ,TX,76540-4199,Public       ,43,375,418,2079,10023,12102
00407221,NORTHWOOD UNIVERSITY                    ,TX,75104-0000,Private      ,8,19,27,638,756,1394
00445300,EL CENTRO COLLEGE                       ,TX,75202-0000,Public       ,55,295,350,2583,6239,8822
00481102,EVEREST INSTITUTE - EVEREST COLLEGE     ,TX,76011-6750,Proprietary  ,23,134,157,275,1156,1431
00494800,TEXAS A&M UNIV SYSTEM HEALTH SCI CT     ,TX,77840-7896,Public       ,3,6,9,191,1118,1309
00494801,TEXAS A&M UNIV SYSTEMS-HSC              ,TX,77843-1114,Public       ,0,0,0,287,341,628
00494900,BAYLOR COLLEGE OF MEDICINE              ,TX,77030-0000,Private      ,4,7,11,216,1306,1522
00495100,UNIV OF TEXAS HEALTH SCIENCE CENTER     ,TX,77225-0000,Public       ,1,24,25,349,2605,2954
00495200,UNIV OF TEXAS MEDICAL BRANCH            ,TX,77550-0000,Public       ,5,20,25,280,2034,2314
00497200,GALVESTON COLLEGE                       ,TX,77550-7447,Public       ,15,35,50,893,1347,2240
00497700,SOUTH TEXAS COLLEGE OF LAW              ,TX,77002-0000,Private      ,0,5,5,27,2022,2049
00520307,REMINGTON COLLEGE - DALLAS CAMPUS       ,TX,75041-9935,Proprietary  ,1,3,4,51,156,207
00660600,BAPTIST HS SCHOOL OF HEALTH PROFESSIONS ,TX,78229-3234,Proprietary  ,2,5,7,51,295,346
00661200,COVENANT SCH OF NSG & ALLIED HEALTH     ,TX,79410-0000,Private      ,1,5,6,100,282,382
00666100,ANGELINA COLLEGE                        ,TX,75902-0000,Public       ,32,121,153,1883,2902,4785
00694100,DALLAS CHRISTIAN COLLEGE                ,TX,75234-7229,Private      ,2,8,10,219,313,532
00709600,COLLEGE OF THE MAINLAND                 ,TX,77591-2499,Public       ,29,92,121,861,2145,3006
00728700,BRAZOSPORT COLLEGE                      ,TX,77566-3199,Public       ,46,43,89,828,1180,2008
00732907,ITT TECHNICAL INSTITUTE                 ,TX,77063-3751,Proprietary  ,0,14,14,130,313,443
00754805,WESTWOOD COLLEGE OF TECHNOLOGY          ,TX,77074-0000,Proprietary  ,11,27,38,392,616,1008
00758602,REMINGTON COLLEGE - FORT WORTH CAMPUS   ,TX,76112-1280,Proprietary  ,25,117,142,317,1066,1383
00835300,LINCOLN COLLEGE OF TECHNOLOGY           ,TX,75052-0000,Proprietary  ,126,127,253,1404,1519,2923
00849800,MIMS CLASSIC BEAUTY COLLEGE             ,TX,78216-0000,Proprietary  ,2,3,5,35,82,117
00850300,MOUNTAIN VIEW COLLEGE                   ,TX,75211-6599,Public       ,35,137,172,2440,4188,6628
00850400,RICHLAND COLLEGE                        ,TX,75243-2199,Public       ,70,193,263,3358,5136,8494
00851000,EASTFIELD COLLEGE                       ,TX,75150-2099,Public       ,46,186,232,2817,5151,7968
00907905,EVEREST COLLEGE                         ,TX,75206-5209,Proprietary  ,41,199,240,485,1868,2353
00908200,INTERNATIONAL BUSINESS COLLEGE          ,TX,79903-0000,Proprietary  ,15,86,101,229,808,1037
00916300,SAN ANTONIO COLLEGE                     ,TX,78212-4299,Public       ,227,459,686,10142,15491,25633
00922500,TEXAS STATE TECHNICAL COLLEGE  HARLINGEN,TX,78550-3697,Public       ,77,160,237,3128,3552,6680
00946600,KAPLAN CAREER INSTITUTE                 ,TX,78216-1899,Proprietary  ,43,177,220,423,1785,2208
00946607,SAN ANT COL OF MED & DENTAL - MCALLEN   ,TX,78503-1622,Proprietary  ,51,148,199,520,1385,1905
00946609,CAREER CENTERS OF TX - CORPUS CHRISTI   ,TX,78416-9900,Proprietary  ,25,153,178,271,1366,1637
00946610,KAPLAN CAREER INSTITUTE - CAREER CENTERS,TX,76103-2310,Proprietary  ,24,123,147,250,988,1238
00954900,WESTERN TEXAS COLLEGE                   ,TX,79549-9501,Public       ,5,6,11,486,344,830
00965100,TEXAS A&M INTERNATIONAL UNIVERSITY      ,TX,78041-1900,Public       ,41,63,104,4034,2910,6944
00974100,UNIVERSITY OF TEXAS AT DALLAS           ,TX,75083-0000,Public       ,40,151,191,6336,7519,13855
00976800,UNIVERSITY OF NORTH TEXAS HEALTH SCIENCE,TX,76107-2699,Public       ,2,9,11,88,1356,1444
00979700,MIDLAND COLLEGE                         ,TX,79705-6397,Public       ,18,60,78,1382,2162,3544
00982802,EVEREST INSTITUTE- AUSTIN               ,TX,78754-0000,Proprietary  ,50,220,270,415,1816,2231
00993000,UNIVERSITY OF TEXAS-PERMIAN BASIN       ,TX,79762-0001,Public       ,16,40,56,1543,2013,3556
00993200,TEXAS STATE TECH CLG-WEST TEXAS         ,TX,79556-4108,Public       ,18,37,55,495,945,1440
00993201,TEXAS STATE TECH COLLEGE-ABILENE        ,TX,79601-0000,Public       ,2,15,17,176,412,588
00993204,TEXAS STATE TECH CLG-BRECKENRIDGE       ,TX,76424-0000,Public       ,2,16,18,34,199,233
00993205,TEXAS STATE TECH COLLEGE-BROWNWOOD      ,TX,76801-0000,Public       ,5,26,31,140,386,526
01001900,UNIV OF TEXAS SOUTHWESTERN MED CTR      ,TX,75390-9096,Public       ,4,12,16,142,1627,1769
01005700,AMERICAN COMMERCIAL COLLEGE             ,TX,79602-1399,Proprietary  ,1,40,41,70,435,505
01005900,AMERICAN COMMERCIAL COLLEGE             ,TX,79761-0000,Proprietary  ,2,30,32,64,395,459
01005901,AMERICAN COMMERCIAL COLLEGE - AMERICAN C,TX,76310-2303,Proprietary  ,3,43,46,52,352,404
01006000,VERNON COLLEGE                          ,TX,76384-4092,Public       ,11,85,96,919,1996,2915
01011500,UNIVERSITY OF TEXAS-SAN ANTONIO         ,TX,78249-0600,Public       ,153,226,379,23281,14663,37944
01013000,WADE COLLEGE                            ,TX,75207-3199,Proprietary  ,2,1,3,219,211,430
01038700,EL PASO COMMUNITY COLLEGE               ,TX,79998-0000,Public       ,157,342,499,11856,12936,24792
01050900,HALLMARK COLLEGE OF AERONAUTICS         ,TX,78214-0000,Proprietary  ,23,86,109,360,1174,1534
01062400,CENTRAL TEXAS COMMERCIAL COLLEGE        ,TX,75231-5033,Proprietary  ,2,18,20,33,91,124
01063300,HOUSTON COMMUNITY COLLEGE               ,TX,77002-0000,Public       ,270,1047,1317,9668,20126,29794
01063303,HOUSTON COMMUNITY COLLEGE - CENTRAL     ,TX,77004-0000,Public       ,0,0,0,1221,2683,3904
01063304,HOUSTON COMMUNITY COLLEGE - RICE AVIATIO,TX,77061-5001,Public       ,0,0,0,666,1176,1842
01063305,HOUSTON COMMUNITY COLLEGE - NORTHEAST CO,TX,77066-5221,Public       ,0,0,0,870,1446,2316
01063306,HOUSTON COMMUNITY COLLEGE - CENTRAL COLL,TX,77088-6372,Public       ,0,0,0,646,967,1613
01063339,HOUSTON COMMUNITY COLLEGE - STAFFORD    ,TX,77477-0000,Public       ,0,0,0,675,783,1458
01063347,HOUSTON COMMUNITY COLLEGE - SOUTHWEST   ,TX,77081-7849,Public       ,0,0,0,1312,1894,3206
01063348,HOUSTON COMMUNITY COLLEGE - COLEMAN     ,TX,77030-0000,Public       ,0,0,0,219,927,1146
01067400,TEXAS TECH U HEALTH SCIENCES CENTER     ,TX,79430-0000,Public       ,2,24,26,586,2585,3171
01076100,DALLAS INSTITUTE OF FUNERAL SERVICE     ,TX,75227-4314,Private      ,2,8,10,63,198,261
01114500,LONE STAR COLLEGE SYSTEM DISTRICT       ,TX,77073-3499,Public       ,95,249,344,4403,7428,11831
01114501,LONE STAR COLLEGE-KINGWOOD              ,TX,77339-0000,Public       ,35,133,168,1342,2658,4000
01114502,LONE STAR COLLEGE-TOMBALL               ,TX,77375-0000,Public       ,17,84,101,1021,1899,2920
01114503,LONE STAR COLLEGE-MONTGOMERY            ,TX,77384-0000,Public       ,26,120,146,1625,3056,4681
01114504,LONE STAR COLLEGE-CY-FAIR               ,TX,77433-1383,Public       ,30,116,146,1976,2790,4766
01116100,TEXAS A&M UNIV CORPUS CHRISTI           ,TX,78412-5599,Public       ,41,90,131,7195,4340,11535
01116300,UNIVERSITY OF TEXAS AT TYLER            ,TX,75799-6699,Public       ,12,57,69,3553,3606,7159
01171100,UNIVERSITY OF HOUSTON-CLEAR LAKE        ,TX,77058-1002,Public       ,13,114,127,1615,5885,7500
01201500,AUSTIN COMMUNITY COLLEGE                ,TX,78752-4390,Public       ,259,734,993,10972,17348,28320
01202000,VICTORIA BEAUTY COLLEGE                 ,TX,77901-6233,Proprietary  ,1,8,9,38,147,185
01226800,BALDWIN BEAUTY SCHOOL #5                ,TX,78704-4785,Proprietary  ,4,11,15,60,167,227
01229700,LAREDO BEAUTY COLLEGE                   ,TX,78040-1051,Proprietary  ,5,28,33,68,332,400
01248200,ATI TECHNICAL TRAINING CENTER           ,TX,75235-4622,Proprietary  ,92,364,456,830,2792,3622
01248209,ATI CAREER TRAINING CENTER - GARLAND    ,TX,75041-2497,Proprietary  ,0,1,1,10,34,44
01248300,COSMETOLOGY CAREER CENTER               ,TX,75006-2566,Proprietary  ,22,35,57,241,455,696
01248800,INTERNATIONAL BEAUTY COLLEGE NO 3       ,TX,75040-0000,Proprietary  ,1,8,9,28,95,123
01276400,METROPLEX BEAUTY SCHOOL                 ,TX,75149-0000,Proprietary  ,3,18,21,43,136,179
01293000,CHARLES & SUE'S SCH OF HAIR DESIGN      ,TX,77801-0000,Proprietary  ,4,10,14,42,85,127
01293100,VELMA B'S BEAUTY ACADEMY                ,TX,75216-1511,Proprietary  ,0,0,0,11,52,63
01293200,INTERNATIONAL BEAUTY COLLEGE            ,TX,75061-4235,Proprietary  ,1,3,4,16,81,97
01300300,NEILSON BEAUTY COLLEGE                  ,TX,75208-4637,Proprietary  ,0,1,1,15,74,89
01301600,OGLE SCHOOL HAIR SKIN NAILS             ,TX,76013-7401,Proprietary  ,7,16,23,178,306,484
01323100,UNIVERSITY OF HOUSTON-VICTORIA          ,TX,77901-5731,Public       ,1,81,82,377,2370,2747
02058600,CONLEE'S COLLEGE OF COSMETOLOGY         ,TX,78028-0000,Proprietary  ,1,5,6,12,38,50
02069302,VATTEROTT COLLEGE - VATTEROTT EDUCATION ,TX,75220-5441,Proprietary  ,6,33,39,119,424,543
02074100,CAPITOL CITY TRADE & TECHNICAL SCH      ,TX,78704-0000,Proprietary  ,36,117,153,284,857,1141
02077400,NORTH LAKE COLLEGE                      ,TX,75038-0000,Public       ,24,92,116,1811,2960,4771
02078100,STEPHENVILLE BEAUTY COLLEGE             ,TX,76401-0000,Proprietary  ,1,1,2,19,37,56
02081400,ARLINGTON BAPTIST COLLEGE               ,TX,76012-0000,Private      ,1,4,5,94,144,238
02093600,SOUTHWEST SCHOOL OF ELECTRONIC          ,TX,78735-0000,Proprietary  ,1,5,6,17,53,70
02098300,WESTERN TECHNICAL COLLEGE               ,TX,79927-2105,Proprietary  ,61,174,235,909,1378,2287
02100200,BROOKHAVEN COLLEGE                      ,TX,75244-0000,Public       ,34,149,183,1835,3768,5603
02113610,AMERICAN INTERCONTINENTAL UNIV - HOUSTON,TX,77042-4516,Proprietary  ,2,19,21,175,760,935
02116008,SANFORD-BROWN COLLEGE - HOUSTON         ,TX,77036-8507,Proprietary  ,52,140,192,372,1288,1660
02116012,SANFORD-BROWN INSTITUTE - HOUSTON NORTH ,TX,77008-1058,Proprietary  ,6,42,48,145,637,782
02117100,ART INSTITUTE OF HOUSTON                ,TX,77056-0000,Proprietary  ,62,99,161,2465,2229,4694
02119200,COURT REPORTING INSTITUTE OF DALLAS     ,TX,75247-6913,Proprietary  ,1,4,5,172,1229,1401
02119202,COURT REPORTING INSTIUTE OF HOUSTON     ,TX,77040-6315,Proprietary  ,1,8,9,42,253,295
02128302,INSTITUTE FOR BUSINESS & TECHNOLOGY - LA,TX,78230-2520,Proprietary  ,11,46,57,104,375,479
02136800,AMERICAN COMMERCIAL COLLEGE             ,TX,76904-0000,Proprietary  ,4,35,39,39,243,282
02144800,BRADFORD SCHOOL OF BUSINESS             ,TX,77027-9881,Proprietary  ,1,2,3,154,161,315
02176100,PIPO ACADEMY OF HAIR DESIGN             ,TX,79903-0000,Proprietary  ,1,4,5,23,78,101
02188600,AUSTIN BUSINESS COLLEGE                 ,TX,78741-0000,Proprietary  ,0,0,0,8,21,29
02200800,AMERICAN COMMERCIAL COLLEGE             ,TX,79411-0000,Proprietary  ,4,40,44,67,454,521
02218300,SOUTHWEST SCHOOL OF BUSINESS & TECHNICAL,TX,78221-0000,Proprietary  ,11,74,85,196,780,976
02218305,SOUTHWEST SCHOOL OF BUSINESS AND TECHNIC,TX,78501-6053,Proprietary  ,3,35,38,71,245,316
02218306,SOUTHWEST SCHOOL OF BUSINESS AND TECHNIC,TX,78413-2045,Proprietary  ,6,17,23,32,162,194
02224600,TRI-STATE BEAUTY SCHOOL #1              ,TX,79915-0000,Proprietary  ,8,46,54,148,427,575
02230500,OGLE SCHOOL HAIR SKIN NAILS             ,TX,76132-3638,Proprietary  ,22,42,64,287,518,805
02230600,OGLE SCHOOL HAIR SKIN NAILS             ,TX,76053-0000,Proprietary  ,6,21,27,102,185,287
02239100,CENTRAL TEXAS BEAUTY COLLEGE #2         ,TX,78664-0000,Proprietary  ,6,22,28,50,247,297
02248200,MILAN INSTITUTE OF COSMETOLOGY          ,TX,79103-0000,Proprietary  ,47,158,205,591,1741,2332
02254800,TEXAS VOCATIONAL SCHOOLS                ,TX,77901-0000,Proprietary  ,10,23,33,60,169,229
02259400,AMBERTON UNIVERSITY                     ,TX,75041-0000,Private      ,0,8,8,23,218,241
02261300,EVEREST INSTITUTE                       ,TX,78213-3841,Proprietary  ,42,201,243,352,1742,2094
02261302,EVEREST INSTITUTE - HOUSTON GREENSPOINT ,TX,77060-3249,Proprietary  ,33,220,253,403,1828,2231
02261303,EVEREST INSTITUTE - HOUSTON HOBBY       ,TX,77087-2737,Proprietary  ,26,195,221,279,1410,1689
02267100,EXPOSITO SCHOOL OF HAIR DESIGN          ,TX,79109-0000,Proprietary  ,2,9,11,32,96,128
02276000,FRANKLIN BEAUTY SCHOOL #2               ,TX,77021-0000,Proprietary  ,1,13,14,46,168,214
02285900,UNIVERSITY OF COSMETOLOGY ARTS&SCI      ,TX,78504-0000,Proprietary  ,12,56,68,185,598,783
02294800,CAPITOL CITY CAREERS                    ,TX,78745-0000,Proprietary  ,3,21,24,26,229,255
02298501,EVEREST COLLEGE- FORT WORTH             ,TX,76137-2472,Proprietary  ,26,155,181,250,1089,1339
02305300,PARKER COLLEGE OF CHIROPRACTIC          ,TX,75229-0000,Private      ,2,5,7,69,1220,1289
02306700,FORT WORTH BEAUTY SCHOOL                ,TX,76116-3299,Proprietary  ,4,21,25,48,271,319
02312200,TEXAS SCHOOL OF BUSINESS                ,TX,77073-6032,Proprietary  ,28,105,133,337,982,1319
02312201,TEXAS SCHOOL OF BUSINESS - SOUTHWEST CAM,TX,77057-0000,Proprietary  ,17,65,82,241,846,1087
02312202,TEXAS SCHOOL OF BUSINESS - FRIENDSWOOD C,TX,77546-8938,Proprietary  ,18,55,73,109,654,763
02312203,TEXAS SCHOOL OF BUSINESS - EAST CAMPUS  ,TX,77029-1916,Proprietary  ,21,71,92,243,819,1062
02313901,WESTWOOD COLLEGE - DALLAS               ,TX,75243-0000,Proprietary  ,14,30,44,517,938,1455
02315400,NORTHEAST TEXAS COMMUNITY COLLEGE       ,TX,75456-0000,Public       ,29,46,75,1056,1414,2470
02318200,"KD STUDIO, ACTOR'S CONSERVATORY         ",TX,75207-2111,Proprietary  ,12,11,23,131,159,290
02320200,HOUSTON GRADUATE SCHOOL OF THEOLOGY     ,TX,77004-0000,Private      ,0,8,8,0,166,166
02326000,SAN ANTONIO BEAUTY COLLEGE NO 3         ,TX,78217-0000,Proprietary  ,0,14,14,58,129,187
02328600,ITT TECHNICAL INSTITUTE                 ,TX,76011-0000,Proprietary  ,63,103,166,690,1244,1934
02331200,BAPTIST MISSIONARY ASSN THEOL SEM       ,TX,75766-0000,Private      ,0,2,2,3,30,33
02331300,INTERACTIVE LEARNING SYSTEMS            ,TX,75247-0000,Proprietary  ,0,0,0,1,75,76
02331301,INTERACTIVE LEARNING SYSTEMS            ,TX,77081-0000,Proprietary  ,7,75,82,71,448,519
02331303,INTERACTIVE LEARNING SYSTEMS            ,TX,77502-0000,Proprietary  ,4,39,43,28,335,363
02331304,INTERACTIVE LEARNING SYSTEMS            ,TX,77060-0000,Proprietary  ,4,25,29,18,220,238
02341300,PALO ALTO COLLEGE                       ,TX,78224-0000,Public       ,144,151,295,4209,5726,9935
02348500,LAMAR STATE COLLEGE-PORT ARTHUR         ,TX,77640-0000,Public       ,12,33,45,759,1255,2014
02357700,ACADEMY OF HAIR DESIGN                  ,TX,77090-0000,Proprietary  ,4,16,20,127,174,301
02358200,LAMAR STATE COLLEGE-ORANGE              ,TX,77630-0000,Public       ,6,48,54,646,1595,2241
02361400,COLLIN COUNTY COMMUNITY COLLEGE         ,TX,75071-0000,Public       ,83,283,366,4184,5870,10054
02362000,UNIVERSAL TECHNICAL INSTITUTE           ,TX,77073-0000,Proprietary  ,128,139,267,4730,2406,7136
02362800,AUSTIN GRADUATE SCHOOL OF THEOLOGY      ,TX,78752-1333,Private      ,0,1,1,5,58,63
02521200,ARLINGTON CAREER INSTITUTE              ,TX,75050-0000,Proprietary  ,2,28,30,75,489,564
02521800,SEGUIN BEAUTY SCHOOL                    ,TX,78155-0000,Proprietary  ,3,12,15,46,100,146
02527500,HOUSTON TRAINING SCHOOLS                ,TX,77020-0000,Proprietary  ,19,99,118,163,945,1108
02530700,SEBRING CAREER SCHOOLS                  ,TX,77083-1510,Proprietary  ,3,12,15,30,113,143
02539600,ART INSTITUTE OF DALLAS                 ,TX,75231-5993,Proprietary  ,38,57,95,2081,1680,3761
02548800,SOUTH TEXAS VO-TECH INSTITUTE           ,TX,78596-0000,Proprietary  ,70,184,254,572,1798,2370
02548802,SOUTH TEXAS VOCATIONAL TECHNICAL INSTITU,TX,78520-8710,Proprietary  ,1,1,2,19,30,49
02549400,SOUTH TEXAS VO-TECH INSTITUTE           ,TX,78501-0000,Proprietary  ,113,273,386,674,1583,2257
02549402,SOUTH TEXAS VOCATIONAL TECHNICAL INSTITU,TX,78416-1141,Proprietary  ,1,4,5,1,7,8
02555400,UNIV OF TX MD ANDERSON CANCER CTR       ,TX,77030-0000,Public       ,0,7,7,71,241,312
02557400,STAR COLLEGE OF COSMETOLOGY             ,TX,75961-0000,Proprietary  ,0,0,0,2,5,7
02568100,TEXAS BARBER COLLEGES & HAIRSTYLING     ,TX,75208-0000,Proprietary  ,32,166,198,324,1265,1589
02569300,TEXAS CULINARY ACADEMY                  ,TX,78758-3403,Proprietary  ,69,252,321,1439,3168,4607
02572000,COMPUTER CAREER CENTER                  ,TX,79925-2021,Proprietary  ,17,114,131,196,1007,1203
02572004,COMPUTER CAREER CENTER - AMARILLO CAMPUS,TX,79101-2404,Proprietary  ,5,36,41,14,89,103
02572005,COMPUTER CAREER CENTER - LUBBOCK CAMPUS ,TX,79414-3517,Proprietary  ,7,18,25,9,35,44
02572100,"CAREER ACADEMY, INC.                    ",TX,75501-0000,Proprietary  ,0,0,0,10,42,52
02580100,IVERSON BUSINESS SCH & COURT REPORT     ,TX,76011-1344,Proprietary  ,16,68,84,137,629,766
02591100,CAREER POINT INSTITUTE                  ,TX,78201-2027,Proprietary  ,55,340,395,523,3282,3805
02591900,CAREER CENTERS OF TEXAS - EL PASO       ,TX,79907-1525,Proprietary  ,76,215,291,644,1781,2425
02591905,CAREER CENTERS OF TEXAS-BROWNSVILLE     ,TX,78521-9905,Proprietary  ,50,103,153,344,882,1226
02596400,REDSTONE COLLEGE - LOS ANGELES          ,TX,77061-0000,Proprietary  ,13,24,37,300,352,652
02596412,WESTWOOD COLLEGE OF AVIATION TECHNOLOGY ,TX,77061-5114,Proprietary  ,0,0,0,23,34,57
02596500,ATI CAREER TRAINING CENTER              ,TX,76180-1599,Proprietary  ,129,408,537,857,2406,3263
02596600,ATI-CAREER TRAINING CENTER              ,TX,75220-4443,Proprietary  ,90,334,424,870,3189,4059
02596601,ATI CAREER TRAINING CENTER - RICHARDSON ,TX,75081-6745,Proprietary  ,1,0,1,19,42,61
02596602,ATI CAREER TRAINING CENTER - DALLAS (STE,TX,75247-6103,Proprietary  ,0,7,7,0,17,17
02600200,OCEAN CORPORATION (THE)                 ,TX,77099-3479,Proprietary  ,5,24,29,153,656,809
02604700,CENTER FOR ADVANCED LEGAL STUDIES       ,TX,77098-4151,Proprietary  ,2,14,16,26,280,306
02606202,EVEREST COLLEGE - EVEREST INSTITUTE - BI,TX,77036-8014,Proprietary  ,71,204,275,571,1797,2368
02615000,SANFORD-BROWN INSTITUTE                 ,TX,75247-6931,Proprietary  ,46,227,273,627,2380,3007
03009400,SW SCH BUS & TECH CAREERS               ,TX,78212-2840,Proprietary  ,1,12,13,28,124,152
03010000,VANGUARD INSTITUTE OF TECHNOLOGY        ,TX,78539-0000,Proprietary  ,0,0,0,2,1,3
03010604,VIRGINIA COLLEGE - VIRGINIA COLLEGE AT A,TX,78723-0000,Proprietary  ,16,105,121,214,1062,1276
03011800,SAN ANTONIO BEAUTY COLLEGE #4           ,TX,78226-1160,Proprietary  ,0,9,9,37,112,149
03019800,PCI HEALTH TRAINING CENTER              ,TX,75247-4720,Proprietary  ,59,129,188,508,1045,1553
03021500,SW SCH BUS & TECH CAREERS               ,TX,78852-4859,Proprietary  ,2,7,9,50,142,192
03023800,AIMS ACADEMY                            ,TX,75050-0000,Proprietary  ,0,0,0,9,27,36
03025000,TEXAS COLLEGE OF COSMETOLOGY            ,TX,79605-2001,Proprietary  ,4,15,19,65,212,277
03026500,REMINGTON COLLEGE - HOUSTON CAMPUS      ,TX,77082-1849,Proprietary  ,42,194,236,658,2140,2798
03026501,REMINGTON COLLEGE - NORTH HOUSTON CAMPUS,TX,77067-1849,Proprietary  ,1,5,6,44,158,202
03028800,CIRCLE J BEAUTY SCHOOL                  ,TX,77587-3714,Proprietary  ,3,18,21,60,229,289
03031408,INTERNATIONAL ACADEMY OF DESIGN AND TECH,TX,78229-2263,Proprietary  ,20,32,52,349,549,898
03032300,SCHOOL OF AUTOMOTIVE MACHINISTS         ,TX,77055-1803,Proprietary  ,2,5,7,81,125,206
03035200,JONES BEAUTY COLLEGE                    ,TX,75229-3734,Proprietary  ,2,18,20,24,141,165
03035300,SOUTHERN CAREERS INSTITUTE              ,TX,78704-5252,Proprietary  ,72,295,367,671,2281,2952
03035301,SOUTHERN CAREERS INSTITUTE              ,TX,78577-0000,Proprietary  ,29,107,136,279,750,1029
03035302,SOUTHERN CAREERS INSTITUTE - CORPUS CHRI,TX,78414-2904,Proprietary  ,14,50,64,167,501,668
03035303,SOUTHERN CAREERS INSTITUTE - #1         ,TX,78221-4351,Proprietary  ,39,177,216,261,1206,1467
03035304,SOUTHERN CAREERS INSTITUTE-LAREDO       ,TX,78041-0000,Proprietary  ,0,0,0,9,20,29
03035305,SOUTHERN CAREERS INSTITUTE - BROWNSVILLE,TX,78520-8680,Proprietary  ,1,0,1,1,0,1
03035306,SOUTHERN CAREERS INSTITUTE - HARLINGEN  ,TX,78550-7911,Proprietary  ,1,5,6,1,5,6
03035307,SOUTHERN CAREERS INSTITUTE - CORPUS CHRI,TX,78410-1609,Proprietary  ,0,1,1,0,1,1
03061800,STAR COLLEGE OF COSMETOLOGY             ,TX,75702-8214,Proprietary  ,1,14,15,66,157,223
03064600,UNIVERSITY OF TEXAS AT BROWNSVILLE      ,TX,78520-4993,Public       ,65,148,213,6849,7360,14209
03071400,ITT TECHNICAL INSTITUTE                 ,TX,78249-3303,Proprietary  ,27,56,83,456,858,1314
03075400,ICC TECHNICAL INSTITUTE                 ,TX,77004-2930,Private      ,0,10,10,25,90,115
03076403,HIGH-TECH INSTITUTE - DALLAS            ,TX,75038-4201,Proprietary  ,4,12,16,63,102,165
03079201,WESTWOOD COLLEGE OF TECHNOLOGY          ,TX,76180-0000,Proprietary  ,1,20,21,298,535,833
03091200,CAREERS UNLIMITED                       ,TX,75702-7110,Proprietary  ,0,0,0,6,28,34
03103400,SOUTH TEXAS COLLEGE                     ,TX,78501-6699,Public       ,216,417,633,10129,11424,21553
03104700,TEXAS COLLEGE OF COSMETOLOGY            ,TX,76903-4708,Proprietary  ,5,12,17,51,171,222
03108700,ROYAL BEAUTY CAREERS                    ,TX,77069-4611,Proprietary  ,9,34,43,145,428,573
03111000,MID-CITIES BARBER COLLEGE               ,TX,75051-4810,Proprietary  ,6,8,14,53,145,198
03115800,TEXAS CAREERS                           ,TX,78213-3792,Proprietary  ,22,110,132,205,1415,1620
03115802,TEXAS CAREERS - LAREDO                  ,TX,78041-6181,Proprietary  ,19,71,90,158,475,633
03115803,TEXAS CAREERS - BEAUMONT                ,TX,77701-3706,Proprietary  ,25,81,106,210,684,894
03115804,TEXAS CAREERS - LUBBOCK                 ,TX,79401-2601,Proprietary  ,17,115,132,209,877,1086
03128100,ACADEMY OF HEALTH CARE PROFESSIONS      ,TX,77092-8108,Proprietary  ,39,140,179,383,1309,1692
03144300,NATIONAL BEAUTY COLLEGE                 ,TX,75041-3433,Proprietary  ,0,10,10,17,72,89
03153300,AMER COLL OF ACUPUNCTURE & O.M.         ,TX,77063-4104,Proprietary  ,0,9,9,4,109,113
03156400,ACADEMY OF ORIENTAL MEDICINE AT AUSTIN  ,TX,78757-1132,Proprietary  ,0,2,2,7,243,250
03159300,ARLINGTON MEDICAL INSTITUTE             ,TX,76011-2645,Proprietary  ,1,8,9,64,183,247
03170300,TEXAS A&M UNIVERSITY-TEXARKANA          ,TX,75501-0000,Public       ,3,32,35,315,1186,1501
03179500,TEXAS COLG TRADITIONAL CHINESE MED      ,TX,78704-6748,Proprietary  ,0,5,5,4,117,121
03189400,COLLEGE OF SAINT THOMAS MORE            ,TX,76109-2323,Private      ,0,0,0,23,15,38
03237400,FARIS COMPUTER SCHOOL                   ,TX,77627-3829,Proprietary  ,1,4,5,6,45,51
03272300,SOUTHEASTERN CAREER INSTITUTE           ,TX,75234-7288,Proprietary  ,8,49,57,100,522,622
03272301,SOUTHEASTERN CAREER INSTITUTE - MIDLAND ,TX,79703-5531,Proprietary  ,16,94,110,147,633,780
03275300,TOUCH OF CLASS SCHOOL OF COSM           ,TX,75402-6314,Proprietary  ,1,13,14,30,103,133
03276300,ACADEMY OF HAIR DESIGN                  ,TX,75901-4900,Proprietary  ,3,20,23,49,153,202
03277300,ACADEMY OF HAIR DESIGN                  ,TX,77701-4650,Proprietary  ,2,10,12,26,101,127
03303300,NORTHWEST EDUCATIONAL CENTER            ,TX,77092-7055,Proprietary  ,4,54,58,39,421,460
03371300,TONI&GUY HAIRDRESSING ACADEMY           ,TX,75006-2351,Proprietary  ,5,5,10,133,141,274
03372300,NORTHWEST VISTA COLLEGE                 ,TX,78251-4217,Public       ,107,191,298,5668,6215,11883
03396500,TEXAS STATE TECHNICAL COLG/MARSHALL     ,TX,75672-7402,Public       ,8,36,44,374,489,863
03400300,CAREER QUEST                            ,TX,78229-3539,Proprietary  ,5,108,113,44,584,628
03412300,ADVANCED BARBER COLLEGE & HAIR DESI     ,TX,78596-0000,Proprietary  ,0,14,14,37,150,187
03416500,DALLAS NURSING INSTITUTE                ,TX,75243-5502,Proprietary  ,7,68,75,134,1138,1272
03422300,MILAN INSTITUTE                         ,TX,78238-3327,Proprietary  ,40,73,113,451,803,1254
03422400,COLLEGE OF BIBLICAL STUDIES-HOUSTON     ,TX,77036-3211,Private      ,0,16,16,46,557,603
03424400,MEDVANCE INSTITUTE                      ,TX,77057-7386,Proprietary  ,28,138,166,246,999,1245
03424401,MEDVANCE INSTITUTE -                    ,TX,77060-3551,Proprietary  ,0,4,4,46,171,217
03426300,CAREER ADVANCEMENT CENTER               ,TX,78752-1470,Proprietary  ,8,38,46,63,402,465
03480304,MEDVANCE INSTITUTE OF BATON ROUGE - GRAN,TX,75050-2342,Proprietary  ,17,87,104,64,325,389
03509400,CORYELL COSMETOLOGY COLLEGE             ,TX,76528-2036,Proprietary  ,2,3,5,8,27,35
03520300,LUBBOCK HAIR ACADEMY                    ,TX,79410-3524,Proprietary  ,0,7,7,31,93,124
03541300,BEHOLD! BEAUTY ACADEMY                  ,TX,77016-3725,Proprietary  ,0,0,0,3,8,11
03542300,CONCORDE CAREER INSTITUTE               ,TX,76011-4016,Proprietary  ,24,114,138,276,1669,1945
03551400,STATE BEAUTY ACADEMY                    ,TX,75116-3501,Proprietary  ,1,5,6,25,72,97
03556400,KUSSAD INSTITUTE OF COURT REPORTING     ,TX,78704-5712,Proprietary  ,0,0,0,8,40,48
03563300,ACADEMY OF COSEMTOLOGY                  ,TX,78745-2858,Proprietary  ,0,0,0,20,75,95
03573300,AVIATION INSTITUTE OF MAINTENANCE       ,TX,75209-3017,Proprietary  ,14,111,125,176,739,915
03610300,MJ'S BEAUTY ACADEMY INC                 ,TX,75224-4409,Proprietary  ,0,5,5,22,69,91
03612400,VALLEY GRANDE INSTITUTE FOR ACADEMI     ,TX,78596-0000,Private      ,6,36,42,145,619,764
03627300,LAMAR INSTITUTE OF TECHNOLOGY           ,TX,77705-4142,Public       ,11,40,51,1298,1906,3204
03676400,HEALTHY HAIR ACADEMY                    ,TX,75227-0000,Proprietary  ,10,71,81,53,296,349
03680300,JAY'S TECHNICAL INSTITUTE               ,TX,77031-3509,Proprietary  ,1,42,43,37,229,266
03682400,DALLAS BARBER & STYLIST COLLEGE         ,TX,75231-0000,Proprietary  ,3,33,36,58,245,303
03714300,TREND BARBER COLLEGE                    ,TX,77071-2104,Proprietary  ,7,34,41,70,278,348
03723300,CULINARY INST ALAIN & MARIE LENOTRE     ,TX,77022-4322,Proprietary  ,5,14,19,112,216,328
03727600,CULINARY ACADEMY OF AUSTIN              ,TX,78752-0000,Proprietary  ,1,3,4,83,124,207
03733300,BAPTIST UNIVERSITY OF THE AMERICAS      ,TX,78224-1336,Private      ,0,6,6,70,202,272
03756300,ANAMARC EDUCATIONAL INSTITUTE           ,TX,79930-6230,Proprietary  ,9,88,97,135,856,991
03885400,COMPUTER LABS                           ,TX,79906-5924,Proprietary  ,0,0,0,2,7,9
03885700,HOUSTON'S TRAINING AND EDUCATION CENTER ,TX,77036-2021,Proprietary  ,5,32,37,12,134,146
03922300,SOUTH TEXAS BARBER COLLEGE              ,TX,78415-3463,Proprietary  ,1,4,5,22,65,87
03926300,AMESED                                  ,TX,75081-0000,Proprietary  ,0,0,0,11,26,37
03944400,PROFESSIONAL CAREERS INSTITUTE          ,TX,77036-2252,Proprietary  ,0,12,12,23,133,156
03970300,HANDS ON THERAPY                        ,TX,75149-2294,Proprietary  ,7,30,37,19,78,97
03984300,ALLIED CAREER CENTER                    ,TX,75007-0000,Proprietary  ,0,0,0,1,6,7
03987300,TEXAS HEALTH SCHOOL                     ,TX,77079-2106,Proprietary  ,2,23,25,55,222,277
04036300,SOUTHEAST TEXAS CAREER INSTITUTE        ,TX,77656-8601,Proprietary  ,5,6,11,37,94,131
04045300,NORTHWEST BEAUTY SCHOOL                 ,TX,77091-1208,Proprietary  ,2,8,10,15,73,88
04045400,MAI-TRIX BEAUTY COLLEGE                 ,TX,77040-0000,Proprietary  ,1,3,4,22,73,95
04089400,CCI TRAINING CENTER                     ,TX,76011-4857,Proprietary  ,2,43,45,31,307,338
04117900,CHAMPION BEAUTY COLLEGE                 ,TX,77069-4611,Proprietary  ,0,6,6,26,94,120
04122100,BENCHMARK CAREER INSTITUTE              ,TX,75080-7426,Proprietary  ,0,0,0,0,2,2
04125400,ACADEMY AT AUSTIN (THE)                 ,TX,78660-3287,Proprietary  ,2,6,8,92,165,257
04125500,MANUEL AND THERESA'S SCHOOL OF HAIR DESI,TX,77803-3236,Proprietary  ,0,1,1,22,33,55
04129800,MEDIATECH INSTITUTE DALLAS              ,TX,75039-3105,Proprietary  ,2,6,8,78,112,190
04129801,MEDIATECH INSTITUTE AUSTIN              ,TX,78704-8933,Proprietary  ,0,2,2,27,34,61
04129802,MEDIATECH INSTITUTE HOUSTON             ,TX,77042-4712,Proprietary  ,6,12,18,32,55,87
04131700,SOUTHWEST CAREER INSTITUTE              ,TX,79925-6230,Proprietary  ,27,103,130,185,488,673
04136500,PCCENTER                                ,TX,75115-4214,Proprietary  ,1,7,8,3,35,38
04142300,AVEDA INSTITUTE SAN ANTONIO             ,TX,78215-1260,Proprietary  ,4,21,25,41,92,133
04146600,360 DEGREES BEAUTY ACADEMY              ,TX,77084-2714,Proprietary  ,0,9,9,1,21,22
00367000,BRIGHAM YOUNG UNIVERSITY                ,UT,84602-8406,Private      ,180,341,521,10220,12447,22667
00367100,DIXIE STATE COLLEGE OF UTAH             ,UT,84770-3876,Public       ,29,99,128,2056,2842,4898
00367200,LDS BUSINESS COLLEGE                    ,UT,84101-3500,Private      ,8,13,21,509,519,1028
00367400,STEVENS HENAGER COLLEGE                 ,UT,84401-1420,Proprietary  ,103,651,754,890,4978,5868
00367500,UNIVERSITY OF UTAH                      ,UT,84112-9055,Public       ,82,300,382,7926,13597,21523
00367600,COLLEGE OF EASTERN UTAH                 ,UT,84501-2699,Public       ,8,44,52,686,736,1422
00367700,UTAH STATE UNIVERSITY                   ,UT,84322-1400,Public       ,64,222,286,6298,8798,15096
00367800,SOUTHERN UTAH UNIVERSITY                ,UT,84720-2470,Public       ,18,108,126,3166,2747,5913
00367900,SNOW COLLEGE                            ,UT,84627-1299,Public       ,7,18,25,1587,691,2278
00368000,WEBER STATE UNIVERSITY                  ,UT,84408-1136,Public       ,66,271,337,4302,9381,13683
00368100,WESTMINSTER COLLEGE                     ,UT,84105-3697,Private      ,11,54,65,1666,1522,3188
00402700,UTAH VALLEY UNIVERSITY                  ,UT,84058-5999,Public       ,147,497,644,6597,12875,19472
00522000,SALT LAKE COMMUNITY COLLEGE             ,UT,84123-0000,Public       ,224,646,870,5668,12014,17682
00943300,SHERMAN KENDALL'S ACADEMY OF BEAUTY     ,UT,84106-1836,Proprietary  ,2,5,7,29,64,93
01009800,NEUMONT UNIVERSITY                      ,UT,84095-0000,Proprietary  ,3,1,4,327,227,554
01116500,UINTAH BASIN APPLIED TECHNOLOGY CLG     ,UT,84066-0000,Public       ,0,10,10,6,66,72
01116600,UTAH CAREER COLLEGE                     ,UT,84088-4021,Proprietary  ,17,50,67,453,1385,1838
02078800,SHERMAN KENDALL'S ACADEMY OF BEAUTY     ,UT,84047-0000,Proprietary  ,2,1,3,17,32,49
02115400,BRIDGERLAND APPLIED TECHNOLOGY COLLEGE  ,UT,84321-0000,Public       ,10,33,43,159,639,798
02156600,DAVIS APPLIED TECHNOLOGY COLLEGE        ,UT,84037-0000,Public       ,8,35,43,214,946,1160
02178500,EAGLE GATE COLLEGE                      ,UT,84123-0000,Proprietary  ,14,73,87,321,1327,1648
02270800,AMERITECH COLLEGE                       ,UT,84604-6927,Proprietary  ,8,26,34,68,381,449
02270802,AMERITECH COLLEGE - DRAPER              ,UT,84020-6545,Proprietary  ,2,4,6,14,120,134
02298500,EVEREST COLLEGE                         ,UT,84119-2668,Proprietary  ,12,68,80,182,853,1035
02346500,OGDEN-WEBER APPLIED TECHNOLOGY COLG     ,UT,84404-0000,Public       ,8,53,61,195,1111,1306
02360800,PROVO COLLEGE                           ,UT,84601-0000,Proprietary  ,19,52,71,294,733,1027
02361000,ITT TECHNICAL INSTITUTE                 ,UT,84123-0000,Proprietary  ,14,85,99,232,954,1186
02504000,MARINELLO SCHOOL OF BEAUTY              ,UT,84041-0000,Proprietary  ,5,12,17,57,126,183
02516100,STACEY'S HANDS OF CHAMPIONS BTY CLG     ,UT,84405-0000,Proprietary  ,4,11,15,50,132,182
02531800,VON CURTIS ACADEMY OF HAIR DESIGN       ,UT,84606-0000,Proprietary  ,43,53,96,902,945,1847
02556800,HAIRITAGE COLLEGE OF BEAUTY             ,UT,84117-7204,Proprietary  ,16,22,38,118,148,266
02557700,PREMIER HAIR ACADEMY                    ,UT,84120-3603,Proprietary  ,2,7,9,12,58,70
02572700,EVANS HAIRSTYLING COLLEGE               ,UT,84770-0000,Proprietary  ,0,1,1,18,33,51
02572800,VISTA COLLEGE                           ,UT,84015-0000,Proprietary  ,3,21,24,24,119,143
02572801,CERTIFIED CAREERS INSTITUTE             ,UT,84015-0000,Proprietary  ,0,0,0,23,139,162
02573100,EVANS HAIRSTYLING COLLEGE               ,UT,84720-0000,Proprietary  ,0,2,2,27,36,63
02612200,MARINELLO SCHOOL OF BEAUTY              ,UT,84604-1585,Proprietary  ,4,5,9,87,77,164
03030600,UTAH COLLEGE OF MASSAGE THERAPY         ,UT,84111-1606,Proprietary  ,38,76,114,453,683,1136
03030601,UTAH CLG OF MASSAGE THER-PROVO CMPS     ,UT,84042-0000,Proprietary  ,5,12,17,136,206,342
03082100,MYOTHERAPY COLLEGE OF UTAH              ,UT,84115-2522,Proprietary  ,1,9,10,22,98,120
03108200,ECHELON EDGE ACADEMY OF HAIR SKIN & NAIL,UT,84070-2004,Proprietary  ,8,7,15,29,61,90
03110400,HAIRITAGE HAIR ACADEMY                  ,UT,84770-5233,Proprietary  ,0,3,3,20,41,61
03339400,WESTERN GOVERNORS UNIVERSITY            ,UT,84107-2533,Private      ,23,1021,1044,386,16432,16818
03413300,MOUNTAINLAND APPLIED TECHNOLOGY COLLEGE ,UT,84058-5857,Public       ,2,9,11,58,188,246
03463300,CAREERS UNLIMITED                       ,UT,84058-0000,Proprietary  ,0,3,3,39,90,129
03617300,HEALING MOUNTAIN MASSAGE SCHOOL         ,UT,84111-3232,Proprietary  ,1,1,2,21,57,78
03829500,SKINWORKS SCHOOL OF ADVANCED SKINCARE   ,UT,84115-0000,Proprietary  ,2,5,7,26,71,97
03838300,OGDEN INSTITUTE OF MASSAGE THERAPY      ,UT,84403-0000,Proprietary  ,0,1,1,14,41,55
03902300,RENAISSANCE SCHOOL OF THERAPEUTIC MASSAG,UT,84010-2835,Proprietary  ,1,0,1,5,13,18
03909300,MAXIMUM STYLE TEC SCHOOL OF COSMETOLOGY ,UT,84323-4679,Proprietary  ,2,4,6,21,50,71
03921300,CAMEO COLLEGE OF ESSENTIAL BEAUTY       ,UT,84115-0000,Proprietary  ,2,11,13,95,245,340
04054300,SOUTHWEST APPLIED TECHNOLOGY COLLEGE    ,UT,84720-6608,Public       ,1,7,8,17,88,105
04072300,DALLAS ROBERTS ACADEMY OF HAIR DESIGN & ,UT,84604-1008,Proprietary  ,1,1,2,50,56,106
04118100,IMAGEWORKS ACADEMY OF HAIR DESIGN       ,UT,84660-1210,Proprietary  ,1,8,9,26,54,80
04121700,DIXIE APPLIED TECHNOLOGY COLLEGE        ,UT,84770-3025,Public       ,1,11,12,176,172,348
04142100,SKIN INSTITUTE (THE)                    ,UT,84770-6452,Proprietary  ,1,3,4,1,3,4
04145500,SKIN SCIENCE INSTITUTE (THE)            ,UT,84115-0000,Proprietary  ,3,2,5,8,14,22
00368200,BENNINGTON COLLEGE                      ,VT,05201-6001,Private      ,2,0,2,971,294,1265
00368300,CASTLETON STATE COLLEGE                 ,VT,05735-0000,Public       ,2,4,6,2700,385,3085
00368400,CHAMPLAIN COLLEGE                       ,VT,05401-3950,Private      ,2,27,29,3190,829,4019
00368402,WOODBURY COLLEGE                        ,VT,05602-0000,Private      ,0,1,1,9,183,192
00368500,COLLEGE OF ST JOSEPH                    ,VT,05701-3899,Private      ,1,6,7,186,239,425
00368600,GODDARD COLLEGE                         ,VT,05667-0000,Private      ,0,6,6,95,963,1058
00368700,GREEN MOUNTAIN COLLEGE                  ,VT,05764-1199,Private      ,2,2,4,1243,181,1424
00368800,JOHNSON STATE COLLEGE                   ,VT,05656-9898,Public       ,0,4,4,1448,945,2393
00368900,LYNDON STATE COLLEGE                    ,VT,05851-0919,Public       ,5,0,5,1638,310,1948
00369000,MARLBORO COLLEGE                        ,VT,05344-0300,Private      ,0,3,3,478,104,582
00369100,MIDDLEBURY COLLEGE                      ,VT,05753-0000,Private      ,4,9,13,3566,485,4051
00369106,MIDDLEBURY COLLEGE - BREAD LOAF SCHOOL O,VT,05753-0000,Private      ,0,0,0,0,3,3
00369200,NORWICH UNIVERSITY                      ,VT,05663-1035,Private      ,6,37,43,2609,1873,4482
00369300,SOUTHERN VERMONT COLLEGE                ,VT,05201-6002,Private      ,1,0,1,582,166,748
00369400,ST MICHAELS COLLEGE                     ,VT,05439-0001,Private      ,2,0,2,3394,201,3595
00369600,UNIVERSITY OF VERMONT                   ,VT,05405-0160,Public       ,10,38,48,15941,2704,18645
00369800,VERMONT TECHNICAL COLLEGE               ,VT,05061-0000,Public       ,3,6,9,1189,618,1807
00857500,SALON PROFESSIONAL ACADEMY (THE)        ,VT,05495-4001,Proprietary  ,0,1,1,64,67,131
00865800,O'BRIEN'S TRAINING CENTER               ,VT,05403-7747,Proprietary  ,0,3,3,24,44,68
00886000,SIT                                     ,VT,05301-4801,Private      ,0,6,6,18,568,586
01116700,COMMUNITY COLLEGE OF VERMONT            ,VT,05676-1552,Public       ,10,48,58,1557,3688,5245
01193400,VERMONT LAW SCHOOL                      ,VT,05068-0000,Private      ,0,2,2,1,1059,1060
01218300,BURLINGTON COLLEGE                      ,VT,05401-8477,Private      ,1,0,1,138,128,266
02143500,STERLING COLLEGE                        ,VT,05827-0000,Private      ,0,0,0,140,28,168
02254000,NEW ENGLAND CULINARY INSTITUTE          ,VT,05602-0000,Proprietary  ,3,6,9,533,368,901
02532600,LANDMARK COLLEGE                        ,VT,05346-0000,Private      ,2,0,2,386,39,425
03708300,BURLINGTON TECHNICAL CENTER             ,VT,05401-2721,Public       ,0,0,0,7,9,16
00392800,CASPER COLLEGE                          ,WY,82601-4612,Public       ,10,43,53,1170,1220,2390
00392900,EASTERN WYOMING COLLEGE                 ,WY,82240-1603,Public       ,1,9,10,382,315,697
00393000,SHERIDAN COLLEGE                        ,WY,82801-9133,Public       ,2,9,11,731,753,1484
00393100,NORTHWEST COLLEGE                       ,WY,82435-1895,Public       ,5,12,17,801,550,1351
00393200,UNIVERSITY OF WYOMING                   ,WY,82071-3663,Public       ,27,80,107,5975,4148,10123
00393300,WESTERN WYOMING COMMUNITY COLLEGE       ,WY,82902-0000,Public       ,4,6,10,725,803,1528
00728900,CENTRAL WYOMING COLLEGE                 ,WY,82501-0000,Public       ,8,38,46,486,703,1189
00915700,WYOMING TECHNICAL INSTITUTE             ,WY,82072-9519,Proprietary  ,6,4,10,4023,1740,5763
00925900,LARAMIE COUNTY COMMUNITY CLG            ,WY,82007-3299,Public       ,13,42,55,1142,1782,2924
02211900,CHEEKS INTERNATIONAL ACDMY              ,WY,82001-0000,Proprietary  ,2,13,15,75,182,257
03291300,BUSINESS SKILLS INSTITUTE A DEPARTMENT O,WY,82930-0000,Public       ,0,0,0,3,5,8
00393500,UNIV OF GUAM                            ,GU,96923-0000,Public       ,45,45,90,1853,1410,3263
01536100,GUAM COMMUNITY COLLEGE                  ,GU,96921-0000,Public       ,10,19,29,858,1108,1966
03438300,PACIFIC ISLANDS BIBLE COLLEGE           ,GU,96913-2619,Private      ,4,3,7,131,78,209
00393600,PONTIFICAL CATHOLIC UNIV OF PR          ,PR,00717-0777,Private      ,19,13,32,5193,4881,10074
00393700,UNIVERSITY OF THE SACRED HEART          ,PR,00914-0383,Private      ,7,26,33,3269,2127,5396
00393800,INTER-AMER UNIV PR-CNTRL ADMN           ,PR,00936-0000,Private      ,7,29,36,3690,6888,10578
00393801,INTER-AMER UNIV PR SCHL LAW             ,PR,00936-8351,Private      ,0,1,1,17,345,362
00393802,INTER AMERICAN UNIVERSITY OF PUERTO RICO,PR,00926-0000,Private      ,4,4,8,71,236,307
00393803,INTER AMERICAN UNIVERSITY OF PR         ,PR,00683-0000,Private      ,17,13,30,3849,2253,6102
00393804,INTER-AMER UNIV PR-RECINTO AGUADILA     ,PR,00605-2000,Private      ,5,21,26,2583,2580,5163
00393805,INTER-AMER UNIV PR-ARECIBO CAMPUS       ,PR,00614-4050,Private      ,3,15,18,2927,2675,5602
00393806,INTER-AMER UNIV PR-BARRANQUITAS REG     ,PR,00794-0517,Private      ,156,29,185,1739,1219,2958
00393807,INTER-AMER UNIV PR-FAJARDO REGIONAL     ,PR,00738-0000,Private      ,2,16,18,1282,1255,2537
00393808,INTER-AMER UNIV PR - GUAYAMA CAMPUS     ,PR,00785-4004,Private      ,64,27,91,1236,1515,2751
00393809,INTER-AMER UNIV PR-PONCE REGIONAL       ,PR,00715-0000,Private      ,4,13,17,3533,3599,7132
00393810,INTER-AMER UNIV PR - SCH OF OPTOMETRY   ,PR,00918-0000,Private      ,0,0,0,5,59,64
00393811,INTER-AMER UNIV PR-BAYAMON REG CLG      ,PR,00959-0000,Private      ,10,13,23,4250,2007,6257
00394100,COLEGIO UNIVERSITARIO DEL ESTE          ,PR,00983-0000,Private      ,31,162,193,5785,8998,14783
00394200,UNIVERSITY OF PR-CENTRAL ADMINISTRATION ,PR,00936-4984,Public       ,1,3,4,742,381,1123
00394201,UNIVERSITY OF PR-RIO PIEDRAS CAMPUS     ,PR,00931-3300,Public       ,16,15,31,8876,2739,11615
00394202,UNIV OF PUERTO RICO-MAYAGUEZ CAMPUS     ,PR,00681-5000,Public       ,14,2,16,9146,1664,10810
00394203,"UNIVERSITY OF PR, MED. SCIENCES CAMPUS  ",PR,00936-5067,Public       ,0,6,6,496,1369,1865
00394204,"UNIVERSITY OF PUERTO RICO, CAYEY CAMPUS ",PR,00736-0000,Public       ,6,5,11,3007,576,3583
00394205,"UNIVERSITY OF PR, HUMACAO CAMPUS        ",PR,00791-4057,Public       ,2,0,2,3536,626,4162
00394206,UNIVERSITY OF PR-AGUADILLA CAMPUS       ,PR,00604-6150,Public       ,4,1,5,2588,528,3116
00394207,UNIVERSITY OF PUERTO RICO-ARECIBO CAMPUS,PR,00614-0000,Public       ,9,0,9,3707,543,4250
00394208,UNIVERSITY OF PUERTO RICO-BAYAMON CAMPUS,PR,00959-0000,Public       ,6,0,6,3848,575,4423
00394209,UNIVERSITY OF PUERTO RICO-CAROLINA      ,PR,00984-4800,Public       ,23,10,33,3225,554,3779
00394210,UNIVERSITY OF PUERTO RICO-PONCE         ,PR,00732-0000,Public       ,7,0,7,3050,447,3497
00394211,"UNIVERSITY OF PR, UTUADO CAMPUS         ",PR,00641-0000,Public       ,1,3,4,1489,273,1762
00501900,UNIV ADVENTISTA DE LAS ANTILLAS         ,PR,00681-0118,Private      ,8,11,19,557,373,930
00502200,BAYAMON CENTRAL UNIVERSITY              ,PR,00960-0000,Private      ,22,13,35,982,1310,2292
00890200,COLUMBIA CENTRO UNIVERSITARIO           ,PR,00726-0000,Proprietary  ,30,113,143,694,1361,2055
01056700,COLEGIO TECNOLOGICO DE SAN JUAN         ,PR,00918-2973,Public       ,7,8,15,624,860,1484
01072400,CARLOS ALBIZU UNIVERSITY                ,PR,00902-3711,Private      ,0,5,5,91,737,828
01081900,CONSERVATORIO DE MUSICA DE PUERTO RICO  ,PR,00907-3373,Public       ,2,0,2,269,90,359
01120300,RYDER MEMORIAL HOSP SCH OF NURSING      ,PR,00792-0000,Private      ,0,0,0,14,24,38
01171900,UNIVERSIDAD DEL TURABO                  ,PR,00778-0000,Private      ,26,127,153,7234,11287,18521
01194000,ICPR JUNIOR COLLEGE                     ,PR,00919-0000,Proprietary  ,80,151,231,1018,1485,2503
01194100,AMERICAN UNIVERSITY OF PUERTO RICO      ,PR,00960-2037,Private      ,40,18,58,984,828,1812
01194101,AMERICAN UNIVERSITY OF PUERTO RICO      ,PR,00674-0000,Private      ,37,19,56,796,793,1589
01252500,CARIBBEAN UNIVERSITY                    ,PR,00960-0493,Private      ,10,48,58,2359,3558,5917
01314800,RAMIREZ COLLEGE OF BUS & TECH           ,PR,00918-0000,Proprietary  ,19,49,68,291,602,893
02063100,MBTI BUSINESS TRNG INSTITUTE            ,PR,00907-3917,Proprietary  ,5,15,20,345,757,1102
02100000,POLYTECHNIC UNIVERSITY OF PR            ,PR,00917-0000,Private      ,9,20,29,3152,2325,5477
02163300,UNIVERSIDAD CENTRAL DEL CARIBE          ,PR,00960-0000,Private      ,2,2,4,139,447,586
02165100,EDP COLLEGE OF PUERTO RICO              ,PR,00919-0000,Proprietary  ,42,72,114,860,1660,2520
02166400,INSTITUTO DE BANCA Y COMERCIO           ,PR,00925-0000,Proprietary  ,224,342,566,9442,12067,21509
02170300,INST EDUC TECNIA OCUP LA REINA          ,PR,00674-0000,Proprietary  ,2,6,8,351,463,814
02170301,INST EDUC TECNICA OCUPLA LA REINA       ,PR,00603-0000,Proprietary  ,0,0,0,2,0,2
02189100,CENTRO DE ESTUDIOS MULTIDISCIPLIN       ,PR,00926-0000,Private      ,86,191,277,1260,1783,3043
02189300,EMMA'S BEAUTY ACADEMY                   ,PR,00680-0000,Proprietary  ,7,12,19,244,259,503
02195400,MODERN HAIRSTYLING INSTITUTE            ,PR,00960-0000,Proprietary  ,33,40,73,585,590,1175
02195500,MODERN HAIRSTYLING INSTITUTE            ,PR,00612-0000,Proprietary  ,0,0,0,6,1,7
02195800,LICEO E ARTE Y TECNOLGIA                ,PR,00919-0000,Private      ,10,52,62,803,698,1501
02195900,MODERN HAIRSTYLING INSTITUTE            ,PR,00980-0000,Proprietary  ,0,1,1,6,6,12
02234900,ANTILLES SCHOOL OF TECH CAREERS         ,PR,00909-0000,Proprietary  ,6,22,28,138,255,393
02241901,COMMONWEALTH OF PR DEPT OF EDUC - CARLOS,PR,00986-0000,Public       ,0,0,0,37,44,81
02241902,COMMONWEALTH OF PR DEPT OF EDUC - TOMAS ,PR,00613-0000,Public       ,0,0,0,13,17,30
02241904,COMMONWEALTH OF PR DEPT OF EDUC - ITPR R,PR,00655-0000,Public       ,0,0,0,539,276,815
02241905,COMMONWEALTH OF PR DEPT OF EDUC - JOSE A,PR,00674-0000,Public       ,0,0,0,568,137,705
02241907,COMMONWEALTH OF PR DEPT OF EDUC - ITPR R,PR,00928-0000,Public       ,0,0,0,505,206,711
02241908,COMMONWEALTH OF PR DEPT OF EDUC - ITPR R,PR,00732-0000,Public       ,0,1,1,550,249,799
02241909,COMMONWEALTH OF PR DEPT OF EDUC - TROQUE,PR,00959-0000,Public       ,0,0,0,36,6,42
02241910,COMMONWEALTH OF PR DEPT OF EDUC - ITPR R,PR,00701-1091,Public       ,0,0,0,425,139,564
02260600,NATIONAL COLLEGE OF BUSINESS & TECH     ,PR,00960-2036,Proprietary  ,25,43,68,3739,4859,8598
02260601,NATIONAL COLLEGE OF BUSINESS & TECHNOLOG,PR,00612-0000,Proprietary  ,2,0,2,54,29,83
02260602,NATIONAL COLLEGE OF BUSINESS & TECHNOLOG,PR,00745-9903,Proprietary  ,0,1,1,20,15,35
02260800,HUERTAS JUNIOR COLLEGE                  ,PR,00726-0000,Proprietary  ,30,101,131,1159,1530,2689
02297700,AUTOMECA TECHNICAL COLLEGE              ,PR,00957-0000,Proprietary  ,1,2,3,1204,767,1971
02303800,AMERICAN EDUCATIONAL COLLEGE            ,PR,00961-0000,Proprietary  ,32,50,82,580,880,1460
02335500,COLEGIO BIBLICO PENTECOSTAL DE PR       ,PR,00978-0000,Private      ,0,0,0,18,150,168
02340600,HUMACAO COMMUNITY COLLEGE               ,PR,00792-0000,Private      ,19,29,48,411,528,939
02343600,INSTITUTE OF BEAUTY CAREERS             ,PR,00613-0000,Proprietary  ,11,24,35,368,546,914
02482400,PONCE SCHOOL OF MEDICINE                ,PR,00716-2347,Private      ,0,2,2,17,636,653
02502400,SERBIA'S SCHOOL OF BEAUTY CULTURE       ,PR,00785-0000,Proprietary  ,10,16,26,234,281,515
02504500,INSTITUCION CHAVIANO DE MAYAGUEZ        ,PR,00708-0000,Proprietary  ,0,13,13,29,196,225
02505400,ATLANTIC COLLEGE                        ,PR,00970-0000,Private      ,4,15,19,928,508,1436
02534900,PONCE PARAMEDICAL COLLEGE (POPAC)       ,PR,00731-0000,Proprietary  ,43,72,115,2135,1768,3903
02549700,ACADEMIA MAISON D'ESTHETIQUE            ,PR,00907-0000,Proprietary  ,2,8,10,146,312,458
02552300,COLEGIO MAYOR DE TECHNOLOGIA            ,PR,00714-0000,Proprietary  ,3,14,17,288,368,656
02562500,INTERNATIONAL TECHNICAL COLLEGE         ,PR,00918-0000,Proprietary  ,5,23,28,66,167,233
02563500,ROGIES SCHOOL OF BEAUTY CULTURE         ,PR,00910-0000,Proprietary  ,10,31,41,155,222,377
02566800,PUERTO RICO TECH JUNIOR COLLEGE         ,PR,00917-0000,Proprietary  ,0,0,0,4,2,6
02569400,ESCUELA DE ARTES PLASTICAS              ,PR,00902-1112,Public       ,1,0,1,334,165,499
02570400,EDUCATIONAL TECHNICAL COLLEGE           ,PR,00925-3404,Proprietary  ,21,45,66,536,1011,1547
02576100,ESCUELA TECNICA DE ELECTRICIDAD         ,PR,00731-0000,Proprietary  ,9,22,31,389,441,830
02587500,UNIVERSIDAD METROPOLITANA               ,PR,00928-1150,Private      ,18,199,217,5002,9275,14277
02588600,SEMINARIO EVANGELICO DE PUERTO RICO     ,PR,00925-0000,Private      ,0,0,0,1,39,40
02593700,HISPANIC AMERICAN COLLEGE               ,PR,00725-0000,Proprietary  ,7,16,23,154,223,377
02611100,INSTITUTO MERLIX                        ,PR,00961-0000,Proprietary  ,3,3,6,78,197,275
03021900,EDIC COLLEGE                            ,PR,00726-0000,Proprietary  ,5,8,13,665,978,1643
03025500,MECH TECH COLLEGE                       ,PR,00725-6118,Proprietary  ,107,157,264,2655,1410,4065
03025900,"LICEO DE ARTE, DISENOS Y COMERCIO       ",PR,00726-0000,Proprietary  ,9,27,36,353,553,906
03029700,"UNIVERSAL TECHNOLOGY CLG OF PR, INC     ",PR,00605-1955,Private      ,15,40,55,814,1519,2333
03061900,COLEGIO TECHNOLOGICO Y COMERCIAL        ,PR,00602-0000,Proprietary  ,2,3,5,26,71,97
03068400,STAR BEAUTY ACADEMY                     ,PR,00961-6312,Proprietary  ,3,4,7,58,94,152
03070500,D'MART INSTITUTE                        ,PR,00794-3517,Proprietary  ,33,75,108,972,1182,2154
03075600,EMMA'S BEAUTY ACADEMY                   ,PR,00795-0000,Proprietary  ,22,13,35,321,287,608
03076000,PUERTO RICO BARBER COLLEGE              ,PR,00738-4632,Proprietary  ,0,0,0,32,95,127
03085700,PROFESSIONAL TECHNICAL INSTITUTION      ,PR,00960-7061,Proprietary  ,4,14,18,291,225,516
03104400,PROFESSIONAL ELECTRIC SCHOOL            ,PR,00674-1797,Proprietary  ,0,0,0,74,75,149
03106900,ESCUELA DE PERITOS ELECTRICITAS         ,PR,00662-0457,Proprietary  ,0,0,0,30,69,99
03112100,JOHN DEWEY COLLEGE                      ,PR,00915-9538,Private      ,226,480,706,2617,5077,7694
03112101,JOHN DEWEY COLLEGE                      ,PR,00986-0000,Private      ,53,60,113,678,859,1537
03112102,JOHN DEWEY COLLEGE-BAYAMON CAMPUS       ,PR,00959-0000,Private      ,73,135,208,478,785,1263
03112104,JOHN DEWEY COLLEGE - YABUCOA LRNING SITE,PR,00767-0767,Private      ,8,22,30,134,301,435
03112105,JOHN DEWEY COLLEGE - FAJARDO BRANCH     ,PR,00738-0738,Private      ,18,57,75,204,334,538
03112106,JOHN DEWEY COLLEGE - ARROYO BRANCH      ,PR,00714-0714,Private      ,26,33,59,170,300,470
03112107,JOHN DEWEY COLLEGE - JUANA DIAZ BRANCH  ,PR,00795-0000,Private      ,9,31,40,270,424,694
03115900,TRINITY COLLEGE OF PUERTO RICO          ,PR,00734-0000,Private      ,1,13,14,101,192,293
03122500,ACADEMIA SERRANT INC.                   ,PR,00717-1568,Proprietary  ,8,26,34,125,291,416
03123100,GLOBELLE TECHNICAL INSTITUTE            ,PR,00693-4218,Proprietary  ,9,12,21,63,85,148
03124200,NOVA COLLEGE DE PUERTO RICO             ,PR,00960-4016,Proprietary  ,10,19,29,108,353,461
03157600,"COLEGIO DE CINEMATOGRAFIA, ARTES Y TELEV",PR,00961-6345,Proprietary  ,12,23,35,367,208,575
03177300,SAN JUAN BAUTISTA SCH OF MEDICINE       ,PR,00726-0000,Private      ,0,1,1,2,286,288
03326300,UNIVERSAL CAREER COMMUNITY COLLEGE      ,PR,00907-0000,Proprietary  ,34,58,92,489,793,1282
03336300,CENTURY COLLEGE                         ,PR,00603-4802,Proprietary  ,6,23,29,116,185,301
03414300,MONTECLARO                              ,PR,00745-9612,Private      ,0,0,0,8,0,8
03452300,INSTITUTO PRE-VOCACIONAL E INDUSTRI     ,PR,00613-1800,Private      ,3,10,13,49,133,182
03469300,IVAEM COLLEGE                           ,PR,00725-0000,Proprietary  ,4,1,5,134,75,209
03531300,COLEGIO PENTECOSTAL MIZPA               ,PR,00928-0966,Private      ,0,0,0,13,232,245
03544300,ATENAS COLLEGE                          ,PR,00674-0000,Private      ,33,85,118,731,1251,1982
03552300,LESTON COLLEGE                          ,PR,00961-6309,Proprietary  ,8,17,25,88,182,270
03608300,CARIBBEAN FORENSIC & TECHNICAL COLL     ,PR,00926-0000,Proprietary  ,2,7,9,54,111,165
03638300,ROSSLYN TRAINING ACADEMY OF COSMETOLOGY ,PR,00602-3225,Proprietary  ,3,3,6,8,30,38
03735400,"CHARLIES GUARD,DETECTIVE BUREAU&ACA     ",PR,00605-0000,Proprietary  ,5,17,22,81,166,247
03751300,ESCUELA HOTELERA DE SAN JUAN            ,PR,00917-0091,Proprietary  ,7,5,12,416,268,684
03758300,BAYAMON COMMUNITY COLLEGE               ,PR,00960-0000,Proprietary  ,10,8,18,85,232,317
03781400,INDUSTRIAL TECHNICAL COLLEGE            ,PR,00792-0000,Proprietary  ,6,13,19,120,187,307
03785300,J.G. GUAYNABO TECHNICAL COLLEGE         ,PR,00960-0000,Proprietary  ,0,2,2,22,55,77
03800300,COLEGIO TECNICO DE ELECTRICIDAD GALLOSA ,PR,00602-0000,Proprietary  ,5,6,11,32,68,100
03800400,INSTITUTE OF BEAUTY OCCUPATIONS AND TECH,PR,00676-5071,Proprietary  ,8,7,15,73,135,208
03843300,ADVANCED TECH COLLEGE                   ,PR,00961-6321,Proprietary  ,5,23,28,35,188,223
03849300,AGUADILLA TECHNICAL COLLEGE             ,PR,00603-0000,Proprietary  ,0,0,0,16,46,62
03965400,MYRANGEL BEAUTY INSTITUTE               ,PR,00754-3917,Proprietary  ,10,33,43,74,169,243
04030300,ASPIRA  DE PUERTO RICO                  ,PR,00987-0000,Private      ,0,0,0,1,20,21
04107300,CARIB TECHNOLOGICAL INSTITUTE           ,PR,00960-0000,Proprietary  ,18,11,29,65,94,159
04117200,INSTITUTO EDUCATIVO PREMIER             ,PR,00731-0000,Proprietary  ,9,29,38,43,128,171
00394600,UNIVERSITY OF THE VIRGIN ISLANDS        ,VI,00802-6000,Public       ,1,4,5,939,704,1643
00394601,UNIV OF THE VIRGIN ISLANDS-ST CROIX     ,VI,00850-0000,Public       ,3,6,9,422,440,862
00667400,CANADIAN THEOLOGICAL SEMINARY           ,CN,00000-0000,Private      ,0,0,0,2,0,2
00667700,MCGILL UNIVERSITY                       ,CN,00000-0000,Public       ,2,2,4,1760,373,2133
00667900,QUEEN'S UNIVERSITY AT KINGSTON          ,CN,00000-0000,Public       ,0,0,0,115,27,142
00668100,ST FRANCIS XAVIER UNIVERSITY            ,CN,00000-0000,Public       ,1,0,1,37,10,47
00668200,ST THOMAS UNIVERSITY                    ,CN,00000-0000,Public       ,3,0,3,17,2,19
00668300,UNIVERSITY OF GUELPH                    ,CN,00000-0000,Public       ,1,0,1,36,50,86
00668400,UNIVERSITY OF MANITOBA                  ,CN,00000-0000,Public       ,0,0,0,18,21,39
00668500,UNIVERSITY OF NEW BRUNSWICK (THE)       ,CN,00000-0000,Public       ,0,0,0,14,20,34
00668600,UNIVERSITY OF OTTAWA                    ,CN,00000-0000,Public       ,2,0,2,39,25,64
00668800,UNIVERSITY OF TORONTO                   ,CN,00000-0000,Public       ,2,3,5,271,396,667
00668900,UNIVERSITY OF WINDSOR                   ,CN,00000-0000,Public       ,1,0,1,20,59,79
00683700,UNIVERSITE LAVAL                        ,CN,00000-0000,Public       ,0,0,0,5,17,22
00683800,DALHOUSIE UNIVERSITY                    ,CN,00000-0000,Public       ,1,2,3,123,65,188
00685200,BISHOP'S UNIVERSITY                     ,CN,00000-0000,Private      ,0,1,1,27,2,29
00685300,MCMASTER UNIVERSITY                     ,CN,00000-0000,Public       ,0,0,0,14,24,38
00767900,YORK UNIVERSITY                         ,CN,00000-0000,Public       ,0,0,0,95,104,199
00787400,UNIVERSITY AT CALGARY (THE)             ,CN,00000-0000,Public       ,0,0,0,16,47,63
00814800,UNIVERSITY OF WINNIPEG                  ,CN,00000-0000,Public       ,0,0,0,7,5,12
00836200,UNIVERSITY OF ALBERTA (THE)             ,CN,00000-0000,Public       ,0,0,0,23,44,67
00836300,MOUNT SAINT VINCENT UNIVERSITY          ,CN,00000-0000,Private      ,0,0,0,5,5,10
00836400,SAINT MARY'S UNIVERSITY                 ,CN,00000-0000,Public       ,0,0,0,29,8,37
00836500,CONCORDIA UNIVERSITY - SIR GEORGE W     ,CN,00000-0000,Public       ,0,1,1,245,145,390
00836600,UNIVERSITE DE MONTREAL                  ,CN,00000-0000,Public       ,0,1,1,11,38,49
00836800,CARLETON UNIVERSITY                     ,CN,00000-0000,Public       ,0,0,0,46,35,81
00836900,UNIVERSITY OF BRITISH COLUMBIA          ,CN,00000-0000,Public       ,1,1,2,677,448,1125
00837000,"SAFA, UNIVERSITY OF VICTORIA            ",CN,00000-0000,Public       ,0,0,0,97,57,154
00844400,SIMON FRASER UNIVERSITY                 ,CN,00000-0000,Public       ,0,0,0,72,108,180
00844600,UNIVERSITY OF WESTERN ONTARIO (THE)     ,CN,00000-0000,Public       ,0,2,2,38,44,82
00844800,UNIVERSITY OF REGINA                    ,CN,00000-0000,Public       ,0,0,0,5,11,16
00844900,ACADIA UNIVERSITY                       ,CN,00000-0000,Public       ,0,0,0,58,10,68
00852600,UNIVERSITY OF WATERLOO                  ,CN,00000-0000,Public       ,0,0,0,37,15,52
00858200,WILFRID LAURIER UNIVERSITY              ,CN,00000-0000,Public       ,0,0,0,9,7,16
00891300,LAKEHEAD UNIVERSITY                     ,CN,00000-0000,Public       ,0,0,0,3,3,6
00911900,UNIVERSITE DE MONCTON                   ,CN,00000-0000,Public       ,0,0,0,0,1,1
00918000,LAURENTIAN UNIVERSITY OF SUDBURY        ,CN,00000-0000,Public       ,0,0,0,0,2,2
00925200,BROCK UNIVERSITY                        ,CN,00000-0000,Public       ,0,0,0,15,11,26
00936700,UNIVERSITY OF PRINCE EDWARD ISLAND      ,CN,00000-0000,Public       ,0,0,0,11,97,108
00942100,BRANDON UNIVERSITY                      ,CN,00000-0000,Public       ,0,0,0,7,6,13
00948600,TRINITY WESTERN UNIVERSITY              ,CN,00000-0000,Private      ,0,1,1,325,53,378
00950000,MEMORIAL UNIVERSITY OF NEWFOUNDLAND     ,CN,00000-0000,Public       ,0,0,0,4,4,8
00950100,UNIVERSITY OF KING'S COLLEGE            ,CN,00000-0000,Public       ,0,0,0,21,1,22
00950300,MOUNT ALLISON UNIVERSITY                ,CN,00000-0000,Public       ,0,0,0,33,2,35
00950500,TRENT UNIVERSITY                        ,CN,00000-0000,Public       ,0,0,0,12,7,19
00969700,LETHBRIDGE COLLEGE                      ,CN,00000-0000,Public       ,0,0,0,8,3,11
00969800,MEDICINE HAT COLLEGE                    ,CN,00000-0000,Public       ,0,0,0,1,6,7
00970100,SENECA COLG OF APPLIED ARTS & TECH      ,CN,00000-0000,Public       ,0,0,0,17,10,27
01012300,NOVA SCOTIA COLLEGE OF ART & DESIGN     ,CN,00000-0000,Public       ,0,0,0,11,17,28
01022100,SAINT PAUL UNIVERSITY                   ,CN,00000-0000,Public       ,0,0,0,2,3,5
01045800,SHERIDAN COLLEGE OF APPLIED ARTS AN     ,CN,00000-0000,Public       ,0,0,0,15,12,27
01067500,REGENT COLLEGE                          ,CN,00000-0000,Private      ,0,0,0,3,120,123
01070300,UNIVERSITY OF LETHBRIDGE                ,CN,00000-0000,Public       ,0,0,0,6,4,10
01072000,RYERSON UNIVERSITY                      ,CN,00000-0000,Public       ,0,1,1,54,63,117
01172200,BRIERCREST BIBLE COLLEGE                ,CN,00000-0000,Private      ,0,0,0,17,11,28
01221100,ALGONQUIN CLG OF APPLIED ARTS &TECH     ,CN,00000-0000,Public       ,0,0,0,5,8,13
01222800,HUMBER COLLEGE                          ,CN,00000-0000,Public       ,0,0,0,10,16,26
01227400,PROVIDENCE COLLEGE                      ,CN,00000-0000,Private      ,0,0,0,14,6,20
02102100,BETHANY BIBLE COLLEGE                   ,CN,00000-0000,Private      ,0,1,1,73,28,101
02167000,PRAIRIE BIBLE INST                      ,CN,00000-0000,Private      ,0,1,1,31,16,47
02184600,INSTITUTE FOR CHRISTIAN STUDIES         ,CN,00000-0000,Private      ,0,0,0,0,5,5
02195600,LASALLE COLLEGE                         ,CN,00000-0000,Private      ,0,0,0,8,19,27
02195700,TAYLOR UNIVERSITY COLLEGE AND SEMINARY  ,CN,00000-0000,Private      ,0,0,0,7,1,8
02201100,COLUMBIA BIBLE COLLEGE                  ,CN,00000-0000,Private      ,0,0,0,25,4,29
02209700,UNIVERSITE DU QUEBEC (UNIVERSITY OF     ,CN,00000-0000,Public       ,0,0,0,1,6,7
02216400,TYNDALE COLLEGE & SEMINARY              ,CN,00000-0000,Private      ,0,0,0,4,9,13
02219000,ST. LAWRENCE COLLEGE                    ,CN,00000-0000,Public       ,0,0,0,5,2,7
02219200,UNIVERSITY OF SASKATCHEWAN              ,CN,00000-0000,Public       ,0,0,0,7,13,20
02338800,EMILY CARR UNIVERSITY OF ART AND DESIGN ,CN,00000-0000,Public       ,0,0,0,62,27,89
02354700,RED DEER COLLEGE                        ,CN,00000-0000,Public       ,0,0,0,2,2,4
02577200,SALVATION ARMY WM & CATHERINE BOOTH     ,CN,00000-0000,Private      ,0,0,0,1,1,2
02592600,NEW BRUNSWICK COMMUNITY COLLEGE         ,CN,00000-0000,Public       ,0,0,0,2,0,2
02593800,CONCORDIA UNIVERSITY COLLEGE            ,CN,00000-0000,Private      ,0,0,0,4,4,8
02611900,THE KING'S UNIVERSITY COLLEGE           ,CN,00000-0000,Private      ,0,0,0,3,2,5
03018300,ROCKY MOUNTAIN COLLEGE: CENTRE FOR      ,CN,00000-0000,Private      ,0,0,0,3,1,4
03033200,SAINT PHILIP'S SEMINARY                 ,CN,00000-0000,Private      ,0,0,0,0,1,1
03033800,UNIVERSITY COLLEGE OF CAPE BRETON       ,CN,00000-0000,Public       ,0,0,0,4,3,7
03078300,VANCOUVER SCHOOL OF THEOLOGY            ,CN,00000-0000,Private      ,0,0,0,1,4,5
03273300,CANADIAN COLLEGE OF NATUROPATHIC ME     ,CN,00000-0000,Private      ,0,0,0,1,25,26
03298300,ALBERTA COLLEGE OF ART & DESIGN         ,CN,00000-0000,Public       ,0,0,0,22,10,32
03332500,KWANTLEN UNIVERSITY COLLEGE             ,CN,00000-0000,Public       ,0,0,0,4,8,12
03335400,CANADIAN UNIVERSITY COLLEGE             ,CN,00000-0000,Private      ,0,0,0,36,3,39
03339300,ST. STEPHENS UNIVERSITY                 ,CN,00000-0000,Private      ,0,0,0,6,2,8
03348500,REDEEMER UNIVERSITY COLLEGE             ,CN,00000-0000,Private      ,0,0,0,10,2,12
03408300,CANDIAN NAZARENE UNIVERSITY COLLEGE     ,CN,00000-0000,Private      ,0,0,0,4,3,7
03420300,HOLLAND COLLEGE                         ,CN,00000-0000,Public       ,0,0,0,1,1,2
03421300,LOYALIST COLLEGE OF APPLIED ARTS &      ,CN,00000-0000,Public       ,0,0,0,4,0,4
03435400,ROYAL ROADS UNIVERSITY                  ,CN,00000-0000,Public       ,0,0,0,1,1,2
03465300,NIPISSING UNIVERSITY                    ,CN,00000-0000,Public       ,0,0,0,1,1,2
03511300,CN CLG ACUPUNCTURE & ORIENTAL MED       ,CN,00000-0000,Private      ,0,0,0,0,10,10
03551300,INTERNATIONAL BIBLE COLLEGE             ,CN,00000-0000,Private      ,0,0,0,2,2,4
03560400,NIAGARA COLLEGE-WELLAND CAMPUS          ,CN,00000-0000,Public       ,0,0,0,5,5,10
03613300,UNIV OF NORTHERN BRITISH COLUMBIA       ,CN,00000-0000,Public       ,0,0,0,8,2,10
03644400,CANADIAN MENNONITE UNIVERSITY           ,CN,00000-0000,Private      ,0,0,0,10,2,12
03674400,CANADIAN SOUTHERN BAPTIST SEMINARY      ,CN,00000-0000,Private      ,0,0,0,0,3,3
03711300,CAPILANO UNIVERSITY                     ,CN,00000-0000,Public       ,0,0,0,10,12,22
03745300,BRITISH COLUMBIA INSTITUTE OF TECHNOLOGY,CN,00000-0000,Public       ,0,0,0,5,7,12
03846300,PACIFIC LIFE BIBLE COLLEGE              ,CN,00000-0000,Private      ,0,1,1,8,4,12
03847300,ATLANTIC BAPTIST UNIVERSITY             ,CN,00000-0000,Private      ,0,0,0,7,2,9
00814700,UNIVERSIDAD AUTONOMA DE GUADALAJARA     ,MX,00000-0000,Private      ,1,3,4,53,1124,1177
01041800,INST TEC Y DE ESTSUPER DE MONTERRE      ,MX,00000-0000,Private      ,0,0,0,75,50,125
01067600,UNIVERSIDAD DE MONTERREY                ,MX,00000-0000,Private      ,0,3,3,21,35,56
01093800,UNIVERSIDAD DE GUANAJUATO               ,MX,00000-0000,Public       ,0,0,0,13,17,30
01097600,INSTITUTO ALLENDE                       ,MX,00000-0000,Private      ,0,0,0,4,7,11
02053300,CENTRO DE ESTUDIOS UNIVERSITARIOS D     ,MX,00000-0000,Private      ,0,1,1,162,217,379
02283100,UNIVERSIDAD TECNOLOGICA DE MEXICO       ,MX,00000-0000,Proprietary  ,0,0,0,17,27,44
01001000,AMERICAN SAMOA CMNTY COLLEGE            ,AS,96799-2609,Public       ,80,12,92,1586,355,1941
01034300,COLLEGE OF MICRONESIA - FSM             ,FM,96941-0159,Public       ,43,26,69,2212,762,2974
01100900,PALAU COMMUNITY COLLEGE                 ,PW,96940-0009,Public       ,32,7,39,806,327,1133
03022400,COLLEGE OF THE MARSHALL ISLANDS         ,MH,96960-1258,Public       ,34,33,67,727,372,1099
03033000,NORTHERN MARIANAS COLLEGE               ,MP,96950-0000,Public       ,1,3,4,387,323,710
