OPE ID,School,State,Zip Code,School Type,20092010Qtr4_Dependent Students,20092010Qtr4_Independent Students,Quarterly Total,YTD_20092010Qtr4_Dependent Students,YTD_20092010Qtr4_Independent Students,Award Year To Date Total
00100200,ALABAMA AGRCLTL & MECHL UNIV            ,AL,35762-1357,Public       ,132,227,359,5437,3002,8439
00100300,FAULKNER UNIVERSITY                     ,AL,36109-3398,Private      ,66,317,383,1389,3683,5072
00100400,UNIVERSITY OF MONTEVALLO                ,AL,35115-6000,Public       ,74,122,196,1917,1251,3168
00100500,ALABAMA STATE UNIVERSITY                ,AL,36101-0000,Public       ,237,338,575,7519,4568,12087
00100700,CENTRAL ALABAMA COMMUNITY COLLEGE       ,AL,35011-0000,Public       ,115,356,471,1281,2153,3434
00100800,ATHENS STATE UNIVERSITY                 ,AL,35611-1999,Public       ,44,301,345,604,2956,3560
00100900,AUBURN UNIVERSITY                       ,AL,36849-5113,Public       ,463,355,818,14178,5359,19537
00101200,BIRMINGHAM SOUTHERN COLLEGE             ,AL,35254-0002,Private      ,44,39,83,1831,361,2192
00101300,CALHOUN COMMUNITY COLLEGE               ,AL,35609-2216,Public       ,426,1070,1496,4315,7321,11636
00101500,ENTERPRISE-OZARK COMMUNITY COLLEGE      ,AL,36331-1300,Public       ,101,267,368,1165,1773,2938
00101600,UNIVERSITY OF NORTH ALABAMA             ,AL,35632-0001,Public       ,164,267,431,4070,2506,6576
00101700,GADSDEN STATE COMMUNITY COLLEGE         ,AL,35903-2269,Public       ,278,940,1218,2976,5725,8701
00101800,GEORGE C WALLACE COMMUNITY COLLEGE      ,AL,36303-0943,Public       ,145,560,705,1825,3787,5612
00101900,HUNTINGDON COLLEGE                      ,AL,36106-2148,Private      ,28,57,85,1038,494,1532
00102000,JACKSONVILLE STATE UNIVERSITY           ,AL,36265-1602,Public       ,215,490,705,5823,5067,10890
00102100,JEFFERSON DAVIS COMMUNITY COLLEGE       ,AL,36427-2790,Public       ,43,140,183,608,1029,1637
00102200,JEFFERSON STATE COMMUNITY COLLEGE       ,AL,35215-3098,Public       ,413,1164,1577,3577,6814,10391
00102300,JUDSON COLLEGE                          ,AL,36756-2504,Private      ,12,14,26,313,117,430
00102400,UNIVERSITY OF WEST ALABAMA              ,AL,35470-0000,Public       ,48,401,449,1721,4644,6365
00102600,MARION MILITARY INSTITUTE               ,AL,36756-3214,Public       ,22,6,28,551,75,626
00102800,MILES COLLEGE                           ,AL,35064-2697,Private      ,69,103,172,2126,1314,3440
00102900,UNIVERSITY OF MOBILE                    ,AL,36613-0000,Private      ,50,147,197,1196,1502,2698
00103000,BISHOP STATE COMMUNITY COLLEGE          ,AL,36603-5898,Public       ,215,706,921,1743,4364,6107
00103001,BISHOP STATE COMM COLG-CARVER CMPS      ,AL,36617-0000,Public       ,19,62,81,141,397,538
00103002,BISHOP STAT COMM CLG-SW CMPS            ,AL,36605-0000,Public       ,12,39,51,81,177,258
00103100,NORTHEAST ALABAMA STATE CMNTY COLG      ,AL,35986-0159,Public       ,114,324,438,1285,2295,3580
00103300,OAKWOOD COLLEGE                         ,AL,35896-0001,Private      ,45,62,107,1767,707,2474
00103400,ALABAMA SOUTHERN COMMUNITY COLLEGE      ,AL,36460-5698,Public       ,96,268,364,1061,1286,2347
00103600,SAMFORD UNIVERSITY                      ,AL,35229-7000,Private      ,52,153,205,2738,2492,5230
00103800,SNEAD STATE COMMUNITY COLLEGE           ,AL,35957-0734,Public       ,89,282,371,1066,1896,2962
00104000,SOUTHERN UNION STATE COMMUNITY CLG      ,AL,36276-0000,Public       ,196,495,691,2824,3038,5862
00104100,SPRING HILL COLLEGE                     ,AL,36608-1791,Private      ,28,54,82,1807,571,2378
00104400,STILLMAN COLLEGE                        ,AL,35403-1430,Private      ,44,34,78,2177,508,2685
00104600,TALLADEGA COLLEGE                       ,AL,35160-2354,Private      ,19,30,49,572,327,899
00104700,TROY STATE UNIVERSITY                   ,AL,36082-0001,Public       ,382,2515,2897,7344,24143,31487
00105000,TUSKEGEE UNIVERSITY                     ,AL,36088-1645,Private      ,111,52,163,4590,1159,5749
00105100,UNIVERSITY OF ALABAMA (THE)             ,AL,35487-0120,Public       ,526,656,1182,16979,8673,25652
00105200,UNIVERSITY OF ALABAMA AT BIRMINGHAM     ,AL,35294-1150,Public       ,317,774,1091,7561,9825,17386
00105500,UNIVERSITY OF ALABAMA IN HUNTSVILLE     ,AL,35899-0001,Public       ,153,338,491,3891,3589,7480
00105700,UNIVERSITY OF SOUTH ALABAMA             ,AL,36688-0002,Public       ,388,862,1250,7103,8655,15758
00105900,LAWSON STATE COMMUNITY COLLEGE          ,AL,35221-1798,Public       ,172,583,755,2321,4066,6387
00105901,LAWSON STATE COMMUNITY COLLEGE - BESSEME,AL,35021-0308,Public       ,32,140,172,433,1026,1459
00106000,FAULKNER STATE COMMUNITY COLLEGE        ,AL,36507-2698,Public       ,246,475,721,2533,3102,5635
00526000,J.F. DRAKE STATE TECH COLLEGE           ,AL,35811-1584,Public       ,42,253,295,385,1703,2088
00569100,SHELTON STATE COMMUNITY CLG             ,AL,35405-4017,Public       ,314,646,960,3567,3926,7493
00569200,REID STATE TECHNICAL COLLEGE            ,AL,36401-0000,Public       ,40,142,182,303,801,1104
00569700,NORTHWEST- SHOALS COMMUNITY COLLEGE     ,AL,35661-0000,Public       ,168,461,629,1863,2638,4501
00569702,NORTHWEST-SHOALS C.C.-PHIL CAMPBELL     ,AL,35581-0000,Public       ,10,47,57,217,283,500
00569900,GEORGE C WALLACE STATE CMTY COLLEGE     ,AL,36703-0000,Public       ,92,277,369,1065,1853,2918
00573300,BEVILL STATE CMTY COLLEGE-WALKER        ,AL,35148-0000,Public       ,132,417,549,1185,2418,3603
00573301,BEVILL STATE COMMUNITY COLLEGE - FAYETTE,AL,35555-0000,Public       ,35,83,118,458,758,1216
00573302,BEVILL STATE CMTY CLG-HAMILTON CAMP     ,AL,35570-0000,Public       ,13,53,66,195,373,568
00573305,BEVILL STATE CMTY CLG-WALKER CLG        ,AL,35501-0000,Public       ,36,94,130,367,561,928
00573400,H. COUNCILL TRENHOLM STATE TECH COLLEGE ,AL,36108-0020,Public       ,114,379,493,788,2037,2825
00573401,H. C. TRENHOLM ST TECH COL-PATTERSON CAM,AL,36116-2612,Public       ,31,98,129,346,652,998
00787100,GEORGE C WALLACE STATE CMTY CLG         ,AL,35077-2000,Public       ,252,640,892,3036,4591,7627
00831000,AUBURN UNIVERSITY-MONTGOMERY            ,AL,36124-0000,Public       ,161,446,607,2889,4088,6977
00898800,LURLEEN B WALLACE COMMUNITY COLLEGE     ,AL,36420-0418,Public       ,77,212,289,861,1406,2267
01019300,HERZING COLLEGE                         ,AL,35209-4816,Proprietary  ,16,159,175,118,992,1110
01055400,CONCORDIA COLLEGE                       ,AL,36701-3323,Private      ,21,45,66,576,430,1006
01218200,CHATTAHOOCHEE VALLEY CMTY CLG           ,AL,36869-7917,Public       ,66,182,248,833,1771,2604
01303906,SOUTH UNIVERSITY - MONTGOMERY           ,AL,36116-1120,Proprietary  ,37,164,201,298,1237,1535
02170600,UNITED STATES SPORTS ACADEMY            ,AL,36526-7055,Private      ,1,161,162,26,750,776
02199700,HERITAGE CHRISTIAN UNIVERSITY           ,AL,35630-0000,Private      ,0,7,7,21,78,99
02270400,SOUTHEASTERN BIBLE COLLEGE              ,AL,35244-2083,Private      ,6,19,25,110,195,305
02296000,PRINCE INSTITUTE OF PROFESSIONAL STUDIES,AL,36117-0000,Proprietary  ,6,20,26,34,160,194
02341000,FORTIS COLLEGE                          ,AL,36609-0000,Proprietary  ,84,225,309,484,1158,1642
02341002,CAPPS COLLEGE - MONTGOMERY              ,AL,36109-3624,Proprietary  ,3,17,20,38,141,179
02341004,FORTIS COLLEGE - SCHOOL OF COSMETOLOGY  ,AL,36609-1981,Proprietary  ,3,9,12,18,56,74
02503400,AMRIDGE UNIVERSITY                      ,AL,36124-0000,Private      ,5,94,99,36,921,957
02605500,REMINGTON COLLEGE - MOBILE CAMPUS       ,AL,36609-5593,Proprietary  ,96,427,523,568,2362,2930
03010600,VIRGINIA COLLEGE                        ,AL,35209-5154,Proprietary  ,376,3215,3591,2177,20336,22513
03010602,VIRGINIA COLLEGE - HUNTSVILLE           ,AL,35805-0000,Proprietary  ,49,275,324,261,1585,1846
03010607,VIRGINIA COLLEGE - MOBILE               ,AL,36606-4748,Proprietary  ,24,120,144,115,604,719
03010616,VIRGINIA COLLEGE - MONTGOMERY           ,AL,36117-2802,Proprietary  ,62,250,312,326,1309,1635
03032500,ALABAMA STATE CLG BARBER STYLING        ,AL,35215-8308,Proprietary  ,1,15,16,34,84,118
03361400,FORTIS COLLEGE                          ,AL,36535-3547,Proprietary  ,9,54,63,51,300,351
03459300,SOUTHEASTERN SCHOOL OF COSMETOLOGY      ,AL,35228-0000,Private      ,7,47,54,39,190,229
03783300,BLUE CLIFF CAREER COLLEGE               ,AL,63306-4749,Proprietary  ,19,52,71,76,220,296
03894300,HUNTSVILLE BIBLE COLLEGE                ,AL,35811-0000,Private      ,1,6,7,11,65,76
04066300,CARDIAC AND VASCULAR INSTITUTE OF ULTRAS,AL,36604-1408,Proprietary  ,1,18,19,6,51,57
04067300,SELMA UNIVERSITY                        ,AL,36701-0000,Private      ,7,34,41,51,264,315
04116500,MIMI'S BEAUTY ACADEMY OF COSMETOLOGY    ,AL,35810-3453,Proprietary  ,0,0,0,7,39,46
04121500,COLUMBIA SOUTHERN UNIVERSITY            ,AL,36561-3815,Proprietary  ,24,987,1011,167,5274,5441
04149200,XCELL ACADEMY-A PAUL MITCHELL PARTNER SC,AL,35216-4990,Proprietary  ,8,23,31,58,117,175
00111100,ALLAN HANCOCK COLLEGE                   ,CA,93454-6399,Public       ,207,519,726,3136,3973,7109
00111300,ANTELOPE VALLEY COLLEGE                 ,CA,93536-5426,Public       ,455,1151,1606,5285,9193,14478
00111600,ART CENTER COLLEGE OF DESIGN            ,CA,91103-1999,Private      ,55,77,132,1198,1303,2501
00111700,AZUSA PACIFIC UNIVERSITY                ,CA,91702-7000,Private      ,165,644,809,6486,5868,12354
00111800,BAKERSFIELD COLLEGE                     ,CA,93305-1299,Public       ,652,1453,2105,8412,10385,18797
00111900,BARSTOW COMMUNITY COLLEGE               ,CA,92311-6608,Public       ,106,725,831,735,3235,3970
00112000,AMER BAPT SEM OF THE WEST-BERKELEY      ,CA,94704-0000,Private      ,0,9,9,2,57,59
00112100,BETHANY UNIVERSITY /  ASSEMBLIES OF GOD ,CA,95066-2896,Private      ,18,22,40,411,331,742
00112200,BIOLA UNIVERSITY                        ,CA,90639-0001,Private      ,95,132,227,5029,2198,7227
00112300,BROOKS INSTITUTE                        ,CA,93103-1809,Proprietary  ,102,82,184,1083,730,1813
00112400,CABRILLO COLLEGE                        ,CA,95003-3194,Public       ,271,585,856,3568,4699,8267
00112500,CALIFORNIA BAPTIST UNIVERSITY           ,CA,92504-3297,Private      ,106,198,304,3562,2508,6070
00112700,CALIFORNIA COLLEGE OF THE ARTS          ,CA,94107-2206,Private      ,37,69,106,1607,1701,3308
00113100,CALIFORNIA INSTITUTE OF TECHNOLOGY      ,CA,91125-0001,Private      ,49,28,77,2866,457,3323
00113200,CALIFORNIA INSTITUTE OF THE ARTS        ,CA,91355-2397,Private      ,38,45,83,1611,1351,2962
00113300,CALIFORNIA LUTHERAN UNIVERSITY          ,CA,91360-2787,Private      ,69,134,203,3035,1518,4553
00113400,CALIFORNIA MARITIME ACADEMY             ,CA,94590-8181,Public       ,12,10,22,650,265,915
00113700,CALIF STATE UNIV-FULLERTON              ,CA,92831-3599,Public       ,789,820,1609,31703,16355,48058
00113800,"CALIFORNIA STATE UNIVERSITY, EAST BAY   ",CA,94542-3000,Public       ,254,492,746,9511,10221,19732
00113900,CALIF STATE UNIV-LONG BEACH             ,CA,90840-0006,Public       ,861,711,1572,37862,18400,56262
00114000,CALIF STATE UNIV-LOS ANGELES            ,CA,90032-4226,Public       ,412,690,1102,21602,16751,38353
00114100,"CALIF STATE UNIV, DOMINGUEZ HILLS       ",CA,90747-0001,Public       ,241,602,843,10005,10902,20907
00114200,CALIF STATE UNIV SAN BERNARDINO         ,CA,92407-2397,Public       ,315,543,858,13989,12198,26187
00114300,CAL POLY STATE UNIVERSITY               ,CA,93407-0001,Public       ,424,201,625,27168,3828,30996
00114400,CALIF STATE POLYTECHNIC UNIV POMONA     ,CA,91768-2500,Public       ,386,330,716,21127,8207,29334
00114600,CALIF STATE UNIV - CHICO                ,CA,95929-0001,Public       ,324,238,562,13984,5835,19819
00114700,CALIF STATE UNIV - FRESNO               ,CA,93740-8026,Public       ,411,355,766,17706,10215,27921
00114900,HUMBOLDT STATE UNIVERSITY               ,CA,95521-8299,Public       ,175,130,305,9245,3992,13237
00115000,CALIF STATE UNIV-SACRAMENTO             ,CA,95819-6044,Public       ,491,695,1186,21825,16422,38247
00115100,SAN DIEGO STATE UNIVERSITY              ,CA,92182-1690,Public       ,884,801,1685,37989,16461,54450
00115300,CALIF STATE UNIV-NORTHRIDGE             ,CA,91330-8307,Public       ,559,811,1370,27196,17475,44671
00115400,SAN FRANCISCO STATE UNIVERSITY          ,CA,94132-1740,Public       ,573,705,1278,27403,17748,45151
00115500,SAN JOSE STATE UNIVERSITY               ,CA,95192-0036,Public       ,479,645,1124,22208,14730,36938
00115600,SONOMA STATE UNIVERSITY                 ,CA,94928-3609,Public       ,155,198,353,8434,3171,11605
00115700,CALIF STATE UNIV-STANISLAUS             ,CA,95382-0299,Public       ,148,224,372,6826,5116,11942
00116100,CERRITOS COLLEGE                        ,CA,90650-6296,Public       ,850,1348,2198,11190,9409,20599
00116200,CHABOT COLLEGE                          ,CA,94545-2400,Public       ,335,872,1207,4253,6041,10294
00116300,CHAFFEY COLLEGE                         ,CA,91737-9400,Public       ,757,1538,2295,9323,11421,20744
00116400,CHAPMAN UNIVERSITY                      ,CA,92866-1099,Private      ,143,825,968,6955,9089,16044
00116415,CHAPMAN UNIVERSITY - IRVINE CAMPUS      ,CA,92618-3801,Private      ,0,1,1,0,1,1
00116453,CHAPMAN UNIVERSITY SCHOOL OF LAW        ,CA,92866-0000,Private      ,5,24,29,89,2086,2175
00116500,CHURCH DIV SCH OF THE PACIFIC           ,CA,94709-0000,Private      ,0,1,1,0,59,59
00116600,CITRUS COLLEGE                          ,CA,91741-1899,Public       ,412,655,1067,6040,5160,11200
00116900,CLAREMONT GRADUATE UNIVERSITY           ,CA,91711-0000,Private      ,0,82,82,12,1904,1916
00117000,CLAREMONT MCKENNA COLLEGE               ,CA,91711-6400,Private      ,35,14,49,3113,126,3239
00117100,HARVEY MUDD COLLEGE                     ,CA,91711-5990,Private      ,8,5,13,1810,28,1838
00117200,PITZER COLLEGE                          ,CA,91711-6101,Private      ,28,3,31,2852,145,2997
00117300,POMONA COLLEGE                          ,CA,91711-6301,Private      ,40,14,54,4306,127,4433
00117400,SCRIPPS COLLEGE                         ,CA,91711-3948,Private      ,10,7,17,1577,73,1650
00117600,WEST HILLS COMMUNITY COLLEGE            ,CA,93210-1399,Public       ,42,192,234,1091,1257,2348
00117700,COGSWELL POLYTECHNICAL COLLEGE          ,CA,94089-1210,Private      ,2,4,6,118,70,188
00117800,COLLEGE OF MARIN                        ,CA,94904-2590,Public       ,62,246,308,752,1883,2635
00117801,COLG OF MARIN-INDIAN VALLEY CMPS        ,CA,94949-0000,Public       ,0,19,19,19,106,125
00117900,NOTRE DAME DE NAMUR UNIVERSITY          ,CA,94002-1997,Private      ,24,92,116,1013,940,1953
00118100,COLLEGE OF SAN MATEO                    ,CA,94402-3784,Public       ,142,314,456,1808,2103,3911
00118200,COLLEGE OF THE DESERT                   ,CA,92260-9305,Public       ,217,512,729,3668,4092,7760
00118300,HOLY NAMES UNIVERSITY                   ,CA,94619-1699,Private      ,19,76,95,692,743,1435
00118500,COLLEGE OF THE REDWOODS                 ,CA,95501-9300,Public       ,202,564,766,2503,4356,6859
00118600,COLLEGE OF THE SEQUOIAS                 ,CA,93277-2234,Public       ,420,1021,1441,5339,6780,12119
00118700,COLLEGE OF THE SISKIYOUS                ,CA,96094-2899,Public       ,77,184,261,964,1253,2217
00118701,COLLEGE OF THE SISKIYOUS - YREKA CENTER ,CA,96097-9538,Public       ,5,32,37,41,135,176
00119000,CONTRA COSTA COLLEGE                    ,CA,94806-3195,Public       ,155,509,664,1823,3185,5008
00119100,DIABLO VALLEY COLLEGE                   ,CA,94523-1544,Public       ,256,557,813,3747,4036,7783
00119200,CUESTA COLLEGE                          ,CA,93403-8106,Public       ,244,521,765,3371,3226,6597
00119300,CYPRESS COLLEGE                         ,CA,90630-5897,Public       ,441,886,1327,5562,6045,11607
00119600,DOMINICAN UNIVERSITY OF CALIFORNIA      ,CA,94901-2298,Private      ,36,106,142,2104,1323,3427
00119700,EL CAMINO COLLEGE                       ,CA,90506-0002,Public       ,597,1124,1721,8982,8478,17460
00119701,COMPTON COMMUNITY COLLEGE               ,CA,90221-5393,Public       ,121,528,649,1474,3432,4906
00119900,FOOTHILL COLLEGE                        ,CA,94022-4597,Public       ,149,324,473,1837,2795,4632
00120000,FULLER THEOLOGICAL SEMINARY             ,CA,91182-0000,Private      ,1,94,95,11,2202,2213
00120100,FULLERTON COLLEGE                       ,CA,92832-2095,Public       ,615,870,1485,8139,6100,14239
00120200,GAVILAN COLLEGE                         ,CA,95020-9599,Public       ,107,233,340,1372,1728,3100
00120300,GLENDALE COMMUNITY COLLEGE              ,CA,91208-2894,Public       ,263,653,916,6090,6426,12516
00120400,GOLDEN GATE BAPT THEOL SEMINARY         ,CA,94941-0000,Private      ,0,6,6,1,56,57
00120500,GOLDEN GATE UNIVERSITY                  ,CA,94105-2967,Private      ,10,271,281,81,3811,3892
00120600,GOLDEN WEST COLLEGE                     ,CA,92647-2748,Public       ,327,707,1034,5249,5316,10565
00120700,GRADUATE THEOLOGICAL UNION              ,CA,94709-0000,Private      ,0,13,13,0,335,335
00120800,GROSSMONT COLLEGE                       ,CA,92020-1798,Public       ,512,1043,1555,5753,7311,13064
00120900,HARTNELL COMMUNITY COLLEGE              ,CA,93901-1697,Public       ,186,322,508,2632,2532,5164
00121200,HUMPHREYS COLLEGE                       ,CA,95207-3896,Private      ,13,99,112,195,1059,1254
00121400,IMPERIAL VALLEY COLLEGE                 ,CA,92251-9787,Public       ,262,394,656,4048,3438,7486
00121500,LA SIERRA UNIVERSITY                    ,CA,92515-3332,Private      ,58,64,122,1796,752,2548
00121600,UNIVERSITY OF LA VERNE                  ,CA,91750-4443,Private      ,78,489,567,2434,6183,8617
00121700,LASSEN COLLEGE                          ,CA,96130-3000,Public       ,24,89,113,390,689,1079
00121800,LOMA LINDA UNIVERSITY                   ,CA,92350-0001,Private      ,21,160,181,737,4909,5646
00121900,LONG BEACH CITY COLLEGE                 ,CA,90808-1780,Public       ,820,1893,2713,11076,13703,24779
00122000,MASTER'S COLLEGE & SEMINARY (THE)       ,CA,91321-1200,Private      ,20,30,50,1077,343,1420
00122300,LOS ANGELES CITY COLLEGE                ,CA,90029-3588,Public       ,340,1077,1417,5208,8967,14175
00122400,LOS ANGELES HARBOR COLLEGE              ,CA,90744-2397,Public       ,161,346,507,2704,3547,6251
00122600,LOS ANGELES PIERCE COLLEGE              ,CA,91371-0001,Public       ,445,815,1260,7288,6425,13713
00122700,LOS ANGELES TRADE TECH COLLEGE          ,CA,90015-4181,Public       ,246,922,1168,3530,7444,10974
00122800,LOS ANGELES VALLEY COLLEGE              ,CA,91401-4096,Public       ,314,646,960,5325,6417,11742
00122900,SO CA UNIV  HEALTH SCIENCES             ,CA,90604-4051,Private      ,3,47,50,22,625,647
00123000,SOUTHERN CA COLLEGE OF OPTOMETRY        ,CA,92831-1699,Private      ,1,2,3,8,476,484
00123200,AMERICAN RIVER COLLEGE                  ,CA,95841-4286,Public       ,716,2282,2998,9105,17218,26323
00123300,SACRAMENTO CITY COLLEGE                 ,CA,95822-1386,Public       ,682,1885,2567,9266,13070,22336
00123600,MENLO COLLEGE                           ,CA,94027-4301,Private      ,27,12,39,972,157,1129
00123700,MERCED COMMUNITY COLLEGE                ,CA,95348-2898,Public       ,391,736,1127,4978,5175,10153
00123800,MILLS COLLEGE                           ,CA,94613-1301,Private      ,38,83,121,1498,1571,3069
00123900,MIRACOSTA COLLEGE                       ,CA,92056-3899,Public       ,204,596,800,2395,3867,6262
00124000,MODESTO JUNIOR COLLEGE                  ,CA,95350-5800,Public       ,507,1166,1673,8037,10095,18132
00124200,MONTEREY PENINSULA COLLEGE              ,CA,93940-4799,Public       ,131,253,384,1855,1982,3837
00124300,MOUNT ST MARYS COLLEGE                  ,CA,90049-1599,Private      ,36,131,167,2022,1849,3871
00124500,MT. SAN ANTONIO COLLEGE                 ,CA,91789-1399,Public       ,645,1041,1686,12481,9919,22400
00124600,MT SAN JACINTO COLLEGE                  ,CA,92583-2399,Public       ,590,1615,2205,6051,9894,15945
00124700,NAPA VALLEY COLLEGE                     ,CA,94558-6236,Public       ,133,309,442,1761,2230,3991
00124900,OCCIDENTAL COLLEGE                      ,CA,90041-3314,Private      ,37,15,52,4772,222,4994
00125000,ORANGE COAST COLLEGE - FIN AID OFF      ,CA,92628-5005,Public       ,553,932,1485,9358,7102,16460
00125100,OTIS COLLEGE OF ART AND DESIGN          ,CA,90045-3505,Private      ,39,44,83,1430,663,2093
00125200,HOPE INTERNATIONAL UNIVERSITY           ,CA,92631-0000,Private      ,16,88,104,597,690,1287
00125300,FRESNO PACIFIC UNIVERSITY               ,CA,93702-4798,Private      ,55,249,304,1433,2235,3668
00125302,FRESNO PACIFIC UNIVERSITY - VISALIA CENT,CA,93277-8341,Private      ,0,0,0,28,160,188
00125303,FRESNO PACIFIC UNIVERSITY - BAKERSFIELD ,CA,93301-4533,Private      ,0,0,0,42,164,206
00125400,PACIFIC LUTHERAN THEOLOGICAL SEM        ,CA,94708-0000,Private      ,0,2,2,0,97,97
00125500,PACIFIC OAKS COLLEGE                    ,CA,91103-3592,Private      ,0,27,27,12,522,534
00125600,PACIFIC SCHOOL OF RELIGION              ,CA,94709-0000,Private      ,0,3,3,0,174,174
00125800,PACIFIC UNION COLLEGE                   ,CA,94508-9797,Private      ,32,33,65,1382,465,1847
00125900,PALO VERDE COLLEGE                      ,CA,92225-0000,Public       ,20,91,111,227,523,750
00126000,PALOMAR COLLEGE                         ,CA,92069-1486,Public       ,481,934,1415,6160,6371,12531
00126100,PASADENA CITY COLLEGE                   ,CA,91106-2003,Public       ,638,1024,1662,12987,8801,21788
00126200,POINT LOMA NAZARENE UNIVERSITY          ,CA,92106-2899,Private      ,83,192,275,3549,1380,4929
00126600,LANEY COLLEGE                           ,CA,94607-4893,Public       ,262,954,1216,3090,6433,9523
00126700,MERRITT COLLEGE                         ,CA,94619-3196,Public       ,115,436,551,1383,3483,4866
00126800,PORTERVILLE COLLEGE                     ,CA,93257-6059,Public       ,153,350,503,1738,2486,4224
00126900,RIO HONDO COLLEGE                       ,CA,90601-1699,Public       ,416,783,1199,7256,6300,13556
00127000,RIVERSIDE COMMUNITY COLLEGE             ,CA,92506-1299,Public       ,1090,2215,3305,17397,20703,38100
00127200,SAN BERNARDINO VALLEY COLLEGE           ,CA,92410-2798,Public       ,465,1545,2010,5480,10312,15792
00127300,SAN DIEGO CITY COLLEGE                  ,CA,92101-4787,Public       ,440,1554,1994,5812,10885,16697
00127500,SAN DIEGO MESA COLLEGE                  ,CA,92111-4996,Public       ,496,998,1494,6470,8014,14484
00127800,SAN FRANCISCO CONSERVATORY OF MUSIC     ,CA,94122-4498,Private      ,11,9,20,322,370,692
00127900,SAN FRANCISCO THEOLOGICAL SEMINARY      ,CA,94960-0000,Private      ,0,7,7,1,101,102
00128000,SAN JOAQUIN DELTA COLLEGE               ,CA,95207-6370,Public       ,586,1516,2102,8173,10983,19156
00128100,WILLIAM JESSUP UNIVERSITY               ,CA,95765-3707,Private      ,11,60,71,538,378,916
00128200,SAN JOSE CITY COLLEGE                   ,CA,95128-2797,Public       ,187,625,812,2975,4870,7845
00128400,SANTA ANA COLLEGE                       ,CA,92706-3398,Public       ,240,606,846,5007,5298,10305
00128500,SANTA BARBARA CITY COLLEGE              ,CA,93109-2394,Public       ,343,609,952,5300,4277,9577
00128600,SANTA MONICA COLLEGE                    ,CA,90405-1644,Public       ,645,1032,1677,11967,8167,20134
00128700,SANTA ROSA JUNIOR COLLEGE               ,CA,95401-4395,Public       ,395,1022,1417,4550,6310,10860
00128800,CLAREMONT SCHOOL OF THEOLOGY            ,CA,91711-0000,Private      ,0,3,3,4,184,188
00128900,SHASTA COLLEGE                          ,CA,96049-7692,Public       ,227,745,972,3472,5352,8824
00129000,SIERRA COLLEGE                          ,CA,95677-3397,Public       ,476,1035,1511,5770,7419,13189
00129100,SIMPSON UNIVERSITY                      ,CA,96003-8606,Private      ,24,70,94,1077,855,1932
00129200,SOLANO COMMUNITY COLLEGE                ,CA,94534-3197,Public       ,236,694,930,2774,5154,7928
00129300,VANGUARD UNIVERSITY OF SOUTHERN CA      ,CA,92626-6597,Private      ,51,85,136,1763,858,2621
00129400,SOUTHWESTERN COLLEGE                    ,CA,91910-7299,Public       ,518,843,1361,7695,6342,14037
00129500,SOUTHWESTERN LAW SCHOOL                 ,CA,90010-1106,Private      ,1,33,34,19,2686,2705
00129600,DOMINICAN SCH PHILOSOPHY & THEOLOGY     ,CA,94709-0000,Private      ,0,3,3,2,41,43
00129900,ST JOHN'S SEMINARY COLLEGE              ,CA,93010-0000,Private      ,0,0,0,0,2,2
00130200,SAINT MARY'S COLLEGE OF CALIFORNIA      ,CA,94556-2744,Private      ,55,145,200,3685,1419,5104
00130500,STANFORD UNIVERSITY                     ,CA,94305-6106,Private      ,254,168,422,20600,3635,24235
00130501,STANFORD UNIVERSITY - GRADUATE SCHOOL OF,CA,94305-5301,Private      ,13,20,33,132,671,803
00130502,STANFORD UNIVERSITY - GRADUATE SCHOOL OF,CA,94305-5015,Private      ,7,30,37,60,1117,1177
00130503,STANFORD UNIVERSITY - STANFORD LAW SCHOO,CA,94305-3096,Private      ,6,17,23,40,2265,2305
00130700,FRESNO CITY COLLEGE                     ,CA,93741-0002,Public       ,834,2257,3091,13220,15904,29124
00130800,REEDLEY COLLEGE                         ,CA,93654-2099,Public       ,365,711,1076,5162,5073,10235
00130900,TAFT COLLEGE                            ,CA,93268-2317,Public       ,67,163,230,867,1161,2028
00131200,UNIVERSITY OF CALIFORNIA-BERKELEY       ,CA,94720-1520,Public       ,544,556,1100,46296,18994,65290
00131300,UNIVERSITY OF CALIFORNIA-DAVIS          ,CA,95616-8558,Public       ,458,293,751,43998,13557,57555
00131400,UNIVERSITY OF CALIFORNIA-IRVINE         ,CA,92697-2825,Public       ,475,332,807,45920,12280,58200
00131500,UNIVERSITY OF CALIFORNIA (UCLA)         ,CA,90095-9000,Public       ,771,955,1726,56516,25664,82180
00131502,UNIV OF CALIFORNIA LOS ANG SCH MED      ,CA,90095-0000,Public       ,8,27,35,170,907,1077
00131503,UNIV OF CALIFORNIA LOS ANG DENTAL       ,CA,90095-0000,Public       ,1,5,6,21,125,146
00131600,UNIVERSITY OF CALIFORNIA-RIVERSIDE      ,CA,92521-0209,Public       ,359,300,659,28924,6839,35763
00131700,UNIVERSITY OF CALIFORNIA-SAN DIEGO      ,CA,92093-0013,Public       ,444,265,709,42238,8754,50992
00131900,UNIVERSITY OF CALIFORNIA-SFRANCISCO     ,CA,94143-0246,Public       ,38,82,120,591,3369,3960
00132000,UNIVERSITY OF CALIFORNIA-SANTA BARB     ,CA,93106-3180,Public       ,422,151,573,41094,6483,47577
00132100,UNIVERSITY OF CALIFORNIA-SANTA CRUZ     ,CA,95064-0001,Public       ,297,147,444,26912,4108,31020
00132200,UNIVERSITY OF REDLANDS                  ,CA,92373-0999,Private      ,79,272,351,3861,2331,6192
00132500,UNIVERSITY OF SAN FRANCISCO             ,CA,94117-1080,Private      ,156,363,519,7785,7132,14917
00132600,SANTA CLARA UNIVERSITY                  ,CA,95053-4956,Private      ,99,118,217,8223,4830,13053
00132800,UNIVERSITY OF SOUTHERN CALIFORNIA       ,CA,90089-0914,Private      ,502,836,1338,29013,21906,50919
00132900,UNIVERSITY OF THE PACIFIC               ,CA,95211-0197,Private      ,134,107,241,9539,3000,12539
00132901,UNIVERSITY OF THE PACIFIC - MCGEORGE SCH,CA,95817-2799,Private      ,6,17,23,22,2378,2400
00132902,UNIV OF THE PACIFIC SCH OF DENT         ,CA,94115-0000,Private      ,0,25,25,25,567,592
00133400,VENTURA COLLEGE                         ,CA,93003-3899,Public       ,306,534,840,4444,3882,8326
00133500,VICTOR VALLEY COLLEGE                   ,CA,92395-5849,Public       ,417,1181,1598,5069,9546,14615
00133800,WEST VALLEY COLLEGE                     ,CA,95070-5697,Public       ,133,340,473,1917,2439,4356
00134100,WESTMONT COLLEGE                        ,CA,93108-1099,Private      ,40,6,46,2098,78,2176
00134200,WHITTIER COLLEGE                        ,CA,90601-4413,Private      ,46,25,71,2510,353,2863
00134201,WHITTIER COLLEGE - COLLEGE OF LAW       ,CA,92626-1501,Private      ,0,20,20,9,1512,1521
00134300,WOODBURY UNIVERSITY                     ,CA,91510-7846,Private      ,32,62,94,1075,873,1948
00134400,YUBA COLLEGE                            ,CA,95901-7699,Public       ,248,769,1017,3468,5807,9275
00177212,TRINITY INTERNATIONAL UNIV-CA           ,CA,92705-0000,Private      ,0,21,21,4,207,211
00274100,AMERICAN JEWISH UNIVERSITY              ,CA,90077-1599,Private      ,4,8,12,80,163,243
00301002,ANTIOCH UNIV/LOS ANGELES                ,CA,90230-7615,Private      ,5,93,98,39,986,1025
00301003,ANTIOCH  UNIV/SANTA BARBARA             ,CA,93101-0000,Private      ,9,29,38,384,480,864
00369110,MONTEREY INST OF INTERNATL STUDIES      ,CA,93940-2691,Private      ,4,33,37,27,939,966
00394700,UC-HASTINGS COLLEGE OF THE LAW          ,CA,94102-0000,Public       ,2,18,20,17,4261,4278
00394800,SAN FRANCISCO ART INSTITUTE             ,CA,94133-2299,Private      ,62,62,124,1182,919,2101
00405500,HEBREW UNION COLLEGE - JEWISH INSTITUTE ,CA,90007-3796,Private      ,1,2,3,2,83,85
00408000,STARR KING SCHOOL FOR THE MINISTRY      ,CA,94709-1299,Private      ,0,3,3,0,71,71
00448000,DE ANZA COLLEGE                         ,CA,95014-5793,Public       ,408,540,948,6030,4827,10857
00448100,OHLONE COLLEGE                          ,CA,94539-5847,Public       ,139,257,396,2245,2276,4521
00448101,OHLONE COLLEGE - NEWARK CENTER FOR HEALT,CA,94560-4902,Public       ,5,16,21,43,98,141
00448400,JOHN F. KENNEDY UNIVERSITY              ,CA,94523-4817,Private      ,2,114,116,22,1667,1689
00449000,PATTEN UNIVERSITY                       ,CA,94601-2699,Private      ,11,33,44,213,431,644
00449400,EVEREST COLLEGE                         ,CA,92408-3752,Proprietary  ,72,220,292,468,1206,1674
00450200,CITY COLLEGE OF SAN FRANCISCO           ,CA,94112-0000,Public       ,651,1638,2289,7905,11742,19647
00563800,DOWNEY ADULT SCHOOL                     ,CA,90241-5610,Public       ,2,25,27,40,100,140
00565500,HACIENDA LA PUENTE ADULT EDUC CTR       ,CA,91746-0000,Public       ,14,132,146,115,508,623
00616500,LA CNTY CLG OF NURSING & ALLD HLTH      ,CA,90033-1018,Public       ,4,37,41,82,392,474
00672000,COLLEGE OF ALAMEDA                      ,CA,94501-2109,Public       ,109,280,389,1520,2269,3789
00673100,CASA LOMA COLLEGE                       ,CA,91405-4523,Private      ,38,89,127,182,559,741
00686300,VENTURA COUNTY CMTY CLG DISTRICT        ,CA,93010-8552,Public       ,3,2,5,27,22,49
00697300,CANADA COLLEGE                          ,CA,94061-1099,Public       ,54,196,250,649,1332,1981
00697500,LINCOLN UNIVERSITY                      ,CA,94612-2801,Private      ,0,9,9,11,80,91
00701200,SAMUEL MERRITT COLLEGE                  ,CA,94609-3108,Private      ,25,133,158,302,2186,2488
00704700,LOS ANGELES SOUTHWEST COLLEGE           ,CA,90047-4810,Public       ,155,588,743,2315,5555,7870
00705000,BAY VISTA COLLEGE OF BEAUTY             ,CA,91950-3616,Proprietary  ,14,42,56,72,174,246
00711500,MOORPARK COLLEGE                        ,CA,93021-1695,Public       ,258,364,622,3054,2559,5613
00713000,NEWBERRY SCHOOLS OF BEAUTY              ,CA,91344-7404,Proprietary  ,12,21,33,62,96,158
00714200,LYLE'S COLLEGE OF BEAUTY                ,CA,93710-3948,Proprietary  ,8,26,34,83,195,278
00714201,LYLE'S CLG OF BTY BAKERSFIELD           ,CA,93301-0000,Proprietary  ,4,7,11,40,65,105
00716400,BRYAN COLLEGE                           ,CA,90057-0000,Proprietary  ,14,154,168,131,979,1110
00717801,WESTERN SEMINARY - BAY AREA CENTER      ,CA,95032-0000,Private      ,0,1,1,2,27,29
00717804,WESTERN SEMINARY - SACRAMENTO           ,CA,95821-3939,Private      ,0,5,5,8,41,49
00718700,NORTH ADRIAN'S COLLEGE OF BEAUTY        ,CA,95350-2381,Proprietary  ,33,53,86,162,239,401
00719000,WYOTECH                                 ,CA,94539-7663,Proprietary  ,147,342,489,802,1700,2502
00719001,WYOTECH - SIERRA CAMPUS                 ,CA,94621-4523,Proprietary  ,0,0,0,31,18,49
00720300,SALON SUCCESS ACADEMY                   ,CA,91786-4060,Proprietary  ,17,36,53,74,130,204
00720400,MODERN BEAUTY ACADEMY                   ,CA,93030-7016,Proprietary  ,7,5,12,35,42,77
00722900,WESTERN BEAUTY INSTITUTE                ,CA,91402-3104,Proprietary  ,24,62,86,191,506,697
00723400,HEALD COLLEGE                           ,CA,94105-2206,Proprietary  ,75,254,329,539,1512,2051
00723600,ART INST OF CALIFORNIA-LOS ANGELES      ,CA,90405-3035,Proprietary  ,522,515,1037,5407,4374,9781
00725300,FEDERICO BEAUTY INSTITUTE               ,CA,95834-1905,Proprietary  ,13,51,64,181,262,443
00729600,COLEMAN COLLEGE                         ,CA,92123-0000,Private      ,23,105,128,158,673,831
00746501,AMERICAN ACADEMY OF DRAMATIC ARTS - HOLL,CA,90028-7504,Private      ,10,9,19,202,111,313
00747600,MARINELLO SCHOOLS OF BEAUTY             ,CA,90023-2666,Proprietary  ,142,319,461,859,1784,2643
00747602,MARINELLO SCHOOLS OF BEAUTY - SPA ACADEM,CA,90048-5101,Proprietary  ,1,4,5,36,44,80
00747603,MARINELLO SCHOOLS OF BEAUTY - INGLEWOOD ,CA,90301-2306,Proprietary  ,0,4,4,13,15,28
00747604,MARINELLO SCHOOLS OF BEAUTY - RESEDA    ,CA,91335-4218,Proprietary  ,0,2,2,10,20,30
00747605,MARINELLO SCHOOLS OF BEAUTY - NORTH HOLL,CA,91606-3210,Proprietary  ,1,4,5,13,17,30
00747606,MARINELLO SCHOOLS OF BEAUTY - WEST COVIN,CA,91790-2805,Proprietary  ,0,0,0,11,11,22
00747607,MARINELLO SCHOOLS OF BEAUTY - SAN BERNAR,CA,92410-3261,Proprietary  ,3,7,10,30,32,62
00747608,MARINELLO SCHOOLS OF BEAUTY - ONTARIO   ,CA,91762-2113,Proprietary  ,4,15,19,47,59,106
00747609,MARINELLO SCHOOLS OF BEAUTY - WHITTIER  ,CA,90601-4107,Proprietary  ,1,4,5,22,25,47
00747611,MARINELLO SCHOOLS OF BEAUTY - SAN DIEGO ,CA,92126-4217,Proprietary  ,3,9,12,46,56,102
00747700,"HEALD COLLEGE,SCHOOLS OF BUS & TECH     ",CA,95670-6005,Proprietary  ,77,252,329,434,1422,1856
00753100,ACADEMY OF ART UNIVERSITY               ,CA,94105-3410,Proprietary  ,474,1177,1651,6661,11172,17833
00753600,COSUMNES RIVER COLLEGE                  ,CA,95823-5799,Public       ,388,879,1267,5063,6213,11276
00754802,WESTWOOD COLLEGE OF TECHNOLOGY          ,CA,92801-0000,Proprietary  ,152,122,274,1262,740,2002
00754803,WESTWOOD COLLEGE OF TECHNOLOGY          ,CA,91786-0000,Proprietary  ,92,115,207,1126,965,2091
00760600,EVEREST COLLEGE                         ,CA,90010-2221,Proprietary  ,49,112,161,320,606,926
00760700,CONCORDE CAREER INSTITUTE               ,CA,91606-3134,Proprietary  ,61,100,161,380,665,1045
00770700,COLUMBIA COLLEGE                        ,CA,95370-8580,Public       ,66,181,247,875,1230,2105
00771300,SKYLINE COLLEGE                         ,CA,94066-1698,Public       ,185,348,533,2162,2367,4529
00793000,CONCORDE CAREER INSTITUTE               ,CA,92108-0000,Proprietary  ,67,198,265,284,966,1250
00799300,CALIF STATE UNIV BAKERSFIELD            ,CA,93311-1022,Public       ,165,279,444,5860,5637,11497
00807100,CONCORDE CAREER INSTITUTE               ,CA,92840-9201,Proprietary  ,87,184,271,364,880,1244
00807300,BUTTE COMMUNITY COLLEGE                 ,CA,95965-0000,Public       ,370,886,1256,5304,6915,12219
00809000,EVEREST COLLEGE                         ,CA,91803-1310,Proprietary  ,48,133,181,286,620,906
00809300,HEALD COLLEGE                           ,CA,93704-1706,Proprietary  ,85,301,386,837,2011,2848
00853200,HEALD COLLEGE                           ,CA,94545-2352,Proprietary  ,94,268,362,787,1888,2675
00853700,CONCORDE CAREER INSTITUTE               ,CA,92401-0000,Proprietary  ,69,199,268,419,1107,1526
00859600,WEST LOS ANGELES COLLEGE                ,CA,90230-3500,Public       ,168,553,721,2331,4794,7125
00859700,FEATHER RIVER COLLEGE                   ,CA,95971-9124,Public       ,34,52,86,654,537,1191
00884400,CALIFORNIA CHRISTIAN COLLEGE            ,CA,93703-3599,Private      ,1,4,5,37,39,76
00884600,WRIGHT INSTITUTE                        ,CA,94704-0000,Private      ,0,7,7,0,467,467
00890300,COLLEGE OF THE CANYONS                  ,CA,91355-1899,Public       ,194,336,530,3615,3220,6835
00891800,SADDLEBACK COLLEGE                      ,CA,92692-3699,Public       ,331,627,958,3098,3970,7068
00902200,ASSOCIATED TECHNICAL COLLEGE            ,CA,90017-0000,Proprietary  ,58,223,281,206,644,850
00903200,EMPIRE COLLEGE                          ,CA,95403-2122,Proprietary  ,30,103,133,138,471,609
00915706,WYOMING TECHNICAL INSTITUTE - WEST SACRA,CA,95605-1507,Proprietary  ,194,330,524,943,1328,2271
00927200,CRAFTON HILLS COLLEGE                   ,CA,92399-1799,Public       ,203,418,621,2423,2911,5334
00932500,ABRAM FRIEDMAN OCCUP CTR                ,CA,90015-3507,Public       ,4,24,28,37,91,128
00950900,SKILLS & BUSINESS EDUCATION CENTER      ,CA,95824-1529,Public       ,24,176,200,184,1086,1270
00974800,WESTERN CAREER COLLEGE                  ,CA,95826-3203,Proprietary  ,159,565,724,669,1982,2651
00974801,WESTERN CAREER COLLEGE - SAN LEANDRO CAM,CA,94578-3711,Proprietary  ,76,215,291,406,1040,1446
00974802,WESTERN CAREER COLLEGE - PLEASANT HILL C,CA,94523-1984,Proprietary  ,53,87,140,244,589,833
00974803,WESTERN CAREER COLLEGE - STOCKTON       ,CA,95207-5509,Proprietary  ,63,107,170,370,623,993
00974804,WESTERN CAREER COLLEGE - CITRUS HEIGHTS ,CA,95621-5577,Proprietary  ,53,188,241,333,1026,1359
00974806,WESTERN CAREER COLLEGE -  ANTIOCH/WALNUT,CA,94531-1604,Proprietary  ,50,113,163,266,639,905
00974807,WESTERN CAREER COLLEGE - SAN JOSE       ,CA,95119-1325,Proprietary  ,82,227,309,606,1377,1983
00974808,WESTERN CAREER COLLEGE - EMERYVILLE     ,CA,94608-3006,Proprietary  ,21,80,101,147,448,595
00974810,WESTERN CAREER COLLEGE - CONCORD        ,CA,94520-5671,Proprietary  ,1,8,9,22,41,63
00998900,SANTA BARBARA BUSINESS COLLEGE          ,CA,93111-0000,Proprietary  ,28,84,112,194,519,713
01011100,CERRO-COSO COMMUNITY COLLEGE            ,CA,93555-9571,Public       ,54,259,313,565,1646,2211
01014225,TOURO CLG OSEOPATHIC MEDICINE           ,CA,94592-1115,Private      ,1,14,15,16,691,707
01014900,PEPPERDINE UNIVERSITY                   ,CA,90263-0000,Private      ,138,416,554,6152,6987,13139
01033300,JESUIT SCHOOL OF THEOLOGY - BERKELEY    ,CA,94709-1193,Private      ,0,2,2,1,52,53
01034000,LOS MEDANOS COLLEGE                     ,CA,94565-5197,Public       ,208,600,808,2404,3890,6294
01036500,CHARLES R DREW UNIV OF MED & SCI        ,CA,90059-0000,Private      ,0,25,25,58,504,562
01036800,MENNONITE BRETHREN BIBLICAL SEM         ,CA,93727-0000,Private      ,0,4,4,1,63,64
01037500,HARBOR OCCUPATIONAL CENTER              ,CA,90731-0000,Public       ,0,0,0,22,29,51
01039500,UNIVERSITY OF SAN DIEGO                 ,CA,92110-2492,Private      ,248,238,486,12931,3906,16837
01039501,UNIVERSITY OF SAN DIEGO - SCHOOL OF LAW ,CA,92110-2492,Private      ,33,64,97,137,3415,3552
01044100,PARDEE RAND GRADUATE SCHOOL             ,CA,90407-2138,Private      ,0,8,8,0,24,24
01047400,MARYMOUNT COLLEGE OF PALOS VERDES       ,CA,90275-0000,Private      ,23,5,28,572,68,640
01057900,WEST VALLEY OCCUPATIONAL CTR            ,CA,91367-0000,Public       ,0,0,0,61,100,161
01083200,WESTERN STATE UNIV COLLEGE OF LAW       ,CA,92831-3014,Proprietary  ,0,55,55,7,1040,1047
01085400,THOMAS JEFFERSON SCHOOL OF LAW          ,CA,92110-0000,Private      ,1,76,77,11,2152,2163
01102400,EVEREST COLLEGE                         ,CA,94103-2091,Proprietary  ,46,103,149,205,469,674
01110700,EVEREST  COLLEGE                        ,CA,92801-5231,Proprietary  ,93,187,280,421,1037,1458
01110900,EVEREST COLLEGE                         ,CA,91335-4631,Proprietary  ,72,169,241,409,756,1165
01111200,FIDM-FASHION INSTITUTE OF DESIGN        ,CA,90015-1421,Proprietary  ,377,213,590,6179,2244,8423
01111700,ALLIANT INTERNATIONAL UNIVERSITY        ,CA,92131-1799,Private      ,6,119,125,84,2535,2619
01111705,ALLIANT INTERNATIONAL UNIVERSITY - LOS A,CA,91803-1360,Private      ,4,15,19,11,593,604
01111706,ALLIANT INTERNATIONAL UNIVERSITY - SAN F,CA,94133-1221,Private      ,0,19,19,10,668,678
01111707,ALLIANT INTERNATIONAL UNIVERSITY - FRESN,CA,93727-2014,Private      ,1,17,18,17,411,428
01112100,EVEREST COLLEGE                         ,CA,94541-4007,Proprietary  ,31,142,173,128,590,718
01112300,EVEREST COLLEGE                         ,CA,90247-4163,Proprietary  ,50,169,219,261,897,1158
01146000,NATIONAL UNIVERSITY                     ,CA,92037-1011,Private      ,67,2322,2389,468,14069,14537
01162600,PRACTICAL SCHOOLS                       ,CA,92805-0000,Proprietary  ,38,91,129,454,841,1295
01164900,LOYOLA MARYMOUNT UNIVERSITY             ,CA,90045-0000,Private      ,141,189,330,10026,3131,13157
01164901,LOYOLA MARYMOUNT UNIVERSITY - LOYOLA LAW,CA,90015-0019,Private      ,7,31,38,43,3781,3824
01167200,MENDOCINO COMMUNITY COLLEGE             ,CA,95482-3000,Public       ,87,230,317,979,1495,2474
01169600,NATIONAL POLYTECHNIC COLLEGE OF SCIENCE ,CA,90744-6399,Private      ,4,64,68,64,333,397
01170700,NORTH-WEST COLLEGE                      ,CA,91790-2097,Proprietary  ,35,84,119,198,448,646
01179200,FRANCISCAN SCHOOL OF THEOLOGY           ,CA,94709-0000,Private      ,0,0,0,1,40,41
01182000,SAN DIEGO MIRAMAR COLLEGE               ,CA,92126-0000,Public       ,179,449,628,2543,3746,6289
01186500,CALIFORNIA HAIR DESIGN ACADEMY          ,CA,92115-0000,Proprietary  ,16,42,58,82,140,222
01186600,LU ROSS ACADEMY                         ,CA,93001-2927,Proprietary  ,14,18,32,50,75,125
01202600,JE BOUTIQUE COLLEGE OF BEAUTY           ,CA,92021-6247,Proprietary  ,12,15,27,54,96,150
01202700,GALEN COLLEGE OF CALIFORNIA             ,CA,93728-2381,Proprietary  ,6,36,42,44,127,171
01203100,SAN DIEGO CHRISTIAN COLLEGE             ,CA,92019-1157,Private      ,14,12,26,496,199,695
01206100,EVEREST COLLEGE                         ,CA,95128-3908,Proprietary  ,36,116,152,232,658,890
01215400,CALIFORNIA INSTITUTE OF INTEGRAL STUDIES,CA,94103-2557,Private      ,2,75,77,17,1453,1470
01215402,CALIFORNIA INSTITUTE OF INTEGRAL STUDIES,CA,94102-5403,Private      ,0,0,0,1,29,30
01231600,MANCHESTER BEAUTY COLLEGE               ,CA,93726-5306,Proprietary  ,6,35,41,84,244,328
01231700,TULARE BEAUTY COLLEGE                   ,CA,93274-3432,Proprietary  ,1,11,12,15,40,55
01244600,UNIVERSAL COLLEGE OF BEAUTY             ,CA,90044-0044,Proprietary  ,7,19,26,28,92,120
01245200,EVERGREEN VALLEY COLLEGE                ,CA,95135-1598,Public       ,182,410,592,3512,3639,7151
01255000,LOS ANGELES MISSION COLLEGE             ,CA,91342-3200,Public       ,133,325,458,2823,3345,6168
01265000,MARINELLO SCHOOL OF BEAUTY              ,CA,91502-2828,Proprietary  ,19,80,99,137,297,434
01265100,MARINELLO SCHOOL OF BEAUTY              ,CA,91748-1674,Proprietary  ,8,34,42,40,152,192
01284200,OXNARD COLLEGE                          ,CA,93030-0000,Public       ,173,451,624,2287,3115,5402
01287200,NORTH-WEST COLLEGE                      ,CA,91768-3199,Proprietary  ,23,78,101,140,408,548
01287300,WYOTECH                                 ,CA,90810-3800,Proprietary  ,198,405,603,993,1974,2967
01287301,WYOTECH - EVEREST  COLLEGE              ,CA,90034-3158,Proprietary  ,19,175,194,181,736,917
01287302,WYOTECH - EVEREST  COLLEGE              ,CA,91746-3412,Proprietary  ,78,234,312,450,1083,1533
01290700,LAKE TAHOE COMMUNITY COLLEGE            ,CA,96150-4524,Public       ,49,158,207,532,761,1293
01291100,MARINELLO SCHOOL OF BEAUTY              ,CA,92646-2552,Proprietary  ,8,20,28,53,95,148
01291200,MTI COLLEGE                             ,CA,95841-0000,Proprietary  ,42,170,212,397,1186,1583
01294200,ROSEMEAD BEAUTY SCHOOL                  ,CA,91770-1639,Proprietary  ,5,36,41,52,202,254
01298400,PROFESSIONAL INSTITUTE OF BEAUTY        ,CA,91731-2613,Proprietary  ,7,31,38,22,124,146
01298500,HAIR CALIFORNIA BEAUTY ACADEMY          ,CA,92867-7127,Proprietary  ,0,13,13,10,40,50
01298900,OCEANSIDE COLLEGE OF BEAUTY             ,CA,92054-5393,Proprietary  ,8,13,21,41,73,114
01301000,LANCASTER BEAUTY SCHOOL                 ,CA,93534-3098,Proprietary  ,14,34,48,73,140,213
01307400,AMERICAN BEAUTY COLLEGE                 ,CA,90706-5417,Proprietary  ,10,8,18,28,42,70
01309500,SALON SUCCESS ACADEMY                   ,CA,92879-6561,Proprietary  ,31,44,75,146,158,304
01310300,CALIFORNIA WESTERN SCHOOL OF LAW        ,CA,92101-0000,Private      ,4,65,69,26,2321,2347
01324000,LYTLE'S REDWOOD EMPIRE BEAUTY CLG       ,CA,95403-0000,Proprietary  ,19,30,49,104,139,243
02054900,MARINELLO SCHOOL OF BEAUTY              ,CA,92630-0000,Proprietary  ,7,15,22,59,120,179
02059800,PARIS BEAUTY COLLEGE                    ,CA,94520-2611,Proprietary  ,18,67,85,74,184,258
02063500,COASTLINE COMMUNITY COLLEGE             ,CA,92708-0000,Public       ,44,424,468,853,3657,4510
02064300,SIERRA COLLEGE OF BEAUTY                ,CA,95340-0000,Proprietary  ,6,22,28,47,94,141
02065500,BROOKS COLLEGE                          ,CA,90804-3289,Proprietary  ,0,0,0,28,11,39
02065700,CALIFORNIA BEAUTY COLLEGE               ,CA,95354-0000,Proprietary  ,9,14,23,72,94,166
02070500,CONCORDIA UNIVERSITY                    ,CA,92612-0000,Private      ,39,129,168,1957,1303,3260
02075800,SOUTHERN CA INST OF ARCHITECTURE        ,CA,90013-0000,Private      ,2,11,13,143,612,755
02086400,MARINELLO SCHOOL OF BEAUTY              ,CA,95050-0000,Proprietary  ,54,106,160,226,454,680
02091200,ELEGANCE INTERNATIONAL                  ,CA,90028-0000,Proprietary  ,15,19,34,98,140,238
02091700,KAPLAN COLLEGE                          ,CA,92123-1509,Proprietary  ,105,356,461,491,1925,2416
02096100,FIELDING INSTITUTE                      ,CA,93105-0000,Private      ,0,262,262,0,1411,1411
02099200,AMERICAN CONSERVATORY THEATER           ,CA,94108-0000,Private      ,2,1,3,22,150,172
02110200,COLUMBIA COLLEGE                        ,CA,91356-0000,Private      ,12,12,24,296,144,440
02110800,CALIFORNIA COLLEGE SAN DIEGO            ,CA,92108-3821,Proprietary  ,60,269,329,524,1590,2114
02111300,CUYAMACA COLLEGE                        ,CA,92019-0000,Public       ,222,641,863,2669,3836,6505
02113601,AMERICAN INTERCONTINENTAL UNIV - LOS ANG,CA,90066-7008,Proprietary  ,6,31,37,65,262,327
02119100,MISSION COLLEGE                         ,CA,95054-1897,Public       ,150,435,585,2003,3689,5692
02120600,SAYBROOK GRADUATE SCHOOL                ,CA,94111-1920,Private      ,1,54,55,4,746,750
02120700,SAN JOAQUIN VALLEY COLLEGE              ,CA,93291-0000,Proprietary  ,279,1045,1324,2326,5679,8005
02120900,ITT TECHNICAL INSTITUTE                 ,CA,95670-6034,Proprietary  ,118,335,453,668,1727,2395
02125000,CAREER ACADEMY OF BEAUTY                ,CA,92845-0000,Proprietary  ,9,35,44,50,128,178
02128200,"VICTOR VALLEY BEAUTY COLLEGE, INC       ",CA,92392-0000,Proprietary  ,12,23,35,120,151,271
02128300,INSTITUTE FOR BUSINESS & TECHNOLOGY     ,CA,95050-0000,Proprietary  ,38,167,205,155,653,808
02128301,INSTITUTE FOR BUSINESS & TECHNOLOGY     ,CA,95610-0000,Proprietary  ,17,77,94,80,332,412
02138300,PALO ALTO UNIVERSITY                    ,CA,94304-1337,Private      ,4,10,14,21,585,606
02147400,CLEVELAND CHIROPRACTIC COLLEGE          ,CA,90004-0000,Private      ,3,46,49,33,403,436
02161800,MUSICIANS INSTITUTE                     ,CA,90028-6157,Proprietary  ,145,160,305,1486,1138,2624
02167800,ESTES INSTITUTE OF COSMETOLOGY          ,CA,93291-0000,Proprietary  ,18,13,31,93,89,182
02174600,MARINELLO SCHOOL OF BEAUTY              ,CA,90201-0000,Proprietary  ,9,30,39,73,133,206
02180600,BRIDGES  ACADEMY OF BEAUTY              ,CA,92311-2327,Proprietary  ,3,3,6,11,16,27
02184900,PALMER COLLEGE OF CHIROPRACTIC WEST     ,CA,95134-0000,Private      ,0,11,11,8,363,371
02185800,MOLER BARBER COLLEGE                    ,CA,94611-0000,Proprietary  ,1,12,13,17,61,78
02187500,"HEALD COLLEGE, SCH OF BUS & TECH        ",CA,94520-0000,Proprietary  ,110,283,393,746,1737,2483
02188400,SIERRA VALLEY COLLEGE OF COURT REPORTING,CA,93726-0000,Proprietary  ,7,35,42,63,213,276
02208600,MADERA BEAUTY COLLEGE                   ,CA,93637-3519,Proprietary  ,2,13,15,33,44,77
02211000,HAIRMASTERS UNIVERSITY OF BEAUTY        ,CA,92405-0000,Proprietary  ,5,7,12,36,58,94
02220000,COLLEEN O'HARA BEAUTY ACADEMY           ,CA,92701-0000,Proprietary  ,24,50,74,100,211,311
02220200,CALIFORNIA CULINARY ACADEMY             ,CA,94102-3336,Proprietary  ,79,190,269,739,1037,1776
02221300,MARINELLO SCHOOL OF BEAUTY              ,CA,92553-0000,Proprietary  ,22,36,58,152,319,471
02222000,AMERICAN FILM INSTITUTE                 ,CA,90027-0000,Private      ,8,32,40,116,545,661
02226000,EAST LOS ANGELES COLLEGE                ,CA,91754-0000,Public       ,515,764,1279,9063,7962,17025
02228500,LIFE CHIROPRACTIC COLLEGE-WEST          ,CA,94545-0000,Private      ,0,10,10,9,412,421
02230900,FREDRICK & CHARLES BEAUTY COLLEGE       ,CA,95501-0000,Proprietary  ,2,7,9,39,71,110
02231900,GEMOLOGICAL INSTITUTE OF AMERICA        ,CA,92008-4698,Private      ,13,40,53,62,255,317
02234300,FASHION CAREERS OF CALIFORNIA           ,CA,92110-0000,Proprietary  ,12,25,37,120,129,249
02236400,"THANH LE COLG, SCH OF COSMETOLOGY       ",CA,92840-0000,Proprietary  ,3,17,20,9,59,68
02237200,PHILLIPS GRADUATE INSTITUTE             ,CA,91316-0000,Private      ,1,21,22,4,324,328
02241600,SAN DIEGO CONTINUING EDUCATION          ,CA,92113-0000,Public       ,6,75,81,63,413,476
02241800,AMERICAN CAREER COLLEGE                 ,CA,90004-0000,Proprietary  ,300,634,934,1762,3797,5559
02242700,BERKELEY CITY COLLEGE                   ,CA,94704-0000,Public       ,124,315,439,1570,2466,4036
02250602,EVEREST COLLEGE                         ,CA,91761-8525,Proprietary  ,48,173,221,370,1186,1556
02255400,INTERNATIONAL SCHOOL OF COSMETOLOGY     ,CA,90250-0000,Proprietary  ,10,9,19,56,49,105
02255600,MARINELLO SCHOOL OF BEAUTY              ,CA,90723-0000,Proprietary  ,14,21,35,85,183,268
02258600,ALAMEDA BEAUTY COLLEGE                  ,CA,94501-0000,Proprietary  ,25,60,85,135,215,350
02262400,YESHIVA OHR ELCHONON CHABAD             ,CA,90046-0000,Private      ,13,1,14,37,4,41
02263101,ANTHEM COLLEGE - HIGH-TECH INSTITUTE - S,CA,95827-0000,Proprietary  ,1,8,9,62,86,148
02267600,INSTITUTE OF TRANSPERSONAL PSYCHLGY     ,CA,94303-4624,Private      ,0,26,26,1,464,465
02270600,LIFE PACIFIC COLLEGE                    ,CA,91773-0000,Private      ,26,19,45,313,194,507
02276800,WESTMINSTER SEMINARY CALIFORNIA         ,CA,92027-0000,Private      ,0,3,3,0,144,144
02277400,SOUTH COAST COLLEGE                     ,CA,92868-2616,Proprietary  ,11,44,55,105,422,527
02282300,ALHAMBRA BEAUTY COLLEGE                 ,CA,91802-0000,Proprietary  ,15,49,64,33,126,159
02285100,HILLTOP BEAUTY SCHOOL                   ,CA,94014-0000,Proprietary  ,2,13,15,25,147,172
02291500,ITT TECHNICAL INSTITUTE                 ,CA,91773-0000,Proprietary  ,177,320,497,829,1465,2294
02291600,ITT TECHNICAL INSTITUTE                 ,CA,92123-0000,Proprietary  ,147,421,568,855,2131,2986
02298000,DESIGN INSTITUTE OF SAN DIEGO           ,CA,92121-0000,Proprietary  ,4,27,31,138,251,389
02304300,"PLATT COLLEGE, SAN DIEGO                ",CA,92115-0000,Proprietary  ,25,51,76,195,323,518
02306300,KAPLAN COLLEGE                          ,CA,95368-0000,Proprietary  ,67,157,224,543,1085,1628
02306302,KAPLAN COLLEGE - FRESNO                 ,CA,93612-3802,Proprietary  ,41,103,144,319,691,1010
02309500,CLOVIS ADULT EDUC                       ,CA,93611-0000,Public       ,4,42,46,40,267,307
02312400,LA COLLEGE INTERNATIONAL                ,CA,90010-0000,Proprietary  ,21,376,397,72,1409,1481
02321800,ITT TECHNICAL INSTITUTE                 ,CA,91342-3664,Proprietary  ,148,327,475,835,1553,2388
02321900,ITT TECHNICAL INSTITUTE                 ,CA,92801-0000,Proprietary  ,159,344,503,681,1546,2227
02327600,ART INST OF CALIFORNIA-SAN DIEGO        ,CA,92108-4401,Proprietary  ,319,349,668,3164,2944,6108
02330500,LAGUNA COLLEGE OF ART AND DESIGN        ,CA,92651-0000,Private      ,15,14,29,386,176,562
02332800,CENTER FOR EMPLOYMENT TRAINING          ,CA,95110-0000,Private      ,147,640,787,445,2410,2855
02338500,GLENDALE CAREER COLLEGE                 ,CA,91201-0000,Proprietary  ,24,60,84,111,235,346
02338700,MARINELLO SCHOOL OF BEAUTY              ,CA,94103-0000,Proprietary  ,60,108,168,111,264,375
02342400,ACADEMY OF RADIO BROADCASTING           ,CA,92647-3809,Proprietary  ,16,51,67,61,181,242
02343400,"BELLUS ACADEMY, THE ACADEMY OF BEAUTY AN",CA,92064-4633,Proprietary  ,28,59,87,114,240,354
02345800,MONTEBELLO BEAUTY COLLEGE               ,CA,90640-0000,Proprietary  ,7,16,23,41,72,113
02351900,KAPLAN COLLEGE                          ,CA,95660-5512,Proprietary  ,36,196,232,288,1113,1401
02351901,KAPLAN COLLEGE - BAKERSFIELD            ,CA,93304-0000,Proprietary  ,65,172,237,453,1140,1593
02358000,THOMAS AQUINAS COLLEGE                  ,CA,93060-9622,Private      ,2,1,3,341,25,366
02359300,SHASTA BIBLE COLLEGE                    ,CA,96002-0000,Private      ,2,5,7,48,60,108
02482700,WESTERN UNIVERSITY OF HEALTH S          ,CA,91766-1854,Private      ,5,35,40,85,4511,4596
02494800,LOLA BEAUTY COLLEGE                     ,CA,92641-0000,Proprietary  ,1,5,6,6,32,38
02497300,TRINITY COLLEGE                         ,CA,93277-0000,Proprietary  ,45,168,213,221,839,1060
02500000,SAN JOAQUIN COLLEGE OF LAW              ,CA,93612-0000,Private      ,1,8,9,11,308,319
02518400,THE NATIONAL HISPANIC UNIVERSITY        ,CA,95127-0000,Private      ,13,44,57,301,426,727
02519800,AVANCE BEAUTY COLLEGE                   ,CA,92154-0000,Proprietary  ,3,17,20,45,96,141
02520200,CALIFORNIA CAREER SCHOOLS               ,CA,92805-0000,Proprietary  ,2,13,15,16,66,82
02520300,INTERIOR DESIGNERS INSTITUTE            ,CA,92660-0000,Proprietary  ,10,48,58,37,134,171
02520400,ADRIAN'S BEAUTY COLLEGE OF TURLOCK      ,CA,95382-0000,Proprietary  ,17,38,55,90,139,229
02537200,PALOMAR INSTITUTE OF COSMETOLOGY        ,CA,92069-0000,Proprietary  ,23,29,52,141,161,302
02539100,KAPLAN COLLEGE                          ,CA,91606-3231,Proprietary  ,59,151,210,495,1342,1837
02539102,KAPLAN COLLEGE -  RIVERSIDE             ,CA,92507-4223,Proprietary  ,72,160,232,430,1014,1444
02539500,IRVINE VALLEY COLLEGE                   ,CA,92620-0000,Public       ,194,405,599,2482,2605,5087
02542300,NATIONAL HOLISTIC INSTITUTE             ,CA,94608-0000,Proprietary  ,38,119,157,191,607,798
02543400,BROWNSON TECHNICAL SCHOOL               ,CA,92805-0000,Proprietary  ,5,71,76,18,211,229
02545900,HYPNOSIS MOTIVATION INSTITUTE           ,CA,91356-0000,Private      ,2,47,49,6,146,152
02546400,MTI BUSINESS COLLEGE INC                ,CA,95207-0000,Proprietary  ,5,41,46,20,156,176
02549000,KAPLAN COLLEGE                          ,CA,92083-7736,Proprietary  ,106,250,356,616,1533,2149
02549005,KAPLAN COLLEGE -  PALM SPRINGS          ,CA,92262-7011,Proprietary  ,48,108,156,316,891,1207
02553500,ASSOCIATED TECHNICAL COLLEGE            ,CA,92101-0000,Proprietary  ,14,58,72,82,275,357
02553600,DIVERSIFIED LANGUAGE INSTITUTE          ,CA,90017-0000,Proprietary  ,8,203,211,27,863,890
02559300,UNITED EDUCATION INSTITUTE              ,CA,90020-0000,Proprietary  ,831,1778,2609,3048,6774,9822
02559400,INTERCOAST COLLEGES                     ,CA,92868-1656,Proprietary  ,54,603,657,247,2580,2827
02565400,KAPLAN COLLEGE                          ,CA,95207-6216,Proprietary  ,67,125,192,308,747,1055
02570300,LOS ANGELES ORT TECHNICAL INSTITUTE     ,CA,90048-0000,Private      ,44,267,311,188,913,1101
02577900,SANTA BARBARA BUSINESS COLLEGE          ,CA,93309-1664,Proprietary  ,81,197,278,424,982,1406
02578000,SANTA BARBARA BUSINESS COLLEGE          ,CA,93454-6943,Proprietary  ,29,70,99,157,432,589
02584200,NEWBRIDGE COLLEGE                       ,CA,92701-0000,Proprietary  ,28,125,153,193,689,882
02591600,NORTH-WEST COLLEGE                      ,CA,91101-1744,Proprietary  ,14,21,35,47,117,164
02593100,HEALD COLLEGE                           ,CA,95678-5303,Proprietary  ,68,232,300,452,1502,1954
02593200,HEALD COLLEGE                           ,CA,95035-8008,Proprietary  ,97,252,349,578,1634,2212
02593300,HEALD COLLEGE                           ,CA,95210-5667,Proprietary  ,132,345,477,782,2139,2921
02595600,ASIAN AMERICAN INTERNATIONAL BTY CG     ,CA,92683-4043,Proprietary  ,5,12,17,19,67,86
02597300,SOUTH BAYLO UNIVERSITY                  ,CA,92801-1701,Private      ,0,39,39,3,205,208
02602300,CENTRAL COAST COLLEGE                   ,CA,93901-3301,Proprietary  ,26,66,92,139,300,439
02608900,PINNACLE COLLEGE                        ,CA,91803-8842,Proprietary  ,12,13,25,47,100,147
02608901,PINNACLE COLLEGE - SACRAMENTO           ,CA,95826-2581,Proprietary  ,12,22,34,69,93,162
02609000,EMPERORS COLG OF TRAD ORIENTAL MED      ,CA,90403-5609,Proprietary  ,0,38,38,4,166,170
02612800,LOS ANGELES RECORDING SCHOOL            ,CA,90028-3112,Proprietary  ,101,139,240,699,778,1477
02619300,SAMRA UNIV OF ORIENTAL MEDICINE         ,CA,90015-1019,Private      ,0,14,14,1,85,86
03010611,VIRGINIA COLLEGE - GOLF ACADEMY OF AMERI,CA,92008-6512,Proprietary  ,20,36,56,134,298,432
03011300,"CALIF STATE UNIV, SAN MARCOS            ",CA,92096-0001,Public       ,200,310,510,9077,5044,14121
03019900,ADELANTE CAREER INSTITUTE               ,CA,91402-4924,Proprietary  ,0,20,20,10,63,73
03025600,DELL'ARTE SCH OF PHYSICAL THEATRE       ,CA,95525-0816,Private      ,0,1,1,6,42,48
03027700,PACIFIC COLLEGE OF ORIENTAL MED         ,CA,92108-4408,Proprietary  ,4,125,129,23,527,550
03029600,POMONA ADULT SCHOOL                     ,CA,91766-0000,Public       ,12,38,50,58,188,246
03031409,INTERNATIONAL ACADEMY OF DESIGN AND TECH,CA,95834-9664,Proprietary  ,35,70,105,367,568,935
03034000,HEALD COLLEGE                           ,CA,93906-5100,Proprietary  ,78,185,263,649,1300,1949
03035700,LAS POSITAS COLLEGE                     ,CA,94551-6750,Public       ,148,290,438,1710,1893,3603
03039900,FREMONT COLLEGE                         ,CA,90703-5342,Proprietary  ,26,67,93,142,276,418
03043900,NEWSCHOOL OF ARCHITECTURE & DESIGN      ,CA,92101-6634,Proprietary  ,15,45,60,252,549,801
03044500,KAPLAN COLLEGE                          ,CA,91402-4222,Proprietary  ,20,92,112,139,402,541
03054100,ROYALE COLLEGE OF BEAUTY                ,CA,92590-2525,Proprietary  ,9,19,28,46,109,155
03062300,WESTECH COLLEGE                         ,CA,91764-4988,Proprietary  ,40,232,272,169,776,945
03062400,MT DIABLO ADULT EDUC LOMA VISTA CTR     ,CA,94518-1122,Public       ,4,35,39,41,167,208
03062700,PLATT COLLEGE                           ,CA,90041-0000,Proprietary  ,15,33,48,123,180,303
03062701,PLATT COLLEGE                           ,CA,91764-0000,Proprietary  ,28,62,90,220,373,593
03063400,MODERN TECHNOLOGY SCHOOL                ,CA,92708-9821,Proprietary  ,5,25,30,49,182,231
03067400,BALDWIN PARK ADULT SCHOOL               ,CA,91706-4897,Public       ,28,36,64,76,179,255
03067500,INSTITUTE OF TECHNOLOGY                 ,CA,93612-3217,Proprietary  ,177,630,807,930,3107,4037
03067505,INSTITUTE OF TECHNOLOGY - REDDING       ,CA,96002-0926,Proprietary  ,5,20,25,6,29,35
03069500,SAGE COLLEGE                            ,CA,92557-6720,Proprietary  ,39,109,148,145,560,705
03070400,ITT TECHNICAL INSTITUTE                 ,CA,92408-3519,Proprietary  ,149,318,467,969,1851,2820
03072300,EVEREST COLLEGE                         ,CA,91761-3222,Proprietary  ,69,179,248,372,879,1251
03072700,WESTWOOD COLLEGE - LOS ANGELES          ,CA,90010-1577,Proprietary  ,299,1730,2029,2421,8442,10863
03074900,MARTINEZ ADULT CENTER                   ,CA,94553-3298,Public       ,0,12,12,3,63,66
03078200,AMERICAN CLG TRADITIONAL CHINESE MD     ,CA,94107-2813,Private      ,0,21,21,3,254,257
03084700,VENTURA ADULT\CONTINUING EDUCATION      ,CA,93003-7313,Public       ,13,47,60,51,181,232
03087400,ITT TECHNICAL INSTITUTE                 ,CA,90502-1356,Proprietary  ,174,560,734,858,2367,3225
03094400,ELITE PROGRESSIVE SCHOOL OF COSM        ,CA,95841-2909,Proprietary  ,39,78,117,229,345,574
03097700,CENTRAL CALIF SCH CONTINUING EDUC       ,CA,93401-6739,Proprietary  ,17,54,71,63,237,300
03098200,YO SAN UNIV TRADITIONAL CHINESE MED     ,CA,90066-1103,Private      ,0,35,35,2,171,173
03108100,SUMMIT CAREER COLLEGE                   ,CA,92324-3956,Proprietary  ,123,432,555,427,1548,1975
03109500,DONGGUK ROYAL UNIVERSITY                ,CA,90020-1765,Private      ,1,7,8,2,69,71
03113300,MCED CAREER COLLEGE                     ,CA,93727-1620,Proprietary  ,6,99,105,50,501,551
03113600,SOUTHERN CALIFORNIA INST OF TECHNOL     ,CA,92805-3758,Proprietary  ,7,204,211,89,988,1077
03116600,EAST SAN GABRIEL VLY REG OCCUP PROG     ,CA,91790-2105,Public       ,13,138,151,61,641,702
03125300,JOHN WESLEY INTER. BARBER & BTY CLG     ,CA,90813-4321,Proprietary  ,7,14,21,42,80,122
03125400,ART INSTITUTE OF CALIFORNIA-HOLLYWOOD (T,CA,90010-1014,Proprietary  ,208,235,443,2015,1707,3722
03125800,PREMIERE CAREER COLLEGE                 ,CA,91706-3746,Proprietary  ,24,75,99,144,379,523
03126800,PACIFICA GRADUATE INSTITUTE             ,CA,93013-0000,Proprietary  ,0,66,66,2,900,902
03128700,MT SIERRA COLLEGE                       ,CA,91016-3414,Proprietary  ,26,56,82,246,428,674
03131300,FIVE BRANCHES UNIVERSITY                ,CA,95062-4669,Private      ,3,27,30,18,353,371
03144400,AMERICAN CLG OF HEALTH PROFESSIONS      ,CA,92374-0000,Proprietary  ,5,38,43,18,72,90
03150500,VIRGINIA SEWING MACHINES & SCH CTR      ,CA,90015-3535,Proprietary  ,0,14,14,2,60,62
03162300,FOUR-D SUCCESS ACADEMY                  ,CA,92324-4218,Proprietary  ,50,159,209,222,871,1093
03163300,PACIFIC STATES UNIVERSITY               ,CA,90006-4298,Private      ,1,6,7,20,45,65
03195400,EVEREST COLLEGE                         ,CA,90501-2867,Proprietary  ,25,50,75,106,213,319
03210300,CALIFORNIA SCHOOL OF CULINARY ARTS      ,CA,91101-5221,Proprietary  ,234,679,913,1605,2659,4264
03225300,AMERICAN UNIVERSITY OF HEALTH SCIENCES  ,CA,90755-3612,Proprietary  ,11,27,38,66,145,211
03242300,CAREER NETWORK INSTITUTE                ,CA,92868-4710,Proprietary  ,48,164,212,154,535,689
03250300,COMMUNITY BASED EDUCATION AND DEVEL     ,CA,90036-1137,Private      ,21,32,53,64,274,338
03260300,CALIFORNIA STATE U-MONTEREY BAY         ,CA,93955-8001,Public       ,138,161,299,7066,2441,9507
03266300,BETHESDA CHRISTIAN UNIVERSITY           ,CA,92801-4132,Private      ,1,10,11,12,47,59
03278300,CLARITA CAREER COLLEGE                  ,CA,91351-5432,Proprietary  ,133,295,428,505,1245,1750
03282300,KIM ANH ACADEMY OF BEAUTY               ,CA,92683-4605,Proprietary  ,3,61,64,19,213,232
03288300,ACAD CHINESE CULTURE & HEALTH SCIS      ,CA,94512-0000,Private      ,0,15,15,4,82,86
03299300,PACIFIC COLLEGE                         ,CA,92626-3160,Proprietary  ,12,102,114,75,533,608
03308300,KENSINGTON COLLEGE                      ,CA,92705-8708,Proprietary  ,1,26,27,7,69,76
03321300,SCRIPPS RESEARCH INSTITUTE (THE)        ,CA,92037-0000,Private      ,1,1,2,6,35,41
03327400,ACUPUNCTURE AND INTEGRATIVE MEDICINE COL,CA,94704-2724,Private      ,0,18,18,4,201,205
03332300,SOUTHERN CA BIBLE CLG & SEMINARY        ,CA,92019-1109,Private      ,1,21,22,6,155,161
03359300,ST. FRANCIS CAREER COLLEGE              ,CA,90262-2659,Private      ,10,29,39,110,316,426
03367300,PROFESSIONAL GOLFERS CAREER COLLEGE     ,CA,92591-6013,Proprietary  ,44,73,117,282,448,730
03394300,REMINGTON COLLEGE - SAN DIEGO CAMPUS    ,CA,92108-3002,Proprietary  ,35,107,142,336,649,985
03395300,INTERNATIONAL CAREER DEVELOPMENT        ,CA,90027-5794,Proprietary  ,197,787,984,890,2587,3477
03399300,NORTHWESTERN TECHNICAL COLLEGE          ,CA,95670-4443,Proprietary  ,28,95,123,132,471,603
03403300,TRINITY LIFE BIBLE COLLEGE              ,CA,95842-3546,Private      ,7,39,46,72,292,364
03413400,ENGLISH CENTER  (THE)                   ,CA,94607-3734,Private      ,3,36,39,30,220,250
03427400,CAREER COLLEGES OF AMERICA              ,CA,90280-7420,Proprietary  ,92,352,444,468,2062,2530
03427500,ANTELOPE VALLEY MEDICAL COLLEGE         ,CA,93534-3324,Proprietary  ,74,173,247,349,799,1148
03440400,MARIAN HEALTH CAREERS CENTER            ,CA,90010-1728,Proprietary  ,16,36,52,55,133,188
03441400,VALLEY CAREER COLLEGE                   ,CA,92020-3057,Proprietary  ,17,89,106,116,401,517
03455900,VALLECITOS CENTER FOR EMPLOYMENT TR     ,CA,94541-5027,Private      ,0,0,0,4,9,13
03458300,MY LE'S BEAUTY COLLEGE                  ,CA,95824-3039,Proprietary  ,5,34,39,50,172,222
03467300,MARINELLO SCHOOL OF BEAUTY              ,CA,92545-3661,Proprietary  ,32,53,85,169,343,512
03467301,CALIFORNIA BEAUTY COLLEGE - DESERT HOT S,CA,92240-1307,Proprietary  ,0,0,0,3,1,4
03474700,OPPORTUNITIES INDUSTRIALIZATION CEN     ,CA,94025-1413,Private      ,0,0,0,1,4,5
03479300,PROFESSIONAL CAREER INSTITUTE           ,CA,90703-2522,Proprietary  ,5,32,37,62,220,282
03485400,JAMES ALBERT SCHOOL OF COSMETOLOGY      ,CA,92627-3831,Proprietary  ,16,33,49,71,137,208
03485401,JAMES ALBERT SCHOOL OF COSMETOLOGY - ANA,CA,92804-5384,Proprietary  ,0,2,2,8,11,19
03516300,THE KING'S COLLEGE AND SEMINARY         ,CA,91405-2233,Private      ,26,44,70,59,306,365
03532400,ADVANCED TRAINING ASSOCIATES            ,CA,92020-1236,Proprietary  ,4,6,10,9,48,57
03542400,COPPER MOUNTAIN COLLEGE                 ,CA,92252-6102,Public       ,68,285,353,612,1790,2402
03577300,COBA ACADEMY                            ,CA,92866-1407,Proprietary  ,12,13,25,65,65,130
03590400,NTMA TRAINING CENTERS OF SOUTHERN C     ,CA,90650-6099,Private      ,30,147,177,81,490,571
03592400,IRELL & MANELLA GRADUATE SCHOOL OF BIOLO,CA,91010-0000,Private      ,0,1,1,2,17,19
03598300,AVALON BEAUTY COLLEGE                   ,CA,93103-3137,Proprietary  ,22,20,42,78,64,142
03614300,UNITED BEAUTY COLLEGE                   ,CA,91733-0000,Proprietary  ,2,27,29,11,67,78
03621300,LIBERTY TRAINING INSTITUTE              ,CA,90057-3202,Proprietary  ,8,39,47,28,100,128
03639300,WEST COAST ULTRASOUND INSTITUTE         ,CA,90211-3312,Proprietary  ,53,218,271,264,1108,1372
03646300,DESIGN'S SCHOOL OF COSMETOLOGY          ,CA,93446-1471,Proprietary  ,17,31,48,67,152,219
03681300,CALIFORNIA HEALING ARTS COLLEGE         ,CA,90025-2589,Proprietary  ,11,35,46,42,136,178
03695300,COMMUNITY ENHANCEMENT SERVICES          ,CA,91205-2395,Private      ,4,29,33,17,100,117
03695700,SANTIAGO CANYON COLLEGE                 ,CA,92869-4512,Public       ,90,125,215,1779,1435,3214
03696300,UNIVERSITY OF THE WEST                  ,CA,91770-3709,Private      ,1,1,2,6,52,58
03698300,WEST COAST UNIVERSITY                   ,CA,90004-0000,Proprietary  ,234,595,829,714,2341,3055
03698400,CA COLLEGE OF VOCATIONAL CAREER         ,CA,93301-1800,Proprietary  ,14,67,81,54,161,215
03736300,ADVANCE BEAUTY COLLEGE                  ,CA,92843-4752,Proprietary  ,6,133,139,26,355,381
03740400,ATI COLLEGE                             ,CA,90650-0000,Proprietary  ,9,43,52,48,238,286
03759300,COMPUTER TUTOR BUSINESS & TECH INST     ,CA,95356-0000,Proprietary  ,13,41,54,34,130,164
03786300,ADVANCED COLLEGE                        ,CA,90280-5255,Proprietary  ,15,104,119,71,390,461
03797400,CAREER CARE INSTITUTE                   ,CA,93534-4766,Proprietary  ,46,141,187,186,681,867
03797401,CAREER CARE INSTITUTE - VENTURA         ,CA,93003-0000,Proprietary  ,0,5,5,26,80,106
03806300,LAKE COLLEGE                            ,CA,96002-0926,Proprietary  ,0,0,0,9,62,71
03810300,SILICON VALLEY UNIVERSITY               ,CA,95131-1868,Private      ,0,3,3,13,44,57
03814400,SOKA UNIVERSITY OF AMERICA              ,CA,92656-8081,Private      ,6,2,8,463,48,511
03838400,WALTER JAY M.D. INSTITUTE AN EDUCATIONAL,CA,90057-0000,Proprietary  ,6,41,47,11,92,103
03852500,CIT COLLEGE OF INFOMEDICAL TECHNOLOGY   ,CA,92831-3703,Proprietary  ,14,138,152,69,480,549
03852501,CIT COLLEGE OF INFOMEDICAL TECHNOLOGY - ,CA,90010-1308,Proprietary  ,0,0,0,1,2,3
03853300,KECK GRADUATE INSTITUTE OF APPLIED LIFE ,CA,91711-4817,Private      ,0,3,3,2,71,73
03853400,LADERA CAREER PATHS TRAINING CENTERS    ,CA,90045-1931,Proprietary  ,0,8,8,6,37,43
03868300,WORLD MISSION UNIVERSITY                ,CA,90020-1789,Private      ,0,6,6,2,71,73
03868400,LOS ANGELES MUSIC ACADEMY               ,CA,91105-2540,Proprietary  ,6,10,16,73,64,137
03871300,FOLSOM LAKE COLLEGE                     ,CA,95630-6798,Public       ,169,390,559,1880,2595,4475
03874300,CAMBRIDGE JUNIOR COLLEGE                ,CA,95993-0000,Proprietary  ,11,44,55,78,187,265
03874400,COMMMUNITY CHRISTIAN COLLEGE            ,CA,92373-4465,Private      ,4,8,12,66,70,136
03889300,STANBRIDGE COLLEGE                      ,CA,92612-0000,Proprietary  ,32,134,166,126,562,688
03901300,PACIFIC COAST TRADE SCHOOL              ,CA,93033-2441,Proprietary  ,10,46,56,34,172,206
03910400,NATIONAL POLYTECHNIC COLLEGE            ,CA,90040-3066,Proprietary  ,12,56,68,61,236,297
03933300,MUELLER COLLEGE OF HOLISTIC STUDIES     ,CA,92116-2630,Proprietary  ,13,30,43,49,231,280
03933301,MUELLER COLLEGE OF HOLISTIC STUDIES -   ,CA,92120-3449,Proprietary  ,0,7,7,1,20,21
03935300,CALIFORNIA NURSES EDUCATIONAL INSTITUTE ,CA,92234-7248,Proprietary  ,6,10,16,18,59,77
03962300,AMERICAN INSTITUTE OF MASSAGE THERAPY   ,CA,92705-5463,Proprietary  ,3,9,12,28,49,77
03964400,INTERNATIONAL SCHOOL OF BEAUTY          ,CA,92260-2740,Proprietary  ,15,39,54,63,189,252
03969600,AMERICAN AUTO INSTITUTE                 ,CA,90703-2637,Proprietary  ,21,57,78,50,117,167
03971300,AMERICAN CAREER COLLEGE                 ,CA,91764-4906,Proprietary  ,109,260,369,645,1451,2096
03973300,EX'PRESSION COLLEGE FOR DIGITAL ARTS    ,CA,94608-1021,Proprietary  ,63,76,139,666,681,1347
03974500,CALIFORNIA CAREER COLLEGE               ,CA,91303-2006,Proprietary  ,3,13,16,27,99,126
03980300,CALIFORNIA STATE UNIVERSITY CHANNEL ISLA,CA,93012-8599,Public       ,84,106,190,3866,1935,5801
03995300,UNIVERSITY OF EAST-WEST MEDICINE        ,CA,94087-6106,Proprietary  ,1,8,9,8,56,64
03999300,BEAUMONT ADULT SCHOOL                   ,CA,92223-1927,Public       ,2,13,15,28,140,168
04001300,PALACE BEAUTY COLLEGE                   ,CA,90006-4233,Proprietary  ,7,21,28,31,106,137
04001400,MOJAVE BARBER COLLEGE                   ,CA,92395-3201,Proprietary  ,3,24,27,24,89,113
04003300,CSI CAREER COLLEGE                      ,CA,95687-3100,Proprietary  ,24,94,118,138,492,630
04004300,THUY PRINCESS BEAUTY COLLEGE            ,CA,91766-0000,Proprietary  ,3,20,23,13,90,103
04005300,INTERAMERICAN COLLEGE                   ,CA,91950-4437,Private      ,5,73,78,10,196,206
04014400,PALLADIUM TECHNICAL ACADEMY             ,CA,91731-2429,Proprietary  ,16,21,37,30,93,123
04023400,PROTEUS                                 ,CA,93291-3014,Private      ,0,4,4,4,15,19
04037300,LOS ANGELES FILM SCHOOL (THE)           ,CA,90028-7300,Proprietary  ,94,160,254,654,711,1365
04049300,MAXINE WATERS EMPLOYMENT PREPARATION CEN,CA,90059-1023,Public       ,2,20,22,15,99,114
04056300,CAREER COLLEGE OF CALIFORNIA            ,CA,92705-5805,Proprietary  ,0,10,10,10,35,45
04057300,TECHSKILLS OF SACRAMENTO                ,CA,95815-4025,Proprietary  ,12,84,96,54,382,436
04071300,AMERICAN PACIFIC COLLEGE                ,CA,91405-6232,Proprietary  ,0,0,0,5,23,28
04076400,GNOMON SCHOOL OF VISUAL EFFECTS         ,CA,90038-2616,Proprietary  ,3,30,33,30,139,169
04092300,COASTLINE BEAUTY COLLEGE                ,CA,92708-3847,Proprietary  ,4,55,59,17,172,189
04092400,MAKE-UP DESIGNORY                       ,CA,91502-1322,Proprietary  ,42,56,98,280,289,569
04100400,TAFT UNIVERSITY SYSTEM (THE)            ,CA,92704-6954,Proprietary  ,0,47,47,3,304,307
04109300,ACADEMY OF BARBERING ARTS (THE)         ,CA,91324-3406,Proprietary  ,19,21,40,56,114,170
04111300,WEST HILLS COLLEGE LEMOORE              ,CA,93245-9248,Public       ,65,241,306,1388,2345,3733
04114500,VALLEY COLLEGE OF MEDICAL CAREERS       ,CA,91304-2354,Proprietary  ,13,31,44,56,168,224
04115300,COACHELLA VALLEY BEAUTY COLLEGE         ,CA,92253-2051,Proprietary  ,8,8,16,28,64,92
04115600,MAYFIELD COLLEGE                        ,CA,92234-7014,Proprietary  ,13,54,67,27,125,152
04116000,VIDEO SYMPHONY ENTERTRAINING            ,CA,91502-3253,Proprietary  ,11,66,77,75,330,405
04119200,CAREER COLLEGE CONSULTANTS              ,CA,90041-2088,Proprietary  ,4,30,34,12,91,103
04126400,CHAMPION INSTITUTE OF COSMETOLOGY       ,CA,92264-7458,Proprietary  ,3,15,18,15,58,73
04126500,COAST CAREER INSTITUTE                  ,CA,90015-3040,Proprietary  ,44,151,195,129,486,615
04127100,"UNIVERSITY OF CALIFORNIA, MERCED        ",CA,95343-5001,Public       ,90,36,126,7886,1004,8890
04127800,HEALTHY HAIR ACADEMY                    ,CA,90303-3137,Proprietary  ,10,38,48,32,121,153
04127900,TUI UNIVERSITY                          ,CA,90630-5023,Proprietary  ,8,304,312,27,1812,1839
04129700,INTERNATIONAL POLYTECHNIC INSTITUTE     ,CA,92231-1737,Private      ,0,2,2,4,20,24
04132300,INSTITUTE OF MEDICAL EDUCATION          ,CA,95113-2207,Proprietary  ,10,83,93,105,641,746
04132400,ACADEMY OF ESTHETICS AND COSMETOLOGY    ,CA,91342-3373,Proprietary  ,0,4,4,11,20,31
04132700,INFOTECH CAREER COLLEGE                 ,CA,90706-5579,Proprietary  ,14,44,58,57,189,246
04133000,BIOHEALTH COLLEGE                       ,CA,95134-2033,Proprietary  ,4,34,38,16,157,173
04134500,CAREER COLLEGE OF SAN DIEGO             ,CA,92102-3348,Proprietary  ,11,68,79,45,277,322
04134700,INTERNATL PROFESSIONAL SCHL OF BODYWORK ,CA,92123-1520,Proprietary  ,7,46,53,37,182,219
04137200,BORNER'S BARBER COLLEGE                 ,CA,90047-3856,Proprietary  ,3,2,5,11,27,38
04138700,CAO INSTITUTE OF AESTHETICS (THE)       ,CA,91801-3903,Proprietary  ,15,27,42,53,82,135
04141300,SAN FRANCISCO INSTITUTE OF ESTHETICS    ,CA,94103-4083,Proprietary  ,18,35,53,106,161,267
04141400,LAURUS COLLEGE                          ,CA,93401-5405,Proprietary  ,12,80,92,42,176,218
04141700,HEALING HANDS SCHOOL OF HOLISTIC HEALTH ,CA,92025-1722,Proprietary  ,3,26,29,13,97,110
04144200,CAREER DEVELOPMENT INSTITUTE            ,CA,90035-4364,Proprietary  ,0,24,24,4,41,45
04145000,SAN DIEGO CULINARY INSTITUTE            ,CA,91941-6435,Proprietary  ,13,44,57,13,44,57
04146000,NATIONAL CAREER COLLEGE                 ,CA,91605-1400,Proprietary  ,1,11,12,6,42,48
04148200,BEYOND 21ST CENTURY BEAUTY ACADEMY      ,CA,90670-6316,Proprietary  ,3,5,8,3,5,8
04149700,HOMESTEAD SCHOOLS                       ,CA,90505-5945,Private      ,19,60,79,24,76,100
04150000,CENTRAL NURSING COLLEGE                 ,CA,90010-2444,Proprietary  ,6,46,52,15,121,136
04150300,RWM FIBER OPTICS                        ,CA,90746-1051,Proprietary  ,2,13,15,7,38,45
04152800,CALIFORNIA ACADEMY (THE) - A PAUL MITCHE,CA,95825-2276,Proprietary  ,25,54,79,108,172,280
04153900,PROVIDENCE CHRISTIAN COLLEGE            ,CA,91761-5626,Private      ,2,1,3,4,3,7
04155500,"ACADEMY FOR JEWISH RELIGION, CALIFORNIA ",CA,90024-3234,Private      ,0,10,10,0,10,10
04158200,PAUL MITCHELL THE SCHOOL SHERMAN OAKS   ,CA,91403-5882,Proprietary  ,18,24,42,18,24,42
04161700,SHASTA SCHOOL OF COSMETOLOGY            ,CA,96003-0000,Proprietary  ,1,2,3,1,2,3
00184600,BRIAR CLIFF UNIVERSITY                  ,IA,51104-2100,Private      ,18,26,44,1143,444,1587
00184700,BUENA VISTA UNIVERSITY                  ,IA,50588-9987,Private      ,33,135,168,1850,1851,3701
00184800,SOUTHEASTERN COMMUNITY COLLEGE          ,IA,52655-0000,Public       ,79,375,454,1203,2509,3712
00185000,CENTRAL COLLEGE                         ,IA,50219-1999,Private      ,24,7,31,2315,129,2444
00185200,CLARKE COLLEGE                          ,IA,52001-3198,Private      ,12,39,51,1009,513,1522
00185400,COE COLLEGE                             ,IA,52402-5092,Private      ,11,16,27,1826,201,2027
00185500,DES MOINES UNIV-OSTEOPATHIC MED CTR     ,IA,50312-0000,Private      ,1,33,34,15,1773,1788
00185600,CORNELL COLLEGE                         ,IA,52314-1098,Private      ,18,3,21,1859,92,1951
00185700,SOUTHWESTERN COMMUNITY COLLEGE          ,IA,50801-1098,Public       ,26,86,112,608,822,1430
00185800,DIVINE WORD COLLEGE                     ,IA,52045-0380,Private      ,7,3,10,13,13,26
00185900,DORDT COLLEGE                           ,IA,51250-1697,Private      ,7,2,9,1376,82,1458
00186000,DRAKE UNIVERSITY                        ,IA,50311-4505,Private      ,48,108,156,4311,2431,6742
00186200,ELLSWORTH COMMUNITY COLLEGE             ,IA,50126-1199,Public       ,32,59,91,738,351,1089
00186400,IOWA LAKES COMMUNITY COLLEGE            ,IA,51334-2234,Public       ,46,211,257,1331,1431,2762
00186500,IOWA CENTRAL COMMUNITY COLLEGE          ,IA,50501-0000,Public       ,101,440,541,2321,2668,4989
00186600,GRACELAND UNIVERSITY                    ,IA,50140-1699,Private      ,17,127,144,1053,1292,2345
00186700,GRAND VIEW UNIVERSITY                   ,IA,50316-1599,Private      ,25,74,99,1707,1159,2866
00186800,GRINNELL COLLEGE                        ,IA,50112-1690,Private      ,21,4,25,2497,47,2544
00186900,IOWA STATE UNIV SCIENCE & TECHNOLOG     ,IA,50011-2028,Public       ,225,291,516,20129,5546,25675
00187100,IOWA WESLEYAN COLLEGE                   ,IA,52641-1398,Private      ,11,41,52,906,493,1399
00187300,LORAS COLLEGE                           ,IA,52004-0178,Private      ,12,13,25,2302,173,2475
00187400,LUTHER COLLEGE                          ,IA,52101-1045,Private      ,17,2,19,3247,82,3329
00187500,MARSHALLTOWN COMMUNITY COLLEGE          ,IA,50158-4760,Public       ,38,157,195,699,1003,1702
00187700,NORTH IOWA AREA COMMUNITY COLLEGE       ,IA,50401-7299,Public       ,65,179,244,1601,1339,2940
00187900,MORNINGSIDE COLLEGE                     ,IA,51106-1751,Private      ,22,54,76,1574,517,2091
00188000,MOUNT MERCY COLLEGE                     ,IA,52402-4797,Private      ,10,63,73,1016,850,1866
00188100,ASHFORD UNIVERSITY                      ,IA,52732-3997,Proprietary  ,588,14399,14987,2857,67158,70015
00188300,NORTHWESTERN COLLEGE                    ,IA,51041-1996,Private      ,13,5,18,1514,97,1611
00188700,SIMPSON COLLEGE                         ,IA,50125-1297,Private      ,11,37,48,2109,561,2670
00188900,ST AMBROSE UNIVERSITY                   ,IA,52803-2898,Private      ,30,66,96,2713,1290,4003
00189000,UNIVERSITY OF NORTHERN IOWA             ,IA,50614-0705,Public       ,148,185,333,10437,3114,13551
00189100,UNIVERSITY OF DUBUQUE                   ,IA,52001-5099,Private      ,24,40,64,1719,595,2314
00189200,UNIVERSITY OF IOWA                      ,IA,52242-1316,Public       ,249,359,608,17394,9521,26915
00189300,UPPER IOWA UNIVERSITY                   ,IA,52142-9206,Private      ,51,558,609,1329,4921,6250
00189500,WALDORF COLLEGE                         ,IA,50436-1700,Private      ,18,6,24,673,96,769
00189600,WARTBURG COLLEGE                        ,IA,50677-2200,Private      ,8,4,12,2442,106,2548
00189700,WARTBURG THEOLOGICAL SEMINARY           ,IA,52004-5004,Private      ,0,3,3,2,143,145
00190000,WILLIAM PENN UNIVERSITY                 ,IA,52577-1799,Private      ,14,155,169,1104,1390,2494
00396300,AIB COLLEGE OF BUSINESS                 ,IA,50321-1799,Private      ,16,59,75,652,639,1291
00407500,ESTRN IOWA COMMUNITY COLLEGE DIST       ,IA,52801-1221,Public       ,5,19,24,60,166,226
00407501,CLINTON COMMUNITY COLLEGE               ,IA,52732-0000,Public       ,31,131,162,430,764,1194
00407502,MUSCATINE COMMUNITY COLLEGE             ,IA,52761-0000,Public       ,21,103,124,453,702,1155
00407503,SCOTT COMMUNITY COLLEGE                 ,IA,52722-0000,Public       ,126,478,604,1442,3239,4681
00407600,KIRKWOOD COMMUNITY COLLEGE              ,IA,52406-2068,Public       ,320,1131,1451,7427,8254,15681
00423300,MERCY/ST. LUKE'S SCH RAD TECH           ,IA,52402-0000,Private      ,2,3,5,14,32,46
00458600,KAPLAN UNIVERSITY                       ,IA,52807-2095,Proprietary  ,1266,23636,24902,6309,116021,122330
00458604,KAPLAN UNIVERSITY - CEDAR RAPIDS        ,IA,52404-2998,Proprietary  ,18,183,201,195,1472,1667
00458605,KAPLAN UNIVERSITY - DES MOINES          ,IA,50323-5702,Proprietary  ,28,245,273,360,1931,2291
00458606,KAPLAN UNIVERSITY - MASON CITY          ,IA,50401-4665,Proprietary  ,16,105,121,123,758,881
00458607,KAPLAN UNIVERSITY - CEDAR FALLS         ,IA,50613-6309,Proprietary  ,20,206,226,239,1471,1710
00458610,KAPLAN UNIVERSITY - COUNCIL BLUFFS      ,IA,51503-5289,Proprietary  ,8,88,96,74,611,685
00458700,NORTHEAST IOWA COMMUNITY COLLEGE        ,IA,52132-0400,Public       ,33,113,146,719,918,1637
00458701,NORTHEAST IOWA COMMUNITY COLLEGE        ,IA,52068-0000,Public       ,66,205,271,1192,1579,2771
00459500,HAWKEYE COMMUNITY COLLEGE               ,IA,50701-0000,Public       ,153,413,566,3317,2962,6279
00459800,IOWA WESTERN CMTY CLG-COUNCIL BLUFF     ,IA,51502-0000,Public       ,158,383,541,2917,2742,5659
00460000,NORTHWEST IOWA COMMUNITY COLLEGE        ,IA,51201-1046,Public       ,11,52,63,501,466,967
00626700,IOWA METHODIST MEDICAL CENTER SCHOOLS   ,IA,50309-1499,Private      ,0,8,8,24,40,64
00627300,MERCY COLLEGE OF HEALTH SCIENCES        ,IA,50309-1239,Private      ,13,77,90,405,851,1256
00712000,DES MOINES AREA CMTY COLLEGE            ,IA,50021-0000,Public       ,452,1486,1938,6485,10233,16718
00712100,FAITH BAPTIST BIBLE CLG & THEOL SEM     ,IA,50021-0000,Private      ,4,6,10,348,71,419
00729100,ST LUKE'S COLLEGE                       ,IA,51104-0263,Private      ,4,10,14,124,129,253
00731600,WESTERN IOWA TECH COMMUNITY COLLEGE     ,IA,51106-0000,Public       ,102,408,510,1709,3064,4773
00758800,CAPRI COLLEGE                           ,IA,52004-0873,Proprietary  ,9,24,33,96,119,215
00761100,EQ SCHOOL OF HAIR DESIGN                ,IA,51503-0813,Proprietary  ,1,8,9,43,53,96
00765600,AMERICAN COLLEGE OF HARISTYLING -CR     ,IA,52402-0000,Proprietary  ,0,5,5,11,22,33
00765800,AMER COLL OF HAIRSTYLING-DES MOINES     ,IA,50309-5446,Proprietary  ,1,7,8,10,43,53
00765900,LA JAMES COLLEGE OF HAIRSTYLING         ,IA,50401-3308,Proprietary  ,6,11,17,71,80,151
00771700,CAPRI COLLEGE                           ,IA,52807-2622,Proprietary  ,9,27,36,98,152,250
00794100,COLLEGE OF HAIR DESIGN                  ,IA,50703-1834,Proprietary  ,2,13,15,25,55,80
00811600,DAYTON'S SCHOOL OF HAIR DESIGN          ,IA,52601-0000,Proprietary  ,0,0,0,5,13,18
00826000,IOWA SCHOOL OF BEAUTY INC               ,IA,50322-0000,Proprietary  ,8,37,45,60,177,237
00840300,INDIAN HILLS COMMUNITY COLLEGE          ,IA,52501-1398,Public       ,117,398,515,1755,2689,4444
00840301,INDIAN HILLS COMMUNITY COLLEGE          ,IA,52544-0000,Public       ,14,49,63,237,343,580
00842400,LA JAMES INTERNATIONAL COLLEGE          ,IA,50501-5577,Proprietary  ,9,21,30,106,113,219
00959300,LA'JAMES COLLEGE OF HAIRSTYLING         ,IA,52240-0000,Proprietary  ,8,16,24,74,71,145
01111300,MAHARISHI UNIV OF MANAGEMENT            ,IA,52557-0001,Private      ,11,35,46,173,342,515
01206400,HAMILTON TECHNICAL COLLEGE              ,IA,52807-2653,Proprietary  ,14,75,89,112,332,444
01230000,PALMER COLLEGE OF CHIROPRACTIC          ,IA,52803-5287,Private      ,2,76,78,62,2415,2477
01300600,LA' JAMES INTERNATIONAL COLLEGE-CF      ,IA,50613-5242,Proprietary  ,10,18,28,69,76,145
02090300,CAPRI COLLEGE                           ,IA,52404-0000,Proprietary  ,9,18,27,94,139,233
02134500,LA JAMES INTERNATIONAL COLLEGE - DAV    ,IA,52806-3952,Proprietary  ,5,16,21,61,95,156
02160900,"SALON PROFESSIONAL ACADEMY, THE         ",IA,50010-0000,Proprietary  ,8,14,22,115,76,191
02262500,FAUST INSTITUTE OF COSMETOLOGY          ,IA,50588-0000,Proprietary  ,4,4,8,25,41,66
02274100,LA' JAMES INTERNATIONAL COLLEGE - DM    ,IA,50131-0000,Proprietary  ,31,24,55,142,163,305
02289000,AMERICAN HAIR ACADEMY                   ,IA,52627-4530,Proprietary  ,3,6,9,14,34,48
02306900,IOWA SCHOOL OF BEAUTY                   ,IA,52501-0000,Proprietary  ,4,7,11,29,52,81
02328900,EMMAUS BIBLE COLLEGE                    ,IA,52001-0000,Private      ,2,1,3,237,43,280
02330900,IOWA SCHOOL OF BEAUTY                   ,IA,50158-0000,Proprietary  ,0,9,9,11,40,51
02333200,DAYTON'S SCHOOL OF HAIR DESIGN          ,IA,52632-0000,Proprietary  ,0,0,0,1,12,13
02609200,VATTEROTT COLLEGE                       ,IA,50321-4704,Proprietary  ,21,144,165,131,792,923
03069100,ALLEN COLLEGE                           ,IA,50703-1916,Private      ,4,18,22,313,339,652
03441300,IOWA SCHOOL OF BEAUTY                   ,IA,51106-5111,Proprietary  ,3,13,16,34,65,99
03607400,TOTAL LOOK SCHOOL OF COSMETOLOGY AND MAS,IA,52136-1053,Proprietary  ,0,3,3,4,10,14
03720300,CARLSON COLLEGE OF MASSAGE THERAPY      ,IA,52205-7519,Proprietary  ,0,1,1,16,32,48
04089300,BIO-CHI INSTITUTE OF MASSAGE THERAPY    ,IA,51103-2138,Proprietary  ,2,7,9,11,30,41
00259600,ATLANTIC COMMUNITY COLLEGE              ,NJ,08330-2699,Public       ,324,765,1089,3883,4613,8496
00259700,BLOOMFIELD COLLEGE                      ,NJ,07003-3425,Private      ,56,130,186,2675,1518,4193
00259800,CALDWELL COLLEGE                        ,NJ,07006-6195,Private      ,28,113,141,1424,1075,2499
00259900,CENTENARY COLLEGE                       ,NJ,07840-2184,Private      ,37,106,143,1526,1024,2550
00260000,COLLEGE OF SAINT ELIZABETH              ,NJ,07960-6989,Private      ,18,82,100,760,717,1477
00260100,CUMBERLAND COUNTY COLLEGE               ,NJ,08362-0517,Public       ,207,473,680,2255,3022,5277
00260300,DREW UNIVERSITY                         ,NJ,07940-4063,Private      ,34,47,81,3758,629,4387
00260700,FAIRLEIGH DICKINSON UNIV-TEANECK        ,NJ,07666-1996,Private      ,86,272,358,3231,2356,5587
00260701,FAIRLEIGH DICKINSON UNIV-FLORHAM        ,NJ,07940-0000,Private      ,40,68,108,2380,586,2966
00260702,FAIRLEIGH DICKINSON UNIV-ED WMS CLG     ,NJ,07601-0000,Private      ,13,23,36,178,150,328
00260703,FAIRLEIGH DICKINSON UNIVERSITY          ,NJ,07940-0000,Private      ,45,71,116,1898,837,2735
00260800,GEORGIAN COURT UNIVERSITY               ,NJ,08701-2697,Private      ,45,132,177,1476,1674,3150
00260900,ROWAN UNIVERSITY                        ,NJ,08028-1702,Public       ,224,330,554,11545,3967,15512
00261000,FELICIAN COLLEGE                        ,NJ,07644-2198,Private      ,32,148,180,1714,1357,3071
00261300,NEW JERSEY CITY UNIVERSITY              ,NJ,07305-1597,Public       ,148,528,676,4588,5568,10156
00261500,MIDDLESEX COUNTY COLLEGE                ,NJ,08818-3050,Public       ,436,665,1101,6136,4737,10873
00261600,MONMOUTH UNIVERSITY                     ,NJ,07764-1898,Private      ,113,188,301,7236,2345,9581
00261700,MONTCLAIR STATE UNIVERSITY              ,NJ,07043-9987,Public       ,360,599,959,16012,6704,22716
00261900,NEW BRUNSWICK THEOLOGICAL SEMINARY      ,NJ,08901-0000,Private      ,0,9,9,25,132,157
00262100,NEW JERSEY INST OF TECHNOLOGY           ,NJ,07102-1982,Public       ,145,241,386,5238,2582,7820
00262200,KEAN UNIVERSITY                         ,NJ,07083-7131,Public       ,343,708,1051,10350,7653,18003
00262400,OCEAN COUNTY COLLEGE                    ,NJ,08754-2001,Public       ,333,554,887,5255,3874,9129
00262500,WILLIAM PATERSON UNIVERSITY             ,NJ,07470-2152,Public       ,239,413,652,9906,4244,14150
00262600,PRINCETON THEOLOGICAL SEMINARY          ,NJ,08542-0000,Private      ,0,12,12,13,686,699
00262700,PRINCETON UNIVERSITY                    ,NJ,08544-0001,Private      ,185,42,227,14112,1609,15721
00262800,RIDER UNIVERSITY                        ,NJ,08648-3099,Private      ,82,127,209,7157,1665,8822
00262900,"RUTGERS, THE STATE UNIVERSITY OF NJ     ",NJ,08901-1281,Public       ,787,1242,2029,41613,20748,62361
00263200,SETON HALL UNIVERSITY                   ,NJ,07079-2697,Private      ,125,265,390,10041,3647,13688
00263201,SETON HALL UNIVERSITY - SCHOOL OF LAW   ,NJ,07079-5210,Private      ,3,37,40,210,2416,2626
00263800,ST PETER'S COLLEGE                      ,NJ,07306-5997,Private      ,45,118,163,3466,1161,4627
00263900,STEVENS INSTITUTE OF TECHNOLOGY         ,NJ,07030-5370,Private      ,57,65,122,3236,627,3863
00264200,COLLEGE OF NEW JERSEY (THE)             ,NJ,08628-0718,Public       ,129,99,228,9949,1148,11097
00264300,UNION COUNTY COLLEGE                    ,NJ,07016-1598,Public       ,394,1163,1557,4824,7528,12352
00473600,BERGEN COMMUNITY COLLEGE                ,NJ,07652-1595,Public       ,532,741,1273,7350,4993,12343
00474000,MERCER COUNTY COMMUNITY COLLEGE         ,NJ,08690-0000,Public       ,242,597,839,3158,4273,7431
00539900,MONMOUTH COUNTY VOCATIONAL SCH DIST     ,NJ,07728-5033,Public       ,4,17,21,47,121,168
00539905,MONMOUTH COUNTY VOCATIONAL SCHOOL DISTRI,NJ,07753-4473,Public       ,0,0,0,1,12,13
00545200,TETERBORO SCH OF AERONAUTICS            ,NJ,07608-1083,Proprietary  ,12,31,43,96,96,192
00546000,SOMERSET COUNTY TECHNICAL INSTITUTE     ,NJ,08807-0350,Public       ,3,25,28,55,202,257
00546100,SALEM COMMUNITY COLLEGE                 ,NJ,08069-2799,Public       ,45,103,148,628,798,1426
00641000,C E GREGORY SCHOOL OF NURSING           ,NJ,08857-0000,Private      ,0,0,0,4,4,8
00641700,HOLY NAME HOSPITAL SCH OF NURSING       ,NJ,07666-4254,Private      ,5,17,22,71,175,246
00642000,MOUNTAINSIDE HOSP SCH NRSG              ,NJ,07042-4898,Proprietary  ,2,12,14,34,138,172
00642100,MUHLENBERG SNYDER SCHOOLS               ,NJ,07061-3399,Private      ,13,51,64,119,535,654
00642900,ST FRANCIS MEDICAL CTR SCH NURSING      ,NJ,08629-1986,Private      ,1,5,6,20,50,70
00642902,ST FRANCIS MED CTR RAD TECH             ,NJ,08629-0000,Private      ,0,4,4,3,24,27
00686500,CAMDEN COUNTY COLLEGE                   ,NJ,08012-3240,Public       ,445,1207,1652,6584,8943,15527
00690100,GLOUCESTER COUNTY COLLEGE               ,NJ,08080-4249,Public       ,186,365,551,3075,2742,5817
00710700,ESSEX COUNTY COLLEGE                    ,NJ,07102-1798,Public       ,457,1413,1870,5378,8632,14010
00736203,STUART SCHOOL OF BUSINESS ADMINISTRATION,NJ,07719-3970,Proprietary  ,0,0,0,1,1,2
00750200,BERKELEY COLLEGE                        ,NJ,07424-3367,Proprietary  ,86,162,248,1817,1792,3609
00750201,BERKELEY COLLEGE                        ,NJ,07095-0000,Proprietary  ,35,100,135,777,747,1524
00750202,BERKELEY COLLEGE - PARAMUS              ,NJ,07652-2931,Proprietary  ,30,82,112,479,521,1000
00750600,LINCOLN TECHNICAL INSTITUTE             ,NJ,07083-5032,Proprietary  ,166,317,483,1057,1418,2475
00750601,LINCOLN TECHNICAL INSTITUTE             ,NJ,07430-0000,Proprietary  ,92,110,202,598,569,1167
00750700,GIBBS COLLEGE                           ,NJ,07039-1611,Proprietary  ,2,4,6,54,102,156
00750701,KATHARINE GIBBS - PISCATAWAY            ,NJ,08854-0000,Proprietary  ,0,0,0,0,3,3
00759300,PARISIAN BEAUTY ACADEMY                 ,NJ,07601-5509,Proprietary  ,27,47,74,125,149,274
00772900,COUNTY COLLEGE OF MORRIS                ,NJ,07869-0000,Public       ,210,228,438,3288,1774,5062
00773000,BURLINGTON COUNTY COLLEGE               ,NJ,08068-1599,Public       ,264,584,848,3828,3902,7730
00773100,RARITAN VALLEY COMMUNITY COLLEGE        ,NJ,08876-1265,Public       ,124,310,434,2199,1945,4144
00780401,CAREER ACADEMY OF NEW YORK - STAR LAKEWO,NJ,08701-5900,Proprietary  ,16,100,116,72,454,526
00780402,CAREER ACADEMY OF NEW YORK - STAR EGG HA,NJ,08234-4863,Proprietary  ,20,95,115,75,394,469
00794700,BETH MEDRASH GOVOHA OF AMERICA          ,NJ,08701-0000,Private      ,101,300,401,256,1700,1956
00840400,BROOKDALE COMMUNITY COLLEGE             ,NJ,07738-1597,Public       ,351,598,949,5914,4248,10162
00844101,ANTHEM INSTITUTE                        ,NJ,08002-0000,Proprietary  ,3,15,18,22,60,82
00849400,HO HO KUS SCHL OF TRADE & TECH SCIENCES ,NJ,07513-1402,Proprietary  ,24,63,87,110,273,383
00860900,RABBINICAL COLLEGE OF AMERICA           ,NJ,07960-3600,Private      ,17,0,17,68,7,75
00907800,CAPRI INSTITUTE OF HAIR DESIGN          ,NJ,07011-2111,Proprietary  ,24,46,70,100,187,287
00934400,RAMAPO COLLEGE OF NEW JERSEY            ,NJ,07430-1680,Public       ,130,93,223,6469,1102,7571
00934500,RICHARD STOCKTON COLLEGE OF NJ          ,NJ,08240-0195,Public       ,152,195,347,7268,2850,10118
00982804,EVEREST INSTITUTE - SOUTH PLAINFIELD    ,NJ,07080-1125,Proprietary  ,41,180,221,206,677,883
00999400,PASSAIC COUNTY COMMUNITY COLLEGE        ,NJ,07505-1179,Public       ,292,716,1008,3589,4811,8400
01039400,UNIV OF MEDICINE & DENTISTRY OF NJ      ,NJ,07107-0000,Public       ,23,197,220,237,4608,4845
01062900,P B COSMETOLOGY EDUCATION CENTRE        ,NJ,08030-1750,Proprietary  ,14,23,37,100,127,227
01085100,ANTHEM INSTITUTE                        ,NJ,07054-3409,Proprietary  ,110,260,370,555,1158,1713
01085101,ANTHEM INSTITUTE                        ,NJ,07306-0000,Proprietary  ,12,39,51,52,153,205
01085102,ANTHEM INSTITUTE                        ,NJ,08902-0000,Proprietary  ,3,18,21,24,78,102
01090300,RIZZIERI INSTITUTE                      ,NJ,08043-4600,Proprietary  ,16,32,48,111,150,261
01152300,MORRIS COUNTY SCHOOL OF TECHNOLOGY      ,NJ,07834-0000,Public       ,4,11,15,28,72,100
01170800,NATURAL MOTION INST OF HAIR DESIGN      ,NJ,07306-5496,Proprietary  ,10,26,36,53,109,162
01198900,TALMUDICAL ACADEMY                      ,NJ,07710-0000,Private      ,8,0,8,44,3,47
01209000,REIGNBOW BEAUTY ACADEMY                 ,NJ,08861-4118,Proprietary  ,10,35,45,43,135,178
01234600,DOVER BUSINESS COLLEGE                  ,NJ,07011-2161,Proprietary  ,67,159,226,357,900,1257
01234602,DOVER BUSINESS COLLEGE                  ,NJ,07801-4643,Proprietary  ,27,93,120,150,430,580
01246100,LINCOLN TECHNICAL INSTITUTE             ,NJ,08820-2896,Proprietary  ,71,199,270,376,925,1301
01246102,LINCOLN TECHNICAL INSTITUTE             ,NJ,08054-0000,Proprietary  ,40,202,242,266,1230,1496
01246103,LINCOLN TECHNICAL INSTITUTE             ,NJ,07652-2106,Proprietary  ,50,182,232,416,991,1407
01246200,HOHOKUS - HACKENSACK SCHOOL OF BUSINESS ,NJ,07601-7197,Proprietary  ,31,174,205,159,690,849
01295400,HUDSON COUNTY COMMUNITY COLLEGE         ,NJ,07306-4012,Public       ,354,864,1218,4274,6144,10418
02053700,EASTWICK COLLEGE                        ,NJ,07446-0000,Proprietary  ,63,168,231,296,893,1189
02061800,ROMAN ACADEMY OF BEAUTY CULTURE         ,NJ,07506-0000,Proprietary  ,9,18,27,34,40,74
02092300,HOHOKUS SCHOOL - RETS/NUTLEY            ,NJ,07110-0000,Proprietary  ,45,172,217,252,627,879
02103700,CAPRI INSTITUTE OF HAIR DESIGN          ,NJ,07652-0000,Proprietary  ,15,34,49,57,115,172
02104000,HARRIS SCHOOL OF BUSINESS               ,NJ,08002-2983,Proprietary  ,80,338,418,287,1397,1684
02106601,FOX INSTITUTE OF BUSINESS - CLIFTON     ,NJ,07011-2345,Proprietary  ,37,142,179,124,400,524
02131100,DU CRET SCHOOL OF THE ARTS              ,NJ,07060-0000,Private      ,2,4,6,29,25,54
02131600,PENNCO TECH                             ,NJ,08012-0000,Proprietary  ,102,217,319,410,818,1228
02132300,BERDAN INSTITUTE                        ,NJ,07512-0000,Proprietary  ,33,75,108,245,497,742
02146800,JOE KUBERT SCH OF CARTOON & GRAPHIC     ,NJ,07801-0000,Proprietary  ,0,2,2,56,54,110
02149800,EMPIRE BEAUTY SCHOOL                    ,NJ,08021-0000,Proprietary  ,13,44,57,118,325,443
02149801,EMPIRE BEAUTY SCHOOL - BORDENTOWN       ,NJ,08505-1513,Proprietary  ,2,6,8,11,33,44
02154000,DIVERS ACAD OF EASTERN SEABOARD         ,NJ,08081-1139,Proprietary  ,24,48,72,97,198,295
02183600,CAPRI INSTITUTE OF HAIR DESIGN          ,NJ,07033-0000,Proprietary  ,14,26,40,67,130,197
02192200,THOMAS EDISON STATE COLLEGE             ,NJ,08608-0000,Public       ,28,624,652,299,4826,5125
02219600,OMEGA INSTITUTE                         ,NJ,08109-0000,Proprietary  ,11,40,51,42,209,251
02223700,NEW HORIZON INST OF COSMETOLOGY         ,NJ,07093-0000,Proprietary  ,7,82,89,24,195,219
02223900,DRAKE COLLEGE OF BUSINESS               ,NJ,07201-0000,Proprietary  ,142,854,996,518,3221,3739
02223902,DRAKE COLLEGE OF BUSINESS - NEWARK CAMPU,NJ,07112-2760,Proprietary  ,0,5,5,0,5,5
02232500,UNION COUNTY VOCATIONAL TECH INST       ,NJ,07076-0000,Public       ,10,23,33,67,133,200
02234600,SHORE BEAUTY SCHOOL                     ,NJ,08232-0000,Proprietary  ,23,34,57,62,96,158
02246000,ROSS UNIVERSITY - MEDICAL SCHOOL        ,NJ,08837-0000,Proprietary  ,1,271,272,16,4418,4434
02248600,COOPER HEALTH SYS-CTR ALLIED HEALTH     ,NJ,08103-0000,Private      ,1,15,16,24,97,121
02252700,CONCORDE SCHOOL OF HAIR DESIGN          ,NJ,07712-0000,Proprietary  ,14,67,81,117,335,452
02252701,CONCORDE SCHOOL OF HAIR DESIGN - BLOOMFI,NJ,07003-2517,Proprietary  ,1,5,6,19,28,47
02261800,EUROPEAN ACADEMY OF COSMETOLOGY         ,NJ,07083-0000,Proprietary  ,4,39,43,59,173,232
02265500,CAPRI INSTITUTE OF HAIR DESIGN          ,NJ,08724-0000,Proprietary  ,11,20,31,50,120,170
02277900,ROSS UNIV - SCH OF VETERINARY MED       ,NJ,08837-0000,Proprietary  ,0,35,35,4,1128,1132
02291000,LINCOLN TECHNICAL INSTITUTE             ,NJ,07080-2424,Proprietary  ,27,60,87,131,125,256
02312000,BERGEN COUNTY TECHNICAL SCHOOLS         ,NJ,07601-6110,Public       ,10,43,53,35,120,155
02344200,EMPIRE BEAUTY SCHOOL                    ,NJ,08002-0000,Proprietary  ,13,57,70,112,282,394
02503900,WARREN COUNTY COMMUNITY COLLEGE         ,NJ,07882-0000,Public       ,46,92,138,662,634,1296
02523700,OCEAN COUNTY VOCATIONAL-TECH SCHOOL     ,NJ,08753-0000,Public       ,5,40,45,151,327,478
02525900,ARTISTIC ACADEMY OF HAIR DESIGN         ,NJ,07950-1409,Proprietary  ,8,20,28,98,96,194
02528200,REIGNBOW BEAUTY ACADEMY                 ,NJ,07060-0000,Proprietary  ,5,38,43,22,105,127
02558700,PRISM CAREER INSTITUTE                  ,NJ,08037-0000,Proprietary  ,54,252,306,228,1206,1434
02568800,SUSSEX COUNTY COMMUNITY COLLEGE         ,NJ,07860-1149,Public       ,87,126,213,1544,1017,2561
02586900,HARRIS SCHOOL OF BUSINESS               ,NJ,08084-1520,Proprietary  ,32,176,208,100,747,847
02615401,STAR TECHNICAL INSTITUTE -              ,NJ,07102-4599,Proprietary  ,0,0,0,1,8,9
02616402,SANFORD-BROWN INSTITUTE - ISELIN        ,NJ,08830-0000,Proprietary  ,76,220,296,452,1257,1709
03077500,RABBI JACOB JOSEPH SCHOOL               ,NJ,08817-4494,Private      ,4,0,4,14,0,14
03122600,EASTERN INTERNATIONAL COLLEGE           ,NJ,07306-3906,Proprietary  ,34,115,149,120,356,476
03187300,STENOTECH CAREER INSTITUTE              ,NJ,07004-3490,Proprietary  ,9,24,33,48,91,139
03197300,INSTITUTE FOR HEALTH EDUCATION(THE)     ,NJ,07306-2929,Proprietary  ,4,57,61,30,184,214
03324300,CENTRAL CAREER SCHOOL                   ,NJ,07080-2408,Proprietary  ,12,40,52,27,118,145
03380302,CULINARY ACADEMY OF LONG ISLAND - STAR N,NJ,07102-4510,Proprietary  ,14,117,131,86,612,698
03380303,CULINARY ACADEMY OF LONG ISLAND - STAR C,NJ,07011-2248,Proprietary  ,6,55,61,9,88,97
03389300,ACADEMY OF MASSAGE THERAPY              ,NJ,07631-0000,Proprietary  ,5,39,44,34,151,185
03424500,NEW COMMUNITY WORKFORCE DEVELOPMENT     ,NJ,07103-2402,Private      ,16,183,199,36,519,555
03530300,"KEY SKILLS LEARNING, INC.               ",NJ,07013-1900,Proprietary  ,0,13,13,0,57,57
03536300,INSTITUTE FOR THERAPEUTIC MASSAGE       ,NJ,07420-1452,Proprietary  ,5,40,45,21,155,176
03574400,CORTIVA INSTITUTE - SOMERSET SCHOOL OF M,NJ,08854-3908,Proprietary  ,8,17,25,36,126,162
03625300,PERFORMANCE TRAINING INSTITUTE          ,NJ,08753-0000,Proprietary  ,2,63,65,4,105,109
03637300,METRO AUTO ELECTRONICS TRAINING INSTITUT,NJ,07033-1798,Proprietary  ,8,49,57,31,112,143
03650600,PC AGE                                  ,NJ,07306-3936,Proprietary  ,10,35,45,35,198,233
03650603,PC AGE                                  ,NJ,08817-2842,Proprietary  ,0,7,7,1,28,29
03666300,SOMERSET CHRISTIAN COLLEGE              ,NJ,08890-9035,Private      ,5,53,58,58,312,370
03769300,PC TECH LEARNING CENTER                 ,NJ,07306-9900,Proprietary  ,3,56,59,18,186,204
03803300,HEALTHCARE TRAINING INSTITUTE           ,NJ,07083-3504,Proprietary  ,5,53,58,43,281,324
03811300,EASTERN SCHOOL OF ACUPUNCTURE AND TRADIT,NJ,07042-3562,Proprietary  ,0,10,10,1,62,63
04081300,BAIS MEDRASH TORAS CHESED               ,NJ,08701-0000,Private      ,1,0,1,16,2,18
04123400,YESHIVAS BE'ER YITZCHOK                 ,NJ,07208-2380,Private      ,2,10,12,4,18,22
04125000,GENTLE HEALING SCHOOL OF MASSAGE        ,NJ,08512-3600,Proprietary  ,0,7,7,2,30,32
04131100,YESHIVA TORAS CHAIM                     ,NJ,08701-2120,Private      ,34,0,34,88,0,88
04131200,TOTAL IMAGE BEAUTY ACADEMY              ,NJ,07307-2943,Proprietary  ,2,2,4,5,35,40
04134100,CENTER FOR ALLIED HEALTH & NURSING EDUCA,NJ,07601-5801,Proprietary  ,22,201,223,70,611,681
04136400,AMERICAN INSTITUTE OF MEDICAL SCIENCES &,NJ,07080-1183,Proprietary  ,4,33,37,23,160,183
04154900,NATIONAL CAREER INSTITUTE               ,NJ,07018-2011,Proprietary  ,1,29,30,1,29,30
        ,BROOKLYN LAW SCHOOL                     ,NY,11201-0000,Private      ,0,0,0,2,82,84
00266500,VAUGHN COLLEGE OF AERONAUTICS AND TECHNO,NY,11369-9997,Private      ,58,66,124,933,655,1588
00266600,ADELPHI UNIVERSITY                      ,NY,11530-4299,Private      ,179,358,537,7615,4622,12237
00266700,DOWLING COLLEGE                         ,NY,11769-1999,Private      ,95,207,302,2612,2266,4878
00266800,ALFRED UNIVERSITY                       ,NY,14802-1205,Private      ,28,46,74,3160,623,3783
00266900,BANK STREET COLLEGE OF EDUCATION        ,NY,10025-0000,Private      ,2,64,66,11,967,978
00267100,BARD COLLEGE                            ,NY,12504-5000,Private      ,25,18,43,2762,653,3415
00267400,NEW YORK THEOLOGICAL SEMINARY           ,NY,10115-0002,Private      ,0,41,41,0,62,62
00267700,BROOKLYN LAW SCHOOL                     ,NY,11201-0000,Private      ,2,40,42,44,3662,3706
00267800,BRYANT & STRATTON COLLEGE               ,NY,14203-1713,Proprietary  ,259,1369,1628,2366,10140,12506
00267803,BRYANT & STRATTON COLLEGE - GREECE      ,NY,14606-4227,Proprietary  ,44,148,192,314,1069,1383
00267805,BRYANT & STRATTON COLLEGE - SYRACUSE    ,NY,13203-2502,Proprietary  ,58,226,284,719,1602,2321
00267807,BRYANT & STRATTON COLLEGE - ALBANY      ,NY,12205-5230,Proprietary  ,24,111,135,282,890,1172
00268100,CANISIUS COLLEGE                        ,NY,14208-1098,Private      ,57,137,194,4575,1622,6197
00268300,SEMINARY OF THE IMMACULATE CONCEPT      ,NY,11743-0000,Private      ,0,0,0,1,0,1
00268500,CAZENOVIA COLLEGE                       ,NY,13035-1085,Private      ,18,8,26,1787,157,1944
00268700,CUNY-BROOKLYN COLLEGE                   ,NY,11210-2814,Public       ,561,998,1559,14457,10235,24692
00268800,CITY COLLEGE-CUNY                       ,NY,10031-9198,Public       ,539,868,1407,17030,8389,25419
00268900,CUNY-HUNTER COLLEGE                     ,NY,10021-0000,Public       ,784,1470,2254,23312,13977,37289
00269000,QUEENS COLLEGE-CUNY                     ,NY,11367-1597,Public       ,497,854,1351,14395,8072,22467
00269100,CUNY- BOROUGH OF MANHATTAN CMTY CLG     ,NY,10007-1047,Public       ,1611,1856,3467,18961,13094,32055
00269200,CUNY BRONX COMMUNITY COLLEGE            ,NY,10453-3102,Public       ,767,1111,1878,9086,8191,17277
00269300,CUNY-JOHN JAY CLG CRIMINAL JUSTICE      ,NY,10019-1093,Public       ,530,673,1203,13414,6842,20256
00269400,KINGSBOROUGH COMMUNITY COLLEGE          ,NY,11235-2398,Public       ,703,638,1341,10398,6143,16541
00269600,NY CITY COLLEGE OF TECHNOLOGY-CUNY      ,NY,11201-2983,Public       ,633,866,1499,12936,7391,20327
00269700,QUEENSBOROUGH COMMUNITY COLLEGE         ,NY,11364-1497,Public       ,826,708,1534,9807,5135,14942
00269800,CUNY THE COLLEGE OF STATEN ISLAND       ,NY,10314-6600,Public       ,510,524,1034,9674,4394,14068
00269900,CLARKSON UNIVERSITY                     ,NY,13699-5615,Private      ,48,13,61,4361,354,4715
00270000,COLGATE ROCHESTER CROZER DIVINITY S     ,NY,14620-0000,Private      ,0,10,10,1,77,78
00270100,COLGATE UNIVERSITY                      ,NY,13346-1386,Private      ,45,4,49,4344,73,4417
00270300,COLLEGE OF MOUNT SAINT VINCENT          ,NY,10471-1093,Private      ,30,35,65,2125,440,2565
00270400,COLLEGE OF NEW ROCHELLE                 ,NY,10805-2339,Private      ,40,513,553,968,4864,5832
00270500,COLLEGE OF SAINT ROSE                   ,NY,12203-1490,Private      ,61,179,240,4344,2276,6620
00270700,COLUMBIA UNIVERSITY                     ,NY,10027-0000,Private      ,142,229,371,5498,3918,9416
00270701,COLUMBIA UNIV ARCHITECTURE              ,NY,10027-0000,Private      ,4,15,19,51,804,855
00270702,COLUMBIA UNIV SCHOOL OF THE ARTS        ,NY,10027-0000,Private      ,11,20,31,104,1421,1525
00270703,COLUMBIA UNIV BUSINESS GRAD             ,NY,10027-0000,Private      ,7,137,144,25,1671,1696
00270704,COLUMBIA UNIV SCHOOL ENGIN-UNDERGRA     ,NY,10027-0000,Private      ,18,4,22,2195,91,2286
00270705,COLUMBIA UNIV SCHOOL GENERAL STUDIE     ,NY,10027-0000,Private      ,28,101,129,470,1270,1740
00270706,COLUMBIA UNIV GRAD SCHL ARTS & SCI      ,NY,10027-0000,Private      ,4,79,83,35,1892,1927
00270707,COLUMBIA UNIV SCH INTL PUB AFFAIRS      ,NY,10027-0000,Private      ,6,67,73,14,1446,1460
00270708,COLUMBIA UNIV JOURNALISM GRAD           ,NY,10027-0000,Private      ,2,13,15,21,692,713
00270710,COLUMBIA UNIV COLUMBIA COLLEGE          ,NY,10027-0000,Private      ,122,34,156,8849,362,9211
00270711,COLUMBIA UNIV SCHOOL OF LAW             ,NY,10027-0000,Private      ,4,28,32,34,4482,4516
00270712,COLUMBIA UNIV SOCIAL WORK               ,NY,10025-0000,Private      ,0,52,52,14,1084,1098
00270713,COLUMBIA UNIV SCHL DENT & ORAL SURG     ,NY,10032-0000,Private      ,1,2,3,5,404,409
00270714,COLUMBIA UNIV INST HUMAN NUTRITION      ,NY,10032-0000,Private      ,1,4,5,3,74,77
00270715,COLUMBIA UNIV NURSING                   ,NY,10032-0000,Private      ,5,29,34,116,877,993
00270716,COLUMBIA UNIV COLL PHYS & SURGEONS      ,NY,10032-0000,Private      ,3,8,11,28,1167,1195
00270717,COLUMBIA UNIV PHYSICAL THERAPY          ,NY,10032-0000,Private      ,1,4,5,8,142,150
00270718,COLUMBIA UNIV OCCUPATIONAL THERAPY      ,NY,10032-0000,Private      ,1,5,6,4,101,105
00270719,COLUMBIA UNIV PUBLIC HEALTH             ,NY,10032-0000,Private      ,3,16,19,9,1051,1060
00270720,COLUMBIA UNIV - ENGINEERING (GRAD)      ,NY,10027-0000,Private      ,5,25,30,67,415,482
00270721,COLUMBIA UNIV-CONT ED & SP PROGMS       ,NY,10027-0000,Private      ,1,81,82,11,448,459
00270800,BARNARD COLLEGE-COLUMBIA UNIV           ,NY,10027-6598,Private      ,51,28,79,3676,178,3854
00270900,CONCORDIA COLLEGE                       ,NY,10708-1998,Private      ,10,35,45,751,307,1058
00271000,COOPER UNION                            ,NY,10003-7120,Private      ,31,24,55,1671,208,1879
00271100,CORNELL UNIVERSITY                      ,NY,14853-2801,Private      ,360,170,530,25219,6337,31556
00271101,WEILL CORNELL MEDICAL COLLEGE AND GRADUA,NY,10021-0000,Private      ,1,13,14,25,833,858
00271200,D'YOUVILLE COLLEGE                      ,NY,14201-1084,Private      ,35,95,130,1602,1665,3267
00271300,DOMINICAN COLLEGE                       ,NY,10962-1299,Private      ,33,77,110,1628,920,2548
00271800,ELMIRA COLLEGE                          ,NY,14901-2099,Private      ,36,58,94,2055,592,2647
00272200,FORDHAM UNIVERSITY                      ,NY,10458-5157,Private      ,336,569,905,19428,10020,29448
00272600,GENERAL THEOLOGICAL SEMINARY            ,NY,10011-0000,Private      ,0,6,6,1,112,113
00272800,HAMILTON COLLEGE                        ,NY,13323-1218,Private      ,26,2,28,2742,48,2790
00272900,HARTWICK COLLEGE                        ,NY,13820-4020,Private      ,20,6,26,2512,89,2601
00273100,HOBART & WILLIAM SMITH COLLEGES         ,NY,14456-3397,Private      ,28,4,32,3664,66,3730
00273200,HOFSTRA UNIVERSITY                      ,NY,11549-1010,Private      ,271,333,604,16460,6537,22997
00273400,HOUGHTON COLLEGE                        ,NY,14744-0128,Private      ,11,20,31,1607,205,1812
00273500,HILBERT COLLEGE                         ,NY,14075-1597,Private      ,22,23,45,954,337,1291
00273700,IONA COLLEGE                            ,NY,10801-1890,Private      ,72,79,151,6831,1213,8044
00273900,ITHACA COLLEGE                          ,NY,14850-7130,Private      ,117,23,140,12289,854,13143
00274000,JEWISH THEOLOGICAL SEMINARY OF AMER     ,NY,10027-4649,Private      ,1,0,1,120,173,293
00274200,THE JUILLIARD SCHOOL                    ,NY,10023-6588,Private      ,27,17,44,1134,580,1714
00274400,KEUKA COLLEGE                           ,NY,14478-0000,Private      ,12,118,130,1294,1117,2411
00274800,LEMOYNE COLLEGE                         ,NY,13214-1399,Private      ,62,84,146,4389,1028,5417
00274900,NEW YORK COLLEGE OF PODIATRIC MED       ,NY,10035-0000,Private      ,1,22,23,52,409,461
00275100,LONG ISLAND UNIVERSITY                  ,NY,11548-1326,Private      ,324,826,1150,11396,10412,21808
00275101,LONG ISLAND UNIVERSITY - BRENTWOOD CAMPU,NY,11717-5326,Private      ,0,7,7,0,7,7
00275102,LONG ISLAND UNIVERSITY - ROCKLAND CAMPUS,NY,10962-0000,Private      ,1,7,8,1,7,8
00275104,LONG ISLAND UNIVERSITY - NEW YORK UNIVER,NY,10011-0000,Private      ,3,5,8,3,5,8
00275105,LONG ISLAND UNIVERSITY - WEST POINT CAMP,NY,10966-0000,Private      ,3,0,3,3,0,3
00275106,LONG ISLAND UNIVERSITY - JEWISH BOARD OF,NY,10019-0000,Private      ,0,1,1,0,1,1
00275107,LONG ISLAND UNIVERSITY - QUEENS DISTRICT,NY,11364-0000,Private      ,0,1,1,0,1,1
00275110,LONG ISLAND UNIVERSITY - WESTBURY SENIOR,NY,11568-1619,Private      ,4,3,7,4,3,7
00275111,LONG ISLAND UNIVERSITY - BABYLON SENIOR ,NY,11702-2222,Private      ,0,1,1,0,1,1
00275115,LONG ISLAND UNIVERSITY - SOUTHAMPTON COL,NY,11968-4198,Private      ,0,3,3,0,3,3
00275116,LONG ISLAND UNIVERSITY - BROOKLYN       ,NY,11201-8423,Private      ,41,95,136,41,95,136
00275800,MANHATTAN COLLEGE                       ,NY,10471-4098,Private      ,65,54,119,5278,515,5793
00275900,MANHATTAN SCHOOL OF MUSIC               ,NY,10027-4698,Private      ,17,19,36,661,709,1370
00276000,MANHATTANVILLE COLLEGE                  ,NY,10577-2132,Private      ,32,103,135,2876,1049,3925
00276300,MARIA COLLEGE                           ,NY,12208-1798,Private      ,10,69,79,210,794,1004
00276500,MARIST COLLEGE                          ,NY,12601-1387,Private      ,163,119,282,9445,1198,10643
00276900,MARYMOUNT MANHATTAN COLLEGE             ,NY,10021-4597,Private      ,89,43,132,3257,348,3605
00277200,MERCY COLLEGE                           ,NY,10522-1189,Private      ,214,825,1039,3583,6998,10581
00277500,MOLLOY COLLEGE                          ,NY,11570-1100,Private      ,71,172,243,2710,1856,4566
00277700,MEDAILLE COLLEGE                        ,NY,14214-2695,Private      ,25,140,165,1602,1408,3010
00277800,MOUNT SAINT MARY COLLEGE                ,NY,12550-3494,Private      ,46,82,128,2762,1133,3895
00277900,NAZARETH COLLEGE OF ROCHESTER           ,NY,14618-3790,Private      ,31,109,140,3074,1610,4684
00278200,NEW YORK INSTITUTE OF TECHNOLOGY        ,NY,11568-8000,Private      ,109,212,321,4891,3197,8088
00278202,NY INSTITUTE OF TECHNOLOGY-OSTEOPATHIC M,NY,11568-0000,Private      ,2,10,12,106,1121,1227
00278300,NEW YORK LAW SCHOOL                     ,NY,10013-0000,Private      ,4,49,53,34,3464,3498
00278400,NEW YORK MEDICAL COLLEGE                ,NY,10595-0000,Private      ,5,46,51,18,2207,2225
00278500,NEW YORK UNIVERSITY                     ,NY,10012-1091,Private      ,634,1827,2461,34325,28856,63181
00278800,NIAGARA UNIVERSITY                      ,NY,14109-2010,Private      ,83,65,148,3784,837,4621
00279000,NYACK COLLEGE                           ,NY,10960-3698,Private      ,42,285,327,1412,2121,3533
00279100,PACE UNIVERSITY - NEW YORK              ,NY,10038-1598,Private      ,142,283,425,8007,3374,11381
00279101,PACE UNIVERSITY-PLEASANTVILLE           ,NY,10570-0000,Private      ,56,109,165,3414,1126,4540
00279102,PACE UNIVERSITY - WHITE PLAINS          ,NY,10603-0000,Private      ,15,114,129,313,2274,2587
00279500,PAUL SMITHS CLG OF ARTS & SCIENCES      ,NY,12970-0000,Private      ,19,12,31,1142,150,1292
00279600,POLYTECHNIC INTSTITUTE OF NEW YORK UNIV ,NY,11201-3840,Private      ,43,113,156,2200,974,3174
00279800,PRATT INSTITUTE                         ,NY,11205-3899,Private      ,107,152,259,4652,2823,7475
00280300,RENSSELAER POLYTECHNIC INSTITUTE        ,NY,12180-3590,Private      ,121,47,168,10194,705,10899
00280500,ROBERTS WESLEYAN COLLEGE                ,NY,14624-1997,Private      ,15,123,138,1471,1188,2659
00280600,ROCHESTER INSTITUTE OF TECHNOLOGY       ,NY,14623-5608,Private      ,232,167,399,14182,3043,17225
00280700,ROCKEFELLER UNIVERSITY                  ,NY,10021-0000,Private      ,1,2,3,8,22,30
00280800,DAEMEN COLLEGE                          ,NY,14226-3592,Private      ,19,100,119,2049,980,3029
00281000,THE SAGE COLLEGES                       ,NY,12180-4199,Private      ,28,111,139,1486,1830,3316
00281200,TROCAIRE COLLEGE                        ,NY,14220-2094,Private      ,34,161,195,536,1339,1875
00281300,SARAH LAWRENCE COLLEGE                  ,NY,10708-5999,Private      ,18,17,35,1987,756,2743
00281400,SKIDMORE COLLEGE                        ,NY,12866-1632,Private      ,33,18,51,3994,136,4130
00281401,SKIDMORE COLL-UNIV WITHOUT WALLS        ,NY,12866-0000,Private      ,2,1,3,26,15,41
00281500,ST BERNARDS SCH THEOLOGY & MINISTRY     ,NY,14618-3822,Private      ,0,1,1,1,42,43
00281600,SIENA COLLEGE                           ,NY,12211-1462,Private      ,69,23,92,5877,253,6130
00281700,ST BONAVENTURE UNIVERSITY               ,NY,14778-2284,Private      ,33,36,69,2516,566,3082
00282000,ST FRANCIS COLLEGE                      ,NY,11201-4398,Private      ,109,72,181,2288,549,2837
00282100,ST JOHN FISHER COLLEGE                  ,NY,14618-3597,Private      ,56,98,154,4399,1792,6191
00282200,CHRIST THE KING SEMINARY                ,NY,14052-0607,Private      ,0,0,0,1,8,9
00282300,ST JOHN'S UNIVERSITY                    ,NY,11439-1343,Private      ,282,340,622,23259,6860,30119
00282500,ST JOSEPH'S COLLEGE                     ,NY,11205-3688,Private      ,37,86,123,1087,681,1768
00282501,ST JOSEPH'S COLLEGE-SUFFOLK CAMPUS      ,NY,11772-0000,Private      ,87,127,214,3147,1331,4478
00282600,ST JOSEPH'S SEMINARY                    ,NY,10704-0000,Private      ,0,0,0,1,0,1
00282900,ST LAWRENCE UNIVERSITY                  ,NY,13617-1455,Private      ,21,4,25,2867,129,2996
00283200,ST THOMAS AQUINAS COLLEGE               ,NY,10976-1050,Private      ,34,26,60,1803,370,2173
00283300,ST VLADIMIR ORTHODOX THEOL SEM          ,NY,10707-0000,Private      ,0,1,1,0,58,58
00283400,EXCELSIOR COLLEGE                       ,NY,12203-5159,Private      ,55,1145,1200,215,5866,6081
00283500,SUNY AT ALBANY                          ,NY,12222-0001,Public       ,344,323,667,20835,5542,26377
00283600,BINGHAMTON UNIVERSITY (SUNY)            ,NY,13902-6000,Public       ,333,178,511,23810,2987,26797
00283700,SUNY AT BUFFALO                         ,NY,14260-0001,Public       ,363,404,767,22449,10200,32649
00283800,SUNY AT STONY BROOK                     ,NY,11794-0001,Public       ,476,438,914,24058,7635,31693
00283900,SUNY-DOWNSTATE MEDICAL CENTER           ,NY,11203-2098,Public       ,8,48,56,135,1944,2079
00284000,SUNY UPSTATE MEDICAL UNIVERSITY         ,NY,13210-2375,Public       ,6,28,34,183,1274,1457
00284100,SUNY BROCKPORT - FIN AID OFF            ,NY,14420-2914,Public       ,165,248,413,9019,3009,12028
00284200,BUFFALO STATE COLLEGE - SUNY            ,NY,14222-1095,Public       ,358,400,758,11765,5359,17124
00284300,SUNY COLLEGE-CORTLAND                   ,NY,13045-0900,Public       ,127,122,249,11160,1808,12968
00284400,SUNY AT FREDONIA                        ,NY,14063-1145,Public       ,101,62,163,7393,1055,8448
00284500,SUNY GENESEO                            ,NY,14454-1401,Public       ,113,39,152,9649,548,10197
00284600,SUNY COLLEGE-NEW PALTZ                  ,NY,12561-2499,Public       ,208,150,358,11880,2315,14195
00284700,SUNY COLLEGE-ONEONTA                    ,NY,13820-4015,Public       ,139,49,188,10413,800,11213
00284800,SUNY OSWEGO                             ,NY,13126-3599,Public       ,134,168,302,10197,2308,12505
00284900,SUNY COLLEGE AT PLATTSBURGH             ,NY,12901-2681,Public       ,98,116,214,6906,1465,8371
00285000,SUNY COLLEGE-POTSDAM                    ,NY,13676-2294,Public       ,97,52,149,4856,1054,5910
00285100,SUNY COLLEGE OF ENVIRONMENT SCIENCE AND ,NY,13210-2778,Public       ,26,31,57,2021,547,2568
00285300,SUNY MARITIME COLLEGE                   ,NY,10465-4198,Public       ,39,20,59,1434,315,1749
00285400,SUNY COLLEGE OF TECHNOLOGY-ALFRED       ,NY,14802-9951,Public       ,68,77,145,3804,915,4719
00285500,SUNY CANTON COLG OF TECHNOLOGY          ,NY,13617-1098,Public       ,82,144,226,2846,1447,4293
00285600,SUNY AG & TECH COLLEGE-COBLESKILL       ,NY,12043-9986,Public       ,78,40,118,3095,522,3617
00285700,SUNY DELHI                              ,NY,13753-1190,Public       ,88,98,186,3469,880,4349
00285800,SUNY FARMINGDALE                        ,NY,11735-1021,Public       ,212,249,461,5649,2071,7720
00285900,SUNY COLLEGE OF AG & TECH AT MORRISVILLE,NY,13408-0901,Public       ,92,115,207,3611,1197,4808
00286000,ADIRONDACK COMMUNITY COLLEGE            ,NY,12804-2004,Public       ,135,277,412,1991,1617,3608
00286100,CAYUGA COMMUNITY COLLEGE                ,NY,13021-3099,Public       ,146,378,524,1864,2235,4099
00286200,BROOME COMMUNITY COLLEGE                ,NY,13902-0000,Public       ,209,377,586,3489,2760,6249
00286300,CORNING COMMUNITY COLLEGE               ,NY,14830-3297,Public       ,151,336,487,1960,2403,4363
00286400,DUTCHESS COMMUNITY COLLEGE              ,NY,12601-1595,Public       ,272,430,702,3256,2399,5655
00286600,FASHION INSTITUTE OF TECHNOLOGY         ,NY,10001-5992,Public       ,290,379,669,7528,3365,10893
00286700,SUNY FULTON MONTGOMERY COMM CLG         ,NY,12095-3790,Public       ,70,161,231,1469,1138,2607
00286800,HUDSON VALLEY COMMUNITY COLLEGE         ,NY,12180-6096,Public       ,455,737,1192,6976,4739,11715
00286900,JAMESTOWN COMMUNITY COLLEGE             ,NY,14702-0020,Public       ,158,399,557,2619,2229,4848
00287000,JEFFERSON COMMUNITY COLLEGE             ,NY,13601-1897,Public       ,78,294,372,1441,1854,3295
00287100,"SUNY, MOHAWK VALLEY COMMUNITY CLG       ",NY,13501-5394,Public       ,315,492,807,4251,3166,7417
00287200,MONROE COMMUNITY COLLEGE                ,NY,14623-5780,Public       ,586,1270,1856,10084,9048,19132
00287300,NASSAU COMMUNITY COLLEGE                ,NY,11530-6793,Public       ,858,906,1764,10969,5840,16809
00287400,NIAGARA COUNTY COMMUNITY COLLEGE        ,NY,14132-9460,Public       ,277,495,772,4214,3490,7704
00287500,ONONDAGA COMMUNITY COLLEGE              ,NY,13215-4585,Public       ,407,668,1075,6330,4323,10653
00287600,ORANGE COUNTY COMMUNITY COLLEGE         ,NY,10940-6441,Public       ,276,429,705,2921,2250,5171
00287700,ROCKLAND COMMUNITY COLLEGE              ,NY,10901-3611,Public       ,235,295,530,2431,1954,4385
00287800,SUFFOLK COMMUNITY COLLEGE               ,NY,11784-2899,Public       ,530,573,1103,7065,3468,10533
00287801,SUFFOLK COMMUNITY CLG-W. CAMPUS         ,NY,11717-0000,Public       ,287,428,715,3357,2550,5907
00287803,SUFFOLK COMMUNITY CLG-EASTRN CAMPUS     ,NY,11901-0000,Public       ,103,135,238,1097,810,1907
00287900,SULLIVAN COUNTY COMMUNITY COLLEGE       ,NY,12759-5151,Public       ,108,133,241,1574,852,2426
00288000,ULSTER COUNTY COMMUNITY COLLEGE         ,NY,12484-0557,Public       ,107,210,317,1337,1039,2376
00288100,SUNY WESTCHESTER COMMUNITY COLLEGE      ,NY,10595-1698,Public       ,472,735,1207,5179,4350,9529
00288200,SYRACUSE UNIVERSITY                     ,NY,13244-2130,Private      ,256,248,504,20328,6264,26592
00288300,UTICA COLLEGE OF SYRACUSE UNIV          ,NY,13502-4892,Private      ,47,155,202,3396,1651,5047
00288500,ALBANY COLLEGE OF PHARMACY AND HEALTH SC,NY,12208-3492,Private      ,13,9,22,1512,662,2174
00288600,ALBANY LAW SCHOOL                       ,NY,12208-0000,Private      ,4,9,13,29,1592,1621
00288700,ALBANY MEDICAL COLLEGE                  ,NY,12208-0000,Private      ,2,16,18,41,1096,1137
00288900,UNION COLLEGE                           ,NY,12308-2311,Private      ,29,5,34,3269,97,3366
00289000,UNION THEOLOGICAL SEMINARY              ,NY,10027-0000,Private      ,0,6,6,0,306,306
00289200,UNITED STATES MERCHANT MARINE ACADEMY   ,NY,11024-1699,Public       ,8,1,9,422,26,448
00289400,UNIVERSITY OF ROCHESTER                 ,NY,14627-9000,Private      ,97,134,231,7578,1879,9457
00289401,EASTMAN SCH OF MUSIC/UNIV ROCHESTER     ,NY,14604-0000,Private      ,8,7,15,720,380,1100
00289402,UNIV OF ROCHESTER SCHL OF MEDICINE      ,NY,14642-0000,Private      ,3,17,20,43,756,799
00289500,VASSAR COLLEGE                          ,NY,12604-0008,Private      ,60,10,70,4994,117,5111
00289600,VILLA MARIA COLLEGE-BUFFALO             ,NY,14225-3999,Private      ,27,39,66,483,260,743
00289900,WAGNER COLLEGE                          ,NY,10301-4495,Private      ,40,39,79,2749,420,3169
00290000,WEBB INSTITUTE                          ,NY,11542-1398,Private      ,0,0,0,54,7,61
00290100,WELLS COLLEGE                           ,NY,13026-0500,Private      ,22,6,28,1265,84,1349
00290300,YESHIVA UNIVERSITY                      ,NY,10033-3201,Private      ,56,101,157,2078,3471,5549
00290302,YESHIVA UNIVERSITY - BRONX CAMPUS       ,NY,10461-1975,Private      ,4,21,25,18,1200,1218
00397400,MESIVTHA TIFERETH JERUSALEM OF AMER     ,NY,10002-6382,Private      ,12,0,12,26,0,26
00397600,RABBINICAL ACAD MESIVTA RABBI CHAIM     ,NY,11230-4715,Private      ,15,2,17,18,2,20
00397700,RABBINICAL COLLEGE CH'SAN SOFER         ,NY,11204-1252,Private      ,0,7,7,0,7,7
00397800,RABBINICAL SEMINARY OF AMERICA          ,NY,11375-0000,Private      ,5,10,15,13,25,38
00397900,COLUMBIA UNIV TEACHERS COLLEGE          ,NY,10027-0000,Private      ,6,195,201,32,4438,4470
00405400,HEBREW UNION COL-JEWISH INST OF REL     ,NY,10012-0000,Private      ,0,0,0,0,93,93
00455301,ITT TECHNICAL INSTITUTE                 ,NY,12205-0000,Proprietary  ,49,145,194,190,537,727
00475900,"CUNY, YORK COLLEGE                      ",NY,11451-0001,Public       ,328,483,811,7595,4432,12027
00476500,CUNY GRADUATE SCH & UNIV CTR            ,NY,10016-4309,Public       ,8,238,246,77,2844,2921
00477600,CENTRAL YESHIVA TOMCHEI TMIMIM LUBA     ,NY,11230-2798,Private      ,157,25,182,178,28,206
00478800,HERKIMER COUNTY COMMUNITY COLLEGE       ,NY,13350-1598,Public       ,125,203,328,2650,1345,3995
00479800,MIRRER YESHIVA CENTRAL INST             ,NY,11223-2010,Private      ,31,7,38,85,53,138
00479900,MONROE COLLEGE                          ,NY,10468-4305,Proprietary  ,255,684,939,3744,6407,10151
00481100,EVEREST INSTITUTE                       ,NY,14621-3007,Proprietary  ,76,363,439,406,2030,2436
00506401,ST JAMES MERCY HOSP SCH OF RAD          ,NY,14843-2197,Private      ,0,1,1,11,23,34
00506600,FAXTON ST. LUKE'S SCHOOL OF RADIOGRAPHY ,NY,13502-4856,Private      ,0,1,1,20,18,38
00520800,THE COLLEGE OF WESTCHESTER              ,NY,10602-0000,Proprietary  ,89,156,245,944,825,1769
00587700,ROBERT J HOCHSTIM SCHOOL OF RADIOG      ,NY,11572-1151,Private      ,0,1,1,1,7,8
00643501,ARNOT OGDEN MEDICAL CENTER              ,NY,14905-1676,Private      ,0,5,5,31,54,85
00643800,PHILLIPS BETH ISRAEL SCH OF NURSING     ,NY,10001-6354,Private      ,2,24,26,95,312,407
00644300,COCHRAN SCH NSG-ST JOHN RVSDE HOSP      ,NY,10701-1399,Private      ,3,30,33,53,388,441
00644500,CROUSE HOSP SCH OF NURSING              ,NY,13210-1690,Private      ,8,23,31,151,258,409
00644800,ELLIS HOSPITAL SCHOOL OF NURSING        ,NY,12308-0000,Private      ,7,12,19,43,141,184
00646101,ST ELIZABETH COLLEGE OF NURSING         ,NY,13501-2998,Private      ,3,9,12,109,205,314
00646102,ST ELIZABETH SCH OF RADIOGRAPHY         ,NY,13501-0000,Private      ,0,2,2,16,22,38
00646700,SAINT JOSEPH'S COLLEGE OF NURSING       ,NY,13203-1806,Private      ,2,14,16,173,257,430
00678200,GENESEE COMMUNITY COLLEGE               ,NY,14020-9704,Public       ,165,371,536,2708,2553,5261
00678500,SCHENECTADY COUNTY COMMUNITY CLG        ,NY,12305-2294,Public       ,141,331,472,2047,2039,4086
00678700,CLINTON COMMUNITY COLLEGE               ,NY,12901-5690,Public       ,62,90,152,1266,787,2053
00678800,TOMPKINS CORTLAND COMMUNITY COLLEGE     ,NY,13053-8504,Public       ,162,254,416,2622,1676,4298
00678900,COLUMBIA-GREENE COMMUNITY COLLEGE       ,NY,12534-9543,Public       ,54,131,185,1015,843,1858
00679100,SUNY AT PURCHASE                        ,NY,10577-1400,Public       ,122,72,194,6719,1041,7760
00702200,CUNY-LEHMAN COLLEGE                     ,NY,10468-1589,Public       ,425,996,1421,11037,8828,19865
00702600,"MT SINAI SCH OF MEDICINE, NY UNIV       ",NY,10029-0000,Private      ,3,18,21,17,1080,1097
00710900,SUNY COLLEGE-OLD WESTBURY               ,NY,11568-0210,Public       ,155,166,321,5156,1758,6914
00711100,NORTH COUNTRY COMMUNITY COLLEGE         ,NY,12983-2046,Public       ,46,108,154,719,733,1452
00726400,MESIFTA TORAH VODAATH RABBINCAL SEM     ,NY,11218-5209,Private      ,12,9,21,24,28,52
00727300,CUNY-BERNARD BARUCH COLLEGE             ,NY,10010-5518,Public       ,442,814,1256,15235,7672,22907
00730400,CULINARY INSTITUTE OF AMERICA           ,NY,12538-1499,Private      ,211,192,403,3282,1551,4833
00737200,AUSTIN'S SCHOOL OF SPA TECHNOLOGY       ,NY,12206-1513,Proprietary  ,29,92,121,163,385,548
00737500,ISLAND DRAFTING & TECHNICAL INST        ,NY,11701-2704,Proprietary  ,3,14,17,76,98,174
00738700,LONG ISLAND BEAUTY SCHOOL               ,NY,11788-4346,Proprietary  ,25,34,59,69,122,191
00738800,LONG ISLAND BEAUTY SCHOOL               ,NY,11550-3704,Proprietary  ,7,27,34,40,121,161
00739100,BEAUTY SCHOOL OF MIDDLETOWN             ,NY,10940-6574,Proprietary  ,6,20,26,29,69,98
00739400,BERKELEY COLLEGE                        ,NY,10017-0000,Proprietary  ,208,482,690,2644,2961,5605
00739402,BERKELEY COLLEGE-WESTCHESTER CAMPUS     ,NY,10601-1533,Proprietary  ,44,67,111,820,417,1237
00739800,KATHARINE GIBBS SCHOOL                  ,NY,10018-2602,Proprietary  ,5,12,17,109,211,320
00740100,MANDL SCHOOL                            ,NY,10019-5516,Proprietary  ,28,145,173,155,712,867
00740500,WOOD TOBE-COBURN SCHOOL                 ,NY,10016-0102,Proprietary  ,5,3,8,594,135,729
00746500,AMERICAN ACADEMY OF DRAMATIC ARTS       ,NY,10016-7089,Private      ,21,19,40,399,168,567
00746600,LIM COLLEGE                             ,NY,10022-5268,Proprietary  ,42,25,67,1684,217,1901
00746800,SCHOOL OF VISUAL ARTS                   ,NY,10010-3994,Proprietary  ,99,120,219,3853,1582,5435
00750602,LINCOLN TECHNICAL INSTITUTE             ,NY,11357-6092,Proprietary  ,83,80,163,544,347,891
00751800,APEX TECHNICAL SCHOOL                   ,NY,10011-2008,Proprietary  ,214,579,793,831,2080,2911
00752200,CONTINENTAL SCH OF BEAUTY CULTURE       ,NY,14623-3231,Proprietary  ,41,105,146,188,499,687
00753200,FINGER LAKES COMMUNITY COLLEGE          ,NY,14424-8395,Public       ,157,327,484,3446,2368,5814
00757200,AMERICAN MUSICAL AND DRAMATIC ACAD      ,NY,10023-2106,Private      ,64,35,99,1685,310,1995
00757300,EMPIRE BEAUTY SCHOOL                    ,NY,11103-4028,Proprietary  ,9,38,47,82,211,293
00780400,CAREER ACADEMY OF NEW YORK              ,NY,10011-7307,Proprietary  ,42,180,222,181,714,895
00818900,CONTINENTAL SCH OF BEAUTY CULTURE       ,NY,14223-0000,Proprietary  ,2,5,7,8,20,28
00818902,CONTINENTAL SCHOOL OF BEAUTY CULTURE  - ,NY,14224-3402,Proprietary  ,0,0,0,3,2,5
00843700,CHAMPLAIN VALLEY - TEC/PRN              ,NY,12901-0000,Public       ,1,3,4,18,44,62
00849500,JAMESTOWN BUSINESS COLLEGE              ,NY,14702-0429,Proprietary  ,10,56,66,154,343,497
00861100,"CUNY, HOSTOS CMTY COLLEGE               ",NY,10451-1499,Public       ,510,950,1460,4685,5369,10054
00861400,RABBINICAL CLG BOBOVER YESHIVA BNEI     ,NY,11219-3293,Private      ,61,22,83,86,23,109
00861700,RABBINICAL SEM MKOR CHAIM-YESHIVA       ,NY,11219-4300,Private      ,15,0,15,15,1,16
00878800,SUNY-STUDENT LOAN SERVICE CENTER        ,NY,12144-3440,Public       ,1,0,1,12,6,18
00900300,OLEAN BUSINESS INSTITUTE INC            ,NY,14760-2691,Proprietary  ,5,22,27,24,83,107
00902900,NEIGHBORHOOD PLAYHOUSE                  ,NY,10022-5017,Private      ,2,1,3,25,36,61
00904300,ELMIRA BUSINESS INSTITUTE               ,NY,14901-2731,Proprietary  ,15,147,162,126,844,970
00907700,UTICA SCHOOL OF COMMERCE                ,NY,13501-2280,Proprietary  ,18,70,88,165,504,669
00924800,SAMARITAN HOSPITAL SCH NURSING          ,NY,12180-2475,Private      ,2,18,20,46,195,241
00928300,MIDWAY-PARIS BEAUTY SCHOOL              ,NY,11385-3453,Proprietary  ,8,39,47,25,97,122
00928400,LEARNING INST FOR BEAUTY SCIENCES       ,NY,11756-1345,Proprietary  ,27,69,96,100,226,326
00933500,MESIVTA EASTERN PKWY RABBINICAL CLG     ,NY,11218-5559,Private      ,7,4,11,21,6,27
00947900,SAINT VINCENTS CMC SI NURSING SCHOOL    ,NY,10304-3850,Proprietary  ,12,33,45,76,164,240
00976900,METROPOLITAN COLLEGE OF NEW YORK        ,NY,10013-1919,Private      ,18,158,176,203,1697,1900
00992900,SUNY COLLEGE OF OPTOMETRY               ,NY,10036-8003,Public       ,4,2,6,24,350,374
01005100,LA GUARDIA CMTY COLLEGE - CUNY          ,NY,11101-3083,Public       ,671,926,1597,9898,7980,17878
01005200,JEFFERSON-LEWIS BOCES PRAC NRSGPRG      ,NY,13601-9509,Public       ,6,18,24,24,115,139
01009700,CUNY-MEDGAR W EVERS COLLEGE             ,NY,11225-2010,Public       ,280,635,915,4732,5471,10203
01014200,TOURO COLLEGE                           ,NY,10010-4202,Private      ,299,947,1246,3438,12045,15483
01014700,WESTERN SUFFOLK BOCES                   ,NY,11768-3499,Public       ,12,54,66,72,283,355
01015300,HELENE FULD COL OF NRSNG/N GEN HOSP     ,NY,10035-0000,Private      ,8,120,128,28,477,505
01028600,EMPIRE STATE COLLEGE                    ,NY,12866-4391,Public       ,95,1459,1554,791,11483,12274
01037800,RABBINICAL COLLEGE OF LONG ISLAND       ,NY,11561-3244,Private      ,11,0,11,35,1,36
01054900,KEHILATH YAKOV RABBINICAL SEMINARY      ,NY,10562-1001,Private      ,20,9,29,20,9,29
01055100,NEW YORK SCH MED & DENTAL ASSISTANT     ,NY,11101-2327,Proprietary  ,35,93,128,165,384,549
01064100,SOUTHERN WESTCHESTER BOCES              ,NY,10543-0000,Public       ,0,12,12,17,141,158
01068400,ERIE COMMUNITY COLLEGE-ALL CAMPUSES     ,NY,14203-2698,Public       ,579,1161,1740,8181,7677,15858
01081300,AMERICAN ACAD MCALLISTER INST           ,NY,10019-3604,Private      ,3,43,46,79,323,402
01083700,SIMMONS INST OF FUNERAL SERVICE         ,NY,13207-2098,Proprietary  ,1,1,2,35,37,72
01093000,SUBURBAN TECHNICAL SCHOOL               ,NY,11550-3771,Proprietary  ,68,245,313,226,840,1066
01094300,RABBINICAL COLLEGE BETH SHRAGA          ,NY,10952-3033,Private      ,3,0,3,9,0,9
01095200,PNW BOCES LPN PROGRAM                   ,NY,10598-0000,Public       ,1,10,11,11,86,97
01103100,TECHNICAL CAREER INSTITUTE              ,NY,10001-2789,Proprietary  ,335,630,965,2329,4626,6955
01118900,UNITED TALMUDICAL SEMINARY              ,NY,11211-7984,Private      ,485,234,719,496,234,730
01161400,CHAMPLAIN VALLEY HOSP SCH RAD TECH      ,NY,12901-1490,Private      ,0,0,0,22,11,33
01161700,NEW YORK METHODIST HOSPITAL             ,NY,11229-9023,Private      ,1,14,15,66,155,221
01164700,SBI CAMPUS - AN AFFILIATE OF SANFORD-BRO,NY,11747-3785,Proprietary  ,49,103,152,334,574,908
01167000,YESHIVA OF NITRA RABBINICAL COLLEGE     ,NY,11211-7108,Private      ,47,1,48,48,1,49
01167700,MEMORIAL SLOAN KETTERING CANCER CTR     ,NY,10021-6094,Private      ,0,6,6,1,23,24
01167800,SUNY INST OF TECHNOLOGY UTICA ROME      ,NY,13504-3050,Public       ,34,112,146,1675,1220,2895
01182100,YESHIVATH ZICHRON MOSHE                 ,NY,12779-0580,Private      ,28,1,29,62,2,64
01183000,BERK TRADE AND BUSINESS SCHOOL          ,NY,11101-0000,Proprietary  ,12,60,72,26,147,173
01185900,WORD OF LIFE BIBLE INSTITUTE            ,NY,12860-0129,Private      ,19,4,23,503,81,584
01186000,MERCY MED CNTR SCHL OF RADIOGRAPHY      ,NY,11570-1098,Private      ,0,2,2,6,14,20
01192100,WESTCHESTER SCH OF BEAUTY CULTURE       ,NY,10550-2295,Proprietary  ,4,26,30,16,92,108
01192200,BETH HATALMUD RABBINICAL CLG            ,NY,11214-2594,Private      ,1,0,1,2,0,2
01198400,OHR HAMEIR THEOLOGICAL SEMINARY         ,NY,10566-0990,Private      ,30,0,30,31,2,33
01201100,TALMUDICAL SEM OHOLEI TORAH             ,NY,11213-3310,Private      ,101,0,101,130,0,130
01207200,PHILLIPS HAIRSTYLING INSTITUTE          ,NY,13210-1509,Proprietary  ,6,31,37,37,114,151
01210700,INSTITUTE OF DESIGN & CONSTRUCTION      ,NY,11201-5380,Private      ,2,25,27,44,151,195
01220300,MEMORIAL HOSPITAL SCH OF NURSING        ,NY,12204-1083,Private      ,4,16,20,34,149,183
01227700,NEW YORK CHIROPRACTIC COLLEGE           ,NY,13148-0800,Private      ,0,26,26,19,713,732
01229300,VEEB NASSAU CNTY SCHL OF PRACT NURS     ,NY,11553-3037,Public       ,0,6,6,51,200,251
01235800,PLAZA COLLEGE                           ,NY,11372-6300,Proprietary  ,66,126,192,447,1051,1498
01236400,SAINT VINCENTS CATHOLIC MEDICAL CENTERS ,NY,11354-0000,Proprietary  ,9,28,37,49,208,257
01240700,SCHUYLER-CHEMUNG-TIOGA BOCES            ,NY,14903-1089,Public       ,2,18,20,26,150,176
01240701,STEUBEN SCHUYLER CHEMUNG TIOGA ALLEGANY ,NY,14870-9518,Public       ,0,0,0,1,2,3
01256100,FIVE TOWNS COLLEGE                      ,NY,11746-5871,Proprietary  ,61,30,91,1396,297,1693
01258900,ERIE 1 BOCES                            ,NY,14224-0000,Public       ,6,49,55,61,256,317
01265200,ONONDAGA CORTLAND MADISON BOCES         ,NY,13090-4500,Public       ,25,171,196,177,959,1136
01278300,OSWEGO COUNTY BOCES ADULT CAREERS       ,NY,13114-4498,Public       ,3,14,17,31,124,155
01292700,CENTRAL TECH NURSING PROGRAM            ,NY,13202-3092,Public       ,3,19,22,14,79,93
01302600,MACHZIKEI HADATH RABBINICAL COLLEGE     ,NY,11204-1805,Private      ,7,0,7,7,0,7
01302700,YESHIVATH VIZNITZ                       ,NY,10952-3021,Private      ,1,0,1,1,0,1
01302900,BORICUA COLLEGE                         ,NY,10032-1599,Private      ,24,89,113,373,1111,1484
02056400,CAPRI COSMETOLOGY LEARNING CENTER       ,NY,10954-0000,Proprietary  ,19,42,61,66,164,230
02066200,THE NEW SCHOOL                          ,NY,10011-0000,Private      ,199,468,667,5332,6003,11335
02069000,NEW YORK SCHOOL OF INTERIOR DESIGN      ,NY,10021-0000,Private      ,11,45,56,204,344,548
02075700,BRIARCLIFFE COLLEGE                     ,NY,11714-0000,Proprietary  ,62,95,157,934,749,1683
02075702,BRIARCLIFFE COLLEGE - PATCHOGUE         ,NY,11772-3019,Proprietary  ,32,84,116,651,582,1233
02092400,RIDLEY-LOWELL SCHOOL OF BUSINESS        ,NY,13905-0000,Proprietary  ,7,62,69,37,296,333
02093700,LONG ISLAND BUSINESS INSTITUTE          ,NY,11725-0000,Proprietary  ,84,105,189,465,1073,1538
02093701,LONG ISLAND BUSINESS INSTITUTE - FLUSHIN,NY,11354-4429,Proprietary  ,31,49,80,31,49,80
02098400,HERKIMER COUNTY BOCES                   ,NY,13350-0000,Public       ,4,5,9,39,137,176
02104300,OTSEGO AREA SCHOOL OF PRAC NURSING      ,NY,13820-0000,Public       ,0,1,1,9,36,45
02105900,HAIR DESIGN INSTITUTE AT FIFTH AVE      ,NY,11220-0000,Proprietary  ,13,85,98,37,167,204
02106800,BRAMSON ORT COLLEGE                     ,NY,11375-0000,Private      ,142,162,304,353,622,975
02110900,CATTARAUGUS/ALLEGANY BOCES              ,NY,14760-0000,Public       ,1,4,5,28,121,149
02112301,RIDLEY - LOWELL BUSINESS & TECHNICAL INS,NY,12601-3328,Proprietary  ,18,132,150,88,454,542
02116011,SANFORD-BROWN INSTITUTE - NEW YORK      ,NY,10003-2103,Proprietary  ,131,400,531,701,1866,2567
02118700,LONG ISLAND COLLEGE HOSPITAL - SCHOOL OF,NY,11201-6001,Private      ,5,16,21,67,239,306
02118702,LONG ISLAND COLLEGE HOSPITAL - SCHOOL OF,NY,11201-6001,Private      ,2,10,12,73,153,226
02124000,ORANGE ULSTER BOCES SCH OF PRAC NRS     ,NY,10924-9401,Public       ,0,17,17,29,125,154
02125500,CIRCLE IN THE SQUARE THEATRE SCHOOL     ,NY,10019-0000,Private      ,2,1,3,62,52,114
02126300,MADISON-ONEIDA BOCES PRAC NRS           ,NY,13478-0000,Public       ,4,23,27,22,166,188
02138500,BOCES RENSSELAER SCH OF PRAC NRSG       ,NY,12033-3221,Public       ,2,8,10,23,90,113
02145800,CAYUGA ONONDAGA BOCES                   ,NY,13021-9430,Public       ,0,7,7,16,85,101
02146000,WAYNE-FINGER LAKES BOCES                ,NY,14513-0000,Public       ,0,5,5,44,251,295
02152000,YESHIVA SHAAR HATORAH ITRI TORAH        ,NY,11418-0000,Private      ,0,0,0,1,0,1
02153600,BROOME-TIOGA BOCES PN PROG              ,NY,13905-0000,Public       ,2,22,24,30,161,191
02157900,ROCHESTER GENERAL HOSPITAL              ,NY,14621-3001,Private      ,0,4,4,20,114,134
02158200,WSHNGTN-SARTGA-WARN-HMLTN-ESX BOCES     ,NY,12839-1051,Public       ,1,2,3,38,133,171
02160100,GENEVA GENERAL HOSPITAL                 ,NY,14456-0000,Private      ,0,11,11,25,99,124
02163400,NEW YORK CAREER INSTITUTE               ,NY,10007-2801,Proprietary  ,35,108,143,236,707,943
02169100,DAVIS COLLEGE                           ,NY,13790-0000,Private      ,2,10,12,177,116,293
02170000,SWEDISH INSTITUTE                       ,NY,10001-0000,Proprietary  ,18,107,125,117,664,781
02170200,ALBANY SCHOHARIE SCHENECTADY            ,NY,12205-0000,Public       ,8,34,42,38,180,218
02171900,AILEY SCHOOL (THE)                      ,NY,10019-4402,Private      ,1,3,4,99,31,130
02172100,HAMILTON-FULTON-MONTGOMERY BOCES        ,NY,12095-0000,Public       ,4,5,9,35,57,92
02172800,DUTCHESS COUNTY BOCES SCH PRAC NURS     ,NY,12601-0000,Public       ,8,40,48,46,176,222
02173200,EMPIRE BEAUTY SCHOOL                    ,NY,10001-0000,Proprietary  ,62,148,210,410,831,1241
02173201,LEARNING INSTITUTES FOR BEAUTY SCIENCES-,NY,11214-4347,Proprietary  ,2,3,5,5,15,20
02173900,ULSTER COUNTY BOCES PRACTICAL NRSG      ,NY,12466-0000,Public       ,6,44,50,32,178,210
02176000,CHERYL FELL'S SCHOOL OF BUSINESS        ,NY,14304-0000,Proprietary  ,1,11,12,7,71,78
02179400,EASTERN SUFFOLK BOCES                   ,NY,11713-0000,Public       ,6,35,41,145,463,608
02182200,NEW SCHOOL OF RADIO & TELEVISION        ,NY,12206-1106,Proprietary  ,3,11,14,38,61,99
02187300,DARKEI NOAM RABBINICAL COLLEGE          ,NY,11210-0000,Private      ,0,0,0,0,1,1
02191600,TORAH TEMIMAH TALMUDICAL SEMINARY       ,NY,11218-0000,Private      ,31,0,31,42,0,42
02192500,BELLEVUE HOSP CTR SCH RAD TECH          ,NY,10016-0000,Public       ,0,14,14,11,46,57
02193700,SAINT LAWRENCE LEWIS COUNTY BOCES       ,NY,13617-0000,Public       ,0,0,0,74,4,78
02193701,SAINT LAWRENCE LEWIS COUNTY BOCES - NORT,NY,13669-0798,Public       ,0,1,1,0,1,1
02193703,SAINT LAWRENCE LEWIS COUNTY BOCES - ADUL,NY,13668-3238,Public       ,0,0,0,1,0,1
02199300,ORLEANS-NIAGARA BOCES                   ,NY,14132-0000,Public       ,1,8,9,9,56,65
02206000,HUNTER BUSINESS SCHOOL                  ,NY,11756-0000,Proprietary  ,51,182,233,151,712,863
02206001,HUNTER BUSINESS SCHOOL -                ,NY,11763-0000,Proprietary  ,0,0,0,13,11,24
02217800,D.HOPFER SCH NURSING AT MT.VRN HOSP     ,NY,10550-0000,Private      ,1,22,23,38,247,285
02219500,MILDRED ELLEY                           ,NY,12206-1513,Proprietary  ,59,255,314,284,1330,1614
02235600,ERIE 2-CHAUTAUQUA-CATTARAUGUS BOCES     ,NY,14006-0000,Public       ,8,25,33,27,148,175
02265100,YESHIVA DERECH CHAIM                    ,NY,11218-0000,Private      ,18,4,22,33,8,41
02265200,GLOBAL BUSINESS INSTITUTE               ,NY,11691-0000,Private      ,78,232,310,359,1118,1477
02272900,ROCKLAND COUNTY BOCES PRAC NRSG SCH     ,NY,10994-0000,Public       ,0,9,9,19,112,131
02275900,"MODERN WELDING SCHOOL, INC.             ",NY,12304-0000,Proprietary  ,17,38,55,49,87,136
02287800,NATIONAL TRACTOR TRAILER SCHOOL         ,NY,13088-2505,Proprietary  ,8,132,140,22,342,364
02294900,INSTITUTE OF AUDIO RESEARCH             ,NY,10003-0000,Proprietary  ,82,111,193,421,421,842
02306500,PROFESSIONAL BUSINESS INSTITUTE         ,NY,10002-0000,Private      ,99,127,226,431,735,1166
02314200,NORTHERN WESTCHESTER SCH COSMETOL       ,NY,10566-0000,Proprietary  ,7,6,13,18,20,38
02320100,OHR SOMAYACH TANENBAUM EDUCATIONAL CENTE,NY,10952-0000,Private      ,0,0,0,1,1,2
02325600,NEW YORK INSTITUTE OF ENGLISH & BUS     ,NY,10001-0000,Private      ,29,59,88,107,281,388
02349700,RABBINICAL SEMINARY ADAS YEREIM         ,NY,11211-0000,Private      ,0,0,0,1,0,1
02350600,YESHIVA AND KOLLEL HARBOTZAS TORAH      ,NY,11230-0000,Private      ,0,8,8,0,14,14
02454300,NEW YORK UNIVERSITY SCHOOL OF MEDICINE  ,NY,10016-6497,Private      ,0,0,0,204,840,1044
02491400,SPANISH AMERICAN INSTITUTE              ,NY,10036-0000,Private      ,1,10,11,4,21,25
02505800,YESHIVA KARLIN STOLIN RAB INSTITUTE     ,NY,11204-0000,Private      ,6,15,21,6,15,21
02505900,SH-OR YOSHUV RABBINICAL COLLEGE         ,NY,11691-0000,Private      ,5,3,8,28,11,39
02506000,ASSOCIATED BETH RIVKAH SCHOOLS          ,NY,11225-0000,Private      ,24,10,34,75,17,92
02506100,CITY UNIV OF NEW YORK-CENTRAL           ,NY,10021-0000,Public       ,15,42,57,591,425,1016
02506200,MERCE CUNNINGHAM STUDIO                 ,NY,10014-0000,Private      ,0,2,2,4,7,11
02506800,YESHIVAT MIKDASH MELECH                 ,NY,11230-0000,Private      ,2,1,3,15,3,18
02511500,JOFFREY BALLET SCHOOL                   ,NY,10011-0000,Proprietary  ,0,0,0,50,3,53
02513500,MAR JON SCHOOL OF BEAUTY CULTURE        ,NY,14150-0000,Proprietary  ,2,14,16,24,59,83
02525600,ART INSTITUTE OF NEW YORK CITY (THE)    ,NY,10013-2429,Proprietary  ,146,185,331,1853,1127,2980
02540800,"GLOBE INSTITUTE OF TECHNOLOGY, INC.     ",NY,10007-0000,Proprietary  ,66,89,155,352,335,687
02546000,TRI-STATE COLLEGE OF ACUPUNCTURE        ,NY,10011-0000,Proprietary  ,0,12,12,1,158,159
02546300,YESHIVA OF THE TELSHE ALUMNI            ,NY,10471-0000,Private      ,9,0,9,10,0,10
02550600,TALMUDICAL INST OF UPSTATE NY           ,NY,14607-0000,Private      ,1,3,4,3,6,9
02556700,SEMINAR L'MOROS BAIS YAAKOV             ,NY,11219-0000,Private      ,14,1,15,281,3,284
02572900,BUSINESS INFORMATICS CENTER             ,NY,11580-0000,Proprietary  ,9,26,35,33,96,129
02575400,FRENCH CULINARY INSTITUTE               ,NY,10013-2618,Proprietary  ,41,223,264,304,896,1200
02587600,ORLO SCH HAIR DESIGN & COSMETOLOGY      ,NY,12206-1723,Proprietary  ,8,33,41,75,99,174
02599400,NEW YORK COLLEGE OF HEALTH PROFESSIONS  ,NY,11791-4413,Private      ,23,75,98,191,749,940
02600100,NEW YORK ACADEMY OF ART (THE)           ,NY,10013-2911,Private      ,6,13,19,67,204,271
02614900,SANFORD-BROWN INSTITUTE                 ,NY,10604-2910,Proprietary  ,39,146,185,190,676,866
02615001,SANFORD-BROWN INSTITUTE - GARDEN CITY   ,NY,11530-4734,Proprietary  ,4,23,27,27,75,102
02616600,SHEAR EGO INTL SCH OF HAIR DESIGN       ,NY,14617-3501,Proprietary  ,9,49,58,65,161,226
02617000,CONTINENTAL SCH OF BEAUTY CULTURE       ,NY,14020-1908,Proprietary  ,9,41,50,41,119,160
02617001,CONTINENTAL SCHOOL OF BEAUTY CULTURE - O,NY,14760-2618,Proprietary  ,0,0,0,3,3,6
02622900,BAIS MEDRASH ELYON                      ,NY,10952-3013,Private      ,1,1,2,1,1,2
03000100,YESHIVA GEDOLAH IMREI YOSEF DSPINKA     ,NY,11219-4696,Private      ,0,58,58,0,58,58
03007200,DANCE THEATRE OF HARLEM                 ,NY,10031-0000,Private      ,0,2,2,10,6,16
03027701,PACIFIC COLLEGE OF ORIENTAL MEDICINE - N,NY,10010-7108,Proprietary  ,6,113,119,22,461,483
03081600,DELAWARE CHENANGO MADISON OT. BOCES     ,NY,13815-9554,Public       ,0,18,18,15,91,106
03088500,NEW YORK INTERNATIONAL BEAUTY SCH       ,NY,10019-0000,Proprietary  ,1,2,3,26,76,102
03089700,COMPUTER CAREER CENTER                  ,NY,11530-3334,Proprietary  ,114,516,630,319,1352,1671
03095500,ASA INST BUSINESS & COMPUTER TECH       ,NY,11201-5208,Proprietary  ,520,1063,1583,1867,4413,6280
03096200,CHARLES STUART SCHOOL                   ,NY,11229-2004,Proprietary  ,2,7,9,9,47,56
03097801,CARSTEN INSTITUTE                       ,NY,10003-1901,Proprietary  ,0,6,6,3,24,27
03099100,SUNBRIDGE COLLEGE                       ,NY,10977-0000,Private      ,0,0,0,0,14,14
03103700,ADIRONDACK BEAUTY SCHOOL                ,NY,12801-3158,Proprietary  ,5,8,13,17,39,56
03104900,SULLIVAN COUNTY BOCES                   ,NY,12754-2116,Public       ,3,4,7,21,43,64
03111100,NEW YORK PARALEGAL SCHOOL               ,NY,10007-0000,Proprietary  ,0,0,0,5,12,17
03115300,GENESEE VALLEY BOCES                    ,NY,14020-1099,Public       ,7,48,55,27,162,189
03120700,NEW YORK CONSERVATORY FOR DRAMATIC ARTS ,NY,10011-4225,Proprietary  ,19,4,23,476,129,605
03127100,YESHIVAS NOVOMINSK                      ,NY,11219-0000,Private      ,16,0,16,16,0,16
03129200,RABBINICAL CLG OHR SHIMAR YISROEL       ,NY,11211-8102,Private      ,34,46,80,36,46,82
03169300,STUDIO JEWELERS                         ,NY,10016-4112,Proprietary  ,0,9,9,3,29,32
03181400,MERKAZ BNOS                             ,NY,11204-0000,Private      ,6,161,167,18,307,325
03191300,CUNY SCHOOL OF LAW @ QUEENS COLLEGE     ,NY,11367-0000,Public       ,15,36,51,199,1278,1477
03193300,MANHATTAN SCHOOL OF COMPUTER TECH       ,NY,11230-1617,Private      ,17,130,147,69,484,553
03203300,NEW YORK INSTITUTE OF MASSAGE           ,NY,14221-6021,Proprietary  ,6,32,38,54,166,220
03216300,UNIFICATION THEOLOGICAL SEMINARY        ,NY,12507-5021,Private      ,0,4,4,0,16,16
03315300,HARLEM SCHOOL OF TECHNOLOGY             ,NY,10027-4426,Proprietary  ,2,11,13,13,44,57
03328300,FRANKLIN CAREER INSTITUTE               ,NY,11550-3003,Private      ,39,91,130,237,588,825
03328301,FRANKLIN CAREER INSTITUTE - BROOKLYN    ,NY,11220-3110,Private      ,8,12,20,8,12,20
03342400,AMERICAN BARBER INSTITUTE               ,NY,10001-5271,Proprietary  ,19,50,69,59,163,222
03358300,ALLEN SCHOOL                            ,NY,11432-4901,Proprietary  ,73,352,425,318,1464,1782
03358301,ALLEN SCHOOL - BROOKLYN                 ,NY,11201-0000,Proprietary  ,15,48,63,18,80,98
03361500,WILLSEY INSTITUTE                       ,NY,10301-1989,Proprietary  ,0,0,0,1,2,3
03380300,CULINARY ACADEMY OF LONG ISLAND         ,NY,11791-5311,Proprietary  ,26,70,96,122,273,395
03419400,NORTHEASTERN SEMINARY                   ,NY,14624-1997,Private      ,0,16,16,7,109,116
03426400,ANTHEM INSTITUTE                        ,NY,10018-0000,Proprietary  ,76,140,216,345,631,976
03433500,LIA SCHORR INSTITUTE OF COSMETIC SK     ,NY,10022-2614,Proprietary  ,1,28,29,11,79,90
03443300,NEW YORK COLLEGE OF TRADITIONAL CHINESE ,NY,11501-0000,Private      ,0,15,15,1,81,82
03496300,YESHIVA SHAAREI TORAH OF ROCKLAND       ,NY,10901-4003,Private      ,4,9,13,4,9,13
03537300,NEW YORK AUTOMOTIVE & DIESEL INSTIT     ,NY,11101-0000,Proprietary  ,51,98,149,179,429,608
03568300,LEON STUDIO ONE SCHOOL OF HAIR DESI     ,NY,14221-5323,Proprietary  ,7,23,30,33,80,113
03651300,SAINT JOSEPH'S MEDICAL CENTER SCHOO     ,NY,10701-4080,Private      ,0,4,4,3,24,27
03652300,METROPOLITAN LEARNING INSTITUTE         ,NY,11375-0000,Private      ,7,154,161,35,709,744
03691300,USA BEAUTY SCHOOL INTERNATIONAL         ,NY,10013-3530,Proprietary  ,3,54,57,22,247,269
03713300,BEIS MEDRASH HEICHAL DOVID              ,NY,11691-4433,Private      ,17,1,18,24,1,25
03773300,CENTER FOR NATURAL WELLNESS SCHOOL OF MA,NY,12205-1601,Proprietary  ,2,25,27,27,124,151
03802300,UTA MESIVTA OF KIRYAS JOEL              ,NY,10950-2169,Private      ,311,44,355,312,153,465
03809400,MICROPOWER CAREER INSTITUTE             ,NY,10001-2812,Proprietary  ,22,203,225,44,449,493
03819400,HUDSON VALLEY SCHOOL OF ADVANCED AESTHET,NY,12493-0000,Proprietary  ,2,9,11,6,25,31
03839300,AVEDA INSTITUTE NEW YORK                ,NY,10013-1522,Proprietary  ,16,52,68,97,231,328
03881300,UNION GRADUATE COLLEGE                  ,NY,12308-3103,Private      ,0,18,18,18,226,244
03903400,AMERICAN BEAUTY SCHOOL                  ,NY,10462-8003,Proprietary  ,27,88,115,85,307,392
03941400,ELITE ACADEMY OF BEAUTY ARTS            ,NY,11223-1630,Proprietary  ,7,19,26,17,92,109
03983300,"SCHOOL OF PROFESSIONAL HORTICULTURE, AT ",NY,10458-5126,Private      ,1,14,15,1,18,19
04043300,ACE COMPUTER TRAINING CENTER            ,NY,11375-5337,Proprietary  ,1,31,32,7,70,77
04092401,MAKE-UP DESIGNORY -                     ,NY,10012-0041,Proprietary  ,24,41,65,46,74,120
04095300,KING'S COLLEGE (THE)                    ,NY,10018-0110,Private      ,13,2,15,412,31,443
04102300,NEW AGE TRAINING                        ,NY,10018-0000,Proprietary  ,0,6,6,0,14,14
04115500,TALMUDICAL SEMINARY OF BOBOV            ,NY,11219-3826,Private      ,15,30,45,15,30,45
04117700,"MONROE 2-ORLEANS BOCES, CENTER FOR WORK ",NY,14624-1119,Public       ,3,38,41,21,83,104
04123200,INSTITUTE OF ALLIED MEDICAL PROFESSIONS ,NY,11373-5541,Private      ,15,123,138,104,615,719
04123300,HUDSON VALLEY SCHOOL OF MASSAGE THERAPY ,NY,12493-0000,Proprietary  ,0,15,15,16,52,68
04125600,CAREER SCHOOL OF NY                     ,NY,10301-2416,Private      ,15,22,37,62,70,132
04134000,"JOHN PAUL'S HAIR, NAIL & SKIN CARE INSTI",NY,12020-1245,Proprietary  ,4,34,38,16,79,95
04137700,ANN MARIE'S WORLD OF BEAUTY SCHOOL      ,NY,13901-2308,Proprietary  ,4,7,11,10,34,44
04138100,YESHIVA OF MACHZIKAI HADAS              ,NY,11219-1408,Private      ,0,34,34,0,34,34
04144300,INSTITUTE OF CULINARY EDUCATION         ,NY,10010-5205,Proprietary  ,58,228,286,58,228,286
04148000,NEW LIFE BUSINESS INSTITUTE             ,NY,11432-6149,Proprietary  ,0,12,12,0,12,12
00267808,BRYANT & STRATTON COLLEGE - PARMA       ,OH,44130-0000,Proprietary  ,78,379,457,644,3297,3941
00301000,ANTIOCH UNIVERSITY                      ,OH,45387-1608,Private      ,4,50,54,35,1000,1035
00301100,ART ACADEMY OF CINCINNATI               ,OH,45202-7106,Private      ,6,6,12,300,89,389
00301200,ASHLAND UNIVERSITY                      ,OH,44805-3799,Private      ,39,354,393,3631,3223,6854
00301300,ATHENAEUM OF OHIO                       ,OH,45230-2000,Private      ,0,1,1,0,12,12
00301400,BALDWIN-WALLACE COLLEGE                 ,OH,44017-2088,Private      ,55,133,188,4643,1578,6221
00301600,BLUFFTON UNIVERSITY                     ,OH,45817-2104,Private      ,16,35,51,1550,379,1929
00301800,BOWLING GREEN STATE UNIVERSITY          ,OH,43403-0001,Public       ,327,491,818,17138,6435,23573
00302300,CAPITAL UNIVERSITY                      ,OH,43209-2394,Private      ,59,164,223,3924,2749,6673
00302400,CASE WESTERN RESERVE UNIV               ,OH,44106-0000,Private      ,57,80,137,6315,1111,7426
00302401,CASE WESTERN RESERVE UNIV - MED         ,OH,44106-0000,Private      ,1,4,5,37,1091,1128
00302402,CASE WESTERN RESERVE UNIV - DENTAL      ,OH,44106-0000,Private      ,1,1,2,13,287,300
00302403,CASE WESTERN RESERVE UNIV - LAW         ,OH,44106-0000,Private      ,1,9,10,14,1392,1406
00302404,CASE WESTERN RESERVE UNIV - UG          ,OH,44106-0000,Private      ,3,5,8,457,58,515
00302405,CASE WESTERN RESERVE UNIV - MSASS       ,OH,44106-0000,Private      ,0,11,11,12,428,440
00302406,CASE WESTERN RESERVE UNIV - NURS UG     ,OH,44106-0000,Private      ,2,14,16,188,134,322
00302407,CASE WESTERN RESERVE UNIV - WSOM        ,OH,44106-0000,Private      ,0,19,19,11,303,314
00302408,CASE WESTERN RESERVE UNIV -A&S GRAD     ,OH,44106-0000,Private      ,0,12,12,3,353,356
00302409,CASE WESTERN RESERVE UNIV -ENG GRAD     ,OH,44106-0000,Private      ,0,7,7,14,103,117
00302410,CASE WESTERN RESERVE UNIV -NURS GRD     ,OH,44106-0000,Private      ,1,16,17,6,329,335
00302500,CEDARVILLE UNIVERSITY                   ,OH,45314-8564,Private      ,48,12,60,3723,210,3933
00302600,CENTRAL STATE UNIVERSITY                ,OH,45384-1004,Public       ,86,112,198,3709,1607,5316
00302900,CINCINNATI CHRISTIAN UNIVERSITY         ,OH,45204-3200,Private      ,26,51,77,531,610,1141
00303000,OHIO CHRISTIAN UNIVERSITY               ,OH,43113-9487,Private      ,30,174,204,423,1142,1565
00303100,CLEVELAND INSTITUTE OF MUSIC            ,OH,44106-1776,Private      ,3,4,7,419,368,787
00303200,CLEVELAND STATE UNIVERSITY              ,OH,44115-2214,Public       ,263,1207,1470,7870,14210,22080
00303300,COLLEGE OF MT ST JOSEPH                 ,OH,45233-1670,Private      ,25,96,121,1734,1229,2963
00303500,OHIO DOMINICAN UNIVERSITY               ,OH,43219-2099,Private      ,40,250,290,2298,2573,4871
00303600,FRANCISCAN UNIV OF STEUBENVILLE         ,OH,43952-1763,Private      ,40,36,76,2252,662,2914
00303700,COLLEGE OF WOOSTER                      ,OH,44691-2363,Private      ,13,9,22,3012,99,3111
00303900,COLUMBUS COLLEGE OF ART AND DESIGN      ,OH,43215-1758,Private      ,34,39,73,1732,419,2151
00304000,CUYAHOGA COMMUNITY COLLEGE              ,OH,44115-2878,Public       ,804,3338,4142,7424,21418,28842
00304001,CUYAHOGA COMMUNITY CLG-EASTERN CAM      ,OH,44122-6195,Public       ,47,117,164,566,1126,1692
00304002,CUYAHOGA COMMUNITY CLG-METRO CAMPUS     ,OH,44115-0000,Public       ,70,246,316,913,2296,3209
00304003,CUYAHOGA COMMUNITY CLG-WESTERN CMPS     ,OH,44130-0000,Public       ,111,200,311,1638,1770,3408
00304100,"DEFIANCE COLLEGE, THE                   ",OH,43512-1695,Private      ,12,44,56,1324,483,1807
00304200,DENISON UNIVERSITY                      ,OH,43023-1329,Private      ,17,5,22,2879,76,2955
00304300,CHANCELLOR UNIVERSITY                   ,OH,44114-1096,Proprietary  ,3,134,137,35,828,863
00304400,TRINITY LUTHERAN SEMINARY               ,OH,43209-0000,Private      ,0,3,3,1,154,155
00304500,UNIVERSITY OF FINDLAY                   ,OH,45840-3695,Private      ,46,125,171,3258,1627,4885
00304600,FRANKLIN UNIVERSITY                     ,OH,43215-5399,Private      ,68,881,949,984,9218,10202
00304700,HEBREW UNION COLLEGE MAIN CAMPUS        ,OH,45220-0000,Private      ,0,2,2,1,91,92
00304800,HEIDELBERG UNIVERSITY                   ,OH,44883-2462,Private      ,12,25,37,2073,373,2446
00304900,HIRAM COLLEGE                           ,OH,44234-1808,Private      ,10,36,46,1673,390,2063
00305000,JOHN CARROLL UNIVERSITY                 ,OH,44118-4581,Private      ,41,67,108,4290,995,5285
00305100,KENT STATE UNIV - KENT CAMPUS           ,OH,44242-0001,Public       ,394,750,1144,20596,10765,31361
00305101,KENT STATE UNIV - GEAUGA CAMPUS         ,OH,44021-0000,Public       ,29,66,95,362,590,952
00305102,KENT STATE UNIV - STARK CAMPUS          ,OH,44720-0000,Public       ,98,236,334,2348,2446,4794
00305103,KENT STATE UNIV - TUSCARAWAS CAMPUS     ,OH,44663-0000,Public       ,45,171,216,946,1525,2471
00305104,KENT STATE UNIV - TRUMBULL CAMPUS       ,OH,44483-0000,Public       ,46,201,247,878,1798,2676
00305105,KENT STATE UNIV - ASHTABULA CAMPUS      ,OH,44004-0000,Public       ,45,214,259,809,1754,2563
00305106,KENT STATE UNIV -E.LIVERPOOL CAMPUS     ,OH,43920-0000,Public       ,13,87,100,350,797,1147
00305107,KENT STATE UNIV - SALEM CAMPUS          ,OH,44460-0000,Public       ,33,127,160,710,1113,1823
00306500,KENYON COLLEGE                          ,OH,43022-9623,Private      ,27,0,27,2580,41,2621
00306600,LAKE ERIE COLLEGE                       ,OH,44077-3389,Private      ,24,40,64,1430,441,1871
00306800,LORAIN COUNTY COMMUNITY COLLEGE         ,OH,44035-1691,Public       ,241,1163,1404,3747,8253,12000
00306900,LOURDES COLLEGE                         ,OH,43560-2898,Private      ,30,197,227,708,2017,2725
00307200,MALONE UNIVERSITY                       ,OH,44709-3897,Private      ,37,142,179,2196,1391,3587
00307300,MARIETTA COLLEGE                        ,OH,45750-4033,Private      ,20,13,33,2403,278,2681
00307500,METHODIST THEOLOGICAL SCH IN OHIO       ,OH,43015-0000,Private      ,0,15,15,0,239,239
00307600,MIAMI-JACOBS COLLEGE                    ,OH,45401-0000,Proprietary  ,30,239,269,211,1586,1797
00307602,MIAMI - JACOBS CAREER COLLEGE - SPRINGBO,OH,45066-1115,Proprietary  ,30,143,173,144,679,823
00307603,MIAMI - JACOBS CAREER COLLEGE - TROY    ,OH,45373-3837,Proprietary  ,40,158,198,198,869,1067
00307700,MIAMI UNIVERSITY                        ,OH,45056-1831,Public       ,280,465,745,18744,5534,24278
00307800,WRIGHT STATE UNIVERSITY                 ,OH,45435-0002,Public       ,309,706,1015,12910,10178,23088
00308300,MOUNT UNION COLLEGE                     ,OH,44601-3993,Private      ,37,23,60,3300,257,3557
00308400,MUSKINGUM UNIVERSITY                    ,OH,43762-1199,Private      ,19,61,80,2251,671,2922
00308500,NOTRE DAME COLLEGE OF OHIO              ,OH,44121-4293,Private      ,24,138,162,1602,1360,2962
00308600,OBERLIN COLLEGE                         ,OH,44074-1090,Private      ,46,7,53,4869,157,5026
00308800,OHIO COLLEGE OF PODIATRIC MEDICINE      ,OH,44131-7304,Private      ,0,2,2,0,462,462
00308900,OHIO NORTHERN UNIVERSITY                ,OH,45810-1555,Private      ,29,28,57,4018,1164,5182
00309000,OHIO STATE UNIVERSITY-ALL CAMPUSES      ,OH,43210-1358,Public       ,821,1248,2069,44767,24704,69471
00310000,OHIO UNIVERSITY                         ,OH,45701-2979,Public       ,253,579,832,19851,6297,26148
00310002,"OHIO UNIVERSITY, ZANESVILLE CAMPUS      ",OH,43701-0000,Public       ,28,117,145,1055,1375,2430
00310003,"OHIO UNIVERSITY, LANCASTER CAMPUS       ",OH,43130-0000,Public       ,53,177,230,1153,1524,2677
00310004,"OHIO UNIVERSITY, SOUTHERN CAMPUS        ",OH,45638-0000,Public       ,38,165,203,834,1680,2514
00310005,"OHIO UNIVERSITY, CHILLICOTHE CAMPUS     ",OH,45601-0000,Public       ,65,271,336,984,2101,3085
00310006,"OHIO UNIVERSITY, EASTERN CAMPUS         ",OH,43950-0000,Public       ,8,27,35,503,285,788
00310008,OHIO UNIV COLL OF OSTEOPATHIC MED       ,OH,45701-0000,Public       ,1,2,3,10,486,496
00310900,OHIO WESLEYAN UNIVERSITY                ,OH,43015-2398,Private      ,21,14,35,2848,145,2993
00311000,OTTERBEIN COLLEGE                       ,OH,43081-2006,Private      ,54,79,133,4024,1034,5058
00311300,PONTIFICAL COLLEGE JOSEPHINUM           ,OH,43235-1498,Private      ,0,3,3,17,24,41
00311401,FIRELANDS REGIONAL MEDICAL CENTER       ,OH,44870-4788,Private      ,1,13,14,49,152,201
00311500,RABBINICAL COLLEGE OF TELSHE            ,OH,44092-2584,Private      ,0,0,0,0,2,2
00311600,UNIV OF RIO GRANDE                      ,OH,45674-3131,Private      ,58,202,260,944,1232,2176
00311601,UNIVERSITY OF RIO GRANDE                ,OH,45674-9989,Private      ,0,0,0,642,531,1173
00311602,UNIVERSITY OF RIO GRANDE - MEIGS CENTER ,OH,45760-0000,Private      ,0,0,0,3,16,19
00311603,UNIVERSITY OF RIO GRANDE - CHILLICOTHE G,OH,45601-0000,Private      ,0,0,0,2,11,13
00311604,UNIVERSITY OF RIO GRANDE - HAMILTON GRAD,OH,45011-2833,Private      ,1,0,1,3,4,7
00311605,UNIVERSITY OF RIO GRANDE - COLUMBUS GRAD,OH,43215-0000,Private      ,0,1,1,15,48,63
00311606,UNIVERSITY OF RIO GRANDE - PORTSMOUTH GR,OH,45662-0000,Private      ,0,0,0,6,10,16
00311607,UNIVERSITY OF RIO GRANDE -              ,OH,45764-0000,Private      ,0,0,0,16,26,42
00311900,SINCLAIR COMMUNITY COLLEGE              ,OH,45402-1460,Public       ,754,2677,3431,8049,18251,26300
00312100,TIFFIN UNIVERSITY                       ,OH,44883-2161,Private      ,72,408,480,2253,2662,4915
00312200,UNITED THEOLOGICAL SEMINARY             ,OH,45406-0000,Private      ,0,16,16,1,225,226
00312300,UNIVERSITY OF AKRON                     ,OH,44325-6211,Public       ,523,1236,1759,19022,14600,33622
00312500,UNIVERSITY OF CINCINNATI                ,OH,45221-0125,Public       ,659,1626,2285,23814,20063,43877
00312504,UNIVERSITY OF CINCINNATI - COLLEGE OF ME,OH,45267-0553,Public       ,35,85,120,185,1065,1250
00312700,UNIVERSITY OF DAYTON                    ,OH,45469-0002,Private      ,109,227,336,10594,3891,14485
00313100,UNIVERSITY OF TOLEDO                    ,OH,43606-3390,Public       ,420,686,1106,17621,9804,27425
00313101,UNIVERSITY OF TOLEDO - HEALTH SCIENCE CA,OH,43614-2598,Public       ,9,61,70,641,1682,2323
00313300,URBANA UNIVERSITY                       ,OH,43078-2091,Private      ,24,62,86,984,721,1705
00313400,URSULINE COLLEGE                        ,OH,44124-4398,Private      ,10,107,117,669,1313,1982
00313500,WALSH UNIVERSITY                        ,OH,44720-3396,Private      ,34,93,127,2449,1158,3607
00314100,WILBERFORCE UNIVERSITY                  ,OH,45384-1001,Private      ,20,40,60,1050,539,1589
00314200,WILMINGTON COLLEGE                      ,OH,45177-2499,Private      ,21,38,59,1900,580,2480
00314300,WITTENBERG UNIVERSITY                   ,OH,45501-2199,Private      ,22,20,42,2862,270,3132
00314400,XAVIER UNIVERSITY                       ,OH,45207-1035,Private      ,79,249,328,5845,3217,9062
00314500,YOUNGSTOWN STATE UNIVERSITY             ,OH,44555-0001,Public       ,271,831,1102,9304,8378,17682
00398200,CLEVELAND INSTITUTE OF ART              ,OH,44106-1700,Private      ,17,22,39,801,202,1003
00406000,WINEBRENNER THEOLOGICAL SEMINARY        ,OH,45840-0000,Private      ,0,7,7,2,61,63
00485200,CLARK STATE COMMUNITY COLLEGE           ,OH,45505-4795,Public       ,157,732,889,1616,4700,6316
00485300,BRADFORD SCHOOL                         ,OH,43219-0000,Proprietary  ,48,80,128,714,619,1333
00485500,DAVIS COLLEGE                           ,OH,43623-4307,Proprietary  ,12,77,89,145,787,932
00486100,UNIVERSITY OF NORTHWESTERN OHIO         ,OH,45805-1498,Private      ,135,223,358,4044,1758,5802
00486600,STAUTZENBERGER COLLEGE                  ,OH,43537-4007,Proprietary  ,52,203,255,457,1571,2028
00510200,SCH OF DIAGNOSTIC IMAGING-CLEVELAND     ,OH,44119-0000,Private      ,0,6,6,11,44,55
00512700,BROWN MACKIE COLLEGE-CINCINNATI         ,OH,45215-1107,Proprietary  ,266,1245,1511,1757,7918,9675
00512728,BROWN MACKIE COLLEGE-CINCINNATI - LANDMA,OH,45215-1231,Proprietary  ,5,21,26,40,155,195
00521000,CLEVELAND INSTITUTE OF ELECTRONICS      ,OH,44114-0000,Proprietary  ,5,80,85,20,351,371
00531300,NORTH CENTRAL STATE COLLEGE             ,OH,44901-0000,Public       ,103,397,500,1393,3211,4604
00575300,OWENS STATE COMMUNITY COLLEGE           ,OH,43699-0000,Public       ,522,1953,2475,6879,14377,21256
00648700,AULTMAN COLLEGE OF NURSING AND HEALTH SC,OH,44710-1799,Private      ,8,23,31,177,379,556
00649400,GOOD SAMARITAN COLG-NURSING/HEALTH      ,OH,45220-2489,Private      ,7,38,45,214,415,629
00649800,MERIDIA HURON SCHOOL OF NURSING         ,OH,44112-4308,Private      ,2,46,48,60,539,599
00650700,TRINIT HEALTH SYSTEM SCH OF NURSING     ,OH,43952-2667,Private      ,1,4,5,41,105,146
00680400,LAKELAND COMMUNITY COLLEGE              ,OH,44094-5198,Public       ,225,843,1068,3152,6312,9464
00686700,COLUMBUS STATE COMMUNITY COLLEGE        ,OH,43215-1786,Public       ,1059,3647,4706,12370,25553,37923
00703500,KETTERING COLLEGE OF MEDICAL ARTS       ,OH,45429-1299,Private      ,16,68,84,494,916,1410
00708500,MOUNT VERNON NAZARENE UNIVERSITY        ,OH,43050-9500,Private      ,14,39,53,1596,606,2202
00708501,MOUNT VERNON NAZARENE UNIV - AGS        ,OH,43050-0000,Private      ,4,92,96,51,947,998
00727500,EASTERN GATEWAY COMMUNITY COLLEGE       ,OH,43952-3598,Public       ,40,218,258,855,1509,2364
00747300,CHOFFIN CAREER & TECHNICAL CENTER       ,OH,44503-1628,Public       ,2,35,37,56,324,380
00759800,HOCKING TECHNICAL COLLEGE               ,OH,45764-9582,Public       ,219,546,765,3836,4234,8070
00777700,REMINGTON COLLEGE - CLEVELAND CAMPUS    ,OH,44125-1957,Proprietary  ,60,334,394,323,1637,1960
00777704,REMINGTON COLLEGE-CLEVELAND WEST CAMPUS ,OH,44070-3129,Proprietary  ,21,99,120,136,458,594
00812900,ADULT AND COMMUNITY EDUCATION @ HUDSON  ,OH,43211-2017,Public       ,4,60,64,43,399,442
00813200,TOLEDO SCHOOL OF PRACTICAL NURSING      ,OH,43613-5110,Public       ,7,65,72,98,511,609
00813300,ZANE STATE COLLEGE                      ,OH,43701-2626,Public       ,72,332,404,1113,2645,3758
00819400,AKRON SCHOOL OF PRACTICAL NRSG          ,OH,44311-0000,Public       ,2,13,15,56,162,218
00827800,TERRA COMMUNITY COLLEGE                 ,OH,43420-9670,Public       ,63,405,468,903,2419,3322
00867700,NORTHWEST STATE COMMUNITY COLLEGE       ,OH,43502-9542,Public       ,64,441,505,1141,2847,3988
00888600,PORTAGE LAKES CAREER CENTER             ,OH,44232-0000,Public       ,3,17,20,30,158,188
00908800,ITT TECHNICAL INSTITUTE                 ,OH,45414-3456,Proprietary  ,72,337,409,664,2126,2790
00915600,WAYNE COUNTY SCHOOLS CAREER CENTER      ,OH,44677-9672,Public       ,2,28,30,50,269,319
00917200,SPRINGFIELD REGIONAL SCHOOL OF NURSING  ,OH,45501-0000,Private      ,5,22,27,59,264,323
00941200,NATIONAL INSTITUTE OF TECHNOLOGY        ,OH,44221-2998,Proprietary  ,23,155,178,274,936,1210
00945101,BROWN MACKIE COLLEGE-NORTH CANTON       ,OH,44720-0000,Proprietary  ,4,34,38,93,397,490
00953000,GERBER AKRON BEAUTY SCHOOL              ,OH,44333-3714,Proprietary  ,1,13,14,19,79,98
00953100,SPA SCHOOL (THE)                        ,OH,43214-1524,Proprietary  ,5,28,33,43,155,198
00966000,TIFFIN ACADEMY OF HAIR DESIGN           ,OH,44883-2833,Proprietary  ,2,13,15,43,88,131
00983700,ITT TECHNICAL INSTITUTE                 ,OH,44509-4098,Proprietary  ,82,255,337,707,1873,2580
00994100,BELMONT TECHNICAL COLLEGE               ,OH,43950-9766,Public       ,44,233,277,1010,1894,2904
00994200,SHAWNEE STATE UNIVERSITY                ,OH,45662-4344,Public       ,104,247,351,3912,2401,6313
01001700,PAYNE THEOLOGICAL SEMINARY              ,OH,45384-0474,Private      ,0,15,15,1,136,137
01002700,JAMES A. RHODES STATE COLLEGE           ,OH,45804-3597,Public       ,100,408,508,1791,3723,5514
01016800,NATIONWIDE BEAUTY ACADEMY               ,OH,43228-1000,Proprietary  ,28,57,85,196,337,533
01028000,OHIO STATE BEAUTY ACADEMY               ,OH,45801-4950,Proprietary  ,20,37,57,63,108,171
01032300,HANNAH E MULLINS SCH-PRAC NRSG          ,OH,44460-2906,Public       ,1,19,20,24,103,127
01034500,CINCINNATI STATE TECH & COMM CLG        ,OH,45223-2690,Public       ,468,1437,1905,4953,10733,15686
01045300,WASHINGTON STATE CMTY COLLEGE           ,OH,45750-9225,Public       ,63,222,285,964,1730,2694
01063000,NORTHERN INSTITUTE OF COSMETOLOGY       ,OH,44052-1803,Proprietary  ,4,14,18,15,83,98
01073600,MARION TECHNICAL COLLEGE                ,OH,43302-5694,Public       ,37,292,329,806,2183,2989
01088000,CHATFIELD COLLEGE                       ,OH,45118-9705,Private      ,3,27,30,39,215,254
01088100,STARK STATE COLLEGE OF TECHNOLOGY       ,OH,44720-7299,Public       ,363,1683,2046,3742,10315,14057
01090600,CINCINNATI CLG OF MORTUARY SCIENCE      ,OH,45224-1428,Private      ,7,21,28,79,176,255
01092300,UNION INSTITUTE & UNIVERSITY            ,OH,45206-1925,Private      ,4,296,300,43,1900,1943
01096200,MOORE UNIV OF HAIR DESIGN               ,OH,45213-0000,Proprietary  ,0,0,0,4,18,22
01099300,HOBART INSTITUTE OF WELDING TECHNOLOGY  ,OH,45373-2400,Private      ,15,48,63,216,243,459
01100500,KAPLAN COLLEGE                          ,OH,43232-4827,Proprietary  ,27,194,221,170,1038,1208
01104600,CENTRAL OHIO TECHNICAL COLLEGE          ,OH,43055-1767,Public       ,97,548,645,1673,4966,6639
01170300,PENTA COUNTY JOINT VOCATIONAL SCH       ,OH,43551-0000,Public       ,2,15,17,26,143,169
01174400,NATIONAL BEAUTY COLLEGE                 ,OH,44720-0000,Proprietary  ,7,23,30,51,138,189
01174500,OHIO TECHNICAL COLLEGE                  ,OH,44103-1228,Proprietary  ,47,117,164,1302,669,1971
01182500,OHIO STATE SCHOOL OF COSMETOLOGY        ,OH,43224-1107,Proprietary  ,3,26,29,44,156,200
01212800,SOUTHWESTERN COLLEGE                    ,OH,45402-3003,Proprietary  ,52,248,300,376,2256,2632
01212802,SOUTHWESTERN COLLEGE                    ,OH,45005-2267,Proprietary  ,14,84,98,80,542,622
01212803,SOUTHWESTERN COLLEGE                    ,OH,45202-4304,Proprietary  ,54,219,273,228,1427,1655
01212804,SOUTHWESTERN COLLEGE                    ,OH,45246-3121,Proprietary  ,59,300,359,320,1995,2315
01212806,SOUTHWESTERN COLLEGE - TOLEDO           ,OH,43615-6800,Proprietary  ,45,166,211,54,266,320
01216600,CAROUSEL BEAUTY COLLEGE                 ,OH,45402-8935,Proprietary  ,14,27,41,71,195,266
01224800,CENTRAL SCHOOL OF PRACTICAL NURSING     ,OH,44103-4371,Private      ,7,48,55,70,391,461
01267200,CAROUSEL BEAUTY COLLEGE                 ,OH,45044-5113,Proprietary  ,1,6,7,10,40,50
01267400,CAROUSEL OF MIAMI VALLEY BEAUTY CLG     ,OH,45424-2063,Proprietary  ,0,4,4,5,10,15
01275000,EDISON COMMUNITY COLLEGE                ,OH,45356-9239,Public       ,81,370,451,1079,2636,3715
01283800,LAURA AND ALVIN SIEGAL COLLEGE OF JUDAIC,OH,44122-7197,Private      ,0,0,0,2,4,6
01284800,MOLER-HOLLYWOOD BEAUTY COLLEGE          ,OH,45202-2577,Proprietary  ,6,31,37,17,118,135
01287000,SOUTHERN STATE COMMUNITY COLLEGE        ,OH,45133-9406,Public       ,96,425,521,1107,3018,4125
01289100,ANTONELLI COLLEGE                       ,OH,45202-2592,Proprietary  ,23,71,94,213,523,736
01289600,VIRGINIA MARTI COLLEGE OF ART AND DESIGN,OH,44107-0778,Proprietary  ,11,30,41,209,222,431
01313200,INTERNATIONAL CLG OF BROADCASTING       ,OH,45431-1898,Proprietary  ,5,23,28,56,145,201
02052000,OHIO INST OF PHOTOGRAPHY & TECHNOLOGY   ,OH,45439-1984,Proprietary  ,21,141,162,296,1102,1398
02054300,TRUMBULL BUSINESS COLLEGE               ,OH,44484-0000,Proprietary  ,15,95,110,97,594,691
02056800,DAYMAR COLLEGE                          ,OH,45601-1038,Proprietary  ,14,112,126,93,955,1048
02056802,DAYMAR COLLEGE - LANCASTER              ,OH,43130-0000,Proprietary  ,5,21,26,6,57,63
02056803,DAYMAR COLLEGE - NEW BOSTON             ,OH,45662-4900,Proprietary  ,0,1,1,4,18,22
02056804,DAYMAR COLLEGE - JACKSON                ,OH,45640-1728,Proprietary  ,1,4,5,4,41,45
02066100,OHIO STATE COLLEGE/BARBER STYLING       ,OH,43213-0000,Proprietary  ,14,66,80,67,260,327
02069500,AKRON INSTITUTE                         ,OH,44306-0000,Proprietary  ,38,225,263,278,1477,1755
02073300,GALLIA-JACKSON-VINTON SCH ADULT ED      ,OH,45674-0000,Public       ,2,19,21,47,253,300
02110700,CLEVELAND INST OF DENTAL-MED ASST       ,OH,44115-2285,Proprietary  ,33,154,187,165,698,863
02116009,SANFORD-BROWN COLLEGE - MIDDLEBURG HEIGH,OH,44130-8362,Proprietary  ,52,266,318,336,1726,2062
02116900,UPPER VALLEY JVS                        ,OH,45356-0000,Public       ,8,53,61,39,375,414
02117300,GREAT OAKS INSTITUTE OF TECHNOLOGY      ,OH,45241-1581,Public       ,9,95,104,157,920,1077
02128600,THE ART INSTITUTE OF CINCINNATI         ,OH,45246-0000,Proprietary  ,15,18,33,308,175,483
02140700,COMMUNITY EDUCATIONAL SERVICES          ,OH,44702-1710,Public       ,0,19,19,29,260,289
02152100,ACADEMY OF COURT REPORTING AND TECHNOLOG,OH,44115-0000,Proprietary  ,10,70,80,61,481,542
02152101,ACADEMY OF COURT REPORTING & TECHNOLOGY ,OH,43215-3902,Proprietary  ,7,83,90,58,610,668
02152102,ACADEMY OF COURT REPORTING - MIAMI-JACOB,OH,44313-3607,Proprietary  ,0,4,4,9,143,152
02152104,ACADEMY OF COURT REPORTING AND TECHNOLOG,OH,45202-2123,Proprietary  ,0,3,3,14,199,213
02152106,ACADEMY OF COURT REPORTING AND TECHNOLOG,OH,45241-5428,Proprietary  ,8,81,89,9,91,100
02158500,OHIO BUSINESS COLLEGE                   ,OH,44055-3344,Proprietary  ,25,100,125,125,791,916
02158501,OHIO BUSINESS COLLEGE                   ,OH,44870-9953,Proprietary  ,6,64,70,81,594,675
02168100,TRI-COUNTY JOINT VOCATIONAL SCHOOL      ,OH,45764-0000,Public       ,1,6,7,32,117,149
02187900,ASHTABULA CO JOINT VOC SCH ADULT ED     ,OH,44047-0000,Public       ,3,18,21,31,258,289
02189000,ADULT CENTER FOR EDUCATION              ,OH,43701-0000,Public       ,4,56,60,57,382,439
02190700,RETS TECH CENTER                        ,OH,45459-0000,Proprietary  ,64,427,491,430,2850,3280
02192100,BUTLER TECHNOLOGY AND CAREER DEVELOPMENT,OH,45011-0000,Public       ,24,118,142,183,741,924
02196300,COLLINS CAREER CENTER                   ,OH,45619-0000,Public       ,21,50,71,214,626,840
02210800,MEDINA COUNTY CAREER CENTER             ,OH,44256-0000,Public       ,1,19,20,28,188,216
02215400,OHIO STATE SCHOOL OF COSMETOLOGY        ,OH,43207-0000,Proprietary  ,6,15,21,52,145,197
02220500,GOD'S BIBLE SCHOOL & COLLEGE            ,OH,45210-0000,Private      ,9,9,18,191,68,259
02220800,CAREER & TECHNOLOGY EDUCATION CENTERS OF,OH,43055-0000,Public       ,5,42,47,36,212,248
02239800,PIONEER CAREER & TECHNOLOGY CENTER      ,OH,44875-0000,Public       ,1,11,12,9,67,76
02245600,WARREN COUNTY CAREER CENTER             ,OH,45036-0000,Public       ,11,47,58,39,228,267
02246300,INSTITUTE OF MEDICAL-DENTAL TECH        ,OH,45246-3317,Proprietary  ,8,61,69,49,263,312
02263700,MIAMI VALLEY CAREER TECHNOLOGY CTR      ,OH,45315-0000,Public       ,13,62,75,85,487,572
02269400,EASTERN HILLS ACAD OF HAIR DESIGN       ,OH,45255-0000,Proprietary  ,8,16,24,23,109,132
02269500,WESTERN HILLS SCHOOL OF BEAUTY & HAIR DE,OH,45211-0000,Proprietary  ,16,61,77,54,293,347
02270100,OHIO HI-POINT CAREER CENTER             ,OH,43311-0000,Public       ,4,68,72,27,429,456
02272700,COLUMBIANA COUNTY CAREER CENTER         ,OH,44432-0000,Public       ,2,55,57,35,296,331
02287900,RAPHAEL'S SCHOOL OF BEAUTY CULTURE      ,OH,44446-0000,Proprietary  ,14,44,58,59,168,227
02289802,KAPLAN COLLEGE                          ,OH,45203-0000,Proprietary  ,37,236,273,147,1081,1228
02301400,OHIO VALLEY COLLEGE OF TECHNOLOGY       ,OH,43920-0000,Proprietary  ,8,23,31,98,219,317
02303600,BOHECKER'S BUSINESS COLLEGE             ,OH,44266-0000,Proprietary  ,18,114,132,179,818,997
02304700,TRI-RIVERS CAREER CENTER                ,OH,43302-0000,Public       ,2,38,40,37,257,294
02311200,AMERICAN SCHOOL OF TECHNOLOGY           ,OH,43229-0000,Proprietary  ,13,166,179,50,596,646
02315500,TOLEDO ACADEMY OF BEAUTY CULTURE - EAST ,OH,43616-0000,Proprietary  ,4,13,17,40,135,175
02328500,MOLER-PICKENS BEAUTY COLLEGE            ,OH,45014-0000,Proprietary  ,3,13,16,13,66,79
02334300,INTERNATIONAL ACAD OF HAIR DESIGN       ,OH,45239-0000,Proprietary  ,6,14,20,52,96,148
02336300,KNOX COUNTY CAREER CENTER               ,OH,43050-4298,Public       ,2,14,16,29,245,274
02336700,CUYAHOGA VALLEY CAREER CENTER           ,OH,44141-1296,Public       ,3,13,16,56,256,312
02337700,PROFESSIONAL SKILLS INSTITUTE           ,OH,43607-0000,Proprietary  ,7,68,75,129,857,986
02351500,WILLOUGHBY EASTLAKE SCH OF PRAC NSG     ,OH,44094-0000,Public       ,7,25,32,20,133,153
02352800,POLARIS CAREER CENTER-ADULT ED DEPT     ,OH,44130-0000,Public       ,5,55,60,67,328,395
02354200,SCIOTO COUNTY JOINT VOCATIONAL SCH      ,OH,45648-0000,Public       ,6,34,40,65,313,378
02454400,NORTHEASTERN OHIO UNIVS COL OF MED      ,OH,44272-0000,Public       ,1,7,8,77,751,828
02497800,GREENE COUNTY CAREER CENTER             ,OH,45385-0000,Public       ,2,39,41,28,212,240
02512600,ADULT VOCATIONAL SERVICES               ,OH,44308-0000,Public       ,0,3,3,2,32,34
02519300,OHIO STATE SCH COSMETOLOGY              ,OH,43068-0000,Proprietary  ,2,7,9,5,25,30
02522700,EASTLAND-FAIRFIELD CAREER AND TECHNICAL ,OH,43125-0000,Public       ,3,46,49,48,345,393
02528300,TDDS TECHNICAL INSTITUTE                ,OH,44429-0000,Proprietary  ,19,143,162,67,558,625
02529500,HAMRICK SCHOOL                          ,OH,44256-0000,Proprietary  ,10,48,58,26,171,197
02541400,TOLEDO ACADEMY OF BEAUTY CULTURE-SO     ,OH,43614-0000,Proprietary  ,2,19,21,54,194,248
02545800,INNER STATE BEAUTY SCHOOLS              ,OH,44124-0000,Proprietary  ,12,40,52,65,256,321
02553000,SCHOOL OF ADVERTISING ART               ,OH,45440-0000,Proprietary  ,4,0,4,209,33,242
02560000,CASAL AVEDA INSTITUTE                   ,OH,44515-0000,Proprietary  ,19,15,34,100,111,211
02560700,PICKAWAY ROSS CO JOINT VOC TECH SCH     ,OH,45601-0000,Public       ,3,36,39,63,354,417
02560701,PICKAWAY ROSS COUNTY JOINT VOCATIONAL SC,OH,45601-9010,Public       ,1,6,7,9,60,69
02562300,APOLLO CAREER CENTER-ADULT EDUC         ,OH,45806-0000,Public       ,14,95,109,78,697,775
02563000,RAPHAELS SCHOOL OF BEAUTY CULTURE       ,OH,44601-2847,Proprietary  ,8,23,31,50,120,170
02568600,MAHONING COUNTY CAREER & TECH CENTR     ,OH,44406-0000,Public       ,1,11,12,19,106,125
02582900,KAPLAN CAREER INSTITUTE                 ,OH,44129-6810,Proprietary  ,32,198,230,222,1064,1286
02586400,TRUMBULL CAREER & TECH CENTER-ADULT     ,OH,44483-1997,Public       ,14,84,98,57,441,498
02588500,OHIO STATE SCHOOL OF COSMETOLOGY        ,OH,43081-0000,Proprietary  ,13,12,25,74,99,173
02599711,VATTEROTT COLLEGE - CLEVELAND           ,OH,44147-3502,Proprietary  ,11,134,145,54,603,657
02603800,LORAIN COUNTY JVS ADULT CAREER CTR      ,OH,44074-9799,Public       ,5,72,77,51,376,427
02616200,BROWN MACKIE COLLEGE-FINDLAY            ,OH,45840-6848,Proprietary  ,132,646,778,781,3952,4733
02620000,SANDUSKY CAREER CENTER                  ,OH,44870-4786,Public       ,1,30,31,27,237,264
03007900,GALLIPOLIS CAREER COLLEGE               ,OH,45631-2600,Proprietary  ,6,26,32,35,255,290
03009702,"HARRISON COLLEGE - MUNCIE - COLUMBUS, OH",OH,43123-0000,Proprietary  ,3,26,29,8,60,68
03015100,ALLIANCE HIGH SCH-CMTY SERVICES DIV     ,OH,44601-2899,Public       ,4,35,39,26,199,225
03015300,EHOVE CAREER CENTER                     ,OH,44846-9500,Public       ,10,50,60,89,492,581
03023700,MADISON ADULT CAREER CENTER             ,OH,44905-2718,Public       ,9,28,37,30,221,251
03024300,VALLEY BEAUTY SCHOOL                    ,OH,43725-2332,Proprietary  ,9,13,22,34,96,130
03027100,FAIRVIEW ACADEMY                        ,OH,44126-2214,Proprietary  ,1,13,14,15,57,72
03034200,WASHINGTON COUNTY CAREER CENTER ADULT TE,OH,45750-9290,Public       ,7,70,77,47,352,399
03051400,AUBURN CAREER CENTER                    ,OH,44077-9723,Public       ,4,21,25,48,214,262
03051500,US GRANT JOINT VOCATIONAL SCHOOL        ,OH,45106-9502,Public       ,0,0,0,2,31,33
03065800,OHIO INSTITUTE OF HEALTH CAREERS        ,OH,44035-2394,Proprietary  ,6,21,27,63,266,329
03065900,BUCKEYE CAREER CENTER                   ,OH,44663-9437,Public       ,0,8,8,74,337,411
03067600,RAPHAEL'S SCHOOL OF BEAUTY CULTURE      ,OH,44512-2222,Proprietary  ,3,9,12,15,56,71
03068200,OHIO CENTER FOR BROADCASTING            ,OH,44125-4220,Proprietary  ,18,67,85,119,384,503
03068202,OHIO CENTER FOR BROADCASTING - COLUMBUS ,OH,43213-2571,Proprietary  ,7,40,47,46,188,234
03071900,MOUNT CARMEL COLLEGE OF NURSING         ,OH,43222-1598,Private      ,16,66,82,653,762,1415
03072303,EVEREST INSTITUTE - COLUMBUS            ,OH,43230-6653,Proprietary  ,35,269,304,155,1080,1235
03078000,OHIO CENTER FOR BROADCASTING            ,OH,45227-1509,Proprietary  ,2,24,26,43,143,186
03079000,ETI TECHNICAL COLLEGE                   ,OH,44446-4398,Proprietary  ,7,53,60,103,450,553
03084800,DELAWARE AREA CAREER CENTER             ,OH,43015-8969,Public       ,2,8,10,6,36,42
03084801,DELAWARE AREA CAREER CENTER -           ,OH,43015-9001,Public       ,1,5,6,6,19,25
03095600,VANTAGE CAREER CENTER                   ,OH,45891-1378,Public       ,2,23,25,22,178,200
03097000,MERCY COLLEGE OF NORTHWEST OHIO         ,OH,43604-1132,Private      ,23,105,128,545,983,1528
03100100,PARAMOUNT BEAUTY ACADEMY                ,OH,45662-4136,Proprietary  ,2,16,18,29,91,120
03105400,CLEVELAND EXTENSION HIGH SCH-WEST       ,OH,44102-2298,Public       ,5,29,34,25,168,193
03116200,DAYTON BARBER COLLEGE                   ,OH,45402-2310,Proprietary  ,1,11,12,29,119,148
03116300,OHIO COLLEGE OF MASSOTHERAPY            ,OH,44321-1363,Private      ,6,35,41,50,182,232
03116400,VANGUARD-SENTINELL VOC SCH DISTRICT     ,OH,43420-1197,Public       ,1,7,8,4,60,64
03117000,ASHLAND COUNTY-W HOLMES CAREER CTR      ,OH,44805-0000,Public       ,2,21,23,20,207,227
03319300,CREATIVE IMAGES-A CERTIFIED MATRIX      ,OH,45414-2557,Proprietary  ,5,19,24,72,209,281
03319301,CREATIVE IMAGES-A CERTIFIED MATRIX      ,OH,45459-0000,Proprietary  ,3,10,13,53,130,183
03416400,VALLEY BEAUTY SCHOOL                    ,OH,43701-3624,Proprietary  ,3,10,13,9,60,69
03425300,ROSEDALE BIBLE COLLEGE                  ,OH,43029-9517,Private      ,7,4,11,62,9,71
03457300,ALLEGHENY WESLEYAN COLLEGE              ,OH,44460-9598,Private      ,2,1,3,43,16,59
03468400,NATIONAL INSTITUTE OF MASSOTHERAPY      ,OH,44319-2100,Proprietary  ,0,12,12,29,95,124
03468500,ATS INSTITUTE OF TECHNOLOGY             ,OH,44143-2216,Proprietary  ,5,98,103,54,723,777
03475400,TRI-STATE BIBLE COLLEGE                 ,OH,45680-8402,Private      ,0,6,6,6,37,43
03534400,AMERICAN INST OF ALTERNATIVE MEDICI     ,OH,43229-1113,Proprietary  ,4,34,38,43,222,265
03578300,TRI-STATE COLLEGE                       ,OH,44452-8535,Proprietary  ,0,6,6,21,61,82
03586400,MED CENTRAL COLLEGE OF NURSING          ,OH,44903-2265,Private      ,9,11,20,371,267,638
03626300,BROWN AVEDA INSTITUTE                   ,OH,44060-6212,Proprietary  ,18,52,70,171,242,413
03693300,CARNEGIE INST OF INTEGRATIVE MED/MASSOTH,OH,44260-9608,Private      ,1,16,17,13,132,145
03700300,REGENCY BEAUTY INSTITUTE - CLEVELAND    ,OH,44094-0000,Proprietary  ,18,51,69,111,312,423
03726300,TEMPLE BAPTIST COLLEGE                  ,OH,45240-0000,Private      ,3,6,9,12,32,44
03747300,BEXLEY HALL SEMINARY                    ,OH,43209-2325,Private      ,0,1,1,0,15,15
03776400,HEALING ARTS INSTITUTE                  ,OH,43551-3138,Proprietary  ,0,10,10,22,58,80
03837300,AVEDA FREDRIC'S INSTITUTE               ,OH,45208-1304,Proprietary  ,14,12,26,107,90,197
03882300,OREGON CAREER CENTER                    ,OH,43616-2631,Public       ,2,22,24,12,128,140
04050400,DESIGNER'S BEAUTY ACADEMY               ,OH,43920-0000,Proprietary  ,2,12,14,13,50,63
04074300,HONDROS COLLEGE                         ,OH,43081-3855,Proprietary  ,28,187,215,232,1482,1714
04116700,NEWLIFE TECHNICAL INSTITUTE             ,OH,43920-2920,Private      ,0,2,2,9,28,37
04117300,DAYTON SCHOOL OF MEDICAL MASSAGE        ,OH,45429-1111,Proprietary  ,30,103,133,209,602,811
04118300,NORTHCOAST MEDICAL TRAINING ACADEMY     ,OH,44240-4174,Proprietary  ,8,51,59,85,311,396
04124500,TECHSKILLS                              ,OH,43231-0000,Proprietary  ,3,41,44,19,230,249
04125700,CUT BEAUTY SCHOOL (THE)                 ,OH,44118-2918,Proprietary  ,4,40,44,35,217,252
04126000,OHIO ACADEMY PAUL MITCHELL PARTNER SCHOO,OH,44087-3107,Proprietary  ,12,13,25,12,13,25
04137800,AVEDA INSTITUTE COLUMBUS                ,OH,43201-2333,Proprietary  ,14,34,48,162,195,357
04138000,INSTITUTE OF THERAPEUTIC MASSAGE        ,OH,45875-0350,Proprietary  ,2,24,26,16,72,88
04140100,CISORIA ACADEMY OF COSMETOLOGY          ,OH,44137-2915,Proprietary  ,4,24,28,7,43,50
04149100,CINCINNATI ACADEMY A PAUL MITCHELL PARTN,OH,45241-1702,Proprietary  ,28,23,51,102,102,204
04152600,PIKE COUNTY CAREER TECHNOLOGY CENTER    ,OH,45661-9114,Public       ,1,2,3,1,19,20
04153300,OHIO ACADEMY COLUMBUS (THE)             ,OH,43231-6038,Proprietary  ,11,20,31,11,20,31
04154000,TOLLES CAREER & TECHNICAL CENTER        ,OH,43064-8854,Public       ,0,0,0,0,1,1
        ,INVALID SCHOOL CODE                     ,  ,00000-0000,,304,1931,2235,4075,8823,12898
00134500,ADAMS STATE COLLEGE                     ,CO,81102-2373,Public       ,79,208,287,2251,1976,4227
00134600,ARAPAHOE COMMUNITY COLLEGE              ,CO,80160-9002,Public       ,225,743,968,1997,4685,6682
00134700,COLORADO COLLEGE                        ,CO,80903-3294,Private      ,52,42,94,2609,343,2952
00134800,COLORADO SCHOOL OF MINES                ,CO,80401-1887,Public       ,97,82,179,4465,947,5412
00134900,UNIVERSITY OF NORTHERN COLORADO         ,CO,80639-0001,Public       ,236,300,536,9428,4033,13461
00135000,COLORADO STATE UNIVERSITY               ,CO,80523-0100,Public       ,601,707,1308,19176,8876,28052
00135200,DENVER  SEMINARY                        ,CO,80120-2192,Private      ,0,60,60,0,616,616
00135300,FORT LEWIS COLLEGE                      ,CO,81301-3999,Public       ,144,104,248,3521,1305,4826
00135400,ILIFF SCHOOL OF THEOLOGY                ,CO,80210-0000,Private      ,1,15,16,1,221,222
00135500,LAMAR COMMUNITY COLLEGE                 ,CO,81052-3999,Public       ,18,45,63,358,428,786
00135800,MESA STATE COLLEGE                      ,CO,81501-7682,Public       ,229,445,674,4598,3116,7714
00135900,COLORADO NORTHWESTERN COMMUNITY COLLEGE ,CO,81648-3598,Public       ,34,59,93,354,380,734
00136000,METROPOLITAN STATE CLG OF DENVER        ,CO,80204-0000,Public       ,740,1815,2555,10493,14774,25267
00136100,NORTHEASTERN JUNIOR COLLEGE             ,CO,80751-2399,Public       ,43,60,103,1049,549,1598
00136200,OTERO JUNIOR COLLEGE                    ,CO,81050-3346,Public       ,34,104,138,545,785,1330
00136300,REGIS UNIVERSITY                        ,CO,80221-1099,Private      ,48,892,940,2242,8681,10923
00136500,COLORADO STATE UNIVERSITY-PUEBLO        ,CO,81001-4901,Public       ,122,298,420,4161,3175,7336
00136800,TRINIDAD STATE JR COLLEGE               ,CO,81082-2396,Public       ,36,194,230,629,1176,1805
00137000,UNIVERSITY OF COLORADO-BOULDER          ,CO,80309-0077,Public       ,537,466,1003,21569,9252,30821
00137100,UNIVERSITY OF DENVER                    ,CO,80208-2000,Private      ,138,515,653,6216,9526,15742
00137200,WESTERN STATE COLLEGE                   ,CO,81231-0000,Public       ,72,40,112,2093,472,2565
00163202,AQUINAS INSTITUTE OF THEOLOGY - AQUINAS ,CO,80903-1498,Private      ,0,1,1,0,4,4
00405702,NATIONAL AMERICAN UNIVERSITY            ,CO,80918-0000,Proprietary  ,2,32,34,18,225,243
00405703,NATIONAL AMERICAN UNIVERSITY            ,CO,80222-0000,Proprietary  ,6,28,34,33,293,326
00450300,EVEREST COLLEGE                         ,CO,80916-3548,Proprietary  ,53,304,357,184,1149,1333
00450600,COLORADO MOUNTAIN COLLEGE               ,CO,81602-0000,Public       ,78,194,272,1239,1124,2363
00450700,EVEREST COLLEGE                         ,CO,80229-4339,Proprietary  ,66,301,367,247,1334,1581
00450701,"EVEREST COLLEGE- EVEREST COLLEGE, AURORA",CO,80012-5692,Proprietary  ,40,170,210,175,860,1035
00450800,UNIVERSITY OF COLORADO DENVER           ,CO,80204-2029,Public       ,64,321,385,180,2898,3078
00450824,UNIVERSITY OF COLORADO DENVER - AURARIA ,CO,80217-3364,Public       ,165,685,850,6216,10817,17033
00450900,UNIV OF COLORADO AT COLO SPRINGS        ,CO,80918-3735,Public       ,136,347,483,5448,4684,10132
00559600,EMILY GRIFFITH OPPORTUNITY SCH          ,CO,80204-2197,Public       ,71,365,436,457,1837,2294
00729700,REDSTONE COLLEGE                        ,CO,80020-9988,Proprietary  ,39,172,211,280,780,1060
00754700,LINCOLN COLLEGE OF TECHNOLOGY           ,CO,80223-2013,Proprietary  ,135,148,283,875,812,1687
00754800,WESTWOOD COLLEGE - DENVER NORTH         ,CO,80221-3653,Proprietary  ,107,309,416,1045,3648,4693
00754801,WESTWOOD COLLEGE - DENVER SOUTH         ,CO,80227-3653,Proprietary  ,49,176,225,289,963,1252
00758200,AIMS COMMUNITY COLLEGE                  ,CO,80632-0000,Public       ,204,571,775,1873,3471,5344
00764900,ROCKY MOUNTAIN COLG OF ART & DESIGN     ,CO,80214-0000,Proprietary  ,35,30,65,882,268,1150
00793300,FRONT RANGE COMMUNITY COLLEGE           ,CO,80031-2199,Public       ,688,1754,2442,5752,10585,16337
00863500,INTELLITEC MEDICAL INSTITUTE            ,CO,80909-1570,Proprietary  ,19,103,122,64,386,450
00887100,CONCORDE CAREER INSTITUTE               ,CO,80203-0000,Proprietary  ,47,177,224,222,991,1213
00889600,PIKES PEAK COMMUNITY COLLEGE            ,CO,80906-5498,Public       ,414,1453,1867,4199,9994,14193
00940100,COLORADO CHRISTIAN UNIVERSITY           ,CO,80226-7449,Private      ,39,226,265,1430,1995,3425
00954200,COMMUNITY COLLEGE OF DENVER             ,CO,80217-2026,Public       ,392,1424,1816,3513,7928,11441
00954300,RED ROCKS COMMUNITY COLLEGE             ,CO,80228-1255,Public       ,239,826,1065,2217,4912,7129
00998100,MORGAN COMMUNITY COLLEGE                ,CO,80701-4399,Public       ,26,133,159,326,900,1226
01014800,COLORADO TECHNICAL UNIVERSITY           ,CO,80907-3896,Proprietary  ,92,1860,1952,513,8329,8842
01014802,COLORADO TECHNICAL UNIV - DENVER        ,CO,80111-3201,Proprietary  ,19,198,217,147,1020,1167
01014805,COLORADO TECH UNIV - ON LINE            ,CO,80907-0000,Proprietary  ,338,8985,9323,1279,36090,37369
01014806,COLORADO TECH UNIV - FED EXPRESS        ,CO,80921-3800,Proprietary  ,2,33,35,7,107,114
01014808,COLORADO TECH UNIV - USAA               ,CO,80920-1005,Proprietary  ,1,5,6,5,25,30
01014809,COLORADO TECH UNIV - SCHRIEVER AFB      ,CO,80912-7298,Proprietary  ,0,1,1,0,3,3
01014810,COLORADO TECH UNIV - PETERSON AFB       ,CO,80914-1586,Proprietary  ,0,0,0,0,6,6
01014811,COLORADO TECH UNIV-HEWLETT PACKARD      ,CO,80919-2303,Proprietary  ,0,1,1,4,9,13
01014812,COLORADO TECHNICAL UNIVERSITY - WESTMINS,CO,80021-3498,Proprietary  ,18,245,263,159,1269,1428
01014813,COLORADO TECH UNIV - ORACLE             ,CO,80921-3660,Proprietary  ,0,6,6,2,27,29
01014815,COLORADO TECHNCL UNIV PUEBLO            ,CO,81003-2315,Proprietary  ,9,81,90,74,527,601
01070900,EMPIRE BEAUTY SCHOOL-LAKEWOOD           ,CO,80215-0000,Proprietary  ,6,22,28,39,153,192
01073200,SAN JUAN BASINTECHNICAL COLLEGE         ,CO,81328-9196,Public       ,2,16,18,18,90,108
01157200,COLORADO SCHOOL OF TRADES               ,CO,80215-2996,Proprietary  ,10,44,54,94,212,306
01267000,BEL-REA INST OF ANIMAL TECH             ,CO,80247-3048,Proprietary  ,63,96,159,489,727,1216
01285000,INTERNATIONAL SALON AND SPA ACADEMY     ,CO,80918-3684,Proprietary  ,10,53,63,93,217,310
01287500,PICKENS TECHNICAL COLLEGE               ,CO,80011-9307,Public       ,38,138,176,252,713,965
01300700,NAZARENE BIBLE COLLEGE                  ,CO,80910-3717,Private      ,7,57,64,67,703,770
02072200,EMPIRE BEAUTY SCHOOL -ARVADA            ,CO,80212-0000,Proprietary  ,7,20,27,55,125,180
02078900,ART INSTITUTE OF COLORADO (THE)         ,CO,80203-2983,Proprietary  ,166,285,451,1807,2016,3823
02116300,PUEBLO COMMUNITY COLLEGE                ,CO,81004-0000,Public       ,229,834,1063,1852,5535,7387
02117500,NAROPA UNIVERSITY                       ,CO,80302-0000,Private      ,15,64,79,377,1267,1644
02133100,COLORADO CENTER FOR MEDICAL LABORATORY S,CO,80218-0000,Private      ,0,7,7,6,58,64
02141100,ARTISTIC BEAUTY COLGS-WESTMINSTER       ,CO,80030-0000,Proprietary  ,21,34,55,81,174,255
02141102,ARTISTIC BEAUTY COLLEGES-LITTLETON      ,CO,80123-3480,Proprietary  ,0,0,0,5,7,12
02141103,ARTISTIC BEAUTY COLLEGES-AURORA         ,CO,80017-3194,Proprietary  ,3,12,15,36,105,141
02156200,DELTA - MONTROSE TECHNICAL COLLEGE      ,CO,81416-0000,Public       ,6,43,49,70,235,305
02160600,EMPIRE BEAUTY SCHOOL -THORNTON          ,CO,80241-1659,Proprietary  ,9,21,30,87,179,266
02165200,SALON PROFESSIONAL ACADEMY (THE)        ,CO,81504-5309,Proprietary  ,10,13,23,67,69,136
02167600,KAPLAN COLLEGE                          ,CO,80229-5309,Proprietary  ,16,113,129,119,658,777
02171300,TRINIDAD STATE JUNIOR COLLEGE           ,CO,81101-0000,Proprietary  ,0,2,2,0,2,2
02188700,DENVER ACAD OF COURT REPORTING          ,CO,80030-0000,Proprietary  ,3,27,30,28,159,187
02211901,CHEEKS INTERNATIONAL ACADEMY OF BEAUTY C,CO,80525-3053,Proprietary  ,0,4,4,7,24,31
02211902,CHEEKS INTERNATIONAL ACDMY BTY CULT     ,CO,80631-0000,Proprietary  ,0,8,8,6,23,29
02253700,INTELLITEC COLLEGE                      ,CO,80909-0000,Proprietary  ,31,185,216,115,551,666
02267500,GLENWOOD BEAUTY ACADEMY                 ,CO,81601-0000,Proprietary  ,6,11,17,18,42,60
02276900,COMMUNITY COLLEGE OF AURORA             ,CO,80011-9036,Public       ,199,818,1017,1806,4948,6754
02321700,ITT TECHNICAL INSTITUTE                 ,CO,80229-5338,Proprietary  ,86,394,480,400,1472,1872
02518500,HAIR DYNAMICS EDUCATION CENTER          ,CO,80525-0000,Proprietary  ,14,53,67,93,157,250
02594300,COLLEGE AMERICA - DENVER                ,CO,80222-3380,Proprietary  ,82,557,639,495,2872,3367
02611000,HERITAGE COLLEGE                        ,CO,80212-7413,Proprietary  ,43,188,231,209,883,1092
03006300,INST OF BUSINESS & MEDICAL CAREERS      ,CO,80525-3044,Proprietary  ,38,190,228,240,962,1202
03012100,REMINGTON COLLEGE - COLORADO SPRINGS CAM,CO,80215-0000,Proprietary  ,8,57,65,40,268,308
03013100,BOULDER COLLEGE OF MASSAGE THERAPY      ,CO,80301-3295,Private      ,7,26,33,78,194,272
03014900,PLATT COLLEGE                           ,CO,80014-3141,Proprietary  ,3,38,41,45,216,261
03027400,XENON INTERNATIONAL ACADEMY III         ,CO,80014-1193,Proprietary  ,7,18,25,50,104,154
03030606,UTAH COLLEGE OF MASSAGE THERAPY - DENVER,CO,80031-2921,Proprietary  ,25,62,87,108,279,387
03030607,UTAH COLLEGE OF MASSAGE THERAPY - DENVER,CO,80012-2523,Proprietary  ,28,52,80,104,222,326
03031603,DPT BUSINESS SCHOOL                     ,CO,80223-0000,Proprietary  ,0,0,0,0,2,2
03066900,INTELLITEC COLLEGE                      ,CO,81506-3994,Proprietary  ,42,219,261,194,796,990
03068201,OHIO CENTER FOR BROADCASTING - COLORADO ,CO,80214-4129,Proprietary  ,20,55,75,64,209,273
03076401,BRYMAN SCHOOL OF ARIZONA (THE) - ANTHEM ,CO,80014-2622,Proprietary  ,0,4,4,7,21,28
03289300,COLORADO HEIGHTS UNIVERSITY             ,CO,80236-2711,Private      ,6,32,38,18,121,139
03306300,MONTESSORI EDUC CRT OF THE ROCKIES      ,CO,80301-2587,Private      ,0,4,4,2,32,34
03534300,JONES INTERNATIONAL UNIVERSITY          ,CO,80112-3446,Proprietary  ,25,1129,1154,97,4040,4137
03545300,UNIVERSITY OF THE ROCKIES               ,CO,80903-3612,Proprietary  ,5,417,422,23,1583,1606
03584400,COLORADO SCHOOL OF HEALING ARTS         ,CO,80226-4332,Proprietary  ,14,33,47,73,253,326
03670300,TONI & GUY HAIRDRESSING ACADEMY         ,CO,80911-1713,Proprietary  ,11,31,42,56,149,205
03686300,COLORADO SCHOOL OF TRADITIONAL CHINESE M,CO,80206-2127,Proprietary  ,0,26,26,4,127,131
03776300,CULINARY SCHOOL OF THE ROCKIES          ,CO,80305-5961,Proprietary  ,5,11,16,22,70,92
03972300,CUTTIN' UP BEAUTY ACADEMY               ,CO,80220-0000,Proprietary  ,5,11,16,18,93,111
03976300,MASSAGE THERAPY INSTITUTE OF COLORADO   ,CO,80206-2127,Proprietary  ,0,26,26,23,106,129
04080300,ASPEN UNIVERSITY                        ,CO,80246-1930,Proprietary  ,2,20,22,14,111,125
04093300,ACADEMY OF NATURAL THERAPY              ,CO,80631-3425,Proprietary  ,2,12,14,19,60,79
04121200,INSTITUTE OF TAOIST EDUCATION AND ACUPUN,CO,80027-1028,Private      ,0,5,5,2,43,45
04125100,MONTESSORI CENTRE INTERNATIONAL DENVER  ,CO,80111-5263,Private      ,0,2,2,0,9,9
04139300,NATIONAL BEAUTY COLLEGE                 ,CO,80221-0000,Proprietary  ,1,22,23,17,95,112
04148300,DENVER SCHOOL OF NURSING                ,CO,80202-1213,Proprietary  ,8,96,104,61,481,542
04151100,SUMMIT SALON & BEAUTY SCHOOL            ,CO,80866-4569,Proprietary  ,0,4,4,0,23,23
00267811,BRYANT & STRATTON COLLEGE - VIRGINIA BEA,VA,23462-4417,Proprietary  ,42,241,283,424,2025,2449
00370200,AVERETT UNIVERSITY                      ,VA,24541-3692,Private      ,27,303,330,1348,1689,3037
00370300,BLUEFIELD COLLEGE                       ,VA,24605-1799,Private      ,9,44,53,552,564,1116
00370400,BRIDGEWATER COLLEGE                     ,VA,22812-1599,Private      ,27,6,33,2994,153,3147
00370500,COLLEGE OF WILLIAM & MARY               ,VA,23187-8795,Public       ,123,97,220,9673,4235,13908
00370600,CHRISTOPHER NEWPORT UNIVERSITY          ,VA,23606-2998,Public       ,112,109,221,6917,1028,7945
00370700,RICHARD BLAND COLLEGE                   ,VA,23805-7100,Public       ,71,70,141,1116,543,1659
00370800,EASTERN MENNONITE UNIVERSITY            ,VA,22802-2462,Private      ,14,34,48,1039,477,1516
00370900,EMORY & HENRY COLLEGE                   ,VA,24327-0010,Private      ,11,10,21,1395,146,1541
00371100,FERRUM COLLEGE                          ,VA,24088-2612,Private      ,37,11,48,2706,273,2979
00371200,TIDEWATER COMMUNITY COLLEGE             ,VA,23510-1910,Public       ,965,2947,3912,9842,19532,29374
00371300,HAMPDEN-SYDNEY COLLEGE                  ,VA,23943-0128,Private      ,17,3,20,1207,37,1244
00371400,HAMPTON UNIVERSITY                      ,VA,23668-0099,Private      ,215,197,412,9528,2836,12364
00371500,HOLLINS UNIVERSITY                      ,VA,24020-0000,Private      ,17,32,49,932,594,1526
00371900,LONGWOOD UNIVERSITY                     ,VA,23909-1899,Public       ,79,56,135,4968,682,5650
00372000,LYNCHBURG COLLEGE                       ,VA,24501-3199,Private      ,43,44,87,3313,620,3933
00372100,JAMES MADISON UNIVERSITY                ,VA,22807-3780,Public       ,313,97,410,20642,2300,22942
00372300,MARY BALDWIN COLLEGE                    ,VA,24401-3610,Private      ,19,96,115,1259,1010,2269
00372400,MARYMOUNT UNIVERSITY                    ,VA,22207-4224,Private      ,64,194,258,2393,2016,4409
00372600,NATIONAL COLLEGE                        ,VA,24153-4524,Proprietary  ,192,1251,1443,1067,8545,9612
00372700,NORTHERN VA CMTY CLG                    ,VA,22003-3743,Public       ,983,2158,3141,10517,13490,24007
00372800,OLD DOMINION UNIVERSITY                 ,VA,23529-0052,Public       ,435,879,1314,17091,12360,29451
00373200,RADFORD UNIVERSITY                      ,VA,24142-6905,Public       ,160,87,247,7948,2123,10071
00373300,RANDOLPH-MACON COLLEGE                  ,VA,23005-5505,Private      ,30,11,41,2440,130,2570
00373400,RANDOLPH COLLEGE                        ,VA,24503-1526,Private      ,15,9,24,873,95,968
00373500,VIRGINIA COMMONWEALTH UNIVERSITY        ,VA,23284-9004,Public       ,495,651,1146,21566,13180,34746
00373600,ROANOKE COLLEGE                         ,VA,24153-3794,Private      ,36,13,49,3022,222,3244
00373700,SHENANDOAH UNIVERSITY                   ,VA,22601-5195,Private      ,51,93,144,2421,1871,4292
00373800,SOUTHERN VIRGINIA UNIVERSITY            ,VA,24416-3038,Private      ,45,18,63,711,241,952
00373900,ST PAULS COLLEGE                        ,VA,23868-1299,Private      ,24,46,70,566,425,991
00374200,SWEET BRIAR COLLEGE                     ,VA,24595-9998,Private      ,12,3,15,744,49,793
00374300,UNION THEO SEMINARY & PRESBYTRN SCH     ,VA,23227-0000,Private      ,0,3,3,1,84,85
00374400,UNIVERSITY OF RICHMOND                  ,VA,23173-0001,Private      ,65,113,178,5243,2458,7701
00374500,UNIVERSITY OF VIRGINIA - SFS            ,VA,22903-0000,Public       ,301,229,530,18312,9652,27964
00374600,UNIVERSITY OF MARY WASHINGTON           ,VA,22401-5358,Public       ,80,96,176,4738,1128,5866
00374700,UNIV OF VIRGINIA'S COLLEGE AT WISE      ,VA,24293-4412,Public       ,23,19,42,1895,413,2308
00374800,EASTERN SHORE COMMUNITY COLLEGE         ,VA,23410-3000,Public       ,41,120,161,369,661,1030
00374900,GEORGE MASON UNIVERSITY                 ,VA,22030-4444,Public       ,459,959,1418,16176,13951,30127
00375100,PATRICK HENRY COMMUNITY COLLEGE         ,VA,24112-5311,Public       ,88,349,437,1092,2599,3691
00375200,VIRGINIA INTERMONT COLLEGE              ,VA,24201-4298,Private      ,18,27,45,828,327,1155
00375300,VIRGINIA MILITARY INSTITUTE             ,VA,24450-2138,Public       ,49,6,55,1555,66,1621
00375400,VIRGINIA POLYTECH INST & STATE UNIV     ,VA,24061-2000,Public       ,275,248,523,24809,4946,29755
00375800,DANVILLE COMMUNITY COLLEGE              ,VA,24541-4004,Public       ,165,452,617,1361,2923,4284
00375900,J. SARGEANT REYNOLDS COMMUNITY CLG      ,VA,23285-0000,Public       ,392,1178,1570,4244,8605,12849
00376000,VIRGINIA WESTERN CMTY COLLEGE           ,VA,24038-0000,Public       ,206,617,823,2468,3999,6467
00376100,WYTHEVILLE COMMUNITY COLLEGE            ,VA,24382-3308,Public       ,59,249,308,1159,2061,3220
00376200,VIRGINIA UNIVERSITY OF LYNCHBURG        ,VA,24501-6400,Private      ,6,62,68,89,370,459
00376400,VIRGINIA STATE UNIVERSITY               ,VA,23806-0001,Public       ,214,193,407,9523,2798,12321
00376500,NORFOLK STATE UNIVERSITY                ,VA,23504-8000,Public       ,213,474,687,8821,5974,14795
00376600,VIRGINIA UNION UNIVERSITY               ,VA,23220-1711,Private      ,64,70,134,3350,1100,4450
00376700,VIRGINIA WESLEYAN COLLEGE               ,VA,23502-5599,Private      ,21,59,80,1886,610,2496
00376800,WASHINGTON & LEE UNIVERSITY             ,VA,24450-0303,Private      ,43,6,49,2504,1653,4157
00400400,JOHN TYLER COMMUNITY COLLEGE            ,VA,23831-5316,Public       ,328,759,1087,2929,5111,8040
00450301,"EVEREST COLLEGE- EVEREST COLLEGE, MCLEAN",VA,22102-3000,Proprietary  ,36,130,166,151,476,627
00450702,"EVEREST COLLEGE- EVEREST COLLEGE, ARLING",VA,22203-1905,Proprietary  ,83,184,267,277,836,1113
00498800,CENTRAL VIRGINIA COMMUNITY COLLEGE      ,VA,24502-2498,Public       ,116,386,502,1451,2257,3708
00499200,MILLER-MOTTE TECHNICAL COLLEGE          ,VA,24505-0000,Proprietary  ,44,107,151,178,472,650
00499600,DABNEY S LANCASTER COMMUNITY CLG        ,VA,24422-1000,Public       ,19,68,87,503,584,1087
00522300,NEW RIVER COMMUNITY COLLEGE             ,VA,24084-1127,Public       ,121,280,401,1524,2203,3727
00607500,ROANOKE MEM HOSP SCH RAD ONCOLOGY       ,VA,24033-0000,Private      ,1,0,1,9,11,20
00607501,ROANOKE MEM HOSP SCH RAD TECH           ,VA,24014-1850,Private      ,1,0,1,5,13,18
00662200,COLLEGE OF HEALTH SCIENCES - CHRV       ,VA,24031-0000,Private      ,21,39,60,513,905,1418
00681900,BLUE RIDGE COMMUNITY COLLEGE            ,VA,24486-0080,Public       ,119,268,387,1801,2037,3838
00687100,THOMAS NELSON COMMUNITY COLLEGE         ,VA,23670-0000,Public       ,353,1070,1423,3358,6849,10207
00709900,VIRGINIA HIGHLANDS COMMUNITY CLG        ,VA,24210-4210,Public       ,54,193,247,1200,1722,2922
00726000,SOUTHWEST VIRGINIA COMMUNITY CLG        ,VA,24641-1510,Public       ,53,229,282,1159,1956,3115
00859200,LOUISE OBICI SCHOOL OF NURSING          ,VA,23434-8038,Private      ,4,10,14,13,35,48
00859202,SUFFOLK PUB SCH-LOUISE OBICI SCH PN     ,VA,23434-0000,Private      ,0,0,0,2,6,8
00865900,LORD FAIRFAX COMMUNITY COLLEGE          ,VA,22645-0047,Public       ,156,403,559,1685,2457,4142
00866000,GERMANNA COMMUNITY COLLEGE              ,VA,22508-0339,Public       ,202,451,653,1700,2715,4415
00866100,SOUTHSIDE VIRGINIA CMTY CLG             ,VA,23821-2930,Public       ,157,582,739,1528,3339,4867
00915900,PAUL D CAMP COMMUNITY COLLEGE           ,VA,23851-0737,Public       ,47,202,249,448,1197,1645
00916000,RAPPAHANNOCK COMMUNITY COLLEGE          ,VA,23149-2616,Public       ,67,206,273,765,1125,1890
00926700,EVEREST COLLEGE                         ,VA,23606-4203,Proprietary  ,19,190,209,118,833,951
00926701,EVEREST COLLEGE - CHESAPEAKE            ,VA,23320-2637,Proprietary  ,46,259,305,169,1019,1188
00942000,SANFORD-BROWN COLLEGE                   ,VA,22182-3913,Proprietary  ,75,193,268,368,826,1194
00953500,STAUNTON SCHOOL OF COSMETOLOGY          ,VA,24401-4323,Proprietary  ,2,8,10,14,38,52
00953700,VIRGINIA SCH OF HAIR DESIGN             ,VA,23669-0000,Proprietary  ,9,25,34,34,121,155
00962900,MOUNTAIN EMPIRE COMMUNITY COLLEGE       ,VA,24219-0700,Public       ,54,217,271,1139,1909,3048
00992800,PIEDMONT VIRGINIA COMMUNITY COLLEGE     ,VA,22902-7589,Public       ,76,275,351,1325,2033,3358
01004300,BON SECOURS MEMORIAL SCH OF NURSING     ,VA,23227-4612,Private      ,3,22,25,151,485,636
01019800,ECPI COLLEGE OF TECHNOLOGY              ,VA,23462-6542,Proprietary  ,505,2031,2536,3439,12314,15753
01033800,EASTERN VIRGINIA MEDICAL SCHOOL         ,VA,23501-1980,Private      ,3,21,24,45,1234,1279
01159600,RALPH'S VIRGINIA SCH OF COSMETOLOGY     ,VA,24501-2652,Proprietary  ,1,8,9,13,28,41
01162601,WESTWOOD COLLEGE - SOUTH BAY - ARLINGTON,VA,22203-4167,Proprietary  ,48,122,170,472,615,1087
01162602,WESTWOOD COLLEGE - SOUTH BAY - ANNANDALE,VA,22003-2602,Proprietary  ,48,109,157,242,642,884
01274401,SOUTHSIDE REGIONAL MED CTR PROF SCHOOLS ,VA,23803-5133,Proprietary  ,4,15,19,62,226,288
01274402,SOUTHSIDE REG MED CTR SCH RAD TECH      ,VA,23803-0000,Proprietary  ,0,2,2,7,27,34
02053000,LIBERTY UNIVERSITY                      ,VA,24502-0000,Private      ,506,4483,4989,16423,35126,51549
02108800,WARDS CORNER BEAUTY ACADEMY             ,VA,23505-0000,Proprietary  ,16,101,117,61,374,435
02111600,DANVILLE REGIONAL MEDICAL CENTER SCHOOL ,VA,24541-0000,Proprietary  ,5,11,16,45,98,143
02128700,CENTRAL SCHOOL OF PRACTICAL NURSING     ,VA,23502-2230,Public       ,1,9,10,21,105,126
02140000,RIVERSIDE SCHOOL OF HEALTH CAREERS      ,VA,23608-3802,Private      ,9,43,52,113,524,637
02175800,LYNCHBURG GENERAL HOSP SCH OF NURSG     ,VA,24501-0000,Private      ,3,13,16,91,188,279
02197600,WOODROW WILSON REHABILITATION CTR       ,VA,22939-0000,Public       ,5,4,9,19,21,40
02242400,HENRICO CTY ST MARYS HOSP PRAC NRSG     ,VA,23075-0000,Public       ,1,3,4,11,45,56
02247200,MEDSPA CAREERS INSTITUTE                ,VA,23606-0000,Proprietary  ,11,37,48,104,362,466
02304500,HERITAGE INSTITUTE                      ,VA,20111-0000,Proprietary  ,34,103,137,122,495,617
02320900,TIDEWATER TECH                          ,VA,23517-0000,Proprietary  ,21,107,128,112,556,668
02334400,CENTURA COLLEGE                         ,VA,23452-0000,Proprietary  ,108,853,961,542,4511,5053
02342700,FORTIS COLLEGE                          ,VA,23502-4101,Proprietary  ,14,84,98,121,441,562
02342701,FORTIS COLLEGE - RICHMOND CAMPUS        ,VA,23236-3472,Proprietary  ,21,87,108,133,385,518
02358500,BON SECOURS SAINT MARY'S HOSPITAL SCHOOL,VA,23227-4612,Private      ,2,7,9,12,53,65
02535400,ECPI TECHNICAL COLLEGE                  ,VA,23236-0000,Proprietary  ,26,79,105,286,641,927
02538800,SUFFOLK BEAUTY ACADEMY                  ,VA,23434-0000,Proprietary  ,2,15,17,15,70,85
02541200,STRATFORD UNIVERSITY                    ,VA,22043-0000,Proprietary  ,33,180,213,160,784,944
02541201,STRATFORD UNIVERSITY-WOODBRIDGE         ,VA,22192-0000,Proprietary  ,6,55,61,56,242,298
02610100,WASHINGTON COUNTY ADULT SKILL CTR       ,VA,24210-2346,Public       ,3,22,25,27,128,155
03002400,GRAHAM WEBB INTERNATIONAL ACAD HAIR     ,VA,22209-2129,Proprietary  ,17,29,46,61,115,176
03010700,BAR PALMA BEAUTY CAREERS  ACADEMY       ,VA,24014-2255,Proprietary  ,7,19,26,30,86,116
03042800,"VIRGINIA BEACH CITY SCHOOLS, SCH.-PR.NSG",VA,23456-0038,Public       ,3,5,8,28,67,95
03091100,ACT COLLEGE                             ,VA,22209-2297,Proprietary  ,30,100,130,109,440,549
03091300,REGENT UNIVERSITY                       ,VA,23464-9800,Private      ,56,548,604,744,5982,6726
03092700,ECPI TECHNICAL COLLEGE-ROANOKE          ,VA,24012-1603,Proprietary  ,18,72,90,133,565,698
03096500,SPRINGFIELD BEAUTY ACADEMY              ,VA,22003-3016,Proprietary  ,0,17,17,6,99,105
03106500,SENTARA NORFOLK GENERAL HOSPITAL        ,VA,23320-2843,Private      ,14,45,59,133,528,661
03116900,BAPTIST THEOLOGICAL SEM.-RICHMOND       ,VA,23227-0000,Private      ,1,4,5,1,46,47
03126300,TIDEWATER TECH AVIATION                 ,VA,23320-5987,Proprietary  ,22,76,98,132,477,609
03126400,CENTURA COLLEGE                         ,VA,23235-5230,Proprietary  ,24,94,118,163,676,839
03126401,CENTURA COLLEGE - WEST                  ,VA,23294-0000,Proprietary  ,0,17,17,15,104,119
03127500,ADVANCED TECHNOLOGY INSTITUTE           ,VA,23462-2409,Proprietary  ,60,133,193,530,648,1178
03280400,VIRGINIA SCHOOL OF MASSAGE              ,VA,22903-0000,Proprietary  ,9,31,40,64,163,227
03409500,RICHMOND SCHOOL OF HEALTH AND TECH      ,VA,23227-0000,Proprietary  ,12,107,119,126,811,937
03455300,CRESCENT COSMETOLOGY UNIVERSITY         ,VA,23666-3115,Proprietary  ,0,3,3,4,23,27
03559300,APPALACHIAN SCHOOL OF LAW               ,VA,24614-0000,Private      ,2,7,9,8,727,735
03638400,TAP THIS VALLEY WORKS CTR FOR EMPLO     ,VA,24016-1901,Private      ,0,10,10,1,18,19
03645400,RUDY & KELLY ACADEMY OF HAIR AND NA     ,VA,23464-6857,Proprietary  ,24,42,66,122,215,337
03654300,CAREER TRAINING SOLUTIONS               ,VA,22406-1014,Proprietary  ,11,70,81,64,408,472
03709300,EDWARD VIA VIRGINIA CLG OSTEOPATHIC MED ,VA,24060-6360,Private      ,0,4,4,5,744,749
03872400,INSTITUTE FOR THE PSYCHOLOGICAL SCIENCES,VA,22202-3609,Private      ,1,2,3,5,102,107
03876300,CULPEPER COSMETOLOGY TRAINING CENTER    ,VA,22701-3155,Public       ,0,16,16,10,47,57
03883400,AVIATION INSTITUTE OF MAINTENANCE       ,VA,20110-4156,Proprietary  ,23,78,101,81,298,379
04038400,AVI CAREER INSTITUTE                    ,VA,22066-1839,Proprietary  ,2,17,19,7,80,87
04124000,DOMINION SCHOOL OF HAIR DESIGN          ,VA,23062-2221,Proprietary  ,0,5,5,8,31,39
04127300,COLUMBIA COLLEGE                        ,VA,22031-4413,Proprietary  ,3,21,24,5,67,72
04133400,CENTURA COLLEGE                         ,VA,22312-2670,Proprietary  ,9,20,29,28,103,131
04133800,SOUTHEAST CULINARY & HOSPITALITY COLLEGE,VA,24201-4159,Proprietary  ,4,20,24,46,78,124
04137300,CAYCE/REILLY SCHOOL OF MASSOTHERAPY     ,VA,23451-2061,Private      ,6,7,13,11,41,52
04140000,GLOBAL HEALTH NURSE TRAINING SERVICES   ,VA,22314-4585,Proprietary  ,8,51,59,25,234,259
04156200,INSTITUTE OF ADVANCED MEDICAL ESTHETICS ,VA,23294-4701,Proprietary  ,2,12,14,2,12,14
00107000,THUNDERBIRD SCHOOL OF GLOBAL MANAGEMENT ,AZ,85306-6000,Private      ,1,71,72,8,863,871
00107100,ARIZONA WESTERN COLLEGE                 ,AZ,85366-0000,Public       ,332,677,1009,3768,4470,8238
00107200,COCHISE COLLEGE                         ,AZ,85607-6190,Public       ,108,365,473,1274,2306,3580
00107300,EASTERN ARIZONA COLLEGE                 ,AZ,85552-0769,Public       ,107,287,394,1313,1680,2993
00107400,GRAND CANYON UNIVERSITY                 ,AZ,85017-3030,Proprietary  ,336,7290,7626,3078,46849,49927
00107600,GLENDALE COMMUNITY COLLEGE              ,AZ,85302-3090,Public       ,904,1725,2629,7798,10183,17981
00107700,MESA COMMUNITY COLLEGE                  ,AZ,85202-4866,Public       ,925,2173,3098,8878,13971,22849
00107800,PHOENIX COLLEGE                         ,AZ,85013-4234,Public       ,445,1594,2039,4217,9083,13300
00107900,YAVAPAI COLLEGE                         ,AZ,86301-3297,Public       ,178,560,738,1818,3379,5197
00108100,ARIZONA STATE UNIV (ALL CAMPUSES)       ,AZ,85287-0412,Public       ,1250,2123,3373,40030,30819,70849
00108200,NORTHERN ARIZONA UNIVERSITY             ,AZ,86011-0001,Public       ,522,958,1480,18921,11804,30725
00108300,UNIVERSITY OF ARIZONA                   ,AZ,85721-0066,Public       ,601,705,1306,24635,13881,38516
00165701,MIDWESTERN UNIVERSITY                   ,AZ,85308-0000,Private      ,3,42,45,74,2813,2887
00446700,TUCSON COLLEGE                          ,AZ,85710-0000,Proprietary  ,37,144,181,162,621,783
00711300,SOUTHWESTERN COLLEGE                    ,AZ,85032-7097,Private      ,10,25,35,401,211,612
00726600,PIMA COUNTY COMMUNITY COLLEGE           ,AZ,85709-1110,Public       ,786,2276,3062,9227,15649,24876
00728300,CENTRAL ARIZONA COLLEGE                 ,AZ,85228-9779,Public       ,222,590,812,2105,3811,5916
00822100,UNIVERSAL TECHNICAL INSTITUTE           ,AZ,85323-7946,Proprietary  ,923,1168,2091,9575,6740,16315
00824600,DINè COLLEGE                            ,AZ,86556-0126,Public       ,79,163,242,783,1212,1995
00830300,GATEWAY COMMUNITY COLLEGE               ,AZ,85034-1795,Public       ,155,788,943,1539,5491,7030
00830302,MARICOPA SKILL CENTER                   ,AZ,85034-0000,Public       ,63,305,368,460,1641,2101
00830400,SCOTTSDALE COMMUNITY COLLEGE            ,AZ,85250-0000,Public       ,271,556,827,3109,3829,6938
00886400,ARIZONA ACADEMY OF BEAUTY               ,AZ,85712-5021,Proprietary  ,5,19,24,20,83,103
00886500,ARTISTIC BEAUTY COLLEGES-TUCSON         ,AZ,85716-3999,Proprietary  ,14,49,63,164,355,519
00886501,ARTISTIC BEAUTY COLLEGES - TUCSON  - NOR,AZ,85705-1665,Proprietary  ,0,5,5,4,23,27
00945100,BROWN MACKIE COLLEGE                    ,AZ,85712-5300,Proprietary  ,135,607,742,614,3198,3812
01084700,ARIZONA AUTOMOTIVE INSTITUTE            ,AZ,85301-3503,Proprietary  ,99,324,423,485,1516,2001
01085800,AVALON SCHOOL OF COSMETOLOGY            ,AZ,85210-4010,Proprietary  ,41,72,113,179,379,558
01168900,REFRIGERATION SCHOOL                    ,AZ,85034-0000,Proprietary  ,31,197,228,141,914,1055
01180200,ARIZONA ACADEMY OF BEAUTY-NORTH         ,AZ,85705-2720,Proprietary  ,5,19,24,18,70,88
01180800,ARTISTIC BEAUTY COLLEGES-FLAGSTAFF      ,AZ,86004-5119,Proprietary  ,19,63,82,142,383,525
01180801,CLG OF BEAUTY ARTS & SCI/CHANDLER       ,AZ,85224-0000,Proprietary  ,2,4,6,10,19,29
01180802,CLG OF BEAUTY ARTS & SCI/PRESCOTT       ,AZ,86303-0000,Proprietary  ,1,3,4,8,13,21
01186200,NORTHLAND PIONEER COLLEGE               ,AZ,86025-2996,Public       ,90,341,431,653,1764,2417
01186400,MOHAVE COMMUNITY COLLEGE                ,AZ,86409-1238,Public       ,216,785,1001,1382,5368,6750
01218400,INTERNATIONAL ACAD OF HAIR DESIGN       ,AZ,85225-7198,Proprietary  ,22,37,59,96,181,277
01234300,ARTISTIC BEAUTY COLLEGES-PHOENIX        ,AZ,85304-0000,Proprietary  ,20,35,55,173,285,458
01234301,EMPIRE BEAUTY SCHOOL - AVONDALE         ,AZ,85323-2352,Proprietary  ,0,0,0,12,28,40
01293700,ARTISTIC BEAUTY COLLEGES - PARADISE VALL,AZ,85257-0000,Proprietary  ,9,19,28,48,87,135
02065200,ITT TECHNICAL INSTITUTE                 ,AZ,85282-0000,Proprietary  ,139,533,672,738,2779,3517
02065300,PRESCOTT COLLEGE                        ,AZ,86301-0000,Private      ,30,106,136,459,1062,1521
02071200,KAPLAN COLLEGE                          ,AZ,85029-4349,Proprietary  ,53,298,351,417,1769,2186
02098800,UNIVERSITY OF PHOENIX                   ,AZ,85040-0000,Proprietary  ,6572,119055,125627,24616,464570,489186
02100500,UNIVERSAL TECHNICAL INSTITUTE           ,AZ,85027-0000,Proprietary  ,793,1345,2138,7942,9522,17464
02100600,APOLLO COLLEGE                          ,AZ,85015-0000,Proprietary  ,263,1101,1364,1822,6300,8122
02113800,ROBERTO-VENN SCH OF LUTHIERY            ,AZ,85040-0000,Proprietary  ,5,11,16,32,71,103
02146600,SOUTH MOUNTAIN COMMUNITY COLLEGE        ,AZ,85040-0000,Public       ,146,410,556,1698,2966,4664
02171500,WESTERN INTERNATIONAL UNIVERSITY        ,AZ,85021-0000,Proprietary  ,12,619,631,63,2331,2394
02174900,COLLINS COLLEGE                         ,AZ,85040-4000,Proprietary  ,100,143,243,1172,1067,2239
02177500,RIO SALADO COMMUNITY COLLEGE            ,AZ,85281-0000,Public       ,258,2785,3043,1462,12653,14115
02190702,RETS COLLEGE - FORTIS COLLEGE-PHOENIX   ,AZ,85006-3759,Proprietary  ,3,11,14,5,23,28
02192300,MARICOPA BEAUTY COLLEGE                 ,AZ,85323-0000,Proprietary  ,2,18,20,50,110,160
02199900,AMERICAN INDIAN CLG-ASSEMBLIES GOD      ,AZ,85021-0000,Private      ,9,16,25,67,83,150
02217100,PIMA MEDICAL INSTITUTE                  ,AZ,85716-0000,Proprietary  ,478,1491,1969,2337,8034,10371
02218800,BROOKLINE COLLEGE                       ,AZ,85019-1600,Proprietary  ,60,487,547,372,2228,2600
02218804,BROOKLINE COLLEGE - MESA                ,AZ,85204-4448,Proprietary  ,26,122,148,87,421,508
02218805,BROOKLINE COLLEGE - TUCSON              ,AZ,85711-5444,Proprietary  ,41,220,261,138,639,777
02220300,ARTISTIC BEAUTY COLLEGES-GLENDALE       ,AZ,85051-0000,Proprietary  ,21,58,79,170,428,598
02263100,ANTHEM COLLEGE                          ,AZ,85014-0000,Proprietary  ,137,784,921,658,2796,3454
02280500,CHARLES OF ITALY BEAUTY COLLEGE         ,AZ,86403-0000,Proprietary  ,10,18,28,29,75,104
02295000,EVEREST COLLEGE                         ,AZ,85021-1610,Proprietary  ,238,2055,2293,1039,9698,10737
02295002,EVEREST COLLEGE - MESA                  ,AZ,85206-4704,Proprietary  ,35,185,220,160,939,1099
02317800,AMERICAN INSTITUTE OF TECHNOLOGY        ,AZ,85043-0000,Proprietary  ,10,419,429,44,1365,1409
02361100,ITT TECHNICAL INSTITUTE                 ,AZ,85704-0000,Proprietary  ,201,452,653,772,1963,2735
02491500,THE ART CENTER DESIGN COLLEGE           ,AZ,85716-0000,Proprietary  ,15,31,46,229,426,655
02521500,LAMSON COLLEGE                          ,AZ,85284-1141,Proprietary  ,18,98,116,119,514,633
02533200,FRANK LLOYD WRIGHT SCHOOL OF ARCHITECTUR,AZ,85261-4430,Private      ,1,5,6,12,45,57
02559000,UNIVERSITY OF ADVANCING TECHNOLOGY      ,AZ,85283-0000,Proprietary  ,77,132,209,1085,753,1838
02561900,TONI AND GUY HAIRDRESSING ACADEMY       ,AZ,85251-3301,Proprietary  ,43,33,76,167,171,338
02582700,CORTIVA INSTITUTE - TUCSON              ,AZ,85710-3503,Proprietary  ,9,31,40,60,226,286
02616700,SCOTTSDALE CULINARY INSTITUTE           ,AZ,85251-2729,Proprietary  ,141,468,609,1090,2356,3446
02623600,PARADISE VALLEY COMMUNITY COLLEGE       ,AZ,85032-1210,Public       ,264,679,943,2621,3906,6527
02623800,CORTIVA INSTITUTE - SCOTTSDALE          ,AZ,85257-4218,Proprietary  ,12,36,48,59,203,262
03005000,SAFFORD COLLEGE OF BEAUTY CULTURE       ,AZ,85546-3309,Proprietary  ,0,2,2,15,43,58
03010613,VIRGINIA COLLEGE - GOLF ACADEMY OF ARIZO,AZ,85225-6742,Proprietary  ,16,39,55,142,258,400
03030604,UTAH COLLEGE OF MASSAGE THERAPY - ARIZON,AZ,85282-0000,Proprietary  ,30,76,106,148,382,530
03030605,UTAH COLLEGE OF MASSAGE THERAPY - ARIZON,AZ,85051-3470,Proprietary  ,53,65,118,187,311,498
03034400,CONSERVATORY RECORDING ARTS & SCIS      ,AZ,85282-1707,Proprietary  ,85,113,198,653,754,1407
03072200,CHANDLER-GILBERT COMMUNITY COLLEGE      ,AZ,85225-2499,Public       ,381,677,1058,3553,4420,7973
03076400,BRYMAN SCHOOL OF ARIZONA                ,AZ,85029-4919,Proprietary  ,233,658,891,1179,3586,4765
03097800,CARSTEN INSTITUTE OF HAIR & BEAUTY      ,AZ,85282-5404,Proprietary  ,23,48,71,88,212,300
03100400,COCONINO COUNTY COMMUNITY COLLEGE       ,AZ,86001-2701,Public       ,123,284,407,1126,1849,2975
03107000,SOUTHWEST CLG OF NATUROPATHIC MED       ,AZ,85282-0000,Private      ,0,23,23,8,430,438
03115000,ARIZONA COLLEGE OF ALLIED HEALTH        ,AZ,85302-3843,Proprietary  ,33,224,257,185,1040,1225
03120300,COLLEGE AMERICA                         ,AZ,86004-3936,Proprietary  ,33,152,185,182,757,939
03156300,ESTRELLA MOUNTAIN COMMUNITY COLLEGE     ,AZ,85392-1010,Public       ,240,544,784,2390,3740,6130
03156301,ESTRELLA MOUNTAIN COMMUNITY COLLEGE - SO,AZ,85392-1010,Public       ,98,214,312,734,1336,2070
03347300,INTERNATIONAL BAPTIST COLLEGE           ,AZ,85282-6799,Private      ,2,2,4,52,21,73
03445300,HDS TRUCK DRIVING INSTITUTE             ,AZ,85731-0000,Proprietary  ,2,21,23,2,57,59
03478400,PHOENIX SEMINARY                        ,AZ,85018-7611,Private      ,0,10,10,5,90,95
03572300,EAST VALLEY INSTITUTE OF TECHNOLOGY     ,AZ,85201-6910,Public       ,13,33,46,100,181,281
03593300,SOUTHWEST INSTITUTE OF HEALING ARTS     ,AZ,85281-3658,Proprietary  ,18,138,156,90,636,726
03617500,PHOENIX INSTITUTE OF HERBAL MEDICINE & A,AZ,85012-0000,Proprietary  ,0,21,21,6,171,177
03695500,ARIZONA SCHOOL OF ACUPUNCTURE AND ORIENT,AZ,85712-1100,Proprietary  ,1,8,9,5,69,74
03740500,ART INSTITUTE OF TUCSON (THE)           ,AZ,85712-2732,Proprietary  ,40,59,99,277,402,679
03784400,TOHONO O'ODHAM COMMUNITY COLLEGE        ,AZ,85634-3129,Public       ,4,2,6,19,81,100
03813300,NORTHCENTRAL UNIVERSITY                 ,AZ,86314-2336,Proprietary  ,2,651,653,5,1568,1573
03814300,TURNING POINT BEAUTY COLLEGE            ,AZ,85222-4229,Proprietary  ,4,11,15,20,68,88
04051300,ART INSTITUTE OF PHOENIX (THE)          ,AZ,85021-2859,Proprietary  ,131,250,381,1469,1583,3052
04059300,TUCSON COLLEGE OF BEAUTY                ,AZ,85705-2451,Proprietary  ,5,16,21,41,82,123
04120900,ARIZONA CULINARY INSTITUTE              ,AZ,85259-4939,Proprietary  ,19,51,70,170,248,418
04131400,PHOENIX SCHOOL OF LAW                   ,AZ,85012-3330,Proprietary  ,0,56,56,11,979,990
04138800,MODERN TECHNIQUES BEAUTY COLLEGE        ,AZ,86403-2974,Proprietary  ,4,4,8,13,27,40
04139200,UNIVERSAL BARBER COLLEGE                ,AZ,85007-3914,Proprietary  ,2,5,7,2,5,7
04152900,STUDIO ACADEMY OF BEAUTY (THE)          ,AZ,85224-3600,Proprietary  ,9,27,36,32,67,99
00142800,DELAWARE STATE UNIVERSITY               ,DE,19901-2277,Public       ,151,150,301,6759,1920,8679
00142900,GOLDEY BEACOM COLLEGE                   ,DE,19808-1993,Private      ,23,38,61,490,379,869
00143100,UNIVERSITY OF DELAWARE                  ,DE,19716-0099,Public       ,254,193,447,22041,2824,24865
00143300,WESLEY COLLEGE                          ,DE,19901-3875,Private      ,45,50,95,2370,541,2911
00143301,WESLEY COLLEGE-CTR FOR ADULT STUDIE     ,DE,19720-0000,Private      ,4,37,41,30,357,387
00331301,WIDENER UNIV SCHOOL OF LAW - DE         ,DE,19803-0000,Private      ,2,25,27,42,1793,1835
00705300,DELAWARE TECH & CMTY COLLEGE-OWENS      ,DE,19947-0000,Public       ,134,497,631,1941,2842,4783
00794800,WILMINGTON UNIVERSITY                   ,DE,19720-6491,Private      ,144,761,905,1984,6149,8133
01172700,DELAWARE TECH & CMTY CLG-TERRY          ,DE,19901-8736,Public       ,90,309,399,1593,2198,3791
02125200,BEEBE SCHOOL OF NURSING                 ,DE,19958-1462,Private      ,0,9,9,41,78,119
02144900,DELAWARE TECH & CMTY CLG-STANTN/WLM     ,DE,19801-0000,Public       ,256,537,793,3247,3757,7004
02190400,SCHILLING DOUGLAS SCH OF HAIR DSGN      ,DE,19711-0000,Proprietary  ,18,15,33,71,129,200
02586902,STAR TECHNICAL INSTITUTE -              ,DE,19901-4615,Proprietary  ,0,2,2,3,38,41
03025800,DAWN TRAINING CENTRE                    ,DE,19805-1511,Proprietary  ,16,114,130,67,454,521
03543300,HARRIS SCHOOL OF BUSINESS               ,DE,19803-5341,Proprietary  ,41,141,182,159,594,753
03702300,DELAWARE LEARNING INSTITUTE OF COSMETOLO,DE,19939-9759,Proprietary  ,11,33,44,56,142,198
04130700,ACADEMY OF MASSAGE AND BODYWORK         ,DE,19701-1321,Proprietary  ,2,6,8,8,43,51
04139800,DELAWARE COLLEGE OF ART & DESIGN        ,DE,19801-3007,Private      ,11,6,17,366,84,450
        ,FEDERAL STUDENT AID USE ONLY            ,DC,20202-0000,,0,0,0,2,116,118
00143400,AMERICAN UNIVERSITY                     ,DC,20016-8020,Private      ,154,329,483,12024,10960,22984
00143700,CATHOLIC UNIVERSITY OF AMERICA          ,DC,20064-0002,Private      ,70,150,220,4871,2578,7449
00143711,"CATHOLIC UNIV AMERICA, LAW SCHOOL       ",DC,20064-0000,Private      ,2,12,14,42,1743,1785
00144100,UNIV OF THE DISTRICT OF COLUMBIA        ,DC,20008-0000,Public       ,102,368,470,2304,4866,7170
00144102,UNIVERSITY OF THE DISTRICT OF COLUMBIA -,DC,20008-1173,Public       ,34,209,243,85,1102,1187
00144300,GALLAUDET UNIVERSITY                    ,DC,20002-3695,Private      ,28,42,70,827,852,1679
00144400,GEORGE WASHINGTON UNIVERSITY            ,DC,20052-2353,Private      ,189,648,837,11984,10737,22721
00144402,GEORGE WASHINGTON UNIV LAW SCHL         ,DC,20052-0000,Private      ,2,39,41,35,5078,5113
00144403,GEORGE WASHINGTON UNIV SCH MED          ,DC,20052-0000,Private      ,1,20,21,52,1594,1646
00144500,GEORGETOWN UNIVERSITY                   ,DC,20057-1252,Private      ,159,231,390,12834,5503,18337
00144501,"GEORGETOWN UNIV, SCH OF MEDICINE        ",DC,20007-0000,Private      ,4,10,14,42,1094,1136
00144502,GEORGETOWN UNIVERSITY - GRADUATE SCHOOL ,DC,20057-0004,Private      ,5,143,148,20,1928,1948
00144503,GEORGETOWN UNIV LAW CENTER              ,DC,20001-0000,Private      ,1,38,39,24,6181,6205
00144800,HOWARD UNIVERSITY                       ,DC,20059-0001,Private      ,311,356,667,14245,8926,23171
00145600,SOUTHEASTERN UNIVERSITY                 ,DC,20024-2788,Private      ,0,0,0,110,476,586
00145900,STRAYER UNIVERSITY                      ,DC,20005-2603,Proprietary  ,516,10493,11009,2340,53556,55896
00146000,TRINITY UNIVERSITY                      ,DC,20017-1004,Private      ,32,188,220,983,2075,3058
00146400,WESLEY THEOLOGICAL SEMINARY             ,DC,20016-0000,Private      ,0,31,31,2,311,313
00207701,JOHNS HOPKINS UNIV SCH ADV INTL STU     ,DC,20036-0000,Private      ,1,54,55,25,1456,1481
01006500,WASHINGTON THEOLOGICAL UNION            ,DC,20012-0000,Private      ,0,3,3,3,36,39
01195000,THE CORCORAN COLLEGE OF ART & DESIG     ,DC,20006-4804,Private      ,8,38,46,493,397,890
01280300,DOMINICAN HOUSE OF STUDIES              ,DC,20017-1584,Private      ,0,0,0,2,14,16
02132800,NAT'L CONSERVATORY DRAMATIC ARTS        ,DC,20007-2758,Private      ,4,5,9,10,38,48
02279200,DUDLEY BEAUTY COLG-WASHINGTON           ,DC,20018-0000,Proprietary  ,17,41,58,56,139,195
02588900,SANZ SCHOOL                             ,DC,20006-0000,Proprietary  ,77,340,417,305,1334,1639
03104300,CAREER BLAZERS LEARNING CENTER OF WASHIN,DC,20037-1881,Proprietary  ,44,221,265,134,734,868
03218300,POTOMAC COLLEGE                         ,DC,20016-1860,Proprietary  ,16,107,123,65,650,715
03409600,BENNETT CAREER INSTITUTE                ,DC,20017-1754,Proprietary  ,15,65,80,89,276,365
03750300,TECHNICAL LEARNING CENTERS              ,DC,20005-3415,Proprietary  ,15,121,136,57,418,475
04114400,INSTITUTE OF WORLD POLITICS (THE)       ,DC,20036-1464,Private      ,0,14,14,0,77,77
04142700,PONTIFICAL JOHN PAUL II INSTITUTE FOR ST,DC,20064-0001,Private      ,0,3,3,0,22,22
00154100,ABRAHAM BALDWIN AGRICULTURAL CLG        ,GA,31794-0000,Public       ,189,198,387,3186,1790,4976
00154200,AGNES SCOTT COLLEGE                     ,GA,30030-3797,Private      ,25,54,79,1291,411,1702
00154300,DARTON COLLEGE                          ,GA,31707-3098,Public       ,199,651,850,3021,5631,8652
00154400,ALBANY STATE UNIVERSITY                 ,GA,31705-2796,Public       ,214,356,570,6758,4396,11154
00154500,ANDREW COLLEGE                          ,GA,39840-1313,Private      ,9,6,15,382,66,448
00154600,ARMSTRONG ATLANTIC STATE UNIVERSITY     ,GA,31419-1997,Public       ,207,591,798,4640,5869,10509
00154700,ATLANTA CHRISTIAN COLLEGE               ,GA,30344-1999,Private      ,23,134,157,410,898,1308
00155200,AUGUSTA STATE UNIVERSITY                ,GA,30904-2200,Public       ,193,420,613,4864,5220,10084
00155400,BERRY COLLEGE                           ,GA,30149-5007,Private      ,70,27,97,2502,294,2796
00155500,THOMAS UNIVERSITY                       ,GA,31792-7499,Private      ,23,160,183,314,1212,1526
00155600,BRENAU UNIVERSITY                       ,GA,30501-3668,Private      ,39,299,338,1136,2885,4021
00155700,BREWTON PARKER COLLEGE                  ,GA,30445-0000,Private      ,21,68,89,704,659,1363
00155800,COASTAL GEORGIA COMMUNITY COLLEGE       ,GA,31520-3644,Public       ,142,429,571,1615,2998,4613
00155900,CLARK ATLANTA UNIVERSITY                ,GA,30314-4385,Private      ,460,373,833,13008,4956,17964
00156000,COLUMBIA THEOLOGICAL SEMINARY           ,GA,30031-0000,Private      ,0,9,9,1,208,209
00156100,COLUMBUS STATE UNIVERSITY               ,GA,31907-5645,Public       ,290,577,867,5698,5531,11229
00156200,GEORGIA PERIMETER COLLEGE               ,GA,30021-0000,Public       ,1393,2976,4369,15062,21615,36677
00156300,EMMANUEL COLLEGE                        ,GA,30639-0000,Private      ,24,25,49,742,235,977
00156400,EMORY UNIVERSITY                        ,GA,30322-1960,Private      ,208,422,630,11229,9757,20986
00156600,FORT VALLEY STATE UNIVERSITY            ,GA,31030-3298,Public       ,202,202,404,5777,2143,7920
00156700,GAINESVILLE STATE COLLEGE               ,GA,30503-0000,Public       ,471,428,899,6065,3463,9528
00156800,INTERDENOMINATIONAL THEOLOGY CENTER     ,GA,30314-0000,Private      ,1,39,40,4,574,578
00156900,GEORGIA INSTITUTE OF TECHNOLOGY         ,GA,30332-0002,Public       ,328,389,717,14841,4872,19713
00157000,SOUTHERN POLYTECHNIC STATE UNIV         ,GA,30060-2896,Public       ,122,337,459,3075,2871,5946
00157100,GEORGIA MILITARY COLLEGE                ,GA,31061-3398,Public       ,289,606,895,3525,4786,8311
00157200,GEORGIA SOUTHERN UNIVERSITY             ,GA,30460-8065,Public       ,501,510,1011,18210,6765,24975
00157300,GEORGIA SOUTHWESTERN STATE UNIV         ,GA,31709-4693,Public       ,65,155,220,2201,2053,4254
00157400,GEORGIA STATE UNIVERSITY                ,GA,30303-3010,Public       ,919,2364,3283,25106,26611,51717
00157500,GORDON COLLEGE                          ,GA,30204-1762,Public       ,293,330,623,4782,2886,7668
00157700,KENNESAW STATE UNIVERSITY               ,GA,30144-5591,Public       ,731,1441,2172,14854,14012,28866
00157800,LAGRANGE COLLEGE                        ,GA,30240-2999,Private      ,10,44,54,1176,617,1793
00157900,MEDICAL COLLEGE OF GEORGIA              ,GA,30912-0004,Public       ,16,67,83,606,2669,3275
00158000,MERCER UNIVERSITY                       ,GA,31207-0003,Private      ,114,566,680,4357,8424,12781
00158100,MIDDLE GEORGIA COLLEGE                  ,GA,31014-1599,Public       ,144,257,401,3472,2148,5620
00158200,MOREHOUSE COLLEGE                       ,GA,30314-3773,Private      ,108,98,206,5146,1161,6307
00158500,NORTH GEORGIA COLLEGE & STATE UNIV      ,GA,30597-0001,Public       ,190,198,388,4085,2105,6190
00158600,OGLETHORPE UNIVERSITY                   ,GA,30319-2737,Private      ,46,76,122,1712,612,2324
00158700,PAINE COLLEGE                           ,GA,30901-3182,Private      ,40,47,87,1612,570,2182
00158800,PIEDMONT COLLEGE                        ,GA,30535-5644,Private      ,37,257,294,909,2496,3405
00158900,REINHARDT COLLEGE                       ,GA,30183-2981,Private      ,33,54,87,952,499,1451
00159000,SAVANNAH STATE UNIVERSITY               ,GA,31404-5298,Public       ,225,281,506,6351,2776,9127
00159100,SHORTER COLLEGE                         ,GA,30165-4298,Private      ,53,455,508,1785,3360,5145
00159200,SOUTH GEORGIA COLLEGE                   ,GA,31533-8104,Public       ,109,171,280,1649,1308,2957
00159400,SPELMAN COLLEGE                         ,GA,30314-4399,Private      ,222,124,346,6377,1367,7744
00159600,TOCCOA FALLS COLLEGE                    ,GA,30598-0001,Private      ,17,12,29,900,237,1137
00159700,TRUETT MCCONNELL COLLEGE                ,GA,30528-1264,Private      ,12,11,23,460,107,567
00159800,UNIVERSITY OF GEORGIA                   ,GA,30602-6114,Public       ,623,770,1393,22266,11916,34182
00159900,VALDOSTA STATE UNIVERSITY               ,GA,31698-0001,Public       ,410,463,873,11970,5703,17673
00160000,WESLEYAN COLLEGE                        ,GA,31210-4407,Private      ,5,46,51,395,512,907
00160100,UNIV OF WEST GEORGIA                    ,GA,30118-0002,Public       ,320,550,870,9715,5513,15228
00160200,GEORGIA COLLEGE & STATE UNIVERSITY      ,GA,31061-0490,Public       ,175,185,360,5568,2188,7756
00160400,YOUNG HARRIS COLLEGE                    ,GA,30582-4137,Private      ,28,10,38,927,87,1014
00348400,COVENANT COLLEGE                        ,GA,30750-4164,Private      ,32,46,78,1265,443,1708
00395600,DALTON STATE COLLEGE                    ,GA,30720-3797,Public       ,226,499,725,3536,4138,7674
00402400,GEORGIA NORTHWESTERN TECHNICAL COLLEGE  ,GA,30161-6757,Public       ,267,1050,1317,1676,5787,7463
00402403,NORTHWESTERN TECHNICAL COLLEGE          ,GA,30739-0569,Public       ,6,39,45,793,2441,3234
00411700,GRADY HEALTH SYSTEM                     ,GA,30303-3050,Public       ,7,51,58,83,419,502
00525400,LANIER TECHNICAL COLLEGE                ,GA,30566-3499,Public       ,103,601,704,997,3732,4729
00525500,MOULTRIE TECHNICAL COLLEGE              ,GA,31768-0000,Public       ,78,440,518,785,2878,3663
00525600,VALDOSTA TECHNICAL COLLEGE              ,GA,31603-0000,Public       ,156,650,806,1243,4188,5431
00551100,OKEFENOKEE TECHNICAL COLLEGE            ,GA,31501-4016,Public       ,84,261,345,486,1768,2254
00559900,AUGUSTA TECHNICAL COLLEGE               ,GA,30906-3399,Public       ,230,790,1020,2071,6807,8878
00560000,ATHENS TECHNICAL COLLEGE                ,GA,30601-1579,Public       ,266,870,1136,2457,6012,8469
00560100,ALBANY TECHNICAL COLLEGE                ,GA,31701-2648,Public       ,187,857,1044,1537,5980,7517
00561300,FLINT RIVER TECHNICAL INSTITUTE         ,GA,30286-0014,Public       ,25,161,186,227,1255,1482
00561401,WEST GEORGIA TECHNICAL COLLEGE - ROOSEVE,GA,31830-0268,Public       ,0,0,0,17,14,31
00561500,SOUTHWEST GEORGIA TECHNICAL COLLEGE     ,GA,31792-2622,Public       ,72,328,400,696,2536,3232
00561700,SOUTH GEORGIA TECHNICAL COLLEGE         ,GA,31709-8167,Public       ,99,312,411,1039,2351,3390
00561800,SAVANNAH TECHNICAL COLLEGE              ,GA,31405-5594,Public       ,310,1386,1696,2479,8774,11253
00561900,NORTH GEORGIA TECHNICAL COLLEGE         ,GA,30523-0000,Public       ,168,474,642,1253,2969,4222
00562000,CHATTAHOOCHEE TECHNICAL COLLEGE         ,GA,30060-3398,Public       ,544,1496,2040,3530,9200,12730
00562004,NORTH METRO TECHNICAL COLLEGE           ,GA,30102-3129,Public       ,58,186,244,1285,2807,4092
00562005,APPALACHIAN TECHNICAL COLLEGE           ,GA,30143-0000,Public       ,19,67,86,248,822,1070
00562100,GRIFFIN TECHNICAL COLLEGE               ,GA,30223-2097,Public       ,209,827,1036,1594,5688,7282
00562200,DEKALB TECHNICAL COLLEGE                ,GA,30021-0000,Public       ,273,1378,1651,2027,9149,11176
00562400,COLUMBUS TECHNICAL COLLEGE              ,GA,31904-6572,Public       ,175,700,875,1578,4913,6491
00576300,CENTRAL GEORGIA TECHNICAL COLLEGE       ,GA,31206-3628,Public       ,283,1328,1611,2123,9211,11334
00772800,MACON STATE COLLEGE                     ,GA,31206-5145,Public       ,181,589,770,3582,6029,9611
00854300,ATLANTA TECHNICAL COLLEGE               ,GA,30310-4499,Public       ,345,1450,1795,2343,8709,11052
00897600,CLAYTON STATE UNIVERSITY                ,GA,30260-0285,Public       ,270,995,1265,5108,9288,14396
00918300,EAST CENTRAL TECHNICAL COLLEGE          ,GA,31750-0000,Public       ,54,237,291,371,1572,1943
00927000,ART INSTITUTE OF ATLANTA                ,GA,30328-1649,Proprietary  ,627,908,1535,8007,6682,14689
00950700,GEORGIA HIGHLANDS COLLEGE               ,GA,30162-0000,Public       ,248,447,695,3243,3295,6538
01031903,MEDIX SCHOOL                            ,GA,30080-7630,Proprietary  ,41,223,264,294,1112,1406
01035601,EVEREST INSTITUTE - DEKALB              ,GA,30035-3420,Proprietary  ,112,433,545,432,1814,2246
01048700,WEST GEORGIA TECHNICAL COLLEGE          ,GA,30182-6476,Public       ,250,831,1081,2084,6073,8157
01048704,WEST GEORGIA TECHNICAL COLLEGE          ,GA,30240-5957,Public       ,68,241,309,707,1977,2684
01077100,GUPTON JONES COLLEGE                    ,GA,30035-4022,Private      ,11,53,64,145,407,552
01099700,EAST GEORGIA COLLEGE                    ,GA,30401-2699,Public       ,152,169,321,2498,1344,3842
01107400,BAINBRIDGE COLLEGE                      ,GA,39819-8400,Public       ,103,593,696,1319,4054,5373
01110901,EVEREST COLLEGE - EVEREST INSTITUTE     ,GA,30067-8340,Proprietary  ,42,250,292,177,1108,1285
01112301,EVEREST COLLEGE - EVEREST INSTITUTE- NOR,GA,30093-2813,Proprietary  ,55,269,324,246,1347,1593
01157400,BAUDER COLLEGE                          ,GA,30313-2439,Proprietary  ,79,222,301,846,1663,2509
01205100,PRO WAY HAIR SCHOOL                     ,GA,30083-2884,Proprietary  ,12,64,76,98,428,526
01216500,ATLANTA METROPOLITAN COLLEGE            ,GA,30310-4498,Public       ,269,670,939,2623,4826,7449
01303900,SOUTH UNIVERSITY                        ,GA,31406-4881,Proprietary  ,371,6007,6378,1833,26623,28456
02055000,WAYCROSS COLLEGE                        ,GA,31503-0000,Public       ,46,106,152,616,825,1441
02060900,BROWN CLG OF COURT REPORTING & M.T.     ,GA,30318-2570,Proprietary  ,2,61,63,35,429,464
02074800,LIFE UNIVERSITY                         ,GA,30060-0000,Private      ,21,120,141,358,2415,2773
02089700,HERZING COLLEGE                         ,GA,30326-1332,Proprietary  ,41,260,301,297,1435,1732
02110501,ART INSTITUTE OF CHARLOTTE (THE) - BROWN,GA,30319-3054,Proprietary  ,6,24,30,93,117,210
02113604,AMERICAN INTERCONTINENTAL UNIV - DUNWOOD,GA,30328-1649,Proprietary  ,0,0,0,98,284,382
02113613,AMERICAN INTERCONTINENTAL UNIVERSITY    ,GA,30328-1649,Proprietary  ,115,576,691,224,980,1204
02116000,SANFORD-BROWN COLLEGE                   ,GA,30328-4803,Proprietary  ,53,322,375,342,2066,2408
02141500,SAVANNAH COLLEGE OF ART & DESIGN        ,GA,31402-3146,Private      ,281,295,576,9196,4251,13447
02202800,AUGUSTA AREA DIET INTERN UNIV HOSP      ,GA,30901-0000,Private      ,1,2,3,5,33,38
02205300,SAVANNAH RIVER COLLEGE                  ,GA,30909-0000,Proprietary  ,0,0,0,19,84,103
02217200,PORTFOLIO CENTER                        ,GA,30309-0000,Proprietary  ,2,18,20,16,151,167
02263105,ANTHEM COLLEGE - HIGH-TECH INSTITUTE - M,GA,30324-3398,Proprietary  ,0,0,0,10,28,38
02266200,AMERICAN PROFESSIONAL INSTITUTE         ,GA,31201-0000,Proprietary  ,81,363,444,324,1963,2287
02279500,HEART OF GEORGIA TECHNICAL COLLEGE      ,GA,31021-0000,Public       ,55,234,289,528,1672,2200
02284300,INTERACTIVE COLLEGE OF TECHNOLOGY       ,GA,30341-0000,Proprietary  ,68,470,538,235,1921,2156
02284308,INTERACTIVE LEARNING SYSTEMS            ,GA,30260-0000,Proprietary  ,15,91,106,47,324,371
02284309,INTERACTIVE COLLEGE OF TECHNOLOGY       ,GA,30501-0000,Proprietary  ,5,69,74,32,315,347
02285500,"CREATIVE CIRCUS, THE                    ",GA,30324-0000,Proprietary  ,19,44,63,84,269,353
02288400,GWINNETT TECHNICAL INSTITUTE            ,GA,30043-5702,Public       ,360,1247,1607,3148,9079,12227
02313902,WESTWOOD COLLEGE - O'HARE AIRPORT - ATLA,GA,30345-2807,Proprietary  ,40,130,170,359,807,1166
02321400,ROFFLER-MOLER HAIRSTYLING COLLEGE       ,GA,30062-0000,Proprietary  ,9,41,50,37,188,225
02354500,SOUTHEASTERN BEAUTY SCHOOLS             ,GA,31906-0000,Proprietary  ,8,37,45,20,107,127
02482100,MOREHOUSE SCHOOL OF MEDICINE            ,GA,30310-0000,Private      ,11,22,33,121,643,764
02502700,ADVANCED CAREER TRAINING                ,GA,30329-0000,Proprietary  ,49,287,336,195,1214,1409
02502701,ADVANCED CAREER TRAINING-RIVERDALE      ,GA,30274-0000,Proprietary  ,45,226,271,203,878,1081
02508600,MIDDLE GEORGIA TECHNICAL COLLEGE        ,GA,31088-0000,Public       ,113,494,607,984,3247,4231
02520000,INTERNATIONAL SCH SKIN & NAILCARE       ,GA,30342-1119,Proprietary  ,7,104,111,33,339,372
02577000,ARNOLD / PADRICKS  UNIV OF COSM         ,GA,30297-0000,Proprietary  ,16,66,82,82,254,336
02577700,BEAUTY COLLEGE OF AMERICA               ,GA,30297-0000,Proprietary  ,7,20,27,34,113,147
02578300,INTERNATIONAL CITY BEAUTY COLLEGE       ,GA,31093-3631,Proprietary  ,2,9,11,11,32,43
02580200,ATLANTA SCHOOL OF MASSAGE               ,GA,30338-0000,Proprietary  ,12,85,97,78,350,428
02583000,GWINNETT COLLEGE OF BUSINESS            ,GA,30047-3447,Proprietary  ,16,87,103,140,724,864
02607600,CAPELLI LEARNING CTR FOR COSM           ,GA,30324-0000,Proprietary  ,19,42,61,84,276,360
03005400,ARTISTIC BEAUTY COLLEGE                 ,GA,30013-2076,Proprietary  ,76,207,283,322,834,1156
03022601,WESTERN CULINARY INSTITUTE - LE CORDON B,GA,30084-5893,Proprietary  ,26,58,84,212,323,535
03030000,OGEECHEE TECHNICAL COLLEGE              ,GA,30458-8049,Public       ,142,431,573,1297,3105,4402
03032100,ALTAMAHA TECHNICAL COLLEGE              ,GA,31545-4465,Public       ,60,283,343,440,1713,2153
03042700,LAURUSTECHNICAL INSTITUTE               ,GA,30030-1506,Proprietary  ,19,131,150,84,607,691
03066500,SOUTHEASTERN TECHNICAL COLLEGE          ,GA,30474-8817,Public       ,58,278,336,491,1773,2264
03066502,SWAINSBORO TECHNICAL COLLEGE            ,GA,30401-5700,Public       ,5,32,37,199,678,877
03072304,EVEREST COLLEGE - EVEREST INSTITUTE     ,GA,30236-0000,Proprietary  ,58,294,352,263,1376,1639
03076300,BEULAH HEIGHTS BIBLE COLLEGE            ,GA,30316-1873,Private      ,1,60,61,45,796,841
03079202,WESTWOOD COLLEGE - ATLANTA MIDTOWN      ,GA,30309-2848,Proprietary  ,87,254,341,758,1516,2274
03081500,SOUTHEASTERN BEAUTY SCHOOL              ,GA,31917-0000,Proprietary  ,4,17,21,16,103,119
03089100,GEORGIA INSTITUTE OF COSMETOLOGY        ,GA,30606-3152,Proprietary  ,25,66,91,122,335,457
03090600,COBB BEAUTY COLLEGE                     ,GA,30144-2828,Proprietary  ,8,26,34,25,82,107
03100900,LUTHER RICE UNIVERSITY                  ,GA,30038-2454,Private      ,3,82,85,32,742,774
03102000,RIVERTOWN SCHOOL OF BEAUTY              ,GA,31904-4747,Proprietary  ,6,44,50,35,171,206
03104500,ATLANTA INSTITUTE OF MUSIC              ,GA,30096-4988,Proprietary  ,38,42,80,232,207,439
03116100,VOGUE BEAUTY SCHOOL                     ,GA,30141-2226,Proprietary  ,8,31,39,37,129,166
03155500,SANDERSVILLE REGIONAL TECH INST         ,GA,31082-6179,Public       ,35,165,200,252,925,1177
03173300,ATLANTA'S JOHN MARSHALL LAW SCHOOL      ,GA,30309-0000,Proprietary  ,3,21,24,19,1311,1330
03232304,LINCOLN COLLEGE OF TECHNOLOGY           ,GA,30067-8638,Proprietary  ,38,140,178,197,626,823
03251300,BEACON UNIVERSITY                       ,GA,31909-4663,Private      ,0,5,5,15,108,123
03418300,GWINNETT COLLEGE-SANDY SPRINGS          ,GA,30328-3161,Proprietary  ,8,55,63,33,254,287
03445500,FAYETTE BEAUTY ACADEMY                  ,GA,30214-1191,Proprietary  ,0,10,10,16,76,92
03523300,AVIATION INSTITUTE OF MAINTENANCE       ,GA,30045-6716,Proprietary  ,31,99,130,207,711,918
03753400,MICHAEL'S SCHOOL OF BEAUTY              ,GA,31211-1493,Proprietary  ,3,18,21,31,141,172
03804400,JAVELIN TECHNICAL TRAINING CENTER       ,GA,30339-6040,Proprietary  ,90,424,514,401,1824,2225
03804401,JAVELIN TECHNICAL TRAINING CENTER -     ,GA,30260-1756,Proprietary  ,2,19,21,13,124,137
03804402,JAVELIN TECHNICAL TRAINING CENTER -     ,GA,30084-5252,Proprietary  ,1,9,10,16,84,100
03812300,OMNITECH INSTITUTE                      ,GA,30035-1206,Proprietary  ,23,114,137,149,500,649
04021300,AUGUSTA SCHOOL OF MASSAGE               ,GA,30809-0000,Proprietary  ,0,9,9,13,53,66
04091300,SAVANNAH SCHOOL OF MASSAGE THERAPY      ,GA,31406-2711,Private      ,3,13,16,12,58,70
04126800,ACADEMY OF SOMATIC HEALING ARTS (ASHA)  ,GA,30071-1024,Proprietary  ,7,51,58,30,202,232
04128500,SOUTHERN CATHOLIC COLLEGE               ,GA,30534-3111,Private      ,2,1,3,171,21,192
04142900,GEORGIA GWINNETT COLLEGE                ,GA,30043-7409,Public       ,195,351,546,1886,2087,3973
04147000,PAUL MITCHELL THE SCHOOL ATLANTA        ,GA,30318-5241,Proprietary  ,24,51,75,146,288,434
04147700,LAKE LANIER SCHOOL OF MASSAGE           ,GA,30501-4546,Proprietary  ,1,13,14,6,42,48
04149900,PROFILE INSTITUTE OF BARBER-STYLING     ,GA,30315-8459,Proprietary  ,11,32,43,14,40,54
04150900,PROCESS INSTITUTE OF COSMETOLOGY (THE)  ,GA,30043-7344,Proprietary  ,14,20,34,29,36,65
04152300,GEORGIA BEAUTY ACADEMY                  ,GA,30721-3952,Proprietary  ,2,28,30,7,49,56
        ,CHICAGO THEOLOGICAL SEMINARY            ,IL,60637-0000,Private      ,0,0,0,0,4,4
00162800,AMERICAN ACADEMY OF ART                 ,IL,60604-4302,Proprietary  ,26,19,45,622,165,787
00163300,AUGUSTANA COLLEGE                       ,IL,61201-2296,Private      ,34,13,47,3655,166,3821
00163400,AURORA UNIVERSITY                       ,IL,60506-4892,Private      ,57,222,279,2448,2618,5066
00163600,SOUTHWESTERN ILLINOIS COLLEGE           ,IL,62221-5899,Public       ,399,1128,1527,3923,7017,10940
00163800,BLACK HAWK COLLEGE                      ,IL,61265-5899,Public       ,170,497,667,2019,3152,5171
00163900,BLACKBURN COLLEGE                       ,IL,62626-1498,Private      ,10,9,19,823,159,982
00164000,PRAIRIE STATE COLLEGE                   ,IL,60411-8226,Public       ,187,582,769,2347,4427,6774
00164100,BRADLEY UNIVERSITY                      ,IL,61625-0002,Private      ,69,61,130,6701,1123,7824
00164300,SPOON RIVER COLLEGE                     ,IL,61520-8907,Public       ,35,117,152,730,854,1584
00164700,CITY COLLEGES OF CHICAGO                ,IL,60606-6998,Public       ,11,81,92,462,763,1225
00164800,TRUMAN COLLEGE                          ,IL,60640-5691,Public       ,178,683,861,2866,5168,8034
00164900,RICHARD J DALEY COLLEGE                 ,IL,60652-1299,Public       ,157,525,682,2555,4297,6852
00165000,CITY COLLEGES OF CHICAGO-MALCOLM X      ,IL,60612-3197,Public       ,171,794,965,2677,6405,9082
00165200,HAROLD WASHINGTON COLLEGE               ,IL,60601-2403,Public       ,420,955,1375,5495,6995,12490
00165400,KENNEDY KING COLLEGE                    ,IL,60621-3798,Public       ,274,1381,1655,3576,9733,13309
00165500,WRIGHT COLLEGE                          ,IL,60634-1591,Public       ,282,646,928,4728,5436,10164
00165700,MIDWESTERN UNIVERSITY                   ,IL,60515-1200,Private      ,1,23,24,112,2732,2844
00165900,ROSALIND FRANKLIN UNIVERSITY OF MEDICINE,IL,60064-3095,Private      ,0,33,33,18,2106,2124
00166100,CHICAGO THEOLOGICAL SEMINARY            ,IL,60637-0000,Private      ,0,8,8,5,162,167
00166300,SPERTUS COLLEGE                         ,IL,60605-1995,Private      ,0,21,21,1,100,101
00166400,UNIVERSITY OF ST FRANCIS                ,IL,60435-6188,Private      ,29,170,199,1491,1816,3307
00166500,COLUMBIA COLLEGE                        ,IL,60605-1996,Private      ,390,362,752,12927,5105,18032
00166600,CONCORDIA UNIVERSITY                    ,IL,60305-1499,Private      ,29,401,430,1965,3602,5567
00166900,DANVILLE AREA COMMUNITY COLLEGE         ,IL,61832-5199,Public       ,62,256,318,904,1995,2899
00167100,DEPAUL UNIVERSITY                       ,IL,60604-2287,Private      ,329,1136,1465,16558,15795,32353
00167400,EASTERN ILLINOIS UNIVERSITY             ,IL,61920-3099,Public       ,230,219,449,10514,3587,14101
00167500,ELGIN COMMUNITY COLLEGE                 ,IL,60123-7193,Public       ,286,674,960,3152,3993,7145
00167600,ELMHURST COLLEGE                        ,IL,60126-3296,Private      ,57,66,123,3578,1087,4665
00167800,EUREKA COLLEGE                          ,IL,61530-9976,Private      ,13,14,27,971,237,1208
00168100,HIGHLAND COMMUNITY COLLEGE              ,IL,61032-9341,Public       ,76,200,276,908,1309,2217
00168200,GARRETT-EVANGELICAL THEOLOGICAL SEM     ,IL,60201-0000,Private      ,0,16,16,0,207,207
00168400,GREENVILLE COLLEGE                      ,IL,62246-1199,Private      ,23,62,85,1557,823,2380
00168500,HEBREW THEOLOGICAL COLLEGE              ,IL,60077-3263,Private      ,6,2,8,346,21,367
00168800,ILLINOIS COLLEGE                        ,IL,62650-2299,Private      ,15,4,19,1385,94,1479
00168900,ILLINOIS COLLEGE OF OPTOMETRY           ,IL,60616-3878,Private      ,0,4,4,9,665,674
00169100,ILLINOIS INSTITUTE OF TECHNOLOGY        ,IL,60616-0000,Private      ,50,159,209,2698,2197,4895
00169103,CHICAGO KENT COLLEGE OF LAW             ,IL,60661-0000,Private      ,0,34,34,18,2312,2330
00169200,ILLINOIS STATE UNIVERSITY               ,IL,61790-1000,Public       ,343,258,601,18677,4803,23480
00169300,NORTHEASTERN ILLINOIS UNIV              ,IL,60625-4699,Public       ,225,591,816,5766,7290,13056
00169400,CHICAGO STATE UNIVERSITY                ,IL,60628-1598,Public       ,160,799,959,6077,11282,17359
00169600,ILLINOIS WESLEYAN UNIVERSITY            ,IL,61701-0000,Private      ,32,16,48,3134,130,3264
00169800,JOHN MARSHALL LAW SCHOOL                ,IL,60604-0000,Private      ,0,140,140,17,2619,2636
00169900,JOLIET JUNIOR COLLEGE                   ,IL,60431-8938,Public       ,501,967,1468,5785,6289,12074
00170000,JUDSON UNIVERSITY                       ,IL,60123-1498,Private      ,10,70,80,882,830,1712
00170100,KASKASKIA COLLEGE                       ,IL,62801-7878,Public       ,102,425,527,1441,2590,4031
00170300,KENDALL COLLEGE                         ,IL,60622-4278,Proprietary  ,73,320,393,1175,2379,3554
00170400,KNOX COLLEGE                            ,IL,61401-4999,Private      ,13,6,19,2221,109,2330
00170500,ILLINOIS VALLEY COMMUNITY COLLEGE       ,IL,61348-9692,Public       ,76,290,366,1331,1888,3219
00170600,LAKE FOREST COLLEGE                     ,IL,60045-2399,Private      ,23,7,30,1785,138,1923
00170700,LEWIS UNIVERSITY                        ,IL,60446-2200,Private      ,89,296,385,3989,3150,7139
00170800,LINCOLN CHRISTIAN UNIVERSITY            ,IL,62656-2167,Private      ,13,44,57,465,579,1044
00170900,LINCOLN COLLEGE                         ,IL,62656-1699,Private      ,46,51,97,1273,612,1885
00171000,LOYOLA UNIVERSITY CHICAGO               ,IL,60626-0000,Private      ,204,527,731,16540,10650,27190
00171002,LOYOLA STRITCH SCHOOL OF MEDICINE       ,IL,60153-0000,Private      ,1,6,7,34,535,569
00171200,LUTHERAN SCHOOL OF THEOL AT CHICAGO     ,IL,60615-0000,Private      ,0,2,2,0,151,151
00171600,MACCORMAC COLLEGE                       ,IL,60602-4405,Private      ,1,22,23,47,164,211
00171700,MACMURRAY COLLEGE                       ,IL,62650-2590,Private      ,7,19,26,573,233,806
00172100,MCCORMICK THEOLOGICAL SEMINARY          ,IL,60615-5108,Private      ,0,11,11,1,153,154
00172200,MCKENDREE UNIVERSITY                    ,IL,62254-1299,Private      ,26,162,188,1706,1572,3278
00172300,MEADVILLE LOMBARD THEOLOGICAL SCHOOL    ,IL,60637-1602,Private      ,0,4,4,0,73,73
00172400,MILLIKIN UNIVERSITY                     ,IL,62522-2084,Private      ,31,73,104,2776,854,3630
00172500,MONMOUTH COLLEGE                        ,IL,61462-1963,Private      ,21,10,31,1949,127,2076
00172700,MOODY BIBLE INSTITUTE                   ,IL,60610-3214,Private      ,1,1,2,1,1,2
00172800,MORTON COLLEGE                          ,IL,60804-4398,Public       ,139,265,404,1815,2035,3850
00173200,NATIONAL UNIV OF HEALTH SCIENCES        ,IL,60148-4583,Private      ,4,53,57,51,939,990
00173300,NATIONAL-LOUIS UNIVERSITY               ,IL,60603-3032,Private      ,21,778,799,344,7226,7570
00173400,NORTH CENTRAL COLLEGE                   ,IL,60540-4690,Private      ,38,57,95,3164,885,4049
00173500,NORTH PARK UNIVERSITY                   ,IL,60625-4895,Private      ,42,148,190,2461,1560,4021
00173600,NORTHERN BAPTIST THEOL SEMINARY         ,IL,60148-0000,Private      ,0,2,2,1,17,18
00173700,NORTHERN ILLINOIS UNIVERSITY            ,IL,60115-2854,Public       ,469,637,1106,21030,9816,30846
00173900,NORTHWESTERN UNIV                       ,IL,60208-0001,Private      ,167,475,642,16524,11001,27525
00174100,OLIVET NAZARENE UNIVERSITY              ,IL,60914-2271,Private      ,38,309,347,3219,2228,5447
00174200,IL EASTERN COMM COLGS-OLNEY CENTRAL     ,IL,62450-1099,Public       ,42,127,169,724,946,1670
00174500,QUINCY UNIVERSITY                       ,IL,62301-2699,Private      ,10,81,91,1394,1059,2453
00174600,ROBERT MORRIS UNIVERSITY ILLINOIS       ,IL,60605-1225,Private      ,144,504,648,4673,5670,10343
00174700,ROCK VALLEY COLLEGE                     ,IL,61114-5699,Public       ,296,1083,1379,3141,5567,8708
00174800,ROCKFORD COLLEGE                        ,IL,61108-2393,Private      ,29,126,155,985,1197,2182
00174900,ROOSEVELT UNIVERSITY                    ,IL,60605-1394,Private      ,122,565,687,4364,7677,12041
00175000,DOMINICAN UNIVERSITY                    ,IL,60305-1066,Private      ,34,165,199,2365,2021,4386
00175200,SAUK VALLEY COMMUNITY COLLEGE           ,IL,61021-9112,Public       ,85,233,318,1111,1393,2504
00175300,SCHOOL OF ART INSTITUTE OF CHICAGO      ,IL,60603-3013,Private      ,93,117,210,3344,2527,5871
00175400,SEABURY-WESTERN THEO SEMINARY           ,IL,60201-0000,Private      ,0,0,0,0,7,7
00175600,SHIMER COLLEGE                          ,IL,60616-3893,Private      ,1,9,10,154,78,232
00175700,SOUTHEASTERN ILLINOIS COLLEGE           ,IL,62946-4925,Public       ,32,160,192,674,930,1604
00175800,SOUTHERN ILL UNIV-CARBONDALE            ,IL,62901-0000,Public       ,288,492,780,14720,8433,23153
00175900,SOUTHERN ILL UNIV-EDWARDSVILLE          ,IL,62026-1060,Public       ,242,384,626,10529,5816,16345
00175924,SO IL UNIV-SCHL OF DENTAL MEDICINE      ,IL,62002-0000,Public       ,0,3,3,10,192,202
00176100,SPRINGFIELD COLLEGE IN ILLINOIS         ,IL,62702-2694,Private      ,23,62,85,449,614,1063
00176500,UNIVERSITY OF ST MARY OF THE LAKE       ,IL,60060-0000,Private      ,0,3,3,3,16,19
00176700,BENEDICTINE UNIVERSITY                  ,IL,60532-0900,Private      ,51,413,464,2536,3686,6222
00176800,ST XAVIER UNIVERSITY                    ,IL,60655-3199,Private      ,87,294,381,3942,3571,7513
00176900,SOUTH SUBURBAN COLLEGE                  ,IL,60473-9978,Public       ,251,1018,1269,2837,7321,10158
00177100,TRINITY CHRISTIAN COLLEGE               ,IL,60463-0929,Private      ,35,86,121,1213,907,2120
00177200,TRINITY INTERNATIONAL UNIVERSITY        ,IL,60015-1283,Private      ,11,64,75,829,1234,2063
00177300,TRITON COLLEGE                          ,IL,60171-1995,Public       ,254,657,911,3619,5061,8680
00177400,UNIVERSITY OF CHICAGO                   ,IL,60637-1476,Private      ,215,164,379,10328,2640,12968
00177401,UNIV OF CHICAGO PRITZKER SCH OF MED     ,IL,60637-0000,Private      ,3,4,7,38,547,585
00177403,"UNIV OF CHICAGO, GRAD SCH OF BUS        ",IL,60637-0000,Private      ,3,94,97,35,1379,1414
00177405,UNIVERSITY OF CHICAGO GRADUATE          ,IL,60637-0000,Private      ,7,134,141,88,5837,5925
00177500,UNIV OF ILLINOIS @ URBANA-CHAMPAIGN     ,IL,61820-5796,Public       ,328,345,673,26659,9121,35780
00177600,UNIV OF ILLINOIS AT CHICAGO             ,IL,60607-7163,Public       ,420,812,1232,19380,15585,34965
00177800,VANDERCOOK COLLEGE OF MUSIC             ,IL,60616-3731,Private      ,0,5,5,154,87,241
00177900,IL EASTERN COMM COLGS-WABASH VALLEY     ,IL,62863-2699,Public       ,33,158,191,530,677,1207
00178000,WESTERN ILLINOIS UNIVERSITY             ,IL,61455-1390,Public       ,244,279,523,10456,4006,14462
00178100,WHEATON COLLEGE                         ,IL,60187-5535,Private      ,34,42,76,2668,641,3309
00178300,WORSHAM COLLEGE OF MORTUARY SCIENCE     ,IL,60090-2646,Proprietary  ,5,15,20,63,119,182
00396100,HARPER COLLEGE                          ,IL,60067-7398,Public       ,308,627,935,4828,4431,9259
00418100,ADVOCATE TRINITY HOSPITAL SCHOOL OF RADI,IL,60617-3982,Private      ,1,17,18,22,94,116
00456000,GEM CITY COLLEGE                        ,IL,62301-4949,Proprietary  ,0,10,10,18,49,67
00456800,MIDSTATE COLLEGE                        ,IL,61614-3558,Proprietary  ,10,122,132,70,957,1027
00457100,SPARKS COLLEGE                          ,IL,62565-2241,Proprietary  ,0,0,0,5,17,22
00512732,BROWN MACKIE COLLEGE-CINCINNATI - BROWN ,IL,61265-7062,Proprietary  ,3,22,25,13,83,96
00621400,BLESSING RIEMAN COLLEGE OF NURSING      ,IL,62301-0000,Private      ,0,3,3,69,69,138
00621401,BLESSING HOSP SCH MED LAB TECH          ,IL,62301-0000,Private      ,0,1,1,2,11,13
00621402,BLESSING HOSP SCH OF RAD TECH           ,IL,62301-2852,Private      ,0,4,4,12,19,31
00621403,BLESSING HOSPITAL - COLLEGE OF NURSING  ,IL,62305-7005,Private      ,0,3,3,16,21,37
00622501,TRINITY COLLEGE OF NURSING & HEALTH SCIE,IL,61201-5317,Private      ,0,11,11,75,215,290
00622800,METHODIST MED CTR OF ILL SCH NRSNG      ,IL,61636-0000,Private      ,5,19,24,117,244,361
00624000,ST FRANCIS MED CLG OF NRSG              ,IL,61603-3783,Private      ,1,19,20,158,354,512
00665600,COLLEGE OF DUPAGE                       ,IL,60137-6599,Public       ,550,1149,1699,7514,7688,15202
00675300,ILLINOIS CENTRAL COLLEGE                ,IL,61635-0001,Public       ,269,855,1124,4119,5935,10054
00693100,WAUBONSEE COMMUNITY COLLEGE             ,IL,60554-0000,Public       ,174,508,682,2146,3193,5339
00711800,PARKLAND COLLEGE                        ,IL,61821-1899,Public       ,264,528,792,4108,4000,8108
00711900,REND LAKE COLLEGE                       ,IL,62846-9801,Public       ,74,254,328,1309,1739,3048
00717000,LINCOLN LAND COMMUNITY COLLEGE          ,IL,62794-9256,Public       ,195,615,810,2398,4009,6407
00726500,CARL SANDBURG COLLEGE                   ,IL,61401-9576,Public       ,65,243,308,988,1773,2761
00754900,COYNE AMERICAN INSTITUTE                ,IL,60607-1300,Proprietary  ,62,270,332,379,1341,1720
00764400,LAKE LAND COLLEGE                       ,IL,61938-9366,Public       ,112,402,514,2352,2746,5098
00768400,KISHWAUKEE COLLEGE                      ,IL,60150-9699,Public       ,133,287,420,1817,1945,3762
00769000,KANKAKEE COMMUNITY COLLEGE              ,IL,60901-6505,Public       ,108,429,537,1314,2649,3963
00769100,MCHENRY COUNTY COLLEGE                  ,IL,60012-2761,Public       ,148,344,492,2946,2030,4976
00769200,MORAINE VALLEY COMMUNITY COLLEGE        ,IL,60465-0937,Public       ,349,713,1062,4987,4736,9723
00769300,SHAWNEE COMMUNITY COLLEGE               ,IL,62992-9725,Public       ,52,195,247,782,1528,2310
00769400,COLLEGE OF LAKE COUNTY                  ,IL,60030-1198,Public       ,298,814,1112,3574,4912,8486
00793700,MS ROBERTS ACADEMY OF BEAUTY CULT       ,IL,60181-2930,Proprietary  ,3,16,19,24,56,80
00807600,JOHN A LOGAN COLLEGE                    ,IL,62918-2500,Public       ,133,356,489,2201,2806,5007
00814604,EVEREST UNIVERSITY - EVEREST  COLLEGE   ,IL,60803-4517,Proprietary  ,53,277,330,196,1161,1357
00825900,EDUCATORS OF BEAUTY                     ,IL,61081-3611,Proprietary  ,3,14,17,59,146,205
00825901,EDUCATORS OF BEAUTY                     ,IL,61104-0000,Proprietary  ,1,16,17,15,47,62
00832800,ALVAREITA'S COLLEGE OF COSMETOLOGY      ,IL,62025-2041,Proprietary  ,7,22,29,44,91,135
00854500,ROCKFORD BUSINESS COLLEGE               ,IL,61103-0000,Proprietary  ,28,157,185,205,1077,1282
00869402,RASMUSSEN COLLEGE - ROCKFORD            ,IL,61108-2513,Proprietary  ,56,241,297,325,1395,1720
00869403,RASMUSSEN COLLEGE - AURORA              ,IL,60506-6219,Proprietary  ,33,131,164,135,518,653
00869404,RASMUSSEN COLLEGE - ROMEOVILLE          ,IL,60446-0000,Proprietary  ,15,73,88,25,124,149
00888000,MORRISON INSTITUTE OF TECHNOLOGY        ,IL,61270-2959,Private      ,3,4,7,125,36,161
00893800,GRAHAM HOSPITAL SCH OF NURSING          ,IL,61520-2497,Private      ,0,2,2,26,65,91
00893900,CANNELLA SCHOOL OF HAIR DESIGN          ,IL,60406-2130,Proprietary  ,10,42,52,31,146,177
00914500,GOVERNORS STATE UNIVERSITY              ,IL,60466-0975,Public       ,39,473,512,893,6010,6903
00923200,CATHOLIC THEOLOGICAL UNION              ,IL,60615-0000,Private      ,0,3,3,0,70,70
00933300,UNIV OF ILLINOIS AT SPRINGFIELD         ,IL,62703-5407,Public       ,44,244,288,1983,2932,4915
00947500,EDUCATORS OF BEAUTY                     ,IL,61301-2404,Proprietary  ,4,6,10,24,46,70
00959500,CANNELLA SCHOOL OF HAIR DESIGN          ,IL,60617-4303,Proprietary  ,6,36,42,27,147,174
00976700,OLIVE-HARVEY COLLEGE                    ,IL,60628-1696,Public       ,99,523,622,1491,4066,5557
00978600,IL EASTERN COMM COLGS-LINCOLN TRAIL     ,IL,62454-5708,Public       ,20,65,85,359,492,851
00980000,RUSH UNIVERSITY                         ,IL,60612-3806,Private      ,7,86,93,139,2342,2481
00989600,OAKTON COMMUNITY COLLEGE                ,IL,60016-1268,Public       ,202,357,559,3074,2883,5957
00998700,SAINT ANTHONY COLLEGE OF NURSING        ,IL,61108-2468,Private      ,3,29,32,102,241,343
01002000,LEWIS AND CLARK COMMUNITY COLLEGE       ,IL,62035-2466,Public       ,149,413,562,2079,3008,5087
01031600,LINCOLN COLLEGE OF TECHNOLOGY           ,IL,60160-1605,Proprietary  ,121,230,351,1018,1379,2397
01050100,LAKEVIEW  COLLEGE OF NURSING            ,IL,61832-3781,Private      ,10,11,21,153,201,354
01069500,TRI-COUNTY BEAUTY ACADEMY               ,IL,62056-2036,Proprietary  ,3,6,9,16,45,61
01071000,CAPITAL AREA SCH OF PRAC NRSG           ,IL,62707-0000,Public       ,2,54,56,54,479,533
01072700,DEVRY UNIVERSITY                        ,IL,60618-5994,Proprietary  ,2113,12030,14143,21691,80107,101798
01083600,PIVOT POINT INTNL CSMTLGY RSRCH CTR     ,IL,60626-0000,Proprietary  ,43,88,131,343,541,884
01087900,RICHLAND COMMUNITY COLLEGE              ,IL,62521-8513,Public       ,91,374,465,962,2084,3046
01102401,EVEREST COLLEGE - CHICAGO               ,IL,60604-2052,Proprietary  ,97,425,522,625,2230,2855
01151002,EVEREST INSTITUTE - EVEREST COLLEGE     ,IL,60542-1610,Proprietary  ,26,170,196,114,639,753
01181000,TAYLOR BUSINESS INSTITUTE               ,IL,60606-5111,Proprietary  ,5,48,53,39,304,343
01185800,EVEREST COLLEGE                         ,IL,60077-1074,Proprietary  ,67,265,332,292,1134,1426
01185802,EVEREST COLLEGE - BURR RIDGE            ,IL,60527-7826,Proprietary  ,49,212,261,179,792,971
01236200,NORTHWESTERN COLLEGE                    ,IL,60630-2298,Proprietary  ,90,412,502,1383,3861,5244
01238500,BLOOMINGTON-NORMAL SCH RADIOGRAPHY      ,IL,61761-4604,Private      ,0,5,5,8,21,29
01258400,ILLINOIS INSTITUTE OF ART (THE)         ,IL,60654-1593,Proprietary  ,318,529,847,5073,4018,9091
01281300,JOHN WOOD COMMUNITY COLLEGE             ,IL,62305-0401,Public       ,67,247,314,1230,1716,2946
01308700,CAPRI GARFIELD RIDGE SCH OF BTY CLR     ,IL,60629-1613,Proprietary  ,9,19,28,78,200,278
01308800,CAPRI OAK FOREST COLLEGE OF BEAUTY      ,IL,60452-2798,Proprietary  ,17,32,49,131,196,327
02055200,HARRINGTON COLLEGE OF DESIGN            ,IL,60606-3433,Proprietary  ,55,114,169,695,917,1612
02068100,ADLER SCH OF PROFESSIONAL PSYCHLGY      ,IL,60601-0000,Private      ,2,29,31,16,972,988
02069300,VATTEROTT COLLEGE                       ,IL,62305-5938,Proprietary  ,30,118,148,136,708,844
02073200,TELSHE YESHIVA-CHICAGO                  ,IL,60625-0000,Private      ,1,0,1,35,8,43
02074400,IL EASTERN COMM COLGS-FRONTIER          ,IL,62837-0000,Public       ,14,69,83,161,482,643
02075400,KELLER GRADUATE SCHOOL OF MGMT.         ,IL,60515-5683,Proprietary  ,2,2105,2107,35,16668,16703
02113600,AMERICAN INTERCONTINENTAL UNIVERSITY    ,IL,60192-3713,Proprietary  ,437,7487,7924,3344,41405,44749
02117400,BECK AREA CAREER CENTER                 ,IL,62278-0000,Public       ,2,21,23,19,147,166
02124400,UNIVERSITY OF SPA & COSMETOLOGY ART     ,IL,62704-0000,Proprietary  ,8,38,46,88,202,290
02150600,COSMETOLOGY AND SPA INSTITUTE (THE)     ,IL,60014-4003,Proprietary  ,4,27,31,95,177,272
02155300,THE CHICAGO SCHOOL OF PROF PSYCHOLOGY   ,IL,60610-4705,Private      ,2,284,286,37,3680,3717
02160300,INTERNATIONAL ACAD OF DESIGN & TECH     ,IL,60602-3319,Proprietary  ,62,155,217,1172,1501,2673
02160304,INTERNATIONAL ACADEMY OF DESIGN AND TECH,IL,60173-5160,Proprietary  ,15,59,74,183,312,495
02168600,EAST WEST UNIVERSITY                    ,IL,60605-0000,Private      ,32,105,137,1017,1514,2531
02179900,ARGOSY UNIVERSITY                       ,IL,60601-7757,Proprietary  ,271,4758,5029,1631,32267,33898
02185400,ST AUGUSTINE COLLEGE                    ,IL,60640-0000,Private      ,25,179,204,411,1847,2258
02192400,MR JOHNS SCHOOL OF COSMETOLOGY          ,IL,62521-0000,Proprietary  ,7,21,28,24,91,115
02202600,CANNELLA SCHOOL OF HAIR DESIGN          ,IL,60181-1321,Proprietary  ,0,16,16,7,75,82
02214100,WEST SUBURBAN COLLEGE OF NURSING        ,IL,60302-2519,Private      ,6,21,27,109,394,503
02228100,MAC DANIEL'S BEAUTY SCHOOL              ,IL,60640-0000,Proprietary  ,0,16,16,18,64,82
02261200,HAIR PROFESSIONALS ACAD COSMETOLOGY     ,IL,60118-0000,Proprietary  ,26,39,65,97,213,310
02261201,HAIR PROFESSIONALS ACADEMY OF COSMETOLOG,IL,60118-9333,Proprietary  ,0,0,0,6,6,12
02262100,HAIR PROFESSIONALS SCH COSMETOLOGY      ,IL,60543-0000,Proprietary  ,8,19,27,43,78,121
02291200,CANNELLA SCHOOL OF HAIR DESIGN          ,IL,60639-0000,Proprietary  ,4,31,35,36,160,196
02295500,CANNELLA SCHOOL OF HAIR DESIGN          ,IL,60120-0000,Proprietary  ,2,7,9,17,82,99
02297500,OEHRLEIN SCHOOL OF COSMETOLOGY          ,IL,61611-0000,Proprietary  ,9,22,31,61,95,156
02312300,LA' JAMES COLLEGE HAIRSTYLING           ,IL,61244-0000,Proprietary  ,2,16,18,15,50,65
02313900,WESTWOOD COLLEGE - O'HARE AIRPORT       ,IL,60631-2801,Proprietary  ,77,186,263,737,1161,1898
02317300,CONCEPT COLLEGE OF COSMETOLOGY          ,IL,61832-0000,Proprietary  ,6,30,36,39,110,149
02319200,LAKE FOREST GRAD SCHL OF MGMT           ,IL,60045-4824,Private      ,0,55,55,2,359,361
02323300,PROFESSIONAL'S CHOICE HAIR DSN ACAD     ,IL,60435-0000,Proprietary  ,1,8,9,17,34,51
02332200,HAIR PROFESSIONALS CAREER COLLEGE       ,IL,60178-0000,Proprietary  ,5,14,19,30,53,83
02337800,THE COLLEGE OF OFFICE TECHNOLOGY        ,IL,60622-0000,Proprietary  ,21,100,121,79,389,468
02349400,ALVAREITA'S COLLEGE OF COSMETOLOGY      ,IL,62035-0000,Proprietary  ,3,7,10,21,44,65
02349500,CANNELLA SCHOOL OF HAIR DESIGN          ,IL,60632-0000,Proprietary  ,5,18,23,36,117,153
02352200,COOKING & HOSPITALITY INSTITUTE         ,IL,60610-3050,Proprietary  ,76,267,343,660,1427,2087
02498200,HAIR PROFESSIONALS ACAD COSMETOLOGY     ,IL,60187-0000,Proprietary  ,14,46,60,50,193,243
02498201,HAIR PROFESSIONALS ACADEMY OF COSMETOLOG,IL,60563-0000,Proprietary  ,1,2,3,12,18,30
02522800,FOX COLLEGE                             ,IL,60453-0000,Proprietary  ,22,33,55,393,290,683
02527600,LEXINGTON COLLEGE                       ,IL,60607-0000,Private      ,1,2,3,61,40,101
02536700,BELL MAR BEAUTY COLLEGE                 ,IL,60650-0000,Proprietary  ,3,16,19,7,56,63
02556100,ENVIRONMENTAL TECHNICAL INSTITUTE       ,IL,60143-0000,Proprietary  ,28,116,144,140,356,496
02556600,NILES SCHOOL OF COSMETOLOGY             ,IL,60714-0000,Proprietary  ,8,7,15,22,53,75
02570305,LOS ANGELES ORT TECHNICAL INSTITUTE -D/B,IL,60077-0000,Private      ,1,0,1,2,4,6
02573700,INSTITUTE FOR CLINICAL SOCIAL WORK      ,IL,60601-0000,Private      ,0,5,5,10,103,113
02579200,INGALLS MEMORIAL HOSPITAL               ,IL,60426-0000,Private      ,0,2,2,3,16,19
02584900,"FIRST INSTITUTE, INC.                   ",IL,60014-7489,Proprietary  ,11,61,72,35,243,278
02587700,HAIR PROFESSIONALS CAREER COLLEGE       ,IL,60465-1929,Proprietary  ,4,16,20,36,83,119
02599500,HANOVER PARK COLLEGE OF BEAUTY CULT     ,IL,60133-5421,Proprietary  ,11,15,26,59,103,162
02622700,KNOWLEDGE SYSTEMS INSTITUTE             ,IL,60076-0000,Private      ,0,1,1,1,10,11
03002000,HAIRMASTERS INST OF COSMETOLOGY         ,IL,61701-5547,Proprietary  ,3,13,16,28,88,116
03027702,PACIFIC COLLEGE OF ORIENTAL MEDICINE - C,IL,60613-4418,Proprietary  ,2,40,42,7,248,255
03065300,TREND SETTERS COLL OF COSMETOLOGY       ,IL,60915-2101,Proprietary  ,31,41,72,98,150,248
03072701,WESTWOOD COLLEGE OF TECHNOLOGY          ,IL,60409-0000,Proprietary  ,43,190,233,368,1238,1606
03072702,WESTWOOD COLLEGE OF TECHNOLOGY          ,IL,60602-0000,Proprietary  ,88,210,298,832,1702,2534
03078400,CAMEO BEAUTY ACADEMY                    ,IL,60453-3196,Proprietary  ,5,19,24,48,81,129
03079200,WESTWOOD COLLEGE - DUPAGE               ,IL,60517-2321,Proprietary  ,43,124,167,500,719,1219
03082900,ROSEL SCHOOL OF COSMETOLOGY             ,IL,60659-1913,Proprietary  ,4,24,28,27,145,172
03083800,HEARTLAND COMMUNITY COLLEGE             ,IL,61761-9446,Public       ,126,346,472,1849,2469,4318
03098000,ST JOHN'S COLLEGE OF NURSING            ,IL,62702-5321,Private      ,4,5,9,104,67,171
03098002,ST JOHN'S HOSP SCH MED TECH             ,IL,62769-5324,Private      ,0,0,0,5,13,18
03099700,CAIN'S BARBER COLLEGE                   ,IL,60615-3510,Proprietary  ,8,53,61,80,339,419
03099800,ILLINOIS SCHOOL OF HEALTH CAREERS       ,IL,60604-0000,Proprietary  ,52,210,262,298,1010,1308
03101800,ILLINOIS CENTER FOR BROADCASTING        ,IL,60148-7015,Proprietary  ,23,65,88,116,299,415
03128300,PYRAMID CAREER INSTITUTE                ,IL,60657-4207,Proprietary  ,0,2,2,0,7,7
03128500,NATIONAL LATINO EDUCATION INSTITUTE     ,IL,60609-2205,Private      ,8,17,25,33,101,134
03199300,CHRISTIAN LIFE COLLEGE                  ,IL,60056-2522,Private      ,3,3,6,20,25,45
03368300,MIDWEST TECHNICAL INSTITUTE             ,IL,62707-8805,Proprietary  ,64,358,422,370,1896,2266
03416300,COMPUTER SYSTEMS INSTITUTE              ,IL,60077-0000,Proprietary  ,48,214,262,190,940,1130
03448300,BIR TRAINING CENTER                     ,IL,60659-1298,Proprietary  ,11,174,185,43,686,729
03455700,CORTIVA INSTITUTE - CHICAGO             ,IL,60602-3315,Proprietary  ,33,109,142,224,604,828
03455701,CORTIVA INSTITUTE - CHICAGO             ,IL,60014-6285,Proprietary  ,0,5,5,2,18,20
03510300,ERIKSON INSTITUTE                       ,IL,60654-4510,Private      ,0,39,39,1,297,298
03623300,VEE'S SCHOOL OF BEAUTY CULTURE          ,IL,62205-2326,Proprietary  ,1,13,14,3,35,38
03643300,"MR. JOHN'S SCHOOL OF JACKSONVILLE,  INC,",IL,62650-3488,Proprietary  ,3,11,14,12,39,51
03684300,NORTHSHORE UNIVERSITY HEALTHSYSTEM SCHOO,IL,60201-9872,Private      ,0,4,4,2,29,31
03721400,AMERICAN CAREER COLLEGE                 ,IL,60402-0000,Proprietary  ,4,31,35,19,102,121
03881400,EUROPEAN MASSAGE THERAPY SCHOOL         ,IL,60077-2269,Proprietary  ,6,33,39,14,135,149
03891300,SOMA INSTITUTE - THE NATIONAL SCHOOL OF ,IL,60604-4466,Proprietary  ,21,61,82,75,265,340
03914300,"CALC, INSTITUTE OF TECHNOLOGY           ",IL,62002-5931,Proprietary  ,1,40,41,16,221,237
04117500,SOLEX MEDICAL ACADEMY                   ,IL,60090-3104,Proprietary  ,0,1,1,1,24,25
04124700,AMERICARE INSTITUTE                     ,IL,60133-5456,Proprietary  ,25,149,174,28,178,206
04136900,UNIVERSITY OF AESTHETICS (THE)          ,IL,60622-2151,Proprietary  ,0,2,2,6,27,33
04137000,UNIVERSITY OF AESTHETICS (THE)          ,IL,60515-5602,Proprietary  ,1,8,9,6,24,30
04137500,TRICOCI UNIVERSITY OF BEAUTY CULTURE    ,IL,60656-1805,Proprietary  ,18,43,61,134,221,355
04139000,CITI COLLEGE OF ALLIED HEALTH           ,IL,60602-1032,Proprietary  ,2,7,9,2,7,9
04141000,AVEDA INSTITUTE CHICAGO                 ,IL,60647-0000,Proprietary  ,6,38,44,42,132,174
04147100,TRICOCI UNIVERSITY OF BEAUTY CULTURE    ,IL,60048-2906,Proprietary  ,4,21,25,26,60,86
04147200,TRICOCI UNIVERSITY OF BEAUTY CULTURE    ,IL,60455-1824,Proprietary  ,7,23,30,42,70,112
04147300,TRICOCI UNIVERSITY OF BEAUTY CULTURE    ,IL,60139-3119,Proprietary  ,7,11,18,50,67,117
04147400,TRICOCI UNIVERSITY OF BEAUTY CULTURE    ,IL,61614-4831,Proprietary  ,4,7,11,25,47,72
04147500,TRICOCI UNIVERSITY OF BEAUTY CULTURE    ,IL,61108-2337,Proprietary  ,13,27,40,43,117,160
        ,ASBURY THEOLOGICAL SEMINARY             ,KY,40390-0000,Private      ,0,0,0,1,30,31
00195100,ALICE LLOYD COLLEGE                     ,KY,41844-9703,Private      ,19,6,25,943,149,1092
00195200,ASBURY COLLEGE                          ,KY,40390-1198,Private      ,33,45,78,1515,507,2022
00195300,ASBURY THEOLOGICAL SEMINARY             ,KY,40390-0000,Private      ,2,66,68,18,1305,1323
00195400,BELLARMINE UNIVERSITY                   ,KY,40205-1877,Private      ,53,148,201,3424,1357,4781
00195500,BEREA COLLEGE                           ,KY,40403-0000,Private      ,54,33,87,2783,639,3422
00195800,BRESCIA UNIVERSITY                      ,KY,42301-3023,Private      ,9,51,60,666,547,1213
00195900,CAMPBELLSVILLE UNIVERSITY               ,KY,42718-2799,Private      ,26,134,160,2240,1436,3676
00196000,SPALDING UNIVERSITY                     ,KY,40203-2188,Private      ,19,151,170,635,2313,2948
00196100,CENTRE COLLEGE                          ,KY,40422-1394,Private      ,27,16,43,2036,86,2122
00196200,UNIVERSITY OF THE CUMBERLANDS           ,KY,40769-1372,Private      ,29,141,170,2293,1482,3775
00196300,EASTERN KENTUCKY UNIVERSITY             ,KY,40475-3102,Public       ,308,764,1072,11247,8685,19932
00196400,GEORGETOWN COLLEGE                      ,KY,40324-1628,Private      ,22,70,92,2160,712,2872
00196500,KENTUCKY CHRISTIAN UNIVERSITY           ,KY,41143-2205,Private      ,10,11,21,710,153,863
00196800,KENTUCKY STATE UNIVERSITY               ,KY,40601-2355,Public       ,93,141,234,3250,1752,5002
00196900,KENTUCKY WESLEYAN COLLEGE               ,KY,42302-1039,Private      ,10,20,30,1236,292,1528
00197000,LEES COLLEGE                            ,KY,41339-0000,Private      ,0,0,0,1,1,2
00197100,LEXINGTON THEOLOGICAL SEMINARY          ,KY,40508-0000,Private      ,0,2,2,0,58,58
00197200,LINDSEY WILSON COLLEGE                  ,KY,42728-1223,Private      ,20,127,147,1898,1596,3494
00197400,LOUISVILLE PRESBYTERIAN THEOL SEM       ,KY,40205-0000,Private      ,0,6,6,1,147,148
00197500,MIDWAY COLLEGE                          ,KY,40347-1120,Private      ,6,149,155,572,1454,2026
00197600,MOREHEAD STATE UNIVERSITY               ,KY,40351-1689,Public       ,185,536,721,5889,5240,11129
00197700,MURRAY STATE UNIVERSITY                 ,KY,42071-0009,Public       ,132,350,482,6105,3867,9972
00197900,WEST KENTUCKY CMNTY & TECHNICAL COLG    ,KY,42002-7380,Public       ,144,591,735,1634,3577,5211
00198000,PIKEVILLE COLLEGE                       ,KY,41501-1194,Private      ,14,33,47,1049,392,1441
00198001,PIKEVILLE CLG-SCH OSTEOPATHIC MEDIC     ,KY,41501-0000,Private      ,0,4,4,8,322,330
00198200,SOUTHERN BAPTIST THEOL SEMINARY         ,KY,40280-0000,Private      ,2,17,19,51,194,245
00198300,ST. CATHARINE COLLEGE                   ,KY,40061-9499,Private      ,17,49,66,677,482,1159
00198700,TRANSYLVANIA UNIVERSITY                 ,KY,40508-1797,Private      ,23,13,36,1632,156,1788
00198800,UNION COLLEGE                           ,KY,40906-1499,Private      ,21,105,126,1284,1069,2353
00198900,UNIVERSITY OF KENTUCKY                  ,KY,40506-0054,Public       ,372,513,885,16307,8690,24997
00198901,UNIV OF KY-COLLEGE OF DENTISTRY         ,KY,40536-0000,Public       ,0,3,3,11,216,227
00198902,UNIV OF KY-COLLEGE OF MEDICINE          ,KY,40536-0000,Public       ,5,6,11,40,453,493
00199000,ASHLAND COMMUNITY AND TECHNICAL COLLEGE ,KY,41101-3683,Public       ,98,370,468,1461,2738,4199
00199100,ELIZABETHTOWN COMMUNITY  AND TECHNICAL C,KY,42701-3081,Public       ,153,766,919,2241,5222,7463
00199300,HENDERSON COMMUNITY COLLEGE             ,KY,42420-4699,Public       ,37,170,207,597,1501,2098
00199400,HOPKINSVILLE COMMUNITY COLLEGE          ,KY,42241-2621,Public       ,99,539,638,1112,4029,5141
00199600,BIG SANDY COMMUNITY AND TECHNICAL COLG  ,KY,41653-1815,Public       ,109,377,486,1767,2434,4201
00199700,SOMERSET COMMUNITY COLLEGE              ,KY,42501-2973,Public       ,200,1003,1203,2833,6443,9276
00199800,SOUTHEAST KENTUCKY COMMUNITY AND TECHNIC,KY,40823-1099,Public       ,62,205,267,1232,1796,3028
00199802,CUMBERLAND VLY TEC CLG MIDDLESBORO      ,KY,40965-2265,Public       ,1,5,6,19,29,48
00199804,SOUTHEAST COMMUNITY COLLEGE             ,KY,40831-1796,Public       ,9,19,28,103,164,267
00199900,UNIVERSITY OF LOUISVILLE                ,KY,40292-0000,Public       ,319,767,1086,12796,11919,24715
00200100,THOMAS MORE COLLEGE                     ,KY,41017-3495,Private      ,18,141,159,1406,883,2289
00200200,WESTERN KENTUCKY UNIVERSITY             ,KY,42101-3576,Public       ,382,859,1241,13612,9392,23004
00461800,SPENCERIAN COLLEGE                      ,KY,40216-2605,Proprietary  ,51,321,372,718,2397,3115
00461900,SULLIVAN UNIVERSITY                     ,KY,40205-3000,Proprietary  ,188,738,926,2118,5941,8059
00512729,BROWN MACKIE COLLEGE-CINCINNATI - 279 BU,KY,41017-2136,Proprietary  ,2,14,16,26,112,138
00524400,BLUEGRASS COMMUNITY & TECHNICAL COLLEGE ,KY,40506-0235,Public       ,367,1450,1817,4816,10029,14845
00527100,BOWLING GREEN TECHNICAL COLLEGE         ,KY,42101-3601,Public       ,74,502,576,1013,2670,3683
00527300,GATEWAY COMMUNITY & TECHNOLOGY COLL     ,KY,41011-0000,Public       ,122,426,548,1241,3448,4689
00696000,MAYSVILLE CMNTY & TECHNCL COLG          ,KY,41056-8910,Public       ,79,456,535,979,2973,3952
00696100,JEFFERSON COMMUNITY AND TECHNICAL COLLEG,KY,40202-2005,Public       ,526,1850,2376,6077,11589,17666
00696200,HAZARD COMMUNITY COLLEGE                ,KY,41701-2402,Public       ,68,306,374,1340,2181,3521
00696203,KY TECH-KNOTT CO. TECHNOLOGY CTR        ,KY,41822-0000,Public       ,0,0,0,2,2,4
00696204,KY TECH-LESLIE COUNTY AREA TECH CTR     ,KY,41749-0000,Public       ,0,1,1,1,1,2
00696205,KY TECH-LEE COUNTY AREA TECH CTR        ,KY,41311-0000,Public       ,0,0,0,1,3,4
00696206,KY TECH-LETCHER CNTY AREA TECH CTR      ,KY,41858-0000,Public       ,1,4,5,21,14,35
00696207,KY TECH-BREATHITT COUNTY VOC ED CTR     ,KY,41339-0000,Public       ,0,2,2,12,10,22
00736205,MEDTECH COLLEGE - LEXINGTON             ,KY,40511-1200,Proprietary  ,8,72,80,8,119,127
00842500,DAYMAR COLLEGE                          ,KY,42001-0000,Proprietary  ,16,89,105,82,612,694
00901000,MADISONVILLE COMMUNITY COLLEGE          ,KY,42431-9199,Public       ,74,365,439,1139,2700,3839
00927500,NORTHERN KENTUCKY UNIVERSITY            ,KY,41099-0001,Public       ,278,575,853,8994,7562,16556
00931300,DAYMAR COLLEGE                          ,KY,42301-5830,Proprietary  ,63,560,623,333,2576,2909
00931302,DAYMAR COLLEGE - LOUISVILLE CAMPUS      ,KY,40219-1973,Proprietary  ,5,42,47,62,263,325
01042400,SALON PROFESSIONAL ACADEMY THE          ,KY,40502-1776,Proprietary  ,9,20,29,70,128,198
01048900,NATIONAL COLLEGE                        ,KY,40508-0000,Proprietary  ,115,693,808,670,5224,5894
01172500,COLLINS SCHOOL OF COSMETOLOGY           ,KY,40965-2809,Proprietary  ,0,13,13,22,65,87
01208800,SULLIVAN COLLEGE OF TECHNOLOGY AND DESIG,KY,40218-4528,Proprietary  ,23,142,165,513,711,1224
01212801,SOUTHWESTERN COLLEGE                    ,KY,41042-1466,Proprietary  ,15,128,143,136,818,954
01240400,LEXINGTON BEAUTY COLLEGE                ,KY,40503-1819,Proprietary  ,0,0,0,17,47,64
01272300,KY TECH-WAYNE COUNTY AREA TECH CTR      ,KY,42633-1088,Public       ,0,0,0,1,2,3
01291400,EMPIRE BEAUTY SCHOOL                    ,KY,40218-0000,Proprietary  ,11,51,62,122,307,429
01291500,EMPIRE BEAUTY SCHOOL                    ,KY,41042-5113,Proprietary  ,11,19,30,93,174,267
01291600,EMPIRE BEAUTY SCHOOL                    ,KY,40216-4212,Proprietary  ,4,29,33,53,174,227
01291700,EMPIRE BEAUTY SCHOOL                    ,KY,40160-0000,Proprietary  ,7,30,37,97,232,329
01296800,EMPIRE BEAUTY SCHOOL                    ,KY,40207-2695,Proprietary  ,13,10,23,83,139,222
02159100,"APPALACHIAN BEAUTY SCHOOL, INC.         ",KY,41503-0000,Proprietary  ,2,5,7,17,50,67
02177100,EMPIRE BEAUTY SCHOOL                    ,KY,40204-0000,Proprietary  ,7,24,31,77,198,275
02251500,TREND SETTERS ACAD OF BEAUTY CULT       ,KY,40258-0000,Proprietary  ,11,40,51,49,179,228
02275000,JENNY LEA ACADEMY OF COSMETOLOGY        ,KY,40831-0000,Proprietary  ,11,48,59,65,209,274
02279800,ELIZABETHTOWN BEAUTY SCHOOL             ,KY,42701-0000,Proprietary  ,0,0,0,4,5,9
02284306,INTERACTIVE LEARNING SYSTEMS            ,KY,41042-0000,Proprietary  ,0,7,7,8,87,95
02323700,PAT WILSON'S BEAUTY COLLEGE             ,KY,42420-0000,Proprietary  ,1,15,16,13,66,79
02337200,PJ'S COLLEGE OF COSMETOLOGY             ,KY,42101-0000,Proprietary  ,16,81,97,126,556,682
02340800,PAUL MITCHELL THE SCHOOL LEXINGTON      ,KY,40601-0000,Proprietary  ,11,21,32,38,77,115
02351700,DONTA SCHOOL OF BEAUTY CULTURE          ,KY,40203-0000,Proprietary  ,11,29,40,56,123,179
02491100,BECKFIELD COLLEGE                       ,KY,41042-0000,Proprietary  ,24,208,232,244,1386,1630
02518900,BARRETT & COMPANY SCH HAIR DESIGN       ,KY,40356-0000,Proprietary  ,3,19,22,42,125,167
02526100,JENNY LEA ACADEMY OF COSMETOLOGY        ,KY,41858-0000,Proprietary  ,0,2,2,8,40,48
02535600,CLEAR CREEK BAPTIST BIBLE COLLEGE       ,KY,40977-0000,Private      ,2,10,12,41,150,191
02551100,PJ'S COLLEGE OF COSMETOLOGY             ,KY,42121-0000,Proprietary  ,4,23,27,24,100,124
02560800,SOUTHEAST SCHOOL OF COSMETOLOGY         ,KY,40962-0000,Proprietary  ,2,9,11,14,50,64
02576200,MID-CONTINENT UNIVERSITY                ,KY,42066-9007,Private      ,13,248,261,274,2450,2724
02616204,BROWN MACKIE COLLEGE-FINDLAY - BROWN MAC,KY,40219-1916,Proprietary  ,14,89,103,145,626,771
02616205,BROWN MACKIE COLLEGE-LOUISVILLE - BROWN ,KY,42240-3579,Proprietary  ,4,23,27,28,200,228
03002100,KENTUCKY MOUNTAIN BIBLE COLLEGE         ,KY,41385-0010,Private      ,2,2,4,54,33,87
03007000,FRONTIER SCH OF MIDWIFERY&FAMILY NU     ,KY,41749-0000,Private      ,0,131,131,2,971,973
03026200,HEAD'S WEST KENTUCKY BEAUTY COLLEGE     ,KY,42431-0000,Proprietary  ,1,5,6,12,42,54
03029200,NU-TEK ACADEMY OF BEAUTY                ,KY,40353-9767,Proprietary  ,2,8,10,12,44,56
03034500,OWENSBORO COMMUNITY & TECHNICAL COLLEGE ,KY,42303-1899,Public       ,71,458,529,1500,3305,4805
03083700,GALEN HEALTH INSTITUTES                 ,KY,40207-1047,Proprietary  ,91,551,642,576,3624,4200
03103500,MR JIM'S BEAUTY COLLEGE                 ,KY,42301-2646,Proprietary  ,1,8,9,6,44,50
03516500,EZELL'S COSMETOLOGY SCHOOL              ,KY,42071-2530,Proprietary  ,2,15,17,18,76,94
03611300,BRIGHTON CENTER'S CENTER FOR EMPLOY     ,KY,41071-1968,Private      ,1,51,52,6,143,149
03804300,BELLEFONTE ACADEMY OF BEAUTY            ,KY,41169-2015,Proprietary  ,5,30,35,26,105,131
03885300,EMPLOYMENT SOLUTIONS                    ,KY,40517-3260,Private      ,4,49,53,20,233,253
03886300,REGENCY SCHOOL OF HAIR DESIGN           ,KY,41653-1278,Proprietary  ,0,3,3,21,60,81
04038300,ATA CAREER EDUCATION                    ,KY,40223-3832,Proprietary  ,38,221,259,188,1162,1350
04123900,LEXINGTON HEALING ARTS ACADEMY          ,KY,40503-1932,Proprietary  ,4,26,30,32,115,147
00200300,CENTENARY COLLEGE OF LOUISIANA          ,LA,71104-3396,Private      ,23,19,42,1224,253,1477
00200400,DILLARD UNIVERSITY                      ,LA,70122-3097,Private      ,53,58,111,1935,711,2646
00200500,NICHOLLS STATE UNIVERSITY               ,LA,70310-0001,Public       ,113,256,369,5174,2800,7974
00200600,GRAMBLING STATE UNIVERSITY              ,LA,71245-2215,Public       ,163,227,390,6590,3276,9866
00200700,LOUISIANA COLLEGE                       ,LA,71359-0000,Private      ,18,53,71,1093,724,1817
00200800,LOUISIANA TECH UNIVERSITY               ,LA,71272-0001,Public       ,127,275,402,6194,2994,9188
00201000,LOUISIANA STATE UNIV & A&M COLG         ,LA,70803-5710,Public       ,376,491,867,20511,7439,27950
00201100,LOUISIANA STATE UNIV-ALEXANDRIA         ,LA,71302-9121,Public       ,66,226,292,1430,2120,3550
00201200,LOUISIANA STATE UNIV-EUNICE             ,LA,70535-6726,Public       ,91,255,346,1917,1839,3756
00201300,LOUISIANA STATE UNIV-SHREVEPORT         ,LA,71115-2399,Public       ,80,302,382,2462,3101,5563
00201400,LA STATE UNIV HEALTH SCIENCES CTR       ,LA,70112-2223,Public       ,15,60,75,430,2060,2490
00201500,(THE) UNIVERSITY OF NEW ORLEANS         ,LA,70148-0001,Public       ,243,678,921,6373,6943,13316
00201600,LOYOLA UNIVERSITY NEW ORLEANS           ,LA,70118-6195,Private      ,87,163,250,3167,2661,5828
00201700,MCNEESE STATE UNIVERSITY                ,LA,70609-4510,Public       ,172,395,567,4975,3755,8730
00201900,NEW ORLEANS BAPTIST THEOL SEMINARY      ,LA,70126-0000,Private      ,1,16,17,28,144,172
00202000,UNIVERSITY OF LOUISIANA AT MONROE       ,LA,71209-9001,Public       ,127,392,519,5901,4584,10485
00202100,NORTHWESTERN STATE UNIVERSITY           ,LA,71497-0001,Public       ,156,501,657,5902,5389,11291
00202200,NOTRE DAME SEMINARY                     ,LA,70118-0000,Private      ,0,2,2,3,13,16
00202300,OUR LADY OF HOLY CROSS COLLEGE          ,LA,70131-7399,Private      ,25,117,142,633,1198,1831
00202400,SOUTHEASTERN LOUISIANA UNIV             ,LA,70402-0001,Public       ,294,581,875,10628,5840,16468
00202500,SOUTHERN UNIVERSITY A & M COLLEGE       ,LA,70813-9374,Public       ,207,478,685,7638,6821,14459
00202600,SOUTHERN UNIV NEW ORLEANS               ,LA,70126-0002,Public       ,105,379,484,1635,3769,5404
00202700,ST JOSEPH SEMINARY COLLEGE              ,LA,70457-9990,Private      ,1,1,2,32,21,53
00202900,TULANE UNIVERSITY                       ,LA,70118-5698,Private      ,216,341,557,11084,6652,17736
00203100,UNIV OF LOUISIANA AT LAFAYETTE          ,LA,70504-0001,Public       ,285,438,723,11532,5115,16647
00203200,XAVIER UNIVERSITY OF LOUISIANA          ,LA,70125-1098,Private      ,113,86,199,4387,1707,6094
00462100,AYERS CAREER COLLEGE                    ,LA,71108-5845,Proprietary  ,14,122,136,68,451,519
00462500,DELGADO COMMUNITY COLLEGE               ,LA,70119-0000,Public       ,676,2048,2724,7281,14040,21321
00520300,REMINGTON COLLEGE - LAFAYETTE CAMPUS    ,LA,70508-5760,Proprietary  ,102,339,441,653,1907,2560
00520306,REMINGTON COLLEGE - BATON ROUGE CAMPUS  ,LA,70816-4040,Proprietary  ,30,122,152,178,635,813
00546700,SOWELA TECHNICAL COMMUNITY COLLEGE      ,LA,70616-6950,Public       ,111,262,373,874,1394,2268
00548800,LOUISIANA TECH COLG-BATON ROUGE         ,LA,70807-0000,Public       ,42,181,223,437,1149,1586
00548802,LOUISIANA TECH COLG-ACADIAN CMPS        ,LA,70526-0000,Public       ,19,56,75,105,209,314
00548803,LOUISIANA TECH COLG-ALEXANDRIA CMPS     ,LA,71302-3137,Public       ,28,109,137,195,590,785
00548804,LOUISIANA TECH COLG-ASCENSION CMPS      ,LA,70778-3007,Public       ,9,29,38,80,186,266
00548805,LA TECH COLLEGE-AVOYELLES CAMPUS        ,LA,71327-0000,Public       ,5,39,44,83,148,231
00548806,LA TECHNICAL COLG-BASTROP CMPS          ,LA,71221-0000,Public       ,12,37,49,71,219,290
00548808,LA TECH COLG CHARLES B COREILCMPS       ,LA,70586-0000,Public       ,5,26,31,110,201,311
00548809,LA TECHNICAL COLG-DELTA-OUACHITA        ,LA,71292-9064,Public       ,19,75,94,191,605,796
00548810,EVANGELINE TECHNICAL INST               ,LA,70582-3104,Public       ,12,23,35,90,232,322
00548811,LA TECHN COLLEGE - FLORIDA PARISHES     ,LA,70441-0000,Public       ,15,59,74,77,210,287
00548812,LOUISIANA TECH COLG-FOLKES CAMPUS       ,LA,70748-0000,Public       ,2,14,16,28,68,96
00548813,LA TECHNICAL INST-GULF AREA CMPS        ,LA,70510-0878,Public       ,11,40,51,162,297,459
00548814,LOUISIANA TECH COLG-HAMMOND CMPS        ,LA,70404-0000,Public       ,20,106,126,191,479,670
00548815,LA TECH COLG-HUEY P. LONG CAMPUS        ,LA,71483-0000,Public       ,9,37,46,73,191,264
00548816,LA TECH COLLEGE-JEFFERSON CAMPUS        ,LA,70001-5605,Public       ,17,72,89,83,384,467
00548817,LOUISIANA TEC CLG-JUMONVILLE MEM CP     ,LA,70760-0000,Public       ,2,12,14,51,136,187
00548818,LA TECH COLLEGE-LAFAYETTE CAMPUS        ,LA,70506-0000,Public       ,71,188,259,554,1027,1581
00548819,LOUISIANA TECHNICAL COLLEGE-LAFOURC     ,LA,70301-4336,Public       ,12,42,54,122,244,366
00548820,LOUISIANA TEC CLG-LAMAR SALTER CMPS     ,LA,71446-0000,Public       ,15,41,56,81,244,325
00548822,LOUISIANA TECHNICAL CLG-MANSFIELD       ,LA,71052-1236,Public       ,11,32,43,62,195,257
00548823,LA. TECH COLG.-MORGAN SMITH CAMPUS      ,LA,70546-0000,Public       ,5,20,25,35,110,145
00548824,LOUISIANA TEC CLG-NATCHITOCHES CMPS     ,LA,71458-0000,Public       ,15,32,47,104,263,367
00548825,LOUISIANA TECH COLG-NORTH CTRL CMPS     ,LA,71241-0000,Public       ,1,16,17,47,155,202
00548826,LOUISIANA TECH CLG-NORTHEAST LA CMP     ,LA,71295-2999,Public       ,10,28,38,86,208,294
00548827,LOUISIANA TEC CLG-NW LOUISIANA CMPS     ,LA,71058-0000,Public       ,33,83,116,242,537,779
00548828,LA TECHNICAL COLG-OAKDALE CMPS          ,LA,71463-0000,Public       ,4,28,32,60,144,204
00548829,LTC-RIVER PARISHES CAMPUS               ,LA,70084-0000,Public       ,23,81,104,207,346,553
00548830,LOUISIANA TECHNICAL COLLEGE-RUSTON      ,LA,71273-0000,Public       ,13,58,71,264,331,595
00548831,LTC - SABINE VALLEY CAMPUS              ,LA,71449-3839,Public       ,7,28,35,43,136,179
00548832,LOUISIANA TECH COLG-SHELBY JACKSON      ,LA,71334-0000,Public       ,12,53,65,63,261,324
00548833,LA TECH COLG SHREVEPORT-BOSSIER         ,LA,71137-0000,Public       ,38,222,260,293,1287,1580
00548837,LOUISIANA TECH COLG-SULLIVAN CAMPUS     ,LA,70427-5866,Public       ,29,78,107,210,528,738
00548838,LOUISIANA TECHNICAL COLG - TALLULAH     ,LA,71284-0000,Public       ,8,33,41,105,233,338
00548839,LA TECH COLG-TECHE AREA CAMPUS          ,LA,70562-0000,Public       ,16,72,88,213,384,597
00548840,LOUISIANA TECH COLG-T.H.HARRIS CMPS     ,LA,70570-6113,Public       ,45,113,158,374,582,956
00548841,LOUISIANA TECH COLG W JEFFERSON CMP     ,LA,70058-0000,Public       ,11,42,53,78,224,302
00548842,LOUISIANA TECHNICAL COLLEGE - WESTSIDE C,LA,70765-0733,Public       ,2,15,17,23,106,129
00548843,LTC-YOUNG MEMORIAL CAMPUS               ,LA,70381-0000,Public       ,19,73,92,143,409,552
00576100,L. E. FLETCHER TECHNICAL COMMUNITY COLLE,LA,70360-2863,Public       ,67,181,248,642,963,1605
00768600,SOUTHERN UNIV AT SHREVEPORT/BOSSIER     ,LA,71107-4795,Public       ,73,316,389,1387,3047,4434
00806700,LSU HEALTH SCIENCES CENTR-SHREVEPOR     ,LA,71130-3932,Public       ,16,33,49,255,932,1187
00989800,DEMMON SCHOOL OF BEAUTY                 ,LA,70607-2128,Proprietary  ,3,17,20,13,71,84
01005701,AMERICAN COMMERCIAL COLLEGE             ,LA,71105-2502,Proprietary  ,8,38,46,48,214,262
01109700,CLOYD'S BEAUTY SCHOOL #1                ,LA,71291-3131,Proprietary  ,7,37,44,44,156,200
01163100,"D-JAY'S SCHL OF BEAUTY, ARTS & SCI      ",LA,70806-0000,Proprietary  ,6,19,25,32,89,121
01184100,JOHN JAY BEAUTY COLLEGE                 ,LA,70124-2592,Proprietary  ,2,14,16,46,72,118
01261100,RONNIE & DORMANS SCHOOL HAIR DESIGN     ,LA,70501-0000,Proprietary  ,1,1,2,7,23,30
01282300,PAT GOINS RUSTON BEAUTY SCHOOL          ,LA,71270-4301,Proprietary  ,1,12,13,16,42,58
01287900,PAT GOINS BENTON ROAD BEAUTY SCHOOL     ,LA,71111-4838,Proprietary  ,1,10,11,14,54,68
01288000,PAT GOINS BEAUTY SCHOOL                 ,LA,71201-5167,Proprietary  ,2,8,10,9,25,34
02055400,BOSSIER PARISH COMMUNITY COLLEGE        ,LA,71111-0000,Public       ,183,532,715,2260,3677,5937
02055500,DELTA SCH OF BUSINESS & TECHNOLOGY      ,LA,70601-0000,Proprietary  ,6,70,76,76,451,527
02089711,HERZING COLLEGE                         ,LA,70062-8727,Proprietary  ,3,22,25,65,321,386
02117800,AVEDA INSTITUTE LAFAYETTE               ,LA,70503-3246,Proprietary  ,12,31,43,104,172,276
02166100,NUNEZ COMMUNITY COLLEGE                 ,LA,70043-0000,Public       ,50,209,259,480,1258,1738
02166200,ITI TECHNICAL COLLEGE                   ,LA,70817-0000,Proprietary  ,47,127,174,309,549,858
02197500,BATON ROUGE SCHOOL OF COMPUTERS         ,LA,70816-0000,Proprietary  ,3,10,13,26,64,90
02234000,CAMERON COLLEGE                         ,LA,70119-0000,Proprietary  ,8,51,59,41,186,227
02258400,AVEDA INSTITUTE BATON ROUGE             ,LA,70816-2246,Proprietary  ,20,40,60,136,200,336
02260200,DIESEL DRIVING ACADEMY                  ,LA,71109-5617,Proprietary  ,13,120,133,41,340,381
02263600,BASTROP BEAUTY SCHOOL #1                ,LA,71220-0000,Proprietary  ,0,0,0,4,6,10
02265600,JOHN JAY KENNER ACADEMY                 ,LA,70062-0000,Proprietary  ,7,19,26,49,108,157
02269300,STEVENSON'S ACADEMY OF HAIR DESIGN      ,LA,70116-0000,Proprietary  ,5,19,24,61,136,197
02327800,PINEVILLE BEAUTY SCHOOL                 ,LA,71360-0000,Proprietary  ,1,8,9,22,66,88
02335701,BATON ROUGE GEN MED CTR SCH NSG         ,LA,70821-0000,Private      ,4,17,21,51,177,228
02335702,BATON ROUGE GEN MED CTR-RAD TECH        ,LA,70806-0000,Private      ,0,8,8,25,48,73
02338000,"CLOYD'S BEAUTY SCHOOL #2, INC           ",LA,71202-3539,Proprietary  ,6,36,42,36,144,180
02352500,"CLOYD'S BEAUTY SCHOOL #3, INC           ",LA,71201-3211,Proprietary  ,8,39,47,43,157,200
02358600,"STAGE ONE THE HAIR SCHOOL, INC.         ",LA,70605-0000,Proprietary  ,2,23,25,55,106,161
02518300,SOUTH LOUISIANA BEAUTY COLLEGE          ,LA,70363-0000,Proprietary  ,4,10,14,26,57,83
02536400,LOUISIANA ACADEMY OF BEAUTY             ,LA,70535-0000,Proprietary  ,1,11,12,26,45,71
02538300,DELTA COLLEGE OF ARTS & TECH INC        ,LA,70806-1529,Proprietary  ,18,74,92,137,512,649
02538301,DELTA COLLEGE OF ARTS & TECHNOLOGY - LAF,LA,70508-6831,Proprietary  ,4,28,32,33,176,209
02548500,COSMETOLOGY TRAINING CENTER             ,LA,70503-0000,Proprietary  ,17,15,32,55,62,117
02554800,VANGUARD COLLEGE OF COSMETOLOGY         ,LA,70458-8823,Proprietary  ,30,30,60,115,147,262
02582200,"GUY'S ACADEMY HAIR, SKIN & NAILS        ",LA,71105-2404,Proprietary  ,8,24,32,51,173,224
02600900,AVEDA INSTITUTE                         ,LA,70433-2922,Proprietary  ,87,221,308,623,1071,1694
02601000,AMERICAN SCHOOL OF BUSINESS             ,LA,71105-5646,Proprietary  ,7,33,40,19,80,99
02601100,OPELOUSAS SCHOOL OF COSMETOLOGY         ,LA,70570-6156,Proprietary  ,1,5,6,10,26,36
02606800,CAREER TRAINING SPECIALISTS             ,LA,71201-6046,Proprietary  ,66,180,246,346,935,1281
02606801,CAREER TECHNICAL COLLEGE - SHREVEPORT   ,LA,71105-2405,Proprietary  ,19,112,131,132,538,670
02617100,BATON ROUGE COLLEGE                     ,LA,70816-2246,Proprietary  ,9,24,33,52,130,182
02619200,DENHAM SPRINGS BEAUTY COLLEGE           ,LA,70726-3829,Proprietary  ,12,15,27,40,74,114
03010400,CRESCENT CITY SCH GAMING & BARTENDG     ,LA,70119-5507,Proprietary  ,22,209,231,55,614,669
03023500,CAMELOT CAREER COLLEGE                  ,LA,70805-7539,Proprietary  ,30,74,104,112,232,344
03030900,DIESEL DRIVING ACADEMY                  ,LA,70815-8109,Proprietary  ,10,123,133,37,457,494
03061400,ASCENSION COLLEGE                       ,LA,70737-2912,Proprietary  ,11,52,63,87,236,323
03095100,GRETNA CAREER COLLEGE                   ,LA,70053-2436,Proprietary  ,7,51,58,61,261,322
03106200,OUR LADY OF THE LAKE COLLEGE            ,LA,70808-4345,Private      ,34,224,258,808,2020,2828
03253300,JONESVILLE BEAUTY SCHOOL                ,LA,71343-0000,Proprietary  ,29,27,56,94,136,230
03294300,BLUE CLIFF SCH THERAPEUTIC MASSAGE      ,LA,70002-3458,Proprietary  ,46,168,214,278,852,1130
03332600,DELTA COLLEGE                           ,LA,70433-9042,Proprietary  ,9,56,65,80,310,390
03332601,DELTA COLLEGE - SLIDELL                 ,LA,70460-2624,Proprietary  ,7,45,52,41,250,291
03356300,MEDICAL TRAINING COLLEGE                ,LA,70816-5820,Proprietary  ,17,80,97,101,330,431
03422500,BLUE CLIFF COLLEGE                      ,LA,71107-6520,Proprietary  ,33,120,153,159,557,716
03422600,BLUE CLIFF COLLEGE                      ,LA,70508-3858,Proprietary  ,24,129,153,206,626,832
03480300,MEDVANCE INSTITUTE                      ,LA,70809-1908,Proprietary  ,52,183,235,370,1329,1699
03498400,OMEGA INSTITUTE OF COSMETOLOGY          ,LA,70360-0000,Proprietary  ,6,6,12,31,37,68
03727500,MOORE CAREER COLLEGE                    ,LA,70808-4191,Proprietary  ,4,7,11,29,54,83
03730300,BATON ROUGE COMMUNITY COLLEGE           ,LA,78806-4129,Public       ,375,806,1181,4391,5404,9795
03752400,SCHOOL OF URBAN MISSIONS                ,LA,70053-0000,Private      ,7,17,24,85,93,178
03789300,UNITECH TRAINING ACADEMY                ,LA,70503-5132,Proprietary  ,46,285,331,150,813,963
03789301,UNITECH TRAINING ACADEMY - WEST MONROE  ,LA,71291-2913,Proprietary  ,1,7,8,1,7,8
03789302,UNITECH TRAINING ACADEMY - HOUMA        ,LA,70363-5556,Proprietary  ,6,15,21,6,15,21
03789303,UNITECH TRAINING ACADEMY -  ALEXANDRIA  ,LA,71303-3625,Proprietary  ,2,7,9,2,7,9
03789304,UNITECH TRAINING ACADEMY - LAKE CHARLES ,LA,70601-7887,Proprietary  ,13,33,46,13,33,46
03789400,RIVER PARISHES COMMUNITY COLLEGE        ,LA,70778-0310,Public       ,30,88,118,432,618,1050
03810500,COURT REPORTING INSTITUTE OF LOUISI     ,LA,70816-0000,Proprietary  ,1,8,9,10,73,83
03956300,SOUTH LOUISIANA COMMUNITY COLLEGE       ,LA,70506-0000,Public       ,144,314,458,1432,1638,3070
04040300,COMPASS CAREER COLLEGE                  ,LA,70403-0653,Proprietary  ,10,45,55,54,232,286
04112300,LOUISIANA CULINARY INSTITUTE            ,LA,70816-4109,Proprietary  ,19,34,53,95,153,248
04120700,ALDEN'S SCHOOL OF COSMETOLOGY           ,LA,70714-1502,Proprietary  ,3,13,16,15,85,100
04130100,LOUISIANA DELTA COMMUNITY COLLEGE       ,LA,71203-3618,Public       ,103,243,346,913,1227,2140
04149500,A & W HEALTHCARE EDUCATORS              ,LA,70122-3146,Proprietary  ,0,5,5,0,5,5
04151600,MY-LE'S BEAUTY COLLEGE                  ,LA,70056-3150,Proprietary  ,6,40,46,6,40,46
00143600,CAPITOL COLLEGE                         ,MD,20708-9759,Private      ,11,44,55,365,321,686
00146200,WASHINGTON BIBLE COLLEGE                ,MD,20706-3599,Private      ,4,39,43,84,417,501
00205700,ALLEGANY COLLEGE OF MARYLAND            ,MD,21502-2596,Public       ,100,223,323,2207,1857,4064
00205800,ANNE ARUNDEL COMMUNITY COLLEGE          ,MD,21012-1895,Public       ,297,919,1216,3903,6032,9935
00206000,BALTIMORE HEBREW UNIVERSITY             ,MD,21215-3996,Private      ,0,0,0,5,38,43
00206100,BALTIMORE CITY COMMUNITY COLLEGE        ,MD,21215-7893,Public       ,187,1032,1219,3190,8477,11667
00206200,BOWIE STATE UNIVERSITY                  ,MD,20715-9465,Public       ,172,351,523,7155,4689,11844
00206300,COMMUNITY COLLEGE OF BALTIMORE COUNTY   ,MD,21228-5381,Public       ,455,1455,1910,7153,12587,19740
00206400,COLLEGE OF SOUTHERN MARYLAND            ,MD,20646-0910,Public       ,193,574,767,2404,3207,5611
00206401,COLLEGE OF SOUTHERN MARYLAND - PRINCE FR,MD,20676-9702,Public       ,0,0,0,149,201,350
00206402,COLLEGE OF SOUTHERN MARYLAND - LEONARDTO,MD,20650-1758,Public       ,0,0,0,170,309,479
00206477,COLLEGE OF SOUTHERN MARYLAND - WALDORF C,MD,20602-3223,Public       ,0,0,0,69,134,203
00206500,CLG NOTRE DAME OF MARYLAND              ,MD,21210-2476,Private      ,11,93,104,733,1440,2173
00206700,COLUMBIA UNION COLLEGE                  ,MD,20912-7796,Private      ,15,82,97,805,845,1650
00206800,COPPIN STATE UNIVERSITY                 ,MD,21216-3698,Public       ,97,305,402,4114,4318,8432
00207100,FREDERICK COMMUNITY COLLEGE             ,MD,21702-9745,Public       ,119,369,488,1650,2287,3937
00207200,FROSTBURG STATE UNIVERSITY              ,MD,21532-1099,Public       ,103,69,172,6238,1291,7529
00207300,GOUCHER COLLEGE                         ,MD,21204-2794,Private      ,30,60,90,2997,591,3588
00207400,HAGERSTOWN COMMUNITY COLLEGE            ,MD,21742-6590,Public       ,124,423,547,1573,2446,4019
00207500,HARFORD COMMUNITY COLLEGE               ,MD,21015-1696,Public       ,126,379,505,1857,2412,4269
00207600,HOOD COLLEGE                            ,MD,21701-8575,Private      ,37,71,108,2077,880,2957
00207700,JOHNS HOPKINS UNIVERSITY                ,MD,21218-2693,Private      ,92,145,237,7750,2174,9924
00207702,JOHNS HOPKINS UNIV SCH ARTS/SCI/ENG     ,MD,21218-0000,Private      ,33,178,211,3840,1919,5759
00207703,JOHNS HOPKINS UNIV SCH OF BUS/ED        ,MD,21046-0000,Private      ,4,126,130,45,1434,1479
00207705,JOHNS HOPKINS BLOOMBERG SCH OF PH       ,MD,21205-0000,Private      ,4,36,40,25,1298,1323
00207706,JOHNS HOPKINS UNIV SCH OF MEDICINE      ,MD,21205-0000,Private      ,12,19,31,121,1111,1232
00207707,JOHNS HOPKINS UNIV SCH OF NURSING       ,MD,21205-0000,Private      ,7,44,51,228,854,1082
00207708,JOHNS HOPKINS UNIV PEABODY CONSERV      ,MD,21202-2397,Private      ,8,5,13,598,428,1026
00207800,LOYOLA UNIVERSITY MARYLAND              ,MD,21210-2699,Private      ,70,151,221,6894,2001,8895
00208000,MARYLAND INST COLLEGE OF ART            ,MD,21217-4191,Private      ,59,23,82,2569,805,3374
00208300,MORGAN STATE UNIVERSITY                 ,MD,21251-0002,Public       ,262,311,573,11490,5055,16545
00208600,MOUNT SAINT MARY'S UNIVERSITY           ,MD,21727-7799,Private      ,30,36,66,2646,356,3002
00208700,NER ISRAEL RABBINICAL COLLEGE           ,MD,21208-1198,Private      ,4,4,8,87,46,133
00208900,PRINCE GEORGES COMMUNITY COLLEGE        ,MD,20774-2199,Public       ,447,1289,1736,5317,8612,13929
00209100,SALISBURY UNIVERSITY                    ,MD,21801-6862,Public       ,163,122,285,9698,1851,11549
00209200,ST JOHN'S COLLEGE                       ,MD,21404-0000,Private      ,9,13,22,625,182,807
00209500,ST. MARY'S COLLEGE OF MARYLAND          ,MD,20686-3001,Public       ,31,10,41,2595,190,2785
00209600,ST MARY'S SEMINARY & UNIV               ,MD,21210-1994,Private      ,1,4,5,23,28,51
00209900,TOWSON UNIVERSITY                       ,MD,21252-0002,Public       ,369,531,900,20510,6793,27303
00210200,UNIVERSITY OF BALTIMORE                 ,MD,21201-5779,Public       ,54,301,355,1439,6259,7698
00210300,"UNIVERSITY OF MARYLAND, COLLEGE PARK    ",MD,20742-5145,Public       ,518,840,1358,30348,12885,43233
00210400,"UNIVERSITY OF MARYLAND, BALTIMORE       ",MD,21201-1691,Public       ,68,324,392,2218,8899,11117
00210500,UMBC                                    ,MD,21250-0002,Public       ,223,274,497,8566,3944,12510
00210600,UNIVERSITY MARYLAND EASTERN SHORE       ,MD,21853-4053,Public       ,131,82,213,5389,1653,7042
00210700,STEVENSON UNIVERSITY                    ,MD,21153-0641,Private      ,70,84,154,4013,1148,5161
00210800,WASHINGTON COLLEGE                      ,MD,21620-1197,Private      ,29,8,37,2717,117,2834
00210900,MCDANIEL COLLEGE                        ,MD,21157-4390,Private      ,31,68,99,2823,650,3473
00458612,KAPLAN COLLEGE                          ,MD,21742-2797,Proprietary  ,40,221,261,404,1268,1672
00458613,KAPLAN COLLEGE -  CAREER TECHNOLOGY CENT,MD,21742-2797,Proprietary  ,0,0,0,18,48,66
00458614,KAPLAN COLLEGE - FREDERICK              ,MD,21704-8307,Proprietary  ,22,83,105,93,359,452
00465000,CHESAPEAKE COLLEGE                      ,MD,21679-0008,Public       ,71,223,294,1078,1569,2647
00691100,MONTGOMERY COLLEGE                      ,MD,20850-1195,Public       ,512,1103,1615,8944,8976,17920
00734100,INTERNATIONAL BEAUTY SCHOOL             ,MD,21502-2370,Proprietary  ,20,199,219,84,577,661
00744700,DEL-MAR-VA BEAUTY ACADEMY               ,MD,21804-0000,Proprietary  ,11,9,20,51,77,128
00749100,TESST COLLEGE OF TECHNOLOGY             ,MD,21227-1063,Proprietary  ,67,315,382,447,1742,2189
00793600,LINCOLN TECHNICAL INSTITUTE             ,MD,21046-1544,Proprietary  ,187,373,560,919,1187,2106
00817500,HOWARD COMMUNITY COLLEGE                ,MD,21044-3197,Public       ,129,398,527,2546,3188,5734
00826300,AWARD BEAUTY SCHOOL                     ,MD,21740-5624,Proprietary  ,24,73,97,73,258,331
00830800,CECIL COLLEGE                           ,MD,21901-1999,Public       ,57,165,222,924,1045,1969
00907906,EVEREST COLLEGE- EVEREST INSTITUTE      ,MD,20910-3737,Proprietary  ,72,186,258,301,709,1010
01001400,GARRETT COMMUNITY COLLEGE               ,MD,21541-1265,Public       ,31,53,84,754,388,1142
01031900,MEDIX SCHOOL                            ,MD,21204-2538,Proprietary  ,115,387,502,617,2115,2732
01041000,TESST COLLEGE OF TECHNOLOGY             ,MD,21286-2201,Proprietary  ,23,105,128,176,689,865
01164400,UNIV OF MARYLAND UNIVERSITY COLLEGE     ,MD,20783-8078,Public       ,160,2797,2957,2135,24359,26494
01164402,U OF MD UNIVERSITY COLLEGE - EUROPE     ,MD,20832-0000,Public       ,8,114,122,265,1284,1549
01164404,U OF MD UNIVERSITY COLLEGE - ASIA       ,MD,31207-0000,Public       ,13,61,74,79,669,748
02073900,WOR-WIC COMMUNITY COLLEGE               ,MD,21804-0000,Public       ,101,434,535,1433,2830,4263
02083600,TESST COLLEGE OF TECHNOLOGY             ,MD,20705-2698,Proprietary  ,47,132,179,407,878,1285
02116005,SANFORD-BROWN INSTITUTE - LANDOVER      ,MD,20785-2287,Proprietary  ,37,217,254,165,1082,1247
02127900,SOJOURNER DOUGLASS COLLEGE              ,MD,21205-0000,Private      ,19,281,300,165,2453,2618
02155100,MARYLAND COLLEGE OF ART AND DESIGN      ,MD,20902-0000,Private      ,2,11,13,63,63,126
02269700,INTERNATIONAL BEAUTY SCHOOL             ,MD,21014-0000,Proprietary  ,8,8,16,29,48,77
02314800,BALTIMORE INTERNATIONAL COLLEGE         ,MD,21202-0000,Private      ,40,117,157,592,589,1181
02331000,MARYLAND BEAUTY ACADEMY OF ESSEX        ,MD,21221-0000,Proprietary  ,13,32,45,54,126,180
02333000,HAIR ACADEMY                            ,MD,20784-0000,Proprietary  ,54,119,173,155,407,562
02343800,MONTGOMERY BEAUTY SCHOOL                ,MD,20901-0000,Proprietary  ,16,50,66,57,177,234
02494700,BALTIMORE STUDIO OF HAIR DESIGN         ,MD,21201-0000,Proprietary  ,15,50,65,61,224,285
02495000,ROBERT PAUL ACAD COSMTGY ARTS & SCI     ,MD,21093-0000,Proprietary  ,7,6,13,61,60,121
02495100,MARYLAND BEAUTY ACADEMY                 ,MD,21136-0000,Proprietary  ,4,14,18,10,46,56
02545400,NORTH AMERICAN TRADE SCHOOLS            ,MD,21244-0069,Proprietary  ,43,222,265,183,827,1010
02573800,"L' ACADEMIE DE CUISINE, INC.            ",MD,20877-0000,Proprietary  ,5,26,31,39,139,178
02578400,TAI SOPHIA INSTITUTE                    ,MD,20723-6010,Private      ,0,84,84,0,310,310
03027200,BLADES SCHOOL OF HAIR DESIGN            ,MD,20619-0226,Proprietary  ,12,22,34,37,79,116
03064900,AARON'S ACADEMY OF BEAUTY               ,MD,20602-2715,Proprietary  ,2,12,14,29,80,109
03097200,AESTHETICS INSTITUTE OF COSMETOLOGY     ,MD,20877-1305,Proprietary  ,14,19,33,25,58,83
03100700,CARROLL COMMUNITY COLLEGE               ,MD,21157-6913,Public       ,62,133,195,1024,933,1957
03148300,AMERICAN BEAUTY ACADEMY                 ,MD,20902-1911,Proprietary  ,42,128,170,230,577,807
03296300,BALTIMORE SCHOOL OF MASSAGE             ,MD,21090-2261,Proprietary  ,45,121,166,209,582,791
03327300,NEW CREATIONS ACADEMY OF HAIR DSN       ,MD,20746-2960,Proprietary  ,5,10,15,13,37,50
03455500,NATIONAL LABOR COLLEGE                  ,MD,20903-1790,Private      ,0,12,12,0,58,58
03493300,ALL-STATE CAREER SCHOOL                 ,MD,21224-6658,Proprietary  ,150,707,857,447,1872,2319
03771300,AMERICAN CAREER INSTITUTE               ,MD,20902-4637,Proprietary  ,30,227,257,75,448,523
03822400,MAPLE SPRINGS BAPTIST BIBLE COLLEGE & SE,MD,20743-5711,Private      ,0,10,10,2,58,60
03937300,YESHIVA COLLEGE OF THE NATION'S CAPITAL ,MD,20902-1700,Private      ,0,0,0,7,2,9
03965500,HAIR EXPRESSIONS ACADEMY                ,MD,20852-1729,Proprietary  ,16,23,39,42,81,123
04121600,FILA ACADEMY (THE)                      ,MD,21061-1634,Proprietary  ,6,30,36,39,128,167
04139700,FREDERICK SCHOOL OF COSMETOLOGY         ,MD,21701-0000,Proprietary  ,0,6,6,13,29,42
04141600,OMEGA STUDIOS' SCHOOL OF APPLIED RECORDI,MD,20852-1731,Proprietary  ,9,29,38,36,79,115
04151800,TEMPLE (THE): A PAUL MITCHELL PARTNER SC,MD,21701-5409,Proprietary  ,15,18,33,46,61,107
00211400,AMERICAN INTERNATIONAL COLLEGE          ,MA,01109-3189,Private      ,45,337,382,2038,2485,4523
00211500,AMHERST COLLEGE                         ,MA,01002-5000,Private      ,51,11,62,4607,176,4783
00211600,ANDOVER NEWTON THEOLOGICAL SCHOOL       ,MA,02459-0000,Private      ,1,8,9,1,201,202
00211700,ANNA MARIA COLLEGE                      ,MA,01612-1198,Private      ,15,44,59,1739,469,2208
00211800,ASSUMPTION COLLEGE                      ,MA,01615-1294,Private      ,31,47,78,4196,605,4801
00211900,ATLANTIC UNION COLLEGE                  ,MA,01561-1000,Private      ,6,33,39,304,322,626
00212000,MERRIMACK COLLEGE                       ,MA,01845-5800,Private      ,45,22,67,3937,254,4191
00212100,BABSON COLLEGE                          ,MA,02457-0310,Private      ,33,69,102,2379,920,3299
00212200,BAY PATH COLLEGE                        ,MA,01106-2212,Private      ,17,141,158,829,1812,2641
00212300,BECKER COLLEGE-WORCESTER                ,MA,01615-0071,Private      ,29,76,105,2154,1062,3216
00212400,BENTLEY UNIVERSITY                      ,MA,02452-4705,Private      ,70,66,136,5780,909,6689
00212600,BERKLEE COLLEGE OF MUSIC                ,MA,02215-3693,Private      ,155,115,270,3964,1090,5054
00212800,BOSTON COLLEGE                          ,MA,02467-3800,Private      ,185,163,348,19147,7337,26484
00212900,BOSTON CONSERVATORY OF MUSIC            ,MA,02215-9830,Private      ,15,6,21,1047,292,1339
00213000,BOSTON UNIVERSITY                       ,MA,02215-1789,Private      ,381,908,1289,30118,18000,48118
00213300,BRANDEIS UNIVERSITY                     ,MA,02453-2700,Private      ,36,48,84,4751,1299,6050
00213900,CLARK UNIVERSITY                        ,MA,01610-1473,Private      ,35,60,95,3769,663,4432
00214000,ELMS COLLEGE                            ,MA,01013-2839,Private      ,15,33,48,1027,573,1600
00214100,COLLEGE OF THE HOLY CROSS               ,MA,01610-2395,Private      ,63,6,69,5544,99,5643
00214300,CURRY COLLEGE                           ,MA,02186-2395,Private      ,45,107,152,4069,1080,5149
00214400,DEAN COLLEGE                            ,MA,02038-1994,Private      ,31,22,53,1477,199,1676
00214500,EASTERN NAZARENE COLLEGE                ,MA,02170-2999,Private      ,11,56,67,772,502,1274
00214507,EASTERN NAZARENE CLG - LEAD PROGRAM     ,MA,02170-0000,Private      ,1,7,8,12,80,92
00214600,EMERSON COLLEGE                         ,MA,02116-4624,Private      ,76,62,138,6706,1503,8209
00214700,EMMANUEL COLLEGE                        ,MA,02115-5798,Private      ,28,40,68,4453,476,4929
00214800,ENDICOTT COLLEGE                        ,MA,01915-2098,Private      ,35,63,98,3988,389,4377
00214900,EPISCOPAL DIVINITY SCHOOL               ,MA,02138-0000,Private      ,0,5,5,1,81,82
00215000,FISHER COLLEGE                          ,MA,02116-1500,Private      ,34,130,164,1313,937,2250
00215100,BENJAMIN FRANKLIN INSTITUTE OF TECH     ,MA,02116-6296,Public       ,33,33,66,713,317,1030
00215300,GORDON COLLEGE                          ,MA,01984-1899,Private      ,22,7,29,1966,93,2059
00215400,HELLENIC COLLEGE                        ,MA,02445-7496,Private      ,1,5,6,56,102,158
00215500,HARVARD UNIVERSITY                      ,MA,02138-3800,Private      ,144,90,234,6955,1169,8124
00215501,AMRCN REPERTORY THTR INST ADV THTR      ,MA,02138-0000,Private      ,1,0,1,6,103,109
00215502,HARVARD BUSINESS SCHOOL                 ,MA,02163-0000,Private      ,14,47,61,229,1746,1975
00215503,HARVARD EXTENSION SCHOOL                ,MA,02138-0000,Private      ,10,144,154,148,1277,1425
00215504,HARVARD SCH OF DENTAL MEDICINE          ,MA,02115-0000,Private      ,1,2,3,10,172,182
00215505,HARVARD UNIV GRAD SCH DESIGN            ,MA,02138-0000,Private      ,0,6,6,6,1037,1043
00215506,HARVARD DIVINITY SCHOOL                 ,MA,02138-0000,Private      ,6,7,13,32,722,754
00215507,HARVARD UNIV GRAD SCH ED                ,MA,02138-0000,Private      ,1,17,18,6,1412,1418
00215508,HARVARD UNIV GRAD S OF ARTS & SCIEN     ,MA,02138-0000,Private      ,7,40,47,100,962,1062
00215509,HARVARD JOHN F KENNEDY SCHL OF GOVT     ,MA,02138-0000,Private      ,1,16,17,23,1445,1468
00215510,HARVARD LAW SCHOOL                      ,MA,02138-0000,Private      ,5,35,40,81,4385,4466
00215511,HARVARD UNIV MEDICAL SCHOOL             ,MA,02115-0000,Private      ,7,13,20,126,1039,1165
00215512,HARVARD UNIV SCH PUBLIC HEALTH          ,MA,02115-0000,Private      ,1,12,13,40,811,851
00215513,HARVARD UNIVERSITY-HARVARD COLLEGE      ,MA,02138-0000,Private      ,81,11,92,14150,364,14514
00215700,HEBREW COLLEGE                          ,MA,02459-2237,Private      ,0,2,2,2,80,82
00215800,LASELL COLLEGE                          ,MA,02466-2716,Private      ,30,19,49,2853,222,3075
00216000,LESLEY UNIVERSITY                       ,MA,02138-2790,Private      ,20,482,502,2556,4834,7390
00216100,UMASS LOWELL                            ,MA,01854-3089,Public       ,192,384,576,9734,4482,14216
00216300,MARIST COLLEGE & SEMINARY               ,MA,01701-0000,Private      ,0,0,0,2,526,528
00216400,NEW ENGLAND COLLEGE OF OPTOMETRY        ,MA,02115-1129,Private      ,0,5,5,7,401,408
00216500,MASS. COLLEGE OF PHARMACY  & HEALTH SCIE,MA,02115-5804,Private      ,37,98,135,3917,2516,6433
00216700,BERKSHIRE COMMUNITY COLLEGE             ,MA,01201-5786,Public       ,44,120,164,911,1265,2176
00216800,CAPE COD COMMUNITY COLLEGE              ,MA,02668-1599,Public       ,130,273,403,1677,1916,3593
00216900,GREENFIELD COMMUNITY COLLEGE            ,MA,01301-9739,Public       ,60,187,247,849,1412,2261
00217000,HOLYOKE COMMUNITY COLLEGE               ,MA,01040-1099,Public       ,219,602,821,3650,4392,8042
00217100,MASSACHUSETTS BAY COMMUNITY COLLEGE     ,MA,02181-0000,Public       ,107,231,338,2221,2286,4507
00217200,MOUNT WACHUSETT COMMUNITY COLLEGE       ,MA,01440-1000,Public       ,118,386,504,1821,2988,4809
00217300,NORTH SHORE COMMUNITY COLLEGE           ,MA,01923-4093,Public       ,252,528,780,3164,3896,7060
00217400,NORTHERN ESSEX COMMUNITY COLLEGE        ,MA,01830-2399,Public       ,177,477,654,2749,3885,6634
00217500,QUINSIGAMOND COMMUNITY COLLEGE          ,MA,01606-2092,Public       ,256,534,790,3736,4224,7960
00217600,BRISTOL COMMUNITY COLLEGE               ,MA,02720-7399,Public       ,268,512,780,3840,4126,7966
00217700,MASSASOIT COMMUNITY COLLEGE             ,MA,02302-3996,Public       ,238,512,750,3179,3546,6725
00217800,MASSACHUSETTS INST OF TECHNOLOGY        ,MA,02139-4307,Private      ,140,159,299,10438,2850,13288
00218000,MASSACHUSETTS COLLEGE OF ART AND DESIGN ,MA,02115-5803,Public       ,29,33,62,2395,745,3140
00218100,MASSACHUSETTS MARITIME ACADEMY          ,MA,02532-3400,Public       ,11,4,15,1241,86,1327
00218300,BRIDGEWATER STATE COLLEGE               ,MA,02325-0001,Public       ,172,237,409,11125,3013,14138
00218400,FITCHBURG STATE COLLEGE                 ,MA,01420-2697,Public       ,76,119,195,5593,1435,7028
00218500,FRAMINGHAM STATE COLLEGE                ,MA,01702-2471,Public       ,84,112,196,5034,1139,6173
00218700,MASSACHUSETTS CLG OF LIBERAL ARTS       ,MA,01247-4100,Public       ,27,31,58,2098,527,2625
00218800,SALEM STATE COLLEGE                     ,MA,01970-5353,Public       ,173,263,436,8494,3429,11923
00218900,WESTFIELD STATE COLLEGE                 ,MA,01086-1630,Public       ,98,75,173,7673,1257,8930
00219000,WORCESTER STATE COLLEGE                 ,MA,01602-2597,Public       ,115,158,273,5455,2009,7464
00219200,MOUNT HOLYOKE COLLEGE                   ,MA,01075-1492,Private      ,18,10,28,2515,317,2832
00219300,MOUNT IDA COLLEGE                       ,MA,02459-3323,Private      ,20,30,50,2224,349,2573
00219400,NEW ENGLAND CONSERVATORY OF MUSIC       ,MA,02115-5018,Private      ,19,15,34,743,641,1384
00219700,NICHOLS COLLEGE                         ,MA,01571-6346,Private      ,16,30,46,2068,368,2436
00219900,NORTHEASTERN UNIVERSITY                 ,MA,02115-5000,Private      ,388,716,1104,30372,10659,41031
00220100,PINE MANOR COLLEGE                      ,MA,02167-0000,Private      ,9,9,18,558,177,735
00220200,BLESSED JOHN XXIII NATIONAL SEMINARY    ,MA,02493-0000,Private      ,0,0,0,0,3,3
00220500,QUINCY COLLEGE                          ,MA,02169-4501,Public       ,108,308,416,1350,2638,3988
00220600,REGIS COLLEGE                           ,MA,02193-0000,Private      ,10,34,44,1820,620,2440
00220800,SIMMONS COLLEGE                         ,MA,02115-5898,Private      ,33,180,213,3103,3497,6600
00220900,SMITH COLLEGE                           ,MA,01063-2936,Private      ,42,16,58,3589,955,4544
00221000,UNIV OF MASSACHUSETTS-DARTMOUTH         ,MA,02747-2300,Public       ,121,133,254,10911,2280,13191
00221100,SPRINGFIELD COLLEGE                     ,MA,01109-3797,Private      ,55,355,410,3928,4079,8007
00221400,ST JOHN'S SEMINARY                      ,MA,02135-8839,Private      ,7,15,22,17,63,80
00221700,STONEHILL COLLEGE                       ,MA,02357-6110,Private      ,57,13,70,5563,117,5680
00221800,SUFFOLK UNIVERSITY                      ,MA,02108-2770,Private      ,113,161,274,9441,2595,12036
00221802,SUFFOLK UNIVERSITY LAW SCHOOL           ,MA,02108-0000,Private      ,2,19,21,171,2866,3037
00221900,TUFTS UNIVERSITY                        ,MA,02155-5808,Private      ,87,80,167,9883,2582,12465
00221901,TUFTS UNIV SCH OF DENTAL MEDICINE       ,MA,02111-0000,Private      ,1,13,14,11,832,843
00221902,TUFTS UNIVERSITY - CUMMINGS SCHOOL OF VE,MA,01536-0000,Private      ,0,0,0,33,429,462
00221904,TUFTS UNIV SCHOOL OF MEDICINE           ,MA,02111-0000,Private      ,4,19,23,59,1753,1812
00222100,UNIV OF MASSACHUSETTS-AMHERST           ,MA,01003-0000,Public       ,408,393,801,32826,6980,39806
00222200,UNIV OF MASSACHUSETTS-BOSTON            ,MA,02125-3393,Public       ,279,698,977,10283,8909,19192
00222400,WELLESLEY COLLEGE                       ,MA,02481-8203,Private      ,36,5,41,3413,157,3570
00222500,WENTWORTH INSTITUTE OF TECHNOLOGY       ,MA,02115-5998,Private      ,71,80,151,4727,685,5412
00222600,WESTERN NEW ENGLAND COLLEGE             ,MA,01119-2654,Private      ,50,63,113,5011,1676,6687
00222700,WHEATON COLLEGE                         ,MA,02766-2322,Private      ,22,4,26,2560,65,2625
00222800,WHEELOCK COLLEGE                        ,MA,02215-4176,Private      ,21,19,40,1366,585,1951
00222900,WILLIAMS COLLEGE                        ,MA,01267-2600,Private      ,27,1,28,3602,104,3706
00223300,WORCESTER POLYTECHNIC INSTITUTE         ,MA,01609-2280,Private      ,50,36,86,5840,467,6307
00396500,BAY STATE COLLEGE                       ,MA,02116-2901,Proprietary  ,78,80,158,1262,716,1978
00396600,BOSTON ARCHITECTURAL COLLEGE            ,MA,02115-2795,Private      ,17,67,84,504,1088,1592
00466100,HAMPSHIRE COLLEGE                       ,MA,01002-3359,Private      ,51,8,59,2389,109,2498
00466600,SALTER COLLEGE                          ,MA,01583-1700,Proprietary  ,143,617,760,754,3291,4045
00466700,SCHOOL OF MUSEUM OF FINE ARTS           ,MA,02115-5534,Private      ,13,8,21,867,268,1135
00466900,UPPER CAPE COD REGIONAL VOC TECH        ,MA,02532-3310,Public       ,0,6,6,12,105,117
00527900,GREATER LOWELL REGNL VOC TECH SCH       ,MA,01879-0000,Public       ,0,3,3,24,89,113
00551900,DIMAN REGIONAL VOC TECH INST            ,MA,02723-3519,Public       ,0,11,11,28,76,104
00552300,BLUE HILLS REGIONAL VOC TECH            ,MA,02021-1398,Public       ,3,7,10,23,146,169
00555700,MCCANN TECHNICAL SCHOOL                 ,MA,01247-0000,Public       ,2,8,10,18,68,86
00613600,NATIONAL AVIATION ACADEMY - NEW ENGLAND ,MA,01730-2620,Proprietary  ,12,17,29,90,124,214
00632200,BROCKTON HOSPITAL SCH OF NURSING        ,MA,02302-0000,Private      ,1,17,18,125,413,538
00632400,LABOURE COLLEGE                         ,MA,02124-5698,Private      ,12,80,92,210,745,955
00633100,LAWRENCE MEM HOSPITAL SCH OF NRSNG      ,MA,02155-1643,Private      ,3,23,26,65,378,443
00635200,BAYSTATE MEDICAL CENTER                 ,MA,01199-0001,Private      ,0,2,2,3,29,32
00687300,MARIAN COURT COLLEGE                    ,MA,01907-2896,Private      ,5,11,16,168,105,273
00748100,GIBBS COLLEGE                           ,MA,02116-2904,Proprietary  ,19,47,66,94,241,335
00748400,NEWBURY COLLEGE                         ,MA,02445-5796,Private      ,19,22,41,1869,284,2153
00748600,THE NEW ENGLAND INSTITUTE OF ART        ,MA,02445-7295,Proprietary  ,84,81,165,1972,758,2730
00748800,KAPLAN CAREER INSTITUTE                 ,MA,02129-1644,Proprietary  ,46,148,194,201,709,910
00748801,KAPLAN CAREER INSTITUTE -               ,MA,02215-2606,Proprietary  ,24,106,130,49,259,308
00807800,SPRINGFIELD TECHNICAL COMMUNITY CLG     ,MA,01105-0000,Public       ,176,647,823,2757,4928,7685
00809002,EVEREST COLLEGE - EVEREST INSTITUTE     ,MA,02150-2333,Proprietary  ,36,150,186,138,504,642
00891600,NEW ENGLAND SCHOOL OF LAW               ,MA,02116-0000,Private      ,1,20,21,9,2258,2267
00964500,BARD COLLEGE AT SIMON'S ROCK            ,MA,01230-9702,Private      ,11,1,12,478,23,501
00974700,GORDON-CONWELL THEOLOGICAL SEMINARY     ,MA,01982-0000,Private      ,0,33,33,5,565,570
00975600,UNIVERSITY OF MASS MEDICAL CENTER       ,MA,01655-0000,Public       ,1,17,18,28,802,830
00987700,HENRI'S SCHOOL OF HAIR DESIGN           ,MA,01420-5675,Proprietary  ,3,4,7,25,23,48
00989900,LOWELL ACADEMY HAIRSTYLING INST         ,MA,01852-1909,Proprietary  ,6,6,12,28,46,74
00993600,MIDDLESEX COMMUNITY COLLEGE             ,MA,01730-1197,Public       ,86,129,215,1518,1193,2711
00993602,"MIDDLESEX COMMUNITY COLLEGE, LOWELL     ",MA,01852-0000,Public       ,128,234,362,2371,2138,4509
01121000,BUNKER HILL COMMUNITY COLLEGE           ,MA,02129-2991,Public       ,492,986,1478,4533,7117,11650
01151000,EVEREST INSTITUTE                       ,MA,02135-7638,Proprietary  ,30,142,172,176,556,732
01193000,ROXBURY COMMUNITY COLLEGE               ,MA,02120-3400,Public       ,90,300,390,1086,2739,3825
01204200,MANSFIELD BEAUTY SCHOOLS                ,MA,02169-5061,Proprietary  ,1,10,11,27,75,102
01206800,MANSFIELD BEAUTY SCHOOL                 ,MA,01103-1410,Proprietary  ,1,11,12,11,49,60
01238600,SOUTHEASTERN TECHNICAL INSTITUTE        ,MA,02375-1780,Public       ,2,39,41,49,227,276
01288100,MONTACHUSETT REG VOC TECH SCH           ,MA,01420-4649,Public       ,0,2,2,9,47,56
01292100,EMPIRE BEAUTY SCHOOL                    ,MA,02215-0000,Proprietary  ,23,60,83,187,395,582
01292101,EMPIRE BEAUTY SCHOOL - HYANNIS          ,MA,02601-2022,Proprietary  ,2,5,7,24,26,50
01294800,ROB ROY ACADEMY                         ,MA,02721-5330,Proprietary  ,12,32,44,53,122,175
02063000,MONTSERRAT COLLEGE OF ART               ,MA,01915-0000,Private      ,7,7,14,555,55,610
02063800,BUTERA SCHOOL OF ART                    ,MA,02116-0000,Proprietary  ,0,2,2,36,14,50
02076700,EMPIRE BEAUTY SCHOOL                    ,MA,02148-0000,Proprietary  ,10,24,34,73,186,259
02079400,EMPIRE BEAUTY SCHOOL                    ,MA,02453-0000,Proprietary  ,26,41,67,75,176,251
02092100,MASSACHUSETTS SCHOOL OF BARBERING       ,MA,02169-0000,Proprietary  ,11,46,57,44,133,177
02092200,EMPIRE BEAUTY SCHOOL                    ,MA,01852-0000,Proprietary  ,7,21,28,60,151,211
02122000,NEW ENGLAND HAIR ACADEMY                ,MA,02148-0000,Proprietary  ,11,29,40,63,124,187
02137000,ROB ROY ACADEMY                         ,MA,02780-0000,Proprietary  ,2,15,17,26,53,79
02137200,MASS GEN HOSP DIETETIC INTERNSHIP       ,MA,02114-0000,Private      ,0,0,0,3,10,13
02143000,LONGY SCHOOL OF MUSIC                   ,MA,02138-3599,Private      ,2,4,6,49,139,188
02163500,NEW ENGLAND SCHOOL OF PHOTOGRAPHY       ,MA,02215-0000,Proprietary  ,14,21,35,145,132,277
02163600,MASS SCH OF PROFESSIONAL PSYCHOLOGY     ,MA,02132-0000,Private      ,2,10,12,2,18,20
02169900,ASSABET VALLEY REGIONAL VOC SCHOOL      ,MA,01752-0000,Public       ,1,5,6,18,83,101
02181600,ROB ROY ACADEMY                         ,MA,01609-0000,Proprietary  ,18,40,58,88,194,282
02182900,CAMBRIDGE COLLEGE                       ,MA,02138-5304,Private      ,23,640,663,303,4548,4851
02197900,NORTH BENNET STREET SCHOOL              ,MA,02113-0000,Private      ,1,10,11,39,103,142
02215100,HALLMARK INSTITUTE OF PHOTOGRAPHY       ,MA,01376-0000,Proprietary  ,26,42,68,164,148,312
02219501,MILDRED ELLEY - PITTSFIELD              ,MA,01201-5300,Proprietary  ,0,1,1,6,25,31
02220400,CATHERINE HINDS INST OF ESTHETICS       ,MA,01801-0000,Proprietary  ,8,40,48,55,167,222
02231600,MGH INSTITUTE OF HEALTH PROFESSION      ,MA,02129-0000,Private      ,3,48,51,37,1075,1112
02274300,CONWAY SCHOOL OF LANDSCAPE DESIGN       ,MA,01341-0179,Private      ,0,0,0,3,23,26
02325700,LABARON HAIRDRESSING ACADEMY            ,MA,02740-0000,Proprietary  ,3,5,8,30,48,78
02325800,LABARON HAIRDRESSING ACAD-BROCKTON      ,MA,02301-0000,Proprietary  ,2,9,11,20,50,70
02337400,BANCROFT SCHOOL OF MASSAGE THERAPY      ,MA,01604-4614,Proprietary  ,1,11,12,17,56,73
02338200,BAY STATE SCHOOL OF TECHNOLOGY          ,MA,02021-0000,Proprietary  ,7,77,84,53,377,430
02339400,ROB ROY ACADEMY                         ,MA,02746-0000,Proprietary  ,3,4,7,9,15,24
02491700,CORTIVA INSTITUTE -  BOSTON             ,MA,02472-2577,Proprietary  ,8,39,47,38,235,273
02523900,ELIZABETH GRADY SCHOOL OF ESTHETICS     ,MA,02155-0000,Proprietary  ,7,21,28,42,114,156
02579800,NEW ENGLAND SCHOOL OF ACUPUNCTURE       ,MA,02458-0000,Private      ,0,6,6,1,166,167
03006802,PENNSYLVANIA CULINARY INSTITUTE - LE COR,MA,02142-1221,Proprietary  ,60,167,227,250,678,928
03066700,AILANO SCHOOL OF COSMETOLOGY            ,MA,02303-4740,Proprietary  ,7,6,13,32,33,65
03104000,SHAWSHEEN ADULT TECHNICAL INSTITUTE     ,MA,01821-5499,Public       ,1,1,2,14,46,60
03120800,KAY HARVEY HAIRDRESSING ACADEMY         ,MA,01089-2701,Proprietary  ,5,11,16,21,40,61
03127700,SOUTHERN NEW ENGLAND SCHOOL OF LAW      ,MA,02747-1252,Private      ,0,7,7,3,266,269
03130500,URBAN COLLEGE OF BOSTON                 ,MA,02111-1093,Private      ,2,58,60,48,635,683
03194300,BOSTON GRAD SCH OF PSYCHOANALYSIS       ,MA,02446-4602,Private      ,0,1,1,2,80,82
03196300,LINCOLN TECHNICAL INSTITUTE             ,MA,02145-1102,Proprietary  ,34,120,154,346,802,1148
03196302,LINCOLN TECHNICAL INSTITUTE             ,MA,01852-5119,Proprietary  ,42,117,159,309,720,1029
03205400,JOLIE HAIR & BEAUTY ACADEMY             ,MA,01056-2769,Proprietary  ,5,36,41,22,115,137
03232302,LINCOLN TECHNICAL INSTITUTE             ,MA,02401-1818,Proprietary  ,42,114,156,260,697,957
03235300,MASSACHUSETTS SCHOOL OF LAW             ,MA,01810-1094,Private      ,1,39,40,3,678,681
03240300,HAIR IN MOTION BEAUTY ACADEMY           ,MA,01604-2213,Proprietary  ,1,5,6,8,20,28
03248300,BOSTON BAPTIST COLLEGE                  ,MA,02136-4000,Private      ,4,8,12,98,51,149
03316400,FUNERAL INSTITUTE OF THE NORTHEAST      ,MA,02062-4766,Proprietary  ,0,14,14,21,91,112
03504300,NATL GRAD SCH OF QUALITY SYSTM MGMT     ,MA,02540-0000,Private      ,0,2,2,0,27,27
03763300,MEDICAL PROFESSIONAL INSTITUTE          ,MA,02148-8143,Proprietary  ,7,27,34,22,135,157
03859300,E.I.N.E.                                ,MA,01876-4709,Proprietary  ,2,7,9,4,37,41
03946300,FRANKLIN W. OLIN COLLEGE OF ENGINEERING ,MA,02492-1200,Private      ,8,0,8,400,4,404
03965300,NEW ENGLAND COLLEGE OF FINANCE          ,MA,02110-1605,Proprietary  ,1,28,29,13,124,137
04039300,SULLIVAN AND COGLIANO TRAINING CENTER   ,MA,02301-1822,Proprietary  ,28,394,422,84,1294,1378
04116900,DIGRIGOLI SCHOOL OF COSMETOLOGY         ,MA,01089-4623,Proprietary  ,3,14,17,24,47,71
04128000,MILLENNIUM TRAINING INSTITUTE           ,MA,01801-6386,Proprietary  ,1,34,35,7,99,106
04128900,CENTRAL MASS SCHOOL OF MASSAGE AND THERA,MA,01562-1712,Proprietary  ,1,3,4,6,26,32
00324204,CARNEGIE MELLON UNIVERSITY - QATAR      ,FC,00000-0000,Private      ,0,5,5,0,8,8
00324206,CARNEGIE MELLON UNIVERSITY  - THE HEINZ ,FC,00000-0000,Private      ,0,0,0,0,5,5
00337112,TEMPLE UNIVERSITY - JAPAN               ,FC,00000-0000,Private      ,3,7,10,40,39,79
00369101,MIDDLEBURY COLLEGE - FRANCE             ,FC,00000-0000,Private      ,0,4,4,5,9,14
00369102,MIDDLEBURY COLLEGE - GERMANY            ,FC,00000-0000,Private      ,1,0,1,2,8,10
00369103,MIDDLEBURY COLLEGE - ITALY              ,FC,00000-0000,Private      ,0,0,0,5,7,12
00369104,MIDDLEBURY COLLEGE - SPAIN              ,FC,00000-0000,Private      ,0,2,2,7,19,26
00369105,MIDDLEBURY COLLEGE - RUSSIA             ,FC,00000-0000,Private      ,0,3,3,1,7,8
00369107,MIDDLEBURY COLLEGE - BREAD LOAF SCHOOL/E,FC,00000-0000,Private      ,0,0,0,0,1,1
00401000,INSTITUT INTERNAT'L D'ETUDES FRANCA     ,FC,00000-0000,Public       ,0,1,1,1,4,5
00401200,HEBREW UNIVERSITY OF JERUSALEM (THE)    ,FC,00000-0000,Public       ,3,3,6,39,125,164
00403000,UNIVERSITY OF CAMBRIDGE                 ,FC,00000-0000,Public       ,0,1,1,5,60,65
00503400,AMERICAN UNIVERSITY OF CAIRO            ,FC,00000-0000,Private      ,4,18,22,74,242,316
00667100,KATHOLIEKE UNIVERSITEIT LEUVEN          ,FC,00000-0000,Private      ,0,5,5,2,54,56
00669100,UNIVERSITY OF CAMBRIDGE - PEMBROKE      ,FC,00000-0000,Public       ,0,0,0,2,14,16
00669200,UNIVERSITY OF LEEDS                     ,FC,00000-0000,Public       ,0,2,2,17,106,123
00669300,UNIV OF LONDON-LONDON SCHOOL ECON       ,FC,00000-0000,Public       ,2,12,14,25,554,579
00669400,SCH OF ORIENTAL & AFRICAN STUDIES       ,FC,00000-0000,Public       ,1,4,5,14,168,182
00669500,UNIV OF LONDON-UNIVERSITY COLLEGE       ,FC,00000-0000,Public       ,1,15,16,24,405,429
00669600,UNIV OF LONDON-SCH ADVANCED STUDY       ,FC,00000-0000,Public       ,0,1,1,0,19,19
00669700,"QUEEN MARY, UNIVERSITY OF LONDON        ",FC,00000-0000,Public       ,0,5,5,23,139,162
00669900,UNIVERSITY OF SUSSEX                    ,FC,00000-0000,Public       ,0,3,3,16,96,112
00670000,"UNIVERSITY OF YORK, THE                 ",FC,00000-0000,Public       ,0,5,5,14,110,124
00670400,UNIVERSITY COLLEGE CORK                 ,FC,00000-0000,Public       ,0,2,2,15,69,84
00671300,UPPSALA UNIVERSITY                      ,FC,00000-0000,Public       ,0,2,2,0,46,46
00671500,UNIVERSITY OF GENEVA                    ,FC,00000-0000,Public       ,0,5,5,5,70,75
00683900,UNIVERSITY OF EDINBURGH                 ,FC,00000-0000,Public       ,5,19,24,148,581,729
00684200,UNIVERSITY OF DUBLIN TRINITY COLLEG     ,FC,00000-0000,Public       ,2,3,5,46,176,222
00685000,UNIVERSITY OF CAMBRIDGE - DOWNING C     ,FC,00000-0000,Public       ,0,0,0,1,7,8
00763200,UNIVERSITY OF BRISTOL                   ,FC,00000-0000,Public       ,0,3,3,13,80,93
00768100,COLLEGE OF EUROPE                       ,FC,00000-0000,Private      ,0,0,0,0,4,4
00770500,ROYAL COLLEGE OF SURGEONS IN IRELAN     ,FC,00000-0000,Private      ,1,2,3,5,70,75
00788100,AMERICAN UNIVERSITY OF PARIS            ,FC,00000-0000,Private      ,14,16,30,246,228,474
00837100,AMERICAN UNIVERSITY OF BEIRUT           ,FC,00000-0000,Private      ,5,5,10,86,85,171
00837300,TEL-AVIV UNIVERSITY                     ,FC,00000-0000,Public       ,0,1,1,7,74,81
00837600,VRIJE UNIVERSITEIT AMSTERDAM            ,FC,00000-0000,Public       ,0,1,1,1,31,32
00837700,UNIVERSITEIT VAN AMSTERDAM(UNIVERSI     ,FC,00000-0000,Public       ,0,6,6,4,121,125
00838000,UNIVERSITY OF WARWICK                   ,FC,00000-0000,Public       ,0,5,5,8,75,83
00838300,UNIVERSITY OF GLASGOW                   ,FC,00000-0000,Public       ,1,4,5,43,362,405
00839300,UNIVERSITY OF OSLO                      ,FC,00000-0000,Public       ,0,2,2,3,24,27
00839400,UNIVERSITY OF OXFORD                    ,FC,00000-0000,Public       ,1,11,12,7,257,264
00839800,UNIVERSITY OF SHEFFIELD (THE)           ,FC,00000-0000,Public       ,0,1,1,13,75,88
00839900,UNIVERSITY OF SOUTHAMPTON               ,FC,00000-0000,Public       ,0,0,0,10,45,55
00845200,ABERYSTWYTH UNIVERSITY                  ,FC,00000-0000,Public       ,0,2,2,9,36,45
00845800,LOUGHBOROUGH UNIVERSITY                 ,FC,00000-0000,Public       ,0,2,2,1,4,5
00846000,UNIVERSITY OF NEWCASTLE UPON TYNE       ,FC,00000-0000,Public       ,1,3,4,11,89,100
00846100,UNIVERSITY OF SAINT ANDREWS             ,FC,00000-0000,Public       ,2,6,8,199,200,399
00850500,UNIVERSITY OF MELBOURNE                 ,FC,00000-0000,Public       ,1,32,33,19,157,176
00858600,SWANSEA UNIVERSITY                      ,FC,00000-0000,Public       ,1,4,5,10,38,48
00858700,UNIVERSITY OF DURHAM                    ,FC,00000-0000,Public       ,0,7,7,12,151,163
00866500,UNIVERSITY OF KENT AT CANTERBURY (THE)  ,FC,00000-0000,Public       ,0,8,8,21,139,160
00867000,UNIVERSITY OF NEW SOUTH WALES           ,FC,00000-0000,Public       ,3,30,33,20,124,144
00868700,UNIVERSITY OF ESSEX                     ,FC,00000-0000,Public       ,0,1,1,10,77,87
00869300,CITY UNIVERSITY                         ,FC,00000-0000,Public       ,0,5,5,4,165,169
00890800,THE UNIVERSITY OF BIRMINGHAM            ,FC,00000-0000,Public       ,0,6,6,10,96,106
00891000,UNIVERSITY OF HULL                      ,FC,00000-0000,Public       ,0,0,0,6,18,24
00892000,UNIVERSITY OF NOTTINGHAM                ,FC,00000-0000,Public       ,1,0,1,12,97,109
00900600,UNIVERSITY OF SALFORD (THE)             ,FC,00000-0000,Public       ,0,1,1,3,9,12
00908400,"UNIV OF LONDON, BIRKBECK                ",FC,00000-0000,Public       ,0,5,5,1,86,87
00908500,UNIV OF LONDON KING'S COLLEGE           ,FC,00000-0000,Public       ,1,11,12,35,328,363
00908600,UNIVERSITY OF LONDON - ROYAL HOLLOWAY   ,FC,00000-0000,Public       ,0,3,3,12,81,93
00914300,BAR-ILAN UNIVERSITY                     ,FC,00000-0000,Private      ,0,1,1,7,16,23
00924700,ARCHITECTURAL ASSOC SCH OF ARCHITEC     ,FC,00000-0000,Private      ,0,0,0,1,23,24
00924900,UNIVERSITY OF LIVERPOOL                 ,FC,00000-0000,Public       ,1,11,12,20,89,109
00936800,UNIVERSITY OF ABERDEEN                  ,FC,00000-0000,Public       ,2,8,10,45,114,159
00942300,ROYAL COLLEGE OF ART                    ,FC,00000-0000,Public       ,0,0,0,4,60,64
00942800,TECHNION-ISRAEL INST OF TECHLGY         ,FC,00000-0000,Public       ,0,1,1,1,83,84
00944200,UNIVERSITY OF EXETER                    ,FC,00000-0000,Public       ,0,1,1,9,96,105
00944400,UNIVERSITY OF LANCASTER                 ,FC,00000-0000,Public       ,1,1,2,8,40,48
00963400,UNIVERSITY OF OXFORD ST CATHERINE'S     ,FC,00000-0000,Public       ,0,1,1,0,11,11
00980800,UNIVERSITY OF STRATHCLYDE               ,FC,00000-0000,Public       ,0,1,1,5,38,43
00986000,UNIVERSITY OF SURREY                    ,FC,00000-0000,Public       ,0,3,3,10,20,30
00990600,PONTIFICAL NORTH AMERICAN COLLEGE       ,FC,00000-0000,Private      ,0,2,2,0,8,8
00992700,UNIVERSITY OF CAMBRIDGE - FITZWILLI     ,FC,00000-0000,Public       ,0,0,0,0,5,5
01006700,LUND UNIVERSITY                         ,FC,00000-0000,Public       ,0,10,10,3,90,93
01008400,UNIVERSITY OF CAPE TOWN                 ,FC,00000-0000,Private      ,2,14,16,8,73,81
01008700,UNIVERSITY OF OXFORD ST PETER'S COL     ,FC,00000-0000,Public       ,0,0,0,0,3,3
01008800,UNIVERSITY OF OXFORD - CORPUS CHRIS     ,FC,00000-0000,Public       ,0,0,0,0,5,5
01008900,CENTRAL SCHOOL OF SPEECH AND DRAMA      ,FC,00000-0000,Private      ,0,1,1,14,57,71
01009000,UNIVERSITY OF OXFORD - BALLIOL COLL     ,FC,00000-0000,Public       ,1,0,1,3,13,16
01014300,UNIVERSITY OF READING                   ,FC,00000-0000,Public       ,0,2,2,14,55,69
01015700,CARDIFF UNIVERSITY                      ,FC,00000-0000,Public       ,0,3,3,10,50,60
01015900,PONTIFICIA UNIVERSITA GREGORIANA        ,FC,00000-0000,Private      ,0,2,2,0,7,7
01016000,CG JUNG INST                            ,FC,00000-0000,Private      ,0,0,0,0,3,3
01018800,UNIVERSITY COLLEGE DUBLIN               ,FC,00000-0000,Public       ,0,4,4,8,208,216
01019000,UNIVERSITY OF CAMBRIDGE CHURCHILL C     ,FC,00000-0000,Public       ,0,0,0,0,6,6
01022800,UNIVERSITY OF STIRLING                  ,FC,00000-0000,Public       ,0,1,1,19,43,62
01033200,UNIVERSITY OF CAMBRIDGE - CLARE COL     ,FC,00000-0000,Public       ,0,0,0,1,8,9
01045600,UNIVERSITY OF HAIFA                     ,FC,00000-0000,Public       ,1,2,3,12,9,21
01047200,INST EUROPEEN OPEEN D'ADMINISTRATIO     ,FC,00000-0000,Private      ,0,6,6,0,79,79
01049300,CRANFIELD UNIVERSITY                    ,FC,00000-0000,Public       ,0,1,1,1,15,16
01052000,TRINITY LABAN                           ,FC,00000-0000,Public       ,1,0,1,6,21,27
01052001,LABAN CENTER FOR MOVEMENT & DANCE       ,FC,00000-0000,Public       ,0,0,0,1,12,13
01052500,UNIVERSITY OF HERTFORDSHIRE             ,FC,00000-0000,Public       ,0,1,1,12,14,26
01057400,LONDON INTRNTL FILM SCHOOL              ,FC,00000-0000,Private      ,0,3,3,4,36,40
01058600,INSTITUTE OF SOCIAL STUDIES             ,FC,00000-0000,Private      ,0,0,0,0,20,20
01058800,AUSTRALIAN NATIONAL UNIVERSITY          ,FC,00000-0000,Public       ,1,12,13,9,58,67
01058900,BANGOR UNIVERSITY                       ,FC,00000-0000,Public       ,0,1,1,4,23,27
01059400,"RICHMOND, THE AMERICAN INT UNI IN LONDON",FC,00000-0000,Private      ,10,4,14,328,37,365
01059900,INST D'ETUDES POLITIQUES DE PARIS       ,FC,00000-0000,Public       ,0,2,2,1,54,55
01068100,MACQUARIE UNIVERSITY                    ,FC,00000-0000,Public       ,2,9,11,8,79,87
01069200,UNIVERSITY OF QUEENSLAND (THE)          ,FC,00000-0000,Public       ,2,45,47,24,167,191
01078900,UNIVERSITY OF OXFORD - WORCESTER CO     ,FC,00000-0000,Public       ,0,0,0,0,12,12
01079200,CITY AND GUILDS OF LONDON INSTITUTE     ,FC,00000-0000,Private      ,0,0,0,2,4,6
01079700,"NATIONAL UNIVERSITY OF IRELAND, MAY     ",FC,00000-0000,Public       ,1,8,9,1,9,10
01080300,SEMMELWEIS UNIVERSITY OF BUDAPEST       ,FC,00000-0000,Public       ,0,2,2,2,43,45
01081600,KINGSTON UNIVERSITY                     ,FC,00000-0000,Public       ,0,3,3,37,100,137
01083800,UNIVERSITITY OF BERGEN (UOB)            ,FC,00000-0000,Public       ,0,0,0,1,6,7
01086400,UNIV OF DUNDEE                          ,FC,00000-0000,Public       ,0,6,6,7,70,77
01086600,UNIVERSITY OF OXFORD - MAGDALEN COLLEGE ,FC,00000-0000,Public       ,0,1,1,1,17,18
01086700,UNIVERSITY OF OXFORD ST JOHN'S COLL     ,FC,00000-0000,Public       ,0,1,1,2,7,9
01091400,MONASH UNIVERSITY                       ,FC,00000-0000,Public       ,2,10,12,11,48,59
01091500,UNIV OF EAST ANGLIA                     ,FC,00000-0000,Public       ,0,2,2,15,66,81
01094200,UNIVERSITY OF OXFORD - ST HUGH'S CO     ,FC,00000-0000,Public       ,0,0,0,1,8,9
01097700,UNIVERSIDAD CENTRAL DEL ESTE            ,FC,00000-0000,Private      ,18,81,99,104,837,941
01098000,SOMERVILLE COLLEGE                      ,FC,00000-0000,Public       ,0,0,0,0,6,6
01099900,UNIV OF OXFORD - WADHAM COLLEGE         ,FC,00000-0000,Public       ,0,0,0,0,6,6
01104400,PONTIFICIA UNIVERSITA SAN TOMMASO       ,FC,00000-0000,Private      ,0,2,2,0,16,16
01105300,UNIVERSITY OF OXFORD - ST HILDA'S C     ,FC,00000-0000,Public       ,0,2,2,0,12,12
01105400,UNIVERSITY OF OXFORD - ST ANNE'S CO     ,FC,00000-0000,Public       ,0,0,0,0,10,10
01105500,UNIV OF OXFORD - LADY MARGARET HALL     ,FC,00000-0000,Public       ,0,0,0,0,12,12
01105600,UNIVERSITY OF OXFORD - UNIVERSITY C     ,FC,00000-0000,Public       ,0,1,1,1,20,21
01105700,UNIVERSITY OF OXFORD - TRINITY COLL     ,FC,00000-0000,Public       ,0,0,0,2,7,9
01105800,UNIVERSITY OF OXFORD-ST EDMUND HALL     ,FC,00000-0000,Public       ,0,1,1,0,10,10
01105900,UNIVERSITY OF OXFORD ST ANTONY'S CO     ,FC,00000-0000,Public       ,0,4,4,0,40,40
01106000,UNIVERSITY OF OXFORD - QUEEN'S COLL     ,FC,00000-0000,Public       ,0,0,0,0,7,7
01106100,UNIVERSITY OF OXFORD - PEMBROKE COL     ,FC,00000-0000,Public       ,0,1,1,1,11,12
01106200,UNIVERSITY OF OXFORD - ORIEL COLLEG     ,FC,00000-0000,Public       ,0,1,1,0,11,11
01106300,UNIVERSITY OF OXFORD - NUFFIELD COL     ,FC,00000-0000,Public       ,0,0,0,0,5,5
01106400,UNIVERSITY OF OXFORD - NEW COLLEGE      ,FC,00000-0000,Public       ,0,0,0,1,20,21
01106500,UNIVERSITY OF OXFORD MERTON COLLEGE     ,FC,00000-0000,Public       ,0,1,1,0,11,11
01106600,UNIVERSITY OF OXFORD - LINCOLN COLL     ,FC,00000-0000,Public       ,0,0,0,1,24,25
01106700,UNIVERSITY OF OXFORD - KEBLE COLLEG     ,FC,00000-0000,Public       ,0,1,1,1,5,6
01106800,UNIVERSITY OF OXFORD - JESUS COLLEG     ,FC,00000-0000,Public       ,0,0,0,1,10,11
01106900,UNIVERSITY OF OXFORD - HERTFORD COL     ,FC,00000-0000,Public       ,0,0,0,0,8,8
01107000,UNIVERSITY OF OXFORD EXETER COLLEGE     ,FC,00000-0000,Public       ,0,1,1,0,21,21
01107100,UNIV OF OXFORD - CHRIST CHURCH          ,FC,00000-0000,Public       ,0,1,1,2,16,18
01107200,UNIVERSITY OF OXFORD - BRASENOSE CO     ,FC,00000-0000,Public       ,0,1,1,0,4,4
01109100,FLINDERS UNIVERSITY OF S AUSTRALIA      ,FC,00000-0000,Public       ,1,3,4,1,15,16
01109400,UNIVERSITY OF WESTERN AUSTRALIA (THE)   ,FC,00000-0000,Public       ,0,3,3,7,20,27
01156700,"IMPERIAL COLLEGE OF SCIENCE, TECHNOLOGY ",FC,00000-0000,Public       ,0,1,1,6,52,58
01167900,UNIVERSITY OF BATH                      ,FC,00000-0000,Public       ,0,2,2,10,33,43
01168300,FRANKLIN COLLEGE  SWITZERLAND           ,FC,00000-0000,Private      ,6,0,6,360,10,370
01175800,UNIV OF CAMBRIDGE - PETERHOUSE          ,FC,00000-0000,Public       ,0,0,0,1,7,8
01176400,ROYAL ACADEMY OF MUSIC                  ,FC,00000-0000,Public       ,0,0,0,10,15,25
01176500,GOLDSMITHS' COLLEGE-UNIV OF LONDON      ,FC,00000-0000,Public       ,0,6,6,22,184,206
01176600,UNIV OF LONDON - INST OF EDUC           ,FC,00000-0000,Public       ,0,3,3,2,25,27
01178000,BRUNEL UNIVERSITY                       ,FC,00000-0000,Public       ,0,0,0,1,1,2
01183800,UNIVERSITY OF OXFORD - MANSFIELD CO     ,FC,00000-0000,Public       ,0,0,0,1,2,3
01207500,UNIVERSITY CAMBRIDGE - TRINITY COLL     ,FC,00000-0000,Public       ,0,0,0,3,10,13
01207800,VICTORIA UNIV OF WELLINGTON             ,FC,00000-0000,Public       ,3,23,26,18,64,82
01209600,ECOLE HåTELIERE DE LAUSANNE             ,FC,00000-0000,Private      ,0,1,1,1,2,3
01210100,UNIVERSITY OF CAMBRIDGE - GIRTON CO     ,FC,00000-0000,Public       ,0,0,0,2,1,3
01213600,VICTORIA UNIV OF MANCHESTER (THE)       ,FC,00000-0000,Public       ,0,8,8,17,116,133
01219800,UNIVERSITY OF BRADFORD                  ,FC,00000-0000,Public       ,0,1,1,3,28,31
01220100,UNIVERSITY OF OXFORD - REGENT'S PAR     ,FC,00000-0000,Public       ,0,0,0,1,7,8
01220600,JAMES COOK UNIVERSITY                   ,FC,00000-0000,Public       ,3,11,14,30,83,113
01221500,BIRMINGHAM CITY UNIVERSITY              ,FC,00000-0000,Public       ,1,1,2,7,16,23
01222300,JAGIELLONIAN UNIVERSITY COLLEGIUM M     ,FC,00000-0000,Public       ,0,0,0,3,54,57
01222500,UNIVERSITY OF SZEGED FACULTY OF MEDICINE,FC,00000-0000,Public       ,0,0,0,0,7,7
01225800,ASTON UNIVERSITY                        ,FC,00000-0000,Public       ,0,1,1,1,17,18
01227500,UNIVERSITY OF OXFORD - WOLFSON COLL     ,FC,00000-0000,Public       ,0,1,1,0,22,22
01230200,GONVILLE & CAIUS COLLEGE                ,FC,00000-0000,Public       ,0,2,2,0,6,6
01233300,UNIV OF THE ARTS LONDON- CAMBERWELL COLL,FC,00000-0000,Public       ,0,2,2,11,12,23
01233500,ROYAL COLLEGE OF MUSIC                  ,FC,00000-0000,Public       ,0,0,0,4,19,23
01233700,WROCLAW UNIVERSITY OF MEDICINE          ,FC,00000-0000,Public       ,0,0,0,1,4,5
01234100,UNIVERSITY OF WALES - ST DAVID'S UN     ,FC,00000-0000,Public       ,1,4,5,5,19,24
01236000,EDINBURGH COLLEGE OF ART                ,FC,00000-0000,Public       ,0,0,0,7,45,52
01242100,UNIV OF AUCKLAND                        ,FC,00000-0000,Public       ,2,22,24,18,84,102
01253900,UNIVERSITY OF THE ARTS LONDON IDO - CENT,FC,00000-0000,Public       ,1,3,4,53,104,157
01254000,UNIVERSIDAD DE NAVARRA                  ,FC,00000-0000,Private      ,0,3,3,4,25,29
01276500,UNIVERSITY OF OXFORD - LINACRE COLL     ,FC,00000-0000,Public       ,0,0,0,0,15,15
01276600,"NATIONAL UNIVERSITY IRELAND, GALWAY     ",FC,00000-0000,Public       ,1,5,6,17,85,102
01280200,PONTIFICIA UNIV CATOLICA MAD Y MAES     ,FC,00000-0000,Private      ,15,14,29,103,170,273
01281100,INST TECNOLOGICO DE SANTO DOMINGO       ,FC,00000-0000,Private      ,6,13,19,27,117,144
01283900,UNIVERSITY OF CAMBRIDGE - SAINT JOH     ,FC,00000-0000,Public       ,0,1,1,0,14,14
01286200,MOUNTVIEW ACADEMY OF THEATRE ARTS       ,FC,00000-0000,Private      ,0,0,0,2,5,7
01297800,UNIVERSITY OF HUDDERSFIELD (THE)        ,FC,00000-0000,Public       ,0,2,2,2,9,11
01315300,MASSEY UNIVERSITY                       ,FC,00000-0000,Public       ,2,33,35,13,100,113
01322500,COLLEGE OF LAW                          ,FC,00000-0000,Private      ,0,1,1,0,29,29
02052400,DARWIN COLLEGE                          ,FC,00000-0000,Public       ,0,1,1,0,16,16
02082400,UNIVERSITY OF CAMBRIDGE - QUEEN'S C     ,FC,00000-0000,Public       ,0,1,1,0,20,20
02083400,UNIVERSITY OF CAMBRIDGE - WOLFSON C     ,FC,00000-0000,Public       ,0,0,0,0,8,8
02087400,UNIVERSITY OF CAMBRIDGE - NEWNHAM C     ,FC,00000-0000,Public       ,0,0,0,2,11,13
02087900,OXFORD BROOKES UNIVERSITY               ,FC,00000-0000,Public       ,1,4,5,20,55,75
02094100,BEN-GURION UNIV                         ,FC,00000-0000,Public       ,0,2,2,0,174,174
02094400,UNIV OF CAMBRIDGE - ST EDMUND'S HOU     ,FC,00000-0000,Public       ,0,1,1,1,11,12
02095500,LONDON BUS SCHOOL                       ,FC,00000-0000,Private      ,0,9,9,3,168,171
02098700,FATIMA COLLEGE OF MEDICINE              ,FC,00000-0000,Private      ,0,4,4,2,75,77
02101900,ROEHAMPTON UNIVERSITY                   ,FC,00000-0000,Public       ,0,2,2,17,73,90
02108600,LONDON ACADEMY OF MUSIC & DRAMATIC      ,FC,00000-0000,Private      ,0,0,0,10,21,31
02115900,UNIVERSITY OF PORTSMOUTH                ,FC,00000-0000,Public       ,0,1,1,8,16,24
02116700,UNIVERSITY OF CAMBRIDGE - LUCY CAVE     ,FC,00000-0000,Public       ,0,0,0,1,9,10
02120000,UNIV OF LONDON - COURTALD INST OF A     ,FC,00000-0000,Public       ,0,0,0,1,34,35
02133400,UNIVERSITY OF CAMBRIDGE - SIDNEY SU     ,FC,00000-0000,Public       ,0,0,0,2,7,9
02142000,UNIVERSITY OF CAMBRIDGE - HOMERTON      ,FC,00000-0000,Public       ,0,0,0,0,8,8
02149700,UNIVERSITY OF WINCHESTER (THE)          ,FC,00000-0000,Public       ,2,0,2,7,5,12
02156800,UNIV OF OTAGO                           ,FC,00000-0000,Public       ,1,9,10,5,36,41
02162300,"IESE BUSINESS SCH, UNIV OF NAVARRA      ",FC,00000-0000,Private      ,0,4,4,6,86,92
02167400,UNIVERSITY OF CAMBRIDGE - CORPUS CH     ,FC,00000-0000,Public       ,0,2,2,0,8,8
02175700,OHR SOMAYACH INSTITUTIONS               ,FC,00000-0000,Private      ,0,1,1,5,2,7
02177700,KING'S COLLEGE- UNIV OF CAMBRIDGE       ,FC,00000-0000,Public       ,0,1,1,1,24,25
02180500,MIDDLESEX UNIVERSITY                    ,FC,00000-0000,Public       ,1,2,3,14,74,88
02181000,UNIVERSITY OF SOUTH AUSTRALIA           ,FC,00000-0000,Public       ,0,3,3,2,23,25
02183500,UNIV OF OXFORD - WYCLIFFE HALL          ,FC,00000-0000,Public       ,0,1,1,0,8,8
02186000,UNIVERSITY OF CAMBRIDGE - MAGDALENE     ,FC,00000-0000,Public       ,0,0,0,0,8,8
02186100,UNIVERSITY OF CAMBRIDGE - EMMANUEL      ,FC,00000-0000,Public       ,0,1,1,0,9,9
02189600,UNIVERSITY OF GRONINGEN                 ,FC,00000-0000,Public       ,0,0,0,2,19,21
02194800,UNIVERSITY OF THE WEST OF ENGLAND -     ,FC,00000-0000,Public       ,0,0,0,10,19,29
02195100,UNIV OF WESTMINSTER                     ,FC,00000-0000,Public       ,0,9,9,37,132,169
02196700,GUILDHALL SCHOOL OF MUSIC & DRAMA       ,FC,00000-0000,Public       ,0,1,1,10,16,26
02207300,UNIVERSITY OF CAMBRIDGE - CHRIST'S      ,FC,00000-0000,Public       ,0,0,0,0,9,9
02207400,CHINESE UNIVERSITY OF HONG KONG (THE)   ,FC,00000-0000,Public       ,1,0,1,9,31,40
02209500,UNIVERSITEIT UTRECHT                    ,FC,00000-0000,Public       ,0,2,2,4,49,53
02210000,UNIV OF LONDON - LONDON SCHOOL OF H     ,FC,00000-0000,Public       ,0,4,4,0,62,62
02212300,UNIVERSITY OF CAMBRIDGE - ROBINSON      ,FC,00000-0000,Public       ,0,0,0,0,6,6
02225300,UNIV OF CANTERBURY                      ,FC,00000-0000,Public       ,1,6,7,18,37,55
02229100,UNIVERSITY OF LEICESTER                 ,FC,00000-0000,Public       ,0,11,11,5,88,93
02229600,SACKLER SCHOOL OF MEDICINE              ,FC,00000-0000,Public       ,0,2,2,0,195,195
02232100,UNIVERSITY OF CAMBRIDGE                 ,FC,00000-0000,Public       ,0,0,0,1,15,16
02233300,"ST GEORGE'S UNIV, SCH OF MEDICINE       ",FC,00000-0000,Proprietary  ,1,438,439,13,2984,2997
02235300,LONDON METROPOLITAN UNIVERSITY          ,FC,00000-0000,Public       ,0,15,15,46,193,239
02240900,AISH HATORAH CLG OF JEWISH STUDIES      ,FC,00000-0000,Private      ,0,2,2,1,5,6
02244400,AMERICAN UNIV OF THE CARIBBEAN          ,FC,00000-0000,Proprietary  ,0,147,147,9,1219,1228
02257100,COVENTRY UNIVERSITY                     ,FC,00000-0000,Public       ,0,2,2,7,14,21
02266600,UNIVERSITY OF LONDON - SAINT GEORGE     ,FC,00000-0000,Public       ,0,0,0,0,16,16
02271700,UNIVERSITY OF CAMBRIDGE - CLARE HAL     ,FC,00000-0000,Public       ,0,0,0,0,8,8
02271800,UNIV OF OXFORD - CAMPION HALL           ,FC,00000-0000,Public       ,1,0,1,1,5,6
02271900,UNIVERSITY OF OXFORD - BLACKFRIARS      ,FC,00000-0000,Public       ,0,0,0,1,6,7
02272100,UNIV OF OXFORD - GREYFRIARS             ,FC,00000-0000,Public       ,0,0,0,0,1,1
02272200,UNIV OF CAMBRIDGE - NEW HALL            ,FC,00000-0000,Public       ,0,0,0,0,3,3
02273600,QUEEN'S UNIV OF BELFAST (THE)           ,FC,00000-0000,Public       ,0,5,5,11,88,99
02273900,HERIOT WATT UNIVERSITY                  ,FC,00000-0000,Public       ,0,2,2,7,29,36
02276700,NYENRODE BUSINESS UNIVERSITEIT          ,FC,00000-0000,Private      ,0,0,0,0,3,3
02279700,UNIVERSITY OF MANCHESTER - INSTITUT     ,FC,00000-0000,Public       ,0,0,0,18,87,105
02293400,ECOLE DES HAUTES ETUDES COMERCIALS      ,FC,00000-0000,Public       ,0,4,4,1,44,45
02296300,UNIVERSITY OF CAMBRIDGE - JESUS COL     ,FC,00000-0000,Public       ,0,0,0,0,7,7
02310500,DE MONTFORT UNIVERSITY                  ,FC,00000-0000,Public       ,0,1,1,4,14,18
02320500,ROYAL NORTHERN COLLEGE OF MUSIC         ,FC,00000-0000,Public       ,0,0,0,1,5,6
02335100,UNIV OF CAMBRIDGE - TRINITY HALL        ,FC,00000-0000,Public       ,0,0,0,1,15,16
02338900,UNIVERSITY  FOR THE CREATIVE ARTS       ,FC,00000-0000,Public       ,0,0,0,1,4,5
02338903,KENT INSTITUTE OF ART & DESIGN          ,FC,00000-0000,Public       ,0,0,0,0,1,1
02347300,ESCUELA AUTONOMA DE CIENCIAS MEDICA     ,FC,00000-0000,Private      ,0,0,0,0,3,3
02351800,UNIVERSIDAD IBEROAMERICANA (UNIBE       ,FC,00000-0000,Private      ,12,106,118,142,1208,1350
02355200,ECOLE SUPERIEURE DE CUISINE FRANCAISE-FE,FC,00000-0000,Public       ,3,6,9,8,24,32
02363000,GSA CONSERVATOIRE                       ,FC,00000-0000,Private      ,0,0,0,5,2,7
02502600,PECSI ORVOSTUDOMANYI EGYETEM (PECS      ,FC,00000-0000,Public       ,0,1,1,1,19,20
02545700,GLASGOW SCHOOL OF ART                   ,FC,00000-0000,Public       ,0,0,0,14,37,51
02561600,SOUTHAMPTON SOLENT UNIVERSITY           ,FC,00000-0000,Public       ,0,0,0,3,2,5
02579600,MURDOCH UNIVERSITY                      ,FC,00000-0000,Public       ,0,14,14,8,64,72
02588000,UNIVERSITY OF ULSTER                    ,FC,00000-0000,Public       ,4,0,4,10,21,31
02591800,CURTIN UNIVERSITY OF TECHNOLOGY         ,FC,00000-0000,Public       ,0,7,7,1,25,26
02592300,MILLTOWN INST OF THEOLOGY & PHILOSO     ,FC,00000-0000,Private      ,0,0,0,0,4,4
02604300,AALBORG UNIVERSITY                      ,FC,00000-0000,Public       ,1,0,1,5,18,23
02611500,HELSINKI SCH OF ECONOMICS & BUS ADM     ,FC,00000-0000,Public       ,0,0,0,2,6,8
02611600,ECOL NATIONAL DES PONTS ET CHAUSSEE     ,FC,00000-0000,Public       ,0,1,1,0,9,9
02611700,DUBLIN CITY UNIVERSITY                  ,FC,00000-0000,Public       ,0,1,1,8,40,48
02622500,DENMARKS TEKNISKE UNIVERSITET           ,FC,00000-0000,Public       ,0,1,1,0,8,8
02623200,UNIVERSITY OF NEWCASTLE (THE)           ,FC,00000-0000,Public       ,4,4,8,14,22,36
03012700,UNIVERSITY OF BUCKINGHAM                ,FC,00000-0000,Private      ,1,0,1,6,14,20
03029400,KEELE UNIVERSITY                        ,FC,00000-0000,Public       ,0,0,0,3,4,7
03029500,NORTHUMBRIA UNIVERSITY                  ,FC,00000-0000,Public       ,1,1,2,8,31,39
03029800,NORGES HANDELSHOYSKOLE                  ,FC,00000-0000,Public       ,0,0,0,0,4,4
03033300,MANCHESTER METROPOLITAN UNIV            ,FC,00000-0000,Public       ,0,3,3,14,35,49
03045000,UNIVERSITY OF EAST LONDON               ,FC,00000-0000,Public       ,1,6,7,12,47,59
03050100,STUDIO ART CENTERS INTERNATIONAL        ,FC,00000-0000,Private      ,1,0,1,21,50,71
03066800,PONTIFICIO ATENEO DELLA SANTA CROCE     ,FC,00000-0000,Private      ,0,3,3,1,13,14
03067200,UNIVERSITY OF SYDNEY                    ,FC,00000-0000,Public       ,3,42,45,27,264,291
03073800,UNIV OF DEBRECEN MED & HEALTH SCI       ,FC,00000-0000,Public       ,0,4,4,4,26,30
03080300,SHEFFIELD HALLAM UNIVERSITY             ,FC,00000-0000,Public       ,0,0,0,3,11,14
03084300,UNIVERSITY OF LIMERICK                  ,FC,00000-0000,Public       ,0,1,1,22,39,61
03086900,AMERN GRAD SCHL OF BUS THE INST OF      ,FC,00000-0000,Private      ,0,0,0,0,2,2
03088700,ROYAL SCOTTISH ACAD MUSIC & DRAMA       ,FC,00000-0000,Public       ,0,0,0,18,21,39
03091400,UNIVERSITY OF WOLLONGONG                ,FC,00000-0000,Public       ,2,5,7,11,24,35
03091500,UNIVERSITY OF CANBERRA                  ,FC,00000-0000,Public       ,1,3,4,6,12,18
03091700,KAROL MARCINKOWSKI UNIV OF MED SCI      ,FC,00000-0000,Public       ,0,5,5,13,192,205
03092500,NOTTINGHAM TRENT UNIVERSITY             ,FC,00000-0000,Public       ,0,2,2,5,27,32
03095000,RMIT UNIVERSITY                         ,FC,00000-0000,Public       ,2,5,7,7,33,40
03095400,BOND UNIVERSITY                         ,FC,00000-0000,Private      ,5,18,23,38,92,130
03095900,ESSEC BUSINESS SCHOOL                   ,FC,00000-0000,Private      ,0,0,0,0,26,26
03096100,LA TROBE UNIVERSITY                     ,FC,00000-0000,Public       ,1,7,8,12,39,51
03096900,DEAKIN UNIVERSITY                       ,FC,00000-0000,Public       ,1,3,4,3,17,20
03097100,UNIVERSITY OF WESTERN SYDNEY            ,FC,00000-0000,Public       ,0,4,4,3,15,18
03097300,VICTORIA UNIVERSITY OF TECHNOLOGY       ,FC,00000-0000,Public       ,0,2,2,7,6,13
03097500,CENTRAL QUEENSLAND UNIVERSITY           ,FC,00000-0000,Public       ,0,1,1,2,5,7
03100000,UNIVERSITY OF ADELAIDE (THE)            ,FC,00000-0000,Public       ,1,6,7,5,31,36
03100200,INST DE MANAGEMENT HOTELIER INTERNA     ,FC,00000-0000,Private      ,0,0,0,0,2,2
03101600,ASIAN INSTITUTE OF MANAGEMENT           ,FC,00000-0000,Private      ,0,1,1,2,6,8
03102500,AMERICAN UNIVERSITY OF ROME             ,FC,00000-0000,Private      ,5,5,10,91,58,149
03102800,ROBERT GORDON UNIVERSITY (THE)          ,FC,00000-0000,Public       ,0,3,3,0,22,22
03104800,GRIFFITH UNIVERSITY                     ,FC,00000-0000,Public       ,1,10,11,23,48,71
03104801,GRIFFITH UNIVERSITY - MOUNT GRAVATT CAMP,FC,00000-0000,Public       ,0,0,0,0,1,1
03104802,GRIFFITH UNIVERSITY - GOLD COAST CAMPUS ,FC,00000-0000,Public       ,0,1,1,1,2,3
03104803,GRIFFITH UNIVERSITY - QUEENSLAND CONSERV,FC,00000-0000,Public       ,0,1,1,0,2,2
03104804,GRIFFITH UNIVERSITY - QUEENSLAND COLLEGE,FC,00000-0000,Public       ,0,3,3,0,5,5
03106100,ROSKILDE UNIV ROSKILDE UNIVERSITY C     ,FC,00000-0000,Public       ,0,0,0,0,2,2
03136300,AUSTRALIAN CATHOLIC UNIVERSITY          ,FC,00000-0000,Public       ,0,4,4,2,11,13
03140300,EDITH COWAN UNIVERSITY                  ,FC,00000-0000,Public       ,1,1,2,3,14,17
03140400,NORTHERN TERRITORY UNIVERSITY           ,FC,00000-0000,Public       ,0,0,0,0,1,1
03140500,QUEENSLAND UNIVERSITY OF TECHNOLOGY     ,FC,00000-0000,Public       ,0,7,7,9,31,40
03140600,SOUTHERN CROSS UNIVERSITY               ,FC,00000-0000,Public       ,1,6,7,5,21,26
03140700,SWINBURNE UNIVERSITY OF TECHNOLOGY      ,FC,00000-0000,Public       ,1,2,3,4,9,13
03140900,UNIVERSITY OF BALLARAT                  ,FC,00000-0000,Public       ,0,0,0,1,2,3
03150300,UNIVERSITY OF TASMANIA                  ,FC,00000-0000,Public       ,2,4,6,7,11,18
03150400,"UNIVERSITY OF TECHNOLOGY, SYDNEY        ",FC,00000-0000,Public       ,0,10,10,0,14,14
03274300,"KUNGLIGA TEKNISKA HOGSKOLAN, KTH        ",FC,00000-0000,Public       ,0,1,1,0,28,28
03287300,LIVERPOOL INSTITUTE FOR PERFORMING ARTS ,FC,00000-0000,Public       ,0,2,2,24,8,32
03300300,"2ND SCHOOL OF MEDICINE, CHARLES UNI     ",FC,00000-0000,Public       ,1,2,3,2,11,13
03300400,"FIRST FACULTY OF MEDICINE, CHARLES UNIV.",FC,00000-0000,Public       ,0,1,1,1,29,30
03329300,JOHN CABOT UNIVERSITY                   ,FC,00000-0000,Private      ,9,3,12,121,28,149
03332400,AGRICULTURE UNIVERSITY OF WROCLAW       ,FC,00000-0000,Public       ,0,0,0,1,2,3
03333300,MEDICAL UNIVERSITY SCHOOL OF LUBLIN     ,FC,00000-0000,Public       ,1,32,33,13,239,252
03334300,UNIVERSIDAD NORDESTANA                  ,FC,00000-0000,Private      ,0,5,5,3,45,48
03335300,MEDICAL UNIVERSITY OF SILESIA           ,FC,00000-0000,Public       ,0,9,9,9,102,111
03349400,"QUEEN MARGARET UNIVERSITY COLLEGE, EDINB",FC,00000-0000,Public       ,0,0,0,4,15,19
03350300,BOURNEMOUTH UNIVERSITY                  ,FC,00000-0000,Public       ,0,2,2,10,22,32
03352300,LONDON SOUTH BANK UNIVERSITY            ,FC,00000-0000,Private      ,0,1,1,6,42,48
03363300,THE ARTS EDUCATIONAL SCHOOLS LONDON     ,FC,00000-0000,Private      ,0,0,0,1,5,6
03364300,"FACULTY OF MEDICINE, PALACKY UNIVER     ",FC,00000-0000,Public       ,0,1,1,0,8,8
03365400,AUCKLAND INSTITUTE OF TECHNOLOGY        ,FC,00000-0000,Public       ,1,8,9,3,18,21
03366300,TROPICAL AGRICULTURE RESEARCH AND H     ,FC,00000-0000,Private      ,0,0,0,0,1,1
03377300,"UNIVERSITY OF WALES INSTITUTE, CARD     ",FC,00000-0000,Public       ,0,1,1,1,8,9
03378300,"THE 3RD FACULTY OF MEDICINE, CHARLE     ",FC,00000-0000,Public       ,0,1,1,0,5,5
03386300,CHARLES UNIVERSITY-MEDICAL FACULTY      ,FC,00000-0000,Public       ,1,0,1,1,10,11
03406300,"THE SCHOOL OF PHARMACY, UNIVERSITY      ",FC,00000-0000,Public       ,0,0,0,1,3,4
03418400,NAPIER UNIVERSITY                       ,FC,00000-0000,Public       ,0,2,2,6,29,35
03435300,ANGLIA POLYTECHNIC UNIVERSITY HIGHE     ,FC,00000-0000,Public       ,0,0,0,4,7,11
03460300,INTERNATIONALES THEOLOGISCHES INSTI     ,FC,00000-0000,Private      ,0,0,0,2,18,20
03462400,UNIV OF ARTS LONDON - LON COLL OF COMMUN,FC,00000-0000,Public       ,0,5,5,17,46,63
03466300,INSTITUTO CENTROAMERICANO DE ADMINI     ,FC,00000-0000,Private      ,0,0,0,0,9,9
03473300,UNIV OF ARTS LONDON - LON COLL FASHION  ,FC,00000-0000,Public       ,1,1,2,36,79,115
03475300,UNIV OF THE ARTS  LONDON - CHELSEA COLL ,FC,00000-0000,Public       ,0,1,1,6,15,21
03478300,ROYAL WELSH COLLEGE OF MUSIC AND DRAMA  ,FC,00000-0000,Public       ,0,0,0,1,8,9
03492400,UNIV OF CAMBRIDGE-ST CATHERINE'S CG     ,FC,00000-0000,Public       ,0,0,0,0,7,7
03494400,UNIV OF CAMBRIDGE-SELWYN COLLEGE        ,FC,00000-0000,Public       ,0,0,0,0,4,4
03494600,UNIV OF OXFORD-HARRIS MANCHESTER        ,FC,00000-0000,Public       ,0,0,0,1,8,9
03500300,WIMBLEDON COLLEGE OF ART                ,FC,00000-0000,Public       ,0,0,0,11,2,13
03501400,LEEDS METROPOLITAN UNIVERSITY           ,FC,00000-0000,Public       ,0,0,0,6,15,21
03507300,UNIVERSITY OF SUNDERLAND                ,FC,00000-0000,Public       ,0,1,1,3,13,16
03515300,UNIVERSITY OF CENTRAL LANCASHIRE        ,FC,00000-0000,Public       ,0,3,3,3,14,17
03517300,UNIVERSITY OF BRIGHTON                  ,FC,00000-0000,Public       ,1,0,1,6,29,35
03518300,EUROPEAN GRADUATE SCHOOL                ,FC,00000-0000,Private      ,0,16,16,0,99,99
03526300,INST CENTROAMERICANO DE ADM DE EMP      ,FC,00000-0000,Private      ,0,1,1,0,1,1
03527300,SOFIA UNIVERSITY ST. KLIMENT OHRIDSKI   ,FC,00000-0000,Public       ,0,1,1,0,4,4
03533300,BATH SPA UNIVERSITY                     ,FC,00000-0000,Public       ,0,1,1,7,23,30
03547300,UNIVERSITY OF GLAMORGAN                 ,FC,00000-0000,Public       ,0,0,0,4,8,12
03580300,LIVERPOOL JOHN MOORES UNIVERSITY        ,FC,00000-0000,Public       ,0,3,3,9,10,19
03589400,THE ARTS INSTITUTE AT BOURNEMOUTH       ,FC,00000-0000,Public       ,0,0,0,4,2,6
03594300,GROUP ESC GRENOBLE GRAD SCH OF BUS.     ,FC,00000-0000,Private      ,0,2,2,2,43,45
03597300,JAGIELLONIAN UNIVERSITY                 ,FC,00000-0000,Public       ,0,2,2,2,32,34
03601300,UNIVERSITAT JAUME I DE CASTELLO/UJI     ,FC,00000-0000,Public       ,0,0,0,1,7,8
03603300,LEEDS COLLEGE OF MUSIC                  ,FC,00000-0000,Public       ,0,0,0,0,1,1
03619300,UNIVERSITY OF GREENWICH                 ,FC,00000-0000,Public       ,0,0,0,13,30,43
03653400,UNIVERSIDAD DE IBEROAMERICA - UNIBE     ,FC,00000-0000,Private      ,1,2,3,6,20,26
03674300,UNIVERSITY OF ABERTAY DUNDEE            ,FC,00000-0000,Public       ,0,0,0,4,6,10
03684400,UNIVERSITY OF LINCOLN                   ,FC,00000-0000,Public       ,0,0,0,1,10,11
03684500,MEDICAL UNIVERSITY OF GDANSK            ,FC,00000-0000,Public       ,0,1,1,3,24,27
03685300,UNIVERSITAT POMPEU FABRA                ,FC,00000-0000,Public       ,1,1,2,8,45,53
03716300,"UNIVERSITY OF WALES, NEWPORT            ",FC,00000-0000,Public       ,0,0,0,4,9,13
03721300,WRITTLE COLLEGE                         ,FC,00000-0000,Public       ,0,0,0,2,2,4
03727400,UNIVERSITY OF WAIKATO (THE)             ,FC,00000-0000,Public       ,0,2,2,6,12,18
03738300,LONDON SCHOOL OF THEOLOGY               ,FC,00000-0000,Private      ,0,0,0,0,8,8
03741300,ALRA (ACADEMY OF LIVE AND RECORDED ARTS),FC,00000-0000,Private      ,1,1,2,2,2,4
03770300,NAZARENE THEOLOGICAL COLLEGE            ,FC,00000-0000,Private      ,0,4,4,1,15,16
03794400,ANGLO EUROPEAN COLLEGE OF CHIROPRACTIC  ,FC,00000-0000,Private      ,0,0,0,0,2,2
03816400,AMERICAN GRAD SCH OF INTERNTL REL & DIPL,FC,00000-0000,Private      ,0,6,6,2,74,76
03818300,LEIPZIG GRADUATE SCHOOL OF MANAGEMENT   ,FC,00000-0000,Private      ,0,2,2,0,12,12
03824300,"ROYAL VETERINARY COLLEGE (THE), UNIVERSI",FC,00000-0000,Public       ,0,0,0,4,113,117
03850400,UNIVERSITY OF NOTRE DAME AUSTRALIA (THE),FC,00000-0000,Private      ,0,0,0,0,5,5
03850500,MEDICAL UNIVERSITY OF LODZ              ,FC,00000-0000,Public       ,0,3,3,4,83,87
03859400,UNIVERSITY COLLEGE FALMOUTH             ,FC,00000-0000,Public       ,0,0,0,4,6,10
03867300,UNIVERSITAT AUTONOMA DE BARCELONA       ,FC,00000-0000,Public       ,0,1,1,2,8,10
03880300,UNIVERSITY OF GLOUCESTERSHIRE (THE)     ,FC,00000-0000,Public       ,0,1,1,4,4,8
03897400,INTERNATIONAL SPACE UNIVERSITY          ,FC,00000-0000,Private      ,0,0,0,0,5,5
03926400,NATIONAL COLLEGE OF ART AND DESIGN      ,FC,00000-0000,Public       ,0,0,0,2,3,5
03941301,AVE MARIA UNIVERSITY - LATIN AMERICA    ,FC,00000-0000,Private      ,15,6,21,174,46,220
03978300,SPURGEON'S COLLEGE                      ,FC,00000-0000,Private      ,0,0,0,1,0,1
03993400,TRINITY COLLEGE CARMARTHEN              ,FC,00000-0000,Public       ,0,0,0,0,4,4
04021400,"AMERICAN COLLEGE, DUBLIN LIMITED (THE)  ",FC,00000-0000,Private      ,1,0,1,5,9,14
04021500,CENTRAL EUROPEAN UNIVERSITY             ,FC,00000-0000,Private      ,0,1,1,4,55,59
04032300,YORK ST JOHN UNIVERSITY                 ,FC,00000-0000,Public       ,0,0,0,8,3,11
04046300,HK UNIVERSITY OF SCI & TECH (HKUST)     ,FC,00000-0000,Public       ,0,0,0,2,22,24
04070300,"RAPHAEL RECANATI INTERNATIONAL SCHOOL, T",FC,00000-0000,Private      ,8,8,16,72,58,130
04085400,NEW ZEALAND COLLEGE OF CHIROPRACTIC     ,FC,00000-0000,Private      ,0,0,0,1,2,3
04113300,LEBANESE AMERICAN UNIVERSITY            ,FC,00000-0000,Private      ,0,2,2,5,7,12
04115900,LIVERPOOL HOPE UNIVERSITY               ,FC,00000-0000,Public       ,0,1,1,0,4,4
04116300,EDHEC BUSINESS SCHOOL                   ,FC,00000-0000,Private      ,0,0,0,0,32,32
04121400,ISAPZURICH (INTERNATIONAL SCHOOL OF ANAL,FC,00000-0000,Private      ,0,2,2,0,6,6
04128600,UNIVERSITY OF WORCESTER                 ,FC,00000-0000,Public       ,1,1,2,1,3,4
04139100,UNIVERSITA DEGLI STUDI DI SCIENZE GASTRO,FC,00000-0000,Private      ,0,7,7,0,7,7
04143700,ST MARY'S UNIVERSITY COLLEGE TWICKENHAM ,FC,00000-0000,Public       ,0,10,10,0,13,13
00380600,ALDERSON-BROADDUS COLLEGE               ,WV,26416-1051,Private      ,6,7,13,782,350,1132
00380700,MOUNTAIN STATE UNIVERSITY               ,WV,25801-5624,Private      ,101,881,982,1276,6924,8200
00380800,BETHANY COLLEGE                         ,WV,26032-0417,Private      ,11,5,16,1410,104,1514
00380900,BLUEFIELD STATE COLLEGE                 ,WV,24701-2198,Public       ,32,136,168,1260,1748,3008
00381000,CONCORD UNIVERSITY                      ,WV,24712-0000,Public       ,54,77,131,2954,1065,4019
00381100,DAVIS & ELKINS COLLEGE                  ,WV,26241-3996,Private      ,8,22,30,742,349,1091
00381200,FAIRMONT STATE UNIVERSITY               ,WV,26554-2470,Public       ,111,306,417,4855,3693,8548
00381300,GLENVILLE STATE COLLEGE                 ,WV,26351-1292,Public       ,23,37,60,1314,560,1874
00381500,MARSHALL UNIVERSITY                     ,WV,25755-3300,Public       ,169,551,720,8586,6658,15244
00381600,SOUTHERN WV COMMUNITY COLLEGE           ,WV,25637-2900,Public       ,41,137,178,1095,1394,2489
00381800,UNIVERSITY OF CHARLESTON                ,WV,25304-1099,Private      ,23,55,78,1416,850,2266
00381900,OHIO VALLEY COLLEGE                     ,WV,26105-8000,Private      ,5,26,31,457,231,688
00382000,SALEM INTERNATIONAL UNIVERSITY          ,WV,26426-0500,Proprietary  ,17,161,178,338,790,1128
00382200,SHEPHERD UNIVERSITY                     ,WV,25443-3210,Public       ,83,113,196,3510,1423,4933
00382300,WEST LIBERTY STATE COLLEGE              ,WV,26074-0295,Public       ,26,50,76,2632,778,3410
00382600,WEST VIRGINIA STATE UNIVERSITY          ,WV,25112-0000,Public       ,69,246,315,2594,2676,5270
00382700,WEST VIRGINIA UNIVERSITY                ,WV,26506-6201,Public       ,262,429,691,23105,8938,32043
00382711,WEST VIRGINIA UNIVERSITY - POTOMAC STATE,WV,26726-3000,Public       ,44,38,82,1599,470,2069
00382721,WEST VIRGINIA UNIV INST OF TECH         ,WV,25136-2436,Public       ,20,35,55,858,365,1223
00382800,WEST VIRGINIA UNIV AT PARKERSBURG       ,WV,26101-9577,Public       ,83,378,461,1606,3108,4714
00383000,WEST VIRGINIA WESLEYAN COLLEGE          ,WV,26201-2600,Private      ,11,19,30,1732,234,1966
00383100,WHEELING JESUIT UNIVERSITY              ,WV,26003-6243,Private      ,9,41,50,1264,630,1894
00500700,WEST VIRGINIA JUNIOR COLLEGE            ,WV,26505-5596,Proprietary  ,10,38,48,126,235,361
00500800,MOUNTAIN STATE COLLEGE                  ,WV,26101-3993,Proprietary  ,4,38,42,40,308,348
00754400,APPALACHIAN BIBLE COLLEGE               ,WV,25818-1353,Private      ,5,3,8,253,77,330
00757800,HUNTINGTON SCHOOL OF BEAUTY CULTURE     ,WV,25705-2030,Proprietary  ,0,21,21,42,105,147
00760000,INTERNATIONAL BEAUTY SCHOOL             ,WV,25401-3231,Proprietary  ,6,27,33,29,120,149
00835500,JAMES RUMSEY TECHNICAL INSTITUTE        ,WV,25403-0259,Public       ,3,19,22,75,226,301
00895900,CLARKSBURG BEAUTY ACADEMY               ,WV,26301-2903,Proprietary  ,11,17,28,53,89,142
00904700,HUNTINGTON JUNIOR COLLEGE               ,WV,25701-2004,Proprietary  ,22,152,174,204,1294,1498
00905400,WEST VIRGINIA NORTHERN CMTY COLLEGE     ,WV,26003-0000,Public       ,56,328,384,1104,2432,3536
01014000,MINERAL COUNTY VOCATIONAL TECH CTR      ,WV,26726-0000,Public       ,0,6,6,10,39,49
01035600,EVEREST INSTITUTE                       ,WV,25313-1304,Proprietary  ,28,163,191,166,725,891
01057300,WEST VIRGINIA JUNIOR COLLEGE            ,WV,25322-0000,Proprietary  ,14,50,64,148,367,515
01057302,WEST VIRGINIA JUNIOR COLLEGE            ,WV,26330-0000,Proprietary  ,31,51,82,153,283,436
01086100,WEST VIRGINIA BUSINESS COLLEGE          ,WV,26301-0000,Proprietary  ,4,32,36,25,200,225
01124500,WEST VIRGINIA SCH OSTEOPATHIC MED       ,WV,24901-1128,Public       ,0,2,2,7,850,857
01174900,WOOD COUNTY SCH OF PRAC NURSING         ,WV,26101-6424,Public       ,2,6,8,20,44,64
01235900,B M SPURR SCHOOL OF PRAC NURSING        ,WV,26038-1660,Private      ,2,0,2,10,20,30
01257300,WEST VIRGINIA UNIV-HOSP-RAD TECH        ,WV,26506-8062,Private      ,1,1,2,59,44,103
01274300,BENJAMIN FRANKLIN CAREER&TECH           ,WV,25064-0000,Public       ,1,19,20,55,165,220
01290400,MONONGALIA CNTY TECH ED CTR             ,WV,26501-6841,Public       ,3,5,8,46,145,191
01290500,ACADEMY OF CAREERS AND TECHNOLOGY       ,WV,25801-0000,Public       ,6,42,48,77,309,386
02057400,ROANE-JACKSON TECHNICAL CENTER          ,WV,25252-0000,Public       ,0,4,4,14,78,92
02068000,UNITED TECHNICAL CENTER                 ,WV,26301-0000,Public       ,2,12,14,33,100,133
02070100,BECKLEY BEAUTY ACADEMY                  ,WV,25801-0000,Proprietary  ,5,13,18,36,80,116
02073400,CARVER CAREER TECH ED CTR               ,WV,25306-6397,Public       ,7,37,44,134,298,432
02145100,SCOTT COLLEGE OF COSMETOLOGY            ,WV,26003-0000,Proprietary  ,9,5,14,46,42,88
02178200,CHARLESTON SCHOOL OF BEAUTY CULTURE     ,WV,25301-0000,Proprietary  ,6,31,37,38,113,151
02218200,GARNET CAREER CENTER                    ,WV,25301-0000,Public       ,3,35,38,88,330,418
02275300,CABELL COUNTY CAREER TECHNOLOGY CTR     ,WV,25705-0000,Public       ,3,12,15,86,159,245
02524500,RALPH R WILLIS VOCATIONAL CENTER        ,WV,25601-0000,Public       ,2,5,7,16,45,61
02534800,FRED W EBERLE TECHNICAL CENTER          ,WV,26201-0000,Public       ,13,32,45,43,163,206
02535500,MERCER COUNTY TECH EDUC CNTR            ,WV,24740-0000,Public       ,0,29,29,56,171,227
02579900,NORTH CENTRAL OPPORTUNITIES IND CTR     ,WV,26554-2936,Private      ,4,15,19,24,115,139
02609400,VALLEY COLLEGE                          ,WV,25404-5711,Proprietary  ,2,30,32,21,156,177
03052000,MEREDITH MANOR EQUESTRIAN CENTRE        ,WV,26184-9707,Proprietary  ,12,16,28,152,103,255
03076500,FAYETTE INSTITUTE OF TECHNOLOGY         ,WV,25901-2174,Public       ,2,23,25,14,64,78
03084200,VALLEY COLLEGE                          ,WV,24740-3141,Proprietary  ,3,11,14,9,62,71
03084400,VALLEY COLLEGE                          ,WV,25801-2643,Proprietary  ,3,26,29,19,105,124
03098300,PUTNAM CAREER & TECHNICAL CENTER        ,WV,25070-0000,Public       ,1,3,4,23,63,86
03099200,"MOUNTAINEER BEAUTY COLLEGE, INC         ",WV,25177-2917,Proprietary  ,1,4,5,22,51,73
03102100,MORGANTOWN BEAUTY COLLEGE               ,WV,26505-5430,Proprietary  ,4,12,16,47,88,135
03123200,STANLEY TECHNICAL INSTITUTE             ,WV,26505-3751,Private      ,1,12,13,5,60,65
03327500,SOUTH BRANCH VOCATIONAL TECH CENTER     ,WV,26847-1698,Public       ,0,2,2,6,22,28
03734300,JOHN D. ROCKEFELLER IV CAREER CENTER    ,WV,26047-9424,Public       ,1,6,7,11,24,35
03819300,AMERICAN PUBLIC UNIVERSITY SYSTEM       ,WV,25414-1621,Proprietary  ,69,2121,2190,364,11002,11366
03957300,BLUE RIDGE COMMUNITY AND TECHNICAL COLLE,WV,25401-3244,Public       ,45,217,262,606,1250,1856
03960300,NEW RIVER COMMUNITY AND TECHNICAL COLLEG,WV,25801-2636,Public       ,67,313,380,917,2220,3137
04028300,MOUNTAIN STATE SCHOOL OF MASSAGE        ,WV,25304-2025,Proprietary  ,3,8,11,19,65,84
04038500,PIERPONT COMMUNITY & TECHNICAL COLLEGE  ,WV,26554-2451,Public       ,35,120,155,687,831,1518
04038600,WEST VIRGINIA STATE COMMUNITY AND TECHNI,WV,25112-1000,Public       ,40,154,194,498,1247,1745
04041400,MARSHALL COMMUNITY AND TECHNICAL COLLEGE,WV,25755-3300,Public       ,51,207,258,922,1503,2425
04047300,BRIDGEMONT COMMUNITY & TECHNICAL COLLEGE,WV,25136-2435,Public       ,20,44,64,578,337,915
04119000,EASTERN WEST VIRGINIA COMMUNITY & TECHNI,WV,26836-0000,Public       ,10,45,55,24,77,101
00106100,ALASKA PACIFIC UNIVERSITY               ,AK,99508-4672,Private      ,15,94,109,567,642,1209
00106300,UNIVERSITY OF ALASKA FAIRBANKS          ,AK,99775-7500,Public       ,121,342,463,2547,3127,5674
00106500,UNIVERSITY OF ALASKA SOUTHEAST          ,AK,99801-8680,Public       ,39,141,180,553,1179,1732
00884300,ALASKA BIBLE COLLEGE                    ,AK,99588-0000,Private      ,0,3,3,19,10,29
01146200,UNIVERSITY OF ALASKA ANCHORAGE          ,AK,99514-1608,Public       ,334,916,1250,5171,7374,12545
02541000,CAREER ACADEMY                          ,AK,99507-0000,Proprietary  ,20,129,149,91,490,581
02576900,CHARTER COLLEGE                         ,AK,99508-0000,Proprietary  ,74,409,483,369,2018,2387
03160300,ALASKA VOCATIONAL TECHNICAL CENTER      ,AK,99664-0889,Public       ,16,63,79,162,298,460
03461300,ILISAGVIK COLLEGE                       ,AK,99723-0749,Public       ,1,7,8,16,73,89
04138600,ALASKA CHRISTIAN COLLEGE                ,AK,99669-9755,Private      ,21,6,27,40,19,59
00108500,UNIV ARKANSAS MONTICELLO                ,AR,71656-0000,Public       ,112,284,396,1980,2303,4283
00108600,UNIV OF ARKANSAS AT PINE BLUFF          ,AR,71601-2790,Public       ,108,155,263,4068,2087,6155
00108700,ARKANSAS BAPTIST COLLEGE                ,AR,72202-6099,Private      ,37,85,122,670,876,1546
00108800,LYON COLLEGE                            ,AR,72501-3699,Private      ,12,9,21,762,134,896
00108900,ARKANSAS TECH UNIVERSITY                ,AR,72801-2222,Public       ,238,474,712,4893,3918,8811
00109000,ARKANSAS STATE UNIVERSITY               ,AR,72467-0000,Public       ,321,1191,1512,7358,9668,17026
00109006,DELTA TECHNICAL INSTITUTE               ,AR,72365-9558,Public       ,2,21,23,30,99,129
00109100,ARKANSAS STATE UNIVERSITY - BEEBE       ,AR,72012-1000,Public       ,107,450,557,1805,2995,4800
00109200,UNIVERSITY OF CENTRAL ARKANSAS          ,AR,72035-0001,Public       ,257,365,622,7500,4597,12097
00109300,CENTRAL BAPTIST COLLEGE                 ,AR,72034-6470,Private      ,11,30,41,393,320,713
00109400,UNIVERSITY OF THE OZARKS                ,AR,72830-2880,Private      ,23,18,41,607,139,746
00109500,CROWLEYS RIDGE COLLEGE                  ,AR,72450-9775,Private      ,11,27,38,157,89,246
00109700,HARDING UNIVERSITY                      ,AR,72149-0001,Private      ,88,121,209,3318,1554,4872
00109800,HENDERSON STATE UNIVERSITY              ,AR,71999-0001,Public       ,96,135,231,3051,1725,4776
00109900,HENDRIX COLLEGE                         ,AR,72032-3080,Private      ,20,12,32,1977,118,2095
00110000,JOHN BROWN UNIVERSITY                   ,AR,72761-2747,Private      ,26,112,138,1197,1103,2300
00110100,UNIV ARKANSAS LITTLE ROCK               ,AR,72204-1099,Public       ,220,812,1032,4390,9994,14384
00110200,OUACHITA BAPTIST UNIVERSITY             ,AR,71998-0001,Private      ,33,16,49,1447,167,1614
00110300,PHILANDER SMITH COLLEGE                 ,AR,72202-3718,Private      ,17,71,88,814,713,1527
00110400,PHILLIPS COUNTY COMMUNITY COLLEGE       ,AR,72342-0000,Public       ,22,107,129,470,1051,1521
00110401,RICE BELT TECH INST                     ,AR,72042-0000,Public       ,0,1,1,7,11,18
00110600,WILLIAMS BAPTIST COLLEGE                ,AR,72476-4661,Private      ,7,16,23,543,203,746
00110700,SOUTHERN ARKANSAS UNIVERSITY            ,AR,71754-0000,Public       ,78,145,223,2162,1746,3908
00110800,UNIV ARKANSAS FAYETTEVILLE              ,AR,72701-0000,Public       ,423,467,890,9947,5973,15920
00110900,UNIV OF ARKANSAS FOR MEDCL SCIENCES     ,AR,72205-7102,Public       ,17,102,119,450,1932,2382
00110901,UNIV OF ARKANSAS COLG OF MEDICINE       ,AR,72205-0000,Public       ,4,14,18,49,695,744
00111000,UNIVERSITY OF ARKANSAS-FORT SMITH       ,AR,72904-7397,Public       ,213,547,760,3639,4579,8218
00524500,U OF A COMM COLLEGE AT MORRILTON        ,AR,72110-9601,Public       ,96,304,400,1090,2039,3129
00570700,SEARK COLLEGE                           ,AR,71603-0000,Public       ,67,353,420,706,2200,2906
00573200,UNIV AR COMMUNITY COLLEGE AT HOPE       ,AR,71801-0000,Public       ,47,204,251,561,1362,1923
00704400,CROWLEYS RIDGE TECHNICAL INSTITUTE      ,AR,72336-0000,Public       ,19,41,60,114,273,387
00773800,SOUTHERN ARKANSAS UNIVERSITY TECH       ,AR,71701-1900,Public       ,48,118,166,460,870,1330
00792100,FAYETTEVILLE BEAUTY COLLEGE             ,AR,72701-0000,Proprietary  ,6,18,24,39,91,130
00997600,OUACHITA TECHNICAL COLLEGE              ,AR,72104-0816,Public       ,37,151,188,354,978,1332
01074100,MELLIE'S BEAUTY COLLEGE                 ,AR,72901-3886,Proprietary  ,5,33,38,49,144,193
01210500,NATIONAL PARK COMMUNITY COLLEGE         ,AR,71913-9174,Public       ,116,486,602,1152,2810,3962
01226000,EAST ARKANSAS COMMUNITY COLLEGE         ,AR,72335-2204,Public       ,46,139,185,560,961,1521
01226100,NORTH ARKANSAS COLLEGE                  ,AR,72601-5508,Public       ,84,313,397,950,1967,2917
01286000,ARKANSAS NORTHEASTERN COLLEGE           ,AR,72316-1109,Public       ,51,238,289,761,1788,2549
02052200,BLACK RIVER TECHNICAL COLLEGE           ,AR,72455-0000,Public       ,64,316,380,753,1989,2742
02073500,UNIVERSITY OF ARKANSAS COMMUNITY COLLEGE,AR,72503-0000,Public       ,44,216,260,498,1372,1870
02073502,UNIVERSITY OF ARKANSAS COMMUNITY COLLEGE,AR,72501-0000,Public       ,0,0,0,31,102,133
02073700,NORTHWEST TECHNICAL INSTITUTE           ,AR,72765-0000,Public       ,20,133,153,162,603,765
02074600,SOUTH ARKANSAS COMMUNITY COLLEGE        ,AR,71731-0000,Public       ,50,258,308,487,1695,2182
02075300,PULASKI TECHNICAL COLLEGE               ,AR,72118-0000,Public       ,383,1907,2290,3252,12480,15732
02087000,OZARKA COLLEGE                          ,AR,72556-0000,Public       ,24,177,201,308,1158,1466
02111100,RICH MOUNTAIN COMMUNITY COLLEGE         ,AR,71953-0000,Public       ,22,73,95,369,590,959
02202400,PROFESSIONAL COSMETOLOGY EDUC CTR       ,AR,71730-5828,Proprietary  ,1,17,18,21,81,102
02220900,COSSATOT COMMUNITY COLLEGE              ,AR,71832-0000,Public       ,36,194,230,437,1067,1504
02260400,BEE JAY'S HAIRSTYLING ACADEMY           ,AR,72212-0000,Proprietary  ,3,20,23,8,56,64
02260401,BEE JAY'S HAIRSTYLING ACADEMY - BATESVIL,AR,72501-6709,Proprietary  ,2,4,6,6,28,34
02272400,EASTERN COLLEGE OF HEALTH VOCATIONS     ,AR,72209-0000,Proprietary  ,31,112,143,171,712,883
02284200,NEW TYLER BARBER COLLEGE INC            ,AR,72114-0000,Proprietary  ,7,36,43,38,143,181
02287400,MARSHA KAY BEAUTY COLLEGE               ,AR,72653-0000,Proprietary  ,3,7,10,22,34,56
02321701,ITT TECHNICAL INSTITUTE                 ,AR,72204-9925,Proprietary  ,67,259,326,357,1026,1383
02330800,JEFFERSON SCHOOL OF NURSING             ,AR,71603-0000,Private      ,5,15,20,32,119,151
02339800,SOUTHERN INSTITUTE OF COSMETOLOGY       ,AR,72301-0000,Proprietary  ,5,27,32,15,66,81
02341700,CAREER ACADEMY OF HAIR DESIGN           ,AR,72764-4304,Proprietary  ,9,27,36,68,199,267
02341701,CAREER ACADEMY OF HAIR DESIGN - ROGERS  ,AR,72756-2102,Proprietary  ,6,27,33,19,93,112
02341702,CAREER ACADEMY OF HAIR DESIGN - SILOAM  ,AR,72761-4217,Proprietary  ,1,5,6,1,5,6
02348200,MID-SOUTH COMMUNITY COLLEGE             ,AR,72301-0000,Public       ,58,232,290,751,1910,2661
02363500,ARTHUR'S BEAUTY COLLEGE                 ,AR,72901-0000,Proprietary  ,4,17,21,21,67,88
02525800,LEE'S SCHOOL OF COSMETOLOGY             ,AR,72114-0000,Proprietary  ,1,11,12,13,56,69
02538500,ARTHUR'S BEAUTY COLLEGE                 ,AR,72076-0000,Proprietary  ,10,54,64,68,198,266
02569600,SEARCY BEAUTY COLLEGE                   ,AR,72143-0000,Proprietary  ,2,16,18,18,73,91
03005100,ARKANSAS BEAUTY SCHOOL                  ,AR,72209-5116,Proprietary  ,1,20,21,22,120,142
03007100,HOT SPRINGS BEAUTY COLLEGE              ,AR,71901-5432,Proprietary  ,5,22,27,39,81,120
03007600,ARKANSAS BEAUTY SCHOOL-CONWAY           ,AR,72032-4354,Proprietary  ,5,17,22,34,75,109
03023400,ARKANSAS COLLEGE OF BARBERING           ,AR,72114-5615,Proprietary  ,8,26,34,54,185,239
03063300,NORTHWEST ARKANSAS COMMUNITY COLLEG     ,AR,72712-5190,Public       ,267,714,981,2378,4778,7156
03065100,ABC BEAUTY COLLEGE                      ,AR,71923-4206,Proprietary  ,3,21,24,24,78,102
03066302,BRYAN COLLEGE -                         ,AR,72756-1825,Proprietary  ,14,64,78,72,336,408
03105200,BAPTIST HEALTH SCHOOLS LITTLE ROCK      ,AR,72210-0000,Private      ,25,143,168,433,1567,2000
03115102,HERITAGE COLLEGE - LITTLE ROCK          ,AR,72227-5544,Proprietary  ,20,137,157,43,328,371
03116800,"DELUXE BEAUTY SCHOOL, L.L.C.            ",AR,71603-0000,Proprietary  ,0,3,3,4,28,32
03124900,IMAGINE -  PAUL MITCHELL PARTNER SCHOOL ,AR,72117-2516,Proprietary  ,22,50,72,121,182,303
03127200,ASKINS VO-TECH                          ,AR,72908-8028,Proprietary  ,6,18,24,12,69,81
03214300,VELVATEX COLLEGE OF BEAUTY CULTURE      ,AR,72202-5452,Proprietary  ,0,7,7,6,32,38
03254300,MARGARET'S HAIR ACADEMY                 ,AR,71655-4905,Proprietary  ,4,11,15,24,69,93
03519400,LYNNDALE FUNDAMENTALS OF BEAUTY SCH     ,AR,71730-4804,Proprietary  ,0,7,7,10,34,44
03855300,ECCLESIA COLLEGE                        ,AR,72762-8159,Private      ,5,10,15,83,40,123
03912300,CROSSETT SCHOOL OF COSMETOLOGY          ,AR,71635-0000,Proprietary  ,0,6,6,4,21,25
03997300,ARKANSAS BEAUTY COLLEGE                 ,AR,72801-3741,Proprietary  ,5,9,14,23,55,78
00133900,CORBAN COLLEGE                          ,OR,97301-9392,Private      ,20,64,84,1199,539,1738
00316505,CASCADE COLLEGE                         ,OR,97216-0000,Private      ,2,21,23,42,157,199
00318600,BLUE MOUNTAIN COMMUNITY COLLEGE         ,OR,97801-0000,Public       ,66,274,340,952,1965,2917
00318800,CENTRAL OREGON COMMUNITY COLLEGE        ,OR,97701-5998,Public       ,244,820,1064,2618,5670,8288
00318900,CLATSOP COMMUNITY COLLEGE               ,OR,97103-3698,Public       ,46,109,155,404,769,1173
00319100,CONCORDIA UNIVERSITY                    ,OR,97211-6099,Private      ,30,178,208,1280,1784,3064
00319300,EASTERN OREGON UNIVERSITY               ,OR,97850-2899,Public       ,71,192,263,2040,2785,4825
00319400,GEORGE FOX UNIVERSITY                   ,OR,97132-2697,Private      ,51,210,261,2355,2049,4404
00319600,LANE COMMUNITY COLLEGE                  ,OR,97405-0640,Public       ,527,1440,1967,5924,12544,18468
00319700,LEWIS & CLARK COLLEGE                   ,OR,97219-7899,Private      ,47,87,134,4470,3607,8077
00319800,LINFIELD COLLEGE                        ,OR,97128-6894,Private      ,38,67,105,2705,759,3464
00319801,LINFIELD COLLEGE - PORTLAND CAMPUS      ,OR,97210-0000,Private      ,9,41,50,284,763,1047
00319900,MARYLHURST UNIVERSITY                   ,OR,97036-7036,Private      ,7,244,251,157,2052,2209
00320300,MOUNT ANGEL SEMINARY                    ,OR,97373-0505,Private      ,0,1,1,16,19,35
00320400,MOUNT HOOD COMMUNITY COLLEGE            ,OR,97030-3300,Public       ,350,1050,1400,3816,7084,10900
00320600,MULTNOMAH BIBLE COLLEGE/SEMINARY        ,OR,97220-5898,Private      ,14,53,67,505,668,1173
00320700,PACIFIC NORTHWEST COLLEGE OF ART        ,OR,97209-3023,Private      ,30,47,77,695,604,1299
00320800,NORTHWEST CHRISTIAN UNIVERSITY          ,OR,97401-3727,Private      ,11,54,65,634,562,1196
00320900,WESTERN OREGON UNIVERSITY               ,OR,97361-1394,Public       ,111,139,250,5616,2421,8037
00321000,OREGON STATE UNIVERSITY                 ,OR,97331-8507,Public       ,453,541,994,18066,9192,27258
00321100,OREGON INSTITUTE OF TECHNOLOGY          ,OR,97601-8801,Public       ,70,140,210,2150,2006,4156
00321200,PACIFIC UNIVERSITY                      ,OR,97116-1797,Private      ,49,85,134,2553,2864,5417
00321300,PORTLAND COMMUNITY COLLEGE              ,OR,97219-7198,Public       ,1008,3682,4690,10540,26611,37151
00321600,PORTLAND STATE UNIVERSITY               ,OR,97207-0000,Public       ,502,1509,2011,12817,20781,33598
00321700,REED COLLEGE                            ,OR,97202-8199,Private      ,36,31,67,2719,424,3143
00321800,CHEMEKETA COMMUNITY COLLEGE             ,OR,97309-1500,Public       ,443,1502,1945,5067,11585,16652
00321900,SOUTHERN OREGON UNIVERSITY              ,OR,97520-5010,Public       ,121,227,348,4372,3013,7385
00322000,SOUTHWESTERN OREGON COMMUNITY CLG       ,OR,97420-2956,Public       ,69,200,269,1437,1584,3021
00322100,TREASURE VALLEY COMMUNITY COLLEGE       ,OR,97914-3423,Public       ,113,398,511,1433,2590,4023
00322200,UMPQUA COMMUNITY COLLEGE                ,OR,97470-0226,Public       ,107,402,509,1282,3498,4780
00322300,UNIVERSITY OF OREGON                    ,OR,97403-1226,Public       ,458,452,910,20047,9954,30001
00322400,UNIVERSITY OF PORTLAND                  ,OR,97203-5798,Private      ,124,149,273,7179,1842,9021
00322500,WARNER PACIFIC COLLEGE                  ,OR,97215-4099,Private      ,16,219,235,745,1460,2205
00322700,WILLAMETTE UNIVERSITY                   ,OR,97301-3930,Private      ,42,49,91,4021,1851,5872
00487800,CLACKAMAS COMMUNITY COLLEGE             ,OR,97045-7998,Public       ,265,712,977,3018,4858,7876
00488200,OREGON HEALTH & SCIENCE UNIVERSITY      ,OR,97239-0000,Public       ,9,94,103,410,3313,3723
00488230,OREGON GRAD INST OF SCIENCE & TECH      ,OR,97006-0000,Public       ,0,0,0,2,11,13
00693800,LINN BENTON COMMUNITY COLLEGE           ,OR,97321-3774,Public       ,294,732,1026,3544,5228,8772
00717800,WESTERN SEMINARY                        ,OR,97215-0000,Private      ,0,37,37,5,296,301
00723402,HEALD COLLEGE - PORTLAND                ,OR,97205-3432,Proprietary  ,61,265,326,282,1234,1516
00781900,ART INSTITUTE OF PORTLAND (THE)         ,OR,97209-2911,Proprietary  ,103,186,289,1709,1763,3472
00888700,CONCORDE CAREER INSTITUTE               ,OR,97232-2242,Proprietary  ,64,201,265,304,1153,1457
00907900,EVEREST COLLEGE                         ,OR,97204-2296,Proprietary  ,62,227,289,284,1181,1465
00958100,SPRINGFIELD COLLEGE OF BEAUTY           ,OR,97477-5474,Proprietary  ,11,24,35,81,178,259
01012200,PHAGANS' MEDFORD BEAUTY SCHOOL          ,OR,97504-5297,Proprietary  ,9,22,31,53,136,189
01018200,ROGUE COMMUNITY COLLEGE                 ,OR,97527-0000,Public       ,260,906,1166,2512,5972,8484
01050700,ACADEMY OF HAIR DESIGN                  ,OR,97301-3526,Proprietary  ,4,17,21,43,107,150
01185200,ITT TECHNICAL INSTITUTE                 ,OR,97220-0000,Proprietary  ,98,291,389,652,1662,2314
01230900,WESTERN STATES CHIROPRACTIC COLLEGE     ,OR,97230-3099,Private      ,2,26,28,31,539,570
01234700,PHAGANS CENTRAL OREGON BEAUTY CLG       ,OR,97701-5175,Proprietary  ,21,40,61,83,257,340
01234800,PHAGANS BEAUTY COLLEGE                  ,OR,97333-4716,Proprietary  ,5,22,27,53,109,162
01235000,PHAGANS SCHOOL OF HAIR DESIGN           ,OR,97267-4808,Proprietary  ,4,7,11,39,98,137
01235100,PHAGANS SCHOOL OF BEAUTY                ,OR,97301-4732,Proprietary  ,8,19,27,46,124,170
01300800,PHAGANS TIGARD BEAUTY SCHOOL            ,OR,97223-0000,Proprietary  ,4,10,14,22,72,94
02101000,NORTHWEST COLLEGE OF HAIR DESIGN        ,OR,97086-7702,Proprietary  ,25,54,79,117,312,429
02101002,NORTHWEST COLLEGE                       ,OR,97007-3954,Proprietary  ,2,7,9,16,39,55
02104900,COLLEGE OF LEGAL ARTS                   ,OR,97219-9998,Proprietary  ,6,47,53,41,276,317
02106100,COLLEGE OF COSMETOLOGY                  ,OR,97601-0000,Proprietary  ,8,18,26,37,76,113
02154400,BEAU MONDE CLG OF HAIR DESIGN           ,OR,97205-0000,Proprietary  ,12,47,59,122,270,392
02159700,EUGENE BIBLE COLLEGE                    ,OR,97405-0000,Private      ,11,12,23,105,116,221
02201900,PHAGANS' SCHOOL OF HAIR DESIGN          ,OR,97232-0000,Proprietary  ,12,50,62,102,332,434
02239203,ALLIED COLLEGE - ANTHEM COLLEGE         ,OR,97005-0000,Proprietary  ,4,19,23,33,126,159
02330100,PIONEER PACIFIC COLLEGE                 ,OR,97070-0000,Proprietary  ,61,236,297,326,1333,1659
02330102,PIONEER PACIFIC COLLEGE                 ,OR,97403-0000,Proprietary  ,23,157,180,133,972,1105
02337900,COLLEGE OF HAIR DESIGN CAREERS          ,OR,97301-0000,Proprietary  ,9,15,24,56,100,156
02344100,ROSEBURG BEAUTY COLLEGE                 ,OR,97470-0000,Proprietary  ,7,9,16,34,93,127
02534000,NATIONAL COLLEGE OF NATURAL MEDICINE    ,OR,97201-0000,Private      ,2,24,26,16,709,725
02578800,NORTHWEST NANNIES INSTITUTE             ,OR,97035-0000,Proprietary  ,2,3,5,39,12,51
02603700,OREGON COL OF ORIENTAL MEDICINE         ,OR,97216-0000,Private      ,1,11,12,8,372,380
02617506,EVEREST COLLEGE - EVEREST INSTITUTE     ,OR,97223-6581,Proprietary  ,22,88,110,92,346,438
03007300,OREGON COLLEGE OF ART & CRAFT           ,OR,97225-6399,Private      ,5,24,29,150,281,431
03022600,WESTERN CULINARY INSTITUTE              ,OR,97205-2793,Proprietary  ,186,485,671,1513,2581,4094
03042500,APOLLO COLLEGE                          ,OR,97232-1302,Proprietary  ,90,403,493,516,2033,2549
03074400,PHAGANS NEWPORT ACAD CSMTLGY CAREER     ,OR,97365-4963,Proprietary  ,6,14,20,27,64,91
03074500,EAST-WEST COLLEGE OF THE HEALING ARTS   ,OR,97232-2765,Proprietary  ,6,76,82,98,416,514
03185300,PHAGANS GRANTS PASS COLLEGE OF BTY      ,OR,97527-3039,Proprietary  ,7,6,13,39,96,135
03428300,KLAMATH COMMUNITY COLLEGE               ,OR,97603-7121,Public       ,58,236,294,489,1419,1908
03642300,VALLEY MEDICAL COLLEGE                  ,OR,97305-1373,Proprietary  ,4,53,57,44,297,341
03668300,BIRTHINGWAY COLLEGE OF MIDWIFERY        ,OR,97266-4042,Private      ,1,15,16,18,139,157
03783400,ABDILL CAREER COLLEGE                   ,OR,97504-7137,Proprietary  ,7,47,54,33,233,266
04146500,PORTLAND ACTORS CONSERVATORY            ,OR,97201-2557,Private      ,3,4,7,3,4,7
00137400,ALBERTUS MAGNUS COLLEGE                 ,CT,06511-1189,Private      ,14,86,100,852,1025,1877
00137403,ALBERTUS MAGNUS CLG-NEW DIMENSIONS      ,CT,06511-0000,Private      ,1,116,117,48,726,774
00137800,CENTRAL CONNECTICUT STATE UNIV          ,CT,06050-2490,Public       ,219,350,569,9477,4269,13746
00137900,CONNECTICUT COLLEGE                     ,CT,06320-4196,Private      ,28,12,40,2922,100,3022
00138000,WESTERN CONNECTICUT STATE UNIV          ,CT,06810-6826,Public       ,111,132,243,5624,1600,7224
00138500,FAIRFIELD UNIVERSITY                    ,CT,06430-0000,Private      ,62,108,170,6431,989,7420
00138700,HARTFORD SEMINARY                       ,CT,06105-0000,Private      ,0,3,3,7,39,46
00138900,HOLY APOSTLES COLLEGE & SEMINARY        ,CT,06416-2005,Private      ,1,7,8,13,55,68
00139200,MANCHESTER COMMUNITY COLLEGE            ,CT,06045-1046,Public       ,298,436,734,3290,3100,6390
00139300,MITCHELL COLLEGE                        ,CT,06320-4498,Private      ,15,10,25,1134,223,1357
00139700,UNIVERSITY OF NEW HAVEN                 ,CT,06516-1999,Private      ,87,161,248,7092,1934,9026
00139800,NORTHWESTERN CT COMMUNITY COLLEGE       ,CT,06098-1747,Public       ,50,82,132,556,618,1174
00139900,NORWALK COMMUNITY TECHNICAL COLLEGE     ,CT,06854-1655,Public       ,177,307,484,2032,2424,4456
00140100,POST UNIVERSITY                         ,CT,06723-3240,Proprietary  ,52,464,516,1142,2253,3395
00140200,QUINNIPIAC UNIVERSITY                   ,CT,06518-1908,Private      ,96,78,174,11841,1597,13438
00140201,QUINNIPIAC UNIVERSITY SCHOOL OF LAW     ,CT,06518-0000,Private      ,3,6,9,107,1300,1407
00140300,SACRED HEART UNIVERSITY                 ,CT,06825-1000,Private      ,78,138,216,7025,1569,8594
00140600,SOUTHERN CONNECTICUT STATE UNIV         ,CT,06515-1355,Public       ,183,330,513,9330,4970,14300
00140900,SAINT JOSEPH COLLEGE                    ,CT,06117-2791,Private      ,11,140,151,1159,1124,2283
00141400,TRINITY COLLEGE                         ,CT,06106-3100,Private      ,49,18,67,2778,256,3034
00141600,UNIVERSITY OF BRIDGEPORT                ,CT,06601-5650,Private      ,69,255,324,3414,2744,6158
00141700,UNIVERSITY OF CONNECTICUT-STORRS        ,CT,06269-2151,Public       ,301,320,621,25781,5778,31559
00141702,UNIV CONN STAMFORD                      ,CT,06901-0000,Public       ,13,23,36,412,282,694
00141703,UNIV OF CONNECTICUT - TORINGTON         ,CT,06790-0000,Public       ,4,5,9,173,59,232
00141706,UNIV OF CONNECTICUT SCH LAW             ,CT,06105-0000,Public       ,0,9,9,28,1330,1358
00141707,UNIV OF CT - SCH OF SOCIAL WORK         ,CT,06117-0000,Public       ,1,8,9,78,452,530
00141708,UNIVERSITY OF CONNECTICUT - SCHOOL OF ME,CT,06030-1920,Public       ,1,13,14,28,546,574
00141709,UNIVERSITY OF CONNECTICUT - SCHOOL OF DE,CT,06030-1920,Public       ,17,17,34,32,252,284
00142200,UNIVERSITY OF HARTFORD                  ,CT,06117-1599,Private      ,118,127,245,9390,1829,11219
00142400,WESLEYAN UNIVERSITY                     ,CT,06459-3208,Private      ,53,14,67,5518,210,5728
00142500,EASTERN CONNECTICUT STATE UNIV          ,CT,06226-2295,Public       ,136,103,239,5447,1272,6719
00142600,YALE UNIVERSITY                         ,CT,06520-8288,Private      ,212,149,361,16114,7662,23776
00142601,YALE UNIV PHYSICIANS ASSOC PROG         ,CT,06510-0000,Private      ,0,1,1,9,113,122
00142602,YALE UNIV EPIDEMIOLOGY & PUB HLTH       ,CT,06510-0000,Private      ,0,0,0,0,11,11
00142603,YALE UNIV SCHOOL MEDICINE               ,CT,06510-0000,Private      ,6,4,10,51,872,923
00280301,RENSSELAER POLYTECHNIC INSTITUTE-RENSSEL,CT,06120-2991,Private      ,0,16,16,14,107,121
00451300,HOUSATONIC COMMUNITY COLLEGE            ,CT,06604-4704,Public       ,268,595,863,2479,3717,6196
00618100,BRIDGEPORT HOSP SCHL OF NURSING         ,CT,06610-2896,Private      ,7,23,30,91,342,433
00619100,ST. VINCENT'S COLLEGE                   ,CT,06606-9966,Private      ,20,81,101,267,619,886
00698200,NAUGATUCK VALLEY COMM-TECH COLG         ,CT,06708-3089,Public       ,226,470,696,2636,3012,5648
00730000,ELI WHITNEY TECHNICAL HIGH SCHOOL       ,CT,06514-0000,Public       ,1,6,7,19,72,91
00730300,LINCOLN TECHNICAL INSTITUTE             ,CT,06051-0000,Proprietary  ,134,458,592,948,2291,3239
00730500,PORTER AND CHESTER INSTITUTE OF BRANFORD,CT,06405-4022,Proprietary  ,70,126,196,268,417,685
00731100,WINDHAM TECHNICAL HIGH SCHOOL           ,CT,06226-2100,Public       ,1,6,7,10,37,47
00745900,PAIER COLLEGE OF ART                    ,CT,06514-3902,Proprietary  ,5,10,15,179,81,260
00763500,CAPITAL COMMUNITY COLLEGE               ,CT,06103-1207,Public       ,174,466,640,1710,3958,5668
00803700,GATEWAY COMMUNITY-TECHNICAL COLLEGE     ,CT,06511-0000,Public       ,212,563,775,2582,4027,6609
00803800,MIDDLESEX COMMUNITY CLG                 ,CT,06457-4889,Public       ,82,189,271,998,1283,2281
00887200,RENASCI ACADEMY OF HAIR                 ,CT,06460-4160,Proprietary  ,3,5,8,5,31,36
00887300,PAUL MITCHELL THE SCHOOL                ,CT,06810-6716,Proprietary  ,9,6,15,71,53,124
00887400,BRIO ACADEMY OF COSMETOLOGY             ,CT,06450-4836,Proprietary  ,28,93,121,137,323,460
00887403,BRIO ACADEMY OF COSMETOLOGY - WILLIMANTI,CT,06226-1940,Proprietary  ,0,3,3,3,11,14
00906500,THE HARTFORD CONSERVATORY               ,CT,06105-2891,Private      ,2,1,3,48,17,65
00927700,E C GOODWIN TECHNICAL HIGH SCHOOL       ,CT,06053-0000,Public       ,0,6,6,21,44,65
00929100,J M WRIGHT TECHNICAL HIGH SCHOOL        ,CT,06904-0000,Public       ,0,0,0,6,18,24
00940700,BRIARWOOD COLLEGE                       ,CT,06489-1057,Proprietary  ,42,86,128,684,674,1358
00976400,TUNXIS COMMUNITY COLLEGE                ,CT,06032-3187,Public       ,140,218,358,1591,1852,3443
00976500,THREE RIVERS COMMUNITY TECH COLLEGE     ,CT,06360-0000,Public       ,112,321,433,1453,2327,3780
00982200,ALBERT I PRINCE TECHNICAL HIGH SCHOOL   ,CT,06106-3799,Public       ,1,6,7,11,65,76
01041700,BRIO ACADEMY OF EAST HARTFORD           ,CT,06108-2220,Proprietary  ,11,32,43,51,154,205
01053000,QUINEBAUG VALLEY COMMUNITY COLLEGE      ,CT,06239-1440,Public       ,60,176,236,753,1258,2011
01077900,PORTER AND CHESTER INSTITUTE-ALLCAMPUSES,CT,06615-7158,Proprietary  ,295,593,888,1202,2367,3569
01115000,ASNUNTUCK COMMUNITY COLLEGE             ,CT,06082-3800,Public       ,55,134,189,460,739,1199
01149600,BULLARD HAVENS VOC TECH SCHOOL          ,CT,06610-3499,Public       ,1,10,11,12,64,76
01169700,VINAL REGIONAL VOC TECH SCHOOL          ,CT,06457-4918,Public       ,0,1,1,8,28,36
01184300,NORWICH TECHNICAL HIGH SCHOOL           ,CT,06360-7097,Public       ,1,8,9,11,36,47
01218500,H C WILCOX TECHNICAL HIGH SCHOOL        ,CT,06450-0000,Public       ,0,1,1,4,2,6
01242500,STONE ACADEMY                           ,CT,06514-4125,Proprietary  ,31,174,205,208,1183,1391
01242503,STONE ACADEMY -WATERBURY                ,CT,06705-3823,Proprietary  ,0,16,16,17,61,78
01242504,STONE ACADEMY -  EAST HARTFORD          ,CT,06118-0000,Proprietary  ,0,3,3,10,80,90
01287700,GIBBS COLLEGE                           ,CT,06855-1436,Proprietary  ,8,29,37,57,157,214
01291300,LEON INSTITUTE OF HAIR DESIGN           ,CT,06604-4226,Proprietary  ,2,18,20,13,78,91
01326400,HENRY ABBOTT TECHNICAL HIGH SCHOOL      ,CT,06811-4881,Public       ,1,2,3,8,32,40
02058900,HARVARD H ELLIS TECHNICAL HIGH SCHOOL   ,CT,06239-0000,Public       ,0,1,1,10,7,17
02074000,BRANFORD HALL CAREER INSTITUTE          ,CT,06405-0000,Proprietary  ,223,1112,1335,993,4738,5731
02106600,FOX INSTITUTE OF BUSINESS               ,CT,06110-0000,Proprietary  ,21,113,134,91,459,550
02112300,RIDLEY LOWELL BUSINESS & TECH INST      ,CT,06320-0000,Proprietary  ,10,79,89,63,456,519
02112700,NORTH HAVEN ACADEMY                     ,CT,06473-3108,Proprietary  ,25,20,45,165,109,274
02115100,BUTLER BUSINESS SCHOOL                  ,CT,06604-0000,Proprietary  ,11,103,114,59,386,445
02148700,CONNECTICUT INST OF HAIR DESIGN         ,CT,06716-0000,Proprietary  ,3,16,19,20,58,78
02202500,NEW ENGLAND TRACTOR TRAILER SCH         ,CT,06071-2036,Proprietary  ,39,389,428,81,925,1006
02213000,ELLA T GRASSO SOUTHEASTERN TECHNICAL HIG,CT,06340-0000,Public       ,0,1,1,4,6,10
02228800,BARAN INSTITUTE OF TECHNOLOGY           ,CT,06088-9631,Proprietary  ,116,125,241,943,626,1569
02244900,GOODWIN COLLEGE                         ,CT,06118-9980,Private      ,72,438,510,738,3015,3753
02245300,HOWELL CHENEY TECHNICAL HIGH SCHOOL     ,CT,06040-0000,Public       ,5,3,8,16,29,45
02265900,WINDHAM COMMUNITY MEM HOSP-RAD TECH     ,CT,06226-0000,Private      ,0,3,3,11,15,26
02296100,YALE-NEW HAVEN HOSP DIETETIC INTERN     ,CT,06510-8900,Private      ,0,0,0,9,11,20
02300000,W F KAYNOR TECHNICAL HIGH SCHOOL        ,CT,06708-0000,Public       ,0,11,11,5,52,57
02316600,CONNECTICUT CTR FOR MASSAGE THERAPY     ,CT,06111-3975,Proprietary  ,11,57,68,79,332,411
02316601,CONNECTICUT CENTER FOR MASSAGE THERAPY -,CT,06880-4619,Proprietary  ,4,48,52,34,180,214
02316603,CONNECTICUT CENTER FOR MASSAGE THERAPY -,CT,06340-4619,Proprietary  ,2,17,19,29,153,182
02562400,EMMETT O BRIEN REG VOC TECH SCHOOL      ,CT,06401-2500,Public       ,0,0,0,0,4,4
02565000,PLATT TECHNICAL HIGH SCHOOL             ,CT,06460-2105,Public       ,1,4,5,8,27,35
03079400,LYME ACADEMY COLLEGE OF FINE ARTS       ,CT,06371-2333,Private      ,4,2,6,81,36,117
03094800,INDUSTRIAL MANAGEMENT & TRAINING        ,CT,06706-1211,Proprietary  ,5,36,41,27,182,209
03231400,OLIVER WOLCOTT TECHNICAL HIGH SCHOOL    ,CT,06790-3859,Public       ,0,0,0,1,2,3
03234300,CHARTER OAK STATE COLLEGE               ,CT,06053-2150,Public       ,6,123,129,81,1104,1185
03316300,LINCOLN TECHNICAL INSTITUTE - HARTFORD  ,CT,06105-3630,Proprietary  ,39,96,135,486,502,988
03381300,CONNECTICUT TRAINING CENTER             ,CT,06108-2705,Private      ,15,64,79,53,221,274
03927300,ALBERT SCHOOL (THE)                     ,CT,06357-2447,Proprietary  ,7,31,38,44,102,146
04053300,CLEMENS COLLEGE                         ,CT,06078-0000,Proprietary  ,8,8,16,119,32,151
04104300,ACADEMY DI CAPELLI - SCHOOL OF COSMETOLO,CT,06492-0000,Proprietary  ,4,10,14,23,49,72
04128800,BRANFORD ACADEMY OF HAIR & COSMETOLOGY  ,CT,06405-0000,Proprietary  ,4,12,16,28,45,73
04145400,OXFORD ACADEMY OF HAIR DESIGN           ,CT,06483-2603,Proprietary  ,5,8,13,16,30,46
04148400,EUROPEAN ACADEMY OF COSMETOLOGY AND HAIR,CT,06437-0000,Proprietary  ,8,4,12,8,4,12
04152400,INTERNATIONAL INSTITUTE OF COSMETOLOGY  ,CT,06109-0000,Proprietary  ,8,5,13,17,9,26
00146600,BARRY UNIVERSITY                        ,FL,33161-6695,Private      ,147,653,800,4884,8390,13274
00146601,BARRY UNIVERSITY SCHOOL OF LAW          ,FL,32807-0000,Private      ,8,33,41,65,1482,1547
00146700,BETHUNE COOKMAN UNIVERSITY              ,FL,32114-3099,Private      ,216,106,322,7298,1599,8897
00146800,ST THOMAS UNIVERSITY                    ,FL,33054-0000,Private      ,40,188,228,1267,2770,4037
00146900,FLORIDA INSTITUTE OF TECHNOLOGY         ,FL,32901-6988,Private      ,97,1237,1334,3285,6875,10160
00147000,BREVARD COMMUNITY COLLEGE               ,FL,32922-6503,Public       ,472,1496,1968,5255,8945,14200
00147100,CENTRAL FLORIDA COMMUNITY COLLEGE       ,FL,34478-1388,Public       ,395,1246,1641,4289,7498,11787
00147200,CHIPOLA  COLLEGE                        ,FL,32446-2053,Public       ,76,188,264,965,1281,2246
00147300,CLEARWATER CHRISTIAN COLLEGE            ,FL,33759-0000,Private      ,13,18,31,786,122,908
00147500,DAYTONA STATE COLLEGE                   ,FL,32114-2800,Public       ,721,2076,2797,7010,12778,19788
00147700,EDISON COLLEGE                          ,FL,33906-6210,Public       ,584,1417,2001,6626,9597,16223
00147800,EDWARD WATERS COLLEGE                   ,FL,32209-6199,Private      ,57,62,119,1288,704,1992
00147900,EMBRY-RIDDLE AERONAUTICAL UNIV          ,FL,32114-3900,Private      ,190,700,890,6757,5384,12141
00148000,FLORIDA A & M UNIVERSITY                ,FL,32307-3100,Public       ,577,394,971,16177,7807,23984
00148100,FLORIDA ATLANTIC UNIVERSITY             ,FL,33431-6498,Public       ,706,1205,1911,15961,13147,29108
00148101,FLORIDA ATLANTIC UNIVERSITY/DAVIE       ,FL,33314-0000,Public       ,52,221,273,943,2462,3405
00148103,FLORIDA ATLANTIC UNIV-JUPITER/PSL       ,FL,33458-0000,Public       ,17,50,67,441,567,1008
00148200,FLORIDA COLLEGE                         ,FL,33617-5578,Private      ,8,11,19,418,57,475
00148400,FLORIDA STATE COLLEGE AT JACKSONVILLE   ,FL,32202-4030,Public       ,1128,3576,4704,10973,23256,34229
00148500,FLORIDA KEYS COMMUNITY COLLEGE          ,FL,33040-4397,Public       ,46,165,211,431,915,1346
00148600,FLORIDA MEMORIAL UNIVERSITY             ,FL,33054-6199,Private      ,91,101,192,2620,1417,4037
00148700,ECKERD COLLEGE                          ,FL,33711-4744,Private      ,51,96,147,2662,956,3618
00148800,FLORIDA SOUTHERN COLLEGE                ,FL,33801-5698,Private      ,77,99,176,2690,867,3557
00148900,FLORIDA STATE UNIVERSITY                ,FL,32306-2430,Public       ,1428,884,2312,31676,16258,47934
00149000,GULF COAST COMMUNITY COLLEGE            ,FL,32401-1058,Public       ,235,786,1021,2145,4378,6523
00149300,INDIAN RIVER STATE COLLEGE              ,FL,34981-5596,Public       ,520,1711,2231,5431,9319,14750
00149500,JACKSONVILLE UNIVERSITY                 ,FL,32211-3394,Private      ,157,434,591,4177,3326,7503
00149700,JONES COLLEGE                           ,FL,32211-5588,Private      ,7,117,124,102,1015,1117
00149900,EVEREST UNIVERSITY                      ,FL,32810-5601,Proprietary  ,108,539,647,585,3162,3747
00149901,EVEREST UNIVERSITY - ORLANDO SOUTH      ,FL,32819-7666,Proprietary  ,384,3732,4116,1350,11052,12402
00149902,EVEREST UNIVERSITY - MELBOURNE          ,FL,32905-6609,Proprietary  ,35,405,440,288,2408,2696
00150000,BROWARD COLLEGE- DOWNTOWN CTR           ,FL,33301-2208,Public       ,660,1657,2317,5695,10477,16172
00150001,BROWARD COLLEGE - DAVIE CAMPUS          ,FL,33314-0000,Public       ,569,885,1454,6325,6368,12693
00150002,BROWARD COLLEGE- NORTH CAMPUS           ,FL,33066-0000,Public       ,287,669,956,3777,4643,8420
00150003,BROWARD COLLEGE- SOUTH CAMPUS           ,FL,33024-0000,Public       ,356,684,1040,4190,4832,9022
00150100,LAKE CITY COMMUNITY COLLEGE             ,FL,32025-2007,Public       ,119,495,614,1060,2733,3793
00150200,LAKE SUMTER COMMUNITY COLLEGE           ,FL,34788-8751,Public       ,181,485,666,1954,2933,4887
00150400,MANATEE COMMUNITY COLLEGE               ,FL,34207-3596,Public       ,494,1287,1781,5191,8544,13735
00150500,LYNN UNIVERSITY                         ,FL,33431-5598,Private      ,51,86,137,1556,719,2275
00150600,MIAMI DADE COLLEGE ADMINISTRATION ONLY  ,FL,33176-3393,Public       ,93,165,258,819,895,1714
00150601,MIAMI DADE COLLEGE - NORTH CAMPUS       ,FL,33167-3495,Public       ,725,1571,2296,10185,13224,23409
00150602,MIAMI DADE COLLEGE - KENDALL CAMPUS     ,FL,33176-3393,Public       ,1132,1838,2970,14582,12608,27190
00150603,MIAMI DADE COLLEGE - WOLFSON CAMPUS     ,FL,33132-2297,Public       ,487,1094,1581,6343,7487,13830
00150604,MIAMI DADE COLLEGE - MEDICAL CAMPUS     ,FL,33127-4693,Public       ,105,569,674,1486,4525,6011
00150605,MIAMI DADE COLLEGE - HOMESTEAD CAMPUS   ,FL,33030-6009,Public       ,172,341,513,1710,2329,4039
00150606,MIAMI DADE COLLEGE -INTERAMERICAN CAMPUS,FL,33135-0000,Public       ,280,793,1073,2871,5442,8313
00150607,MIAMI DADE COLLEGE - HIALEAH CAMPUS     ,FL,33012-2918,Public       ,196,429,625,2090,2810,4900
00150800,NORTH FLORIDA COMMUNITY COLLEGE         ,FL,32340-1699,Public       ,40,143,183,489,939,1428
00150900,NOVA SOUTHEASTERN UNIVERSITY            ,FL,33314-7796,Private      ,270,2519,2789,5092,32059,37151
00151000,NORTHWEST FLORIDA STATE COLLEGE         ,FL,32578-1295,Public       ,185,754,939,1971,4524,6495
00151200,PALM BEACH COMMUNITY COLLEGE            ,FL,33461-4796,Public       ,1059,2262,3321,11360,13914,25274
00151300,PENSACOLA JR COLLEGE                    ,FL,32504-8998,Public       ,415,1332,1747,4239,8138,12377
00151400,POLK COMMUNITY COLLEGE                  ,FL,33881-4299,Public       ,295,943,1238,3685,6119,9804
00151500,ROLLINS COLLEGE                         ,FL,32789-4499,Private      ,62,161,223,2339,1405,3744
00151900,SANTA FE COLLEGE                        ,FL,32606-6200,Public       ,544,1050,1594,7956,7663,15619
00152000,SEMINOLE COMMUNITY COLLEGE              ,FL,32773-6199,Public       ,723,1983,2706,6990,11971,18961
00152100,SOUTHEASTERN UNIVERSITY                 ,FL,33801-6099,Private      ,83,155,238,2717,1335,4052
00152200,SOUTH FLORIDA COMMUNITY COLLEGE         ,FL,33825-9399,Public       ,125,399,524,1338,2194,3532
00152300,ST JOHNS RIVER COMMUNITY COLLEGE        ,FL,32177-3897,Public       ,246,604,850,2195,3811,6006
00152600,SAINT LEO UNIVERSITY                    ,FL,33574-6665,Private      ,160,1547,1707,3161,12608,15769
00152800,ST. PETERSBURG COLLEGE                  ,FL,33760-3768,Public       ,818,2714,3532,7868,18310,26178
00153100,STETSON UNIVERSITY                      ,FL,32723-3761,Private      ,65,106,171,2970,939,3909
00153101,STETSON UNIVERSITY - COLLEGE OF LAW     ,FL,33707-3299,Private      ,6,21,27,42,2027,2069
00153300,TALLAHASSEE COMMUNITY COLLEGE           ,FL,32304-2895,Public       ,617,1099,1716,8594,8620,17214
00153400,EVEREST UNIVERSITY                      ,FL,33614-5801,Proprietary  ,112,827,939,692,5815,6507
00153408,EVEREST UNIVERSITY - TAMPA BRANDON CAMPU,FL,33619-1354,Proprietary  ,163,1781,1944,1214,15323,16537
00153409,EVEREST UNIVERSITY - ORANGE PARK        ,FL,32073-1111,Proprietary  ,80,371,451,373,1872,2245
00153500,UNIVERSITY OF FLORIDA                   ,FL,32611-3150,Public       ,1108,925,2033,31357,18301,49658
00153600,UNIVERSITY OF MIAMI                     ,FL,33146-6531,Private      ,544,345,889,15182,5739,20921
00153601,UNIV OF MIAMI SCHOOL OF LAW             ,FL,33124-0000,Private      ,6,27,33,76,2050,2126
00153602,UNIV OF MIAMI-SCH OF MEDICINE           ,FL,33136-0000,Private      ,61,59,120,648,1316,1964
00153700,UNIVERSITY OF SOUTH FLORIDA             ,FL,33620-6960,Public       ,1286,1743,3029,29518,23178,52696
00153701,UNIV OF SOUTH FLORIDA-ST PETERSBURG     ,FL,33701-0000,Public       ,39,108,147,759,916,1675
00153702,UNIV OF SOUTH FLORIDA-SARASOTA          ,FL,34243-0000,Public       ,18,59,77,278,760,1038
00153705,UNIV OF SOUTH FLORIDA                   ,FL,33803-0000,Public       ,52,92,144,674,691,1365
00153706,UNIV OF SOUTH FLORIDA- MEDICINE         ,FL,33612-0000,Public       ,70,37,107,865,1173,2038
00153800,UNIVERSITY OF TAMPA                     ,FL,33606-1490,Private      ,220,252,472,7775,2352,10127
00154000,WEBBER INTERNATIONAL UNIVERSITY         ,FL,33827-0096,Private      ,21,23,44,819,254,1073
00173308,NATIONAL-LOUIS UNIVERSITY               ,FL,33609-0000,Private      ,0,8,8,2,60,62
00177201,TRINITY INTERNATIONAL UNIVERSITY - SOUTH,FL,33324-4611,Private      ,5,41,46,47,427,474
00395400,UNIV OF CENTRAL FLORIDA                 ,FL,32816-0001,Public       ,1679,1769,3448,42501,21860,64361
00395500,UNIVERSITY OF WEST FLORIDA              ,FL,32514-5750,Public       ,275,533,808,5901,5753,11654
00407215,NORTHWOOD UNIVERSITY                    ,FL,33409-0000,Private      ,18,30,48,557,285,842
00558500,LIVELY TECHNICAL CENTER                 ,FL,32304-0000,Public       ,73,303,376,455,1689,2144
00558501,LIVELY TECHNICAL CENTER - AVIATION SCHOO,FL,32304-8723,Public       ,3,17,20,26,68,94
00558600,LINDSEY HOPKINS TECHNICAL ED CENTER     ,FL,33127-4692,Public       ,32,195,227,272,1098,1370
00559400,D G ERWIN TECHNICAL CENTER              ,FL,33610-8255,Public       ,85,418,503,575,2299,2874
00560500,PINELLAS TECH ED CTR-CLEARWATER         ,FL,33760-2194,Public       ,52,311,363,328,1292,1620
00560700,SARASOTA COUNTY TECHNICAL INSTITUTE     ,FL,34233-0000,Public       ,29,153,182,238,884,1122
00560800,TRAVISS TECHNICAL CENTER                ,FL,33803-0000,Public       ,44,225,269,310,1136,1446
00561200,MANATEE TECHNICAL INSTITUTE             ,FL,34210-0000,Public       ,44,242,286,331,1218,1549
00561201,MANATEE TECHNICAL INSTITUTE-EAST        ,FL,34211-0000,Public       ,25,116,141,206,833,1039
00675000,VALENCIA COMMUNITY COLLEGE              ,FL,32802-3028,Public       ,1952,3645,5597,22701,22729,45430
00752500,SUWANNEE-HAMILTON AREA VOC TECH CTR     ,FL,32060-0000,Public       ,12,52,64,61,251,312
00752600,WASHINGTON HOLMES TECHNICAL CENTER      ,FL,32428-1699,Public       ,23,103,126,135,552,687
00755800,LEE COUNTY HIGH TECH CENTER CENTRAL     ,FL,33916-2299,Public       ,40,256,296,326,1191,1517
00758600,REMINGTON COLLEGE - TAMPA CAMPUS        ,FL,33612-8410,Proprietary  ,31,173,204,184,654,838
00758604,REMINGTON COLLEGE-LARGO CAMPUS          ,FL,33771-0000,Proprietary  ,1,18,19,5,76,81
00787000,HILLSBOROUGH COMMUNITY COLLEGE          ,FL,33606-3572,Public       ,1325,3090,4415,13034,18789,31823
00789300,FLAGLER COLLEGE                         ,FL,32085-1027,Private      ,79,52,131,3123,510,3633
00789301,FLAGLER COLLEGE - TALLAHASSEE COMMUNITY ,FL,32304-2895,Private      ,11,36,47,176,450,626
00807500,ST JOHN VIANNEY COLLEGE SEMINARY        ,FL,33165-3244,Private      ,0,0,0,21,15,36
00814600,EVEREST UNIVERSITY - POMPANO BEACH      ,FL,33062-2522,Proprietary  ,76,484,560,494,3170,3664
00822300,ST VINCENT DE PAUL REGIONL SEMINARY     ,FL,33436-0000,Private      ,0,5,5,0,12,12
00841700,STENOTYPE INST OF JACKSONVILLE          ,FL,32207-0000,Proprietary  ,21,122,143,60,437,497
00850100,RASMUSSEN COLLEGE                       ,FL,34471-7051,Proprietary  ,96,912,1008,569,4038,4607
00850103,RASMUSSEN COLLEGE-HOLIDAY               ,FL,34690-0000,Proprietary  ,33,169,202,238,1189,1427
00850106,RASMUSSEN COLLEGE - FORT MYERS          ,FL,33905-7805,Proprietary  ,32,161,193,207,797,1004
00884800,WARNER SOUTHERN COLLEGE                 ,FL,33859-8725,Private      ,33,72,105,590,733,1323
00884900,PALM BEACH ATLANTIC UNIVERSITY          ,FL,33401-6505,Private      ,69,208,277,2409,2201,4610
00887800,MIAMI INTERNATIONAL UNIV ART&DESIGN     ,FL,33132-1418,Proprietary  ,255,345,600,3285,2811,6096
00910400,RIVERSIDE HAIRSTYLING ACADEMY           ,FL,32207-3810,Proprietary  ,3,13,16,21,86,107
00963500,FLORIDA INTERNATIONAL UNIVERSITY        ,FL,33199-0001,Public       ,972,2002,2974,24401,24857,49258
00984100,UNIVERSITY OF NORTH FLORIDA             ,FL,32224-2645,Public       ,568,641,1209,10669,7575,18244
00990200,SHERIDAN TECHNICAL CENTER               ,FL,33021-3399,Public       ,92,466,558,619,2234,2853
01016100,"LORAINE'S ACADEMY, INC                  ",FL,33710-0000,Proprietary  ,20,43,63,47,174,221
01019500,ART INSTITUTE OF FT LAUDERDALE          ,FL,33316-3000,Proprietary  ,149,308,457,2282,2415,4697
01065200,PASCO-HERNANDO COMMUNITY CLG            ,FL,34654-5199,Public       ,419,1291,1710,3975,7498,11473
01072401,CARLOS ALBIZU UNIVERSITY                ,FL,33172-0000,Private      ,9,140,149,116,1214,1330
01082600,TOM P. HANEY TECHNICAL CENTER           ,FL,32405-5099,Public       ,37,236,273,181,925,1106
01112700,GOODING INST OF NUR ANES BAY MED CT     ,FL,32401-0000,Public       ,0,3,3,2,79,81
01226300,ATLANTIC TECHNICAL CENTER               ,FL,33063-3902,Public       ,63,348,411,503,1693,2196
01254400,FIRST COAST TECHNICAL COLLEGE           ,FL,32084-1921,Public       ,44,169,213,292,957,1249
01254401,FIRST COAST TECHNICAL INSTITUTE - PUTNAM,FL,32077-6830,Public       ,0,0,0,0,7,7
01257400,RINGLING SCHOOL OF ART AND DESIGN       ,FL,34234-5895,Private      ,38,16,54,1741,342,2083
01303904,SOUTH UNIVERSITY                        ,FL,33409-5149,Proprietary  ,37,237,274,341,1743,2084
01323400,LORENZO WALKER INST OF TECHNOLOGY       ,FL,34104-4405,Public       ,35,129,164,270,819,1089
02052002,FLORIDA EDUCATION CENTER - LAUDERHILL   ,FL,33313-5857,Proprietary  ,1,10,11,4,23,27
02089600,CONCORDE CAREER INSTITUTE               ,FL,32211-0000,Proprietary  ,25,229,254,190,1181,1371
02089709,HERZING COLLEGE                         ,FL,32792-5509,Proprietary  ,5,28,33,42,200,242
02113609,AMERICAN INTERCONTINENTAL UNIV - WESTON ,FL,33326-3233,Proprietary  ,42,129,171,495,1149,1644
02115300,PINELLAS TECHNICAL EDUCATION CENTERS - S,FL,33711-0000,Public       ,54,389,443,304,1518,1822
02116006,SANFORD-BROWN INSTITUTE - FT. LAUDERDALE,FL,33309-1906,Proprietary  ,34,189,223,204,997,1201
02121800,EVEREST INSTITUTE                       ,FL,33169-4759,Proprietary  ,82,283,365,427,1415,1842
02121801,EVEREST INSTITUTE  - HIALEAH            ,FL,33012-7193,Proprietary  ,45,146,191,454,928,1382
02148200,FASHION FOCUS HAIR ACADEMY              ,FL,34231-0000,Proprietary  ,4,12,16,23,64,87
02148300,MANHATTAN BEAUTY SCHOOL                 ,FL,33611-0000,Proprietary  ,37,143,180,133,601,734
02149900,PAUL MITCHELL THE SCHOOL-JACKSONVILLE   ,FL,32205-0000,Proprietary  ,35,88,123,158,312,470
02151900,KEISER  UNIVERSITY                      ,FL,33309-0000,Proprietary  ,640,2698,3338,4458,16892,21350
02156300,MARGATE SCHOOL OF BEAUTY                ,FL,33063-0000,Proprietary  ,30,121,151,89,423,512
02156700,FLORIDA CHRISTIAN COLLEGE               ,FL,34744-0000,Private      ,9,26,35,219,183,402
02159600,BAPTIST COLLEGE OF FLORIDA (THE)        ,FL,32440-0000,Private      ,20,26,46,319,282,601
02172700,CONCORDE CAREER INSTITUTE               ,FL,33607-0000,Proprietary  ,21,187,208,153,794,947
02188900,HOBE SOUND BIBLE COLLEGE                ,FL,33475-0000,Private      ,1,8,9,84,64,148
02200100,BRADENTON BEAUTY & BARBER ACADEMY       ,FL,34209-0000,Proprietary  ,14,59,73,60,225,285
02215900,ATI CAREER TRAINING CENTER              ,FL,33309-1785,Proprietary  ,63,211,274,253,925,1178
02218700,FLORIDA TECHNICAL COLLEGE               ,FL,32826-2707,Proprietary  ,55,333,388,339,1562,1901
02218707,FLORIDA TECHNICAL COLLEGE - LAKELAND    ,FL,33813-2101,Proprietary  ,9,106,115,69,534,603
02218709,FLORIDA TECHNICAL COLLEGE - DELAND      ,FL,32720-7415,Proprietary  ,2,27,29,28,157,185
02228300,LAKE TECHNICAL CENTER                   ,FL,32726-0000,Public       ,44,179,223,244,935,1179
02245500,CENTRAL FLORIDA COLLEGE                 ,FL,32789-4679,Proprietary  ,31,163,194,229,740,969
02257900,INTERNATIONAL ACADEMY                   ,FL,32119-3541,Proprietary  ,14,67,81,71,244,315
02275100,CONCORDE CAREER INSTITUTE               ,FL,33025-0000,Proprietary  ,21,149,170,137,619,756
02278800,SOUTHWEST FLORIDA COLLEGE               ,FL,33907-0000,Proprietary  ,80,341,421,501,2030,2531
02278801,SOUTHWEST FLORIDA COLLEGE - TAMPA       ,FL,33619-1344,Proprietary  ,40,121,161,288,695,983
02278802,SOUTHWEST FLORIDA COLLEGE - INSTITUTUE O,FL,33928-9469,Proprietary  ,2,4,6,10,16,26
02278803,SOUTHWEST FLORIDA COLLEGE - PORT CHARLOT,FL,33953-3100,Proprietary  ,12,86,98,55,394,449
02279600,CORTIVA INSTITUTE - FLORIDA             ,FL,33781-0000,Proprietary  ,5,56,61,41,236,277
02280800,NEW ENGLAND INST TECH-PALM BEACH        ,FL,33407-0000,Proprietary  ,126,485,611,805,2450,3255
02283800,BEAUTY SCHOOLS OF AMERICA               ,FL,33012-3322,Proprietary  ,154,621,775,539,2444,2983
02286500,ITT TECHNICAL INSTITUTE                 ,FL,33634-7515,Proprietary  ,274,722,996,1250,3235,4485
02287100,LA BELLE BEAUTY SCHOOL                  ,FL,33012-0000,Proprietary  ,12,150,162,30,287,317
02293200,ATI CAREER TRAINING CENTER              ,FL,33309-5916,Proprietary  ,185,575,760,704,2387,3091
02293201,ATI CAREER TRAINING CENTER - MIAMI      ,FL,33122-1707,Proprietary  ,8,50,58,58,155,213
02293202,ATI CAREER TAINING CENTER - ATI COLLEGE ,FL,87109-2016,Proprietary  ,76,229,305,439,1908,2347
02293600,ADVANCED TECHNICAL CENTERS              ,FL,33266-1597,Private      ,0,10,10,10,31,41
02297000,CHARLOTTE TECHNICAL CENTER              ,FL,33948-0000,Public       ,33,109,142,200,708,908
02300900,WITHLACOOCHEE TECHNICAL INSTITUTE       ,FL,34450-0000,Public       ,39,171,210,213,811,1024
02305700,GULF COAST COLLEGE                      ,FL,33619-0000,Proprietary  ,9,83,92,104,425,529
02305800,FLORIDA CAREER COLLEGE                  ,FL,33012-7028,Proprietary  ,377,1099,1476,2095,5602,7697
02307400,GEORGE STONE AREA VOCATIONAL TECHNICAL  ,FL,32526-0000,Public       ,33,237,270,212,1022,1234
02314100,SCHILLER INTERNATIONAL UNIVERSITY       ,FL,33770-3716,Proprietary  ,6,24,30,85,148,233
02316200,MIAMI LAKES TECHNICAL EDUCATION CTR     ,FL,33014-0000,Public       ,52,176,228,383,985,1368
02321200,ORANGE TECH EDUC CTR- WESTSIDE TECH     ,FL,34787-0000,Public       ,26,143,169,271,772,1043
02325100,KEY COLLEGE                             ,FL,33004-3046,Proprietary  ,4,22,26,19,104,123
02326303,MEDVANCE INSTITUTE - WEST PALM          ,FL,33461-2171,Proprietary  ,64,220,284,295,987,1282
02326306,MEDVANCE INSTITUTE - MIAMI              ,FL,33173-3431,Proprietary  ,31,96,127,146,513,659
02326800,RESORT & SPA SCHOOLS INTERNATIONAL      ,FL,34233-0000,Proprietary  ,5,110,115,25,301,326
02326900,SUNSTATE ACADEMY OF HAIR DESIGN         ,FL,33907-1415,Proprietary  ,42,90,132,148,298,446
02329900,FLORIDA INSTITUTE OF ULTRASOUND         ,FL,32514-0000,Proprietary  ,7,20,27,49,209,258
02338400,FT PIERCE BEAUTY ACADEMY                ,FL,34982-0000,Proprietary  ,29,116,145,86,326,412
02341001,FORTIS COLLEGE - DBA FORTIS INSTITUTE   ,FL,32504-7322,Proprietary  ,2,39,41,27,143,170
02346200,WYOTECH                                 ,FL,32174-1010,Proprietary  ,101,273,374,613,1105,1718
02362100,FULL SAIL UNIVERSITY                    ,FL,32792-0000,Proprietary  ,825,1693,2518,8575,10011,18586
02499000,ACADEMY OF COSMETOLOGY                  ,FL,32953-3311,Proprietary  ,8,42,50,41,187,228
02501500,"O*TEC, MID-FLORIDA TECH                 ",FL,32809-0000,Public       ,51,298,349,375,1065,1440
02504600,WINTER PARK TECH                        ,FL,32789-0000,Public       ,14,158,172,135,854,989
02508900,TALMUDIC COLLEGE OF FLORIDA             ,FL,33139-0000,Private      ,3,2,5,26,13,39
02511700,RIDGE TECHNICAL CENTER                  ,FL,33881-0000,Public       ,60,249,309,256,945,1201
02513200,ORLANDO TECHNICAL CENTER                ,FL,32801-0000,Public       ,32,277,309,344,1385,1729
02515400,CITY COLLEGE                            ,FL,33309-3073,Private      ,78,363,441,465,1883,2348
02517100,SARASOTA SCHOOL OF MASSAGE THERAPY      ,FL,34243-6130,Proprietary  ,3,36,39,18,156,174
02524000,SUNSTATE ACADEMY OF HAIR DESIGN         ,FL,34624-0000,Proprietary  ,34,60,94,98,206,304
02524200,ROBERT MORGAN EDUCATIONAL CENTER        ,FL,33177-0000,Public       ,81,242,323,443,1128,1571
02547600,FLORIDA NATIONAL COLLEGE                ,FL,33012-0000,Proprietary  ,163,556,719,947,3004,3951
02554200,RADFORD LOCKLIN TECH CENTER             ,FL,32570-0000,Public       ,3,46,49,38,209,247
02573200,LA BELLE BEAUTY ACADEMY                 ,FL,33135-0000,Proprietary  ,14,52,66,59,273,332
02586200,FLORIDA CAREER COLLEGE                  ,FL,33759-3924,Proprietary  ,16,100,116,139,577,716
02586201,FLORIDA CAREER COLLEGE -                ,FL,33569-2553,Proprietary  ,0,14,14,3,40,43
02597100,HERITAGE INSTITUTE                      ,FL,33912-7132,Proprietary  ,60,337,397,329,1425,1754
02598200,FLORIDA TECHNICAL CLG JACKSONVILLE      ,FL,32211-5123,Proprietary  ,22,121,143,101,495,596
02599800,EVEREST UNIVERSITY                      ,FL,33759-1359,Proprietary  ,62,290,352,308,1681,1989
02599801,EVEREST UNIVERSITY - TAMPA LAKELAND CAMP,FL,33801-3801,Proprietary  ,47,303,350,262,1640,1902
02599805,EVEREST UNIVERSITY - JACKSONVILLE       ,FL,32256-0000,Proprietary  ,74,360,434,362,1972,2334
02601600,HENRY W BREWSTER TECHNICAL CENTER       ,FL,33602-0000,Public       ,23,138,161,130,704,834
02612700,DARLYNE MCGEE'S ACAD OF COSMETOLOGY     ,FL,32905-2805,Proprietary  ,6,17,23,26,120,146
02616400,SANFORD-BROWN INSTITUTE                 ,FL,32256-3520,Proprietary  ,67,504,571,531,2950,3481
02616401,SANFORD-BROWN INSTITUTE - TAMPA         ,FL,33610-8304,Proprietary  ,62,335,397,264,1578,1842
03003200,EVEREST INSTITUTE                       ,FL,33186-1410,Proprietary  ,65,175,240,438,988,1426
03003201,EVEREST INSTITUTE - FT. LAUDERDALE      ,FL,33304-2522,Proprietary  ,41,165,206,173,595,768
03003600,MCFATTER TECHNICAL CENTER               ,FL,33317-7499,Public       ,53,260,313,392,1224,1616
03006801,PENNSYLVANIA CULINARY INSTITUTE - LE COR,FL,33025-3929,Proprietary  ,67,273,340,441,1267,1708
03008600,FLORIDA COLLEGE OF NATURAL HEALTH       ,FL,33064-1342,Proprietary  ,57,253,310,316,1225,1541
03010608,VIRGINIA COLLEGE - PENSACOLA            ,FL,32501-5650,Proprietary  ,11,110,121,86,746,832
03010612,VIRGINIA COLLEGE - GOLF ACADEMY OF AMERI,FL,32701-0000,Proprietary  ,15,41,56,144,257,401
03012300,ASM BEAUTY WORLD ACADEMY                ,FL,33021-0000,Proprietary  ,3,29,32,19,107,126
03018500,BENE'S INTERNATIONAL SCHOOL OF BEAUTY   ,FL,34652-1637,Proprietary  ,29,68,97,102,271,373
03028200,TRINITY COLLEGE OF FLORIDA              ,FL,34655-4401,Private      ,7,15,22,151,148,299
03031400,INTERNATIONAL ACAD OF DESIGN & TECH     ,FL,33634-6313,Proprietary  ,235,885,1120,2162,4940,7102
03031402,INTERNATIONAL ACADEMY OF DESIGN AND TECH,FL,32809-4633,Proprietary  ,54,118,172,769,850,1619
03031403,IADT - ORLANDO CULINARY ACADEMY         ,FL,32819-0000,Proprietary  ,28,75,103,411,512,923
03035800,HERITAGE INSTITUTE                      ,FL,32216-0948,Proprietary  ,25,153,178,79,563,642
03035900,NATIONAL AVIATION ACADEMY               ,FL,33760-3931,Proprietary  ,22,85,107,209,523,732
03037500,HODGES UNIVERSITY                       ,FL,34119-7932,Private      ,71,477,548,544,3485,4029
03054200,TECHNICAL CAREER INSTITUTE              ,FL,33144-2373,Proprietary  ,46,126,172,489,573,1062
03071600,COLLEGE OF BUSINESS & TECHNOLOGY        ,FL,33176-1412,Proprietary  ,27,324,351,176,1340,1516
03071601,COLLEGE OF BUSINESS & TECHNOLOGY -      ,FL,33144-2072,Proprietary  ,0,20,20,17,60,77
03071602,COLLEGE OF BUSINESS & TECHNOLOGY -      ,FL,33012-3436,Proprietary  ,1,4,5,7,7,14
03076402,HIGH-TECH INSTITUTE - ORLANDO           ,FL,32803-3509,Proprietary  ,6,48,54,63,247,310
03079800,GEORGE T BAKER AVIATION                 ,FL,33142-5687,Public       ,24,58,82,243,313,556
03079900,CITY COLLEGE                            ,FL,32707-5342,Private      ,16,99,115,60,437,497
03087600,ITT TECHNICAL INSTITUTE                 ,FL,32746-1607,Proprietary  ,271,670,941,1231,3302,4533
03089200,NOUVELLE INSTITUTE                      ,FL,33125-4141,Proprietary  ,10,77,87,39,454,493
03096300,FLORIDA CAREER INSTITUTE                ,FL,33860-0000,Proprietary  ,7,47,54,38,263,301
03099600,MERCY HOSPITAL SCHOOL OF PRACTICAL NSG  ,FL,33133-4237,Private      ,8,27,35,67,202,269
03100800,TAYLOR TECHNICAL INSTITUTE              ,FL,32348-0894,Public       ,7,40,47,77,248,325
03101900,TRINITY BAPTIST COLLEGE                 ,FL,32221-1398,Private      ,15,18,33,210,137,347
03103900,MARION COUNTY COMMUNITY TECH & ADUL     ,FL,34474-3172,Public       ,50,207,257,252,967,1219
03108500,EVERGLADES UNIVERSITY                   ,FL,33431-0000,Private      ,34,259,293,168,1561,1729
03108600,COM-PU-MED VOCATIONAL CAREERS           ,FL,33012-4861,Proprietary  ,27,181,208,73,546,619
03113400,ACADEMY OF HEALING ARTS                 ,FL,33463-2113,Proprietary  ,6,33,39,22,128,150
03114700,PRAXIS INSTITUTE                        ,FL,33135-2657,Proprietary  ,13,118,131,66,540,606
03115500,FLORIDA HOSPITAL COLG OF HEALTH SCI     ,FL,32803-1237,Private      ,57,363,420,917,2596,3513
03123900,KEISER CAREER INSTITUTE                 ,FL,33413-0000,Proprietary  ,75,292,367,528,1765,2293
03125600,MIAMI AD SCHOOL                         ,FL,33139-5203,Proprietary  ,7,57,64,66,353,419
03127900,TECHNICAL EDUCATION CTR OSCEOLA         ,FL,34744-4459,Public       ,36,226,262,288,965,1253
03139600,DELTA CONNECTION ACADEMY                ,FL,32773-9683,Proprietary  ,0,0,0,49,94,143
03158300,LEE COUNTY HIGH TECH CENTER NORTH       ,FL,33993-2479,Public       ,17,129,146,124,605,729
03171300,UNIVERSITY OF ST. AUGUSTINE FOR HEALTH S,FL,32084-4215,Proprietary  ,1,116,117,24,897,921
03178400,CORAL RIDGE NURSES ASST TRAINING        ,FL,33306-0000,Proprietary  ,0,14,14,1,55,56
03224300,NEW PROFESSIONS TECHNICAL INSTITUTE     ,FL,33134-1640,Proprietary  ,12,193,205,61,623,684
03230300,OKALOOSA APPLIED TECHNOLOGY CENTER      ,FL,32547-1299,Public       ,11,138,149,101,593,694
03238300,FLORIDA COLLEGE OF INTEGRATIVE MED      ,FL,32809-5721,Proprietary  ,5,55,60,31,222,253
03255300,FLORIDA GULF COAST UNIVERSITY           ,FL,33965-6565,Public       ,330,365,695,8575,3950,12525
03256300,YESHIVA GEDOLAH RABBINICAL COLLEGE      ,FL,33139-4708,Private      ,32,0,32,36,3,39
03264300,SOUTH FLORIDA BIBLE COLLEGE AND THEOLOGI,FL,33441-5768,Private      ,0,15,15,15,64,79
03346300,ACAD FOR PRAC NURSING & HEALTH OCCP     ,FL,33417-4574,Private      ,11,87,98,110,638,748
03348400,PROFESSIONAL TRAINING CENTERS           ,FL,33184-0000,Proprietary  ,14,124,138,120,673,793
03370300,AUDIO RECORDING TECHNOLOGY INSTITUTE    ,FL,32811-0000,Proprietary  ,12,32,44,82,144,226
03373300,BEACON COLLEGE                          ,FL,34748-5224,Private      ,4,5,9,89,41,130
03374300,FLORIDA COASTAL SCHOOL OF LAW           ,FL,32256-0000,Proprietary  ,0,80,80,14,3169,3183
03382300,BRADFORD-UNION AREA CAREERTECHNICAL CENT,FL,32091-2434,Public       ,7,46,53,46,236,282
03390300,LINCOLN TECHNICAL INSTITUTE             ,FL,32730-2351,Proprietary  ,19,149,168,144,764,908
03411400,INTERNATIONAL TRAINING CAREERS          ,FL,33155-1462,Private      ,5,108,113,34,330,364
03414500,SOUTHEAST INSTITUTE OF ORIENTAL MED     ,FL,33176-1509,Proprietary  ,2,26,28,18,166,184
03425400,CENTRAL FLORIDA INSTITUTE               ,FL,34684-4436,Proprietary  ,43,183,226,204,937,1141
03429600,ATLANTIC INST OF ORIENTAL MEDICINE      ,FL,33316-0000,Private      ,0,15,15,1,124,125
03429700,EAST WEST COLLG OF NATURAL MEDICINE     ,FL,34236-4959,Proprietary  ,1,22,23,4,150,154
03433400,NEW CONCEPT MASSAGE AND BEAUTY SCHO     ,FL,33135-0000,Proprietary  ,3,22,25,9,72,81
03434300,FORTIS COLLEGE                          ,FL,32073-2999,Proprietary  ,30,148,178,198,791,989
03459400,SAINT PETERSBURG THEOLOGICAL SEMINA     ,FL,33708-3116,Private      ,2,6,8,6,51,57
03480301,MEDVANCE INSTITUTE - FORT LAUDERDALE    ,FL,33313-7261,Proprietary  ,20,142,162,134,724,858
03480302,MEDVANCE INSTITUTE - STUART             ,FL,34994-3000,Proprietary  ,9,90,99,44,314,358
03491400,AMERICAN ADVANCED TECHNICIANS INST      ,FL,33014-4430,Proprietary  ,3,18,21,18,70,88
03549300,ULTIMATE MEDICAL ACADEMY                ,FL,33756-5802,Proprietary  ,94,791,885,442,2896,3338
03553300,KEISER CAREER COLLEGE                   ,FL,32216-0000,Proprietary  ,29,131,160,143,522,665
03557300,NORTH FLORIDA COSMETOLOGY INSTITUTE     ,FL,32312-0000,Proprietary  ,6,39,45,53,243,296
03564300,SUPERIOR CAREER INSTITUTE               ,FL,33311-1141,Proprietary  ,2,47,49,16,167,183
03570400,ENGLISH CENTER (THE)                    ,FL,33133-2703,Public       ,3,25,28,10,138,148
03595400,ANGLEY COLLEGE                          ,FL,32720-4257,Proprietary  ,56,360,416,135,784,919
03611400,FLORIDA BARBER ACADEMY                  ,FL,33441-0000,Proprietary  ,26,90,116,52,204,256
03618300,FLORIDA INSTITUTE OF ANIMAL ARTS        ,FL,32792-1740,Proprietary  ,19,51,70,114,227,341
03627400,JACKSONVILLE BEAUTY INSTITUTE           ,FL,32208-1885,Proprietary  ,10,63,73,49,228,277
03627600,FLORIDA EDUCATION INSTITUTE             ,FL,33144-5036,Proprietary  ,11,122,133,54,368,422
03661400,SOUTH FLORIDA INSTITUTE OF TECHNOLO     ,FL,33135-0000,Proprietary  ,13,216,229,81,828,909
03691400,AVE MARIA SCHOOL OF LAW                 ,FL,34119-1376,Private      ,0,5,5,3,661,664
03696400,SABER                                   ,FL,33134-1604,Private      ,6,126,132,27,542,569
03706300,AMERICAN INSTITUTE                      ,FL,33319-5613,Proprietary  ,48,183,231,162,710,872
03757300,ADVANCE SCIENCE INSTITUTE               ,FL,33012-0000,Proprietary  ,2,56,58,18,169,187
03801400,BEAUTY INSTITUTE (THE)                  ,FL,33409-2972,Proprietary  ,7,34,41,35,138,173
03801401,BEAUTY INSTITUTE (THE) - MARGATE        ,FL,33068-5704,Proprietary  ,0,4,4,5,12,17
03816300,ARTISTIC NAILS & BEAUTY ACADEMY         ,FL,33605-5919,Proprietary  ,27,80,107,77,257,334
03823300,FLORIDA ACADEMY OF HEALTH & BEAUTY      ,FL,33311-0000,Proprietary  ,1,17,18,5,61,66
03832300,DADE MEDICAL COLLEGE                    ,FL,33126-5534,Proprietary  ,72,200,272,291,957,1248
03842500,CAMBRIDGE INSTITUTE OF ALLIED HEALTH    ,FL,32750-0000,Proprietary  ,3,43,46,27,208,235
03856300,UNIVERSAL BEAUTY SCHOOL                 ,FL,33174-4406,Proprietary  ,5,13,18,18,88,106
03856500,FLORIDA SCHOOL OF TRADITIONAL MIDWIFERY ,FL,32601-5507,Private      ,0,3,3,2,20,22
03866300,GALIANO CAREER ACADEMY                  ,FL,32701-0000,Proprietary  ,42,130,172,95,482,577
03875300,MEDICAL CAREER INSTITUTE OF SOUTH FLORID,FL,33407-2103,Proprietary  ,10,94,104,59,412,471
03888300,DRAGON RISES COLLEGE OF ORIENTAL MEDICIN,FL,32601-5089,Proprietary  ,0,5,5,4,57,61
03903500,SOUTHERN TECHNICAL COLLEGE              ,FL,32809-0000,Proprietary  ,47,272,319,179,1141,1320
03906300,CAREER INSTITUTE OF FLORIDA             ,FL,33773-3434,Proprietary  ,4,76,80,27,355,382
03911300,TOTAL INTERNATIONAL CAREER INSTITUTE    ,FL,33012-0000,Proprietary  ,4,36,40,8,129,137
03939300,WOLFORD COLLEGE                         ,FL,34108-1931,Private      ,1,29,30,10,323,333
03939400,CENTURA INSTITUTE                       ,FL,32807-3566,Proprietary  ,8,71,79,61,345,406
03939600,DAYTONA COLLEGE                         ,FL,32174-8445,Proprietary  ,7,44,51,54,144,198
03941300,AVE MARIA UNIVERSITY                    ,FL,34142-9505,Private      ,11,12,23,773,307,1080
03957400,NEW COLLEGE OF FLORIDA                  ,FL,34243-2109,Public       ,30,13,43,1476,168,1644
03985300,COMMERCIAL DIVING ACADEMY               ,FL,32208-0000,Proprietary  ,39,132,171,195,719,914
03986300,AVIATOR COLLEGE OF AERONAUTICAL SCIENCE ,FL,34946-9022,Proprietary  ,4,21,25,16,62,78
04016500,AMERICAN INSTITUTE OF BEAUTY            ,FL,33773-0000,Proprietary  ,14,47,61,43,191,234
04029300,TRENDSETTERS OF FLORIDA SCHOOL OF BEAUTY,FL,32205-0000,Proprietary  ,2,21,23,22,85,107
04058300,HEALTH OPPORTUNITY TECHNICAL CENTER     ,FL,33169-4517,Proprietary  ,1,33,34,14,242,256
04083400,INSTITUTE OF ALLIED MEDICAL PROFESSIONS ,FL,33484-6543,Proprietary  ,1,48,49,36,222,258
04105400,PENSACOLA SCHOOL OF MASSAGE THERAPY & HE,FL,32504-7337,Proprietary  ,2,41,43,34,195,229
04106300,PALM BEACH ACADEMY OF HEALTH & BEAUTY   ,FL,33403-2130,Proprietary  ,8,21,29,48,137,185
04116600,TAYLOR COLLEGE                          ,FL,34420-8714,Proprietary  ,1,59,60,38,287,325
04119400,AVEDA INSTITUTE - SAINT PETERSBURG      ,FL,33701-4242,Proprietary  ,63,133,196,432,636,1068
04120400,HI-TECH SCHOOL OF COSMETOLOGY           ,FL,33174-0000,Proprietary  ,13,24,37,74,128,202
04120500,ACADEMY OF PROFESSIONAL CAREERS         ,FL,32792-4433,Proprietary  ,0,0,0,4,9,13
04126900,ACADEMY OF CAREER TRAINING              ,FL,34741-4644,Proprietary  ,18,74,92,90,252,342
04127400,DIGITAL MEDIA ARTS COLLEGE              ,FL,33431-5919,Proprietary  ,12,26,38,280,210,490
04128400,MANAGEMENT RESOURCES INSTITUTE          ,FL,33126-5473,Proprietary  ,4,99,103,12,377,389
04129300,INTERNATIONAL B NATURALE BEAUTY SCHOOL  ,FL,33311-1152,Proprietary  ,1,11,12,1,12,13
04129900,FLORIDA SCHOOL OF MASSAGE               ,FL,32608-5419,Proprietary  ,9,43,52,98,222,320
04130400,SHEAR EXCELLENCE INTERNATIONAL HAIR ACAD,FL,33614-2783,Private      ,14,31,45,36,107,143
04131900,FASTTRAIN OF MIAMI                      ,FL,33134-1065,Proprietary  ,8,75,83,43,285,328
04132000,FASTTRAIN OF FORT LAUDERDALE            ,FL,33311-1506,Proprietary  ,4,67,71,18,191,209
04132100,FASTTRAIN OF TAMPA                      ,FL,33607-4153,Proprietary  ,15,93,108,23,208,231
04132200,FASTTRAIN OF JACKSONVILLE               ,FL,32256-4849,Proprietary  ,8,76,84,22,204,226
04133500,ACADEMY FOR FIVE ELEMENT ACUPUNCTURE    ,FL,32601-6811,Private      ,0,5,5,5,95,100
04134800,AVEDA INSTITUTE - TALLAHASSEE           ,FL,32304-3186,Proprietary  ,11,24,35,94,126,220
04134900,ORANGE PARK BEAUTY ACADEMY              ,FL,32073-5524,Proprietary  ,4,14,18,23,90,113
04135000,COZMO THE SCHOOL                        ,FL,34135-4810,Proprietary  ,9,24,33,38,116,154
04135900,ALLIED HEALTH INSTITUTE                 ,FL,33309-1900,Proprietary  ,10,126,136,28,585,613
04140800,NORTH FLORIDA ACADEMY                   ,FL,32065-7758,Proprietary  ,8,6,14,39,55,94
04143100,PROFESSIONAL HANDS INSTITUTE            ,FL,33135-1939,Proprietary  ,7,62,69,17,169,186
04145900,CELEBRITY SCHOOL OF BEAUTY              ,FL,33144-4153,Proprietary  ,5,68,73,25,147,172
04146200,WALTON CAREER DEVELOPMENT CENTER        ,FL,32433-1557,Public       ,3,15,18,3,15,18
04147800,ROSE TRAINING INSTITUTE                 ,FL,33881-4094,Proprietary  ,3,30,33,5,97,102
04148500,MEDICAL INSTITUTE OF PALM BEACH         ,FL,33460-5042,Proprietary  ,3,56,59,22,163,185
04150800,IMMOKALEE TECHNICAL CENTER              ,FL,34142-3146,Public       ,14,19,33,14,19,33
04156300,UNIVERSITY OF FORT LAUDERDALE           ,FL,33313-5809,Private      ,0,17,17,0,17,17
04157100,DELTA CONNECTION ACADEMY                ,FL,32725-9683,Proprietary  ,0,1,1,0,1,1
04162500,HOLLYWOOD INSTITUTE OF BEAUTY CAREERS   ,FL,33020-4807,Proprietary  ,5,70,75,5,71,76
00160500,CHAMINADE UNIV OF HONOLULU              ,HI,96816-1578,Private      ,57,133,190,1511,1536,3047
00160600,BRIGHAM YOUNG UNIV-HAWAII CAMPUS        ,HI,96762-1294,Private      ,111,84,195,1202,751,1953
00161000,UNIVERSITY OF HAWAII AT MANOA           ,HI,96822-2399,Public       ,319,435,754,10772,8249,19021
00161100,UNIVERSITY OF HAWAII AT HILO            ,HI,96720-4091,Public       ,76,152,228,3097,2359,5456
00161200,HONOLULU COMMUNITY COLLEGE              ,HI,96817-4598,Public       ,131,270,401,1557,1896,3453
00161300,KAPIOLANI COMMUNITY COLLEGE             ,HI,96816-4421,Public       ,195,389,584,2530,2854,5384
00161400,KAUAI COMMUNITY COLLEGE                 ,HI,96766-9591,Public       ,44,96,140,383,605,988
00161500,MAUI COMMUNITY COLLEGE                  ,HI,96732-1644,Public       ,152,446,598,1399,2629,4028
00454900,LEEWARD COMMUNITY COLLEGE               ,HI,96782-3393,Public       ,177,383,560,2027,2525,4552
00525800,HAWAII COMMUNITY COLLEGE                ,HI,96720-4075,Public       ,111,284,395,1431,2124,3555
00723401,HEALD COLLEGE - HONOLULU                ,HI,96814-0000,Proprietary  ,159,287,446,819,1382,2201
00727900,HAWAII PACIFIC UNIVERSITY               ,HI,96813-2882,Private      ,107,232,339,3946,3265,7211
01122000,WINDWARD COMMUNITY COLLEGE              ,HI,96744-0000,Public       ,73,155,228,748,1083,1831
02100300,MED-ASSIST SCHOOL OF HAWAII             ,HI,96813-0000,Proprietary  ,10,31,41,54,155,209
02107800,UNIVERSITY OF HAWAII - WEST OAHU        ,HI,96782-0000,Public       ,31,78,109,653,1037,1690
02139500,HAWAII INSTITUTE OF HAIR DESIGN         ,HI,96817-5195,Proprietary  ,5,26,31,41,140,181
03017800,TRAVEL INSTITUTE OF THE PACIFIC         ,HI,96814-1946,Proprietary  ,7,34,41,47,162,209
03020800,NEW YORK TECHNICAL INST OF HAWAII       ,HI,96817-4415,Proprietary  ,0,0,0,1,3,4
03072500,WORLD MEDICINE INSTITUTE                ,HI,96826-0000,Private      ,4,8,12,17,72,89
03649300,HAWAII TECHNOLOGY INSTITUTE             ,HI,96813-3036,Private      ,4,15,19,27,73,100
03735300,INST OF CLINICAL ACUPUNCTURE & ORIENT MD,HI,96813-2307,Proprietary  ,1,7,8,2,43,45
03999400,TRADITIONAL CHINESE MEDICAL COLLEGE OF H,HI,96743-8324,Private      ,0,3,3,2,52,54
04154100,PACIFIC RIM BIBLE COLLEGE               ,HI,96819-2228,Private      ,5,17,22,5,17,22
00161600,BOISE STATE UNIVERSITY                  ,ID,83725-1000,Public       ,389,1119,1508,10175,11980,22155
00161700,"COLLEGE OF IDAHO, THE                   ",ID,83605-4432,Private      ,24,26,50,1258,316,1574
00161900,COLLEGE OF SOUTHERN IDAHO               ,ID,83301-0000,Public       ,288,692,980,3249,4888,8137
00161908,COLLEGE OF WESTERN IDAHO                ,ID,83687-1515,Public       ,272,846,1118,1060,2814,3874
00162000,IDAHO STATE UNIVERSITY                  ,ID,83209-5377,Public       ,342,925,1267,4933,9442,14375
00162100,LEWIS-CLARK STATE COLLEGE               ,ID,83501-2698,Public       ,76,237,313,2156,2234,4390
00162300,NORTH IDAHO COLLEGE                     ,ID,83814-2199,Public       ,245,630,875,2654,3788,6442
00162400,NORTHWEST NAZARENE UNIVERSITY           ,ID,83686-5897,Private      ,24,121,145,1567,1186,2753
00162500,BRIGHAM YOUNG UNIVERSITY-IDAHO          ,ID,83460-1650,Private      ,1255,1116,2371,8799,7049,15848
00162600,UNIVERSITY OF IDAHO                     ,ID,83844-4291,Public       ,184,242,426,8515,4314,12829
00455300,ITT TECHNICAL INSTITUTE                 ,ID,83713-1529,Proprietary  ,147,433,580,832,2350,3182
00458304,BROWN MACKIE COLLEGE-SOUTH BEND - BROWN ,ID,83709-2746,Proprietary  ,23,127,150,142,785,927
00987300,MR JUAN'S CLG OF HAIR DESIGN            ,ID,83301-4154,Proprietary  ,3,12,15,20,52,72
01113300,EASTERN IDAHO TECHNICAL COLLEGE         ,ID,83404-5788,Public       ,49,178,227,325,1310,1635
02210700,CAREER BEAUTY COLLEGE                   ,ID,83440-0000,Proprietary  ,0,0,0,9,13,22
02218000,APOLLO COLLEGE                          ,ID,83704-0000,Proprietary  ,39,251,290,276,1272,1548
02234500,BOISE BIBLE COLLEGE                     ,ID,83714-1220,Private      ,4,7,11,140,91,231
02275800,MR LEONS SCHOOL OF HAIR DESIGN          ,ID,83843-8384,Proprietary  ,7,8,15,39,58,97
02275801,MR. LEON'S SCHOOL OF HAIR DESIGN        ,ID,83501-1910,Proprietary  ,1,4,5,3,16,19
02314000,SCHOOL OF HAIRSTYLING (THE)             ,ID,83202-0000,Proprietary  ,3,8,11,41,75,116
02319800,HEADMASTERS SCHOOL OF HAIR DESIGN       ,ID,83814-0000,Proprietary  ,37,44,81,135,209,344
02349200,HEADMASTERS SCHOOL OF HAIR DESIGN       ,ID,83501-0000,Proprietary  ,4,10,14,33,56,89
02559500,RAZZLE DAZZLE CLG OF HAIR DESIGN        ,ID,83686-5104,Proprietary  ,4,24,28,47,132,179
02607100,SCOT LEWIS SCHOOLS                      ,ID,83709-1662,Proprietary  ,17,29,46,121,193,314
03098700,ACADEMY OF COURT REPORTING              ,ID,83704-8320,Proprietary  ,48,225,273,251,1080,1331
03832400,COSMETOLOGY SCHOOL OF ARTS & SCIENCES   ,ID,83318-1327,Proprietary  ,2,10,12,12,63,75
04134300,EVANS HAIRSTYLING COLLEGE               ,ID,83440-5277,Proprietary  ,6,11,17,53,30,83
04144500,HAIR ACDMY PAUL MITCHELL PARTNER SCHOOL ,ID,83440-2600,Proprietary  ,9,14,23,76,95,171
04150600,D & L ACADEMY OF HAIR DESIGN            ,ID,83301-6229,Proprietary  ,1,4,5,1,5,6
04155200,OLIVER FINLEY ACADEMY OF COSMETOLOGY    ,ID,83704-8011,Proprietary  ,10,37,47,34,93,127
00163200,AQUINAS INSTITUTE OF THEOLOGY           ,MO,63108-3323,Private      ,0,5,5,3,71,74
00244900,AVILA COLLEGE                           ,MO,64145-1698,Private      ,23,130,153,941,1453,2394
00245000,CALVARY BIBLE COLLEGE                   ,MO,64147-1341,Private      ,5,22,27,155,172,327
00245200,CENTRAL BIBLE COLLEGE                   ,MO,65803-1096,Private      ,22,25,47,547,315,862
00245300,CENTRAL METHODIST UNIVERSITY            ,MO,65248-1198,Private      ,24,65,89,1390,768,2158
00245301,CENTRAL METHODIST UNIVERSITY            ,MO,63601-0000,Private      ,3,14,17,64,224,288
00245302,CENTRAL METHODIST UNIVERSITY- UNION     ,MO,63084-0000,Private      ,0,5,5,31,51,82
00245400,UNIVERSITY OF CENTRAL MISSOURI          ,MO,64093-5178,Public       ,140,371,511,7256,4501,11757
00245600,COLUMBIA COLLEGE                        ,MO,65216-4581,Private      ,172,1628,1800,2809,15694,18503
00245700,CONCORDIA SEMINARY                      ,MO,63105-3199,Private      ,0,4,4,3,491,494
00245800,COTTEY COLLEGE                          ,MO,64772-2790,Private      ,8,3,11,318,40,358
00245900,CROWDER COLLEGE                         ,MO,64850-9165,Public       ,174,422,596,1862,2797,4659
00246000,CULVER STOCKTON COLLEGE                 ,MO,63435-1299,Private      ,9,10,19,1013,181,1194
00246100,DRURY UNIVERSITY                        ,MO,65802-3791,Private      ,100,363,463,2385,3955,6340
00246200,EDEN THEOLOGICAL SEMINARY               ,MO,63119-0000,Private      ,0,4,4,6,108,114
00246300,EVANGEL UNIVERSITY                      ,MO,65802-2125,Private      ,40,63,103,1961,806,2767
00246400,FONTBONNE UNIVERSITY                    ,MO,63105-3098,Private      ,27,325,352,1203,2854,4057
00246600,HARRIS-STOWE STATE COLLEGE              ,MO,63103-2199,Public       ,58,166,224,1581,1975,3556
00246700,CONCEPTION SEMINARY COLLEGE             ,MO,64433-0000,Private      ,5,1,6,65,20,85
00246800,JEFFERSON COLLEGE                       ,MO,63050-2441,Public       ,151,496,647,2631,3126,5757
00247100,ST LOUIS COMMUNITY COLLEGE              ,MO,63102-0000,Public       ,795,2699,3494,9754,16890,26644
00247300,KANSAS CITY ART INSTITUTE               ,MO,64111-1874,Private      ,19,22,41,987,273,1260
00247400,KANSAS CITY UNIV OF MED AND BIOSCIENCES ,MO,64106-0000,Private      ,5,5,10,8,20,28
00247400,KANSAS CITY UNIV OF MED & BIOSCIENCES   ,MO,64106-0000,Private      ,0,0,0,19,1079,1098
00247600,KENRICK-GLENNON SEMINARY                ,MO,63119-0000,Private      ,0,0,0,8,6,14
00247700,A.T. STILL UNIV OF HEALTH SCIENCES      ,MO,63501-0000,Private      ,0,104,104,10,2866,2876
00247900,LINCOLN UNIVERSITY                      ,MO,65101-3500,Public       ,79,142,221,2801,1845,4646
00248000,LINDENWOOD UNIVERSITY                   ,MO,63301-1695,Private      ,122,669,791,4854,6867,11721
00248200,MARYVILLE UNIVERSITY                    ,MO,63141-7299,Private      ,29,165,194,2040,2112,4152
00248400,METROPOLITAN COMMUNITY COLLEGE          ,MO,64111-2408,Public       ,902,2468,3370,9072,14711,23783
00248500,MIDWESTERN BAPTIST THEOL SEMINARY       ,MO,64118-4697,Private      ,5,26,31,80,272,352
00248600,MINERAL AREA COLLEGE                    ,MO,63601-1000,Public       ,111,411,522,1900,2622,4522
00248800,MISSOURI SOUTHERN STATE UNIVERSITY      ,MO,64801-1595,Public       ,202,390,592,3700,3705,7405
00248900,MISSOURI VALLEY COLLEGE                 ,MO,65340-3197,Private      ,15,32,47,1606,466,2072
00249000,MISSOURI WESTERN STATE UNIVERSITY       ,MO,64507-2294,Public       ,115,232,347,4321,2599,6920
00249100,MOBERLY AREA COMMUNITY COLLEGE          ,MO,65270-1304,Public       ,163,458,621,2643,3171,5814
00249400,NAZARENE THEOLOGICAL SEMINARY           ,MO,64131-1246,Private      ,0,11,11,0,172,172
00249500,TRUMAN STATE UNIVERSITY                 ,MO,63501-4221,Public       ,52,28,80,5510,570,6080
00249600,NORTHWEST MISSOURI STATE UNIV           ,MO,64468-6001,Public       ,83,104,187,6434,1383,7817
00249800,PARK UNIVERSITY                         ,MO,64152-3795,Private      ,63,750,813,1369,7454,8823
00249900,ROCKHURST UNIVERSITY                    ,MO,64110-2561,Private      ,21,110,131,1952,1538,3490
00250000,COLLEGE OF THE OZARKS                   ,MO,65726-2502,Private      ,69,27,96,2952,366,3318
00250100,SOUTHEAST MISSOURI STATE UNIV           ,MO,63701-4799,Public       ,161,412,573,7427,4138,11565
00250200,SOUTHWEST BAPTIST UNIVERSITY            ,MO,65613-2597,Private      ,40,138,178,2135,1668,3803
00250300,MISSOURI STATE UNIVERSITY               ,MO,65897-0094,Public       ,338,594,932,13034,7317,20351
00250400,ST LOUIS COLLEGE OF PHARMACY            ,MO,63110-1088,Private      ,11,16,27,786,543,1329
00250600,SAINT LOUIS UNIVERSITY                  ,MO,63103-2097,Private      ,118,350,468,8263,7544,15807
00250900,SAINT PAUL SCHOOL OF THEOLOGY           ,MO,64127-2499,Private      ,0,12,12,3,189,192
00251200,STEPHENS COLLEGE                        ,MO,65215-0001,Private      ,16,52,68,962,574,1536
00251400,NORTH CENTRAL MISSOURI COLLEGE          ,MO,64683-1824,Public       ,20,119,139,742,1025,1767
00251600,UNIVERSITY OF MISSOURI-COLUMBIA         ,MO,65211-1600,Public       ,358,455,813,21997,8372,30369
00251700,MISSOURI UNIVERSITY OF SCIENCE & TECHNOL,MO,65409-0250,Public       ,76,75,151,4710,1148,5858
00251800,UNIVERSITY OF MISSOURI-KANSAS CITY      ,MO,64110-2497,Public       ,175,661,836,6309,9066,15375
00251900,UNIVERSITY OF MISSOURI-ST LOUIS         ,MO,63121-4499,Public       ,174,690,864,5374,9408,14782
00252000,WASHINGTON UNIVERSITY                   ,MO,63130-4899,Private      ,154,194,348,13322,5450,18772
00252001,WASHINGTON UNIV-SCHOOL OF MEDICINE      ,MO,63110-0000,Private      ,4,12,16,54,1283,1337
00252100,WEBSTER UNIVERSITY                      ,MO,63119-3194,Private      ,69,1102,1171,3122,13335,16457
00252200,WENTWORTH MILITARY ACADEMY              ,MO,64067-1799,Private      ,13,37,50,172,212,384
00252300,WESTMINSTER COLLEGE                     ,MO,65251-1299,Private      ,13,5,18,1256,128,1384
00252400,WILLIAM JEWELL COLLEGE                  ,MO,64068-1896,Private      ,19,22,41,1545,263,1808
00252500,WILLIAM WOODS UNIVERSITY                ,MO,65251-2388,Private      ,24,296,320,1017,2012,3029
00405704,NATIONAL AMERICAN UNIVERSITY            ,MO,64057-1791,Proprietary  ,6,61,67,52,442,494
00441300,ST JOHNS HOSP SCH RAD TECH              ,MO,65802-0000,Private      ,1,13,14,41,95,136
00470300,LOGAN COLLEGE OF CHIROPRACTIC           ,MO,63006-1065,Private      ,4,52,56,78,1196,1274
00470700,COVENANT THEOLOGICAL SEMINARY           ,MO,63141-8697,Private      ,0,24,24,2,539,541
00471100,LINN STATE TECHNICAL COLLEGE            ,MO,65051-9607,Public       ,27,41,68,1085,475,1560
00471300,THREE RIVERS COMMUNITY COLLEGE          ,MO,63901-2393,Public       ,121,390,511,1736,2848,4584
00528800,KIRKSVILLE AREA TECHNICAL CENTER        ,MO,63501-0000,Public       ,2,8,10,32,77,109
00528900,WAYNESVILLE TECHNICAL ACADEMY           ,MO,65583-0000,Public       ,1,13,14,21,119,140
00542400,SOUTH CENTRAL CAREER CENTER             ,MO,65775-3334,Public       ,5,31,36,54,210,264
00542600,SIKESTON CAREER AND TECHNOLOGY CTR      ,MO,63801-0000,Public       ,2,16,18,38,138,176
00542900,ROLLA TECHNICAL INSTITUTE               ,MO,65401-3601,Public       ,12,34,46,255,339,594
00543000,POPLAR BLUFF TECHNICAL CAREER CNTR      ,MO,63901-0000,Public       ,3,11,14,45,101,146
00543800,SALINE COUNTY CAREER CENTER             ,MO,65340-0000,Public       ,0,6,6,20,93,113
00544500,TRUMAN MEDICAL CENTER SCHOOL OF NURSE AN,MO,64108-2677,Private      ,1,9,10,31,103,134
00553100,GRAND RIVER TECHNICAL SCHOOL            ,MO,64601-1299,Public       ,1,2,3,80,49,129
00553200,CAPE GIRARDEAU CAREER & TECHNOLOGY CENTE,MO,63703-7511,Public       ,6,49,55,94,403,497
00638500,CHAMBERLAIN COLLEGE OF NURSING          ,MO,63139-3297,Proprietary  ,78,1234,1312,989,7041,8030
00638900,BARNES JEWISH COLLEGE OF NURSING AND ALL,MO,63110-1091,Private      ,13,63,76,267,727,994
00639200,RESEARCH COLLEGE OF NURSING             ,MO,64132-1199,Proprietary  ,5,19,24,84,270,354
00639201,RESEARCH MEDICAL CENTER - COLLEGE OF NUR,MO,64132-1199,Proprietary  ,0,4,4,9,28,37
00639202,RESEARCH MED CTR SCHL OF RAD TECH       ,MO,64132-0000,Proprietary  ,0,8,8,4,49,53
00666600,LUTHERAN  SCHOOL OF NURSING             ,MO,63118-3909,Proprietary  ,6,25,31,12,48,60
00754000,MISSOURI BAPTIST UNIVERSITY             ,MO,63141-8698,Private      ,40,208,248,1385,2034,3419
00755700,ITT TECHNICAL INSTITUTE                 ,MO,63045-1122,Proprietary  ,345,950,1295,1579,4028,5607
00808000,STATE FAIR COMMUNITY COLLEGE            ,MO,65301-0000,Public       ,143,404,547,2082,2892,4974
00826900,HILLYARD TECHNICAL CENTER               ,MO,64506-0000,Public       ,3,22,25,104,255,359
00855200,PATRICIA STEVENS COLLEGE                ,MO,63102-2334,Proprietary  ,13,19,32,77,164,241
00860600,TRI-COUNTY TECHNICAL SCHOOL             ,MO,65026-0000,Public       ,3,19,22,20,91,111
00886200,EAST CENTRAL COLLEGE                    ,MO,63084-0529,Public       ,144,381,525,2000,2425,4425
00908900,HANNIBAL-LAGRANGE COLLEGE               ,MO,63401-1999,Private      ,14,40,54,770,500,1270
00952000,NATIONAL ACADEMY OF BEAUTY ARTS         ,MO,63128-1307,Proprietary  ,22,82,104,193,457,650
00959000,INDEPENDENCE COLLEGE OF COSMETOLOGY     ,MO,64055-1105,Proprietary  ,9,23,32,44,107,151
00960700,HOUSE OF HEAVILIN BEAUTY COLLEGE        ,MO,64110-2826,Proprietary  ,6,15,21,33,103,136
00978200,SAINT LUKE'S COLLEGE                    ,MO,64114-3237,Private      ,4,16,20,76,184,260
00979500,MISSOURI COLLEGE                        ,MO,63144-2901,Proprietary  ,64,202,266,383,1152,1535
01014814,COLORADO TECHNL UNIV NORTH KANSAS CITY  ,MO,64116-3614,Proprietary  ,38,163,201,241,1330,1571
01027900,HICKEY COLLEGE                          ,MO,63146-0000,Proprietary  ,42,40,82,451,241,692
01040500,PINNACLE CAREER INSTITUTE               ,MO,64131-3367,Proprietary  ,46,411,457,226,1881,2107
01040501,PINNACLE CAREER INSTITUTE - NORTH KANSAS,MO,64153-1151,Proprietary  ,7,59,66,44,319,363
01050303,WICHITA TECHNICAL INSTITUTE - WTI JOPLIN,MO,64801-2970,Proprietary  ,9,63,72,33,329,362
01102600,WARRENSBURG AREA VOC TECH SCH           ,MO,64093-0000,Public       ,1,5,6,29,55,84
01173500,PIKE/LINCOLN TECHNICAL CENTER           ,MO,63344-0000,Public       ,1,10,11,37,85,122
01212000,ASSEMBLIES OF GOD THEO. SEMINARY        ,MO,65802-0000,Private      ,0,22,22,4,261,265
01250000,RANKEN TECHNICAL COLLEGE                ,MO,63113-2811,Private      ,152,253,405,1404,1399,2803
01258000,ST LOUIS CHRISTIAN COLLEGE              ,MO,63033-6499,Private      ,11,13,24,173,232,405
01320800,BAPTIST BIBLE COLLEGE                   ,MO,65803-3498,Private      ,31,22,53,370,227,597
02056100,FOUR RIVERS CAREER CENTER               ,MO,63090-0000,Public       ,3,6,9,15,54,69
02066900,NICHOLS CAREER CENTER                   ,MO,65101-2814,Public       ,2,10,12,74,144,218
02068200,COX HEALTH - COX COLLEGE                ,MO,65802-0000,Private      ,10,86,96,201,636,837
02068202,COX HEALTH - RADIOLOGIC TECHNOLOGY      ,MO,65802-0000,Private      ,0,15,15,33,81,114
02068204,COX HEALTH - MEDICAL TECHNOLOGY         ,MO,65807-0000,Private      ,2,12,14,14,60,74
02073600,KENNETT CAREER & TECHNOLOGY CENTER      ,MO,63857-0000,Public       ,1,9,10,23,49,72
02090400,BOONSLICK TECHNICAL EDUCATION CTR       ,MO,65233-0000,Public       ,1,5,6,9,66,75
02121100,MIDWEST INSTITUTE                       ,MO,63122-0000,Proprietary  ,12,82,94,57,352,409
02124500,FRANKLIN TECHNOLOGY CENTER              ,MO,64801-0000,Public       ,8,33,41,73,390,463
02142200,LEX LA RAY TECHNICAL CENTER             ,MO,64067-0000,Public       ,3,7,10,17,72,89
02151000,HANNIBAL CAREER AND TECHNICAL CENTE     ,MO,63401-2285,Public       ,0,7,7,22,109,131
02164200,FOREST INST PROFESSIONAL PSYCHOLOGY     ,MO,65807-0000,Private      ,0,5,5,9,310,319
02165900,CHILLICOTHE BEAUTY ACADEMY              ,MO,64601-0000,Proprietary  ,1,8,9,10,32,42
02180200,METRO BUSINESS COLLEGE                  ,MO,63701-0000,Proprietary  ,29,156,185,191,951,1142
02188100,NORTHLAND CAREER CENTER                 ,MO,64079-8333,Public       ,0,1,1,20,91,111
02202700,OZARK CHRISTIAN COLLEGE                 ,MO,64801-0000,Private      ,14,19,33,493,185,678
02203400,NEVADA REGIONAL TECHNICAL CENTER        ,MO,64772-0000,Public       ,0,6,6,24,80,104
02205200,SANFORD-BROWN COLLEGE                   ,MO,63026-7305,Proprietary  ,49,216,265,327,1692,2019
02205203,SANFORD BROWN COLLEGE-ST. PETERS        ,MO,63301-4042,Proprietary  ,33,189,222,244,1310,1554
02214500,SALEM COLLEGE OF HAIRSTYLING            ,MO,65401-0000,Proprietary  ,4,9,13,13,54,67
02239200,ALLIED COLLEGE - NORTH                  ,MO,63043-0000,Proprietary  ,109,277,386,610,1500,2110
02239202,ALLIED COLLEGE - METRO SOUTH            ,MO,63026-0000,Proprietary  ,3,26,29,52,122,174
02250600,EVEREST COLLEGE                         ,MO,65807-2446,Proprietary  ,24,150,174,140,848,988
02263106,HIGH-TECH INSTITUTE - KANSAS CITY       ,MO,64114-0000,Proprietary  ,0,17,17,21,76,97
02263400,LAKE CAREER AND TECHNICAL CENTER        ,MO,65020-0000,Public       ,0,6,6,6,33,39
02266400,CENTRAL CHRISTIAN CLG OF THE BIBLE      ,MO,65270-0000,Private      ,5,6,11,278,162,440
02277500,HOUSE OF HEAVILIN OF BLUE SPRINGS       ,MO,64014-3953,Proprietary  ,11,19,30,66,131,197
02289200,COLUMBIA AREA CAREER CENTER             ,MO,65203-0000,Public       ,5,30,35,50,197,247
02295700,MISSOURI BEAUTY ACADEMY                 ,MO,63640-1827,Proprietary  ,3,32,35,64,190,254
02300105,EVEREST COLLEGE - EARTH CITY            ,MO,63045-1100,Proprietary  ,49,247,296,197,1048,1245
02304000,MISSOURI TECH                           ,MO,63132-0000,Proprietary  ,5,16,21,45,133,178
02309100,AMERICAN COLLEGE OF HAIR DESIGN         ,MO,65301-2144,Proprietary  ,4,14,18,29,55,84
02313000,CASS CAREER CENTER                      ,MO,64701-0000,Public       ,2,1,3,12,77,89
02340500,ST LOUIS COLLEGE OF HEALTH CAREERS      ,MO,63110-0000,Proprietary  ,24,129,153,151,753,904
02340501,ST LOUIS COLLEGE OF HEALTH              ,MO,63129-0000,Proprietary  ,3,5,8,15,58,73
02342100,CAREER & TECHNOLOGY CTR AT FT OSAGE     ,MO,64058-0000,Public       ,1,1,2,13,20,33
02361600,CONCORDE CAREER COLLEGE                 ,MO,64111-0000,Proprietary  ,43,199,242,196,1160,1356
02497500,CLINTON TECHNICAL SCHOOL                ,MO,64735-2966,Public       ,3,9,12,10,52,62
02520800,MERRELL UNIV OF BTY ARTS & SCIENCES     ,MO,65109-0000,Proprietary  ,16,37,53,79,170,249
02530600,SAINT CHARLES COMMUNITY COLLEGE         ,MO,63376-0975,Public       ,243,499,742,3565,3177,6742
02543800,PARIS II EDUCATIONAL CENTER (THE)       ,MO,64118-0000,Proprietary  ,16,24,40,43,115,158
02555300,PATSY AND ROB'S ACADEMY OF BEAUTY       ,MO,63074-0000,Proprietary  ,7,21,28,38,126,164
02564700,ELAINE STEVEN BEAUTY COLLEGE            ,MO,63136-0000,Proprietary  ,9,33,42,66,188,254
02564701,ELAINE STEVEN BEAUTY COLLEGE - ADVANCE B,MO,63383-2006,Proprietary  ,0,0,0,3,5,8
02564702,ELAINE STEVEN BEAUTY COLLEGE - ADVANCE B,MO,63401-2269,Proprietary  ,0,0,0,6,9,15
02568500,GRABBER SCHOOL OF HAIR DESIGN           ,MO,63011-0000,Proprietary  ,3,19,22,54,112,166
02599700,VATTEROTT COLLEGE                       ,MO,63134-2900,Proprietary  ,69,333,402,394,1881,2275
02599701,VATTEROTT COLLEGE - KANSAS CITY         ,MO,64129-1692,Proprietary  ,27,263,290,201,1408,1609
02599702,VATTEROTT COLLEGE - SPRINGFIELD LOCATION,MO,65807-5340,Proprietary  ,18,160,178,135,834,969
02599703,VATTEROTT COLLEGE - JOPLIN              ,MO,64801-5033,Proprietary  ,10,117,127,89,679,768
02599705,VATTEROTT COLLEGE - SUNSET HILLS        ,MO,63127-1516,Proprietary  ,16,207,223,158,1043,1201
02599712,VATTEROTT COLLEGE - O'FALLON            ,MO,63366-2748,Proprietary  ,11,81,92,92,453,545
02608000,NEOSHO BEAUTY COLLEGE                   ,MO,64850-1525,Proprietary  ,2,9,11,14,52,66
02609202,VATTEROTT COLLEGE-ST JOSEPH             ,MO,64501-2911,Proprietary  ,13,94,107,128,557,685
02609203,VATTEROTT COLLEGE - L'ECOLE CULINAIRE   ,MO,63124-1103,Proprietary  ,29,124,153,231,755,986
02611004,HERITAGE COLLEGE-KANSAS CITY            ,MO,64131-4203,Proprietary  ,54,223,277,212,1019,1231
03042400,LEBANON TECHNOLOGY & CAREER CENTER      ,MO,65536-3296,Public       ,4,15,19,37,141,178
03066300,BRYAN CAREER COLLEGE                    ,MO,65806-2507,Proprietary  ,12,81,93,66,382,448
03068600,NORTH COUNTY TECH SPECIAL SCH DIST      ,MO,63033-6498,Public       ,6,77,83,74,581,655
03070200,CENTRAL COLLEGE OF COSMETOLOGY          ,MO,65583-0000,Proprietary  ,5,20,25,21,111,132
03070900,SE MO HOSP CLG NURSING & HEALTH SCI     ,MO,63703-4507,Private      ,3,18,21,83,253,336
03077200,COSMETOLOGY CONCEPTS INSTITUTE          ,MO,65202-1972,Proprietary  ,2,13,15,34,89,123
03083000,OZARKS TECHNICAL COMMUNITY COLLEGE      ,MO,65802-3601,Public       ,475,1390,1865,6362,9513,15875
03092600,MESSENGER COLLEGE                       ,MO,64804-4909,Private      ,1,7,8,47,65,112
03097600,ST LOUIS HAIR ACADEMY                   ,MO,63107-1737,Proprietary  ,2,10,12,15,65,80
03101000,NEW DIMENSION SCHOOL OF HAIR DESIGN     ,MO,64801-5017,Proprietary  ,3,6,9,15,65,80
03106000,MISSOURI STATE UNIVERSITY - WEST PLAINS ,MO,65775-2715,Public       ,65,207,272,1074,1373,2447
03110900,HOUSE OF HEAVILIN BEAUTY COLLEGE        ,MO,64030-1154,Proprietary  ,1,7,8,14,63,77
03166300,MOBERLY AREA TECHNICAL CENTER           ,MO,65270-1904,Public       ,0,6,6,14,29,43
03519300,MISSOURI COLLEGE OF COSMETOLOGY NORTH   ,MO,65803-1235,Proprietary  ,7,36,43,59,223,282
03528300,MIDWEST UNIVERSITY                      ,MO,63385-2905,Private      ,0,7,7,6,36,42
03579300,TEXAS COUNTY TECHNICAL INSTITUTE        ,MO,65483-2700,Private      ,8,38,46,47,346,393
03616300,AVIATION INSTITUTE OF MAINTENANCE       ,MO,64129-1811,Proprietary  ,12,61,73,60,328,388
03663400,UNIVERSITY OF COSMETOLOGY               ,MO,63080-1910,Proprietary  ,2,7,9,13,41,54
03878300,PROFESSIONAL MASSAGE TRAINING CENTER    ,MO,65803-2939,Proprietary  ,4,19,23,38,99,137
03916300,ECLIPS SCHOOL OF COSMETOLOGY AND BARBERI,MO,63703-5809,Proprietary  ,7,23,30,26,98,124
03924300,HAIR ACADEMY 110 (THE)                  ,MO,63501-2915,Proprietary  ,0,4,4,18,18,36
03970400,MTTI-WELLSPRING CENTER FOR NATURAL HEALT,MO,64114-3313,Proprietary  ,7,38,45,42,161,203
04037500,ACADEMY OF HAIR DESIGN                  ,MO,65804-2303,Proprietary  ,11,38,49,61,192,253
04048300,DIVAS UNLIMITED ACADEMY                 ,MO,63114-2625,Proprietary  ,0,0,0,8,25,33
04127000,PEMISCOT COUNTY SPECIAL SCHOOL DISTRICT ,MO,63851-1666,Public       ,0,1,1,10,54,64
04130600,HEALING ARTS CENTER                     ,MO,63143-2103,Proprietary  ,2,21,23,13,84,97
04133300,TREND SETTERS SCHOOL OF COSMETOLOGY     ,MO,63702-7607,Proprietary  ,3,22,25,46,91,137
04145200,TRANSFORMED BARBER AND COSMETOLOGY ACADE,MO,64137-1207,Proprietary  ,11,44,55,11,44,55
04145700,THE SYSTEM A PAUL MITCHELL PARTNER SCHL ,MO,65807-5969,Proprietary  ,25,33,58,103,124,227
04146100,URSHAN GRADUATE SCHOOL OF THEOLOGY      ,MO,63031-7526,Private      ,0,2,2,0,18,18
00163201,AQUINAS INSTITUTE OF THEOLOGY - MINISTRY,OK,73123-0380,Private      ,2,3,5,2,9,11
00314600,WESTERN OKLAHOMA STATE COLLEGE          ,OK,73521-1397,Public       ,27,119,146,602,982,1584
00314700,BACONE COLLEGE                          ,OK,74403-1597,Private      ,32,61,93,937,751,1688
00314900,SOUTHERN NAZARENE UNIVERSITY            ,OK,73008-2694,Private      ,44,326,370,1188,1669,2857
00315000,CAMERON UNIVERSITY                      ,OK,73505-6377,Public       ,114,416,530,2027,3646,5673
00315100,OKLAHOMA WESLEYAN UNIVERSITY            ,OK,74006-6299,Private      ,10,85,95,604,958,1562
00315200,UNIV OF CENTRAL OKLAHOMA                ,OK,73034-5209,Public       ,362,646,1008,7756,7028,14784
00315300,CONNORS STATE COLLEGE                   ,OK,74469-9700,Public       ,51,225,276,942,1427,2369
00315400,EAST CENTRAL UNIVERSITY                 ,OK,74820-6999,Public       ,100,297,397,2356,2820,5176
00315500,EASTERN OKLAHOMA STATE COLLEGE          ,OK,74578-4999,Public       ,41,167,208,832,1236,2068
00315600,REDLANDS COMMUNITY COLLEGE              ,OK,73036-5304,Public       ,41,201,242,694,1210,1904
00315700,LANGSTON UNIVERSITY                     ,OK,73050-0000,Public       ,77,147,224,2080,2028,4108
00315800,MURRAY STATE COLLEGE                    ,OK,73460-3137,Public       ,68,272,340,1105,1977,3082
00316000,NORTHEASTERN OKLAHOMA A & M COLLEGE     ,OK,74354-6497,Public       ,62,150,212,1443,1180,2623
00316100,NORTHEASTERN STATE UNIVERSITY           ,OK,74464-2399,Public       ,191,524,715,4572,6182,10754
00316200,NORTHERN OKLAHOMA COLLEGE               ,OK,74653-0310,Public       ,120,300,420,1824,2188,4012
00316300,NORTHWESTERN OKLAHOMA STATE UNIV        ,OK,73717-2799,Public       ,43,85,128,1150,963,2113
00316400,OKLAHOMA BAPTIST UNIVERSITY             ,OK,74801-2590,Private      ,47,40,87,1742,360,2102
00316500,OKLAHOMA CHRISTIAN UNIVERSITY           ,OK,73131-0000,Private      ,50,71,121,2017,648,2665
00316600,OKLAHOMA CITY UNIVERSITY                ,OK,73106-1493,Private      ,45,169,214,2166,2477,4643
00316700,UNIV OF SCIENCE & ARTS OF OKLAHOMA      ,OK,73018-5322,Public       ,24,62,86,714,513,1227
00316800,ROGERS STATE UNIVERSITY                 ,OK,74017-3252,Public       ,94,320,414,2176,2942,5118
00317000,OKLAHOMA STATE UNIVERSITY               ,OK,74078-1015,Public       ,528,549,1077,13488,7295,20783
00317200,OKLAHOMA STATE UNIVERSITY-OKMULGEE      ,OK,74447-3901,Public       ,123,257,380,1638,1719,3357
00317400,OKLAHOMA PANHANDLE STATE UNIVERSITY     ,OK,73939-0000,Public       ,66,52,118,837,450,1287
00317600,CARL ALBERT STATE COLLEGE               ,OK,74953-5208,Public       ,45,260,305,1120,1982,3102
00317800,SEMINOLE STATE COLLEGE                  ,OK,74818-1902,Public       ,70,150,220,874,1338,2212
00317900,SOUTHEASTERN OKLAHOMA STATE UNIV        ,OK,74701-0609,Public       ,107,247,354,2308,2334,4642
00318000,SOUTHWESTERN CHRISTIAN UNIVERSITY       ,OK,73008-2335,Private      ,7,30,37,174,216,390
00318100,SOUTHWESTERN OKLAHOMA STATE UNIV        ,OK,73096-3098,Public       ,103,182,285,2675,1919,4594
00318101,SOUTHWESTERN OK STATE UNIV AT SAYRE     ,OK,73662-0000,Public       ,13,42,55,151,276,427
00318300,ST GREGORY'S UNIVERSITY                 ,OK,74804-2499,Private      ,3,68,71,335,480,815
00318308,SAINT GREGORY'S UNIVERSITY - IPD TULSA  ,OK,74135-2499,Private      ,0,20,20,17,157,174
00318400,UNIVERSITY OF OKLAHOMA                  ,OK,73019-4078,Public       ,431,726,1157,15146,9907,25053
00318401,UNIVERSITY OF OKLAHOMA-HLTH SCI CTR     ,OK,73190-0000,Public       ,9,121,130,428,3587,4015
00318500,UNIVERSITY OF TULSA                     ,OK,74104-3189,Private      ,75,127,202,2758,1904,4662
00398500,ORAL ROBERTS UNIVERSITY                 ,OK,74171-0001,Private      ,54,144,198,2799,1568,4367
00458305,BROWN MACKIE COLLEGE-SOUTH BEND - BROWN ,OK,74146-5234,Proprietary  ,10,120,130,59,480,539
00531100,TULSA COUNTY AREA VOC TECH SCHOOL       ,OK,74145-0000,Public       ,22,228,250,234,1219,1453
00531200,RED RIVER TECHNOLOGY CENTER             ,OK,73533-2700,Public       ,5,40,45,38,242,280
00533900,METRO TECHNOLOGY CENTERS SCH DIST22     ,OK,73111-0000,Public       ,29,270,299,203,1328,1531
00533903,METRO TECHNOLOGY CENTERS SCH DIST22     ,OK,73129-0000,Public       ,7,78,85,59,371,430
00694200,MID-AMERICA CHRISTIAN UNIVERSITY        ,OK,73170-4504,Private      ,15,134,149,447,1159,1606
00767800,SPARTAN COLLEGE OF AERONAUTICS AND TECHN,OK,74115-5800,Proprietary  ,87,154,241,1137,1067,2204
00791100,VIRGILS BEAUTY COLLEGE                  ,OK,74401-6802,Proprietary  ,10,11,21,19,53,72
00834300,AUTRY TECHNOLOGY CENTER                 ,OK,73703-2598,Public       ,6,52,58,62,310,372
00861900,TRI COUNTY TECHNOLOGY CENTER            ,OK,74006-6029,Public       ,5,29,34,87,210,297
00918500,ROSE STATE COLLEGE                      ,OK,73110-2799,Public       ,162,735,897,2226,5434,7660
00920400,KIAMICHI AREA VOC TECH SCHOOL           ,OK,74578-0548,Public       ,26,153,179,282,1218,1500
00920408,KIAMICHI AREA VOC TECH SCHOOL           ,OK,74953-0000,Public       ,4,20,24,34,121,155
00961800,TULSA WELDING SCHOOL                    ,OK,74104-0000,Proprietary  ,132,417,549,1091,1704,2795
00964700,"OKLAHOMA STATE UNIV, OKLA CITY          ",OK,73107-6159,Public       ,168,797,965,2019,5491,7510
00970800,EVES COLLEGE OF HAIRSTYLING             ,OK,73501-4359,Proprietary  ,4,36,40,25,134,159
00976300,TULSA COMMUNITY COLLEGE                 ,OK,74135-6198,Public       ,401,1710,2111,7284,11763,19047
00996300,CADDO KIOWA VOC TECH CENTER             ,OK,73038-0000,Public       ,15,68,83,90,386,476
00996400,CENTRAL OKLAHOMA AREA VOC TECH SCH      ,OK,74030-9613,Public       ,15,67,82,82,307,389
00996500,CANADIAN VALLEY TECHNOLOGY CENTER       ,OK,73036-9117,Public       ,14,104,118,95,476,571
00996800,GORDON COOPER TECHNOLOGY CENTER         ,OK,74804-9913,Public       ,8,68,76,89,412,501
01005300,INDIAN CAPITAL TECHNOLGY CENTER #4      ,OK,74403-9907,Public       ,22,126,148,172,697,869
01026600,HILLSDALE FREE WILL BAPTIST COLLEGE     ,OK,73153-0000,Private      ,8,13,21,231,74,305
01034200,SOUTHERN OKLAHOMA TECHNOLOGY CENTER     ,OK,73401-2100,Public       ,7,44,51,81,281,362
01039100,OKLAHOMA CITY COMMUNITY COLLEGE         ,OK,73159-4444,Public       ,318,1313,1631,4092,8473,12565
01050304,WTI TULSA CAMPUS                        ,OK,74112-3140,Proprietary  ,4,40,44,15,156,171
01071700,GREAT PLAINS TECHNOLOGY CENTER SCHOOL DI,OK,73505-8399,Public       ,11,79,90,86,451,537
01076200,WESTERN OK AREA VOC TECH SCH DIST12     ,OK,73624-1469,Public       ,5,19,24,54,137,191
01120600,PIONEER TECHNOLOGY CENTER               ,OK,74601-1106,Public       ,3,43,46,39,217,256
01128200,OKLAHOMA STATE UNV CLG OSTEOPTHC MD     ,OK,74107-0000,Public       ,3,13,16,51,564,615
01153700,MID-AMERICA TECHNOLOGY CENTER           ,OK,73095-0210,Public       ,4,15,19,32,105,137
01227200,MOORE-NORMAN TECHNOLOGY CENTER          ,OK,73069-8399,Public       ,31,140,171,157,799,956
02052700,NORTHEAST TECHNOLOGY CENTER             ,OK,74361-0487,Public       ,18,116,134,75,569,644
02052701,NORTHEAST TECHNOLOGY CENTER -           ,OK,74362-0825,Public       ,0,0,0,20,116,136
02060800,MERIDIAN TECHNOLOGY CENTER              ,OK,74074-0000,Public       ,4,53,57,91,385,476
02126500,ENID BEAUTY COLLEGE                     ,OK,73701-0000,Proprietary  ,6,9,15,28,70,98
02177900,STATE BARBER AND HAIR DESIGN CLG        ,OK,73108-0000,Proprietary  ,0,0,0,1,0,1
02184400,SAND SPRINGS BEAUTY COLLEGE             ,OK,74063-0000,Proprietary  ,6,19,25,37,121,158
02197300,HOLLYWOOD COSMETOLOGY CENTER            ,OK,73189-0000,Proprietary  ,1,8,9,8,45,53
02222700,FRANCIS TUTTLE TECHNOLOGY CENTER        ,OK,73142-0000,Public       ,38,267,305,240,1325,1565
02238500,CENTRAL STATE BEAUTY ACADEMY            ,OK,73162-6007,Proprietary  ,7,44,51,66,268,334
02250900,E OK COUNTY AREA VO-TECH                ,OK,73020-0000,Public       ,9,25,34,38,92,130
02256200,"BROKEN ARROW BEAUTY COLLEGE, INC        ",OK,74012-0000,Proprietary  ,7,30,37,47,131,178
02282100,HIGH PLAINS AREA VOC-TECH               ,OK,73801-0000,Public       ,6,27,33,34,120,154
02306800,PLATT COLLEGE                           ,OK,74145-0000,Proprietary  ,56,512,568,322,2186,2508
02510300,BEAUTY TECHNICAL COLLEGE                ,OK,74465-0000,Proprietary  ,1,5,6,12,28,40
02531200,WOODWARD BEAUTY COLLEGE                 ,OK,73801-0000,Proprietary  ,1,6,7,2,10,12
02554300,AMERICAN BEAUTY INSTITUTE               ,OK,74501-0000,Proprietary  ,5,7,12,16,39,55
02556500,YUKON BEAUTY COLLEGE                    ,OK,73099-4108,Proprietary  ,1,2,3,9,27,36
02560200,PHILLIPS THEOLOGICAL SEMINARY -         ,OK,74116-5612,Private      ,0,10,10,2,99,101
02581100,CLAREMORE BEAUTY COLLEGE                ,OK,74017-7034,Proprietary  ,0,4,4,12,29,41
02581200,CC'S COSMETOLOGY COLLEGE                ,OK,74129-0000,Proprietary  ,10,79,89,39,299,338
02591101,CAREER POINT INSTITUTE                  ,OK,74146-0000,Proprietary  ,1,16,17,13,115,128
02596501,ATI-CAREER TRAINING CENTER - OKLAHOMA CI,OK,73107-2442,Proprietary  ,2,28,30,12,116,128
02596502,ATI- CAREER TRAINING CENTER - OKLAHOMA C,OK,76101-2740,Proprietary  ,1,9,10,1,9,10
02597400,PONTOTOC TECHNOLOGY CENTER SCHOOL       ,OK,74820-8621,Public       ,9,21,30,63,198,261
02599706,VATTEROTT COLLEGE - TULSA               ,OK,74146-2205,Proprietary  ,13,135,148,61,546,607
02600000,NORTHWEST TECHNOLOG CTR SCH DIST 10     ,OK,73717-9600,Public       ,3,6,9,22,63,85
02600500,WES WATKINS TECHNOLOGY CENTER           ,OK,74883-9660,Public       ,2,21,23,36,205,241
02609205,VATTEROTT COLLEGE - OKLAHOMA CITY       ,OK,73127-2103,Proprietary  ,11,163,174,55,680,735
03008700,SOUTHWEST TECHNOLOGY CENTER             ,OK,73521-1527,Public       ,1,12,13,20,104,124
03010300,POTEAU BEAUTY COLLEGE                   ,OK,74953-5400,Proprietary  ,0,0,0,6,22,28
03024700,STILLWATER BEAUTY ACADEMY               ,OK,74075-3467,Proprietary  ,3,3,6,14,41,55
03030700,OKLAHOMA SCHOOL OF PHOTOGRAPHY          ,OK,73160-3320,Proprietary  ,6,14,20,20,66,86
03030800,AMERICAN BROADCASTING SCHOOL            ,OK,73115-3334,Proprietary  ,13,50,63,47,213,260
03051100,CHISHOLM TRAIL TECHNOLOGY CENTER        ,OK,73764-9720,Public       ,3,12,15,21,66,87
03078500,TECH INST OF COSMETOLOGY ARTS & SCI     ,OK,74120-3610,Proprietary  ,1,10,11,16,45,61
03103800,SOUTHERN SCHOOL OF BEAUTY               ,OK,74701-5008,Proprietary  ,1,4,5,14,46,60
03109800,PONCA CITY BEAUTY COLLEGE               ,OK,74601-4201,Proprietary  ,0,9,9,0,24,24
03109801,BARTLESVILLE BEAUTY COLLEGE             ,OK,74003-2835,Proprietary  ,1,8,9,2,28,30
03115100,HERITAGE COLLEGE                        ,OK,73119-0000,Proprietary  ,39,275,314,265,1160,1425
03124800,PLATT COLLEGE                           ,OK,73501-3808,Proprietary  ,13,43,56,56,233,289
03126200,GREEN COUNTRY AREA VOC TECH SCHOOL      ,OK,74447-1217,Public       ,5,21,26,33,119,152
03198400,MID-DEL AREA VOCATIONAL & TECH SCH      ,OK,73110-4825,Public       ,2,28,30,13,110,123
03329400,PRYOR BEAUTY COLLEGE                    ,OK,74361-0000,Proprietary  ,1,3,4,9,29,38
03329401,PRYOR BEAUTY COLLEGE - GROVE BEAUTY COLL,OK,74345-0009,Proprietary  ,0,4,4,3,22,25
03329402,PRYOR BEAUTY COLLEGE - NORTH EAST OKLAHO,OK,74338-0000,Proprietary  ,0,4,4,1,12,13
03367400,COMMUNITY CARE COLLEGE                  ,OK,74145-6420,Proprietary  ,57,261,318,394,1706,2100
03396300,OKLAHOMA HEALTH ACADEMY                 ,OK,74105-6220,Proprietary  ,9,55,64,52,242,294
03396400,OKLAHOMA HEALTH ACADEMY                 ,OK,73160-3667,Proprietary  ,12,66,78,55,271,326
03453400,SHAWNEE BEAUTY COLLEGE                  ,OK,74801-7014,Proprietary  ,4,10,14,22,55,77
03676300,FAMILY OF FAITH COLLEGE                 ,OK,74802-1805,Private      ,0,1,1,12,22,34
03831300,INSTITUTE OF HAIR DESIGN                ,OK,74804-0000,Proprietary  ,4,7,11,13,35,48
03928300,CENTRAL STATE MASSAGE ACADEMY           ,OK,73162-6007,Proprietary  ,6,20,26,43,115,158
04027300,4-STATES ACADEMY OF COSMETOLOGY         ,OK,74354-0000,Proprietary  ,2,9,11,16,94,110
04060300,AMERICAN INSTITUTE OF MEDICAL TECHNOLOGY,OK,74146-5201,Proprietary  ,2,11,13,33,114,147
04062300,OKLAHOMA TECHNOLOGY INSTITUTE           ,OK,73114-6318,Proprietary  ,4,38,42,14,125,139
04121300,4-STATES OKMULGEE ACADEMY OF COSMETOLOGY,OK,74447-0000,Proprietary  ,1,7,8,10,37,47
04133600,CUTTER'S EDGE SCHOOL OF COSMETOLOGY     ,OK,74023-2905,Proprietary  ,0,6,6,6,21,27
04144400,ACADEMY OF HAIR DESIGN (THE)            ,OK,73120-6808,Proprietary  ,3,17,20,32,51,83
00163700,BETHANY THEOLOGICAL SEMINARY            ,IN,47374-0000,Private      ,0,2,2,1,41,42
00178400,ANCILLA COLLEGE-FINANCIAL AID OFFC      ,IN,46513-0001,Private      ,4,48,52,468,607,1075
00178500,ANDERSON UNIVERSITY                     ,IN,46012-3495,Private      ,32,81,113,2833,1112,3945
00178600,BALL STATE UNIVERSITY                   ,IN,47306-0880,Public       ,217,441,658,20329,9355,29684
00178700,BETHEL COLLEGE INC                      ,IN,46545-5591,Private      ,9,93,102,1592,1410,3002
00178800,BUTLER UNIVERSITY                       ,IN,46208-3487,Private      ,55,85,140,6268,1601,7869
00178900,CHRISTIAN THEOLOGICAL SEMINARY          ,IN,46208-0000,Private      ,0,8,8,2,220,222
00179200,DEPAUW UNIVERSITY                       ,IN,46135-0037,Private      ,23,13,36,3068,106,3174
00179300,EARLHAM COLLEGE                         ,IN,47374-4095,Private      ,18,6,24,1540,144,1684
00179301,EARLHAM SCHOOL OF RELIGION              ,IN,47374-0000,Private      ,0,3,3,16,62,78
00179500,UNIVERSITY OF EVANSVILLE                ,IN,47722-0002,Private      ,30,43,73,3806,748,4554
00179800,FRANKLIN COLLEGE OF INDIANA             ,IN,46131-2623,Private      ,20,13,33,1851,178,2029
00179900,GOSHEN COLLEGE                          ,IN,46526-4794,Private      ,12,32,44,1147,465,1612
00180000,GRACE COLLEGE & THEO SEMINARY           ,IN,46590-1224,Private      ,9,36,45,1517,808,2325
00180100,HANOVER COLLEGE                         ,IN,47243-0108,Private      ,6,4,10,1809,71,1880
00180300,HUNTINGTON UNIVERSITY                   ,IN,46750-1299,Private      ,8,32,40,1397,407,1804
00180400,UNIVERSITY OF INDIANAPOLIS              ,IN,46227-3697,Private      ,52,228,280,4943,3717,8660
00180500,INDIANA INSTITUTE OF TECHNOLOGY         ,IN,46803-1297,Private      ,29,261,290,1558,3319,4877
00180700,INDIANA STATE UNIVERSITY                ,IN,47809-2501,Public       ,140,407,547,8886,6584,15470
00180800,UNIVERSITY OF SOUTHERN INDIANA          ,IN,47712-3596,Public       ,104,238,342,8657,3745,12402
00180900,INDIANA UNIVERSITY-BLOOMINGTON          ,IN,47405-1223,Public       ,358,444,802,31089,11876,42965
00181100,INDIANA UNIV-EAST                       ,IN,47374-1289,Public       ,30,168,198,1335,2154,3489
00181300,INDIANA UNIV-PURDUE UNIV INDPLS         ,IN,46202-5145,Public       ,267,1159,1426,16244,21373,37617
00181301,INDIANA UNIVERSITY - PURDUE UNIVERSITY I,IN,47203-1769,Public       ,40,145,185,1431,1694,3125
00181400,INDIANA UNIV KOKOMO                     ,IN,46902-3557,Public       ,27,177,204,1483,2170,3653
00181500,INDIANA UNIV-NORTHWEST                  ,IN,46408-1197,Public       ,89,391,480,2736,4518,7254
00181600,INDIANA UNIVERSITY - SOUTH BEND         ,IN,46615-0000,Public       ,132,491,623,4634,5858,10492
00181700,INDIANA UNIVERSITY-SOUTHEAST            ,IN,47150-6405,Public       ,92,305,397,3839,4008,7847
00182000,MANCHESTER COLLEGE                      ,IN,46962-1276,Private      ,14,7,21,2392,154,2546
00182100,MARIAN UNIVERSITY                       ,IN,46222-1997,Private      ,28,128,156,1935,1814,3749
00182200,INDIANA WESLEYAN UNIVERSITY             ,IN,46953-4974,Private      ,48,1796,1844,4194,12665,16859
00182300,ASSOCIATED MENNONITE BIBLICAL SEM       ,IN,46517-1999,Private      ,0,0,0,0,111,111
00182400,OAKLAND CITY UNIVERSITY                 ,IN,47660-1099,Private      ,5,51,56,639,2246,2885
00182500,PURDUE UNIVERSITY                       ,IN,47907-2050,Public       ,305,393,698,30701,8092,38793
00182600,PURDUE UNIV NORTH CENTRAL CAMPUS        ,IN,46391-9528,Public       ,59,242,301,2537,3043,5580
00182700,PURDUE UNIV CALUMET                     ,IN,46323-2094,Public       ,152,419,571,5342,5874,11216
00182800,INDIANA UNIV-PURDUE UNIV FORT WAYNE     ,IN,46805-1499,Public       ,166,556,722,8629,8018,16647
00183000,ROSE HULMAN INSTITUTE OF TECHNOLOGY     ,IN,47803-3999,Private      ,21,7,28,3048,123,3171
00183200,UNIVERSITY OF SAINT FRANCIS             ,IN,46808-3994,Private      ,26,110,136,2151,1794,3945
00183300,ST JOSEPH'S COLLEGE                     ,IN,47978-0000,Private      ,5,8,13,1249,142,1391
00183400,CALUMET COLLEGE OF SAINT JOSEPH         ,IN,46394-2195,Private      ,17,96,113,503,912,1415
00183500,SAINT MARY-OF-THE-WOODS COLLEGE         ,IN,47876-0067,Private      ,6,97,103,447,1362,1809
00183600,ST MARY'S COLLEGE                       ,IN,46556-5007,Private      ,6,2,8,1793,73,1866
00183800,TAYLOR UNIVERSITY                       ,IN,46989-1001,Private      ,17,17,34,2463,238,2701
00183801,TAYLOR UNIVERSITY - FORT WAYNE          ,IN,46807-0000,Private      ,0,0,0,126,96,222
00183900,TRINE UNIVERSITY                        ,IN,46703-1764,Private      ,12,52,64,2383,804,3187
00184000,UNIVERSITY OF NOTRE DAME                ,IN,46556-5602,Private      ,97,122,219,12575,3551,16126
00184200,VALPARAISO UNIVERSITY                   ,IN,46383-6493,Private      ,49,70,119,4065,1979,6044
00184300,VINCENNES UNIVERSITY                    ,IN,47591-1523,Public       ,149,459,608,6045,4408,10453
00184400,WABASH COLLEGE                          ,IN,47933-0352,Private      ,9,5,14,1314,58,1372
00224905,DAVENPORT UNIVERSITY-MERRILLVILLE       ,IN,46410-0000,Private      ,0,0,0,19,180,199
00420300,GOOD SAMARITAN HOSP RADIOGRAPHY PRG     ,IN,47591-0000,Public       ,1,1,2,4,17,21
00457900,INTERNATIONAL BUSINESS COLLEGE          ,IN,46804-0000,Proprietary  ,8,25,33,666,324,990
00457901,INTERNATIONAL BUSINESS COLLEGE          ,IN,46256-0000,Proprietary  ,7,29,36,521,295,816
00458300,BROWN MACKIE COLLEGE-SOUTH BEND         ,IN,46635-1776,Proprietary  ,80,513,593,623,3584,4207
00458301,BROWN MACKIE COLLEGE-SOUTH BEND - BROWN ,IN,46805-0000,Proprietary  ,22,166,188,254,1344,1598
00512730,BROWN MACKIE COLLEGE-MERRILLVILLE       ,IN,46410-0000,Proprietary  ,4,50,54,103,452,555
00512731,BROWN MACKIE COLLEGE-CINCINNATI - BROWN ,IN,46360-4362,Proprietary  ,15,102,117,115,519,634
00625700,SAINT ELIZABETH SCHOOL OF NURSING       ,IN,47904-2198,Private      ,0,10,10,138,274,412
00726300,HOLY CROSS COLLEGE                      ,IN,46556-0308,Private      ,8,2,10,552,102,654
00727600,SAINT MEINRAD SCHOOL OF THEOLOGY        ,IN,47577-1002,Private      ,1,8,9,4,114,118
00732700,ITT TECHNICAL INSTITUTE                 ,IN,47630-7430,Proprietary  ,411,1110,1521,1915,4818,6733
00732900,ITT TECHNICAL INSTITUTE                 ,IN,46268-1119,Proprietary  ,512,2858,3370,2490,11896,14386
00736200,MEDTECH COLLEGE                         ,IN,46250-3970,Proprietary  ,28,234,262,227,1709,1936
00736202,MEDTECH COLLEGE - GREENWOOD             ,IN,46143-6478,Proprietary  ,14,123,137,141,823,964
00736204,MEDTECH COLLEGE - FORT WAYNE            ,IN,46804-2209,Proprietary  ,3,66,69,67,552,619
00793800,LINCOLN COLLEGE OF TECHNOLOGY           ,IN,46202-0000,Proprietary  ,168,269,437,2466,1693,4159
00832900,ITT TECHNICAL INSTITUTE                 ,IN,46825-2393,Proprietary  ,321,950,1271,1725,4710,6435
00842300,IVY TECH COMMUNITY COLLEGE OF INDIANA - ,IN,46601-3892,Public       ,224,1373,1597,2724,10075,12799
00854600,NOT FOR STUDENT USE                     ,IN,46208-4700,Public       ,4,7,11,56,122,178
00854700,IVY TECH COMMUNITY COLLEGE OF INDIANA - ,IN,47802-4898,Public       ,136,705,841,2186,5820,8006
00951500,J MICHAEL HARROLD BEAUTY ACADEMY        ,IN,47807-3390,Proprietary  ,4,19,23,28,60,88
00961200,"APEX SCHOOL OF BEAUTY CULTURE, INC      ",IN,46016-0000,Proprietary  ,0,9,9,9,45,54
00961300,MERRILLVILLE BEAUTY COLLEGE             ,IN,46410-3401,Proprietary  ,10,26,36,40,128,168
00967300,RUDAE'S SCHOOL OF BEAUTY CULTURE        ,IN,46825-5444,Proprietary  ,29,43,72,125,200,325
00967301,RUDAE'S SCHOOL OF BEAUTY CULTURE - FORT ,IN,46825-5444,Proprietary  ,0,0,0,0,1,1
00977700,KAPLAN COLLEGE                          ,IN,46278-1736,Proprietary  ,34,239,273,416,1850,2266
00977702,KAPLAN COLLEGE - TEMPORARY FACILITY EXPA,IN,46268-4111,Proprietary  ,3,8,11,20,63,83
00977703,KAPLAN COLLEGE -  SE INDY               ,IN,46227-0000,Proprietary  ,28,179,207,163,743,906
00991700,IVY TECH COMMUNITY COLLEGE OF INDIANA - ,IN,46208-1763,Public       ,599,2813,3412,9174,21255,30429
00992300,IVY TECH COMMUNITY COLLEGE OF INDIANA - ,IN,47250-1881,Public       ,77,396,473,963,2654,3617
00992400,IVY TECH COMMUNITY COLLEGE OF INDIANA - ,IN,47302-9448,Public       ,178,1342,1520,3639,8998,12637
00992500,IVY TECH COMMUNITY COLLEGE OF INDIANA - ,IN,47710-3398,Public       ,128,699,827,2208,5477,7685
00992600,IVY TECH COMMUNITY COLLEGE OF INDIANA- R,IN,46805-1489,Public       ,289,1642,1931,4473,12101,16574
01003700,IVY TECH STATE COLLEGE - REGION 9       ,IN,47374-1220,Public       ,92,673,765,1110,4493,5603
01003800,IVY TECH COMMUNITY COLLEGE OF INDIANA - ,IN,47203-1868,Public       ,118,581,699,1728,4463,6191
01003900,IVY TECH COMMUNITY COLLEGE OF INDIANA - ,IN,47903-6299,Public       ,244,1046,1290,3305,6482,9787
01004000,IVY TECH COMMUNITY COLLEGE OF INDIANA - ,IN,46409-1303,Public       ,262,1339,1601,2781,8747,11528
01004100,IVY TECH STATE COLLEGE - REGION 5       ,IN,46903-1373,Public       ,147,909,1056,1659,6124,7783
01010900,IVY TECH COMMUNITY COLLEGE OF INDIANA - ,IN,47172-1897,Public       ,94,531,625,1426,3855,5281
01015100,VINCENNES BEAUTY COLLEGE                ,IN,47591-1297,Proprietary  ,3,7,10,28,51,79
01040900,LAFAYETTE BEAUTY ACADEMY                ,IN,47901-1149,Proprietary  ,7,17,24,43,113,156
01061800,MID-AMERICA CLG FUNERAL SERVICE         ,IN,47130-9990,Private      ,2,12,14,45,126,171
01150500,CREATIVE HAIR STYLING ACADEMY           ,IN,46322-1554,Proprietary  ,9,14,23,47,86,133
02084800,RAVENSCROFT BEAUTY COLLEGE              ,IN,46815-0000,Proprietary  ,13,37,50,78,215,293
02087600,CONCORDIA THEOLOGICAL SEMINARY          ,IN,46825-0000,Private      ,0,9,9,3,261,264
02100402,EVEREST INSTITUTE - EVEREST COLLEGE     ,IN,46410-5683,Proprietary  ,49,213,262,250,1164,1414
02140800,MARTIN UNIVERSITY                       ,IN,46218-0000,Private      ,23,153,176,207,1424,1631
02158400,HARRISON COLLEGE                        ,IN,46204-2611,Proprietary  ,41,422,463,702,3606,4308
02158401,HARRISON COLLEGE - COLUMBUS             ,IN,47203-1843,Proprietary  ,8,52,60,89,434,523
02158402,HARRISON COLLEGE - LAFAYETTE            ,IN,47905-4859,Proprietary  ,4,38,42,95,442,537
02158404,HARRISON COLLEGE - MARION               ,IN,46952-0000,Proprietary  ,1,6,7,32,115,147
02158405,HARRISON COLLEGE - TERRE HAUTE          ,IN,47802-0000,Proprietary  ,4,44,48,91,513,604
02158407,HARRISON COLLEGE - ANDERSON             ,IN,46013-0000,Proprietary  ,4,63,67,99,472,571
02158409,HARRISON COLLEGE - EVANSVILLE           ,IN,47715-3901,Proprietary  ,4,38,42,93,441,534
02158410,HARRISON COLLEGE - EAST                 ,IN,46239-8903,Proprietary  ,15,96,111,229,1031,1260
02158412,HARRISON COLLEGE - FORT WAYNE           ,IN,46825-0000,Proprietary  ,14,75,89,239,865,1104
02158413,HARRISON COLLEGE - NORTHWEST            ,IN,46278-0000,Proprietary  ,11,39,50,187,451,638
02158800,DON ROBERTS BEAUTY SCHOOLS              ,IN,46383-0000,Proprietary  ,1,5,6,28,39,67
02164300,DON ROBERTS SCHOOL OF HAIR DESIGN       ,IN,46375-9999,Proprietary  ,3,13,16,30,69,99
02201800,KAPLAN COLLEGE                          ,IN,46410-0000,Proprietary  ,7,79,86,164,775,939
02201802,KAPLAN COLLEGE - HAMMOND                ,IN,46324-3347,Proprietary  ,15,154,169,211,1102,1313
02241700,PJ'S COLLEGE OF COSMETOLOGY             ,IN,47129-0000,Proprietary  ,5,34,39,58,185,243
02245505,CENTRAL FLORIDA COLLEGE - FORTIS COLLEGE,IN,46268-0000,Proprietary  ,0,1,1,0,1,1
02302700,J EVERETT LIGHT CAREER CENTER           ,IN,46240-0000,Public       ,4,26,30,55,212,267
02304800,PJ'S COLLEGE OF COSMETOLOGY             ,IN,47374-0000,Proprietary  ,0,11,11,17,82,99
02308900,MASTER'S OF COSMETOLOGY COLLEGE         ,IN,46809-0000,Proprietary  ,8,21,29,78,95,173
02339600,ROGER'S ACADEMY OF HAIR DESIGN          ,IN,47712-0000,Proprietary  ,15,39,54,106,184,290
02345200,EMPIRE BEAUTY SCHOOL                    ,IN,46237-0000,Proprietary  ,10,69,79,99,389,488
02351300,KNOX BEAUTY COLLEGE                     ,IN,46534-0000,Proprietary  ,0,4,4,6,33,39
02490500,HAIR FASHIONS BY KAYE BEAUTY CLG        ,IN,46250-0000,Proprietary  ,1,9,10,31,113,144
02490800,HAIR FASHIONS BY KAYE BEAUTY CLG        ,IN,46060-0000,Proprietary  ,5,37,42,47,197,244
02607000,HAIR ARTS ACADEMY                       ,IN,47404-3581,Proprietary  ,3,19,22,18,69,87
02615800,COLLEGE OF COURT REPORTING              ,IN,46342-5969,Proprietary  ,2,36,38,28,372,400
02616203,BROWN MACKIE COLLEGE-FINDLAY - INDIANAPO,IN,46204-1017,Proprietary  ,43,308,351,307,1985,2292
03009700,HARRISON COLLEGE                        ,IN,47303-6413,Proprietary  ,6,37,43,85,412,497
03009701,HARRISON COLLEGE - MUNCIE - ELKHART     ,IN,46516-9795,Proprietary  ,12,59,71,96,531,627
03084601,THE ART INSTITUTE OF INDIANAPOLIS       ,IN,46268-1170,Proprietary  ,59,135,194,1177,1201,2378
03100600,MARION COMM TUCKER AREA VOC SCHOOL      ,IN,46952-3831,Public       ,2,13,15,49,127,176
03176300,AMERICAN TRANS AIR AVIATION ACADEMY     ,IN,46241-1445,Proprietary  ,15,65,80,69,355,424
03262300,DAVID DEMUTH INSTITUTE OF COSM          ,IN,47374-4101,Proprietary  ,1,8,9,15,54,69
03456700,CROSSROADS BIBLE COLLEGE                ,IN,46219-4912,Private      ,3,31,34,69,247,316
03521300,IVY TECH COMMUNITY COLLEGE OF INDIANA - ,IN,47404-9772,Public       ,141,630,771,3042,4967,8009
03538300,ALEXANDRIA SCH OF SCIENTIFIC THERAP     ,IN,46001-0287,Proprietary  ,0,0,0,30,66,96
04038700,IDEAL BEAUTY ACADEMY                    ,IN,47130-4215,Proprietary  ,6,20,26,28,82,110
04100300,SUCCESS SCHOOLS                         ,IN,46410-5310,Proprietary  ,9,26,35,33,144,177
04121000,TECHSKILLS - INDIANAPOLIS               ,IN,46240-4302,Proprietary  ,4,77,81,21,247,268
04130900,HONORS BEAUTY COLLEGE                   ,IN,46256-3317,Proprietary  ,11,32,43,72,195,267
04155900,AVEDA FREDRIC'S INSTITUTE               ,IN,46250-4746,Proprietary  ,9,9,18,9,9,18
00163203,AQUINAS INSTITUTE OF THEOLOGY - MINISTRY,KS,66109-3718,Private      ,0,0,0,0,2,2
00190100,ALLEN COUNTY COMMUNITY COLLEGE          ,KS,66749-1607,Public       ,51,191,242,937,1326,2263
00190200,COWLEY COUNTY COMMUNITY COLLEGE & AREA V,KS,67005-2662,Public       ,101,331,432,1357,2329,3686
00190300,BAKER UNIVERSITY                        ,KS,66006-0065,Private      ,29,374,403,1591,2625,4216
00190400,BETHANY COLLEGE                         ,KS,67456-1897,Private      ,8,5,13,762,120,882
00190500,BETHEL COLLEGE                          ,KS,67117-0531,Private      ,4,6,10,473,121,594
00190600,BUTLER COUNTY COMMUNITY COLLEGE         ,KS,67042-3280,Public       ,262,659,921,3600,4706,8306
00190700,CENTRAL BAPTIST THEOLOGY SEMINARY       ,KS,66226-3513,Private      ,0,3,3,0,32,32
00190800,CENTRAL CHRISTIAN COLLEGE OF KANSAS     ,KS,67460-5799,Private      ,8,7,15,462,67,529
00190900,CLOUD COUNTY COMMUNITY COLLEGE          ,KS,66901-1002,Public       ,41,143,184,778,983,1761
00191000,COFFEYVILLE COMMUNITY COLLEGE           ,KS,67337-5064,Public       ,64,101,165,1036,564,1600
00191100,COLBY COMMUNITY COLLEGE                 ,KS,67701-4099,Public       ,28,35,63,579,351,930
00191300,DODGE CITY COMMUNITY COLLEGE            ,KS,67801-2399,Public       ,27,55,82,613,538,1151
00191400,DONNELLY COLLEGE                        ,KS,66102-4298,Private      ,29,99,128,197,737,934
00191500,FORT HAYS STATE UNIVERSITY              ,KS,67601-4099,Public       ,71,386,457,3438,4018,7456
00191600,FORT SCOTT COMMUNITY COLLEGE            ,KS,66701-3199,Public       ,59,161,220,1147,958,2105
00191700,BARCLAY COLLEGE                         ,KS,67059-0288,Private      ,5,7,12,117,94,211
00191800,FRIENDS UNIVERSITY                      ,KS,67213-3397,Private      ,40,230,270,1205,2715,3920
00191900,GARDEN CITY COMMUNITY COLLEGE           ,KS,67846-6398,Public       ,56,72,128,858,589,1447
00192000,HESSTON COLLEGE                         ,KS,67062-2093,Private      ,5,13,18,443,165,608
00192100,HIGHLAND COMMUNITY COLLEGE              ,KS,66035-4062,Public       ,55,161,216,1128,1168,2296
00192114,HIGHLAND COMMUNITY COLLEGE - NOTHEAST KA,KS,66002-1513,Public       ,6,16,22,77,130,207
00192300,HUTCHINSON COMMUNITY COLLEGE            ,KS,67501-5894,Public       ,117,340,457,1926,2260,4186
00192400,INDEPENDENCE COMMUNITY COLLEGE          ,KS,67301-0000,Public       ,40,78,118,504,424,928
00192500,KANSAS CITY KANSAS COMMUNITY CLG        ,KS,66112-9978,Public       ,138,510,648,1680,3993,5673
00192502,"KANSAS CITY KS AREA TECH SCHOOL, KS     ",KS,66104-0000,Public       ,11,29,40,84,235,319
00192600,PITTSBURG STATE UNIVERSITY              ,KS,66762-7500,Public       ,105,209,314,4513,2619,7132
00192700,EMPORIA STATE UNIVERSITY                ,KS,66801-5087,Public       ,83,234,317,3168,2731,5899
00192800,KANSAS STATE UNIVERSITY                 ,KS,66506-1104,Public       ,312,357,669,14287,5883,20170
00192900,KANSAS WESLEYAN UNIVERSITY              ,KS,67401-6196,Private      ,16,32,48,900,423,1323
00193000,LABETTE COMMUNITY COLLEGE               ,KS,67357-4299,Public       ,44,125,169,589,847,1436
00193100,MANHATTAN CHRISTIAN COLLEGE             ,KS,66502-4081,Private      ,5,8,13,285,119,404
00193300,MCPHERSON COLLEGE                       ,KS,67460-3899,Private      ,9,15,24,642,169,811
00193600,NEOSHO COUNTY COMMUNITY COLLEGE         ,KS,66720-2699,Public       ,35,110,145,572,911,1483
00193700,OTTAWA UNIVERSITY                       ,KS,66067-3399,Private      ,31,411,442,958,2544,3502
00193800,PRATT COMMUNITY COLLEGE                 ,KS,67124-8432,Public       ,20,77,97,556,595,1151
00193900,NEWMAN UNIVERSITY                       ,KS,67213-2084,Private      ,25,104,129,1054,1401,2455
00194000,SOUTHWESTERN COLLEGE                    ,KS,67156-2499,Private      ,17,104,121,719,1194,1913
00194300,UNIVERSITY OF ST MARY                   ,KS,66048-5023,Private      ,13,69,82,577,667,1244
00194500,STERLING COLLEGE                        ,KS,67579-1533,Private      ,12,17,29,840,195,1035
00194600,TABOR COLLEGE                           ,KS,67063-1799,Private      ,10,31,41,665,221,886
00194800,UNIVERSITY OF KANSAS                    ,KS,66045-7535,Public       ,325,457,782,15674,9772,25446
00194900,WASHBURN UNIVERSITY                     ,KS,66621-1110,Public       ,104,359,463,3083,4452,7535
00195000,WICHITA STATE UNIVERSITY                ,KS,67208-0001,Public       ,214,601,815,6340,7582,13922
00460800,BARTON COUNTY COMMUNITY COLLEGE         ,KS,67530-9283,Public       ,35,220,255,774,1379,2153
00526400,FLINT HILLS TECHNICAL COLLEGE           ,KS,66801-5999,Public       ,8,50,58,229,364,593
00526500,NORTH CENTRAL KANSAS TECH COLG          ,KS,67420-0000,Public       ,7,24,31,370,297,667
00526700,NORTHWEST KANSAS TECHNICAL SCHOOL       ,KS,67735-3441,Public       ,4,9,13,213,112,325
00549800,WICHITA AREA TECHNICAL COLLEGE          ,KS,67211-2099,Public       ,73,348,421,451,2054,2505
00549900,SALINA AREA TECHNICAL COLLEGE           ,KS,67401-8195,Public       ,10,20,30,157,195,352
00550000,MANHATTAN AREA TECHNICAL COLLEGE        ,KS,66503-2499,Public       ,42,82,124,313,504,817
00675500,BROWN MACKIE COLLEGE (THE)              ,KS,67401-7307,Proprietary  ,59,259,318,337,1531,1868
00703200,MID AMERICA NAZARENE UNIVERSITY         ,KS,66062-1899,Private      ,19,152,171,982,1017,1999
00822800,SEWARD CO COMM CO/AREA TECHNICAL SCHOOL ,KS,67905-0000,Public       ,38,61,99,447,442,889
00824400,JOHNSON COUNTY COMMUNITY COLLEGE        ,KS,66210-1299,Public       ,426,1044,1470,5444,7143,12587
00833200,B-STREET DESIGN SCHOOL OF INTERNATIONAL ,KS,66502-6082,Proprietary  ,4,16,20,34,108,142
00868200,ACADEMY OF HAIR DESIGN                  ,KS,67401-2803,Proprietary  ,2,20,22,30,65,95
01025600,BENEDICTINE COLLEGE                     ,KS,66002-1499,Private      ,21,6,27,1891,128,2019
01043800,HASKELL INDIAN NATIONS UNIVERSITY       ,KS,66046-4800,Public       ,85,83,168,973,739,1712
01050300,WICHITA TECHNICAL INSTITUTE             ,KS,67213-1927,Proprietary  ,31,218,249,278,1861,2139
01050302,WICHITA TECHNICAL INSTITUTE - WTI TOPEKA,KS,66609-1217,Proprietary  ,13,70,83,34,203,237
01050305,WICHITA TECHNICAL INSTITUTE - EAST CAMPU,KS,67208-4243,Proprietary  ,4,52,56,21,180,201
01068900,KAW AREA TECHNICAL SCHOOL               ,KS,66604-2199,Public       ,27,66,93,215,489,704
02090700,CLEVELAND CHIROPRACTIC COLLEGE          ,KS,66210-1613,Private      ,4,57,61,46,595,641
02134800,OLD TOWN BARBER AND BEAUTY COLLEGE      ,KS,67211-0000,Proprietary  ,4,15,19,34,84,118
02196400,CAPITOL CITY HAIR DESIGN COLLEGE        ,KS,66102-0000,Proprietary  ,10,40,50,32,162,194
02257700,HAYS ACADEMY OF HAIR DESIGN             ,KS,67601-0000,Proprietary  ,7,7,14,46,66,112
02303500,AMERICAN INSTITUTE OF BAKING            ,KS,66502-0000,Private      ,0,4,4,5,13,18
02340700,LABARON HAIRDRESSING ACADEMY            ,KS,66204-0000,Proprietary  ,2,13,15,12,52,64
02590900,WRIGHT CAREER COLLEGE                   ,KS,66212-0000,Private      ,89,506,595,323,2197,2520
02599709,VATTEROTT COLLEGE - WICHITA             ,KS,67226-1304,Proprietary  ,16,117,133,89,603,692
02603100,XENON INTERNATIONAL ACADEMY             ,KS,67203-5428,Proprietary  ,14,33,47,133,233,366
02606300,PAUL MITCHELL THE SCHOOL WICHITA        ,KS,67226-2803,Proprietary  ,11,18,29,71,97,168
02611005,HERITAGE COLLEGE - WICHITA              ,KS,67210-1879,Proprietary  ,49,299,348,230,1239,1469
02613000,PINNACLE CAREER INSTITUTE               ,KS,66046-2703,Proprietary  ,8,69,77,60,308,368
03031300,XENON INTERNATIONAL ACADEMY IV          ,KS,66061-3765,Proprietary  ,13,11,24,48,84,132
03066200,BRYAN COLLEGE                           ,KS,66604-2496,Proprietary  ,7,38,45,43,261,304
03450300,B-STREET DESIGN SCHOOL OF INTERNATIONAL ,KS,66611-2373,Proprietary  ,13,31,44,55,130,185
03450301,B-STREET DESIGN SCHOOL OF INTERNATIONAL ,KS,67207-5148,Proprietary  ,5,19,24,35,107,142
03450302,B-STREET DESIGN SCHOOL OF INTERNATIONAL ,KS,66212-5451,Proprietary  ,10,32,42,57,146,203
03529300,SIDNEY'S HAIRDRESSING COLLEGE           ,KS,67501-7094,Proprietary  ,7,11,18,43,68,111
03862300,BMSI INSTITUTE                          ,KS,66212-3388,Proprietary  ,0,0,0,3,11,14
04132900,Z HAIR ACADEMY                          ,KS,66046-4040,Proprietary  ,1,2,3,29,57,86
00203300,UNIVERSITY OF MAINE-PRESQUE ISLE        ,ME,04769-2888,Public       ,13,59,72,742,517,1259
00203500,BANGOR THEOLOGICAL SEMINARY             ,ME,04402-0411,Private      ,0,4,4,2,86,88
00203600,BATES COLLEGE                           ,ME,04240-6028,Private      ,38,6,44,2744,59,2803
00203800,BOWDOIN COLLEGE                         ,ME,04011-8451,Private      ,41,3,44,3645,63,3708
00203900,COLBY COLLEGE                           ,ME,04901-8841,Private      ,25,7,32,2867,59,2926
00204000,UNIVERSITY OF MAINE-FARMINGTON          ,ME,04938-1990,Public       ,28,35,63,2530,459,2989
00204100,UNIVERSITY OF MAINE-FORT KENT           ,ME,04743-1292,Public       ,12,19,31,486,306,792
00204300,HUSSON UNIVERSITY                       ,ME,04401-2999,Private      ,31,80,111,2375,1182,3557
00204400,MAINE MARITIME ACADEMY                  ,ME,04420-0001,Public       ,13,5,18,976,138,1114
00205000,UNIVERSITY OF NEW ENGLAND               ,ME,04005-9599,Private      ,33,219,252,3856,2757,6613
00205100,SAINT JOSEPH'S COLLEGE                  ,ME,04084-5263,Private      ,14,76,90,1577,570,2147
00205200,THOMAS COLLEGE                          ,ME,04901-5097,Private      ,23,16,39,923,229,1152
00205300,UNIVERSITY OF MAINE                     ,ME,04469-0001,Public       ,128,166,294,10593,3118,13711
00205400,UNIVERSITY OF SOUTHERN MAINE            ,ME,04104-0000,Public       ,120,321,441,6408,5009,11417
00205500,UNIVERSITY OF MAINE-MACHIAS             ,ME,04654-1397,Public       ,3,14,17,513,306,819
00520400,BEAL COLLEGE                            ,ME,04401-6896,Proprietary  ,12,66,78,218,595,813
00527600,CENTRAL MAINE COMMUNITY COLLEGE         ,ME,04210-6498,Public       ,52,254,306,1444,1784,3228
00527700,EASTERN MAINE COMMUNITY COLLEGE         ,ME,04401-4280,Public       ,72,204,276,1488,1569,3057
00552500,SOUTHERN MAINE COMMUNITY  COLLEGE       ,ME,04106-1698,Public       ,205,472,677,3287,3135,6422
00576000,NORTHERN MAINE COMMUNITY COLLEGE        ,ME,04769-2016,Public       ,27,104,131,484,834,1318
00577600,MERCY HOSP SCH OF RADIOLOGIC TECH       ,ME,04101-3795,Private      ,1,5,6,21,43,64
00630501,CENTRAL MAINE MEDICAL CENTER - COLLEGE O,ME,04240-4500,Private      ,5,25,30,57,232,289
00676000,UNIVERSITY OF MAINE-AUGUSTA             ,ME,04330-9410,Public       ,76,535,611,1605,5198,6803
00685800,UNITY COLLEGE                           ,ME,04988-9502,Private      ,14,8,22,928,91,1019
00903800,MR BERNARD'S SCH HAIR FASHION INC       ,ME,04243-1163,Proprietary  ,7,29,36,49,173,222
00923100,WASHINGTON COUNTY COMMUNITY COLLEGE     ,ME,04619-9704,Public       ,12,35,47,275,355,630
00929200,ANDOVER COLLEGE                         ,ME,04106-2415,Proprietary  ,25,104,129,234,871,1105
00929201,ANDOVER COLLEGE -                       ,ME,04240-0000,Proprietary  ,16,113,129,195,988,1183
00945900,EMPIRE BEAUTY SCHOOL                    ,ME,04101-3348,Proprietary  ,27,65,92,178,371,549
00945902,PIERRE'S SCHOOL OF COSMETOLOGY - CARIBOU,ME,04736-2020,Proprietary  ,0,0,0,5,5,10
00945903,EMPIRE BEAUTY SCHOOL - BANGOR           ,ME,04401-6534,Proprietary  ,2,3,5,21,23,44
00982600,KENNEBEC VALLEY  COMMUNITY  COLLEGE     ,ME,04937-1367,Public       ,51,227,278,756,1693,2449
01138500,COLLEGE OF THE ATLANTIC                 ,ME,04609-1105,Private      ,13,7,20,427,70,497
01167300,MAINE COLLEGE OF ART                    ,ME,04101-3987,Private      ,11,9,20,538,223,761
02104400,SPA TECH INSTITUTE                      ,ME,04102-0000,Proprietary  ,26,123,149,175,508,683
02347100,NEW ENGLAND SCHOOL OF COMMUNICATIONS    ,ME,04401-0000,Private      ,22,5,27,597,107,704
02361300,LANDING SCHOOL OF BOATBUILDING & DESIGN ,ME,04046-1490,Private      ,0,1,1,25,57,82
03122900,YORK COUNTY COMMUNITY COLLEGE           ,ME,04090-0529,Public       ,47,130,177,518,754,1272
03429300,SEACOAST CAREER SCHOOLS                 ,ME,04073-0000,Proprietary  ,34,245,279,155,833,988
03612300,BIRTHWISE MIDWIFERY SCHOOL              ,ME,04009-1110,Proprietary  ,0,5,5,9,50,59
00209300,ST JOHN'S COLLEGE                       ,NM,87505-4599,Private      ,12,12,24,457,204,661
00264900,COLLEGE OF SANTA FE                     ,NM,87505-7634,Private      ,14,18,32,456,237,693
00265000,UNIVERSITY OF THE SOUTHWEST             ,NM,88240-9129,Private      ,5,37,42,324,419,743
00265100,EASTERN NEW MEXICO UNIV PORTALES        ,NM,88130-6000,Public       ,64,216,280,2549,2445,4994
00265101,EASTERN NEW MEXICO UNIV-ROSWELL CAM     ,NM,88202-0000,Public       ,84,210,294,1049,1598,2647
00265300,NEW MEXICO HIGHLANDS UNIVERSITY         ,NM,87701-4436,Public       ,37,152,189,1609,2190,3799
00265400,NEW MEXICO INST OF MINING & TECH        ,NM,87801-4796,Public       ,22,21,43,931,368,1299
00265500,NEW MEXICO JUNIOR COLLEGE               ,NM,88240-9123,Public       ,56,198,254,754,1072,1826
00265600,NEW MEXICO MILITARY INSTITUTE           ,NM,88201-5173,Public       ,14,3,17,334,32,366
00265700,NEW MEXICO STATE UNIVERSITY             ,NM,88003-8001,Public       ,344,571,915,10670,8929,19599
00265701,NEW MEXICO STATE UNIV-ALAMOGORDO        ,NM,88311-0000,Public       ,30,155,185,406,1157,1563
00265702,NEW MEXICO STATE UNIV.-DONA ANA CLG     ,NM,88003-0000,Public       ,135,402,537,2014,3295,5309
00265703,NEW MEXICO STATE UNIV-CARLSBAD          ,NM,88220-0000,Public       ,22,102,124,330,680,1010
00265704,NEW MEXICO STATE UNIV-GRANTS            ,NM,87020-0000,Public       ,17,60,77,195,479,674
00266000,SAN JUAN COLLEGE                        ,NM,87402-4699,Public       ,190,633,823,1673,3655,5328
00266300,THE UNIVERSITY OF NEW MEXICO            ,NM,87131-0001,Public       ,537,1159,1696,13592,15459,29051
00266301,UNIV OF NEW MEXICO - GALLUP BRANCH      ,NM,87301-5697,Public       ,29,65,94,480,728,1208
00266302,UNIV OF NEW MEXICO - VALENCIA BRANCH    ,NM,87031-0000,Public       ,24,39,63,349,454,803
00266303,UNIV OF NEW MEXICO - LOS ALAMOS         ,NM,87544-0000,Public       ,2,14,16,127,104,231
00266304,UNIVERSITY OF NEW MEXICO                ,NM,87571-6401,Public       ,5,17,22,151,286,437
00266400,WESTERN NEW MEXICO UNIVERSITY           ,NM,88061-5417,Public       ,43,204,247,1014,1957,2971
00369109,MIDDLEBURY COLLEGE - INSTITUTE OF AMERIC,NM,87505-0000,Private      ,0,0,0,4,2,6
00405701,NATIONAL AMERICAN UNIVERSITY            ,NM,87110-0000,Proprietary  ,7,53,60,28,333,361
00474200,CENTRAL NEW MEXICO COMMUNITY COLLEGE    ,NM,87106-4096,Public       ,686,2633,3319,6875,16226,23101
00474300,CLOVIS COMMUNITY COLLEGE                ,NM,88101-8381,Public       ,54,248,302,572,1657,2229
00996200,LUNA COMMUNITY COLLEGE                  ,NM,87701-0000,Public       ,26,65,91,416,581,997
01063200,DEWOLFF CLG HAIRSTYLING/COSMETOLOGY     ,NM,87112-4113,Proprietary  ,8,36,44,42,166,208
01300500,OLYMPIAN UNIVERSITY OF COSMETOLOGY      ,NM,88310-5051,Proprietary  ,62,186,248,400,1084,1484
02083900,NORTHERN NEW MEXICO COLLEGE             ,NM,87530-0000,Public       ,37,149,186,620,1034,1654
02146400,INSTITUTE OF AMERICAN INDIAN ARTS       ,NM,87508-0000,Public       ,18,28,46,175,252,427
02218808,BROOKLINE COLLEGE - ALBUQUERQUE         ,NM,87105-1649,Proprietary  ,24,134,158,100,455,555
02278100,SANTA FE COMMUNITY COLLEGE              ,NM,87507-0000,Public       ,65,332,397,791,1842,2633
02293203,ATI CAREER TRAINING CENTER - ALBUQUERQUE,NM,87109-2016,Proprietary  ,1,7,8,17,62,79
02357600,CROWNPOINT INSTITUTE OF TECHNOLOGY      ,NM,87313-0000,Public       ,32,105,137,281,644,925
02511000,SOUTHWESTERN INDIAN POLYTECH INST       ,NM,87184-0000,Public       ,38,76,114,316,444,760
02572003,COMPUTER CAREER CENTER - LAS CRUCES CAMP,NM,88011-8220,Proprietary  ,16,87,103,61,371,432
02622000,SOUTHWEST ACUPUNCTURE COLLEGE           ,NM,87505-0000,Proprietary  ,1,25,26,3,277,280
03076100,SOUTHWESTERN COLLEGE                    ,NM,87507-0000,Private      ,1,10,11,8,167,175
03206300,MESALANDS COMMUNITY COLLEGE             ,NM,88401-3352,Public       ,5,29,34,148,291,439
03430300,UNIVERSAL THERAPEUTIC MASSAGE INSTITUTE ,NM,87107-4403,Proprietary  ,4,26,30,26,107,133
03678300,PIMA MEDICAL INSTITUTE                  ,NM,87110-4127,Proprietary  ,5,14,19,48,126,174
03944300,MASSAGE THERAPY TRAINING INSTITUTE      ,NM,88007-0000,Proprietary  ,5,12,17,22,54,76
00223400,ADRIAN COLLEGE                          ,MI,49221-2575,Private      ,31,43,74,2717,296,3013
00223500,ALBION COLLEGE                          ,MI,49224-1831,Private      ,20,12,32,2265,109,2374
00223600,ALMA COLLEGE                            ,MI,48801-1599,Private      ,21,10,31,2137,126,2263
00223700,ALPENA COMMUNITY COLLEGE                ,MI,49707-1495,Public       ,70,200,270,1089,1341,2430
00223800,ANDREWS UNIVERSITY                      ,MI,49104-0750,Private      ,48,73,121,1744,1314,3058
00223900,AQUINAS COLLEGE                         ,MI,49506-1799,Private      ,38,63,101,2411,776,3187
00224000,BAY DE NOC COMMUNITY COLLEGE            ,MI,49829-2524,Public       ,73,276,349,1356,1765,3121
00224100,CALVIN COLLEGE                          ,MI,49546-4388,Private      ,37,39,76,4232,401,4633
00224200,CALVIN THEOLOGICAL SEMINARY             ,MI,49546-4387,Private      ,2,5,7,14,150,164
00224300,CENTRAL MICHIGAN UNIVERSITY             ,MI,48859-0001,Public       ,361,894,1255,21257,10469,31726
00224600,CLEARY UNIVERSITY                       ,MI,48105-2659,Private      ,9,75,84,178,844,1022
00224700,CONCORDIA UNIVERSITY-ANN ARBOR          ,MI,48105-2797,Private      ,8,58,66,546,403,949
00224800,CRANBROOK ACADEMY OF ART                ,MI,48303-0000,Private      ,0,10,10,17,331,348
00224900,DAVENPORT UNIVERSITY                    ,MI,49503-0000,Private      ,162,1546,1708,3558,14843,18401
00225100,DELTA COLLEGE                           ,MI,48710-0001,Public       ,504,1404,1908,6412,9102,15514
00225400,MICHIGAN STATE UNIVERSITY COLLEGE OF LAW,MI,48824-1300,Private      ,18,32,50,351,1914,2265
00225900,EASTERN MICHIGAN UNIVERSITY             ,MI,48197-2214,Public       ,494,1243,1737,15278,13647,28925
00226000,FERRIS STATE UNIVERSITY                 ,MI,49307-2251,Public       ,212,542,754,12512,6987,19499
00226100,CHARLES STEWART MOTT COMMUNITY CLG      ,MI,48503-2089,Public       ,575,1946,2521,6079,12644,18723
00226200,KETTERING UNIVERSITY                    ,MI,48504-4898,Private      ,35,52,87,2517,466,2983
00226300,GLEN OAKS COMMUNITY COLLEGE             ,MI,49032-9784,Public       ,30,187,217,609,1301,1910
00226400,GOGEBIC COMMUNITY COLLEGE               ,MI,49938-1365,Public       ,26,88,114,657,696,1353
00226500,GRACE BIBLE COLLEGE                     ,MI,49509-1998,Private      ,4,6,10,243,75,318
00226600,CORNERSTONE UNIVERSITY                  ,MI,49525-5897,Private      ,31,268,299,1571,1981,3552
00226700,GRAND RAPIDS COMMUNITY COLLEGE          ,MI,49503-3295,Public       ,850,2173,3023,10789,13110,23899
00226800,GRAND VALLEY STATE UNIVERSITY           ,MI,49401-9403,Public       ,296,584,880,21453,8185,29638
00226900,GREAT LAKES CHRISTIAN COLLEGE           ,MI,48917-1299,Private      ,4,13,17,193,158,351
00227000,HENRY FORD COMMUNITY COLLEGE            ,MI,48128-1495,Public       ,956,2303,3259,9929,16682,26611
00227300,HOPE COLLEGE                            ,MI,49423-3607,Private      ,30,16,46,3969,185,4154
00227400,JACKSON COMMUNITY COLLEGE               ,MI,49201-8399,Public       ,256,1188,1444,3966,7442,11408
00227500,KALAMAZOO COLLEGE                       ,MI,49006-3295,Private      ,10,25,35,1844,158,2002
00227600,KELLOGG COMMUNITY COLLEGE               ,MI,49017-3397,Public       ,179,849,1028,2582,5925,8507
00227700,LAKE MICHIGAN COLLEGE                   ,MI,49022-1899,Public       ,136,641,777,1925,3775,5700
00227800,LANSING COMMUNITY COLLEGE               ,MI,48933-1293,Public       ,718,2728,3446,9087,15369,24456
00227900,LAWRENCE TECHNOLOGICAL UNIVERSITY       ,MI,48075-1058,Private      ,58,227,285,1880,2098,3978
00228200,MADONNA UNIVERSITY                      ,MI,48150-1173,Private      ,50,317,367,1535,3365,4900
00228400,MARYGROVE COLLEGE                       ,MI,48221-2599,Private      ,38,398,436,751,3280,4031
00228800,ROCHESTER COLLEGE                       ,MI,48307-2764,Private      ,19,91,110,603,713,1316
00228801,ROCHESTER COLLEGE - MACOMB COMMUNITY COL,MI,48038-1139,Private      ,66,181,247,640,968,1608
00228802,ROCHESTER COLLEGE - MOTT COMMUNITY COLLE,MI,48503-2089,Private      ,18,76,94,232,416,648
00228803,ROCHESTER COLLEGE  - SPECS HOWARD       ,MI,48075-3953,Private      ,2,13,15,29,61,90
00229000,MICHIGAN STATE UNIVERSITY               ,MI,48824-1113,Public       ,523,635,1158,34784,12879,47663
00229200,MICHIGAN TECHNOLOGICAL UNIV             ,MI,49931-1295,Public       ,48,65,113,6015,1071,7086
00229300,LAKE SUPERIOR STATE UNIVERSITY          ,MI,49783-1691,Public       ,42,86,128,2381,971,3352
00229400,MONROE COUNTY COMMUNITY CLG             ,MI,48161-9746,Public       ,191,395,586,1730,2654,4384
00229500,MONTCALM COMMUNITY COLLEGE              ,MI,48885-9723,Public       ,65,305,370,1019,2124,3143
00229700,MUSKEGON COMMUNITY COLLEGE              ,MI,49442-1432,Public       ,249,656,905,3151,4679,7830
00229900,NORTH CENTRAL MICHIGAN COLLEGE          ,MI,49770-8740,Public       ,77,276,353,1037,2148,3185
00230100,NORTHERN MICHIGAN UNIVERSITY            ,MI,49855-5316,Public       ,167,265,432,7709,3061,10770
00230200,NORTHWESTERN MICHIGAN COLLEGE           ,MI,49686-3061,Public       ,139,519,658,2565,3500,6065
00230300,OAKLAND COMMUNITY COLLEGE               ,MI,48304-2266,Public       ,0,0,0,75,63,138
00230301,OAKLAND COMMUNITY COLLEGE - ORCHARD RIDG,MI,48334-4579,Public       ,209,571,780,2413,3795,6208
00230302,OAKLAND COMMUNITY COLLEGE - ROYAL OAK CA,MI,48067-3898,Public       ,301,792,1093,2844,5422,8266
00230303,OAKLAND COMMUNITY COLLEGE - SOUTHFIELD C,MI,48075-4793,Public       ,211,772,983,2151,5146,7297
00230304,OAKLAND COMMUNITY COLLEGE - AUBURN HILLS,MI,48323-2845,Public       ,342,1044,1386,3469,6235,9704
00230305,OAKLAND COMMUNITY COLLEGE - HIGHLAND LAK,MI,48327-4187,Public       ,186,424,610,1790,3195,4985
00230700,OAKLAND UNIVERSITY                      ,MI,48309-4401,Public       ,398,1026,1424,13085,9844,22929
00230800,OLIVET COLLEGE                          ,MI,49076-9902,Private      ,15,19,34,1506,375,1881
00231000,ST. CLAIR COUNTY COMMUNITY COLLEGE      ,MI,48061-0000,Public       ,210,661,871,2296,4244,6540
00231100,KUYPER COLLEGE                          ,MI,49525-9749,Private      ,3,13,16,360,151,511
00231300,SACRED HEART MAJOR SEMINARY             ,MI,48206-1799,Private      ,1,10,11,37,165,202
00231400,SAGINAW VALLEY STATE UNIV               ,MI,48710-0001,Public       ,162,386,548,8952,4268,13220
00231500,SCHOOLCRAFT COLLEGE                     ,MI,48152-2696,Public       ,474,1252,1726,5847,9045,14892
00231600,SIENA HEIGHTS UNIVERSITY                ,MI,49221-1796,Private      ,27,181,208,1140,1872,3012
00231700,SOUTHWESTERN MICHIGAN COLLEGE           ,MI,49047-9793,Public       ,102,378,480,1537,2479,4016
00231800,SPRING ARBOR UNIVERSITY                 ,MI,49283-9984,Private      ,37,313,350,2223,3577,5800
00232200,FINLANDIA UNIVERSITY                    ,MI,49930-1882,Private      ,16,28,44,556,320,876
00232300,UNIVERSITY OF DETROIT MERCY             ,MI,48221-3038,Private      ,94,325,419,3122,4093,7215
00232303,UNIV OF DETROIT MERCY - LAW SCHOOL      ,MI,48226-0000,Private      ,2,25,27,20,960,980
00232330,UNIV OF DETROIT MERCY - DENTAL SCHOOL   ,MI,48208-2576,Private      ,2,9,11,53,418,471
00232500,UNIVERSITY OF MICHIGAN - ANN ARBOR      ,MI,48109-1316,Public       ,337,519,856,26607,12161,38768
00232501,UNIVERSITY OF MICHIGAN-MEDICAL SCH      ,MI,48109-0000,Public       ,13,16,29,160,1149,1309
00232503,UNIVERSITY OF MICHIGAN LAW SCHOOL       ,MI,48109-0000,Public       ,2,23,25,46,2829,2875
00232600,UNIVERSITY OF MICHIGAN-DEARBORN         ,MI,48128-2406,Public       ,187,490,677,5201,5240,10441
00232700,UNIVERSITY OF MICHIGAN-FLINT            ,MI,48502-1950,Public       ,144,528,672,4449,6045,10494
00232800,WASHTENAW COMMUNITY COLLEGE             ,MI,48106-0000,Public       ,577,1430,2007,5183,9005,14188
00232900,WAYNE STATE UNIVERSITY                  ,MI,48202-0000,Public       ,641,1978,2619,17364,22454,39818
00232901,WAYNE STATE UNIV SCH OF MEDICINE        ,MI,48201-3359,Public       ,17,50,67,273,1712,1985
00232902,WAYNE STATE UNIVERSITY - LAW SCHOOL     ,MI,48202-3424,Public       ,16,60,76,167,1420,1587
00233000,WESTERN MICHIGAN UNIVERSITY             ,MI,49008-3899,Public       ,415,621,1036,18812,9432,28244
00233100,WESTERN THEOLOGICAL SEMINARY            ,MI,49423-0000,Private      ,0,6,6,0,141,141
00407100,WALSH COLLEGE OF ACCT & BUS ADMN        ,MI,48007-7006,Private      ,22,331,353,299,2820,3119
00407200,NORTHWOOD UNIVERSITY                    ,MI,48640-2398,Private      ,49,157,206,2303,1958,4261
00467300,BAKER COLLEGE - FLINT                   ,MI,48507-5508,Private      ,194,1029,1223,2714,9194,11908
00467301,BAKER COLLEGE OF CADILLAC               ,MI,49601-0000,Private      ,44,273,317,579,2283,2862
00467302,BAKER COLLEGE OF CLINTON TOWNSHIP       ,MI,48035-0000,Private      ,165,808,973,2413,7167,9580
00467303,BAKER COLLEGE OF MUSKEGON               ,MI,49442-0000,Private      ,183,690,873,3130,6228,9358
00467304,BAKER COLLEGE OF OWOSSO                 ,MI,48867-0000,Private      ,105,266,371,1937,2945,4882
00467305,BAKER COLLEGE OF AUBURN HILLS           ,MI,48326-0000,Private      ,129,529,658,1344,4966,6310
00467306,BAKER COLLEGE OF PORT HURON             ,MI,48060-0000,Private      ,39,242,281,683,2235,2918
00467309,BAKER COLLEGE OF JACKSON                ,MI,49202-0000,Private      ,59,382,441,810,3115,3925
00467311,BAKER COLLEGE-CASS CITY                 ,MI,48726-0000,Private      ,13,72,85,257,635,892
00467313,BAKER COLLEGE - GRADUATE ON-LINE        ,MI,48507-0000,Private      ,29,606,635,363,5989,6352
00467317,BAKER COLLEGE-ALLEN PARK                ,MI,48101-0000,Private      ,106,436,542,1151,4070,5221
00469200,DORSEY SCHOOL OF BUSINESS               ,MI,48195-2334,Proprietary  ,30,174,204,100,611,711
00469201,DORSEY SCHOOL OF BUSINESS               ,MI,48184-0000,Proprietary  ,20,133,153,74,468,542
00469202,DORSEY SCHOOL OF BUSINESS               ,MI,48071-0000,Proprietary  ,17,131,148,63,498,561
00469204,DORSEY SCHOOL OF BUSINESS               ,MI,48066-0000,Proprietary  ,41,167,208,172,820,992
00469205,DORSEY BUSINESS SCHOOL - FARMINGTON HILL,MI,48334-3385,Proprietary  ,7,51,58,31,221,252
00469206,DORSEY BUSINESS SCHOOL - ROSEVILLE CULIN,MI,48066-4555,Proprietary  ,15,97,112,92,470,562
00469207,DORSEY BUSINESS SCHOOL - WATERFORD/PONTI,MI,48341-1037,Proprietary  ,21,142,163,21,142,163
00491003,KAPLAN CAREER INSTITUTE - DEARBORN      ,MI,48228-0000,Proprietary  ,33,150,183,135,752,887
00676800,MID MICHIGAN COMMUNITY COLLEGE          ,MI,48625-9447,Public       ,229,556,785,2691,3728,6419
00677100,COLLEGE FOR CREATIVE STUDIES            ,MI,48202-4034,Private      ,50,69,119,1552,640,2192
00694900,KALAMAZOO VALLEY COMMUNITY COLLEGE      ,MI,49003-4070,Public       ,492,1504,1996,5803,8277,14080
00717100,KIRTLAND COMMUNITY COLLEGE              ,MI,48653-0000,Public       ,80,305,385,1006,2113,3119
00761700,CARNEGIE INSTITUTE                      ,MI,48083-1159,Proprietary  ,8,95,103,78,626,704
00795000,WEST SHORE COMMUNITY COLLEGE            ,MI,49454-0000,Public       ,67,164,231,687,1044,1731
00817800,EMPIRE BEAUTY SCHOOL                    ,MI,49525-2440,Proprietary  ,24,89,113,256,637,893
00817801,EMPIRE BEAUTY SCHOOL - KALAMAZOO CAMPUS ,MI,49024-2694,Proprietary  ,0,9,9,21,47,68
00890600,MACOMB COMMUNITY COLLEGE                ,MI,48088-3896,Public       ,1062,2850,3912,10433,16407,26840
00894600,PORT HURON COSMETOLOGY COLLEGE          ,MI,48329-1618,Proprietary  ,4,12,16,33,66,99
00923000,WAYNE COUNTY COMMUNITY CLG-DISTRICT     ,MI,48226-3095,Public       ,1269,4836,6105,10236,30303,40539
00973200,VIRGINIA FARRELL BEAUTY SCHOOL          ,MI,48080-1448,Proprietary  ,4,10,14,32,73,105
00973400,VIRGINIA FARRELL BEAUTY SCHOOL          ,MI,48220-1739,Proprietary  ,10,41,51,72,192,264
00982800,EVEREST INSTITUTE                       ,MI,48033-4400,Proprietary  ,90,384,474,449,1975,2424
00982801,EVEREST INSTITUTE- DEARBORN             ,MI,48124-1927,Proprietary  ,84,331,415,438,1642,2080
00982803,EVEREST INSTITUTE - DETROIT             ,MI,48207-4291,Proprietary  ,72,237,309,323,1131,1454
01047000,KALAMAZOO BEAUTY ACADEMY                ,MI,49002-5220,Proprietary  ,7,12,19,36,66,102
01062700,ITT TECHNICAL INSTITUTE                 ,MI,49519-0000,Proprietary  ,217,725,942,1283,3435,4718
01082700,DAVID PRESSLEY PROF SCH OF COSMTLGY     ,MI,48067-3219,Proprietary  ,16,31,47,105,143,248
01109800,FLINT INSTITUTE OF BARBERING            ,MI,48504-4395,Proprietary  ,2,21,23,27,120,147
01164600,VIRGINIA FARRELL BEAUTY SCHOOL          ,MI,48185-3091,Proprietary  ,5,22,27,41,151,192
01229100,WRIGHT BEAUTY ACADEMY                   ,MI,49015-2696,Proprietary  ,4,18,22,34,112,146
01262700,THOMAS M. COOLEY LAW SCHOOL             ,MI,48901-1586,Private      ,3,363,366,18,5108,5126
01321800,M J MURPHY BTY CLG MT PLEASANT          ,MI,48858-2502,Proprietary  ,7,16,23,57,92,149
02060300,MICHIGAN INSTITUTE OF AERONAUTICS       ,MI,48111-0000,Proprietary  ,50,149,199,528,1073,1601
02068700,ADRIAN BEAUTY ACADEMY                   ,MI,49221-0000,Proprietary  ,5,4,9,27,44,71
02099700,ROSS MEDICAL EDUCATION CENTER           ,MI,48532-0000,Proprietary  ,64,301,365,234,1543,1777
02099701,ROSS MEDICAL EDUCATION CENTER-SAGINAW   ,MI,48603-5227,Proprietary  ,2,16,18,27,128,155
02099702,ROSS MEDICAL EDUCATION CENTER-PORT HURON,MI,48060-1958,Proprietary  ,0,8,8,8,86,94
02099703,ROSS MEDICAL EDUCATION CENTER-ROOSEVELT ,MI,49441-4156,Proprietary  ,1,4,5,9,28,37
02100400,EVEREST INSTITUTE                       ,MI,49525-2301,Proprietary  ,47,270,317,255,1335,1590
02100401,EVEREST INSTITUTE - KALAMAZOO           ,MI,49009-3307,Proprietary  ,47,250,297,170,971,1141
02125600,MICHIGAN COLLEGE OF BEAUTY              ,MI,48083-0000,Proprietary  ,32,72,104,159,364,523
02152103,ACADEMY OF COURT REPORTING & TECHNOLOGY ,MI,48017-1495,Proprietary  ,7,38,45,50,408,458
02158600,MR BELA'S SCHOOL OF COSMETOLOGY         ,MI,48092-4637,Proprietary  ,7,29,36,32,90,122
02160303,INTERNATIONAL ACADEMY OF DESIGN AND TECH,MI,48083-2160,Proprietary  ,50,117,167,733,966,1699
02180100,ROSS MEDICAL EDUCATION CENTER           ,MI,48092-0000,Proprietary  ,27,146,173,131,680,811
02180105,ROSS MEDICAL EDUCATION CENTER-REDFORD   ,MI,48239-1260,Proprietary  ,1,19,20,7,97,104
02198900,MICHIGAN SCHOOL OF PROFESSIONAL PSYCHOLO,MI,48334-4512,Private      ,1,3,4,8,154,162
02209200,TAYLORTOWN SCHOOL OF BEAUTY             ,MI,48180-0000,Proprietary  ,0,9,9,25,78,103
02237800,SPECS HOWARD SCHOOL OF MEDIA ARTS       ,MI,48075-0000,Proprietary  ,69,156,225,545,834,1379
02285700,BAYSHIRE BEAUTY ACADEMY                 ,MI,48708-5614,Proprietary  ,4,18,22,36,120,156
02289801,KAPLAN INSTITUTE - DETROIT CAMPUS       ,MI,48202-0000,Proprietary  ,52,242,294,305,1315,1620
02324500,MICHIGAN COLLEGE OF BEAUTY              ,MI,48161-0000,Proprietary  ,11,37,48,67,144,211
02339700,ROSS MEDICAL EDUCATION CENTER           ,MI,48116-0000,Proprietary  ,44,297,341,171,1105,1276
02339701,ROSS MEDICAL EDUCATION CENTER-ANN ARBOR ,MI,48108-1411,Proprietary  ,2,18,20,22,85,107
02339703,ROSS MEDICAL EDUCATION CENTER - DAVISON ,MI,48423-1751,Proprietary  ,0,4,4,0,4,4
02361500,MICHIGAN BARBER COLLEGE                 ,MI,48204-2244,Private      ,17,66,83,118,372,490
02363800,YESHIVA GEDOLAH OF GREATER DETROIT      ,MI,48237-0000,Private      ,14,0,14,38,4,42
02491000,WEST MI COLG OF BARBERING & BEAUTY      ,MI,49008-0000,Proprietary  ,7,33,40,33,137,170
02498300,VIRGINIA FARRELL BEAUTY SCHOOL          ,MI,48154-0000,Proprietary  ,11,23,34,54,136,190
02533600,ROSS MEDICAL EDUCATION CENTER           ,MI,48917-2108,Proprietary  ,34,194,228,149,834,983
02533601,ROSS MEDICAL EDUCATION CENTER - GRAND RA,MI,49546-2430,Proprietary  ,2,40,42,29,187,216
02588200,DOUGLAS J AVEDA INSTITUTE               ,MI,48823-4351,Proprietary  ,56,105,161,519,618,1137
02588201,DOUGLAS J AVEDA INSTITUTE - ANN ARBOR   ,MI,48104-2211,Proprietary  ,13,12,25,83,96,179
02595700,HILLSDALE BEAUTY COLLEGE                ,MI,49242-0000,Proprietary  ,2,4,6,45,24,69
02618400,MICHIGAN CAREER & TECHNICAL INST        ,MI,49080-9254,Public       ,30,20,50,197,115,312
03005700,DETROIT BUSINESS INST. DOWNRIVER        ,MI,48193-6761,Proprietary  ,30,69,99,78,221,299
03028500,LAWTON SCHOOL                           ,MI,48075-5406,Proprietary  ,14,57,71,60,253,313
03066600,BAY MILLS COMMUNITY COLLEGE             ,MI,49715-9750,Public       ,12,58,70,162,443,605
03075200,TWIN CITY BEAUTY COLLEGE                ,MI,49085-3305,Proprietary  ,16,47,63,58,172,230
03075201,TWIN CITY BEAUTY COLLEGE - TRAVERSE CITY,MI,49686-5119,Proprietary  ,1,3,4,14,30,44
03090000,SHARP'S ACADEMY OF HAIRSTYLING INC.     ,MI,48433-0000,Proprietary  ,1,13,14,18,59,77
03109700,HOUGHTON LAKE INST OF COSMETOLOGY       ,MI,48629-0669,Proprietary  ,1,6,7,11,18,29
03110300,THE SCHOOL OF CREATIVE HAIR DESIGN      ,MI,49036-1139,Proprietary  ,6,13,19,21,50,71
03124000,NORTHWESTERN TECHNOLOGICAL INST         ,MI,48075-2412,Proprietary  ,21,145,166,95,535,630
03135300,MICHIGAN THEOLOGICAL SEMINARY           ,MI,48170-4399,Private      ,0,13,13,4,126,130
03284300,MICHIGAN JEWISH INSTITUTE               ,MI,48237-0000,Private      ,394,104,498,985,249,1234
03490300,PAUL MITCHELL THE SCHOOL ESCANABA       ,MI,49829-0000,Proprietary  ,34,47,81,128,156,284
03588300,IRENE'S MYOMASSOLOGY INSTITUTE          ,MI,48033-2404,Proprietary  ,11,104,115,75,439,514
03704300,BLUE WATER COLLEGE OF COSMETOLOGY       ,MI,48040-0000,Proprietary  ,6,13,19,26,55,81
03772300,SAGINAW CHIPPEWA TRIBAL COLLEGE         ,MI,48858-0000,Public       ,0,5,5,8,48,56
03815300,IN SESSION-ARTS OF COSMETOLOGY BEAU     ,MI,48609-0000,Proprietary  ,5,18,23,36,111,147
03907300,PAUL MITCHELL THE SCHOOL GREAT LAKES    ,MI,48060-0000,Proprietary  ,14,21,35,82,114,196
03915300,CAREER QUEST LEARNING CENTER            ,MI,48910-4732,Proprietary  ,12,131,143,81,740,821
03968300,LAKEWOOD SCHOOL OF THERAPEUTIC MASSAGE  ,MI,48060-0000,Proprietary  ,1,11,12,5,52,57
03976500,ANN ARBOR INSTITUTE OF MASSAGE THERAPY  ,MI,48103-0000,Proprietary  ,1,19,20,22,83,105
04002400,ECUMENICAL THEOLOGICAL SEMINARY         ,MI,48201-3035,Private      ,0,7,7,1,98,99
04006300,NUVO COLLEGE OF COSMETOLOGY             ,MI,49441-3822,Proprietary  ,2,17,19,24,103,127
04014300,P&A SCHOLARS BEAUTY SCHOOL              ,MI,48204-0000,Proprietary  ,18,45,63,114,235,349
04094300,ROBERT B. MILLER COLLEGE (THE)          ,MI,49017-3306,Private      ,2,30,32,58,342,400
04121100,GALLERY COLLEGE OF BEAUTY (THE)         ,MI,48036-3591,Proprietary  ,15,40,55,85,243,328
04136300,FOCUS:  HOPE INFORMATION TECHNOLOGIES CE,MI,48238-2949,Private      ,6,43,49,54,240,294
04138400,SCHOOL OF DESIGNING ARTS                ,MI,49037-7995,Proprietary  ,5,15,20,31,58,89
04139600,REGAL BEAUTY SCHOOL                     ,MI,48150-4013,Proprietary  ,3,7,10,15,65,80
04140900,INTERNATIONAL COSMETOLOGY ACADEMY       ,MI,49508-1308,Proprietary  ,4,25,29,31,151,182
04141100,FRENCH ACADEMY OF COSMETOLOGY           ,MI,49456-3207,Proprietary  ,4,10,14,34,57,91
04158400,L'ESPRIT ACADEMY                        ,MI,48150-0000,Proprietary  ,19,5,24,19,5,24
00233200,ANOKA-RAMSEY CC-CAMBRIDGE/COONRAPID     ,MN,55433-3499,Public       ,313,691,1004,3398,4273,7671
00233400,AUGSBURG COLLEGE                        ,MN,55454-1351,Private      ,42,203,245,2650,2194,4844
00233500,RIVERLAND COMMUNITY COLLEGE             ,MN,55912-1473,Public       ,84,283,367,1092,1937,3029
00233600,BEMIDJI STATE UNIVERSITY                ,MN,56601-2699,Public       ,74,195,269,3206,1899,5105
00233700,BETHANY LUTHERAN COLLEGE INC            ,MN,56001-6163,Private      ,13,4,17,716,51,767
00233900,CENTRAL LAKES COLG-BRAINERD/STAPLES     ,MN,56401-3900,Public       ,106,343,449,1505,2135,3640
00234000,CARLETON COLLEGE                        ,MN,55057-4001,Private      ,19,1,20,3004,43,3047
00234100,COLLEGE OF ST BENEDICT                  ,MN,56374-2099,Private      ,24,3,27,2018,48,2066
00234200,ST. CATHERINE UNIVERSITY                ,MN,55105-1789,Private      ,48,218,266,2314,3236,5550
00234300,COLLEGE OF ST SCHOLASTICA               ,MN,55811-4199,Private      ,31,174,205,2382,1684,4066
00234500,UNIVERSITY OF ST THOMAS                 ,MN,55105-1096,Private      ,89,280,369,6224,3950,10174
00234600,CONCORDIA COLLEGE-MOORHEAD              ,MN,56562-0001,Private      ,41,11,52,3245,161,3406
00234700,"CONCORDIA UNIVERSITY, ST PAUL, MN       ",MN,55104-5494,Private      ,27,262,289,1323,1829,3152
00235000,VERMILION COMMUNITY COLLEGE             ,MN,55731-1996,Public       ,10,17,27,479,170,649
00235300,GUSTAVUS ADOLPHUS COLLEGE               ,MN,56082-1498,Private      ,22,2,24,3042,52,3094
00235400,HAMLINE UNIVERSITY                      ,MN,55104-1284,Private      ,23,208,231,2472,3328,5800
00235500,HIBBING COMMUNITY COLLEGE               ,MN,55746-3300,Public       ,41,110,151,694,1076,1770
00235600,ITASCA COMMUNITY COLLEGE                ,MN,55744-3397,Public       ,41,69,110,746,634,1380
00235700,LUTHER SEMINARY                         ,MN,55108-0000,Private      ,0,18,18,2,442,444
00235800,MACALESTER COLLEGE                      ,MN,55105-1899,Private      ,24,10,34,3271,88,3359
00236000,"MINNESOTA STATE UNIVERSITY, MANKATO     ",MN,56002-0000,Public       ,197,311,508,10756,4118,14874
00236100,MARTIN LUTHER COLLEGE                   ,MN,56073-3965,Private      ,6,6,12,659,50,709
00236200,MINNEAPOLIS COMM AND TECH COLLEGE       ,MN,55403-1779,Public       ,545,1745,2290,4499,9985,14484
00236500,MINNEAPOLIS COLLEGE OF ART & DESIGN     ,MN,55404-4343,Private      ,34,43,77,929,377,1306
00236600,CROSSROADS COLLEGE                      ,MN,55902-2382,Private      ,6,7,13,116,86,202
00236700,MINNESOTA STATE UNIVERSITY MOORHEAD     ,MN,56563-0001,Public       ,107,216,323,5118,2292,7410
00236900,NORTH CENTRAL UNIVERSITY                ,MN,55404-1391,Private      ,35,38,73,1183,360,1543
00237000,NORTH HENNEPIN COMMUNITY COLLEGE        ,MN,55445-2299,Public       ,276,703,979,2823,4720,7543
00237100,NORTHWESTERN COLLEGE                    ,MN,55113-1598,Private      ,30,112,142,2317,821,3138
00237300,ROCHESTER COMMUNITY/TECH COLLEGE        ,MN,55904-4999,Public       ,193,481,674,2920,3321,6241
00237500,SOUTHWEST MINNESOTA STATE UNIVERSITY    ,MN,56258-1598,Public       ,30,87,117,1995,1061,3056
00237700,ST CLOUD STATE UNIVERSITY               ,MN,56301-4498,Public       ,287,456,743,10224,4972,15196
00237900,SAINT JOHNS UNIVERSITY                  ,MN,56321-0000,Private      ,24,8,32,1843,90,1933
00238000,SAINT MARY'S UNIVERSITY                 ,MN,55987-1399,Private      ,17,421,438,1552,2988,4540
00238200,ST OLAF COLLEGE                         ,MN,55057-1098,Private      ,27,3,30,3822,58,3880
00238300,CROWN COLLEGE                           ,MN,55375-9001,Private      ,13,69,82,752,648,1400
00238500,NORTHLAND COMMUNITY & TECHNICAL CLG     ,MN,56701-2598,Public       ,100,261,361,1599,2146,3745
00238600,UNITED THEOLGCL SEMINRY TWIN CITIES     ,MN,55112-0000,Private      ,0,5,5,1,110,111
00238800,"UNIVERSITY OF MINNESOTA, DULUTH         ",MN,55812-2496,Public       ,198,129,327,9581,2050,11631
00238900,"UNIVERSITY OF MINNESOTA, MORRIS         ",MN,56267-2113,Public       ,24,13,37,1770,248,2018
00239100,WILLIAM MITCHELL COLLEGE OF LAW         ,MN,55105-0000,Private      ,0,12,12,0,1279,1279
00239300,MINNESOTA STATE COLLEGE-SE TECH         ,MN,55987-0409,Public       ,64,219,283,853,1613,2466
00239400,WINONA STATE UNIVERSITY                 ,MN,55987-5838,Public       ,103,115,218,6979,1435,8414
00396900,UNIVERSITY OF MINNESOTA-TWIN CITIES     ,MN,55455-0422,Public       ,625,1054,1679,28507,18280,46787
00400900,MESABI RANGE CMNTY & TECH COLLEGE       ,MN,55792-0000,Public       ,35,96,131,542,754,1296
00405708,NATIONAL AMERICAN UNIVERSITY            ,MN,55113-0000,Proprietary  ,8,43,51,51,319,370
00405715,NATIONAL AMERICAN UNIVERSITY - BLOOMINGT,MN,55425-5550,Proprietary  ,5,36,41,36,313,349
00406900,UNIVERSITY OF MINNESOTA-CROOKSTON       ,MN,56716-5001,Public       ,24,46,70,979,476,1455
00438600,VETERAN'S MEDICAL CTR- SCH RAD TECH     ,MN,55417-2399,Public       ,0,1,1,1,16,17
00464100,DUNWOODY COLLEGE OF TECHNOLOGY          ,MN,55403-1192,Private      ,76,248,324,1051,1641,2692
00464200,GLOBE UNIVERSITY                        ,MN,55125-5408,Proprietary  ,177,784,961,1172,3558,4730
00464500,MINNEAPOLIS BUSINESS COLLEGE            ,MN,55113-4036,Proprietary  ,2,12,14,427,160,587
00464600,MINNESOTA SCHOOL OF BUSINESS            ,MN,55423-0000,Proprietary  ,272,997,1269,2518,7187,9705
00464800,RASMUSSEN COLLEGE - EAGAN               ,MN,55122-1346,Proprietary  ,31,199,230,314,1271,1585
00525200,RIDGEWATER COLLEGE                      ,MN,56201-2098,Public       ,106,308,414,2024,2143,4167
00526300,MINNESOTA WEST CMNTY & TECH COLG        ,MN,56241-1096,Public       ,44,236,280,977,1537,2514
00553300,"SAINT PAUL COLLEGE, COMMUNITY/TECHNICAL ",MN,55102-1800,Public       ,288,1164,1452,2525,5927,8452
00553400,ST CLOUD TECHNICAL COLLEGE              ,MN,56303-1240,Public       ,203,349,552,2608,2413,5021
00553500,PINE TECHNICAL COLLEGE                  ,MN,55063-2198,Public       ,30,122,152,237,820,1057
00553700,SOUTH CENTRAL COLLEGE                   ,MN,56003-0000,Public       ,119,277,396,1643,2073,3716
00554100,MINNESOTA STATE COMMUNITY AND TECHNICAL ,MN,56573-1405,Public       ,167,448,615,2441,3479,5920
00554400,ALEXANDRIA TECHNICAL COLLEGE            ,MN,56308-3799,Public       ,52,141,193,1255,986,2241
00575700,LAKE SUPERIOR COLLEGE                   ,MN,55811-3399,Public       ,133,425,558,2011,2744,4755
00575900,NORTHWEST TECHNICAL COLLEGE - BEMIDJI   ,MN,56601-4907,Public       ,35,148,183,442,1007,1449
00677500,RAINY RIVER COMMUNITY COLLEGE           ,MN,56649-2187,Public       ,6,23,29,114,154,268
00735000,ANOKA-HENNEPIN TECHNICAL COLLEGE        ,MN,55303-1590,Public       ,79,348,427,835,2249,3084
00735100,BROWN COLLEGE                           ,MN,55120-1004,Proprietary  ,86,147,233,987,1117,2104
00746200,COLLEGE OF VISUAL ARTS                  ,MN,55102-2199,Private      ,8,6,14,204,56,260
00795400,NORMANDALE COMMUNITY COLLEGE            ,MN,55431-4399,Public       ,363,724,1087,4301,4812,9113
00826700,NORTHWEST TECHNICAL INSTITUTE           ,MN,55121-5001,Proprietary  ,6,7,13,125,45,170
00869400,RASMUSSEN COLLEGE                       ,MN,56301-3713,Proprietary  ,34,221,255,336,1366,1702
00869401,RASMUSSEN COLLEGE - BROOKLYN PARK       ,MN,55445-1512,Proprietary  ,41,262,303,331,1620,1951
00905800,BETHEL UNIVERSITY                       ,MN,55112-6999,Private      ,48,198,246,3024,2020,5044
00960000,COSMETOLOGY CAREERS UNLTD-DULUTH        ,MN,55802-2031,Proprietary  ,4,10,14,29,63,92
00972200,EMPIRE BEAUTY SCHOOL                    ,MN,55119-7003,Proprietary  ,9,38,47,87,276,363
00974000,INVER HILLS COMMUNITY COLLEGE           ,MN,55076-3224,Public       ,204,505,709,2122,3244,5366
00983100,MODEL COLLEGE OF HAIR DESIGN            ,MN,56301-4280,Proprietary  ,5,21,26,94,77,171
00987000,EMPIRE BEAUTY SCHOOL                    ,MN,55420-2919,Proprietary  ,18,66,84,95,282,377
00989200,"DULUTH BUSINESS UNIV, INC.              ",MN,55807-0000,Proprietary  ,21,96,117,150,489,639
00999200,OAK HILLS CHRISTIAN COLLEGE             ,MN,56601-0000,Private      ,4,1,5,123,70,193
01024800,ART INSTITUTES INTL MINNESOTA           ,MN,55402-3137,Proprietary  ,103,160,263,1705,1263,2968
01035602,EVEREST INSTITUTE - EAGAN               ,MN,55121-1696,Proprietary  ,38,247,285,146,956,1102
01037400,METROPOLITAN STATE UNIVERSITY           ,MN,55106-5000,Public       ,110,786,896,1594,6353,7947
01040200,DAKOTA COUNTY TECHNICAL COLLEGE         ,MN,55068-2999,Public       ,136,283,419,1208,1965,3173
01049000,REGENCY BEAUTY INSTITUTE                ,MN,55428-0000,Proprietary  ,440,997,1437,3259,5794,9053
01049100,HENNEPIN TECHNICAL COLLEGE              ,MN,55445-2399,Public       ,210,802,1012,1818,4583,6401
01054600,CENTURY COMMUNITY AND TECHNICAL CLG     ,MN,55110-1894,Public       ,474,1193,1667,4703,6500,11203
01101700,HERZING COLLEGE                         ,MN,55428-3548,Proprietary  ,19,47,66,183,469,652
01168600,RASMUSSEN COLLEGE - EDEN PRAIRIE        ,MN,55344-7220,Proprietary  ,83,677,760,373,3112,3485
01173200,"MAYO CLINIC, COLLEGE OF MEDICINE        ",MN,55905-0000,Private      ,3,11,14,33,379,412
01173201,MAYO SCHOOL OF HEALTH-RELATED SCIEN     ,MN,55905-0000,Private      ,1,6,7,49,118,167
01173206,MAYO GRAD SCHOOL                        ,MN,55901-0000,Private      ,0,5,5,3,47,50
01173207,MAYO MEDICAL SCHOOL                     ,MN,55901-0000,Private      ,1,5,6,2,139,141
01232800,NORTHWESTERN HEALTH SCIENCES UNIV       ,MN,55431-1599,Private      ,3,57,60,52,845,897
02050300,ACADEMY COLLEGE                         ,MN,55420-1554,Proprietary  ,9,43,52,44,251,295
02097300,HASTINGS BEAUTY SCHOOL                  ,MN,55033-1205,Proprietary  ,0,1,1,0,1,1
02123200,AVEDA INSTITUTE                         ,MN,55414-0000,Proprietary  ,43,75,118,335,373,708
02159800,COSMETOLOGY CAREERS UNLTD - HIBBING     ,MN,55746-0000,Proprietary  ,2,2,4,26,25,51
02160901,"SALON PROFESSIONAL ACADEMY, THE - THE SA",MN,55428-4928,Proprietary  ,5,16,21,46,73,119
02238100,MINNESOTA SCHOOL OF COSMETOLOGY         ,MN,55125-0000,Proprietary  ,18,36,54,92,162,254
02260500,SUMMIT ACAD OPPORTUNITIES IND CTR       ,MN,55405-0000,Private      ,13,77,90,42,279,321
02263102,HIGH-TECH INSTITUTE - MINNEAPOLIS       ,MN,55416-2467,Proprietary  ,3,12,15,12,50,62
02503300,RASMUSSEN COLLEGE - MANKATO             ,MN,56001-8658,Proprietary  ,36,153,189,318,1112,1430
02503302,RASMUSSEN COLLEGE - MANKATO -  LAKE ELMO,MN,55042-8624,Proprietary  ,29,163,192,227,948,1175
02504200,WALDEN UNIVERSITY                       ,MN,55401-2511,Proprietary  ,17,7017,7034,93,37588,37681
02514100,AMERICAN INDIAN OPPORTUNITIES CTR       ,MN,55404-0000,Private      ,4,40,44,17,153,170
02543600,INGENUE                                 ,MN,56560-0000,Proprietary  ,2,3,5,13,23,36
02551200,EAST METRO OIC                          ,MN,55104-3435,Private      ,1,13,14,30,103,133
03001200,MCNALLY SMITH COLLEGE OF MUSIC          ,MN,55101-2220,Proprietary  ,35,31,66,766,258,1024
03051900,ALFRED ADLER GRADUATE SCHOOL            ,MN,55305-0000,Private      ,0,40,40,0,265,265
03096400,LEECH LAKE TRIBAL COLLEGE               ,MN,56633-0000,Public       ,6,24,30,26,242,268
03129100,FOND DU LAC TRIBAL & COMMUNITY CLG      ,MN,55720-2984,Public       ,36,129,165,500,972,1472
03267300,CAPELLA UNIVERSITY                      ,MN,55402-3389,Proprietary  ,25,5514,5539,110,43084,43194
03833300,AMERICAN ACADEMY OF ACUPUNCTURE AND ORIE,MN,55113-0000,Proprietary  ,0,19,19,1,101,102
03921400,WHITE EARTH TRIBAL AND COMMUNITY COLLEGE,MN,56557-0478,Private      ,5,21,26,32,134,166
04044300,HAZELDEN GRADUATE SCHOOL OF ADDICTION ST,MN,55012-0000,Private      ,1,17,18,1,126,127
04130200,INST. OF PRODUCTION AND RECORDING       ,MN,55401-1315,Proprietary  ,49,60,109,429,233,662
04148800,CENTERPOINT MASSAGE & SHIATSU THERAPY SC,MN,55414-4525,Proprietary  ,4,37,41,4,37,41
00239600,ALCORN STATE UNIVERSITY                 ,MS,39096-7500,Public       ,79,236,315,3199,3063,6262
00239700,BELHAVEN COLLEGE                        ,MS,39202-1789,Private      ,38,419,457,1339,3490,4829
00239800,BLUE MOUNTAIN COLLEGE                   ,MS,38610-9370,Private      ,16,32,48,378,335,713
00240100,COAHOMA COMMUNITY COLLEGE               ,MS,38614-9799,Public       ,52,198,250,1535,2709,4244
00240200,COPIAH-LINCOLN COMMUNITY COLLEGE        ,MS,39191-0649,Public       ,112,407,519,2031,2705,4736
00240300,DELTA STATE UNIVERSITY                  ,MS,38733-0000,Public       ,75,214,289,2787,3200,5987
00240400,EAST CENTRAL COMMUNITY COLLEGE          ,MS,39327-0129,Public       ,70,262,332,1636,2148,3784
00240500,EAST MISSISSIPPI COMM COLLEGE           ,MS,39358-0000,Public       ,130,464,594,2542,4082,6624
00240700,HINDS COMMUNITY COLLEGE                 ,MS,39154-9799,Public       ,498,1466,1964,6821,10553,17374
00240800,HOLMES COMMUNITY COLLEGE                ,MS,39079-0000,Public       ,195,722,917,3327,5889,9216
00240900,ITAWAMBA COMMUNITY COLLEGE              ,MS,38843-1099,Public       ,166,730,896,3767,6493,10260
00241000,JACKSON STATE UNIVERSITY                ,MS,39217-0001,Public       ,199,690,889,7998,9406,17404
00241100,JONES COUNTY JUNIOR COLLEGE             ,MS,39437-3999,Public       ,216,415,631,3479,3079,6558
00241300,MERIDIAN COMMUNITY COLLEGE              ,MS,39307-5890,Public       ,102,383,485,2184,3007,5191
00241400,MILLSAPS COLLEGE                        ,MS,39201-0000,Private      ,30,52,82,1380,446,1826
00241500,MISSISSIPPI COLLEGE                     ,MS,39058-0001,Private      ,70,206,276,2447,3049,5496
00241501,MISSISSIPPI COLLEGE - SCHOOL OF LAW     ,MS,39201-1391,Private      ,4,16,20,31,842,873
00241502,MISSISSIPPI COLLEGE - RANKIN CAMPUS     ,MS,39042-0000,Private      ,0,9,9,18,65,83
00241600,MISSISSIPPI DELTA CMTY COLLEGE          ,MS,38761-0000,Public       ,112,233,345,2023,2578,4601
00241700,MISSISSIPPI GULF CST CLG-PERKINSTON     ,MS,39573-0000,Public       ,85,148,233,1509,986,2495
00241701,MISSISSIPPI GULF CST CLG-JEFF DAVIS     ,MS,39507-0000,Public       ,149,508,657,1513,3346,4859
00241702,MISSISSIPPI GULF CST CLG-JACKSON CN     ,MS,39553-0000,Public       ,125,411,536,1461,2666,4127
00242200,MISSISSIPPI UNIV FOR WOMEN              ,MS,39701-5818,Public       ,29,146,175,1480,1962,3442
00242300,MISSISSIPPI STATE UNIVERSITY            ,MS,39762-9698,Public       ,327,470,797,11658,6717,18375
00242400,MISSISSIPPI VALLEY STATE UNIVERSITY     ,MS,38941-1400,Public       ,86,203,289,2911,3605,6516
00242600,NORTHEAST MS CMNTY COLLEGE              ,MS,38829-1731,Public       ,125,316,441,2449,2576,5025
00242700,NORTHWEST MISSISSIPPI COMMUNITY CLG     ,MS,38668-1703,Public       ,289,633,922,5027,5666,10693
00243000,PEARL RIVER COMMUNITY COLLEGE           ,MS,39470-2201,Public       ,193,486,679,3038,3812,6850
00243300,RUST COLLEGE                            ,MS,38635-2328,Private      ,46,43,89,1431,603,2034
00243500,SOUTHEASTERN BAPTIST COLLEGE            ,MS,39440-0000,Private      ,2,4,6,35,69,104
00243600,SOUTHWEST MISSISSIPPI CMNTY CLG         ,MS,39666-8099,Public       ,96,239,335,1445,1608,3053
00243900,TOUGALOO COLLEGE                        ,MS,39174-9799,Private      ,24,38,62,1494,558,2052
00244000,UNIVERSITY OF MISSISSIPPI               ,MS,38677-1848,Public       ,300,344,644,9581,6325,15906
00244001,UNIVERSITY OF MISSISSIPPI - MED CTR     ,MS,39216-0000,Public       ,17,62,79,384,1649,2033
00244100,UNIVERSITY OF SOUTHERN MISSISSIPPI      ,MS,39406-0001,Public       ,341,733,1074,10043,9219,19262
00244700,WILLIAM CAREY UNIVERSITY                ,MS,39401-5499,Private      ,44,311,355,1163,3297,4460
01146100,WESLEY COLLEGE                          ,MS,39073-1070,Private      ,3,17,20,67,117,184
01289101,ANTONELLI COLLEGE - JACKSON             ,MS,39208-4526,Proprietary  ,25,198,223,124,1028,1152
01289102,ANTONELLI COLLEGE - HATTIESBURG         ,MS,39401-3056,Proprietary  ,17,101,118,152,709,861
02074900,CHRIS' BEAUTY COLLEGE                   ,MS,39501-0000,Proprietary  ,9,26,35,37,137,174
02160500,NORTH MISSISSIPPI MED CTR MED TECH      ,MS,38801-0000,Private      ,0,5,5,14,42,56
02235900,ACADEMY OF HAIR DESIGN #4               ,MS,39208-0000,Proprietary  ,4,17,21,46,121,167
02244300,ACADEMY OF HAIR DESIGN #1               ,MS,38901-0000,Proprietary  ,8,42,50,75,253,328
02249900,DELTA BEAUTY COLLEGE                    ,MS,38701-0000,Proprietary  ,0,6,6,26,77,103
02251600,ACADEMY OF HAIR DESIGN #6               ,MS,39401-7581,Proprietary  ,7,42,49,64,210,274
02251700,FOSTER'S COSMETOLOGY COLLEGE            ,MS,38663-0000,Proprietary  ,2,11,13,13,48,61
02302800,MISSISSIPPI COLLEGE OF BEAUTY CULT      ,MS,39440-0000,Proprietary  ,2,12,14,18,52,70
02320800,MAGNOLIA COLLEGE OF COSMETOLOGY         ,MS,39206-0000,Proprietary  ,11,33,44,51,190,241
02361200,MAGNOLIA BIBLE COLLEGE                  ,MS,39090-0000,Private      ,0,0,0,10,21,31
02502100,CREATIONS COLLEGE OF COSMETOLOGY        ,MS,38803-0000,Proprietary  ,3,10,13,22,106,128
02516200,WESLEY BIBLICAL SEMINARY                ,MS,39206-0000,Private      ,0,7,7,4,112,116
02554600,GIBSON'S BARBER AND BEAUTY COLLEGE      ,MS,39773-0000,Proprietary  ,0,0,0,13,35,48
02586000,J & J HAIR DESIGN COLLEGE               ,MS,39051-3716,Proprietary  ,4,29,33,28,134,162
03004000,FINAL TOUCH BEAUTY SCHOOL               ,MS,39307-2934,Proprietary  ,3,14,17,20,63,83
03010401,CRESCENT CITY BARTENDING SCHOOL         ,MS,39501-0000,Proprietary  ,0,11,11,4,47,51
03010404,CRESCENT CITY SCHOOL OF GAMING & BARTEND,MS,38664-1903,Proprietary  ,0,4,4,3,14,17
03010603,VIRGINIA COLLEGE - JACKSON              ,MS,39206-5602,Proprietary  ,36,278,314,208,1605,1813
03010610,VIRGINIA COLLEGE - BILOXI               ,MS,39532-2124,Proprietary  ,12,99,111,94,792,886
03263300,TRAXLER'S SCHOOL OF HAIR                ,MS,39212-2529,Proprietary  ,2,16,18,18,73,91
03464300,ACADEMY OF HAIR DESIGN                  ,MS,39562-0000,Proprietary  ,4,11,15,16,78,94
03525300,BLUE CLIFF COLLEGE                      ,MS,39507-0000,Proprietary  ,21,96,117,137,452,589
03848300,DAY SPA CAREER COLLEGE                  ,MS,39564-0000,Proprietary  ,5,16,21,21,69,90
03963300,HEALING TOUCH SCHOOL OF MASSAGE THERAPY ,MS,39402-1300,Proprietary  ,2,13,15,12,41,53
04131300,CORINTH ACADEMY OF COSMETOLOGY          ,MS,38834-4813,Proprietary  ,5,12,17,21,66,87
04137400,MISSISSIPPI SCHOOL OF THERAPEUTIC MASSAG,MS,39216-5023,Proprietary  ,0,1,1,0,1,1
04140200,"MISSISSIPPI INSTITUTE OF AESTHETICS, NAI",MS,39056-5628,Proprietary  ,5,11,16,17,69,86
00252600,CARROLL COLLEGE                         ,MT,59625-0002,Private      ,23,21,44,1583,260,1843
00252700,UNIVERSITY OF GREAT FALLS               ,MT,59405-4996,Private      ,12,55,67,524,614,1138
00252800,MILES COMMUNITY COLLEGE                 ,MT,59301-4799,Public       ,12,32,44,331,252,583
00252900,DAWSON COMMUNITY COLLEGE                ,MT,59330-1405,Public       ,9,22,31,276,144,420
00253000,MONTANA STATE UNIVERSITY - BILLINGS     ,MT,59101-0298,Public       ,122,440,562,2493,3603,6096
00253100,MONTANA TECH OF THE UNIV OF MONTANA     ,MT,59701-8997,Public       ,51,152,203,1491,1277,2768
00253200,MONTANA STATE UNIVERSITY - BOZEMAN      ,MT,59717-0001,Public       ,222,356,578,8821,4229,13050
00253300,MONTANA STATE UNIVERSITY-NORTHERN       ,MT,59501-3148,Public       ,28,62,90,781,785,1566
00253400,ROCKY MOUNTAIN COLLEGE                  ,MT,59102-1796,Private      ,27,34,61,967,347,1314
00253600,UNIVERSITY OF MONTANA (THE)             ,MT,59812-0001,Public       ,268,587,855,8361,7633,15994
00253700,UNIVERSITY OF MONTANA WESTERN (THE)     ,MT,59725-3598,Public       ,30,46,76,1071,536,1607
00677700,FLATHEAD VALLEY COMMUNITY COLLEGE       ,MT,59901-2699,Public       ,90,316,406,826,1751,2577
00757000,HELENA COLLEGE OF TECHNOLOGY            ,MT,59601-3098,Public       ,37,155,192,442,1004,1446
00790000,BUTTE ACADEMY OF BEAUTY CULTURE         ,MT,59701-9197,Proprietary  ,2,3,5,17,41,58
00894700,"DAHL'S COLLEGE OF BEAUTY,INC            ",MT,59401-3731,Proprietary  ,3,18,21,26,66,92
00931400,MSU COLLEGE OF TECH-GREAT FALLS         ,MT,59405-4907,Public       ,51,266,317,654,1662,2316
02143400,SALISH KOOTENAI COLLEGE                 ,MT,59855-0000,Public       ,38,122,160,305,962,1267
02286600,LITTLE BIG HORN COLLEGE                 ,MT,59022-0000,Public       ,7,24,31,99,254,353
02343000,FT PECK COMMUNITY COLLEGE               ,MT,59255-0000,Public       ,10,34,44,65,272,337
02510600,BLACKFEET COMMUNITY COLLEGE             ,MT,59417-0000,Private      ,11,21,32,171,455,626
02517500,FORT BELKNAP COLLEGE                    ,MT,59526-0000,Public       ,2,9,11,36,108,144
02545200,CHIEF DULL KNIFE COLLEGE                ,MT,59043-0098,Public       ,7,16,23,55,164,219
02610900,STONE CHILD COLLEGE                     ,MT,59521-9796,Public       ,3,17,20,65,183,248
02621300,ACADEMY OF COSMETOLOGY                  ,MT,59715-3544,Proprietary  ,5,7,12,27,36,63
03205300,MODERN BEAUTY SCHOOL                    ,MT,59801-8386,Proprietary  ,5,15,20,30,60,90
03763400,"ACADEMY OF NAIL, SKIN & HAIR            ",MT,59101-0000,Proprietary  ,9,26,35,78,142,220
03778300,HEALTH WORKS INSTITUTE                  ,MT,59715-0000,Proprietary  ,1,10,11,15,45,60
04163700,BITTERROOT SCHOOL OF COSMETOLOGY        ,MT,59840-3118,Proprietary  ,1,1,2,1,1,2
04164100,SALON PROFESSIONAL ACADEMY (THE)        ,MT,59405-0000,Proprietary  ,3,8,11,3,8,11
00253900,CHADRON STATE COLLEGE                   ,NE,69337-2690,Public       ,33,95,128,1618,1045,2663
00254000,COLLEGE OF ST MARY                      ,NE,68106-2606,Private      ,17,81,98,415,1188,1603
00254100,CONCORDIA UNIVERSITY                    ,NE,68434-1594,Private      ,13,60,73,1391,439,1830
00254200,CREIGHTON UNIVERSITY                    ,NE,68178-0001,Private      ,55,147,202,4752,4745,9497
00254300,DANA COLLEGE                            ,NE,68008-9905,Private      ,9,5,14,865,107,972
00254400,DOANE COLLEGE                           ,NE,68333-2421,Private      ,26,123,149,1486,1004,2490
00254700,GRACE UNIVERSITY                        ,NE,68108-3629,Private      ,10,23,33,324,291,615
00254800,HASTINGS COLLEGE                        ,NE,68901-7621,Private      ,15,10,25,1463,165,1628
00255100,UNIVERSITY OF NEBRASKA AT KEARNEY       ,NE,68849-0001,Public       ,75,130,205,4047,1674,5721
00255300,MIDLAND LUTHERAN COLLEGE                ,NE,68025-4254,Private      ,9,18,27,775,245,1020
00255400,UNIVERSITY OF NEBRASKA-OMAHA            ,NE,68182-0001,Public       ,213,483,696,8089,6032,14121
00255500,NEBRASKA WESLEYAN UNIVERSITY            ,NE,68504-2796,Private      ,36,34,70,1830,457,2287
00255700,MID-PLAINS COMM COLLEGE - NORTH PLATTE  ,NE,69101-9420,Public       ,30,76,106,479,630,1109
00255701,MID-PLAINS COMMUNITY COLLEGE - MCCOOK   ,NE,69001-2631,Public       ,15,26,41,241,172,413
00255900,PERU STATE COLLEGE                      ,NE,68421-0010,Public       ,22,102,124,961,1011,1972
00256000,WESTERN NEBRASKA COMMUNITY COLLEGE      ,NE,69361-1815,Public       ,67,137,204,720,1102,1822
00256300,UNION COLLEGE                           ,NE,68506-4387,Private      ,14,17,31,713,317,1030
00256500,UNIVERSITY OF NEBRASKA-LINCOLN          ,NE,68588-0419,Public       ,294,313,607,14949,5234,20183
00256596,UNIVERSITY OF NEBRASKA - CURTIS         ,NE,69025-9522,Public       ,1,2,3,224,45,269
00256600,WAYNE STATE COLLEGE                     ,NE,68787-1172,Public       ,48,70,118,2815,895,3710
00256700,YORK COLLEGE                            ,NE,68467-2699,Private      ,24,4,28,583,143,726
00443100,MARY LANNING MEM HOSP SCH RAD TECH      ,NE,68901-4497,Private      ,0,1,1,7,6,13
00443600,REGNL WST MEDCL CTR SCHL RAD            ,NE,69361-0000,Private      ,0,0,0,5,7,12
00458608,KAPLAN UNIVERSITY - OMAHA               ,NE,68134-1002,Proprietary  ,29,238,267,244,1706,1950
00458609,KAPLAN UNIVERSITY - LINCOLN             ,NE,68508-2668,Proprietary  ,22,162,184,163,1197,1360
00639900,BRYANLGH COLLEGE OF HEALTH SCIENCES     ,NE,68506-1398,Private      ,5,16,21,301,253,554
00640400,NEBR METHODIST CLG OF NURS ALLD HLTH    ,NE,68114-2852,Private      ,19,47,66,368,590,958
00689500,UNIVERSITY OF NEBRASKA-MED CTR          ,NE,68198-4265,Public       ,24,72,96,561,2189,2750
00750100,VATTEROTT COLLEGE                       ,NE,68137-1237,Proprietary  ,21,147,168,183,928,1111
00849200,ALEGENT HEALTH SCHOOLS                  ,NE,68114-2767,Private      ,2,4,6,32,83,115
00952300,BAHNER COLLEGE OF HAIRSTYLING           ,NE,68025-3297,Proprietary  ,2,6,8,27,32,59
00961700,CAPITOL BEAUTY SCHOOL                   ,NE,68144-3873,Proprietary  ,11,12,23,119,102,221
00974300,BELLEVUE UNIVERSITY                     ,NE,68005-0000,Private      ,57,894,951,736,6540,7276
00986200,CLARKSON COLLEGE                        ,NE,68131-2739,Private      ,13,53,66,453,815,1268
01151900,JOSEPH'S COLLEGE OF BEAUTY/ALL CAMPUSES ,NE,68510-2226,Proprietary  ,11,66,77,165,313,478
01151909,JOSEPH'S COLLEGE OF BEAUTY - OMAHA      ,NE,68131-0000,Proprietary  ,0,3,3,4,23,27
01166700,NORTHEAST COMMUNITY COLLEGE             ,NE,68702-0000,Public       ,56,155,211,1639,1276,2915
01258600,METROPOLITAN COMMUNITY COLLEGE          ,NE,68103-0000,Public       ,413,1431,1844,4136,9834,13970
01297600,NEBRASKA CHRISTIAN COLLEGE              ,NE,68046-4256,Private      ,3,2,5,121,46,167
02079700,COLLEGE OF HAIR DESIGN                  ,NE,68508-0000,Proprietary  ,19,31,50,193,156,349
02099500,CENTRAL COMMUNITY COLLEGE- GI           ,NE,68801-0000,Public       ,49,171,220,628,1251,1879
02099501,CENTRAL COMMUNITY COLLEGE - HASTINGS    ,NE,68902-0000,Public       ,32,118,150,930,749,1679
02099502,CENTRAL COMMUNITY COLLEGE - COLUMBUS    ,NE,68602-0000,Public       ,20,58,78,438,459,897
02508300,SOUTHEAST COMM. COLLEGE-ALL CAMPUSES    ,NE,68520-0000,Public       ,376,694,1070,5058,5705,10763
02550800,NEBRASKA INDIAN COMMUNITY COLLEGE       ,NE,68039-0000,Public       ,4,15,19,20,95,115
02610500,XENON INTERNATIONAL ACADEMY II          ,NE,68127-3522,Proprietary  ,12,32,44,223,191,414
03127300,OMAHA SCHOOL OF MASSAGE THERAPY         ,NE,68127-5002,Proprietary  ,15,63,78,71,186,257
03164300,THE CREATIVE CENTER                     ,NE,68164-2911,Proprietary  ,1,5,6,168,30,198
03279300,MYOTHERAPY INSTITUTE                    ,NE,68516-3641,Proprietary  ,3,10,13,24,38,62
03323300,LITTLE PRIEST TRIBAL COLLEGE            ,NE,68071-0000,Private      ,3,12,15,28,96,124
03821400,UNIVERSAL COLLEGE OF HEALING ARTS       ,NE,68112-1810,Proprietary  ,1,11,12,9,67,76
00256800,UNIVERSITY OF NEVADA RENO               ,NV,89557-0002,Public       ,311,385,696,7596,5027,12623
00256900,UNIVERSITY OF NEVADA-LAS VEGAS          ,NV,89154-1001,Public       ,547,1118,1665,12045,13937,25982
00697700,GREAT BASIN COLLEGE                     ,NV,89801-3348,Public       ,40,167,207,559,1140,1699
00736700,MARINELLO SCHOOLS OF BEAUTY             ,NV,89110-3563,Proprietary  ,22,56,78,153,349,502
00737100,MARINELLO SCHOOL OF BEAUTY              ,NV,89502-5982,Proprietary  ,13,37,50,54,163,217
00844103,ANTHEM INSTITUTE - MORRISON UNIVERSITY  ,NV,89521-4826,Proprietary  ,0,22,22,13,75,88
00919200,SIERRA NEVADA COLLEGE                   ,NV,89451-0000,Private      ,16,70,86,323,529,852
01036200,COLLEGE OF SOUTHERN NEVADA              ,NV,89146-1139,Public       ,1315,3448,4763,9814,19962,29776
01036300,WESTERN NEVADA COLLEGE                  ,NV,89703-0000,Public       ,104,394,498,1054,2425,3479
01323200,ACADEMY OF HAIR DESIGN                  ,NV,89102-0000,Proprietary  ,12,44,56,120,177,297
02107700,TRUCKEE MEADOWS COMMUNITY CLG           ,NV,89512-0000,Public       ,310,968,1278,2953,5997,8950
02237500,EVEREST COLLEGE                         ,NV,89103-0000,Proprietary  ,89,259,348,493,1298,1791
02338509,NEVADA CAREER INSTITUTE                 ,NV,89121-0000,Proprietary  ,16,66,82,60,338,398
02361001,ITT TECHNICAL INSTITUTE                 ,NV,89014-0000,Proprietary  ,102,224,326,459,1139,1598
02616703,SCOTTSDALE CULINARY INSTITUTE - LE CORDO,NV,89144-7047,Proprietary  ,9,40,49,106,227,333
02621500,CAREER COLLEGE OF NORTHERN NEVADA       ,NV,89434-7905,Proprietary  ,18,140,158,168,740,908
03030603,UTAH CLG OF MASSAGE THERAPY-NSMT        ,NV,89123-0000,Proprietary  ,28,84,112,139,453,592
03031405,INTERNATIONAL ACADEMY OF DESIGN AND TECH,NV,89074-7750,Proprietary  ,46,74,120,339,480,819
03043200,KAPLAN COLLEGE                          ,NV,89102-8618,Proprietary  ,50,205,255,232,1161,1393
03076404,HIGH-TECH INSTITUTE - LAS VEGAS         ,NV,89102-4514,Proprietary  ,5,72,77,46,211,257
03084600,THE ART INSTITUTE OF LAS VEGAS          ,NV,89074-7737,Proprietary  ,158,224,382,1308,1630,2938
03088200,CARSON CITY BEAUTY ACADEMY              ,NV,89706-0000,Proprietary  ,4,11,15,36,100,136
03110000,ACADEMY OF HEALING ARTS                 ,NV,89106-4031,Proprietary  ,67,213,280,275,879,1154
03232306,EUPHORIA INSTITUTE - SUMMERLIN          ,NV,89117-8803,Proprietary  ,26,60,86,121,235,356
03232307,EUPHORIA INSTITUTE - GREEN VALLEY       ,NV,89052-4964,Proprietary  ,20,35,55,144,243,387
03232308,EUPHORIA INSTITUTE - ALIANTE            ,NV,89131-1036,Proprietary  ,29,45,74,147,255,402
03787300,EXPERTISE SCHOOL OF BEAUTY              ,NV,89106-2516,Private      ,5,42,47,38,229,267
03838500,NORTHWEST HEALTH CAREERS                ,NV,89128-0000,Proprietary  ,15,65,80,61,214,275
03975300,INSTITUTE OF PROFESSIONAL CAREERS       ,NV,89119-7825,Proprietary  ,2,23,25,25,103,128
04065300,UNIVERSITY OF SOUTHERN NEVADA           ,NV,89014-2333,Private      ,19,41,60,176,1358,1534
04114300,NEVADA STATE COLLEGE                    ,NV,89002-9455,Public       ,70,193,263,840,1590,2430
04144800,INTERNATIONAL ACADEMY OF STYLE          ,NV,89509-3450,Proprietary  ,3,14,17,3,14,17
04147600,AVEDA INSTITUTE LAS VEGAS               ,NV,89119-6103,Proprietary  ,8,29,37,66,153,219
00257200,COLBY-SAWYER COLLEGE                    ,NH,03257-4648,Private      ,18,4,22,2521,86,2607
00257300,DARTMOUTH COLLEGE                       ,NH,03755-3529,Private      ,91,24,115,10508,1850,12358
00257500,FRANKLIN PIERCE UNIVERSITY              ,NH,03461-0060,Private      ,28,91,119,2619,1117,3736
00257900,NEW ENGLAND COLLEGE                     ,NH,03242-3293,Private      ,21,121,142,1360,1017,2377
00258000,SOUTHERN NEW HAMPSHIRE UNIVERSITY       ,NH,03106-1045,Private      ,89,575,664,3966,4251,8217
00258100,NHTI  - CONCORD'S COMMUNITY COLLEGE     ,NH,03301-7412,Public       ,137,192,329,2441,1695,4136
00258200,MANCHESTER COMMUNITY COLLEGE            ,NH,03102-8518,Public       ,90,176,266,1085,1261,2346
00258202,NEW HAMPSHIRE COMMUNITY TECHNICAL COLLEG,NH,03038-0000,Public       ,0,1,1,19,6,25
00258300,GREAT BAY COMMUNITY COLLEGE             ,NH,03885-0000,Public       ,68,97,165,756,857,1613
00258600,RIVIER COLLEGE                          ,NH,03060-5086,Private      ,20,90,110,1438,955,2393
00258700,SAINT ANSELM COLLEGE                    ,NH,03102-1310,Private      ,33,4,37,3898,82,3980
00258900,UNIVERSITY OF NEW HAMPSHIRE             ,NH,03824-2511,Public       ,186,178,364,19059,3312,22371
00259000,KEENE STATE COLLEGE                     ,NH,03431-0000,Public       ,81,40,121,7197,608,7805
00259100,PLYMOUTH STATE UNIVERSITY               ,NH,03264-1595,Public       ,59,124,183,6004,1169,7173
00301004,ANTIOCH UNIVERSITY                      ,NH,03431-0000,Private      ,0,26,26,3,839,842
00472900,HESSER COLLEGE                          ,NH,03103-7230,Proprietary  ,70,209,279,855,1424,2279
00472901,HESSER COLLEGE - NASHUA CAMPUS          ,NH,03063-1286,Proprietary  ,32,77,109,215,706,921
00472904,HESSER COLLEGE - PORTSMOUTH CAMPUS      ,NH,03801-3245,Proprietary  ,31,124,155,188,610,798
00472905,HESSER COLLEGE - SALEM CAMPUS           ,NH,03079-2842,Proprietary  ,47,112,159,302,735,1037
00472906,HESSER COLLEGE - CONCORD CAMPUS         ,NH,03301-3415,Proprietary  ,20,91,111,140,596,736
00473000,MCINTOSH COLLEGE INC                    ,NH,03820-3990,Proprietary  ,0,0,0,10,16,26
00473100,DANIEL WEBSTER COLLEGE                  ,NH,03063-1300,Proprietary  ,9,17,26,1059,240,1299
00473300,CHESTER COLLEGE OF NEW ENGLAND          ,NH,03036-4331,Private      ,4,3,7,264,38,302
00529100,WHITE MOUNTAINS COMMUNITY COLLEGE       ,NH,03570-3799,Public       ,22,76,98,363,641,1004
00702500,LEBANON COLLEGE                         ,NH,03766-0000,Private      ,0,15,15,37,77,114
00755500,LAKES REGION COMMUNITY COLLEGE          ,NH,03246-1326,Public       ,23,77,100,606,564,1170
00756000,RIVER VALLEY COMMUNITY COLLEGE          ,NH,03743-9707,Public       ,19,77,96,311,666,977
00849300,CONTINENTAL ACADEMIE OF HAIR DESIGN     ,NH,03103-4901,Proprietary  ,2,3,5,24,18,42
00864500,EMPIRE BEAUTY SCHOOL                    ,NH,03220-0000,Proprietary  ,22,29,51,129,130,259
00923600,NASHUA COMMUNITY COLLEGE                ,NH,03063-2052,Public       ,72,125,197,865,909,1774
01318900,CONTINENTAL ACADEMIE OF HAIR DESIGN     ,NH,03051-3754,Proprietary  ,8,4,12,51,46,97
02097900,FRANKLIN PIERCE LAW CENTER              ,NH,03301-0000,Private      ,0,8,8,6,774,780
02140400,ST JOSEPH SCH OF PRAC NRSG              ,NH,03060-0000,Private      ,1,13,14,40,148,188
02174800,MICHAEL'S SCHOOL OF HAIR DESIGN & ESTHET,NH,03110-0000,Proprietary  ,20,21,41,89,65,154
02179600,EMPIRE BEAUTY SCHOOL                    ,NH,03878-0000,Proprietary  ,24,39,63,109,149,258
02211600,PORTSMOUTH BTY SCH OF HAIR DESIGN       ,NH,03801-4084,Proprietary  ,4,1,5,19,20,39
02223300,MAGDALEN COLLEGE                        ,NH,03278-4012,Private      ,2,0,2,53,5,58
02245400,KEENE BEAUTY ACADEMY                    ,NH,03431-0000,Proprietary  ,6,5,11,42,40,82
02247000,NEW ENGLAND SCHOOL OF HAIR DESIGN       ,NH,03784-0000,Proprietary  ,4,10,14,35,63,98
02300200,CONCORD ACADEMY OF HAIR DESIGN          ,NH,03301-0000,Proprietary  ,0,0,0,1,1,2
03043100,THOMAS MORE COLLEGE OF LIBERAL ARTS     ,NH,03054-4818,Private      ,2,1,3,85,7,92
03101300,GRANITE STATE COLLEGE                   ,NH,03301-6400,Public       ,20,122,142,276,1377,1653
03182300,NEW HAMPSHIRE INSTITUTE OF ART          ,NH,03104-4858,Private      ,9,13,22,589,113,702
03437300,UPPER VALLEY TEACHER TRANING PROGRAM    ,NH,03766-1358,Private      ,0,0,0,1,44,45
03729300,NH INSTITUTE FOR THERAPEUTIC ARTS       ,NH,03051-4906,Proprietary  ,5,14,19,19,57,76
00267000,BAPTIST BIBLE COLG OF PENNSYLVANIA      ,PA,18411-1297,Private      ,12,29,41,657,213,870
00322800,BRYN ATHYN COLLEGE OF THE NEW CHURCH    ,PA,19009-0717,Private      ,7,2,9,170,22,192
00322900,ALBRIGHT COLLEGE                        ,PA,19612-5234,Private      ,39,64,103,3588,958,4546
00323000,ALLEGHENY COLLEGE                       ,PA,16335-3902,Private      ,19,7,26,3461,101,3562
00323100,COMM CLG OF ALLEGHENY-ALLEGHENY CMP     ,PA,15212-0000,Public       ,261,668,929,2680,4971,7651
00323101,"COMM CLG OF ALLEGHENY, BOYCE CAMPUS     ",PA,15146-0000,Public       ,125,301,426,1433,2320,3753
00323102,"COMM CLG OF ALLEGHENY, NORTH CAMPUS     ",PA,15237-0000,Public       ,97,232,329,1167,1468,2635
00323103,"COMM CLG OF ALLEGHENY, SOUTH CAMPUS     ",PA,15122-0000,Public       ,150,330,480,1769,2310,4079
00323300,ALVERNIA UNIVERSITY                     ,PA,19607-1799,Private      ,20,106,126,2024,1502,3526
00323500,ARCADIA UNIVERSITY                      ,PA,19038-3295,Private      ,42,141,183,3982,2015,5997
00323700,BRYN MAWR COLLEGE                       ,PA,19010-2899,Private      ,9,15,24,1712,514,2226
00323800,BUCKNELL UNIVERSITY                     ,PA,17837-2122,Private      ,46,6,52,5230,175,5405
00323900,BUCKS COUNTY COMMUNITY COLLEGE          ,PA,18940-1320,Public       ,254,574,828,3776,3744,7520
00324000,BUTLER COUNTY COMMUNITY COLLEGE         ,PA,16001-0000,Public       ,130,262,392,1882,2086,3968
00324100,CABRINI COLLEGE                         ,PA,19087-3698,Private      ,15,225,240,2232,1463,3695
00324200,CARNEGIE MELLON UNIVERSITY              ,PA,15213-3890,Private      ,89,47,136,10363,1467,11830
00324201,CARNEGIE MELLON UNIV- THE HEINZ SCH     ,PA,15213-0000,Private      ,10,23,33,281,565,846
00324202,CARNEGIE MELLON- TEPPER SCHOOL OF BUSINE,PA,15213-0000,Private      ,3,17,20,249,576,825
00324300,CEDAR CREST COLLEGE                     ,PA,18104-6196,Private      ,20,79,99,1351,1196,2547
00324400,CHATHAM UNIVERSITY                      ,PA,15232-2826,Private      ,11,142,153,769,1561,2330
00324500,CHESTNUT HILL COLLEGE                   ,PA,19118-2693,Private      ,30,149,179,1878,1711,3589
00324700,MISERICORDIA  UNIVERSITY                ,PA,18612-1008,Private      ,14,70,84,2037,1112,3149
00324900,COMMUNITY COLLEGE OF PHILADELPHIA       ,PA,19130-3991,Public       ,1029,2459,3488,10828,18005,28833
00325100,CURTIS INSTITUTE OF MUSIC               ,PA,19103-6187,Private      ,6,4,10,218,101,319
00325200,DELAWARE VALLEY COLLEGE                 ,PA,18901-2697,Private      ,21,63,84,2285,425,2710
00325300,DICKINSON COLLEGE                       ,PA,17013-2896,Private      ,29,0,29,3204,174,3378
00325400,DICKINSON SCHOOL OF LAW                 ,PA,17013-2899,Private      ,0,0,0,4,35,39
00325600,DREXEL UNIVERSITY                       ,PA,19104-2875,Private      ,294,934,1228,24427,14838,39265
00325800,DUQUESNE UNIVERSITY                     ,PA,15282-0001,Private      ,64,210,274,7915,4356,12271
00325900,EASTERN UNIVERSITY                      ,PA,19087-3696,Private      ,35,184,219,2207,2334,4541
00325908,EASTERN BAPTIST THEOLGCL SEMINARY       ,PA,19096-0000,Private      ,0,0,0,1,91,92
00326200,ELIZABETHTOWN COLLEGE                   ,PA,17022-2298,Private      ,22,47,69,3078,505,3583
00326300,EVANGELICAL SCHOOL OF THEOLOGY          ,PA,17067-0000,Private      ,0,6,6,1,104,105
00326500,FRANKLIN & MARSHALL COLLEGE             ,PA,17604-0000,Private      ,32,8,40,3104,114,3218
00326600,GANNON UNIVERSITY                       ,PA,16541-0001,Private      ,20,84,104,3509,1501,5010
00326700,GENEVA COLLEGE                          ,PA,15010-3599,Private      ,20,78,98,1786,946,2732
00326800,GETTYSBURG COLLEGE                      ,PA,17325-1486,Private      ,27,6,33,4120,96,4216
00326900,GROVE CITY COLLEGE                      ,PA,16127-0000,Private      ,15,3,18,1894,45,1939
00327000,GWYNEDD-MERCY COLLEGE                   ,PA,19437-0901,Private      ,30,149,179,1811,1263,3074
00327200,HARCUM COLLEGE                          ,PA,19010-3476,Private      ,26,70,96,572,1126,1698
00327300,HARRISBURG AREA COMMUNITY COLLEGE       ,PA,17110-2999,Public       ,691,1830,2521,8586,13880,22466
00327400,HAVERFORD COLLEGE                       ,PA,19041-1392,Private      ,13,3,16,2191,32,2223
00327500,HOLY FAMILY UNIVERSITY                  ,PA,19114-2094,Private      ,30,156,186,2039,1844,3883
00327600,IMMACULATA UNIVERSITY                   ,PA,19345-0647,Private      ,18,178,196,1451,1634,3085
00327700,INDIANA UNIVERSITY OF PENNSYLVANIA      ,PA,15705-1097,Public       ,161,223,384,13493,3852,17345
00327900,JUNIATA COLLEGE                         ,PA,16652-2196,Private      ,11,5,16,2213,90,2303
00328000,KEYSTONE COLLEGE                        ,PA,18440-0200,Private      ,25,69,94,1583,832,2415
00328200,KINGS COLLEGE                           ,PA,18711-0801,Private      ,26,42,68,2855,531,3386
00328300,LACKAWANNA COLLEGE                      ,PA,18509-9961,Private      ,76,108,184,1448,980,2428
00328400,LAFAYETTE COLLEGE                       ,PA,18042-1768,Private      ,38,5,43,3796,85,3881
00328500,LANCASTER BIBLE COLLEGE                 ,PA,17601-5036,Private      ,7,51,58,578,389,967
00328600,LANCASTER THEOLOGICAL SEMINARY          ,PA,17603-0000,Private      ,0,8,8,1,112,113
00328700,LASALLE UNIVERSITY                      ,PA,19141-1199,Private      ,76,281,357,5415,3395,8810
00328800,LEBANON VALLEY COLLEGE                  ,PA,17003-1400,Private      ,16,10,26,2329,235,2564
00328900,LEHIGH UNIVERSITY                       ,PA,18015-1588,Private      ,74,46,120,8218,816,9034
00329000,LINCOLN UNIVERSITY                      ,PA,19352-0999,Public       ,104,86,190,4137,1318,5455
00329100,LUTHERAN THEOLOG SEMINARY-GETTYSBRG     ,PA,17325-0000,Private      ,0,0,0,0,142,142
00329200,LUTHERAN THEOLOGICAL SEMINARY           ,PA,19119-0000,Private      ,0,9,9,0,204,204
00329300,LYCOMING COLLEGE                        ,PA,17701-5192,Private      ,17,8,25,2026,110,2136
00329400,MANOR COLLEGE                           ,PA,19046-3399,Private      ,20,64,84,522,577,1099
00329600,MARYWOOD UNIVERSITY                     ,PA,18509-1598,Private      ,21,69,90,2705,1624,4329
00329700,MERCYHURST COLLEGE                      ,PA,16546-0001,Private      ,63,156,219,4026,1804,5830
00329800,MESSIAH COLLEGE                         ,PA,17027-0800,Private      ,32,21,53,3463,190,3653
00330000,MOORE COLLEGE OF ART & DESIGN           ,PA,19103-1179,Private      ,15,12,27,760,263,1023
00330100,MORAVIAN COLLEGE                        ,PA,18018-6650,Private      ,27,22,49,2222,273,2495
00330101,MORAVIAN THEOLOGICAL SEMINARY           ,PA,18018-0000,Private      ,1,4,5,12,77,89
00330200,MOUNT ALOYSIUS COLLEGE                  ,PA,16630-1999,Private      ,13,64,77,1248,835,2083
00330300,CARLOW COLLEGE                          ,PA,15213-3165,Private      ,11,143,154,1228,1775,3003
00330400,MUHLENBERG COLLEGE                      ,PA,18104-5586,Private      ,33,32,65,3430,321,3751
00330600,VALLEY FORGE CHRISTIAN COLLEGE          ,PA,19460-2399,Private      ,16,19,35,905,259,1164
00330900,PEIRCE COLLEGE                          ,PA,19102-4699,Private      ,23,215,238,266,2281,2547
00331100,PENNSYLVANIA COLLEGE OF OPTOMETRY       ,PA,19027-1598,Private      ,0,4,4,6,916,922
00331300,WIDENER UNIVERSITY                      ,PA,19013-5792,Private      ,51,115,166,4281,2177,6458
00331302,WIDENER UNIV SCH OF LAW- HARRISBURG     ,PA,17106-9381,Private      ,0,8,8,7,851,858
00331500,BLOOMSBURG UNIVERSITY OF PA             ,PA,17815-1301,Public       ,164,123,287,11267,1954,13221
00331600,CALIFORNIA UNIV OF PENNSYLVANIA         ,PA,15419-1394,Public       ,86,363,449,6844,4205,11049
00331700,CHEYNEY UNIVERSITY OF PENNSYLVANIA      ,PA,19319-0200,Public       ,63,55,118,2202,967,3169
00331800,CLARION UNIVERSITY OF PENNSYLVANIA      ,PA,16214-1232,Public       ,81,180,261,5580,2325,7905
00332000,EAST STROUDSBURG UNIVERSITY             ,PA,18301-2999,Public       ,111,120,231,7943,1725,9668
00332100,EDINBORO UNIVERSITY OF PENNSYLVANIA     ,PA,16444-0001,Public       ,92,235,327,6203,3570,9773
00332200,KUTZTOWN UNIVERSITY OF PENNSYLVANIA     ,PA,19530-9339,Public       ,156,139,295,10680,2156,12836
00332300,LOCK HAVEN UNIV OF PENNSYLVANIA         ,PA,17745-2439,Public       ,92,84,176,5455,1315,6770
00332400,MANSFIELD UNIVERSITY                    ,PA,16933-1123,Public       ,42,98,140,3115,1226,4341
00332500,MILLERSVILLE UNIVERSITY OF PA           ,PA,17551-1800,Public       ,132,137,269,8498,2166,10664
00332600,SHIPPENSBURG UNIVERSITY                 ,PA,17257-2299,Public       ,113,139,252,8110,1686,9796
00332700,SLIPPERY ROCK UNIVERSITY                ,PA,16057-1326,Public       ,107,156,263,8514,2229,10743
00332800,WEST CHESTER UNIVERSITY                 ,PA,19383-0001,Public       ,212,278,490,14612,3754,18366
00332900,PENN STATE UNIVERSITY                   ,PA,16802-1503,Public       ,961,1674,2635,70690,22637,93327
00332901,PENN STATE UNIV-HERSHEY MEDCL CTR       ,PA,17033-0000,Public       ,0,0,0,2,10,12
00335000,UNIVERSITY OF THE ARTS (THE)            ,PA,19102-9493,Private      ,56,34,90,3316,667,3983
00335100,PHILADELPHIA BIBLICAL UNIVERSITY        ,PA,19047-2942,Private      ,12,41,53,923,568,1491
00335200,PHILADELPHIA CLG OSTEOPATHIC MED        ,PA,19131-0000,Private      ,0,27,27,16,2743,2759
00335300,UNIVERSITY OF THE SCIENCES IN PHILADELPH,PA,19104-4495,Private      ,30,35,65,3445,955,4400
00335400,PHILADELPHIA UNIVERSITY                 ,PA,19144-5497,Private      ,59,74,133,4062,1245,5307
00335600,PITTSBURGH THEOLOGICAL SEMINARY         ,PA,15206-0000,Private      ,0,5,5,3,216,219
00335700,POINT PARK UNIVERSITY                   ,PA,15222-1912,Private      ,38,206,244,3246,2373,5619
00335800,REFORMED PRESBYTERIAN THEOL SEMINAR     ,PA,15208-0000,Private      ,0,3,3,0,28,28
00335900,ROBERT MORRIS UNIVERSITY                ,PA,15108-1189,Private      ,48,162,210,4135,2157,6292
00336000,ROSEMONT COLLEGE                        ,PA,19010-1699,Private      ,9,44,53,720,570,1290
00336200,SETON HILL UNIVERSITY                   ,PA,15601-1599,Private      ,20,66,86,1867,959,2826
00336400,ST. CHARLES BORROMEO SEMINARY           ,PA,19096-0000,Private      ,0,5,5,31,52,83
00336600,SAINT FRANCIS UNIVERSITY                ,PA,15940-0600,Private      ,16,35,51,2017,627,2644
00336700,SAINT JOSEPH'S UNIVERSITY               ,PA,19131-1395,Private      ,83,346,429,6151,2603,8754
00336800,ST VINCENT COLLEGE                      ,PA,15650-2690,Private      ,11,14,25,2152,343,2495
00336900,SUSQUEHANNA UNIVERSITY                  ,PA,17870-1001,Private      ,13,5,18,3040,104,3144
00337000,SWARTHMORE COLLEGE                      ,PA,19081-1397,Private      ,32,1,33,3525,66,3591
00337100,TEMPLE UNIV - MAIN CAMPUS               ,PA,19122-6003,Private      ,424,493,917,28115,8379,36494
00337101,TEMPLE UNIV - SCHOOL OF LAW             ,PA,19122-0000,Private      ,0,16,16,50,2742,2792
00337102,TEMPLE UNIV - SCHOOL OF MEDICINE        ,PA,19140-0000,Private      ,8,15,23,146,1433,1579
00337103,TEMPLE UNIV - SCHOOL OF DENTISTRY       ,PA,19140-0000,Private      ,2,4,6,24,603,627
00337104,TEMPLE UNIV - AMBLER CAMPUS             ,PA,19002-0000,Private      ,32,42,74,774,627,1401
00337105,TEMPLE UNIV - SCH OF ALLIED HEALTH      ,PA,19140-0000,Private      ,6,21,27,383,472,855
00337106,TEMPLE UNIV - SCHOOL OF PHARMACY        ,PA,19140-0000,Private      ,2,12,14,193,713,906
00337107,TEMPLE UNIV - TYLER SCHOOL OF ART       ,PA,19122-0000,Private      ,25,21,46,721,383,1104
00337108,TEMPLE UNIV - GRAD DIV HEALTH SCI       ,PA,19140-0000,Private      ,5,38,43,71,588,659
00337109,TEMPLE UNIV - GRADUATE DIVISION         ,PA,19122-0000,Private      ,9,159,168,169,3311,3480
00337111,TEMPLE UNIV-SCH OF PODIATRIC MED        ,PA,19107-0000,Private      ,1,2,3,8,406,414
00337600,THIEL COLLEGE                           ,PA,16125-2181,Private      ,16,18,34,1379,186,1565
00337800,UNIVERSITY OF PENNSYLVANIA              ,PA,19104-6216,Private      ,252,355,607,16407,13095,29502
00337900,UNIVERSITY OF PITTSBURGH                ,PA,15260-0000,Public       ,329,653,982,27272,10989,38261
00337906,UNIVERSITY OF PITTSBURGH - SCHOOL OF MED,PA,15261-0001,Public       ,5,20,25,71,1006,1077
00337907,UNIVERSITY OF PITTSBURGH - SCHOOL OF DEN,PA,15261-2523,Public       ,5,8,13,45,383,428
00338400,UNIVERSITY OF SCRANTON                  ,PA,18510-4622,Private      ,57,173,230,7055,1711,8766
00338500,URSINUS COLLEGE                         ,PA,19426-2562,Private      ,21,5,26,3671,128,3799
00338600,VALLEY FORGE MILITARY COLLEGE           ,PA,19087-3695,Private      ,14,1,15,365,36,401
00338800,VILLANOVA UNIVERSITY                    ,PA,19085-1699,Private      ,103,272,375,10917,2488,13405
00338801,VILLANOVA UNIV SCH OF LAW               ,PA,19085-0000,Private      ,2,19,21,24,1795,1819
00338900,WASHINGTON & JEFFERSON COLLEGE          ,PA,15301-4801,Private      ,27,0,27,2761,54,2815
00339100,WAYNESBURG UNIVERSITY                   ,PA,15370-1222,Private      ,16,93,109,1995,1001,2996
00339200,WESTMINSTER COLLEGE                     ,PA,16172-0002,Private      ,16,6,22,2512,148,2660
00339300,WESTMINSTER THEOLOGICAL SEMINARY        ,PA,19038-0000,Private      ,0,13,13,2,257,259
00339400,WILKES UNIVERSITY                       ,PA,18766-0998,Private      ,40,90,130,3110,1104,4214
00339500,PENNSYLVANIA COLLEGE OF TECHNOLOGY      ,PA,17701-5779,Public       ,116,226,342,5552,2557,8109
00339600,WILSON COLLEGE                          ,PA,17201-1285,Private      ,9,38,47,458,497,955
00339900,YORK COLLEGE OF PENNSYLVANIA            ,PA,17405-7199,Private      ,114,84,198,7337,1255,8592
00398600,DESALES UNIVERSITY                      ,PA,18034-9568,Private      ,26,114,140,2249,1208,3457
00398700,LA ROCHE COLLEGE                        ,PA,15237-5898,Private      ,16,33,49,978,488,1466
00398800,NEUMANN COLLEGE                         ,PA,19014-1298,Private      ,39,75,114,2871,1098,3969
00405800,GRATZ COLLEGE                           ,PA,19027-3097,Private      ,0,14,14,2,128,130
00445200,MONTGOMERY COUNTY COMMUNITY COLLEGE     ,PA,19422-6300,Public       ,307,692,999,4226,4956,9182
00488700,BRANDYWINE SCHOOL OF NURSING            ,PA,19320-1536,Proprietary  ,0,1,1,23,56,79
00488900,CAMBRIA-ROWE BUSINESS COLLEGE           ,PA,15902-2494,Proprietary  ,6,35,41,168,313,481
00489000,CENTRAL PENNSYLVANIA COLLEGE            ,PA,17093-0309,Proprietary  ,46,98,144,1119,1025,2144
00489300,DU BOIS BUSINESS COLLEGE                ,PA,15801-2401,Proprietary  ,13,43,56,220,398,618
00489400,ERIE BUSINESS CENTER                    ,PA,16501-1305,Proprietary  ,8,58,66,80,500,580
00489401,ERIE BUSINESS CENTER SOUTH              ,PA,16101-0000,Proprietary  ,8,16,24,28,113,141
00489800,MCCANN SCHOOL OF BUSINESS & TECHNOL     ,PA,17901-1335,Proprietary  ,151,471,622,1083,2719,3802
00489807,MCCANN SCHOOL OF BUSINESS & TECHNOLOGY -,PA,17013-3180,Proprietary  ,0,3,3,0,3,3
00489900,MERCY HOSP SCH OF NURSING               ,PA,15219-5166,Private      ,0,8,8,88,136,224
00490100,NEWPORT BUSINESS INSTITUTE              ,PA,15068-3929,Proprietary  ,5,13,18,40,88,128
00490200,PENN COMMERCIAL BUSINESS/TECHNICAL SCHL ,PA,15301-2871,Proprietary  ,12,114,126,257,519,776
00491000,KAPLAN CAREER INSTITUTE                 ,PA,17111-3571,Proprietary  ,35,143,178,322,878,1200
00491001,THOMPSON INSTITUTE-PHILADEPHIA CAMPUS   ,PA,19104-3386,Proprietary  ,67,248,315,375,1346,1721
00491400,NEWPORT BUSINESS INSTITUTE              ,PA,17701-5855,Proprietary  ,1,22,23,23,195,218
00500701,WEST VIRGINIA CAREER INSTITUTE          ,PA,15456-0000,Proprietary  ,14,30,44,80,172,252
00531000,PITTSBURGH INST OF AERONAUTICS          ,PA,15236-0000,Private      ,14,34,48,261,165,426
00533000,FAYETTE CNTY AREA VOC TECH PRC NRSG     ,PA,15401-0000,Public       ,1,13,14,32,108,140
00533500,CENTRAL PENN INST OF SCI & TECH PNP     ,PA,16823-0000,Public       ,9,30,39,79,174,253
00536500,YORK CO AREA VOC-TECH SCH-PRAC NSG      ,PA,17402-0000,Public       ,6,39,45,28,203,231
00594200,UPMC PRESBYTERIAN SCH OF RADIOLOGIC     ,PA,15213-2582,Private      ,0,0,0,15,15,30
00594600,SCHOOL OF RADIOLOGIC TECHNOLOGY AT ST. C,PA,19134-1995,Proprietary  ,1,5,6,17,52,69
00653400,CITIZENS SCHOOL OF NURSING              ,PA,15068-6591,Private      ,1,4,5,101,135,236
00653700,CONEMAUGH VLY MEM HOSP SCH NRSNG        ,PA,15905-4398,Private      ,0,6,6,86,108,194
00653702,CONEMAUGH HOSP- SCH HISTOTECHNOLOGY     ,PA,15905-0000,Private      ,1,2,3,3,12,15
00653704,CONEMAUGH VLY MEM HOSP SCH RAD TECH     ,PA,15905-0000,Private      ,1,0,1,38,13,51
00653706,CONEMAUGH VLY MEM HOSP SCH  MED TECH    ,PA,15905-4398,Private      ,0,1,1,4,8,12
00653900,EPISCOPAL HOSPITAL SCHL OF NURSING      ,PA,19125-1000,Private      ,3,3,6,15,65,80
00655100,ST MARGARET SCHL OF NURSING             ,PA,15238-3205,Private      ,2,16,18,63,175,238
00656000,OHIO VALLEY HOSP SCH OF NURSING         ,PA,15136-1694,Private      ,0,0,0,41,55,96
00656500,READING HOSPITAL SCHOOL OF HEALTH SCIENC,PA,19611-1744,Private      ,1,9,10,219,340,559
00657400,"ST LUKE'S HOSPITAL OF BETHLEHEM, PA     ",PA,18015-1065,Private      ,0,6,6,59,153,212
00657600,SEWICKLEY VALLEY HOSP SCH NRSNG         ,PA,15143-1498,Private      ,0,2,2,46,71,117
00657700,UPMC SHADYSIDE SCHOOL OF NURSING        ,PA,15232-1381,Private      ,7,58,65,153,380,533
00657800,SHARON REGIONAL SCHOOL OF NURSING       ,PA,16146-3395,Private      ,0,3,3,10,56,66
00658200,WASHINGTON HOSP SCH OF NURSING          ,PA,15301-3398,Private      ,0,1,1,53,139,192
00658202,WASHINGTON HOSP SCH OF RAD TECH         ,PA,15301-3398,Private      ,0,0,0,20,16,36
00658300,WESTERN PENN HOSP-SCH OF NURSING        ,PA,15224-1790,Private      ,0,5,5,127,137,264
00680700,COMMUNITY COLLEGE OF BEAVER COUNTY      ,PA,15061-2588,Public       ,72,182,254,1306,1504,2810
00681000,LEHIGH CARBON COMMUNITY COLLEGE         ,PA,18078-2598,Public       ,212,468,680,3089,3688,6777
00681100,LUZERNE COUNTY COMMUNITY COLLEGE        ,PA,18634-3899,Public       ,191,450,641,3424,3611,7035
00708700,ABINGTON MEM HOSP SCHL OF NURSING       ,PA,19090-1284,Private      ,2,7,9,89,319,408
00709100,EVEREST INSTITUTE                       ,PA,15222-1320,Proprietary  ,45,227,272,244,1062,1306
00711000,DELAWARE COUNTY COMMUNITY COLLEGE       ,PA,19063-1094,Public       ,380,757,1137,4668,5865,10533
00719100,NORTHAMPTON COMMUNITY COLLEGE           ,PA,18020-7599,Public       ,352,746,1098,5435,5507,10942
00739802,KATHERINE GIBBS-PHILADELPHIA            ,PA,19403-2422,Proprietary  ,0,3,3,14,34,48
00743000,ANTONELLI INST OF ART & PHOTOGRAPHY     ,PA,19038-8242,Proprietary  ,0,1,1,247,23,270
00743600,KAPLAN CAREER INSTITUTE - ICM CAMPUS    ,PA,15222-1977,Proprietary  ,54,175,229,555,1290,1845
00743700,PITTSBURGH TECHNICAL INSTITUTE          ,PA,15071-3205,Proprietary  ,68,106,174,2407,1068,3475
00746900,"HUSSIAN SCHOOL OF ART, INC.             ",PA,19106-0000,Proprietary  ,4,1,5,124,31,155
00747000,"ART INSTITUTE OF PITTSBURGH, THE        ",PA,15219-1328,Proprietary  ,872,5894,6766,6625,26340,32965
00752900,CTR ART TCH BRDYWN CMPS PRC NRS PRG     ,PA,19320-2459,Public       ,7,21,28,30,147,177
00775900,LINCOLN TECHNICAL INSTITUTE             ,PA,18104-3298,Proprietary  ,49,167,216,415,810,1225
00777900,LANSDALE SCHOOL OF BUSINESS             ,PA,19454-4148,Proprietary  ,14,95,109,128,539,667
00778000,NEW CASTLE SCHOOL OF TRADES             ,PA,16143-9721,Proprietary  ,33,172,205,258,788,1046
00778100,CHI INSTITUTE/RETS CAMPUS               ,PA,19008-3516,Proprietary  ,64,155,219,251,778,1029
00783200,LINCOLN TECH INSTITUTE                  ,PA,19136-1595,Proprietary  ,58,105,163,442,600,1042
00783900,TRIANGLE TECH                           ,PA,15214-3897,Proprietary  ,30,55,85,229,309,538
00791200,THADDEUS STEVENS CLG OF TECHNOLOGY      ,PA,17602-0000,Public       ,17,25,42,1049,426,1475
00791600,FRANKLIN CNTY CAREER & TECH CTR-PNP     ,PA,17201-0000,Public       ,5,19,24,22,60,82
00820000,JAMESON MEMORIAL HOSP SCH NURSING       ,PA,16105-2595,Private      ,1,5,6,28,85,113
00826301,AWARD BEAUTY SCHOOL - CHAMBERSBURG BEAUT,PA,17201-2435,Proprietary  ,0,0,0,3,9,12
00835000,ART INSTITUTE OF PHILADELPHIA           ,PA,19103-5198,Proprietary  ,211,258,469,4064,2574,6638
00844100,ANTHEM INSTITUTE                        ,PA,19064-1243,Proprietary  ,71,223,294,326,928,1254
00856800,VET TECH INSTITUTE                      ,PA,15222-3400,Proprietary  ,27,11,38,312,147,459
00865300,JEFFERSON CO DUBOIS VOC TECH-PR NSG     ,PA,15851-0000,Public       ,0,1,1,31,66,97
00888900,LEHIGH VALLEY COLLEGE                   ,PA,18034-8447,Proprietary  ,0,2,2,32,45,77
00895500,PRUONTOS HAIR DESIGN INSTITUTE & BEAUTY ,PA,16602-0000,Proprietary  ,5,5,10,24,27,51
00915705,WYOMING TECHNICAL INSTITUTE - BLAIRSVILL,PA,15717-8060,Proprietary  ,248,210,458,1707,760,2467
00918600,DEAN INSTITUTE OF TECHNOLOGY            ,PA,15226-1197,Proprietary  ,4,29,33,49,158,207
00944900,PENNCO TECH                             ,PA,19007-0000,Proprietary  ,83,154,237,374,710,1084
00966400,EMPIRE BEAUTY SCHOOL                    ,PA,18052-5730,Proprietary  ,29,47,76,194,299,493
00966500,EMPIRE BEAUTY SCHOOL                    ,PA,17109-2210,Proprietary  ,15,38,53,84,264,348
00966600,EMPIRE BEAUTY SCHOOL                    ,PA,19605-2803,Proprietary  ,13,53,66,96,293,389
00972100,BRADFORD SCHOOL                         ,PA,15219-2602,Proprietary  ,1,7,8,633,138,771
00972300,FRANKFORD HOSP SCH OF NURSING           ,PA,19124-2696,Private      ,10,12,22,203,301,504
00978300,GORDON PHILLIPS SCH OF BEAUTY CULT      ,PA,19135-0000,Proprietary  ,26,103,129,229,441,670
00986300,LANCASTER GENERAL COLLEGE OF NURSING AND,PA,17602-4955,Private      ,16,41,57,403,665,1068
01000600,GREATER JOHNSTOWN AREA VOC TECH SCH     ,PA,15904-0000,Public       ,3,23,26,79,295,374
01005500,CRAWFORD CNTY AREA VO-TECH PRAC NUR     ,PA,16335-0000,Public       ,0,1,1,7,46,53
01017600,WESTMORELAND COUNTY COMMUNITY CLG       ,PA,15697-1895,Public       ,186,474,660,2793,3684,6477
01038800,READING AREA COMMUNITY COLLEGE          ,PA,19603-1706,Public       ,159,538,697,2194,4044,6238
01054100,EMPIRE BEAUTY SCHOOL                    ,PA,15146-2229,Proprietary  ,16,56,72,166,338,504
01054200,EMPIRE BEAUTY SCHOOL                    ,PA,18701-0000,Proprietary  ,22,46,68,162,266,428
01054300,EMPIRE BEAUTY SCHOOL                    ,PA,17701-3914,Proprietary  ,19,36,55,106,195,301
01081400,PITTSBURGH INST MORTUARY SCIENCE        ,PA,15206-3706,Private      ,9,34,43,89,216,305
01086000,GREATER ALTOONA CAREER/TECH CENTER      ,PA,16602-0000,Public       ,1,10,11,57,258,315
01096300,GREENE COUNTY VOC-TECH SCHOOL           ,PA,15370-0000,Public       ,0,0,0,8,41,49
01097000,EMPIRE BEAUTY SCHOOL                    ,PA,17042-5209,Proprietary  ,2,22,24,30,80,110
01099800,PENNSYLVANIA INSTITUTE OF TECH          ,PA,19063-4098,Private      ,70,138,208,636,1092,1728
01102000,EMPIRE BEAUTY SCHOOL                    ,PA,17604-4335,Proprietary  ,18,40,58,116,237,353
01102100,EMPIRE BEAUTY SCHOOL                    ,PA,17402-2862,Proprietary  ,32,72,104,177,512,689
01162100,AUTOMOTIVE TRAINING CENTER              ,PA,19341-1310,Proprietary  ,53,34,87,559,242,801
01162200,WELDER TRAINING & TESTING INST          ,PA,18109-3253,Proprietary  ,9,19,28,45,98,143
01163800,EMPIRE BEAUTY SCHOOL                    ,PA,17876-0000,Proprietary  ,3,11,14,35,67,102
01171500,POTTSVILLE HOSPITAL SCHOOL OF NURSING   ,PA,17901-3692,Private      ,0,2,2,56,46,102
01191900,BEAVER FALLS BEAUTY ACADEMY             ,PA,15010-4208,Proprietary  ,1,7,8,20,54,74
01205000,ROSEDALE TECHNICAL INSTITUTE            ,PA,15205-9791,Private      ,24,35,59,212,240,452
01239300,THOMAS JEFF UNIV-CLG ALLIED HEALTH      ,PA,19107-0000,Private      ,5,34,39,306,1059,1365
01239301,JEFFERSON MED CLG-T. JEFFERSON UNIV     ,PA,19107-5587,Private      ,3,25,28,168,1522,1690
01239303,THOMAS JEFFERSON UNIV-GRADUATE COLG     ,PA,19107-0000,Private      ,2,56,58,190,1090,1280
01246104,LINCOLN TECHNICAL INSTITUTE             ,PA,19104-0202,Proprietary  ,112,290,402,474,1052,1526
01246105,LINCOLN TECHNICAL INSTITUTE             ,PA,19116-4202,Proprietary  ,34,93,127,276,529,805
01252300,TALMUDICAL YESHIVA OF PHILA             ,PA,19131-1296,Private      ,30,0,30,33,0,33
01260500,EMPIRE BEAUTY SCHOOL                    ,PA,17331-2405,Proprietary  ,10,24,34,51,97,148
01260600,EMPIRE BEAUTY SCHOOL                    ,PA,17901-2505,Proprietary  ,21,65,86,139,425,564
01260700,EMPIRE BEAUTY SCHOOL                    ,PA,16801-5218,Proprietary  ,2,2,4,15,18,33
01292900,SOUTH HILLS BEAUTY ACADEMY              ,PA,15216-2335,Proprietary  ,7,20,27,32,56,88
01301500,GORDON PHILLIPS SCH BEAUTY CULTURE      ,PA,19102-2701,Proprietary  ,48,100,148,272,586,858
01313400,YESHIVATH BETH MOSHE                    ,PA,18505-2196,Private      ,17,0,17,51,1,52
01321400,ROXBOROUGH MEM HOSP SCH OF NURSING      ,PA,19128-0000,Proprietary  ,0,4,4,70,174,244
01326300,SOUTH HILLS SCH OF BUS & TECHNOLOGY     ,PA,16801-4516,Proprietary  ,22,41,63,466,531,997
01326304,SOUTH HILLS SCHOOL OF BUSINESS & TECHNOL,PA,16602-1188,Proprietary  ,1,8,9,46,39,85
02061000,VENUS BEAUTY ACADEMY                    ,PA,19079-0000,Proprietary  ,6,16,22,55,60,115
02068300,DOUGLAS SCHOOL OF BUSINESS              ,PA,15062-0000,Proprietary  ,17,30,47,285,245,530
02090200,TRIANGLE TECH                           ,PA,16502-0000,Proprietary  ,6,37,43,111,211,322
02092500,LAUREL TECHNICAL INSTITUTE              ,PA,16146-0000,Proprietary  ,8,32,40,93,342,435
02092502,BUSINESS INSTITUTE OF PENNSYLVANIA      ,PA,16335-0000,Proprietary  ,0,4,4,4,23,27
02107300,PENNSYLVANIA ACADEMY OF FINE ARTS       ,PA,19102-1424,Private      ,5,9,14,222,260,482
02112200,GREAT LAKES INSTITUTE OF TECHNOLOGY     ,PA,16509-0000,Proprietary  ,38,114,152,276,608,884
02114200,JOHNSON COLLEGE                         ,PA,18508-0000,Private      ,17,15,32,452,243,695
02116001,SANFORD-BROWN INSTITUTE - TREVOSE       ,PA,19053-4700,Proprietary  ,61,208,269,415,1368,1783
02118000,LEVITTOWN BEAUTY ACADEMY LLC            ,PA,19054-1713,Proprietary  ,0,8,8,32,41,73
02119300,PA ACAD OF COSMETOLOGY ARTS & SCI       ,PA,15904-0000,Proprietary  ,4,21,25,70,96,166
02119301,PA ACAD OF COSMTLGY ARTS & SCI          ,PA,15801-0000,Proprietary  ,1,1,2,6,1,7
02120800,"YORKTOWNE BUSINESS INSTITUTE, INC.      ",PA,17404-0000,Proprietary  ,7,38,45,125,295,420
02127400,YORK TECHNICAL INSTITUTE                ,PA,17402-0000,Proprietary  ,136,313,449,1267,1838,3105
02129000,TRIANGLE TECH                           ,PA,15601-0000,Proprietary  ,27,53,80,281,330,611
02129001,TRIANGLE TECH - BUSINESS CAREERS INSTITU,PA,15601-3304,Proprietary  ,0,2,2,4,12,16
02144000,"VISION ACADEMY, THE                     ",PA,18103-0000,Proprietary  ,11,24,35,43,81,124
02149000,EMPIRE BEAUTY SCHOOL                    ,PA,19341-2804,Proprietary  ,11,20,31,72,123,195
02151500,CENTRAL SUSQUEHANNA LPN CENTER          ,PA,17847-0000,Public       ,1,6,7,30,156,186
02152105,ACADEMY OF COURT REPORTING AND TECHNOLOG,PA,15222-1710,Proprietary  ,10,40,50,47,258,305
02153500,OAKBRIDGE ACADEMY OF ARTS               ,PA,15068-0000,Proprietary  ,4,1,5,66,22,88
02158300,JUNIATA-MIFFLIN CO AREA VOC TECH        ,PA,17044-0000,Public       ,1,1,2,20,58,78
02161400,NORTHEASTERN HOSP SCH OF NRSG           ,PA,19134-0000,Private      ,2,6,8,46,135,181
02169600,CLEARFIELD CTY CAREER AND TECH CNTR     ,PA,16830-0000,Public       ,2,19,21,35,149,184
02174400,TRIANGLE TECH                           ,PA,15801-0000,Proprietary  ,23,54,77,323,428,751
02178900,ACADEMY OF HAIR DESIGN                  ,PA,18202-1465,Proprietary  ,3,5,8,20,28,48
02183000,ORLEANS TECHNICAL INSTITUTE             ,PA,19111-0000,Private      ,58,173,231,190,685,875
02192800,WALNUT HILL COLLEGE                     ,PA,19104-0000,Proprietary  ,22,31,53,453,274,727
02202300,SANFORD-BROWN INSTITUTE                 ,PA,15219-1907,Proprietary  ,31,143,174,385,1118,1503
02202301,SANFORD-BROWN INSTITUTE                 ,PA,15146-2141,Proprietary  ,18,93,111,182,670,852
02203900,ERIE INSTITUTE OF TECHNOLOGY            ,PA,16565-1002,Proprietary  ,9,57,66,116,332,448
02206200,AMBLER BEAUTY ACADEMY                   ,PA,19002-0000,Proprietary  ,12,25,37,64,112,176
02206300,STROUDSBURG SCHOOL OF COSMETOLOGY       ,PA,18360-0000,Proprietary  ,3,2,5,19,24,43
02212700,LANCASTER SCHOOL OF COSMETOLOGY         ,PA,17602-0000,Proprietary  ,15,37,52,52,155,207
02234200,ACADEMY OF MEDICAL ARTS & BUSINESS      ,PA,17112-0000,Proprietary  ,17,70,87,137,322,459
02251200,SCHUYLKILL COUNTY AREA VOC TECH SCH     ,PA,17931-0000,Public       ,4,10,14,29,94,123
02251202,SCHUYLKILL COUNTY AREA VOC TECH SCH     ,PA,17931-0000,Public       ,2,21,23,13,69,82
02253900,BERKS TECHNICAL INSTITUTE               ,PA,19610-0000,Proprietary  ,50,115,165,542,840,1382
02255200,PENNSYLVANIA SCHOOL OF BUSINESS         ,PA,18101-1604,Proprietary  ,34,101,135,175,698,873
02269900,PENNSYLVANIA COLLEGE OF ART & DESIGN    ,PA,17603-3528,Private      ,3,6,9,394,60,454
02270500,BUCKS COUNTY SCHOOL OF BEAUTY CULT      ,PA,19053-0000,Proprietary  ,4,5,9,45,40,85
02273400,RECONSTRUCTIONIST RABBINICAL COLLEG     ,PA,19095-0000,Private      ,0,1,1,0,28,28
02276600,HANOVER PUBLIC SCH DIST PRAC NURSG      ,PA,17331-0000,Public       ,7,18,25,10,53,63
02282500,LENAPE SCHOOL OF PRACTICAL NURSING      ,PA,16226-0000,Public       ,6,32,38,36,179,215
02288800,EMPIRE BEAUTY SCHOOL                    ,PA,18974-4508,Proprietary  ,4,19,23,57,105,162
02289500,PACE INSTITUTE                          ,PA,19601-0000,Proprietary  ,6,30,36,94,315,409
02289600,CONSOLIDATED SCHOOL OF BUSINESS         ,PA,17404-0000,Proprietary  ,2,40,42,35,205,240
02289700,ACADEMY OF CREATIVE HAIR DESIGN         ,PA,18702-0000,Proprietary  ,14,27,41,47,104,151
02289800,CHI INSTITUTE - FRANKLIN MILLS          ,PA,19154-0000,Proprietary  ,56,175,231,476,1261,1737
02290400,"ALTOONA BEAUTY SCHOOL, INC              ",PA,16602-0000,Proprietary  ,5,17,22,27,66,93
02292700,LANSDALE SCHOOL OF COSMETOLOGY          ,PA,19446-0000,Proprietary  ,8,8,16,30,37,67
02299300,TRINITY EPISCOPAL SCHOOL MINISTRY       ,PA,15003-0000,Private      ,0,2,2,1,83,84
02301300,PJA SCHOOL (THE)                        ,PA,19082-1917,Proprietary  ,14,95,109,85,438,523
02304400,YTI CAREER INSTITUTE - MECHANICSBURG    ,PA,17055-0000,Proprietary  ,12,55,67,147,313,460
02306200,VENANGO COUNTY AREA VOC TECH SCHOOL     ,PA,16301-0000,Public       ,0,0,0,22,63,85
02310800,LANCASTER COUNTY CAREER & TECH CTR      ,PA,17584-0000,Public       ,22,68,90,178,684,862
02330300,LEBANON CO CAREER & TECHNOLOGY CTR      ,PA,17042-0000,Public       ,2,6,8,25,140,165
02330600,PENNSYLVANIA GUNSMITH SCHOOL            ,PA,15202-0000,Proprietary  ,4,17,21,34,68,102
02350100,WESTERN AREA CAREER & TECHNOLOGY CT     ,PA,15317-0000,Public       ,0,3,3,18,78,96
02350200,INDIANA COUNTY TECH CTR SCH PR NSG      ,PA,15701-1465,Public       ,1,10,11,35,105,140
02353100,NORTHERN TIER CAREER CENTER             ,PA,18848-0000,Public       ,0,0,0,18,55,73
02361002,ITT TECHNICAL INSTITUTE                 ,PA,19406-0000,Proprietary  ,62,128,190,362,589,951
02362300,MERCER COUNTY AREA VOC TECH SCHOOL      ,PA,16137-0000,Public       ,4,9,13,17,90,107
02492500,DELAWARE VLY ACAD MED DNTL ASSTS        ,PA,19114-0000,Proprietary  ,7,24,31,50,128,178
02492600,EASTERN CTR ARTS AND TECH PR NSG        ,PA,19090-0000,Public       ,3,22,25,20,160,180
02495500,ALL-STATE CAREER SCHOOL                 ,PA,19029-0000,Proprietary  ,40,223,263,257,970,1227
02529800,WILKES BARRE AREA CAREER AND TECHNICAL C,PA,18705-0000,Public       ,5,28,33,56,209,265
02536600,COMMONWEALTH TECH INSTIT @ HIRAM G      ,PA,15905-0000,Public       ,27,11,38,249,116,365
02539900,STAR TECHNICAL INSTITUTE                ,PA,19082-0000,Proprietary  ,0,0,0,0,3,3
02544300,BUTLER BEAUTY SCHOOL                    ,PA,16001-0000,Proprietary  ,11,21,32,62,120,182
02545000,LAWRENCE COUNTY CAREER AND TECHNICAL CEN,PA,16101-0000,Public       ,2,15,17,20,84,104
02546200,LAUREL BUSINESS INSTITUTE               ,PA,15401-0877,Proprietary  ,11,34,45,192,282,474
02550000,CLARION CO AREA VOC-TECH PRAC NRSG      ,PA,16254-0000,Public       ,2,5,7,24,92,116
02554500,HAZLETON AREA CAREER CENTER PRACTICAL NU,PA,18201-0000,Public       ,1,2,3,19,44,63
02557800,ART INSTITUTE OF YORK (THE) - PENNSYLVAN,PA,17402-9012,Proprietary  ,39,33,72,745,284,1029
02566400,ALBERT EINSTEIN MED CTR DEPT DNTL       ,PA,19141-3098,Private      ,0,0,0,10,18,28
02574800,PENNSYLVANIA INSTITUTE OF TAXIDERMY     ,PA,15931-0000,Proprietary  ,1,12,13,11,34,45
02609500,CAREER TRAINING ACADEMY                 ,PA,15068-6308,Proprietary  ,6,31,37,76,239,315
02609501,CAREER TRAINING ACADEMY                 ,PA,15146-0000,Proprietary  ,0,3,3,2,20,22
02615400,STAR TECHNICAL INSTITUTE                ,PA,19114-2204,Proprietary  ,0,0,0,3,9,12
02616100,JEAN MADELINE ED CTR FOR COSM           ,PA,19147-1542,Proprietary  ,30,43,73,306,283,589
03006800,PENNSYLVANIA CULINARY INSTITUTE         ,PA,15222-3511,Proprietary  ,89,119,208,637,634,1271
03010800,TRI-STATE BUSINESS INSTITUTE            ,PA,16506-1013,Proprietary  ,80,392,472,910,2673,3583
03011500,ALLIED MEDICAL AND TECHNICAL INSTITUTE  ,PA,18702-0000,Proprietary  ,34,81,115,218,451,669
03011600,ALLIED MEDICAL AND TECHNICAL INSTITUTE  ,PA,18509-2903,Proprietary  ,21,98,119,209,460,669
03029900,CONSOLIDATED SCHOOL OF BUSINESS         ,PA,17603-2389,Proprietary  ,5,31,36,35,187,222
03031600,DPT BUSINESS SCHOOL                     ,PA,19116-3961,Proprietary  ,29,113,142,80,473,553
03031601,DPT BUSINESS SCHOOL                     ,PA,19106-0000,Proprietary  ,20,47,67,67,290,357
03067000,ANTONELLI MEDICAL & PROF INST           ,PA,19464-9244,Proprietary  ,1,19,20,8,71,79
03072400,ALL-STATE CAREER SCHOOL                 ,PA,15122-1000,Proprietary  ,12,49,61,25,195,220
03072600,DCI CAREER INSTITUTE                    ,PA,15061-2307,Proprietary  ,10,40,50,55,185,240
03081900,YTI CAREER INSTITUTE - ALTOONA          ,PA,16602-4457,Proprietary  ,23,56,79,142,367,509
03090800,LAKE ERIE COLL OF OSTEOPATHIC MED       ,PA,16509-0000,Private      ,0,16,16,96,2899,2995
03098600,CAREER TECH CTR OF LACKAWANNA CNTY      ,PA,18508-0000,Public       ,3,8,11,31,128,159
03101500,BIDWELL TRAINING CENTER                 ,PA,15233-2233,Private      ,5,46,51,12,81,93
03103300,JNA INSTITUTE OF CULINARY ARTS          ,PA,19146-3119,Proprietary  ,12,19,31,59,123,182
03109100,METROPOLITAN CAREER CENTER              ,PA,19144-0000,Private      ,11,40,51,50,188,238
03110700,AVIATION INSTITUTE OF MAINTENANCE       ,PA,19114-1017,Proprietary  ,26,81,107,134,384,518
03120400,REGIONAL CAREER & TECHNICAL CENTER      ,PA,16509-4699,Public       ,0,0,0,1,11,12
03128400,DELAWARE COUNTY TECHNICAL SCHOOL        ,PA,19032-1998,Public       ,4,7,11,29,141,170
03180400,PENNSYLVANIA HIGHLANDS COMMUNITY COLLEGE,PA,15904-2927,Public       ,49,108,157,761,857,1618
03236400,LT INTERNATIONAL BEAUTY SCHOOL          ,PA,19130-2235,Proprietary  ,4,49,53,8,103,111
03353300,ACADEMY OF VOCAL ARTS                   ,PA,19103-6685,Private      ,0,3,3,9,36,45
03380301,CULINARY ACADEMY OF LONG ISLAND - STAR P,PA,19114-2204,Proprietary  ,31,146,177,110,515,625
03439400,NAWCC SCHOOL OF HOROLOGY                ,PA,17512-2130,Private      ,0,1,1,3,11,14
03535300,HUNTINGDON COUNTY CAREER AND TECHNO     ,PA,17060-0905,Public       ,0,1,1,10,35,45
03561400,SUSQUEHANNA COUNTY CAREER & TECHNOL     ,PA,18816-0100,Public       ,0,2,2,5,9,14
03766300,PENNSYLVANIA SCHOOL OF MUSCLE THERAPY   ,PA,19406-3101,Proprietary  ,1,23,24,39,133,172
03899300,CALVARY BAPTIST THEOLOGICAL SEMINARY    ,PA,19446-4718,Private      ,0,3,3,0,7,7
03923300,PRECISION MANUFACTURING INSTITUTE       ,PA,16335-8380,Private      ,0,6,6,13,61,74
03948300,HARRISBURG UNIVERSITY OF SCIENCE AND TEC,PA,17101-2116,Private      ,3,23,26,173,194,367
03949300,WON INSTITUTE OF GRADUATE STUDIES       ,PA,19038-4535,Private      ,0,1,1,1,35,36
03950500,NORTHWEST REGIONAL TECHNOLOGY INSTITUTE ,PA,16508-2820,Proprietary  ,1,32,33,7,78,85
03952300,NATIONAL MASSAGE THERAPY INSTITUTE      ,PA,19116-3965,Proprietary  ,32,166,198,145,533,678
04024300,EDUCATION AND TECHNOLOGY INSTITUTE      ,PA,15601-9214,Private      ,0,9,9,3,22,25
04119900,PENNSYLVANIA MYOTHERAPY INSTITUTE       ,PA,17350-8426,Proprietary  ,1,2,3,2,14,16
04127500,CAREER DEVELOPMENT & EMPLOYMENT         ,PA,18702-5253,Proprietary  ,1,11,12,5,29,34
04137100,KIMBERLY'S BEAUTY SCHOOL                ,PA,19134-0000,Proprietary  ,0,13,13,3,42,45
04138300,INTERNATIONAL BEAUTY ACADEMY            ,PA,19149-2710,Proprietary  ,1,14,15,11,54,65
04145800,PULSE BEAUTY ACADEMY A PAUL MITCHELL PAR,PA,19335-0000,Proprietary  ,13,20,33,43,43,86
04158000,METRO BEAUTY ACADEMY                    ,PA,18106-9693,Proprietary  ,10,7,17,10,7,17
00267813,BRYANT & STRATTON COLLEGE - MIL DOWNTOWN,WI,53203-2608,Proprietary  ,76,320,396,671,2547,3218
00383200,ALVERNO COLLEGE                         ,WI,53234-3922,Private      ,41,157,198,1425,2339,3764
00383500,BELOIT COLLEGE                          ,WI,53511-5595,Private      ,13,5,18,1871,105,1976
00383700,CARDINAL STRITCH UNIVERSITY             ,WI,53217-9884,Private      ,36,778,814,1032,4563,5595
00383800,CARROLL UNIVERSITY                      ,WI,53186-5593,Private      ,30,40,70,3248,741,3989
00383900,CARTHAGE COLLEGE                        ,WI,53141-0000,Private      ,45,70,115,4372,746,5118
00384000,WESTERN TECHNICAL COLLEGE               ,WI,54601-0908,Public       ,147,361,508,2019,2770,4789
00384200,CONCORDIA UNIVERSITY WISCONSIN          ,WI,53097-2402,Private      ,29,433,462,2348,3654,6002
00384800,EDGEWOOD COLLEGE                        ,WI,53711-1958,Private      ,15,73,88,1518,1047,2565
00385000,SILVER LAKE COLLEGE                     ,WI,54220-9319,Private      ,3,46,49,196,424,620
00385400,LAKELAND COLLEGE                        ,WI,53082-0000,Private      ,20,202,222,1136,2027,3163
00385600,LAWRENCE UNIVERSITY                     ,WI,54912-0599,Private      ,20,3,23,2334,94,2428
00386100,MARIAN UNIVERSITY                       ,WI,54935-4699,Private      ,22,126,148,1375,1318,2693
00386300,MARQUETTE UNIVERSITY                    ,WI,53201-0000,Private      ,96,173,269,12405,4251,16656
00386600,MILWAUKEE AREA TECH COLLEGE             ,WI,53233-1443,Public       ,731,2684,3415,6149,16990,23139
00386800,MILWAUKEE SCHOOL OF ENGINEERING         ,WI,53202-3109,Private      ,36,56,92,2655,715,3370
00386900,MOUNT MARY COLLEGE                      ,WI,53222-4597,Private      ,26,115,141,891,1512,2403
00387400,NASHOTAH HOUSE                          ,WI,53058-0000,Private      ,0,6,6,1,41,42
00387500,NORTHLAND COLLEGE                       ,WI,54806-3999,Private      ,9,10,19,747,127,874
00388400,RIPON COLLEGE                           ,WI,54971-0248,Private      ,17,3,20,1351,62,1413
00389200,ST. NORBERT COLLEGE                     ,WI,54115-2002,Private      ,29,11,40,2353,115,2468
00389500,UNIVERSITY OF WISCONSIN-MADISON         ,WI,53715-1382,Public       ,322,412,734,22628,10978,33606
00389600,UNIVERSITY OF WISCONSIN-MILWAUKEE       ,WI,53201-3165,Public       ,522,942,1464,17520,11813,29333
00389700,UNIVERSITY OF WISCONSIN COLLEGES        ,WI,53708-8680,Public       ,115,200,315,1864,1510,3374
00389701,UNIVERSITY OF WISCONSIN-BARABOO         ,WI,53913-1098,Public       ,14,23,37,324,155,479
00389702,UNIVERSITY OF WISCONSIN-BARRON          ,WI,54868-2497,Public       ,16,22,38,271,182,453
00389703,UNIVERSITY OF WISCONSIN-FOND DU LAC     ,WI,54935-2998,Public       ,15,20,35,472,217,689
00389704,UNIVERSITY OF WISCONSIN-FOX VALLEY      ,WI,54952-1297,Public       ,24,53,77,823,502,1325
00389705,UNIVERSITY OF WISCONSIN-MANITOWOC       ,WI,54220-6699,Public       ,6,17,23,243,141,384
00389706,UNIVERSITY OF WISCONSIN-MARATHON        ,WI,54401-5396,Public       ,35,41,76,819,355,1174
00389707,UNIVERSITY OF WISCONSIN-MARINETTE       ,WI,54143-4299,Public       ,11,17,28,257,141,398
00389708,UNIVERSITY OF WISCONSIN-MARSHFIELD      ,WI,54449-3310,Public       ,12,16,28,304,177,481
00389709,UNIVERSITY OF WISCONSIN-RICHLAND        ,WI,53581-1399,Public       ,5,16,21,255,89,344
00389710,UNIVERSITY OF WISCONSIN COLLEGES - ROCK ,WI,53546-5699,Public       ,42,55,97,662,415,1077
00389711,UNIVERSITY OF WISCONSIN-SHEBOYGAN       ,WI,53081-4789,Public       ,20,36,56,433,261,694
00389712,UNIVERSITY OF WISCONSIN-WASHINGTON      ,WI,53095-3699,Public       ,32,32,64,511,247,758
00389713,UNIVERSITY OF WISCONSIN-WAUKESHA        ,WI,53188-2799,Public       ,38,59,97,995,470,1465
00389900,UNIVERSITY OF WISCONSIN-GREEN BAY       ,WI,54311-7001,Public       ,62,187,249,4505,2013,6518
00391100,VITERBO UNIVERSITY                      ,WI,54601-4777,Private      ,21,96,117,1680,1154,2834
00391500,UNIVERSITY OF WISCONSIN-STOUT           ,WI,54751-0790,Public       ,123,180,303,6046,2068,8114
00391700,UNIVERSITY OF WISCONSIN-EAU CLAIRE      ,WI,54702-4004,Public       ,164,132,296,8429,1812,10241
00391900,UNIVERSITY OF WISCONSIN-LA CROSSE       ,WI,54601-3742,Public       ,130,124,254,7302,1670,8972
00392000,UNIVERSITY OF WISCONSIN-OSHKOSH         ,WI,54901-8604,Public       ,148,201,349,7573,3234,10807
00392100,UNIVERSITY OF WISCONSIN-PLATTEVILLE     ,WI,53818-3099,Public       ,102,178,280,5638,1647,7285
00392300,UNIVERSITY OF WISCONSIN-RIVER FALLS     ,WI,54022-5013,Public       ,109,127,236,5071,1323,6394
00392400,UNIVERSITY OF WISCONSIN-STEVENS POINT   ,WI,54481-3871,Public       ,124,118,242,7099,1837,8936
00392500,UNIVERSITY OF WISCONSIN-SUPERIOR        ,WI,54880-2898,Public       ,56,127,183,1657,1381,3038
00392600,UNIVERSITY OF WISCONSIN-WHITEWATER      ,WI,53190-1792,Public       ,157,187,344,8186,2461,10647
00400700,MADISON AREA TECHNICAL COLLEGE          ,WI,53704-2599,Public       ,431,1163,1594,4547,7466,12013
00501500,UNIVERSITY OF WISCONSIN-PARKSIDE        ,WI,53141-2000,Public       ,115,206,321,3455,2267,5722
00529400,WAUKESHA COUNTY TECHNICAL COLLEGE       ,WI,53072-4696,Public       ,130,420,550,1630,3047,4677
00530100,NORTHEAST WISCONSIN TECHNICAL COLLEGE   ,WI,54307-9042,Public       ,236,733,969,2651,5171,7822
00530400,CHIPPEWA VALLEY TECHNICAL COLLEGE       ,WI,54701-6162,Public       ,169,470,639,2374,3542,5916
00538000,MID-STATE TECHNICAL COLLEGE             ,WI,54494-5512,Public       ,105,304,409,905,2191,3096
00538400,NICOLET AREA TECHNICAL COLLEGE          ,WI,54501-0000,Public       ,47,181,228,488,968,1456
00538700,NORTHCENTRAL TECHNICAL COLLEGE          ,WI,54401-1899,Public       ,99,413,512,1071,2732,3803
00538900,GATEWAY TECHNICAL COLLEGE               ,WI,53144-1690,Public       ,257,1091,1348,2034,6818,8852
00539000,BLACKHAWK TECHNICAL COLLEGE             ,WI,53547-5009,Public       ,103,436,539,967,3043,4010
00610800,BELLIN HOSP SCH OF RAD TECH             ,WI,54305-3505,Private      ,0,2,2,20,19,39
00611500,MERCY MED CTR SCH OF RAD TECH           ,WI,54904-3370,Private      ,0,0,0,7,14,21
00612601,ST LUKE'S MEDCL CTR SCHL RAD TECH       ,WI,53215-4330,Private      ,0,5,5,8,44,52
00612603,ST LUKE'S MED CTR SCH OF SONOGRAPHY     ,WI,53215-0000,Private      ,0,7,7,8,37,45
00613100,THEDA CLARK REG MED CTR SCH RAD TEC     ,WI,54957-0000,Private      ,0,2,2,7,20,27
00663900,BELLIN COLLEGE                          ,WI,54305-0000,Private      ,2,9,11,216,173,389
00766900,SOUTHWEST WISCONSIN TECH COLLEGE        ,WI,53809-0000,Public       ,28,119,147,700,891,1591
00821700,WISCONSIN COLLEGE OF COSMETOLOGY        ,WI,54304-0000,Proprietary  ,4,8,12,53,56,109
00919400,LAKESHORE TECHNICAL COLLEGE             ,WI,53015-1412,Public       ,62,350,412,679,2229,2908
00925600,MORAINE PARK TECHNICAL COLLEGE          ,WI,54936-0000,Public       ,103,413,516,1034,2867,3901
00941900,STATE CLG OF BEAUTY CULT-WAUSAU         ,WI,54403-4667,Proprietary  ,6,22,28,62,76,138
00962100,HERZING COLLEGE                         ,WI,53718-4236,Proprietary  ,73,867,940,761,5100,5861
00974400,FOX VALLEY TECHNICAL COLLEGE            ,WI,54913-0000,Public       ,217,830,1047,2717,5042,7759
01091300,MADISON MEDIA INSTITUTE                 ,WI,53718-6787,Proprietary  ,28,41,69,399,307,706
01148400,ADVANCED INSTITUTE OF HAIR DESIGN       ,WI,53225-0000,Proprietary  ,23,49,72,188,241,429
01182400,WISCONSIN INDIANHEAD TECH CLG WITC      ,WI,54871-9300,Public       ,100,368,468,1171,2421,3592
02077100,MILWAUKEE INST OF ART & DESIGN          ,WI,53202-0000,Private      ,21,17,38,837,184,1021
02078000,SACRED HEART SCHOOL OF THEOLOGY         ,WI,53130-0000,Private      ,0,1,1,0,4,4
02136600,WISCONSIN LUTHERAN COLLEGE              ,WI,53226-0000,Private      ,15,10,25,899,94,993
02201803,KAPLAN COLLEGE - MILWAUKEE              ,WI,53212-3939,Proprietary  ,59,229,288,241,1089,1330
02239204,HIGH-TECH INSTITUTE - MILWAUKEE         ,WI,53005-4207,Proprietary  ,0,8,8,17,26,43
02271300,WI SCH OF PROFESSIONAL PSYCHOLOGY       ,WI,53225-0000,Private      ,0,6,6,3,95,98
02317200,MARANATHA BAPTIST BIBLE COLLEGE         ,WI,53094-0000,Private      ,50,15,65,797,127,924
02324700,EMPIRE BEAUTY SCHOOL                    ,WI,53717-0000,Proprietary  ,2,30,32,57,181,238
02332100,EMPIRE BEAUTY SCHOOL                    ,WI,54220-0000,Proprietary  ,21,46,67,87,208,295
02332101,EMPIRE BEAUTY SCHOOL - APPLETON         ,WI,54914-4644,Proprietary  ,0,4,4,11,16,27
02453500,MEDICAL COLLEGE OF WISCONSIN            ,WI,53226-0000,Private      ,2,9,11,16,1153,1169
02494300,GILL-TECH ACADEMY OF HAIR DESIGN        ,WI,54911-0000,Proprietary  ,10,16,26,81,69,150
02503303,RASMUSSEN COLLEGE - MANKATO - GREEN BAY ,WI,54303-2349,Proprietary  ,42,234,276,201,1088,1289
02532200,LAC COURTE OREILLES OJIBWA CMTY CLG     ,WI,54843-0000,Public       ,8,47,55,72,417,489
03007400,LAKESIDE SCHOOL OF MASSAGE THERAPY      ,WI,53719-1103,Private      ,2,28,30,34,117,151
03061200,MIDWEST COLLEGE OF ORIENTAL MEDICINE    ,WI,53403-9747,Proprietary  ,1,46,47,2,216,218
03077600,EMPIRE BEAUTY SCHOOL                    ,WI,54304-4838,Proprietary  ,26,74,100,185,394,579
03087500,ITT TECHNICAL INSTITUTE                 ,WI,53220-4612,Proprietary  ,333,772,1105,1329,3375,4704
03125100,COLLEGE OF MENOMINEE NATION             ,WI,54135-0000,Private      ,13,68,81,135,574,709
03125102,COLLEGE OF  THE MENOMINEE NATION - GREEN,WI,54304-4964,Private      ,1,14,15,19,93,112
03220300,"SALON PROFESSIONAL ACADEMY, THE         ",WI,54701-7633,Proprietary  ,5,14,19,68,79,147
03309300,MONTESSORI INSTITUTE OF MILWAUKEE       ,WI,53207-0000,Private      ,0,2,2,3,28,31
03808300,INSTITUTE OF BEAUTY AND WELLNESS (THE)  ,WI,53202-5715,Proprietary  ,10,32,42,73,137,210
03822300,FOUR SEASONS SALON AND COSMETOLOGY SCHOO,WI,53566-0000,Proprietary  ,1,2,3,13,20,33
03872500,NORTHLAND INTERNATIONAL UNIVERSITY      ,WI,54119-9285,Private      ,17,5,22,460,65,525
03925300,BLUE SKY SCHOOL OF PROFESSIONAL MASSAGE ,WI,53024-9699,Private      ,2,18,20,40,132,172
04117400,MILWAUKEE CAREER COLLEGE                ,WI,53222-4305,Proprietary  ,41,203,244,182,838,1020
04118600,ACADEMY OF COSMETOLOGY                  ,WI,53548-3307,Proprietary  ,3,9,12,20,57,77
04124800,VISIONS IN HAIR DESIGN INSTITUTE OF COSM,WI,53210-1120,Proprietary  ,1,10,11,12,26,38
04132600,WISCONSIN ACADEMY (THE)                 ,WI,54157-1726,Proprietary  ,0,5,5,16,46,62
04137900,PC PROSCHOOLS                           ,WI,53005-6003,Proprietary  ,11,23,34,28,47,75
04138200,SALON PROFESSIONAL ACADEMY (THE)        ,WI,54914-3921,Proprietary  ,6,4,10,64,56,120
04157700,SALON PROFESSIONAL ACADEMY (THE)        ,WI,54650-8699,Proprietary  ,24,34,58,24,34,58
00290500,NORTH CAROLINA A&T STATE UNIV           ,NC,27411-0001,Public       ,328,497,825,12911,5533,18444
00290600,APPALACHIAN STATE UNIVERSITY            ,NC,28608-2059,Public       ,339,265,604,14909,3956,18865
00290700,UNIVERSITY OF NC AT ASHEVILLE           ,NC,28804-3299,Public       ,81,140,221,3443,1450,4893
00290800,BARTON COLLEGE                          ,NC,27893-3104,Private      ,22,60,82,1476,722,2198
00291000,BELMONT ABBEY COLLEGE                   ,NC,28012-1802,Private      ,28,143,171,1213,1226,2439
00291100,BENNETT COLLEGE                         ,NC,27401-3239,Private      ,27,29,56,1167,328,1495
00291200,BREVARD COLLEGE                         ,NC,28712-3306,Private      ,18,7,25,899,137,1036
00291300,CAMPBELL UNIVERSITY                     ,NC,27506-0036,Private      ,93,182,275,3982,3228,7210
00291400,CATAWBA COLLEGE                         ,NC,28144-2488,Private      ,35,48,83,1482,608,2090
00291500,CENTRAL PIEDMONT COMMUNITY COLLEGE      ,NC,28204-2297,Public       ,896,3310,4206,7366,16999,24365
00291600,CHOWAN UNIVERSITY                       ,NC,27855-1850,Private      ,36,30,66,1516,353,1869
00291700,COLLEGE OF THE ALBEMARLE                ,NC,27909-2327,Public       ,96,352,448,771,1881,2652
00291800,DAVIDSON COLLEGE                        ,NC,28035-7157,Private      ,54,11,65,3048,102,3150
00291900,DAVIDSON COUNTY COMMUNITY COLLEGE       ,NC,27293-0000,Public       ,152,528,680,1389,3655,5044
00292000,DUKE UNIVERSITY                         ,NC,27708-0397,Private      ,183,88,271,14908,1602,16510
00292001,DUKE UNIV - SCHOOL OF MEDICINE          ,NC,27710-0000,Private      ,5,17,22,97,1264,1361
00292002,DUKE UNIV - SCHOOL OF LAW               ,NC,27708-0000,Private      ,4,26,30,38,2922,2960
00292003,DUKE UNIV - GRAD SCH ARTS & SCIENCE     ,NC,27708-0000,Private      ,3,30,33,83,893,976
00292004,DUKE UNIV - FUQUA SCH OF BUSINESS       ,NC,27708-0000,Private      ,5,29,34,53,1210,1263
00292005,DUKE UNIV/NICHOLAS SCH OF ENVIRON.      ,NC,27708-0000,Private      ,0,5,5,10,301,311
00292006,DUKE UNIV - DIVINITY SCHOOL             ,NC,27708-0000,Private      ,9,10,19,94,650,744
00292007,DUKE UNIV - SCHOOL OF NURSING           ,NC,27710-0000,Private      ,4,46,50,90,630,720
00292010,DUKE UNIVERSITY - SCHOOL OF PUBLIC POLIC,NC,27708-0239,Private      ,4,10,14,12,45,57
00292300,EAST CAROLINA UNIVERSITY                ,NC,27858-1818,Public       ,485,822,1307,20473,11271,31744
00292600,ELIZABETH CITY STATE UNIVERSITY         ,NC,27909-7806,Public       ,67,136,203,3882,1554,5436
00292700,ELON UNIVERSITY                         ,NC,27244-2010,Private      ,83,43,126,6258,1067,7325
00292800,FAYETTEVILLE STATE UNIVERSITY           ,NC,28301-4298,Public       ,127,520,647,5403,6347,11750
00292900,GARDNER-WEBB UNIVERSITY                 ,NC,28017-0000,Private      ,61,201,262,2440,2318,4758
00293000,GREENSBORO COLLEGE                      ,NC,27401-1875,Private      ,39,108,147,1388,926,2314
00293100,GUILFORD COLLEGE                        ,NC,27410-4171,Private      ,59,300,359,2792,2490,5282
00293300,HIGH POINT UNIVERSITY                   ,NC,27262-4221,Private      ,52,137,189,3845,1460,5305
00293400,ISOTHERMAL COMMUNITY COLLEGE            ,NC,28160-0804,Public       ,93,309,402,933,2008,2941
00293500,JOHN WESLEY COLLEGE                     ,NC,27265-0000,Private      ,0,27,27,38,171,209
00293600,JOHNSON C SMITH UNIVERSITY              ,NC,28216-5398,Private      ,66,123,189,3418,1003,4421
00293700,KING'S COLLEGE-CHARLOTTE                ,NC,28204-2435,Proprietary  ,21,73,94,734,528,1262
00293900,LEES MCRAE COLLEGE                      ,NC,28604-0000,Private      ,18,15,33,1014,306,1320
00294000,LENOIR COMMUNITY COLLEGE                ,NC,28502-0188,Public       ,90,442,532,972,2697,3669
00294100,LENOIR-RHYNE UNIVERSITY                 ,NC,28603-0000,Private      ,69,57,126,2137,639,2776
00294200,LIVINGSTONE COLLEGE                     ,NC,28144-5298,Private      ,38,26,64,1501,469,1970
00294300,LOUISBURG COLLEGE                       ,NC,27549-2398,Private      ,41,19,60,996,161,1157
00294400,MARS HILL COLLEGE                       ,NC,28754-0000,Private      ,33,33,66,1506,442,1948
00294500,MEREDITH COLLEGE                        ,NC,27607-5298,Private      ,36,76,112,1925,946,2871
00294600,METHODIST UNIVERSITY                    ,NC,28311-1420,Private      ,38,141,179,2323,1324,3647
00294700,MITCHELL COMMUNITY COLLEGE              ,NC,28677-5264,Public       ,122,501,623,1024,2685,3709
00294800,MONTREAT COLLEGE                        ,NC,28757-1267,Private      ,10,95,105,606,1024,1630
00294900,MOUNT OLIVE COLLEGE                     ,NC,28365-1299,Private      ,44,386,430,1169,3746,4915
00295000,NORTH CAROLINA CENTRAL UNIVERSITY       ,NC,27707-3198,Public       ,223,483,706,7828,7452,15280
00295100,NORTH CAROLINA WESLEYAN COLLEGE         ,NC,27804-8699,Private      ,28,89,117,1157,1045,2202
00295300,PEACE COLLEGE                           ,NC,27604-1194,Private      ,21,41,62,885,366,1251
00295400,UNIV OF NORTH CAROLINA AT PEMBROKE      ,NC,28372-1510,Public       ,120,294,414,5457,4010,9467
00295500,PFEIFFER UNIVERSITY                     ,NC,28109-0000,Private      ,18,127,145,1022,1270,2292
00295600,PIEDMONT BAPTIST COLLEGE AND GRADUATE SC,NC,27101-5025,Private      ,12,42,54,217,206,423
00295700,QUEENS UNIVERSITY OF CHARLOTTE          ,NC,28274-0001,Private      ,67,271,338,1941,2223,4164
00295800,ROCKINGHAM COMMUNITY COLLEGE            ,NC,27375-0000,Public       ,77,267,344,850,1706,2556
00296000,SALEM COLLEGE                           ,NC,27108-0000,Private      ,14,61,75,582,641,1223
00296100,SANDHILLS COMMUNITY COLLEGE             ,NC,28374-8283,Public       ,151,494,645,1457,3189,4646
00296200,SHAW UNIVERSITY                         ,NC,27601-2393,Private      ,61,186,247,2740,2405,5145
00296300,SOUTHEASTERN BAPTIST THEOL SEMINARY     ,NC,27588-0000,Private      ,0,11,11,57,159,216
00296400,SOUTHEASTERN COMMUNITY COLLEGE          ,NC,28472-5422,Public       ,56,267,323,782,1778,2560
00296700,ST ANDREWS PRESBYTERIAN COLLEGE         ,NC,28352-9979,Private      ,6,4,10,729,135,864
00296800,ST AUGUSTINES COLLEGE                   ,NC,27610-2298,Private      ,49,63,112,2022,756,2778
00297000,SURRY COMMUNITY COLLEGE                 ,NC,27017-0304,Public       ,105,306,411,1229,1838,3067
00297200,NORTH CAROLINA STATE UNIV-RALEIGH       ,NC,27695-1751,Public       ,448,638,1086,22153,8875,31028
00297300,GASTON COLLEGE                          ,NC,28034-1499,Public       ,245,897,1142,2072,5453,7525
00297400,UNIVERSITY OF N C-CHAPEL HILL           ,NC,27514-0000,Public       ,356,528,884,19356,12315,31671
00297500,UNIVERSITY OF NC AT CHARLOTTE           ,NC,28223-0001,Public       ,422,1056,1478,16693,12010,28703
00297600,UNIVERSITY OF N C - GREENSBORO          ,NC,27412-0001,Public       ,325,600,925,14365,9062,23427
00297800,WAKE FOREST UNIV - UNDERGRADUATE        ,NC,27109-7246,Private      ,110,22,132,6843,343,7186
00297801,WAKE FOREST UNIV - SCH OF MEDICINE      ,NC,27157-1090,Private      ,4,7,11,54,932,986
00297803,WAKE FOREST UNIVERSITY - SCHOOLS OF BUSI,NC,27109-7659,Private      ,8,37,45,33,688,721
00297805,WAKE FOREST UNIV - SCH OF LAW           ,NC,27109-7206,Private      ,3,10,13,24,1473,1497
00297806,WAKE FOREST UNIV - GRAD A&S/DIVINITY    ,NC,27109-7246,Private      ,6,31,37,72,537,609
00297900,WARREN WILSON COLLEGE                   ,NC,28815-0000,Private      ,24,20,44,1258,356,1614
00298000,WAYNE COMMUNITY COLLEGE                 ,NC,27533-0000,Public       ,136,484,620,1256,2789,4045
00298100,WESTERN CAROLINA UNIVERSITY             ,NC,28723-9731,Public       ,194,269,463,7728,3395,11123
00298200,WESTERN PIEDMONT COMMUNITY COLLEGE      ,NC,28655-4504,Public       ,80,364,444,1130,2471,3601
00298300,WILKES COMMUNITY COLLEGE                ,NC,28697-2100,Public       ,76,281,357,1010,1701,2711
00298400,UNIVERSITY OF N C-WILMINGTON            ,NC,28403-3297,Public       ,255,301,556,10969,4133,15102
00298500,WINGATE UNIVERSITY                      ,NC,28174-0159,Private      ,59,66,125,2326,958,3284
00298600,WINSTON-SALEM STATE UNIVERSITY          ,NC,27102-0000,Public       ,151,361,512,7077,4405,11482
00398100,UNC SCHOOL OF THE ARTS                  ,NC,27127-2188,Public       ,18,11,29,1198,335,1533
00403300,ASHEVILLE BUNCOMBE TECH CMTY CLG        ,NC,28801-4897,Public       ,189,619,808,1750,3915,5665
00406200,PITT COMMUNITY COLLEGE                  ,NC,28590-0000,Public       ,280,810,1090,3325,5367,8692
00483500,CALDWELL COMMUNITY CLG & TECH INST      ,NC,28638-2626,Public       ,141,446,587,1484,2866,4350
00483800,GUILFORD TECHNICAL COMMUNITY CLG        ,NC,27282-0309,Public       ,514,1800,2314,5892,11639,17531
00484400,WAKE TECHNICAL COMMUNITY COLLEGE        ,NC,27603-5696,Public       ,564,1676,2240,5536,10501,16037
00484500,WILSON COMMUNITY COLLEGE                ,NC,27893-3310,Public       ,81,371,452,581,2074,2655
00499201,MILLER-MOTTE TECHNICAL COLLEGE - MILLER-,NC,27511-9209,Proprietary  ,38,173,211,179,886,1065
00499202,MILLER-MOTTE TECHNICAL COLLEGE - MILLER-,NC,27604-6072,Proprietary  ,38,209,247,156,838,994
00499203,MILLER-MOTTE TECHNICAL COLLEGE - FAYETTE,NC,28311-7651,Proprietary  ,23,135,158,23,135,158
00531600,COASTAL CAROLINA COMMUNITY COLLEGE      ,NC,28546-6816,Public       ,120,598,718,1307,3858,5165
00531700,FORSYTH TECHNICAL COMMUNITY COLLEGE     ,NC,27103-5197,Public       ,339,1202,1541,2776,7278,10054
00531800,CATAWBA VALLEY COMMUNITY COLLEGE        ,NC,28602-8302,Public       ,192,652,844,2020,4026,6046
00532000,CAPE FEAR COMMUNITY COLLEGE             ,NC,28401-3910,Public       ,358,1019,1377,3359,5391,8750
00544700,RANDOLPH COMMUNITY COLLEGE              ,NC,27204-1009,Public       ,111,377,488,893,2160,3053
00544800,DURHAM TECHNICAL CMNTY COLLEGE          ,NC,27703-5023,Public       ,188,838,1026,1392,4925,6317
00544900,CENTRAL CAROLINA COMMUNITY COLLEGE      ,NC,27330-9000,Public       ,147,675,822,1278,3923,5201
00546300,ALAMANCE COMMUNITY COLLEGE              ,NC,27253-0000,Public       ,145,636,781,1433,3864,5297
00546400,RICHMOND COMMUNITY COLLEGE              ,NC,28345-4522,Public       ,86,327,413,633,1983,2616
00575400,ROWAN-CABARRUS COMMUNITY COLLEGE        ,NC,28145-1595,Public       ,232,776,1008,1960,4984,6944
00647700,CABARRUS COLLEGE OF HEALTH SCIENCES     ,NC,28025-0000,Private      ,12,72,84,255,636,891
00647800,MERCY HOSP SCH OF NURSING               ,NC,28207-0000,Public       ,7,82,89,119,578,697
00648300,WATTS SCHOOL OF NURSING                 ,NC,27704-0000,Private      ,4,29,33,73,229,302
00679900,CRAVEN COMMUNITY COLLEGE                ,NC,28562-0000,Public       ,82,460,542,774,2826,3600
00703100,PAMLICO COMMUNITY COLLEGE               ,NC,28529-0000,Public       ,5,32,37,75,332,407
00764000,FAYETTEVILLE TECHNICAL CMTY COLLEGE     ,NC,28303-0236,Public       ,307,1685,1992,3208,12268,15476
00768700,JAMES SPRUNT COMMUNITY COLLEGE          ,NC,28349-0398,Public       ,43,172,215,393,1222,1615
00781400,BROOKSTONE COLLEGE OF BUSINESS          ,NC,28262-0000,Proprietary  ,22,84,106,90,448,538
00781401,BROOKSTONE COLLEGE OF BUSINESS          ,NC,27409-0000,Proprietary  ,16,128,144,62,452,514
00789200,SAMPSON COMMUNITY COLLEGE               ,NC,28328-0000,Public       ,48,186,234,520,1409,1929
00798500,SOUTH PIEDMONT COMMUNITY COLLEGE        ,NC,28135-9703,Public       ,111,434,545,763,2401,3164
00798600,HALIFAX COMMUNITY COLLEGE               ,NC,27890-0089,Public       ,50,224,274,609,1516,2125
00798700,BLADEN COMMUNITY COLLEGE                ,NC,28332-0266,Public       ,46,227,273,531,1680,2211
00798800,MARTIN COMMUNITY COLLEGE                ,NC,27892-8307,Public       ,31,131,162,245,775,1020
00808100,CARTERET COMMUNITY COLLEGE              ,NC,28557-2989,Public       ,64,269,333,542,1457,1999
00808200,CLEVELAND COMMUNITY COLLEGE             ,NC,28150-0000,Public       ,110,509,619,964,3027,3991
00808300,HAYWOOD COMMUNITY COLLEGE               ,NC,28721-0000,Public       ,52,220,272,592,1271,1863
00808500,MCDOWELL TECHNICAL COMMUNITY CLG        ,NC,28752-8728,Public       ,40,196,236,366,1081,1447
00808700,MONTGOMERY COMMUNITY COLLEGE            ,NC,27371-0787,Public       ,21,124,145,261,742,1003
00846600,SOUTHWESTERN COMMUNITY COLLEGE          ,NC,28779-8581,Public       ,57,200,257,722,1498,2220
00855700,NASH COMMUNITY COLLEGE                  ,NC,27804-0488,Public       ,115,426,541,1004,2354,3358
00855800,BEAUFORT COUNTY COMMUNITY COLLEGE       ,NC,27889-7889,Public       ,68,239,307,535,1638,2173
00861200,ROBESON COMMUNITY COLLEGE               ,NC,28359-2151,Public       ,132,466,598,1044,3088,4132
00861300,ROANOKE-CHOWAN COMMUNITY COLLEGE        ,NC,27910-9522,Public       ,29,108,137,303,766,1069
00885500,EDGECOMBE COMMUNITY COLLEGE             ,NC,27886-9399,Public       ,95,515,610,745,3165,3910
00902500,SOUTH EASTERN CLG OF BEAUTY CULTURE     ,NC,28204-0000,Proprietary  ,25,63,88,125,423,548
00933600,JOHNSTON COMMUNITY COLLEGE              ,NC,27577-0000,Public       ,133,535,668,1203,2887,4090
00943000,TRI-COUNTY COMMUNITY COLLEGE            ,NC,28906-7919,Public       ,43,142,185,348,881,1229
00964600,PIEDMONT COMMUNITY COLLEGE              ,NC,27573-1197,Public       ,39,226,265,528,1495,2023
00968400,BLUE RIDGE COMMUNITY COLLEGE            ,NC,28731-9624,Public       ,60,224,284,570,1327,1897
00974701,GORDON-CONWELL THEO SEM - CHARLOTTE     ,NC,28273-0000,Private      ,0,29,29,3,200,203
00990300,VANCE-GRANVILLE CMTY COLLEGE            ,NC,27536-0917,Public       ,119,517,636,1207,3162,4369
01026400,SOUTH COLLEGE                           ,NC,28803-3152,Proprietary  ,12,106,118,72,545,617
01119400,STANLY COMMUNITY COLLEGE                ,NC,28001-7458,Public       ,73,374,447,750,2160,2910
01119700,MAYLAND COMMUNITY COLLEGE               ,NC,28777-2777,Public       ,45,110,155,378,649,1027
01179900,PAUL MITCHELL THE SCHOOL FAYETTEVILLE   ,NC,28303-5364,Proprietary  ,9,33,42,49,166,215
01192600,LEON'S BEAUTY SCHOOL                    ,NC,27403-2812,Proprietary  ,8,50,58,101,252,353
02056500,MITCHELL'S HAIR STYLING ACADEMY         ,NC,27893-0000,Proprietary  ,19,22,41,81,142,223
02056501,MITCHELL'S HAIR STYLING ACADEMY - MITCHE,NC,27606-3326,Proprietary  ,1,13,14,25,70,95
02110500,ART INSTITUTE OF CHARLOTTE (THE)        ,NC,28217-0000,Proprietary  ,195,521,716,2004,2722,4726
02170700,BRUNSWICK COMMUNITY COLLEGE             ,NC,28422-0000,Public       ,58,163,221,535,1017,1552
02205000,COLLEGE OF WILMINGTON                   ,NC,28403-0000,Proprietary  ,7,27,34,59,165,224
02210400,FAYETTEVILLE BEAUTY COLLEGE             ,NC,28303-0000,Proprietary  ,8,35,43,46,180,226
02227800,MITCHELL'S HAIR STYLING ACADEMY         ,NC,27534-0000,Proprietary  ,1,1,2,4,16,20
02227900,MITCHELL'S HAIR STYLING ACADEMY         ,NC,27858-0000,Proprietary  ,2,4,6,14,28,42
02238700,HAIRSTYLING INSTITUTE OF CHARLOTTE      ,NC,28204-0000,Proprietary  ,6,38,44,54,213,267
02280900,ROANOKE BIBLE COLLEGE                   ,NC,27909-0000,Private      ,3,8,11,129,98,227
02286300,CAROLINA BEAUTY COLLEGE                 ,NC,27262-0000,Proprietary  ,0,0,0,74,342,416
02560600,PINNACLE INSTITUTE OF COSMETOLOGY       ,NC,28115-8020,Proprietary  ,11,16,27,44,72,116
02614201,MILLER-MOTTE BUSINESS COLLEGE           ,NC,28403-0000,Proprietary  ,93,458,551,354,1892,2246
02614205,MILLER - MOTTE TECHNICAL COLLEGE - MILLE,NC,27834-5052,Proprietary  ,23,183,206,100,636,736
03009500,WINSTON-SALEM BARBER SCHOOL             ,NC,27107-0000,Proprietary  ,6,14,20,46,128,174
03064400,REGENCY BEAUTY INSTITUTE                ,NC,27127-0000,Proprietary  ,33,75,108,74,176,250
03089300,HERITAGE BIBLE COLLEGE                  ,NC,28335-0000,Private      ,1,4,5,23,84,107
03104200,CAROLINAS COLLEGE OF HEALTH SCIENCE     ,NC,28232-2861,Public       ,19,123,142,290,903,1193
03109000,SCHOOL OF COMMUNICATION ARTS OF NORTH CA,NC,27614-7076,Proprietary  ,52,102,154,439,610,1049
03361300,MEDICAL ARTS MASSAGE SCHOOL             ,NC,27616-6453,Proprietary  ,13,52,65,48,252,300
03513400,APEX SCHOOL OF THEOLOGY                 ,NC,27703-8024,Private      ,3,66,69,7,405,412
03555300,SOUTHEASTERN INSTITUTE                  ,NC,28217-0000,Proprietary  ,16,139,155,81,448,529
03555400,SOUTHEASTERN SCHOOL OF NEUROMUSCULAR  MA,NC,29406-0000,Proprietary  ,16,60,76,57,260,317
03570300,CAROLINA CHRISTIAN COLLEGE              ,NC,27105-3241,Private      ,0,6,6,5,52,57
03663300,HOOD THEOLOGICAL SEMINARY               ,NC,28144-5768,Private      ,0,14,14,0,249,249
03748500,LA SHE'S BEAUTY ACADEMY                 ,NC,27707-3569,Proprietary  ,5,26,31,28,112,140
03777300,CAROLINA ACAD OF COSMETIC ART & SCI     ,NC,28054-0460,Proprietary  ,17,56,73,87,229,316
03827300,NEW LIFE THEOLOGICAL SEMINARY           ,NC,28205-1648,Private      ,2,22,24,5,133,138
04098300,TECHSKILLS - CHARLOTTE                  ,NC,28217-0000,Proprietary  ,6,67,73,35,312,347
04101300,CAROLINA SCHOOL OF BROADCASTING         ,NC,28214-8085,Proprietary  ,6,38,44,59,171,230
04115700,REGINA'S COLLEGE OF BEAUTY              ,NC,28110-2831,Proprietary  ,6,49,55,15,132,147
04120300,"FILA ACADEMY, THE                       ",NC,27265-3114,Proprietary  ,4,15,19,18,73,91
04129400,CENTER FOR MASSAGE & NATURAL HEALTH     ,NC,28787-8331,Proprietary  ,5,20,25,13,45,58
04140700,AVEDA INSTITUTE CHAPEL HILL             ,NC,27516-2559,Proprietary  ,18,51,69,139,214,353
04143500,CHARLOTTE SCHOOL OF LAW                 ,NC,28208-2816,Proprietary  ,2,72,74,27,916,943
04146400,DAOIST TRADITIONS COLLEGE OF CHINESE MED,NC,28801-1060,Proprietary  ,0,5,5,3,48,51
04149300,PARK WEST BARBER SCHOOL                 ,NC,27701-4022,Proprietary  ,9,50,59,9,53,62
00298800,BISMARCK STATE COLLEGE                  ,ND,58501-1299,Public       ,82,188,270,2031,1580,3611
00298900,DICKINSON STATE UNIVERSITY              ,ND,58601-4896,Public       ,42,64,106,1253,735,1988
00299000,JAMESTOWN COLLEGE                       ,ND,58405-3401,Private      ,13,11,24,1016,145,1161
00299100,LAKE REGION STATE COLLEGE               ,ND,58301-1598,Public       ,23,56,79,328,418,746
00299200,UNIVERSITY OF MARY                      ,ND,58504-9652,Private      ,20,178,198,1516,1586,3102
00299300,MAYVILLE STATE UNIVERSITY               ,ND,58257-1299,Public       ,14,22,36,501,263,764
00299400,MINOT STATE UNIVERSITY                  ,ND,58707-0002,Public       ,37,127,164,1478,1492,2970
00299500,MINOT STATE UNIV-BOTTINEAU CAMPUS       ,ND,58318-1159,Public       ,9,34,43,286,268,554
00299600,NORTH DAKOTA STATE CLG OF SCIENCE       ,ND,58076-0002,Public       ,44,63,107,1330,750,2080
00299700,NORTH DAKOTA STATE UNIVERSITY           ,ND,58108-6050,Public       ,164,206,370,9210,2786,11996
00300500,UNIVERSITY OF NORTH DAKOTA              ,ND,58202-8193,Public       ,128,324,452,7501,4560,12061
00300700,WILLISTON STATE COLLEGE                 ,ND,58802-1326,Public       ,13,42,55,256,365,621
00300800,VALLEY CITY STATE UNIVERSITY            ,ND,58072-0000,Public       ,7,27,34,633,288,921
00484600,RASMUSSEN COLLEGE                       ,ND,58103-7196,Proprietary  ,47,218,265,395,1512,1907
00484601,RASMUSSEN COLLEGE - BISMARCK            ,ND,58503-0000,Proprietary  ,20,98,118,179,665,844
00775600,JOSEF'S SCHOOL OF HAIR DESIGN INC       ,ND,58102-4977,Proprietary  ,7,15,22,86,99,185
00935400,MEDCENTER ONE COLLEGE OF NURSING        ,ND,58501-4494,Private      ,1,11,12,60,74,134
01040600,JOSEF'S SCHOOL OF HAIR DESIGN           ,ND,58201-6394,Proprietary  ,9,9,18,66,73,139
01205900,TRINITY BIBLE COLLEGE                   ,ND,58436-7150,Private      ,14,7,21,231,110,341
01229500,R D HAIRSTYLING COLLEGE                 ,ND,58501-4001,Proprietary  ,3,6,9,45,38,83
02188200,SITTING BULL COLLEGE                    ,ND,58538-9721,Public       ,6,54,60,57,342,399
02236500,LITTLE HOOP COMMUNITY COLLEGE           ,ND,58335-0000,Public       ,5,25,30,35,195,230
02242900,UNITED TRIBES TECHNICAL COLLEGE         ,ND,58504-0000,Private      ,22,72,94,196,693,889
02298200,HEADQUARTERS ACADEMY OF HAIR DESIGN     ,ND,58701-0000,Proprietary  ,5,14,19,23,73,96
02301100,TURTLE MTN CMNTY COLG-FIN AID OFC       ,ND,58316-0000,Private      ,13,46,59,237,522,759
02553700,FORT BERTHOLD COMMUNITY COLLEGE         ,ND,58763-0000,Public       ,7,16,23,40,168,208
03087200,MOLER BARBER CLG OF HAIRSTYLING         ,ND,58103-0000,Proprietary  ,1,5,6,3,18,21
04031300,SALON PROFESSIONAL ACADEMY (THE)        ,ND,58103-3337,Proprietary  ,8,7,15,59,59,118
04139400,HAIR ACADEMY (THE)                      ,ND,58501-4929,Proprietary  ,2,10,12,56,45,101
00301005,ANTIOCH UNIV/SEATTLE                    ,WA,98121-0000,Private      ,0,100,100,62,1263,1325
00376900,BELLEVUE COMMUNITY COLLEGE              ,WA,98007-6484,Public       ,350,944,1294,3637,6285,9922
00377000,BIG BEND COMMUNITY COLLEGE              ,WA,98837-3299,Public       ,110,250,360,1007,1586,2593
00377100,"CENTRAL WASHINGTON UNIV., FIN AID       ",WA,98926-7495,Public       ,266,296,562,9149,4474,13623
00377200,CENTRALIA COLLEGE                       ,WA,98531-4099,Public       ,87,324,411,1008,1926,2934
00377300,CLARK COLLEGE                           ,WA,98663-3598,Public       ,530,1439,1969,4632,9213,13845
00377400,COLUMBIA BASIN COLLEGE                  ,WA,99301-3379,Public       ,177,547,724,2316,3942,6258
00377500,EASTERN WASHINGTON UNIVERSITY           ,WA,99004-2447,Public       ,271,341,612,8319,6083,14402
00377600,EVERETT COMMUNITY COLLEGE               ,WA,98201-1352,Public       ,270,894,1164,2351,5648,7999
00377700,HERITAGE UNIVERSITY                     ,WA,98948-9562,Private      ,17,108,125,376,1494,1870
00377800,GONZAGA UNIVERSITY                      ,WA,99258-0083,Private      ,114,240,354,6559,3809,10368
00377900,GRAYS HARBOR COLLEGE                    ,WA,98520-7599,Public       ,91,261,352,811,1668,2479
00378000,GREEN RIVER COMMUNITY COLLEGE           ,WA,98092-3622,Public       ,338,821,1159,2635,4827,7462
00378100,HIGHLINE COMMUNITY COLLEGE              ,WA,98198-9800,Public       ,309,852,1161,2641,5326,7967
00378200,LOWER COLUMBIA COLLEGE                  ,WA,98632-0310,Public       ,140,579,719,1162,3373,4535
00378300,NORTHWEST UNIVERSITY                    ,WA,98083-0000,Private      ,38,77,115,1138,819,1957
00378400,OLYMPIC COLLEGE                         ,WA,98337-1600,Public       ,165,683,848,1710,4424,6134
00378500,PACIFIC LUTHERAN UNIVERSITY             ,WA,98447-0003,Private      ,83,113,196,4193,1606,5799
00378600,PENINSULA COLLEGE                       ,WA,98362-6660,Public       ,82,308,390,526,1666,2192
00378700,SEATTLE CENTRAL COMMUNITY COLLEGE       ,WA,98122-2413,Public       ,261,883,1144,2713,6351,9064
00378703,SEATTLE VOCATIONAL INSTITUTE            ,WA,98144-0000,Public       ,29,99,128,107,461,568
00378800,SEATTLE PACIFIC UNIVERSITY              ,WA,98119-1997,Private      ,107,141,248,4327,2120,6447
00379000,SEATTLE UNIVERSITY                      ,WA,98122-1090,Private      ,187,269,456,7042,6507,13549
00379100,SHORELINE COMMUNITY COLLEGE             ,WA,98133-5696,Public       ,153,452,605,1828,3837,5665
00379200,SKAGIT VALLEY COLLEGE                   ,WA,98273-5899,Public       ,146,535,681,1266,3172,4438
00379300,SPOKANE COMMUNITY COLLEGE               ,WA,99207-5399,Public       ,425,1582,2007,3615,9997,13612
00379400,ST MARTIN'S UNIVERSITY                  ,WA,98503-7500,Private      ,28,82,110,1307,1044,2351
00379600,TACOMA COMMUNITY COLLEGE                ,WA,98466-6100,Public       ,302,1117,1419,2928,7721,10649
00379700,UNIVERSITY OF PUGET SOUND               ,WA,98416-1039,Private      ,67,72,139,4460,1120,5580
00379800,UNIVERSITY OF WASHINGTON                ,WA,98195-5880,Public       ,777,1280,2057,28314,25261,53575
00379900,WALLA WALLA UNIVERSITY                  ,WA,99324-1198,Private      ,27,36,63,1464,673,2137
00380000,WASHINGTON STATE UNIVERSITY             ,WA,99164-1035,Public       ,493,710,1203,19258,11462,30720
00380100,WENATCHEE VALLEY COLLEGE                ,WA,98801-1799,Public       ,140,407,547,1352,2657,4009
00380200,WESTERN WASHINGTON UNIVERSITY           ,WA,98225-5946,Public       ,370,262,632,14694,4304,18998
00380300,WHITMAN COLLEGE                         ,WA,99362-2067,Private      ,25,6,31,2824,101,2925
00380400,WHITWORTH UNIVERSITY                    ,WA,99251-0001,Private      ,43,80,123,3579,1097,4676
00380500,YAKIMA VALLEY COMMUNITY COLLEGE         ,WA,98907-2520,Public       ,154,541,695,2451,4657,7108
00499900,BELLINGHAM TECHNICAL COLLEGE            ,WA,98225-0000,Public       ,101,414,515,753,2437,3190
00500000,PIERCE COLLEGE                          ,WA,98498-1919,Public       ,286,975,1261,2808,6607,9415
00500100,EDMONDS COMMUNITY COLLEGE               ,WA,98036-5999,Public       ,215,685,900,2011,4520,6531
00500600,WALLA WALLA COMMUNITY COLLEGE           ,WA,99362-9267,Public       ,114,341,455,1597,2661,4258
00530600,BATES TECHNICAL COLLEGE                 ,WA,98405-0000,Public       ,92,569,661,676,2830,3506
00530601,BATES TECHNICAL COLLEGE - SOUTH CAMPUS  ,WA,98409-5847,Public       ,0,0,0,61,194,255
00537200,SOUTH PUGET SOUND COMMUNITY COLLEGE     ,WA,98512-6292,Public       ,232,765,997,2058,4460,6518
00537300,LAKE WASHINGTON TECHNICAL COLLEGE       ,WA,98034-8505,Public       ,76,361,437,647,2523,3170
00575200,CLOVER PARK TECHNICAL COLLEGE           ,WA,98499-0000,Public       ,186,865,1051,1279,5205,6484
00815500,EVERGREEN STATE COLLEGE (THE)           ,WA,98505-0002,Public       ,115,245,360,3601,3690,7291
00844300,ITT TECHNICAL INSTITUTE                 ,WA,98168-3334,Proprietary  ,119,444,563,564,1777,2341
00907901,EVEREST COLLEGE                         ,WA,98684-6950,Proprietary  ,23,113,136,131,605,736
00938700,PERRY TECHNICAL INSTITUTE               ,WA,98903-1239,Private      ,58,121,179,537,839,1376
00954400,SPOKANE FALLS COMMUNITY COLLEGE         ,WA,99224-5204,Public       ,376,899,1275,3550,6049,9599
00970400,NORTH SEATTLE COMMUNITY COLLEGE         ,WA,98103-3599,Public       ,144,552,696,1339,4176,5515
00970600,SOUTH SEATTLE COMMUNITY COLLEGE         ,WA,98106-1499,Public       ,170,540,710,1499,3467,4966
00973900,GLEN DOW ACAD OF HAIR DESIGN            ,WA,99201-0209,Proprietary  ,14,21,35,97,159,256
01036400,WHATCOM COMMUNITY COLLEGE               ,WA,98226-8003,Public       ,183,344,527,1844,2506,4350
01043400,RENTON TECHNICAL COLLEGE                ,WA,98056-0000,Public       ,111,473,584,827,2859,3686
01148100,DIVERS INSTITUTE OF TECHNOLOGY          ,WA,98107-0667,Proprietary  ,35,92,127,140,498,638
01231500,CORNISH COLLEGE OF THE ARTS             ,WA,98121-4604,Private      ,34,25,59,1295,385,1680
01249600,GREENWOOD BEAUTY SCHOOL                 ,WA,98103-0000,Proprietary  ,12,24,36,42,127,169
01260100,NORTHWEST BAPTIST SEMINARY              ,WA,98402-6699,Private      ,0,5,5,0,5,5
01302200,CITY UNIVERSITY OF SEATTLE              ,WA,98005-3030,Private      ,9,260,269,130,2633,2763
01309400,BELLINGHAM BEAUTY SCHOOL                ,WA,98225-0000,Proprietary  ,5,18,23,32,77,109
02091701,KAPLAN COLLEGE - SEATTLE                ,WA,98055-4910,Proprietary  ,3,42,45,75,400,475
02105300,BELLEVUE BEAUTY SCHOOL                  ,WA,98007-0000,Proprietary  ,10,30,40,43,105,148
02106700,TRINITY LUTHERAN COLLEGE                ,WA,98201-3569,Private      ,5,10,15,95,58,153
02180000,NORTHWEST INDIAN COLLEGE                ,WA,98226-9278,Public       ,22,100,122,143,605,748
02184200,PAROBA COLLEGE OF COSMETOLOGY           ,WA,98208-0000,Proprietary  ,4,28,32,30,95,125
02202200,STYLEMASTERS COLLEGE OF HAIR DESIGN     ,WA,98632-0000,Proprietary  ,9,14,23,26,94,120
02203300,GENE JUAREZ ACADEMY OF BEAUTY           ,WA,98125-0000,Proprietary  ,50,95,145,387,510,897
02203301,GENE JUAREZ ACADEMY OF BEAUTY           ,WA,98003-0000,Proprietary  ,6,14,20,76,110,186
02222900,INTERNATIONAL AIR & HOSPITALITY ACADEMY ,WA,98661-4835,Proprietary  ,49,138,187,258,498,756
02222906,INTERNATIONAL AIR & HOSPITALITY ACADEMY ,WA,98661-3805,Proprietary  ,1,5,6,6,13,19
02236800,PROFESSIONAL BEAUTY SCHOOL              ,WA,98902-0000,Proprietary  ,3,12,15,52,91,143
02242500,BASTYR UNIVERSITY                       ,WA,98028-0000,Private      ,5,75,80,94,1141,1235
02263107,CAMBRIDGE COLLEGE-BELLEVUE              ,WA,98007-0000,Proprietary  ,0,0,0,3,15,18
02291300,ART INSTITUTE OF SEATTLE                ,WA,98121-1622,Proprietary  ,199,263,462,2392,2031,4423
02300100,EVEREST COLLEGE                         ,WA,98367-1835,Proprietary  ,25,111,136,113,488,601
02300103,EVEREST COLLEGE - EVERETT               ,WA,98208-2610,Proprietary  ,50,196,246,191,798,989
02300104,EVEREST COLLEGE - TACOMA                ,WA,98402-3004,Proprietary  ,47,214,261,169,881,1050
02326500,INTERFACE COLLEGE                       ,WA,99201-3209,Proprietary  ,4,60,64,24,271,295
02331400,NORTHWEST HAIR ACADEMY                  ,WA,98273-0000,Proprietary  ,20,27,47,93,113,206
02331402,NORTHWEST HAIR ACADEMY - EVERETT        ,WA,98204-0000,Proprietary  ,6,5,11,42,40,82
02504900,ACADEMY OF HAIR DESIGN (THE)            ,WA,98801-0000,Proprietary  ,10,17,27,41,84,125
02541900,BJ'S BEAUTY AND BARBER COLLEGE          ,WA,98409-0000,Proprietary  ,15,34,49,56,154,210
02602100,NORTHWEST COLLEGE OF ART                ,WA,98370-8625,Proprietary  ,8,1,9,166,45,211
02606200,EVEREST COLLEGE                         ,WA,98055-2990,Proprietary  ,73,209,282,227,846,1073
02617500,EVEREST COLLEGE                         ,WA,98133-9018,Proprietary  ,18,84,102,97,323,420
02617501,EVEREST COLLEGE - FIFE                  ,WA,98424-2647,Proprietary  ,26,60,86,135,340,475
02617503,EVEREST COLLEGE - VANCOUVER             ,WA,98684-6951,Proprietary  ,16,58,74,89,334,423
03031406,INTERNATIONAL ACADEMY OF DESIGN AND TECH,WA,98188-3319,Proprietary  ,25,43,68,220,299,519
03065000,CLARE'S BEAUTY COLLEGE                  ,WA,99301-5505,Proprietary  ,5,20,25,30,88,118
03071800,ITT TECHNICAL INSTITUTE                 ,WA,99216-1589,Proprietary  ,111,417,528,512,1902,2414
03099000,CORTIVA INSTITUTE - SEATTLE             ,WA,98109-5474,Proprietary  ,19,64,83,123,374,497
03110800,BAKKE GRADUATE UNIVERSITY               ,WA,98104-1222,Private      ,0,8,8,0,27,27
03139500,MONTESSORI SCHOOLS OF WASHINGTON        ,WA,98203-6600,Private      ,0,2,2,0,8,8
03280300,SEATTLE INST OF ORIENTAL MEDICINE       ,WA,98115-0000,Proprietary  ,2,3,5,8,58,66
03283300,NORTHWEST HVAC/R ASSOCIATION & TRAINING ,WA,99202-2125,Private      ,2,8,10,13,99,112
03361600,SEATTLE MIDWIFERY SCHOOL                ,WA,98144-0000,Private      ,0,9,9,4,89,93
03466400,MARS HILL GRADUATE SCHOOL               ,WA,98121-0000,Private      ,1,7,8,2,306,308
03483500,CASCADIA COMMUNITY COLLEGE              ,WA,98011-9510,Public       ,87,199,286,828,1245,2073
03490400,EMIL FRIES PIANO HOSPITAL & TRAININ     ,WA,98661-4323,Private      ,0,2,2,1,9,10
03670301,TONI&GUY HAIRDRESSING ACADEMY -         ,WA,98225-4526,Proprietary  ,0,1,1,0,1,1
03689400,FAITH EVANGELICAL SEMINARY              ,WA,98407-2607,Private      ,1,40,41,4,208,212
03707500,CHETTA'S ACADEMY OF HAIR AND NAILS      ,WA,98362-4310,Proprietary  ,1,3,4,5,17,22
03724300,DIGIPEN INSTITUTE OF TECHNOLOGY         ,WA,98052-5170,Proprietary  ,15,15,30,692,315,1007
03917300,EVERGREEN BEAUTY AND BARBER COLLEGE     ,WA,98208-3759,Proprietary  ,11,51,62,48,215,263
03932500,TOTAL COSMETOLOGY TRAINING CENTER       ,WA,99217-6231,Proprietary  ,7,26,33,38,136,174
03953300,YAKIMA BEAUTY SCHOOL;BEAUTYWORKS        ,WA,98901-2202,Proprietary  ,1,8,9,25,46,71
04043400,ALPINE COLLEGE                          ,WA,99206-5097,Proprietary  ,14,64,78,49,304,353
04120000,SUNNYSIDE BEAUTY ACADEMY                ,WA,98944-8711,Proprietary  ,0,1,1,3,16,19
04127200,VICTORIA'S ACADEMY OF COSMETOLOGY       ,WA,99336-3826,Proprietary  ,7,19,26,56,109,165
04130500,PACIFIC NORTHWEST UNIV OF HEALTH SCIENCE,WA,98901-1471,Private      ,0,4,4,10,236,246
04130800,CASCADE BEAUTY COLLEGE                  ,WA,98002-5504,Proprietary  ,2,10,12,17,54,71
04132800,INLAND MASSAGE INSTITUTE                ,WA,99208-5923,Proprietary  ,2,9,11,17,75,92
04149400,GARY MANUEL AVEDA INSTITUTE             ,WA,98122-3807,Proprietary  ,37,81,118,37,81,118
04155000,NORTHWEST SCHOOL OF WOODEN BOAT BUILDING,WA,98339-8706,Private      ,1,5,6,1,5,6
00340100,BROWN UNIVERSITY                        ,RI,02912-9127,Private      ,194,21,215,17195,483,17678
00340101,BROWN UNIVERSITY - GRADUATE SCHOOL      ,RI,02912-1827,Private      ,2,70,72,37,1643,1680
00340102,BROWN MEDICAL SCHOOL                    ,RI,02912-0000,Private      ,2,5,7,20,433,453
00340200,BRYANT UNIVERSITY                       ,RI,02917-1284,Private      ,66,27,93,5498,440,5938
00340400,JOHNSON & WALES UNIVERSITY              ,RI,02903-3703,Private      ,331,302,633,18821,4235,23056
00340600,PROVIDENCE COLLEGE                      ,RI,02918-0001,Private      ,72,62,134,7354,664,8018
00340700,RHODE ISLAND COLLEGE                    ,RI,02908-1991,Public       ,113,213,326,7141,3511,10652
00340800,COMMUNITY COLLEGE OF RI - WARWICK       ,RI,02906-0000,Public       ,455,893,1348,4915,6106,11021
00340801,COMMUNITY COLLEGE OF RI - LINCOLN       ,RI,02865-4585,Public       ,101,197,298,1810,2089,3899
00340802,COMMUNITY COLLEGE OF RI- PROVIDENCE     ,RI,02905-2313,Public       ,92,248,340,1563,2336,3899
00340900,RHODE ISLAND SCHOOL OF DESIGN           ,RI,02903-2784,Private      ,49,32,81,2624,1456,4080
00341000,ROGER WILLIAMS UNIVERSITY               ,RI,02809-2921,Private      ,46,40,86,7436,1619,9055
00341100,SALVE REGINA UNIVERSITY                 ,RI,02840-4192,Private      ,36,22,58,4532,378,4910
00341400,UNIVERSITY OF RHODE ISLAND              ,RI,02881-0000,Public       ,269,228,497,19000,3793,22793
00659100,ST. JOSEPH HOSP SCH OF NURSING          ,RI,02904-5199,Private      ,2,11,13,53,157,210
00784400,GIBBS COLLEGE                           ,RI,02920-7807,Proprietary  ,0,8,8,34,100,134
00784500,NEW ENGLAND INSTITUTE OF TECHNOLOGY     ,RI,02886-2266,Private      ,199,347,546,2976,2401,5377
01115900,"SAWYER SCHOOL,THE                       ",RI,02860-4117,Proprietary  ,62,293,355,331,1515,1846
02071900,ARTHUR ANGELO SCH COSMET&HAIR DSGN      ,RI,02903-0000,Proprietary  ,16,33,49,109,213,322
02176900,WARWICK ACADEMY OF BEAUTY CULTURE       ,RI,02886-1534,Proprietary  ,11,22,33,82,144,226
02584400,NEW ENGLAND TRACTOR TRAILER TRAINING SCH,RI,02860-1752,Proprietary  ,23,220,243,69,647,716
03080000,NEWPORT SCHOOL OF HAIRDRESSING          ,RI,02860-4038,Proprietary  ,3,18,21,10,77,87
03115200,MOTORING TECHNICAL TRAINING INST        ,RI,02914-0000,Proprietary  ,28,55,83,143,262,405
03232300,LINCOLN TECHNICAL INSTITUTE             ,RI,02865-4211,Proprietary  ,83,198,281,549,1043,1592
03570500,ZION BIBLE COLLEGE                      ,RI,02806-1246,Private      ,6,11,17,162,104,266
03732300,INTERNATIONAL YACHT RESTORATION SCH     ,RI,02840-6720,Private      ,0,1,1,18,32,50
04141200,TONI & GUY HAIRDRESSING ACADEMY         ,RI,02920-0000,Proprietary  ,4,9,13,57,49,106
00341700,ALLEN UNIVERSITY                        ,SC,29204-1085,Private      ,50,40,90,1202,582,1784
00341800,ANDERSON UNIVERSITY                     ,SC,29621-4035,Private      ,30,108,138,2038,902,2940
00341900,CHARLESTON SOUTHERN UNIVERSITY          ,SC,29406-2160,Private      ,84,169,253,3877,2047,5924
00342000,BENEDICT COLLEGE                        ,SC,29204-1086,Private      ,125,115,240,4118,1557,5675
00342100,BOB JONES UNIVERSITY                    ,SC,29614-1000,Proprietary  ,82,37,119,2958,414,3372
00342200,SOUTHERN WESLEYAN UNIVERSITY            ,SC,29630-1020,Private      ,14,151,165,912,2049,2961
00342300,THE CITADEL                             ,SC,29409-0002,Public       ,63,103,166,2380,1099,3479
00342400,CLAFLIN UNIVERSITY                      ,SC,29115-4498,Private      ,47,87,134,2534,1054,3588
00342500,CLEMSON UNIVERSITY                      ,SC,29634-0001,Public       ,277,278,555,16272,3717,19989
00342600,UNIV OF SC AT SUMTER                    ,SC,29150-2498,Public       ,17,71,88,747,627,1374
00342700,COKER COLLEGE                           ,SC,29550-3797,Private      ,19,91,110,978,996,1974
00342800,COLLEGE OF CHARLESTON                   ,SC,29424-0100,Public       ,233,219,452,9743,2642,12385
00342900,COLUMBIA INTERNATIONAL UNIVERSITY       ,SC,29203-1599,Private      ,17,58,75,517,739,1256
00343000,COLUMBIA COLLEGE                        ,SC,29203-5998,Private      ,21,99,120,1326,1243,2569
00343100,CONVERSE COLLEGE                        ,SC,29302-0006,Private      ,9,57,66,711,747,1458
00343200,ERSKINE COLLEGE                         ,SC,29639-0000,Private      ,13,3,16,773,39,812
00343201,ERSKINE THEOLOGICAL SEMINARY            ,SC,29639-0000,Private      ,0,10,10,6,149,155
00343400,FURMAN UNIVERSITY                       ,SC,29613-5253,Private      ,54,68,122,3307,417,3724
00343500,LANDER UNIVERSITY                       ,SC,29649-2099,Public       ,61,75,136,3292,923,4215
00343600,LIMESTONE COLLEGE                       ,SC,29340-3799,Private      ,36,284,320,1310,3195,4505
00343700,LUTHERAN THEOLOGICAL SOUTHERN SEM       ,SC,29203-5898,Private      ,0,2,2,2,142,144
00343800,MEDICAL UNIV OF SOUTH CAROLINA - FA     ,SC,29425-1760,Public       ,22,84,106,230,2861,3091
00343900,MORRIS COLLEGE                          ,SC,29150-3599,Private      ,41,57,98,1433,581,2014
00344000,NEWBERRY COLLEGE                        ,SC,29108-2197,Private      ,30,16,46,1644,295,1939
00344100,NORTH GREENVILLE COLLEGE                ,SC,29688-1892,Private      ,33,34,67,2247,381,2628
00344500,PRESBYTERIAN COLLEGE                    ,SC,29325-2503,Private      ,28,7,35,1512,73,1585
00344600,SOUTH CAROLINA STATE UNIVERSITY         ,SC,29117-4427,Public       ,150,203,353,6379,2964,9343
00344700,SPARTANBURG METHODIST COLLEGE           ,SC,29301-5899,Private      ,26,20,46,1291,211,1502
00344800,UNIVERSITY OF SOUTH CAROLINA            ,SC,29208-3999,Public       ,401,694,1095,20340,11399,31739
00344900,UNIVERSITY OF SOUTH CAROLINA AIKEN      ,SC,29801-6399,Public       ,62,96,158,3100,1353,4453
00345000,UNIV OF SC AT BEAUFORT                  ,SC,29902-4602,Public       ,58,109,167,1208,998,2206
00345100,COASTAL CAROLINA UNIVERSITY             ,SC,29528-0000,Public       ,217,255,472,10295,2357,12652
00345300,UNIV OF SC AT LANCASTER                 ,SC,29721-0889,Public       ,44,95,139,933,753,1686
00345400,UNIV OF SC SYSTEM SALKEHATCHIE          ,SC,29810-0617,Public       ,24,98,122,500,629,1129
00345500,VOORHEES COLLEGE                        ,SC,29042-0000,Private      ,19,28,47,871,430,1301
00345600,WINTHROP UNIVERSITY                     ,SC,29733-0001,Public       ,127,218,345,6076,2384,8460
00345700,WOFFORD COLLEGE                         ,SC,29303-3663,Private      ,33,10,43,1872,125,1997
00399000,FLORENCE-DARLINGTON TECH COLLEGE        ,SC,29501-0548,Public       ,225,894,1119,2866,5759,8625
00399100,GREENVILLE TECHNICAL COLLEGE            ,SC,29607-2439,Public       ,632,2060,2692,7631,14026,21657
00399200,PIEDMONT TECHNICAL COLLEGE              ,SC,29648-1467,Public       ,198,765,963,2308,5336,7644
00399300,MIDLANDS TECHNICAL COLLEGE              ,SC,29202-0000,Public       ,525,1569,2094,7151,12080,19231
00399400,SPARTANBURG COMMUNITY COLLEGE           ,SC,29305-4386,Public       ,284,888,1172,3279,5906,9185
00399500,CENTRAL CAROLINA TECHNICAL COLLEGE      ,SC,29150-2499,Public       ,144,678,822,1548,4375,5923
00399600,YORK TECHNICAL COLLEGE                  ,SC,29730-3395,Public       ,348,1248,1596,2944,6711,9655
00492000,TRIDENT TECHNICAL COLLEGE               ,SC,29423-8067,Public       ,641,2069,2710,6843,12784,19627
00492300,CLINTON JR COLLEGE                      ,SC,29730-5152,Private      ,8,15,23,135,78,213
00492400,FORREST JUNIOR COLLEGE                  ,SC,29624-2405,Proprietary  ,4,43,47,24,173,197
00492500,HORRY-GEORGETOWN TECH COLLEGE           ,SC,29526-9521,Public       ,401,1193,1594,3534,7090,10624
00492600,TRI-COUNTY TECHNICAL COLLEGE            ,SC,29670-9133,Public       ,224,779,1003,3608,4870,8478
00492700,UNIV OF SC AT UNION                     ,SC,29379-0729,Public       ,9,37,46,253,283,536
00536300,DENMARK TECHNICAL COLLEGE               ,SC,29042-0000,Public       ,63,193,256,955,1157,2112
00681500,ORANGEBURG-CALHOUN TECHNICAL COLG       ,SC,29118-8299,Public       ,101,377,478,1398,2744,4142
00695100,UNIVERSITY OF SOUTH CAROLINA UPSTATE    ,SC,29303-9972,Public       ,108,225,333,5003,2835,7838
00760200,NORTHEASTERN TECHNICAL COLLEGE          ,SC,29520-7015,Public       ,54,213,267,559,1314,1873
00922600,FRANCIS MARION UNIVERSITY               ,SC,29501-0000,Public       ,109,159,268,4644,1789,6433
00932200,WILLIAMSBURG TECHNICAL COLLEGE          ,SC,29556-4197,Public       ,44,128,172,374,868,1242
00991000,TECHNICAL COLLEGE OF THE LOWCOUNTRY     ,SC,29902-5441,Public       ,83,476,559,915,2902,3817
00991100,UNIV OF SC-REGIONAL CAMPUSES ADMIN      ,SC,29208-0001,Public       ,4,16,20,155,99,254
01005600,AIKEN TECHNICAL COLLEGE                 ,SC,29802-0696,Public       ,173,533,706,1932,3890,5822
01209200,KENNETH SHULER SCHOOL OF COSMETOLOGY    ,SC,29732-2169,Proprietary  ,10,40,50,49,139,188
01303907,SOUTH UNIVERSITY                        ,SC,29203-6400,Proprietary  ,40,346,386,421,2461,2882
02063700,SHERMAN CLG STRAIGHT CHIROPRACTIC       ,SC,29316-0000,Private      ,1,22,23,6,275,281
02189800,NO AMER INST OF AVIATION OF SO CAR      ,SC,29527-0000,Proprietary  ,0,2,2,5,13,18
02338600,CHARZANNE BEAUTY COLLEGE                ,SC,29649-0000,Proprietary  ,1,9,10,17,64,81
02341100,KENNETH SHULER SCHOOL OF COSMETOLOGY & N,SC,29210-0000,Proprietary  ,15,103,118,152,584,736
02356600,CHARLESTON COSMETOLOGY INSTITUTE        ,SC,29420-0000,Proprietary  ,17,33,50,79,156,235
02552400,ACADEMY OF HAIR TECHNOLOGY              ,SC,29615-2363,Proprietary  ,12,32,44,65,132,197
02567600,SUMTER BEAUTY COLLEGE                   ,SC,29150-0000,Proprietary  ,1,11,12,17,103,120
02614202,MILLER - MOTTE TECHNICAL COLLEGE - NORTH,SC,29406-9239,Proprietary  ,53,221,274,353,1310,1663
03010614,VIRGINIA COLLEGE - GOLF ACADEMY OF AMERI,SC,29579-0000,Proprietary  ,26,59,85,218,366,584
03052300,KENNETH SHULER SCH COSM & HAIR DESG     ,SC,29841-2013,Proprietary  ,2,17,19,48,123,171
03088300,ACADEMY OF COSMETOLOGY                  ,SC,29418-5667,Proprietary  ,13,29,42,48,151,199
03293300,STRAND COLLEGE OF HAIR DESIGN           ,SC,29572-4310,Proprietary  ,2,38,40,34,128,162
03304300,CENTURA COLLEGE                         ,SC,29406-9235,Proprietary  ,26,170,196,136,738,874
03513300,LACY COSMETOLOGY SCHOOL                 ,SC,29803-9084,Proprietary  ,2,12,14,14,71,85
03513301,LACY COSMETOLOGY SCHOOL -               ,SC,29072-0000,Proprietary  ,3,10,13,12,48,60
03513302,LACY COSMETOLOGY SCHOOL -               ,SC,29445-0000,Proprietary  ,1,8,9,10,64,74
03595300,CHARLESTON SCHOOL OF MASSAGE            ,SC,29412-8270,Proprietary  ,1,8,9,8,53,61
03746300,LEGRAND INSTITUTE OF COSMETOLOGY        ,SC,29020-0000,Proprietary  ,4,15,19,27,58,85
03746400,SOUTHEASTERN INSTITUTE                  ,SC,29210-0000,Proprietary  ,7,82,89,82,331,413
03768400,STYLETRENDS BARBER AND HAIRSTYLING ACADE,SC,29730-4511,Proprietary  ,4,14,18,22,88,110
03856400,W. L. BONNER COLLEGE                    ,SC,29203-0000,Private      ,0,9,9,9,81,90
03892300,HARLEY'S BEAUTY & BARBER CAREER INST.   ,SC,29204-1919,Proprietary  ,4,22,26,20,95,115
04096300,CHARLESTON SCHOOL OF LAW                ,SC,29402-0535,Proprietary  ,0,13,13,6,1237,1243
04158100,AIKEN SCHOOL OF COSMETOLOGY             ,SC,29801-4026,Proprietary  ,7,13,20,7,13,20
00345800,AUGUSTANA COLLEGE                       ,SD,57197-0001,Private      ,16,15,31,1809,228,2037
00345900,BLACK HILLS STATE UNIVERSITY            ,SD,57799-9670,Public       ,74,155,229,2269,1681,3950
00346100,DAKOTA WESLEYAN UNIVERSITY              ,SD,57301-4398,Private      ,7,17,24,657,309,966
00346300,DAKOTA STATE UNIVERSITY                 ,SD,57042-1799,Public       ,24,74,98,1246,662,1908
00346500,MOUNT MARTY COLLEGE                     ,SD,57078-3724,Private      ,11,27,38,536,512,1048
00346600,NORTHERN STATE UNIVERSITY               ,SD,57401-7198,Public       ,18,61,79,1519,682,2201
00346700,PRESENTATION COLLEGE                    ,SD,57401-1299,Private      ,3,31,34,333,505,838
00346900,UNIVERSITY OF SIOUX FALLS               ,SD,57105-1699,Private      ,24,46,70,1311,504,1815
00347000,SOUTH DAKOTA SCH OF MINES & TECH        ,SD,57701-3995,Public       ,22,46,68,1388,581,1969
00347100,SOUTH DAKOTA STATE UNIVERSITY           ,SD,57007-2298,Public       ,112,236,348,7794,3106,10900
00347400,UNIVERSITY OF SOUTH DAKOTA              ,SD,57069-2390,Public       ,85,288,373,4530,4299,8829
00405600,SIOUX FALLS SEMINARY                    ,SD,57105-2729,Private      ,0,3,3,1,86,87
00405700,NATIONAL AMERICAN UNIVERSITY            ,SD,57701-3692,Proprietary  ,149,1384,1533,688,7563,8251
00405707,NATIONAL AMERICAN UNIVERSITY            ,SD,57105-0000,Proprietary  ,0,39,39,49,339,388
00492900,MCKENNAN HOSP-RADOLOGICAL TECH          ,SD,57101-0000,Private      ,0,1,1,17,15,32
00530900,LAKE AREA TECHNICAL INSTITUTE           ,SD,57201-2869,Public       ,35,68,103,872,530,1402
00598700,AVERA SACRED HEART HOSPITAL SCHOOL OF RA,SD,57078-3899,Private      ,0,0,0,4,4,8
00776400,SOUTHEAST TECHNICAL INST                ,SD,57107-0000,Public       ,69,194,263,1409,1468,2877
00828400,MITCHELL TECHNICAL INSTITUTE            ,SD,57301-2002,Public       ,17,39,56,626,446,1072
01013800,STEWART SCHOOL                          ,SD,57104-0000,Proprietary  ,9,13,22,91,95,186
01014804,COLORADO TECHNICAL UNIVERSITY           ,SD,57108-2272,Proprietary  ,21,143,164,300,1273,1573
01017000,WESTERN DAKOTA TECHNICAL INSTITUTE      ,SD,57701-4018,Public       ,49,179,228,523,1171,1694
01147701,SIOUX VALLEY HOSP-MEDICAL TECH          ,SD,57117-5039,Private      ,0,0,0,13,12,25
01465900,OGLALA LAKOTA COLLEGE                   ,SD,57752-0490,Public       ,22,146,168,293,1458,1751
02137100,BLACK HILLS BEAUTY COLLEGE              ,SD,57701-0000,Proprietary  ,5,14,19,67,83,150
02143700,SINTE GLESKA UNIVERSITY                 ,SD,57570-0000,Public       ,8,47,55,126,631,757
02144600,KILIAN COMMUNITY COLLEGE                ,SD,57103-7020,Private      ,12,74,86,96,445,541
02277300,SISSETON WAHPETON COLLEGE               ,SD,57262-0000,Public       ,7,9,16,41,167,208
02297800,HEADLINES ACADEMY                       ,SD,57701-0000,Proprietary  ,7,12,19,52,103,155
00347700,AQUINAS COLLEGE                         ,TN,37205-2086,Private      ,9,83,92,256,778,1034
00347701,AQUINAS COLLEGE -  PRIMETIME PROGRAM    ,TN,37214-3644,Private      ,0,13,13,14,208,222
00347800,AUSTIN PEAY STATE UNIVERSITY            ,TN,37044-0002,Public       ,202,748,950,6636,7515,14151
00347900,BELMONT UNIVERSITY                      ,TN,37212-3757,Private      ,109,221,330,5468,3005,8473
00348000,BETHEL COLLEGE                          ,TN,38201-1705,Private      ,36,414,450,1276,3222,4498
00348100,CARSON-NEWMAN COLLEGE                   ,TN,37760-2204,Private      ,52,54,106,3043,707,3750
00348200,CHRISTIAN BROTHERS UNIVERSITY           ,TN,38104-5581,Private      ,33,129,162,2068,1643,3711
00348300,COLUMBIA STATE COMMUNITY COLLEGE        ,TN,38401-5653,Public       ,152,465,617,3005,3458,6463
00348500,CUMBERLAND UNIVERSITY                   ,TN,37087-3554,Private      ,28,114,142,1374,958,2332
00348600,LIPSCOMB UNIVERSITY                     ,TN,37204-3951,Private      ,57,158,215,3070,1659,4729
00348700,EAST TENNESSEE STATE UNIV - MAIN CAMPUS ,TN,37614-2857,Public       ,243,549,792,10323,7363,17686
00348701,EAST TENNESSEE STATE UNIV - MEDICINE    ,TN,37614-1708,Public       ,10,22,32,214,458,672
00348709,EAST TENNESSEE STATE UNIV - PHARMACY    ,TN,37614-1704,Public       ,9,9,18,80,395,475
00349000,FISK UNIVERSITY                         ,TN,37208-3045,Private      ,36,38,74,1210,464,1674
00349200,FREED-HARDEMAN UNIVERSITY               ,TN,38340-2399,Private      ,17,48,65,1729,911,2640
00349500,JOHNSON BIBLE COLLEGE                   ,TN,37998-9775,Private      ,15,22,37,594,317,911
00349600,KING COLLEGE                            ,TN,37620-2699,Private      ,18,91,109,1214,1169,2383
00349800,LAMBUTH UNIVERSITY                      ,TN,38301-5296,Private      ,14,28,42,1130,369,1499
00349900,LANE COLLEGE                            ,TN,38301-4598,Private      ,69,68,137,3148,1203,4351
00350000,LEE UNIVERSITY                          ,TN,37320-0000,Private      ,68,79,147,3516,1360,4876
00350100,LEMOYNE-OWEN COLLEGE                    ,TN,38126-6510,Private      ,42,154,196,1012,1472,2484
00350200,LINCOLN MEMORIAL UNIVERSITY             ,TN,37752-7920,Private      ,31,174,205,1592,3653,5245
00350400,MARTIN METHODIST COLLEGE                ,TN,38478-2799,Private      ,16,51,67,849,527,1376
00350500,MARYVILLE COLLEGE                       ,TN,37804-5907,Private      ,27,22,49,1878,240,2118
00350600,MEHARRY MEDICAL COLLEGE                 ,TN,37208-0000,Private      ,3,35,38,39,1320,1359
00350700,MEMPHIS COLLEGE OF ART                  ,TN,38104-2764,Private      ,15,17,32,610,246,856
00350900,UNIVERSITY OF MEMPHIS (THE)             ,TN,38152-4611,Public       ,377,1243,1620,15317,16798,32115
00351000,MIDDLE TENNESSEE STATE UNIV             ,TN,37130-0000,Public       ,595,1013,1608,21274,12110,33384
00351100,MILLIGAN COLLEGE                        ,TN,37682-4001,Private      ,11,38,49,1074,589,1663
00351700,SOUTHERN COLLEGE OF OPTOMETRY           ,TN,38104-2222,Private      ,2,2,4,13,567,580
00351800,SOUTHERN ADVENTIST UNIVERSITY           ,TN,37315-0370,Private      ,66,52,118,2320,682,3002
00351900,RHODES COLLEGE                          ,TN,38112-1690,Private      ,48,21,69,2631,311,2942
00352200,TENNESSEE STATE UNIVERSITY              ,TN,37209-1561,Public       ,286,741,1027,10429,8428,18857
00352201,TENNESSEE STATE UNIVERSITY - AVON WILLIA,TN,37203-3401,Public       ,0,0,0,205,106,311
00352300,TENNESSEE TECHNOLOGICAL UNIV            ,TN,38505-0001,Public       ,198,302,500,8950,4053,13003
00352400,TENNESSEE TEMPLE UNIVERSITY             ,TN,37404-3587,Private      ,20,111,131,511,533,1044
00352500,TENNESSEE WESLEYAN COLLEGE              ,TN,37371-0040,Private      ,14,26,40,1188,521,1709
00352600,TREVECCA NAZARENE UNIVERSITY            ,TN,37210-2877,Private      ,19,158,177,1301,2144,3445
00352700,TUSCULUM COLLEGE                        ,TN,37743-0001,Private      ,57,148,205,2137,1923,4060
00352800,UNION UNIVERSITY                        ,TN,38305-3697,Private      ,42,234,276,2622,2536,5158
00352900,UNIVERSITY OF TENNESSEE-CHATTANOOGA     ,TN,37403-2598,Public       ,258,359,617,11594,4486,16080
00353000,UNIVERSITY OF TENNESSEE-KNOXVILLE       ,TN,37996-0150,Public       ,466,545,1011,24220,9850,34070
00353006,UNIVERSITY OF TENNESSEE-HEALTH SCI CTR  ,TN,38103-0000,Public       ,9,76,85,297,3066,3363
00353100,UNIVERSITY OF TENNESSEE-MARTIN          ,TN,38238-0002,Public       ,111,234,345,7155,3408,10563
00353400,UNIVERSITY OF THE SOUTH                 ,TN,37383-1000,Private      ,23,9,32,1735,92,1827
00353500,VANDERBILT UNIVERSITY                   ,TN,37240-0001,Private      ,202,173,375,12702,6480,19182
00353501,VANDERBILT UNIV MED CTR ALLIEDHEAL      ,TN,37232-5510,Private      ,0,11,11,42,223,265
00353502,VANDERBILT UNIV - SCH OF MED            ,TN,37232-0000,Private      ,7,12,19,106,1027,1133
00353600,BRYAN COLLEGE                           ,TN,37321-7000,Private      ,20,51,71,995,566,1561
00399800,CHATTANOOGA STATE COMMUNITY COLLEGE     ,TN,37406-1097,Public       ,341,1125,1466,4790,8353,13143
00399900,CLEVELAND STATE COMMUNITY COLLEGE       ,TN,37312-2858,Public       ,98,349,447,1814,2743,4557
00402500,TN TECHNOLOGY CTR AT KNOXVILLE          ,TN,37919-2327,Public       ,52,230,282,442,1504,1946
00402600,TENNESSEE TECH. CNTR AT CROSSVILLE      ,TN,38555-4142,Public       ,21,79,100,327,613,940
00461700,NATIONAL COLLEGE OF BUSINESS & TECH     ,TN,37211-6605,Proprietary  ,72,357,429,432,2874,3306
00493400,DRAUGHONS JR CLG OF BUSINESS            ,TN,37217-1056,Proprietary  ,92,493,585,521,2988,3509
00493700,JACKSON STATE COMMUNITY COLLEGE         ,TN,38301-3797,Public       ,143,518,661,2857,4422,7279
00493800,SOUTH COLLEGE                           ,TN,37909-3323,Proprietary  ,50,301,351,444,1977,2421
00494700,WEST TENNESSEE BUSINESS COLLEGE         ,TN,38301-3256,Proprietary  ,18,81,99,126,625,751
00528000,TN TECHNOLOGY CTR AT COVINGTON          ,TN,38019-0249,Public       ,14,35,49,167,361,528
00528100,TN TECHNOLOGY CTR AT ELIZABETHTON       ,TN,37643-0789,Public       ,17,140,157,289,1054,1343
00528200,TN TECHNOLOGY CTR AT HARTSVILLE         ,TN,37074-0000,Public       ,15,67,82,222,483,705
00528300,TN TECHNOLOGY CTR AT NEWBERN            ,TN,38059-1198,Public       ,9,64,73,188,556,744
00530700,TN TECHNOLOGY CTR AT MCMINNVILLE        ,TN,37110-1322,Public       ,19,58,77,180,577,757
00535100,TENNESSEE TECHNOLOGY CENTER AT MORRISTOW,TN,37813-2094,Public       ,38,143,181,478,1309,1787
00535200,TN TECHNOLOGY CENTER AT MCKENZIE        ,TN,38201-1620,Public       ,8,60,68,169,563,732
00535300,TN TECHNOLOGY CENTER AT LIVINGSTON      ,TN,38570-0219,Public       ,12,49,61,254,495,749
00535400,TN TECHNOLOGY CTR AT JACKSON            ,TN,38301-0000,Public       ,27,112,139,434,1387,1821
00535600,TENNESSEE TECHNOLOGY CENTER AT HOHENWALD,TN,38462-0000,Public       ,16,112,128,271,658,929
00535700,TENNESSEE TECHNOLOGY CENTER AT CRUMP    ,TN,38327-3402,Public       ,13,76,89,257,589,846
00535800,TN TECHNOLOGY CENTER AT ATHENS          ,TN,37371-0848,Public       ,17,39,56,290,534,824
00535900,TENNESSEE TECHNOLOGY CENTER AT NASHVILLE,TN,37209-0000,Public       ,53,292,345,466,1559,2025
00536000,TENNESSEE TECHNOLOGY CENTER AT MEMPHIS  ,TN,38105-3604,Public       ,80,288,368,831,2291,3122
00537800,NORTHEAST STATE TECH CMNTY COLG         ,TN,37617-0246,Public       ,177,639,816,3047,4866,7913
00537900,TN TECHNOLOGY CTR AT SHELBYVILLE        ,TN,37160-3697,Public       ,26,71,97,365,1037,1402
00683500,DYERSBURG STATE COMMUNITY COLLEGE       ,TN,38024-0000,Public       ,87,381,468,1690,3052,4742
00683600,MOTLOW STATE COMMUNITY COLLEGE          ,TN,37388-7972,Public       ,172,459,631,2863,3472,6335
00743900,FOUNTAINHEAD COLLEGE OF TECHNOLOGY      ,TN,37918-2583,Proprietary  ,17,85,102,128,434,562
00744000,NASHVILLE AUTO DIESEL COLLEGE           ,TN,37206-3298,Proprietary  ,279,198,477,2665,1138,3803
00778200,TENNESSEE TECHNOLOGY CENTER AT DICKSON  ,TN,37055-0000,Public       ,33,158,191,350,955,1305
00778300,MIDDLE TENNESSEE SCH OF ANESTHESIA      ,TN,37116-0417,Private      ,1,4,5,18,164,182
00814500,NASHVILLE STATE TECH CMNTY COLLEGE      ,TN,37209-0000,Public       ,315,1100,1415,3241,7248,10489
00865500,GENESIS CAREER COLLEGE OF COOKEVILLE    ,TN,38501-1959,Proprietary  ,14,45,59,48,139,187
00885900,JOHN A GUPTON COLLEGE                   ,TN,37203-2934,Private      ,5,27,32,96,167,263
00886300,WALTERS STATE COMMUNITY COLLEGE         ,TN,37813-6899,Public       ,236,675,911,4085,5047,9132
00946400,TN TECHNOLOGY CTR AT PULASKI            ,TN,38478-4541,Public       ,18,114,132,144,545,689
00956700,TENNESSEE SCHOOL OF BEAUTY              ,TN,37921-3303,Proprietary  ,35,68,103,191,390,581
00971000,TENNESSEE TECHNOLOGY CENTER AT ONEIDA/HU,TN,37756-4149,Public       ,19,49,68,128,332,460
00991200,VOLUNTEER STATE COMMUNITY COLLEGE       ,TN,37066-3188,Public       ,244,775,1019,3840,5545,9385
00991400,ROANE STATE COMMUNITY COLLEGE           ,TN,37748-8664,Public       ,196,542,738,3629,4502,8131
00998200,CRICHTON COLLEGE                        ,TN,38111-4745,Private      ,13,105,118,257,1285,1542
01021700,INTERNATIONAL ACADEMY OF DESIGN & TECH  ,TN,37212-0000,Proprietary  ,49,89,138,507,671,1178
01032600,TN TECHNOLOGY CTR AT HARRIMAN           ,TN,37748-1109,Public       ,17,64,81,210,431,641
01043900,SOUTHWEST TENNESSEE COMMUNITY COLLG     ,TN,38104-3322,Public       ,543,1832,2375,7073,14755,21828
01044700,"PLAZA BEAUTY SCHOOL, INC.               ",TN,38117-4822,Proprietary  ,9,37,46,64,195,259
01046000,AMERICAN BAPTIST THEOLOGICAL SEMINA     ,TN,37207-4994,Private      ,0,9,9,16,119,135
01052900,MEMPHIS THEOLOGICAL SEMINARY            ,TN,38104-0000,Private      ,0,24,24,2,239,241
01070000,TN TECHNOLOGY CENTER AT JACKSBORO       ,TN,37757-2461,Public       ,13,28,41,140,331,471
01155300,WM R MOORE COLLEGE OF TECHNOLOGY        ,TN,38104-0000,Private      ,13,46,59,84,229,313
01216400,TENNESSEE TECHNICAL CNTR AT RIPLEY      ,TN,38063-7359,Public       ,9,67,76,78,438,516
01254700,EMMANUEL SCHOOL OF RELIGION             ,TN,37601-0000,Private      ,1,5,6,2,79,81
01269300,PELLISSIPPI STATE COMMUNITY COLLEGE     ,TN,37933-0990,Public       ,324,785,1109,5382,5683,11065
02069303,VATTEROTT COLLEGE -                     ,TN,38016-5877,Proprietary  ,15,99,114,82,367,449
02092800,TENNESSEE TECHNOLOGY CENTER AT WHITEVILL,TN,38075-0000,Public       ,16,58,74,168,412,580
02103500,TN TECHNOLOGY CTR AT MURFREESBORO       ,TN,37129-0000,Public       ,13,97,110,249,722,971
02106400,O'MORE COLLEGE OF DESIGN                ,TN,37064-0000,Private      ,8,6,14,186,63,249
02125300,NASHVILLE CLG OF MEDICAL CAREERS        ,TN,37115-0000,Proprietary  ,7,45,52,49,266,315
02153100,JON NAVE UNIVERSITY OF COSMETOLOGY      ,TN,37013-3347,Proprietary  ,28,69,97,160,251,411
02157100,CONCORDE CAREER COLLEGE                 ,TN,38137-0000,Proprietary  ,60,312,372,375,1809,2184
02188300,PENTECOSTAL THEOLOGICAL SEMINARY        ,TN,37320-0000,Private      ,0,18,18,4,225,229
02204200,"CHATTANOOGA COLLEGE - MEDICAL, DENTAL AN",TN,37411-0000,Proprietary  ,21,127,148,114,636,750
02237900,TN TECHNOLOGY CENTER AT PARIS           ,TN,38242-0000,Public       ,17,102,119,158,707,865
02257400,ARNOLD'S BEAUTY SCHOOL                  ,TN,38358-0000,Proprietary  ,6,19,25,38,68,106
02263104,HIGH-TECH INSTITUTE - NASHVILLE         ,TN,37214-2531,Proprietary  ,4,34,38,56,161,217
02275500,REUBEN-ALLEN COLLEGE                    ,TN,37922-0000,Proprietary  ,9,15,24,46,74,120
02278700,MR WAYNES SCH OF UNISEX HAIR DESIGN     ,TN,38501-0000,Proprietary  ,6,11,17,20,48,68
02293900,VOLUNTEER BEAUTY ACADEMY-NASHVILLE      ,TN,37115-2112,Proprietary  ,8,19,27,32,121,153
02294000,VOLUNTEER BEAUTY ACADEMY-DYERSBURG      ,TN,38024-1622,Proprietary  ,2,12,14,17,86,103
02326200,KAPLAN CAREER INSTITUTE                 ,TN,37217-1342,Proprietary  ,33,266,299,233,1370,1603
02326202,KAPLAN CAREER INSTITUTE - THOMPSON LANE ,TN,37204-3692,Proprietary  ,0,8,8,21,118,139
02326300,MEDVANCE INSTITUTE                      ,TN,38501-4305,Proprietary  ,20,105,125,137,578,715
02335900,VOLUNTEER BEAUTY ACADEMY-NASHVILLE      ,TN,37209-3033,Proprietary  ,1,15,16,17,92,109
02359800,ITT TECHNICAL INSTITUTE                 ,TN,37214-3717,Proprietary  ,248,706,954,1216,3068,4284
02498000,NEW WAVE HAIR ACADEMY                   ,TN,38128-0000,Proprietary  ,0,0,0,29,90,119
02539800,QUEEN CITY COLLEGE                      ,TN,37042-0000,Proprietary  ,8,39,47,44,227,271
02540000,TENNESSEE ACADEMY OF COSMETOLOGY        ,TN,38133-0000,Proprietary  ,9,37,46,54,172,226
02578200,NOSSI COLLEGE OF ART                    ,TN,37072-0000,Proprietary  ,15,31,46,316,355,671
02595000,FAYETTEVILLE BEAUTY SCHOOL              ,TN,37334-2909,Proprietary  ,3,20,23,17,78,95
02597600,NEW WAVE HAIR ACADEMY                   ,TN,38301-3812,Proprietary  ,0,0,0,28,107,135
02599710,VATTEROTT COLLEGE - MEMPHIS             ,TN,38132-1714,Proprietary  ,19,127,146,160,932,1092
02605501,REMINGTON COLLEGE - MEMPHIS CAMPUS      ,TN,38132-0000,Proprietary  ,67,342,409,444,1765,2209
02609204,VATTEROTT COLLEGE - VATTEROTT CAREER COL,TN,38133-4727,Proprietary  ,10,90,100,96,443,539
02614200,MILLER MOTTE BUSINESS COLLEGE           ,TN,37040-6023,Proprietary  ,39,152,191,289,1117,1406
02614203,MILLER - MOTTE TECHNICAL COLLEGE - CHATT,TN,37421-7220,Proprietary  ,27,144,171,230,1037,1267
02614204,MILLER - MOTTE TECHNICAL COLLEGE - GOODL,TN,37072-1870,Proprietary  ,22,110,132,94,434,528
03001800,FREE WILL BAPTIST BIBLE COLLEGE         ,TN,37205-2498,Private      ,9,13,22,233,149,382
03008800,FRANKLIN ACADEMY                        ,TN,37312-3939,Private      ,4,12,16,28,78,106
03010606,VIRGINIA COLLEGE - SCH OF BUSNSS & HLTH ,TN,37411-5600,Proprietary  ,3,51,54,48,320,368
03012500,NEW WAVE HAIR ACADEMY                   ,TN,38111-4253,Proprietary  ,0,0,0,50,173,223
03024900,TENNESSEE ACADEMY OF COSMETOLOGY        ,TN,38125-3442,Proprietary  ,7,23,30,54,157,211
03061100,GENESIS CAREER COLLEGE OF LEBANON       ,TN,37087-2718,Proprietary  ,17,69,86,102,319,421
03073400,ITT TECHNICAL INSTITUTE                 ,TN,37932-3343,Proprietary  ,296,734,1030,1453,3746,5199
03076405,HIGH-TECH INSTITUTE - MEMPHIS           ,TN,38134-7345,Proprietary  ,8,43,51,66,265,331
03079100,NORTH CENTRAL INSTITUTE                 ,TN,37042-3116,Proprietary  ,1,16,17,16,86,102
03088800,WATKINS INSTITUTE COLLEGE OF ART & DESIG,TN,37228-1306,Private      ,18,21,39,458,284,742
03126900,STYLES & PROFILES BEAUTY COLLEGE        ,TN,38375-2109,Proprietary  ,1,7,8,8,30,38
03149300,NEW DIRECTIONS HAIR ACADEMY             ,TN,37209-0000,Proprietary  ,0,0,0,44,126,170
03355400,RICHMONT GRADUATE UNIVERSITY            ,TN,37404-0000,Private      ,0,14,14,4,230,234
03440300,BAPTIST MEMORIAL COLLEGE OF HEALTH      ,TN,38104-3104,Private      ,20,117,137,749,1580,2329
03480303,MEDVANCE INSTITUTE - NASHVILLE          ,TN,37203-1536,Proprietary  ,35,192,227,154,761,915
03513500,WILLIAMSON CHRISTIAN COLLEGE            ,TN,37067-8237,Private      ,0,7,7,3,50,53
03647300,NEW CONCEPTS SCHOOL OF COSMETOLOGY      ,TN,37311-7373,Proprietary  ,3,16,19,17,51,68
03683300,INTERNATIONAL BARBER & STYLE COLLEGE    ,TN,37209-0000,Proprietary  ,7,65,72,38,220,258
03701300,MEMPHIS INSTITUTE OF BARBERING          ,TN,38107-4334,Proprietary  ,6,36,42,60,240,300
03774400,SHEAR ACADEMY                           ,TN,38555-4177,Proprietary  ,3,12,15,8,36,44
03830300,SAE INSTITUTE OF TECHNOLOGY             ,TN,37203-4310,Proprietary  ,23,34,57,168,245,413
03841300,CAREER BEAUTY COLLEGE                   ,TN,38464-3634,Proprietary  ,0,5,5,11,29,40
03920300,INSTITUTE OF HAIR DESIGN                ,TN,38310-1801,Proprietary  ,1,6,7,20,35,55
03930300,BUCHANAN BEAUTY COLLEGE                 ,TN,37160-2741,Proprietary  ,2,22,24,14,92,106
03982300,VISIBLE SCHOOL - MUSIC AND WORSHIPS ARTS,TN,38104-5814,Private      ,6,6,12,92,38,130
04025300,LAST MINUTE CUTS SCHOOL OF BARBERING AND,TN,38109-7709,Proprietary  ,0,0,0,9,18,27
04035300,NAVE COSMETOLOGY ACADEMY                ,TN,38401-6335,Proprietary  ,15,24,39,53,168,221
04124100,ELITE COLLEGE OF COSMETOLOGY            ,TN,38351-1431,Proprietary  ,6,20,26,27,80,107
04157200,LOVE BEAUTY SCHOOL                      ,TN,37355-2950,Proprietary  ,3,20,23,3,20,23
00353700,ABILENE CHRISTIAN UNIVERSITY            ,TX,79699-3701,Private      ,139,156,295,4374,1601,5975
00353900,ALVIN COMMUNITY COLLEGE                 ,TX,77511-4807,Public       ,124,337,461,1015,2151,3166
00354000,AMARILLO COLLEGE                        ,TX,79109-2446,Public       ,309,1066,1375,3040,6646,9686
00354100,ANGELO STATE UNIVERSITY                 ,TX,76909-5069,Public       ,203,222,425,5937,2498,8435
00354300,AUSTIN COLLEGE                          ,TX,75090-4440,Private      ,30,18,48,1925,175,2100
00354400,AUSTIN PRESBYTERIAN THEOLOGICAL SEM     ,TX,78705-5797,Private      ,0,9,9,0,138,138
00354500,BAYLOR UNIVERSITY                       ,TX,76798-1458,Private      ,524,252,776,18001,4306,22307
00354600,COASTAL BEND COLLEGE                    ,TX,78102-2197,Public       ,119,357,476,1675,2509,4184
00354900,BLINN COLLEGE                           ,TX,77833-4098,Public       ,552,626,1178,9061,4248,13309
00355300,CISCO JUNIOR COLLEGE                    ,TX,76437-9803,Public       ,122,403,525,1878,2503,4381
00355400,CLARENDON COLLEGE                       ,TX,79226-0000,Public       ,35,108,143,505,592,1097
00355600,COMMONWEALTH INST OF FUNERAL SVC        ,TX,77090-5918,Private      ,5,31,36,52,194,246
00355700,CONCORDIA UNIVERSITY TEXAS              ,TX,78726-4141,Private      ,47,256,303,1218,2079,3297
00355800,NORTH CENTRAL TEXAS COLLEGE             ,TX,76240-4699,Public       ,260,622,882,2675,3951,6626
00356000,DALLAS BAPTIST UNIVERSITY               ,TX,75211-9299,Private      ,121,432,553,2491,4094,6585
00356100,CEDAR VALLEY COLLEGE                    ,TX,75134-0000,Public       ,161,618,779,1832,4039,5871
00356200,DALLAS THEOLOGICAL SEM                  ,TX,75204-0000,Private      ,1,80,81,15,629,644
00356300,DEL MAR COLLEGE                         ,TX,78404-3897,Public       ,437,1126,1563,4820,7468,12288
00356400,EAST TEXAS BAPTIST UNIVERSITY           ,TX,75670-1423,Private      ,38,27,65,1429,355,1784
00356500,TEXAS A&M UNIVERSITY - COMMERCE         ,TX,75429-3011,Public       ,166,586,752,4153,6193,10346
00356600,EPISCOPAL THEOL SEM OF THE STHWST       ,TX,78768-0000,Private      ,0,0,0,1,13,14
00356800,FRANK PHILLIPS COLLEGE                  ,TX,79008-0000,Public       ,28,101,129,438,600,1038
00357000,GRAYSON COUNTY COLLEGE                  ,TX,75020-8299,Public       ,125,548,673,1519,3411,4930
00357100,HARDIN-SIMMONS UNIVERSITY               ,TX,79698-6050,Private      ,61,66,127,2218,958,3176
00357200,TRINITY VALLEY COMMUNITY COLLEGE        ,TX,75751-2734,Public       ,160,601,761,2003,3905,5908
00357300,HILL COLLEGE                            ,TX,76645-2711,Public       ,73,226,299,822,1189,2011
00357301,HILL COLLEGE                            ,TX,76031-0000,Public       ,74,276,350,641,1687,2328
00357400,HOWARD COLLEGE                          ,TX,79720-0213,Public       ,98,327,425,1205,2232,3437
00357500,HOWARD PAYNE UNIVERSITY                 ,TX,76801-2715,Private      ,32,38,70,1245,394,1639
00357600,HOUSTON BAPTIST UNIVERSITY              ,TX,77074-3298,Private      ,142,203,345,3888,2170,6058
00357700,HUSTON - TILLOTSON UNIVERSITY           ,TX,78702-2795,Private      ,32,47,79,956,608,1564
00357800,UNIVERSITY OF THE INCARNATE WORD        ,TX,78209-6398,Private      ,115,327,442,4312,4605,8917
00357900,JACKSONVILLE COLLEGE                    ,TX,75766-4759,Private      ,11,23,34,220,167,387
00358000,KILGORE COLLEGE                         ,TX,75662-3299,Public       ,225,827,1052,2852,4489,7341
00358100,LAMAR UNIVERSITY-BEAUMONT               ,TX,77710-0042,Public       ,374,1032,1406,7533,6707,14240
00358200,LAREDO COMMUNITY COLLEGE                ,TX,78040-4395,Public       ,490,616,1106,5382,4724,10106
00358300,LEE COLLEGE                             ,TX,77520-4796,Public       ,157,548,705,1527,3610,5137
00358400,LETOURNEAU UNIVERSITY                   ,TX,75607-0000,Private      ,40,270,310,1539,3268,4807
00358500,LON MORRIS COLLEGE                      ,TX,75766-2900,Private      ,34,26,60,776,202,978
00358600,LUBBOCK CHRISTIAN UNIVERSITY            ,TX,79407-2099,Private      ,68,125,193,1347,1262,2609
00358800,UNIVERSITY OF MARY HARDIN-BAYLOR        ,TX,76513-2599,Private      ,70,101,171,3108,1309,4417
00359000,MCLENNAN COMMUNITY COLLEGE              ,TX,76708-1498,Public       ,286,953,1239,3712,6978,10690
00359100,MCMURRY UNIVERSITY                      ,TX,79697-0001,Private      ,51,67,118,1767,731,2498
00359200,MIDWESTERN STATE UNIVERSITY             ,TX,76308-2099,Public       ,167,279,446,3986,2935,6921
00359300,NAVARRO COLLEGE                         ,TX,75110-4818,Public       ,270,797,1067,3704,5197,8901
00359400,UNIVERSITY OF NORTH TEXAS               ,TX,76203-1370,Public       ,908,1546,2454,24422,18600,43022
00359500,OBLATE SCHOOL OF THEOLOGY               ,TX,78216-0000,Private      ,0,2,2,4,21,25
00359600,ODESSA COLLEGE                          ,TX,79764-7127,Public       ,202,473,675,1639,2919,4558
00359800,OUR LADY OF THE LAKE UNIVERSITY         ,TX,78207-4689,Private      ,60,179,239,1886,2627,4513
00359900,UNIVERSITY OF TEXAS - PAN AMERICAN      ,TX,78541-2999,Public       ,489,648,1137,14423,9644,24067
00360000,PANOLA COLLEGE                          ,TX,75633-2397,Public       ,59,245,304,803,1473,2276
00360100,PARIS JR COLLEGE                        ,TX,75460-6298,Public       ,132,527,659,1787,3236,5023
00360200,PAUL QUINN COLLEGE                      ,TX,75241-4398,Private      ,18,60,78,406,691,1097
00360300,RANGER COLLEGE                          ,TX,76470-3298,Public       ,19,39,58,430,359,789
00360400,RICE UNIVERSITY                         ,TX,77251-1892,Private      ,233,165,398,8056,2220,10276
00360600,SAM HOUSTON STATE UNIVERSITY            ,TX,77340-0000,Public       ,539,569,1108,13703,6592,20295
00360700,ALAMO CMTY CLG DISTRICT PROGRAM         ,TX,78207-0000,Public       ,42,119,161,490,744,1234
00360800,ST PHILLIPS COLLEGE                     ,TX,78203-2098,Public       ,418,1442,1860,4653,9772,14425
00360900,SAN JACINTO CLG-CENTRAL-NORTH-SOUTH     ,TX,77501-0000,Public       ,681,1782,2463,7083,10878,17961
00361000,SCHREINER UNIVERSITY                    ,TX,78028-5697,Private      ,30,53,83,1331,476,1807
00361100,SOUTH PLAINS COLLEGE                    ,TX,79336-6504,Public       ,312,711,1023,4557,5241,9798
00361200,UNIV OF HOUSTON-DOWNTOWN                ,TX,77002-1001,Public       ,310,820,1130,6129,9789,15918
00361300,SOUTHERN METHODIST UNIVERSITY           ,TX,75275-0181,Private      ,194,400,594,5984,5437,11421
00361400,SOUTHWEST TEXAS JR COLLEGE              ,TX,78801-6221,Public       ,199,495,694,2481,3245,5726
00361500,TEXAS STATE UNIVERSITY--SAN MARCOS      ,TX,78666-4602,Public       ,965,956,1921,24136,13455,37591
00361600,SOUTHWESTERN ASSEMBLIES OF GOD UNIV     ,TX,75165-2397,Private      ,61,122,183,1500,1185,2685
00361700,SOUTHWESTERN BAPTIST THEOL SEMINARY     ,TX,76122-0000,Private      ,3,17,20,45,177,222
00361800,SOUTHWESTERN CHRISTIAN COLLEGE          ,TX,75160-3400,Private      ,6,13,19,213,112,325
00361900,SOUTHWESTERN ADVENTIST UNIVERSITY       ,TX,76059-1922,Private      ,12,38,50,633,424,1057
00362000,SOUTHWESTERN UNIVERSITY                 ,TX,78626-6111,Private      ,58,29,87,2181,223,2404
00362100,ST EDWARDS UNIVERSITY                   ,TX,78704-0000,Private      ,118,232,350,4638,2673,7311
00362300,ST MARY'S UNIV OF SAN ANTONIO           ,TX,78228-8500,Private      ,93,114,207,3572,2842,6414
00362400,STEPHEN F AUSTIN STATE UNIVERSITY       ,TX,75962-0001,Public       ,407,352,759,12254,4659,16913
00362500,SUL ROSS STATE UNIVERSITY               ,TX,79832-0113,Public       ,41,151,192,1523,1951,3474
00362600,TARRANT COUNTY COLLEGE                  ,TX,76102-6599,Public       ,1412,3518,4930,13656,22970,36626
00362700,TEMPLE COLLEGE                          ,TX,76504-7435,Public       ,174,624,798,2088,4464,6552
00362800,TEXARKANA COLLEGE                       ,TX,75599-0001,Public       ,118,447,565,1689,2878,4567
00363000,PRAIRIE VIEW A&M UNIVERSITY             ,TX,77446-2967,Public       ,315,448,763,9929,5940,15869
00363100,TARLETON STATE UNIVERSITY               ,TX,76402-0000,Public       ,234,422,656,6083,5466,11549
00363200,TEXAS A&M UNIVERSITY                    ,TX,77842-0000,Public       ,1169,546,1715,34938,8534,43472
00363204,TEXAS A&M UNIVERSITY - GALVESTON        ,TX,77553-1675,Public       ,0,0,0,417,146,563
00363400,TEXAS STATE TECHNICAL CLG AT WACO       ,TX,76705-1695,Public       ,242,681,923,3014,4050,7064
00363500,TEXAS CHIROPRACTIC COLLEGE              ,TX,77505-1699,Private      ,1,15,16,12,419,431
00363600,TEXAS CHRISTIAN UNIVERSITY              ,TX,76129-0001,Private      ,301,268,569,8817,3050,11867
00363700,JARVIS CHRISTIAN COLLEGE                ,TX,75765-1470,Private      ,27,21,48,720,283,1003
00363800,TEXAS COLLEGE                           ,TX,75702-4500,Private      ,31,70,101,855,693,1548
00363900,TEXAS A&M UNIVERSITY-KINGSVILLE         ,TX,78363-8203,Public       ,220,357,577,6068,5191,11259
00364100,TEXAS LUTHERAN UNIVERSITY               ,TX,78155-5999,Private      ,35,27,62,1816,291,2107
00364200,TEXAS SOUTHERN UNIVERSITY               ,TX,77004-4598,Public       ,369,881,1250,9264,11347,20611
00364300,TEXAS SOUTHMOST COLLEGE                 ,TX,78520-4992,Public       ,16,52,68,217,361,578
00364400,TEXAS TECH UNIVERSITY                   ,TX,79409-0000,Public       ,785,638,1423,21550,9651,31201
00364500,TEXAS WESLEYAN UNIVERSITY               ,TX,76105-1536,Private      ,58,198,256,1196,3741,4937
00364600,TEXAS WOMAN'S UNIVERSITY                ,TX,76204-5587,Public       ,187,787,974,5464,10288,15752
00364700,TRINITY UNIVERSITY                      ,TX,78212-7200,Private      ,69,43,112,3342,527,3869
00364800,TYLER JUNIOR COLLEGE                    ,TX,75701-3436,Public       ,455,1034,1489,6618,6875,13493
00365100,UNIVERSITY OF DALLAS                    ,TX,75062-4799,Private      ,34,141,175,1868,1349,3217
00365200,UNIVERSITY OF HOUSTON                   ,TX,77204-2010,Public       ,1089,1934,3023,26449,23440,49889
00365400,UNIVERSITY OF ST THOMAS                 ,TX,77006-4626,Private      ,36,238,274,1538,1413,2951
00365600,UNIVERSITY OF TEXAS-ARLINGTON           ,TX,76019-0000,Public       ,641,1699,2340,17170,19755,36925
00365800,UNIVERSITY OF TEXAS-AUSTIN              ,TX,78713-7758,Public       ,1094,945,2039,39552,19609,59161
00365900,UT HEALTH CENTER-SAN ANTONIO            ,TX,78229-3900,Public       ,34,147,181,608,3101,3709
00366100,UNIVERSITY OF TEXAS-EL PASO             ,TX,79968-0629,Public       ,369,742,1111,11997,10966,22963
00366200,VICTORIA COLLEGE (THE)                  ,TX,77901-4494,Public       ,142,428,570,1376,2627,4003
00366300,WAYLAND BAPTIST UNIVERSITY              ,TX,79072-6998,Private      ,38,354,392,1014,3217,4231
00366400,WEATHERFORD COLLEGE                     ,TX,76086-5699,Public       ,199,492,691,2070,2877,4947
00366500,WEST TEXAS A&M UNIVERSITY               ,TX,79016-0000,Public       ,168,301,469,4991,3667,8658
00366800,WHARTON COUNTY JR COLLEGE               ,TX,77488-3298,Public       ,239,500,739,2311,2788,5099
00366900,WILEY COLLEGE                           ,TX,75670-5199,Private      ,37,71,108,968,819,1787
00400300,CENTRAL TEXAS COLLEGE                   ,TX,76540-4199,Public       ,282,1775,2057,2370,11182,13552
00407221,NORTHWOOD UNIVERSITY                    ,TX,75104-0000,Private      ,11,88,99,597,827,1424
00445300,EL CENTRO COLLEGE                       ,TX,75202-0000,Public       ,299,1430,1729,3096,8304,11400
00481102,EVEREST INSTITUTE - EVEREST COLLEGE     ,TX,76011-6750,Proprietary  ,36,224,260,239,1024,1263
00494800,TEXAS A&M UNIV SYSTEM HEALTH SCI CT     ,TX,77840-7896,Public       ,53,45,98,567,1632,2199
00494900,BAYLOR COLLEGE OF MEDICINE              ,TX,77030-0000,Private      ,23,45,68,236,1355,1591
00495100,UNIV OF TEXAS HEALTH SCIENCE CENTER     ,TX,77225-0000,Public       ,19,160,179,388,2945,3333
00495200,UNIV OF TEXAS MEDICAL BRANCH            ,TX,77550-0000,Public       ,18,112,130,202,2186,2388
00497200,GALVESTON COLLEGE                       ,TX,77550-7447,Public       ,93,236,329,844,1427,2271
00497700,SOUTH TEXAS COLLEGE OF LAW              ,TX,77002-0000,Private      ,1,74,75,34,2130,2164
00520307,REMINGTON COLLEGE - DALLAS CAMPUS       ,TX,75041-9935,Proprietary  ,11,64,75,94,289,383
00660600,BAPTIST HS SCHOOL OF HEALTH PROFESSIONS ,TX,78229-3234,Proprietary  ,23,117,140,164,889,1053
00661200,COVENANT SCH OF NSG & ALLIED HEALTH     ,TX,79410-0000,Private      ,9,30,39,129,354,483
00666100,ANGELINA COLLEGE                        ,TX,75902-0000,Public       ,175,641,816,2056,3603,5659
00694100,DALLAS CHRISTIAN COLLEGE                ,TX,75234-7229,Private      ,11,37,48,229,353,582
00709600,COLLEGE OF THE MAINLAND                 ,TX,77591-2499,Public       ,124,464,588,993,2545,3538
00728700,BRAZOSPORT COLLEGE                      ,TX,77566-3199,Public       ,85,278,363,1068,1599,2667
00732907,ITT TECHNICAL INSTITUTE                 ,TX,77063-3751,Proprietary  ,11,96,107,147,458,605
00754805,WESTWOOD COLLEGE OF TECHNOLOGY          ,TX,77074-0000,Proprietary  ,59,174,233,471,814,1285
00758602,REMINGTON COLLEGE - FORT WORTH CAMPUS   ,TX,76112-1280,Proprietary  ,65,222,287,347,1075,1422
00835300,LINCOLN COLLEGE OF TECHNOLOGY           ,TX,75052-0000,Proprietary  ,219,282,501,1213,1384,2597
00849800,MIMS CLASSIC BEAUTY COLLEGE             ,TX,78216-0000,Proprietary  ,4,14,18,27,67,94
00850300,MOUNTAIN VIEW COLLEGE                   ,TX,75211-6599,Public       ,223,773,996,2794,5248,8042
00850400,RICHLAND COLLEGE                        ,TX,75243-2199,Public       ,369,1039,1408,3966,6490,10456
00851000,EASTFIELD COLLEGE                       ,TX,75150-2099,Public       ,344,1030,1374,3311,6212,9523
00907905,EVEREST COLLEGE                         ,TX,75206-5209,Proprietary  ,74,406,480,425,1821,2246
00908200,INTERNATIONAL BUSINESS COLLEGE          ,TX,79903-0000,Proprietary  ,41,147,188,157,558,715
00916300,SAN ANTONIO COLLEGE                     ,TX,78212-4299,Public       ,996,2378,3374,11176,17754,28930
00922500,TEXAS STATE TECHNICAL COLLEGE  HARLINGEN,TX,78550-3697,Public       ,253,538,791,3216,3787,7003
00946600,KAPLAN CAREER INSTITUTE                 ,TX,78216-1899,Proprietary  ,59,264,323,338,1507,1845
00946607,SAN ANT COL OF MED & DENTAL - MCALLEN   ,TX,78503-1622,Proprietary  ,61,194,255,426,1159,1585
00946609,CAREER CENTERS OF TX - CORPUS CHRISTI   ,TX,78416-9900,Proprietary  ,33,174,207,187,1085,1272
00946610,KAPLAN CAREER INSTITUTE - CAREER CENTERS,TX,76103-2310,Proprietary  ,42,217,259,191,953,1144
00954900,WESTERN TEXAS COLLEGE                   ,TX,79549-9501,Public       ,19,72,91,625,456,1081
00965100,TEXAS A&M INTERNATIONAL UNIVERSITY      ,TX,78041-1900,Public       ,200,208,408,4307,3154,7461
00974100,UNIVERSITY OF TEXAS AT DALLAS           ,TX,75083-0000,Public       ,291,776,1067,7372,8537,15909
00976800,UNIVERSITY OF NORTH TEXAS HEALTH SCIENCE,TX,76107-2699,Public       ,10,54,64,132,1544,1676
00979700,MIDLAND COLLEGE                         ,TX,79705-6397,Public       ,139,376,515,1634,2611,4245
00982802,EVEREST INSTITUTE- AUSTIN               ,TX,78754-0000,Proprietary  ,86,398,484,353,1615,1968
00993000,UNIVERSITY OF TEXAS-PERMIAN BASIN       ,TX,79762-0001,Public       ,82,188,270,1660,2183,3843
00993200,TEXAS STATE TECH CLG-WEST TEXAS         ,TX,79556-4108,Public       ,46,148,194,614,970,1584
00993201,TEXAS STATE TECH COLLEGE-ABILENE        ,TX,79601-0000,Public       ,17,83,100,185,459,644
00993204,TEXAS STATE TECH CLG-BRECKENRIDGE       ,TX,76424-0000,Public       ,4,35,39,38,195,233
00993205,TEXAS STATE TECH COLLEGE-BROWNWOOD      ,TX,76801-0000,Public       ,19,70,89,115,384,499
01001900,UNIV OF TEXAS SOUTHWESTERN MED CTR      ,TX,75390-9096,Public       ,12,69,81,177,1779,1956
01005700,AMERICAN COMMERCIAL COLLEGE             ,TX,79602-1399,Proprietary  ,3,87,90,46,407,453
01005900,AMERICAN COMMERCIAL COLLEGE             ,TX,79761-0000,Proprietary  ,7,49,56,37,251,288
01005901,AMERICAN COMMERCIAL COLLEGE - AMERICAN C,TX,76310-2303,Proprietary  ,3,50,53,32,327,359
01006000,VERNON COLLEGE                          ,TX,76384-4092,Public       ,106,360,466,1085,2446,3531
01011500,UNIVERSITY OF TEXAS-SAN ANTONIO         ,TX,78249-0600,Public       ,846,1229,2075,24732,15847,40579
01013000,WADE COLLEGE                            ,TX,75207-3199,Proprietary  ,23,33,56,201,206,407
01038700,EL PASO COMMUNITY COLLEGE               ,TX,79998-0000,Public       ,919,1942,2861,12834,14552,27386
01050900,HALLMARK COLLEGE OF AERONAUTICS         ,TX,78214-0000,Proprietary  ,54,242,296,308,1170,1478
01062400,CENTRAL TEXAS COMMERCIAL COLLEGE        ,TX,75231-5033,Proprietary  ,5,48,53,30,154,184
01063300,HOUSTON COMMUNITY COLLEGE               ,TX,77002-0000,Public       ,1444,5208,6652,16847,35751,52598
01067400,TEXAS TECH U HEALTH SCIENCES CENTER     ,TX,79430-0000,Public       ,55,197,252,705,3075,3780
01076100,DALLAS INSTITUTE OF FUNERAL SERVICE     ,TX,75227-4314,Private      ,5,48,53,55,255,310
01114500,LONE STAR COLLEGE SYSTEM                ,TX,77073-3499,Public       ,858,2764,3622,5929,11771,17700
01114501,LONE STAR COLLEGE-KINGWOOD              ,TX,77339-0000,Public       ,75,274,349,1547,3004,4551
01114502,LONE STAR COLLEGE-TOMBALL               ,TX,77375-0000,Public       ,69,219,288,1222,2174,3396
01114503,LONE STAR COLLEGE-MONTGOMERY            ,TX,77384-0000,Public       ,138,364,502,1903,3645,5548
01114504,LONE STAR COLLEGE-CY-FAIR               ,TX,77433-1383,Public       ,127,266,393,2447,3355,5802
01116100,TEXAS A&M UNIV CORPUS CHRISTI           ,TX,78412-5599,Public       ,268,434,702,7691,4757,12448
01116300,UNIVERSITY OF TEXAS AT TYLER            ,TX,75799-6699,Public       ,141,359,500,3909,4011,7920
01171100,UNIVERSITY OF HOUSTON-CLEAR LAKE        ,TX,77058-1002,Public       ,105,558,663,1668,6249,7917
01201500,AUSTIN COMMUNITY COLLEGE                ,TX,78752-4390,Public       ,1226,3498,4724,12820,22246,35066
01202000,VICTORIA BEAUTY COLLEGE                 ,TX,77901-6233,Proprietary  ,6,34,40,50,121,171
01226800,BALDWIN BEAUTY SCHOOL #5                ,TX,78704-4785,Proprietary  ,17,65,82,104,276,380
01229700,LAREDO BEAUTY COLLEGE                   ,TX,78040-1051,Proprietary  ,12,35,47,75,260,335
01248200,ATI TECHNICAL TRAINING CENTER           ,TX,75235-4622,Proprietary  ,174,769,943,845,3487,4332
01248209,ATI CAREER TRAINING CENTER - GARLAND    ,TX,75041-2497,Proprietary  ,1,18,19,15,82,97
01248210,ATI CAREER TRAINING CENTER - WACO       ,TX,76711-1682,Proprietary  ,5,27,32,16,76,92
01248300,COSMETOLOGY CAREER CENTER               ,TX,75006-2566,Proprietary  ,61,129,190,242,390,632
01248800,INTERNATIONAL BEAUTY COLLEGE NO 3       ,TX,75040-0000,Proprietary  ,1,15,16,20,73,93
01276400,METROPLEX BEAUTY SCHOOL                 ,TX,75149-0000,Proprietary  ,9,30,39,33,128,161
01293000,CHARLES & SUE'S SCH OF HAIR DESIGN      ,TX,77801-0000,Proprietary  ,7,12,19,48,69,117
01293200,TINT SCHOOL OF MAKEUP & COSMETOLOGY     ,TX,75061-4235,Proprietary  ,2,23,25,17,81,98
01300300,NEILSON BEAUTY COLLEGE                  ,TX,75208-4637,Proprietary  ,2,12,14,24,101,125
01301600,OGLE SCHOOL HAIR SKIN NAILS             ,TX,76013-7400,Proprietary  ,23,65,88,143,291,434
01323100,UNIVERSITY OF HOUSTON-VICTORIA          ,TX,77901-5731,Public       ,29,329,358,440,2787,3227
02058600,CONLEE'S COLLEGE OF COSMETOLOGY         ,TX,78028-0000,Proprietary  ,2,11,13,12,47,59
02069302,VATTEROTT COLLEGE - VATTEROTT EDUCATION ,TX,75220-5441,Proprietary  ,16,97,113,99,441,540
02074100,CAPITOL CITY TRADE & TECHNICAL SCH      ,TX,78704-0000,Proprietary  ,82,133,215,331,677,1008
02077400,NORTH LAKE COLLEGE                      ,TX,75038-0000,Public       ,203,627,830,2203,3969,6172
02078100,STEPHENVILLE BEAUTY COLLEGE             ,TX,76401-0000,Proprietary  ,5,7,12,14,31,45
02081400,ARLINGTON BAPTIST COLLEGE               ,TX,76012-0000,Private      ,3,26,29,92,170,262
02093600,SOUTHWEST SCHOOL OF ELECTRONIC          ,TX,78735-0000,Proprietary  ,3,12,15,25,47,72
02098300,WESTERN TECHNICAL COLLEGE               ,TX,79927-2105,Proprietary  ,132,267,399,930,1281,2211
02100200,BROOKHAVEN COLLEGE                      ,TX,75244-0000,Public       ,199,737,936,2108,4772,6880
02113610,AMERICAN INTERCONTINENTAL UNIV - HOUSTON,TX,77042-4516,Proprietary  ,27,134,161,176,786,962
02116008,SANFORD-BROWN COLLEGE - HOUSTON         ,TX,77036-8507,Proprietary  ,71,335,406,449,1565,2014
02116012,SANFORD-BROWN INSTITUTE - HOUSTON NORTH ,TX,77008-1058,Proprietary  ,25,149,174,140,665,805
02117100,ART INSTITUTE OF HOUSTON                ,TX,77056-0000,Proprietary  ,278,406,684,2964,2766,5730
02119200,COURT REPORTING INSTITUTE OF DALLAS     ,TX,75247-6913,Proprietary  ,9,82,91,101,822,923
02119202,COURT REPORTING INSTIUTE OF HOUSTON     ,TX,77040-6315,Proprietary  ,5,48,53,69,522,591
02128302,INSTITUTE FOR BUSINESS & TECHNOLOGY - LA,TX,78230-2520,Proprietary  ,22,110,132,97,410,507
02136800,AMERICAN COMMERCIAL COLLEGE             ,TX,76904-0000,Proprietary  ,5,37,42,44,235,279
02144800,VET TECH INSTITUTE OF HOUSTON           ,TX,77027-9881,Proprietary  ,24,33,57,189,215,404
02176100,PIPO ACADEMY OF HAIR DESIGN             ,TX,79903-0000,Proprietary  ,1,10,11,23,64,87
02200800,AMERICAN COMMERCIAL COLLEGE             ,TX,79411-0000,Proprietary  ,6,66,72,34,320,354
02218300,SOUTHWEST SCHOOL OF BUSINESS & TECHNICAL,TX,78221-0000,Proprietary  ,45,190,235,161,662,823
02218305,SOUTHWEST SCHOOL OF BUSINESS AND TECHNIC,TX,78501-6053,Proprietary  ,11,35,46,58,219,277
02218306,SOUTHWEST SCHOOL OF BUSINESS AND TECHNIC,TX,78413-2045,Proprietary  ,7,66,73,34,191,225
02224600,TRI-STATE BEAUTY SCHOOL #1              ,TX,79915-0000,Proprietary  ,21,51,72,121,345,466
02230500,OGLE SCHOOL HAIR SKIN NAILS             ,TX,76132-3638,Proprietary  ,45,120,165,260,567,827
02230600,OGLE SCHOOL HAIR SKIN NAILS             ,TX,76053-4650,Proprietary  ,27,40,67,99,178,277
02239100,CENTRAL TEXAS BEAUTY COLLEGE #2         ,TX,78664-4204,Proprietary  ,8,41,49,38,215,253
02248200,MILAN INSTITUTE OF COSMETOLOGY          ,TX,79103-0000,Proprietary  ,124,365,489,626,1660,2286
02254800,TEXAS VOCATIONAL SCHOOLS                ,TX,77901-0000,Proprietary  ,8,28,36,50,132,182
02259400,AMBERTON UNIVERSITY                     ,TX,75041-0000,Private      ,0,45,45,18,280,298
02261300,EVEREST INSTITUTE                       ,TX,78213-3841,Proprietary  ,52,373,425,248,1547,1795
02261302,EVEREST INSTITUTE - HOUSTON GREENSPOINT ,TX,77060-3249,Proprietary  ,68,407,475,286,1463,1749
02261303,EVEREST INSTITUTE - HOUSTON HOBBY       ,TX,77087-2737,Proprietary  ,60,287,347,255,1207,1462
02267100,EXPOSITO SCHOOL OF HAIR DESIGN          ,TX,79109-0000,Proprietary  ,7,13,20,29,88,117
02276000,FRANKLIN BEAUTY SCHOOL #2               ,TX,77021-0000,Proprietary  ,6,39,45,36,151,187
02285900,UNIVERSITY OF COSMETOLOGY ARTS&SCI      ,TX,78504-0000,Proprietary  ,33,153,186,195,614,809
02294800,CAPITOL CITY CAREERS                    ,TX,78745-0000,Proprietary  ,3,42,45,37,157,194
02298501,EVEREST COLLEGE- FORT WORTH             ,TX,76137-2472,Proprietary  ,45,266,311,219,1066,1285
02305300,PARKER COLLEGE OF CHIROPRACTIC          ,TX,75229-0000,Private      ,7,68,75,67,1237,1304
02306700,FORT WORTH BEAUTY SCHOOL                ,TX,76116-3299,Proprietary  ,8,36,44,44,188,232
02312200,TEXAS SCHOOL OF BUSINESS                ,TX,77073-6032,Proprietary  ,43,158,201,270,828,1098
02312201,TEXAS SCHOOL OF BUSINESS - SOUTHWEST CAM,TX,77057-0000,Proprietary  ,25,124,149,173,658,831
02312202,TEXAS SCHOOL OF BUSINESS - FRIENDSWOOD C,TX,77546-8938,Proprietary  ,30,106,136,104,591,695
02312203,TEXAS SCHOOL OF BUSINESS - EAST CAMPUS  ,TX,77029-1916,Proprietary  ,25,103,128,173,599,772
02313901,WESTWOOD COLLEGE - DALLAS               ,TX,75243-0000,Proprietary  ,77,173,250,555,1185,1740
02315400,NORTHEAST TEXAS COMMUNITY COLLEGE       ,TX,75456-0000,Public       ,92,290,382,1221,1911,3132
02318200,"KD STUDIO, ACTOR'S CONSERVATORY         ",TX,75207-2111,Proprietary  ,8,21,29,149,183,332
02320200,HOUSTON GRADUATE SCHOOL OF THEOLOGY     ,TX,77004-0000,Private      ,2,18,20,4,163,167
02326000,SAN ANTONIO BEAUTY COLLEGE NO 3         ,TX,78217-0000,Proprietary  ,6,27,33,37,106,143
02328600,ITT TECHNICAL INSTITUTE                 ,TX,76011-0000,Proprietary  ,125,388,513,513,1391,1904
02331200,BAPTIST MISSIONARY ASSN THEOL SEM       ,TX,75766-0000,Private      ,0,3,3,6,30,36
02331300,INTERACTIVE LEARNING SYSTEMS            ,TX,77502-1201,Proprietary  ,14,95,109,18,132,150
02331301,INTERACTIVE LEARNING SYSTEMS            ,TX,77081-0000,Proprietary  ,16,105,121,69,428,497
02331303,INTERACTIVE LEARNING SYSTEMS            ,TX,77502-0000,Proprietary  ,0,0,0,20,146,166
02331304,INTERACTIVE LEARNING SYSTEMS            ,TX,77060-0000,Proprietary  ,7,139,146,31,402,433
02341300,PALO ALTO COLLEGE                       ,TX,78224-0000,Public       ,311,787,1098,4327,6193,10520
02348500,LAMAR STATE COLLEGE-PORT ARTHUR         ,TX,77640-0000,Public       ,80,236,316,862,1469,2331
02357700,ACADEMY OF HAIR DESIGN                  ,TX,77090-0000,Proprietary  ,25,40,65,140,231,371
02358200,LAMAR STATE COLLEGE-ORANGE              ,TX,77630-0000,Public       ,57,303,360,684,1809,2493
02361400,COLLIN COUNTY COMMUNITY COLLEGE         ,TX,75071-0000,Public       ,509,1423,1932,5385,8260,13645
02362000,UNIVERSAL TECHNICAL INSTITUTE           ,TX,77073-0000,Proprietary  ,434,431,865,4993,2891,7884
02362800,AUSTIN GRADUATE SCHOOL OF THEOLOGY      ,TX,78752-1333,Private      ,1,15,16,10,66,76
02521200,ARLINGTON CAREER INSTITUTE              ,TX,75050-0000,Proprietary  ,15,80,95,69,466,535
02521800,SEGUIN BEAUTY SCHOOL                    ,TX,78155-0000,Proprietary  ,9,17,26,46,106,152
02521801,SEGUIN BEAUTY SCHOOL-NEW BRAUNFELS      ,TX,78130-7937,Proprietary  ,0,2,2,3,8,11
02527500,HOUSTON TRAINING SCHOOLS                ,TX,77020-0000,Proprietary  ,22,172,194,112,779,891
02530700,SEBRING CAREER SCHOOLS                  ,TX,77083-1510,Proprietary  ,3,36,39,20,109,129
02539600,ART INSTITUTE OF DALLAS                 ,TX,75231-5993,Proprietary  ,162,266,428,2175,1968,4143
02548800,SOUTH TEXAS VO-TECH INSTITUTE           ,TX,78596-0000,Proprietary  ,126,287,413,600,1451,2051
02548802,SOUTH TEXAS VOCATIONAL TECHNICAL INSTITU,TX,78520-8710,Proprietary  ,0,9,9,25,44,69
02549400,SOUTH TEXAS VO-TECH INSTITUTE           ,TX,78501-0000,Proprietary  ,154,421,575,839,2046,2885
02549402,SOUTH TEXAS VOCATIONAL TECHNICAL INSTITU,TX,78416-1141,Proprietary  ,4,18,22,29,53,82
02555400,UNIV OF TX MD ANDERSON CANCER CTR       ,TX,77030-0000,Public       ,1,14,15,76,239,315
02567200,OFFICE CAREER CENTER                    ,TX,76180-0000,Proprietary  ,0,0,0,0,2,2
02568100,TEXAS BARBER COLLEGES & HAIRSTYLING     ,TX,75208-0000,Proprietary  ,80,300,380,366,1313,1679
02569300,TEXAS CULINARY ACADEMY                  ,TX,78758-3403,Proprietary  ,276,1093,1369,1844,5596,7440
02572000,COMPUTER CAREER CENTER                  ,TX,79925-2021,Proprietary  ,36,203,239,154,701,855
02572004,COMPUTER CAREER CENTER - AMARILLO CAMPUS,TX,79101-2404,Proprietary  ,10,57,67,40,242,282
02572005,COMPUTER CAREER CENTER - LUBBOCK CAMPUS ,TX,79414-3517,Proprietary  ,17,51,68,30,180,210
02572100,"CAREER ACADEMY, INC.                    ",TX,75501-0000,Proprietary  ,0,0,0,0,2,2
02580100,IVERSON BUSINESS SCH & COURT REPORT     ,TX,76011-1344,Proprietary  ,23,72,95,113,483,596
02591100,CAREER POINT INSTITUTE                  ,TX,78201-2027,Proprietary  ,96,629,725,414,2561,2975
02591900,CAREER CENTERS OF TEXAS - EL PASO       ,TX,79907-1525,Proprietary  ,82,347,429,507,1551,2058
02591905,CAREER CENTERS OF TEXAS-BROWNSVILLE     ,TX,78521-9905,Proprietary  ,39,155,194,268,706,974
02596400,REDSTONE COLLEGE - LOS ANGELES          ,TX,77061-0000,Proprietary  ,17,43,60,220,330,550
02596500,ATI CAREER TRAINING CENTER              ,TX,76180-1599,Proprietary  ,295,1097,1392,1003,3394,4397
02596503,ATI- CAREER TRAINING CENTER - HOUSTON (#,TX,77029-1978,Proprietary  ,2,9,11,2,9,11
02596600,ATI-CAREER TRAINING CENTER              ,TX,75220-4443,Proprietary  ,176,597,773,797,2928,3725
02596601,ATI CAREER TRAINING CENTER - RICHARDSON ,TX,75081-6745,Proprietary  ,4,18,22,23,115,138
02596602,ATI CAREER TRAINING CENTER - DALLAS (STE,TX,75247-6103,Proprietary  ,10,81,91,73,303,376
02600200,OCEAN CORPORATION (THE)                 ,TX,77099-3479,Proprietary  ,27,196,223,141,768,909
02604700,CENTER FOR ADVANCED LEGAL STUDIES       ,TX,77098-4151,Proprietary  ,2,72,74,20,296,316
02606202,EVEREST COLLEGE - EVEREST INSTITUTE - BI,TX,77036-8014,Proprietary  ,85,338,423,354,1299,1653
02615000,SANFORD-BROWN INSTITUTE                 ,TX,75247-6931,Proprietary  ,160,594,754,716,2660,3376
03009400,SW SCH BUS & TECH CAREERS               ,TX,78212-2840,Proprietary  ,6,19,25,25,67,92
03010604,VIRGINIA COLLEGE - VIRGINIA COLLEGE AT A,TX,78723-0000,Proprietary  ,32,169,201,264,1262,1526
03011800,UNIVERSITY OF COSMETOLOGY ARTS & SCIENCE,TX,78226-1160,Proprietary  ,4,24,28,30,101,131
03019800,PCI HEALTH TRAINING CENTER              ,TX,75247-4720,Proprietary  ,81,215,296,391,919,1310
03021500,SW SCH BUS & TECH CAREERS               ,TX,78852-4859,Proprietary  ,10,41,51,58,129,187
03025000,TEXAS COLLEGE OF COSMETOLOGY            ,TX,79605-2001,Proprietary  ,6,35,41,64,224,288
03026500,REMINGTON COLLEGE - HOUSTON CAMPUS      ,TX,77082-1849,Proprietary  ,93,395,488,720,2016,2736
03026501,REMINGTON COLLEGE - NORTH HOUSTON CAMPUS,TX,77067-1849,Proprietary  ,7,61,68,85,272,357
03028800,CIRCLE J BEAUTY SCHOOL                  ,TX,77587-3714,Proprietary  ,17,32,49,57,168,225
03031408,INTERNATIONAL ACADEMY OF DESIGN AND TECH,TX,78229-2263,Proprietary  ,45,101,146,322,529,851
03032300,SCHOOL OF AUTOMOTIVE MACHINISTS         ,TX,77055-1803,Proprietary  ,14,22,36,92,137,229
03035200,TINT SCHOOL OF MAKEUP & COSMETOLOGY     ,TX,75229-3734,Proprietary  ,9,28,37,44,174,218
03035300,SOUTHERN CAREERS INSTITUTE              ,TX,78704-5252,Proprietary  ,81,418,499,475,1881,2356
03035301,SOUTHERN CAREERS INSTITUTE              ,TX,78577-0000,Proprietary  ,34,187,221,239,785,1024
03035302,SOUTHERN CAREERS INSTITUTE - CORPUS CHRI,TX,78414-2904,Proprietary  ,34,103,137,128,444,572
03035303,SOUTHERN CAREERS INSTITUTE - #1         ,TX,78221-4351,Proprietary  ,31,208,239,203,932,1135
03035305,SOUTHERN CAREERS INSTITUTE - BROWNSVILLE,TX,78520-8680,Proprietary  ,0,8,8,2,17,19
03035306,SOUTHERN CAREERS INSTITUTE - HARLINGEN  ,TX,78550-7911,Proprietary  ,1,4,5,12,33,45
03035307,SOUTHERN CAREERS INSTITUTE - CORPUS CHRI,TX,78410-1609,Proprietary  ,2,9,11,12,25,37
03061800,STAR COLLEGE OF COSMETOLOGY             ,TX,75702-8214,Proprietary  ,9,31,40,58,152,210
03064600,UNIVERSITY OF TEXAS AT BROWNSVILLE      ,TX,78520-4993,Public       ,400,825,1225,7387,8118,15505
03071400,ITT TECHNICAL INSTITUTE                 ,TX,78249-3303,Proprietary  ,62,195,257,337,882,1219
03075400,ICC TECHNICAL INSTITUTE                 ,TX,77004-2930,Private      ,5,32,37,34,115,149
03076403,HIGH-TECH INSTITUTE - DALLAS            ,TX,75038-4201,Proprietary  ,5,21,26,44,123,167
03079201,WESTWOOD COLLEGE OF TECHNOLOGY          ,TX,76180-0000,Proprietary  ,28,97,125,242,600,842
03103400,SOUTH TEXAS COLLEGE                     ,TX,78501-6699,Public       ,882,1671,2553,11506,13180,24686
03104700,TEXAS COLLEGE OF COSMETOLOGY            ,TX,76903-4708,Proprietary  ,4,33,37,38,186,224
03108700,ROYAL BEAUTY CAREERS                    ,TX,77069-4611,Proprietary  ,21,74,95,120,392,512
03111000,MID-CITIES BARBER COLLEGE               ,TX,75051-4810,Proprietary  ,17,26,43,49,113,162
03115800,TEXAS CAREERS                           ,TX,78238-4203,Proprietary  ,33,161,194,207,1360,1567
03115802,TEXAS CAREERS - LAREDO                  ,TX,78041-6181,Proprietary  ,22,86,108,168,483,651
03115803,TEXAS CAREERS - BEAUMONT                ,TX,77701-3706,Proprietary  ,56,164,220,207,700,907
03115804,TEXAS CAREERS - LUBBOCK                 ,TX,79401-2601,Proprietary  ,48,139,187,195,734,929
03128100,ACADEMY OF HEALTH CARE PROFESSIONS      ,TX,77092-8108,Proprietary  ,82,281,363,364,1095,1459
03144300,NATIONAL BEAUTY COLLEGE                 ,TX,75043-4046,Proprietary  ,3,20,23,15,50,65
03153300,AMER COLL OF ACUPUNCTURE & O.M.         ,TX,77063-4104,Proprietary  ,0,18,18,3,104,107
03156400,ACADEMY OF ORIENTAL MEDICINE AT AUSTIN  ,TX,78757-1132,Proprietary  ,2,20,22,5,237,242
03159300,ARLINGTON MEDICAL INSTITUTE             ,TX,76011-2645,Proprietary  ,13,51,64,55,238,293
03170300,TEXAS A&M UNIVERSITY-TEXARKANA          ,TX,75501-0000,Public       ,38,170,208,382,1337,1719
03179500,TEXAS COLG TRADITIONAL CHINESE MED      ,TX,78704-6748,Proprietary  ,0,9,9,2,129,131
03189400,COLLEGE OF SAINT THOMAS MORE            ,TX,76109-2323,Private      ,4,3,7,27,20,47
03237400,FARIS COMPUTER SCHOOL                   ,TX,77627-3829,Proprietary  ,0,12,12,2,28,30
03272300,SOUTHEASTERN CAREER INSTITUTE           ,TX,75234-7288,Proprietary  ,48,173,221,124,568,692
03272301,SOUTHEASTERN CAREER INSTITUTE - MIDLAND ,TX,79703-5531,Proprietary  ,30,140,170,134,735,869
03275300,TOUCH OF CLASS SCHOOL OF COSM           ,TX,75402-6314,Proprietary  ,7,34,41,35,122,157
03276300,ACADEMY OF HAIR DESIGN                  ,TX,75901-4900,Proprietary  ,8,33,41,44,152,196
03277300,ACADEMY OF HAIR DESIGN                  ,TX,77701-4650,Proprietary  ,6,29,35,37,106,143
03303300,NORTHWEST EDUCATIONAL CENTER            ,TX,77092-7055,Proprietary  ,17,95,112,55,364,419
03371300,TONI&GUY HAIRDRESSING ACADEMY           ,TX,75006-2351,Proprietary  ,23,20,43,122,146,268
03372300,NORTHWEST VISTA COLLEGE                 ,TX,78251-4217,Public       ,623,1053,1676,6951,7665,14616
03396500,TEXAS STATE TECHNICAL COLG/MARSHALL     ,TX,75672-7402,Public       ,33,115,148,416,636,1052
03400300,CAREER QUEST                            ,TX,78229-3539,Proprietary  ,8,206,214,54,775,829
03412300,ADVANCED BARBER COLLEGE & HAIR DESI     ,TX,78596-0000,Proprietary  ,16,46,62,43,146,189
03416500,DALLAS NURSING INSTITUTE                ,TX,75243-5502,Proprietary  ,20,254,274,167,1505,1672
03422300,MILAN INSTITUTE                         ,TX,78238-3327,Proprietary  ,93,235,328,463,1024,1487
03422400,COLLEGE OF BIBLICAL STUDIES-HOUSTON     ,TX,77036-3211,Private      ,7,81,88,55,554,609
03424400,MEDVANCE INSTITUTE                      ,TX,77057-7386,Proprietary  ,54,240,294,259,1114,1373
03424401,MEDVANCE INSTITUTE -                    ,TX,77060-3551,Proprietary  ,10,41,51,28,135,163
03426300,CAREER ADVANCEMENT CENTER               ,TX,78752-1470,Proprietary  ,18,56,74,53,257,310
03480304,MEDVANCE INSTITUTE OF BATON ROUGE - GRAN,TX,75050-2342,Proprietary  ,41,108,149,146,522,668
03509400,CORYELL COSMETOLOGY COLLEGE             ,TX,76528-2036,Proprietary  ,2,7,9,7,22,29
03520300,LUBBOCK HAIR ACADEMY                    ,TX,79410-3524,Proprietary  ,2,30,32,23,108,131
03542300,CONCORDE CAREER INSTITUTE               ,TX,76011-4016,Proprietary  ,49,287,336,284,1421,1705
03551400,STATE BEAUTY ACADEMY                    ,TX,75116-3501,Proprietary  ,1,6,7,9,56,65
03556400,KUSSAD INSTITUTE OF COURT REPORTING     ,TX,78704-5712,Proprietary  ,0,3,3,3,32,35
03563300,ACADEMY OF COSEMTOLOGY                  ,TX,78745-2858,Proprietary  ,0,0,0,9,10,19
03573300,AVIATION INSTITUTE OF MAINTENANCE       ,TX,75209-3017,Proprietary  ,25,115,140,177,809,986
03610300,MJ'S BEAUTY ACADEMY INC                 ,TX,75224-4409,Proprietary  ,3,14,17,23,59,82
03612400,VALLEY GRANDE INSTITUTE FOR ACADEMI     ,TX,78596-0000,Private      ,22,129,151,141,587,728
03627300,LAMAR INSTITUTE OF TECHNOLOGY           ,TX,77705-4142,Public       ,129,382,511,1537,2370,3907
03676400,HEALTHY HAIR ACADEMY                    ,TX,75227-0000,Proprietary  ,21,67,88,82,243,325
03680300,JAY'S TECHNICAL INSTITUTE               ,TX,77031-3509,Proprietary  ,11,45,56,42,223,265
03682400,DALLAS BARBER & STYLIST COLLEGE         ,TX,75231-0000,Proprietary  ,13,47,60,72,274,346
03714300,TREND BARBER COLLEGE                    ,TX,77071-2104,Proprietary  ,24,106,130,93,425,518
03723300,CULINARY INST ALAIN & MARIE LENOTRE     ,TX,77022-4322,Proprietary  ,17,60,77,130,295,425
03727600,CULINARY ACADEMY OF AUSTIN              ,TX,78752-0000,Proprietary  ,9,25,34,101,142,243
03733300,BAPTIST UNIVERSITY OF THE AMERICAS      ,TX,78224-1336,Private      ,4,12,16,54,186,240
03756300,ANAMARC EDUCATIONAL INSTITUTE           ,TX,79930-6230,Proprietary  ,11,157,168,104,835,939
03885400,COMPUTER LABS                           ,TX,79906-5924,Proprietary  ,0,0,0,2,1,3
03885700,HOUSTON'S TRAINING AND EDUCATION CENTER ,TX,77036-2021,Proprietary  ,3,41,44,15,164,179
03922300,SOUTH TEXAS BARBER COLLEGE              ,TX,78415-3463,Proprietary  ,4,10,14,24,48,72
03944400,PROFESSIONAL CAREERS INSTITUTE          ,TX,77036-2252,Proprietary  ,8,68,76,33,207,240
03970300,HANDS ON THERAPY                        ,TX,75149-2294,Proprietary  ,4,19,23,32,143,175
03987300,TEXAS HEALTH SCHOOL                     ,TX,77079-2106,Proprietary  ,10,53,63,57,217,274
04036300,SOUTHEAST TEXAS CAREER INSTITUTE        ,TX,77656-8601,Proprietary  ,4,18,22,32,100,132
04045300,NORTHWEST BEAUTY SCHOOL                 ,TX,77091-1208,Proprietary  ,2,20,22,17,84,101
04045400,MAI-TRIX BEAUTY COLLEGE                 ,TX,77040-0000,Proprietary  ,4,19,23,24,87,111
04082300,PROFESSIONAL CAREER TRAINING INSTITUTE  ,TX,77090-0000,Proprietary  ,3,69,72,4,75,79
04089400,CCI TRAINING CENTER                     ,TX,76011-4857,Proprietary  ,2,101,103,28,342,370
04117900,CHAMPION BEAUTY COLLEGE                 ,TX,77069-4611,Proprietary  ,2,26,28,31,144,175
04125400,ACADEMY AT AUSTIN (THE)                 ,TX,78660-3287,Proprietary  ,24,50,74,98,203,301
04125500,MANUEL AND THERESA'S SCHOOL OF HAIR DESI,TX,77803-3236,Proprietary  ,5,8,13,14,28,42
04129800,MEDIATECH INSTITUTE DALLAS              ,TX,75039-3105,Proprietary  ,27,48,75,166,244,410
04129801,MEDIATECH INSTITUTE AUSTIN              ,TX,78704-8933,Proprietary  ,20,22,42,106,113,219
04129802,MEDIATECH INSTITUTE HOUSTON             ,TX,77042-4712,Proprietary  ,12,25,37,99,161,260
04131700,SOUTHWEST CAREER COLLEGE                ,TX,79925-6230,Proprietary  ,37,171,208,219,840,1059
04136500,PCCENTER                                ,TX,75115-4214,Proprietary  ,3,18,21,7,65,72
04142300,AVEDA INSTITUTE SAN ANTONIO             ,TX,78215-1260,Proprietary  ,15,52,67,123,268,391
04146600,360 DEGREES BEAUTY ACADEMY              ,TX,77084-2714,Proprietary  ,3,14,17,24,73,97
04146800,SOUTH TEXAS TRAINING CENTER             ,TX,78586-7721,Proprietary  ,4,13,17,9,46,55
04152700,ASTRODOME CAREER CENTERS                ,TX,77054-2678,Proprietary  ,0,2,2,0,2,2
04154800,DUVALL'S SCHOOL OF COSMETOLOGY          ,TX,76021-4159,Proprietary  ,10,15,25,25,26,51
04160700,AVENUE FIVE INSTITUTE                   ,TX,78757-7000,Proprietary  ,2,18,20,2,18,20
00367000,BRIGHAM YOUNG UNIVERSITY                ,UT,84602-8406,Private      ,866,1022,1888,11357,12751,24108
00367100,DIXIE STATE COLLEGE OF UTAH             ,UT,84770-3876,Public       ,293,572,865,2841,3920,6761
00367200,LDS BUSINESS COLLEGE                    ,UT,84101-3500,Private      ,95,122,217,640,677,1317
00367400,STEVENS HENAGER COLLEGE                 ,UT,84401-1420,Proprietary  ,239,1647,1886,1061,7061,8122
00367500,UNIVERSITY OF UTAH                      ,UT,84112-9055,Public       ,587,1212,1799,9246,15310,24556
00367600,COLLEGE OF EASTERN UTAH                 ,UT,84501-2699,Public       ,82,196,278,863,972,1835
00367700,UTAH STATE UNIVERSITY                   ,UT,84322-1400,Public       ,672,979,1651,7466,9731,17197
00367800,SOUTHERN UTAH UNIVERSITY                ,UT,84720-2470,Public       ,517,398,915,3905,3190,7095
00367900,SNOW COLLEGE                            ,UT,84627-1299,Public       ,224,190,414,2003,932,2935
00368000,WEBER STATE UNIVERSITY                  ,UT,84408-1136,Public       ,635,1429,2064,5244,11036,16280
00368100,WESTMINSTER COLLEGE                     ,UT,84105-3697,Private      ,58,178,236,1911,1719,3630
00402700,UTAH VALLEY UNIVERSITY                  ,UT,84058-5999,Public       ,1029,1915,2944,7756,15045,22801
00522000,SALT LAKE COMMUNITY COLLEGE             ,UT,84123-0000,Public       ,1027,2606,3633,6943,15686,22629
00943300,SHERMAN KENDALL'S ACADEMY OF BEAUTY     ,UT,84106-1836,Proprietary  ,6,15,21,33,70,103
01009800,NEUMONT UNIVERSITY                      ,UT,84095-0000,Proprietary  ,13,7,20,347,112,459
01116500,UINTAH BASIN APPLIED TECHNOLOGY CLG     ,UT,84066-0000,Public       ,3,31,34,8,112,120
01116600,UTAH CAREER COLLEGE                     ,UT,84088-4021,Proprietary  ,63,241,304,498,1747,2245
02078800,SHERMAN KENDALL'S ACADEMY OF BEAUTY     ,UT,84047-0000,Proprietary  ,3,8,11,29,45,74
02115400,BRIDGERLAND APPLIED TECHNOLOGY COLLEGE  ,UT,84321-0000,Public       ,28,134,162,223,780,1003
02156600,DAVIS APPLIED TECHNOLOGY COLLEGE        ,UT,84037-0000,Public       ,63,311,374,272,1533,1805
02178500,EAGLE GATE COLLEGE                      ,UT,84123-0000,Proprietary  ,48,238,286,280,1380,1660
02178501,EAGLE GATE COLLEGE - LAYTON CAMPUS      ,UT,84041-2383,Proprietary  ,3,14,17,3,14,17
02178502,EAGLE GATE COLLEGE - SLC DOWNTOWN LEARNI,UT,84111-3407,Proprietary  ,2,4,6,2,4,6
02270800,AMERITECH COLLEGE                       ,UT,84604-6927,Proprietary  ,3,57,60,52,286,338
02270802,AMERITECH COLLEGE - DRAPER              ,UT,84020-6545,Proprietary  ,1,29,30,20,171,191
02298500,EVEREST COLLEGE                         ,UT,84119-2668,Proprietary  ,32,135,167,137,873,1010
02346500,OGDEN-WEBER APPLIED TECHNOLOGY COLG     ,UT,84404-0000,Public       ,48,312,360,258,1512,1770
02360800,PROVO COLLEGE                           ,UT,84601-0000,Proprietary  ,45,142,187,278,899,1177
02360802,PROVO COLLEGE - AMERICAN FORK CAMPUS    ,UT,84003-3395,Proprietary  ,0,4,4,0,4,4
02361000,ITT TECHNICAL INSTITUTE                 ,UT,84123-0000,Proprietary  ,81,294,375,269,1117,1386
02504000,MARINELLO SCHOOL OF BEAUTY              ,UT,84041-0000,Proprietary  ,8,46,54,65,157,222
02516100,MARINELLO SCHOOL OF BEAUTY              ,UT,84405-1501,Proprietary  ,9,31,40,45,127,172
02531800,VON CURTIS ACADEMY OF HAIR DESIGN       ,UT,84606-0000,Proprietary  ,203,232,435,849,847,1696
02556800,HAIRITAGE COLLEGE OF BEAUTY             ,UT,84117-7204,Proprietary  ,46,56,102,153,243,396
02557700,PREMIER HAIR ACADEMY                    ,UT,84120-3603,Proprietary  ,1,6,7,10,53,63
02572700,EVANS HAIRSTYLING COLLEGE               ,UT,84770-0000,Proprietary  ,3,8,11,17,44,61
02572800,VISTA COLLEGE                           ,UT,84015-0000,Proprietary  ,11,53,64,44,195,239
02572801,CERTIFIED CAREERS INSTITUTE             ,UT,84015-0000,Proprietary  ,0,0,0,1,3,4
02572802,VISTA COLLEGE - SALT LAKE CITY          ,UT,84119-1458,Proprietary  ,0,3,3,3,28,31
02573100,EVANS HAIRSTYLING COLLEGE               ,UT,84720-0000,Proprietary  ,2,7,9,21,42,63
02612200,MARINELLO SCHOOL OF BEAUTY              ,UT,84604-1585,Proprietary  ,17,16,33,68,88,156
03030600,UTAH COLLEGE OF MASSAGE THERAPY         ,UT,84111-1606,Proprietary  ,64,97,161,380,631,1011
03030601,UTAH CLG OF MASSAGE THER-PROVO CMPS     ,UT,84042-0000,Proprietary  ,24,31,55,78,186,264
03082100,MYOTHERAPY COLLEGE OF UTAH              ,UT,84115-2522,Proprietary  ,7,16,23,30,85,115
03108200,ECHELON EDGE ACADEMY OF HAIR SKIN & NAIL,UT,84070-2004,Proprietary  ,18,22,40,34,59,93
03110400,HAIRITAGE HAIR ACADEMY                  ,UT,84770-5233,Proprietary  ,4,10,14,22,53,75
03339400,WESTERN GOVERNORS UNIVERSITY            ,UT,84107-2533,Private      ,93,3317,3410,517,19996,20513
03413300,MOUNTAINLAND APPLIED TECHNOLOGY COLLEGE ,UT,84058-5857,Public       ,11,68,79,104,320,424
03463300,CAREERS UNLIMITED                       ,UT,84058-0000,Proprietary  ,3,7,10,50,105,155
03617300,HEALING MOUNTAIN MASSAGE SCHOOL         ,UT,84111-3232,Proprietary  ,5,11,16,17,74,91
03829500,SKINWORKS SCHOOL OF ADVANCED SKINCARE   ,UT,84115-0000,Proprietary  ,6,14,20,16,76,92
03838300,OGDEN INSTITUTE OF MASSAGE THERAPY      ,UT,84403-0000,Proprietary  ,1,11,12,15,42,57
03902300,RENAISSANCE SCHOOL OF THERAPEUTIC MASSAG,UT,84010-2835,Proprietary  ,4,10,14,10,22,32
03909300,MAXIMUM STYLE TEC SCHOOL OF COSMETOLOGY ,UT,84323-4679,Proprietary  ,5,6,11,32,58,90
03921300,CAMEO COLLEGE OF ESSENTIAL BEAUTY       ,UT,84115-0000,Proprietary  ,20,70,90,77,281,358
04054300,SOUTHWEST APPLIED TECHNOLOGY COLLEGE    ,UT,84720-6608,Public       ,4,30,34,31,160,191
04072300,DALLAS ROBERTS ACADEMY OF HAIR DESIGN & ,UT,84604-1008,Proprietary  ,6,7,13,38,58,96
04118100,IMAGEWORKS ACADEMY OF HAIR DESIGN       ,UT,84660-1210,Proprietary  ,0,5,5,10,36,46
04121700,DIXIE APPLIED TECHNOLOGY COLLEGE        ,UT,84770-3025,Public       ,23,86,109,199,292,491
04142100,SKIN INSTITUTE (THE)                    ,UT,84770-6452,Proprietary  ,0,6,6,14,31,45
04145500,SKIN SCIENCE INSTITUTE (THE)            ,UT,84115-0000,Proprietary  ,5,18,23,39,108,147
04153000,RENAISSANCE ACADEMIE                    ,UT,84604-0000,Proprietary  ,5,6,11,7,9,16
00368200,BENNINGTON COLLEGE                      ,VT,05201-6001,Private      ,14,11,25,1053,302,1355
00368300,CASTLETON STATE COLLEGE                 ,VT,05735-0000,Public       ,38,23,61,2916,462,3378
00368400,CHAMPLAIN COLLEGE                       ,VT,05401-3950,Private      ,157,90,247,3363,1028,4391
00368402,WOODBURY COLLEGE                        ,VT,05602-0000,Private      ,0,2,2,1,44,45
00368500,COLLEGE OF ST JOSEPH                    ,VT,05701-3899,Private      ,1,20,21,167,300,467
00368600,GODDARD COLLEGE                         ,VT,05667-0000,Private      ,6,88,94,87,997,1084
00368700,GREEN MOUNTAIN COLLEGE                  ,VT,05764-1199,Private      ,14,12,26,1174,218,1392
00368800,JOHNSON STATE COLLEGE                   ,VT,05656-9898,Public       ,34,69,103,1524,965,2489
00368900,LYNDON STATE COLLEGE                    ,VT,05851-0919,Public       ,26,27,53,1682,340,2022
00369000,MARLBORO COLLEGE                        ,VT,05344-0300,Private      ,4,13,17,508,105,613
00369100,MIDDLEBURY COLLEGE                      ,VT,05753-0000,Private      ,34,31,65,3665,459,4124
00369106,MIDDLEBURY COLLEGE - BREAD LOAF SCHOOL O,VT,05753-0000,Private      ,0,0,0,11,101,112
00369200,NORWICH UNIVERSITY                      ,VT,05663-1035,Private      ,36,187,223,2673,1793,4466
00369300,SOUTHERN VERMONT COLLEGE                ,VT,05201-6002,Private      ,7,12,19,569,169,738
00369400,ST MICHAELS COLLEGE                     ,VT,05439-0001,Private      ,25,22,47,3199,215,3414
00369600,UNIVERSITY OF VERMONT                   ,VT,05405-0160,Public       ,175,124,299,17817,3124,20941
00369700,VERMONT COLLEGE OF FINE ARTS            ,VT,05602-3128,Private      ,0,32,32,3,102,105
00369800,VERMONT TECHNICAL COLLEGE               ,VT,05061-0000,Public       ,27,51,78,1201,803,2004
00857500,SALON PROFESSIONAL ACADEMY (THE)        ,VT,05495-4001,Proprietary  ,5,15,20,62,71,133
00865800,O'BRIENS AVEDA INSTITUTE                ,VT,05403-7747,Proprietary  ,1,10,11,26,53,79
00886000,SIT                                     ,VT,05301-4801,Private      ,4,35,39,18,554,572
01116700,COMMUNITY COLLEGE OF VERMONT            ,VT,05676-1552,Public       ,154,650,804,1769,4164,5933
01193400,VERMONT LAW SCHOOL                      ,VT,05068-0000,Private      ,1,8,9,4,1046,1050
01218300,BURLINGTON COLLEGE                      ,VT,05401-8477,Private      ,9,17,26,173,142,315
02143500,STERLING COLLEGE                        ,VT,05827-0000,Private      ,3,1,4,164,28,192
02254000,NEW ENGLAND CULINARY INSTITUTE          ,VT,05602-0000,Proprietary  ,28,52,80,462,407,869
02532600,LANDMARK COLLEGE                        ,VT,05346-0000,Private      ,22,7,29,423,63,486
03708300,BURLINGTON TECHNICAL CENTER             ,VT,05401-2721,Public       ,1,0,1,16,11,27
04146900,ADVANCED WELDING INSTITUTE              ,VT,05403-0000,Proprietary  ,2,1,3,12,9,21
00392800,CASPER COLLEGE                          ,WY,82601-4612,Public       ,78,255,333,1277,1583,2860
00392900,EASTERN WYOMING COLLEGE                 ,WY,82240-1603,Public       ,26,47,73,419,350,769
00393000,SHERIDAN COLLEGE                        ,WY,82801-9133,Public       ,49,196,245,858,1142,2000
00393100,NORTHWEST COLLEGE                       ,WY,82435-1895,Public       ,54,92,146,910,675,1585
00393200,UNIVERSITY OF WYOMING                   ,WY,82071-3663,Public       ,221,316,537,6215,4448,10663
00393300,WESTERN WYOMING COMMUNITY COLLEGE       ,WY,82902-0000,Public       ,66,213,279,866,1162,2028
00728900,CENTRAL WYOMING COLLEGE                 ,WY,82501-0000,Public       ,38,157,195,508,876,1384
00915700,WYOMING TECHNICAL INSTITUTE             ,WY,82072-9519,Proprietary  ,265,195,460,2420,1154,3574
00925900,LARAMIE COUNTY COMMUNITY CLG            ,WY,82007-3299,Public       ,98,252,350,1309,1968,3277
02211900,CHEEKS INTERNATIONAL ACDMY              ,WY,82001-0000,Proprietary  ,8,35,43,50,176,226
00393500,UNIV OF GUAM                            ,GU,96923-0000,Public       ,128,120,248,1963,1515,3478
01536100,GUAM COMMUNITY COLLEGE                  ,GU,96921-0000,Public       ,94,159,253,978,1236,2214
03438300,PACIFIC ISLANDS BIBLE COLLEGE           ,GU,96913-2619,Private      ,18,9,27,63,59,122
00393600,PONTIFICAL CATHOLIC UNIV OF PR          ,PR,00717-0777,Private      ,73,258,331,5236,5034,10270
00393700,UNIVERSITY OF THE SACRED HEART          ,PR,00914-0383,Private      ,70,131,201,3277,2274,5551
00393800,INTER-AMER UNIV PR-CNTRL ADMN           ,PR,00936-0000,Private      ,127,442,569,2776,6379,9155
00393801,INTER-AMER UNIV PR SCHL LAW             ,PR,00936-8351,Private      ,1,3,4,19,368,387
00393802,INTER AMERICAN UNIVERSITY OF PUERTO RICO,PR,00926-0000,Private      ,27,90,117,739,1212,1951
00393803,INTER AMERICAN UNIVERSITY OF PR         ,PR,00683-0000,Private      ,85,102,187,3611,2232,5843
00393804,INTER-AMER UNIV PR-RECINTO AGUADILA     ,PR,00605-2000,Private      ,70,144,214,2081,2728,4809
00393805,INTER-AMER UNIV PR-ARECIBO CAMPUS       ,PR,00614-4050,Private      ,70,177,247,2365,3084,5449
00393806,INTER-AMER UNIV PR-BARRANQUITAS REG     ,PR,00794-0517,Private      ,44,104,148,1348,1307,2655
00393807,INTER-AMER UNIV PR-FAJARDO REGIONAL     ,PR,00738-0000,Private      ,59,81,140,1308,1285,2593
00393808,INTER-AMER UNIV PR - GUAYAMA CAMPUS     ,PR,00785-4004,Private      ,31,104,135,1056,1557,2613
00393809,INTER-AMER UNIV PR-PONCE REGIONAL       ,PR,00715-0000,Private      ,73,204,277,3061,3926,6987
00393811,INTER-AMER UNIV PR-BAYAMON REG CLG      ,PR,00959-0000,Private      ,97,102,199,3534,2449,5983
00394100,COLEGIO UNIVERSITARIO DEL ESTE          ,PR,00983-0000,Private      ,195,500,695,6218,8360,14578
00394200,UNIVERSITY OF PR-CENTRAL ADMINISTRATION ,PR,00936-4984,Public       ,0,14,14,333,127,460
00394201,UNIVERSITY OF PR-RIO PIEDRAS CAMPUS     ,PR,00931-3300,Public       ,158,176,334,9851,3411,13262
00394202,UNIV OF PUERTO RICO-MAYAGUEZ CAMPUS     ,PR,00681-5000,Public       ,126,100,226,9655,2021,11676
00394203,"UNIVERSITY OF PR, MED. SCIENCES CAMPUS  ",PR,00936-5067,Public       ,10,40,50,392,1326,1718
00394204,"UNIVERSITY OF PUERTO RICO, CAYEY CAMPUS ",PR,00736-0000,Public       ,9,17,26,3263,627,3890
00394205,"UNIVERSITY OF PR, HUMACAO CAMPUS        ",PR,00791-4057,Public       ,15,23,38,3803,727,4530
00394206,UNIVERSITY OF PR-AGUADILLA CAMPUS       ,PR,00604-6150,Public       ,26,37,63,2620,619,3239
00394207,UNIVERSITY OF PUERTO RICO-ARECIBO CAMPUS,PR,00614-0000,Public       ,27,34,61,4013,671,4684
00394208,UNIVERSITY OF PUERTO RICO-BAYAMON CAMPUS,PR,00959-0000,Public       ,35,31,66,4323,722,5045
00394209,UNIVERSITY OF PUERTO RICO-CAROLINA      ,PR,00984-4800,Public       ,66,59,125,3602,689,4291
00394210,UNIVERSITY OF PUERTO RICO-PONCE         ,PR,00732-0000,Public       ,7,24,31,3401,504,3905
00394211,"UNIVERSITY OF PR, UTUADO CAMPUS         ",PR,00641-0000,Public       ,8,8,16,1430,269,1699
00501900,UNIV ADVENTISTA DE LAS ANTILLAS         ,PR,00681-0118,Private      ,22,25,47,630,413,1043
00502200,BAYAMON CENTRAL UNIVERSITY              ,PR,00960-0000,Private      ,39,111,150,975,1171,2146
00890200,COLUMBIA CENTRO UNIVERSITARIO           ,PR,00726-0000,Proprietary  ,70,187,257,813,1379,2192
01056700,COLEGIO TECNOLOGICO DE SAN JUAN         ,PR,00918-2973,Public       ,33,64,97,735,1046,1781
01072400,CARLOS ALBIZU UNIVERSITY                ,PR,00902-3711,Private      ,3,25,28,86,737,823
01081900,CONSERVATORIO DE MUSICA DE PUERTO RICO  ,PR,00907-3373,Public       ,9,4,13,265,92,357
01120300,RYDER MEMORIAL HOSP SCH OF NURSING      ,PR,00792-0000,Private      ,2,5,7,6,9,15
01171900,UNIVERSIDAD DEL TURABO                  ,PR,00778-0000,Private      ,132,558,690,7102,10247,17349
01194000,ICPR JUNIOR COLLEGE                     ,PR,00919-0000,Proprietary  ,99,107,206,940,1122,2062
01194002,INSTITUTO COMERCIAL DE PUERTO RICO JUNIO,PR,00681-1108,Proprietary  ,0,0,0,1,0,1
01194100,AMERICAN UNIVERSITY OF PUERTO RICO      ,PR,00960-2037,Private      ,62,127,189,926,812,1738
01194101,AMERICAN UNIVERSITY OF PUERTO RICO      ,PR,00674-0000,Private      ,60,88,148,734,761,1495
01252500,CARIBBEAN UNIVERSITY                    ,PR,00960-0493,Private      ,63,352,415,2433,3594,6027
01314800,RAMIREZ COLLEGE OF BUS & TECH           ,PR,00918-0000,Proprietary  ,10,23,33,231,482,713
02063100,MBTI BUSINESS TRNG INSTITUTE            ,PR,00907-3917,Proprietary  ,45,161,206,345,758,1103
02100000,POLYTECHNIC UNIVERSITY OF PR            ,PR,00917-0000,Private      ,94,218,312,2858,2440,5298
02163300,UNIVERSIDAD CENTRAL DEL CARIBE          ,PR,00960-0000,Private      ,1,6,7,156,449,605
02165100,EDP COLLEGE OF PUERTO RICO              ,PR,00919-0000,Private      ,44,140,184,843,1554,2397
02166400,INSTITUTO DE BANCA Y COMERCIO           ,PR,00925-0000,Proprietary  ,1096,1937,3033,8634,11339,19973
02170300,INST EDUC TECNIA OCUP LA REINA          ,PR,00674-0000,Proprietary  ,16,26,42,300,414,714
02170301,INST EDUC TECNICA OCUPLA LA REINA       ,PR,00603-0000,Proprietary  ,1,0,1,4,4,8
02189100,CENTRO DE ESTUDIOS MULTIDISCIPLIN       ,PR,00926-0000,Private      ,112,177,289,1241,1827,3068
02189300,EMMA'S BEAUTY ACADEMY                   ,PR,00680-0000,Proprietary  ,13,25,38,210,215,425
02195400,MODERN HAIRSTYLING INSTITUTE            ,PR,00960-0000,Proprietary  ,86,121,207,514,539,1053
02195500,MODERN HAIRSTYLING INSTITUTE            ,PR,00612-0000,Proprietary  ,1,0,1,4,1,5
02195800,LICEO E ARTE Y TECNOLGIA                ,PR,00919-0000,Private      ,53,81,134,676,626,1302
02195900,MODERN HAIRSTYLING INSTITUTE            ,PR,00980-0000,Proprietary  ,0,1,1,7,7,14
02234900,ANTILLES SCHOOL OF TECH CAREERS         ,PR,00909-0000,Proprietary  ,19,35,54,144,215,359
02241901,COMMONWEALTH OF PR DEPT OF EDUC - CARLOS,PR,00986-0000,Public       ,8,7,15,33,45,78
02241902,COMMONWEALTH OF PR DEPT OF EDUC - TOMAS ,PR,00613-0000,Public       ,2,1,3,13,29,42
02241904,COMMONWEALTH OF PR DEPT OF EDUC - ITPR R,PR,00655-0000,Public       ,5,4,9,496,260,756
02241905,COMMONWEALTH OF PR DEPT OF EDUC - JOSE A,PR,00674-0000,Public       ,0,1,1,67,12,79
02241907,COMMONWEALTH OF PR DEPT OF EDUC - ITPR R,PR,00928-0000,Public       ,16,9,25,462,202,664
02241908,COMMONWEALTH OF PR DEPT OF EDUC - ITPR R,PR,00732-0000,Public       ,5,13,18,522,250,772
02241909,COMMONWEALTH OF PR DEPT OF EDUC - TROQUE,PR,00959-0000,Public       ,0,1,1,45,14,59
02241910,COMMONWEALTH OF PR DEPT OF EDUC - ITPR R,PR,00701-1091,Public       ,9,16,25,667,220,887
02260600,NATIONAL COLLEGE OF BUSINESS & TECH     ,PR,00960-2036,Proprietary  ,230,588,818,3682,4892,8574
02260601,NATIONAL COLLEGE OF BUSINESS & TECHNOLOG,PR,00612-0000,Proprietary  ,2,3,5,44,31,75
02260602,NATIONAL COLLEGE OF BUSINESS & TECHNOLOG,PR,00745-9903,Proprietary  ,0,1,1,16,22,38
02260800,HUERTAS JUNIOR COLLEGE                  ,PR,00726-0000,Proprietary  ,62,100,162,1088,1412,2500
02297700,AUTOMECA TECHNICAL COLLEGE              ,PR,00957-0000,Proprietary  ,66,68,134,1219,724,1943
02303800,AMERICAN EDUCATIONAL COLLEGE            ,PR,00961-0000,Proprietary  ,62,85,147,441,631,1072
02335500,COLEGIO BIBLICO PENTECOSTAL DE PR       ,PR,00978-0000,Private      ,0,10,10,20,148,168
02340600,HUMACAO COMMUNITY COLLEGE               ,PR,00792-0000,Private      ,32,45,77,359,455,814
02343600,INSTITUTE OF BEAUTY CAREERS             ,PR,00613-0000,Proprietary  ,20,60,80,273,430,703
02482400,PONCE SCHOOL OF MEDICINE                ,PR,00716-2347,Private      ,2,4,6,16,627,643
02502400,SERBIA'S SCHOOL OF BEAUTY CULTURE       ,PR,00785-0000,Proprietary  ,26,28,54,182,219,401
02504500,INSTITUCION CHAVIANO DE MAYAGUEZ        ,PR,00708-0000,Proprietary  ,3,46,49,14,140,154
02505400,ATLANTIC COLLEGE                        ,PR,00970-0000,Private      ,54,48,102,790,577,1367
02534900,PONCE PARAMEDICAL COLLEGE (POPAC)       ,PR,00731-0000,Proprietary  ,150,189,339,2056,1723,3779
02549700,ACADEMIA MAISON D'ESTHETIQUE            ,PR,00907-0000,Proprietary  ,0,0,0,66,162,228
02552300,COLEGIO MAYOR DE TECHNOLOGIA            ,PR,00714-0000,Proprietary  ,21,27,48,220,254,474
02562500,INTERNATIONAL TECHNICAL COLLEGE         ,PR,00918-0000,Proprietary  ,3,21,24,46,139,185
02563500,ROGIES SCHOOL OF BEAUTY CULTURE         ,PR,00910-0000,Proprietary  ,6,25,31,140,220,360
02569400,ESCUELA DE ARTES PLASTICAS              ,PR,00902-1112,Public       ,7,18,25,364,175,539
02570400,EDUCATIONAL TECHNICAL COLLEGE           ,PR,00925-3404,Proprietary  ,44,95,139,440,830,1270
02576100,ESCUELA TECNICA DE ELECTRICIDAD         ,PR,00731-0000,Proprietary  ,13,29,42,305,319,624
02587500,UNIVERSIDAD METROPOLITANA               ,PR,00928-0000,Private      ,135,587,722,5065,8324,13389
02588600,SEMINARIO EVANGELICO DE PUERTO RICO     ,PR,00925-0000,Private      ,0,8,8,1,43,44
02593700,HISPANIC AMERICAN COLLEGE               ,PR,00725-0000,Proprietary  ,12,36,48,168,209,377
02611100,INSTITUTO MERLIX                        ,PR,00961-0000,Proprietary  ,0,0,0,2,1,3
03021900,EDIC COLLEGE                            ,PR,00726-0000,Proprietary  ,37,65,102,840,1087,1927
03025500,MECH TECH COLLEGE                       ,PR,00725-6118,Proprietary  ,196,280,476,2832,1702,4534
03025900,"LICEO DE ARTE, DISENOS Y COMERCIO       ",PR,00726-0000,Proprietary  ,39,75,114,366,507,873
03029700,"UNIVERSAL TECHNOLOGY CLG OF PR, INC     ",PR,00605-1955,Private      ,75,119,194,746,1260,2006
03061900,COLEGIO TECHNOLOGICO Y COMERCIAL        ,PR,00602-0000,Proprietary  ,10,21,31,37,66,103
03068400,STAR BEAUTY ACADEMY                     ,PR,00961-6312,Proprietary  ,15,26,41,66,90,156
03070500,D'MART INSTITUTE                        ,PR,00794-3517,Proprietary  ,110,172,282,938,1198,2136
03075600,EMMA'S BEAUTY ACADEMY                   ,PR,00795-0000,Proprietary  ,18,37,55,308,257,565
03076000,PUERTO RICO BARBER COLLEGE              ,PR,00738-4632,Proprietary  ,0,0,0,1,0,1
03085700,PROFESSIONAL TECHNICAL INSTITUTION      ,PR,00960-7061,Proprietary  ,25,39,64,225,193,418
03104400,PROFESSIONAL ELECTRIC SCHOOL            ,PR,00674-1797,Proprietary  ,0,1,1,57,67,124
03106900,ESCUELA DE PERITOS ELECTRICITAS         ,PR,00662-0457,Proprietary  ,2,4,6,41,54,95
03112100,JOHN DEWEY COLLEGE                      ,PR,00915-9538,Private      ,384,673,1057,2174,4205,6379
03112101,JOHN DEWEY COLLEGE                      ,PR,00986-0000,Private      ,77,94,171,570,719,1289
03112102,JOHN DEWEY COLLEGE-BAYAMON CAMPUS       ,PR,00959-0000,Private      ,118,186,304,503,761,1264
03112104,JOHN DEWEY COLLEGE - YABUCOA LRNING SITE,PR,00767-0767,Private      ,34,52,86,147,345,492
03112105,JOHN DEWEY COLLEGE - FAJARDO BRANCH     ,PR,00738-0738,Private      ,17,49,66,192,328,520
03112106,JOHN DEWEY COLLEGE - ARROYO BRANCH      ,PR,00714-0714,Private      ,22,36,58,125,214,339
03112107,JOHN DEWEY COLLEGE - JUANA DIAZ BRANCH  ,PR,00795-0000,Private      ,28,55,83,166,246,412
03112108,JOHN DEWEY COLLEGE - HATILLO CAMPUS     ,PR,00659-0000,Private      ,0,0,0,1,2,3
03112109,JOHN DEWEY COLLEGE - MANATI             ,PR,00674-0000,Private      ,40,72,112,40,73,113
03115900,TRINITY COLLEGE OF PUERTO RICO          ,PR,00734-0000,Private      ,16,24,40,109,159,268
03122500,ACADEMIA SERRANT INC.                   ,PR,00717-1568,Proprietary  ,17,71,88,98,270,368
03123100,GLOBELLE TECHNICAL INSTITUTE            ,PR,00693-4218,Proprietary  ,33,24,57,131,67,198
03124200,NOVA COLLEGE DE PUERTO RICO             ,PR,00960-4016,Proprietary  ,11,50,61,73,222,295
03157600,"COLEGIO DE CINEMATOGRAFIA, ARTES Y TELEV",PR,00961-6345,Proprietary  ,72,67,139,381,231,612
03177300,SAN JUAN BAUTISTA SCH OF MEDICINE       ,PR,00726-0000,Private      ,0,4,4,3,278,281
03326300,UNIVERSAL CAREER COMMUNITY COLLEGE      ,PR,00907-0000,Proprietary  ,78,139,217,463,715,1178
03336300,CENTURY COLLEGE                         ,PR,00603-4802,Proprietary  ,9,21,30,101,169,270
03414300,MONTECLARO                              ,PR,00745-9612,Private      ,0,0,0,19,0,19
03452300,INSTITUTO PRE-VOCACIONAL E INDUSTRI     ,PR,00613-1800,Private      ,4,7,11,74,132,206
03469300,IVAEM COLLEGE                           ,PR,00725-0000,Proprietary  ,4,5,9,141,68,209
03531300,COLEGIO PENTECOSTAL MIZPA               ,PR,00928-0966,Private      ,0,16,16,15,207,222
03544300,ATENAS COLLEGE                          ,PR,00674-0000,Private      ,44,73,117,750,1150,1900
03552300,LESTON COLLEGE                          ,PR,00961-6309,Proprietary  ,21,20,41,66,114,180
03608300,CARIBBEAN FORENSIC & TECHNICAL COLL     ,PR,00926-0000,Proprietary  ,11,22,33,47,88,135
03638300,ROSSLYN TRAINING ACADEMY OF COSMETOLOGY ,PR,00602-3225,Proprietary  ,7,13,20,19,46,65
03735400,"CHARLIES GUARD,DETECTIVE BUREAU&ACA     ",PR,00605-0000,Proprietary  ,3,7,10,54,164,218
03751300,ESCUELA HOTELERA DE SAN JUAN            ,PR,00917-0091,Proprietary  ,54,68,122,472,364,836
03758300,BAYAMON COMMUNITY COLLEGE               ,PR,00960-0000,Proprietary  ,9,27,36,45,138,183
03781400,INDUSTRIAL TECHNICAL COLLEGE            ,PR,00792-0000,Proprietary  ,26,60,86,105,175,280
03785300,J.G. GUAYNABO TECHNICAL COLLEGE         ,PR,00960-0000,Proprietary  ,13,25,38,34,81,115
03800300,COLEGIO TECNICO DE ELECTRICIDAD GALLOSA ,PR,00602-0000,Proprietary  ,1,9,10,17,54,71
03800400,INSTITUTE OF BEAUTY OCCUPATIONS AND TECH,PR,00676-5071,Proprietary  ,14,30,44,57,91,148
03843300,ADVANCED TECH COLLEGE                   ,PR,00961-6321,Proprietary  ,18,46,64,120,270,390
03849300,AGUADILLA TECHNICAL COLLEGE             ,PR,00603-0000,Proprietary  ,0,1,1,7,19,26
03965400,MYRANGEL BEAUTY INSTITUTE               ,PR,00754-3917,Proprietary  ,8,23,31,66,196,262
04030300,ASPIRA  DE PUERTO RICO                  ,PR,00987-0000,Private      ,0,1,1,2,8,10
04107300,CARIB TECHNOLOGICAL INSTITUTE           ,PR,00960-0000,Proprietary  ,76,49,125,142,103,245
04117200,INSTITUTO EDUCATIVO PREMIER             ,PR,00731-0000,Proprietary  ,11,27,38,81,152,233
04131600,LIBERTY TECHNICAL COLLEGE               ,PR,00737-1298,Proprietary  ,10,11,21,20,35,55
00394600,UNIVERSITY OF THE VIRGIN ISLANDS        ,VI,00802-6000,Public       ,49,82,131,1053,809,1862
00394601,UNIV OF THE VIRGIN ISLANDS-ST CROIX     ,VI,00850-0000,Public       ,34,57,91,471,565,1036
00667400,CANADIAN THEOLOGICAL SEMINARY           ,CN,00000-0000,Private      ,0,0,0,2,1,3
00667700,MCGILL UNIVERSITY                       ,CN,00000-0000,Public       ,31,16,47,1748,424,2172
00667900,QUEEN'S UNIVERSITY AT KINGSTON          ,CN,00000-0000,Public       ,4,3,7,107,41,148
00668100,ST FRANCIS XAVIER UNIVERSITY            ,CN,00000-0000,Public       ,2,0,2,36,11,47
00668200,ST THOMAS UNIVERSITY                    ,CN,00000-0000,Public       ,1,1,2,12,5,17
00668300,UNIVERSITY OF GUELPH                    ,CN,00000-0000,Public       ,1,6,7,32,58,90
00668400,UNIVERSITY OF MANITOBA                  ,CN,00000-0000,Public       ,0,1,1,30,34,64
00668500,UNIVERSITY OF NEW BRUNSWICK (THE)       ,CN,00000-0000,Public       ,2,0,2,16,9,25
00668600,UNIVERSITY OF OTTAWA                    ,CN,00000-0000,Public       ,0,2,2,32,34,66
00668800,UNIVERSITY OF TORONTO                   ,CN,00000-0000,Public       ,4,19,23,295,462,757
00668900,UNIVERSITY OF WINDSOR                   ,CN,00000-0000,Public       ,0,5,5,17,49,66
00683700,UNIVERSITE LAVAL                        ,CN,00000-0000,Public       ,1,1,2,8,13,21
00683800,DALHOUSIE UNIVERSITY                    ,CN,00000-0000,Public       ,0,3,3,138,62,200
00685200,BISHOP'S UNIVERSITY                     ,CN,00000-0000,Private      ,3,1,4,41,2,43
00685300,MCMASTER UNIVERSITY                     ,CN,00000-0000,Public       ,0,1,1,24,25,49
00767900,YORK UNIVERSITY                         ,CN,00000-0000,Public       ,4,4,8,107,106,213
00787400,UNIVERSITY AT CALGARY (THE)             ,CN,00000-0000,Public       ,3,3,6,31,57,88
00814800,UNIVERSITY OF WINNIPEG                  ,CN,00000-0000,Public       ,0,1,1,6,6,12
00836200,UNIVERSITY OF ALBERTA (THE)             ,CN,00000-0000,Public       ,1,4,5,21,58,79
00836300,MOUNT SAINT VINCENT UNIVERSITY          ,CN,00000-0000,Private      ,1,0,1,1,3,4
00836400,SAINT MARY'S UNIVERSITY                 ,CN,00000-0000,Public       ,1,0,1,24,15,39
00836500,CONCORDIA UNIVERSITY - SIR GEORGE W     ,CN,00000-0000,Public       ,5,12,17,237,168,405
00836600,UNIVERSITE DE MONTREAL                  ,CN,00000-0000,Public       ,1,1,2,17,36,53
00836800,CARLETON UNIVERSITY                     ,CN,00000-0000,Public       ,1,1,2,50,28,78
00836900,UNIVERSITY OF BRITISH COLUMBIA          ,CN,00000-0000,Public       ,16,19,35,719,521,1240
00837000,"SAFA, UNIVERSITY OF VICTORIA            ",CN,00000-0000,Public       ,5,6,11,77,59,136
00844400,SIMON FRASER UNIVERSITY                 ,CN,00000-0000,Public       ,3,7,10,68,93,161
00844600,UNIVERSITY OF WESTERN ONTARIO (THE)     ,CN,00000-0000,Public       ,0,6,6,43,54,97
00844800,UNIVERSITY OF REGINA                    ,CN,00000-0000,Public       ,0,1,1,9,11,20
00844900,ACADIA UNIVERSITY                       ,CN,00000-0000,Public       ,1,1,2,43,16,59
00852600,UNIVERSITY OF WATERLOO                  ,CN,00000-0000,Public       ,0,2,2,37,23,60
00858200,WILFRID LAURIER UNIVERSITY              ,CN,00000-0000,Public       ,0,0,0,8,6,14
00891300,LAKEHEAD UNIVERSITY                     ,CN,00000-0000,Public       ,0,1,1,7,6,13
00911900,UNIVERSITE DE MONCTON                   ,CN,00000-0000,Public       ,0,0,0,0,2,2
00925200,BROCK UNIVERSITY                        ,CN,00000-0000,Public       ,0,0,0,7,20,27
00936700,UNIVERSITY OF PRINCE EDWARD ISLAND      ,CN,00000-0000,Public       ,0,0,0,11,110,121
00942100,BRANDON UNIVERSITY                      ,CN,00000-0000,Public       ,1,0,1,8,5,13
00948600,TRINITY WESTERN UNIVERSITY              ,CN,00000-0000,Private      ,10,7,17,314,50,364
00950100,UNIVERSITY OF KING'S COLLEGE            ,CN,00000-0000,Public       ,0,1,1,23,6,29
00950300,MOUNT ALLISON UNIVERSITY                ,CN,00000-0000,Public       ,1,0,1,37,4,41
00950400,NOVA SCOTIA AGRICULTURAL COLLEGE        ,CN,00000-0000,Public       ,0,0,0,2,5,7
00950500,TRENT UNIVERSITY                        ,CN,00000-0000,Public       ,0,2,2,8,8,16
00969700,LETHBRIDGE COLLEGE                      ,CN,00000-0000,Public       ,0,0,0,2,6,8
00969800,MEDICINE HAT COLLEGE                    ,CN,00000-0000,Public       ,0,1,1,6,1,7
00970100,SENECA COLG OF APPLIED ARTS & TECH      ,CN,00000-0000,Public       ,1,7,8,14,28,42
01012300,NOVA SCOTIA COLLEGE OF ART & DESIGN     ,CN,00000-0000,Public       ,3,1,4,15,11,26
01022100,SAINT PAUL UNIVERSITY                   ,CN,00000-0000,Public       ,0,0,0,1,5,6
01045800,SHERIDAN COLLEGE OF APPLIED ARTS AN     ,CN,00000-0000,Public       ,0,1,1,16,14,30
01067500,REGENT COLLEGE                          ,CN,00000-0000,Private      ,0,8,8,2,98,100
01070300,UNIVERSITY OF LETHBRIDGE                ,CN,00000-0000,Public       ,0,2,2,5,11,16
01072000,RYERSON UNIVERSITY                      ,CN,00000-0000,Public       ,0,6,6,45,63,108
01172200,BRIERCREST BIBLE COLLEGE                ,CN,00000-0000,Private      ,4,3,7,15,11,26
01221100,ALGONQUIN CLG OF APPLIED ARTS &TECH     ,CN,00000-0000,Public       ,0,1,1,7,9,16
01222800,HUMBER COLLEGE                          ,CN,00000-0000,Public       ,0,4,4,12,18,30
01227400,PROVIDENCE COLLEGE                      ,CN,00000-0000,Private      ,0,0,0,9,7,16
02102100,BETHANY BIBLE COLLEGE                   ,CN,00000-0000,Private      ,2,2,4,59,24,83
02116600,CANADIAN MEMORIAL CHIROPRACTIC COLL     ,CN,00000-0000,Private      ,0,0,0,0,2,2
02167000,PRAIRIE BIBLE INST                      ,CN,00000-0000,Private      ,0,2,2,30,16,46
02184600,INSTITUTE FOR CHRISTIAN STUDIES         ,CN,00000-0000,Private      ,0,2,2,1,7,8
02195600,LASALLE COLLEGE                         ,CN,00000-0000,Private      ,0,1,1,13,7,20
02195700,TAYLOR UNIVERSITY COLLEGE AND SEMINARY  ,CN,00000-0000,Private      ,0,1,1,0,3,3
02201100,COLUMBIA BIBLE COLLEGE                  ,CN,00000-0000,Private      ,1,0,1,20,10,30
02216400,TYNDALE COLLEGE & SEMINARY              ,CN,00000-0000,Private      ,0,1,1,1,3,4
02219000,ST. LAWRENCE COLLEGE                    ,CN,00000-0000,Public       ,0,0,0,4,5,9
02219200,UNIVERSITY OF SASKATCHEWAN              ,CN,00000-0000,Public       ,0,3,3,10,23,33
02324900,EMMANUEL BIBLE COLLEGE                  ,CN,00000-0000,Private      ,0,0,0,0,1,1
02338800,EMILY CARR UNIVERSITY OF ART AND DESIGN ,CN,00000-0000,Public       ,4,3,7,48,44,92
02354700,RED DEER COLLEGE                        ,CN,00000-0000,Public       ,0,1,1,1,4,5
02577200,SALVATION ARMY WM & CATHERINE BOOTH     ,CN,00000-0000,Private      ,0,0,0,1,0,1
02593800,CONCORDIA UNIVERSITY COLLEGE            ,CN,00000-0000,Private      ,0,1,1,5,7,12
02611900,THE KING'S UNIVERSITY COLLEGE           ,CN,00000-0000,Private      ,0,1,1,1,5,6
03018300,ROCKY MOUNTAIN COLLEGE: CENTRE FOR      ,CN,00000-0000,Private      ,0,0,0,1,5,6
03033800,UNIVERSITY COLLEGE OF CAPE BRETON       ,CN,00000-0000,Public       ,0,0,0,3,1,4
03078300,VANCOUVER SCHOOL OF THEOLOGY            ,CN,00000-0000,Private      ,0,1,1,0,7,7
03273300,CANADIAN COLLEGE OF NATUROPATHIC ME     ,CN,00000-0000,Private      ,0,3,3,0,30,30
03298300,ALBERTA COLLEGE OF ART & DESIGN         ,CN,00000-0000,Public       ,1,2,3,23,10,33
03332500,KWANTLEN UNIVERSITY COLLEGE             ,CN,00000-0000,Public       ,0,0,0,7,11,18
03335400,CANADIAN UNIVERSITY COLLEGE             ,CN,00000-0000,Private      ,1,1,2,22,12,34
03339300,ST. STEPHENS UNIVERSITY                 ,CN,00000-0000,Private      ,0,0,0,4,4,8
03348500,REDEEMER UNIVERSITY COLLEGE             ,CN,00000-0000,Private      ,0,0,0,13,2,15
03408300,CANDIAN NAZARENE UNIVERSITY COLLEGE     ,CN,00000-0000,Private      ,0,0,0,1,3,4
03420300,HOLLAND COLLEGE                         ,CN,00000-0000,Public       ,0,0,0,0,3,3
03421300,LOYALIST COLLEGE OF APPLIED ARTS &      ,CN,00000-0000,Public       ,0,0,0,3,2,5
03465300,NIPISSING UNIVERSITY                    ,CN,00000-0000,Public       ,0,0,0,2,0,2
03511300,CN CLG ACUPUNCTURE & ORIENTAL MED       ,CN,00000-0000,Private      ,0,1,1,0,7,7
03551300,INTERNATIONAL BIBLE COLLEGE             ,CN,00000-0000,Private      ,0,0,0,0,1,1
03560400,NIAGARA COLLEGE-WELLAND CAMPUS          ,CN,00000-0000,Public       ,0,1,1,2,5,7
03613300,UNIV OF NORTHERN BRITISH COLUMBIA       ,CN,00000-0000,Public       ,1,0,1,7,9,16
03644400,CANADIAN MENNONITE UNIVERSITY           ,CN,00000-0000,Private      ,0,0,0,12,3,15
03674400,CANADIAN SOUTHERN BAPTIST SEMINARY      ,CN,00000-0000,Private      ,0,0,0,0,1,1
03711300,CAPILANO UNIVERSITY                     ,CN,00000-0000,Public       ,0,4,4,10,19,29
03745300,BRITISH COLUMBIA INSTITUTE OF TECHNOLOGY,CN,00000-0000,Public       ,0,3,3,3,17,20
03846300,PACIFIC LIFE BIBLE COLLEGE              ,CN,00000-0000,Private      ,1,0,1,5,3,8
03847300,ATLANTIC BAPTIST UNIVERSITY             ,CN,00000-0000,Private      ,0,0,0,11,1,12
04122700,MCMASTER DIVINITY COLLEGE               ,CN,00000-0000,Private      ,0,1,1,0,6,6
00814700,UNIVERSIDAD AUTONOMA DE GUADALAJARA     ,MX,00000-0000,Private      ,2,212,214,61,1108,1169
01041800,INST TEC Y DE ESTSUPER DE MONTERRE      ,MX,00000-0000,Private      ,1,7,8,85,73,158
01067600,UNIVERSIDAD DE MONTERREY                ,MX,00000-0000,Private      ,1,1,2,32,50,82
01093800,UNIVERSIDAD DE GUANAJUATO               ,MX,00000-0000,Public       ,1,1,2,7,28,35
01097600,INSTITUTO ALLENDE                       ,MX,00000-0000,Private      ,0,2,2,2,18,20
02053300,CENTRO DE ESTUDIOS UNIVERSITARIOS D     ,MX,00000-0000,Private      ,12,53,65,112,189,301
01001000,AMERICAN SAMOA CMNTY COLLEGE            ,AS,96799-2609,Public       ,41,33,74,1597,369,1966
01034300,COLLEGE OF MICRONESIA - FSM             ,FM,96941-0159,Public       ,211,110,321,2393,1048,3441
01100900,PALAU COMMUNITY COLLEGE                 ,PW,96940-0009,Public       ,22,23,45,758,342,1100
03022400,COLLEGE OF THE MARSHALL ISLANDS         ,MH,96960-1258,Public       ,82,44,126,646,331,977
03033000,NORTHERN MARIANAS COLLEGE               ,MP,96950-0000,Public       ,43,61,104,448,370,818
