OPE ID,School,State,Zip Code,School Type,20092010Qtr3_Dependent Students,20092010Qtr3_Independent Students,Quarterly Total,YTD_20092010Qtr3_Dependent Students,YTD_20092010Qtr3_Independent Students,Award Year To Date Total
00100200,ALABAMA AGRCLTL & MECHL UNIV            ,AL,35762-1357,Public       ,814,876,1690,5305,2775,8080
00100300,FAULKNER UNIVERSITY                     ,AL,36109-3398,Private      ,278,991,1269,1323,3366,4689
00100400,UNIVERSITY OF MONTEVALLO                ,AL,35115-6000,Public       ,303,330,633,1843,1129,2972
00100500,ALABAMA STATE UNIVERSITY                ,AL,36101-0000,Public       ,1064,1328,2392,7282,4230,11512
00100700,CENTRAL ALABAMA COMMUNITY COLLEGE       ,AL,35011-0000,Public       ,326,716,1042,1166,1797,2963
00100800,ATHENS STATE UNIVERSITY                 ,AL,35611-1999,Public       ,138,875,1013,560,2655,3215
00100900,AUBURN UNIVERSITY                       ,AL,36849-5113,Public       ,1341,1021,2362,13715,5004,18719
00101200,BIRMINGHAM SOUTHERN COLLEGE             ,AL,35254-0002,Private      ,181,97,278,1787,322,2109
00101300,CALHOUN COMMUNITY COLLEGE               ,AL,35609-2216,Public       ,1048,2026,3074,3889,6251,10140
00101500,ENTERPRISE-OZARK COMMUNITY COLLEGE      ,AL,36331-1300,Public       ,367,614,981,1064,1506,2570
00101600,UNIVERSITY OF NORTH ALABAMA             ,AL,35632-0001,Public       ,674,705,1379,3906,2239,6145
00101700,GADSDEN STATE COMMUNITY COLLEGE         ,AL,35903-2269,Public       ,813,1841,2654,2698,4785,7483
00101800,GEORGE C WALLACE COMMUNITY COLLEGE      ,AL,36303-0943,Public       ,566,1447,2013,1680,3227,4907
00101900,HUNTINGDON COLLEGE                      ,AL,36106-2148,Private      ,162,138,300,1010,437,1447
00102000,JACKSONVILLE STATE UNIVERSITY           ,AL,36265-1602,Public       ,894,1451,2345,5608,4577,10185
00102100,JEFFERSON DAVIS COMMUNITY COLLEGE       ,AL,36427-2790,Public       ,207,397,604,565,889,1454
00102200,JEFFERSON STATE COMMUNITY COLLEGE       ,AL,35215-3098,Public       ,755,1612,2367,3164,5650,8814
00102300,JUDSON COLLEGE                          ,AL,36756-2504,Private      ,46,32,78,301,103,404
00102400,UNIVERSITY OF WEST ALABAMA              ,AL,35470-0000,Public       ,308,1481,1789,1673,4243,5916
00102600,MARION MILITARY INSTITUTE               ,AL,36756-3214,Public       ,94,17,111,529,69,598
00102800,MILES COLLEGE                           ,AL,35064-2697,Private      ,563,503,1066,2057,1211,3268
00102900,UNIVERSITY OF MOBILE                    ,AL,36613-0000,Private      ,169,427,596,1146,1355,2501
00103000,BISHOP STATE COMMUNITY COLLEGE          ,AL,36603-5898,Public       ,623,1487,2110,1528,3658,5186
00103001,BISHOP STATE COMM COLG-CARVER CMPS      ,AL,36617-0000,Public       ,55,146,201,122,335,457
00103002,BISHOP STAT COMM CLG-SW CMPS            ,AL,36605-0000,Public       ,15,74,89,69,138,207
00103100,NORTHEAST ALABAMA STATE CMNTY COLG      ,AL,35986-0159,Public       ,444,959,1403,1171,1971,3142
00103300,OAKWOOD COLLEGE                         ,AL,35896-0001,Private      ,369,190,559,1722,645,2367
00103400,ALABAMA SOUTHERN COMMUNITY COLLEGE      ,AL,36460-5698,Public       ,353,470,823,965,1018,1983
00103600,SAMFORD UNIVERSITY                      ,AL,35229-7000,Private      ,215,385,600,2686,2339,5025
00103800,SNEAD STATE COMMUNITY COLLEGE           ,AL,35957-0734,Public       ,213,560,773,977,1614,2591
00104000,SOUTHERN UNION STATE COMMUNITY CLG      ,AL,36276-0000,Public       ,630,846,1476,2628,2543,5171
00104100,SPRING HILL COLLEGE                     ,AL,36608-1791,Private      ,81,148,229,1779,517,2296
00104400,STILLMAN COLLEGE                        ,AL,35403-1430,Private      ,208,120,328,2133,474,2607
00104600,TALLADEGA COLLEGE                       ,AL,35160-2354,Private      ,202,116,318,553,297,850
00104700,TROY STATE UNIVERSITY                   ,AL,36082-0001,Public       ,1340,7310,8650,6962,21628,28590
00105000,TUSKEGEE UNIVERSITY                     ,AL,36088-1645,Private      ,242,160,402,4479,1107,5586
00105100,UNIVERSITY OF ALABAMA (THE)             ,AL,35487-0120,Public       ,1683,1734,3417,16453,8017,24470
00105200,UNIVERSITY OF ALABAMA AT BIRMINGHAM     ,AL,35294-1150,Public       ,1042,2048,3090,7244,9051,16295
00105500,UNIVERSITY OF ALABAMA IN HUNTSVILLE     ,AL,35899-0001,Public       ,596,931,1527,3738,3251,6989
00105700,UNIVERSITY OF SOUTH ALABAMA             ,AL,36688-0002,Public       ,1310,2159,3469,6715,7793,14508
00105900,LAWSON STATE COMMUNITY COLLEGE          ,AL,35221-1798,Public       ,864,1550,2414,2149,3483,5632
00105901,LAWSON STATE COMMUNITY COLLEGE - BESSEME,AL,35021-0308,Public       ,155,366,521,401,886,1287
00106000,FAULKNER STATE COMMUNITY COLLEGE        ,AL,36507-2698,Public       ,641,957,1598,2287,2627,4914
00526000,J.F. DRAKE STATE TECH COLLEGE           ,AL,35811-1584,Public       ,145,650,795,343,1450,1793
00569100,SHELTON STATE COMMUNITY CLG             ,AL,35405-4017,Public       ,979,1279,2258,3253,3280,6533
00569200,REID STATE TECHNICAL COLLEGE            ,AL,36401-0000,Public       ,134,378,512,263,659,922
00569700,NORTHWEST- SHOALS COMMUNITY COLLEGE     ,AL,35661-0000,Public       ,607,962,1569,1695,2177,3872
00569702,NORTHWEST-SHOALS C.C.-PHIL CAMPBELL     ,AL,35581-0000,Public       ,49,84,133,207,236,443
00569900,GEORGE C WALLACE STATE CMTY COLLEGE     ,AL,36703-0000,Public       ,445,794,1239,973,1576,2549
00573300,BEVILL STATE CMTY COLLEGE-WALKER        ,AL,35148-0000,Public       ,476,896,1372,1053,2001,3054
00573301,BEVILL STATE COMMUNITY COLLEGE - FAYETTE,AL,35555-0000,Public       ,121,246,367,423,675,1098
00573302,BEVILL STATE CMTY CLG-HAMILTON CAMP     ,AL,35570-0000,Public       ,54,118,172,182,320,502
00573305,BEVILL STATE CMTY CLG-WALKER CLG        ,AL,35501-0000,Public       ,82,183,265,331,467,798
00573400,H. COUNCILL TRENHOLM STATE TECH COLLEGE ,AL,36108-0020,Public       ,338,829,1167,674,1658,2332
00573401,H. C. TRENHOLM ST TECH COL-PATTERSON CAM,AL,36116-2612,Public       ,123,231,354,315,554,869
00787100,GEORGE C WALLACE STATE CMTY CLG         ,AL,35077-2000,Public       ,860,1423,2283,2784,3951,6735
00831000,AUBURN UNIVERSITY-MONTGOMERY            ,AL,36124-0000,Public       ,509,1101,1610,2728,3642,6370
00898800,LURLEEN B WALLACE COMMUNITY COLLEGE     ,AL,36420-0418,Public       ,230,479,709,784,1194,1978
01019300,HERZING COLLEGE                         ,AL,35209-4816,Proprietary  ,23,239,262,102,833,935
01055400,CONCORDIA COLLEGE                       ,AL,36701-3323,Private      ,135,147,282,555,385,940
01218200,CHATTAHOOCHEE VALLEY CMTY CLG           ,AL,36869-7917,Public       ,244,559,803,767,1589,2356
01303906,SOUTH UNIVERSITY - MONTGOMERY           ,AL,36116-1120,Proprietary  ,99,333,432,261,1073,1334
02170600,UNITED STATES SPORTS ACADEMY            ,AL,36526-7055,Private      ,8,218,226,25,589,614
02199700,HERITAGE CHRISTIAN UNIVERSITY           ,AL,35630-0000,Private      ,7,38,45,21,71,92
02270400,SOUTHEASTERN BIBLE COLLEGE              ,AL,35244-2083,Private      ,27,69,96,104,176,280
02296000,PRINCE INSTITUTE OF PROFESSIONAL STUDIES,AL,36117-0000,Proprietary  ,9,45,54,28,140,168
02341000,FORTIS COLLEGE                          ,AL,36609-0000,Proprietary  ,189,410,599,400,933,1333
02341002,CAPPS COLLEGE - MONTGOMERY              ,AL,36109-3624,Proprietary  ,7,42,49,35,124,159
02341004,FORTIS COLLEGE - SCHOOL OF COSMETOLOGY  ,AL,36609-1981,Proprietary  ,6,20,26,15,47,62
02503400,AMRIDGE UNIVERSITY                      ,AL,36124-0000,Private      ,14,418,432,31,827,858
02605500,REMINGTON COLLEGE - MOBILE CAMPUS       ,AL,36609-5593,Proprietary  ,218,732,950,472,1935,2407
03010600,VIRGINIA COLLEGE                        ,AL,35209-5154,Proprietary  ,734,5490,6224,1801,17121,18922
03010602,VIRGINIA COLLEGE - HUNTSVILLE           ,AL,35805-0000,Proprietary  ,86,496,582,212,1310,1522
03010607,VIRGINIA COLLEGE - MOBILE               ,AL,36606-4748,Proprietary  ,30,125,155,91,484,575
03010616,VIRGINIA COLLEGE - MONTGOMERY           ,AL,36117-2802,Proprietary  ,113,437,550,264,1059,1323
03032500,ALABAMA STATE CLG BARBER STYLING        ,AL,35215-8308,Proprietary  ,10,28,38,33,69,102
03361400,FORTIS COLLEGE                          ,AL,36535-3547,Proprietary  ,17,103,120,42,246,288
03459300,SOUTHEASTERN SCHOOL OF COSMETOLOGY      ,AL,35228-0000,Private      ,23,85,108,32,143,175
03783300,BLUE CLIFF CAREER COLLEGE               ,AL,63306-4749,Proprietary  ,30,79,109,57,168,225
03894300,HUNTSVILLE BIBLE COLLEGE                ,AL,35811-0000,Private      ,3,22,25,10,59,69
04066300,CARDIAC AND VASCULAR INSTITUTE OF ULTRAS,AL,36604-1408,Proprietary  ,5,33,38,5,33,38
04067300,SELMA UNIVERSITY                        ,AL,36701-0000,Private      ,22,105,127,44,230,274
04116500,MIMI'S BEAUTY ACADEMY OF COSMETOLOGY    ,AL,35810-3453,Proprietary  ,2,12,14,7,39,46
04121500,COLUMBIA SOUTHERN UNIVERSITY            ,AL,36561-3815,Proprietary  ,48,1591,1639,143,4287,4430
04149200,XCELL ACADEMY-A PAUL MITCHELL PARTNER SC,AL,35216-4990,Proprietary  ,21,44,65,50,94,144
00111100,ALLAN HANCOCK COLLEGE                   ,CA,93454-6399,Public       ,680,1084,1764,2929,3454,6383
00111300,ANTELOPE VALLEY COLLEGE                 ,CA,93536-5426,Public       ,1426,3109,4535,4830,8042,12872
00111600,ART CENTER COLLEGE OF DESIGN            ,CA,91103-1999,Private      ,106,164,270,1143,1226,2369
00111700,AZUSA PACIFIC UNIVERSITY                ,CA,91702-7000,Private      ,341,1508,1849,6321,5224,11545
00111800,BAKERSFIELD COLLEGE                     ,CA,93305-1299,Public       ,963,1980,2943,7760,8932,16692
00111900,BARSTOW COMMUNITY COLLEGE               ,CA,92311-6608,Public       ,353,1320,1673,629,2510,3139
00112000,AMER BAPT SEM OF THE WEST-BERKELEY      ,CA,94704-0000,Private      ,0,10,10,2,48,50
00112100,BETHANY UNIVERSITY /  ASSEMBLIES OF GOD ,CA,95066-2896,Private      ,34,75,109,393,309,702
00112200,BIOLA UNIVERSITY                        ,CA,90639-0001,Private      ,225,338,563,4934,2066,7000
00112300,BROOKS INSTITUTE                        ,CA,93103-1809,Proprietary  ,119,121,240,981,648,1629
00112400,CABRILLO COLLEGE                        ,CA,95003-3194,Public       ,585,1050,1635,3297,4114,7411
00112500,CALIFORNIA BAPTIST UNIVERSITY           ,CA,92504-3297,Private      ,201,616,817,3456,2310,5766
00112700,CALIFORNIA COLLEGE OF THE ARTS          ,CA,94107-2206,Private      ,56,109,165,1570,1632,3202
00113100,CALIFORNIA INSTITUTE OF TECHNOLOGY      ,CA,91125-0001,Private      ,43,32,75,2817,429,3246
00113200,CALIFORNIA INSTITUTE OF THE ARTS        ,CA,91355-2397,Private      ,40,39,79,1573,1306,2879
00113300,CALIFORNIA LUTHERAN UNIVERSITY          ,CA,91360-2787,Private      ,128,349,477,2966,1384,4350
00113400,CALIFORNIA MARITIME ACADEMY             ,CA,94590-8181,Public       ,44,29,73,638,255,893
00113700,CALIF STATE UNIV-FULLERTON              ,CA,92831-3599,Public       ,1462,2224,3686,30914,15535,46449
00113800,"CALIFORNIA STATE UNIVERSITY, EAST BAY   ",CA,94542-3000,Public       ,522,1292,1814,9257,9729,18986
00113900,CALIF STATE UNIV-LONG BEACH             ,CA,90840-0006,Public       ,780,1535,2315,37001,17689,54690
00114000,CALIF STATE UNIV-LOS ANGELES            ,CA,90032-4226,Public       ,674,1642,2316,21190,16061,37251
00114100,"CALIF STATE UNIV, DOMINGUEZ HILLS       ",CA,90747-0001,Public       ,570,2027,2597,9764,10300,20064
00114200,CALIF STATE UNIV SAN BERNARDINO         ,CA,92407-2397,Public       ,789,1840,2629,13674,11655,25329
00114300,CAL POLY STATE UNIVERSITY               ,CA,93407-0001,Public       ,678,378,1056,26744,3627,30371
00114400,CALIF STATE POLYTECHNIC UNIV POMONA     ,CA,91768-2500,Public       ,816,964,1780,20741,7877,28618
00114600,CALIF STATE UNIV - CHICO                ,CA,95929-0001,Public       ,636,654,1290,13660,5597,19257
00114700,CALIF STATE UNIV - FRESNO               ,CA,93740-8026,Public       ,742,1126,1868,17295,9860,27155
00114900,HUMBOLDT STATE UNIVERSITY               ,CA,95521-8299,Public       ,345,363,708,9070,3862,12932
00115000,CALIF STATE UNIV-SACRAMENTO             ,CA,95819-6044,Public       ,719,1535,2254,21334,15727,37061
00115100,SAN DIEGO STATE UNIVERSITY              ,CA,92182-1690,Public       ,1403,1873,3276,37105,15660,52765
00115300,CALIF STATE UNIV-NORTHRIDGE             ,CA,91330-8307,Public       ,982,1965,2947,26637,16664,43301
00115400,SAN FRANCISCO STATE UNIVERSITY          ,CA,94132-1740,Public       ,805,1596,2401,26830,17043,43873
00115500,SAN JOSE STATE UNIVERSITY               ,CA,95192-0036,Public       ,737,1447,2184,21729,14085,35814
00115600,SONOMA STATE UNIVERSITY                 ,CA,94928-3609,Public       ,225,355,580,8279,2973,11252
00115700,CALIF STATE UNIV-STANISLAUS             ,CA,95382-0299,Public       ,293,592,885,6678,4892,11570
00116100,CERRITOS COLLEGE                        ,CA,90650-6296,Public       ,2299,2690,4989,10340,8061,18401
00116200,CHABOT COLLEGE                          ,CA,94545-2400,Public       ,818,1408,2226,3918,5169,9087
00116300,CHAFFEY COLLEGE                         ,CA,91737-9400,Public       ,2053,2748,4801,8566,9883,18449
00116400,CHAPMAN UNIVERSITY                      ,CA,92866-1099,Private      ,295,2086,2381,6812,8264,15076
00116453,CHAPMAN UNIVERSITY SCHOOL OF LAW        ,CA,92866-0000,Private      ,9,102,111,84,2062,2146
00116500,CHURCH DIV SCH OF THE PACIFIC           ,CA,94709-0000,Private      ,0,2,2,0,58,58
00116600,CITRUS COLLEGE                          ,CA,91741-1899,Public       ,1410,1738,3148,5628,4505,10133
00116900,CLAREMONT GRADUATE UNIVERSITY           ,CA,91711-0000,Private      ,1,256,257,12,1822,1834
00117000,CLAREMONT MCKENNA COLLEGE               ,CA,91711-6400,Private      ,24,9,33,3078,112,3190
00117100,HARVEY MUDD COLLEGE                     ,CA,91711-5990,Private      ,3,4,7,1802,23,1825
00117200,PITZER COLLEGE                          ,CA,91711-6101,Private      ,17,17,34,2824,142,2966
00117300,POMONA COLLEGE                          ,CA,91711-6301,Private      ,51,21,72,4266,113,4379
00117400,SCRIPPS COLLEGE                         ,CA,91711-3948,Private      ,15,8,23,1567,66,1633
00117600,WEST HILLS COMMUNITY COLLEGE            ,CA,93210-1399,Public       ,199,330,529,1049,1065,2114
00117700,COGSWELL POLYTECHNICAL COLLEGE          ,CA,94089-1210,Private      ,4,25,29,116,66,182
00117800,COLLEGE OF MARIN                        ,CA,94904-2590,Public       ,205,566,771,690,1637,2327
00117801,COLG OF MARIN-INDIAN VALLEY CMPS        ,CA,94949-0000,Public       ,6,35,41,19,87,106
00117900,NOTRE DAME DE NAMUR UNIVERSITY          ,CA,94002-1997,Private      ,81,224,305,989,848,1837
00118100,COLLEGE OF SAN MATEO                    ,CA,94402-3784,Public       ,350,561,911,1666,1789,3455
00118200,COLLEGE OF THE DESERT                   ,CA,92260-9305,Public       ,710,1047,1757,3451,3580,7031
00118300,HOLY NAMES UNIVERSITY                   ,CA,94619-1699,Private      ,45,164,209,673,667,1340
00118500,COLLEGE OF THE REDWOODS                 ,CA,95501-9300,Public       ,459,1082,1541,2301,3792,6093
00118600,COLLEGE OF THE SEQUOIAS                 ,CA,93277-2234,Public       ,957,1740,2697,4919,5759,10678
00118700,COLLEGE OF THE SISKIYOUS                ,CA,96094-2899,Public       ,197,319,516,887,1069,1956
00118701,COLLEGE OF THE SISKIYOUS - YREKA CENTER ,CA,96097-9538,Public       ,12,27,39,36,103,139
00119000,CONTRA COSTA COLLEGE                    ,CA,94806-3195,Public       ,490,929,1419,1668,2676,4344
00119100,DIABLO VALLEY COLLEGE                   ,CA,94523-1544,Public       ,759,1019,1778,3491,3479,6970
00119200,CUESTA COLLEGE                          ,CA,93403-8106,Public       ,479,783,1262,3127,2705,5832
00119300,CYPRESS COLLEGE                         ,CA,90630-5897,Public       ,1167,1702,2869,5121,5159,10280
00119600,DOMINICAN UNIVERSITY OF CALIFORNIA      ,CA,94901-2298,Private      ,58,206,264,2068,1217,3285
00119700,EL CAMINO COLLEGE                       ,CA,90506-0002,Public       ,1932,2437,4369,8385,7354,15739
00119701,COMPTON COMMUNITY COLLEGE               ,CA,90221-5393,Public       ,499,1405,1904,1353,2904,4257
00119900,FOOTHILL COLLEGE                        ,CA,94022-4597,Public       ,397,743,1140,1688,2471,4159
00120000,FULLER THEOLOGICAL SEMINARY             ,CA,91182-0000,Private      ,4,296,300,10,2108,2118
00120100,FULLERTON COLLEGE                       ,CA,92832-2095,Public       ,1638,1705,3343,7524,5230,12754
00120200,GAVILAN COLLEGE                         ,CA,95020-9599,Public       ,350,501,851,1265,1495,2760
00120300,GLENDALE COMMUNITY COLLEGE              ,CA,91208-2894,Public       ,1341,1786,3127,5827,5773,11600
00120400,GOLDEN GATE BAPT THEOL SEMINARY         ,CA,94941-0000,Private      ,0,15,15,1,50,51
00120500,GOLDEN GATE UNIVERSITY                  ,CA,94105-2967,Private      ,13,503,516,71,3540,3611
00120600,GOLDEN WEST COLLEGE                     ,CA,92647-2748,Public       ,959,1405,2364,4922,4609,9531
00120700,GRADUATE THEOLOGICAL UNION              ,CA,94709-0000,Private      ,0,15,15,0,322,322
00120800,GROSSMONT COLLEGE                       ,CA,92020-1798,Public       ,1470,2499,3969,5241,6268,11509
00120900,HARTNELL COMMUNITY COLLEGE              ,CA,93901-1697,Public       ,666,712,1378,2446,2210,4656
00121200,HUMPHREYS COLLEGE                       ,CA,95207-3896,Private      ,30,211,241,182,960,1142
00121400,IMPERIAL VALLEY COLLEGE                 ,CA,92251-9787,Public       ,1290,1344,2634,3786,3044,6830
00121500,LA SIERRA UNIVERSITY                    ,CA,92515-3332,Private      ,212,174,386,1738,688,2426
00121600,UNIVERSITY OF LA VERNE                  ,CA,91750-4443,Private      ,139,1425,1564,2356,5694,8050
00121700,LASSEN COLLEGE                          ,CA,96130-3000,Public       ,117,247,364,366,600,966
00121800,LOMA LINDA UNIVERSITY                   ,CA,92350-0001,Private      ,76,453,529,716,4749,5465
00121900,LONG BEACH CITY COLLEGE                 ,CA,90808-1780,Public       ,1877,3339,5216,10256,11810,22066
00122000,MASTER'S COLLEGE & SEMINARY (THE)       ,CA,91321-1200,Private      ,54,65,119,1057,313,1370
00122300,LOS ANGELES CITY COLLEGE                ,CA,90029-3588,Public       ,1121,2264,3385,4868,7890,12758
00122400,LOS ANGELES HARBOR COLLEGE              ,CA,90744-2397,Public       ,718,1017,1735,2543,3201,5744
00122600,LOS ANGELES PIERCE COLLEGE              ,CA,91371-0001,Public       ,1146,1458,2604,6843,5610,12453
00122700,LOS ANGELES TRADE TECH COLLEGE          ,CA,90015-4181,Public       ,833,2135,2968,3284,6522,9806
00122800,LOS ANGELES VALLEY COLLEGE              ,CA,91401-4096,Public       ,1111,1677,2788,5011,5771,10782
00122900,SO CA UNIV  HEALTH SCIENCES             ,CA,90604-4051,Private      ,8,79,87,19,578,597
00123000,SOUTHERN CA COLLEGE OF OPTOMETRY        ,CA,92831-1699,Private      ,0,6,6,7,474,481
00123200,AMERICAN RIVER COLLEGE                  ,CA,95841-4286,Public       ,1434,3581,5015,8389,14936,23325
00123300,SACRAMENTO CITY COLLEGE                 ,CA,95822-1386,Public       ,1318,2726,4044,8584,11185,19769
00123600,MENLO COLLEGE                           ,CA,94027-4301,Private      ,46,30,76,945,145,1090
00123700,MERCED COMMUNITY COLLEGE                ,CA,95348-2898,Public       ,747,976,1723,4587,4439,9026
00123800,MILLS COLLEGE                           ,CA,94613-1301,Private      ,40,98,138,1460,1488,2948
00123900,MIRACOSTA COLLEGE                       ,CA,92056-3899,Public       ,520,1074,1594,2191,3271,5462
00124000,MODESTO JUNIOR COLLEGE                  ,CA,95350-5800,Public       ,1191,1906,3097,7530,8929,16459
00124200,MONTEREY PENINSULA COLLEGE              ,CA,93940-4799,Public       ,386,492,878,1724,1729,3453
00124300,MOUNT ST MARYS COLLEGE                  ,CA,90049-1599,Private      ,68,280,348,1986,1718,3704
00124500,MT. SAN ANTONIO COLLEGE                 ,CA,91789-1399,Public       ,2445,2803,5248,11836,8878,20714
00124600,MT SAN JACINTO COLLEGE                  ,CA,92583-2399,Public       ,1571,2629,4200,5461,8279,13740
00124700,NAPA VALLEY COLLEGE                     ,CA,94558-6236,Public       ,312,535,847,1628,1921,3549
00124900,OCCIDENTAL COLLEGE                      ,CA,90041-3314,Private      ,34,20,54,4735,207,4942
00125000,ORANGE COAST COLLEGE - FIN AID OFF      ,CA,92628-5005,Public       ,1421,1710,3131,8805,6170,14975
00125100,OTIS COLLEGE OF ART AND DESIGN          ,CA,90045-3505,Private      ,82,77,159,1391,619,2010
00125200,HOPE INTERNATIONAL UNIVERSITY           ,CA,92631-0000,Private      ,71,166,237,581,602,1183
00125300,FRESNO PACIFIC UNIVERSITY               ,CA,93702-4798,Private      ,133,612,745,1378,1986,3364
00125302,FRESNO PACIFIC UNIVERSITY - VISALIA CENT,CA,93277-8341,Private      ,0,0,0,28,160,188
00125303,FRESNO PACIFIC UNIVERSITY - BAKERSFIELD ,CA,93301-4533,Private      ,0,0,0,42,164,206
00125400,PACIFIC LUTHERAN THEOLOGICAL SEM        ,CA,94708-0000,Private      ,0,2,2,0,95,95
00125500,PACIFIC OAKS COLLEGE                    ,CA,91103-3592,Private      ,3,101,104,12,495,507
00125600,PACIFIC SCHOOL OF RELIGION              ,CA,94709-0000,Private      ,0,11,11,0,171,171
00125800,PACIFIC UNION COLLEGE                   ,CA,94508-9797,Private      ,241,118,359,1350,432,1782
00125900,PALO VERDE COLLEGE                      ,CA,92225-0000,Public       ,101,199,300,207,432,639
00126000,PALOMAR COLLEGE                         ,CA,92069-1486,Public       ,1289,1629,2918,5679,5437,11116
00126100,PASADENA CITY COLLEGE                   ,CA,91106-2003,Public       ,2173,2287,4460,12349,7777,20126
00126200,POINT LOMA NAZARENE UNIVERSITY          ,CA,92106-2899,Private      ,140,438,578,3466,1188,4654
00126600,LANEY COLLEGE                           ,CA,94607-4893,Public       ,703,1884,2587,2828,5479,8307
00126700,MERRITT COLLEGE                         ,CA,94619-3196,Public       ,383,1172,1555,1268,3047,4315
00126800,PORTERVILLE COLLEGE                     ,CA,93257-6059,Public       ,279,589,868,1585,2136,3721
00126900,RIO HONDO COLLEGE                       ,CA,90601-1699,Public       ,1635,1799,3434,6840,5517,12357
00127000,RIVERSIDE COMMUNITY COLLEGE             ,CA,92506-1299,Public       ,4455,6019,10474,16307,18488,34795
00127200,SAN BERNARDINO VALLEY COLLEGE           ,CA,92410-2798,Public       ,1308,3075,4383,5015,8767,13782
00127300,SAN DIEGO CITY COLLEGE                  ,CA,92101-4787,Public       ,1323,3219,4542,5372,9331,14703
00127500,SAN DIEGO MESA COLLEGE                  ,CA,92111-4996,Public       ,1403,2323,3726,5974,7016,12990
00127800,SAN FRANCISCO CONSERVATORY OF MUSIC     ,CA,94122-4498,Private      ,14,13,27,311,361,672
00127900,SAN FRANCISCO THEOLOGICAL SEMINARY      ,CA,94960-0000,Private      ,0,21,21,1,94,95
00128000,SAN JOAQUIN DELTA COLLEGE               ,CA,95207-6370,Public       ,1590,3040,4630,7587,9467,17054
00128100,WILLIAM JESSUP UNIVERSITY               ,CA,95765-3707,Private      ,48,95,143,527,318,845
00128200,SAN JOSE CITY COLLEGE                   ,CA,95128-2797,Public       ,593,1227,1820,2788,4245,7033
00128400,SANTA ANA COLLEGE                       ,CA,92706-3398,Public       ,951,1538,2489,4767,4692,9459
00128500,SANTA BARBARA CITY COLLEGE              ,CA,93109-2394,Public       ,797,1123,1920,4957,3668,8625
00128600,SANTA MONICA COLLEGE                    ,CA,90405-1644,Public       ,1840,1919,3759,11322,7135,18457
00128700,SANTA ROSA JUNIOR COLLEGE               ,CA,95401-4395,Public       ,855,1552,2407,4155,5288,9443
00128800,CLAREMONT SCHOOL OF THEOLOGY            ,CA,91711-0000,Private      ,0,15,15,4,181,185
00128900,SHASTA COLLEGE                          ,CA,96049-7692,Public       ,524,1242,1766,3245,4607,7852
00129000,SIERRA COLLEGE                          ,CA,95677-3397,Public       ,937,1709,2646,5294,6384,11678
00129100,SIMPSON UNIVERSITY                      ,CA,96003-8606,Private      ,74,141,215,1053,785,1838
00129200,SOLANO COMMUNITY COLLEGE                ,CA,94534-3197,Public       ,515,1196,1711,2538,4460,6998
00129300,VANGUARD UNIVERSITY OF SOUTHERN CA      ,CA,92626-6597,Private      ,123,201,324,1712,773,2485
00129400,SOUTHWESTERN COLLEGE                    ,CA,91910-7299,Public       ,1521,1740,3261,7177,5499,12676
00129500,SOUTHWESTERN LAW SCHOOL                 ,CA,90010-1106,Private      ,2,91,93,18,2653,2671
00129600,DOMINICAN SCH PHILOSOPHY & THEOLOGY     ,CA,94709-0000,Private      ,0,10,10,2,38,40
00129900,ST JOHN'S SEMINARY COLLEGE              ,CA,93010-0000,Private      ,0,1,1,0,2,2
00130200,SAINT MARY'S COLLEGE OF CALIFORNIA      ,CA,94556-2744,Private      ,124,231,355,3630,1274,4904
00130500,STANFORD UNIVERSITY                     ,CA,94305-6106,Private      ,361,327,688,20346,3467,23813
00130501,STANFORD UNIVERSITY - GRADUATE SCHOOL OF,CA,94305-5301,Private      ,6,72,78,119,651,770
00130502,STANFORD UNIVERSITY - GRADUATE SCHOOL OF,CA,94305-5015,Private      ,8,120,128,53,1087,1140
00130503,STANFORD UNIVERSITY - STANFORD LAW SCHOO,CA,94305-3096,Private      ,2,45,47,34,2248,2282
00130700,FRESNO CITY COLLEGE                     ,CA,93741-0002,Public       ,1426,3284,4710,12386,13647,26033
00130800,REEDLEY COLLEGE                         ,CA,93654-2099,Public       ,693,1100,1793,4797,4362,9159
00130900,TAFT COLLEGE                            ,CA,93268-2317,Public       ,227,328,555,800,998,1798
00131200,UNIVERSITY OF CALIFORNIA-BERKELEY       ,CA,94720-1520,Public       ,713,1250,1963,45752,18438,64190
00131300,UNIVERSITY OF CALIFORNIA-DAVIS          ,CA,95616-8558,Public       ,684,780,1464,43540,13264,56804
00131400,UNIVERSITY OF CALIFORNIA-IRVINE         ,CA,92697-2825,Public       ,503,685,1188,45445,11948,57393
00131500,UNIVERSITY OF CALIFORNIA (UCLA)         ,CA,90095-9000,Public       ,872,2279,3151,55745,24709,80454
00131502,UNIV OF CALIFORNIA LOS ANG SCH MED      ,CA,90095-0000,Public       ,8,24,32,162,880,1042
00131503,UNIV OF CALIFORNIA LOS ANG DENTAL       ,CA,90095-0000,Public       ,3,7,10,20,120,140
00131600,UNIVERSITY OF CALIFORNIA-RIVERSIDE      ,CA,92521-0209,Public       ,546,1077,1623,28565,6539,35104
00131700,UNIVERSITY OF CALIFORNIA-SAN DIEGO      ,CA,92093-0013,Public       ,493,561,1054,41794,8489,50283
00131900,UNIVERSITY OF CALIFORNIA-SFRANCISCO     ,CA,94143-0246,Public       ,33,166,199,553,3287,3840
00132000,UNIVERSITY OF CALIFORNIA-SANTA BARB     ,CA,93106-3180,Public       ,539,310,849,40672,6332,47004
00132100,UNIVERSITY OF CALIFORNIA-SANTA CRUZ     ,CA,95064-0001,Public       ,322,275,597,26615,3961,30576
00132200,UNIVERSITY OF REDLANDS                  ,CA,92373-0999,Private      ,96,573,669,3782,2059,5841
00132500,UNIVERSITY OF SAN FRANCISCO             ,CA,94117-1080,Private      ,182,761,943,7629,6769,14398
00132600,SANTA CLARA UNIVERSITY                  ,CA,95053-4956,Private      ,176,392,568,8124,4712,12836
00132800,UNIVERSITY OF SOUTHERN CALIFORNIA       ,CA,90089-0914,Private      ,536,1513,2049,28511,21070,49581
00132900,UNIVERSITY OF THE PACIFIC               ,CA,95211-0197,Private      ,174,247,421,9405,2893,12298
00132901,UNIVERSITY OF THE PACIFIC - MCGEORGE SCH,CA,95817-2799,Private      ,4,90,94,16,2361,2377
00132902,UNIV OF THE PACIFIC SCH OF DENT         ,CA,94115-0000,Private      ,2,27,29,25,542,567
00133400,VENTURA COLLEGE                         ,CA,93003-3899,Public       ,847,980,1827,4138,3348,7486
00133500,VICTOR VALLEY COLLEGE                   ,CA,92395-5849,Public       ,1632,3394,5026,4652,8365,13017
00133800,WEST VALLEY COLLEGE                     ,CA,95070-5697,Public       ,412,661,1073,1784,2099,3883
00134100,WESTMONT COLLEGE                        ,CA,93108-1099,Private      ,68,7,75,2058,72,2130
00134200,WHITTIER COLLEGE                        ,CA,90601-4413,Private      ,116,80,196,2464,328,2792
00134201,WHITTIER COLLEGE - COLLEGE OF LAW       ,CA,92626-1501,Private      ,0,81,81,9,1492,1501
00134300,WOODBURY UNIVERSITY                     ,CA,91510-7846,Private      ,77,167,244,1043,811,1854
00134400,YUBA COLLEGE                            ,CA,95901-7699,Public       ,658,1344,2002,3220,5038,8258
00177212,TRINITY INTERNATIONAL UNIV-CA           ,CA,92705-0000,Private      ,1,77,78,4,186,190
00274100,AMERICAN JEWISH UNIVERSITY              ,CA,90077-1599,Private      ,8,22,30,76,155,231
00301002,ANTIOCH UNIV/LOS ANGELES                ,CA,90230-7615,Private      ,6,177,183,34,893,927
00301003,ANTIOCH  UNIV/SANTA BARBARA             ,CA,93101-0000,Private      ,11,102,113,375,451,826
00369110,MONTEREY INST OF INTERNATL STUDIES      ,CA,93940-2691,Private      ,0,76,76,23,906,929
00394700,UC-HASTINGS COLLEGE OF THE LAW          ,CA,94102-0000,Public       ,0,35,35,15,4243,4258
00394800,SAN FRANCISCO ART INSTITUTE             ,CA,94133-2299,Private      ,54,108,162,1120,857,1977
00405500,HEBREW UNION COLLEGE - JEWISH INSTITUTE ,CA,90007-3796,Private      ,0,0,0,1,81,82
00408000,STARR KING SCHOOL FOR THE MINISTRY      ,CA,94709-1299,Private      ,0,4,4,0,68,68
00448000,DE ANZA COLLEGE                         ,CA,95014-5793,Public       ,1190,1344,2534,5622,4287,9909
00448100,OHLONE COLLEGE                          ,CA,94539-5847,Public       ,383,620,1003,2106,2019,4125
00448101,OHLONE COLLEGE - NEWARK CENTER FOR HEALT,CA,94560-4902,Public       ,10,31,41,38,82,120
00448400,JOHN F. KENNEDY UNIVERSITY              ,CA,94523-4817,Private      ,6,286,292,20,1553,1573
00449000,PATTEN UNIVERSITY                       ,CA,94601-2699,Private      ,50,125,175,202,398,600
00449400,EVEREST COLLEGE                         ,CA,92408-3752,Proprietary  ,195,433,628,396,986,1382
00450200,CITY COLLEGE OF SAN FRANCISCO           ,CA,94112-0000,Public       ,1575,3356,4931,7254,10104,17358
00563800,DOWNEY ADULT SCHOOL                     ,CA,90241-5610,Public       ,8,29,37,38,75,113
00565500,HACIENDA LA PUENTE ADULT EDUC CTR       ,CA,91746-0000,Public       ,52,166,218,101,376,477
00616500,LA CNTY CLG OF NURSING & ALLD HLTH      ,CA,90033-1018,Public       ,9,82,91,78,355,433
00672000,COLLEGE OF ALAMEDA                      ,CA,94501-2109,Public       ,366,728,1094,1411,1989,3400
00673100,CASA LOMA COLLEGE                       ,CA,91405-4523,Private      ,58,170,228,144,470,614
00686300,VENTURA COUNTY CMTY CLG DISTRICT        ,CA,93010-8552,Public       ,4,7,11,24,20,44
00697300,CANADA COLLEGE                          ,CA,94061-1099,Public       ,157,420,577,595,1136,1731
00697500,LINCOLN UNIVERSITY                      ,CA,94612-2801,Private      ,5,19,24,11,71,82
00701200,SAMUEL MERRITT COLLEGE                  ,CA,94609-3108,Private      ,22,204,226,277,2053,2330
00704700,LOS ANGELES SOUTHWEST COLLEGE           ,CA,90047-4810,Public       ,635,1682,2317,2160,4967,7127
00705000,BAY VISTA COLLEGE OF BEAUTY             ,CA,91950-3616,Proprietary  ,28,84,112,58,132,190
00711500,MOORPARK COLLEGE                        ,CA,93021-1695,Public       ,543,613,1156,2796,2195,4991
00713000,NEWBERRY SCHOOLS OF BEAUTY              ,CA,91344-7404,Proprietary  ,30,42,72,50,75,125
00714200,LYLE'S COLLEGE OF BEAUTY                ,CA,93710-3948,Proprietary  ,20,101,121,75,169,244
00714201,LYLE'S CLG OF BTY BAKERSFIELD           ,CA,93301-0000,Proprietary  ,3,17,20,36,58,94
00716400,BRYAN COLLEGE                           ,CA,90057-0000,Proprietary  ,31,280,311,117,825,942
00717801,WESTERN SEMINARY - BAY AREA CENTER      ,CA,95032-0000,Private      ,0,3,3,2,26,28
00717804,WESTERN SEMINARY - SACRAMENTO           ,CA,95821-3939,Private      ,1,5,6,8,36,44
00718700,NORTH ADRIAN'S COLLEGE OF BEAUTY        ,CA,95350-2381,Proprietary  ,77,109,186,129,186,315
00719000,WYOTECH                                 ,CA,94539-7663,Proprietary  ,285,523,808,655,1358,2013
00719001,WYOTECH - SIERRA CAMPUS                 ,CA,94621-4523,Proprietary  ,6,6,12,31,18,49
00720300,SALON SUCCESS ACADEMY                   ,CA,91786-4060,Proprietary  ,29,41,70,57,94,151
00720400,MODERN BEAUTY ACADEMY                   ,CA,93030-7016,Proprietary  ,18,10,28,28,37,65
00722900,WESTERN BEAUTY INSTITUTE                ,CA,91402-3104,Proprietary  ,88,191,279,167,444,611
00723400,HEALD COLLEGE                           ,CA,94105-2206,Proprietary  ,148,324,472,464,1258,1722
00723600,ART INST OF CALIFORNIA-LOS ANGELES      ,CA,90405-3035,Proprietary  ,552,729,1281,4885,3859,8744
00725300,FEDERICO BEAUTY INSTITUTE               ,CA,95834-1905,Proprietary  ,57,88,145,168,211,379
00729600,COLEMAN COLLEGE                         ,CA,92123-0000,Private      ,39,192,231,135,568,703
00746501,AMERICAN ACADEMY OF DRAMATIC ARTS - HOLL,CA,90028-7504,Private      ,18,20,38,192,102,294
00747600,MARINELLO SCHOOLS OF BEAUTY             ,CA,90023-2666,Proprietary  ,400,561,961,717,1465,2182
00747602,MARINELLO SCHOOLS OF BEAUTY - SPA ACADEM,CA,90048-5101,Proprietary  ,7,13,20,35,40,75
00747603,MARINELLO SCHOOLS OF BEAUTY - INGLEWOOD ,CA,90301-2306,Proprietary  ,3,1,4,13,11,24
00747604,MARINELLO SCHOOLS OF BEAUTY - RESEDA    ,CA,91335-4218,Proprietary  ,3,6,9,10,18,28
00747605,MARINELLO SCHOOLS OF BEAUTY - NORTH HOLL,CA,91606-3210,Proprietary  ,3,4,7,12,13,25
00747606,MARINELLO SCHOOLS OF BEAUTY - WEST COVIN,CA,91790-2805,Proprietary  ,4,6,10,11,11,22
00747607,MARINELLO SCHOOLS OF BEAUTY - SAN BERNAR,CA,92410-3261,Proprietary  ,3,6,9,27,25,52
00747608,MARINELLO SCHOOLS OF BEAUTY - ONTARIO   ,CA,91762-2113,Proprietary  ,7,19,26,43,44,87
00747609,MARINELLO SCHOOLS OF BEAUTY - WHITTIER  ,CA,90601-4107,Proprietary  ,2,5,7,21,21,42
00747611,MARINELLO SCHOOLS OF BEAUTY - SAN DIEGO ,CA,92126-4217,Proprietary  ,11,10,21,43,47,90
00747700,"HEALD COLLEGE,SCHOOLS OF BUS & TECH     ",CA,95670-6005,Proprietary  ,96,299,395,357,1170,1527
00753100,ACADEMY OF ART UNIVERSITY               ,CA,94105-3410,Proprietary  ,1187,3043,4230,6187,9995,16182
00753600,COSUMNES RIVER COLLEGE                  ,CA,95823-5799,Public       ,742,1373,2115,4675,5334,10009
00754802,WESTWOOD COLLEGE OF TECHNOLOGY          ,CA,92801-0000,Proprietary  ,209,182,391,1110,618,1728
00754803,WESTWOOD COLLEGE OF TECHNOLOGY          ,CA,91786-0000,Proprietary  ,174,186,360,1034,850,1884
00760600,EVEREST COLLEGE                         ,CA,90010-2221,Proprietary  ,103,230,333,271,494,765
00760700,CONCORDE CAREER INSTITUTE               ,CA,91606-3134,Proprietary  ,114,224,338,319,565,884
00770700,COLUMBIA COLLEGE                        ,CA,95370-8580,Public       ,188,400,588,809,1049,1858
00771300,SKYLINE COLLEGE                         ,CA,94066-1698,Public       ,456,689,1145,1977,2019,3996
00793000,CONCORDE CAREER INSTITUTE               ,CA,92108-0000,Proprietary  ,73,250,323,217,768,985
00799300,CALIF STATE UNIV BAKERSFIELD            ,CA,93311-1022,Public       ,380,959,1339,5695,5358,11053
00807100,CONCORDE CAREER INSTITUTE               ,CA,92840-9201,Proprietary  ,111,234,345,277,696,973
00807300,BUTTE COMMUNITY COLLEGE                 ,CA,95965-0000,Public       ,984,1660,2644,4934,6029,10963
00809000,EVEREST COLLEGE                         ,CA,91803-1310,Proprietary  ,89,161,250,238,487,725
00809300,HEALD COLLEGE                           ,CA,93704-1706,Proprietary  ,163,464,627,752,1710,2462
00853200,HEALD COLLEGE                           ,CA,94545-2352,Proprietary  ,196,374,570,693,1620,2313
00853700,CONCORDE CAREER INSTITUTE               ,CA,92401-0000,Proprietary  ,121,274,395,350,908,1258
00859600,WEST LOS ANGELES COLLEGE                ,CA,90230-3500,Public       ,623,1451,2074,2163,4241,6404
00859700,FEATHER RIVER COLLEGE                   ,CA,95971-9124,Public       ,120,171,291,620,485,1105
00884400,CALIFORNIA CHRISTIAN COLLEGE            ,CA,93703-3599,Private      ,2,10,12,36,35,71
00884600,WRIGHT INSTITUTE                        ,CA,94704-0000,Private      ,0,38,38,0,460,460
00890300,COLLEGE OF THE CANYONS                  ,CA,91355-1899,Public       ,953,1079,2032,3421,2884,6305
00891800,SADDLEBACK COLLEGE                      ,CA,92692-3699,Public       ,824,1302,2126,2767,3343,6110
00902200,ASSOCIATED TECHNICAL COLLEGE            ,CA,90017-0000,Proprietary  ,84,190,274,148,421,569
00903200,EMPIRE COLLEGE                          ,CA,95403-2122,Proprietary  ,49,158,207,108,368,476
00915706,WYOMING TECHNICAL INSTITUTE - WEST SACRA,CA,95605-1507,Proprietary  ,263,394,657,749,998,1747
00927200,CRAFTON HILLS COLLEGE                   ,CA,92399-1799,Public       ,538,781,1319,2220,2493,4713
00932500,ABRAM FRIEDMAN OCCUP CTR                ,CA,90015-3507,Public       ,2,25,27,33,67,100
00950900,SKILLS & BUSINESS EDUCATION CENTER      ,CA,95824-1529,Public       ,42,247,289,160,910,1070
00974800,WESTERN CAREER COLLEGE                  ,CA,95826-3203,Proprietary  ,187,591,778,510,1417,1927
00974801,WESTERN CAREER COLLEGE - SAN LEANDRO CAM,CA,94578-3711,Proprietary  ,122,298,420,330,825,1155
00974802,WESTERN CAREER COLLEGE - PLEASANT HILL C,CA,94523-1984,Proprietary  ,79,151,230,191,502,693
00974803,WESTERN CAREER COLLEGE - STOCKTON       ,CA,95207-5509,Proprietary  ,95,185,280,307,516,823
00974804,WESTERN CAREER COLLEGE - CITRUS HEIGHTS ,CA,95621-5577,Proprietary  ,116,336,452,280,838,1118
00974806,WESTERN CAREER COLLEGE -  ANTIOCH/WALNUT,CA,94531-1604,Proprietary  ,83,165,248,216,526,742
00974807,WESTERN CAREER COLLEGE - SAN JOSE       ,CA,95119-1325,Proprietary  ,148,312,460,524,1150,1674
00974808,WESTERN CAREER COLLEGE - EMERYVILLE     ,CA,94608-3006,Proprietary  ,39,110,149,126,368,494
00974810,WESTERN CAREER COLLEGE - CONCORD        ,CA,94520-5671,Proprietary  ,1,8,9,21,33,54
00998900,SANTA BARBARA BUSINESS COLLEGE          ,CA,93111-0000,Proprietary  ,61,120,181,166,435,601
01011100,CERRO-COSO COMMUNITY COLLEGE            ,CA,93555-9571,Public       ,180,526,706,511,1387,1898
01014225,TOURO CLG OSEOPATHIC MEDICINE           ,CA,94592-1115,Private      ,2,34,36,15,677,692
01014900,PEPPERDINE UNIVERSITY                   ,CA,90263-0000,Private      ,282,924,1206,6014,6571,12585
01033300,JESUIT SCHOOL OF THEOLOGY - BERKELEY    ,CA,94709-1193,Private      ,0,2,2,1,50,51
01034000,LOS MEDANOS COLLEGE                     ,CA,94565-5197,Public       ,635,1150,1785,2196,3290,5486
01036500,CHARLES R DREW UNIV OF MED & SCI        ,CA,90059-0000,Private      ,8,102,110,58,479,537
01036800,MENNONITE BRETHREN BIBLICAL SEM         ,CA,93727-0000,Private      ,0,14,14,1,59,60
01037500,HARBOR OCCUPATIONAL CENTER              ,CA,90731-0000,Public       ,0,3,3,22,29,51
01039500,UNIVERSITY OF SAN DIEGO                 ,CA,92110-2492,Private      ,250,432,682,12683,3668,16351
01039501,UNIVERSITY OF SAN DIEGO - SCHOOL OF LAW ,CA,92110-2492,Private      ,20,143,163,104,3351,3455
01044100,PARDEE RAND GRADUATE SCHOOL             ,CA,90407-2138,Private      ,0,6,6,0,16,16
01047400,MARYMOUNT COLLEGE OF PALOS VERDES       ,CA,90275-0000,Private      ,44,10,54,549,63,612
01057900,WEST VALLEY OCCUPATIONAL CTR            ,CA,91367-0000,Public       ,3,18,21,61,100,161
01083200,WESTERN STATE UNIV COLLEGE OF LAW       ,CA,92831-3014,Proprietary  ,0,52,52,7,985,992
01085400,THOMAS JEFFERSON SCHOOL OF LAW          ,CA,92110-0000,Private      ,0,147,147,10,2076,2086
01102400,EVEREST COLLEGE                         ,CA,94103-2091,Proprietary  ,65,152,217,159,366,525
01110700,EVEREST  COLLEGE                        ,CA,92801-5231,Proprietary  ,177,451,628,328,850,1178
01110900,EVEREST COLLEGE                         ,CA,91335-4631,Proprietary  ,164,234,398,337,587,924
01111200,FIDM-FASHION INSTITUTE OF DESIGN        ,CA,90015-1421,Proprietary  ,711,419,1130,5802,2031,7833
01111700,ALLIANT INTERNATIONAL UNIVERSITY        ,CA,92131-1799,Private      ,10,409,419,78,2416,2494
01111705,ALLIANT INTERNATIONAL UNIVERSITY - LOS A,CA,91803-1360,Private      ,0,66,66,7,578,585
01111706,ALLIANT INTERNATIONAL UNIVERSITY - SAN F,CA,94133-1221,Private      ,3,103,106,10,649,659
01111707,ALLIANT INTERNATIONAL UNIVERSITY - FRESN,CA,93727-2014,Private      ,3,48,51,16,394,410
01112100,EVEREST COLLEGE                         ,CA,94541-4007,Proprietary  ,53,274,327,97,448,545
01112300,EVEREST COLLEGE                         ,CA,90247-4163,Proprietary  ,100,350,450,211,728,939
01146000,NATIONAL UNIVERSITY                     ,CA,92037-1011,Private      ,109,3931,4040,401,11747,12148
01162600,PRACTICAL SCHOOLS                       ,CA,92805-0000,Proprietary  ,72,130,202,416,750,1166
01164900,LOYOLA MARYMOUNT UNIVERSITY             ,CA,90045-0000,Private      ,281,410,691,9885,2942,12827
01164901,LOYOLA MARYMOUNT UNIVERSITY - LOYOLA LAW,CA,90015-0019,Private      ,6,146,152,36,3750,3786
01167200,MENDOCINO COMMUNITY COLLEGE             ,CA,95482-3000,Public       ,197,428,625,892,1265,2157
01169600,NATIONAL POLYTECHNIC COLLEGE OF SCIENCE ,CA,90744-6399,Private      ,24,82,106,60,269,329
01170700,NORTH-WEST COLLEGE                      ,CA,91790-2097,Proprietary  ,56,155,211,163,364,527
01179200,FRANCISCAN SCHOOL OF THEOLOGY           ,CA,94709-0000,Private      ,0,8,8,1,40,41
01182000,SAN DIEGO MIRAMAR COLLEGE               ,CA,92126-0000,Public       ,570,1124,1694,2364,3297,5661
01186500,CALIFORNIA HAIR DESIGN ACADEMY          ,CA,92115-0000,Proprietary  ,37,71,108,66,98,164
01186600,LU ROSS ACADEMY                         ,CA,93001-2927,Proprietary  ,34,44,78,36,57,93
01202600,JE BOUTIQUE COLLEGE OF BEAUTY           ,CA,92021-6247,Proprietary  ,25,49,74,42,81,123
01202700,GALEN COLLEGE OF CALIFORNIA             ,CA,93728-2381,Proprietary  ,15,42,57,38,91,129
01203100,SAN DIEGO CHRISTIAN COLLEGE             ,CA,92019-1157,Private      ,69,53,122,482,187,669
01206100,EVEREST COLLEGE                         ,CA,95128-3908,Proprietary  ,75,206,281,196,542,738
01215400,CALIFORNIA INSTITUTE OF INTEGRAL STUDIES,CA,94103-2557,Private      ,2,158,160,15,1378,1393
01215402,CALIFORNIA INSTITUTE OF INTEGRAL STUDIES,CA,94102-5403,Private      ,0,25,25,1,29,30
01231600,MANCHESTER BEAUTY COLLEGE               ,CA,93726-5306,Proprietary  ,21,88,109,78,209,287
01231700,TULARE BEAUTY COLLEGE                   ,CA,93274-3432,Proprietary  ,5,14,19,14,29,43
01244600,UNIVERSAL COLLEGE OF BEAUTY             ,CA,90044-0044,Proprietary  ,5,52,57,21,73,94
01245200,EVERGREEN VALLEY COLLEGE                ,CA,95135-1598,Public       ,607,804,1411,3330,3229,6559
01255000,LOS ANGELES MISSION COLLEGE             ,CA,91342-3200,Public       ,547,858,1405,2690,3020,5710
01265000,MARINELLO SCHOOL OF BEAUTY              ,CA,91502-2828,Proprietary  ,65,102,167,118,217,335
01265100,MARINELLO SCHOOL OF BEAUTY              ,CA,91748-1674,Proprietary  ,21,79,100,32,118,150
01284200,OXNARD COLLEGE                          ,CA,93030-0000,Public       ,688,1020,1708,2114,2664,4778
01287200,NORTH-WEST COLLEGE                      ,CA,91768-3199,Proprietary  ,46,118,164,117,330,447
01287300,WYOTECH                                 ,CA,90810-3800,Proprietary  ,318,622,940,795,1569,2364
01287301,WYOTECH - EVEREST  COLLEGE              ,CA,90034-3158,Proprietary  ,71,285,356,162,561,723
01287302,WYOTECH - EVEREST  COLLEGE              ,CA,91746-3412,Proprietary  ,156,357,513,372,849,1221
01290700,LAKE TAHOE COMMUNITY COLLEGE            ,CA,96150-4524,Public       ,156,290,446,483,603,1086
01291100,MARINELLO SCHOOL OF BEAUTY              ,CA,92646-2552,Proprietary  ,13,20,33,45,75,120
01291200,MTI COLLEGE                             ,CA,95841-0000,Proprietary  ,70,197,267,355,1016,1371
01294200,ROSEMEAD BEAUTY SCHOOL                  ,CA,91770-1639,Proprietary  ,28,111,139,47,166,213
01298400,PROFESSIONAL INSTITUTE OF BEAUTY        ,CA,91731-2613,Proprietary  ,10,57,67,15,93,108
01298500,HAIR CALIFORNIA BEAUTY ACADEMY          ,CA,92867-7127,Proprietary  ,5,13,18,10,27,37
01298900,OCEANSIDE COLLEGE OF BEAUTY             ,CA,92054-5393,Proprietary  ,8,22,30,33,60,93
01301000,LANCASTER BEAUTY SCHOOL                 ,CA,93534-3098,Proprietary  ,23,48,71,59,106,165
01307400,AMERICAN BEAUTY COLLEGE                 ,CA,90706-5417,Proprietary  ,4,18,22,18,34,52
01309500,SALON SUCCESS ACADEMY                   ,CA,92879-6561,Proprietary  ,69,70,139,115,114,229
01310300,CALIFORNIA WESTERN SCHOOL OF LAW        ,CA,92101-0000,Private      ,2,89,91,22,2256,2278
01324000,LYTLE'S REDWOOD EMPIRE BEAUTY CLG       ,CA,95403-0000,Proprietary  ,28,31,59,85,109,194
02054900,MARINELLO SCHOOL OF BEAUTY              ,CA,92630-0000,Proprietary  ,35,73,108,52,105,157
02059800,PARIS BEAUTY COLLEGE                    ,CA,94520-2611,Proprietary  ,32,62,94,56,117,173
02063500,COASTLINE COMMUNITY COLLEGE             ,CA,92708-0000,Public       ,152,1084,1236,809,3233,4042
02064300,SIERRA COLLEGE OF BEAUTY                ,CA,95340-0000,Proprietary  ,16,39,55,41,72,113
02065500,BROOKS COLLEGE                          ,CA,90804-3289,Proprietary  ,0,0,0,28,11,39
02065700,CALIFORNIA BEAUTY COLLEGE               ,CA,95354-0000,Proprietary  ,14,29,43,63,80,143
02070500,CONCORDIA UNIVERSITY                    ,CA,92612-0000,Private      ,84,285,369,1918,1174,3092
02075800,SOUTHERN CA INST OF ARCHITECTURE        ,CA,90013-0000,Private      ,14,59,73,141,601,742
02086400,MARINELLO SCHOOL OF BEAUTY              ,CA,95050-0000,Proprietary  ,123,204,327,172,348,520
02091200,ELEGANCE INTERNATIONAL                  ,CA,90028-0000,Proprietary  ,36,37,73,83,121,204
02091700,KAPLAN COLLEGE                          ,CA,92123-1509,Proprietary  ,118,424,542,386,1569,1955
02096100,FIELDING INSTITUTE                      ,CA,93105-0000,Private      ,0,297,297,0,1149,1149
02099200,AMERICAN CONSERVATORY THEATER           ,CA,94108-0000,Private      ,0,6,6,20,149,169
02110200,COLUMBIA COLLEGE                        ,CA,91356-0000,Private      ,43,18,61,284,132,416
02110800,CALIFORNIA COLLEGE SAN DIEGO            ,CA,92108-3821,Proprietary  ,144,519,663,464,1321,1785
02111300,CUYAMACA COLLEGE                        ,CA,92019-0000,Public       ,690,1120,1810,2447,3195,5642
02113601,AMERICAN INTERCONTINENTAL UNIV - LOS ANG,CA,90066-7008,Proprietary  ,7,71,78,59,231,290
02119100,MISSION COLLEGE                         ,CA,95054-1897,Public       ,376,848,1224,1853,3254,5107
02120600,SAYBROOK GRADUATE SCHOOL                ,CA,94111-1920,Private      ,0,107,107,3,692,695
02120700,SAN JOAQUIN VALLEY COLLEGE              ,CA,93291-0000,Proprietary  ,541,1565,2106,2047,4634,6681
02120900,ITT TECHNICAL INSTITUTE                 ,CA,95670-6034,Proprietary  ,216,583,799,550,1392,1942
02125000,CAREER ACADEMY OF BEAUTY                ,CA,92845-0000,Proprietary  ,24,60,84,41,93,134
02128200,"VICTOR VALLEY BEAUTY COLLEGE, INC       ",CA,92392-0000,Proprietary  ,35,36,71,108,128,236
02128300,INSTITUTE FOR BUSINESS & TECHNOLOGY     ,CA,95050-0000,Proprietary  ,45,160,205,117,486,603
02128301,INSTITUTE FOR BUSINESS & TECHNOLOGY - NA,CA,95670-6351,Proprietary  ,34,127,161,63,255,318
02138300,PALO ALTO UNIVERSITY                    ,CA,94304-1337,Private      ,6,60,66,17,575,592
02147400,CLEVELAND CHIROPRACTIC COLLEGE          ,CA,90004-0000,Private      ,2,109,111,30,357,387
02161800,MUSICIANS INSTITUTE                     ,CA,90028-6157,Proprietary  ,334,284,618,1341,978,2319
02167800,ESTES INSTITUTE OF COSMETOLOGY          ,CA,93291-0000,Proprietary  ,22,38,60,75,76,151
02174600,MARINELLO SCHOOL OF BEAUTY              ,CA,90201-0000,Proprietary  ,52,56,108,64,103,167
02180600,BRIDGES  ACADEMY OF BEAUTY              ,CA,92311-2327,Proprietary  ,6,4,10,8,13,21
02184900,PALMER COLLEGE OF CHIROPRACTIC WEST     ,CA,95134-0000,Private      ,1,34,35,8,352,360
02185800,MOLER BARBER COLLEGE                    ,CA,94611-0000,Proprietary  ,5,24,29,16,49,65
02187500,"HEALD COLLEGE, SCH OF BUS & TECH        ",CA,94520-0000,Proprietary  ,165,343,508,636,1454,2090
02188400,SIERRA VALLEY COLLEGE OF COURT REPORTING,CA,93726-0000,Proprietary  ,18,56,74,56,178,234
02208600,MADERA BEAUTY COLLEGE                   ,CA,93637-3519,Proprietary  ,2,14,16,31,31,62
02211000,HAIRMASTERS UNIVERSITY OF BEAUTY        ,CA,92405-0000,Proprietary  ,12,18,30,31,51,82
02220000,COLLEEN O'HARA BEAUTY ACADEMY           ,CA,92701-0000,Proprietary  ,41,68,109,76,161,237
02220200,CALIFORNIA CULINARY ACADEMY             ,CA,94102-3336,Proprietary  ,127,269,396,660,847,1507
02221300,MARINELLO SCHOOL OF BEAUTY              ,CA,92553-0000,Proprietary  ,53,88,141,130,283,413
02222000,AMERICAN FILM INSTITUTE                 ,CA,90027-0000,Private      ,12,61,73,108,513,621
02226000,EAST LOS ANGELES COLLEGE                ,CA,91754-0000,Public       ,1843,2080,3923,8548,7198,15746
02228500,LIFE CHIROPRACTIC COLLEGE-WEST          ,CA,94545-0000,Private      ,3,27,30,9,402,411
02230900,FREDRICK & CHARLES BEAUTY COLLEGE       ,CA,95501-0000,Proprietary  ,7,17,24,37,64,101
02231900,GEMOLOGICAL INSTITUTE OF AMERICA        ,CA,92008-4698,Private      ,12,72,84,49,215,264
02234300,FASHION CAREERS OF CALIFORNIA           ,CA,92110-0000,Proprietary  ,11,21,32,108,104,212
02236400,"THANH LE COLG, SCH OF COSMETOLOGY       ",CA,92840-0000,Proprietary  ,4,36,40,6,42,48
02237200,PHILLIPS GRADUATE INSTITUTE             ,CA,91316-0000,Private      ,2,54,56,3,303,306
02241600,SAN DIEGO CONTINUING EDUCATION          ,CA,92113-0000,Public       ,17,123,140,57,338,395
02241800,AMERICAN CAREER COLLEGE                 ,CA,90004-0000,Proprietary  ,548,1014,1562,1462,3163,4625
02242700,BERKELEY CITY COLLEGE                   ,CA,94704-0000,Public       ,324,725,1049,1446,2151,3597
02250602,EVEREST COLLEGE                         ,CA,91761-8525,Proprietary  ,128,332,460,322,1013,1335
02255400,INTERNATIONAL SCHOOL OF COSMETOLOGY     ,CA,90250-0000,Proprietary  ,8,10,18,46,40,86
02255600,MARINELLO SCHOOL OF BEAUTY              ,CA,90723-0000,Proprietary  ,20,46,66,71,162,233
02258600,ALAMEDA BEAUTY COLLEGE                  ,CA,94501-0000,Proprietary  ,49,77,126,110,155,265
02262400,YESHIVA OHR ELCHONON CHABAD             ,CA,90046-0000,Private      ,0,1,1,24,3,27
02263101,ANTHEM COLLEGE - HIGH-TECH INSTITUTE - S,CA,95827-0000,Proprietary  ,2,11,13,61,78,139
02267600,INSTITUTE OF TRANSPERSONAL PSYCHLGY     ,CA,94303-4624,Private      ,0,104,104,1,438,439
02270600,LIFE PACIFIC COLLEGE                    ,CA,91773-0000,Private      ,56,53,109,287,175,462
02276800,WESTMINSTER SEMINARY CALIFORNIA         ,CA,92027-0000,Private      ,0,14,14,0,141,141
02277400,SOUTH COAST COLLEGE                     ,CA,92868-2616,Proprietary  ,16,82,98,94,378,472
02282300,ALHAMBRA BEAUTY COLLEGE                 ,CA,91802-0000,Proprietary  ,11,63,74,18,77,95
02285100,HILLTOP BEAUTY SCHOOL                   ,CA,94014-0000,Proprietary  ,8,39,47,23,134,157
02291500,ITT TECHNICAL INSTITUTE                 ,CA,91773-0000,Proprietary  ,253,401,654,652,1145,1797
02291600,ITT TECHNICAL INSTITUTE                 ,CA,92123-0000,Proprietary  ,218,565,783,708,1710,2418
02298000,DESIGN INSTITUTE OF SAN DIEGO           ,CA,92121-0000,Proprietary  ,24,44,68,134,224,358
02304300,"PLATT COLLEGE, SAN DIEGO                ",CA,92115-0000,Proprietary  ,40,92,132,170,272,442
02306300,KAPLAN COLLEGE                          ,CA,95368-0000,Proprietary  ,119,221,340,476,928,1404
02306302,KAPLAN COLLEGE - FRESNO                 ,CA,93612-3802,Proprietary  ,56,127,183,278,588,866
02309500,CLOVIS ADULT EDUC                       ,CA,93611-0000,Public       ,13,56,69,36,225,261
02312400,LA COLLEGE INTERNATIONAL                ,CA,90010-0000,Proprietary  ,26,531,557,51,1033,1084
02321800,ITT TECHNICAL INSTITUTE                 ,CA,91342-3664,Proprietary  ,235,451,686,687,1226,1913
02321900,ITT TECHNICAL INSTITUTE                 ,CA,92801-0000,Proprietary  ,212,542,754,522,1202,1724
02327600,ART INST OF CALIFORNIA-SAN DIEGO        ,CA,92108-4401,Proprietary  ,326,520,846,2845,2595,5440
02330500,LAGUNA COLLEGE OF ART AND DESIGN        ,CA,92651-0000,Private      ,48,40,88,371,162,533
02332800,CENTER FOR EMPLOYMENT TRAINING          ,CA,95110-0000,Private      ,167,888,1055,298,1770,2068
02338500,GLENDALE CAREER COLLEGE                 ,CA,91201-0000,Proprietary  ,43,67,110,87,175,262
02338700,MARINELLO SCHOOL OF BEAUTY              ,CA,94103-0000,Proprietary  ,24,85,109,51,156,207
02342400,ACADEMY OF RADIO BROADCASTING           ,CA,92647-3809,Proprietary  ,18,66,84,45,130,175
02343400,"BELLUS ACADEMY, THE ACADEMY OF BEAUTY AN",CA,92064-4633,Proprietary  ,57,115,172,86,181,267
02345800,MONTEBELLO BEAUTY COLLEGE               ,CA,90640-0000,Proprietary  ,19,37,56,34,56,90
02351900,KAPLAN COLLEGE                          ,CA,95660-5512,Proprietary  ,77,266,343,252,917,1169
02351901,KAPLAN COLLEGE - BAKERSFIELD            ,CA,93304-0000,Proprietary  ,93,252,345,388,968,1356
02358000,THOMAS AQUINAS COLLEGE                  ,CA,93060-9622,Private      ,15,3,18,339,24,363
02359300,SHASTA BIBLE COLLEGE                    ,CA,96002-0000,Private      ,12,16,28,46,55,101
02482700,WESTERN UNIVERSITY OF HEALTH S          ,CA,91766-1854,Private      ,1,102,103,80,4476,4556
02494800,LOLA BEAUTY COLLEGE                     ,CA,92641-0000,Proprietary  ,5,25,30,5,27,32
02497300,TRINITY COLLEGE                         ,CA,93277-8109,Proprietary  ,72,277,349,176,671,847
02500000,SAN JOAQUIN COLLEGE OF LAW              ,CA,93612-0000,Private      ,1,35,36,10,300,310
02518400,THE NATIONAL HISPANIC UNIVERSITY        ,CA,95127-0000,Private      ,27,110,137,288,382,670
02519800,AVANCE BEAUTY COLLEGE                   ,CA,92154-0000,Proprietary  ,20,58,78,42,79,121
02520200,CALIFORNIA CAREER SCHOOLS               ,CA,92805-0000,Proprietary  ,8,26,34,14,53,67
02520300,INTERIOR DESIGNERS INSTITUTE            ,CA,92660-0000,Proprietary  ,15,60,75,27,86,113
02520400,ADRIAN'S BEAUTY COLLEGE OF TURLOCK      ,CA,95382-0000,Proprietary  ,26,63,89,73,101,174
02537200,PALOMAR INSTITUTE OF COSMETOLOGY        ,CA,92069-0000,Proprietary  ,45,67,112,118,132,250
02539100,KAPLAN COLLEGE                          ,CA,91606-3231,Proprietary  ,114,265,379,436,1191,1627
02539102,KAPLAN COLLEGE -  RIVERSIDE             ,CA,92507-4223,Proprietary  ,126,274,400,358,854,1212
02539500,IRVINE VALLEY COLLEGE                   ,CA,92620-0000,Public       ,536,758,1294,2288,2200,4488
02542300,NATIONAL HOLISTIC INSTITUTE             ,CA,94608-0000,Proprietary  ,54,172,226,153,488,641
02543400,BROWNSON TECHNICAL SCHOOL               ,CA,92805-0000,Proprietary  ,8,88,96,13,140,153
02545900,HYPNOSIS MOTIVATION INSTITUTE           ,CA,91356-0000,Private      ,4,79,83,4,99,103
02546400,MTI BUSINESS COLLEGE INC                ,CA,95207-0000,Proprietary  ,7,61,68,15,115,130
02549000,KAPLAN COLLEGE                          ,CA,92083-7736,Proprietary  ,164,373,537,510,1283,1793
02549005,KAPLAN COLLEGE -  PALM SPRINGS          ,CA,92262-7011,Proprietary  ,90,214,304,268,783,1051
02553500,ASSOCIATED TECHNICAL COLLEGE            ,CA,92101-0000,Proprietary  ,28,89,117,68,217,285
02553600,DIVERSIFIED LANGUAGE INSTITUTE          ,CA,90017-0000,Proprietary  ,13,261,274,19,660,679
02559300,UNITED EDUCATION INSTITUTE              ,CA,90020-0000,Proprietary  ,1169,2401,3570,2217,4996,7213
02559400,INTERCOAST COLLEGES                     ,CA,92868-1656,Proprietary  ,88,789,877,193,1977,2170
02565400,KAPLAN COLLEGE                          ,CA,95207-6216,Proprietary  ,43,162,205,241,622,863
02570300,LOS ANGELES ORT TECHNICAL INSTITUTE     ,CA,90048-0000,Private      ,68,316,384,144,646,790
02577900,SANTA BARBARA BUSINESS COLLEGE          ,CA,93309-1664,Proprietary  ,149,297,446,343,785,1128
02578000,SANTA BARBARA BUSINESS COLLEGE          ,CA,93454-6943,Proprietary  ,53,103,156,128,362,490
02584200,NEWBRIDGE COLLEGE                       ,CA,92701-0000,Proprietary  ,76,207,283,165,564,729
02591600,NORTH-WEST COLLEGE                      ,CA,91101-1744,Proprietary  ,8,26,34,33,96,129
02593100,HEALD COLLEGE                           ,CA,95678-5303,Proprietary  ,115,282,397,384,1270,1654
02593200,HEALD COLLEGE                           ,CA,95035-8008,Proprietary  ,133,368,501,481,1382,1863
02593300,HEALD COLLEGE                           ,CA,95210-5667,Proprietary  ,190,512,702,650,1794,2444
02595600,ASIAN AMERICAN INTERNATIONAL BTY CG     ,CA,92683-4043,Proprietary  ,9,43,52,14,55,69
02597300,SOUTH BAYLO UNIVERSITY                  ,CA,92801-1701,Private      ,2,79,81,3,166,169
02602300,CENTRAL COAST COLLEGE                   ,CA,93901-3301,Proprietary  ,54,147,201,113,234,347
02608900,PINNACLE COLLEGE                        ,CA,91803-8842,Proprietary  ,17,27,44,35,87,122
02608901,PINNACLE COLLEGE - SACRAMENTO           ,CA,95826-2581,Proprietary  ,23,29,52,57,71,128
02609000,EMPERORS COLG OF TRAD ORIENTAL MED      ,CA,90403-5609,Proprietary  ,0,48,48,4,128,132
02612800,LOS ANGELES RECORDING SCHOOL            ,CA,90028-3112,Proprietary  ,148,176,324,598,639,1237
02619300,SAMRA UNIV OF ORIENTAL MEDICINE         ,CA,90015-1019,Private      ,0,35,35,1,71,72
03010611,VIRGINIA COLLEGE - GOLF ACADEMY OF AMERI,CA,92008-6512,Proprietary  ,40,72,112,114,262,376
03011300,"CALIF STATE UNIV, SAN MARCOS            ",CA,92096-0001,Public       ,368,605,973,8877,4734,13611
03019900,ADELANTE CAREER INSTITUTE               ,CA,91402-4924,Proprietary  ,8,34,42,10,43,53
03025600,DELL'ARTE SCH OF PHYSICAL THEATRE       ,CA,95525-0816,Private      ,2,13,15,6,41,47
03027700,PACIFIC COLLEGE OF ORIENTAL MED         ,CA,92108-4408,Proprietary  ,3,173,176,19,402,421
03029600,POMONA ADULT SCHOOL                     ,CA,91766-0000,Public       ,26,102,128,46,150,196
03031409,INTERNATIONAL ACADEMY OF DESIGN AND TECH,CA,95834-9664,Proprietary  ,84,112,196,332,498,830
03034000,HEALD COLLEGE                           ,CA,93906-5100,Proprietary  ,153,254,407,571,1115,1686
03035700,LAS POSITAS COLLEGE                     ,CA,94551-6750,Public       ,355,494,849,1562,1603,3165
03039900,FREMONT COLLEGE                         ,CA,90703-5342,Proprietary  ,29,80,109,116,209,325
03043900,NEWSCHOOL OF ARCHITECTURE & DESIGN      ,CA,92101-6634,Proprietary  ,21,95,116,237,504,741
03044500,KAPLAN COLLEGE                          ,CA,91402-4222,Proprietary  ,51,93,144,119,310,429
03054100,ROYALE COLLEGE OF BEAUTY                ,CA,92590-2525,Proprietary  ,15,41,56,37,90,127
03062300,WESTECH COLLEGE                         ,CA,91764-4988,Proprietary  ,67,307,374,129,544,673
03062400,MT DIABLO ADULT EDUC LOMA VISTA CTR     ,CA,94518-1122,Public       ,5,46,51,37,132,169
03062700,PLATT COLLEGE                           ,CA,90041-0000,Proprietary  ,22,51,73,108,147,255
03062701,PLATT COLLEGE                           ,CA,91764-0000,Proprietary  ,52,102,154,192,311,503
03063400,MODERN TECHNOLOGY SCHOOL                ,CA,92708-9821,Proprietary  ,11,44,55,44,157,201
03067400,BALDWIN PARK ADULT SCHOOL               ,CA,91706-4897,Public       ,31,79,110,48,143,191
03067500,INSTITUTE OF TECHNOLOGY                 ,CA,93612-3217,Proprietary  ,278,901,1179,753,2477,3230
03067505,INSTITUTE OF TECHNOLOGY - REDDING       ,CA,96002-0926,Proprietary  ,1,9,10,1,9,10
03069500,SAGE COLLEGE                            ,CA,92557-6720,Proprietary  ,38,181,219,106,451,557
03070400,ITT TECHNICAL INSTITUTE                 ,CA,92408-3519,Proprietary  ,212,439,651,820,1533,2353
03072300,EVEREST COLLEGE                         ,CA,91761-3222,Proprietary  ,119,275,394,303,700,1003
03072700,WESTWOOD COLLEGE - LOS ANGELES          ,CA,90010-1577,Proprietary  ,571,2680,3251,2122,6712,8834
03074900,MARTINEZ ADULT CENTER                   ,CA,94553-3298,Public       ,1,23,24,3,51,54
03078200,AMERICAN CLG TRADITIONAL CHINESE MD     ,CA,94107-2813,Private      ,1,35,36,3,233,236
03084700,VENTURA ADULT\CONTINUING EDUCATION      ,CA,93003-7313,Public       ,18,52,70,38,134,172
03087400,ITT TECHNICAL INSTITUTE                 ,CA,90502-1356,Proprietary  ,289,778,1067,684,1807,2491
03094400,ELITE PROGRESSIVE SCHOOL OF COSM        ,CA,95841-2909,Proprietary  ,83,125,208,190,267,457
03097700,CENTRAL CALIF SCH CONTINUING EDUC       ,CA,93401-6739,Proprietary  ,18,85,103,46,183,229
03098200,YO SAN UNIV TRADITIONAL CHINESE MED     ,CA,90066-1103,Private      ,0,48,48,2,136,138
03108100,SUMMIT CAREER COLLEGE                   ,CA,92324-3956,Proprietary  ,152,561,713,304,1116,1420
03109500,DONGGUK ROYAL UNIVERSITY                ,CA,90020-1765,Private      ,0,31,31,1,62,63
03113300,MCED CAREER COLLEGE                     ,CA,93727-1620,Proprietary  ,17,231,248,44,402,446
03113600,SOUTHERN CALIFORNIA INST OF TECHNOL     ,CA,92805-3758,Proprietary  ,27,259,286,82,784,866
03116600,EAST SAN GABRIEL VLY REG OCCUP PROG     ,CA,91790-2105,Public       ,18,267,285,48,503,551
03125300,JOHN WESLEY INTER. BARBER & BTY CLG     ,CA,90813-4321,Proprietary  ,23,44,67,35,66,101
03125400,ART INSTITUTE OF CALIFORNIA-HOLLYWOOD (T,CA,90010-1014,Proprietary  ,307,338,645,1807,1472,3279
03125800,PREMIERE CAREER COLLEGE                 ,CA,91706-3746,Proprietary  ,80,161,241,120,304,424
03126800,PACIFICA GRADUATE INSTITUTE             ,CA,93013-0000,Proprietary  ,0,232,232,2,834,836
03128700,MT SIERRA COLLEGE                       ,CA,91016-3414,Proprietary  ,53,95,148,220,372,592
03131300,FIVE BRANCHES UNIVERSITY                ,CA,95062-4669,Private      ,3,89,92,15,326,341
03144400,AMERICAN CLG OF HEALTH PROFESSIONS      ,CA,92374-0000,Proprietary  ,6,22,28,13,34,47
03150500,VIRGINIA SEWING MACHINES & SCH CTR      ,CA,90015-3535,Proprietary  ,0,13,13,2,46,48
03162300,FOUR-D SUCCESS ACADEMY                  ,CA,92324-4218,Proprietary  ,79,280,359,172,712,884
03163300,PACIFIC STATES UNIVERSITY               ,CA,90006-4298,Private      ,2,6,8,19,39,58
03195400,EVEREST COLLEGE                         ,CA,90501-2867,Proprietary  ,49,96,145,81,163,244
03210300,LE CORDON BLEU COLLEGE OF CULINARY ARTS ,CA,91101-5221,Proprietary  ,350,674,1024,1371,1980,3351
03225300,AMERICAN UNIVERSITY OF HEALTH SCIENCES  ,CA,90755-3612,Proprietary  ,14,36,50,55,118,173
03242300,CAREER NETWORK INSTITUTE                ,CA,92868-4710,Proprietary  ,52,175,227,106,371,477
03250300,COMMUNITY BASED EDUCATION AND DEVEL     ,CA,90036-1137,Private      ,28,128,156,43,242,285
03260300,CALIFORNIA STATE U-MONTEREY BAY         ,CA,93955-8001,Public       ,243,405,648,6928,2280,9208
03266300,BETHESDA CHRISTIAN UNIVERSITY           ,CA,92801-4132,Private      ,5,31,36,11,37,48
03278300,CLARITA CAREER COLLEGE                  ,CA,91351-5432,Proprietary  ,191,360,551,372,950,1322
03282300,KIM ANH ACADEMY OF BEAUTY               ,CA,92683-4605,Proprietary  ,16,152,168,16,152,168
03288300,ACAD CHINESE CULTURE & HEALTH SCIS      ,CA,94512-0000,Private      ,1,28,29,4,67,71
03299300,PACIFIC COLLEGE                         ,CA,92626-3160,Proprietary  ,25,184,209,63,431,494
03308300,KENSINGTON COLLEGE                      ,CA,92705-8708,Proprietary  ,3,24,27,6,43,49
03321300,SCRIPPS RESEARCH INSTITUTE (THE)        ,CA,92037-0000,Private      ,0,3,3,5,34,39
03327400,ACUPUNCTURE AND INTEGRATIVE MEDICINE COL,CA,94704-2724,Private      ,1,31,32,4,183,187
03332300,SOUTHERN CA BIBLE CLG & SEMINARY        ,CA,92019-1109,Private      ,2,44,46,5,134,139
03359300,ST. FRANCIS CAREER COLLEGE              ,CA,90262-2659,Private      ,13,61,74,100,287,387
03367300,PROFESSIONAL GOLFERS CAREER COLLEGE     ,CA,92591-6013,Proprietary  ,61,120,181,238,375,613
03394300,REMINGTON COLLEGE - SAN DIEGO CAMPUS    ,CA,92108-3002,Proprietary  ,92,176,268,301,542,843
03395300,INTERNATIONAL CAREER DEVELOPMENT        ,CA,90027-5794,Proprietary  ,325,934,1259,693,1800,2493
03399300,NORTHWESTERN TECHNICAL COLLEGE          ,CA,95670-4443,Proprietary  ,53,167,220,104,376,480
03403300,TRINITY LIFE BIBLE COLLEGE              ,CA,95842-3546,Private      ,15,92,107,65,253,318
03413400,ENGLISH CENTER  (THE)                   ,CA,94607-3734,Private      ,19,102,121,27,184,211
03427400,CAREER COLLEGES OF AMERICA              ,CA,90280-7420,Proprietary  ,159,607,766,376,1710,2086
03427500,ANTELOPE VALLEY MEDICAL COLLEGE         ,CA,93534-3324,Proprietary  ,104,225,329,275,626,901
03440400,MARIAN HEALTH CAREERS CENTER            ,CA,90010-1728,Proprietary  ,22,69,91,39,97,136
03441400,VALLEY CAREER COLLEGE                   ,CA,92020-3057,Proprietary  ,54,171,225,99,312,411
03455900,VALLECITOS CENTER FOR EMPLOYMENT TR     ,CA,94541-5027,Private      ,0,2,2,4,9,13
03458300,MY LE'S BEAUTY COLLEGE                  ,CA,95824-3039,Proprietary  ,12,70,82,45,138,183
03467300,MARINELLO SCHOOL OF BEAUTY              ,CA,92545-3661,Proprietary  ,75,135,210,137,290,427
03467301,CALIFORNIA BEAUTY COLLEGE - DESERT HOT S,CA,92240-1307,Proprietary  ,1,0,1,3,1,4
03474700,OPPORTUNITIES INDUSTRIALIZATION CEN     ,CA,94025-1413,Private      ,0,0,0,1,4,5
03479300,PROFESSIONAL CAREER INSTITUTE           ,CA,90703-2522,Proprietary  ,17,58,75,57,188,245
03485400,JAMES ALBERT SCHOOL OF COSMETOLOGY      ,CA,92627-3831,Proprietary  ,39,70,109,55,104,159
03485401,JAMES ALBERT SCHOOL OF COSMETOLOGY - ANA,CA,92804-5384,Proprietary  ,0,3,3,8,9,17
03516300,THE KING'S COLLEGE AND SEMINARY         ,CA,91405-2233,Private      ,15,129,144,33,262,295
03532400,ADVANCED TRAINING ASSOCIATES            ,CA,92020-1236,Proprietary  ,2,23,25,5,42,47
03542400,COPPER MOUNTAIN COLLEGE                 ,CA,92252-6102,Public       ,166,517,683,544,1505,2049
03577300,COBA ACADEMY                            ,CA,92866-1407,Proprietary  ,43,36,79,53,52,105
03590400,NTMA TRAINING CENTERS OF SOUTHERN C     ,CA,90650-6099,Private      ,22,189,211,51,343,394
03592400,IRELL & MANELLA GRADUATE SCHOOL OF BIOLO,CA,91010-0000,Private      ,0,3,3,2,16,18
03598300,AVALON BEAUTY COLLEGE                   ,CA,93103-3137,Proprietary  ,23,15,38,56,44,100
03614300,UNITED BEAUTY COLLEGE                   ,CA,91733-0000,Proprietary  ,5,27,32,9,40,49
03621300,LIBERTY TRAINING INSTITUTE              ,CA,90057-3202,Proprietary  ,17,56,73,20,61,81
03639300,WEST COAST ULTRASOUND INSTITUTE         ,CA,90211-3312,Proprietary  ,79,299,378,211,890,1101
03646300,DESIGN'S SCHOOL OF COSMETOLOGY          ,CA,93446-1471,Proprietary  ,31,70,101,50,121,171
03681300,CALIFORNIA HEALING ARTS COLLEGE         ,CA,90025-2589,Proprietary  ,14,64,78,31,101,132
03695300,COMMUNITY ENHANCEMENT SERVICES          ,CA,91205-2395,Private      ,10,66,76,13,71,84
03695700,SANTIAGO CANYON COLLEGE                 ,CA,92869-4512,Public       ,444,505,949,1689,1310,2999
03696300,UNIVERSITY OF THE WEST                  ,CA,91770-3709,Private      ,1,12,13,5,51,56
03698300,WEST COAST UNIVERSITY                   ,CA,90004-0000,Proprietary  ,195,655,850,480,1746,2226
03698400,CA COLLEGE OF VOCATIONAL CAREER         ,CA,93301-1800,Proprietary  ,15,39,54,40,94,134
03736300,ADVANCE BEAUTY COLLEGE                  ,CA,92843-4752,Proprietary  ,11,134,145,20,222,242
03740400,ATI COLLEGE                             ,CA,90650-0000,Proprietary  ,25,91,116,39,195,234
03759300,COMPUTER TUTOR BUSINESS & TECH INST     ,CA,95356-0000,Proprietary  ,6,37,43,21,89,110
03786300,ADVANCED COLLEGE                        ,CA,90280-5255,Proprietary  ,29,118,147,56,286,342
03797400,CAREER CARE INSTITUTE                   ,CA,93534-4766,Proprietary  ,43,149,192,140,540,680
03797401,CAREER CARE INSTITUTE - VENTURA         ,CA,93003-0000,Proprietary  ,25,69,94,26,75,101
03806300,LAKE COLLEGE                            ,CA,96002-0926,Proprietary  ,0,0,0,9,62,71
03810300,SILICON VALLEY UNIVERSITY               ,CA,95131-1868,Private      ,1,8,9,13,41,54
03814400,SOKA UNIVERSITY OF AMERICA              ,CA,92656-8081,Private      ,5,6,11,457,46,503
03838400,WALTER JAY M.D. INSTITUTE AN EDUCATIONAL,CA,90057-0000,Proprietary  ,4,42,46,5,51,56
03852500,CIT COLLEGE OF INFOMEDICAL TECHNOLOGY   ,CA,92831-3703,Proprietary  ,36,171,207,55,342,397
03852501,CIT COLLEGE OF INFOMEDICAL TECHNOLOGY - ,CA,90010-1308,Proprietary  ,1,2,3,1,2,3
03853300,KECK GRADUATE INSTITUTE OF APPLIED LIFE ,CA,91711-4817,Private      ,0,11,11,2,68,70
03853400,LADERA CAREER PATHS TRAINING CENTERS    ,CA,90045-1931,Proprietary  ,3,19,22,6,29,35
03868300,WORLD MISSION UNIVERSITY                ,CA,90020-1789,Private      ,1,29,30,2,65,67
03868400,LOS ANGELES MUSIC ACADEMY               ,CA,91105-2540,Proprietary  ,13,10,23,67,54,121
03871300,FOLSOM LAKE COLLEGE                     ,CA,95630-6798,Public       ,265,552,817,1711,2205,3916
03874300,CAMBRIDGE JUNIOR COLLEGE                ,CA,95993-0000,Proprietary  ,21,70,91,67,143,210
03874400,COMMMUNITY CHRISTIAN COLLEGE            ,CA,92373-4465,Private      ,16,19,35,62,62,124
03889300,STANBRIDGE COLLEGE                      ,CA,92612-0000,Proprietary  ,40,184,224,94,428,522
03901300,PACIFIC COAST TRADE SCHOOL              ,CA,93033-2441,Proprietary  ,16,90,106,24,126,150
03910400,NATIONAL POLYTECHNIC COLLEGE            ,CA,90040-3066,Proprietary  ,26,80,106,49,180,229
03933300,MUELLER COLLEGE OF HOLISTIC STUDIES     ,CA,92116-2630,Proprietary  ,8,68,76,36,201,237
03933301,MUELLER COLLEGE OF HOLISTIC STUDIES -   ,CA,92120-3449,Proprietary  ,0,6,6,1,13,14
03935300,CALIFORNIA NURSES EDUCATIONAL INSTITUTE ,CA,92234-7248,Proprietary  ,8,26,34,12,49,61
03962300,AMERICAN INSTITUTE OF MASSAGE THERAPY   ,CA,92705-5463,Proprietary  ,4,17,21,25,40,65
03964400,INTERNATIONAL SCHOOL OF BEAUTY          ,CA,92260-2740,Proprietary  ,19,70,89,48,150,198
03969600,AMERICAN AUTO INSTITUTE                 ,CA,90703-2637,Proprietary  ,12,34,46,29,60,89
03971300,AMERICAN CAREER COLLEGE                 ,CA,91764-4906,Proprietary  ,213,400,613,536,1191,1727
03973300,EX'PRESSION COLLEGE FOR DIGITAL ARTS    ,CA,94608-1021,Proprietary  ,152,148,300,603,605,1208
03974500,CALIFORNIA CAREER COLLEGE               ,CA,91303-2006,Proprietary  ,9,34,43,24,86,110
03980300,CALIFORNIA STATE UNIVERSITY CHANNEL ISLA,CA,93012-8599,Public       ,110,223,333,3782,1829,5611
03995300,UNIVERSITY OF EAST-WEST MEDICINE        ,CA,94087-6106,Proprietary  ,1,14,15,7,48,55
03999300,BEAUMONT ADULT SCHOOL                   ,CA,92223-1927,Public       ,9,41,50,26,127,153
04001300,PALACE BEAUTY COLLEGE                   ,CA,90006-4233,Proprietary  ,11,64,75,24,85,109
04001400,MOJAVE BARBER COLLEGE                   ,CA,92395-3201,Proprietary  ,7,28,35,21,65,86
04003300,CSI CAREER COLLEGE                      ,CA,95687-3100,Proprietary  ,44,171,215,114,398,512
04004300,THUY PRINCESS BEAUTY COLLEGE            ,CA,91766-0000,Proprietary  ,3,54,57,10,70,80
04005300,INTERAMERICAN COLLEGE                   ,CA,91950-4437,Private      ,2,48,50,5,123,128
04014400,PALLADIUM TECHNICAL ACADEMY             ,CA,91731-2429,Proprietary  ,11,47,58,14,72,86
04023400,PROTEUS                                 ,CA,93291-3014,Private      ,0,8,8,4,11,15
04037300,LOS ANGELES FILM SCHOOL (THE)           ,CA,90028-7300,Proprietary  ,120,140,260,560,551,1111
04049300,MAXINE WATERS EMPLOYMENT PREPARATION CEN,CA,90059-1023,Public       ,2,35,37,13,79,92
04056300,CAREER COLLEGE OF CALIFORNIA            ,CA,92705-5805,Proprietary  ,6,9,15,10,25,35
04057300,TECHSKILLS OF SACRAMENTO                ,CA,95815-4025,Proprietary  ,9,110,119,42,298,340
04071300,AMERICAN PACIFIC COLLEGE                ,CA,91405-6232,Proprietary  ,0,10,10,5,23,28
04076400,GNOMON SCHOOL OF VISUAL EFFECTS         ,CA,90038-2616,Proprietary  ,6,42,48,27,109,136
04092300,COASTLINE BEAUTY COLLEGE                ,CA,92708-3847,Proprietary  ,9,84,93,13,117,130
04092400,MAKE-UP DESIGNORY                       ,CA,91502-1322,Proprietary  ,82,78,160,238,233,471
04100400,TAFT UNIVERSITY SYSTEM (THE)            ,CA,92704-6954,Proprietary  ,1,84,85,3,257,260
04109300,ACADEMY OF BARBERING ARTS (THE)         ,CA,91324-3406,Proprietary  ,23,61,84,37,93,130
04111300,WEST HILLS COLLEGE LEMOORE              ,CA,93245-9248,Public       ,251,570,821,1323,2104,3427
04114500,VALLEY COLLEGE OF MEDICAL CAREERS       ,CA,91304-2354,Proprietary  ,14,38,52,43,137,180
04115300,COACHELLA VALLEY BEAUTY COLLEGE         ,CA,92253-2051,Proprietary  ,4,19,23,20,56,76
04115600,MAYFIELD COLLEGE                        ,CA,92234-7014,Proprietary  ,10,48,58,14,71,85
04116000,VIDEO SYMPHONY ENTERTRAINING            ,CA,91502-3253,Proprietary  ,18,89,107,64,264,328
04119200,CAREER COLLEGE CONSULTANTS              ,CA,90041-2088,Proprietary  ,6,59,65,8,61,69
04126400,CHAMPION INSTITUTE OF COSMETOLOGY       ,CA,92264-7458,Proprietary  ,6,21,27,12,43,55
04126500,COAST CAREER INSTITUTE                  ,CA,90015-3040,Proprietary  ,57,203,260,85,335,420
04127100,"UNIVERSITY OF CALIFORNIA, MERCED        ",CA,95343-5001,Public       ,82,74,156,7796,968,8764
04127800,HEALTHY HAIR ACADEMY                    ,CA,90303-3137,Proprietary  ,15,83,98,22,83,105
04127900,TUI UNIVERSITY                          ,CA,90630-5023,Proprietary  ,8,525,533,19,1508,1527
04129700,INTERNATIONAL POLYTECHNIC INSTITUTE     ,CA,92231-1737,Private      ,1,9,10,4,18,22
04132300,INSTITUTE OF MEDICAL EDUCATION          ,CA,95113-2207,Proprietary  ,39,213,252,95,558,653
04132400,ACADEMY OF ESTHETICS AND COSMETOLOGY    ,CA,91342-3373,Proprietary  ,1,3,4,11,16,27
04132700,INFOTECH CAREER COLLEGE                 ,CA,90706-5579,Proprietary  ,28,70,98,43,145,188
04133000,BIOHEALTH COLLEGE                       ,CA,95134-2033,Proprietary  ,8,65,73,12,123,135
04134500,CAREER COLLEGE OF SAN DIEGO             ,CA,92102-3348,Proprietary  ,10,67,77,34,209,243
04134700,INTERNATL PROFESSIONAL SCHL OF BODYWORK ,CA,92123-1520,Proprietary  ,12,67,79,30,136,166
04137200,BORNER'S BARBER COLLEGE                 ,CA,90047-3856,Proprietary  ,7,18,25,8,25,33
04138700,CAO INSTITUTE OF AESTHETICS (THE)       ,CA,91801-3903,Proprietary  ,28,33,61,38,55,93
04141300,SAN FRANCISCO INSTITUTE OF ESTHETICS    ,CA,94103-4083,Proprietary  ,39,54,93,88,126,214
04141400,LAURUS COLLEGE                          ,CA,93401-5405,Proprietary  ,14,60,74,30,96,126
04141700,HEALING HANDS SCHOOL OF HOLISTIC HEALTH ,CA,92025-1722,Proprietary  ,3,34,37,10,71,81
04144200,CAREER DEVELOPMENT INSTITUTE            ,CA,90035-4364,Proprietary  ,0,6,6,4,17,21
04146000,NATIONAL CAREER COLLEGE                 ,CA,91605-1400,Proprietary  ,4,30,34,5,31,36
04149700,HOMESTEAD SCHOOLS                       ,CA,90505-5945,Private      ,5,16,21,5,16,21
04150000,CENTRAL NURSING COLLEGE                 ,CA,90010-2444,Proprietary  ,9,75,84,9,75,84
04150300,RWM FIBER OPTICS                        ,CA,90746-1051,Proprietary  ,5,25,30,5,25,30
04152800,CALIFORNIA ACADEMY (THE) - A PAUL MITCHE,CA,95825-2276,Proprietary  ,66,92,158,83,118,201
04153900,PROVIDENCE CHRISTIAN COLLEGE            ,CA,91761-5626,Private      ,2,2,4,2,2,4
00184600,BRIAR CLIFF UNIVERSITY                  ,IA,51104-2100,Private      ,64,106,170,1125,418,1543
00184700,BUENA VISTA UNIVERSITY                  ,IA,50588-9987,Private      ,92,437,529,1817,1716,3533
00184800,SOUTHEASTERN COMMUNITY COLLEGE          ,IA,52655-0000,Public       ,306,856,1162,1124,2134,3258
00185000,CENTRAL COLLEGE                         ,IA,50219-1999,Private      ,89,20,109,2291,122,2413
00185200,CLARKE COLLEGE                          ,IA,52001-3198,Private      ,47,99,146,997,474,1471
00185400,COE COLLEGE                             ,IA,52402-5092,Private      ,39,37,76,1815,185,2000
00185500,DES MOINES UNIV-OSTEOPATHIC MED CTR     ,IA,50312-0000,Private      ,1,184,185,14,1740,1754
00185600,CORNELL COLLEGE                         ,IA,52314-1098,Private      ,32,10,42,1841,89,1930
00185700,SOUTHWESTERN COMMUNITY COLLEGE          ,IA,50801-1098,Public       ,114,294,408,582,736,1318
00185800,DIVINE WORD COLLEGE                     ,IA,52045-0380,Private      ,2,7,9,6,10,16
00185900,DORDT COLLEGE                           ,IA,51250-1697,Private      ,48,15,63,1369,80,1449
00186000,DRAKE UNIVERSITY                        ,IA,50311-4505,Private      ,121,306,427,4263,2323,6586
00186200,ELLSWORTH COMMUNITY COLLEGE             ,IA,50126-1199,Public       ,117,91,208,706,292,998
00186400,IOWA LAKES COMMUNITY COLLEGE            ,IA,51334-2234,Public       ,215,480,695,1285,1220,2505
00186500,IOWA CENTRAL COMMUNITY COLLEGE          ,IA,50501-0000,Public       ,429,923,1352,2220,2228,4448
00186600,GRACELAND UNIVERSITY                    ,IA,50140-1699,Private      ,141,305,446,1036,1165,2201
00186700,GRAND VIEW UNIVERSITY                   ,IA,50316-1599,Private      ,121,238,359,1682,1085,2767
00186800,GRINNELL COLLEGE                        ,IA,50112-1690,Private      ,46,6,52,2476,43,2519
00186900,IOWA STATE UNIV SCIENCE & TECHNOLOG     ,IA,50011-2028,Public       ,913,800,1713,19904,5255,25159
00187100,IOWA WESLEYAN COLLEGE                   ,IA,52641-1398,Private      ,55,90,145,895,452,1347
00187300,LORAS COLLEGE                           ,IA,52004-0178,Private      ,65,29,94,2290,160,2450
00187400,LUTHER COLLEGE                          ,IA,52101-1045,Private      ,73,11,84,3230,80,3310
00187500,MARSHALLTOWN COMMUNITY COLLEGE          ,IA,50158-4760,Public       ,166,333,499,661,846,1507
00187700,NORTH IOWA AREA COMMUNITY COLLEGE       ,IA,50401-7299,Public       ,262,388,650,1536,1160,2696
00187900,MORNINGSIDE COLLEGE                     ,IA,51106-1751,Private      ,69,112,181,1552,463,2015
00188000,MOUNT MERCY COLLEGE                     ,IA,52402-4797,Private      ,68,189,257,1006,787,1793
00188100,ASHFORD UNIVERSITY                      ,IA,52732-3997,Proprietary  ,1025,25220,26245,2269,52759,55028
00188300,NORTHWESTERN COLLEGE                    ,IA,51041-1996,Private      ,63,17,80,1501,92,1593
00188700,SIMPSON COLLEGE                         ,IA,50125-1297,Private      ,94,141,235,2098,524,2622
00188900,ST AMBROSE UNIVERSITY                   ,IA,52803-2898,Private      ,213,326,539,2683,1224,3907
00189000,UNIVERSITY OF NORTHERN IOWA             ,IA,50614-0705,Public       ,861,675,1536,10289,2929,13218
00189100,UNIVERSITY OF DUBUQUE                   ,IA,52001-5099,Private      ,106,110,216,1695,555,2250
00189200,UNIVERSITY OF IOWA                      ,IA,52242-1316,Public       ,1174,1281,2455,17145,9162,26307
00189300,UPPER IOWA UNIVERSITY                   ,IA,52142-9206,Private      ,199,1444,1643,1278,4363,5641
00189500,WALDORF COLLEGE                         ,IA,50436-1700,Private      ,65,19,84,655,90,745
00189600,WARTBURG COLLEGE                        ,IA,50677-2200,Private      ,37,12,49,2434,102,2536
00189700,WARTBURG THEOLOGICAL SEMINARY           ,IA,52004-5004,Private      ,0,12,12,2,140,142
00190000,WILLIAM PENN UNIVERSITY                 ,IA,52577-1799,Private      ,140,238,378,1090,1235,2325
00396300,AIB COLLEGE OF BUSINESS                 ,IA,50321-1799,Private      ,46,116,162,636,580,1216
00407500,ESTRN IOWA COMMUNITY COLLEGE DIST       ,IA,52801-1221,Public       ,11,52,63,55,147,202
00407501,CLINTON COMMUNITY COLLEGE               ,IA,52732-0000,Public       ,117,275,392,399,633,1032
00407502,MUSCATINE COMMUNITY COLLEGE             ,IA,52761-0000,Public       ,107,267,374,432,599,1031
00407503,SCOTT COMMUNITY COLLEGE                 ,IA,52722-0000,Public       ,412,1080,1492,1316,2761,4077
00407600,KIRKWOOD COMMUNITY COLLEGE              ,IA,52406-2068,Public       ,1554,2757,4311,7107,7123,14230
00423300,MERCY/ST. LUKE'S SCH RAD TECH           ,IA,52402-0000,Private      ,1,5,6,12,29,41
00458600,KAPLAN UNIVERSITY                       ,IA,52807-2095,Proprietary  ,2115,31967,34082,5043,92385,97428
00458604,KAPLAN UNIVERSITY - CEDAR RAPIDS        ,IA,52404-2998,Proprietary  ,45,354,399,177,1289,1466
00458605,KAPLAN UNIVERSITY - DES MOINES          ,IA,50323-5702,Proprietary  ,73,383,456,332,1686,2018
00458606,KAPLAN UNIVERSITY - MASON CITY          ,IA,50401-4665,Proprietary  ,33,140,173,107,653,760
00458607,KAPLAN UNIVERSITY - CEDAR FALLS         ,IA,50613-6309,Proprietary  ,52,328,380,219,1265,1484
00458610,KAPLAN UNIVERSITY - COUNCIL BLUFFS      ,IA,51503-5289,Proprietary  ,17,139,156,66,523,589
00458700,NORTHEAST IOWA COMMUNITY COLLEGE        ,IA,52132-0400,Public       ,133,217,350,686,805,1491
00458701,NORTHEAST IOWA COMMUNITY COLLEGE        ,IA,52068-0000,Public       ,298,477,775,1126,1374,2500
00459500,HAWKEYE COMMUNITY COLLEGE               ,IA,50701-0000,Public       ,678,927,1605,3164,2549,5713
00459800,IOWA WESTERN CMTY CLG-COUNCIL BLUFF     ,IA,51502-0000,Public       ,607,746,1353,2759,2359,5118
00460000,NORTHWEST IOWA COMMUNITY COLLEGE        ,IA,51201-1046,Public       ,66,156,222,490,414,904
00626700,IOWA METHODIST MEDICAL CENTER SCHOOLS   ,IA,50309-1499,Private      ,2,8,10,24,32,56
00627300,MERCY COLLEGE OF HEALTH SCIENCES        ,IA,50309-1239,Private      ,52,184,236,392,774,1166
00712000,DES MOINES AREA CMTY COLLEGE            ,IA,50021-0000,Public       ,1374,3121,4495,6033,8747,14780
00712100,FAITH BAPTIST BIBLE CLG & THEOL SEM     ,IA,50021-0000,Private      ,49,17,66,344,65,409
00729100,ST LUKE'S COLLEGE                       ,IA,51104-0263,Private      ,6,21,27,120,119,239
00731600,WESTERN IOWA TECH COMMUNITY COLLEGE     ,IA,51106-0000,Public       ,504,1005,1509,1607,2656,4263
00758800,CAPRI COLLEGE                           ,IA,52004-0873,Proprietary  ,23,34,57,87,95,182
00761100,EQ SCHOOL OF HAIR DESIGN                ,IA,51503-0813,Proprietary  ,9,14,23,42,45,87
00765600,AMERICAN COLLEGE OF HARISTYLING -CR     ,IA,52402-0000,Proprietary  ,7,5,12,11,17,28
00765800,AMER COLL OF HAIRSTYLING-DES MOINES     ,IA,50309-5446,Proprietary  ,7,14,21,9,36,45
00765900,LA JAMES COLLEGE OF HAIRSTYLING         ,IA,50401-3308,Proprietary  ,22,23,45,65,69,134
00771700,CAPRI COLLEGE                           ,IA,52807-2622,Proprietary  ,40,58,98,89,125,214
00794100,COLLEGE OF HAIR DESIGN                  ,IA,50703-1834,Proprietary  ,9,19,28,23,42,65
00811600,DAYTON'S SCHOOL OF HAIR DESIGN          ,IA,52601-0000,Proprietary  ,0,0,0,5,13,18
00826000,IOWA SCHOOL OF BEAUTY INC               ,IA,50322-0000,Proprietary  ,23,76,99,52,140,192
00840300,INDIAN HILLS COMMUNITY COLLEGE          ,IA,52501-1398,Public       ,374,876,1250,1638,2291,3929
00840301,INDIAN HILLS COMMUNITY COLLEGE          ,IA,52544-0000,Public       ,43,104,147,223,294,517
00842400,LA JAMES INTERNATIONAL COLLEGE          ,IA,50501-5577,Proprietary  ,20,29,49,97,92,189
00959300,LA'JAMES COLLEGE OF HAIRSTYLING         ,IA,52240-0000,Proprietary  ,19,27,46,66,55,121
01111300,MAHARISHI UNIV OF MANAGEMENT            ,IA,52557-0001,Private      ,27,71,98,162,307,469
01206400,HAMILTON TECHNICAL COLLEGE              ,IA,52807-2653,Proprietary  ,36,113,149,98,257,355
01230000,PALMER COLLEGE OF CHIROPRACTIC          ,IA,52803-5287,Private      ,12,170,182,60,2339,2399
01300600,LA' JAMES INTERNATIONAL COLLEGE-CF      ,IA,50613-5242,Proprietary  ,19,28,47,59,58,117
02090300,CAPRI COLLEGE                           ,IA,52404-0000,Proprietary  ,26,41,67,85,121,206
02134500,LA JAMES INTERNATIONAL COLLEGE - DAV    ,IA,52806-3952,Proprietary  ,23,34,57,56,79,135
02160900,"SALON PROFESSIONAL ACADEMY, THE         ",IA,50010-0000,Proprietary  ,20,25,45,107,62,169
02262500,FAUST INSTITUTE OF COSMETOLOGY          ,IA,50588-0000,Proprietary  ,11,19,30,21,37,58
02274100,LA' JAMES INTERNATIONAL COLLEGE - DM    ,IA,50131-0000,Proprietary  ,34,60,94,111,139,250
02289000,AMERICAN HAIR ACADEMY                   ,IA,52627-4530,Proprietary  ,5,12,17,11,28,39
02306900,IOWA SCHOOL OF BEAUTY                   ,IA,52501-0000,Proprietary  ,12,21,33,25,45,70
02328900,EMMAUS BIBLE COLLEGE                    ,IA,52001-0000,Private      ,42,12,54,235,42,277
02330900,IOWA SCHOOL OF BEAUTY                   ,IA,50158-0000,Proprietary  ,2,12,14,11,31,42
02333200,DAYTON'S SCHOOL OF HAIR DESIGN          ,IA,52632-0000,Proprietary  ,0,0,0,1,12,13
02609200,VATTEROTT COLLEGE                       ,IA,50321-4704,Proprietary  ,42,221,263,110,648,758
03069100,ALLEN COLLEGE                           ,IA,50703-1916,Private      ,11,50,61,309,321,630
03441300,IOWA SCHOOL OF BEAUTY                   ,IA,51106-5111,Proprietary  ,9,14,23,31,52,83
03607400,TOTAL LOOK SCHOOL OF COSMETOLOGY AND MAS,IA,52136-1053,Proprietary  ,2,2,4,4,7,11
03720300,CARLSON COLLEGE OF MASSAGE THERAPY      ,IA,52205-7519,Proprietary  ,8,16,24,16,31,47
04089300,BIO-CHI INSTITUTE OF MASSAGE THERAPY    ,IA,51103-2138,Proprietary  ,3,6,9,9,23,32
00259600,ATLANTIC COMMUNITY COLLEGE              ,NJ,08330-2699,Public       ,709,1298,2007,3559,3848,7407
00259700,BLOOMFIELD COLLEGE                      ,NJ,07003-3425,Private      ,210,379,589,2619,1388,4007
00259800,CALDWELL COLLEGE                        ,NJ,07006-6195,Private      ,116,299,415,1396,962,2358
00259900,CENTENARY COLLEGE                       ,NJ,07840-2184,Private      ,78,220,298,1489,918,2407
00260000,COLLEGE OF SAINT ELIZABETH              ,NJ,07960-6989,Private      ,32,187,219,742,635,1377
00260100,CUMBERLAND COUNTY COLLEGE               ,NJ,08362-0517,Public       ,416,775,1191,2048,2549,4597
00260300,DREW UNIVERSITY                         ,NJ,07940-4063,Private      ,83,110,193,3724,582,4306
00260700,FAIRLEIGH DICKINSON UNIV-TEANECK        ,NJ,07666-1996,Private      ,190,619,809,3145,2084,5229
00260701,FAIRLEIGH DICKINSON UNIV-FLORHAM        ,NJ,07940-0000,Private      ,87,113,200,2340,518,2858
00260702,FAIRLEIGH DICKINSON UNIV-ED WMS CLG     ,NJ,07601-0000,Private      ,16,41,57,165,127,292
00260703,FAIRLEIGH DICKINSON UNIVERSITY          ,NJ,07940-0000,Private      ,80,193,273,1853,766,2619
00260800,GEORGIAN COURT UNIVERSITY               ,NJ,08701-2697,Private      ,143,422,565,1431,1542,2973
00260900,ROWAN UNIVERSITY                        ,NJ,08028-1702,Public       ,650,804,1454,11321,3637,14958
00261000,FELICIAN COLLEGE                        ,NJ,07644-2198,Private      ,154,364,518,1682,1209,2891
00261300,NEW JERSEY CITY UNIVERSITY              ,NJ,07305-1597,Public       ,444,1336,1780,4440,5040,9480
00261500,MIDDLESEX COUNTY COLLEGE                ,NJ,08818-3050,Public       ,1079,1278,2357,5700,4072,9772
00261600,MONMOUTH UNIVERSITY                     ,NJ,07764-1898,Private      ,346,441,787,7123,2157,9280
00261700,MONTCLAIR STATE UNIVERSITY              ,NJ,07043-9987,Public       ,1332,1428,2760,15652,6105,21757
00261900,NEW BRUNSWICK THEOLOGICAL SEMINARY      ,NJ,08901-0000,Private      ,5,34,39,25,123,148
00262100,NEW JERSEY INST OF TECHNOLOGY           ,NJ,07102-1982,Public       ,371,658,1029,5093,2341,7434
00262200,KEAN UNIVERSITY                         ,NJ,07083-7131,Public       ,989,1644,2633,10007,6945,16952
00262400,OCEAN COUNTY COLLEGE                    ,NJ,08754-2001,Public       ,869,1159,2028,4922,3320,8242
00262500,WILLIAM PATERSON UNIVERSITY             ,NJ,07470-2152,Public       ,823,897,1720,9667,3831,13498
00262600,PRINCETON THEOLOGICAL SEMINARY          ,NJ,08542-0000,Private      ,1,43,44,13,674,687
00262700,PRINCETON UNIVERSITY                    ,NJ,08544-0001,Private      ,159,98,257,13927,1567,15494
00262800,RIDER UNIVERSITY                        ,NJ,08648-3099,Private      ,309,310,619,7075,1538,8613
00262900,"RUTGERS, THE STATE UNIVERSITY OF NJ     ",NJ,08901-1281,Public       ,2446,3169,5615,40826,19506,60332
00263200,SETON HALL UNIVERSITY                   ,NJ,07079-2697,Private      ,297,589,886,9916,3382,13298
00263201,SETON HALL UNIVERSITY - SCHOOL OF LAW   ,NJ,07079-5210,Private      ,11,144,155,207,2379,2586
00263800,ST PETER'S COLLEGE                      ,NJ,07306-5997,Private      ,172,317,489,3421,1043,4464
00263900,STEVENS INSTITUTE OF TECHNOLOGY         ,NJ,07030-5370,Private      ,149,178,327,3179,562,3741
00264200,COLLEGE OF NEW JERSEY (THE)             ,NJ,08628-0718,Public       ,425,228,653,9820,1049,10869
00264300,UNION COUNTY COLLEGE                    ,NJ,07016-1598,Public       ,1347,2413,3760,4430,6365,10795
00473600,BERGEN COMMUNITY COLLEGE                ,NJ,07652-1595,Public       ,1448,1419,2867,6818,4252,11070
00474000,MERCER COUNTY COMMUNITY COLLEGE         ,NJ,08690-0000,Public       ,759,1393,2152,2916,3676,6592
00539900,MONMOUTH COUNTY VOCATIONAL SCH DIST     ,NJ,07728-5033,Public       ,20,64,84,43,104,147
00539905,MONMOUTH COUNTY VOCATIONAL SCHOOL DISTRI,NJ,07753-4473,Public       ,1,12,13,1,12,13
00545200,TETERBORO SCH OF AERONAUTICS            ,NJ,07608-1083,Proprietary  ,31,29,60,84,65,149
00546000,SOMERSET COUNTY TECHNICAL INSTITUTE     ,NJ,08807-0350,Public       ,19,85,104,52,177,229
00546100,SALEM COMMUNITY COLLEGE                 ,NJ,08069-2799,Public       ,144,244,388,583,695,1278
00641000,C E GREGORY SCHOOL OF NURSING           ,NJ,08857-0000,Private      ,0,0,0,4,4,8
00641700,HOLY NAME HOSPITAL SCH OF NURSING       ,NJ,07666-4254,Private      ,8,37,45,66,158,224
00642000,MOUNTAINSIDE HOSP SCH NRSG              ,NJ,07042-4898,Proprietary  ,8,37,45,32,126,158
00642100,MUHLENBERG SNYDER SCHOOLS               ,NJ,07061-3399,Private      ,20,99,119,106,484,590
00642900,ST FRANCIS MEDICAL CTR SCH NURSING      ,NJ,08629-1986,Private      ,2,15,17,19,45,64
00642902,ST FRANCIS MED CTR RAD TECH             ,NJ,08629-0000,Private      ,1,6,7,3,20,23
00686500,CAMDEN COUNTY COLLEGE                   ,NJ,08012-3240,Public       ,1216,2502,3718,6139,7736,13875
00690100,GLOUCESTER COUNTY COLLEGE               ,NJ,08080-4249,Public       ,631,906,1537,2889,2377,5266
00710700,ESSEX COUNTY COLLEGE                    ,NJ,07102-1798,Public       ,1387,2622,4009,4921,7219,12140
00736203,STUART SCHOOL OF BUSINESS ADMINISTRATION,NJ,07719-3970,Proprietary  ,0,0,0,1,1,2
00750200,BERKELEY COLLEGE                        ,NJ,07424-3367,Proprietary  ,264,366,630,1731,1630,3361
00750201,BERKELEY COLLEGE                        ,NJ,07095-0000,Proprietary  ,119,174,293,742,647,1389
00750202,BERKELEY COLLEGE - PARAMUS              ,NJ,07652-2931,Proprietary  ,79,139,218,449,439,888
00750600,LINCOLN TECHNICAL INSTITUTE             ,NJ,07083-5032,Proprietary  ,385,600,985,891,1101,1992
00750601,LINCOLN TECHNICAL INSTITUTE             ,NJ,07430-0000,Proprietary  ,193,217,410,506,459,965
00750700,GIBBS COLLEGE                           ,NJ,07039-1611,Proprietary  ,5,21,26,52,98,150
00750701,KATHARINE GIBBS - PISCATAWAY            ,NJ,08854-0000,Proprietary  ,0,0,0,0,3,3
00759300,PARISIAN BEAUTY ACADEMY                 ,NJ,07601-5509,Proprietary  ,65,64,129,98,102,200
00772900,COUNTY COLLEGE OF MORRIS                ,NJ,07869-0000,Public       ,755,575,1330,3078,1546,4624
00773000,BURLINGTON COUNTY COLLEGE               ,NJ,08068-1599,Public       ,745,1127,1872,3564,3318,6882
00773100,RARITAN VALLEY COMMUNITY COLLEGE        ,NJ,08876-1265,Public       ,421,599,1020,2075,1635,3710
00780401,CAREER ACADEMY OF NEW YORK - STAR LAKEWO,NJ,08701-5900,Proprietary  ,29,190,219,56,354,410
00780402,CAREER ACADEMY OF NEW YORK - STAR EGG HA,NJ,08234-4863,Proprietary  ,28,137,165,55,299,354
00794700,BETH MEDRASH GOVOHA OF AMERICA          ,NJ,08701-0000,Private      ,99,655,754,155,1400,1555
00840400,BROOKDALE COMMUNITY COLLEGE             ,NJ,07738-1597,Public       ,1559,1469,3028,5563,3650,9213
00844101,ANTHEM INSTITUTE                        ,NJ,08002-0000,Proprietary  ,6,26,32,19,45,64
00849400,HO HO KUS SCHL OF TRADE & TECH SCIENCES ,NJ,07513-1402,Proprietary  ,53,120,173,86,210,296
00860900,RABBINICAL COLLEGE OF AMERICA           ,NJ,07960-3600,Private      ,41,1,42,51,7,58
00907800,CAPRI INSTITUTE OF HAIR DESIGN          ,NJ,07011-2111,Proprietary  ,42,87,129,76,141,217
00934400,RAMAPO COLLEGE OF NEW JERSEY            ,NJ,07430-1680,Public       ,364,232,596,6339,1009,7348
00934500,RICHARD STOCKTON COLLEGE OF NJ          ,NJ,08240-0195,Public       ,530,590,1120,7116,2655,9771
00982804,EVEREST INSTITUTE - SOUTH PLAINFIELD    ,NJ,07080-1125,Proprietary  ,98,279,377,165,497,662
00999400,PASSAIC COUNTY COMMUNITY COLLEGE        ,NJ,07505-1179,Public       ,1142,1810,2952,3297,4095,7392
01039400,UNIV OF MEDICINE & DENTISTRY OF NJ      ,NJ,07107-0000,Public       ,39,643,682,214,4411,4625
01062900,P B COSMETOLOGY EDUCATION CENTRE        ,NJ,08030-1750,Proprietary  ,37,85,122,86,104,190
01085100,ANTHEM INSTITUTE                        ,NJ,07054-3409,Proprietary  ,183,392,575,445,898,1343
01085101,ANTHEM INSTITUTE                        ,NJ,07306-0000,Proprietary  ,17,63,80,40,114,154
01085102,ANTHEM INSTITUTE                        ,NJ,08902-0000,Proprietary  ,5,33,38,21,60,81
01090300,RIZZIERI INSTITUTE                      ,NJ,08043-4600,Proprietary  ,42,48,90,95,118,213
01152300,MORRIS COUNTY SCHOOL OF TECHNOLOGY      ,NJ,07834-0000,Public       ,5,41,46,24,61,85
01170800,NATURAL MOTION INST OF HAIR DESIGN      ,NJ,07306-5496,Proprietary  ,18,25,43,43,83,126
01198900,TALMUDICAL ACADEMY                      ,NJ,07710-0000,Private      ,26,2,28,36,3,39
01209000,REIGNBOW BEAUTY ACADEMY                 ,NJ,08861-4118,Proprietary  ,25,74,99,33,100,133
01234600,DOVER BUSINESS COLLEGE                  ,NJ,07011-2161,Proprietary  ,112,286,398,290,741,1031
01234602,DOVER BUSINESS COLLEGE                  ,NJ,07801-4643,Proprietary  ,52,149,201,123,337,460
01246100,LINCOLN TECHNICAL INSTITUTE             ,NJ,08820-2896,Proprietary  ,112,355,467,305,726,1031
01246102,LINCOLN TECHNICAL INSTITUTE             ,NJ,08054-0000,Proprietary  ,103,368,471,226,1028,1254
01246103,LINCOLN TECHNICAL INSTITUTE             ,NJ,07652-2106,Proprietary  ,125,305,430,366,809,1175
01246200,HOHOKUS - HACKENSACK SCHOOL OF BUSINESS ,NJ,07601-7197,Proprietary  ,61,226,287,128,516,644
01295400,HUDSON COUNTY COMMUNITY COLLEGE         ,NJ,07306-4012,Public       ,1246,1935,3181,3920,5280,9200
02053700,EASTWICK COLLEGE                        ,NJ,07446-0000,Proprietary  ,76,294,370,233,725,958
02061800,ROMAN ACADEMY OF BEAUTY CULTURE         ,NJ,07506-0000,Proprietary  ,20,20,40,25,22,47
02092300,HOHOKUS SCHOOL - RETS/NUTLEY            ,NJ,07110-0000,Proprietary  ,89,192,281,207,455,662
02103700,CAPRI INSTITUTE OF HAIR DESIGN          ,NJ,07652-0000,Proprietary  ,25,50,75,42,81,123
02104000,HARRIS SCHOOL OF BUSINESS               ,NJ,08002-2983,Proprietary  ,126,528,654,207,1059,1266
02106601,FOX INSTITUTE OF BUSINESS - CLIFTON     ,NJ,07011-2345,Proprietary  ,49,177,226,87,258,345
02131100,DU CRET SCHOOL OF THE ARTS              ,NJ,07060-0000,Private      ,12,11,23,27,21,48
02131600,PENNCO TECH                             ,NJ,08012-0000,Proprietary  ,141,302,443,308,601,909
02132300,BERDAN INSTITUTE                        ,NJ,07512-0000,Proprietary  ,63,165,228,212,422,634
02146800,JOE KUBERT SCH OF CARTOON & GRAPHIC     ,NJ,07801-0000,Proprietary  ,5,8,13,56,52,108
02149800,EMPIRE BEAUTY SCHOOL                    ,NJ,08021-0000,Proprietary  ,40,48,88,105,281,386
02149801,EMPIRE BEAUTY SCHOOL - BORDENTOWN       ,NJ,08505-1513,Proprietary  ,7,12,19,9,27,36
02154000,DIVERS ACAD OF EASTERN SEABOARD         ,NJ,08081-1139,Proprietary  ,37,65,102,73,150,223
02183600,CAPRI INSTITUTE OF HAIR DESIGN          ,NJ,07033-0000,Proprietary  ,28,69,97,53,104,157
02192200,THOMAS EDISON STATE COLLEGE             ,NJ,08608-0000,Public       ,66,1284,1350,271,4202,4473
02219600,OMEGA INSTITUTE                         ,NJ,08109-0000,Proprietary  ,16,72,88,31,169,200
02223700,NEW HORIZON INST OF COSMETOLOGY         ,NJ,07093-0000,Proprietary  ,16,93,109,17,113,130
02223900,DRAKE COLLEGE OF BUSINESS               ,NJ,07201-0000,Proprietary  ,173,1058,1231,376,2367,2743
02232500,UNION COUNTY VOCATIONAL TECH INST       ,NJ,07076-0000,Public       ,28,68,96,57,110,167
02234600,SHORE BEAUTY SCHOOL                     ,NJ,08232-0000,Proprietary  ,26,45,71,39,62,101
02246000,ROSS UNIVERSITY - MEDICAL SCHOOL        ,NJ,08837-0000,Proprietary  ,3,484,487,15,4147,4162
02248600,COOPER HEALTH SYS-CTR ALLIED HEALTH     ,NJ,08103-0000,Private      ,10,34,44,23,82,105
02252700,CONCORDE SCHOOL OF HAIR DESIGN          ,NJ,07712-0000,Proprietary  ,50,136,186,103,268,371
02252701,CONCORDE SCHOOL OF HAIR DESIGN - BLOOMFI,NJ,07003-2517,Proprietary  ,6,8,14,18,23,41
02261800,EUROPEAN ACADEMY OF COSMETOLOGY         ,NJ,07083-0000,Proprietary  ,24,54,78,55,134,189
02265500,CAPRI INSTITUTE OF HAIR DESIGN          ,NJ,08724-0000,Proprietary  ,27,51,78,39,100,139
02277900,ROSS UNIV - SCH OF VETERINARY MED       ,NJ,08837-0000,Proprietary  ,0,123,123,4,1093,1097
02291000,LINCOLN TECHNICAL INSTITUTE             ,NJ,07080-2424,Proprietary  ,51,49,100,104,65,169
02312000,BERGEN COUNTY TECHNICAL SCHOOLS         ,NJ,07601-6110,Public       ,10,47,57,25,77,102
02344200,EMPIRE BEAUTY SCHOOL                    ,NJ,08002-0000,Proprietary  ,30,66,96,99,225,324
02503900,WARREN COUNTY COMMUNITY COLLEGE         ,NJ,07882-0000,Public       ,164,233,397,616,542,1158
02523700,OCEAN COUNTY VOCATIONAL-TECH SCHOOL     ,NJ,08753-0000,Public       ,43,123,166,146,287,433
02525900,ARTISTIC ACADEMY OF HAIR DESIGN         ,NJ,07950-1409,Proprietary  ,39,43,82,90,76,166
02528200,REIGNBOW BEAUTY ACADEMY                 ,NJ,07060-0000,Proprietary  ,16,50,66,17,67,84
02558700,PRISM CAREER INSTITUTE                  ,NJ,08037-0000,Proprietary  ,94,467,561,174,954,1128
02568800,SUSSEX COUNTY COMMUNITY COLLEGE         ,NJ,07860-1149,Public       ,409,414,823,1457,891,2348
02586900,HARRIS SCHOOL OF BUSINESS               ,NJ,08084-1520,Proprietary  ,45,280,325,68,571,639
02615401,STAR TECHNICAL INSTITUTE -              ,NJ,07102-4599,Proprietary  ,0,0,0,1,8,9
02616402,SANFORD-BROWN INSTITUTE - ISELIN        ,NJ,08830-0000,Proprietary  ,170,384,554,376,1037,1413
03077500,RABBI JACOB JOSEPH SCHOOL               ,NJ,08817-4494,Private      ,6,0,6,10,0,10
03122600,EASTERN INTERNATIONAL COLLEGE           ,NJ,07306-3906,Proprietary  ,71,188,259,86,241,327
03187300,STENOTECH CAREER INSTITUTE              ,NJ,07004-3490,Proprietary  ,21,46,67,39,67,106
03197300,INSTITUTE FOR HEALTH EDUCATION(THE)     ,NJ,07306-2929,Proprietary  ,19,87,106,26,127,153
03324300,CENTRAL CAREER SCHOOL                   ,NJ,07080-2408,Proprietary  ,9,54,63,15,78,93
03380302,CULINARY ACADEMY OF LONG ISLAND - STAR N,NJ,07102-4510,Proprietary  ,28,223,251,72,495,567
03380303,CULINARY ACADEMY OF LONG ISLAND - STAR C,NJ,07011-2248,Proprietary  ,3,33,36,3,33,36
03389300,ACADEMY OF MASSAGE THERAPY              ,NJ,07631-0000,Proprietary  ,14,72,86,29,112,141
03424500,NEW COMMUNITY WORKFORCE DEVELOPMENT     ,NJ,07103-2402,Private      ,11,124,135,20,336,356
03530300,"KEY SKILLS LEARNING, INC.               ",NJ,07013-1900,Proprietary  ,0,42,42,0,44,44
03536300,INSTITUTE FOR THERAPEUTIC MASSAGE       ,NJ,07420-1452,Proprietary  ,6,46,52,16,115,131
03574400,CORTIVA INSTITUTE - SOMERSET SCHOOL OF M,NJ,08854-3908,Proprietary  ,16,56,72,28,109,137
03625300,PERFORMANCE TRAINING INSTITUTE          ,NJ,08753-0000,Proprietary  ,1,39,40,2,42,44
03637300,METRO AUTO ELECTRONICS TRAINING INSTITUT,NJ,07033-1798,Proprietary  ,8,37,45,23,63,86
03650600,PC AGE                                  ,NJ,07306-3936,Proprietary  ,9,69,78,25,163,188
03650603,PC AGE                                  ,NJ,08817-2842,Proprietary  ,0,13,13,1,21,22
03666300,SOMERSET CHRISTIAN COLLEGE              ,NJ,08890-9035,Private      ,11,74,85,53,259,312
03769300,PC TECH LEARNING CENTER                 ,NJ,07306-9900,Proprietary  ,13,113,126,15,130,145
03803300,HEALTHCARE TRAINING INSTITUTE           ,NJ,07083-3504,Proprietary  ,23,133,156,38,228,266
03811300,EASTERN SCHOOL OF ACUPUNCTURE AND TRADIT,NJ,07042-3562,Proprietary  ,0,18,18,1,52,53
04081300,BAIS MEDRASH TORAS CHESED               ,NJ,08701-0000,Private      ,8,1,9,15,2,17
04123400,YESHIVAS BE'ER YITZCHOK                 ,NJ,07208-2380,Private      ,2,7,9,2,8,10
04125000,GENTLE HEALING SCHOOL OF MASSAGE        ,NJ,08512-3600,Proprietary  ,2,17,19,2,23,25
04131100,YESHIVA TORAS CHAIM                     ,NJ,08701-2120,Private      ,29,0,29,54,0,54
04131200,TOTAL IMAGE BEAUTY ACADEMY              ,NJ,07307-2943,Proprietary  ,0,10,10,3,33,36
04134100,CENTER FOR ALLIED HEALTH & NURSING EDUCA,NJ,07601-5801,Proprietary  ,15,124,139,48,410,458
04136400,AMERICAN INSTITUTE OF MEDICAL SCIENCES &,NJ,07080-1183,Proprietary  ,10,65,75,19,127,146
        ,BROOKLYN LAW SCHOOL                     ,NY,11201-0000,Private      ,0,0,0,2,82,84
00266500,VAUGHN COLLEGE OF AERONAUTICS AND TECHNO,NY,11369-9997,Private      ,191,204,395,875,589,1464
00266600,ADELPHI UNIVERSITY                      ,NY,11530-4299,Private      ,416,985,1401,7436,4264,11700
00266700,DOWLING COLLEGE                         ,NY,11769-1999,Private      ,287,612,899,2517,2059,4576
00266800,ALFRED UNIVERSITY                       ,NY,14802-1205,Private      ,95,135,230,3132,577,3709
00266900,BANK STREET COLLEGE OF EDUCATION        ,NY,10025-0000,Private      ,2,108,110,9,903,912
00267100,BARD COLLEGE                            ,NY,12504-5000,Private      ,17,22,39,2737,635,3372
00267400,NEW YORK THEOLOGICAL SEMINARY           ,NY,10115-0002,Private      ,0,21,21,0,21,21
00267700,BROOKLYN LAW SCHOOL                     ,NY,11201-0000,Private      ,11,123,134,42,3622,3664
00267800,BRYANT & STRATTON COLLEGE               ,NY,14203-1713,Proprietary  ,652,2533,3185,2107,8771,10878
00267803,BRYANT & STRATTON COLLEGE - GREECE      ,NY,14606-4227,Proprietary  ,77,251,328,270,921,1191
00267805,BRYANT & STRATTON COLLEGE - SYRACUSE    ,NY,13203-2502,Proprietary  ,186,390,576,661,1376,2037
00267807,BRYANT & STRATTON COLLEGE - ALBANY      ,NY,12205-5230,Proprietary  ,84,205,289,258,779,1037
00268100,CANISIUS COLLEGE                        ,NY,14208-1098,Private      ,227,370,597,4518,1485,6003
00268300,SEMINARY OF THE IMMACULATE CONCEPT      ,NY,11743-0000,Private      ,0,0,0,1,0,1
00268500,CAZENOVIA COLLEGE                       ,NY,13035-1085,Private      ,59,50,109,1769,149,1918
00268700,CUNY-BROOKLYN COLLEGE                   ,NY,11210-2814,Public       ,1153,1885,3038,13896,9237,23133
00268800,CITY COLLEGE-CUNY                       ,NY,10031-9198,Public       ,1343,1772,3115,16491,7521,24012
00268900,CUNY-HUNTER COLLEGE                     ,NY,10021-0000,Public       ,1313,2067,3380,22528,12507,35035
00269000,QUEENS COLLEGE-CUNY                     ,NY,11367-1597,Public       ,1480,1831,3311,13898,7218,21116
00269100,CUNY- BOROUGH OF MANHATTAN CMTY CLG     ,NY,10007-1047,Public       ,3792,3063,6855,17350,11238,28588
00269200,CUNY BRONX COMMUNITY COLLEGE            ,NY,10453-3102,Public       ,1736,1904,3640,8319,7080,15399
00269300,CUNY-JOHN JAY CLG CRIMINAL JUSTICE      ,NY,10019-1093,Public       ,1323,1211,2534,12884,6169,19053
00269400,KINGSBOROUGH COMMUNITY COLLEGE          ,NY,11235-2398,Public       ,3261,2156,5417,9695,5505,15200
00269600,NY CITY COLLEGE OF TECHNOLOGY-CUNY      ,NY,11201-2983,Public       ,2315,1888,4203,12303,6525,18828
00269700,QUEENSBOROUGH COMMUNITY COLLEGE         ,NY,11364-1497,Public       ,1940,1253,3193,8981,4427,13408
00269800,CUNY THE COLLEGE OF STATEN ISLAND       ,NY,10314-6600,Public       ,1391,1021,2412,9164,3870,13034
00269900,CLARKSON UNIVERSITY                     ,NY,13699-5615,Private      ,96,46,142,4313,341,4654
00270000,COLGATE ROCHESTER CROZER DIVINITY S     ,NY,14620-0000,Private      ,0,17,17,1,67,68
00270100,COLGATE UNIVERSITY                      ,NY,13346-1386,Private      ,57,3,60,4299,69,4368
00270300,COLLEGE OF MOUNT SAINT VINCENT          ,NY,10471-1093,Private      ,188,111,299,2095,405,2500
00270400,COLLEGE OF NEW ROCHELLE                 ,NY,10805-2339,Private      ,118,1584,1702,928,4351,5279
00270500,COLLEGE OF SAINT ROSE                   ,NY,12203-1490,Private      ,304,467,771,4283,2097,6380
00270700,COLUMBIA UNIVERSITY                     ,NY,10027-0000,Private      ,146,459,605,5356,3689,9045
00270701,COLUMBIA UNIV ARCHITECTURE              ,NY,10027-0000,Private      ,6,40,46,47,789,836
00270702,COLUMBIA UNIV SCHOOL OF THE ARTS        ,NY,10027-0000,Private      ,5,82,87,93,1401,1494
00270703,COLUMBIA UNIV BUSINESS GRAD             ,NY,10027-0000,Private      ,2,173,175,18,1534,1552
00270704,COLUMBIA UNIV SCHOOL ENGIN-UNDERGRA     ,NY,10027-0000,Private      ,25,6,31,2177,87,2264
00270705,COLUMBIA UNIV SCHOOL GENERAL STUDIE     ,NY,10027-0000,Private      ,35,173,208,442,1169,1611
00270706,COLUMBIA UNIV GRAD SCHL ARTS & SCI      ,NY,10027-0000,Private      ,3,166,169,31,1813,1844
00270707,COLUMBIA UNIV SCH INTL PUB AFFAIRS      ,NY,10027-0000,Private      ,1,81,82,8,1379,1387
00270708,COLUMBIA UNIV JOURNALISM GRAD           ,NY,10027-0000,Private      ,1,14,15,19,679,698
00270710,COLUMBIA UNIV COLUMBIA COLLEGE          ,NY,10027-0000,Private      ,128,46,174,8727,328,9055
00270711,COLUMBIA UNIV SCHOOL OF LAW             ,NY,10027-0000,Private      ,10,102,112,30,4454,4484
00270712,COLUMBIA UNIV SOCIAL WORK               ,NY,10025-0000,Private      ,2,54,56,14,1032,1046
00270713,COLUMBIA UNIV SCHL DENT & ORAL SURG     ,NY,10032-0000,Private      ,0,9,9,4,402,406
00270714,COLUMBIA UNIV INST HUMAN NUTRITION      ,NY,10032-0000,Private      ,0,21,21,2,70,72
00270715,COLUMBIA UNIV NURSING                   ,NY,10032-0000,Private      ,5,49,54,111,848,959
00270716,COLUMBIA UNIV COLL PHYS & SURGEONS      ,NY,10032-0000,Private      ,5,23,28,25,1159,1184
00270717,COLUMBIA UNIV PHYSICAL THERAPY          ,NY,10032-0000,Private      ,1,12,13,7,138,145
00270718,COLUMBIA UNIV OCCUPATIONAL THERAPY      ,NY,10032-0000,Private      ,0,6,6,3,96,99
00270719,COLUMBIA UNIV PUBLIC HEALTH             ,NY,10032-0000,Private      ,1,49,50,6,1035,1041
00270720,COLUMBIA UNIV - ENGINEERING (GRAD)      ,NY,10027-0000,Private      ,6,48,54,62,390,452
00270721,COLUMBIA UNIV-CONT ED & SP PROGMS       ,NY,10027-0000,Private      ,3,145,148,10,367,377
00270800,BARNARD COLLEGE-COLUMBIA UNIV           ,NY,10027-6598,Private      ,64,29,93,3625,150,3775
00270900,CONCORDIA COLLEGE                       ,NY,10708-1998,Private      ,102,75,177,741,272,1013
00271000,COOPER UNION                            ,NY,10003-7120,Private      ,56,27,83,1640,184,1824
00271100,CORNELL UNIVERSITY                      ,NY,14853-2801,Private      ,585,386,971,24859,6167,31026
00271101,WEILL CORNELL MEDICAL COLLEGE AND GRADUA,NY,10021-0000,Private      ,3,44,47,24,820,844
00271200,D'YOUVILLE COLLEGE                      ,NY,14201-1084,Private      ,100,305,405,1567,1570,3137
00271300,DOMINICAN COLLEGE                       ,NY,10962-1299,Private      ,99,221,320,1595,843,2438
00271800,ELMIRA COLLEGE                          ,NY,14901-2099,Private      ,90,164,254,2019,534,2553
00272200,FORDHAM UNIVERSITY                      ,NY,10458-5157,Private      ,556,1408,1964,19092,9451,28543
00272600,GENERAL THEOLOGICAL SEMINARY            ,NY,10011-0000,Private      ,0,15,15,1,106,107
00272800,HAMILTON COLLEGE                        ,NY,13323-1218,Private      ,56,0,56,2716,46,2762
00272900,HARTWICK COLLEGE                        ,NY,13820-4020,Private      ,51,8,59,2492,83,2575
00273100,HOBART & WILLIAM SMITH COLLEGES         ,NY,14456-3397,Private      ,32,4,36,3636,62,3698
00273200,HOFSTRA UNIVERSITY                      ,NY,11549-1010,Private      ,806,947,1753,16189,6204,22393
00273400,HOUGHTON COLLEGE                        ,NY,14744-0128,Private      ,63,55,118,1596,185,1781
00273500,HILBERT COLLEGE                         ,NY,14075-1597,Private      ,116,94,210,932,314,1246
00273700,IONA COLLEGE                            ,NY,10801-1890,Private      ,160,183,343,6759,1134,7893
00273900,ITHACA COLLEGE                          ,NY,14850-7130,Private      ,238,66,304,12172,831,13003
00274000,JEWISH THEOLOGICAL SEMINARY OF AMER     ,NY,10027-4649,Private      ,3,12,15,119,173,292
00274200,THE JUILLIARD SCHOOL                    ,NY,10023-6588,Private      ,23,28,51,1107,563,1670
00274400,KEUKA COLLEGE                           ,NY,14478-0000,Private      ,43,225,268,1282,999,2281
00274800,LEMOYNE COLLEGE                         ,NY,13214-1399,Private      ,229,231,460,4327,944,5271
00274900,NEW YORK COLLEGE OF PODIATRIC MED       ,NY,10035-0000,Private      ,2,38,40,51,387,438
00275100,LONG ISLAND UNIVERSITY                  ,NY,11548-1326,Private      ,1348,3001,4349,11072,9586,20658
00275800,MANHATTAN COLLEGE                       ,NY,10471-4098,Private      ,177,118,295,5213,461,5674
00275900,MANHATTAN SCHOOL OF MUSIC               ,NY,10027-4698,Private      ,14,25,39,644,690,1334
00276000,MANHATTANVILLE COLLEGE                  ,NY,10577-2132,Private      ,74,238,312,2844,946,3790
00276300,MARIA COLLEGE                           ,NY,12208-1798,Private      ,59,190,249,200,725,925
00276500,MARIST COLLEGE                          ,NY,12601-1387,Private      ,396,332,728,9282,1079,10361
00276900,MARYMOUNT MANHATTAN COLLEGE             ,NY,10021-4597,Private      ,133,51,184,3168,305,3473
00277200,MERCY COLLEGE                           ,NY,10522-1189,Private      ,733,2237,2970,3369,6173,9542
00277500,MOLLOY COLLEGE                          ,NY,11570-1100,Private      ,178,386,564,2639,1684,4323
00277700,MEDAILLE COLLEGE                        ,NY,14214-2695,Private      ,225,383,608,1577,1268,2845
00277800,MOUNT SAINT MARY COLLEGE                ,NY,12550-3494,Private      ,188,279,467,2716,1051,3767
00277900,NAZARETH COLLEGE OF ROCHESTER           ,NY,14618-3790,Private      ,191,255,446,3043,1501,4544
00278200,NEW YORK INSTITUTE OF TECHNOLOGY        ,NY,11568-8000,Private      ,637,716,1353,4782,2985,7767
00278202,NY INSTITUTE OF TECHNOLOGY-OSTEOPATHIC M,NY,11568-0000,Private      ,8,75,83,104,1111,1215
00278300,NEW YORK LAW SCHOOL                     ,NY,10013-0000,Private      ,7,261,268,30,3415,3445
00278400,NEW YORK MEDICAL COLLEGE                ,NY,10595-0000,Private      ,0,181,181,13,2161,2174
00278500,NEW YORK UNIVERSITY                     ,NY,10012-1091,Private      ,950,2873,3823,33691,27029,60720
00278800,NIAGARA UNIVERSITY                      ,NY,14109-2010,Private      ,217,167,384,3701,772,4473
00279000,NYACK COLLEGE                           ,NY,10960-3698,Private      ,218,774,992,1370,1836,3206
00279100,PACE UNIVERSITY - NEW YORK              ,NY,10038-1598,Private      ,354,575,929,7865,3091,10956
00279101,PACE UNIVERSITY-PLEASANTVILLE           ,NY,10570-0000,Private      ,194,241,435,3358,1017,4375
00279102,PACE UNIVERSITY - WHITE PLAINS          ,NY,10603-0000,Private      ,11,238,249,298,2160,2458
00279500,PAUL SMITHS CLG OF ARTS & SCIENCES      ,NY,12970-0000,Private      ,111,32,143,1123,138,1261
00279600,POLYTECHNIC INTSTITUTE OF NEW YORK UNIV ,NY,11201-3840,Private      ,115,283,398,2157,861,3018
00279800,PRATT INSTITUTE                         ,NY,11205-3899,Private      ,232,255,487,4545,2671,7216
00280300,RENSSELAER POLYTECHNIC INSTITUTE        ,NY,12180-3590,Private      ,399,118,517,10073,658,10731
00280500,ROBERTS WESLEYAN COLLEGE                ,NY,14624-1997,Private      ,117,311,428,1456,1065,2521
00280600,ROCHESTER INSTITUTE OF TECHNOLOGY       ,NY,14623-5608,Private      ,811,558,1369,13950,2876,16826
00280700,ROCKEFELLER UNIVERSITY                  ,NY,10021-0000,Private      ,2,3,5,7,20,27
00280800,DAEMEN COLLEGE                          ,NY,14226-3592,Private      ,201,272,473,2030,880,2910
00281000,THE SAGE COLLEGES                       ,NY,12180-4199,Private      ,134,367,501,1458,1719,3177
00281200,TROCAIRE COLLEGE                        ,NY,14220-2094,Private      ,118,377,495,502,1178,1680
00281300,SARAH LAWRENCE COLLEGE                  ,NY,10708-5999,Private      ,35,42,77,1969,739,2708
00281400,SKIDMORE COLLEGE                        ,NY,12866-1632,Private      ,47,13,60,3961,118,4079
00281401,SKIDMORE COLL-UNIV WITHOUT WALLS        ,NY,12866-0000,Private      ,0,4,4,24,14,38
00281500,ST BERNARDS SCH THEOLOGY & MINISTRY     ,NY,14618-3822,Private      ,0,9,9,1,41,42
00281600,SIENA COLLEGE                           ,NY,12211-1462,Private      ,232,43,275,5808,230,6038
00281700,ST BONAVENTURE UNIVERSITY               ,NY,14778-2284,Private      ,115,130,245,2483,530,3013
00282000,ST FRANCIS COLLEGE                      ,NY,11201-4398,Private      ,385,174,559,2179,477,2656
00282100,ST JOHN FISHER COLLEGE                  ,NY,14618-3597,Private      ,162,297,459,4343,1694,6037
00282200,CHRIST THE KING SEMINARY                ,NY,14052-0607,Private      ,0,5,5,1,8,9
00282300,ST JOHN'S UNIVERSITY                    ,NY,11439-1343,Private      ,955,863,1818,22977,6520,29497
00282500,ST JOSEPH'S COLLEGE                     ,NY,11205-3688,Private      ,122,223,345,1050,595,1645
00282501,ST JOSEPH'S COLLEGE-SUFFOLK CAMPUS      ,NY,11772-0000,Private      ,486,361,847,3060,1204,4264
00282600,ST JOSEPH'S SEMINARY                    ,NY,10704-0000,Private      ,0,0,0,1,0,1
00282900,ST LAWRENCE UNIVERSITY                  ,NY,13617-1455,Private      ,26,25,51,2846,125,2971
00283200,ST THOMAS AQUINAS COLLEGE               ,NY,10976-1050,Private      ,121,89,210,1769,344,2113
00283300,ST VLADIMIR ORTHODOX THEOL SEM          ,NY,10707-0000,Private      ,0,5,5,0,57,57
00283400,EXCELSIOR COLLEGE                       ,NY,12203-5159,Private      ,56,1809,1865,160,4721,4881
00283500,SUNY AT ALBANY                          ,NY,12222-0001,Public       ,1274,924,2198,20491,5219,25710
00283600,BINGHAMTON UNIVERSITY (SUNY)            ,NY,13902-6000,Public       ,859,472,1331,23477,2809,26286
00283700,SUNY AT BUFFALO                         ,NY,14260-0001,Public       ,1427,1472,2899,22086,9796,31882
00283800,SUNY AT STONY BROOK                     ,NY,11794-0001,Public       ,1542,1333,2875,23582,7197,30779
00283900,SUNY-DOWNSTATE MEDICAL CENTER           ,NY,11203-2098,Public       ,17,195,212,127,1896,2023
00284000,SUNY UPSTATE MEDICAL UNIVERSITY         ,NY,13210-2375,Public       ,18,92,110,177,1246,1423
00284100,SUNY BROCKPORT - FIN AID OFF            ,NY,14420-2914,Public       ,813,715,1528,8854,2761,11615
00284200,BUFFALO STATE COLLEGE - SUNY            ,NY,14222-1095,Public       ,1412,1394,2806,11407,4959,16366
00284300,SUNY COLLEGE-CORTLAND                   ,NY,13045-0900,Public       ,466,273,739,11033,1686,12719
00284400,SUNY AT FREDONIA                        ,NY,14063-1145,Public       ,487,199,686,7292,993,8285
00284500,SUNY GENESEO                            ,NY,14454-1401,Public       ,378,83,461,9536,509,10045
00284600,SUNY COLLEGE-NEW PALTZ                  ,NY,12561-2499,Public       ,471,350,821,11672,2165,13837
00284700,SUNY COLLEGE-ONEONTA                    ,NY,13820-4015,Public       ,650,140,790,10274,751,11025
00284800,SUNY OSWEGO                             ,NY,13126-3599,Public       ,718,385,1103,10063,2140,12203
00284900,SUNY COLLEGE AT PLATTSBURGH             ,NY,12901-2681,Public       ,481,295,776,6808,1349,8157
00285000,SUNY COLLEGE-POTSDAM                    ,NY,13676-2294,Public       ,370,204,574,4759,1002,5761
00285100,SUNY COLLEGE OF ENVIRONMENT SCIENCE AND ,NY,13210-2778,Public       ,80,70,150,1995,516,2511
00285300,SUNY MARITIME COLLEGE                   ,NY,10465-4198,Public       ,179,76,255,1395,295,1690
00285400,SUNY COLLEGE OF TECHNOLOGY-ALFRED       ,NY,14802-9951,Public       ,411,205,616,3736,838,4574
00285500,SUNY CANTON COLG OF TECHNOLOGY          ,NY,13617-1098,Public       ,277,355,632,2764,1303,4067
00285600,SUNY AG & TECH COLLEGE-COBLESKILL       ,NY,12043-9986,Public       ,429,154,583,3017,482,3499
00285700,SUNY DELHI                              ,NY,13753-1190,Public       ,305,175,480,3381,782,4163
00285800,SUNY FARMINGDALE                        ,NY,11735-1021,Public       ,758,568,1326,5437,1822,7259
00285900,SUNY COLLEGE OF AG & TECH AT MORRISVILLE,NY,13408-0901,Public       ,444,317,761,3519,1082,4601
00286000,ADIRONDACK COMMUNITY COLLEGE            ,NY,12804-2004,Public       ,538,457,995,1856,1340,3196
00286100,CAYUGA COMMUNITY COLLEGE                ,NY,13021-3099,Public       ,552,697,1249,1718,1857,3575
00286200,BROOME COMMUNITY COLLEGE                ,NY,13902-0000,Public       ,841,824,1665,3280,2383,5663
00286300,CORNING COMMUNITY COLLEGE               ,NY,14830-3297,Public       ,637,819,1456,1809,2067,3876
00286400,DUTCHESS COMMUNITY COLLEGE              ,NY,12601-1595,Public       ,1039,838,1877,2984,1969,4953
00286600,FASHION INSTITUTE OF TECHNOLOGY         ,NY,10001-5992,Public       ,489,556,1045,7238,2986,10224
00286700,SUNY FULTON MONTGOMERY COMM CLG         ,NY,12095-3790,Public       ,426,361,787,1399,977,2376
00286800,HUDSON VALLEY COMMUNITY COLLEGE         ,NY,12180-6096,Public       ,1449,1369,2818,6521,4002,10523
00286900,JAMESTOWN COMMUNITY COLLEGE             ,NY,14702-0020,Public       ,543,595,1138,2461,1830,4291
00287000,JEFFERSON COMMUNITY COLLEGE             ,NY,13601-1897,Public       ,424,666,1090,1363,1560,2923
00287100,"SUNY, MOHAWK VALLEY COMMUNITY CLG       ",NY,13501-5394,Public       ,949,907,1856,3936,2674,6610
00287200,MONROE COMMUNITY COLLEGE                ,NY,14623-5780,Public       ,2796,3074,5870,9498,7778,17276
00287300,NASSAU COMMUNITY COLLEGE                ,NY,11530-6793,Public       ,3472,2032,5504,10111,4934,15045
00287400,NIAGARA COUNTY COMMUNITY COLLEGE        ,NY,14132-9460,Public       ,804,848,1652,3937,2995,6932
00287500,ONONDAGA COMMUNITY COLLEGE              ,NY,13215-4585,Public       ,1342,1238,2580,5923,3655,9578
00287600,ORANGE COUNTY COMMUNITY COLLEGE         ,NY,10940-6441,Public       ,809,668,1477,2645,1821,4466
00287700,ROCKLAND COMMUNITY COLLEGE              ,NY,10901-3611,Public       ,939,713,1652,2196,1659,3855
00287800,SUFFOLK COMMUNITY COLLEGE               ,NY,11784-2899,Public       ,1831,1025,2856,6535,2895,9430
00287801,SUFFOLK COMMUNITY CLG-W. CAMPUS         ,NY,11717-0000,Public       ,993,774,1767,3070,2122,5192
00287803,SUFFOLK COMMUNITY CLG-EASTRN CAMPUS     ,NY,11901-0000,Public       ,357,251,608,994,675,1669
00287900,SULLIVAN COUNTY COMMUNITY COLLEGE       ,NY,12759-5151,Public       ,321,261,582,1466,719,2185
00288000,ULSTER COUNTY COMMUNITY COLLEGE         ,NY,12484-0557,Public       ,394,324,718,1230,829,2059
00288100,SUNY WESTCHESTER COMMUNITY COLLEGE      ,NY,10595-1698,Public       ,1569,1262,2831,4707,3615,8322
00288200,SYRACUSE UNIVERSITY                     ,NY,13244-2130,Private      ,439,561,1000,20072,6016,26088
00288300,UTICA COLLEGE OF SYRACUSE UNIV          ,NY,13502-4892,Private      ,136,299,435,3349,1496,4845
00288500,ALBANY COLLEGE OF PHARMACY AND HEALTH SC,NY,12208-3492,Private      ,26,27,53,1499,653,2152
00288600,ALBANY LAW SCHOOL                       ,NY,12208-0000,Private      ,0,56,56,25,1583,1608
00288700,ALBANY MEDICAL COLLEGE                  ,NY,12208-0000,Private      ,4,68,72,39,1080,1119
00288900,UNION COLLEGE                           ,NY,12308-2311,Private      ,53,12,65,3240,92,3332
00289000,UNION THEOLOGICAL SEMINARY              ,NY,10027-0000,Private      ,0,15,15,0,300,300
00289200,UNITED STATES MERCHANT MARINE ACADEMY   ,NY,11024-1699,Public       ,11,4,15,414,25,439
00289400,UNIVERSITY OF ROCHESTER                 ,NY,14627-9000,Private      ,114,326,440,7481,1745,9226
00289401,EASTMAN SCH OF MUSIC/UNIV ROCHESTER     ,NY,14604-0000,Private      ,20,39,59,712,373,1085
00289402,UNIV OF ROCHESTER SCHL OF MEDICINE      ,NY,14642-0000,Private      ,1,48,49,40,739,779
00289500,VASSAR COLLEGE                          ,NY,12604-0008,Private      ,64,14,78,4934,107,5041
00289600,VILLA MARIA COLLEGE-BUFFALO             ,NY,14225-3999,Private      ,55,71,126,456,221,677
00289900,WAGNER COLLEGE                          ,NY,10301-4495,Private      ,148,101,249,2709,381,3090
00290000,WEBB INSTITUTE                          ,NY,11542-1398,Private      ,8,1,9,54,7,61
00290100,WELLS COLLEGE                           ,NY,13026-0500,Private      ,31,16,47,1243,78,1321
00290300,YESHIVA UNIVERSITY                      ,NY,10033-3201,Private      ,172,261,433,2022,3370,5392
00290302,YESHIVA UNIVERSITY - BRONX CAMPUS       ,NY,10461-1975,Private      ,5,78,83,14,1179,1193
00397400,MESIVTHA TIFERETH JERUSALEM OF AMER     ,NY,10002-6382,Private      ,11,0,11,14,0,14
00397600,RABBINICAL ACAD MESIVTA RABBI CHAIM     ,NY,11230-4715,Private      ,0,0,0,3,0,3
00397800,RABBINICAL SEMINARY OF AMERICA          ,NY,11375-0000,Private      ,6,13,19,8,15,23
00397900,COLUMBIA UNIV TEACHERS COLLEGE          ,NY,10027-0000,Private      ,2,496,498,26,4243,4269
00405400,HEBREW UNION COL-JEWISH INST OF REL     ,NY,10012-0000,Private      ,0,3,3,0,93,93
00455301,ITT TECHNICAL INSTITUTE                 ,NY,12205-0000,Proprietary  ,46,206,252,141,392,533
00475900,"CUNY, YORK COLLEGE                      ",NY,11451-0001,Public       ,834,921,1755,7267,3949,11216
00476500,CUNY GRADUATE SCH & UNIV CTR            ,NY,10016-4309,Public       ,13,599,612,69,2606,2675
00477600,CENTRAL YESHIVA TOMCHEI TMIMIM LUBA     ,NY,11230-2798,Private      ,7,2,9,21,3,24
00478800,HERKIMER COUNTY COMMUNITY COLLEGE       ,NY,13350-1598,Public       ,548,418,966,2525,1142,3667
00479800,MIRRER YESHIVA CENTRAL INST             ,NY,11223-2010,Private      ,53,44,97,54,46,100
00479900,MONROE COLLEGE                          ,NY,10468-4305,Proprietary  ,1062,2208,3270,3489,5723,9212
00481100,EVEREST INSTITUTE                       ,NY,14621-3007,Proprietary  ,129,462,591,330,1667,1997
00506401,ST JAMES MERCY HOSP SCH OF RAD          ,NY,14843-2197,Private      ,1,2,3,11,22,33
00506600,FAXTON ST. LUKE'S SCHOOL OF RADIOGRAPHY ,NY,13502-4856,Private      ,2,3,5,20,17,37
00520800,THE COLLEGE OF WESTCHESTER              ,NY,10602-0000,Proprietary  ,247,289,536,855,669,1524
00587700,ROBERT J HOCHSTIM SCHOOL OF RADIOG      ,NY,11572-1151,Private      ,0,1,1,1,6,7
00643501,ARNOT OGDEN MEDICAL CENTER              ,NY,14905-1676,Private      ,4,13,17,31,49,80
00643800,PHILLIPS BETH ISRAEL SCH OF NURSING     ,NY,10001-6354,Private      ,28,67,95,93,288,381
00644300,COCHRAN SCH NSG-ST JOHN RVSDE HOSP      ,NY,10701-1399,Private      ,6,89,95,50,358,408
00644500,CROUSE HOSP SCH OF NURSING              ,NY,13210-1690,Private      ,23,66,89,143,235,378
00644800,ELLIS HOSPITAL SCHOOL OF NURSING        ,NY,12308-0000,Private      ,9,34,43,36,129,165
00646101,ST ELIZABETH COLLEGE OF NURSING         ,NY,13501-2998,Private      ,10,10,20,106,196,302
00646102,ST ELIZABETH SCH OF RADIOGRAPHY         ,NY,13501-0000,Private      ,1,6,7,16,20,36
00646700,SAINT JOSEPH'S COLLEGE OF NURSING       ,NY,13203-1806,Private      ,11,27,38,171,243,414
00678200,GENESEE COMMUNITY COLLEGE               ,NY,14020-9704,Public       ,708,854,1562,2543,2182,4725
00678500,SCHENECTADY COUNTY COMMUNITY CLG        ,NY,12305-2294,Public       ,651,661,1312,1906,1708,3614
00678700,CLINTON COMMUNITY COLLEGE               ,NY,12901-5690,Public       ,234,226,460,1204,697,1901
00678800,TOMPKINS CORTLAND COMMUNITY COLLEGE     ,NY,13053-8504,Public       ,471,487,958,2460,1422,3882
00678900,COLUMBIA-GREENE COMMUNITY COLLEGE       ,NY,12534-9543,Public       ,256,200,456,961,712,1673
00679100,SUNY AT PURCHASE                        ,NY,10577-1400,Public       ,403,181,584,6597,969,7566
00702200,CUNY-LEHMAN COLLEGE                     ,NY,10468-1589,Public       ,984,1916,2900,10612,7832,18444
00702600,"MT SINAI SCH OF MEDICINE, NY UNIV       ",NY,10029-0000,Private      ,1,54,55,14,1062,1076
00710900,SUNY COLLEGE-OLD WESTBURY               ,NY,11568-0210,Public       ,462,387,849,5001,1592,6593
00711100,NORTH COUNTRY COMMUNITY COLLEGE         ,NY,12983-2046,Public       ,190,230,420,673,625,1298
00726400,MESIFTA TORAH VODAATH RABBINCAL SEM     ,NY,11218-5209,Private      ,11,19,30,12,19,31
00727300,CUNY-BERNARD BARUCH COLLEGE             ,NY,10010-5518,Public       ,930,1444,2374,14793,6858,21651
00730400,CULINARY INSTITUTE OF AMERICA           ,NY,12538-1499,Private      ,337,300,637,3071,1359,4430
00737200,AUSTIN'S SCHOOL OF SPA TECHNOLOGY       ,NY,12206-1513,Proprietary  ,65,130,195,134,293,427
00737500,ISLAND DRAFTING & TECHNICAL INST        ,NY,11701-2704,Proprietary  ,18,31,49,73,84,157
00738700,LONG ISLAND BEAUTY SCHOOL               ,NY,11788-4346,Proprietary  ,34,68,102,44,88,132
00738800,LONG ISLAND BEAUTY SCHOOL               ,NY,11550-3704,Proprietary  ,15,43,58,33,94,127
00739100,BEAUTY SCHOOL OF MIDDLETOWN             ,NY,10940-6574,Proprietary  ,11,30,41,23,49,72
00739400,BERKELEY COLLEGE                        ,NY,10017-0000,Proprietary  ,573,827,1400,2436,2479,4915
00739402,BERKELEY COLLEGE-WESTCHESTER CAMPUS     ,NY,10601-1533,Proprietary  ,136,104,240,776,350,1126
00739800,KATHARINE GIBBS SCHOOL                  ,NY,10018-2602,Proprietary  ,17,27,44,104,199,303
00740100,MANDL SCHOOL                            ,NY,10019-5516,Proprietary  ,67,276,343,127,567,694
00740500,WOOD TOBE-COBURN SCHOOL                 ,NY,10016-0102,Proprietary  ,105,37,142,589,132,721
00746500,AMERICAN ACADEMY OF DRAMATIC ARTS       ,NY,10016-7089,Private      ,55,42,97,378,149,527
00746600,LIM COLLEGE                             ,NY,10022-5268,Proprietary  ,162,44,206,1642,192,1834
00746800,SCHOOL OF VISUAL ARTS                   ,NY,10010-3994,Proprietary  ,199,176,375,3754,1462,5216
00750602,LINCOLN TECHNICAL INSTITUTE             ,NY,11357-6092,Proprietary  ,184,114,298,461,267,728
00751800,APEX TECHNICAL SCHOOL                   ,NY,10011-2008,Proprietary  ,304,680,984,617,1501,2118
00752200,CONTINENTAL SCH OF BEAUTY CULTURE       ,NY,14623-3231,Proprietary  ,119,305,424,147,394,541
00753200,FINGER LAKES COMMUNITY COLLEGE          ,NY,14424-8395,Public       ,682,711,1393,3289,2041,5330
00757200,AMERICAN MUSICAL AND DRAMATIC ACAD      ,NY,10023-2106,Private      ,171,59,230,1621,275,1896
00757300,EMPIRE BEAUTY SCHOOL                    ,NY,11103-4028,Proprietary  ,27,62,89,73,173,246
00780400,CAREER ACADEMY OF NEW YORK              ,NY,10011-7307,Proprietary  ,53,220,273,139,534,673
00818900,CONTINENTAL SCH OF BEAUTY CULTURE       ,NY,14223-0000,Proprietary  ,3,10,13,6,15,21
00818902,CONTINENTAL SCHOOL OF BEAUTY CULTURE  - ,NY,14224-3402,Proprietary  ,0,0,0,3,2,5
00843700,CHAMPLAIN VALLEY - TEC/PRN              ,NY,12901-0000,Public       ,9,23,32,17,41,58
00849500,JAMESTOWN BUSINESS COLLEGE              ,NY,14702-0429,Proprietary  ,24,80,104,144,287,431
00861100,"CUNY, HOSTOS CMTY COLLEGE               ",NY,10451-1499,Public       ,1057,1360,2417,4175,4419,8594
00861400,RABBINICAL CLG BOBOVER YESHIVA BNEI     ,NY,11219-3293,Private      ,25,1,26,25,1,26
00861700,RABBINICAL SEM MKOR CHAIM-YESHIVA       ,NY,11219-4300,Private      ,0,1,1,0,1,1
00878800,SUNY-STUDENT LOAN SERVICE CENTER        ,NY,12144-3440,Public       ,0,2,2,11,6,17
00900300,OLEAN BUSINESS INSTITUTE INC            ,NY,14760-2691,Proprietary  ,6,24,30,19,61,80
00902900,NEIGHBORHOOD PLAYHOUSE                  ,NY,10022-5017,Private      ,4,9,13,23,35,58
00904300,ELMIRA BUSINESS INSTITUTE               ,NY,14901-2731,Proprietary  ,27,206,233,111,697,808
00907700,UTICA SCHOOL OF COMMERCE                ,NY,13501-2280,Proprietary  ,42,145,187,147,434,581
00924800,SAMARITAN HOSPITAL SCH NURSING          ,NY,12180-2475,Private      ,3,16,19,44,177,221
00928300,MIDWAY-PARIS BEAUTY SCHOOL              ,NY,11385-3453,Proprietary  ,11,47,58,17,58,75
00928400,LEARNING INST FOR BEAUTY SCIENCES       ,NY,11756-1345,Proprietary  ,57,126,183,73,157,230
00933500,MESIVTA EASTERN PKWY RABBINICAL CLG     ,NY,11218-5559,Private      ,13,2,15,14,2,16
00947900,SAINT VINCENTS CMC SI NURSING SCHOOL    ,NY,10304-3850,Proprietary  ,12,20,32,64,131,195
00976900,METROPOLITAN COLLEGE OF NEW YORK        ,NY,10013-1919,Private      ,70,429,499,185,1539,1724
00992900,SUNY COLLEGE OF OPTOMETRY               ,NY,10036-8003,Public       ,2,10,12,20,348,368
01005100,LA GUARDIA CMTY COLLEGE - CUNY          ,NY,11101-3083,Public       ,2561,2393,4954,9227,7054,16281
01005200,JEFFERSON-LEWIS BOCES PRAC NRSGPRG      ,NY,13601-9509,Public       ,6,31,37,18,97,115
01009700,CUNY-MEDGAR W EVERS COLLEGE             ,NY,11225-2010,Public       ,1108,1677,2785,4452,4836,9288
01014200,TOURO COLLEGE                           ,NY,10010-4202,Private      ,1319,3357,4676,3139,11098,14237
01014700,WESTERN SUFFOLK BOCES                   ,NY,11768-3499,Public       ,25,111,136,60,229,289
01015300,HELENE FULD COL OF NRSNG/N GEN HOSP     ,NY,10035-0000,Private      ,11,180,191,20,357,377
01028600,EMPIRE STATE COLLEGE                    ,NY,12866-4391,Public       ,204,2525,2729,696,10024,10720
01037800,RABBINICAL COLLEGE OF LONG ISLAND       ,NY,11561-3244,Private      ,23,0,23,24,1,25
01055100,NEW YORK SCH MED & DENTAL ASSISTANT     ,NY,11101-2327,Proprietary  ,49,92,141,130,291,421
01064100,SOUTHERN WESTCHESTER BOCES              ,NY,10543-0000,Public       ,8,79,87,17,129,146
01068400,ERIE COMMUNITY COLLEGE-ALL CAMPUSES     ,NY,14203-2698,Public       ,2610,2519,5129,7602,6516,14118
01081300,AMERICAN ACAD MCALLISTER INST           ,NY,10019-3604,Private      ,22,90,112,76,280,356
01083700,SIMMONS INST OF FUNERAL SERVICE         ,NY,13207-2098,Proprietary  ,5,9,14,34,36,70
01093000,SUBURBAN TECHNICAL SCHOOL               ,NY,11550-3771,Proprietary  ,87,321,408,158,595,753
01094300,RABBINICAL COLLEGE BETH SHRAGA          ,NY,10952-3033,Private      ,6,0,6,6,0,6
01095200,PNW BOCES LPN PROGRAM                   ,NY,10598-0000,Public       ,4,43,47,10,76,86
01103100,TECHNICAL CAREER INSTITUTE              ,NY,10001-2789,Proprietary  ,991,1679,2670,1994,3996,5990
01118900,UNITED TALMUDICAL SEMINARY              ,NY,11211-7984,Private      ,10,0,10,11,0,11
01161400,CHAMPLAIN VALLEY HOSP SCH RAD TECH      ,NY,12901-1490,Private      ,1,2,3,22,11,33
01161700,NEW YORK METHODIST HOSPITAL             ,NY,11229-9023,Private      ,23,46,69,65,141,206
01164700,SBI CAMPUS - AN AFFILIATE OF SANFORD-BRO,NY,11747-3785,Proprietary  ,82,140,222,285,471,756
01167000,YESHIVA OF NITRA RABBINICAL COLLEGE     ,NY,11211-7108,Private      ,0,0,0,1,0,1
01167700,MEMORIAL SLOAN KETTERING CANCER CTR     ,NY,10021-6094,Private      ,0,7,7,1,17,18
01167800,SUNY INST OF TECHNOLOGY UTICA ROME      ,NY,13504-3050,Public       ,165,312,477,1641,1108,2749
01182100,YESHIVATH ZICHRON MOSHE                 ,NY,12779-0580,Private      ,33,1,34,34,1,35
01183000,BERK TRADE AND BUSINESS SCHOOL          ,NY,11101-0000,Proprietary  ,9,67,76,14,87,101
01185900,WORD OF LIFE BIBLE INSTITUTE            ,NY,12860-0129,Private      ,129,29,158,484,77,561
01186000,MERCY MED CNTR SCHL OF RADIOGRAPHY      ,NY,11570-1098,Private      ,1,5,6,6,12,18
01192100,WESTCHESTER SCH OF BEAUTY CULTURE       ,NY,10550-2295,Proprietary  ,5,44,49,12,66,78
01192200,BETH HATALMUD RABBINICAL CLG            ,NY,11214-2594,Private      ,0,0,0,1,0,1
01198400,OHR HAMEIR THEOLOGICAL SEMINARY         ,NY,10566-0990,Private      ,0,1,1,1,2,3
01201100,TALMUDICAL SEM OHOLEI TORAH             ,NY,11213-3310,Private      ,21,0,21,29,0,29
01207200,PHILLIPS HAIRSTYLING INSTITUTE          ,NY,13210-1509,Proprietary  ,18,29,47,31,83,114
01210700,INSTITUTE OF DESIGN & CONSTRUCTION      ,NY,11201-5380,Private      ,15,57,72,42,126,168
01220300,MEMORIAL HOSPITAL SCH OF NURSING        ,NY,12204-1083,Private      ,7,19,26,30,133,163
01227700,NEW YORK CHIROPRACTIC COLLEGE           ,NY,13148-0800,Private      ,1,49,50,19,687,706
01229300,VEEB NASSAU CNTY SCHL OF PRACT NURS     ,NY,11553-3037,Public       ,18,79,97,51,194,245
01235800,PLAZA COLLEGE                           ,NY,11372-6300,Proprietary  ,151,324,475,381,925,1306
01236400,SAINT VINCENTS CATHOLIC MEDICAL CENTERS ,NY,11354-0000,Proprietary  ,10,61,71,40,180,220
01240700,SCHUYLER-CHEMUNG-TIOGA BOCES            ,NY,14903-1089,Public       ,0,10,10,24,132,156
01240701,STEUBEN SCHUYLER CHEMUNG TIOGA ALLEGANY ,NY,14870-9518,Public       ,1,1,2,1,2,3
01256100,FIVE TOWNS COLLEGE                      ,NY,11746-5871,Proprietary  ,169,81,250,1335,267,1602
01258900,ERIE 1 BOCES                            ,NY,14224-0000,Public       ,32,73,105,55,207,262
01265200,ONONDAGA CORTLAND MADISON BOCES         ,NY,13090-4500,Public       ,65,355,420,152,788,940
01278300,OSWEGO COUNTY BOCES ADULT CAREERS       ,NY,13114-4498,Public       ,7,33,40,28,110,138
01292700,CENTRAL TECH NURSING PROGRAM            ,NY,13202-3092,Public       ,6,11,17,11,60,71
01302900,BORICUA COLLEGE                         ,NY,10032-1599,Private      ,136,405,541,349,1022,1371
02056400,CAPRI COSMETOLOGY LEARNING CENTER       ,NY,10954-0000,Proprietary  ,29,64,93,47,122,169
02066200,THE NEW SCHOOL                          ,NY,10011-0000,Private      ,424,910,1334,5133,5535,10668
02069000,NEW YORK SCHOOL OF INTERIOR DESIGN      ,NY,10021-0000,Private      ,25,55,80,193,299,492
02075700,BRIARCLIFFE COLLEGE                     ,NY,11714-0000,Proprietary  ,132,113,245,872,654,1526
02075702,BRIARCLIFFE COLLEGE - PATCHOGUE         ,NY,11772-3019,Proprietary  ,96,106,202,619,498,1117
02092400,RIDLEY-LOWELL SCHOOL OF BUSINESS        ,NY,13905-0000,Proprietary  ,21,203,224,30,234,264
02093700,LONG ISLAND BUSINESS INSTITUTE          ,NY,11725-0000,Proprietary  ,156,315,471,381,968,1349
02098400,HERKIMER COUNTY BOCES                   ,NY,13350-0000,Public       ,9,54,63,35,132,167
02104300,OTSEGO AREA SCHOOL OF PRAC NURSING      ,NY,13820-0000,Public       ,8,30,38,9,35,44
02105900,HAIR DESIGN INSTITUTE AT FIFTH AVE      ,NY,11220-0000,Proprietary  ,14,58,72,24,82,106
02106800,BRAMSON ORT COLLEGE                     ,NY,11375-0000,Private      ,96,164,260,211,460,671
02110900,CATTARAUGUS/ALLEGANY BOCES              ,NY,14760-0000,Public       ,15,61,76,27,117,144
02112301,RIDLEY - LOWELL BUSINESS & TECHNICAL INS,NY,12601-3328,Proprietary  ,47,168,215,70,322,392
02116011,SANFORD-BROWN INSTITUTE - NEW YORK      ,NY,10003-2103,Proprietary  ,202,539,741,570,1466,2036
02118700,LONG ISLAND COLLEGE HOSPITAL - SCHOOL OF,NY,11201-6001,Private      ,10,61,71,62,223,285
02118702,LONG ISLAND COLLEGE HOSPITAL - SCHOOL OF,NY,11201-6001,Private      ,11,33,44,71,143,214
02124000,ORANGE ULSTER BOCES SCH OF PRAC NRS     ,NY,10924-9401,Public       ,17,37,54,29,108,137
02125500,CIRCLE IN THE SQUARE THEATRE SCHOOL     ,NY,10019-0000,Private      ,10,10,20,60,51,111
02126300,MADISON-ONEIDA BOCES PRAC NRS           ,NY,13478-0000,Public       ,10,96,106,18,143,161
02138500,BOCES RENSSELAER SCH OF PRAC NRSG       ,NY,12033-3221,Public       ,11,46,57,21,82,103
02145800,CAYUGA ONONDAGA BOCES                   ,NY,13021-9430,Public       ,7,23,30,16,78,94
02146000,WAYNE-FINGER LAKES BOCES                ,NY,14513-0000,Public       ,25,70,95,44,246,290
02152000,YESHIVA SHAAR HATORAH ITRI TORAH        ,NY,11418-0000,Private      ,0,0,0,1,0,1
02153600,BROOME-TIOGA BOCES PN PROG              ,NY,13905-0000,Public       ,5,20,25,28,139,167
02157900,ROCHESTER GENERAL HOSPITAL              ,NY,14621-3001,Private      ,3,20,23,20,110,130
02158200,WSHNGTN-SARTGA-WARN-HMLTN-ESX BOCES     ,NY,12839-1051,Public       ,13,23,36,37,131,168
02160100,GENEVA GENERAL HOSPITAL                 ,NY,14456-0000,Private      ,7,14,21,25,88,113
02163400,NEW YORK CAREER INSTITUTE               ,NY,10007-2801,Proprietary  ,65,172,237,201,599,800
02169100,DAVIS COLLEGE                           ,NY,13790-0000,Private      ,21,25,46,175,106,281
02170000,SWEDISH INSTITUTE                       ,NY,10001-0000,Proprietary  ,31,167,198,99,557,656
02170200,ALBANY SCHOHARIE SCHENECTADY            ,NY,12205-0000,Public       ,17,99,116,30,146,176
02171900,AILEY SCHOOL (THE)                      ,NY,10019-4402,Private      ,9,5,14,98,28,126
02172100,HAMILTON-FULTON-MONTGOMERY BOCES        ,NY,12095-0000,Public       ,9,39,48,31,52,83
02172800,DUTCHESS COUNTY BOCES SCH PRAC NURS     ,NY,12601-0000,Public       ,13,60,73,38,136,174
02173200,EMPIRE BEAUTY SCHOOL                    ,NY,10001-0000,Proprietary  ,139,234,373,348,683,1031
02173201,LEARNING INSTITUTES FOR BEAUTY SCIENCES-,NY,11214-4347,Proprietary  ,2,5,7,3,12,15
02173900,ULSTER COUNTY BOCES PRACTICAL NRSG      ,NY,12466-0000,Public       ,13,55,68,26,134,160
02176000,CHERYL FELL'S SCHOOL OF BUSINESS        ,NY,14304-0000,Proprietary  ,3,29,32,6,60,66
02179400,EASTERN SUFFOLK BOCES                   ,NY,11713-0000,Public       ,54,143,197,139,428,567
02182200,NEW SCHOOL OF RADIO & TELEVISION        ,NY,12206-1106,Proprietary  ,15,29,44,35,50,85
02187300,DARKEI NOAM RABBINICAL COLLEGE          ,NY,11210-0000,Private      ,0,1,1,0,1,1
02191600,TORAH TEMIMAH TALMUDICAL SEMINARY       ,NY,11218-0000,Private      ,10,0,10,11,0,11
02192500,BELLEVUE HOSP CTR SCH RAD TECH          ,NY,10016-0000,Public       ,4,11,15,11,32,43
02193700,SAINT LAWRENCE LEWIS COUNTY BOCES       ,NY,13617-0000,Public       ,0,0,0,74,4,78
02193703,SAINT LAWRENCE LEWIS COUNTY BOCES - ADUL,NY,13668-3238,Public       ,0,0,0,1,0,1
02199300,ORLEANS-NIAGARA BOCES                   ,NY,14132-0000,Public       ,1,20,21,8,48,56
02206000,HUNTER BUSINESS SCHOOL                  ,NY,11756-0000,Proprietary  ,47,236,283,100,530,630
02206001,HUNTER BUSINESS SCHOOL -                ,NY,11763-0000,Proprietary  ,0,0,0,13,11,24
02217800,D.HOPFER SCH NURSING AT MT.VRN HOSP     ,NY,10550-0000,Private      ,7,69,76,37,225,262
02219500,MILDRED ELLEY                           ,NY,12206-1513,Proprietary  ,93,389,482,225,1075,1300
02235600,ERIE 2-CHAUTAUQUA-CATTARAUGUS BOCES     ,NY,14006-0000,Public       ,8,42,50,19,123,142
02265100,YESHIVA DERECH CHAIM                    ,NY,11218-0000,Private      ,11,4,15,15,4,19
02265200,GLOBAL BUSINESS INSTITUTE               ,NY,11691-0000,Private      ,84,293,377,281,886,1167
02272900,ROCKLAND COUNTY BOCES PRAC NRSG SCH     ,NY,10994-0000,Public       ,13,39,52,19,103,122
02275900,"MODERN WELDING SCHOOL, INC.             ",NY,12304-0000,Proprietary  ,19,34,53,32,49,81
02287800,NATIONAL TRACTOR TRAILER SCHOOL         ,NY,13088-2505,Proprietary  ,8,134,142,14,210,224
02294900,INSTITUTE OF AUDIO RESEARCH             ,NY,10003-0000,Proprietary  ,138,121,259,339,310,649
02306500,PROFESSIONAL BUSINESS INSTITUTE         ,NY,10002-0000,Private      ,139,221,360,332,608,940
02314200,NORTHERN WESTCHESTER SCH COSMETOL       ,NY,10566-0000,Proprietary  ,5,9,14,11,14,25
02320100,OHR SOMAYACH TANENBAUM EDUCATIONAL CENTE,NY,10952-0000,Private      ,0,0,0,1,1,2
02325600,NEW YORK INSTITUTE OF ENGLISH & BUS     ,NY,10001-0000,Private      ,33,78,111,78,222,300
02349700,RABBINICAL SEMINARY ADAS YEREIM         ,NY,11211-0000,Private      ,0,0,0,1,0,1
02350600,YESHIVA AND KOLLEL HARBOTZAS TORAH      ,NY,11230-0000,Private      ,0,6,6,0,6,6
02454300,NEW YORK UNIVERSITY SCHOOL OF MEDICINE  ,NY,10016-6497,Private      ,2,6,8,204,840,1044
02491400,SPANISH AMERICAN INSTITUTE              ,NY,10036-0000,Private      ,1,8,9,3,11,14
02505900,SH-OR YOSHUV RABBINICAL COLLEGE         ,NY,11691-0000,Private      ,15,8,23,23,8,31
02506000,ASSOCIATED BETH RIVKAH SCHOOLS          ,NY,11225-0000,Private      ,38,6,44,51,7,58
02506100,CITY UNIV OF NEW YORK-CENTRAL           ,NY,10021-0000,Public       ,29,55,84,576,383,959
02506200,MERCE CUNNINGHAM STUDIO                 ,NY,10014-0000,Private      ,2,3,5,4,5,9
02506800,YESHIVAT MIKDASH MELECH                 ,NY,11230-0000,Private      ,3,1,4,13,2,15
02511500,JOFFREY BALLET SCHOOL                   ,NY,10011-0000,Proprietary  ,16,0,16,50,3,53
02513500,MAR JON SCHOOL OF BEAUTY CULTURE        ,NY,14150-0000,Proprietary  ,15,19,34,22,45,67
02525600,ART INSTITUTE OF NEW YORK CITY (THE)    ,NY,10013-2429,Proprietary  ,307,245,552,1707,942,2649
02540800,"GLOBE INSTITUTE OF TECHNOLOGY, INC.     ",NY,10007-0000,Proprietary  ,176,112,288,286,246,532
02546000,TRI-STATE COLLEGE OF ACUPUNCTURE        ,NY,10011-0000,Proprietary  ,0,40,40,1,146,147
02546300,YESHIVA OF THE TELSHE ALUMNI            ,NY,10471-0000,Private      ,1,0,1,1,0,1
02550600,TALMUDICAL INST OF UPSTATE NY           ,NY,14607-0000,Private      ,0,1,1,2,3,5
02556700,SEMINAR L'MOROS BAIS YAAKOV             ,NY,11219-0000,Private      ,145,2,147,267,2,269
02572900,BUSINESS INFORMATICS CENTER             ,NY,11580-0000,Proprietary  ,15,60,75,24,70,94
02575400,FRENCH CULINARY INSTITUTE               ,NY,10013-2618,Proprietary  ,71,229,300,263,673,936
02587600,ORLO SCH HAIR DESIGN & COSMETOLOGY      ,NY,12206-1723,Proprietary  ,34,35,69,67,66,133
02599400,NEW YORK COLLEGE OF HEALTH PROFESSIONS  ,NY,11791-4413,Private      ,43,171,214,168,674,842
02600100,NEW YORK ACADEMY OF ART (THE)           ,NY,10013-2911,Private      ,9,23,32,61,191,252
02614900,SANFORD-BROWN INSTITUTE                 ,NY,10604-2910,Proprietary  ,65,207,272,151,530,681
02615001,SANFORD-BROWN INSTITUTE - GARDEN CITY   ,NY,11530-4734,Proprietary  ,7,16,23,23,52,75
02616600,SHEAR EGO INTL SCH OF HAIR DESIGN       ,NY,14617-3501,Proprietary  ,28,53,81,56,112,168
02617000,CONTINENTAL SCH OF BEAUTY CULTURE       ,NY,14020-1908,Proprietary  ,23,61,84,32,78,110
02617001,CONTINENTAL SCHOOL OF BEAUTY CULTURE - O,NY,14760-2618,Proprietary  ,1,2,3,3,3,6
03007200,DANCE THEATRE OF HARLEM                 ,NY,10031-0000,Private      ,2,2,4,10,4,14
03027701,PACIFIC COLLEGE OF ORIENTAL MEDICINE - N,NY,10010-7108,Proprietary  ,4,151,155,16,348,364
03081600,DELAWARE CHENANGO MADISON OT. BOCES     ,NY,13815-9554,Public       ,10,57,67,15,73,88
03088500,NEW YORK INTERNATIONAL BEAUTY SCH       ,NY,10019-0000,Proprietary  ,5,23,28,25,74,99
03089700,COMPUTER CAREER CENTER                  ,NY,11530-3334,Proprietary  ,142,520,662,205,836,1041
03095500,ASA INST BUSINESS & COMPUTER TECH       ,NY,11201-5208,Proprietary  ,1023,2541,3564,1347,3350,4697
03096200,CHARLES STUART SCHOOL                   ,NY,11229-2004,Proprietary  ,6,20,26,7,40,47
03097801,CARSTEN INSTITUTE                       ,NY,10003-1901,Proprietary  ,1,11,12,3,18,21
03099100,SUNBRIDGE COLLEGE                       ,NY,10977-0000,Private      ,0,0,0,0,14,14
03103700,ADIRONDACK BEAUTY SCHOOL                ,NY,12801-3158,Proprietary  ,4,9,13,12,31,43
03104900,SULLIVAN COUNTY BOCES                   ,NY,12754-2116,Public       ,7,22,29,18,39,57
03111100,NEW YORK PARALEGAL SCHOOL               ,NY,10007-0000,Proprietary  ,0,0,0,5,12,17
03115300,GENESEE VALLEY BOCES                    ,NY,14020-1099,Public       ,8,43,51,20,114,134
03120700,NEW YORK CONSERVATORY FOR DRAMATIC ARTS ,NY,10011-4225,Proprietary  ,44,25,69,457,125,582
03129200,RABBINICAL CLG OHR SHIMAR YISROEL       ,NY,11211-8102,Private      ,0,0,0,2,0,2
03169300,STUDIO JEWELERS                         ,NY,10016-4112,Proprietary  ,0,11,11,3,20,23
03181400,MERKAZ BNOS                             ,NY,11204-0000,Private      ,7,54,61,12,146,158
03191300,CUNY SCHOOL OF LAW @ QUEENS COLLEGE     ,NY,11367-0000,Public       ,21,61,82,184,1242,1426
03193300,MANHATTAN SCHOOL OF COMPUTER TECH       ,NY,11230-1617,Private      ,19,137,156,52,354,406
03203300,NEW YORK INSTITUTE OF MASSAGE           ,NY,14221-6021,Proprietary  ,23,49,72,48,134,182
03216300,UNIFICATION THEOLOGICAL SEMINARY        ,NY,12507-5021,Private      ,0,7,7,0,12,12
03315300,HARLEM SCHOOL OF TECHNOLOGY             ,NY,10027-4426,Proprietary  ,5,22,27,11,33,44
03328300,FRANKLIN CAREER INSTITUTE               ,NY,11550-3003,Private      ,66,142,208,198,497,695
03342400,AMERICAN BARBER INSTITUTE               ,NY,10001-5271,Proprietary  ,13,43,56,40,113,153
03358300,ALLEN SCHOOL                            ,NY,11432-4901,Proprietary  ,114,467,581,245,1112,1357
03358301,ALLEN SCHOOL - BROOKLYN                 ,NY,11201-0000,Proprietary  ,3,32,35,3,32,35
03361500,WILLSEY INSTITUTE                       ,NY,10301-1989,Proprietary  ,0,0,0,1,2,3
03380300,CULINARY ACADEMY OF LONG ISLAND         ,NY,11791-5311,Proprietary  ,37,81,118,96,203,299
03419400,NORTHEASTERN SEMINARY                   ,NY,14624-1997,Private      ,0,22,22,7,93,100
03426400,ANTHEM INSTITUTE                        ,NY,10018-0000,Proprietary  ,119,189,308,269,491,760
03433500,LIA SCHORR INSTITUTE OF COSMETIC SK     ,NY,10022-2614,Proprietary  ,6,25,31,10,51,61
03443300,NEW YORK COLLEGE OF TRADITIONAL CHINESE ,NY,11501-0000,Private      ,0,27,27,1,66,67
03537300,NEW YORK AUTOMOTIVE & DIESEL INSTIT     ,NY,11101-0000,Proprietary  ,58,140,198,128,331,459
03568300,LEON STUDIO ONE SCHOOL OF HAIR DESI     ,NY,14221-5323,Proprietary  ,17,35,52,26,57,83
03651300,SAINT JOSEPH'S MEDICAL CENTER SCHOO     ,NY,10701-4080,Private      ,0,4,4,3,20,23
03652300,METROPOLITAN LEARNING INSTITUTE         ,NY,11375-0000,Private      ,13,153,166,28,555,583
03691300,USA BEAUTY SCHOOL INTERNATIONAL         ,NY,10013-3530,Proprietary  ,10,129,139,19,193,212
03713300,BEIS MEDRASH HEICHAL DOVID              ,NY,11691-4433,Private      ,3,0,3,7,0,7
03773300,CENTER FOR NATURAL WELLNESS SCHOOL OF MA,NY,12205-1601,Proprietary  ,10,57,67,25,99,124
03802300,UTA MESIVTA OF KIRYAS JOEL              ,NY,10950-2169,Private      ,0,109,109,1,109,110
03809400,MICROPOWER CAREER INSTITUTE             ,NY,10001-2812,Proprietary  ,21,217,238,22,246,268
03819400,HUDSON VALLEY SCHOOL OF ADVANCED AESTHET,NY,12493-0000,Proprietary  ,0,8,8,4,16,20
03839300,AVEDA INSTITUTE NEW YORK                ,NY,10013-1522,Proprietary  ,23,72,95,81,179,260
03881300,UNION GRADUATE COLLEGE                  ,NY,12308-3103,Private      ,3,59,62,18,208,226
03903400,AMERICAN BEAUTY SCHOOL                  ,NY,10462-8003,Proprietary  ,29,147,176,58,219,277
03941400,ELITE ACADEMY OF BEAUTY ARTS            ,NY,11223-1630,Proprietary  ,3,25,28,10,73,83
03983300,"SCHOOL OF PROFESSIONAL HORTICULTURE, AT ",NY,10458-5126,Private      ,0,2,2,0,4,4
04043300,ACE COMPUTER TRAINING CENTER            ,NY,11375-5337,Proprietary  ,4,23,27,6,39,45
04092401,MAKE-UP DESIGNORY -                     ,NY,10012-0041,Proprietary  ,22,33,55,22,33,55
04095300,KING'S COLLEGE (THE)                    ,NY,10018-0110,Private      ,21,16,37,399,29,428
04102300,NEW AGE TRAINING                        ,NY,10018-0000,Proprietary  ,0,4,4,0,8,8
04117700,"MONROE 2-ORLEANS BOCES, CENTER FOR WORK ",NY,14624-1119,Public       ,11,27,38,18,45,63
04123200,INSTITUTE OF ALLIED MEDICAL PROFESSIONS ,NY,11373-5541,Private      ,46,193,239,89,492,581
04123300,HUDSON VALLEY SCHOOL OF MASSAGE THERAPY ,NY,12493-0000,Proprietary  ,7,23,30,16,37,53
04125600,CAREER SCHOOL OF NY                     ,NY,10301-2416,Private      ,39,41,80,47,48,95
04134000,"JOHN PAUL'S HAIR, NAIL & SKIN CARE INSTI",NY,12020-1245,Proprietary  ,6,33,39,12,45,57
04137700,ANN MARIE'S WORLD OF BEAUTY SCHOOL      ,NY,13901-2308,Proprietary  ,4,9,13,6,27,33
00267808,BRYANT & STRATTON COLLEGE - PARMA       ,OH,44130-0000,Proprietary  ,163,723,886,566,2918,3484
00301000,ANTIOCH UNIVERSITY                      ,OH,45387-1608,Private      ,6,292,298,31,950,981
00301100,ART ACADEMY OF CINCINNATI               ,OH,45202-7106,Private      ,28,14,42,294,83,377
00301200,ASHLAND UNIVERSITY                      ,OH,44805-3799,Private      ,162,844,1006,3592,2869,6461
00301300,ATHENAEUM OF OHIO                       ,OH,45230-2000,Private      ,0,2,2,0,11,11
00301400,BALDWIN-WALLACE COLLEGE                 ,OH,44017-2088,Private      ,235,331,566,4588,1445,6033
00301600,BLUFFTON UNIVERSITY                     ,OH,45817-2104,Private      ,49,81,130,1534,344,1878
00301800,BOWLING GREEN STATE UNIVERSITY          ,OH,43403-0001,Public       ,1485,1226,2711,16811,5944,22755
00302300,CAPITAL UNIVERSITY                      ,OH,43209-2394,Private      ,224,340,564,3865,2585,6450
00302400,CASE WESTERN RESERVE UNIV               ,OH,44106-0000,Private      ,83,203,286,6258,1031,7289
00302401,CASE WESTERN RESERVE UNIV - MED         ,OH,44106-0000,Private      ,1,29,30,36,1087,1123
00302402,CASE WESTERN RESERVE UNIV - DENTAL      ,OH,44106-0000,Private      ,1,10,11,12,286,298
00302403,CASE WESTERN RESERVE UNIV - LAW         ,OH,44106-0000,Private      ,0,46,46,13,1383,1396
00302404,CASE WESTERN RESERVE UNIV - UG          ,OH,44106-0000,Private      ,15,12,27,454,53,507
00302405,CASE WESTERN RESERVE UNIV - MSASS       ,OH,44106-0000,Private      ,1,43,44,12,417,429
00302406,CASE WESTERN RESERVE UNIV - NURS UG     ,OH,44106-0000,Private      ,5,18,23,186,120,306
00302407,CASE WESTERN RESERVE UNIV - WSOM        ,OH,44106-0000,Private      ,1,57,58,11,284,295
00302408,CASE WESTERN RESERVE UNIV -A&S GRAD     ,OH,44106-0000,Private      ,1,43,44,3,341,344
00302409,CASE WESTERN RESERVE UNIV -ENG GRAD     ,OH,44106-0000,Private      ,0,19,19,14,96,110
00302410,CASE WESTERN RESERVE UNIV -NURS GRD     ,OH,44106-0000,Private      ,1,39,40,5,313,318
00302500,CEDARVILLE UNIVERSITY                   ,OH,45314-8564,Private      ,210,55,265,3675,198,3873
00302600,CENTRAL STATE UNIVERSITY                ,OH,45384-1004,Public       ,422,313,735,3623,1495,5118
00302900,CINCINNATI CHRISTIAN UNIVERSITY         ,OH,45204-3200,Private      ,110,191,301,505,559,1064
00303000,OHIO CHRISTIAN UNIVERSITY               ,OH,43113-9487,Private      ,96,428,524,393,968,1361
00303100,CLEVELAND INSTITUTE OF MUSIC            ,OH,44106-1776,Private      ,6,15,21,416,364,780
00303200,CLEVELAND STATE UNIVERSITY              ,OH,44115-2214,Public       ,1055,3257,4312,7607,13003,20610
00303300,COLLEGE OF MT ST JOSEPH                 ,OH,45233-1670,Private      ,97,187,284,1709,1133,2842
00303500,OHIO DOMINICAN UNIVERSITY               ,OH,43219-2099,Private      ,128,499,627,2258,2323,4581
00303600,FRANCISCAN UNIV OF STEUBENVILLE         ,OH,43952-1763,Private      ,165,128,293,2212,626,2838
00303700,COLLEGE OF WOOSTER                      ,OH,44691-2363,Private      ,51,12,63,2999,90,3089
00303900,COLUMBUS COLLEGE OF ART AND DESIGN      ,OH,43215-1758,Private      ,130,81,211,1698,380,2078
00304000,CUYAHOGA COMMUNITY COLLEGE              ,OH,44115-2878,Public       ,2007,5623,7630,6620,18080,24700
00304001,CUYAHOGA COMMUNITY CLG-EASTERN CAM      ,OH,44122-6195,Public       ,131,284,415,519,1009,1528
00304002,CUYAHOGA COMMUNITY CLG-METRO CAMPUS     ,OH,44115-0000,Public       ,184,596,780,843,2050,2893
00304003,CUYAHOGA COMMUNITY CLG-WESTERN CMPS     ,OH,44130-0000,Public       ,339,449,788,1527,1570,3097
00304100,"DEFIANCE COLLEGE, THE                   ",OH,43512-1695,Private      ,73,97,170,1312,439,1751
00304200,DENISON UNIVERSITY                      ,OH,43023-1329,Private      ,41,3,44,2862,71,2933
00304300,CHANCELLOR UNIVERSITY                   ,OH,44114-1096,Proprietary  ,14,237,251,32,694,726
00304400,TRINITY LUTHERAN SEMINARY               ,OH,43209-0000,Private      ,0,24,24,1,151,152
00304500,UNIVERSITY OF FINDLAY                   ,OH,45840-3695,Private      ,283,333,616,3212,1502,4714
00304600,FRANKLIN UNIVERSITY                     ,OH,43215-5399,Private      ,189,1781,1970,916,8337,9253
00304700,HEBREW UNION COLLEGE MAIN CAMPUS        ,OH,45220-0000,Private      ,0,2,2,1,89,90
00304800,HEIDELBERG UNIVERSITY                   ,OH,44883-2462,Private      ,125,79,204,2061,348,2409
00304900,HIRAM COLLEGE                           ,OH,44234-1808,Private      ,46,89,135,1663,354,2017
00305000,JOHN CARROLL UNIVERSITY                 ,OH,44118-4581,Private      ,200,222,422,4249,928,5177
00305100,KENT STATE UNIV - KENT CAMPUS           ,OH,44242-0001,Public       ,1918,2064,3982,20202,10015,30217
00305101,KENT STATE UNIV - GEAUGA CAMPUS         ,OH,44021-0000,Public       ,81,130,211,333,524,857
00305102,KENT STATE UNIV - STARK CAMPUS          ,OH,44720-0000,Public       ,456,617,1073,2250,2210,4460
00305103,KENT STATE UNIV - TUSCARAWAS CAMPUS     ,OH,44663-0000,Public       ,160,402,562,901,1354,2255
00305104,KENT STATE UNIV - TRUMBULL CAMPUS       ,OH,44483-0000,Public       ,191,471,662,832,1597,2429
00305105,KENT STATE UNIV - ASHTABULA CAMPUS      ,OH,44004-0000,Public       ,161,437,598,764,1540,2304
00305106,KENT STATE UNIV -E.LIVERPOOL CAMPUS     ,OH,43920-0000,Public       ,67,166,233,337,710,1047
00305107,KENT STATE UNIV - SALEM CAMPUS          ,OH,44460-0000,Public       ,125,238,363,677,986,1663
00306500,KENYON COLLEGE                          ,OH,43022-9623,Private      ,33,3,36,2553,41,2594
00306600,LAKE ERIE COLLEGE                       ,OH,44077-3389,Private      ,97,100,197,1406,401,1807
00306800,LORAIN COUNTY COMMUNITY COLLEGE         ,OH,44035-1691,Public       ,1141,2465,3606,3506,7090,10596
00306900,LOURDES COLLEGE                         ,OH,43560-2898,Private      ,133,465,598,678,1820,2498
00307200,MALONE UNIVERSITY                       ,OH,44709-3897,Private      ,91,282,373,2159,1249,3408
00307300,MARIETTA COLLEGE                        ,OH,45750-4033,Private      ,108,40,148,2383,265,2648
00307500,METHODIST THEOLOGICAL SCH IN OHIO       ,OH,43015-0000,Private      ,0,32,32,0,224,224
00307600,MIAMI-JACOBS COLLEGE                    ,OH,45401-0000,Proprietary  ,72,457,529,181,1347,1528
00307602,MIAMI - JACOBS CAREER COLLEGE - SPRINGBO,OH,45066-1115,Proprietary  ,53,234,287,114,536,650
00307603,MIAMI - JACOBS CAREER COLLEGE - TROY    ,OH,45373-3837,Proprietary  ,55,203,258,158,711,869
00307700,MIAMI UNIVERSITY                        ,OH,45056-1831,Public       ,1162,1115,2277,18464,5069,23533
00307800,WRIGHT STATE UNIVERSITY                 ,OH,45435-0002,Public       ,1255,1820,3075,12601,9472,22073
00308300,MOUNT UNION COLLEGE                     ,OH,44601-3993,Private      ,197,48,245,3263,234,3497
00308400,MUSKINGUM UNIVERSITY                    ,OH,43762-1199,Private      ,133,165,298,2232,610,2842
00308500,NOTRE DAME COLLEGE OF OHIO              ,OH,44121-4293,Private      ,119,327,446,1578,1222,2800
00308600,OBERLIN COLLEGE                         ,OH,44074-1090,Private      ,51,22,73,4823,150,4973
00308800,OHIO COLLEGE OF PODIATRIC MEDICINE      ,OH,44131-7304,Private      ,0,22,22,0,460,460
00308900,OHIO NORTHERN UNIVERSITY                ,OH,45810-1555,Private      ,292,139,431,3989,1136,5125
00309000,OHIO STATE UNIVERSITY-ALL CAMPUSES      ,OH,43210-1358,Public       ,3363,3139,6502,43946,23456,67402
00310000,OHIO UNIVERSITY                         ,OH,45701-2979,Public       ,1299,1151,2450,19598,5718,25316
00310002,"OHIO UNIVERSITY, ZANESVILLE CAMPUS      ",OH,43701-0000,Public       ,139,277,416,1027,1258,2285
00310003,"OHIO UNIVERSITY, LANCASTER CAMPUS       ",OH,43130-0000,Public       ,195,379,574,1100,1347,2447
00310004,"OHIO UNIVERSITY, SOUTHERN CAMPUS        ",OH,45638-0000,Public       ,188,467,655,796,1515,2311
00310005,"OHIO UNIVERSITY, CHILLICOTHE CAMPUS     ",OH,45601-0000,Public       ,224,518,742,919,1830,2749
00310006,"OHIO UNIVERSITY, EASTERN CAMPUS         ",OH,43950-0000,Public       ,71,86,157,495,258,753
00310008,OHIO UNIV COLL OF OSTEOPATHIC MED       ,OH,45701-0000,Public       ,2,46,48,9,484,493
00310900,OHIO WESLEYAN UNIVERSITY                ,OH,43015-2398,Private      ,39,14,53,2827,131,2958
00311000,OTTERBEIN COLLEGE                       ,OH,43081-2006,Private      ,243,211,454,3970,955,4925
00311300,PONTIFICAL COLLEGE JOSEPHINUM           ,OH,43235-1498,Private      ,1,10,11,17,21,38
00311401,FIRELANDS REGIONAL MEDICAL CENTER       ,OH,44870-4788,Private      ,3,17,20,48,139,187
00311500,RABBINICAL COLLEGE OF TELSHE            ,OH,44092-2584,Private      ,0,1,1,0,2,2
00311600,UNIV OF RIO GRANDE                      ,OH,45674-3131,Private      ,228,462,690,886,1030,1916
00311601,UNIVERSITY OF RIO GRANDE                ,OH,45674-9989,Private      ,0,0,0,642,531,1173
00311602,UNIVERSITY OF RIO GRANDE - MEIGS CENTER ,OH,45760-0000,Private      ,1,7,8,3,16,19
00311603,UNIVERSITY OF RIO GRANDE - CHILLICOTHE G,OH,45601-0000,Private      ,1,4,5,2,11,13
00311604,UNIVERSITY OF RIO GRANDE - HAMILTON GRAD,OH,45011-2833,Private      ,0,2,2,2,4,6
00311605,UNIVERSITY OF RIO GRANDE - COLUMBUS GRAD,OH,43215-0000,Private      ,4,15,19,15,47,62
00311606,UNIVERSITY OF RIO GRANDE - PORTSMOUTH GR,OH,45662-0000,Private      ,0,3,3,6,10,16
00311607,UNIVERSITY OF RIO GRANDE -              ,OH,45764-0000,Private      ,7,8,15,16,26,42
00311900,SINCLAIR COMMUNITY COLLEGE              ,OH,45402-1460,Public       ,2207,4913,7120,7295,15574,22869
00312100,TIFFIN UNIVERSITY                       ,OH,44883-2161,Private      ,280,636,916,2181,2254,4435
00312200,UNITED THEOLOGICAL SEMINARY             ,OH,45406-0000,Private      ,0,74,74,1,209,210
00312300,UNIVERSITY OF AKRON                     ,OH,44325-6211,Public       ,1961,2574,4535,18499,13364,31863
00312500,UNIVERSITY OF CINCINNATI                ,OH,45221-0125,Public       ,3415,4726,8141,23155,18437,41592
00312504,UNIVERSITY OF CINCINNATI - COLLEGE OF ME,OH,45267-0553,Public       ,26,47,73,150,980,1130
00312700,UNIVERSITY OF DAYTON                    ,OH,45469-0002,Private      ,389,687,1076,10485,3664,14149
00313100,UNIVERSITY OF TOLEDO                    ,OH,43606-3390,Public       ,1629,1945,3574,17201,9118,26319
00313101,UNIVERSITY OF TOLEDO - HEALTH SCIENCE CA,OH,43614-2598,Public       ,48,199,247,632,1621,2253
00313300,URBANA UNIVERSITY                       ,OH,43078-2091,Private      ,70,167,237,960,659,1619
00313400,URSULINE COLLEGE                        ,OH,44124-4398,Private      ,54,294,348,659,1206,1865
00313500,WALSH UNIVERSITY                        ,OH,44720-3396,Private      ,93,200,293,2415,1065,3480
00314100,WILBERFORCE UNIVERSITY                  ,OH,45384-1001,Private      ,57,110,167,1030,499,1529
00314200,WILMINGTON COLLEGE                      ,OH,45177-2499,Private      ,96,95,191,1879,542,2421
00314300,WITTENBERG UNIVERSITY                   ,OH,45501-2199,Private      ,79,56,135,2840,250,3090
00314400,XAVIER UNIVERSITY                       ,OH,45207-1035,Private      ,255,581,836,5766,2968,8734
00314500,YOUNGSTOWN STATE UNIVERSITY             ,OH,44555-0001,Public       ,1270,1818,3088,9033,7547,16580
00398200,CLEVELAND INSTITUTE OF ART              ,OH,44106-1700,Private      ,41,38,79,784,180,964
00406000,WINEBRENNER THEOLOGICAL SEMINARY        ,OH,45840-0000,Private      ,1,19,20,2,54,56
00485200,CLARK STATE COMMUNITY COLLEGE           ,OH,45505-4795,Public       ,446,1256,1702,1459,3968,5427
00485300,BRADFORD SCHOOL                         ,OH,43219-0000,Proprietary  ,116,141,257,666,539,1205
00485500,DAVIS COLLEGE                           ,OH,43623-4307,Proprietary  ,60,213,273,133,710,843
00486100,UNIVERSITY OF NORTHWESTERN OHIO         ,OH,45805-1498,Private      ,365,359,724,3909,1535,5444
00486600,STAUTZENBERGER COLLEGE                  ,OH,43537-4007,Proprietary  ,121,448,569,405,1368,1773
00510200,SCH OF DIAGNOSTIC IMAGING-CLEVELAND     ,OH,44119-0000,Private      ,3,10,13,11,38,49
00512700,BROWN MACKIE COLLEGE-CINCINNATI         ,OH,45215-1107,Proprietary  ,548,2258,2806,1491,6673,8164
00512728,BROWN MACKIE COLLEGE-CINCINNATI - LANDMA,OH,45215-1231,Proprietary  ,14,33,47,35,134,169
00521000,CLEVELAND INSTITUTE OF ELECTRONICS      ,OH,44114-0000,Proprietary  ,6,104,110,15,271,286
00531300,NORTH CENTRAL STATE COLLEGE             ,OH,44901-0000,Public       ,343,840,1183,1290,2814,4104
00575300,OWENS STATE COMMUNITY COLLEGE           ,OH,43699-0000,Public       ,1958,4131,6089,6357,12424,18781
00648700,AULTMAN COLLEGE OF NURSING AND HEALTH SC,OH,44710-1799,Private      ,30,70,100,169,356,525
00649400,GOOD SAMARITAN COLG-NURSING/HEALTH      ,OH,45220-2489,Private      ,35,68,103,207,377,584
00649800,MERIDIA HURON SCHOOL OF NURSING         ,OH,44112-4308,Private      ,14,115,129,58,493,551
00650700,TRINIT HEALTH SYSTEM SCH OF NURSING     ,OH,43952-2667,Private      ,7,10,17,40,101,141
00680400,LAKELAND COMMUNITY COLLEGE              ,OH,44094-5198,Public       ,863,1737,2600,2927,5469,8396
00686700,COLUMBUS STATE COMMUNITY COLLEGE        ,OH,43215-1786,Public       ,3316,6294,9610,11311,21906,33217
00703500,KETTERING COLLEGE OF MEDICAL ARTS       ,OH,45429-1299,Private      ,51,169,220,478,848,1326
00708500,MOUNT VERNON NAZARENE UNIVERSITY        ,OH,43050-9500,Private      ,145,135,280,1582,567,2149
00708501,MOUNT VERNON NAZARENE UNIV - AGS        ,OH,43050-0000,Private      ,11,280,291,47,855,902
00727500,EASTERN GATEWAY COMMUNITY COLLEGE       ,OH,43952-3598,Public       ,223,512,735,815,1291,2106
00747300,CHOFFIN CAREER & TECHNICAL CENTER       ,OH,44503-1628,Public       ,7,58,65,54,289,343
00759800,HOCKING TECHNICAL COLLEGE               ,OH,45764-9582,Public       ,722,1059,1781,3617,3688,7305
00777700,REMINGTON COLLEGE - CLEVELAND CAMPUS    ,OH,44125-1957,Proprietary  ,114,565,679,263,1303,1566
00777704,REMINGTON COLLEGE-CLEVELAND WEST CAMPUS ,OH,44070-3129,Proprietary  ,41,133,174,115,359,474
00812900,ADULT AND COMMUNITY EDUCATION @ HUDSON  ,OH,43211-2017,Public       ,18,148,166,39,339,378
00813200,TOLEDO SCHOOL OF PRACTICAL NURSING      ,OH,43613-5110,Public       ,20,108,128,91,446,537
00813300,ZANE STATE COLLEGE                      ,OH,43701-2626,Public       ,180,579,759,1041,2313,3354
00819400,AKRON SCHOOL OF PRACTICAL NRSG          ,OH,44311-0000,Public       ,8,22,30,54,149,203
00827800,TERRA COMMUNITY COLLEGE                 ,OH,43420-9670,Public       ,271,750,1021,840,2014,2854
00867700,NORTHWEST STATE COMMUNITY COLLEGE       ,OH,43502-9542,Public       ,247,660,907,1077,2406,3483
00888600,PORTAGE LAKES CAREER CENTER             ,OH,44232-0000,Public       ,9,55,64,27,141,168
00908800,ITT TECHNICAL INSTITUTE                 ,OH,45414-3456,Proprietary  ,218,596,814,592,1789,2381
00915600,WAYNE COUNTY SCHOOLS CAREER CENTER      ,OH,44677-9672,Public       ,13,96,109,48,241,289
00917200,SPRINGFIELD REGIONAL SCHOOL OF NURSING  ,OH,45501-0000,Private      ,13,87,100,54,242,296
00941200,NATIONAL INSTITUTE OF TECHNOLOGY        ,OH,44221-2998,Proprietary  ,54,229,283,251,781,1032
00945101,BROWN MACKIE COLLEGE-NORTH CANTON       ,OH,44720-0000,Proprietary  ,15,65,80,89,363,452
00953000,GERBER AKRON BEAUTY SCHOOL              ,OH,44333-3714,Proprietary  ,9,24,33,18,66,84
00953100,SPA SCHOOL (THE)                        ,OH,43214-1524,Proprietary  ,14,58,72,38,127,165
00966000,TIFFIN ACADEMY OF HAIR DESIGN           ,OH,44883-2833,Proprietary  ,7,28,35,41,75,116
00983700,ITT TECHNICAL INSTITUTE                 ,OH,44509-4098,Proprietary  ,188,410,598,625,1618,2243
00994100,BELMONT TECHNICAL COLLEGE               ,OH,43950-9766,Public       ,269,544,813,966,1661,2627
00994200,SHAWNEE STATE UNIVERSITY                ,OH,45662-4344,Public       ,510,580,1090,3808,2154,5962
01001700,PAYNE THEOLOGICAL SEMINARY              ,OH,45384-0474,Private      ,0,57,57,1,121,122
01002700,JAMES A. RHODES STATE COLLEGE           ,OH,45804-3597,Public       ,426,1079,1505,1691,3315,5006
01016800,NATIONWIDE BEAUTY ACADEMY               ,OH,43228-1000,Proprietary  ,58,87,145,168,280,448
01028000,OHIO STATE BEAUTY ACADEMY               ,OH,45801-4950,Proprietary  ,34,64,98,43,71,114
01032300,HANNAH E MULLINS SCH-PRAC NRSG          ,OH,44460-2906,Public       ,6,22,28,23,84,107
01034500,CINCINNATI STATE TECH & COMM CLG        ,OH,45223-2690,Public       ,1400,2868,4268,4485,9296,13781
01045300,WASHINGTON STATE CMTY COLLEGE           ,OH,45750-9225,Public       ,232,580,812,901,1508,2409
01063000,NORTHERN INSTITUTE OF COSMETOLOGY       ,OH,44052-1803,Proprietary  ,6,27,33,11,69,80
01073600,MARION TECHNICAL COLLEGE                ,OH,43302-5694,Public       ,166,545,711,769,1891,2660
01088000,CHATFIELD COLLEGE                       ,OH,45118-9705,Private      ,12,66,78,36,188,224
01088100,STARK STATE COLLEGE OF TECHNOLOGY       ,OH,44720-7299,Public       ,985,2594,3579,3379,8632,12011
01090600,CINCINNATI CLG OF MORTUARY SCIENCE      ,OH,45224-1428,Private      ,12,44,56,72,155,227
01092300,UNION INSTITUTE & UNIVERSITY            ,OH,45206-1925,Private      ,7,456,463,39,1604,1643
01096200,MOORE UNIV OF HAIR DESIGN               ,OH,45213-0000,Proprietary  ,1,10,11,4,18,22
01099300,HOBART INSTITUTE OF WELDING TECHNOLOGY  ,OH,45373-2400,Private      ,42,57,99,201,195,396
01100500,KAPLAN COLLEGE                          ,OH,43232-4827,Proprietary  ,50,291,341,143,844,987
01104600,CENTRAL OHIO TECHNICAL COLLEGE          ,OH,43055-1767,Public       ,337,938,1275,1576,4418,5994
01170300,PENTA COUNTY JOINT VOCATIONAL SCH       ,OH,43551-0000,Public       ,16,70,86,24,128,152
01174400,NATIONAL BEAUTY COLLEGE                 ,OH,44720-0000,Proprietary  ,20,37,57,44,115,159
01174500,OHIO TECHNICAL COLLEGE                  ,OH,44103-1228,Proprietary  ,187,182,369,1255,552,1807
01182500,OHIO STATE SCHOOL OF COSMETOLOGY        ,OH,43224-1107,Proprietary  ,7,39,46,41,130,171
01212800,SOUTHWESTERN COLLEGE                    ,OH,45402-3003,Proprietary  ,146,725,871,324,2008,2332
01212802,SOUTHWESTERN COLLEGE                    ,OH,45005-2267,Proprietary  ,29,151,180,66,458,524
01212803,SOUTHWESTERN COLLEGE                    ,OH,45202-4304,Proprietary  ,109,467,576,174,1208,1382
01212804,SOUTHWESTERN COLLEGE                    ,OH,45246-3121,Proprietary  ,99,530,629,261,1695,1956
01212806,SOUTHWESTERN COLLEGE - TOLEDO           ,OH,43615-6800,Proprietary  ,7,93,100,9,100,109
01216600,CAROUSEL BEAUTY COLLEGE                 ,OH,45402-8935,Proprietary  ,28,53,81,57,168,225
01224800,CENTRAL SCHOOL OF PRACTICAL NURSING     ,OH,44103-4371,Private      ,17,106,123,63,343,406
01267200,CAROUSEL BEAUTY COLLEGE                 ,OH,45044-5113,Proprietary  ,5,15,20,9,34,43
01267400,CAROUSEL OF MIAMI VALLEY BEAUTY CLG     ,OH,45424-2063,Proprietary  ,1,3,4,5,6,11
01275000,EDISON COMMUNITY COLLEGE                ,OH,45356-9239,Public       ,211,568,779,998,2266,3264
01283800,LAURA AND ALVIN SIEGAL COLLEGE OF JUDAIC,OH,44122-7197,Private      ,0,0,0,2,4,6
01284800,MOLER-HOLLYWOOD BEAUTY COLLEGE          ,OH,45202-2577,Proprietary  ,8,45,53,11,87,98
01287000,SOUTHERN STATE COMMUNITY COLLEGE        ,OH,45133-9406,Public       ,318,865,1183,1011,2593,3604
01289100,ANTONELLI COLLEGE                       ,OH,45202-2592,Proprietary  ,47,134,181,190,452,642
01289600,VIRGINIA MARTI COLLEGE OF ART AND DESIGN,OH,44107-0778,Proprietary  ,43,60,103,198,192,390
01313200,INTERNATIONAL CLG OF BROADCASTING       ,OH,45431-1898,Proprietary  ,9,32,41,51,122,173
02052000,OHIO INST OF PHOTOGRAPHY & TECHNOLOGY   ,OH,45439-1984,Proprietary  ,69,248,317,275,961,1236
02054300,TRUMBULL BUSINESS COLLEGE               ,OH,44484-0000,Proprietary  ,20,127,147,82,499,581
02056800,DAYMAR COLLEGE                          ,OH,45601-1038,Proprietary  ,38,280,318,79,843,922
02056802,DAYMAR COLLEGE - LANCASTER              ,OH,43130-0000,Proprietary  ,0,16,16,1,36,37
02056803,DAYMAR COLLEGE - NEW BOSTON             ,OH,45662-4900,Proprietary  ,1,9,10,4,17,21
02056804,DAYMAR COLLEGE - JACKSON                ,OH,45640-1728,Proprietary  ,2,12,14,3,37,40
02066100,OHIO STATE COLLEGE/BARBER STYLING       ,OH,43213-0000,Proprietary  ,21,99,120,53,194,247
02069500,AKRON INSTITUTE                         ,OH,44306-0000,Proprietary  ,67,351,418,240,1252,1492
02073300,GALLIA-JACKSON-VINTON SCH ADULT ED      ,OH,45674-0000,Public       ,19,79,98,45,234,279
02110700,CLEVELAND INST OF DENTAL-MED ASST       ,OH,44115-2285,Proprietary  ,71,231,302,132,544,676
02116009,SANFORD-BROWN COLLEGE - MIDDLEBURG HEIGH,OH,44130-8362,Proprietary  ,75,353,428,284,1460,1744
02116900,UPPER VALLEY JVS                        ,OH,45356-0000,Public       ,8,103,111,31,322,353
02117300,GREAT OAKS INSTITUTE OF TECHNOLOGY      ,OH,45241-1581,Public       ,48,264,312,148,825,973
02128600,THE ART INSTITUTE OF CINCINNATI         ,OH,45246-0000,Proprietary  ,28,40,68,293,157,450
02140700,COMMUNITY EDUCATIONAL SERVICES          ,OH,44702-1710,Public       ,9,70,79,29,241,270
02152100,ACADEMY OF COURT REPORTING AND TECHNOLOG,OH,44115-0000,Proprietary  ,14,123,137,51,411,462
02152101,ACADEMY OF COURT REPORTING & TECHNOLOGY ,OH,43215-3902,Proprietary  ,19,124,143,51,527,578
02152102,ACADEMY OF COURT REPORTING - MIAMI-JACOB,OH,44313-3607,Proprietary  ,3,16,19,9,139,148
02152104,ACADEMY OF COURT REPORTING AND TECHNOLOG,OH,45202-2123,Proprietary  ,6,74,80,14,196,210
02152106,ACADEMY OF COURT REPORTING AND TECHNOLOG,OH,45241-5428,Proprietary  ,1,10,11,1,10,11
02158500,OHIO BUSINESS COLLEGE                   ,OH,44055-3344,Proprietary  ,39,191,230,100,691,791
02158501,OHIO BUSINESS COLLEGE                   ,OH,44870-9953,Proprietary  ,28,159,187,75,530,605
02168100,TRI-COUNTY JOINT VOCATIONAL SCHOOL      ,OH,45764-0000,Public       ,13,48,61,31,111,142
02187900,ASHTABULA CO JOINT VOC SCH ADULT ED     ,OH,44047-0000,Public       ,12,120,132,28,240,268
02189000,ADULT CENTER FOR EDUCATION              ,OH,43701-0000,Public       ,17,105,122,53,326,379
02190700,RETS TECH CENTER                        ,OH,45459-0000,Proprietary  ,124,744,868,366,2423,2789
02192100,BUTLER TECHNOLOGY AND CAREER DEVELOPMENT,OH,45011-0000,Public       ,64,235,299,159,623,782
02196300,COLLINS CAREER CENTER                   ,OH,45619-0000,Public       ,71,199,270,193,576,769
02210800,MEDINA COUNTY CAREER CENTER             ,OH,44256-0000,Public       ,12,98,110,27,169,196
02215400,OHIO STATE SCHOOL OF COSMETOLOGY        ,OH,43207-0000,Proprietary  ,12,30,42,46,130,176
02220500,GOD'S BIBLE SCHOOL & COLLEGE            ,OH,45210-0000,Private      ,45,30,75,182,59,241
02220800,CAREER & TECHNOLOGY EDUCATION CENTERS OF,OH,43055-0000,Public       ,13,73,86,31,170,201
02239800,PIONEER CAREER & TECHNOLOGY CENTER      ,OH,44875-0000,Public       ,6,33,39,8,56,64
02245600,WARREN COUNTY CAREER CENTER             ,OH,45036-0000,Public       ,15,110,125,28,181,209
02246300,INSTITUTE OF MEDICAL-DENTAL TECH        ,OH,45246-3317,Proprietary  ,14,80,94,41,202,243
02263700,MIAMI VALLEY CAREER TECHNOLOGY CTR      ,OH,45315-0000,Public       ,29,152,181,72,425,497
02269400,EASTERN HILLS ACAD OF HAIR DESIGN       ,OH,45255-0000,Proprietary  ,7,35,42,15,93,108
02269500,WESTERN HILLS SCHOOL OF BEAUTY & HAIR DE,OH,45211-0000,Proprietary  ,16,99,115,38,232,270
02270100,OHIO HI-POINT CAREER CENTER             ,OH,43311-0000,Public       ,3,120,123,23,361,384
02272700,COLUMBIANA COUNTY CAREER CENTER         ,OH,44432-0000,Public       ,14,94,108,33,241,274
02287900,RAPHAEL'S SCHOOL OF BEAUTY CULTURE      ,OH,44446-0000,Proprietary  ,25,53,78,45,124,169
02289802,KAPLAN COLLEGE                          ,OH,45203-0000,Proprietary  ,55,317,372,110,845,955
02301400,OHIO VALLEY COLLEGE OF TECHNOLOGY       ,OH,43920-0000,Proprietary  ,31,84,115,90,196,286
02303600,BOHECKER'S BUSINESS COLLEGE             ,OH,44266-0000,Proprietary  ,25,148,173,161,704,865
02304700,TRI-RIVERS CAREER CENTER                ,OH,43302-0000,Public       ,11,69,80,35,219,254
02311200,AMERICAN SCHOOL OF TECHNOLOGY           ,OH,43229-0000,Proprietary  ,17,229,246,37,430,467
02315500,TOLEDO ACADEMY OF BEAUTY CULTURE - EAST ,OH,43616-0000,Proprietary  ,13,59,72,36,122,158
02328500,MOLER-PICKENS BEAUTY COLLEGE            ,OH,45014-0000,Proprietary  ,4,40,44,10,53,63
02334300,INTERNATIONAL ACAD OF HAIR DESIGN       ,OH,45239-0000,Proprietary  ,11,27,38,46,82,128
02336300,KNOX COUNTY CAREER CENTER               ,OH,43050-4298,Public       ,11,50,61,27,231,258
02336700,CUYAHOGA VALLEY CAREER CENTER           ,OH,44141-1296,Public       ,14,47,61,53,243,296
02337700,PROFESSIONAL SKILLS INSTITUTE           ,OH,43607-0000,Proprietary  ,28,169,197,122,789,911
02351500,WILLOUGHBY EASTLAKE SCH OF PRAC NSG     ,OH,44094-0000,Public       ,3,24,27,13,108,121
02352800,POLARIS CAREER CENTER-ADULT ED DEPT     ,OH,44130-0000,Public       ,26,156,182,62,273,335
02354200,SCIOTO COUNTY JOINT VOCATIONAL SCH      ,OH,45648-0000,Public       ,27,109,136,59,279,338
02454400,NORTHEASTERN OHIO UNIVS COL OF MED      ,OH,44272-0000,Public       ,2,53,55,76,744,820
02497800,GREENE COUNTY CAREER CENTER             ,OH,45385-0000,Public       ,14,84,98,26,173,199
02512600,ADULT VOCATIONAL SERVICES               ,OH,44308-0000,Public       ,0,7,7,2,29,31
02519300,OHIO STATE SCH COSMETOLOGY              ,OH,43068-0000,Proprietary  ,2,7,9,3,18,21
02522700,EASTLAND-FAIRFIELD CAREER AND TECHNICAL ,OH,43125-0000,Public       ,24,121,145,45,299,344
02528300,TDDS TECHNICAL INSTITUTE                ,OH,44429-0000,Proprietary  ,14,193,207,48,415,463
02529500,HAMRICK SCHOOL                          ,OH,44256-0000,Proprietary  ,9,66,75,16,123,139
02541400,TOLEDO ACADEMY OF BEAUTY CULTURE-SO     ,OH,43614-0000,Proprietary  ,17,65,82,52,175,227
02545800,INNER STATE BEAUTY SCHOOLS              ,OH,44124-0000,Proprietary  ,25,81,106,53,216,269
02553000,SCHOOL OF ADVERTISING ART               ,OH,45440-0000,Proprietary  ,23,3,26,205,33,238
02560000,CASAL AVEDA INSTITUTE                   ,OH,44515-0000,Proprietary  ,21,32,53,81,96,177
02560700,PICKAWAY ROSS CO JOINT VOC TECH SCH     ,OH,45601-0000,Public       ,17,161,178,60,318,378
02560701,PICKAWAY ROSS COUNTY JOINT VOCATIONAL SC,OH,45601-9010,Public       ,6,43,49,8,54,62
02562300,APOLLO CAREER CENTER-ADULT EDUC         ,OH,45806-0000,Public       ,23,175,198,64,602,666
02563000,RAPHAELS SCHOOL OF BEAUTY CULTURE       ,OH,44601-2847,Proprietary  ,22,37,59,42,97,139
02568600,MAHONING COUNTY CAREER & TECH CENTR     ,OH,44406-0000,Public       ,7,42,49,18,95,113
02582900,KAPLAN CAREER INSTITUTE                 ,OH,44129-6810,Proprietary  ,88,271,359,190,866,1056
02586400,TRUMBULL CAREER & TECH CENTER-ADULT     ,OH,44483-1997,Public       ,13,107,120,43,357,400
02588500,OHIO STATE SCHOOL OF COSMETOLOGY        ,OH,43081-0000,Proprietary  ,9,35,44,61,87,148
02599711,VATTEROTT COLLEGE - CLEVELAND           ,OH,44147-3502,Proprietary  ,22,162,184,43,469,512
02603800,LORAIN COUNTY JVS ADULT CAREER CTR      ,OH,44074-9799,Public       ,27,216,243,46,304,350
02616200,BROWN MACKIE COLLEGE-FINDLAY            ,OH,45840-6848,Proprietary  ,241,1120,1361,649,3306,3955
02620000,SANDUSKY CAREER CENTER                  ,OH,44870-4786,Public       ,9,85,94,26,207,233
03007900,GALLIPOLIS CAREER COLLEGE               ,OH,45631-2600,Proprietary  ,9,56,65,29,229,258
03009702,"HARRISON COLLEGE - MUNCIE - COLUMBUS, OH",OH,43123-0000,Proprietary  ,5,26,31,5,34,39
03015100,ALLIANCE HIGH SCH-CMTY SERVICES DIV     ,OH,44601-2899,Public       ,10,108,118,22,164,186
03015300,EHOVE CAREER CENTER                     ,OH,44846-9500,Public       ,24,132,156,79,442,521
03023700,MADISON ADULT CAREER CENTER             ,OH,44905-2718,Public       ,12,73,85,21,193,214
03024300,VALLEY BEAUTY SCHOOL                    ,OH,43725-2332,Proprietary  ,14,45,59,25,83,108
03027100,FAIRVIEW ACADEMY                        ,OH,44126-2214,Proprietary  ,6,20,26,14,44,58
03034200,WASHINGTON COUNTY CAREER CENTER ADULT TE,OH,45750-9290,Public       ,9,164,173,40,282,322
03051400,AUBURN CAREER CENTER                    ,OH,44077-9723,Public       ,15,71,86,44,193,237
03051500,US GRANT JOINT VOCATIONAL SCHOOL        ,OH,45106-9502,Public       ,0,9,9,2,31,33
03065800,OHIO INSTITUTE OF HEALTH CAREERS        ,OH,44035-2394,Proprietary  ,12,72,84,57,245,302
03065900,BUCKEYE CAREER CENTER                   ,OH,44663-9437,Public       ,26,79,105,74,329,403
03067600,RAPHAEL'S SCHOOL OF BEAUTY CULTURE      ,OH,44512-2222,Proprietary  ,7,21,28,12,47,59
03068200,OHIO CENTER FOR BROADCASTING            ,OH,44125-4220,Proprietary  ,30,91,121,101,317,418
03068202,OHIO CENTER FOR BROADCASTING - COLUMBUS ,OH,43213-2571,Proprietary  ,10,86,96,39,148,187
03071900,MOUNT CARMEL COLLEGE OF NURSING         ,OH,43222-1598,Private      ,48,136,184,637,696,1333
03072303,EVEREST INSTITUTE - COLUMBUS            ,OH,43230-6653,Proprietary  ,72,385,457,120,811,931
03078000,OHIO CENTER FOR BROADCASTING            ,OH,45227-1509,Proprietary  ,14,33,47,41,119,160
03079000,ETI TECHNICAL COLLEGE                   ,OH,44446-4398,Proprietary  ,37,135,172,96,397,493
03084800,DELAWARE AREA CAREER CENTER             ,OH,43015-8969,Public       ,0,15,15,4,28,32
03084801,DELAWARE AREA CAREER CENTER -           ,OH,43015-9001,Public       ,2,6,8,5,14,19
03095600,VANTAGE CAREER CENTER                   ,OH,45891-1378,Public       ,4,44,48,20,155,175
03097000,MERCY COLLEGE OF NORTHWEST OHIO         ,OH,43604-1132,Private      ,77,174,251,522,878,1400
03100100,PARAMOUNT BEAUTY ACADEMY                ,OH,45662-4136,Proprietary  ,11,44,55,27,75,102
03105400,CLEVELAND EXTENSION HIGH SCH-WEST       ,OH,44102-2298,Public       ,7,42,49,20,139,159
03116200,DAYTON BARBER COLLEGE                   ,OH,45402-2310,Proprietary  ,12,42,54,28,108,136
03116300,OHIO COLLEGE OF MASSOTHERAPY            ,OH,44321-1363,Private      ,15,68,83,44,147,191
03116400,VANGUARD-SENTINELL VOC SCH DISTRICT     ,OH,43420-1197,Public       ,0,18,18,3,53,56
03117000,ASHLAND COUNTY-W HOLMES CAREER CTR      ,OH,44805-0000,Public       ,3,92,95,18,186,204
03319300,CREATIVE IMAGES-A CERTIFIED MATRIX      ,OH,45414-2557,Proprietary  ,20,38,58,67,190,257
03319301,CREATIVE IMAGES-A CERTIFIED MATRIX      ,OH,45459-0000,Proprietary  ,20,45,65,50,120,170
03416400,VALLEY BEAUTY SCHOOL                    ,OH,43701-3624,Proprietary  ,3,30,33,6,50,56
03425300,ROSEDALE BIBLE COLLEGE                  ,OH,43029-9517,Private      ,11,2,13,55,5,60
03457300,ALLEGHENY WESLEYAN COLLEGE              ,OH,44460-9598,Private      ,20,7,27,41,15,56
03468400,NATIONAL INSTITUTE OF MASSOTHERAPY      ,OH,44319-2100,Proprietary  ,11,34,45,29,83,112
03468500,ATS INSTITUTE OF TECHNOLOGY             ,OH,44143-2216,Proprietary  ,18,175,193,49,625,674
03475400,TRI-STATE BIBLE COLLEGE                 ,OH,45680-8402,Private      ,2,22,24,6,31,37
03534400,AMERICAN INST OF ALTERNATIVE MEDICI     ,OH,43229-1113,Proprietary  ,14,65,79,39,188,227
03578300,TRI-STATE COLLEGE                       ,OH,44452-8535,Proprietary  ,9,26,35,21,55,76
03586400,MED CENTRAL COLLEGE OF NURSING          ,OH,44903-2265,Private      ,41,52,93,362,256,618
03626300,BROWN AVEDA INSTITUTE                   ,OH,44060-6212,Proprietary  ,63,69,132,153,190,343
03693300,CARNEGIE CAREER COLLEGE                 ,OH,44260-9608,Private      ,2,42,44,12,116,128
03700300,REGENCY BEAUTY INSTITUTE - CLEVELAND    ,OH,44094-0000,Proprietary  ,44,105,149,93,261,354
03726300,TEMPLE BAPTIST COLLEGE                  ,OH,45240-0000,Private      ,7,12,19,9,26,35
03747300,BEXLEY HALL SEMINARY                    ,OH,43209-2325,Private      ,0,4,4,0,14,14
03776400,HEALING ARTS INSTITUTE                  ,OH,43551-3138,Proprietary  ,5,16,21,22,48,70
03837300,AVEDA FREDRIC'S INSTITUTE               ,OH,45208-1304,Proprietary  ,24,35,59,93,78,171
03882300,OREGON CAREER CENTER                    ,OH,43616-2631,Public       ,4,49,53,10,106,116
04050400,DESIGNER'S BEAUTY ACADEMY               ,OH,43920-0000,Proprietary  ,5,16,21,11,38,49
04074300,HONDROS COLLEGE                         ,OH,43081-3855,Proprietary  ,41,267,308,204,1295,1499
04116700,NEWLIFE TECHNICAL INSTITUTE             ,OH,43920-2920,Private      ,3,10,13,9,26,35
04117300,DAYTON SCHOOL OF MEDICAL MASSAGE        ,OH,45429-1111,Proprietary  ,83,228,311,179,499,678
04118300,NORTHCOAST MEDICAL TRAINING ACADEMY     ,OH,44240-4174,Proprietary  ,33,102,135,77,260,337
04124500,TECHSKILLS                              ,OH,43231-0000,Proprietary  ,9,83,92,16,189,205
04125700,CUT BEAUTY SCHOOL (THE)                 ,OH,44118-2918,Proprietary  ,16,76,92,31,177,208
04137800,AVEDA INSTITUTE COLUMBUS                ,OH,43201-2333,Proprietary  ,40,61,101,148,161,309
04138000,INSTITUTE OF THERAPEUTIC MASSAGE        ,OH,45875-0350,Proprietary  ,8,19,27,14,48,62
04140100,CISORIA ACADEMY OF COSMETOLOGY          ,OH,44137-2915,Proprietary  ,3,19,22,3,19,22
04149100,CINCINNATI ACADEMY A PAUL MITCHELL PARTN,OH,45241-1702,Proprietary  ,43,52,95,74,79,153
04152600,PIKE COUNTY CAREER TECHNOLOGY CENTER    ,OH,45661-9114,Public       ,0,17,17,0,17,17
04154000,TOLLES CAREER & TECHNICAL CENTER        ,OH,43064-8854,Public       ,0,1,1,0,1,1
        ,INVALID SCHOOL CODE                     ,  ,00000-0000,,631,2761,3392,3771,6892,10663
00134500,ADAMS STATE COLLEGE                     ,CO,81102-2373,Public       ,397,614,1011,2172,1768,3940
00134600,ARAPAHOE COMMUNITY COLLEGE              ,CO,80160-9002,Public       ,574,1412,1986,1772,3942,5714
00134700,COLORADO COLLEGE                        ,CO,80903-3294,Private      ,66,53,119,2557,301,2858
00134800,COLORADO SCHOOL OF MINES                ,CO,80401-1887,Public       ,196,164,360,4368,865,5233
00134900,UNIVERSITY OF NORTHERN COLORADO         ,CO,80639-0001,Public       ,840,760,1600,9192,3733,12925
00135000,COLORADO STATE UNIVERSITY               ,CO,80523-0100,Public       ,1704,1699,3403,18575,8169,26744
00135200,DENVER  SEMINARY                        ,CO,80120-2192,Private      ,0,117,117,0,556,556
00135300,FORT LEWIS COLLEGE                      ,CO,81301-3999,Public       ,410,284,694,3377,1201,4578
00135400,ILIFF SCHOOL OF THEOLOGY                ,CO,80210-0000,Private      ,0,42,42,0,206,206
00135500,LAMAR COMMUNITY COLLEGE                 ,CO,81052-3999,Public       ,91,187,278,340,383,723
00135800,MESA STATE COLLEGE                      ,CO,81501-7682,Public       ,821,924,1745,4369,2671,7040
00135900,COLORADO NORTHWESTERN COMMUNITY COLLEGE ,CO,81648-3598,Public       ,82,152,234,320,321,641
00136000,METROPOLITAN STATE CLG OF DENVER        ,CO,80204-0000,Public       ,2094,3427,5521,9753,12959,22712
00136100,NORTHEASTERN JUNIOR COLLEGE             ,CO,80751-2399,Public       ,204,177,381,1006,489,1495
00136200,OTERO JUNIOR COLLEGE                    ,CO,81050-3346,Public       ,166,390,556,511,681,1192
00136300,REGIS UNIVERSITY                        ,CO,80221-1099,Private      ,117,1530,1647,2194,7789,9983
00136500,COLORADO STATE UNIVERSITY-PUEBLO        ,CO,81001-4901,Public       ,390,805,1195,4039,2877,6916
00136800,TRINIDAD STATE JR COLLEGE               ,CO,81082-2396,Public       ,211,486,697,593,982,1575
00137000,UNIVERSITY OF COLORADO-BOULDER          ,CO,80309-0077,Public       ,2049,1460,3509,21032,8786,29818
00137100,UNIVERSITY OF DENVER                    ,CO,80208-2000,Private      ,224,1221,1445,6078,9011,15089
00137200,WESTERN STATE COLLEGE                   ,CO,81231-0000,Public       ,189,125,314,2021,432,2453
00163202,AQUINAS INSTITUTE OF THEOLOGY - AQUINAS ,CO,80903-1498,Private      ,0,1,1,0,3,3
00405702,NATIONAL AMERICAN UNIVERSITY            ,CO,80918-0000,Proprietary  ,7,67,74,16,193,209
00405703,NATIONAL AMERICAN UNIVERSITY            ,CO,80222-0000,Proprietary  ,12,109,121,27,265,292
00450300,EVEREST COLLEGE                         ,CO,80916-3548,Proprietary  ,73,389,462,131,845,976
00450600,COLORADO MOUNTAIN COLLEGE               ,CO,81602-0000,Public       ,252,315,567,1161,930,2091
00450700,EVEREST COLLEGE                         ,CO,80229-4339,Proprietary  ,80,417,497,181,1033,1214
00450701,"EVEREST COLLEGE- EVEREST COLLEGE, AURORA",CO,80012-5692,Proprietary  ,67,304,371,135,690,825
00450800,UNIVERSITY OF COLORADO DENVER           ,CO,80204-2029,Public       ,10,289,299,116,2577,2693
00450824,UNIVERSITY OF COLORADO DENVER - AURARIA ,CO,80217-3364,Public       ,696,1694,2390,6051,10132,16183
00450900,UNIV OF COLORADO AT COLO SPRINGS        ,CO,80918-3735,Public       ,575,885,1460,5312,4337,9649
00559600,EMILY GRIFFITH OPPORTUNITY SCH          ,CO,80204-2197,Public       ,119,611,730,386,1472,1858
00729700,REDSTONE COLLEGE                        ,CO,80020-9988,Proprietary  ,70,178,248,241,608,849
00754700,LINCOLN COLLEGE OF TECHNOLOGY           ,CO,80223-2013,Proprietary  ,155,170,325,740,664,1404
00754800,WESTWOOD COLLEGE - DENVER NORTH         ,CO,80221-3653,Proprietary  ,199,642,841,938,3339,4277
00754801,WESTWOOD COLLEGE - DENVER SOUTH         ,CO,80227-3653,Proprietary  ,90,327,417,240,787,1027
00758200,AIMS COMMUNITY COLLEGE                  ,CO,80632-0000,Public       ,490,946,1436,1669,2900,4569
00764900,ROCKY MOUNTAIN COLG OF ART & DESIGN     ,CO,80214-0000,Proprietary  ,78,54,132,847,238,1085
00793300,FRONT RANGE COMMUNITY COLLEGE           ,CO,80031-2199,Public       ,1441,2588,4029,5064,8831,13895
00863500,INTELLITEC MEDICAL INSTITUTE            ,CO,80909-1570,Proprietary  ,21,164,185,45,283,328
00887100,CONCORDE CAREER INSTITUTE               ,CO,80203-0000,Proprietary  ,64,265,329,175,814,989
00889600,PIKES PEAK COMMUNITY COLLEGE            ,CO,80906-5498,Public       ,1309,3208,4517,3785,8541,12326
00940100,COLORADO CHRISTIAN UNIVERSITY           ,CO,80226-7449,Private      ,131,527,658,1391,1769,3160
00954200,COMMUNITY COLLEGE OF DENVER             ,CO,80217-2026,Public       ,860,2109,2969,3121,6504,9625
00954300,RED ROCKS COMMUNITY COLLEGE             ,CO,80228-1255,Public       ,652,1526,2178,1978,4086,6064
00998100,MORGAN COMMUNITY COLLEGE                ,CO,80701-4399,Public       ,93,320,413,300,767,1067
01014800,COLORADO TECHNICAL UNIVERSITY           ,CO,80907-3896,Proprietary  ,148,2591,2739,421,6469,6890
01014802,COLORADO TECHNICAL UNIV - DENVER        ,CO,80111-3201,Proprietary  ,44,299,343,128,822,950
01014805,COLORADO TECH UNIV - ON LINE            ,CO,80907-0000,Proprietary  ,409,11034,11443,941,27105,28046
01014806,COLORADO TECH UNIV - FED EXPRESS        ,CO,80921-3800,Proprietary  ,1,35,36,5,74,79
01014808,COLORADO TECH UNIV - USAA               ,CO,80920-1005,Proprietary  ,0,8,8,4,20,24
01014809,COLORADO TECH UNIV - SCHRIEVER AFB      ,CO,80912-7298,Proprietary  ,0,0,0,0,2,2
01014810,COLORADO TECH UNIV - PETERSON AFB       ,CO,80914-1586,Proprietary  ,0,1,1,0,6,6
01014811,COLORADO TECH UNIV-HEWLETT PACKARD      ,CO,80919-2303,Proprietary  ,0,2,2,4,8,12
01014812,COLORADO TECHNICAL UNIVERSITY - WESTMINS,CO,80021-3498,Proprietary  ,53,360,413,141,1024,1165
01014813,COLORADO TECH UNIV - ORACLE             ,CO,80921-3660,Proprietary  ,0,4,4,2,21,23
01014815,COLORADO TECHNCL UNIV PUEBLO            ,CO,81003-2315,Proprietary  ,11,96,107,65,446,511
01070900,EMPIRE BEAUTY SCHOOL-LAKEWOOD           ,CO,80215-0000,Proprietary  ,20,44,64,33,131,164
01073200,SAN JUAN BASINTECHNICAL COLLEGE         ,CO,81328-9196,Public       ,9,30,39,16,74,90
01157200,COLORADO SCHOOL OF TRADES               ,CO,80215-2996,Proprietary  ,17,58,75,84,168,252
01267000,BEL-REA INST OF ANIMAL TECH             ,CO,80247-3048,Proprietary  ,111,150,261,426,631,1057
01285000,INTERNATIONAL SALON AND SPA ACADEMY     ,CO,80918-3684,Proprietary  ,38,81,119,83,164,247
01287500,PICKENS TECHNICAL COLLEGE               ,CO,80011-9307,Public       ,74,196,270,214,575,789
01300700,NAZARENE BIBLE COLLEGE                  ,CO,80910-3717,Private      ,21,173,194,60,646,706
02072200,EMPIRE BEAUTY SCHOOL -ARVADA            ,CO,80212-0000,Proprietary  ,10,19,29,48,105,153
02078900,ART INSTITUTE OF COLORADO (THE)         ,CO,80203-2983,Proprietary  ,337,495,832,1641,1731,3372
02116300,PUEBLO COMMUNITY COLLEGE                ,CO,81004-0000,Public       ,645,1939,2584,1623,4701,6324
02117500,NAROPA UNIVERSITY                       ,CO,80302-0000,Private      ,33,96,129,362,1203,1565
02133100,COLORADO CENTER FOR MEDICAL LABORATORY S,CO,80218-0000,Private      ,1,12,13,6,51,57
02141100,ARTISTIC BEAUTY COLGS-WESTMINSTER       ,CO,80030-0000,Proprietary  ,22,43,65,60,140,200
02141102,ARTISTIC BEAUTY COLLEGES-LITTLETON      ,CO,80123-3480,Proprietary  ,0,0,0,5,7,12
02141103,ARTISTIC BEAUTY COLLEGES-AURORA         ,CO,80017-3194,Proprietary  ,8,20,28,33,93,126
02156200,DELTA - MONTROSE TECHNICAL COLLEGE      ,CO,81416-0000,Public       ,25,73,98,64,192,256
02160600,EMPIRE BEAUTY SCHOOL -THORNTON          ,CO,80241-1659,Proprietary  ,27,40,67,78,158,236
02165200,SALON PROFESSIONAL ACADEMY (THE)        ,CO,81504-5309,Proprietary  ,19,18,37,57,56,113
02167600,KAPLAN COLLEGE                          ,CO,80229-5309,Proprietary  ,38,150,188,103,545,648
02188700,DENVER ACAD OF COURT REPORTING          ,CO,80030-0000,Proprietary  ,15,51,66,25,132,157
02211901,CHEEKS INTERNATIONAL ACADEMY OF BEAUTY C,CO,80525-3053,Proprietary  ,0,11,11,7,20,27
02211902,CHEEKS INTERNATIONAL ACDMY BTY CULT     ,CO,80631-0000,Proprietary  ,2,7,9,6,15,21
02253700,INTELLITEC COLLEGE                      ,CO,80909-0000,Proprietary  ,56,238,294,84,366,450
02267500,GLENWOOD BEAUTY ACADEMY                 ,CO,81601-0000,Proprietary  ,11,28,39,12,31,43
02276900,COMMUNITY COLLEGE OF AURORA             ,CO,80011-9036,Public       ,550,1752,2302,1607,4130,5737
02321700,ITT TECHNICAL INSTITUTE                 ,CO,80229-5338,Proprietary  ,123,518,641,314,1078,1392
02518500,HAIR DYNAMICS EDUCATION CENTER          ,CO,80525-0000,Proprietary  ,46,53,99,79,104,183
02594300,COLLEGE AMERICA - DENVER                ,CO,80222-3380,Proprietary  ,190,921,1111,413,2315,2728
02611000,HERITAGE COLLEGE                        ,CO,80212-7413,Proprietary  ,66,231,297,166,695,861
03006300,INST OF BUSINESS & MEDICAL CAREERS      ,CO,80525-3044,Proprietary  ,68,237,305,202,772,974
03012100,REMINGTON COLLEGE - COLORADO SPRINGS CAM,CO,80215-0000,Proprietary  ,14,69,83,32,211,243
03013100,BOULDER COLLEGE OF MASSAGE THERAPY      ,CO,80301-3295,Private      ,17,54,71,71,168,239
03014900,PLATT COLLEGE                           ,CO,80014-3141,Proprietary  ,16,61,77,42,178,220
03027400,XENON INTERNATIONAL ACADEMY III         ,CO,80014-1193,Proprietary  ,27,30,57,43,86,129
03030606,UTAH COLLEGE OF MASSAGE THERAPY - DENVER,CO,80031-2921,Proprietary  ,46,81,127,83,217,300
03030607,UTAH COLLEGE OF MASSAGE THERAPY - DENVER,CO,80012-2523,Proprietary  ,29,56,85,76,170,246
03031603,DPT BUSINESS SCHOOL                     ,CO,80223-0000,Proprietary  ,0,0,0,0,2,2
03066900,INTELLITEC COLLEGE                      ,CO,81506-3994,Proprietary  ,97,349,446,152,577,729
03068201,OHIO CENTER FOR BROADCASTING - COLORADO ,CO,80214-4129,Proprietary  ,21,62,83,44,154,198
03076401,BRYMAN SCHOOL OF ARIZONA (THE) - ANTHEM ,CO,80014-2622,Proprietary  ,1,6,7,7,17,24
03289300,COLORADO HEIGHTS UNIVERSITY             ,CO,80236-2711,Private      ,4,43,47,12,89,101
03306300,MONTESSORI EDUC CRT OF THE ROCKIES      ,CO,80301-2587,Private      ,0,0,0,2,28,30
03534300,JONES INTERNATIONAL UNIVERSITY          ,CO,80112-3446,Proprietary  ,25,1235,1260,72,2911,2983
03545300,UNIVERSITY OF THE ROCKIES               ,CO,80903-3612,Proprietary  ,0,611,611,18,1166,1184
03584400,COLORADO SCHOOL OF HEALING ARTS         ,CO,80226-4332,Proprietary  ,18,86,104,59,220,279
03670300,TONI & GUY HAIRDRESSING ACADEMY         ,CO,80911-1713,Proprietary  ,16,48,64,45,118,163
03686300,COLORADO SCHOOL OF TRADITIONAL CHINESE M,CO,80206-2127,Proprietary  ,3,38,41,4,101,105
03776300,CULINARY SCHOOL OF THE ROCKIES          ,CO,80305-5961,Proprietary  ,7,27,34,17,59,76
03972300,CUTTIN' UP BEAUTY ACADEMY               ,CO,80220-0000,Proprietary  ,8,53,61,13,82,95
03976300,MASSAGE THERAPY INSTITUTE OF COLORADO   ,CO,80206-2127,Proprietary  ,7,32,39,23,80,103
04080300,ASPEN UNIVERSITY                        ,CO,80246-1930,Proprietary  ,1,45,46,12,91,103
04093300,ACADEMY OF NATURAL THERAPY              ,CO,80631-3425,Proprietary  ,6,19,25,17,48,65
04121200,INSTITUTE OF TAOIST EDUCATION AND ACUPUN,CO,80027-1028,Private      ,0,8,8,2,38,40
04125100,MONTESSORI CENTRE INTERNATIONAL DENVER  ,CO,80111-5263,Private      ,0,0,0,0,7,7
04139300,NATIONAL BEAUTY COLLEGE                 ,CO,80221-0000,Proprietary  ,9,38,47,16,73,89
04148300,DENVER SCHOOL OF NURSING                ,CO,80202-1213,Proprietary  ,19,171,190,53,385,438
04151100,SUMMIT SALON & BEAUTY SCHOOL            ,CO,80866-4569,Proprietary  ,0,12,12,0,19,19
00267811,BRYANT & STRATTON COLLEGE - VIRGINIA BEA,VA,23462-4417,Proprietary  ,120,533,653,382,1784,2166
00370200,AVERETT UNIVERSITY                      ,VA,24541-3692,Private      ,94,479,573,1321,1386,2707
00370300,BLUEFIELD COLLEGE                       ,VA,24605-1799,Private      ,36,193,229,543,520,1063
00370400,BRIDGEWATER COLLEGE                     ,VA,22812-1599,Private      ,56,19,75,2967,147,3114
00370500,COLLEGE OF WILLIAM & MARY               ,VA,23187-8795,Public       ,153,162,315,9550,4138,13688
00370600,CHRISTOPHER NEWPORT UNIVERSITY          ,VA,23606-2998,Public       ,222,177,399,6805,919,7724
00370700,RICHARD BLAND COLLEGE                   ,VA,23805-7100,Public       ,181,148,329,1045,473,1518
00370800,EASTERN MENNONITE UNIVERSITY            ,VA,22802-2462,Private      ,46,98,144,1025,443,1468
00370900,EMORY & HENRY COLLEGE                   ,VA,24327-0010,Private      ,47,24,71,1384,136,1520
00371100,FERRUM COLLEGE                          ,VA,24088-2612,Private      ,90,44,134,2669,262,2931
00371200,TIDEWATER COMMUNITY COLLEGE             ,VA,23510-1910,Public       ,2741,5508,8249,8877,16585,25462
00371300,HAMPDEN-SYDNEY COLLEGE                  ,VA,23943-0128,Private      ,78,7,85,1190,34,1224
00371400,HAMPTON UNIVERSITY                      ,VA,23668-0099,Private      ,563,434,997,9313,2639,11952
00371500,HOLLINS UNIVERSITY                      ,VA,24020-0000,Private      ,29,86,115,915,562,1477
00371900,LONGWOOD UNIVERSITY                     ,VA,23909-1899,Public       ,278,104,382,4889,626,5515
00372000,LYNCHBURG COLLEGE                       ,VA,24501-3199,Private      ,166,138,304,3270,576,3846
00372100,JAMES MADISON UNIVERSITY                ,VA,22807-3780,Public       ,762,258,1020,20329,2203,22532
00372300,MARY BALDWIN COLLEGE                    ,VA,24401-3610,Private      ,78,259,337,1240,914,2154
00372400,MARYMOUNT UNIVERSITY                    ,VA,22207-4224,Private      ,175,345,520,2329,1822,4151
00372600,NATIONAL COLLEGE                        ,VA,24153-4524,Proprietary  ,342,2270,2612,875,7294,8169
00372700,NORTHERN VA CMTY CLG                    ,VA,22003-3743,Public       ,2473,3534,6007,9534,11332,20866
00372800,OLD DOMINION UNIVERSITY                 ,VA,23529-0052,Public       ,1294,2088,3382,16656,11481,28137
00373200,RADFORD UNIVERSITY                      ,VA,24142-6905,Public       ,524,302,826,7788,2036,9824
00373300,RANDOLPH-MACON COLLEGE                  ,VA,23005-5505,Private      ,52,16,68,2410,119,2529
00373400,RANDOLPH COLLEGE                        ,VA,24503-1526,Private      ,25,16,41,858,86,944
00373500,VIRGINIA COMMONWEALTH UNIVERSITY        ,VA,23284-9004,Public       ,1719,1871,3590,21071,12529,33600
00373600,ROANOKE COLLEGE                         ,VA,24153-3794,Private      ,117,39,156,2986,209,3195
00373700,SHENANDOAH UNIVERSITY                   ,VA,22601-5195,Private      ,145,293,438,2370,1778,4148
00373800,SOUTHERN VIRGINIA UNIVERSITY            ,VA,24416-3038,Private      ,129,70,199,666,223,889
00373900,ST PAULS COLLEGE                        ,VA,23868-1299,Private      ,100,115,215,542,379,921
00374200,SWEET BRIAR COLLEGE                     ,VA,24595-9998,Private      ,28,8,36,732,46,778
00374300,UNION THEO SEMINARY & PRESBYTRN SCH     ,VA,23227-0000,Private      ,0,20,20,1,81,82
00374400,UNIVERSITY OF RICHMOND                  ,VA,23173-0001,Private      ,59,249,308,5178,2345,7523
00374500,UNIVERSITY OF VIRGINIA - SFS            ,VA,22903-0000,Public       ,504,601,1105,18011,9423,27434
00374600,UNIVERSITY OF MARY WASHINGTON           ,VA,22401-5358,Public       ,149,204,353,4658,1032,5690
00374700,UNIV OF VIRGINIA'S COLLEGE AT WISE      ,VA,24293-4412,Public       ,91,68,159,1872,394,2266
00374800,EASTERN SHORE COMMUNITY COLLEGE         ,VA,23410-3000,Public       ,87,150,237,328,541,869
00374900,GEORGE MASON UNIVERSITY                 ,VA,22030-4444,Public       ,1206,2272,3478,15717,12992,28709
00375100,PATRICK HENRY COMMUNITY COLLEGE         ,VA,24112-5311,Public       ,307,847,1154,1004,2250,3254
00375200,VIRGINIA INTERMONT COLLEGE              ,VA,24201-4298,Private      ,63,95,158,810,300,1110
00375300,VIRGINIA MILITARY INSTITUTE             ,VA,24450-2138,Public       ,53,8,61,1506,60,1566
00375400,VIRGINIA POLYTECH INST & STATE UNIV     ,VA,24061-2000,Public       ,815,595,1410,24534,4698,29232
00375800,DANVILLE COMMUNITY COLLEGE              ,VA,24541-4004,Public       ,334,790,1124,1196,2471,3667
00375900,J. SARGEANT REYNOLDS COMMUNITY CLG      ,VA,23285-0000,Public       ,936,2193,3129,3852,7427,11279
00376000,VIRGINIA WESTERN CMTY COLLEGE           ,VA,24038-0000,Public       ,604,1261,1865,2262,3382,5644
00376100,WYTHEVILLE COMMUNITY COLLEGE            ,VA,24382-3308,Public       ,186,559,745,1100,1812,2912
00376200,VIRGINIA UNIVERSITY OF LYNCHBURG        ,VA,24501-6400,Private      ,25,133,158,83,308,391
00376400,VIRGINIA STATE UNIVERSITY               ,VA,23806-0001,Public       ,562,466,1028,9309,2605,11914
00376500,NORFOLK STATE UNIVERSITY                ,VA,23504-8000,Public       ,800,1230,2030,8608,5500,14108
00376600,VIRGINIA UNION UNIVERSITY               ,VA,23220-1711,Private      ,297,275,572,3286,1030,4316
00376700,VIRGINIA WESLEYAN COLLEGE               ,VA,23502-5599,Private      ,89,107,196,1865,551,2416
00376800,WASHINGTON & LEE UNIVERSITY             ,VA,24450-0303,Private      ,54,30,84,2461,1647,4108
00400400,JOHN TYLER COMMUNITY COLLEGE            ,VA,23831-5316,Public       ,795,1447,2242,2601,4352,6953
00450301,"EVEREST COLLEGE- EVEREST COLLEGE, MCLEAN",VA,22102-3000,Proprietary  ,61,189,250,115,346,461
00450702,"EVEREST COLLEGE- EVEREST COLLEGE, ARLING",VA,22203-1905,Proprietary  ,129,352,481,194,652,846
00498800,CENTRAL VIRGINIA COMMUNITY COLLEGE      ,VA,24502-2498,Public       ,328,657,985,1335,1871,3206
00499200,MILLER-MOTTE TECHNICAL COLLEGE          ,VA,24505-0000,Proprietary  ,79,185,264,134,365,499
00499600,DABNEY S LANCASTER COMMUNITY CLG        ,VA,24422-1000,Public       ,72,164,236,484,516,1000
00522300,NEW RIVER COMMUNITY COLLEGE             ,VA,24084-1127,Public       ,304,533,837,1403,1923,3326
00607500,ROANOKE MEM HOSP SCH RAD ONCOLOGY       ,VA,24033-0000,Private      ,0,5,5,8,11,19
00607501,ROANOKE MEM HOSP SCH RAD TECH           ,VA,24014-1850,Private      ,0,4,4,4,13,17
00662200,COLLEGE OF HEALTH SCIENCES - CHRV       ,VA,24031-0000,Private      ,42,119,161,492,866,1358
00681900,BLUE RIDGE COMMUNITY COLLEGE            ,VA,24486-0080,Public       ,281,465,746,1682,1769,3451
00687100,THOMAS NELSON COMMUNITY COLLEGE         ,VA,23670-0000,Public       ,941,1937,2878,3005,5779,8784
00709900,VIRGINIA HIGHLANDS COMMUNITY CLG        ,VA,24210-4210,Public       ,200,438,638,1146,1529,2675
00726000,SOUTHWEST VIRGINIA COMMUNITY CLG        ,VA,24641-1510,Public       ,323,618,941,1106,1727,2833
00859200,LOUISE OBICI SCHOOL OF NURSING          ,VA,23434-8038,Private      ,3,10,13,9,25,34
00859202,SUFFOLK PUB SCH-LOUISE OBICI SCH PN     ,VA,23434-0000,Private      ,0,0,0,2,6,8
00865900,LORD FAIRFAX COMMUNITY COLLEGE          ,VA,22645-0047,Public       ,397,680,1077,1529,2054,3583
00866000,GERMANNA COMMUNITY COLLEGE              ,VA,22508-0339,Public       ,389,706,1095,1498,2264,3762
00866100,SOUTHSIDE VIRGINIA CMTY CLG             ,VA,23821-2930,Public       ,603,1370,1973,1371,2757,4128
00915900,PAUL D CAMP COMMUNITY COLLEGE           ,VA,23851-0737,Public       ,111,363,474,401,995,1396
00916000,RAPPAHANNOCK COMMUNITY COLLEGE          ,VA,23149-2616,Public       ,219,328,547,698,919,1617
00926700,EVEREST COLLEGE                         ,VA,23606-4203,Proprietary  ,34,252,286,99,643,742
00926701,EVEREST COLLEGE - CHESAPEAKE            ,VA,23320-2637,Proprietary  ,64,350,414,123,760,883
00942000,SANFORD-BROWN COLLEGE                   ,VA,22182-3913,Proprietary  ,122,251,373,293,633,926
00953500,STAUNTON SCHOOL OF COSMETOLOGY          ,VA,24401-4323,Proprietary  ,9,18,27,12,30,42
00953700,VIRGINIA SCH OF HAIR DESIGN             ,VA,23669-0000,Proprietary  ,12,42,54,25,96,121
00962900,MOUNTAIN EMPIRE COMMUNITY COLLEGE       ,VA,24219-0700,Public       ,278,635,913,1085,1692,2777
00992800,PIEDMONT VIRGINIA COMMUNITY COLLEGE     ,VA,22902-7589,Public       ,339,595,934,1249,1758,3007
01004300,BON SECOURS MEMORIAL SCH OF NURSING     ,VA,23227-4612,Private      ,23,76,99,148,463,611
01019800,ECPI COLLEGE OF TECHNOLOGY              ,VA,23462-6542,Proprietary  ,1129,3665,4794,2934,10283,13217
01033800,EASTERN VIRGINIA MEDICAL SCHOOL         ,VA,23501-1980,Private      ,3,91,94,42,1213,1255
01159600,RALPH'S VIRGINIA SCH OF COSMETOLOGY     ,VA,24501-2652,Proprietary  ,9,12,21,12,20,32
01162601,WESTWOOD COLLEGE - SOUTH BAY - ARLINGTON,VA,22203-4167,Proprietary  ,117,176,293,424,493,917
01162602,WESTWOOD COLLEGE - SOUTH BAY - ANNANDALE,VA,22003-2602,Proprietary  ,48,180,228,194,533,727
01274401,SOUTHSIDE REGIONAL MED CTR PROF SCHOOLS ,VA,23803-5133,Proprietary  ,11,45,56,58,211,269
01274402,SOUTHSIDE REG MED CTR SCH RAD TECH      ,VA,23803-0000,Proprietary  ,2,7,9,7,25,32
02053000,LIBERTY UNIVERSITY                      ,VA,24502-0000,Private      ,1294,10938,12232,15917,30643,46560
02108800,WARDS CORNER BEAUTY ACADEMY             ,VA,23505-0000,Proprietary  ,33,183,216,45,273,318
02111600,DANVILLE REGIONAL MEDICAL CENTER SCHOOL ,VA,24541-0000,Proprietary  ,6,14,20,40,87,127
02128700,CENTRAL SCHOOL OF PRACTICAL NURSING     ,VA,23502-2230,Public       ,6,22,28,20,96,116
02140000,RIVERSIDE SCHOOL OF HEALTH CAREERS      ,VA,23608-3802,Private      ,10,102,112,104,481,585
02175800,LYNCHBURG GENERAL HOSP SCH OF NURSG     ,VA,24501-0000,Private      ,23,43,66,88,175,263
02197600,WOODROW WILSON REHABILITATION CTR       ,VA,22939-0000,Public       ,11,10,21,14,17,31
02242400,HENRICO CTY ST MARYS HOSP PRAC NRSG     ,VA,23075-0000,Public       ,2,7,9,10,42,52
02247200,MEDSPA CAREERS INSTITUTE                ,VA,23606-0000,Proprietary  ,21,87,108,93,325,418
02304500,HERITAGE INSTITUTE                      ,VA,20111-0000,Proprietary  ,29,148,177,88,392,480
02320900,TIDEWATER TECH                          ,VA,23517-0000,Proprietary  ,33,180,213,91,449,540
02334400,CENTURA COLLEGE                         ,VA,23452-0000,Proprietary  ,178,1142,1320,434,3658,4092
02342700,FORTIS COLLEGE                          ,VA,23502-4101,Proprietary  ,34,106,140,107,357,464
02342701,FORTIS COLLEGE - RICHMOND CAMPUS        ,VA,23236-3472,Proprietary  ,44,120,164,112,298,410
02358500,BON SECOURS SAINT MARY'S HOSPITAL SCHOOL,VA,23227-4612,Private      ,6,23,29,10,46,56
02535400,ECPI TECHNICAL COLLEGE                  ,VA,23236-0000,Proprietary  ,76,192,268,260,562,822
02538800,SUFFOLK BEAUTY ACADEMY                  ,VA,23434-0000,Proprietary  ,6,37,43,13,55,68
02541200,STRATFORD UNIVERSITY                    ,VA,22043-0000,Proprietary  ,48,261,309,127,604,731
02541201,STRATFORD UNIVERSITY-WOODBRIDGE         ,VA,22192-0000,Proprietary  ,16,74,90,50,187,237
02610100,WASHINGTON COUNTY ADULT SKILL CTR       ,VA,24210-2346,Public       ,5,41,46,24,106,130
03002400,GRAHAM WEBB INTERNATIONAL ACAD HAIR     ,VA,22209-2129,Proprietary  ,27,57,84,44,86,130
03010700,BAR PALMA BEAUTY CAREERS  ACADEMY       ,VA,24014-2255,Proprietary  ,10,50,60,23,67,90
03042800,"VIRGINIA BEACH CITY SCHOOLS, SCH.-PR.NSG",VA,23456-0038,Public       ,10,22,32,25,62,87
03091100,ACT COLLEGE                             ,VA,22209-2297,Proprietary  ,39,191,230,79,340,419
03091300,REGENT UNIVERSITY                       ,VA,23464-9800,Private      ,105,1389,1494,688,5434,6122
03092700,ECPI TECHNICAL COLLEGE-ROANOKE          ,VA,24012-1603,Proprietary  ,35,168,203,115,493,608
03096500,SPRINGFIELD BEAUTY ACADEMY              ,VA,22003-3016,Proprietary  ,4,52,56,6,82,88
03106500,SENTARA NORFOLK GENERAL HOSPITAL        ,VA,23320-2843,Private      ,24,117,141,119,483,602
03116900,BAPTIST THEOLOGICAL SEM.-RICHMOND       ,VA,23227-0000,Private      ,0,18,18,0,42,42
03126300,TIDEWATER TECH AVIATION                 ,VA,23320-5987,Proprietary  ,42,134,176,110,401,511
03126400,CENTURA COLLEGE                         ,VA,23235-5230,Proprietary  ,48,182,230,139,582,721
03126401,CENTURA COLLEGE - WEST                  ,VA,23294-0000,Proprietary  ,4,36,40,15,87,102
03127500,ADVANCED TECHNOLOGY INSTITUTE           ,VA,23462-2409,Proprietary  ,141,213,354,470,515,985
03280400,VIRGINIA SCHOOL OF MASSAGE              ,VA,22903-0000,Proprietary  ,26,44,70,55,132,187
03409500,RICHMOND SCHOOL OF HEALTH AND TECH      ,VA,23227-0000,Proprietary  ,28,170,198,114,704,818
03455300,CRESCENT COSMETOLOGY UNIVERSITY         ,VA,23666-3115,Proprietary  ,1,8,9,4,20,24
03559300,APPALACHIAN SCHOOL OF LAW               ,VA,24614-0000,Private      ,0,75,75,6,720,726
03638400,TAP THIS VALLEY WORKS CTR FOR EMPLO     ,VA,24016-1901,Private      ,1,4,5,1,8,9
03645400,RUDY & KELLY ACADEMY OF HAIR AND NA     ,VA,23464-6857,Proprietary  ,47,65,112,98,173,271
03654300,CAREER TRAINING SOLUTIONS               ,VA,22406-1014,Proprietary  ,22,122,144,53,338,391
03709300,EDWARD VIA VIRGINIA CLG OSTEOPATHIC MED ,VA,24060-6360,Private      ,0,63,63,5,740,745
03872400,INSTITUTE FOR THE PSYCHOLOGICAL SCIENCES,VA,22202-3609,Private      ,1,10,11,4,100,104
03876300,CULPEPER COSMETOLOGY TRAINING CENTER    ,VA,22701-3155,Public       ,5,14,19,10,31,41
03883400,AVIATION INSTITUTE OF MAINTENANCE       ,VA,20110-4156,Proprietary  ,21,90,111,58,220,278
04038400,AVI CAREER INSTITUTE                    ,VA,22066-1839,Proprietary  ,3,41,44,5,63,68
04124000,DOMINION SCHOOL OF HAIR DESIGN          ,VA,23062-2221,Proprietary  ,3,10,13,8,26,34
04127300,COLUMBIA COLLEGE                        ,VA,22031-4413,Proprietary  ,2,35,37,2,46,48
04133400,CENTURA COLLEGE                         ,VA,22312-2670,Proprietary  ,9,39,48,19,83,102
04133800,SOUTHEAST CULINARY & HOSPITALITY COLLEGE,VA,24201-4159,Proprietary  ,10,27,37,42,58,100
04137300,CAYCE/REILLY SCHOOL OF MASSOTHERAPY     ,VA,23451-2061,Private      ,5,34,39,5,34,39
04140000,GLOBAL HEALTH NURSE TRAINING SERVICES   ,VA,22314-4585,Proprietary  ,5,63,68,17,183,200
00107000,THUNDERBIRD SCHOOL OF GLOBAL MANAGEMENT ,AZ,85306-6000,Private      ,2,208,210,7,792,799
00107100,ARIZONA WESTERN COLLEGE                 ,AZ,85366-0000,Public       ,676,1127,1803,3436,3793,7229
00107200,COCHISE COLLEGE                         ,AZ,85607-6190,Public       ,348,709,1057,1166,1941,3107
00107300,EASTERN ARIZONA COLLEGE                 ,AZ,85552-0769,Public       ,292,557,849,1206,1393,2599
00107400,GRAND CANYON UNIVERSITY                 ,AZ,85017-3030,Proprietary  ,610,10182,10792,2742,39559,42301
00107600,GLENDALE COMMUNITY COLLEGE              ,AZ,85302-3090,Public       ,1799,2802,4601,6894,8458,15352
00107700,MESA COMMUNITY COLLEGE                  ,AZ,85202-4866,Public       ,2357,4040,6397,7953,11798,19751
00107800,PHOENIX COLLEGE                         ,AZ,85013-4234,Public       ,1082,2546,3628,3772,7489,11261
00107900,YAVAPAI COLLEGE                         ,AZ,86301-3297,Public       ,319,812,1131,1640,2819,4459
00108100,ARIZONA STATE UNIV (ALL CAMPUSES)       ,AZ,85287-0412,Public       ,4362,5713,10075,38780,28696,67476
00108200,NORTHERN ARIZONA UNIVERSITY             ,AZ,86011-0001,Public       ,1306,2455,3761,18399,10846,29245
00108300,UNIVERSITY OF ARIZONA                   ,AZ,85721-0066,Public       ,1930,1886,3816,24034,13176,37210
00165701,MIDWESTERN UNIVERSITY                   ,AZ,85308-0000,Private      ,10,161,171,71,2771,2842
00446700,TUCSON COLLEGE                          ,AZ,85711-3781,Proprietary  ,47,182,229,125,477,602
00711300,SOUTHWESTERN COLLEGE                    ,AZ,85032-7097,Private      ,73,59,132,391,186,577
00726600,PIMA COUNTY COMMUNITY COLLEGE           ,AZ,85709-1110,Public       ,2235,4431,6666,8441,13373,21814
00728300,CENTRAL ARIZONA COLLEGE                 ,AZ,85228-9779,Public       ,597,1240,1837,1883,3221,5104
00822100,UNIVERSAL TECHNICAL INSTITUTE           ,AZ,85323-7946,Proprietary  ,1548,1525,3073,8652,5572,14224
00824600,DINè COLLEGE                            ,AZ,86556-0126,Public       ,300,497,797,704,1049,1753
00830300,GATEWAY COMMUNITY COLLEGE               ,AZ,85034-1795,Public       ,420,1667,2087,1384,4703,6087
00830302,MARICOPA SKILL CENTER                   ,AZ,85034-0000,Public       ,144,520,664,397,1336,1733
00830400,SCOTTSDALE COMMUNITY COLLEGE            ,AZ,85250-0000,Public       ,706,1086,1792,2838,3273,6111
00886400,ARIZONA ACADEMY OF BEAUTY               ,AZ,85712-5021,Proprietary  ,2,26,28,15,64,79
00886500,ARTISTIC BEAUTY COLLEGES-TUCSON         ,AZ,85716-3999,Proprietary  ,36,63,99,150,306,456
00886501,ARTISTIC BEAUTY COLLEGES - TUCSON  - NOR,AZ,85705-1665,Proprietary  ,0,4,4,4,18,22
00945100,BROWN MACKIE COLLEGE                    ,AZ,85712-5300,Proprietary  ,211,1005,1216,479,2591,3070
01084700,ARIZONA AUTOMOTIVE INSTITUTE            ,AZ,85301-3503,Proprietary  ,189,542,731,386,1192,1578
01085800,AVALON SCHOOL OF COSMETOLOGY            ,AZ,85210-4010,Proprietary  ,68,134,202,138,307,445
01168900,REFRIGERATION SCHOOL                    ,AZ,85034-0000,Proprietary  ,63,415,478,110,717,827
01180200,ARIZONA ACADEMY OF BEAUTY-NORTH         ,AZ,85705-2720,Proprietary  ,5,24,29,13,51,64
01180800,ARTISTIC BEAUTY COLLEGES-FLAGSTAFF      ,AZ,86004-5119,Proprietary  ,40,78,118,123,320,443
01180801,CLG OF BEAUTY ARTS & SCI/CHANDLER       ,AZ,85224-0000,Proprietary  ,0,6,6,8,15,23
01180802,CLG OF BEAUTY ARTS & SCI/PRESCOTT       ,AZ,86303-0000,Proprietary  ,3,4,7,7,10,17
01186200,NORTHLAND PIONEER COLLEGE               ,AZ,86025-2996,Public       ,246,626,872,563,1423,1986
01186400,MOHAVE COMMUNITY COLLEGE                ,AZ,86409-1238,Public       ,507,1928,2435,1166,4583,5749
01218400,INTERNATIONAL ACAD OF HAIR DESIGN       ,AZ,85225-7198,Proprietary  ,22,49,71,74,144,218
01234300,ARTISTIC BEAUTY COLLEGES-PHOENIX        ,AZ,85304-0000,Proprietary  ,45,61,106,153,250,403
01234301,EMPIRE BEAUTY SCHOOL - AVONDALE         ,AZ,85323-2352,Proprietary  ,0,0,0,12,28,40
01293700,ARTISTIC BEAUTY COLLEGES - PARADISE VALL,AZ,85257-0000,Proprietary  ,12,24,36,39,68,107
02065200,ITT TECHNICAL INSTITUTE                 ,AZ,85282-0000,Proprietary  ,284,1076,1360,599,2246,2845
02065300,PRESCOTT COLLEGE                        ,AZ,86301-0000,Private      ,36,270,306,429,956,1385
02071200,KAPLAN COLLEGE                          ,AZ,85029-4349,Proprietary  ,94,427,521,364,1471,1835
02098800,UNIVERSITY OF PHOENIX                   ,AZ,85040-0000,Proprietary  ,10351,190415,200766,18044,345515,363559
02100500,UNIVERSAL TECHNICAL INSTITUTE           ,AZ,85027-0000,Proprietary  ,1282,1932,3214,7149,8177,15326
02100600,APOLLO COLLEGE                          ,AZ,85015-0000,Proprietary  ,624,1968,2592,1559,5199,6758
02113800,ROBERTO-VENN SCH OF LUTHIERY            ,AZ,85040-0000,Proprietary  ,6,23,29,27,60,87
02146600,SOUTH MOUNTAIN COMMUNITY COLLEGE        ,AZ,85040-0000,Public       ,531,1014,1545,1552,2556,4108
02171500,WESTERN INTERNATIONAL UNIVERSITY        ,AZ,85021-0000,Proprietary  ,17,792,809,51,1712,1763
02174900,COLLINS COLLEGE                         ,AZ,85040-4000,Proprietary  ,205,219,424,1072,924,1996
02177500,RIO SALADO COMMUNITY COLLEGE            ,AZ,85281-0000,Public       ,531,4378,4909,1204,9868,11072
02190702,RETS COLLEGE - FORTIS COLLEGE-PHOENIX   ,AZ,85006-3759,Proprietary  ,0,6,6,2,12,14
02192300,MARICOPA BEAUTY COLLEGE                 ,AZ,85323-0000,Proprietary  ,21,47,68,48,92,140
02199900,AMERICAN INDIAN CLG-ASSEMBLIES GOD      ,AZ,85021-0000,Private      ,20,22,42,58,67,125
02217100,PIMA MEDICAL INSTITUTE                  ,AZ,85716-0000,Proprietary  ,830,2499,3329,1859,6543,8402
02218800,BROOKLINE COLLEGE                       ,AZ,85019-1600,Proprietary  ,126,620,746,312,1741,2053
02218804,BROOKLINE COLLEGE - MESA                ,AZ,85204-4448,Proprietary  ,40,187,227,61,299,360
02218805,BROOKLINE COLLEGE - TUCSON              ,AZ,85711-5444,Proprietary  ,60,281,341,97,419,516
02220300,ARTISTIC BEAUTY COLLEGES-GLENDALE       ,AZ,85051-0000,Proprietary  ,42,78,120,149,370,519
02263100,ANTHEM COLLEGE                          ,AZ,85014-0000,Proprietary  ,240,852,1092,521,2012,2533
02280500,CHARLES OF ITALY BEAUTY COLLEGE         ,AZ,86403-0000,Proprietary  ,3,28,31,19,57,76
02295000,EVEREST COLLEGE                         ,AZ,85021-1610,Proprietary  ,296,2593,2889,801,7643,8444
02295002,EVEREST COLLEGE - MESA                  ,AZ,85206-4704,Proprietary  ,63,343,406,125,754,879
02317800,AMERICAN INSTITUTE OF TECHNOLOGY        ,AZ,85043-0000,Proprietary  ,11,490,501,34,946,980
02361100,ITT TECHNICAL INSTITUTE                 ,AZ,85704-0000,Proprietary  ,308,736,1044,571,1511,2082
02491500,THE ART CENTER DESIGN COLLEGE           ,AZ,85716-0000,Proprietary  ,92,155,247,214,395,609
02521500,LAMSON COLLEGE                          ,AZ,85284-1141,Proprietary  ,37,171,208,101,416,517
02533200,FRANK LLOYD WRIGHT SCHOOL OF ARCHITECTUR,AZ,85261-4430,Private      ,1,11,12,11,40,51
02559000,UNIVERSITY OF ADVANCING TECHNOLOGY      ,AZ,85283-0000,Proprietary  ,151,190,341,1008,621,1629
02561900,TONI AND GUY HAIRDRESSING ACADEMY       ,AZ,85251-3301,Proprietary  ,63,62,125,124,138,262
02582700,CORTIVA INSTITUTE - TUCSON              ,AZ,85710-3503,Proprietary  ,20,86,106,51,195,246
02616700,LE CORDON BLEU COLLEGE OF CULINARY ARTS ,AZ,85251-2729,Proprietary  ,267,729,996,949,1888,2837
02623600,PARADISE VALLEY COMMUNITY COLLEGE       ,AZ,85032-1210,Public       ,740,1136,1876,2357,3227,5584
02623800,CORTIVA INSTITUTE - SCOTTSDALE          ,AZ,85257-4218,Proprietary  ,19,59,78,47,167,214
03005000,SAFFORD COLLEGE OF BEAUTY CULTURE       ,AZ,85546-3309,Proprietary  ,13,39,52,15,41,56
03010613,VIRGINIA COLLEGE - GOLF ACADEMY OF ARIZO,AZ,85225-6742,Proprietary  ,28,76,104,126,219,345
03030604,UTAH COLLEGE OF MASSAGE THERAPY - ARIZON,AZ,85282-0000,Proprietary  ,42,100,142,118,306,424
03030605,UTAH COLLEGE OF MASSAGE THERAPY - ARIZON,AZ,85051-3470,Proprietary  ,75,123,198,134,246,380
03034400,CONSERVATORY RECORDING ARTS & SCIS      ,AZ,85282-1707,Proprietary  ,117,152,269,568,641,1209
03072200,CHANDLER-GILBERT COMMUNITY COLLEGE      ,AZ,85225-2499,Public       ,810,1155,1965,3172,3743,6915
03076400,BRYMAN SCHOOL OF ARIZONA                ,AZ,85029-4919,Proprietary  ,362,1019,1381,946,2928,3874
03097800,CARSTEN INSTITUTE OF HAIR & BEAUTY      ,AZ,85282-5404,Proprietary  ,27,70,97,65,164,229
03100400,COCONINO COUNTY COMMUNITY COLLEGE       ,AZ,86001-2701,Public       ,351,554,905,1003,1565,2568
03107000,SOUTHWEST CLG OF NATUROPATHIC MED       ,AZ,85282-0000,Private      ,1,92,93,8,407,415
03115000,ARIZONA COLLEGE OF ALLIED HEALTH        ,AZ,85302-3843,Proprietary  ,71,346,417,152,816,968
03120300,COLLEGE AMERICA                         ,AZ,86004-3936,Proprietary  ,92,326,418,149,605,754
03156300,ESTRELLA MOUNTAIN COMMUNITY COLLEGE     ,AZ,85392-1010,Public       ,644,1178,1822,2150,3196,5346
03156301,ESTRELLA MOUNTAIN COMMUNITY COLLEGE - SO,AZ,85392-1010,Public       ,201,449,650,636,1122,1758
03347300,INTERNATIONAL BAPTIST COLLEGE           ,AZ,85282-6799,Private      ,21,8,29,50,19,69
03445300,HDS TRUCK DRIVING INSTITUTE             ,AZ,85731-0000,Proprietary  ,0,23,23,0,36,36
03478400,PHOENIX SEMINARY                        ,AZ,85018-7611,Private      ,4,31,35,5,80,85
03572300,EAST VALLEY INSTITUTE OF TECHNOLOGY     ,AZ,85201-6910,Public       ,30,77,107,87,148,235
03593300,SOUTHWEST INSTITUTE OF HEALING ARTS     ,AZ,85281-3658,Proprietary  ,29,196,225,72,498,570
03617500,PHOENIX INSTITUTE OF HERBAL MEDICINE & A,AZ,85012-0000,Proprietary  ,0,45,45,6,150,156
03695500,ARIZONA SCHOOL OF ACUPUNCTURE AND ORIENT,AZ,85712-1100,Proprietary  ,0,15,15,4,61,65
03740500,ART INSTITUTE OF TUCSON (THE)           ,AZ,85712-2732,Proprietary  ,53,93,146,237,343,580
03784400,TOHONO O'ODHAM COMMUNITY COLLEGE        ,AZ,85634-3129,Public       ,8,47,55,15,79,94
03813300,NORTHCENTRAL UNIVERSITY                 ,AZ,86314-2336,Proprietary  ,3,917,920,3,917,920
03814300,TURNING POINT BEAUTY COLLEGE            ,AZ,85222-4229,Proprietary  ,11,25,36,16,57,73
04051300,ART INSTITUTE OF PHOENIX (THE)          ,AZ,85021-2859,Proprietary  ,247,369,616,1338,1333,2671
04059300,TUCSON COLLEGE OF BEAUTY                ,AZ,85705-2451,Proprietary  ,17,30,47,36,66,102
04120900,ARIZONA CULINARY INSTITUTE              ,AZ,85259-4939,Proprietary  ,30,78,108,151,197,348
04131400,PHOENIX SCHOOL OF LAW                   ,AZ,85012-3330,Proprietary  ,2,148,150,11,923,934
04138800,MODERN TECHNIQUES BEAUTY COLLEGE        ,AZ,86403-2974,Proprietary  ,4,7,11,9,23,32
04152900,STUDIO ACADEMY OF BEAUTY (THE)          ,AZ,85224-3600,Proprietary  ,15,32,47,23,40,63
00142800,DELAWARE STATE UNIVERSITY               ,DE,19901-2277,Public       ,404,386,790,6608,1770,8378
00142900,GOLDEY BEACOM COLLEGE                   ,DE,19808-1993,Private      ,73,124,197,467,341,808
00143100,UNIVERSITY OF DELAWARE                  ,DE,19716-0099,Public       ,721,422,1143,21787,2631,24418
00143300,WESLEY COLLEGE                          ,DE,19901-3875,Private      ,154,99,253,2325,491,2816
00143301,WESLEY COLLEGE-CTR FOR ADULT STUDIE     ,DE,19720-0000,Private      ,9,80,89,26,320,346
00331301,WIDENER UNIV SCHOOL OF LAW - DE         ,DE,19803-0000,Private      ,4,132,136,40,1768,1808
00705300,DELAWARE TECH & CMTY COLLEGE-OWENS      ,DE,19947-0000,Public       ,409,810,1219,1807,2345,4152
00794800,WILMINGTON UNIVERSITY                   ,DE,19720-6491,Private      ,469,1923,2392,1840,5388,7228
01172700,DELAWARE TECH & CMTY CLG-TERRY          ,DE,19901-8736,Public       ,305,603,908,1503,1889,3392
02125200,BEEBE SCHOOL OF NURSING                 ,DE,19958-1462,Private      ,4,9,13,41,69,110
02144900,DELAWARE TECH & CMTY CLG-STANTN/WLM     ,DE,19801-0000,Public       ,618,938,1556,2991,3220,6211
02190400,SCHILLING DOUGLAS SCH OF HAIR DSGN      ,DE,19711-0000,Proprietary  ,18,45,63,53,114,167
02586902,STAR TECHNICAL INSTITUTE -              ,DE,19901-4615,Proprietary  ,2,8,10,3,36,39
03025800,DAWN TRAINING CENTRE                    ,DE,19805-1511,Proprietary  ,23,115,138,51,340,391
03543300,HARRIS SCHOOL OF BUSINESS               ,DE,19803-5341,Proprietary  ,71,267,338,118,453,571
03702300,DELAWARE LEARNING INSTITUTE OF COSMETOLO,DE,19939-9759,Proprietary  ,17,52,69,45,109,154
04130700,ACADEMY OF MASSAGE AND BODYWORK         ,DE,19701-1321,Proprietary  ,3,21,24,6,37,43
04139800,DELAWARE COLLEGE OF ART & DESIGN        ,DE,19801-3007,Private      ,34,22,56,355,78,433
        ,FEDERAL STUDENT AID USE ONLY            ,DC,20202-0000,,0,0,0,2,116,118
00143400,AMERICAN UNIVERSITY                     ,DC,20016-8020,Private      ,159,677,836,11870,10631,22501
00143700,CATHOLIC UNIVERSITY OF AMERICA          ,DC,20064-0002,Private      ,222,450,672,4801,2428,7229
00143711,"CATHOLIC UNIV AMERICA, LAW SCHOOL       ",DC,20064-0000,Private      ,3,147,150,40,1731,1771
00144100,UNIV OF THE DISTRICT OF COLUMBIA        ,DC,20008-0000,Public       ,397,1036,1433,2202,4498,6700
00144102,UNIVERSITY OF THE DISTRICT OF COLUMBIA -,DC,20008-1173,Public       ,10,69,79,51,893,944
00144300,GALLAUDET UNIVERSITY                    ,DC,20002-3695,Private      ,127,152,279,799,810,1609
00144400,GEORGE WASHINGTON UNIVERSITY            ,DC,20052-2353,Private      ,300,1348,1648,11795,10089,21884
00144402,GEORGE WASHINGTON UNIV LAW SCHL         ,DC,20052-0000,Private      ,2,175,177,33,5039,5072
00144403,GEORGE WASHINGTON UNIV SCH MED          ,DC,20052-0000,Private      ,7,51,58,51,1574,1625
00144500,GEORGETOWN UNIVERSITY                   ,DC,20057-1252,Private      ,249,523,772,12675,5272,17947
00144501,"GEORGETOWN UNIV, SCH OF MEDICINE        ",DC,20007-0000,Private      ,3,32,35,38,1084,1122
00144502,GEORGETOWN UNIVERSITY - GRADUATE SCHOOL ,DC,20057-0004,Private      ,4,414,418,15,1785,1800
00144503,GEORGETOWN UNIV LAW CENTER              ,DC,20001-0000,Private      ,2,209,211,23,6143,6166
00144800,HOWARD UNIVERSITY                       ,DC,20059-0001,Private      ,923,1068,1991,13934,8570,22504
00145600,SOUTHEASTERN UNIVERSITY                 ,DC,20024-2788,Private      ,11,22,33,110,476,586
00145900,STRAYER UNIVERSITY                      ,DC,20005-2603,Proprietary  ,908,17625,18533,1824,43063,44887
00146000,TRINITY UNIVERSITY                      ,DC,20017-1004,Private      ,73,422,495,951,1887,2838
00146400,WESLEY THEOLOGICAL SEMINARY             ,DC,20016-0000,Private      ,0,60,60,2,280,282
00207701,JOHNS HOPKINS UNIV SCH ADV INTL STU     ,DC,20036-0000,Private      ,0,93,93,24,1402,1426
01006500,WASHINGTON THEOLOGICAL UNION            ,DC,20012-0000,Private      ,0,9,9,3,33,36
01195000,THE CORCORAN COLLEGE OF ART & DESIG     ,DC,20006-4804,Private      ,37,66,103,485,359,844
01280300,DOMINICAN HOUSE OF STUDIES              ,DC,20017-1584,Private      ,0,6,6,2,14,16
02132800,NAT'L CONSERVATORY DRAMATIC ARTS        ,DC,20007-2758,Private      ,0,12,12,6,33,39
02279200,DUDLEY BEAUTY COLG-WASHINGTON           ,DC,20018-0000,Proprietary  ,21,53,74,39,98,137
02588900,SANZ SCHOOL                             ,DC,20006-0000,Proprietary  ,117,538,655,228,994,1222
03104300,CAREER BLAZERS LEARNING CENTER OF WASHIN,DC,20037-1881,Proprietary  ,62,288,350,90,513,603
03218300,POTOMAC COLLEGE                         ,DC,20016-1860,Proprietary  ,20,237,257,49,543,592
03409600,BENNETT CAREER INSTITUTE                ,DC,20017-1754,Proprietary  ,36,89,125,74,211,285
03750300,TECHNICAL LEARNING CENTERS              ,DC,20005-3415,Proprietary  ,24,197,221,42,297,339
04114400,INSTITUTE OF WORLD POLITICS (THE)       ,DC,20036-1464,Private      ,0,63,63,0,63,63
04142700,PONTIFICAL JOHN PAUL II INSTITUTE FOR ST,DC,20064-0001,Private      ,0,13,13,0,19,19
00154100,ABRAHAM BALDWIN AGRICULTURAL CLG        ,GA,31794-0000,Public       ,612,484,1096,2997,1592,4589
00154200,AGNES SCOTT COLLEGE                     ,GA,30030-3797,Private      ,61,69,130,1266,357,1623
00154300,DARTON COLLEGE                          ,GA,31707-3098,Public       ,706,1607,2313,2822,4980,7802
00154400,ALBANY STATE UNIVERSITY                 ,GA,31705-2796,Public       ,755,1079,1834,6544,4040,10584
00154500,ANDREW COLLEGE                          ,GA,39840-1313,Private      ,36,21,57,373,60,433
00154600,ARMSTRONG ATLANTIC STATE UNIVERSITY     ,GA,31419-1997,Public       ,758,1405,2163,4433,5278,9711
00154700,ATLANTA CHRISTIAN COLLEGE               ,GA,30344-1999,Private      ,62,253,315,387,764,1151
00155200,AUGUSTA STATE UNIVERSITY                ,GA,30904-2200,Public       ,585,929,1514,4671,4800,9471
00155400,BERRY COLLEGE                           ,GA,30149-5007,Private      ,94,48,142,2432,267,2699
00155500,THOMAS UNIVERSITY                       ,GA,31792-7499,Private      ,73,387,460,291,1052,1343
00155600,BRENAU UNIVERSITY                       ,GA,30501-3668,Private      ,119,638,757,1097,2586,3683
00155700,BREWTON PARKER COLLEGE                  ,GA,30445-0000,Private      ,122,214,336,683,591,1274
00155800,COASTAL GEORGIA COMMUNITY COLLEGE       ,GA,31520-3644,Public       ,413,767,1180,1473,2569,4042
00155900,CLARK ATLANTA UNIVERSITY                ,GA,30314-4385,Private      ,1036,972,2008,12548,4583,17131
00156000,COLUMBIA THEOLOGICAL SEMINARY           ,GA,30031-0000,Private      ,0,29,29,1,199,200
00156100,COLUMBUS STATE UNIVERSITY               ,GA,31907-5645,Public       ,739,1206,1945,5408,4954,10362
00156200,GEORGIA PERIMETER COLLEGE               ,GA,30021-0000,Public       ,3640,5296,8936,13669,18639,32308
00156300,EMMANUEL COLLEGE                        ,GA,30639-0000,Private      ,117,45,162,718,210,928
00156400,EMORY UNIVERSITY                        ,GA,30322-1960,Private      ,287,953,1240,11021,9335,20356
00156600,FORT VALLEY STATE UNIVERSITY            ,GA,31030-3298,Public       ,603,497,1100,5575,1941,7516
00156700,GAINESVILLE STATE COLLEGE               ,GA,30503-0000,Public       ,1066,748,1814,5594,3035,8629
00156800,INTERDENOMINATIONAL THEOLOGY CENTER     ,GA,30314-0000,Private      ,0,135,135,3,535,538
00156900,GEORGIA INSTITUTE OF TECHNOLOGY         ,GA,30332-0002,Public       ,902,850,1752,14513,4483,18996
00157000,SOUTHERN POLYTECHNIC STATE UNIV         ,GA,30060-2896,Public       ,352,656,1008,2953,2534,5487
00157100,GEORGIA MILITARY COLLEGE                ,GA,31061-3398,Public       ,1210,1553,2763,3236,4180,7416
00157200,GEORGIA SOUTHERN UNIVERSITY             ,GA,30460-8065,Public       ,1604,1535,3139,17709,6255,23964
00157300,GEORGIA SOUTHWESTERN STATE UNIV         ,GA,31709-4693,Public       ,270,468,738,2136,1898,4034
00157400,GEORGIA STATE UNIVERSITY                ,GA,30303-3010,Public       ,2600,4615,7215,24187,24247,48434
00157500,GORDON COLLEGE                          ,GA,30204-1762,Public       ,845,613,1458,4489,2556,7045
00157700,KENNESAW STATE UNIVERSITY               ,GA,30144-5591,Public       ,1704,2653,4357,14123,12571,26694
00157800,LAGRANGE COLLEGE                        ,GA,30240-2999,Private      ,60,118,178,1166,573,1739
00157900,MEDICAL COLLEGE OF GEORGIA              ,GA,30912-0004,Public       ,87,359,446,590,2602,3192
00158000,MERCER UNIVERSITY                       ,GA,31207-0003,Private      ,342,1734,2076,4243,7858,12101
00158100,MIDDLE GEORGIA COLLEGE                  ,GA,31014-1599,Public       ,514,448,962,3328,1891,5219
00158200,MOREHOUSE COLLEGE                       ,GA,30314-3773,Private      ,644,267,911,5038,1063,6101
00158500,NORTH GEORGIA COLLEGE & STATE UNIV      ,GA,30597-0001,Public       ,417,403,820,3895,1907,5802
00158600,OGLETHORPE UNIVERSITY                   ,GA,30319-2737,Private      ,102,124,226,1666,536,2202
00158700,PAINE COLLEGE                           ,GA,30901-3182,Private      ,154,96,250,1572,523,2095
00158800,PIEDMONT COLLEGE                        ,GA,30535-5644,Private      ,123,589,712,872,2239,3111
00158900,REINHARDT COLLEGE                       ,GA,30183-2981,Private      ,154,140,294,919,445,1364
00159000,SAVANNAH STATE UNIVERSITY               ,GA,31404-5298,Public       ,847,657,1504,6126,2495,8621
00159100,SHORTER COLLEGE                         ,GA,30165-4298,Private      ,157,826,983,1732,2905,4637
00159200,SOUTH GEORGIA COLLEGE                   ,GA,31533-8104,Public       ,337,324,661,1540,1137,2677
00159400,SPELMAN COLLEGE                         ,GA,30314-4399,Private      ,410,195,605,6155,1243,7398
00159600,TOCCOA FALLS COLLEGE                    ,GA,30598-0001,Private      ,54,50,104,883,225,1108
00159700,TRUETT MCCONNELL COLLEGE                ,GA,30528-1264,Private      ,81,36,117,448,96,544
00159800,UNIVERSITY OF GEORGIA                   ,GA,30602-6114,Public       ,2229,2163,4392,21643,11146,32789
00159900,VALDOSTA STATE UNIVERSITY               ,GA,31698-0001,Public       ,1117,1256,2373,11560,5240,16800
00160000,WESLEYAN COLLEGE                        ,GA,31210-4407,Private      ,46,134,180,390,466,856
00160100,UNIV OF WEST GEORGIA                    ,GA,30118-0002,Public       ,929,1062,1991,9395,4963,14358
00160200,GEORGIA COLLEGE & STATE UNIVERSITY      ,GA,31061-0490,Public       ,611,526,1137,5393,2003,7396
00160400,YOUNG HARRIS COLLEGE                    ,GA,30582-4137,Private      ,67,20,87,899,77,976
00348400,COVENANT COLLEGE                        ,GA,30750-4164,Private      ,75,105,180,1233,397,1630
00395600,DALTON STATE COLLEGE                    ,GA,30720-3797,Public       ,512,862,1374,3310,3639,6949
00402300,APPALACHIAN TECHNICAL COLLEGE           ,GA,30143-0000,Public       ,59,225,284,229,755,984
00402400,GEORGIA NORTHWESTERN TECHNICAL COLLEGE  ,GA,30161-6757,Public       ,571,1948,2519,1409,4737,6146
00402403,NORTHWESTERN TECHNICAL COLLEGE          ,GA,30739-0569,Public       ,194,481,675,787,2402,3189
00411700,GRADY HEALTH SYSTEM                     ,GA,30303-3050,Public       ,9,108,117,76,368,444
00525400,LANIER TECHNICAL COLLEGE                ,GA,30566-3499,Public       ,271,1068,1339,894,3131,4025
00525500,MOULTRIE TECHNICAL COLLEGE              ,GA,31768-0000,Public       ,282,921,1203,707,2438,3145
00525600,VALDOSTA TECHNICAL COLLEGE              ,GA,31603-0000,Public       ,420,1349,1769,1087,3538,4625
00551100,OKEFENOKEE TECHNICAL COLLEGE            ,GA,31501-4016,Public       ,181,576,757,402,1507,1909
00559900,AUGUSTA TECHNICAL COLLEGE               ,GA,30906-3399,Public       ,667,2077,2744,1841,6017,7858
00560000,ATHENS TECHNICAL COLLEGE                ,GA,30601-1579,Public       ,740,1720,2460,2191,5142,7333
00560100,ALBANY TECHNICAL COLLEGE                ,GA,31701-2648,Public       ,563,1827,2390,1350,5123,6473
00561300,FLINT RIVER TECHNICAL INSTITUTE         ,GA,30286-0014,Public       ,81,441,522,202,1094,1296
00561401,WEST GEORGIA TECHNICAL COLLEGE - ROOSEVE,GA,31830-0268,Public       ,0,0,0,17,14,31
00561500,SOUTHWEST GEORGIA TECHNICAL COLLEGE     ,GA,31792-2622,Public       ,175,711,886,624,2208,2832
00561700,SOUTH GEORGIA TECHNICAL COLLEGE         ,GA,31709-8167,Public       ,357,842,1199,940,2039,2979
00561800,SAVANNAH TECHNICAL COLLEGE              ,GA,31405-5594,Public       ,842,2703,3545,2169,7388,9557
00561900,NORTH GEORGIA TECHNICAL COLLEGE         ,GA,30523-0000,Public       ,380,871,1251,1085,2495,3580
00562000,CHATTAHOOCHEE TECHNICAL COLLEGE         ,GA,30060-3398,Public       ,1090,2719,3809,2986,7704,10690
00562004,NORTH METRO TECHNICAL COLLEGE           ,GA,30102-3129,Public       ,314,607,921,1227,2621,3848
00562100,GRIFFIN TECHNICAL COLLEGE               ,GA,30223-2097,Public       ,498,1724,2222,1385,4861,6246
00562200,DEKALB TECHNICAL COLLEGE                ,GA,30021-0000,Public       ,673,2756,3429,1754,7771,9525
00562400,COLUMBUS TECHNICAL COLLEGE              ,GA,31904-6572,Public       ,515,1467,1982,1403,4213,5616
00576300,CENTRAL GEORGIA TECHNICAL COLLEGE       ,GA,31206-3628,Public       ,678,2695,3373,1840,7883,9723
00772800,MACON STATE COLLEGE                     ,GA,31206-5145,Public       ,633,1455,2088,3401,5440,8841
00854300,ATLANTA TECHNICAL COLLEGE               ,GA,30310-4499,Public       ,703,2558,3261,1998,7259,9257
00897600,CLAYTON STATE UNIVERSITY                ,GA,30260-0285,Public       ,738,2039,2777,4838,8293,13131
00918300,EAST CENTRAL TECHNICAL COLLEGE          ,GA,31750-0000,Public       ,122,486,608,317,1335,1652
00927000,ART INSTITUTE OF ATLANTA                ,GA,30328-1649,Proprietary  ,1273,1444,2717,7380,5774,13154
00950700,GEORGIA HIGHLANDS COLLEGE               ,GA,30162-0000,Public       ,703,784,1487,2995,2848,5843
01031903,MEDIX SCHOOL                            ,GA,30080-7630,Proprietary  ,93,361,454,253,889,1142
01035601,EVEREST INSTITUTE - DEKALB              ,GA,30035-3420,Proprietary  ,151,729,880,320,1381,1701
01048700,WEST GEORGIA TECHNICAL COLLEGE          ,GA,30182-6476,Public       ,708,1709,2417,1834,5242,7076
01048704,WEST GEORGIA TECHNICAL COLLEGE          ,GA,30240-5957,Public       ,159,475,634,639,1736,2375
01077100,GUPTON JONES COLLEGE                    ,GA,30035-4022,Private      ,36,133,169,134,354,488
01099700,EAST GEORGIA COLLEGE                    ,GA,30401-2699,Public       ,578,356,934,2346,1175,3521
01107400,BAINBRIDGE COLLEGE                      ,GA,39819-8400,Public       ,495,1494,1989,1216,3461,4677
01110901,EVEREST COLLEGE - EVEREST INSTITUTE     ,GA,30067-8340,Proprietary  ,59,365,424,135,858,993
01112301,EVEREST COLLEGE - EVEREST INSTITUTE- NOR,GA,30093-2813,Proprietary  ,74,377,451,191,1078,1269
01157400,BAUDER COLLEGE                          ,GA,30313-2439,Proprietary  ,176,395,571,767,1441,2208
01205100,PRO WAY HAIR SCHOOL                     ,GA,30083-2884,Proprietary  ,32,122,154,86,364,450
01216500,ATLANTA METROPOLITAN COLLEGE            ,GA,30310-4498,Public       ,637,1298,1935,2354,4156,6510
01303900,SOUTH UNIVERSITY                        ,GA,31406-4881,Proprietary  ,571,7298,7869,1462,20616,22078
02055000,WAYCROSS COLLEGE                        ,GA,31503-0000,Public       ,156,248,404,570,719,1289
02060900,BROWN CLG OF COURT REPORTING & M.T.     ,GA,30318-2570,Proprietary  ,12,115,127,33,368,401
02074800,LIFE UNIVERSITY                         ,GA,30060-0000,Private      ,62,263,325,337,2295,2632
02089700,HERZING COLLEGE                         ,GA,30326-1332,Proprietary  ,84,415,499,256,1175,1431
02110501,ART INSTITUTE OF CHARLOTTE (THE) - BROWN,GA,30319-3054,Proprietary  ,9,29,38,87,93,180
02113604,AMERICAN INTERCONTINENTAL UNIV - DUNWOOD,GA,30328-1649,Proprietary  ,0,0,0,98,284,382
02113613,AMERICAN INTERCONTINENTAL UNIVERSITY    ,GA,30328-1649,Proprietary  ,109,404,513,109,404,513
02116000,SANFORD-BROWN COLLEGE                   ,GA,30328-4803,Proprietary  ,88,534,622,289,1744,2033
02141500,SAVANNAH COLLEGE OF ART & DESIGN        ,GA,31402-3146,Private      ,911,713,1624,8915,3956,12871
02202800,AUGUSTA AREA DIET INTERN UNIV HOSP      ,GA,30901-0000,Private      ,0,8,8,4,31,35
02205300,SAVANNAH RIVER COLLEGE                  ,GA,30909-0000,Proprietary  ,1,2,3,19,84,103
02217200,PORTFOLIO CENTER                        ,GA,30309-0000,Proprietary  ,8,48,56,14,133,147
02263105,ANTHEM COLLEGE - HIGH-TECH INSTITUTE - M,GA,30324-3398,Proprietary  ,3,11,14,10,28,38
02266200,AMERICAN PROFESSIONAL INSTITUTE         ,GA,31201-3185,Proprietary  ,121,623,744,243,1600,1843
02279500,HEART OF GEORGIA TECHNICAL COLLEGE      ,GA,31021-0000,Public       ,148,471,619,473,1438,1911
02284300,INTERACTIVE COLLEGE OF TECHNOLOGY       ,GA,30341-0000,Proprietary  ,83,682,765,167,1451,1618
02284308,INTERACTIVE LEARNING SYSTEMS            ,GA,30260-0000,Proprietary  ,15,114,129,32,233,265
02284309,INTERACTIVE COLLEGE OF TECHNOLOGY       ,GA,30501-0000,Proprietary  ,9,146,155,27,246,273
02285500,"CREATIVE CIRCUS, THE                    ",GA,30324-0000,Proprietary  ,18,62,80,65,225,290
02288400,GWINNETT TECHNICAL INSTITUTE            ,GA,30043-5702,Public       ,859,2310,3169,2788,7832,10620
02313902,WESTWOOD COLLEGE - O'HARE AIRPORT - ATLA,GA,30345-2807,Proprietary  ,100,231,331,319,677,996
02321400,ROFFLER-MOLER HAIRSTYLING COLLEGE       ,GA,30062-0000,Proprietary  ,11,69,80,28,147,175
02354500,SOUTHEASTERN BEAUTY SCHOOLS             ,GA,31906-0000,Proprietary  ,7,22,29,12,70,82
02482100,MOREHOUSE SCHOOL OF MEDICINE            ,GA,30310-0000,Private      ,10,39,49,110,621,731
02502700,ADVANCED CAREER TRAINING                ,GA,30329-0000,Proprietary  ,65,430,495,146,927,1073
02502701,ADVANCED CAREER TRAINING-RIVERDALE      ,GA,30274-0000,Proprietary  ,94,330,424,158,652,810
02508600,MIDDLE GEORGIA TECHNICAL COLLEGE        ,GA,31088-0000,Public       ,372,1012,1384,871,2753,3624
02520000,INTERNATIONAL SCH SKIN & NAILCARE       ,GA,30342-1119,Proprietary  ,14,136,150,26,235,261
02577000,ARNOLD / PADRICKS  UNIV OF COSM         ,GA,30297-0000,Proprietary  ,33,89,122,66,188,254
02577700,BEAUTY COLLEGE OF AMERICA               ,GA,30297-0000,Proprietary  ,13,46,59,27,93,120
02578300,INTERNATIONAL CITY BEAUTY COLLEGE       ,GA,31093-3631,Proprietary  ,2,10,12,9,23,32
02580200,ATLANTA SCHOOL OF MASSAGE               ,GA,30338-0000,Proprietary  ,22,122,144,66,265,331
02583000,GWINNETT COLLEGE OF BUSINESS            ,GA,30047-3447,Proprietary  ,39,195,234,124,637,761
02607600,CAPELLI LEARNING CTR FOR COSM           ,GA,30324-0000,Proprietary  ,23,79,102,65,234,299
03005400,ARTISTIC BEAUTY COLLEGE                 ,GA,30013-2076,Proprietary  ,107,309,416,246,627,873
03022601,WESTERN CULINARY INSTITUTE - LE CORDON B,GA,30084-5893,Proprietary  ,41,92,133,186,265,451
03030000,OGEECHEE TECHNICAL COLLEGE              ,GA,30458-8049,Public       ,431,996,1427,1155,2674,3829
03032100,ALTAMAHA TECHNICAL COLLEGE              ,GA,31545-4465,Public       ,169,621,790,380,1430,1810
03042700,LAURUSTECHNICAL INSTITUTE               ,GA,30030-1506,Proprietary  ,30,206,236,65,476,541
03066500,SOUTHEASTERN TECHNICAL COLLEGE          ,GA,30474-8817,Public       ,177,552,729,433,1495,1928
03066502,SWAINSBORO TECHNICAL COLLEGE            ,GA,30401-5700,Public       ,67,189,256,194,646,840
03072304,EVEREST COLLEGE - EVEREST INSTITUTE     ,GA,30236-0000,Proprietary  ,97,492,589,205,1082,1287
03076300,BEULAH HEIGHTS BIBLE COLLEGE            ,GA,30316-1873,Private      ,21,329,350,44,736,780
03079202,WESTWOOD COLLEGE - ATLANTA MIDTOWN      ,GA,30309-2848,Proprietary  ,182,489,671,671,1262,1933
03081500,SOUTHEASTERN BEAUTY SCHOOL              ,GA,31917-0000,Proprietary  ,7,34,41,12,86,98
03089100,GEORGIA INSTITUTE OF COSMETOLOGY        ,GA,30606-3152,Proprietary  ,57,181,238,97,269,366
03090600,COBB BEAUTY COLLEGE                     ,GA,30144-2828,Proprietary  ,7,35,42,17,56,73
03100900,LUTHER RICE UNIVERSITY                  ,GA,30038-2454,Private      ,9,190,199,29,660,689
03102000,RIVERTOWN SCHOOL OF BEAUTY              ,GA,31904-4747,Proprietary  ,18,90,108,29,127,156
03104500,ATLANTA INSTITUTE OF MUSIC              ,GA,30096-4988,Proprietary  ,76,70,146,194,165,359
03116100,VOGUE BEAUTY SCHOOL                     ,GA,30141-2226,Proprietary  ,14,53,67,29,98,127
03155500,SANDERSVILLE REGIONAL TECH INST         ,GA,31082-6179,Public       ,98,339,437,217,760,977
03173300,ATLANTA'S JOHN MARSHALL LAW SCHOOL      ,GA,30309-0000,Proprietary  ,5,203,208,16,1290,1306
03232304,LINCOLN COLLEGE OF TECHNOLOGY           ,GA,30067-8638,Proprietary  ,73,229,302,159,486,645
03251300,BEACON UNIVERSITY                       ,GA,31909-4663,Private      ,1,49,50,15,103,118
03418300,GWINNETT COLLEGE-SANDY SPRINGS          ,GA,30328-3161,Proprietary  ,12,128,140,25,199,224
03445500,FAYETTE BEAUTY ACADEMY                  ,GA,30214-1191,Proprietary  ,5,33,38,16,66,82
03523300,AVIATION INSTITUTE OF MAINTENANCE       ,GA,30045-6716,Proprietary  ,64,157,221,176,612,788
03753400,MICHAEL'S SCHOOL OF BEAUTY              ,GA,31211-1493,Proprietary  ,11,55,66,28,123,151
03804400,JAVELIN TECHNICAL TRAINING CENTER       ,GA,30339-6040,Proprietary  ,123,619,742,311,1400,1711
03804401,JAVELIN TECHNICAL TRAINING CENTER -     ,GA,30260-1756,Proprietary  ,3,52,55,11,105,116
03804402,JAVELIN TECHNICAL TRAINING CENTER -     ,GA,30084-5252,Proprietary  ,2,40,42,15,75,90
03812300,OMNITECH INSTITUTE                      ,GA,30035-1206,Proprietary  ,51,153,204,126,386,512
04021300,AUGUSTA SCHOOL OF MASSAGE               ,GA,30809-0000,Proprietary  ,7,24,31,13,44,57
04091300,SAVANNAH SCHOOL OF MASSAGE THERAPY      ,GA,31406-2711,Private      ,4,20,24,9,45,54
04126800,ACADEMY OF SOMATIC HEALING ARTS (ASHA)  ,GA,30071-1024,Proprietary  ,9,55,64,23,151,174
04128500,SOUTHERN CATHOLIC COLLEGE               ,GA,30534-3111,Private      ,19,2,21,169,20,189
04142900,GEORGIA GWINNETT COLLEGE                ,GA,30043-7409,Public       ,553,682,1235,1691,1736,3427
04147000,PAUL MITCHELL THE SCHOOL ATLANTA        ,GA,30318-5241,Proprietary  ,52,84,136,122,237,359
04147700,LAKE LANIER SCHOOL OF MASSAGE           ,GA,30501-4546,Proprietary  ,5,28,33,5,29,34
04149900,PROFILE INSTITUTE OF BARBER-STYLING     ,GA,30315-8459,Proprietary  ,3,8,11,3,8,11
04150900,PROCESS INSTITUTE OF COSMETOLOGY (THE)  ,GA,30043-7344,Proprietary  ,15,16,31,15,16,31
04152300,GEORGIA BEAUTY ACADEMY                  ,GA,30721-3952,Proprietary  ,5,21,26,5,21,26
        ,CHICAGO THEOLOGICAL SEMINARY            ,IL,60637-0000,Private      ,0,0,0,0,4,4
00162800,AMERICAN ACADEMY OF ART                 ,IL,60604-4302,Proprietary  ,59,35,94,596,146,742
00163300,AUGUSTANA COLLEGE                       ,IL,61201-2296,Private      ,61,24,85,3621,153,3774
00163400,AURORA UNIVERSITY                       ,IL,60506-4892,Private      ,162,636,798,2391,2396,4787
00163600,SOUTHWESTERN ILLINOIS COLLEGE           ,IL,62221-5899,Public       ,1124,2254,3378,3524,5889,9413
00163800,BLACK HAWK COLLEGE                      ,IL,61265-5899,Public       ,453,871,1324,1849,2655,4504
00163900,BLACKBURN COLLEGE                       ,IL,62626-1498,Private      ,44,26,70,813,150,963
00164000,PRAIRIE STATE COLLEGE                   ,IL,60411-8226,Public       ,646,1262,1908,2160,3845,6005
00164100,BRADLEY UNIVERSITY                      ,IL,61625-0002,Private      ,210,147,357,6632,1062,7694
00164300,SPOON RIVER COLLEGE                     ,IL,61520-8907,Public       ,148,178,326,695,737,1432
00164700,CITY COLLEGES OF CHICAGO                ,IL,60606-6998,Public       ,64,170,234,451,682,1133
00164800,TRUMAN COLLEGE                          ,IL,60640-5691,Public       ,587,1378,1965,2688,4485,7173
00164900,RICHARD J DALEY COLLEGE                 ,IL,60652-1299,Public       ,716,1305,2021,2398,3772,6170
00165000,CITY COLLEGES OF CHICAGO-MALCOLM X      ,IL,60612-3197,Public       ,692,1872,2564,2506,5611,8117
00165200,HAROLD WASHINGTON COLLEGE               ,IL,60601-2403,Public       ,1367,1909,3276,5075,6040,11115
00165400,KENNEDY KING COLLEGE                    ,IL,60621-3798,Public       ,929,3009,3938,3302,8352,11654
00165500,WRIGHT COLLEGE                          ,IL,60634-1591,Public       ,1076,1493,2569,4446,4790,9236
00165700,MIDWESTERN UNIVERSITY                   ,IL,60515-1200,Private      ,5,167,172,111,2709,2820
00165900,ROSALIND FRANKLIN UNIVERSITY OF MEDICINE,IL,60064-3095,Private      ,3,113,116,18,2073,2091
00166100,CHICAGO THEOLOGICAL SEMINARY            ,IL,60637-0000,Private      ,0,32,32,5,154,159
00166300,SPERTUS COLLEGE                         ,IL,60605-1995,Private      ,0,33,33,1,79,80
00166400,UNIVERSITY OF ST FRANCIS                ,IL,60435-6188,Private      ,58,386,444,1462,1646,3108
00166500,COLUMBIA COLLEGE                        ,IL,60605-1996,Private      ,1252,732,1984,12537,4743,17280
00166600,CONCORDIA UNIVERSITY                    ,IL,60305-1499,Private      ,102,717,819,1936,3201,5137
00166900,DANVILLE AREA COMMUNITY COLLEGE         ,IL,61832-5199,Public       ,235,578,813,842,1739,2581
00167100,DEPAUL UNIVERSITY                       ,IL,60604-2287,Private      ,953,2813,3766,16229,14659,30888
00167400,EASTERN ILLINOIS UNIVERSITY             ,IL,61920-3099,Public       ,1044,655,1699,10284,3368,13652
00167500,ELGIN COMMUNITY COLLEGE                 ,IL,60123-7193,Public       ,712,849,1561,2866,3319,6185
00167600,ELMHURST COLLEGE                        ,IL,60126-3296,Private      ,251,207,458,3521,1021,4542
00167800,EUREKA COLLEGE                          ,IL,61530-9976,Private      ,26,23,49,958,223,1181
00168100,HIGHLAND COMMUNITY COLLEGE              ,IL,61032-9341,Public       ,207,429,636,832,1109,1941
00168200,GARRETT-EVANGELICAL THEOLOGICAL SEM     ,IL,60201-0000,Private      ,0,51,51,0,191,191
00168400,GREENVILLE COLLEGE                      ,IL,62246-1199,Private      ,81,198,279,1534,761,2295
00168500,HEBREW THEOLOGICAL COLLEGE              ,IL,60077-3263,Private      ,43,8,51,340,19,359
00168800,ILLINOIS COLLEGE                        ,IL,62650-2299,Private      ,21,14,35,1370,90,1460
00168900,ILLINOIS COLLEGE OF OPTOMETRY           ,IL,60616-3878,Private      ,1,22,23,9,661,670
00169100,ILLINOIS INSTITUTE OF TECHNOLOGY        ,IL,60616-0000,Private      ,193,455,648,2648,2038,4686
00169103,CHICAGO KENT COLLEGE OF LAW             ,IL,60661-0000,Private      ,4,168,172,18,2278,2296
00169200,ILLINOIS STATE UNIVERSITY               ,IL,61790-1000,Public       ,1142,616,1758,18334,4545,22879
00169300,NORTHEASTERN ILLINOIS UNIV              ,IL,60625-4699,Public       ,629,1363,1992,5541,6699,12240
00169400,CHICAGO STATE UNIVERSITY                ,IL,60628-1598,Public       ,747,2429,3176,5917,10483,16400
00169600,ILLINOIS WESLEYAN UNIVERSITY            ,IL,61701-0000,Private      ,63,16,79,3102,114,3216
00169800,JOHN MARSHALL LAW SCHOOL                ,IL,60604-0000,Private      ,3,343,346,17,2479,2496
00169900,JOLIET JUNIOR COLLEGE                   ,IL,60431-8938,Public       ,980,1333,2313,5284,5322,10606
00170000,JUDSON UNIVERSITY                       ,IL,60123-1498,Private      ,44,163,207,872,760,1632
00170100,KASKASKIA COLLEGE                       ,IL,62801-7878,Public       ,348,741,1089,1339,2165,3504
00170300,KENDALL COLLEGE                         ,IL,60622-4278,Proprietary  ,155,508,663,1102,2059,3161
00170400,KNOX COLLEGE                            ,IL,61401-4999,Private      ,26,20,46,2208,103,2311
00170500,ILLINOIS VALLEY COMMUNITY COLLEGE       ,IL,61348-9692,Public       ,252,492,744,1255,1598,2853
00170600,LAKE FOREST COLLEGE                     ,IL,60045-2399,Private      ,49,22,71,1762,131,1893
00170700,LEWIS UNIVERSITY                        ,IL,60446-2200,Private      ,379,786,1165,3900,2854,6754
00170800,LINCOLN CHRISTIAN UNIVERSITY            ,IL,62656-2167,Private      ,63,128,191,452,535,987
00170900,LINCOLN COLLEGE                         ,IL,62656-1699,Private      ,141,106,247,1227,561,1788
00171000,LOYOLA UNIVERSITY CHICAGO               ,IL,60626-0000,Private      ,561,1379,1940,16336,10123,26459
00171002,LOYOLA STRITCH SCHOOL OF MEDICINE       ,IL,60153-0000,Private      ,3,16,19,33,529,562
00171200,LUTHERAN SCHOOL OF THEOL AT CHICAGO     ,IL,60615-0000,Private      ,0,33,33,0,149,149
00171600,MACCORMAC COLLEGE                       ,IL,60602-4405,Private      ,14,54,68,46,142,188
00171700,MACMURRAY COLLEGE                       ,IL,62650-2590,Private      ,55,34,89,566,214,780
00172100,MCCORMICK THEOLOGICAL SEMINARY          ,IL,60615-5108,Private      ,0,20,20,1,142,143
00172200,MCKENDREE UNIVERSITY                    ,IL,62254-1299,Private      ,86,310,396,1680,1410,3090
00172300,MEADVILLE LOMBARD THEOLOGICAL SCHOOL    ,IL,60637-1602,Private      ,0,9,9,0,69,69
00172400,MILLIKIN UNIVERSITY                     ,IL,62522-2084,Private      ,103,131,234,2745,781,3526
00172500,MONMOUTH COLLEGE                        ,IL,61462-1963,Private      ,80,18,98,1928,117,2045
00172800,MORTON COLLEGE                          ,IL,60804-4398,Public       ,606,687,1293,1676,1770,3446
00173200,NATIONAL UNIV OF HEALTH SCIENCES        ,IL,60148-4583,Private      ,11,201,212,47,886,933
00173300,NATIONAL-LOUIS UNIVERSITY               ,IL,60603-3032,Private      ,68,1987,2055,323,6448,6771
00173400,NORTH CENTRAL COLLEGE                   ,IL,60540-4690,Private      ,123,206,329,3126,828,3954
00173500,NORTH PARK UNIVERSITY                   ,IL,60625-4895,Private      ,190,416,606,2419,1412,3831
00173600,NORTHERN BAPTIST THEOL SEMINARY         ,IL,60148-0000,Private      ,0,4,4,1,15,16
00173700,NORTHERN ILLINOIS UNIVERSITY            ,IL,60115-2854,Public       ,1652,1704,3356,20561,9179,29740
00173900,NORTHWESTERN UNIV                       ,IL,60208-0001,Private      ,297,1305,1602,16357,10526,26883
00174100,OLIVET NAZARENE UNIVERSITY              ,IL,60914-2271,Private      ,216,551,767,3181,1919,5100
00174200,IL EASTERN COMM COLGS-OLNEY CENTRAL     ,IL,62450-1099,Public       ,111,200,311,682,819,1501
00174500,QUINCY UNIVERSITY                       ,IL,62301-2699,Private      ,50,155,205,1384,978,2362
00174600,ROBERT MORRIS UNIVERSITY ILLINOIS       ,IL,60605-1225,Private      ,517,1174,1691,4529,5166,9695
00174700,ROCK VALLEY COLLEGE                     ,IL,61114-5699,Public       ,536,1233,1769,2845,4484,7329
00174800,ROCKFORD COLLEGE                        ,IL,61108-2393,Private      ,90,303,393,956,1071,2027
00174900,ROOSEVELT UNIVERSITY                    ,IL,60605-1394,Private      ,313,1450,1763,4242,7112,11354
00175000,DOMINICAN UNIVERSITY                    ,IL,60305-1066,Private      ,134,431,565,2331,1856,4187
00175200,SAUK VALLEY COMMUNITY COLLEGE           ,IL,61021-9112,Public       ,239,360,599,1026,1160,2186
00175300,SCHOOL OF ART INSTITUTE OF CHICAGO      ,IL,60603-3013,Private      ,206,207,413,3251,2410,5661
00175400,SEABURY-WESTERN THEO SEMINARY           ,IL,60201-0000,Private      ,0,4,4,0,7,7
00175600,SHIMER COLLEGE                          ,IL,60616-3893,Private      ,9,15,24,153,69,222
00175700,SOUTHEASTERN ILLINOIS COLLEGE           ,IL,62946-4925,Public       ,119,233,352,642,770,1412
00175800,SOUTHERN ILL UNIV-CARBONDALE            ,IL,62901-0000,Public       ,1458,1795,3253,14432,7941,22373
00175900,SOUTHERN ILL UNIV-EDWARDSVILLE          ,IL,62026-1060,Public       ,794,980,1774,10287,5432,15719
00175924,SO IL UNIV-SCHL OF DENTAL MEDICINE      ,IL,62002-0000,Public       ,1,5,6,10,189,199
00176100,SPRINGFIELD COLLEGE IN ILLINOIS         ,IL,62702-2694,Private      ,76,154,230,426,552,978
00176500,UNIVERSITY OF ST MARY OF THE LAKE       ,IL,60060-0000,Private      ,0,6,6,3,13,16
00176700,BENEDICTINE UNIVERSITY                  ,IL,60532-0900,Private      ,201,847,1048,2485,3273,5758
00176800,ST XAVIER UNIVERSITY                    ,IL,60655-3199,Private      ,265,775,1040,3855,3277,7132
00176900,SOUTH SUBURBAN COLLEGE                  ,IL,60473-9978,Public       ,939,2376,3315,2586,6303,8889
00177100,TRINITY CHRISTIAN COLLEGE               ,IL,60463-0929,Private      ,85,206,291,1178,821,1999
00177200,TRINITY INTERNATIONAL UNIVERSITY        ,IL,60015-1283,Private      ,88,321,409,818,1170,1988
00177300,TRITON COLLEGE                          ,IL,60171-1995,Public       ,1011,1573,2584,3365,4404,7769
00177400,UNIVERSITY OF CHICAGO                   ,IL,60637-1476,Private      ,254,345,599,10113,2476,12589
00177401,UNIV OF CHICAGO PRITZKER SCH OF MED     ,IL,60637-0000,Private      ,3,23,26,35,543,578
00177403,"UNIV OF CHICAGO, GRAD SCH OF BUS        ",IL,60637-0000,Private      ,1,383,384,32,1285,1317
00177405,UNIVERSITY OF CHICAGO GRADUATE          ,IL,60637-0000,Private      ,6,390,396,81,5703,5784
00177500,UNIV OF ILLINOIS @ URBANA-CHAMPAIGN     ,IL,61820-5796,Public       ,1641,987,2628,26331,8776,35107
00177600,UNIV OF ILLINOIS AT CHICAGO             ,IL,60607-7163,Public       ,1358,2109,3467,18960,14773,33733
00177800,VANDERCOOK COLLEGE OF MUSIC             ,IL,60616-3731,Private      ,10,12,22,154,82,236
00177900,IL EASTERN COMM COLGS-WABASH VALLEY     ,IL,62863-2699,Public       ,83,191,274,497,519,1016
00178000,WESTERN ILLINOIS UNIVERSITY             ,IL,61455-1390,Public       ,1094,817,1911,10212,3727,13939
00178100,WHEATON COLLEGE                         ,IL,60187-5535,Private      ,78,86,164,2634,599,3233
00178300,WORSHAM COLLEGE OF MORTUARY SCIENCE     ,IL,60090-2646,Proprietary  ,15,35,50,58,104,162
00396100,HARPER COLLEGE                          ,IL,60067-7398,Public       ,1144,1267,2411,4520,3804,8324
00418100,ADVOCATE TRINITY HOSPITAL SCHOOL OF RADI,IL,60617-3982,Private      ,1,25,26,21,77,98
00456000,GEM CITY COLLEGE                        ,IL,62301-4949,Proprietary  ,9,20,29,18,39,57
00456800,MIDSTATE COLLEGE                        ,IL,61614-3558,Proprietary  ,20,219,239,60,835,895
00457100,SPARKS COLLEGE                          ,IL,62565-2241,Proprietary  ,1,11,12,5,17,22
00512732,BROWN MACKIE COLLEGE-CINCINNATI - BROWN ,IL,61265-7062,Proprietary  ,3,16,19,10,61,71
00621400,BLESSING RIEMAN COLLEGE OF NURSING      ,IL,62301-0000,Private      ,8,12,20,69,66,135
00621401,BLESSING HOSP SCH MED LAB TECH          ,IL,62301-0000,Private      ,0,4,4,2,10,12
00621402,BLESSING HOSP SCH OF RAD TECH           ,IL,62301-2852,Private      ,1,3,4,12,15,27
00621403,BLESSING HOSPITAL - COLLEGE OF NURSING  ,IL,62305-7005,Private      ,1,3,4,16,18,34
00622501,TRINITY COLLEGE OF NURSING & HEALTH SCIE,IL,61201-5317,Private      ,11,46,57,75,204,279
00622800,METHODIST MED CTR OF ILL SCH NRSNG      ,IL,61636-0000,Private      ,10,25,35,112,225,337
00624000,ST FRANCIS MED CLG OF NRSG              ,IL,61603-3783,Private      ,12,39,51,157,335,492
00665600,COLLEGE OF DUPAGE                       ,IL,60137-6599,Public       ,1767,2052,3819,6964,6539,13503
00675300,ILLINOIS CENTRAL COLLEGE                ,IL,61635-0001,Public       ,799,1609,2408,3850,5080,8930
00693100,WAUBONSEE COMMUNITY COLLEGE             ,IL,60554-0000,Public       ,507,904,1411,1972,2685,4657
00711800,PARKLAND COLLEGE                        ,IL,61821-1899,Public       ,845,997,1842,3844,3472,7316
00711900,REND LAKE COLLEGE                       ,IL,62846-9801,Public       ,295,447,742,1235,1485,2720
00717000,LINCOLN LAND COMMUNITY COLLEGE          ,IL,62794-9256,Public       ,502,1036,1538,2203,3394,5597
00726500,CARL SANDBURG COLLEGE                   ,IL,61401-9576,Public       ,179,362,541,923,1530,2453
00754900,COYNE AMERICAN INSTITUTE                ,IL,60607-1300,Proprietary  ,138,437,575,317,1071,1388
00764400,LAKE LAND COLLEGE                       ,IL,61938-9366,Public       ,341,691,1032,2240,2344,4584
00768400,KISHWAUKEE COLLEGE                      ,IL,60150-9699,Public       ,419,453,872,1684,1658,3342
00769000,KANKAKEE COMMUNITY COLLEGE              ,IL,60901-6505,Public       ,297,682,979,1206,2220,3426
00769100,MCHENRY COUNTY COLLEGE                  ,IL,60012-2761,Public       ,558,521,1079,2798,1686,4484
00769200,MORAINE VALLEY COMMUNITY COLLEGE        ,IL,60465-0937,Public       ,1096,1241,2337,4638,4023,8661
00769300,SHAWNEE COMMUNITY COLLEGE               ,IL,62992-9725,Public       ,190,632,822,730,1333,2063
00769400,COLLEGE OF LAKE COUNTY                  ,IL,60030-1198,Public       ,1011,1461,2472,3276,4098,7374
00793700,MS ROBERTS ACADEMY OF BEAUTY CULT       ,IL,60181-2930,Proprietary  ,16,23,39,21,40,61
00807600,JOHN A LOGAN COLLEGE                    ,IL,62918-2500,Public       ,594,883,1477,2068,2450,4518
00814604,EVEREST UNIVERSITY - EVEREST  COLLEGE   ,IL,60803-4517,Proprietary  ,81,455,536,143,884,1027
00825900,EDUCATORS OF BEAUTY                     ,IL,61081-3611,Proprietary  ,19,39,58,56,132,188
00825901,EDUCATORS OF BEAUTY                     ,IL,61104-0000,Proprietary  ,2,12,14,14,31,45
00832800,ALVAREITA'S COLLEGE OF COSMETOLOGY      ,IL,62025-2041,Proprietary  ,11,24,35,37,69,106
00854500,ROCKFORD BUSINESS COLLEGE               ,IL,61103-0000,Proprietary  ,73,283,356,177,920,1097
00869402,RASMUSSEN COLLEGE - ROCKFORD            ,IL,61108-2513,Proprietary  ,75,294,369,269,1154,1423
00869403,RASMUSSEN COLLEGE - AURORA              ,IL,60506-6219,Proprietary  ,49,160,209,102,387,489
00869404,RASMUSSEN COLLEGE - ROMEOVILLE          ,IL,60446-0000,Proprietary  ,10,41,51,10,51,61
00888000,MORRISON INSTITUTE OF TECHNOLOGY        ,IL,61270-2959,Private      ,7,12,19,122,32,154
00893800,GRAHAM HOSPITAL SCH OF NURSING          ,IL,61520-2497,Private      ,1,6,7,26,63,89
00893900,CANNELLA SCHOOL OF HAIR DESIGN          ,IL,60406-2130,Proprietary  ,13,81,94,21,104,125
00914500,GOVERNORS STATE UNIVERSITY              ,IL,60466-0975,Public       ,210,1411,1621,854,5537,6391
00923200,CATHOLIC THEOLOGICAL UNION              ,IL,60615-0000,Private      ,0,18,18,0,67,67
00933300,UNIV OF ILLINOIS AT SPRINGFIELD         ,IL,62703-5407,Public       ,229,641,870,1939,2688,4627
00947500,EDUCATORS OF BEAUTY                     ,IL,61301-2404,Proprietary  ,2,13,15,20,40,60
00959500,CANNELLA SCHOOL OF HAIR DESIGN          ,IL,60617-4303,Proprietary  ,11,54,65,21,111,132
00976700,OLIVE-HARVEY COLLEGE                    ,IL,60628-1696,Public       ,438,1302,1740,1392,3543,4935
00978600,IL EASTERN COMM COLGS-LINCOLN TRAIL     ,IL,62454-5708,Public       ,62,128,190,339,427,766
00980000,RUSH UNIVERSITY                         ,IL,60612-3806,Private      ,16,249,265,132,2256,2388
00989600,OAKTON COMMUNITY COLLEGE                ,IL,60016-1268,Public       ,492,689,1181,2872,2526,5398
00998700,SAINT ANTHONY COLLEGE OF NURSING        ,IL,61108-2468,Private      ,12,36,48,99,212,311
01002000,LEWIS AND CLARK COMMUNITY COLLEGE       ,IL,62035-2466,Public       ,606,913,1519,1930,2595,4525
01031600,LINCOLN COLLEGE OF TECHNOLOGY           ,IL,60160-1605,Proprietary  ,245,344,589,897,1149,2046
01050100,LAKEVIEW  COLLEGE OF NURSING            ,IL,61832-3781,Private      ,21,16,37,143,190,333
01069500,TRI-COUNTY BEAUTY ACADEMY               ,IL,62056-2036,Proprietary  ,5,15,20,13,39,52
01071000,CAPITAL AREA SCH OF PRAC NRSG           ,IL,62707-0000,Public       ,15,96,111,52,425,477
01072700,DEVRY UNIVERSITY                        ,IL,60618-5994,Proprietary  ,3670,15762,19432,19578,68077,87655
01083600,PIVOT POINT INTNL CSMTLGY RSRCH CTR     ,IL,60626-0000,Proprietary  ,112,179,291,300,453,753
01087900,RICHLAND COMMUNITY COLLEGE              ,IL,62521-8513,Public       ,262,618,880,871,1710,2581
01102401,EVEREST COLLEGE - CHICAGO               ,IL,60604-2052,Proprietary  ,181,690,871,528,1805,2333
01151002,EVEREST INSTITUTE - EVEREST COLLEGE     ,IL,60542-1610,Proprietary  ,43,202,245,88,469,557
01181000,TAYLOR BUSINESS INSTITUTE               ,IL,60606-5111,Proprietary  ,13,106,119,34,256,290
01185800,EVEREST COLLEGE                         ,IL,60077-1074,Proprietary  ,104,410,514,225,869,1094
01185802,EVEREST COLLEGE - BURR RIDGE            ,IL,60527-7826,Proprietary  ,74,306,380,130,580,710
01236200,NORTHWESTERN COLLEGE                    ,IL,60630-2298,Proprietary  ,225,776,1001,1293,3449,4742
01238500,BLOOMINGTON-NORMAL SCH RADIOGRAPHY      ,IL,61761-4604,Private      ,1,2,3,8,16,24
01258400,ILLINOIS INSTITUTE OF ART (THE)         ,IL,60654-1593,Proprietary  ,691,817,1508,4755,3489,8244
01281300,JOHN WOOD COMMUNITY COLLEGE             ,IL,62305-0401,Public       ,307,487,794,1163,1469,2632
01308700,CAPRI GARFIELD RIDGE SCH OF BTY CLR     ,IL,60629-1613,Proprietary  ,28,100,128,69,181,250
01308800,CAPRI OAK FOREST COLLEGE OF BEAUTY      ,IL,60452-2798,Proprietary  ,31,52,83,114,164,278
02055200,HARRINGTON COLLEGE OF DESIGN            ,IL,60606-3433,Proprietary  ,104,227,331,640,803,1443
02068100,ADLER SCH OF PROFESSIONAL PSYCHLGY      ,IL,60601-0000,Private      ,2,135,137,14,943,957
02069300,VATTEROTT COLLEGE                       ,IL,62305-5938,Proprietary  ,37,175,212,106,590,696
02073200,TELSHE YESHIVA-CHICAGO                  ,IL,60625-0000,Private      ,2,6,8,34,8,42
02074400,IL EASTERN COMM COLGS-FRONTIER          ,IL,62837-0000,Public       ,32,113,145,147,413,560
02075400,KELLER GRADUATE SCHOOL OF MGMT.         ,IL,60515-5683,Proprietary  ,8,3602,3610,33,14563,14596
02113600,AMERICAN INTERCONTINENTAL UNIVERSITY    ,IL,60192-3713,Proprietary  ,782,9940,10722,2907,33918,36825
02117400,BECK AREA CAREER CENTER                 ,IL,62278-0000,Public       ,1,33,34,17,126,143
02124400,UNIVERSITY OF SPA & COSMETOLOGY ART     ,IL,62704-0000,Proprietary  ,25,54,79,80,164,244
02150600,COSMETOLOGY AND SPA INSTITUTE (THE)     ,IL,60014-4003,Proprietary  ,37,62,99,91,150,241
02155300,THE CHICAGO SCHOOL OF PROF PSYCHOLOGY   ,IL,60610-4705,Private      ,3,548,551,35,3396,3431
02160300,INTERNATIONAL ACAD OF DESIGN & TECH     ,IL,60602-3319,Proprietary  ,212,320,532,1110,1346,2456
02160304,INTERNATIONAL ACADEMY OF DESIGN AND TECH,IL,60173-5160,Proprietary  ,36,67,103,168,253,421
02168600,EAST WEST UNIVERSITY                    ,IL,60605-0000,Private      ,123,227,350,985,1409,2394
02179900,ARGOSY UNIVERSITY                       ,IL,60601-7757,Proprietary  ,427,6166,6593,1360,27509,28869
02185400,ST AUGUSTINE COLLEGE                    ,IL,60640-0000,Private      ,68,384,452,386,1668,2054
02192400,MR JOHNS SCHOOL OF COSMETOLOGY          ,IL,62521-0000,Proprietary  ,8,28,36,17,70,87
02202600,CANNELLA SCHOOL OF HAIR DESIGN          ,IL,60181-1321,Proprietary  ,4,35,39,7,59,66
02214100,WEST SUBURBAN COLLEGE OF NURSING        ,IL,60302-2519,Private      ,19,66,85,103,373,476
02228100,MAC DANIEL'S BEAUTY SCHOOL              ,IL,60640-0000,Proprietary  ,3,33,36,18,48,66
02261200,HAIR PROFESSIONALS ACAD COSMETOLOGY     ,IL,60118-0000,Proprietary  ,38,97,135,71,174,245
02261201,HAIR PROFESSIONALS ACADEMY OF COSMETOLOG,IL,60118-9333,Proprietary  ,1,0,1,6,6,12
02262100,HAIR PROFESSIONALS SCH COSMETOLOGY      ,IL,60543-0000,Proprietary  ,26,41,67,35,59,94
02291200,CANNELLA SCHOOL OF HAIR DESIGN          ,IL,60639-0000,Proprietary  ,13,77,90,32,129,161
02295500,CANNELLA SCHOOL OF HAIR DESIGN          ,IL,60120-0000,Proprietary  ,10,50,60,15,75,90
02297500,OEHRLEIN SCHOOL OF COSMETOLOGY          ,IL,61611-0000,Proprietary  ,27,30,57,52,73,125
02312300,LA' JAMES COLLEGE HAIRSTYLING           ,IL,61244-0000,Proprietary  ,6,14,20,13,34,47
02313900,WESTWOOD COLLEGE - O'HARE AIRPORT       ,IL,60631-2801,Proprietary  ,126,233,359,660,975,1635
02317300,CONCEPT COLLEGE OF COSMETOLOGY          ,IL,61832-0000,Proprietary  ,11,21,32,33,80,113
02319200,LAKE FOREST GRAD SCHL OF MGMT           ,IL,60045-4824,Private      ,0,197,197,2,304,306
02323300,PROFESSIONAL'S CHOICE HAIR DSN ACAD     ,IL,60435-0000,Proprietary  ,4,11,15,16,26,42
02332200,HAIR PROFESSIONALS CAREER COLLEGE       ,IL,60178-0000,Proprietary  ,20,27,47,25,39,64
02337800,THE COLLEGE OF OFFICE TECHNOLOGY        ,IL,60622-0000,Proprietary  ,27,138,165,58,289,347
02349400,ALVAREITA'S COLLEGE OF COSMETOLOGY      ,IL,62035-0000,Proprietary  ,12,16,28,18,37,55
02349500,CANNELLA SCHOOL OF HAIR DESIGN          ,IL,60632-0000,Proprietary  ,23,82,105,31,99,130
02352200,COOKING & HOSPITALITY INSTITUTE         ,IL,60610-3050,Proprietary  ,125,400,525,584,1160,1744
02498200,HAIR PROFESSIONALS ACAD COSMETOLOGY     ,IL,60187-0000,Proprietary  ,22,90,112,36,147,183
02498201,HAIR PROFESSIONALS ACADEMY OF COSMETOLOG,IL,60563-0000,Proprietary  ,3,5,8,11,16,27
02522800,FOX COLLEGE                             ,IL,60453-0000,Proprietary  ,35,34,69,371,257,628
02527600,LEXINGTON COLLEGE                       ,IL,60607-0000,Private      ,5,9,14,60,38,98
02536700,BELL MAR BEAUTY COLLEGE                 ,IL,60650-0000,Proprietary  ,1,25,26,4,40,44
02556100,ENVIRONMENTAL TECHNICAL INSTITUTE       ,IL,60143-0000,Proprietary  ,60,142,202,112,240,352
02556600,NILES SCHOOL OF COSMETOLOGY             ,IL,60714-0000,Proprietary  ,10,19,29,14,46,60
02570305,LOS ANGELES ORT TECHNICAL INSTITUTE -D/B,IL,60077-0000,Private      ,0,0,0,1,4,5
02573700,INSTITUTE FOR CLINICAL SOCIAL WORK      ,IL,60601-0000,Private      ,2,42,44,10,98,108
02579200,INGALLS MEMORIAL HOSPITAL               ,IL,60426-0000,Private      ,1,2,3,3,14,17
02584900,"FIRST INSTITUTE, INC.                   ",IL,60014-7489,Proprietary  ,10,64,74,24,182,206
02587700,HAIR PROFESSIONALS CAREER COLLEGE       ,IL,60465-1929,Proprietary  ,18,46,64,32,67,99
02599500,HANOVER PARK COLLEGE OF BEAUTY CULT     ,IL,60133-5421,Proprietary  ,14,25,39,48,88,136
02622700,KNOWLEDGE SYSTEMS INSTITUTE             ,IL,60076-0000,Private      ,1,3,4,1,9,10
03002000,HAIRMASTERS INST OF COSMETOLOGY         ,IL,61701-5547,Proprietary  ,12,29,41,25,75,100
03027702,PACIFIC COLLEGE OF ORIENTAL MEDICINE - C,IL,60613-4418,Proprietary  ,2,101,103,5,208,213
03065300,TREND SETTERS COLL OF COSMETOLOGY       ,IL,60915-2101,Proprietary  ,34,70,104,67,109,176
03072701,WESTWOOD COLLEGE OF TECHNOLOGY          ,IL,60409-0000,Proprietary  ,71,287,358,325,1048,1373
03072702,WESTWOOD COLLEGE OF TECHNOLOGY          ,IL,60602-0000,Proprietary  ,140,342,482,744,1492,2236
03078400,CAMEO BEAUTY ACADEMY                    ,IL,60453-3196,Proprietary  ,29,30,59,43,62,105
03079200,WESTWOOD COLLEGE - DUPAGE               ,IL,60517-2321,Proprietary  ,111,196,307,457,595,1052
03082900,ROSEL SCHOOL OF COSMETOLOGY             ,IL,60659-1913,Proprietary  ,8,44,52,23,121,144
03083800,HEARTLAND COMMUNITY COLLEGE             ,IL,61761-9446,Public       ,273,534,807,1723,2123,3846
03098000,ST JOHN'S COLLEGE OF NURSING            ,IL,62702-5321,Private      ,6,7,13,100,62,162
03098002,ST JOHN'S HOSP SCH MED TECH             ,IL,62769-5324,Private      ,0,4,4,5,13,18
03099700,CAIN'S BARBER COLLEGE                   ,IL,60615-3510,Proprietary  ,30,119,149,72,286,358
03099800,ILLINOIS SCHOOL OF HEALTH CAREERS       ,IL,60604-0000,Proprietary  ,103,332,435,246,800,1046
03101800,ILLINOIS CENTER FOR BROADCASTING        ,IL,60148-7015,Proprietary  ,40,95,135,93,234,327
03128300,PYRAMID CAREER INSTITUTE                ,IL,60657-4207,Proprietary  ,0,1,1,0,5,5
03128500,NATIONAL LATINO EDUCATION INSTITUTE     ,IL,60609-2205,Private      ,13,36,49,25,84,109
03199300,CHRISTIAN LIFE COLLEGE                  ,IL,60056-2522,Private      ,6,10,16,17,22,39
03368300,MIDWEST TECHNICAL INSTITUTE             ,IL,62707-8805,Proprietary  ,152,635,787,306,1538,1844
03416300,COMPUTER SYSTEMS INSTITUTE              ,IL,60077-0000,Proprietary  ,70,326,396,142,726,868
03448300,BIR TRAINING CENTER                     ,IL,60659-1298,Proprietary  ,14,215,229,32,512,544
03455700,CORTIVA INSTITUTE - CHICAGO             ,IL,60602-3315,Proprietary  ,66,137,203,191,495,686
03455701,CORTIVA INSTITUTE - CHICAGO             ,IL,60014-6285,Proprietary  ,2,9,11,2,13,15
03510300,ERIKSON INSTITUTE                       ,IL,60654-4510,Private      ,0,31,31,1,258,259
03623300,VEE'S SCHOOL OF BEAUTY CULTURE          ,IL,62205-2326,Proprietary  ,0,8,8,2,22,24
03643300,"MR. JOHN'S SCHOOL OF JACKSONVILLE,  INC,",IL,62650-3488,Proprietary  ,4,18,22,9,28,37
03684300,NORTHSHORE UNIVERSITY HEALTHSYSTEM SCHOO,IL,60201-9872,Private      ,1,5,6,2,25,27
03721400,AMERICAN CAREER COLLEGE                 ,IL,60402-0000,Proprietary  ,7,33,40,15,71,86
03881400,EUROPEAN MASSAGE THERAPY SCHOOL         ,IL,60077-2269,Proprietary  ,4,68,72,8,102,110
03891300,SOMA INSTITUTE - THE NATIONAL SCHOOL OF ,IL,60604-4466,Proprietary  ,26,89,115,54,204,258
03914300,"CALC, INSTITUTE OF TECHNOLOGY           ",IL,62002-5931,Proprietary  ,6,67,73,15,181,196
04117500,SOLEX MEDICAL ACADEMY                   ,IL,60090-3104,Proprietary  ,1,9,10,1,23,24
04124700,AMERICARE INSTITUTE                     ,IL,60133-5456,Proprietary  ,3,29,32,3,29,32
04136900,UNIVERSITY OF AESTHETICS (THE)          ,IL,60622-2151,Proprietary  ,0,9,9,6,25,31
04137000,UNIVERSITY OF AESTHETICS (THE)          ,IL,60515-5602,Proprietary  ,2,4,6,5,16,21
04137500,TRICOCI UNIVERSITY OF BEAUTY CULTURE    ,IL,60656-1805,Proprietary  ,41,55,96,116,178,294
04141000,AVEDA INSTITUTE CHICAGO                 ,IL,60647-0000,Proprietary  ,24,54,78,36,94,130
04147100,TRICOCI UNIVERSITY OF BEAUTY CULTURE    ,IL,60048-2906,Proprietary  ,18,32,50,22,39,61
04147200,TRICOCI UNIVERSITY OF BEAUTY CULTURE    ,IL,60455-1824,Proprietary  ,31,36,67,35,47,82
04147300,TRICOCI UNIVERSITY OF BEAUTY CULTURE    ,IL,60139-3119,Proprietary  ,14,15,29,43,56,99
04147400,TRICOCI UNIVERSITY OF BEAUTY CULTURE    ,IL,61614-4831,Proprietary  ,3,15,18,21,40,61
04147500,TRICOCI UNIVERSITY OF BEAUTY CULTURE    ,IL,61108-2337,Proprietary  ,9,36,45,30,90,120
        ,ASBURY THEOLOGICAL SEMINARY             ,KY,40390-0000,Private      ,0,0,0,1,30,31
00195100,ALICE LLOYD COLLEGE                     ,KY,41844-9703,Private      ,73,33,106,924,143,1067
00195200,ASBURY COLLEGE                          ,KY,40390-1198,Private      ,97,110,207,1482,462,1944
00195300,ASBURY THEOLOGICAL SEMINARY             ,KY,40390-0000,Private      ,1,157,158,16,1239,1255
00195400,BELLARMINE UNIVERSITY                   ,KY,40205-1877,Private      ,118,269,387,3371,1209,4580
00195500,BEREA COLLEGE                           ,KY,40403-0000,Private      ,56,44,100,2729,606,3335
00195800,BRESCIA UNIVERSITY                      ,KY,42301-3023,Private      ,46,108,154,657,496,1153
00195900,CAMPBELLSVILLE UNIVERSITY               ,KY,42718-2799,Private      ,111,285,396,2214,1302,3516
00196000,SPALDING UNIVERSITY                     ,KY,40203-2188,Private      ,67,366,433,616,2162,2778
00196100,CENTRE COLLEGE                          ,KY,40422-1394,Private      ,32,12,44,2009,70,2079
00196200,UNIVERSITY OF THE CUMBERLANDS           ,KY,40769-1372,Private      ,94,336,430,2264,1341,3605
00196300,EASTERN KENTUCKY UNIVERSITY             ,KY,40475-3102,Public       ,1160,1639,2799,10939,7921,18860
00196400,GEORGETOWN COLLEGE                      ,KY,40324-1628,Private      ,85,226,311,2138,642,2780
00196500,KENTUCKY CHRISTIAN UNIVERSITY           ,KY,41143-2205,Private      ,41,21,62,700,142,842
00196800,KENTUCKY STATE UNIVERSITY               ,KY,40601-2355,Public       ,271,360,631,3157,1611,4768
00196900,KENTUCKY WESLEYAN COLLEGE               ,KY,42302-1039,Private      ,58,42,100,1226,272,1498
00197000,LEES COLLEGE                            ,KY,41339-0000,Private      ,0,0,0,1,1,2
00197100,LEXINGTON THEOLOGICAL SEMINARY          ,KY,40508-0000,Private      ,0,12,12,0,56,56
00197200,LINDSEY WILSON COLLEGE                  ,KY,42728-1223,Private      ,91,255,346,1878,1469,3347
00197400,LOUISVILLE PRESBYTERIAN THEOL SEM       ,KY,40205-0000,Private      ,0,16,16,1,141,142
00197500,MIDWAY COLLEGE                          ,KY,40347-1120,Private      ,73,314,387,566,1305,1871
00197600,MOREHEAD STATE UNIVERSITY               ,KY,40351-1689,Public       ,612,1105,1717,5704,4704,10408
00197700,MURRAY STATE UNIVERSITY                 ,KY,42071-0009,Public       ,590,787,1377,5973,3517,9490
00197900,WEST KENTUCKY CMNTY & TECHNICAL COLG    ,KY,42002-7380,Public       ,297,802,1099,1490,2986,4476
00198000,PIKEVILLE COLLEGE                       ,KY,41501-1194,Private      ,62,76,138,1035,359,1394
00198001,PIKEVILLE CLG-SCH OSTEOPATHIC MEDIC     ,KY,41501-0000,Private      ,1,13,14,8,318,326
00198200,SOUTHERN BAPTIST THEOL SEMINARY         ,KY,40280-0000,Private      ,6,48,54,49,177,226
00198300,ST. CATHARINE COLLEGE                   ,KY,40061-9499,Private      ,43,62,105,660,433,1093
00198700,TRANSYLVANIA UNIVERSITY                 ,KY,40508-1797,Private      ,32,30,62,1609,143,1752
00198800,UNION COLLEGE                           ,KY,40906-1499,Private      ,93,325,418,1263,964,2227
00198900,UNIVERSITY OF KENTUCKY                  ,KY,40506-0054,Public       ,1462,1445,2907,15935,8177,24112
00198901,UNIV OF KY-COLLEGE OF DENTISTRY         ,KY,40536-0000,Public       ,1,13,14,11,213,224
00198902,UNIV OF KY-COLLEGE OF MEDICINE          ,KY,40536-0000,Public       ,5,13,18,35,447,482
00199000,ASHLAND COMMUNITY AND TECHNICAL COLLEGE ,KY,41101-3683,Public       ,369,734,1103,1363,2368,3731
00199100,ELIZABETHTOWN COMMUNITY  AND TECHNICAL C,KY,42701-3081,Public       ,496,1321,1817,2088,4456,6544
00199300,HENDERSON COMMUNITY COLLEGE             ,KY,42420-4699,Public       ,138,316,454,560,1331,1891
00199400,HOPKINSVILLE COMMUNITY COLLEGE          ,KY,42241-2621,Public       ,250,1031,1281,1013,3490,4503
00199600,BIG SANDY COMMUNITY AND TECHNICAL COLG  ,KY,41653-1815,Public       ,363,680,1043,1658,2057,3715
00199700,SOMERSET COMMUNITY COLLEGE              ,KY,42501-2973,Public       ,570,1467,2037,2633,5440,8073
00199800,SOUTHEAST KENTUCKY COMMUNITY AND TECHNIC,KY,40823-1099,Public       ,282,487,769,1170,1591,2761
00199802,CUMBERLAND VLY TEC CLG MIDDLESBORO      ,KY,40965-2265,Public       ,2,8,10,18,24,42
00199804,SOUTHEAST COMMUNITY COLLEGE             ,KY,40831-1796,Public       ,13,47,60,94,145,239
00199900,UNIVERSITY OF LOUISVILLE                ,KY,40292-0000,Public       ,1069,1717,2786,12477,11152,23629
00200100,THOMAS MORE COLLEGE                     ,KY,41017-3495,Private      ,71,209,280,1388,742,2130
00200200,WESTERN KENTUCKY UNIVERSITY             ,KY,42101-3576,Public       ,1806,1991,3797,13230,8533,21763
00461800,SPENCERIAN COLLEGE                      ,KY,40216-2605,Proprietary  ,180,737,917,667,2076,2743
00461900,SULLIVAN UNIVERSITY                     ,KY,40205-3000,Proprietary  ,316,1355,1671,1930,5203,7133
00512729,BROWN MACKIE COLLEGE-CINCINNATI - 279 BU,KY,41017-2136,Proprietary  ,5,22,27,24,98,122
00524400,BLUEGRASS COMMUNITY & TECHNICAL COLLEGE ,KY,40506-0235,Public       ,1077,2459,3536,4449,8579,13028
00527100,BOWLING GREEN TECHNICAL COLLEGE         ,KY,42101-3601,Public       ,205,665,870,939,2168,3107
00527300,GATEWAY COMMUNITY & TECHNOLOGY COLL     ,KY,41011-0000,Public       ,305,909,1214,1119,3022,4141
00696000,MAYSVILLE CMNTY & TECHNCL COLG          ,KY,41056-8910,Public       ,209,685,894,900,2517,3417
00696100,JEFFERSON COMMUNITY AND TECHNICAL COLLEG,KY,40202-2005,Public       ,1224,2241,3465,5551,9739,15290
00696200,HAZARD COMMUNITY COLLEGE                ,KY,41701-2402,Public       ,272,610,882,1272,1875,3147
00696203,KY TECH-KNOTT CO. TECHNOLOGY CTR        ,KY,41822-0000,Public       ,0,0,0,2,2,4
00696204,KY TECH-LESLIE COUNTY AREA TECH CTR     ,KY,41749-0000,Public       ,0,0,0,1,0,1
00696205,KY TECH-LEE COUNTY AREA TECH CTR        ,KY,41311-0000,Public       ,0,0,0,1,3,4
00696206,KY TECH-LETCHER CNTY AREA TECH CTR      ,KY,41858-0000,Public       ,3,3,6,20,10,30
00696207,KY TECH-BREATHITT COUNTY VOC ED CTR     ,KY,41339-0000,Public       ,3,3,6,12,8,20
00736205,MEDTECH COLLEGE - LEXINGTON             ,KY,40511-1200,Proprietary  ,0,47,47,0,47,47
00842500,DAYMAR COLLEGE                          ,KY,42001-0000,Proprietary  ,29,164,193,66,523,589
00901000,MADISONVILLE COMMUNITY COLLEGE          ,KY,42431-9199,Public       ,246,689,935,1065,2335,3400
00927500,NORTHERN KENTUCKY UNIVERSITY            ,KY,41099-0001,Public       ,1153,1536,2689,8716,6987,15703
00931300,DAYMAR COLLEGE                          ,KY,42301-5830,Proprietary  ,128,828,956,270,2016,2286
00931302,DAYMAR COLLEGE - LOUISVILLE CAMPUS      ,KY,40219-1973,Proprietary  ,6,64,70,57,221,278
01042400,SALON PROFESSIONAL ACADEMY THE          ,KY,40502-1776,Proprietary  ,16,30,46,61,108,169
01048900,NATIONAL COLLEGE                        ,KY,40508-0000,Proprietary  ,170,1279,1449,555,4531,5086
01172500,COLLINS SCHOOL OF COSMETOLOGY           ,KY,40965-2809,Proprietary  ,11,24,35,22,52,74
01208800,SULLIVAN COLLEGE OF TECHNOLOGY AND DESIG,KY,40218-4528,Proprietary  ,87,206,293,490,569,1059
01212801,SOUTHWESTERN COLLEGE                    ,KY,41042-1466,Proprietary  ,54,236,290,121,690,811
01240400,LEXINGTON BEAUTY COLLEGE                ,KY,40503-1819,Proprietary  ,0,0,0,17,47,64
01272300,KY TECH-WAYNE COUNTY AREA TECH CTR      ,KY,42633-1088,Public       ,0,0,0,1,2,3
01291400,EMPIRE BEAUTY SCHOOL                    ,KY,40218-0000,Proprietary  ,20,63,83,111,256,367
01291500,EMPIRE BEAUTY SCHOOL                    ,KY,41042-5113,Proprietary  ,15,35,50,82,155,237
01291600,EMPIRE BEAUTY SCHOOL                    ,KY,40216-4212,Proprietary  ,9,26,35,49,145,194
01291700,EMPIRE BEAUTY SCHOOL                    ,KY,40160-0000,Proprietary  ,19,29,48,90,202,292
01296800,EMPIRE BEAUTY SCHOOL                    ,KY,40207-2695,Proprietary  ,8,27,35,70,129,199
02159100,"APPALACHIAN BEAUTY SCHOOL, INC.         ",KY,41503-0000,Proprietary  ,5,14,19,15,45,60
02177100,EMPIRE BEAUTY SCHOOL                    ,KY,40204-0000,Proprietary  ,15,29,44,70,174,244
02251500,TREND SETTERS ACAD OF BEAUTY CULT       ,KY,40258-0000,Proprietary  ,26,87,113,38,139,177
02275000,JENNY LEA ACADEMY OF COSMETOLOGY        ,KY,40831-0000,Proprietary  ,27,72,99,54,161,215
02279800,ELIZABETHTOWN BEAUTY SCHOOL             ,KY,42701-0000,Proprietary  ,0,0,0,4,5,9
02284306,INTERACTIVE LEARNING SYSTEMS            ,KY,41042-0000,Proprietary  ,4,47,51,8,80,88
02323700,PAT WILSON'S BEAUTY COLLEGE             ,KY,42420-0000,Proprietary  ,7,17,24,12,51,63
02337200,PJ'S COLLEGE OF COSMETOLOGY             ,KY,42101-0000,Proprietary  ,44,194,238,110,475,585
02340800,PAUL MITCHELL THE SCHOOL LEXINGTON      ,KY,40601-0000,Proprietary  ,10,34,44,27,56,83
02351700,DONTA SCHOOL OF BEAUTY CULTURE          ,KY,40203-0000,Proprietary  ,23,48,71,45,94,139
02491100,BECKFIELD COLLEGE                       ,KY,41042-0000,Proprietary  ,48,299,347,220,1178,1398
02518900,BARRETT & COMPANY SCH HAIR DESIGN       ,KY,40356-0000,Proprietary  ,17,39,56,39,106,145
02526100,JENNY LEA ACADEMY OF COSMETOLOGY        ,KY,41858-0000,Proprietary  ,2,10,12,8,38,46
02535600,CLEAR CREEK BAPTIST BIBLE COLLEGE       ,KY,40977-0000,Private      ,15,53,68,39,140,179
02551100,PJ'S COLLEGE OF COSMETOLOGY             ,KY,42121-0000,Proprietary  ,10,27,37,20,77,97
02560800,SOUTHEAST SCHOOL OF COSMETOLOGY         ,KY,40962-0000,Proprietary  ,5,16,21,12,41,53
02576200,MID-CONTINENT UNIVERSITY                ,KY,42066-9007,Private      ,40,398,438,261,2202,2463
02616204,BROWN MACKIE COLLEGE-FINDLAY - BROWN MAC,KY,40219-1916,Proprietary  ,18,137,155,131,537,668
02616205,BROWN MACKIE COLLEGE-LOUISVILLE - BROWN ,KY,42240-3579,Proprietary  ,6,38,44,24,177,201
03002100,KENTUCKY MOUNTAIN BIBLE COLLEGE         ,KY,41385-0010,Private      ,16,9,25,52,31,83
03007000,FRONTIER SCH OF MIDWIFERY&FAMILY NU     ,KY,41749-0000,Private      ,1,196,197,2,840,842
03026200,HEAD'S WEST KENTUCKY BEAUTY COLLEGE     ,KY,42431-0000,Proprietary  ,8,13,21,11,37,48
03029200,NU-TEK ACADEMY OF BEAUTY                ,KY,40353-9767,Proprietary  ,3,6,9,10,36,46
03034500,OWENSBORO COMMUNITY & TECHNICAL COLLEGE ,KY,42303-1899,Public       ,296,757,1053,1429,2847,4276
03083700,GALEN HEALTH INSTITUTES                 ,KY,40207-1047,Proprietary  ,109,768,877,485,3073,3558
03103500,MR JIM'S BEAUTY COLLEGE                 ,KY,42301-2646,Proprietary  ,0,22,22,5,36,41
03516500,EZELL'S COSMETOLOGY SCHOOL              ,KY,42071-2530,Proprietary  ,6,25,31,16,61,77
03611300,BRIGHTON CENTER'S CENTER FOR EMPLOY     ,KY,41071-1968,Private      ,4,73,77,5,92,97
03804300,BELLEFONTE ACADEMY OF BEAUTY            ,KY,41169-2015,Proprietary  ,18,66,84,21,75,96
03885300,EMPLOYMENT SOLUTIONS                    ,KY,40517-3260,Private      ,3,116,119,16,184,200
03886300,REGENCY SCHOOL OF HAIR DESIGN           ,KY,41653-1278,Proprietary  ,6,26,32,21,57,78
04038300,ATA CAREER EDUCATION                    ,KY,40223-3832,Proprietary  ,52,285,337,150,941,1091
04123900,LEXINGTON HEALING ARTS ACADEMY          ,KY,40503-1932,Proprietary  ,14,42,56,28,89,117
00200300,CENTENARY COLLEGE OF LOUISIANA          ,LA,71104-3396,Private      ,84,58,142,1201,234,1435
00200400,DILLARD UNIVERSITY                      ,LA,70122-3097,Private      ,234,146,380,1882,653,2535
00200500,NICHOLLS STATE UNIVERSITY               ,LA,70310-0001,Public       ,581,653,1234,5061,2544,7605
00200600,GRAMBLING STATE UNIVERSITY              ,LA,71245-2215,Public       ,756,682,1438,6427,3049,9476
00200700,LOUISIANA COLLEGE                       ,LA,71359-0000,Private      ,166,222,388,1075,671,1746
00200800,LOUISIANA TECH UNIVERSITY               ,LA,71272-0001,Public       ,866,807,1673,6067,2719,8786
00201000,LOUISIANA STATE UNIV & A&M COLG         ,LA,70803-5710,Public       ,2299,1357,3656,20135,6948,27083
00201100,LOUISIANA STATE UNIV-ALEXANDRIA         ,LA,71302-9121,Public       ,232,498,730,1364,1894,3258
00201200,LOUISIANA STATE UNIV-EUNICE             ,LA,70535-6726,Public       ,316,367,683,1826,1584,3410
00201300,LOUISIANA STATE UNIV-SHREVEPORT         ,LA,71115-2399,Public       ,357,743,1100,2382,2799,5181
00201400,LA STATE UNIV HEALTH SCIENCES CTR       ,LA,70112-2223,Public       ,63,196,259,415,2000,2415
00201500,(THE) UNIVERSITY OF NEW ORLEANS         ,LA,70148-0001,Public       ,1081,1875,2956,6130,6265,12395
00201600,LOYOLA UNIVERSITY NEW ORLEANS           ,LA,70118-6195,Private      ,321,634,955,3080,2498,5578
00201700,MCNEESE STATE UNIVERSITY                ,LA,70609-4510,Public       ,598,809,1407,4803,3360,8163
00201900,NEW ORLEANS BAPTIST THEOL SEMINARY      ,LA,70126-0000,Private      ,4,38,42,27,128,155
00202000,UNIVERSITY OF LOUISIANA AT MONROE       ,LA,71209-9001,Public       ,842,1159,2001,5774,4192,9966
00202100,NORTHWESTERN STATE UNIVERSITY           ,LA,71497-0001,Public       ,657,1357,2014,5746,4888,10634
00202200,NOTRE DAME SEMINARY                     ,LA,70118-0000,Private      ,0,5,5,3,11,14
00202300,OUR LADY OF HOLY CROSS COLLEGE          ,LA,70131-7399,Private      ,133,309,442,608,1081,1689
00202400,SOUTHEASTERN LOUISIANA UNIV             ,LA,70402-0001,Public       ,1744,1478,3222,10334,5259,15593
00202500,SOUTHERN UNIVERSITY A & M COLLEGE       ,LA,70813-9374,Public       ,1055,1446,2501,7431,6343,13774
00202600,SOUTHERN UNIV NEW ORLEANS               ,LA,70126-0002,Public       ,536,1191,1727,1530,3390,4920
00202700,ST JOSEPH SEMINARY COLLEGE              ,LA,70457-9990,Private      ,13,13,26,31,20,51
00202900,TULANE UNIVERSITY                       ,LA,70118-5698,Private      ,450,844,1294,10868,6311,17179
00203100,UNIV OF LOUISIANA AT LAFAYETTE          ,LA,70504-0001,Public       ,1451,1071,2522,11247,4677,15924
00203200,XAVIER UNIVERSITY OF LOUISIANA          ,LA,70125-1098,Private      ,454,258,712,4274,1621,5895
00462100,AYERS CAREER COLLEGE                    ,LA,71108-5845,Proprietary  ,19,140,159,54,329,383
00462500,DELGADO COMMUNITY COLLEGE               ,LA,70119-0000,Public       ,2233,4078,6311,6605,11992,18597
00520300,REMINGTON COLLEGE - LAFAYETTE CAMPUS    ,LA,70508-5760,Proprietary  ,256,578,834,551,1568,2119
00520306,REMINGTON COLLEGE - BATON ROUGE CAMPUS  ,LA,70816-4040,Proprietary  ,72,272,344,148,513,661
00546700,SOWELA TECHNICAL COMMUNITY COLLEGE      ,LA,70616-6950,Public       ,238,449,687,763,1132,1895
00548800,LOUISIANA TECH COLG-BATON ROUGE         ,LA,70807-0000,Public       ,196,569,765,395,968,1363
00548802,LOUISIANA TECH COLG-ACADIAN CMPS        ,LA,70526-0000,Public       ,32,59,91,86,153,239
00548803,LOUISIANA TECH COLG-ALEXANDRIA CMPS     ,LA,71302-3137,Public       ,75,210,285,167,481,648
00548804,LOUISIANA TECH COLG-ASCENSION CMPS      ,LA,70778-3007,Public       ,43,77,120,71,157,228
00548805,LA TECH COLLEGE-AVOYELLES CAMPUS        ,LA,71327-0000,Public       ,42,54,96,78,109,187
00548806,LA TECHNICAL COLG-BASTROP CMPS          ,LA,71221-0000,Public       ,29,77,106,59,182,241
00548808,LA TECH COLG CHARLES B COREILCMPS       ,LA,70586-0000,Public       ,52,85,137,105,175,280
00548809,LA TECHNICAL COLG-DELTA-OUACHITA        ,LA,71292-9064,Public       ,87,263,350,172,530,702
00548810,EVANGELINE TECHNICAL INST               ,LA,70582-3104,Public       ,48,126,174,78,209,287
00548811,LA TECHN COLLEGE - FLORIDA PARISHES     ,LA,70441-0000,Public       ,33,89,122,62,151,213
00548812,LOUISIANA TECH COLG-FOLKES CAMPUS       ,LA,70748-0000,Public       ,14,26,40,26,54,80
00548813,LA TECHNICAL INST-GULF AREA CMPS        ,LA,70510-0878,Public       ,67,119,186,151,257,408
00548814,LOUISIANA TECH COLG-HAMMOND CMPS        ,LA,70404-0000,Public       ,87,178,265,171,373,544
00548815,LA TECH COLG-HUEY P. LONG CAMPUS        ,LA,71483-0000,Public       ,34,102,136,64,154,218
00548816,LA TECH COLLEGE-JEFFERSON CAMPUS        ,LA,70001-5605,Public       ,34,151,185,66,312,378
00548817,LOUISIANA TEC CLG-JUMONVILLE MEM CP     ,LA,70760-0000,Public       ,30,87,117,49,124,173
00548818,LA TECH COLLEGE-LAFAYETTE CAMPUS        ,LA,70506-0000,Public       ,198,380,578,483,839,1322
00548819,LOUISIANA TECHNICAL COLLEGE-LAFOURC     ,LA,70301-4336,Public       ,57,107,164,110,202,312
00548820,LOUISIANA TEC CLG-LAMAR SALTER CMPS     ,LA,71446-0000,Public       ,32,114,146,66,203,269
00548822,LOUISIANA TECHNICAL CLG-MANSFIELD       ,LA,71052-1236,Public       ,26,82,108,51,163,214
00548823,LA. TECH COLG.-MORGAN SMITH CAMPUS      ,LA,70546-0000,Public       ,18,65,83,30,90,120
00548824,LOUISIANA TEC CLG-NATCHITOCHES CMPS     ,LA,71458-0000,Public       ,43,108,151,89,231,320
00548825,LOUISIANA TECH COLG-NORTH CTRL CMPS     ,LA,71241-0000,Public       ,28,75,103,46,139,185
00548826,LOUISIANA TECH CLG-NORTHEAST LA CMP     ,LA,71295-2999,Public       ,37,98,135,76,180,256
00548827,LOUISIANA TEC CLG-NW LOUISIANA CMPS     ,LA,71058-0000,Public       ,131,256,387,209,454,663
00548828,LA TECHNICAL COLG-OAKDALE CMPS          ,LA,71463-0000,Public       ,21,56,77,56,116,172
00548829,LTC-RIVER PARISHES CAMPUS               ,LA,70084-0000,Public       ,74,118,192,184,265,449
00548830,LOUISIANA TECHNICAL COLLEGE-RUSTON      ,LA,71273-0000,Public       ,57,95,152,251,273,524
00548831,LTC - SABINE VALLEY CAMPUS              ,LA,71449-3839,Public       ,24,58,82,36,108,144
00548832,LOUISIANA TECH COLG-SHELBY JACKSON      ,LA,71334-0000,Public       ,20,87,107,51,208,259
00548833,LA TECH COLG SHREVEPORT-BOSSIER         ,LA,71137-0000,Public       ,120,567,687,255,1065,1320
00548837,LOUISIANA TECH COLG-SULLIVAN CAMPUS     ,LA,70427-5866,Public       ,84,211,295,181,450,631
00548838,LOUISIANA TECHNICAL COLG - TALLULAH     ,LA,71284-0000,Public       ,74,131,205,97,200,297
00548839,LA TECH COLG-TECHE AREA CAMPUS          ,LA,70562-0000,Public       ,82,161,243,197,312,509
00548840,LOUISIANA TECH COLG-T.H.HARRIS CMPS     ,LA,70570-6113,Public       ,136,199,335,329,469,798
00548841,LOUISIANA TECH COLG W JEFFERSON CMP     ,LA,70058-0000,Public       ,30,75,105,67,182,249
00548842,LOUISIANA TECHNICAL COLLEGE - WESTSIDE C,LA,70765-0733,Public       ,14,47,61,21,91,112
00548843,LTC-YOUNG MEMORIAL CAMPUS               ,LA,70381-0000,Public       ,63,170,233,124,336,460
00576100,L. E. FLETCHER TECHNICAL COMMUNITY COLLE,LA,70360-2863,Public       ,167,292,459,575,782,1357
00768600,SOUTHERN UNIV AT SHREVEPORT/BOSSIER     ,LA,71107-4795,Public       ,543,1236,1779,1314,2731,4045
00806700,LSU HEALTH SCIENCES CENTR-SHREVEPOR     ,LA,71130-3932,Public       ,39,101,140,239,899,1138
00989800,DEMMON SCHOOL OF BEAUTY                 ,LA,70607-2128,Proprietary  ,6,28,34,10,54,64
01005701,AMERICAN COMMERCIAL COLLEGE             ,LA,71105-2502,Proprietary  ,19,81,100,40,176,216
01109700,CLOYD'S BEAUTY SCHOOL #1                ,LA,71291-3131,Proprietary  ,24,87,111,37,119,156
01163100,"D-JAY'S SCHL OF BEAUTY, ARTS & SCI      ",LA,70806-0000,Proprietary  ,13,36,49,26,70,96
01184100,JOHN JAY BEAUTY COLLEGE                 ,LA,70124-2592,Proprietary  ,11,26,37,44,58,102
01261100,RONNIE & DORMANS SCHOOL HAIR DESIGN     ,LA,70501-0000,Proprietary  ,0,6,6,6,22,28
01282300,PAT GOINS RUSTON BEAUTY SCHOOL          ,LA,71270-4301,Proprietary  ,9,20,29,15,30,45
01287900,PAT GOINS BENTON ROAD BEAUTY SCHOOL     ,LA,71111-4838,Proprietary  ,11,26,37,13,44,57
01288000,PAT GOINS BEAUTY SCHOOL                 ,LA,71201-5167,Proprietary  ,3,7,10,7,17,24
02055400,BOSSIER PARISH COMMUNITY COLLEGE        ,LA,71111-0000,Public       ,617,1079,1696,2077,3145,5222
02055500,DELTA SCH OF BUSINESS & TECHNOLOGY      ,LA,70601-0000,Proprietary  ,23,132,155,70,381,451
02089711,HERZING COLLEGE                         ,LA,70062-8727,Proprietary  ,7,56,63,62,299,361
02117800,AVEDA INSTITUTE LAFAYETTE               ,LA,70503-3246,Proprietary  ,32,55,87,92,141,233
02166100,NUNEZ COMMUNITY COLLEGE                 ,LA,70043-0000,Public       ,233,575,808,430,1049,1479
02166200,ITI TECHNICAL COLLEGE                   ,LA,70817-0000,Proprietary  ,120,203,323,262,422,684
02197500,BATON ROUGE SCHOOL OF COMPUTERS         ,LA,70816-0000,Proprietary  ,9,21,30,23,54,77
02234000,CAMERON COLLEGE                         ,LA,70119-0000,Proprietary  ,20,88,108,33,135,168
02258400,AVEDA INSTITUTE BATON ROUGE             ,LA,70816-2246,Proprietary  ,31,41,72,116,160,276
02260200,DIESEL DRIVING ACADEMY                  ,LA,71109-5617,Proprietary  ,21,111,132,28,220,248
02263600,BASTROP BEAUTY SCHOOL #1                ,LA,71220-0000,Proprietary  ,3,2,5,4,6,10
02265600,JOHN JAY KENNER ACADEMY                 ,LA,70062-0000,Proprietary  ,17,35,52,42,89,131
02269300,STEVENSON'S ACADEMY OF HAIR DESIGN      ,LA,70116-0000,Proprietary  ,22,57,79,56,117,173
02327800,PINEVILLE BEAUTY SCHOOL                 ,LA,71360-0000,Proprietary  ,8,20,28,21,58,79
02335701,BATON ROUGE GEN MED CTR SCH NSG         ,LA,70821-0000,Private      ,11,48,59,47,160,207
02335702,BATON ROUGE GEN MED CTR-RAD TECH        ,LA,70806-0000,Private      ,2,13,15,25,40,65
02338000,"CLOYD'S BEAUTY SCHOOL #2, INC           ",LA,71202-3539,Proprietary  ,22,81,103,30,108,138
02352500,"CLOYD'S BEAUTY SCHOOL #3, INC           ",LA,71201-3211,Proprietary  ,23,85,108,35,118,153
02358600,"STAGE ONE THE HAIR SCHOOL, INC.         ",LA,70605-0000,Proprietary  ,13,40,53,53,83,136
02518300,SOUTH LOUISIANA BEAUTY COLLEGE          ,LA,70363-0000,Proprietary  ,13,37,50,22,47,69
02536400,LOUISIANA ACADEMY OF BEAUTY             ,LA,70535-0000,Proprietary  ,11,15,26,25,34,59
02538300,DELTA COLLEGE OF ARTS & TECH INC        ,LA,70806-1529,Proprietary  ,52,186,238,119,438,557
02538301,DELTA COLLEGE OF ARTS & TECHNOLOGY - LAF,LA,70508-6831,Proprietary  ,11,70,81,29,148,177
02548500,COSMETOLOGY TRAINING CENTER             ,LA,70503-0000,Proprietary  ,22,26,48,38,47,85
02554800,VANGUARD COLLEGE OF COSMETOLOGY         ,LA,70458-8823,Proprietary  ,42,73,115,85,117,202
02582200,"GUY'S ACADEMY HAIR, SKIN & NAILS        ",LA,71105-2404,Proprietary  ,21,70,91,43,149,192
02600900,AVEDA INSTITUTE                         ,LA,70433-2922,Proprietary  ,179,300,479,536,850,1386
02601000,AMERICAN SCHOOL OF BUSINESS             ,LA,71105-5646,Proprietary  ,4,15,19,12,47,59
02601100,OPELOUSAS SCHOOL OF COSMETOLOGY         ,LA,70570-6156,Proprietary  ,5,13,18,9,21,30
02606800,CAREER TRAINING SPECIALISTS             ,LA,71201-6046,Proprietary  ,113,318,431,280,755,1035
02606801,CAREER TECHNICAL COLLEGE - SHREVEPORT   ,LA,71105-2405,Proprietary  ,41,180,221,113,426,539
02617100,BATON ROUGE COLLEGE                     ,LA,70816-2246,Proprietary  ,10,54,64,43,106,149
02619200,DENHAM SPRINGS BEAUTY COLLEGE           ,LA,70726-3829,Proprietary  ,10,18,28,28,59,87
03010400,CRESCENT CITY SCH GAMING & BARTENDG     ,LA,70119-5507,Proprietary  ,20,322,342,33,405,438
03023500,CAMELOT CAREER COLLEGE                  ,LA,70805-7539,Proprietary  ,43,118,161,82,158,240
03030900,DIESEL DRIVING ACADEMY                  ,LA,70815-8109,Proprietary  ,11,134,145,27,334,361
03061400,ASCENSION COLLEGE                       ,LA,70737-2912,Proprietary  ,35,83,118,76,184,260
03095100,GRETNA CAREER COLLEGE                   ,LA,70053-2436,Proprietary  ,36,157,193,54,210,264
03106200,OUR LADY OF THE LAKE COLLEGE            ,LA,70808-4345,Private      ,150,448,598,774,1796,2570
03253300,JONESVILLE BEAUTY SCHOOL                ,LA,71343-0000,Proprietary  ,39,57,96,65,109,174
03294300,BLUE CLIFF SCH THERAPEUTIC MASSAGE      ,LA,70002-3458,Proprietary  ,92,297,389,232,684,916
03332600,DELTA COLLEGE                           ,LA,70433-9042,Proprietary  ,25,81,106,71,254,325
03332601,DELTA COLLEGE - SLIDELL                 ,LA,70460-2624,Proprietary  ,10,59,69,34,205,239
03356300,MEDICAL TRAINING COLLEGE                ,LA,70816-5820,Proprietary  ,28,95,123,84,250,334
03422500,BLUE CLIFF COLLEGE                      ,LA,71107-6520,Proprietary  ,49,159,208,126,437,563
03422600,BLUE CLIFF COLLEGE                      ,LA,70508-3858,Proprietary  ,45,167,212,182,497,679
03480300,MEDVANCE INSTITUTE                      ,LA,70809-1908,Proprietary  ,146,403,549,318,1146,1464
03498400,OMEGA INSTITUTE OF COSMETOLOGY          ,LA,70360-0000,Proprietary  ,11,8,19,25,31,56
03727500,MOORE CAREER COLLEGE                    ,LA,70808-4191,Proprietary  ,9,24,33,25,47,72
03730300,BATON ROUGE COMMUNITY COLLEGE           ,LA,78806-4129,Public       ,1247,1497,2744,4016,4598,8614
03752400,SCHOOL OF URBAN MISSIONS                ,LA,70053-0000,Private      ,43,46,89,78,76,154
03789300,UNITECH TRAINING ACADEMY                ,LA,70503-5132,Proprietary  ,74,428,502,104,528,632
03789400,RIVER PARISHES COMMUNITY COLLEGE        ,LA,70778-0310,Public       ,128,222,350,402,530,932
03810500,COURT REPORTING INSTITUTE OF LOUISI     ,LA,70816-0000,Proprietary  ,2,31,33,9,65,74
03956300,SOUTH LOUISIANA COMMUNITY COLLEGE       ,LA,70506-0000,Public       ,373,451,824,1288,1324,2612
04040300,COMPASS CAREER COLLEGE                  ,LA,70403-0653,Proprietary  ,15,79,94,44,187,231
04112300,LOUISIANA CULINARY INSTITUTE            ,LA,70816-4109,Proprietary  ,32,45,77,76,119,195
04120700,ALDEN'S SCHOOL OF COSMETOLOGY           ,LA,70714-1502,Proprietary  ,8,51,59,12,72,84
04130100,LOUISIANA DELTA COMMUNITY COLLEGE       ,LA,71203-3618,Public       ,272,377,649,810,984,1794
00143600,CAPITOL COLLEGE                         ,MD,20708-9759,Private      ,26,84,110,354,277,631
00146200,WASHINGTON BIBLE COLLEGE                ,MD,20706-3599,Private      ,23,115,138,80,378,458
00205700,ALLEGANY COLLEGE OF MARYLAND            ,MD,21502-2596,Public       ,317,404,721,2107,1634,3741
00205800,ANNE ARUNDEL COMMUNITY COLLEGE          ,MD,21012-1895,Public       ,963,1665,2628,3606,5113,8719
00206000,BALTIMORE HEBREW UNIVERSITY             ,MD,21215-3996,Private      ,0,0,0,5,38,43
00206100,BALTIMORE CITY COMMUNITY COLLEGE        ,MD,21215-7893,Public       ,657,2152,2809,3003,7445,10448
00206200,BOWIE STATE UNIVERSITY                  ,MD,20715-9465,Public       ,644,850,1494,6983,4338,11321
00206300,COMMUNITY COLLEGE OF BALTIMORE COUNTY   ,MD,21228-5381,Public       ,1863,3589,5452,6698,11132,17830
00206400,COLLEGE OF SOUTHERN MARYLAND            ,MD,20646-0910,Public       ,442,731,1173,2211,2633,4844
00206401,COLLEGE OF SOUTHERN MARYLAND - PRINCE FR,MD,20676-9702,Public       ,75,108,183,149,201,350
00206402,COLLEGE OF SOUTHERN MARYLAND - LEONARDTO,MD,20650-1758,Public       ,78,143,221,170,309,479
00206477,COLLEGE OF SOUTHERN MARYLAND - WALDORF C,MD,20602-3223,Public       ,36,66,102,69,134,203
00206500,CLG NOTRE DAME OF MARYLAND              ,MD,21210-2476,Private      ,23,248,271,722,1347,2069
00206700,COLUMBIA UNION COLLEGE                  ,MD,20912-7796,Private      ,146,205,351,790,763,1553
00206800,COPPIN STATE UNIVERSITY                 ,MD,21216-3698,Public       ,336,836,1172,4017,4013,8030
00207100,FREDERICK COMMUNITY COLLEGE             ,MD,21702-9745,Public       ,275,457,732,1531,1918,3449
00207200,FROSTBURG STATE UNIVERSITY              ,MD,21532-1099,Public       ,302,165,467,6135,1222,7357
00207300,GOUCHER COLLEGE                         ,MD,21204-2794,Private      ,34,76,110,2967,531,3498
00207400,HAGERSTOWN COMMUNITY COLLEGE            ,MD,21742-6590,Public       ,269,618,887,1449,2023,3472
00207500,HARFORD COMMUNITY COLLEGE               ,MD,21015-1696,Public       ,346,586,932,1731,2033,3764
00207600,HOOD COLLEGE                            ,MD,21701-8575,Private      ,60,152,212,2040,809,2849
00207700,JOHNS HOPKINS UNIVERSITY                ,MD,21218-2693,Private      ,90,314,404,7658,2029,9687
00207702,JOHNS HOPKINS UNIV SCH ARTS/SCI/ENG     ,MD,21218-0000,Private      ,62,314,376,3807,1741,5548
00207703,JOHNS HOPKINS UNIV SCH OF BUS/ED        ,MD,21046-0000,Private      ,5,194,199,41,1308,1349
00207705,JOHNS HOPKINS BLOOMBERG SCH OF PH       ,MD,21205-0000,Private      ,1,106,107,21,1262,1283
00207706,JOHNS HOPKINS UNIV SCH OF MEDICINE      ,MD,21205-0000,Private      ,12,45,57,109,1092,1201
00207707,JOHNS HOPKINS UNIV SCH OF NURSING       ,MD,21205-0000,Private      ,2,90,92,221,810,1031
00207708,JOHNS HOPKINS UNIV PEABODY CONSERV      ,MD,21202-2397,Private      ,8,19,27,590,423,1013
00207800,LOYOLA UNIVERSITY MARYLAND              ,MD,21210-2699,Private      ,93,310,403,6824,1850,8674
00208000,MARYLAND INST COLLEGE OF ART            ,MD,21217-4191,Private      ,49,36,85,2510,782,3292
00208300,MORGAN STATE UNIVERSITY                 ,MD,21251-0002,Public       ,821,930,1751,11228,4744,15972
00208600,MOUNT SAINT MARY'S UNIVERSITY           ,MD,21727-7799,Private      ,66,76,142,2616,320,2936
00208700,NER ISRAEL RABBINICAL COLLEGE           ,MD,21208-1198,Private      ,10,11,21,83,42,125
00208900,PRINCE GEORGES COMMUNITY COLLEGE        ,MD,20774-2199,Public       ,1236,2159,3395,4870,7323,12193
00209100,SALISBURY UNIVERSITY                    ,MD,21801-6862,Public       ,465,252,717,9535,1729,11264
00209200,ST JOHN'S COLLEGE                       ,MD,21404-0000,Private      ,13,26,39,616,169,785
00209500,ST. MARY'S COLLEGE OF MARYLAND          ,MD,20686-3001,Public       ,66,19,85,2564,180,2744
00209600,ST MARY'S SEMINARY & UNIV               ,MD,21210-1994,Private      ,2,8,10,22,24,46
00209900,TOWSON UNIVERSITY                       ,MD,21252-0002,Public       ,907,907,1814,20141,6262,26403
00210200,UNIVERSITY OF BALTIMORE                 ,MD,21201-5779,Public       ,153,932,1085,1385,5958,7343
00210300,"UNIVERSITY OF MARYLAND, COLLEGE PARK    ",MD,20742-5145,Public       ,1348,1964,3312,29830,12045,41875
00210400,"UNIVERSITY OF MARYLAND, BALTIMORE       ",MD,21201-1691,Public       ,106,665,771,2150,8575,10725
00210500,UMBC                                    ,MD,21250-0002,Public       ,452,527,979,8343,3670,12013
00210600,UNIVERSITY MARYLAND EASTERN SHORE       ,MD,21853-4053,Public       ,434,249,683,5258,1571,6829
00210700,STEVENSON UNIVERSITY                    ,MD,21153-0641,Private      ,134,185,319,3943,1064,5007
00210800,WASHINGTON COLLEGE                      ,MD,21620-1197,Private      ,49,12,61,2688,109,2797
00210900,MCDANIEL COLLEGE                        ,MD,21157-4390,Private      ,52,120,172,2792,582,3374
00458612,KAPLAN COLLEGE                          ,MD,21742-2797,Proprietary  ,74,291,365,364,1047,1411
00458613,KAPLAN COLLEGE -  CAREER TECHNOLOGY CENT,MD,21742-2797,Proprietary  ,1,6,7,18,48,66
00458614,KAPLAN COLLEGE - FREDERICK              ,MD,21704-8307,Proprietary  ,27,93,120,71,276,347
00465000,CHESAPEAKE COLLEGE                      ,MD,21679-0008,Public       ,153,346,499,1007,1346,2353
00691100,MONTGOMERY COLLEGE                      ,MD,20850-1195,Public       ,1561,1935,3496,8432,7873,16305
00734100,INTERNATIONAL BEAUTY SCHOOL             ,MD,21502-2370,Proprietary  ,36,257,293,64,378,442
00744700,DEL-MAR-VA BEAUTY ACADEMY               ,MD,21804-0000,Proprietary  ,24,45,69,40,68,108
00749100,TESST COLLEGE OF TECHNOLOGY             ,MD,21227-1063,Proprietary  ,101,400,501,380,1427,1807
00793600,LINCOLN TECHNICAL INSTITUTE             ,MD,21046-1544,Proprietary  ,329,452,781,732,814,1546
00817500,HOWARD COMMUNITY COLLEGE                ,MD,21044-3197,Public       ,435,681,1116,2417,2790,5207
00826300,AWARD BEAUTY SCHOOL                     ,MD,21740-5624,Proprietary  ,35,133,168,49,185,234
00830800,CECIL COLLEGE                           ,MD,21901-1999,Public       ,162,255,417,867,880,1747
00907906,EVEREST COLLEGE- EVEREST INSTITUTE      ,MD,20910-3737,Proprietary  ,122,280,402,229,523,752
01001400,GARRETT COMMUNITY COLLEGE               ,MD,21541-1265,Public       ,144,117,261,723,335,1058
01031900,MEDIX SCHOOL                            ,MD,21204-2538,Proprietary  ,197,708,905,502,1728,2230
01041000,TESST COLLEGE OF TECHNOLOGY             ,MD,21286-2201,Proprietary  ,37,138,175,153,584,737
01164400,UNIV OF MARYLAND UNIVERSITY COLLEGE     ,MD,20783-8078,Public       ,463,6881,7344,1975,21562,23537
01164402,U OF MD UNIVERSITY COLLEGE - EUROPE     ,MD,20832-0000,Public       ,46,320,366,257,1170,1427
01164404,U OF MD UNIVERSITY COLLEGE - ASIA       ,MD,31207-0000,Public       ,16,173,189,66,608,674
02073900,WOR-WIC COMMUNITY COLLEGE               ,MD,21804-0000,Public       ,312,663,975,1332,2396,3728
02083600,TESST COLLEGE OF TECHNOLOGY             ,MD,20705-2698,Proprietary  ,89,185,274,360,746,1106
02116005,SANFORD-BROWN INSTITUTE - LANDOVER      ,MD,20785-2287,Proprietary  ,57,294,351,128,865,993
02127900,SOJOURNER DOUGLASS COLLEGE              ,MD,21205-0000,Private      ,27,418,445,146,2172,2318
02155100,MARYLAND COLLEGE OF ART AND DESIGN      ,MD,20902-0000,Private      ,4,11,15,61,52,113
02269700,INTERNATIONAL BEAUTY SCHOOL             ,MD,21014-0000,Proprietary  ,9,25,34,21,40,61
02314800,BALTIMORE INTERNATIONAL COLLEGE         ,MD,21202-0000,Private      ,66,116,182,552,472,1024
02331000,MARYLAND BEAUTY ACADEMY OF ESSEX        ,MD,21221-0000,Proprietary  ,20,41,61,41,94,135
02333000,HAIR ACADEMY                            ,MD,20784-0000,Proprietary  ,74,228,302,101,288,389
02343800,MONTGOMERY BEAUTY SCHOOL                ,MD,20901-0000,Proprietary  ,24,61,85,41,127,168
02494700,BALTIMORE STUDIO OF HAIR DESIGN         ,MD,21201-0000,Proprietary  ,20,86,106,46,174,220
02495000,ROBERT PAUL ACAD COSMTGY ARTS & SCI     ,MD,21093-0000,Proprietary  ,18,12,30,54,54,108
02495100,MARYLAND BEAUTY ACADEMY                 ,MD,21136-0000,Proprietary  ,0,21,21,6,32,38
02545400,NORTH AMERICAN TRADE SCHOOLS            ,MD,21244-0069,Proprietary  ,100,408,508,140,605,745
02573800,"L' ACADEMIE DE CUISINE, INC.            ",MD,20877-0000,Proprietary  ,8,33,41,34,113,147
02578400,TAI SOPHIA INSTITUTE                    ,MD,20723-6010,Private      ,0,63,63,0,226,226
03027200,BLADES SCHOOL OF HAIR DESIGN            ,MD,20619-0226,Proprietary  ,15,30,45,25,57,82
03064900,AARON'S ACADEMY OF BEAUTY               ,MD,20602-2715,Proprietary  ,13,27,40,27,68,95
03097200,AESTHETICS INSTITUTE OF COSMETOLOGY     ,MD,20877-1305,Proprietary  ,2,21,23,11,39,50
03100700,CARROLL COMMUNITY COLLEGE               ,MD,21157-6913,Public       ,132,221,353,962,800,1762
03148300,AMERICAN BEAUTY ACADEMY                 ,MD,20902-1911,Proprietary  ,109,242,351,188,449,637
03296300,BALTIMORE SCHOOL OF MASSAGE             ,MD,21090-2261,Proprietary  ,64,218,282,164,461,625
03327300,NEW CREATIONS ACADEMY OF HAIR DSN       ,MD,20746-2960,Proprietary  ,2,16,18,8,27,35
03455500,NATIONAL LABOR COLLEGE                  ,MD,20903-1790,Private      ,0,37,37,0,46,46
03493300,ALL-STATE CAREER SCHOOL                 ,MD,21224-6658,Proprietary  ,163,714,877,297,1165,1462
03771300,AMERICAN CAREER INSTITUTE               ,MD,20902-4637,Proprietary  ,27,162,189,45,221,266
03822400,MAPLE SPRINGS BAPTIST BIBLE COLLEGE & SE,MD,20743-5711,Private      ,0,12,12,2,48,50
03937300,YESHIVA COLLEGE OF THE NATION'S CAPITAL ,MD,20902-1700,Private      ,2,1,3,7,2,9
03965500,HAIR EXPRESSIONS ACADEMY                ,MD,20852-1729,Proprietary  ,12,34,46,26,58,84
04121600,FILA ACADEMY (THE)                      ,MD,21061-1634,Proprietary  ,18,58,76,33,98,131
04139700,FREDERICK SCHOOL OF COSMETOLOGY         ,MD,21701-0000,Proprietary  ,5,8,13,13,23,36
04141600,OMEGA STUDIOS' SCHOOL OF APPLIED RECORDI,MD,20852-1731,Proprietary  ,20,31,51,27,50,77
04151800,TEMPLE (THE): A PAUL MITCHELL PARTNER SC,MD,21701-5409,Proprietary  ,31,43,74,31,43,74
00211400,AMERICAN INTERNATIONAL COLLEGE          ,MA,01109-3189,Private      ,150,595,745,1993,2148,4141
00211500,AMHERST COLLEGE                         ,MA,01002-5000,Private      ,71,22,93,4556,165,4721
00211600,ANDOVER NEWTON THEOLOGICAL SCHOOL       ,MA,02459-0000,Private      ,0,30,30,0,193,193
00211700,ANNA MARIA COLLEGE                      ,MA,01612-1198,Private      ,53,106,159,1724,425,2149
00211800,ASSUMPTION COLLEGE                      ,MA,01615-1294,Private      ,31,82,113,4165,558,4723
00211900,ATLANTIC UNION COLLEGE                  ,MA,01561-1000,Private      ,61,65,126,298,289,587
00212000,MERRIMACK COLLEGE                       ,MA,01845-5800,Private      ,73,66,139,3892,232,4124
00212100,BABSON COLLEGE                          ,MA,02457-0310,Private      ,65,191,256,2346,851,3197
00212200,BAY PATH COLLEGE                        ,MA,01106-2212,Private      ,39,559,598,812,1671,2483
00212300,BECKER COLLEGE-WORCESTER                ,MA,01615-0071,Private      ,155,201,356,2125,986,3111
00212400,BENTLEY UNIVERSITY                      ,MA,02452-4705,Private      ,72,155,227,5710,843,6553
00212600,BERKLEE COLLEGE OF MUSIC                ,MA,02215-3693,Private      ,317,213,530,3809,975,4784
00212800,BOSTON COLLEGE                          ,MA,02467-3800,Private      ,197,337,534,18962,7174,26136
00212900,BOSTON CONSERVATORY OF MUSIC            ,MA,02215-9830,Private      ,19,8,27,1032,286,1318
00213000,BOSTON UNIVERSITY                       ,MA,02215-1789,Private      ,444,1666,2110,29737,17092,46829
00213300,BRANDEIS UNIVERSITY                     ,MA,02453-2700,Private      ,108,128,236,4715,1251,5966
00213900,CLARK UNIVERSITY                        ,MA,01610-1473,Private      ,64,96,160,3734,603,4337
00214000,ELMS COLLEGE                            ,MA,01013-2839,Private      ,30,67,97,1012,540,1552
00214100,COLLEGE OF THE HOLY CROSS               ,MA,01610-2395,Private      ,42,6,48,5481,93,5574
00214300,CURRY COLLEGE                           ,MA,02186-2395,Private      ,80,243,323,4024,973,4997
00214400,DEAN COLLEGE                            ,MA,02038-1994,Private      ,84,36,120,1446,177,1623
00214500,EASTERN NAZARENE COLLEGE                ,MA,02170-2999,Private      ,97,179,276,761,446,1207
00214507,EASTERN NAZARENE CLG - LEAD PROGRAM     ,MA,02170-0000,Private      ,1,17,18,11,73,84
00214600,EMERSON COLLEGE                         ,MA,02116-4624,Private      ,80,79,159,6630,1441,8071
00214700,EMMANUEL COLLEGE                        ,MA,02115-5798,Private      ,42,79,121,4425,436,4861
00214800,ENDICOTT COLLEGE                        ,MA,01915-2098,Private      ,72,85,157,3953,326,4279
00214900,EPISCOPAL DIVINITY SCHOOL               ,MA,02138-0000,Private      ,0,15,15,1,76,77
00215000,FISHER COLLEGE                          ,MA,02116-1500,Private      ,143,256,399,1279,807,2086
00215100,BENJAMIN FRANKLIN INSTITUTE OF TECH     ,MA,02116-6296,Public       ,92,89,181,680,284,964
00215300,GORDON COLLEGE                          ,MA,01984-1899,Private      ,78,21,99,1944,86,2030
00215400,HELLENIC COLLEGE                        ,MA,02445-7496,Private      ,6,25,31,55,97,152
00215500,HARVARD UNIVERSITY                      ,MA,02138-3800,Private      ,136,158,294,6811,1079,7890
00215501,AMRCN REPERTORY THTR INST ADV THTR      ,MA,02138-0000,Private      ,0,2,2,5,103,108
00215502,HARVARD BUSINESS SCHOOL                 ,MA,02163-0000,Private      ,14,83,97,215,1699,1914
00215503,HARVARD EXTENSION SCHOOL                ,MA,02138-0000,Private      ,35,310,345,138,1133,1271
00215504,HARVARD SCH OF DENTAL MEDICINE          ,MA,02115-0000,Private      ,0,13,13,9,170,179
00215505,HARVARD UNIV GRAD SCH DESIGN            ,MA,02138-0000,Private      ,0,26,26,6,1031,1037
00215506,HARVARD DIVINITY SCHOOL                 ,MA,02138-0000,Private      ,9,20,29,26,715,741
00215507,HARVARD UNIV GRAD SCH ED                ,MA,02138-0000,Private      ,0,41,41,5,1395,1400
00215508,HARVARD UNIV GRAD S OF ARTS & SCIEN     ,MA,02138-0000,Private      ,4,70,74,93,922,1015
00215509,HARVARD JOHN F KENNEDY SCHL OF GOVT     ,MA,02138-0000,Private      ,1,40,41,22,1429,1451
00215510,HARVARD LAW SCHOOL                      ,MA,02138-0000,Private      ,7,92,99,76,4350,4426
00215511,HARVARD UNIV MEDICAL SCHOOL             ,MA,02115-0000,Private      ,15,24,39,119,1026,1145
00215512,HARVARD UNIV SCH PUBLIC HEALTH          ,MA,02115-0000,Private      ,2,25,27,39,799,838
00215513,HARVARD UNIVERSITY-HARVARD COLLEGE      ,MA,02138-0000,Private      ,141,36,177,14069,353,14422
00215700,HEBREW COLLEGE                          ,MA,02459-2237,Private      ,0,15,15,2,78,80
00215800,LASELL COLLEGE                          ,MA,02466-2716,Private      ,58,32,90,2823,203,3026
00216000,LESLEY UNIVERSITY                       ,MA,02138-2790,Private      ,123,949,1072,2536,4352,6888
00216100,UMASS LOWELL                            ,MA,01854-3089,Public       ,743,1102,1845,9542,4098,13640
00216300,MARIST COLLEGE & SEMINARY               ,MA,01701-0000,Private      ,0,7,7,2,526,528
00216400,NEW ENGLAND COLLEGE OF OPTOMETRY        ,MA,02115-1129,Private      ,0,14,14,7,396,403
00216500,MASS. COLLEGE OF PHARMACY  & HEALTH SCIE,MA,02115-5804,Private      ,81,173,254,3880,2418,6298
00216700,BERKSHIRE COMMUNITY COLLEGE             ,MA,01201-5786,Public       ,134,288,422,867,1145,2012
00216800,CAPE COD COMMUNITY COLLEGE              ,MA,02668-1599,Public       ,362,504,866,1547,1643,3190
00216900,GREENFIELD COMMUNITY COLLEGE            ,MA,01301-9739,Public       ,222,424,646,789,1225,2014
00217000,HOLYOKE COMMUNITY COLLEGE               ,MA,01040-1099,Public       ,584,991,1575,3431,3790,7221
00217100,MASSACHUSETTS BAY COMMUNITY COLLEGE     ,MA,02181-0000,Public       ,381,521,902,2114,2055,4169
00217200,MOUNT WACHUSETT COMMUNITY COLLEGE       ,MA,01440-1000,Public       ,301,712,1013,1703,2602,4305
00217300,NORTH SHORE COMMUNITY COLLEGE           ,MA,01923-4093,Public       ,798,1118,1916,2912,3368,6280
00217400,NORTHERN ESSEX COMMUNITY COLLEGE        ,MA,01830-2399,Public       ,775,1317,2092,2572,3408,5980
00217500,QUINSIGAMOND COMMUNITY COLLEGE          ,MA,01606-2092,Public       ,800,1157,1957,3480,3690,7170
00217600,BRISTOL COMMUNITY COLLEGE               ,MA,02720-7399,Public       ,841,948,1789,3572,3614,7186
00217700,MASSASOIT COMMUNITY COLLEGE             ,MA,02302-3996,Public       ,603,732,1335,2941,3034,5975
00217800,MASSACHUSETTS INST OF TECHNOLOGY        ,MA,02139-4307,Private      ,120,219,339,10298,2691,12989
00218000,MASSACHUSETTS COLLEGE OF ART AND DESIGN ,MA,02115-5803,Public       ,72,73,145,2366,712,3078
00218100,MASSACHUSETTS MARITIME ACADEMY          ,MA,02532-3400,Public       ,53,14,67,1230,82,1312
00218300,BRIDGEWATER STATE COLLEGE               ,MA,02325-0001,Public       ,539,454,993,10953,2776,13729
00218400,FITCHBURG STATE COLLEGE                 ,MA,01420-2697,Public       ,194,224,418,5517,1316,6833
00218500,FRAMINGHAM STATE COLLEGE                ,MA,01702-2471,Public       ,223,194,417,4950,1027,5977
00218700,MASSACHUSETTS CLG OF LIBERAL ARTS       ,MA,01247-4100,Public       ,105,93,198,2071,496,2567
00218800,SALEM STATE COLLEGE                     ,MA,01970-5353,Public       ,568,648,1216,8321,3166,11487
00218900,WESTFIELD STATE COLLEGE                 ,MA,01086-1630,Public       ,317,214,531,7575,1182,8757
00219000,WORCESTER STATE COLLEGE                 ,MA,01602-2597,Public       ,259,343,602,5340,1851,7191
00219200,MOUNT HOLYOKE COLLEGE                   ,MA,01075-1492,Private      ,41,17,58,2497,307,2804
00219300,MOUNT IDA COLLEGE                       ,MA,02459-3323,Private      ,51,35,86,2204,319,2523
00219400,NEW ENGLAND CONSERVATORY OF MUSIC       ,MA,02115-5018,Private      ,13,4,17,724,626,1350
00219700,NICHOLS COLLEGE                         ,MA,01571-6346,Private      ,59,92,151,2052,338,2390
00219900,NORTHEASTERN UNIVERSITY                 ,MA,02115-5000,Private      ,475,1562,2037,29984,9943,39927
00220100,PINE MANOR COLLEGE                      ,MA,02167-0000,Private      ,44,17,61,549,168,717
00220200,BLESSED JOHN XXIII NATIONAL SEMINARY    ,MA,02493-0000,Private      ,0,1,1,0,3,3
00220500,QUINCY COLLEGE                          ,MA,02169-4501,Public       ,296,621,917,1242,2330,3572
00220600,REGIS COLLEGE                           ,MA,02193-0000,Private      ,48,70,118,1810,586,2396
00220800,SIMMONS COLLEGE                         ,MA,02115-5898,Private      ,61,367,428,3070,3317,6387
00220900,SMITH COLLEGE                           ,MA,01063-2936,Private      ,71,33,104,3547,939,4486
00221000,UNIV OF MASSACHUSETTS-DARTMOUTH         ,MA,02747-2300,Public       ,394,301,695,10790,2147,12937
00221100,SPRINGFIELD COLLEGE                     ,MA,01109-3797,Private      ,148,836,984,3873,3724,7597
00221400,ST JOHN'S SEMINARY                      ,MA,02135-8839,Private      ,8,35,43,10,48,58
00221700,STONEHILL COLLEGE                       ,MA,02357-6110,Private      ,72,15,87,5506,104,5610
00221800,SUFFOLK UNIVERSITY                      ,MA,02108-2770,Private      ,139,340,479,9328,2434,11762
00221802,SUFFOLK UNIVERSITY LAW SCHOOL           ,MA,02108-0000,Private      ,2,77,79,169,2847,3016
00221900,TUFTS UNIVERSITY                        ,MA,02155-5808,Private      ,80,168,248,9796,2502,12298
00221901,TUFTS UNIV SCH OF DENTAL MEDICINE       ,MA,02111-0000,Private      ,0,14,14,10,819,829
00221902,TUFTS UNIVERSITY - CUMMINGS SCHOOL OF VE,MA,01536-0000,Private      ,0,5,5,33,429,462
00221904,TUFTS UNIV SCHOOL OF MEDICINE           ,MA,02111-0000,Private      ,4,65,69,55,1734,1789
00222100,UNIV OF MASSACHUSETTS-AMHERST           ,MA,01003-0000,Public       ,1173,939,2112,32418,6587,39005
00222200,UNIV OF MASSACHUSETTS-BOSTON            ,MA,02125-3393,Public       ,626,1309,1935,10004,8211,18215
00222400,WELLESLEY COLLEGE                       ,MA,02481-8203,Private      ,54,10,64,3377,152,3529
00222500,WENTWORTH INSTITUTE OF TECHNOLOGY       ,MA,02115-5998,Private      ,206,129,335,4656,605,5261
00222600,WESTERN NEW ENGLAND COLLEGE             ,MA,01119-2654,Private      ,87,167,254,4961,1613,6574
00222700,WHEATON COLLEGE                         ,MA,02766-2322,Private      ,30,5,35,2538,61,2599
00222800,WHEELOCK COLLEGE                        ,MA,02215-4176,Private      ,29,88,117,1345,566,1911
00222900,WILLIAMS COLLEGE                        ,MA,01267-2600,Private      ,46,5,51,3575,103,3678
00223300,WORCESTER POLYTECHNIC INSTITUTE         ,MA,01609-2280,Private      ,79,95,174,5790,431,6221
00396500,BAY STATE COLLEGE                       ,MA,02116-2901,Proprietary  ,120,157,277,1184,636,1820
00396600,BOSTON ARCHITECTURAL COLLEGE            ,MA,02115-2795,Private      ,42,178,220,487,1021,1508
00466100,HAMPSHIRE COLLEGE                       ,MA,01002-3359,Private      ,53,6,59,2338,101,2439
00466600,SALTER COLLEGE                          ,MA,01583-1700,Proprietary  ,195,916,1111,611,2674,3285
00466700,SCHOOL OF MUSEUM OF FINE ARTS           ,MA,02115-5534,Private      ,20,17,37,854,260,1114
00466900,UPPER CAPE COD REGIONAL VOC TECH        ,MA,02532-3310,Public       ,1,6,7,12,99,111
00527900,GREATER LOWELL REGNL VOC TECH SCH       ,MA,01879-0000,Public       ,3,29,32,24,86,110
00551900,DIMAN REGIONAL VOC TECH INST            ,MA,02723-3519,Public       ,2,8,10,28,65,93
00552300,BLUE HILLS REGIONAL VOC TECH            ,MA,02021-1398,Public       ,2,15,17,20,139,159
00555700,MCCANN TECHNICAL SCHOOL                 ,MA,01247-0000,Public       ,3,17,20,16,60,76
00613600,NATIONAL AVIATION ACADEMY - NEW ENGLAND ,MA,01730-2620,Proprietary  ,23,34,57,78,107,185
00632200,BROCKTON HOSPITAL SCH OF NURSING        ,MA,02302-0000,Private      ,9,43,52,124,396,520
00632400,LABOURE COLLEGE                         ,MA,02124-5698,Private      ,38,139,177,198,665,863
00633100,LAWRENCE MEM HOSPITAL SCH OF NRSNG      ,MA,02155-1643,Private      ,6,55,61,62,355,417
00635200,BAYSTATE MEDICAL CENTER                 ,MA,01199-0001,Private      ,0,8,8,3,27,30
00687300,MARIAN COURT COLLEGE                    ,MA,01907-2896,Private      ,28,24,52,163,94,257
00748100,GIBBS COLLEGE                           ,MA,02116-2904,Proprietary  ,34,104,138,75,194,269
00748400,NEWBURY COLLEGE                         ,MA,02445-5796,Private      ,67,48,115,1850,262,2112
00748600,THE NEW ENGLAND INSTITUTE OF ART        ,MA,02445-7295,Proprietary  ,159,136,295,1888,677,2565
00748800,KAPLAN CAREER INSTITUTE                 ,MA,02129-1644,Proprietary  ,68,203,271,155,561,716
00748801,KAPLAN CAREER INSTITUTE -               ,MA,02215-2606,Proprietary  ,25,151,176,25,153,178
00807800,SPRINGFIELD TECHNICAL COMMUNITY CLG     ,MA,01105-0000,Public       ,689,1346,2035,2581,4281,6862
00809002,EVEREST COLLEGE - EVEREST INSTITUTE     ,MA,02150-2333,Proprietary  ,65,190,255,102,354,456
00891600,NEW ENGLAND SCHOOL OF LAW               ,MA,02116-0000,Private      ,0,56,56,8,2238,2246
00964500,BARD COLLEGE AT SIMON'S ROCK            ,MA,01230-9702,Private      ,20,2,22,467,22,489
00974700,GORDON-CONWELL THEOLOGICAL SEMINARY     ,MA,01982-0000,Private      ,1,90,91,5,532,537
00975600,UNIVERSITY OF MASS MEDICAL CENTER       ,MA,01655-0000,Public       ,1,64,65,27,785,812
00987700,HENRI'S SCHOOL OF HAIR DESIGN           ,MA,01420-5675,Proprietary  ,13,13,26,22,19,41
00989900,LOWELL ACADEMY HAIRSTYLING INST         ,MA,01852-1909,Proprietary  ,12,27,39,22,40,62
00993600,MIDDLESEX COMMUNITY COLLEGE             ,MA,01730-1197,Public       ,314,360,674,1432,1064,2496
00993602,"MIDDLESEX COMMUNITY COLLEGE, LOWELL     ",MA,01852-0000,Public       ,475,606,1081,2243,1904,4147
01121000,BUNKER HILL COMMUNITY COLLEGE           ,MA,02129-2991,Public       ,900,1572,2472,4041,6131,10172
01151000,EVEREST INSTITUTE                       ,MA,02135-7638,Proprietary  ,75,195,270,146,414,560
01193000,ROXBURY COMMUNITY COLLEGE               ,MA,02120-3400,Public       ,276,846,1122,996,2439,3435
01204200,MANSFIELD BEAUTY SCHOOLS                ,MA,02169-5061,Proprietary  ,10,22,32,26,65,91
01206800,MANSFIELD BEAUTY SCHOOL                 ,MA,01103-1410,Proprietary  ,3,17,20,10,38,48
01238600,SOUTHEASTERN TECHNICAL INSTITUTE        ,MA,02375-1780,Public       ,11,61,72,47,188,235
01288100,MONTACHUSETT REG VOC TECH SCH           ,MA,01420-4649,Public       ,0,9,9,9,45,54
01292100,EMPIRE BEAUTY SCHOOL                    ,MA,02215-0000,Proprietary  ,42,87,129,164,335,499
01292101,EMPIRE BEAUTY SCHOOL - HYANNIS          ,MA,02601-2022,Proprietary  ,2,4,6,22,21,43
01294800,ROB ROY ACADEMY                         ,MA,02721-5330,Proprietary  ,26,50,76,41,90,131
02063000,MONTSERRAT COLLEGE OF ART               ,MA,01915-0000,Private      ,16,2,18,548,48,596
02063800,BUTERA SCHOOL OF ART                    ,MA,02116-0000,Proprietary  ,2,1,3,36,12,48
02076700,EMPIRE BEAUTY SCHOOL                    ,MA,02148-0000,Proprietary  ,22,38,60,63,162,225
02079400,EMPIRE BEAUTY SCHOOL                    ,MA,02453-0000,Proprietary  ,24,61,85,49,135,184
02092100,MASSACHUSETTS SCHOOL OF BARBERING       ,MA,02169-0000,Proprietary  ,22,34,56,33,87,120
02092200,EMPIRE BEAUTY SCHOOL                    ,MA,01852-0000,Proprietary  ,20,28,48,53,130,183
02122000,NEW ENGLAND HAIR ACADEMY                ,MA,02148-0000,Proprietary  ,17,50,67,52,95,147
02137000,ROB ROY ACADEMY                         ,MA,02780-0000,Proprietary  ,15,21,36,24,38,62
02137200,MASS GEN HOSP DIETETIC INTERNSHIP       ,MA,02114-0000,Private      ,0,0,0,3,10,13
02143000,LONGY SCHOOL OF MUSIC                   ,MA,02138-3599,Private      ,8,3,11,47,135,182
02163500,NEW ENGLAND SCHOOL OF PHOTOGRAPHY       ,MA,02215-0000,Proprietary  ,24,35,59,131,111,242
02163600,MASS SCH OF PROFESSIONAL PSYCHOLOGY     ,MA,02132-0000,Private      ,0,8,8,0,8,8
02169900,ASSABET VALLEY REGIONAL VOC SCHOOL      ,MA,01752-0000,Public       ,6,18,24,17,78,95
02181600,ROB ROY ACADEMY                         ,MA,01609-0000,Proprietary  ,36,66,102,70,154,224
02182900,CAMBRIDGE COLLEGE                       ,MA,02138-5304,Private      ,97,1779,1876,280,3908,4188
02197900,NORTH BENNET STREET SCHOOL              ,MA,02113-0000,Private      ,5,18,23,38,93,131
02215100,HALLMARK INSTITUTE OF PHOTOGRAPHY       ,MA,01376-0000,Proprietary  ,0,0,0,138,106,244
02219501,MILDRED ELLEY - PITTSFIELD              ,MA,01201-5300,Proprietary  ,3,13,16,6,24,30
02220400,CATHERINE HINDS INST OF ESTHETICS       ,MA,01801-0000,Proprietary  ,12,66,78,47,127,174
02231600,MGH INSTITUTE OF HEALTH PROFESSION      ,MA,02129-0000,Private      ,0,56,56,34,1027,1061
02274300,CONWAY SCHOOL OF LANDSCAPE DESIGN       ,MA,01341-0179,Private      ,0,2,2,3,23,26
02325700,LABARON HAIRDRESSING ACADEMY            ,MA,02740-0000,Proprietary  ,17,26,43,27,43,70
02325800,LABARON HAIRDRESSING ACAD-BROCKTON      ,MA,02301-0000,Proprietary  ,9,24,33,18,41,59
02337400,BANCROFT SCHOOL OF MASSAGE THERAPY      ,MA,01604-4614,Proprietary  ,7,22,29,16,45,61
02338200,BAY STATE SCHOOL OF TECHNOLOGY          ,MA,02021-0000,Proprietary  ,26,190,216,46,300,346
02339400,ROB ROY ACADEMY                         ,MA,02746-0000,Proprietary  ,1,5,6,6,11,17
02491700,CORTIVA INSTITUTE -  BOSTON             ,MA,02472-2577,Proprietary  ,10,73,83,30,196,226
02523900,ELIZABETH GRADY SCHOOL OF ESTHETICS     ,MA,02155-0000,Proprietary  ,15,50,65,35,93,128
02579800,NEW ENGLAND SCHOOL OF ACUPUNCTURE       ,MA,02458-0000,Private      ,0,26,26,1,160,161
03006802,PENNSYLVANIA CULINARY INSTITUTE - LE COR,MA,02142-1221,Proprietary  ,71,192,263,190,511,701
03066700,AILANO SCHOOL OF COSMETOLOGY            ,MA,02303-4740,Proprietary  ,7,13,20,25,27,52
03104000,SHAWSHEEN ADULT TECHNICAL INSTITUTE     ,MA,01821-5499,Public       ,3,6,9,13,45,58
03115200,MOTORING TECHNICAL TRAINING INST        ,MA,02771-5933,Proprietary  ,32,91,123,115,207,322
03120800,KAY HARVEY HAIRDRESSING ACADEMY         ,MA,01089-2701,Proprietary  ,8,18,26,16,29,45
03127700,SOUTHERN NEW ENGLAND SCHOOL OF LAW      ,MA,02747-1252,Private      ,0,22,22,3,259,262
03130500,URBAN COLLEGE OF BOSTON                 ,MA,02111-1093,Private      ,12,181,193,46,577,623
03194300,BOSTON GRAD SCH OF PSYCHOANALYSIS       ,MA,02446-4602,Private      ,0,23,23,2,79,81
03196300,LINCOLN TECHNICAL INSTITUTE             ,MA,02145-1102,Proprietary  ,122,250,372,312,682,994
03196302,LINCOLN TECHNICAL INSTITUTE             ,MA,01852-5119,Proprietary  ,119,265,384,267,603,870
03205400,JOLIE HAIR & BEAUTY ACADEMY             ,MA,01056-2769,Proprietary  ,13,55,68,17,79,96
03232302,LINCOLN TECHNICAL INSTITUTE             ,MA,02401-1818,Proprietary  ,85,190,275,218,583,801
03235300,MASSACHUSETTS SCHOOL OF LAW             ,MA,01810-1094,Private      ,0,124,124,2,639,641
03240300,HAIR IN MOTION BEAUTY ACADEMY           ,MA,01604-2213,Proprietary  ,2,12,14,7,15,22
03248300,BOSTON BAPTIST COLLEGE                  ,MA,02136-4000,Private      ,21,12,33,94,43,137
03316400,FUNERAL INSTITUTE OF THE NORTHEAST      ,MA,02062-4766,Proprietary  ,7,15,22,21,77,98
03504300,NATL GRAD SCH OF QUALITY SYSTM MGMT     ,MA,02540-0000,Private      ,0,20,20,0,25,25
03763300,MEDICAL PROFESSIONAL INSTITUTE          ,MA,02148-8143,Proprietary  ,6,36,42,15,108,123
03859300,E.I.N.E.                                ,MA,01876-4709,Proprietary  ,1,18,19,2,30,32
03946300,FRANKLIN W. OLIN COLLEGE OF ENGINEERING ,MA,02492-1200,Private      ,5,0,5,392,4,396
03965300,NEW ENGLAND COLLEGE OF FINANCE          ,MA,02110-1605,Proprietary  ,5,42,47,12,96,108
04039300,SULLIVAN AND COGLIANO TRAINING CENTER   ,MA,02301-1822,Proprietary  ,36,486,522,56,900,956
04116900,DIGRIGOLI SCHOOL OF COSMETOLOGY         ,MA,01089-4623,Proprietary  ,9,16,25,21,33,54
04128000,MILLENNIUM TRAINING INSTITUTE           ,MA,01801-6386,Proprietary  ,2,32,34,6,65,71
04128900,CENTRAL MASS SCHOOL OF MASSAGE AND THERA,MA,01562-1712,Proprietary  ,1,12,13,5,23,28
00324204,CARNEGIE MELLON UNIVERSITY - QATAR      ,FC,00000-0000,Private      ,0,1,1,0,3,3
00324206,CARNEGIE MELLON UNIVERSITY  - THE HEINZ ,FC,00000-0000,Private      ,0,0,0,0,5,5
00337112,TEMPLE UNIVERSITY - JAPAN               ,FC,00000-0000,Private      ,7,16,23,37,32,69
00369101,MIDDLEBURY COLLEGE - FRANCE             ,FC,00000-0000,Private      ,1,2,3,5,5,10
00369102,MIDDLEBURY COLLEGE - GERMANY            ,FC,00000-0000,Private      ,1,2,3,1,8,9
00369103,MIDDLEBURY COLLEGE - ITALY              ,FC,00000-0000,Private      ,3,1,4,5,7,12
00369104,MIDDLEBURY COLLEGE - SPAIN              ,FC,00000-0000,Private      ,0,3,3,7,17,24
00369105,MIDDLEBURY COLLEGE - RUSSIA             ,FC,00000-0000,Private      ,0,0,0,1,4,5
00369107,MIDDLEBURY COLLEGE - BREAD LOAF SCHOOL/E,FC,00000-0000,Private      ,0,1,1,0,1,1
00401000,INSTITUT INTERNAT'L D'ETUDES FRANCA     ,FC,00000-0000,Public       ,0,0,0,1,3,4
00401200,HEBREW UNIVERSITY OF JERUSALEM (THE)    ,FC,00000-0000,Public       ,2,9,11,36,122,158
00403000,UNIVERSITY OF CAMBRIDGE                 ,FC,00000-0000,Public       ,0,8,8,5,59,64
00503400,AMERICAN UNIVERSITY OF CAIRO            ,FC,00000-0000,Private      ,6,43,49,70,224,294
00667100,KATHOLIEKE UNIVERSITEIT LEUVEN          ,FC,00000-0000,Private      ,1,13,14,2,49,51
00669100,UNIVERSITY OF CAMBRIDGE - PEMBROKE      ,FC,00000-0000,Public       ,1,2,3,2,14,16
00669200,UNIVERSITY OF LEEDS                     ,FC,00000-0000,Public       ,2,21,23,17,104,121
00669300,UNIV OF LONDON-LONDON SCHOOL ECON       ,FC,00000-0000,Public       ,2,68,70,23,542,565
00669400,SCH OF ORIENTAL & AFRICAN STUDIES       ,FC,00000-0000,Public       ,2,38,40,13,164,177
00669500,UNIV OF LONDON-UNIVERSITY COLLEGE       ,FC,00000-0000,Public       ,3,56,59,23,390,413
00669600,UNIV OF LONDON-SCH ADVANCED STUDY       ,FC,00000-0000,Public       ,0,1,1,0,18,18
00669700,"QUEEN MARY, UNIVERSITY OF LONDON        ",FC,00000-0000,Public       ,2,26,28,23,134,157
00669900,UNIVERSITY OF SUSSEX                    ,FC,00000-0000,Public       ,3,22,25,16,93,109
00670000,"UNIVERSITY OF YORK, THE                 ",FC,00000-0000,Public       ,2,13,15,14,105,119
00670400,UNIVERSITY COLLEGE CORK                 ,FC,00000-0000,Public       ,5,18,23,15,67,82
00671300,UPPSALA UNIVERSITY                      ,FC,00000-0000,Public       ,0,6,6,0,44,44
00671500,UNIVERSITY OF GENEVA                    ,FC,00000-0000,Public       ,1,12,13,5,65,70
00683900,UNIVERSITY OF EDINBURGH                 ,FC,00000-0000,Public       ,20,92,112,143,562,705
00684200,UNIVERSITY OF DUBLIN TRINITY COLLEG     ,FC,00000-0000,Public       ,13,52,65,44,173,217
00685000,UNIVERSITY OF CAMBRIDGE - DOWNING C     ,FC,00000-0000,Public       ,1,1,2,1,7,8
00763200,UNIVERSITY OF BRISTOL                   ,FC,00000-0000,Public       ,1,7,8,13,77,90
00768100,COLLEGE OF EUROPE                       ,FC,00000-0000,Private      ,0,0,0,0,4,4
00770500,ROYAL COLLEGE OF SURGEONS IN IRELAN     ,FC,00000-0000,Private      ,1,14,15,4,68,72
00788100,AMERICAN UNIVERSITY OF PARIS            ,FC,00000-0000,Private      ,23,49,72,232,212,444
00837100,AMERICAN UNIVERSITY OF BEIRUT           ,FC,00000-0000,Private      ,14,25,39,81,80,161
00837300,TEL-AVIV UNIVERSITY                     ,FC,00000-0000,Public       ,0,21,21,7,73,80
00837600,VRIJE UNIVERSITEIT AMSTERDAM            ,FC,00000-0000,Public       ,0,4,4,1,30,31
00837700,UNIVERSITEIT VAN AMSTERDAM(UNIVERSI     ,FC,00000-0000,Public       ,1,22,23,4,115,119
00838000,UNIVERSITY OF WARWICK                   ,FC,00000-0000,Public       ,0,20,20,8,70,78
00838300,UNIVERSITY OF GLASGOW                   ,FC,00000-0000,Public       ,11,54,65,42,358,400
00839300,UNIVERSITY OF OSLO                      ,FC,00000-0000,Public       ,0,4,4,3,22,25
00839400,UNIVERSITY OF OXFORD                    ,FC,00000-0000,Public       ,3,39,42,6,246,252
00839800,UNIVERSITY OF SHEFFIELD (THE)           ,FC,00000-0000,Public       ,0,14,14,13,74,87
00839900,UNIVERSITY OF SOUTHAMPTON               ,FC,00000-0000,Public       ,0,8,8,10,45,55
00845200,ABERYSTWYTH UNIVERSITY                  ,FC,00000-0000,Public       ,2,5,7,9,34,43
00845800,LOUGHBOROUGH UNIVERSITY                 ,FC,00000-0000,Public       ,1,2,3,1,2,3
00846000,UNIVERSITY OF NEWCASTLE UPON TYNE       ,FC,00000-0000,Public       ,0,11,11,10,86,96
00846100,UNIVERSITY OF SAINT ANDREWS             ,FC,00000-0000,Public       ,46,45,91,197,194,391
00850500,UNIVERSITY OF MELBOURNE                 ,FC,00000-0000,Public       ,3,22,25,18,125,143
00858600,SWANSEA UNIVERSITY                      ,FC,00000-0000,Public       ,0,6,6,9,34,43
00858700,UNIVERSITY OF DURHAM                    ,FC,00000-0000,Public       ,1,32,33,12,144,156
00866500,UNIVERSITY OF KENT AT CANTERBURY (THE)  ,FC,00000-0000,Public       ,4,24,28,21,131,152
00867000,UNIVERSITY OF NEW SOUTH WALES           ,FC,00000-0000,Public       ,4,25,29,17,94,111
00868700,UNIVERSITY OF ESSEX                     ,FC,00000-0000,Public       ,1,15,16,10,76,86
00869300,CITY UNIVERSITY                         ,FC,00000-0000,Public       ,0,24,24,4,160,164
00890800,THE UNIVERSITY OF BIRMINGHAM            ,FC,00000-0000,Public       ,2,23,25,10,90,100
00891000,UNIVERSITY OF HULL                      ,FC,00000-0000,Public       ,1,3,4,6,18,24
00892000,UNIVERSITY OF NOTTINGHAM                ,FC,00000-0000,Public       ,2,21,23,11,97,108
00900600,UNIVERSITY OF SALFORD (THE)             ,FC,00000-0000,Public       ,0,1,1,3,8,11
00908400,"UNIV OF LONDON, BIRKBECK                ",FC,00000-0000,Public       ,0,16,16,1,81,82
00908500,UNIV OF LONDON KING'S COLLEGE           ,FC,00000-0000,Public       ,4,69,73,34,317,351
00908600,UNIVERSITY OF LONDON - ROYAL HOLLOWAY   ,FC,00000-0000,Public       ,1,17,18,12,78,90
00914300,BAR-ILAN UNIVERSITY                     ,FC,00000-0000,Private      ,0,5,5,7,15,22
00924700,ARCHITECTURAL ASSOC SCH OF ARCHITEC     ,FC,00000-0000,Private      ,0,2,2,1,23,24
00924900,UNIVERSITY OF LIVERPOOL                 ,FC,00000-0000,Public       ,2,18,20,19,78,97
00936800,UNIVERSITY OF ABERDEEN                  ,FC,00000-0000,Public       ,4,16,20,43,106,149
00942300,ROYAL COLLEGE OF ART                    ,FC,00000-0000,Public       ,3,2,5,4,60,64
00942800,TECHNION-ISRAEL INST OF TECHLGY         ,FC,00000-0000,Public       ,1,22,23,1,82,83
00944200,UNIVERSITY OF EXETER                    ,FC,00000-0000,Public       ,1,19,20,9,95,104
00944400,UNIVERSITY OF LANCASTER                 ,FC,00000-0000,Public       ,1,7,8,7,39,46
00963400,UNIVERSITY OF OXFORD ST CATHERINE'S     ,FC,00000-0000,Public       ,0,3,3,0,10,10
00980800,UNIVERSITY OF STRATHCLYDE               ,FC,00000-0000,Public       ,0,9,9,5,37,42
00986000,UNIVERSITY OF SURREY                    ,FC,00000-0000,Public       ,0,1,1,10,17,27
00990600,PONTIFICAL NORTH AMERICAN COLLEGE       ,FC,00000-0000,Private      ,0,3,3,0,6,6
00992700,UNIVERSITY OF CAMBRIDGE - FITZWILLI     ,FC,00000-0000,Public       ,0,1,1,0,5,5
01006700,LUND UNIVERSITY                         ,FC,00000-0000,Public       ,0,12,12,3,80,83
01008400,UNIVERSITY OF CAPE TOWN                 ,FC,00000-0000,Private      ,2,15,17,6,59,65
01008700,UNIVERSITY OF OXFORD ST PETER'S COL     ,FC,00000-0000,Public       ,0,2,2,0,3,3
01008800,UNIVERSITY OF OXFORD - CORPUS CHRIS     ,FC,00000-0000,Public       ,0,1,1,0,5,5
01008900,CENTRAL SCHOOL OF SPEECH AND DRAMA      ,FC,00000-0000,Private      ,4,9,13,14,56,70
01009000,UNIVERSITY OF OXFORD - BALLIOL COLL     ,FC,00000-0000,Public       ,0,0,0,2,13,15
01014300,UNIVERSITY OF READING                   ,FC,00000-0000,Public       ,3,9,12,14,53,67
01015700,CARDIFF UNIVERSITY                      ,FC,00000-0000,Public       ,3,8,11,10,47,57
01015900,PONTIFICIA UNIVERSITA GREGORIANA        ,FC,00000-0000,Private      ,0,4,4,0,5,5
01016000,CG JUNG INST                            ,FC,00000-0000,Private      ,0,0,0,0,3,3
01018800,UNIVERSITY COLLEGE DUBLIN               ,FC,00000-0000,Public       ,2,37,39,8,204,212
01019000,UNIVERSITY OF CAMBRIDGE CHURCHILL C     ,FC,00000-0000,Public       ,0,1,1,0,6,6
01022800,UNIVERSITY OF STIRLING                  ,FC,00000-0000,Public       ,3,9,12,19,42,61
01033200,UNIVERSITY OF CAMBRIDGE - CLARE COL     ,FC,00000-0000,Public       ,0,2,2,1,8,9
01045600,UNIVERSITY OF HAIFA                     ,FC,00000-0000,Public       ,0,0,0,11,7,18
01047200,INST EUROPEEN OPEEN D'ADMINISTRATIO     ,FC,00000-0000,Private      ,0,15,15,0,73,73
01049300,CRANFIELD UNIVERSITY                    ,FC,00000-0000,Public       ,0,5,5,1,14,15
01052000,TRINITY LABAN                           ,FC,00000-0000,Public       ,1,4,5,5,21,26
01052001,LABAN CENTER FOR MOVEMENT & DANCE       ,FC,00000-0000,Public       ,0,1,1,1,12,13
01052500,UNIVERSITY OF HERTFORDSHIRE             ,FC,00000-0000,Public       ,0,4,4,12,13,25
01057400,LONDON INTRNTL FILM SCHOOL              ,FC,00000-0000,Private      ,0,12,12,4,33,37
01058600,INSTITUTE OF SOCIAL STUDIES             ,FC,00000-0000,Private      ,0,5,5,0,20,20
01058800,AUSTRALIAN NATIONAL UNIVERSITY          ,FC,00000-0000,Public       ,3,7,10,8,46,54
01058900,BANGOR UNIVERSITY                       ,FC,00000-0000,Public       ,1,5,6,4,22,26
01059400,"RICHMOND, THE AMERICAN INT UNI IN LONDON",FC,00000-0000,Private      ,29,2,31,318,33,351
01059900,INST D'ETUDES POLITIQUES DE PARIS       ,FC,00000-0000,Public       ,0,8,8,1,52,53
01068100,MACQUARIE UNIVERSITY                    ,FC,00000-0000,Public       ,0,7,7,6,70,76
01069200,UNIVERSITY OF QUEENSLAND (THE)          ,FC,00000-0000,Public       ,5,34,39,22,122,144
01078900,UNIVERSITY OF OXFORD - WORCESTER CO     ,FC,00000-0000,Public       ,0,1,1,0,12,12
01079200,CITY AND GUILDS OF LONDON INSTITUTE     ,FC,00000-0000,Private      ,0,0,0,2,4,6
01079700,"NATIONAL UNIVERSITY OF IRELAND, MAY     ",FC,00000-0000,Public       ,0,1,1,0,1,1
01080300,SEMMELWEIS UNIVERSITY OF BUDAPEST       ,FC,00000-0000,Public       ,0,11,11,2,41,43
01081600,KINGSTON UNIVERSITY                     ,FC,00000-0000,Public       ,8,13,21,37,97,134
01083800,UNIVERSITITY OF BERGEN (UOB)            ,FC,00000-0000,Public       ,0,1,1,1,6,7
01086400,UNIV OF DUNDEE                          ,FC,00000-0000,Public       ,0,12,12,7,64,71
01086600,UNIVERSITY OF OXFORD - MAGDALEN COLLEGE ,FC,00000-0000,Public       ,1,2,3,1,16,17
01086700,UNIVERSITY OF OXFORD ST JOHN'S COLL     ,FC,00000-0000,Public       ,2,1,3,2,6,8
01091400,MONASH UNIVERSITY                       ,FC,00000-0000,Public       ,2,11,13,9,38,47
01091500,UNIV OF EAST ANGLIA                     ,FC,00000-0000,Public       ,2,9,11,15,64,79
01094200,UNIVERSITY OF OXFORD - ST HUGH'S CO     ,FC,00000-0000,Public       ,1,1,2,1,8,9
01097700,UNIVERSIDAD CENTRAL DEL ESTE            ,FC,00000-0000,Private      ,29,168,197,86,756,842
01098000,SOMERVILLE COLLEGE                      ,FC,00000-0000,Public       ,0,0,0,0,6,6
01099900,UNIV OF OXFORD - WADHAM COLLEGE         ,FC,00000-0000,Public       ,0,0,0,0,6,6
01104400,PONTIFICIA UNIVERSITA SAN TOMMASO       ,FC,00000-0000,Private      ,0,5,5,0,14,14
01105300,UNIVERSITY OF OXFORD - ST HILDA'S C     ,FC,00000-0000,Public       ,0,5,5,0,10,10
01105400,UNIVERSITY OF OXFORD - ST ANNE'S CO     ,FC,00000-0000,Public       ,0,4,4,0,10,10
01105500,UNIV OF OXFORD - LADY MARGARET HALL     ,FC,00000-0000,Public       ,0,2,2,0,12,12
01105600,UNIVERSITY OF OXFORD - UNIVERSITY C     ,FC,00000-0000,Public       ,1,2,3,1,19,20
01105700,UNIVERSITY OF OXFORD - TRINITY COLL     ,FC,00000-0000,Public       ,2,0,2,2,7,9
01105800,UNIVERSITY OF OXFORD-ST EDMUND HALL     ,FC,00000-0000,Public       ,0,0,0,0,9,9
01105900,UNIVERSITY OF OXFORD ST ANTONY'S CO     ,FC,00000-0000,Public       ,0,9,9,0,36,36
01106000,UNIVERSITY OF OXFORD - QUEEN'S COLL     ,FC,00000-0000,Public       ,0,0,0,0,7,7
01106100,UNIVERSITY OF OXFORD - PEMBROKE COL     ,FC,00000-0000,Public       ,0,2,2,1,10,11
01106200,UNIVERSITY OF OXFORD - ORIEL COLLEG     ,FC,00000-0000,Public       ,0,3,3,0,10,10
01106300,UNIVERSITY OF OXFORD - NUFFIELD COL     ,FC,00000-0000,Public       ,0,1,1,0,5,5
01106400,UNIVERSITY OF OXFORD - NEW COLLEGE      ,FC,00000-0000,Public       ,0,4,4,1,20,21
01106500,UNIVERSITY OF OXFORD MERTON COLLEGE     ,FC,00000-0000,Public       ,0,3,3,0,10,10
01106600,UNIVERSITY OF OXFORD - LINCOLN COLL     ,FC,00000-0000,Public       ,1,2,3,1,24,25
01106700,UNIVERSITY OF OXFORD - KEBLE COLLEG     ,FC,00000-0000,Public       ,1,1,2,1,4,5
01106800,UNIVERSITY OF OXFORD - JESUS COLLEG     ,FC,00000-0000,Public       ,1,1,2,1,10,11
01106900,UNIVERSITY OF OXFORD - HERTFORD COL     ,FC,00000-0000,Public       ,0,3,3,0,8,8
01107000,UNIVERSITY OF OXFORD EXETER COLLEGE     ,FC,00000-0000,Public       ,0,3,3,0,20,20
01107100,UNIV OF OXFORD - CHRIST CHURCH          ,FC,00000-0000,Public       ,0,5,5,2,15,17
01107200,UNIVERSITY OF OXFORD - BRASENOSE CO     ,FC,00000-0000,Public       ,0,1,1,0,3,3
01109100,FLINDERS UNIVERSITY OF S AUSTRALIA      ,FC,00000-0000,Public       ,0,1,1,0,12,12
01109400,UNIVERSITY OF WESTERN AUSTRALIA (THE)   ,FC,00000-0000,Public       ,3,4,7,7,17,24
01156700,"IMPERIAL COLLEGE OF SCIENCE, TECHNOLOGY ",FC,00000-0000,Public       ,2,12,14,6,51,57
01167900,UNIVERSITY OF BATH                      ,FC,00000-0000,Public       ,1,4,5,10,31,41
01168300,FRANKLIN COLLEGE  SWITZERLAND           ,FC,00000-0000,Private      ,15,3,18,354,10,364
01175800,UNIV OF CAMBRIDGE - PETERHOUSE          ,FC,00000-0000,Public       ,0,1,1,1,7,8
01176400,ROYAL ACADEMY OF MUSIC                  ,FC,00000-0000,Public       ,4,2,6,10,15,25
01176500,GOLDSMITHS' COLLEGE-UNIV OF LONDON      ,FC,00000-0000,Public       ,2,24,26,22,178,200
01176600,UNIV OF LONDON - INST OF EDUC           ,FC,00000-0000,Public       ,0,8,8,2,22,24
01178000,BRUNEL UNIVERSITY                       ,FC,00000-0000,Public       ,1,1,2,1,1,2
01183800,UNIVERSITY OF OXFORD - MANSFIELD CO     ,FC,00000-0000,Public       ,0,0,0,1,2,3
01207500,UNIVERSITY CAMBRIDGE - TRINITY COLL     ,FC,00000-0000,Public       ,1,1,2,3,10,13
01207800,VICTORIA UNIV OF WELLINGTON             ,FC,00000-0000,Public       ,4,7,11,15,41,56
01209600,ECOLE HåTELIERE DE LAUSANNE             ,FC,00000-0000,Private      ,1,1,2,1,1,2
01210100,UNIVERSITY OF CAMBRIDGE - GIRTON CO     ,FC,00000-0000,Public       ,0,0,0,2,1,3
01213600,VICTORIA UNIV OF MANCHESTER (THE)       ,FC,00000-0000,Public       ,2,35,37,17,108,125
01219800,UNIVERSITY OF BRADFORD                  ,FC,00000-0000,Public       ,1,9,10,3,27,30
01220100,UNIVERSITY OF OXFORD - REGENT'S PAR     ,FC,00000-0000,Public       ,0,4,4,1,7,8
01220600,JAMES COOK UNIVERSITY                   ,FC,00000-0000,Public       ,5,13,18,27,72,99
01221500,BIRMINGHAM CITY UNIVERSITY              ,FC,00000-0000,Public       ,1,3,4,6,15,21
01222300,JAGIELLONIAN UNIVERSITY COLLEGIUM M     ,FC,00000-0000,Public       ,0,15,15,3,54,57
01222500,UNIVERSITY OF SZEGED FACULTY OF MEDICINE,FC,00000-0000,Public       ,0,2,2,0,7,7
01225800,ASTON UNIVERSITY                        ,FC,00000-0000,Public       ,0,5,5,1,16,17
01227500,UNIVERSITY OF OXFORD - WOLFSON COLL     ,FC,00000-0000,Public       ,0,8,8,0,21,21
01230200,GONVILLE & CAIUS COLLEGE                ,FC,00000-0000,Public       ,0,2,2,0,4,4
01233300,UNIV OF THE ARTS LONDON- CAMBERWELL COLL,FC,00000-0000,Public       ,2,0,2,11,10,21
01233500,ROYAL COLLEGE OF MUSIC                  ,FC,00000-0000,Public       ,1,3,4,4,19,23
01233700,WROCLAW UNIVERSITY OF MEDICINE          ,FC,00000-0000,Public       ,0,0,0,1,4,5
01234100,UNIVERSITY OF WALES - ST DAVID'S UN     ,FC,00000-0000,Public       ,1,5,6,4,15,19
01236000,EDINBURGH COLLEGE OF ART                ,FC,00000-0000,Public       ,0,3,3,7,45,52
01242100,UNIV OF AUCKLAND                        ,FC,00000-0000,Public       ,4,16,20,16,62,78
01253900,UNIVERSITY OF THE ARTS LONDON IDO - CENT,FC,00000-0000,Public       ,11,25,36,52,101,153
01254000,UNIVERSIDAD DE NAVARRA                  ,FC,00000-0000,Private      ,0,8,8,4,22,26
01276500,UNIVERSITY OF OXFORD - LINACRE COLL     ,FC,00000-0000,Public       ,0,3,3,0,15,15
01276600,"NATIONAL UNIVERSITY IRELAND, GALWAY     ",FC,00000-0000,Public       ,1,10,11,16,80,96
01280200,PONTIFICIA UNIV CATOLICA MAD Y MAES     ,FC,00000-0000,Private      ,44,94,138,88,156,244
01281100,INST TECNOLOGICO DE SANTO DOMINGO       ,FC,00000-0000,Private      ,9,28,37,21,104,125
01283900,UNIVERSITY OF CAMBRIDGE - SAINT JOH     ,FC,00000-0000,Public       ,0,1,1,0,13,13
01286200,MOUNTVIEW ACADEMY OF THEATRE ARTS       ,FC,00000-0000,Private      ,0,1,1,2,5,7
01297800,UNIVERSITY OF HUDDERSFIELD (THE)        ,FC,00000-0000,Public       ,1,2,3,2,7,9
01315300,MASSEY UNIVERSITY                       ,FC,00000-0000,Public       ,2,13,15,11,67,78
01322500,COLLEGE OF LAW                          ,FC,00000-0000,Private      ,0,11,11,0,28,28
02052400,DARWIN COLLEGE                          ,FC,00000-0000,Public       ,0,2,2,0,15,15
02082400,UNIVERSITY OF CAMBRIDGE - QUEEN'S C     ,FC,00000-0000,Public       ,0,3,3,0,19,19
02083400,UNIVERSITY OF CAMBRIDGE - WOLFSON C     ,FC,00000-0000,Public       ,0,2,2,0,8,8
02087400,UNIVERSITY OF CAMBRIDGE - NEWNHAM C     ,FC,00000-0000,Public       ,0,5,5,2,11,13
02087900,OXFORD BROOKES UNIVERSITY               ,FC,00000-0000,Public       ,6,13,19,19,51,70
02094100,BEN-GURION UNIV                         ,FC,00000-0000,Public       ,0,14,14,0,172,172
02094400,UNIV OF CAMBRIDGE - ST EDMUND'S HOU     ,FC,00000-0000,Public       ,0,4,4,1,10,11
02095500,LONDON BUS SCHOOL                       ,FC,00000-0000,Private      ,0,29,29,3,159,162
02098700,FATIMA COLLEGE OF MEDICINE              ,FC,00000-0000,Private      ,0,25,25,2,71,73
02101900,ROEHAMPTON UNIVERSITY                   ,FC,00000-0000,Public       ,6,6,12,17,71,88
02108600,LONDON ACADEMY OF MUSIC & DRAMATIC      ,FC,00000-0000,Private      ,1,7,8,10,21,31
02115900,UNIVERSITY OF PORTSMOUTH                ,FC,00000-0000,Public       ,1,2,3,8,15,23
02116700,UNIVERSITY OF CAMBRIDGE - LUCY CAVE     ,FC,00000-0000,Public       ,1,6,7,1,9,10
02120000,UNIV OF LONDON - COURTALD INST OF A     ,FC,00000-0000,Public       ,0,2,2,1,34,35
02133400,UNIVERSITY OF CAMBRIDGE - SIDNEY SU     ,FC,00000-0000,Public       ,0,0,0,2,7,9
02142000,UNIVERSITY OF CAMBRIDGE - HOMERTON      ,FC,00000-0000,Public       ,0,1,1,0,8,8
02149700,UNIVERSITY OF WINCHESTER (THE)          ,FC,00000-0000,Public       ,0,1,1,5,5,10
02156800,UNIV OF OTAGO                           ,FC,00000-0000,Public       ,0,3,3,4,27,31
02162300,"IESE BUSINESS SCH, UNIV OF NAVARRA      ",FC,00000-0000,Private      ,1,13,14,6,82,88
02167400,UNIVERSITY OF CAMBRIDGE - CORPUS CH     ,FC,00000-0000,Public       ,0,1,1,0,6,6
02175700,OHR SOMAYACH INSTITUTIONS               ,FC,00000-0000,Private      ,1,1,2,5,1,6
02177700,KING'S COLLEGE- UNIV OF CAMBRIDGE       ,FC,00000-0000,Public       ,0,1,1,1,23,24
02180500,MIDDLESEX UNIVERSITY                    ,FC,00000-0000,Public       ,6,14,20,13,72,85
02181000,UNIVERSITY OF SOUTH AUSTRALIA           ,FC,00000-0000,Public       ,0,6,6,2,20,22
02183500,UNIV OF OXFORD - WYCLIFFE HALL          ,FC,00000-0000,Public       ,0,0,0,0,7,7
02186000,UNIVERSITY OF CAMBRIDGE - MAGDALENE     ,FC,00000-0000,Public       ,0,1,1,0,8,8
02186100,UNIVERSITY OF CAMBRIDGE - EMMANUEL      ,FC,00000-0000,Public       ,0,1,1,0,8,8
02189600,UNIVERSITY OF GRONINGEN                 ,FC,00000-0000,Public       ,0,3,3,2,19,21
02194800,UNIVERSITY OF THE WEST OF ENGLAND -     ,FC,00000-0000,Public       ,1,3,4,10,19,29
02195100,UNIV OF WESTMINSTER                     ,FC,00000-0000,Public       ,5,25,30,37,123,160
02196700,GUILDHALL SCHOOL OF MUSIC & DRAMA       ,FC,00000-0000,Public       ,0,1,1,10,15,25
02207300,UNIVERSITY OF CAMBRIDGE - CHRIST'S      ,FC,00000-0000,Public       ,0,1,1,0,9,9
02207400,CHINESE UNIVERSITY OF HONG KONG (THE)   ,FC,00000-0000,Public       ,0,6,6,8,31,39
02209500,UNIVERSITEIT UTRECHT                    ,FC,00000-0000,Public       ,1,5,6,4,47,51
02210000,UNIV OF LONDON - LONDON SCHOOL OF H     ,FC,00000-0000,Public       ,0,9,9,0,58,58
02212300,UNIVERSITY OF CAMBRIDGE - ROBINSON      ,FC,00000-0000,Public       ,0,1,1,0,6,6
02225300,UNIV OF CANTERBURY                      ,FC,00000-0000,Public       ,4,9,13,17,31,48
02229100,UNIVERSITY OF LEICESTER                 ,FC,00000-0000,Public       ,2,22,24,5,77,82
02229600,SACKLER SCHOOL OF MEDICINE              ,FC,00000-0000,Public       ,0,25,25,0,193,193
02232100,UNIVERSITY OF CAMBRIDGE                 ,FC,00000-0000,Public       ,0,6,6,1,15,16
02233300,"ST GEORGE'S UNIV, SCH OF MEDICINE       ",FC,00000-0000,Proprietary  ,1,929,930,12,2546,2558
02235300,LONDON METROPOLITAN UNIVERSITY          ,FC,00000-0000,Public       ,4,39,43,46,178,224
02240900,AISH HATORAH CLG OF JEWISH STUDIES      ,FC,00000-0000,Private      ,0,1,1,1,3,4
02244400,AMERICAN UNIV OF THE CARIBBEAN          ,FC,00000-0000,Proprietary  ,1,243,244,9,1072,1081
02257100,COVENTRY UNIVERSITY                     ,FC,00000-0000,Public       ,1,2,3,7,12,19
02266600,UNIVERSITY OF LONDON - SAINT GEORGE     ,FC,00000-0000,Public       ,0,4,4,0,16,16
02271700,UNIVERSITY OF CAMBRIDGE - CLARE HAL     ,FC,00000-0000,Public       ,0,2,2,0,8,8
02271800,UNIV OF OXFORD - CAMPION HALL           ,FC,00000-0000,Public       ,0,1,1,0,5,5
02271900,UNIVERSITY OF OXFORD - BLACKFRIARS      ,FC,00000-0000,Public       ,0,2,2,1,6,7
02272100,UNIV OF OXFORD - GREYFRIARS             ,FC,00000-0000,Public       ,0,0,0,0,1,1
02272200,UNIV OF CAMBRIDGE - NEW HALL            ,FC,00000-0000,Public       ,0,0,0,0,3,3
02273600,QUEEN'S UNIV OF BELFAST (THE)           ,FC,00000-0000,Public       ,1,15,16,11,83,94
02273900,HERIOT WATT UNIVERSITY                  ,FC,00000-0000,Public       ,2,11,13,7,27,34
02276700,NYENRODE BUSINESS UNIVERSITEIT          ,FC,00000-0000,Private      ,0,2,2,0,3,3
02279700,UNIVERSITY OF MANCHESTER - INSTITUT     ,FC,00000-0000,Public       ,0,0,0,18,87,105
02293400,ECOLE DES HAUTES ETUDES COMERCIALS      ,FC,00000-0000,Public       ,0,9,9,1,40,41
02296300,UNIVERSITY OF CAMBRIDGE - JESUS COL     ,FC,00000-0000,Public       ,0,0,0,0,7,7
02310500,DE MONTFORT UNIVERSITY                  ,FC,00000-0000,Public       ,2,6,8,4,13,17
02320500,ROYAL NORTHERN COLLEGE OF MUSIC         ,FC,00000-0000,Public       ,1,0,1,1,5,6
02335100,UNIV OF CAMBRIDGE - TRINITY HALL        ,FC,00000-0000,Public       ,0,2,2,1,15,16
02338900,UNIVERSITY  FOR THE CREATIVE ARTS       ,FC,00000-0000,Public       ,0,0,0,1,4,5
02338903,KENT INSTITUTE OF ART & DESIGN          ,FC,00000-0000,Public       ,0,0,0,0,1,1
02347300,ESCUELA AUTONOMA DE CIENCIAS MEDICA     ,FC,00000-0000,Private      ,0,0,0,0,3,3
02351800,UNIVERSIDAD IBEROAMERICANA (UNIBE       ,FC,00000-0000,Private      ,27,256,283,130,1102,1232
02355200,ECOLE SUPERIEURE DE CUISINE FRANCAISE-FE,FC,00000-0000,Public       ,0,4,4,5,18,23
02363000,GSA CONSERVATOIRE                       ,FC,00000-0000,Private      ,0,0,0,5,2,7
02502600,PECSI ORVOSTUDOMANYI EGYETEM (PECS      ,FC,00000-0000,Public       ,0,10,10,1,18,19
02545700,GLASGOW SCHOOL OF ART                   ,FC,00000-0000,Public       ,3,4,7,14,37,51
02561600,SOUTHAMPTON SOLENT UNIVERSITY           ,FC,00000-0000,Public       ,1,1,2,3,2,5
02579600,MURDOCH UNIVERSITY                      ,FC,00000-0000,Public       ,0,9,9,8,50,58
02588000,UNIVERSITY OF ULSTER                    ,FC,00000-0000,Public       ,1,5,6,6,21,27
02591800,CURTIN UNIVERSITY OF TECHNOLOGY         ,FC,00000-0000,Public       ,0,6,6,1,18,19
02592300,MILLTOWN INST OF THEOLOGY & PHILOSO     ,FC,00000-0000,Private      ,0,0,0,0,4,4
02604300,AALBORG UNIVERSITY                      ,FC,00000-0000,Public       ,2,6,8,4,18,22
02611500,HELSINKI SCH OF ECONOMICS & BUS ADM     ,FC,00000-0000,Public       ,0,1,1,2,6,8
02611600,ECOL NATIONAL DES PONTS ET CHAUSSEE     ,FC,00000-0000,Public       ,0,3,3,0,8,8
02611700,DUBLIN CITY UNIVERSITY                  ,FC,00000-0000,Public       ,1,6,7,8,39,47
02622500,DENMARKS TEKNISKE UNIVERSITET           ,FC,00000-0000,Public       ,0,1,1,0,7,7
02623200,UNIVERSITY OF NEWCASTLE (THE)           ,FC,00000-0000,Public       ,1,5,6,10,18,28
03012700,UNIVERSITY OF BUCKINGHAM                ,FC,00000-0000,Private      ,2,3,5,5,14,19
03029400,KEELE UNIVERSITY                        ,FC,00000-0000,Public       ,1,2,3,3,4,7
03029500,NORTHUMBRIA UNIVERSITY                  ,FC,00000-0000,Public       ,3,4,7,7,30,37
03029800,NORGES HANDELSHOYSKOLE                  ,FC,00000-0000,Public       ,0,1,1,0,4,4
03033300,MANCHESTER METROPOLITAN UNIV            ,FC,00000-0000,Public       ,4,9,13,14,32,46
03045000,UNIVERSITY OF EAST LONDON               ,FC,00000-0000,Public       ,4,12,16,11,41,52
03050100,STUDIO ART CENTERS INTERNATIONAL        ,FC,00000-0000,Private      ,4,1,5,20,50,70
03066800,PONTIFICIO ATENEO DELLA SANTA CROCE     ,FC,00000-0000,Private      ,0,5,5,1,10,11
03067200,UNIVERSITY OF SYDNEY                    ,FC,00000-0000,Public       ,3,46,49,24,222,246
03073800,UNIV OF DEBRECEN MED & HEALTH SCI       ,FC,00000-0000,Public       ,0,11,11,4,22,26
03080300,SHEFFIELD HALLAM UNIVERSITY             ,FC,00000-0000,Public       ,0,2,2,3,11,14
03084300,UNIVERSITY OF LIMERICK                  ,FC,00000-0000,Public       ,3,10,13,22,38,60
03086900,AMERN GRAD SCHL OF BUS THE INST OF      ,FC,00000-0000,Private      ,0,0,0,0,2,2
03088700,ROYAL SCOTTISH ACAD MUSIC & DRAMA       ,FC,00000-0000,Public       ,1,5,6,18,21,39
03091400,UNIVERSITY OF WOLLONGONG                ,FC,00000-0000,Public       ,0,5,5,9,19,28
03091500,UNIVERSITY OF CANBERRA                  ,FC,00000-0000,Public       ,1,4,5,5,9,14
03091700,KAROL MARCINKOWSKI UNIV OF MED SCI      ,FC,00000-0000,Public       ,3,73,76,13,187,200
03092500,NOTTINGHAM TRENT UNIVERSITY             ,FC,00000-0000,Public       ,0,6,6,5,25,30
03095000,RMIT UNIVERSITY                         ,FC,00000-0000,Public       ,1,6,7,5,28,33
03095400,BOND UNIVERSITY                         ,FC,00000-0000,Private      ,4,23,27,33,74,107
03095900,ESSEC BUSINESS SCHOOL                   ,FC,00000-0000,Private      ,0,6,6,0,26,26
03096100,LA TROBE UNIVERSITY                     ,FC,00000-0000,Public       ,2,11,13,11,32,43
03096900,DEAKIN UNIVERSITY                       ,FC,00000-0000,Public       ,1,4,5,2,14,16
03097100,UNIVERSITY OF WESTERN SYDNEY            ,FC,00000-0000,Public       ,0,0,0,3,11,14
03097300,VICTORIA UNIVERSITY OF TECHNOLOGY       ,FC,00000-0000,Public       ,0,1,1,7,4,11
03097500,CENTRAL QUEENSLAND UNIVERSITY           ,FC,00000-0000,Public       ,0,0,0,2,4,6
03100000,UNIVERSITY OF ADELAIDE (THE)            ,FC,00000-0000,Public       ,1,7,8,4,25,29
03100200,INST DE MANAGEMENT HOTELIER INTERNA     ,FC,00000-0000,Private      ,0,0,0,0,2,2
03101600,ASIAN INSTITUTE OF MANAGEMENT           ,FC,00000-0000,Private      ,0,0,0,2,5,7
03102500,AMERICAN UNIVERSITY OF ROME             ,FC,00000-0000,Private      ,10,6,16,86,53,139
03102800,ROBERT GORDON UNIVERSITY (THE)          ,FC,00000-0000,Public       ,0,3,3,0,19,19
03104800,GRIFFITH UNIVERSITY                     ,FC,00000-0000,Public       ,2,7,9,22,38,60
03104801,GRIFFITH UNIVERSITY - MOUNT GRAVATT CAMP,FC,00000-0000,Public       ,0,1,1,0,1,1
03104802,GRIFFITH UNIVERSITY - GOLD COAST CAMPUS ,FC,00000-0000,Public       ,1,1,2,1,1,2
03104803,GRIFFITH UNIVERSITY - QUEENSLAND CONSERV,FC,00000-0000,Public       ,0,1,1,0,1,1
03104804,GRIFFITH UNIVERSITY - QUEENSLAND COLLEGE,FC,00000-0000,Public       ,0,2,2,0,2,2
03106100,ROSKILDE UNIV ROSKILDE UNIVERSITY C     ,FC,00000-0000,Public       ,0,1,1,0,2,2
03136300,AUSTRALIAN CATHOLIC UNIVERSITY          ,FC,00000-0000,Public       ,0,4,4,2,7,9
03140300,EDITH COWAN UNIVERSITY                  ,FC,00000-0000,Public       ,0,4,4,2,13,15
03140400,NORTHERN TERRITORY UNIVERSITY           ,FC,00000-0000,Public       ,0,0,0,0,1,1
03140500,QUEENSLAND UNIVERSITY OF TECHNOLOGY     ,FC,00000-0000,Public       ,3,4,7,9,24,33
03140600,SOUTHERN CROSS UNIVERSITY               ,FC,00000-0000,Public       ,0,4,4,4,15,19
03140700,SWINBURNE UNIVERSITY OF TECHNOLOGY      ,FC,00000-0000,Public       ,0,2,2,3,7,10
03140900,UNIVERSITY OF BALLARAT                  ,FC,00000-0000,Public       ,1,1,2,1,2,3
03150300,UNIVERSITY OF TASMANIA                  ,FC,00000-0000,Public       ,0,1,1,5,7,12
03150400,"UNIVERSITY OF TECHNOLOGY, SYDNEY        ",FC,00000-0000,Public       ,0,4,4,0,4,4
03274300,"KUNGLIGA TEKNISKA HOGSKOLAN, KTH        ",FC,00000-0000,Public       ,0,6,6,0,27,27
03287300,LIVERPOOL INSTITUTE FOR PERFORMING ARTS ,FC,00000-0000,Public       ,3,0,3,24,6,30
03300300,"2ND SCHOOL OF MEDICINE, CHARLES UNI     ",FC,00000-0000,Public       ,0,3,3,1,9,10
03300400,"FIRST FACULTY OF MEDICINE, CHARLES UNIV.",FC,00000-0000,Public       ,0,14,14,1,28,29
03329300,JOHN CABOT UNIVERSITY                   ,FC,00000-0000,Private      ,12,1,13,112,25,137
03332400,AGRICULTURE UNIVERSITY OF WROCLAW       ,FC,00000-0000,Public       ,1,0,1,1,2,3
03333300,MEDICAL UNIVERSITY SCHOOL OF LUBLIN     ,FC,00000-0000,Public       ,2,117,119,12,207,219
03334300,UNIVERSIDAD NORDESTANA                  ,FC,00000-0000,Private      ,2,10,12,3,40,43
03335300,MEDICAL UNIVERSITY OF SILESIA           ,FC,00000-0000,Public       ,5,43,48,9,93,102
03349400,"QUEEN MARGARET UNIVERSITY COLLEGE, EDINB",FC,00000-0000,Public       ,0,2,2,4,15,19
03350300,BOURNEMOUTH UNIVERSITY                  ,FC,00000-0000,Public       ,4,2,6,10,20,30
03352300,LONDON SOUTH BANK UNIVERSITY            ,FC,00000-0000,Private      ,1,8,9,6,41,47
03363300,THE ARTS EDUCATIONAL SCHOOLS LONDON     ,FC,00000-0000,Private      ,0,0,0,1,5,6
03364300,"FACULTY OF MEDICINE, PALACKY UNIVER     ",FC,00000-0000,Public       ,0,1,1,0,7,7
03365400,AUCKLAND INSTITUTE OF TECHNOLOGY        ,FC,00000-0000,Public       ,1,2,3,2,10,12
03366300,TROPICAL AGRICULTURE RESEARCH AND H     ,FC,00000-0000,Private      ,0,0,0,0,1,1
03377300,"UNIVERSITY OF WALES INSTITUTE, CARD     ",FC,00000-0000,Public       ,0,2,2,1,7,8
03378300,"THE 3RD FACULTY OF MEDICINE, CHARLE     ",FC,00000-0000,Public       ,0,3,3,0,4,4
03386300,CHARLES UNIVERSITY-MEDICAL FACULTY      ,FC,00000-0000,Public       ,0,4,4,0,10,10
03406300,"THE SCHOOL OF PHARMACY, UNIVERSITY      ",FC,00000-0000,Public       ,0,0,0,1,3,4
03418400,NAPIER UNIVERSITY                       ,FC,00000-0000,Public       ,1,4,5,6,27,33
03435300,ANGLIA POLYTECHNIC UNIVERSITY HIGHE     ,FC,00000-0000,Public       ,2,3,5,4,7,11
03460300,INTERNATIONALES THEOLOGISCHES INSTI     ,FC,00000-0000,Private      ,1,2,3,2,18,20
03462400,UNIV OF ARTS LONDON - LON COLL OF COMMUN,FC,00000-0000,Public       ,2,8,10,17,41,58
03466300,INSTITUTO CENTROAMERICANO DE ADMINI     ,FC,00000-0000,Private      ,0,1,1,0,9,9
03473300,UNIV OF ARTS LONDON - LON COLL FASHION  ,FC,00000-0000,Public       ,6,13,19,35,78,113
03475300,UNIV OF THE ARTS  LONDON - CHELSEA COLL ,FC,00000-0000,Public       ,0,1,1,6,14,20
03478300,ROYAL WELSH COLLEGE OF MUSIC AND DRAMA  ,FC,00000-0000,Public       ,0,1,1,1,8,9
03492400,UNIV OF CAMBRIDGE-ST CATHERINE'S CG     ,FC,00000-0000,Public       ,0,2,2,0,7,7
03494400,UNIV OF CAMBRIDGE-SELWYN COLLEGE        ,FC,00000-0000,Public       ,0,2,2,0,4,4
03494600,UNIV OF OXFORD-HARRIS MANCHESTER        ,FC,00000-0000,Public       ,1,1,2,1,8,9
03500300,WIMBLEDON COLLEGE OF ART                ,FC,00000-0000,Public       ,2,0,2,11,2,13
03501400,LEEDS METROPOLITAN UNIVERSITY           ,FC,00000-0000,Public       ,0,9,9,6,15,21
03507300,UNIVERSITY OF SUNDERLAND                ,FC,00000-0000,Public       ,1,4,5,3,12,15
03515300,UNIVERSITY OF CENTRAL LANCASHIRE        ,FC,00000-0000,Public       ,1,2,3,3,11,14
03517300,UNIVERSITY OF BRIGHTON                  ,FC,00000-0000,Public       ,0,7,7,5,29,34
03518300,EUROPEAN GRADUATE SCHOOL                ,FC,00000-0000,Private      ,0,21,21,0,83,83
03527300,SOFIA UNIVERSITY ST. KLIMENT OHRIDSKI   ,FC,00000-0000,Public       ,0,1,1,0,3,3
03533300,BATH SPA UNIVERSITY                     ,FC,00000-0000,Public       ,1,4,5,7,22,29
03547300,UNIVERSITY OF GLAMORGAN                 ,FC,00000-0000,Public       ,0,2,2,4,8,12
03580300,LIVERPOOL JOHN MOORES UNIVERSITY        ,FC,00000-0000,Public       ,0,0,0,9,7,16
03589400,THE ARTS INSTITUTE AT BOURNEMOUTH       ,FC,00000-0000,Public       ,1,1,2,4,2,6
03594300,GROUP ESC GRENOBLE GRAD SCH OF BUS.     ,FC,00000-0000,Private      ,1,14,15,2,41,43
03597300,JAGIELLONIAN UNIVERSITY                 ,FC,00000-0000,Public       ,0,7,7,2,30,32
03601300,UNIVERSITAT JAUME I DE CASTELLO/UJI     ,FC,00000-0000,Public       ,0,1,1,1,7,8
03603300,LEEDS COLLEGE OF MUSIC                  ,FC,00000-0000,Public       ,0,0,0,0,1,1
03619300,UNIVERSITY OF GREENWICH                 ,FC,00000-0000,Public       ,4,9,13,13,30,43
03653400,UNIVERSIDAD DE IBEROAMERICA - UNIBE     ,FC,00000-0000,Private      ,2,2,4,5,18,23
03674300,UNIVERSITY OF ABERTAY DUNDEE            ,FC,00000-0000,Public       ,1,1,2,4,6,10
03684400,UNIVERSITY OF LINCOLN                   ,FC,00000-0000,Public       ,1,1,2,1,10,11
03684500,MEDICAL UNIVERSITY OF GDANSK            ,FC,00000-0000,Public       ,1,8,9,3,23,26
03685300,UNIVERSITAT POMPEU FABRA                ,FC,00000-0000,Public       ,1,10,11,7,44,51
03716300,"UNIVERSITY OF WALES, NEWPORT            ",FC,00000-0000,Public       ,0,1,1,4,9,13
03721300,WRITTLE COLLEGE                         ,FC,00000-0000,Public       ,0,0,0,2,2,4
03727400,UNIVERSITY OF WAIKATO (THE)             ,FC,00000-0000,Public       ,2,4,6,6,10,16
03738300,LONDON SCHOOL OF THEOLOGY               ,FC,00000-0000,Private      ,0,3,3,0,8,8
03741300,ALRA (ACADEMY OF LIVE AND RECORDED ARTS),FC,00000-0000,Private      ,0,0,0,1,1,2
03770300,NAZARENE THEOLOGICAL COLLEGE            ,FC,00000-0000,Private      ,1,5,6,1,11,12
03794400,ANGLO EUROPEAN COLLEGE OF CHIROPRACTIC  ,FC,00000-0000,Private      ,0,0,0,0,2,2
03816400,AMERICAN GRAD SCH OF INTERNTL REL & DIPL,FC,00000-0000,Private      ,0,12,12,2,68,70
03818300,LEIPZIG GRADUATE SCHOOL OF MANAGEMENT   ,FC,00000-0000,Private      ,0,4,4,0,10,10
03824300,"ROYAL VETERINARY COLLEGE (THE), UNIVERSI",FC,00000-0000,Public       ,1,13,14,4,113,117
03850400,UNIVERSITY OF NOTRE DAME AUSTRALIA (THE),FC,00000-0000,Private      ,0,3,3,0,5,5
03850500,MEDICAL UNIVERSITY OF LODZ              ,FC,00000-0000,Public       ,2,40,42,4,80,84
03859400,UNIVERSITY COLLEGE FALMOUTH             ,FC,00000-0000,Public       ,0,1,1,4,6,10
03867300,UNIVERSITAT AUTONOMA DE BARCELONA       ,FC,00000-0000,Public       ,2,7,9,2,7,9
03880300,UNIVERSITY OF GLOUCESTERSHIRE (THE)     ,FC,00000-0000,Public       ,0,1,1,4,3,7
03897400,INTERNATIONAL SPACE UNIVERSITY          ,FC,00000-0000,Private      ,0,0,0,0,5,5
03926400,NATIONAL COLLEGE OF ART AND DESIGN      ,FC,00000-0000,Public       ,2,1,3,2,3,5
03941301,AVE MARIA UNIVERSITY - LATIN AMERICA    ,FC,00000-0000,Private      ,31,10,41,159,40,199
03978300,SPURGEON'S COLLEGE                      ,FC,00000-0000,Private      ,0,0,0,1,0,1
03993400,TRINITY COLLEGE CARMARTHEN              ,FC,00000-0000,Public       ,0,2,2,0,4,4
04021400,"AMERICAN COLLEGE, DUBLIN LIMITED (THE)  ",FC,00000-0000,Private      ,0,6,6,4,9,13
04021500,CENTRAL EUROPEAN UNIVERSITY             ,FC,00000-0000,Private      ,1,7,8,4,54,58
04032300,YORK ST JOHN UNIVERSITY                 ,FC,00000-0000,Public       ,2,0,2,8,3,11
04046300,HK UNIVERSITY OF SCI & TECH (HKUST)     ,FC,00000-0000,Public       ,1,7,8,2,22,24
04070300,"RAPHAEL RECANATI INTERNATIONAL SCHOOL, T",FC,00000-0000,Private      ,22,26,48,64,50,114
04085400,NEW ZEALAND COLLEGE OF CHIROPRACTIC     ,FC,00000-0000,Private      ,1,1,2,1,2,3
04113300,LEBANESE AMERICAN UNIVERSITY            ,FC,00000-0000,Private      ,2,4,6,5,5,10
04115900,LIVERPOOL HOPE UNIVERSITY               ,FC,00000-0000,Public       ,0,2,2,0,3,3
04116300,EDHEC BUSINESS SCHOOL                   ,FC,00000-0000,Private      ,0,9,9,0,32,32
04121400,ISAPZURICH (INTERNATIONAL SCHOOL OF ANAL,FC,00000-0000,Private      ,0,4,4,0,4,4
04128600,UNIVERSITY OF WORCESTER                 ,FC,00000-0000,Public       ,0,0,0,0,2,2
04143700,ST MARY'S UNIVERSITY COLLEGE TWICKENHAM ,FC,00000-0000,Public       ,0,3,3,0,3,3
00380600,ALDERSON-BROADDUS COLLEGE               ,WV,26416-1051,Private      ,18,21,39,776,343,1119
00380700,MOUNTAIN STATE UNIVERSITY               ,WV,25801-5624,Private      ,207,1910,2117,1175,6043,7218
00380800,BETHANY COLLEGE                         ,WV,26032-0417,Private      ,68,16,84,1399,99,1498
00380900,BLUEFIELD STATE COLLEGE                 ,WV,24701-2198,Public       ,159,399,558,1228,1612,2840
00381000,CONCORD UNIVERSITY                      ,WV,24712-0000,Public       ,130,194,324,2900,988,3888
00381100,DAVIS & ELKINS COLLEGE                  ,WV,26241-3996,Private      ,50,55,105,734,327,1061
00381200,FAIRMONT STATE UNIVERSITY               ,WV,26554-2470,Public       ,355,713,1068,4744,3387,8131
00381300,GLENVILLE STATE COLLEGE                 ,WV,26351-1292,Public       ,106,116,222,1291,523,1814
00381500,MARSHALL UNIVERSITY                     ,WV,25755-3300,Public       ,636,1362,1998,8417,6107,14524
00381600,SOUTHERN WV COMMUNITY COLLEGE           ,WV,25637-2900,Public       ,205,468,673,1054,1257,2311
00381800,UNIVERSITY OF CHARLESTON                ,WV,25304-1099,Private      ,61,121,182,1393,795,2188
00381900,OHIO VALLEY COLLEGE                     ,WV,26105-8000,Private      ,69,73,142,452,205,657
00382000,SALEM INTERNATIONAL UNIVERSITY          ,WV,26426-0500,Proprietary  ,79,274,353,321,629,950
00382200,SHEPHERD UNIVERSITY                     ,WV,25443-3210,Public       ,247,227,474,3427,1310,4737
00382300,WEST LIBERTY STATE COLLEGE              ,WV,26074-0295,Public       ,209,169,378,2606,728,3334
00382600,WEST VIRGINIA STATE UNIVERSITY          ,WV,25112-0000,Public       ,215,466,681,2525,2430,4955
00382700,WEST VIRGINIA UNIVERSITY                ,WV,26506-6201,Public       ,877,1101,1978,22843,8509,31352
00382711,WEST VIRGINIA UNIVERSITY - POTOMAC STATE,WV,26726-3000,Public       ,109,128,237,1555,432,1987
00382721,WEST VIRGINIA UNIV INST OF TECH         ,WV,25136-2436,Public       ,51,57,108,838,330,1168
00382800,WEST VIRGINIA UNIV AT PARKERSBURG       ,WV,26101-9577,Public       ,219,838,1057,1523,2730,4253
00383000,WEST VIRGINIA WESLEYAN COLLEGE          ,WV,26201-2600,Private      ,65,37,102,1721,215,1936
00383100,WHEELING JESUIT UNIVERSITY              ,WV,26003-6243,Private      ,90,150,240,1255,589,1844
00500700,WEST VIRGINIA JUNIOR COLLEGE            ,WV,26505-5596,Proprietary  ,23,52,75,116,197,313
00500800,MOUNTAIN STATE COLLEGE                  ,WV,26101-3993,Proprietary  ,7,89,96,36,270,306
00754400,APPALACHIAN BIBLE COLLEGE               ,WV,25818-1353,Private      ,17,9,26,248,74,322
00757800,HUNTINGTON SCHOOL OF BEAUTY CULTURE     ,WV,25705-2030,Proprietary  ,12,33,45,42,84,126
00760000,INTERNATIONAL BEAUTY SCHOOL             ,WV,25401-3231,Proprietary  ,8,50,58,23,93,116
00835500,JAMES RUMSEY TECHNICAL INSTITUTE        ,WV,25403-0259,Public       ,12,71,83,72,207,279
00895900,CLARKSBURG BEAUTY ACADEMY               ,WV,26301-2903,Proprietary  ,24,54,78,42,72,114
00904700,HUNTINGTON JUNIOR COLLEGE               ,WV,25701-2004,Proprietary  ,59,302,361,182,1142,1324
00905400,WEST VIRGINIA NORTHERN CMTY COLLEGE     ,WV,26003-0000,Public       ,259,730,989,1048,2104,3152
01014000,MINERAL COUNTY VOCATIONAL TECH CTR      ,WV,26726-0000,Public       ,0,13,13,10,33,43
01035600,EVEREST INSTITUTE                       ,WV,25313-1304,Proprietary  ,41,245,286,138,562,700
01057300,WEST VIRGINIA JUNIOR COLLEGE            ,WV,25322-0000,Proprietary  ,23,79,102,134,317,451
01057302,WEST VIRGINIA JUNIOR COLLEGE            ,WV,26330-0000,Proprietary  ,21,62,83,122,232,354
01086100,WEST VIRGINIA BUSINESS COLLEGE          ,WV,26301-0000,Proprietary  ,5,44,49,21,168,189
01124500,WEST VIRGINIA SCH OSTEOPATHIC MED       ,WV,24901-1128,Public       ,1,17,18,7,848,855
01174900,WOOD COUNTY SCH OF PRAC NURSING         ,WV,26101-6424,Public       ,2,5,7,18,38,56
01235900,B M SPURR SCHOOL OF PRAC NURSING        ,WV,26038-1660,Private      ,0,3,3,8,20,28
01257300,WEST VIRGINIA UNIV-HOSP-RAD TECH        ,WV,26506-8062,Private      ,4,5,9,58,43,101
01274300,BENJAMIN FRANKLIN CAREER&TECH           ,WV,25064-0000,Public       ,9,66,75,54,146,200
01290400,MONONGALIA CNTY TECH ED CTR             ,WV,26501-6841,Public       ,3,37,40,43,140,183
01290500,ACADEMY OF CAREERS AND TECHNOLOGY       ,WV,25801-0000,Public       ,19,126,145,71,267,338
02057400,ROANE-JACKSON TECHNICAL CENTER          ,WV,25252-0000,Public       ,1,26,27,14,74,88
02068000,UNITED TECHNICAL CENTER                 ,WV,26301-0000,Public       ,2,25,27,31,88,119
02070100,BECKLEY BEAUTY ACADEMY                  ,WV,25801-0000,Proprietary  ,6,29,35,31,67,98
02073400,CARVER CAREER TECH ED CTR               ,WV,25306-6397,Public       ,28,89,117,127,261,388
02145100,SCOTT COLLEGE OF COSMETOLOGY            ,WV,26003-0000,Proprietary  ,15,17,32,37,37,74
02178200,CHARLESTON SCHOOL OF BEAUTY CULTURE     ,WV,25301-0000,Proprietary  ,14,42,56,32,82,114
02218200,GARNET CAREER CENTER                    ,WV,25301-0000,Public       ,26,119,145,85,295,380
02275300,CABELL COUNTY CAREER TECHNOLOGY CTR     ,WV,25705-0000,Public       ,36,56,92,83,147,230
02524500,RALPH R WILLIS VOCATIONAL CENTER        ,WV,25601-0000,Public       ,3,8,11,14,40,54
02534800,FRED W EBERLE TECHNICAL CENTER          ,WV,26201-0000,Public       ,8,70,78,30,131,161
02535500,MERCER COUNTY TECH EDUC CNTR            ,WV,24740-0000,Public       ,12,67,79,56,142,198
02579900,NORTH CENTRAL OPPORTUNITIES IND CTR     ,WV,26554-2936,Private      ,7,61,68,20,100,120
02609400,VALLEY COLLEGE                          ,WV,25404-5711,Proprietary  ,6,49,55,19,126,145
03052000,MEREDITH MANOR EQUESTRIAN CENTRE        ,WV,26184-9707,Proprietary  ,24,29,53,140,87,227
03076500,FAYETTE INSTITUTE OF TECHNOLOGY         ,WV,25901-2174,Public       ,6,15,21,12,41,53
03084200,VALLEY COLLEGE                          ,WV,24740-3141,Proprietary  ,3,21,24,6,51,57
03084400,VALLEY COLLEGE                          ,WV,25801-2643,Proprietary  ,5,29,34,16,79,95
03098300,PUTNAM CAREER & TECHNICAL CENTER        ,WV,25070-0000,Public       ,2,23,25,22,60,82
03099200,"MOUNTAINEER BEAUTY COLLEGE, INC         ",WV,25177-2917,Proprietary  ,5,12,17,21,47,68
03102100,MORGANTOWN BEAUTY COLLEGE               ,WV,26505-5430,Proprietary  ,8,31,39,43,76,119
03123200,STANLEY TECHNICAL INSTITUTE             ,WV,26505-3751,Private      ,3,16,19,4,48,52
03327500,SOUTH BRANCH VOCATIONAL TECH CENTER     ,WV,26847-1698,Public       ,6,15,21,6,20,26
03734300,JOHN D. ROCKEFELLER IV CAREER CENTER    ,WV,26047-9424,Public       ,2,6,8,10,18,28
03819300,AMERICAN PUBLIC UNIVERSITY SYSTEM       ,WV,25414-1621,Proprietary  ,112,3217,3329,295,8881,9176
03957300,BLUE RIDGE COMMUNITY AND TECHNICAL COLLE,WV,25401-3244,Public       ,153,303,456,561,1033,1594
03960300,NEW RIVER COMMUNITY AND TECHNICAL COLLEG,WV,25801-2636,Public       ,176,626,802,850,1907,2757
04028300,MOUNTAIN STATE SCHOOL OF MASSAGE        ,WV,25304-2025,Proprietary  ,2,21,23,16,57,73
04038500,PIERPONT COMMUNITY & TECHNICAL COLLEGE  ,WV,26554-2451,Public       ,76,202,278,652,711,1363
04038600,WEST VIRGINIA STATE COMMUNITY AND TECHNI,WV,25112-1000,Public       ,43,218,261,458,1093,1551
04041400,MARSHALL COMMUNITY AND TECHNICAL COLLEGE,WV,25755-3300,Public       ,192,446,638,871,1296,2167
04047300,BRIDGEMONT COMMUNITY & TECHNICAL COLLEGE,WV,25136-2435,Public       ,55,76,131,558,293,851
04119000,EASTERN WEST VIRGINIA COMMUNITY & TECHNI,WV,26836-0000,Public       ,14,32,46,14,32,46
00106100,ALASKA PACIFIC UNIVERSITY               ,AK,99508-4672,Private      ,46,143,189,552,548,1100
00106300,UNIVERSITY OF ALASKA FAIRBANKS          ,AK,99775-7500,Public       ,442,820,1262,2426,2785,5211
00106500,UNIVERSITY OF ALASKA SOUTHEAST          ,AK,99801-8680,Public       ,96,278,374,514,1038,1552
00884300,ALASKA BIBLE COLLEGE                    ,AK,99588-0000,Private      ,4,3,7,19,7,26
01146200,UNIVERSITY OF ALASKA ANCHORAGE          ,AK,99514-1608,Public       ,928,1593,2521,4837,6458,11295
02541000,CAREER ACADEMY                          ,AK,99507-0000,Proprietary  ,35,144,179,71,361,432
02576900,CHARTER COLLEGE                         ,AK,99508-0000,Proprietary  ,149,616,765,295,1609,1904
03160300,ALASKA VOCATIONAL TECHNICAL CENTER      ,AK,99664-0889,Public       ,42,89,131,146,235,381
03461300,ILISAGVIK COLLEGE                       ,AK,99723-0749,Public       ,9,45,54,15,66,81
04138600,ALASKA CHRISTIAN COLLEGE                ,AK,99669-9755,Private      ,3,5,8,19,13,32
00108500,UNIV ARKANSAS MONTICELLO                ,AR,71656-0000,Public       ,454,734,1188,1868,2019,3887
00108600,UNIV OF ARKANSAS AT PINE BLUFF          ,AR,71601-2790,Public       ,617,593,1210,3960,1932,5892
00108700,ARKANSAS BAPTIST COLLEGE                ,AR,72202-6099,Private      ,208,266,474,633,791,1424
00108800,LYON COLLEGE                            ,AR,72501-3699,Private      ,52,38,90,750,125,875
00108900,ARKANSAS TECH UNIVERSITY                ,AR,72801-2222,Public       ,752,887,1639,4655,3444,8099
00109000,ARKANSAS STATE UNIVERSITY               ,AR,72467-0000,Public       ,1341,2767,4108,7037,8477,15514
00109006,DELTA TECHNICAL INSTITUTE               ,AR,72365-9558,Public       ,8,34,42,28,78,106
00109100,ARKANSAS STATE UNIVERSITY - BEEBE       ,AR,72012-1000,Public       ,300,840,1140,1698,2545,4243
00109200,UNIVERSITY OF CENTRAL ARKANSAS          ,AR,72035-0001,Public       ,1204,1110,2314,7243,4232,11475
00109300,CENTRAL BAPTIST COLLEGE                 ,AR,72034-6470,Private      ,95,70,165,382,290,672
00109400,UNIVERSITY OF THE OZARKS                ,AR,72830-2880,Private      ,63,26,89,584,121,705
00109500,CROWLEYS RIDGE COLLEGE                  ,AR,72450-9775,Private      ,40,27,67,146,62,208
00109700,HARDING UNIVERSITY                      ,AR,72149-0001,Private      ,314,382,696,3230,1433,4663
00109800,HENDERSON STATE UNIVERSITY              ,AR,71999-0001,Public       ,475,478,953,2955,1590,4545
00109900,HENDRIX COLLEGE                         ,AR,72032-3080,Private      ,46,24,70,1957,106,2063
00110000,JOHN BROWN UNIVERSITY                   ,AR,72761-2747,Private      ,57,291,348,1171,991,2162
00110100,UNIV ARKANSAS LITTLE ROCK               ,AR,72204-1099,Public       ,792,2352,3144,4170,9182,13352
00110200,OUACHITA BAPTIST UNIVERSITY             ,AR,71998-0001,Private      ,137,39,176,1414,151,1565
00110300,PHILANDER SMITH COLLEGE                 ,AR,72202-3718,Private      ,127,176,303,797,642,1439
00110400,PHILLIPS COUNTY COMMUNITY COLLEGE       ,AR,72342-0000,Public       ,187,489,676,448,944,1392
00110401,RICE BELT TECH INST                     ,AR,72042-0000,Public       ,0,4,4,7,10,17
00110600,WILLIAMS BAPTIST COLLEGE                ,AR,72476-4661,Private      ,59,38,97,536,187,723
00110700,SOUTHERN ARKANSAS UNIVERSITY            ,AR,71754-0000,Public       ,379,483,862,2084,1601,3685
00110800,UNIV ARKANSAS FAYETTEVILLE              ,AR,72701-0000,Public       ,1424,1400,2824,9524,5506,15030
00110900,UNIV OF ARKANSAS FOR MEDCL SCIENCES     ,AR,72205-7102,Public       ,60,261,321,433,1830,2263
00110901,UNIV OF ARKANSAS COLG OF MEDICINE       ,AR,72205-0000,Public       ,6,43,49,45,681,726
00111000,UNIVERSITY OF ARKANSAS-FORT SMITH       ,AR,72904-7397,Public       ,735,1258,1993,3426,4032,7458
00524500,U OF A COMM COLLEGE AT MORRILTON        ,AR,72110-9601,Public       ,203,519,722,994,1735,2729
00570700,SEARK COLLEGE                           ,AR,71603-0000,Public       ,236,722,958,639,1847,2486
00573200,UNIV AR COMMUNITY COLLEGE AT HOPE       ,AR,71801-0000,Public       ,161,503,664,514,1158,1672
00704400,CROWLEYS RIDGE TECHNICAL INSTITUTE      ,AR,72336-0000,Public       ,54,97,151,95,232,327
00773800,SOUTHERN ARKANSAS UNIVERSITY TECH       ,AR,71701-1900,Public       ,121,283,404,412,752,1164
00792100,FAYETTEVILLE BEAUTY COLLEGE             ,AR,72701-0000,Proprietary  ,18,35,53,33,73,106
00997600,OUACHITA TECHNICAL COLLEGE              ,AR,72104-0816,Public       ,83,302,385,317,827,1144
01074100,MELLIE'S BEAUTY COLLEGE                 ,AR,72901-3886,Proprietary  ,20,52,72,44,111,155
01210500,NATIONAL PARK COMMUNITY COLLEGE         ,AR,71913-9174,Public       ,330,813,1143,1036,2324,3360
01226000,EAST ARKANSAS COMMUNITY COLLEGE         ,AR,72335-2204,Public       ,232,397,629,514,822,1336
01226100,NORTH ARKANSAS COLLEGE                  ,AR,72601-5508,Public       ,191,467,658,866,1654,2520
01286000,ARKANSAS NORTHEASTERN COLLEGE           ,AR,72316-1109,Public       ,205,636,841,710,1550,2260
02052200,BLACK RIVER TECHNICAL COLLEGE           ,AR,72455-0000,Public       ,225,724,949,689,1673,2362
02073500,UNIVERSITY OF ARKANSAS COMMUNITY COLLEGE,AR,72503-0000,Public       ,135,456,591,454,1156,1610
02073502,UNIVERSITY OF ARKANSAS COMMUNITY COLLEGE,AR,72501-0000,Public       ,16,69,85,31,102,133
02073700,NORTHWEST TECHNICAL INSTITUTE           ,AR,72765-0000,Public       ,45,192,237,142,470,612
02074600,SOUTH ARKANSAS COMMUNITY COLLEGE        ,AR,71731-0000,Public       ,138,499,637,437,1437,1874
02075300,PULASKI TECHNICAL COLLEGE               ,AR,72118-0000,Public       ,894,3073,3967,2869,10573,13442
02087000,OZARKA COLLEGE                          ,AR,72556-0000,Public       ,106,408,514,284,981,1265
02111100,RICH MOUNTAIN COMMUNITY COLLEGE         ,AR,71953-0000,Public       ,89,218,307,347,517,864
02202400,PROFESSIONAL COSMETOLOGY EDUC CTR       ,AR,71730-5828,Proprietary  ,9,30,39,20,64,84
02220900,COSSATOT COMMUNITY COLLEGE              ,AR,71832-0000,Public       ,79,255,334,401,873,1274
02260400,BEE JAY'S HAIRSTYLING ACADEMY           ,AR,72212-0000,Proprietary  ,3,25,28,5,36,41
02260401,BEE JAY'S HAIRSTYLING ACADEMY - BATESVIL,AR,72501-6709,Proprietary  ,3,11,14,4,24,28
02272400,EASTERN COLLEGE OF HEALTH VOCATIONS     ,AR,72209-0000,Proprietary  ,62,225,287,140,600,740
02284200,NEW TYLER BARBER COLLEGE INC            ,AR,72114-0000,Proprietary  ,14,68,82,31,107,138
02287400,MARSHA KAY BEAUTY COLLEGE               ,AR,72653-0000,Proprietary  ,15,20,35,19,27,46
02321701,ITT TECHNICAL INSTITUTE                 ,AR,72204-9925,Proprietary  ,92,339,431,290,767,1057
02330800,JEFFERSON SCHOOL OF NURSING             ,AR,71603-0000,Private      ,7,20,27,27,104,131
02339800,SOUTHERN INSTITUTE OF COSMETOLOGY       ,AR,72301-0000,Proprietary  ,9,28,37,10,39,49
02341700,CAREER ACADEMY OF HAIR DESIGN           ,AR,72764-4304,Proprietary  ,18,63,81,59,172,231
02341701,CAREER ACADEMY OF HAIR DESIGN - ROGERS  ,AR,72756-2102,Proprietary  ,11,52,63,13,66,79
02348200,MID-SOUTH COMMUNITY COLLEGE             ,AR,72301-0000,Public       ,270,739,1009,693,1678,2371
02363500,ARTHUR'S BEAUTY COLLEGE                 ,AR,72901-0000,Proprietary  ,10,26,36,17,50,67
02525800,LEE'S SCHOOL OF COSMETOLOGY             ,AR,72114-0000,Proprietary  ,4,20,24,12,45,57
02538500,ARTHUR'S BEAUTY COLLEGE                 ,AR,72076-0000,Proprietary  ,30,82,112,58,144,202
02569600,SEARCY BEAUTY COLLEGE                   ,AR,72143-0000,Proprietary  ,10,23,33,16,57,73
03005100,ARKANSAS BEAUTY SCHOOL                  ,AR,72209-5116,Proprietary  ,6,30,36,21,100,121
03007100,HOT SPRINGS BEAUTY COLLEGE              ,AR,71901-5432,Proprietary  ,15,25,40,34,59,93
03007600,ARKANSAS BEAUTY SCHOOL-CONWAY           ,AR,72032-4354,Proprietary  ,15,26,41,29,58,87
03023400,ARKANSAS COLLEGE OF BARBERING           ,AR,72114-5615,Proprietary  ,31,100,131,46,159,205
03063300,NORTHWEST ARKANSAS COMMUNITY COLLEG     ,AR,72712-5190,Public       ,523,1178,1701,2111,4064,6175
03065100,ABC BEAUTY COLLEGE                      ,AR,71923-4206,Proprietary  ,15,42,57,21,57,78
03066302,BRYAN COLLEGE -                         ,AR,72756-1825,Proprietary  ,18,93,111,58,272,330
03105200,BAPTIST HEALTH SCHOOLS LITTLE ROCK      ,AR,72210-0000,Private      ,70,215,285,408,1424,1832
03115102,HERITAGE COLLEGE - LITTLE ROCK          ,AR,72227-5544,Proprietary  ,23,191,214,23,191,214
03116800,"DELUXE BEAUTY SCHOOL, L.L.C.            ",AR,71603-0000,Proprietary  ,2,10,12,4,25,29
03124900,IMAGINE -  PAUL MITCHELL PARTNER SCHOOL ,AR,72117-2516,Proprietary  ,33,58,91,99,132,231
03127200,ASKINS VO-TECH                          ,AR,72908-8028,Proprietary  ,1,18,19,6,51,57
03214300,VELVATEX COLLEGE OF BEAUTY CULTURE      ,AR,72202-5452,Proprietary  ,2,13,15,6,25,31
03254300,MARGARET'S HAIR ACADEMY                 ,AR,71655-4905,Proprietary  ,7,33,40,20,58,78
03519400,LYNNDALE FUNDAMENTALS OF BEAUTY SCH     ,AR,71730-4804,Proprietary  ,3,9,12,10,27,37
03855300,ECCLESIA COLLEGE                        ,AR,72762-8159,Private      ,22,22,44,78,30,108
03912300,CROSSETT SCHOOL OF COSMETOLOGY          ,AR,71635-0000,Proprietary  ,4,11,15,4,15,19
03997300,ARKANSAS BEAUTY COLLEGE                 ,AR,72801-3741,Proprietary  ,7,26,33,18,46,64
00133900,CORBAN COLLEGE                          ,OR,97301-9392,Private      ,45,104,149,1179,475,1654
00316505,CASCADE COLLEGE                         ,OR,97216-0000,Private      ,6,38,44,40,136,176
00318600,BLUE MOUNTAIN COMMUNITY COLLEGE         ,OR,97801-0000,Public       ,153,455,608,886,1691,2577
00318800,CENTRAL OREGON COMMUNITY COLLEGE        ,OR,97701-5998,Public       ,515,1392,1907,2374,4850,7224
00318900,CLATSOP COMMUNITY COLLEGE               ,OR,97103-3698,Public       ,70,192,262,358,660,1018
00319100,CONCORDIA UNIVERSITY                    ,OR,97211-6099,Private      ,127,338,465,1250,1606,2856
00319300,EASTERN OREGON UNIVERSITY               ,OR,97850-2899,Public       ,155,515,670,1969,2593,4562
00319400,GEORGE FOX UNIVERSITY                   ,OR,97132-2697,Private      ,178,506,684,2304,1839,4143
00319600,LANE COMMUNITY COLLEGE                  ,OR,97405-0640,Public       ,1063,2652,3715,5397,11104,16501
00319700,LEWIS & CLARK COLLEGE                   ,OR,97219-7899,Private      ,60,166,226,4423,3520,7943
00319800,LINFIELD COLLEGE                        ,OR,97128-6894,Private      ,68,148,216,2667,692,3359
00319801,LINFIELD COLLEGE - PORTLAND CAMPUS      ,OR,97210-0000,Private      ,6,70,76,275,722,997
00319900,MARYLHURST UNIVERSITY                   ,OR,97036-7036,Private      ,32,545,577,150,1808,1958
00320300,MOUNT ANGEL SEMINARY                    ,OR,97373-0505,Private      ,6,11,17,16,18,34
00320400,MOUNT HOOD COMMUNITY COLLEGE            ,OR,97030-3300,Public       ,817,1656,2473,3466,6034,9500
00320600,MULTNOMAH BIBLE COLLEGE/SEMINARY        ,OR,97220-5898,Private      ,58,145,203,491,615,1106
00320700,PACIFIC NORTHWEST COLLEGE OF ART        ,OR,97209-3023,Private      ,58,116,174,665,557,1222
00320800,NORTHWEST CHRISTIAN UNIVERSITY          ,OR,97401-3727,Private      ,26,110,136,623,508,1131
00320900,WESTERN OREGON UNIVERSITY               ,OR,97361-1394,Public       ,304,361,665,5505,2282,7787
00321000,OREGON STATE UNIVERSITY                 ,OR,97331-8507,Public       ,1118,1366,2484,17613,8651,26264
00321100,OREGON INSTITUTE OF TECHNOLOGY          ,OR,97601-8801,Public       ,161,311,472,2080,1866,3946
00321200,PACIFIC UNIVERSITY                      ,OR,97116-1797,Private      ,77,228,305,2504,2779,5283
00321300,PORTLAND COMMUNITY COLLEGE              ,OR,97219-7198,Public       ,2299,6590,8889,9532,22929,32461
00321600,PORTLAND STATE UNIVERSITY               ,OR,97207-0000,Public       ,1494,4022,5516,12315,19272,31587
00321700,REED COLLEGE                            ,OR,97202-8199,Private      ,39,62,101,2683,393,3076
00321800,CHEMEKETA COMMUNITY COLLEGE             ,OR,97309-1500,Public       ,1032,2661,3693,4624,10083,14707
00321900,SOUTHERN OREGON UNIVERSITY              ,OR,97520-5010,Public       ,314,503,817,4251,2786,7037
00322000,SOUTHWESTERN OREGON COMMUNITY CLG       ,OR,97420-2956,Public       ,179,324,503,1368,1384,2752
00322100,TREASURE VALLEY COMMUNITY COLLEGE       ,OR,97914-3423,Public       ,291,725,1016,1320,2192,3512
00322200,UMPQUA COMMUNITY COLLEGE                ,OR,97470-0226,Public       ,204,768,972,1175,3096,4271
00322300,UNIVERSITY OF OREGON                    ,OR,97403-1226,Public       ,1059,1109,2168,19589,9502,29091
00322400,UNIVERSITY OF PORTLAND                  ,OR,97203-5798,Private      ,187,216,403,7055,1693,8748
00322500,WARNER PACIFIC COLLEGE                  ,OR,97215-4099,Private      ,47,361,408,729,1241,1970
00322700,WILLAMETTE UNIVERSITY                   ,OR,97301-3930,Private      ,72,163,235,3979,1802,5781
00487800,CLACKAMAS COMMUNITY COLLEGE             ,OR,97045-7998,Public       ,630,1267,1897,2753,4146,6899
00488200,OREGON HEALTH & SCIENCE UNIVERSITY      ,OR,97239-0000,Public       ,24,248,272,401,3219,3620
00488230,OREGON GRAD INST OF SCIENCE & TECH      ,OR,97006-0000,Public       ,0,0,0,2,11,13
00693800,LINN BENTON COMMUNITY COLLEGE           ,OR,97321-3774,Public       ,726,1172,1898,3250,4496,7746
00717800,WESTERN SEMINARY                        ,OR,97215-0000,Private      ,0,69,69,5,259,264
00723402,HEALD COLLEGE - PORTLAND                ,OR,97205-3432,Proprietary  ,71,317,388,221,969,1190
00781900,ART INSTITUTE OF PORTLAND (THE)         ,OR,97209-2911,Proprietary  ,206,283,489,1606,1577,3183
00888700,CONCORDE CAREER INSTITUTE               ,OR,97232-2242,Proprietary  ,98,387,485,240,952,1192
00907900,EVEREST COLLEGE                         ,OR,97204-2296,Proprietary  ,73,347,420,222,954,1176
00958100,SPRINGFIELD COLLEGE OF BEAUTY           ,OR,97477-5474,Proprietary  ,13,37,50,70,154,224
01012200,PHAGANS' MEDFORD BEAUTY SCHOOL          ,OR,97504-5297,Proprietary  ,23,52,75,44,114,158
01018200,ROGUE COMMUNITY COLLEGE                 ,OR,97527-0000,Public       ,497,1312,1809,2252,5066,7318
01050700,ACADEMY OF HAIR DESIGN                  ,OR,97301-3526,Proprietary  ,16,49,65,39,90,129
01185200,ITT TECHNICAL INSTITUTE                 ,OR,97220-0000,Proprietary  ,215,553,768,554,1371,1925
01230900,WESTERN STATES CHIROPRACTIC COLLEGE     ,OR,97230-3099,Private      ,4,56,60,29,513,542
01234700,PHAGANS CENTRAL OREGON BEAUTY CLG       ,OR,97701-5175,Proprietary  ,19,88,107,62,217,279
01234800,PHAGANS BEAUTY COLLEGE                  ,OR,97333-4716,Proprietary  ,12,31,43,48,87,135
01235000,PHAGANS SCHOOL OF HAIR DESIGN           ,OR,97267-4808,Proprietary  ,11,29,40,35,91,126
01235100,PHAGANS SCHOOL OF BEAUTY                ,OR,97301-4732,Proprietary  ,10,39,49,38,105,143
01300800,PHAGANS TIGARD BEAUTY SCHOOL            ,OR,97223-0000,Proprietary  ,6,14,20,18,62,80
02101000,NORTHWEST COLLEGE OF HAIR DESIGN        ,OR,97086-7702,Proprietary  ,39,106,145,92,258,350
02101002,NORTHWEST COLLEGE                       ,OR,97007-3954,Proprietary  ,1,15,16,14,32,46
02104900,COLLEGE OF LEGAL ARTS                   ,OR,97219-9998,Proprietary  ,13,97,110,35,229,264
02106100,COLLEGE OF COSMETOLOGY                  ,OR,97601-0000,Proprietary  ,7,26,33,29,58,87
02154400,BEAU MONDE CLG OF HAIR DESIGN           ,OR,97205-0000,Proprietary  ,36,72,108,110,223,333
02159700,EUGENE BIBLE COLLEGE                    ,OR,97405-0000,Private      ,28,31,59,94,104,198
02201900,PHAGANS' SCHOOL OF HAIR DESIGN          ,OR,97232-0000,Proprietary  ,24,89,113,90,282,372
02239203,ALLIED COLLEGE - ANTHEM COLLEGE         ,OR,97005-0000,Proprietary  ,6,33,39,29,107,136
02330100,PIONEER PACIFIC COLLEGE                 ,OR,97070-0000,Proprietary  ,115,446,561,265,1097,1362
02330102,PIONEER PACIFIC COLLEGE                 ,OR,97403-0000,Proprietary  ,26,219,245,110,815,925
02337900,COLLEGE OF HAIR DESIGN CAREERS          ,OR,97301-0000,Proprietary  ,22,38,60,47,85,132
02344100,ROSEBURG BEAUTY COLLEGE                 ,OR,97470-0000,Proprietary  ,8,29,37,27,84,111
02534000,NATIONAL COLLEGE OF NATURAL MEDICINE    ,OR,97201-0000,Private      ,5,59,64,14,685,699
02578800,NORTHWEST NANNIES INSTITUTE             ,OR,97035-0000,Proprietary  ,14,3,17,37,9,46
02603700,OREGON COL OF ORIENTAL MEDICINE         ,OR,97216-0000,Private      ,3,68,71,7,361,368
02617506,EVEREST COLLEGE - EVEREST INSTITUTE     ,OR,97223-6581,Proprietary  ,35,136,171,70,258,328
03007300,OREGON COLLEGE OF ART & CRAFT           ,OR,97225-6399,Private      ,21,33,54,145,257,402
03022600,LE CORDON BLEU COLLEGE OF CULINARY ARTS ,OR,97205-2793,Proprietary  ,290,706,996,1327,2096,3423
03042500,APOLLO COLLEGE                          ,OR,97232-1302,Proprietary  ,150,683,833,426,1630,2056
03074400,PHAGANS NEWPORT ACAD CSMTLGY CAREER     ,OR,97365-4963,Proprietary  ,10,16,26,21,50,71
03074500,EAST-WEST COLLEGE OF THE HEALING ARTS   ,OR,97232-2765,Proprietary  ,30,91,121,92,340,432
03185300,PHAGANS GRANTS PASS COLLEGE OF BTY      ,OR,97527-3039,Proprietary  ,17,50,67,32,90,122
03428300,KLAMATH COMMUNITY COLLEGE               ,OR,97603-7121,Public       ,138,364,502,431,1183,1614
03642300,VALLEY MEDICAL COLLEGE                  ,OR,97305-1373,Proprietary  ,9,97,106,40,244,284
03668300,BIRTHINGWAY COLLEGE OF MIDWIFERY        ,OR,97266-4042,Private      ,5,28,33,17,124,141
03783400,ABDILL CAREER COLLEGE                   ,OR,97504-7137,Proprietary  ,7,76,83,26,186,212
00137400,ALBERTUS MAGNUS COLLEGE                 ,CT,06511-1189,Private      ,36,202,238,838,939,1777
00137403,ALBERTUS MAGNUS CLG-NEW DIMENSIONS      ,CT,06511-0000,Private      ,8,185,193,47,610,657
00137800,CENTRAL CONNECTICUT STATE UNIV          ,CT,06050-2490,Public       ,551,635,1186,9258,3919,13177
00137900,CONNECTICUT COLLEGE                     ,CT,06320-4196,Private      ,24,12,36,2894,88,2982
00138000,WESTERN CONNECTICUT STATE UNIV          ,CT,06810-6826,Public       ,293,248,541,5513,1468,6981
00138500,FAIRFIELD UNIVERSITY                    ,CT,06430-0000,Private      ,62,190,252,6369,881,7250
00138700,HARTFORD SEMINARY                       ,CT,06105-0000,Private      ,0,14,14,7,36,43
00138900,HOLY APOSTLES COLLEGE & SEMINARY        ,CT,06416-2005,Private      ,3,19,22,12,48,60
00139200,MANCHESTER COMMUNITY COLLEGE            ,CT,06045-1046,Public       ,682,740,1422,2992,2664,5656
00139300,MITCHELL COLLEGE                        ,CT,06320-4498,Private      ,77,37,114,1119,213,1332
00139700,UNIVERSITY OF NEW HAVEN                 ,CT,06516-1999,Private      ,183,381,564,7005,1773,8778
00139800,NORTHWESTERN CT COMMUNITY COLLEGE       ,CT,06098-1747,Public       ,125,161,286,506,536,1042
00139900,NORWALK COMMUNITY TECHNICAL COLLEGE     ,CT,06854-1655,Public       ,611,678,1289,1855,2117,3972
00140100,POST UNIVERSITY                         ,CT,06723-3240,Proprietary  ,156,706,862,1090,1789,2879
00140200,QUINNIPIAC UNIVERSITY                   ,CT,06518-1908,Private      ,102,220,322,11745,1519,13264
00140201,QUINNIPIAC UNIVERSITY SCHOOL OF LAW     ,CT,06518-0000,Private      ,1,45,46,104,1294,1398
00140300,SACRED HEART UNIVERSITY                 ,CT,06825-1000,Private      ,200,314,514,6947,1431,8378
00140600,SOUTHERN CONNECTICUT STATE UNIV         ,CT,06515-1355,Public       ,398,689,1087,9147,4640,13787
00140900,SAINT JOSEPH COLLEGE                    ,CT,06117-2791,Private      ,32,209,241,1148,984,2132
00141400,TRINITY COLLEGE                         ,CT,06106-3100,Private      ,67,38,105,2729,238,2967
00141600,UNIVERSITY OF BRIDGEPORT                ,CT,06601-5650,Private      ,184,513,697,3345,2489,5834
00141700,UNIVERSITY OF CONNECTICUT-STORRS        ,CT,06269-2151,Public       ,593,651,1244,25480,5458,30938
00141702,UNIV CONN STAMFORD                      ,CT,06901-0000,Public       ,32,56,88,399,259,658
00141703,UNIV OF CONNECTICUT - TORINGTON         ,CT,06790-0000,Public       ,5,15,20,169,54,223
00141706,UNIV OF CONNECTICUT SCH LAW             ,CT,06105-0000,Public       ,1,24,25,28,1321,1349
00141707,UNIV OF CT - SCH OF SOCIAL WORK         ,CT,06117-0000,Public       ,5,24,29,77,444,521
00141708,UNIVERSITY OF CONNECTICUT - SCHOOL OF ME,CT,06030-1920,Public       ,6,35,41,27,533,560
00141709,UNIVERSITY OF CONNECTICUT - SCHOOL OF DE,CT,06030-1920,Public       ,9,30,39,15,235,250
00142200,UNIVERSITY OF HARTFORD                  ,CT,06117-1599,Private      ,238,260,498,9272,1702,10974
00142400,WESLEYAN UNIVERSITY                     ,CT,06459-3208,Private      ,66,27,93,5465,196,5661
00142500,EASTERN CONNECTICUT STATE UNIV          ,CT,06226-2295,Public       ,260,186,446,5311,1169,6480
00142600,YALE UNIVERSITY                         ,CT,06520-8288,Private      ,223,243,466,15902,7513,23415
00142601,YALE UNIV PHYSICIANS ASSOC PROG         ,CT,06510-0000,Private      ,2,11,13,9,112,121
00142602,YALE UNIV EPIDEMIOLOGY & PUB HLTH       ,CT,06510-0000,Private      ,0,0,0,0,11,11
00142603,YALE UNIV SCHOOL MEDICINE               ,CT,06510-0000,Private      ,6,22,28,45,868,913
00280301,RENSSELAER POLYTECHNIC INSTITUTE-RENSSEL,CT,06120-2991,Private      ,2,40,42,14,91,105
00451300,HOUSATONIC COMMUNITY COLLEGE            ,CT,06604-4704,Public       ,508,799,1307,2211,3122,5333
00618100,BRIDGEPORT HOSP SCHL OF NURSING         ,CT,06610-2896,Private      ,3,60,63,84,319,403
00619100,ST. VINCENT'S COLLEGE                   ,CT,06606-9966,Private      ,34,136,170,247,538,785
00698200,NAUGATUCK VALLEY COMM-TECH COLG         ,CT,06708-3089,Public       ,634,769,1403,2410,2542,4952
00730000,ELI WHITNEY TECHNICAL HIGH SCHOOL       ,CT,06514-0000,Public       ,4,20,24,18,66,84
00730300,LINCOLN TECHNICAL INSTITUTE             ,CT,06051-0000,Proprietary  ,331,858,1189,814,1833,2647
00730500,PORTER AND CHESTER INSTITUTE OF BRANFORD,CT,06405-4022,Proprietary  ,37,93,130,198,291,489
00731100,WINDHAM TECHNICAL HIGH SCHOOL           ,CT,06226-2100,Public       ,4,8,12,9,31,40
00745900,PAIER COLLEGE OF ART                    ,CT,06514-3902,Proprietary  ,37,21,58,174,71,245
00763500,CAPITAL COMMUNITY COLLEGE               ,CT,06103-1207,Public       ,380,869,1249,1536,3492,5028
00803700,GATEWAY COMMUNITY-TECHNICAL COLLEGE     ,CT,06511-0000,Public       ,668,1055,1723,2370,3464,5834
00803800,MIDDLESEX COMMUNITY CLG                 ,CT,06457-4889,Public       ,238,323,561,916,1094,2010
00887200,RENASCI ACADEMY OF HAIR                 ,CT,06460-4160,Proprietary  ,0,14,14,2,26,28
00887300,PAUL MITCHELL THE SCHOOL                ,CT,06810-6716,Proprietary  ,31,24,55,62,47,109
00887400,BRIO ACADEMY OF COSMETOLOGY             ,CT,06450-4836,Proprietary  ,78,159,237,109,230,339
00887403,BRIO ACADEMY OF COSMETOLOGY - WILLIMANTI,CT,06226-1940,Proprietary  ,0,1,1,3,8,11
00906500,THE HARTFORD CONSERVATORY               ,CT,06105-2891,Private      ,8,5,13,46,16,62
00927700,E C GOODWIN TECHNICAL HIGH SCHOOL       ,CT,06053-0000,Public       ,3,4,7,21,38,59
00929100,J M WRIGHT TECHNICAL HIGH SCHOOL        ,CT,06904-0000,Public       ,0,5,5,6,18,24
00940700,BRIARWOOD COLLEGE                       ,CT,06489-1057,Proprietary  ,117,190,307,642,588,1230
00976400,TUNXIS COMMUNITY COLLEGE                ,CT,06032-3187,Public       ,359,460,819,1451,1634,3085
00976500,THREE RIVERS COMMUNITY TECH COLLEGE     ,CT,06360-0000,Public       ,362,661,1023,1341,2006,3347
00982200,ALBERT I PRINCE TECHNICAL HIGH SCHOOL   ,CT,06106-3799,Public       ,5,31,36,10,59,69
01041700,BRIO ACADEMY OF EAST HARTFORD           ,CT,06108-2220,Proprietary  ,21,65,86,40,122,162
01053000,QUINEBAUG VALLEY COMMUNITY COLLEGE      ,CT,06239-1440,Public       ,191,336,527,693,1082,1775
01077900,PORTER AND CHESTER INSTITUTE-ALLCAMPUSES,CT,06615-7158,Proprietary  ,526,891,1417,907,1774,2681
01115000,ASNUNTUCK COMMUNITY COLLEGE             ,CT,06082-3800,Public       ,122,193,315,405,605,1010
01149600,BULLARD HAVENS VOC TECH SCHOOL          ,CT,06610-3499,Public       ,1,15,16,11,54,65
01169700,VINAL REGIONAL VOC TECH SCHOOL          ,CT,06457-4918,Public       ,1,3,4,8,27,35
01184300,NORWICH TECHNICAL HIGH SCHOOL           ,CT,06360-7097,Public       ,1,9,10,10,28,38
01218500,H C WILCOX TECHNICAL HIGH SCHOOL        ,CT,06450-0000,Public       ,3,0,3,4,1,5
01242500,STONE ACADEMY                           ,CT,06514-4125,Proprietary  ,72,366,438,177,1009,1186
01242503,STONE ACADEMY -WATERBURY                ,CT,06705-3823,Proprietary  ,7,16,23,17,45,62
01242504,STONE ACADEMY -  EAST HARTFORD          ,CT,06118-0000,Proprietary  ,1,20,21,10,77,87
01287700,GIBBS COLLEGE                           ,CT,06855-1436,Proprietary  ,10,29,39,49,128,177
01291300,LEON INSTITUTE OF HAIR DESIGN           ,CT,06604-4226,Proprietary  ,5,25,30,11,60,71
01326400,HENRY ABBOTT TECHNICAL HIGH SCHOOL      ,CT,06811-4881,Public       ,2,8,10,7,30,37
02058900,HARVARD H ELLIS TECHNICAL HIGH SCHOOL   ,CT,06239-0000,Public       ,2,1,3,10,6,16
02074000,BRANFORD HALL CAREER INSTITUTE          ,CT,06405-0000,Proprietary  ,364,1593,1957,770,3626,4396
02106600,FOX INSTITUTE OF BUSINESS               ,CT,06110-0000,Proprietary  ,40,217,257,70,346,416
02112300,RIDLEY LOWELL BUSINESS & TECH INST      ,CT,06320-0000,Proprietary  ,39,204,243,53,377,430
02112700,NORTH HAVEN ACADEMY                     ,CT,06473-3108,Proprietary  ,45,32,77,140,89,229
02115100,BUTLER BUSINESS SCHOOL                  ,CT,06604-0000,Proprietary  ,24,140,164,48,283,331
02148700,CONNECTICUT INST OF HAIR DESIGN         ,CT,06716-0000,Proprietary  ,2,21,23,17,42,59
02202500,NEW ENGLAND TRACTOR TRAILER SCH         ,CT,06071-2036,Proprietary  ,28,275,303,42,536,578
02213000,ELLA T GRASSO SOUTHEASTERN TECHNICAL HIG,CT,06340-0000,Public       ,0,2,2,4,5,9
02228800,LINCOLN TECHNICAL INSTITUTE - EAST WINDS,CT,06088-9631,Proprietary  ,210,169,379,827,501,1328
02244900,GOODWIN COLLEGE                         ,CT,06118-9980,Private      ,215,844,1059,666,2577,3243
02245300,HOWELL CHENEY TECHNICAL HIGH SCHOOL     ,CT,06040-0000,Public       ,3,6,9,11,26,37
02265900,WINDHAM COMMUNITY MEM HOSP-RAD TECH     ,CT,06226-0000,Private      ,1,3,4,11,12,23
02296100,YALE-NEW HAVEN HOSP DIETETIC INTERN     ,CT,06510-8900,Private      ,3,2,5,9,11,20
02300000,W F KAYNOR TECHNICAL HIGH SCHOOL        ,CT,06708-0000,Public       ,1,9,10,5,41,46
02316600,CONNECTICUT CTR FOR MASSAGE THERAPY     ,CT,06111-3975,Proprietary  ,20,89,109,68,275,343
02316601,CONNECTICUT CENTER FOR MASSAGE THERAPY -,CT,06880-4619,Proprietary  ,12,33,45,30,132,162
02316603,CONNECTICUT CENTER FOR MASSAGE THERAPY -,CT,06340-4619,Proprietary  ,5,48,53,27,136,163
02562400,EMMETT O BRIEN REG VOC TECH SCHOOL      ,CT,06401-2500,Public       ,0,0,0,0,4,4
02565000,PLATT TECHNICAL HIGH SCHOOL             ,CT,06460-2105,Public       ,2,10,12,7,23,30
03079400,LYME ACADEMY COLLEGE OF FINE ARTS       ,CT,06371-2333,Private      ,10,7,17,77,34,111
03094800,INDUSTRIAL MANAGEMENT & TRAINING        ,CT,06706-1211,Proprietary  ,4,59,63,22,146,168
03231400,OLIVER WOLCOTT TECHNICAL HIGH SCHOOL    ,CT,06790-3859,Public       ,0,0,0,1,2,3
03234300,CHARTER OAK STATE COLLEGE               ,CT,06053-2150,Public       ,29,316,345,75,981,1056
03316300,LINCOLN TECHNICAL INSTITUTE - HARTFORD  ,CT,06105-3630,Proprietary  ,81,152,233,447,406,853
03381300,CONNECTICUT TRAINING CENTER             ,CT,06108-2705,Private      ,23,84,107,38,157,195
03927300,ALBERT SCHOOL (THE)                     ,CT,06357-2447,Proprietary  ,27,51,78,37,71,108
04053300,CLEMENS COLLEGE                         ,CT,06078-0000,Proprietary  ,19,9,28,111,24,135
04104300,ACADEMY DI CAPELLI - SCHOOL OF COSMETOLO,CT,06492-0000,Proprietary  ,9,13,22,19,39,58
04128800,BRANFORD ACADEMY OF HAIR & COSMETOLOGY  ,CT,06405-0000,Proprietary  ,12,19,31,24,33,57
04145400,OXFORD ACADEMY OF HAIR DESIGN           ,CT,06483-2603,Proprietary  ,11,22,33,11,22,33
04152400,INTERNATIONAL INSTITUTE OF COSMETOLOGY  ,CT,06109-0000,Proprietary  ,9,4,13,9,4,13
00146600,BARRY UNIVERSITY                        ,FL,33161-6695,Private      ,463,1594,2057,4737,7737,12474
00146601,BARRY UNIVERSITY SCHOOL OF LAW          ,FL,32807-0000,Private      ,4,187,191,57,1449,1506
00146700,BETHUNE COOKMAN UNIVERSITY              ,FL,32114-3099,Private      ,647,257,904,7082,1493,8575
00146800,ST THOMAS UNIVERSITY                    ,FL,33054-0000,Private      ,132,637,769,1227,2582,3809
00146900,FLORIDA INSTITUTE OF TECHNOLOGY         ,FL,32901-6988,Private      ,239,1710,1949,3188,5638,8826
00147000,BREVARD COMMUNITY COLLEGE               ,FL,32922-6503,Public       ,1603,2654,4257,4783,7449,12232
00147100,CENTRAL FLORIDA COMMUNITY COLLEGE       ,FL,34478-1388,Public       ,875,1917,2792,3894,6252,10146
00147200,CHIPOLA  COLLEGE                        ,FL,32446-2053,Public       ,226,371,597,889,1093,1982
00147300,CLEARWATER CHRISTIAN COLLEGE            ,FL,33759-0000,Private      ,72,18,90,773,104,877
00147500,DAYTONA STATE COLLEGE                   ,FL,32114-2800,Public       ,2072,3623,5695,6289,10702,16991
00147700,EDISON COLLEGE                          ,FL,33906-6210,Public       ,1329,2216,3545,6042,8180,14222
00147800,EDWARD WATERS COLLEGE                   ,FL,32209-6199,Private      ,237,180,417,1231,642,1873
00147900,EMBRY-RIDDLE AERONAUTICAL UNIV          ,FL,32114-3900,Private      ,583,1393,1976,6567,4684,11251
00148000,FLORIDA A & M UNIVERSITY                ,FL,32307-3100,Public       ,1532,1295,2827,15600,7413,23013
00148100,FLORIDA ATLANTIC UNIVERSITY             ,FL,33431-6498,Public       ,1482,2492,3974,15255,11942,27197
00148101,FLORIDA ATLANTIC UNIVERSITY/DAVIE       ,FL,33314-0000,Public       ,98,440,538,891,2241,3132
00148103,FLORIDA ATLANTIC UNIV-JUPITER/PSL       ,FL,33458-0000,Public       ,44,103,147,424,517,941
00148200,FLORIDA COLLEGE                         ,FL,33617-5578,Private      ,94,16,110,410,46,456
00148400,FLORIDA STATE COLLEGE AT JACKSONVILLE   ,FL,32202-4030,Public       ,2826,6467,9293,9845,19680,29525
00148500,FLORIDA KEYS COMMUNITY COLLEGE          ,FL,33040-4397,Public       ,138,310,448,385,750,1135
00148600,FLORIDA MEMORIAL UNIVERSITY             ,FL,33054-6199,Private      ,404,383,787,2529,1316,3845
00148700,ECKERD COLLEGE                          ,FL,33711-4744,Private      ,137,282,419,2611,860,3471
00148800,FLORIDA SOUTHERN COLLEGE                ,FL,33801-5698,Private      ,183,200,383,2613,768,3381
00148900,FLORIDA STATE UNIVERSITY                ,FL,32306-2430,Public       ,2934,2552,5486,30248,15374,45622
00149000,GULF COAST COMMUNITY COLLEGE            ,FL,32401-1058,Public       ,557,1229,1786,1910,3592,5502
00149300,INDIAN RIVER STATE COLLEGE              ,FL,34981-5596,Public       ,1491,2676,4167,4911,7608,12519
00149500,JACKSONVILLE UNIVERSITY                 ,FL,32211-3394,Private      ,354,826,1180,4020,2892,6912
00149700,JONES COLLEGE                           ,FL,32211-5588,Private      ,34,305,339,95,898,993
00149900,EVEREST UNIVERSITY                      ,FL,32810-5601,Proprietary  ,192,876,1068,477,2623,3100
00149901,EVEREST UNIVERSITY - ORLANDO SOUTH      ,FL,32819-7666,Proprietary  ,401,2944,3345,966,7320,8286
00149902,EVEREST UNIVERSITY - MELBOURNE          ,FL,32905-6609,Proprietary  ,106,747,853,253,2003,2256
00150000,BROWARD COLLEGE- DOWNTOWN CTR           ,FL,33301-2208,Public       ,1547,2750,4297,5035,8820,13855
00150001,BROWARD COLLEGE - DAVIE CAMPUS          ,FL,33314-0000,Public       ,1365,1585,2950,5756,5483,11239
00150002,BROWARD COLLEGE- NORTH CAMPUS           ,FL,33066-0000,Public       ,821,1197,2018,3490,3974,7464
00150003,BROWARD COLLEGE- SOUTH CAMPUS           ,FL,33024-0000,Public       ,981,1288,2269,3834,4148,7982
00150100,LAKE CITY COMMUNITY COLLEGE             ,FL,32025-2007,Public       ,265,813,1078,941,2238,3179
00150200,LAKE SUMTER COMMUNITY COLLEGE           ,FL,34788-8751,Public       ,406,693,1099,1773,2448,4221
00150400,MANATEE COMMUNITY COLLEGE               ,FL,34207-3596,Public       ,1189,2184,3373,4697,7257,11954
00150500,LYNN UNIVERSITY                         ,FL,33431-5598,Private      ,199,199,398,1505,633,2138
00150600,MIAMI DADE COLLEGE ADMINISTRATION ONLY  ,FL,33176-3393,Public       ,196,249,445,726,730,1456
00150601,MIAMI DADE COLLEGE - NORTH CAMPUS       ,FL,33167-3495,Public       ,2312,3490,5802,9460,11653,21113
00150602,MIAMI DADE COLLEGE - KENDALL CAMPUS     ,FL,33176-3393,Public       ,3296,3275,6571,13450,10770,24220
00150603,MIAMI DADE COLLEGE - WOLFSON CAMPUS     ,FL,33132-2297,Public       ,1462,1950,3412,5856,6393,12249
00150604,MIAMI DADE COLLEGE - MEDICAL CAMPUS     ,FL,33127-4693,Public       ,281,1081,1362,1381,3956,5337
00150605,MIAMI DADE COLLEGE - HOMESTEAD CAMPUS   ,FL,33030-6009,Public       ,459,678,1137,1538,1988,3526
00150606,MIAMI DADE COLLEGE -INTERAMERICAN CAMPUS,FL,33135-0000,Public       ,682,1241,1923,2591,4649,7240
00150607,MIAMI DADE COLLEGE - HIALEAH CAMPUS     ,FL,33012-2918,Public       ,477,662,1139,1894,2381,4275
00150800,NORTH FLORIDA COMMUNITY COLLEGE         ,FL,32340-1699,Public       ,170,325,495,449,796,1245
00150900,NOVA SOUTHEASTERN UNIVERSITY            ,FL,33314-7796,Private      ,457,5287,5744,4822,29540,34362
00151000,NORTHWEST FLORIDA STATE COLLEGE         ,FL,32578-1295,Public       ,445,1218,1663,1786,3770,5556
00151200,PALM BEACH COMMUNITY COLLEGE            ,FL,33461-4796,Public       ,3191,4158,7349,10301,11652,21953
00151300,PENSACOLA JR COLLEGE                    ,FL,32504-8998,Public       ,1087,2161,3248,3824,6806,10630
00151400,POLK STATE COLLEGE                      ,FL,33881-4299,Public       ,796,1497,2293,3390,5176,8566
00151500,ROLLINS COLLEGE                         ,FL,32789-4499,Private      ,103,361,464,2277,1244,3521
00151900,SANTA FE COLLEGE                        ,FL,32606-6200,Public       ,1358,1822,3180,7412,6613,14025
00152000,SEMINOLE COMMUNITY COLLEGE              ,FL,32773-6199,Public       ,2096,3689,5785,6267,9988,16255
00152100,SOUTHEASTERN UNIVERSITY                 ,FL,33801-6099,Private      ,296,347,643,2634,1180,3814
00152200,SOUTH FLORIDA COMMUNITY COLLEGE         ,FL,33825-9399,Public       ,333,621,954,1213,1795,3008
00152300,ST JOHNS RIVER COMMUNITY COLLEGE        ,FL,32177-3897,Public       ,632,1077,1709,1949,3207,5156
00152600,SAINT LEO UNIVERSITY                    ,FL,33574-6665,Private      ,476,3140,3616,3001,11061,14062
00152800,ST. PETERSBURG COLLEGE                  ,FL,33760-3768,Public       ,2173,4933,7106,7050,15596,22646
00153100,STETSON UNIVERSITY                      ,FL,32723-3761,Private      ,119,174,293,2905,833,3738
00153101,STETSON UNIVERSITY - COLLEGE OF LAW     ,FL,33707-3299,Private      ,5,142,147,36,2006,2042
00153300,TALLAHASSEE COMMUNITY COLLEGE           ,FL,32304-2895,Public       ,1865,2289,4154,7977,7521,15498
00153400,EVEREST UNIVERSITY                      ,FL,33614-5801,Proprietary  ,240,1424,1664,580,4988,5568
00153408,EVEREST UNIVERSITY - TAMPA BRANDON CAMPU,FL,33619-1354,Proprietary  ,423,5054,5477,1051,13542,14593
00153409,EVEREST UNIVERSITY - ORANGE PARK        ,FL,32073-1111,Proprietary  ,147,493,640,293,1501,1794
00153500,UNIVERSITY OF FLORIDA                   ,FL,32611-3150,Public       ,2066,2452,4518,30249,17376,47625
00153600,UNIVERSITY OF MIAMI                     ,FL,33146-6531,Private      ,654,761,1415,14638,5394,20032
00153601,UNIV OF MIAMI SCHOOL OF LAW             ,FL,33124-0000,Private      ,7,138,145,70,2023,2093
00153602,UNIV OF MIAMI-SCH OF MEDICINE           ,FL,33136-0000,Private      ,54,104,158,587,1257,1844
00153700,UNIVERSITY OF SOUTH FLORIDA             ,FL,33620-6960,Public       ,2923,4509,7432,28232,21435,49667
00153701,UNIV OF SOUTH FLORIDA-ST PETERSBURG     ,FL,33701-0000,Public       ,77,216,293,720,808,1528
00153702,UNIV OF SOUTH FLORIDA-SARASOTA          ,FL,34243-0000,Public       ,44,157,201,260,701,961
00153705,UNIV OF SOUTH FLORIDA                   ,FL,33803-0000,Public       ,72,155,227,622,599,1221
00153706,UNIV OF SOUTH FLORIDA- MEDICINE         ,FL,33612-0000,Public       ,61,100,161,795,1136,1931
00153800,UNIVERSITY OF TAMPA                     ,FL,33606-1490,Private      ,431,453,884,7555,2100,9655
00154000,WEBBER INTERNATIONAL UNIVERSITY         ,FL,33827-0096,Private      ,91,57,148,798,231,1029
00173308,NATIONAL-LOUIS UNIVERSITY               ,FL,33609-0000,Private      ,0,22,22,2,52,54
00177201,TRINITY INTERNATIONAL UNIVERSITY - SOUTH,FL,33324-4611,Private      ,14,150,164,42,386,428
00395400,UNIV OF CENTRAL FLORIDA                 ,FL,32816-0001,Public       ,3685,4085,7770,40822,20091,60913
00395500,UNIVERSITY OF WEST FLORIDA              ,FL,32514-5750,Public       ,673,1246,1919,5626,5220,10846
00407215,NORTHWOOD UNIVERSITY                    ,FL,33409-0000,Private      ,65,86,151,539,255,794
00558500,LIVELY TECHNICAL CENTER                 ,FL,32304-0000,Public       ,157,543,700,382,1386,1768
00558501,LIVELY TECHNICAL CENTER - AVIATION SCHOO,FL,32304-8723,Public       ,6,11,17,23,51,74
00558600,LINDSEY HOPKINS TECHNICAL ED CENTER     ,FL,33127-4692,Public       ,96,443,539,240,903,1143
00559400,D G ERWIN TECHNICAL CENTER              ,FL,33610-8255,Public       ,150,569,719,490,1881,2371
00560500,PINELLAS TECH ED CTR-CLEARWATER         ,FL,33760-2194,Public       ,106,397,503,276,981,1257
00560700,SARASOTA COUNTY TECHNICAL INSTITUTE     ,FL,34233-0000,Public       ,64,261,325,209,731,940
00560800,TRAVISS TECHNICAL CENTER                ,FL,33803-0000,Public       ,99,319,418,266,911,1177
00561200,MANATEE TECHNICAL INSTITUTE             ,FL,34210-0000,Public       ,142,396,538,287,976,1263
00561201,MANATEE TECHNICAL INSTITUTE-EAST        ,FL,34211-0000,Public       ,71,244,315,181,717,898
00675000,VALENCIA COMMUNITY COLLEGE              ,FL,32802-3028,Public       ,5102,5837,10939,20749,19084,39833
00752500,SUWANNEE-HAMILTON AREA VOC TECH CTR     ,FL,32060-0000,Public       ,15,73,88,49,199,248
00752600,WASHINGTON HOLMES TECHNICAL CENTER      ,FL,32428-1699,Public       ,51,198,249,112,449,561
00755800,LEE COUNTY HIGH TECH CENTER CENTRAL     ,FL,33916-2299,Public       ,106,377,483,286,935,1221
00758600,REMINGTON COLLEGE - TAMPA CAMPUS        ,FL,33612-8410,Proprietary  ,48,166,214,153,481,634
00758604,REMINGTON COLLEGE-LARGO CAMPUS          ,FL,33771-0000,Proprietary  ,2,22,24,4,58,62
00787000,HILLSBOROUGH COMMUNITY COLLEGE          ,FL,33606-3572,Public       ,2699,4544,7243,11709,15699,27408
00789300,FLAGLER COLLEGE                         ,FL,32085-1027,Private      ,211,103,314,3044,458,3502
00789301,FLAGLER COLLEGE - TALLAHASSEE COMMUNITY ,FL,32304-2895,Private      ,34,100,134,165,414,579
00807500,ST JOHN VIANNEY COLLEGE SEMINARY        ,FL,33165-3244,Private      ,3,5,8,21,15,36
00814600,EVEREST UNIVERSITY - POMPANO BEACH      ,FL,33062-2522,Proprietary  ,158,1007,1165,418,2686,3104
00822300,ST VINCENT DE PAUL REGIONL SEMINARY     ,FL,33436-0000,Private      ,0,2,2,0,7,7
00841700,STENOTYPE INST OF JACKSONVILLE          ,FL,32207-0000,Proprietary  ,30,215,245,39,315,354
00850100,RASMUSSEN COLLEGE                       ,FL,34471-7051,Proprietary  ,160,1117,1277,473,3126,3599
00850103,RASMUSSEN COLLEGE-HOLIDAY               ,FL,34690-0000,Proprietary  ,72,298,370,205,1020,1225
00850106,RASMUSSEN COLLEGE - FORT MYERS          ,FL,33905-7805,Proprietary  ,64,239,303,175,636,811
00884800,WARNER SOUTHERN COLLEGE                 ,FL,33859-8725,Private      ,72,226,298,557,661,1218
00884900,PALM BEACH ATLANTIC UNIVERSITY          ,FL,33401-6505,Private      ,293,581,874,2340,1993,4333
00887800,MIAMI INTERNATIONAL UNIV ART&DESIGN     ,FL,33132-1418,Proprietary  ,475,579,1054,3030,2466,5496
00910400,RIVERSIDE HAIRSTYLING ACADEMY           ,FL,32207-3810,Proprietary  ,6,28,34,18,73,91
00963500,FLORIDA INTERNATIONAL UNIVERSITY        ,FL,33199-0001,Public       ,2375,4304,6679,23429,22855,46284
00984100,UNIVERSITY OF NORTH FLORIDA             ,FL,32224-2645,Public       ,1175,1505,2680,10101,6934,17035
00990200,SHERIDAN TECHNICAL CENTER               ,FL,33021-3399,Public       ,202,686,888,527,1768,2295
01016100,"LORAINE'S ACADEMY, INC                  ",FL,33710-0000,Proprietary  ,19,95,114,27,131,158
01019500,ART INSTITUTE OF FT LAUDERDALE          ,FL,33316-3000,Proprietary  ,349,439,788,2133,2107,4240
01065200,PASCO-HERNANDO COMMUNITY CLG            ,FL,34654-5199,Public       ,1083,2117,3200,3556,6207,9763
01072401,CARLOS ALBIZU UNIVERSITY                ,FL,33172-0000,Private      ,31,354,385,107,1074,1181
01082600,TOM P. HANEY TECHNICAL CENTER           ,FL,32405-5099,Public       ,62,295,357,144,689,833
01112700,GOODING INST OF NUR ANES BAY MED CT     ,FL,32401-0000,Public       ,1,12,13,2,76,78
01226300,ATLANTIC TECHNICAL CENTER               ,FL,33063-3902,Public       ,170,562,732,440,1345,1785
01254400,FIRST COAST TECHNICAL COLLEGE           ,FL,32084-1921,Public       ,117,331,448,248,788,1036
01254401,FIRST COAST TECHNICAL INSTITUTE - PUTNAM,FL,32077-6830,Public       ,0,0,0,0,7,7
01257400,RINGLING SCHOOL OF ART AND DESIGN       ,FL,34234-5895,Private      ,122,47,169,1703,326,2029
01303904,SOUTH UNIVERSITY - WEST PALM BEACH CAMPU,FL,33409-5149,Proprietary  ,76,349,425,304,1506,1810
01323400,LORENZO WALKER INST OF TECHNOLOGY       ,FL,34104-4405,Public       ,96,281,377,235,690,925
02052002,FLORIDA EDUCATION CENTER - LAUDERHILL   ,FL,33313-5857,Proprietary  ,1,9,10,3,13,16
02089600,CONCORDE CAREER INSTITUTE               ,FL,32211-0000,Proprietary  ,70,352,422,165,952,1117
02089709,HERZING COLLEGE                         ,FL,32792-5509,Proprietary  ,11,64,75,37,172,209
02113609,AMERICAN INTERCONTINENTAL UNIV - WESTON ,FL,33326-3233,Proprietary  ,76,241,317,453,1020,1473
02115300,PINELLAS TECHNICAL EDUCATION CENTERS - S,FL,33711-0000,Public       ,114,414,528,250,1129,1379
02116006,SANFORD-BROWN INSTITUTE - FT. LAUDERDALE,FL,33309-1906,Proprietary  ,67,298,365,170,808,978
02121800,EVEREST INSTITUTE                       ,FL,33169-4759,Proprietary  ,132,498,630,345,1132,1477
02121801,EVEREST INSTITUTE  - HIALEAH            ,FL,33012-7193,Proprietary  ,197,339,536,409,782,1191
02148200,FASHION FOCUS HAIR ACADEMY              ,FL,34231-0000,Proprietary  ,8,25,33,19,52,71
02148300,MANHATTAN BEAUTY SCHOOL                 ,FL,33611-0000,Proprietary  ,62,287,349,96,458,554
02149900,PAUL MITCHELL THE SCHOOL-JACKSONVILLE   ,FL,32205-0000,Proprietary  ,67,121,188,123,224,347
02151900,KEISER  UNIVERSITY                      ,FL,33309-0000,Proprietary  ,1366,4660,6026,3818,14194,18012
02156300,MARGATE SCHOOL OF BEAUTY                ,FL,33063-0000,Proprietary  ,36,166,202,59,302,361
02156700,FLORIDA CHRISTIAN COLLEGE               ,FL,34744-0000,Private      ,37,41,78,210,157,367
02159600,BAPTIST COLLEGE OF FLORIDA (THE)        ,FL,32440-0000,Private      ,85,92,177,299,256,555
02172700,CONCORDE CAREER INSTITUTE               ,FL,33607-0000,Proprietary  ,50,220,270,132,607,739
02188900,HOBE SOUND BIBLE COLLEGE                ,FL,33475-0000,Private      ,43,28,71,83,56,139
02200100,BRADENTON BEAUTY & BARBER ACADEMY       ,FL,34209-0000,Proprietary  ,29,97,126,46,166,212
02215900,ATI CAREER TRAINING CENTER              ,FL,33309-1785,Proprietary  ,138,463,601,190,714,904
02218700,FLORIDA TECHNICAL COLLEGE               ,FL,32826-2707,Proprietary  ,97,512,609,284,1229,1513
02218707,FLORIDA TECHNICAL COLLEGE - LAKELAND    ,FL,33813-2101,Proprietary  ,27,159,186,60,428,488
02218709,FLORIDA TECHNICAL COLLEGE - DELAND      ,FL,32720-7415,Proprietary  ,2,51,53,26,130,156
02228300,LAKE TECHNICAL CENTER                   ,FL,32726-0000,Public       ,58,248,306,200,756,956
02245500,CENTRAL FLORIDA COLLEGE                 ,FL,32789-4679,Proprietary  ,61,242,303,198,577,775
02257900,INTERNATIONAL ACADEMY                   ,FL,32119-3541,Proprietary  ,34,128,162,57,177,234
02275100,CONCORDE CAREER INSTITUTE               ,FL,33025-0000,Proprietary  ,55,169,224,116,470,586
02278800,SOUTHWEST FLORIDA COLLEGE               ,FL,33907-0000,Proprietary  ,191,679,870,421,1689,2110
02278801,SOUTHWEST FLORIDA COLLEGE - TAMPA       ,FL,33619-1344,Proprietary  ,86,223,309,248,574,822
02278802,SOUTHWEST FLORIDA COLLEGE - INSTITUTUE O,FL,33928-9469,Proprietary  ,2,7,9,8,12,20
02278803,SOUTHWEST FLORIDA COLLEGE - PORT CHARLOT,FL,33953-3100,Proprietary  ,24,159,183,43,308,351
02279600,CORTIVA INSTITUTE - FLORIDA             ,FL,33781-0000,Proprietary  ,13,63,76,36,180,216
02280800,NEW ENGLAND INST TECH-PALM BEACH        ,FL,33407-0000,Proprietary  ,306,850,1156,679,1965,2644
02283800,BEAUTY SCHOOLS OF AMERICA               ,FL,33012-3322,Proprietary  ,238,1130,1368,385,1823,2208
02286500,ITT TECHNICAL INSTITUTE                 ,FL,33634-7515,Proprietary  ,434,1104,1538,976,2513,3489
02287100,LA BELLE BEAUTY SCHOOL                  ,FL,33012-0000,Proprietary  ,13,108,121,18,137,155
02293200,ATI CAREER TRAINING CENTER              ,FL,33309-5916,Proprietary  ,431,1186,1617,519,1812,2331
02293201,ATI CAREER TRAINING CENTER - MIAMI      ,FL,33122-1707,Proprietary  ,16,42,58,50,105,155
02293202,ATI CAREER TAINING CENTER - ATI COLLEGE ,FL,87109-2016,Proprietary  ,240,874,1114,363,1679,2042
02293600,ADVANCED TECHNICAL CENTERS              ,FL,33266-1597,Private      ,3,8,11,10,21,31
02297000,CHARLOTTE TECHNICAL CENTER              ,FL,33948-0000,Public       ,50,217,267,167,599,766
02300900,WITHLACOOCHEE TECHNICAL INSTITUTE       ,FL,34450-0000,Public       ,64,223,287,174,640,814
02305700,GULF COAST COLLEGE                      ,FL,33619-0000,Proprietary  ,20,147,167,95,342,437
02305800,FLORIDA CAREER COLLEGE                  ,FL,33012-7028,Proprietary  ,738,1838,2576,1718,4503,6221
02307400,GEORGE STONE AREA VOCATIONAL TECHNICAL  ,FL,32526-0000,Public       ,79,345,424,179,785,964
02314100,SCHILLER INTERNATIONAL UNIVERSITY       ,FL,33770-3716,Proprietary  ,11,35,46,79,124,203
02316200,MIAMI LAKES TECHNICAL EDUCATION CTR     ,FL,33014-0000,Public       ,151,337,488,331,809,1140
02321200,ORANGE TECH EDUC CTR- WESTSIDE TECH     ,FL,34787-0000,Public       ,111,288,399,245,629,874
02325100,KEY COLLEGE                             ,FL,33004-3046,Proprietary  ,1,30,31,15,82,97
02326303,MEDVANCE INSTITUTE - WEST PALM          ,FL,33461-2171,Proprietary  ,124,390,514,231,767,998
02326306,MEDVANCE INSTITUTE - MIAMI              ,FL,33173-3431,Proprietary  ,58,183,241,115,417,532
02326800,RESORT & SPA SCHOOLS INTERNATIONAL      ,FL,34233-0000,Proprietary  ,19,151,170,20,191,211
02326900,SUNSTATE ACADEMY OF HAIR DESIGN         ,FL,33907-1415,Proprietary  ,56,109,165,106,208,314
02329900,FLORIDA INSTITUTE OF ULTRASOUND         ,FL,32514-0000,Proprietary  ,6,54,60,42,189,231
02338400,FT PIERCE BEAUTY ACADEMY                ,FL,34982-0000,Proprietary  ,42,166,208,57,210,267
02341001,FORTIS COLLEGE - DBA FORTIS INSTITUTE   ,FL,32504-7322,Proprietary  ,7,39,46,25,104,129
02346200,WYOTECH                                 ,FL,32174-1010,Proprietary  ,152,341,493,512,832,1344
02362100,FULL SAIL UNIVERSITY                    ,FL,32792-0000,Proprietary  ,1617,2713,4330,7750,8318,16068
02499000,ACADEMY OF COSMETOLOGY                  ,FL,32953-3311,Proprietary  ,10,56,66,33,145,178
02501500,"O*TEC, MID-FLORIDA TECH                 ",FL,32809-0000,Public       ,142,382,524,324,767,1091
02504600,WINTER PARK TECH                        ,FL,32789-0000,Public       ,45,330,375,121,696,817
02508900,TALMUDIC COLLEGE OF FLORIDA             ,FL,33139-0000,Private      ,18,6,24,23,11,34
02511700,RIDGE TECHNICAL CENTER                  ,FL,33881-0000,Public       ,87,293,380,196,696,892
02513200,ORLANDO TECHNICAL CENTER                ,FL,32801-0000,Public       ,119,416,535,312,1108,1420
02515400,CITY COLLEGE                            ,FL,33309-3073,Private      ,130,442,572,387,1520,1907
02517100,SARASOTA SCHOOL OF MASSAGE THERAPY      ,FL,34243-6130,Proprietary  ,7,44,51,15,120,135
02524000,SUNSTATE ACADEMY OF HAIR DESIGN         ,FL,34624-0000,Proprietary  ,42,103,145,64,146,210
02524200,ROBERT MORGAN EDUCATIONAL CENTER        ,FL,33177-0000,Public       ,167,461,628,362,886,1248
02547600,FLORIDA NATIONAL COLLEGE                ,FL,33012-0000,Proprietary  ,319,951,1270,784,2448,3232
02554200,RADFORD LOCKLIN TECH CENTER             ,FL,32570-0000,Public       ,17,65,82,35,163,198
02573200,LA BELLE BEAUTY ACADEMY                 ,FL,33135-0000,Proprietary  ,23,117,140,45,221,266
02586200,FLORIDA CAREER COLLEGE                  ,FL,33759-3924,Proprietary  ,32,141,173,123,477,600
02586201,FLORIDA CAREER COLLEGE -                ,FL,33569-2553,Proprietary  ,2,9,11,3,26,29
02597100,HERITAGE INSTITUTE                      ,FL,33912-7132,Proprietary  ,112,464,576,269,1088,1357
02598200,FLORIDA TECHNICAL CLG JACKSONVILLE      ,FL,32211-5123,Proprietary  ,29,159,188,79,374,453
02599800,EVEREST UNIVERSITY                      ,FL,33770-2556,Proprietary  ,82,503,585,246,1391,1637
02599801,EVEREST UNIVERSITY - TAMPA LAKELAND CAMP,FL,33801-3801,Proprietary  ,89,464,553,215,1337,1552
02599805,EVEREST UNIVERSITY - JACKSONVILLE       ,FL,32256-0000,Proprietary  ,127,582,709,288,1612,1900
02601600,HENRY W BREWSTER TECHNICAL CENTER       ,FL,33602-0000,Public       ,56,240,296,107,566,673
02612700,DARLYNE MCGEE'S ACAD OF COSMETOLOGY     ,FL,32905-2805,Proprietary  ,10,52,62,20,103,123
02616400,SANFORD-BROWN INSTITUTE                 ,FL,32256-3520,Proprietary  ,157,727,884,464,2446,2910
02616401,SANFORD-BROWN INSTITUTE - TAMPA         ,FL,33610-8304,Proprietary  ,106,521,627,202,1243,1445
03003200,EVEREST INSTITUTE                       ,FL,33186-1410,Proprietary  ,155,298,453,373,813,1186
03003201,EVEREST INSTITUTE - FT. LAUDERDALE      ,FL,33304-2522,Proprietary  ,78,217,295,132,430,562
03003600,MCFATTER TECHNICAL CENTER               ,FL,33317-7499,Public       ,117,397,514,339,964,1303
03006801,PENNSYLVANIA CULINARY INSTITUTE - LE COR,FL,33025-3929,Proprietary  ,111,387,498,374,994,1368
03008600,FLORIDA COLLEGE OF NATURAL HEALTH       ,FL,33064-1342,Proprietary  ,113,374,487,259,972,1231
03010608,VIRGINIA COLLEGE - PENSACOLA            ,FL,32501-5650,Proprietary  ,22,182,204,75,636,711
03010612,VIRGINIA COLLEGE - GOLF ACADEMY OF AMERI,FL,32701-0000,Proprietary  ,25,56,81,129,216,345
03012300,ASM BEAUTY WORLD ACADEMY                ,FL,33021-0000,Proprietary  ,10,36,46,16,78,94
03018500,BENE'S INTERNATIONAL SCHOOL OF BEAUTY   ,FL,34652-1637,Proprietary  ,41,103,144,73,203,276
03028200,TRINITY COLLEGE OF FLORIDA              ,FL,34655-4401,Private      ,42,39,81,144,133,277
03031400,INTERNATIONAL ACAD OF DESIGN & TECH     ,FL,33634-6313,Proprietary  ,462,1315,1777,1927,4055,5982
03031402,INTERNATIONAL ACADEMY OF DESIGN AND TECH,FL,32809-4613,Proprietary  ,117,164,281,715,732,1447
03031403,IADT - ORLANDO CULINARY ACADEMY         ,FL,32819-0000,Proprietary  ,72,142,214,383,437,820
03035800,HERITAGE INSTITUTE                      ,FL,32216-0948,Proprietary  ,23,225,248,54,410,464
03035900,NATIONAL AVIATION ACADEMY               ,FL,33760-3931,Proprietary  ,42,102,144,187,438,625
03037500,HODGES UNIVERSITY                       ,FL,34119-7932,Private      ,224,1232,1456,473,3008,3481
03054200,TECHNICAL CAREER INSTITUTE              ,FL,33144-2373,Proprietary  ,144,182,326,443,447,890
03071600,COLLEGE OF BUSINESS & TECHNOLOGY        ,FL,33176-1412,Proprietary  ,71,468,539,149,1016,1165
03071601,COLLEGE OF BUSINESS & TECHNOLOGY -      ,FL,33144-2072,Proprietary  ,4,20,24,17,40,57
03071602,COLLEGE OF BUSINESS & TECHNOLOGY -      ,FL,33012-3436,Proprietary  ,1,2,3,6,3,9
03076402,HIGH-TECH INSTITUTE - ORLANDO           ,FL,32803-3509,Proprietary  ,11,64,75,57,199,256
03079800,GEORGE T BAKER AVIATION                 ,FL,33142-5687,Public       ,102,111,213,219,255,474
03079900,CITY COLLEGE                            ,FL,32707-5342,Private      ,23,101,124,44,338,382
03087600,ITT TECHNICAL INSTITUTE                 ,FL,32746-1607,Proprietary  ,472,1331,1803,960,2632,3592
03089200,NOUVELLE INSTITUTE                      ,FL,33125-4141,Proprietary  ,22,224,246,29,377,406
03096300,FLORIDA CAREER INSTITUTE                ,FL,33860-0000,Proprietary  ,14,98,112,31,216,247
03099600,MERCY HOSPITAL SCHOOL OF PRACTICAL NSG  ,FL,33133-4237,Private      ,17,49,66,59,175,234
03100800,TAYLOR TECHNICAL INSTITUTE              ,FL,32348-0894,Public       ,39,99,138,70,208,278
03101900,TRINITY BAPTIST COLLEGE                 ,FL,32221-1398,Private      ,53,39,92,195,119,314
03103900,MARION COUNTY COMMUNITY TECH & ADUL     ,FL,34474-3172,Public       ,50,207,257,202,760,962
03108500,EVERGLADES UNIVERSITY                   ,FL,33431-0000,Private      ,48,461,509,134,1302,1436
03108600,COM-PU-MED VOCATIONAL CAREERS           ,FL,33012-4861,Proprietary  ,42,319,361,46,365,411
03113400,ACADEMY OF HEALING ARTS                 ,FL,33463-2113,Proprietary  ,10,63,73,16,95,111
03114700,PRAXIS INSTITUTE                        ,FL,33135-2657,Proprietary  ,35,281,316,53,422,475
03115500,FLORIDA HOSPITAL COLG OF HEALTH SCI     ,FL,32803-1237,Private      ,189,662,851,860,2233,3093
03123900,KEISER CAREER INSTITUTE                 ,FL,33413-0000,Proprietary  ,169,490,659,453,1473,1926
03125600,MIAMI AD SCHOOL                         ,FL,33139-5203,Proprietary  ,27,91,118,59,296,355
03127900,TECHNICAL EDUCATION CTR OSCEOLA         ,FL,34744-4459,Public       ,111,314,425,252,739,991
03139600,DELTA CONNECTION ACADEMY                ,FL,32773-9683,Proprietary  ,5,29,34,49,94,143
03158300,LEE COUNTY HIGH TECH CENTER NORTH       ,FL,33993-2479,Public       ,41,158,199,107,476,583
03171300,UNIVERSITY OF ST. AUGUSTINE FOR HEALTH S,FL,32084-4215,Proprietary  ,4,175,179,23,781,804
03178400,CORAL RIDGE NURSES ASST TRAINING        ,FL,33306-0000,Proprietary  ,0,21,21,1,41,42
03224300,NEW PROFESSIONS TECHNICAL INSTITUTE     ,FL,33134-1640,Proprietary  ,27,231,258,49,430,479
03230300,OKALOOSA APPLIED TECHNOLOGY CENTER      ,FL,32547-1299,Public       ,36,164,200,90,455,545
03238300,FLORIDA COLLEGE OF INTEGRATIVE MED      ,FL,32809-5721,Proprietary  ,1,34,35,26,167,193
03255300,FLORIDA GULF COAST UNIVERSITY           ,FL,33965-6565,Public       ,696,735,1431,8245,3585,11830
03256300,YESHIVA GEDOLAH RABBINICAL COLLEGE      ,FL,33139-4708,Private      ,1,1,2,4,3,7
03264300,SOUTH FLORIDA BIBLE COLLEGE AND THEOLOGI,FL,33441-5768,Private      ,4,26,30,15,49,64
03346300,ACAD FOR PRAC NURSING & HEALTH OCCP     ,FL,33417-4574,Private      ,37,221,258,99,551,650
03348400,PROFESSIONAL TRAINING CENTERS           ,FL,33184-0000,Proprietary  ,45,167,212,106,549,655
03370300,AUDIO RECORDING TECHNOLOGY INSTITUTE    ,FL,32811-0000,Proprietary  ,21,32,53,70,112,182
03373300,BEACON COLLEGE                          ,FL,34748-5224,Private      ,10,8,18,85,36,121
03374300,FLORIDA COASTAL SCHOOL OF LAW           ,FL,32256-0000,Proprietary  ,2,275,277,14,3089,3103
03382300,BRADFORD-UNION AREA CAREERTECHNICAL CENT,FL,32091-2434,Public       ,16,62,78,39,190,229
03390300,LINCOLN TECHNICAL INSTITUTE             ,FL,32730-2351,Proprietary  ,45,198,243,125,615,740
03411400,INTERNATIONAL TRAINING CAREERS          ,FL,33155-1462,Private      ,20,185,205,29,222,251
03414500,SOUTHEAST INSTITUTE OF ORIENTAL MED     ,FL,33176-1509,Proprietary  ,7,56,63,16,140,156
03425400,CENTRAL FLORIDA INSTITUTE               ,FL,34684-4436,Proprietary  ,57,270,327,161,754,915
03429600,ATLANTIC INST OF ORIENTAL MEDICINE      ,FL,33316-0000,Private      ,0,36,36,1,109,110
03429700,EAST WEST COLLG OF NATURAL MEDICINE     ,FL,34236-4959,Proprietary  ,1,46,47,3,128,131
03433400,NEW CONCEPT MASSAGE AND BEAUTY SCHO     ,FL,33135-0000,Proprietary  ,3,17,20,6,50,56
03434300,FORTIS COLLEGE                          ,FL,32073-2999,Proprietary  ,76,249,325,168,643,811
03459400,SAINT PETERSBURG THEOLOGICAL SEMINA     ,FL,33708-3116,Private      ,1,20,21,4,45,49
03480301,MEDVANCE INSTITUTE - FORT LAUDERDALE    ,FL,33313-7261,Proprietary  ,57,290,347,114,582,696
03480302,MEDVANCE INSTITUTE - STUART             ,FL,34994-3000,Proprietary  ,21,87,108,35,224,259
03491400,AMERICAN ADVANCED TECHNICIANS INST      ,FL,33014-4430,Proprietary  ,5,28,33,15,52,67
03549300,ULTIMATE MEDICAL ACADEMY                ,FL,33756-5802,Proprietary  ,168,1016,1184,348,2105,2453
03553300,KEISER CAREER COLLEGE                   ,FL,32216-0000,Proprietary  ,41,199,240,114,391,505
03557300,NORTH FLORIDA COSMETOLOGY INSTITUTE     ,FL,32312-0000,Proprietary  ,12,90,102,47,204,251
03564300,SUPERIOR CAREER INSTITUTE               ,FL,33311-1141,Proprietary  ,6,73,79,14,120,134
03570400,ENGLISH CENTER (THE)                    ,FL,33133-2703,Public       ,3,62,65,7,113,120
03595400,ANGLEY COLLEGE                          ,FL,32720-4257,Proprietary  ,50,272,322,79,424,503
03611400,FLORIDA BARBER ACADEMY                  ,FL,33441-0000,Proprietary  ,20,90,110,26,114,140
03618300,FLORIDA INSTITUTE OF ANIMAL ARTS        ,FL,32792-1740,Proprietary  ,38,73,111,95,176,271
03627400,JACKSONVILLE BEAUTY INSTITUTE           ,FL,32208-1885,Proprietary  ,22,111,133,39,165,204
03627600,FLORIDA EDUCATION INSTITUTE             ,FL,33144-5036,Proprietary  ,37,201,238,43,246,289
03661400,SOUTH FLORIDA INSTITUTE OF TECHNOLO     ,FL,33135-0000,Proprietary  ,26,289,315,68,612,680
03691400,AVE MARIA SCHOOL OF LAW                 ,FL,34119-1376,Private      ,2,41,43,3,656,659
03696400,SABER                                   ,FL,33134-1604,Private      ,7,193,200,21,416,437
03706300,AMERICAN INSTITUTE                      ,FL,33319-5613,Proprietary  ,63,301,364,114,527,641
03757300,ADVANCE SCIENCE INSTITUTE               ,FL,33012-0000,Proprietary  ,15,113,128,16,113,129
03801400,BEAUTY INSTITUTE (THE)                  ,FL,33409-2972,Proprietary  ,17,83,100,28,104,132
03801401,BEAUTY INSTITUTE (THE) - MARGATE        ,FL,33068-5704,Proprietary  ,2,2,4,5,8,13
03816300,ARTISTIC NAILS & BEAUTY ACADEMY         ,FL,33605-5919,Proprietary  ,27,119,146,50,177,227
03823300,FLORIDA ACADEMY OF HEALTH & BEAUTY      ,FL,33311-0000,Proprietary  ,4,39,43,4,44,48
03832300,DADE MEDICAL COLLEGE                    ,FL,33126-5534,Proprietary  ,96,294,390,219,757,976
03842500,CAMBRIDGE INSTITUTE OF ALLIED HEALTH    ,FL,32750-0000,Proprietary  ,13,49,62,24,165,189
03856300,UNIVERSAL BEAUTY SCHOOL                 ,FL,33174-4406,Proprietary  ,11,65,76,13,75,88
03856500,FLORIDA SCHOOL OF TRADITIONAL MIDWIFERY ,FL,32601-5507,Private      ,2,17,19,2,17,19
03866300,GALIANO CAREER ACADEMY                  ,FL,32701-0000,Proprietary  ,44,239,283,53,352,405
03875300,MEDICAL CAREER INSTITUTE OF SOUTH FLORID,FL,33407-2103,Proprietary  ,27,157,184,49,318,367
03888300,DRAGON RISES COLLEGE OF ORIENTAL MEDICIN,FL,32601-5089,Proprietary  ,1,17,18,4,52,56
03903500,SOUTHERN TECHNICAL COLLEGE              ,FL,32809-0000,Proprietary  ,75,523,598,132,869,1001
03906300,CAREER INSTITUTE OF FLORIDA             ,FL,33773-3434,Proprietary  ,10,127,137,23,279,302
03911300,TOTAL INTERNATIONAL CAREER INSTITUTE    ,FL,33012-0000,Proprietary  ,2,92,94,4,93,97
03939300,WOLFORD COLLEGE                         ,FL,34108-1931,Private      ,0,86,86,9,294,303
03939400,CENTURA INSTITUTE                       ,FL,32807-3566,Proprietary  ,24,88,112,53,274,327
03939600,DAYTONA COLLEGE                         ,FL,32174-8445,Proprietary  ,17,47,64,47,100,147
03941300,AVE MARIA UNIVERSITY                    ,FL,34142-9505,Private      ,86,32,118,762,295,1057
03957400,NEW COLLEGE OF FLORIDA                  ,FL,34243-2109,Public       ,76,41,117,1446,155,1601
03985300,COMMERCIAL DIVING ACADEMY               ,FL,32208-0000,Proprietary  ,74,238,312,156,587,743
03986300,AVIATOR COLLEGE OF AERONAUTICAL SCIENCE ,FL,34946-9022,Proprietary  ,3,18,21,12,41,53
04016500,AMERICAN INSTITUTE OF BEAUTY            ,FL,33773-0000,Proprietary  ,15,68,83,29,144,173
04029300,TRENDSETTERS OF FLORIDA SCHOOL OF BEAUTY,FL,32205-0000,Proprietary  ,9,18,27,20,64,84
04058300,HEALTH OPPORTUNITY TECHNICAL CENTER     ,FL,33169-4517,Proprietary  ,5,94,99,13,209,222
04083400,INSTITUTE OF ALLIED MEDICAL PROFESSIONS ,FL,33484-6543,Proprietary  ,30,125,155,35,174,209
04105400,PENSACOLA SCHOOL OF MASSAGE THERAPY & HE,FL,32504-7337,Proprietary  ,14,66,80,32,154,186
04106300,PALM BEACH ACADEMY OF HEALTH & BEAUTY   ,FL,33403-2130,Proprietary  ,14,44,58,40,116,156
04116600,TAYLOR COLLEGE                          ,FL,34420-8714,Proprietary  ,15,74,89,37,228,265
04119400,AVEDA INSTITUTE - SAINT PETERSBURG      ,FL,33701-4242,Proprietary  ,136,181,317,369,503,872
04120400,HI-TECH SCHOOL OF COSMETOLOGY           ,FL,33174-0000,Proprietary  ,36,67,103,61,104,165
04120500,ACADEMY OF PROFESSIONAL CAREERS         ,FL,32792-4433,Proprietary  ,0,0,0,4,9,13
04126900,ACADEMY OF CAREER TRAINING              ,FL,34741-4644,Proprietary  ,33,82,115,72,178,250
04127400,DIGITAL MEDIA ARTS COLLEGE              ,FL,33431-5919,Proprietary  ,58,39,97,268,184,452
04128400,MANAGEMENT RESOURCES INSTITUTE          ,FL,33126-5473,Proprietary  ,5,160,165,8,278,286
04129300,INTERNATIONAL B NATURALE BEAUTY SCHOOL  ,FL,33311-1152,Proprietary  ,0,1,1,0,1,1
04129900,FLORIDA SCHOOL OF MASSAGE               ,FL,32608-5419,Proprietary  ,19,69,88,89,179,268
04130400,SHEAR EXCELLENCE INTERNATIONAL HAIR ACAD,FL,33614-2783,Private      ,15,58,73,22,76,98
04131900,FASTTRAIN OF MIAMI                      ,FL,33134-1065,Proprietary  ,17,91,108,35,210,245
04132000,FASTTRAIN OF FORT LAUDERDALE            ,FL,33311-1506,Proprietary  ,9,88,97,14,124,138
04132100,FASTTRAIN OF TAMPA                      ,FL,33607-4153,Proprietary  ,3,63,66,8,115,123
04132200,FASTTRAIN OF JACKSONVILLE               ,FL,32256-4849,Proprietary  ,7,83,90,14,128,142
04133500,ACADEMY FOR FIVE ELEMENT ACUPUNCTURE    ,FL,32601-6811,Private      ,2,20,22,5,90,95
04134800,AVEDA INSTITUTE - TALLAHASSEE           ,FL,32304-3186,Proprietary  ,23,34,57,83,102,185
04134900,ORANGE PARK BEAUTY ACADEMY              ,FL,32073-5524,Proprietary  ,11,35,46,19,76,95
04135000,COZMO THE SCHOOL                        ,FL,34135-4810,Proprietary  ,19,50,69,29,92,121
04135900,ALLIED HEALTH INSTITUTE                 ,FL,33309-1900,Proprietary  ,8,209,217,18,459,477
04140800,NORTH FLORIDA ACADEMY                   ,FL,32065-7758,Proprietary  ,9,19,28,31,49,80
04143100,PROFESSIONAL HANDS INSTITUTE            ,FL,33135-1939,Proprietary  ,6,65,71,10,107,117
04145900,CELEBRITY SCHOOL OF BEAUTY              ,FL,33144-4153,Proprietary  ,13,72,85,20,79,99
04147800,ROSE TRAINING INSTITUTE                 ,FL,33881-4094,Proprietary  ,2,67,69,2,67,69
04148500,MEDICAL INSTITUTE OF PALM BEACH         ,FL,33460-5042,Proprietary  ,19,104,123,19,107,126
04162500,HOLLYWOOD INSTITUTE OF BEAUTY CAREERS   ,FL,33020-4807,Proprietary  ,0,1,1,0,1,1
00160500,CHAMINADE UNIV OF HONOLULU              ,HI,96816-1578,Private      ,129,289,418,1454,1403,2857
00160600,BRIGHAM YOUNG UNIV-HAWAII CAMPUS        ,HI,96762-1294,Private      ,182,162,344,1091,667,1758
00161000,UNIVERSITY OF HAWAII AT MANOA           ,HI,96822-2399,Public       ,616,940,1556,10453,7814,18267
00161100,UNIVERSITY OF HAWAII AT HILO            ,HI,96720-4091,Public       ,183,274,457,3021,2207,5228
00161200,HONOLULU COMMUNITY COLLEGE              ,HI,96817-4598,Public       ,229,390,619,1426,1626,3052
00161300,KAPIOLANI COMMUNITY COLLEGE             ,HI,96816-4421,Public       ,319,598,917,2335,2465,4800
00161400,KAUAI COMMUNITY COLLEGE                 ,HI,96766-9591,Public       ,83,153,236,339,509,848
00161500,MAUI COMMUNITY COLLEGE                  ,HI,96732-1644,Public       ,209,573,782,1247,2183,3430
00454900,LEEWARD COMMUNITY COLLEGE               ,HI,96782-3393,Public       ,320,532,852,1850,2142,3992
00525800,HAWAII COMMUNITY COLLEGE                ,HI,96720-4075,Public       ,217,388,605,1320,1840,3160
00723401,HEALD COLLEGE - HONOLULU                ,HI,96814-0000,Proprietary  ,293,528,821,660,1095,1755
00727900,HAWAII PACIFIC UNIVERSITY               ,HI,96813-2882,Private      ,209,524,733,3839,3033,6872
01122000,WINDWARD COMMUNITY COLLEGE              ,HI,96744-0000,Public       ,131,236,367,675,928,1603
02100300,MED-ASSIST SCHOOL OF HAWAII             ,HI,96813-0000,Proprietary  ,24,58,82,44,124,168
02107800,UNIVERSITY OF HAWAII - WEST OAHU        ,HI,96782-0000,Public       ,53,147,200,622,959,1581
02139500,HAWAII INSTITUTE OF HAIR DESIGN         ,HI,96817-5195,Proprietary  ,15,46,61,36,114,150
03017800,TRAVEL INSTITUTE OF THE PACIFIC         ,HI,96814-1946,Proprietary  ,17,65,82,40,128,168
03020800,NEW YORK TECHNICAL INST OF HAWAII       ,HI,96817-4415,Proprietary  ,0,0,0,1,3,4
03072500,WORLD MEDICINE INSTITUTE                ,HI,96826-0000,Private      ,0,21,21,13,64,77
03649300,HAWAII TECHNOLOGY INSTITUTE             ,HI,96813-3036,Private      ,7,28,35,23,58,81
03735300,INST OF CLINICAL ACUPUNCTURE & ORIENT MD,HI,96813-2307,Proprietary  ,0,11,11,1,36,37
03999400,TRADITIONAL CHINESE MEDICAL COLLEGE OF H,HI,96743-8324,Private      ,1,7,8,2,49,51
00161600,BOISE STATE UNIVERSITY                  ,ID,83725-1000,Public       ,932,2056,2988,9786,10861,20647
00161700,"COLLEGE OF IDAHO, THE                   ",ID,83605-4432,Private      ,56,59,115,1234,290,1524
00161900,COLLEGE OF SOUTHERN IDAHO               ,ID,83301-0000,Public       ,590,1202,1792,2961,4196,7157
00161908,COLLEGE OF WESTERN IDAHO                ,ID,83687-1515,Public       ,427,1108,1535,788,1968,2756
00162000,IDAHO STATE UNIVERSITY                  ,ID,83209-5377,Public       ,850,2060,2910,4591,8517,13108
00162100,LEWIS-CLARK STATE COLLEGE               ,ID,83501-2698,Public       ,223,442,665,2080,1997,4077
00162300,NORTH IDAHO COLLEGE                     ,ID,83814-2199,Public       ,379,719,1098,2409,3158,5567
00162400,NORTHWEST NAZARENE UNIVERSITY           ,ID,83686-5897,Private      ,123,358,481,1543,1065,2608
00162500,BRIGHAM YOUNG UNIVERSITY-IDAHO          ,ID,83460-1650,Private      ,1644,2203,3847,7544,5933,13477
00162600,UNIVERSITY OF IDAHO                     ,ID,83844-4291,Public       ,494,677,1171,8331,4072,12403
00455300,ITT TECHNICAL INSTITUTE                 ,ID,83713-1529,Proprietary  ,287,834,1121,685,1917,2602
00458304,BROWN MACKIE COLLEGE-SOUTH BEND - BROWN ,ID,83709-2746,Proprietary  ,36,209,245,119,658,777
00987300,MR JUAN'S CLG OF HAIR DESIGN            ,ID,83301-4154,Proprietary  ,3,21,24,17,40,57
01113300,EASTERN IDAHO TECHNICAL COLLEGE         ,ID,83404-5788,Public       ,63,322,385,276,1132,1408
02210700,CAREER BEAUTY COLLEGE                   ,ID,83440-0000,Proprietary  ,2,0,2,9,13,22
02218000,APOLLO COLLEGE                          ,ID,83704-0000,Proprietary  ,79,414,493,237,1021,1258
02234500,BOISE BIBLE COLLEGE                     ,ID,83714-1220,Private      ,29,37,66,136,84,220
02275800,MR LEONS SCHOOL OF HAIR DESIGN          ,ID,83843-8384,Proprietary  ,9,21,30,32,50,82
02275801,MR. LEON'S SCHOOL OF HAIR DESIGN        ,ID,83501-1910,Proprietary  ,2,3,5,2,12,14
02314000,SCHOOL OF HAIRSTYLING (THE)             ,ID,83202-0000,Proprietary  ,10,17,27,38,67,105
02319800,HEADMASTERS SCHOOL OF HAIR DESIGN       ,ID,83814-0000,Proprietary  ,57,82,139,98,165,263
02349200,HEADMASTERS SCHOOL OF HAIR DESIGN       ,ID,83501-0000,Proprietary  ,14,23,37,29,46,75
02559500,RAZZLE DAZZLE CLG OF HAIR DESIGN        ,ID,83686-5104,Proprietary  ,15,40,55,43,108,151
02607100,SCOT LEWIS SCHOOLS                      ,ID,83709-1662,Proprietary  ,41,76,117,104,164,268
03098700,ACADEMY OF COURT REPORTING              ,ID,83704-8320,Proprietary  ,90,331,421,203,855,1058
03832400,COSMETOLOGY SCHOOL OF ARTS & SCIENCES   ,ID,83318-1327,Proprietary  ,4,20,24,10,53,63
04134300,EVANS HAIRSTYLING COLLEGE               ,ID,83440-5277,Proprietary  ,15,8,23,47,19,66
04144500,HAIR ACDMY PAUL MITCHELL PARTNER SCHOOL ,ID,83440-2600,Proprietary  ,32,31,63,67,81,148
04150600,D & L ACADEMY OF HAIR DESIGN            ,ID,83301-6229,Proprietary  ,0,1,1,0,1,1
04155200,OLIVER FINLEY ACADEMY OF COSMETOLOGY    ,ID,83704-8011,Proprietary  ,24,56,80,24,56,80
00163200,AQUINAS INSTITUTE OF THEOLOGY           ,MO,63108-3323,Private      ,1,15,16,3,66,69
00244900,AVILA COLLEGE                           ,MO,64145-1698,Private      ,67,325,392,918,1323,2241
00245000,CALVARY BIBLE COLLEGE                   ,MO,64147-1341,Private      ,28,54,82,150,150,300
00245200,CENTRAL BIBLE COLLEGE                   ,MO,65803-1096,Private      ,85,75,160,525,290,815
00245300,CENTRAL METHODIST UNIVERSITY            ,MO,65248-1198,Private      ,105,220,325,1366,703,2069
00245301,CENTRAL METHODIST UNIVERSITY            ,MO,63601-0000,Private      ,11,66,77,61,210,271
00245302,CENTRAL METHODIST UNIVERSITY- UNION     ,MO,63084-0000,Private      ,6,17,23,31,46,77
00245400,UNIVERSITY OF CENTRAL MISSOURI          ,MO,64093-5178,Public       ,538,815,1353,7116,4130,11246
00245600,COLUMBIA COLLEGE                        ,MO,65216-4581,Private      ,448,3187,3635,2637,14066,16703
00245700,CONCORDIA SEMINARY                      ,MO,63105-3199,Private      ,0,9,9,3,487,490
00245800,COTTEY COLLEGE                          ,MO,64772-2790,Private      ,17,4,21,310,37,347
00245900,CROWDER COLLEGE                         ,MO,64850-9165,Public       ,376,828,1204,1688,2375,4063
00246000,CULVER STOCKTON COLLEGE                 ,MO,63435-1299,Private      ,55,31,86,1004,171,1175
00246100,DRURY UNIVERSITY                        ,MO,65802-3791,Private      ,264,1015,1279,2285,3592,5877
00246200,EDEN THEOLOGICAL SEMINARY               ,MO,63119-0000,Private      ,3,26,29,6,104,110
00246300,EVANGEL UNIVERSITY                      ,MO,65802-2125,Private      ,247,222,469,1921,743,2664
00246400,FONTBONNE UNIVERSITY                    ,MO,63105-3098,Private      ,73,559,632,1176,2529,3705
00246600,HARRIS-STOWE STATE COLLEGE              ,MO,63103-2199,Public       ,352,626,978,1523,1809,3332
00246700,CONCEPTION SEMINARY COLLEGE             ,MO,64433-0000,Private      ,20,6,26,60,19,79
00246800,JEFFERSON COLLEGE                       ,MO,63050-2441,Public       ,533,853,1386,2480,2630,5110
00247100,ST LOUIS COMMUNITY COLLEGE              ,MO,63102-0000,Public       ,2755,5183,7938,8959,14191,23150
00247300,KANSAS CITY ART INSTITUTE               ,MO,64111-1874,Private      ,61,49,110,968,251,1219
00247400,KANSAS CITY UNIV OF MED AND BIOSCIENCES ,MO,64106-0000,Private      ,3,15,18,3,15,18
00247400,KANSAS CITY UNIV OF MED & BIOSCIENCES   ,MO,64106-0000,Private      ,2,20,22,19,1079,1098
00247600,KENRICK-GLENNON SEMINARY                ,MO,63119-0000,Private      ,0,2,2,8,6,14
00247700,A.T. STILL UNIV OF HEALTH SCIENCES      ,MO,63501-0000,Private      ,1,402,403,10,2762,2772
00247900,LINCOLN UNIVERSITY                      ,MO,65101-3500,Public       ,372,458,830,2722,1703,4425
00248000,LINDENWOOD UNIVERSITY                   ,MO,63301-1695,Private      ,471,1705,2176,4732,6198,10930
00248200,MARYVILLE UNIVERSITY                    ,MO,63141-7299,Private      ,125,467,592,2011,1947,3958
00248400,METROPOLITAN COMMUNITY COLLEGE          ,MO,64111-2408,Public       ,1409,3220,4629,8170,12243,20413
00248500,MIDWESTERN BAPTIST THEOL SEMINARY       ,MO,64118-4697,Private      ,20,105,125,75,246,321
00248600,MINERAL AREA COLLEGE                    ,MO,63601-1000,Public       ,292,713,1005,1789,2211,4000
00248800,MISSOURI SOUTHERN STATE UNIVERSITY      ,MO,64801-1595,Public       ,427,726,1153,3498,3315,6813
00248900,MISSOURI VALLEY COLLEGE                 ,MO,65340-3197,Private      ,112,90,202,1591,434,2025
00249000,MISSOURI WESTERN STATE UNIVERSITY       ,MO,64507-2294,Public       ,310,529,839,4206,2367,6573
00249100,MOBERLY AREA COMMUNITY COLLEGE          ,MO,65270-1304,Public       ,403,707,1110,2480,2713,5193
00249400,NAZARENE THEOLOGICAL SEMINARY           ,MO,64131-1246,Private      ,0,50,50,0,161,161
00249500,TRUMAN STATE UNIVERSITY                 ,MO,63501-4221,Public       ,166,63,229,5458,542,6000
00249600,NORTHWEST MISSOURI STATE UNIV           ,MO,64468-6001,Public       ,372,272,644,6351,1279,7630
00249800,PARK UNIVERSITY                         ,MO,64152-3795,Private      ,208,1889,2097,1306,6704,8010
00249900,ROCKHURST UNIVERSITY                    ,MO,64110-2561,Private      ,130,319,449,1931,1428,3359
00250000,COLLEGE OF THE OZARKS                   ,MO,65726-2502,Private      ,75,26,101,2883,339,3222
00250100,SOUTHEAST MISSOURI STATE UNIV           ,MO,63701-4799,Public       ,528,891,1419,7266,3726,10992
00250200,SOUTHWEST BAPTIST UNIVERSITY            ,MO,65613-2597,Private      ,167,461,628,2095,1530,3625
00250300,MISSOURI STATE UNIVERSITY               ,MO,65897-0094,Public       ,1109,1573,2682,12696,6723,19419
00250400,ST LOUIS COLLEGE OF PHARMACY            ,MO,63110-1088,Private      ,28,30,58,775,527,1302
00250600,SAINT LOUIS UNIVERSITY                  ,MO,63103-2097,Private      ,299,978,1277,8145,7194,15339
00250900,SAINT PAUL SCHOOL OF THEOLOGY           ,MO,64127-2499,Private      ,0,26,26,3,177,180
00251200,STEPHENS COLLEGE                        ,MO,65215-0001,Private      ,48,105,153,946,522,1468
00251400,NORTH CENTRAL MISSOURI COLLEGE          ,MO,64683-1824,Public       ,101,275,376,722,906,1628
00251600,UNIVERSITY OF MISSOURI-COLUMBIA         ,MO,65211-1600,Public       ,1223,1172,2395,21639,7917,29556
00251700,MISSOURI UNIVERSITY OF SCIENCE & TECHNOL,MO,65409-0250,Public       ,267,199,466,4634,1073,5707
00251800,UNIVERSITY OF MISSOURI-KANSAS CITY      ,MO,64110-2497,Public       ,677,1730,2407,6134,8405,14539
00251900,UNIVERSITY OF MISSOURI-ST LOUIS         ,MO,63121-4499,Public       ,817,2215,3032,5200,8718,13918
00252000,WASHINGTON UNIVERSITY                   ,MO,63130-4899,Private      ,218,492,710,13168,5256,18424
00252001,WASHINGTON UNIV-SCHOOL OF MEDICINE      ,MO,63110-0000,Private      ,6,24,30,50,1271,1321
00252100,WEBSTER UNIVERSITY                      ,MO,63119-3194,Private      ,199,2333,2532,3053,12233,15286
00252200,WENTWORTH MILITARY ACADEMY              ,MO,64067-1799,Private      ,45,70,115,159,175,334
00252300,WESTMINSTER COLLEGE                     ,MO,65251-1299,Private      ,38,15,53,1243,123,1366
00252400,WILLIAM JEWELL COLLEGE                  ,MO,64068-1896,Private      ,55,34,89,1526,241,1767
00252500,WILLIAM WOODS UNIVERSITY                ,MO,65251-2388,Private      ,91,640,731,993,1716,2709
00405704,NATIONAL AMERICAN UNIVERSITY            ,MO,64057-1791,Proprietary  ,11,95,106,46,381,427
00441300,ST JOHNS HOSP SCH RAD TECH              ,MO,65802-0000,Private      ,1,16,17,40,82,122
00470300,LOGAN COLLEGE OF CHIROPRACTIC           ,MO,63006-1065,Private      ,12,90,102,74,1144,1218
00470700,COVENANT THEOLOGICAL SEMINARY           ,MO,63141-8697,Private      ,0,68,68,2,515,517
00471100,LINN STATE TECHNICAL COLLEGE            ,MO,65051-9607,Public       ,71,114,185,1058,434,1492
00471300,THREE RIVERS COMMUNITY COLLEGE          ,MO,63901-2393,Public       ,333,796,1129,1615,2458,4073
00528800,KIRKSVILLE AREA TECHNICAL CENTER        ,MO,63501-0000,Public       ,12,27,39,30,69,99
00528900,WAYNESVILLE CAREER CENTER               ,MO,65583-2131,Public       ,8,38,46,20,106,126
00542400,SOUTH CENTRAL CAREER CENTER             ,MO,65775-3334,Public       ,17,82,99,49,179,228
00542600,SIKESTON CAREER AND TECHNOLOGY CTR      ,MO,63801-0000,Public       ,6,27,33,36,122,158
00542900,ROLLA TECHNICAL INSTITUTE               ,MO,65401-3601,Public       ,35,75,110,243,305,548
00543000,POPLAR BLUFF TECHNICAL CAREER CNTR      ,MO,63901-0000,Public       ,5,12,17,42,90,132
00543800,SALINE COUNTY CAREER CENTER             ,MO,65340-0000,Public       ,1,12,13,20,87,107
00544500,TRUMAN MEDICAL CENTER SCHOOL OF NURSE AN,MO,64108-2677,Private      ,5,25,30,30,94,124
00553100,GRAND RIVER TECHNICAL SCHOOL            ,MO,64601-1299,Public       ,13,16,29,79,47,126
00553200,CAPE GIRARDEAU CAREER & TECHNOLOGY CENTE,MO,63703-7511,Public       ,14,110,124,88,354,442
00638500,CHAMBERLAIN COLLEGE OF NURSING          ,MO,63139-3297,Proprietary  ,168,1566,1734,911,5807,6718
00638900,BARNES JEWISH COLLEGE OF NURSING AND ALL,MO,63110-1091,Private      ,35,116,151,254,664,918
00639200,RESEARCH COLLEGE OF NURSING             ,MO,64132-1199,Proprietary  ,10,55,65,79,251,330
00639201,RESEARCH MEDICAL CENTER - COLLEGE OF NUR,MO,64132-1199,Proprietary  ,3,5,8,9,24,33
00639202,RESEARCH MED CTR SCHL OF RAD TECH       ,MO,64132-0000,Proprietary  ,1,16,17,4,41,45
00666600,LUTHERAN  SCHOOL OF NURSING             ,MO,63118-3909,Proprietary  ,0,0,0,6,23,29
00754000,MISSOURI BAPTIST UNIVERSITY             ,MO,63141-8698,Private      ,109,546,655,1345,1826,3171
00755700,ITT TECHNICAL INSTITUTE                 ,MO,63045-1122,Proprietary  ,538,1454,1992,1234,3078,4312
00808000,STATE FAIR COMMUNITY COLLEGE            ,MO,65301-0000,Public       ,343,813,1156,1939,2488,4427
00826900,HILLYARD TECHNICAL CENTER               ,MO,64506-0000,Public       ,16,68,84,101,233,334
00855200,PATRICIA STEVENS COLLEGE                ,MO,63102-2334,Proprietary  ,20,65,85,64,145,209
00860600,TRI-COUNTY TECHNICAL SCHOOL             ,MO,65026-0000,Public       ,1,28,29,17,72,89
00886200,EAST CENTRAL COLLEGE                    ,MO,63084-0529,Public       ,353,680,1033,1856,2044,3900
00908900,HANNIBAL-LAGRANGE COLLEGE               ,MO,63401-1999,Private      ,73,98,171,756,460,1216
00952000,NATIONAL ACADEMY OF BEAUTY ARTS         ,MO,63128-1307,Proprietary  ,62,137,199,171,375,546
00959000,INDEPENDENCE COLLEGE OF COSMETOLOGY     ,MO,64055-1105,Proprietary  ,16,55,71,35,84,119
00960700,HOUSE OF HEAVILIN BEAUTY COLLEGE        ,MO,64110-2826,Proprietary  ,6,33,39,27,88,115
00978200,SAINT LUKE'S COLLEGE                    ,MO,64114-3237,Private      ,8,23,31,72,168,240
00979500,MISSOURI COLLEGE                        ,MO,63144-2901,Proprietary  ,115,345,460,319,950,1269
01014814,COLORADO TECHNL UNIV NORTH KANSAS CITY  ,MO,64116-3614,Proprietary  ,52,289,341,203,1167,1370
01027900,HICKEY COLLEGE                          ,MO,63146-0000,Proprietary  ,149,77,226,409,201,610
01040500,PINNACLE CAREER INSTITUTE               ,MO,64131-3367,Proprietary  ,81,596,677,180,1470,1650
01040501,PINNACLE CAREER INSTITUTE - NORTH KANSAS,MO,64153-1151,Proprietary  ,15,99,114,37,260,297
01050303,WICHITA TECHNICAL INSTITUTE - WTI JOPLIN,MO,64801-2970,Proprietary  ,4,98,102,24,266,290
01102600,WARRENSBURG AREA VOC TECH SCH           ,MO,64093-0000,Public       ,4,8,12,28,50,78
01173500,PIKE/LINCOLN TECHNICAL CENTER           ,MO,63344-0000,Public       ,6,17,23,36,75,111
01212000,ASSEMBLIES OF GOD THEO. SEMINARY        ,MO,65802-0000,Private      ,1,66,67,4,239,243
01250000,RANKEN TECHNICAL COLLEGE                ,MO,63113-2811,Private      ,254,367,621,1252,1146,2398
01258000,ST LOUIS CHRISTIAN COLLEGE              ,MO,63033-6499,Private      ,60,67,127,162,219,381
01320800,BAPTIST BIBLE COLLEGE                   ,MO,65803-3498,Private      ,80,79,159,339,205,544
02056100,FOUR RIVERS CAREER CENTER               ,MO,63090-0000,Public       ,2,5,7,12,48,60
02066900,NICHOLS CAREER CENTER                   ,MO,65101-2814,Public       ,2,16,18,72,134,206
02068200,COX HEALTH - COX COLLEGE                ,MO,65802-0000,Private      ,44,141,185,191,550,741
02068202,COX HEALTH - RADIOLOGIC TECHNOLOGY      ,MO,65802-0000,Private      ,3,13,16,33,66,99
02068204,COX HEALTH - MEDICAL TECHNOLOGY         ,MO,65807-0000,Private      ,3,8,11,12,48,60
02073600,KENNETT CAREER & TECHNOLOGY CENTER      ,MO,63857-0000,Public       ,1,7,8,22,40,62
02090400,BOONSLICK TECHNICAL EDUCATION CTR       ,MO,65233-0000,Public       ,0,9,9,8,61,69
02121100,MIDWEST INSTITUTE                       ,MO,63122-0000,Proprietary  ,23,163,186,45,270,315
02124500,FRANKLIN TECHNOLOGY CENTER              ,MO,64801-0000,Public       ,15,130,145,65,357,422
02142200,LEX LA RAY TECHNICAL CENTER             ,MO,64067-0000,Public       ,1,10,11,14,65,79
02151000,HANNIBAL CAREER AND TECHNICAL CENTE     ,MO,63401-2285,Public       ,3,22,25,22,102,124
02164200,FOREST INST PROFESSIONAL PSYCHOLOGY     ,MO,65807-0000,Private      ,0,26,26,9,305,314
02165900,CHILLICOTHE BEAUTY ACADEMY              ,MO,64601-0000,Proprietary  ,5,10,15,9,24,33
02180200,METRO BUSINESS COLLEGE                  ,MO,63701-0000,Proprietary  ,64,325,389,162,795,957
02188100,NORTHLAND CAREER CENTER                 ,MO,64079-8333,Public       ,3,18,21,20,90,110
02202700,OZARK CHRISTIAN COLLEGE                 ,MO,64801-0000,Private      ,88,59,147,479,166,645
02203400,NEVADA REGIONAL TECHNICAL CENTER        ,MO,64772-0000,Public       ,2,10,12,24,74,98
02205200,SANFORD-BROWN COLLEGE                   ,MO,63026-7305,Proprietary  ,74,338,412,278,1476,1754
02205203,SANFORD BROWN COLLEGE-ST. PETERS        ,MO,63301-4042,Proprietary  ,75,305,380,211,1121,1332
02214500,SALEM COLLEGE OF HAIRSTYLING            ,MO,65401-0000,Proprietary  ,3,24,27,9,45,54
02239200,ALLIED COLLEGE - NORTH                  ,MO,63043-0000,Proprietary  ,169,406,575,501,1223,1724
02239202,ALLIED COLLEGE - METRO SOUTH            ,MO,63026-0000,Proprietary  ,10,35,45,49,96,145
02250600,EVEREST COLLEGE                         ,MO,65807-2446,Proprietary  ,34,205,239,116,698,814
02263106,HIGH-TECH INSTITUTE - KANSAS CITY       ,MO,64114-0000,Proprietary  ,2,21,23,21,59,80
02263400,LAKE CAREER AND TECHNICAL CENTER        ,MO,65020-0000,Public       ,0,13,13,6,27,33
02266400,CENTRAL CHRISTIAN CLG OF THE BIBLE      ,MO,65270-0000,Private      ,63,37,100,273,156,429
02277500,HOUSE OF HEAVILIN OF BLUE SPRINGS       ,MO,64014-3953,Proprietary  ,21,40,61,55,112,167
02289200,COLUMBIA AREA CAREER CENTER             ,MO,65203-0000,Public       ,6,58,64,45,167,212
02295700,MISSOURI BEAUTY ACADEMY                 ,MO,63640-1827,Proprietary  ,15,56,71,61,158,219
02300105,EVEREST COLLEGE - EARTH CITY            ,MO,63045-1100,Proprietary  ,73,419,492,148,801,949
02304000,MISSOURI TECH                           ,MO,63132-0000,Proprietary  ,10,35,45,40,117,157
02309100,AMERICAN COLLEGE OF HAIR DESIGN         ,MO,65301-2144,Proprietary  ,10,14,24,25,41,66
02313000,CASS CAREER CENTER                      ,MO,64701-0000,Public       ,1,12,13,10,76,86
02340500,ST LOUIS COLLEGE OF HEALTH CAREERS      ,MO,63110-0000,Proprietary  ,45,248,293,127,624,751
02340501,ST LOUIS COLLEGE OF HEALTH              ,MO,63129-0000,Proprietary  ,0,13,13,12,53,65
02342100,CAREER & TECHNOLOGY CTR AT FT OSAGE     ,MO,64058-0000,Public       ,2,6,8,12,19,31
02361600,CONCORDE CAREER COLLEGE                 ,MO,64111-0000,Proprietary  ,69,343,412,153,961,1114
02497500,CLINTON TECHNICAL SCHOOL                ,MO,64735-2966,Public       ,3,23,26,7,43,50
02520800,MERRELL UNIV OF BTY ARTS & SCIENCES     ,MO,65109-0000,Proprietary  ,22,52,74,63,133,196
02530600,SAINT CHARLES COMMUNITY COLLEGE         ,MO,63376-0975,Public       ,595,814,1409,3322,2678,6000
02543800,PARIS II EDUCATIONAL CENTER (THE)       ,MO,64118-0000,Proprietary  ,16,51,67,27,91,118
02555300,PATSY AND ROB'S ACADEMY OF BEAUTY       ,MO,63074-0000,Proprietary  ,16,35,51,31,105,136
02564700,ELAINE STEVEN BEAUTY COLLEGE            ,MO,63136-0000,Proprietary  ,32,104,136,57,155,212
02564701,ELAINE STEVEN BEAUTY COLLEGE - ADVANCE B,MO,63383-2006,Proprietary  ,2,2,4,3,5,8
02564702,ELAINE STEVEN BEAUTY COLLEGE - ADVANCE B,MO,63401-2269,Proprietary  ,2,3,5,6,9,15
02568500,GRABBER SCHOOL OF HAIR DESIGN           ,MO,63011-0000,Proprietary  ,25,42,67,51,93,144
02599700,VATTEROTT COLLEGE                       ,MO,63134-2900,Proprietary  ,141,545,686,325,1548,1873
02599701,VATTEROTT COLLEGE - KANSAS CITY         ,MO,64129-1692,Proprietary  ,75,408,483,174,1145,1319
02599702,VATTEROTT COLLEGE - SPRINGFIELD LOCATION,MO,65807-5340,Proprietary  ,35,209,244,117,674,791
02599703,VATTEROTT COLLEGE - JOPLIN              ,MO,64801-5033,Proprietary  ,29,193,222,79,562,641
02599705,VATTEROTT COLLEGE - SUNSET HILLS        ,MO,63127-1516,Proprietary  ,40,305,345,142,836,978
02599712,VATTEROTT COLLEGE - O'FALLON            ,MO,63366-2748,Proprietary  ,23,105,128,81,372,453
02608000,NEOSHO BEAUTY COLLEGE                   ,MO,64850-1525,Proprietary  ,4,18,22,12,43,55
02609202,VATTEROTT COLLEGE-ST JOSEPH             ,MO,64501-2911,Proprietary  ,45,146,191,115,463,578
02609203,VATTEROTT COLLEGE - L'ECOLE CULINAIRE   ,MO,63124-1103,Proprietary  ,71,191,262,202,631,833
02611004,HERITAGE COLLEGE-KANSAS CITY            ,MO,64131-4203,Proprietary  ,63,353,416,158,796,954
03042400,LEBANON TECHNOLOGY & CAREER CENTER      ,MO,65536-3296,Public       ,8,51,59,33,126,159
03066300,BRYAN CAREER COLLEGE                    ,MO,65806-2507,Proprietary  ,15,102,117,54,301,355
03068600,NORTH COUNTY TECH SPECIAL SCH DIST      ,MO,63033-6498,Public       ,17,143,160,68,504,572
03070200,CENTRAL COLLEGE OF COSMETOLOGY          ,MO,65583-0000,Proprietary  ,10,49,59,16,91,107
03070900,SE MO HOSP CLG NURSING & HEALTH SCI     ,MO,63703-4507,Private      ,12,44,56,80,235,315
03077200,COSMETOLOGY CONCEPTS INSTITUTE          ,MO,65202-1972,Proprietary  ,6,33,39,32,76,108
03083000,OZARKS TECHNICAL COMMUNITY COLLEGE      ,MO,65802-3601,Public       ,1169,2567,3736,5887,8123,14010
03092600,MESSENGER COLLEGE                       ,MO,64804-4909,Private      ,26,23,49,46,58,104
03097600,ST LOUIS HAIR ACADEMY                   ,MO,63107-1737,Proprietary  ,3,21,24,13,55,68
03101000,NEW DIMENSION SCHOOL OF HAIR DESIGN     ,MO,64801-5017,Proprietary  ,3,25,28,12,59,71
03106000,MISSOURI STATE UNIVERSITY - WEST PLAINS ,MO,65775-2715,Public       ,161,350,511,1009,1166,2175
03110900,HOUSE OF HEAVILIN BEAUTY COLLEGE        ,MO,64030-1154,Proprietary  ,3,25,28,13,56,69
03166300,MOBERLY AREA TECHNICAL CENTER           ,MO,65270-1904,Public       ,2,10,12,14,23,37
03519300,MISSOURI COLLEGE OF COSMETOLOGY NORTH   ,MO,65803-1235,Proprietary  ,17,58,75,52,187,239
03528300,MIDWEST UNIVERSITY                      ,MO,63385-2905,Private      ,1,9,10,6,29,35
03579300,TEXAS COUNTY TECHNICAL INSTITUTE        ,MO,65483-2700,Private      ,12,79,91,39,308,347
03616300,AVIATION INSTITUTE OF MAINTENANCE       ,MO,64129-1811,Proprietary  ,23,107,130,48,267,315
03663400,UNIVERSITY OF COSMETOLOGY               ,MO,63080-1910,Proprietary  ,2,19,21,11,34,45
03878300,PROFESSIONAL MASSAGE TRAINING CENTER    ,MO,65803-2939,Proprietary  ,7,34,41,34,80,114
03916300,ECLIPS SCHOOL OF COSMETOLOGY AND BARBERI,MO,63703-5809,Proprietary  ,9,35,44,19,75,94
03924300,HAIR ACADEMY 110 (THE)                  ,MO,63501-2915,Proprietary  ,3,5,8,18,14,32
03970400,MTTI-WELLSPRING CENTER FOR NATURAL HEALT,MO,64114-3313,Proprietary  ,10,53,63,35,123,158
04037500,ACADEMY OF HAIR DESIGN                  ,MO,65804-2303,Proprietary  ,16,63,79,50,154,204
04048300,DIVAS UNLIMITED ACADEMY                 ,MO,63114-2625,Proprietary  ,2,12,14,8,25,33
04127000,PEMISCOT COUNTY SPECIAL SCHOOL DISTRICT ,MO,63851-1666,Public       ,1,8,9,10,53,63
04130600,HEALING ARTS CENTER                     ,MO,63143-2103,Proprietary  ,6,27,33,11,63,74
04133300,TREND SETTERS SCHOOL OF COSMETOLOGY     ,MO,63702-7607,Proprietary  ,11,27,38,43,69,112
04145700,THE SYSTEM A PAUL MITCHELL PARTNER SCHL ,MO,65807-5969,Proprietary  ,32,48,80,78,91,169
04146100,URSHAN GRADUATE SCHOOL OF THEOLOGY      ,MO,63031-7526,Private      ,0,6,6,0,16,16
00163201,AQUINAS INSTITUTE OF THEOLOGY - MINISTRY,OK,73123-0380,Private      ,0,2,2,0,6,6
00314600,WESTERN OKLAHOMA STATE COLLEGE          ,OK,73521-1397,Public       ,194,337,531,575,863,1438
00314700,BACONE COLLEGE                          ,OK,74403-1597,Private      ,124,168,292,905,690,1595
00314900,SOUTHERN NAZARENE UNIVERSITY            ,OK,73008-2694,Private      ,230,526,756,1144,1343,2487
00315000,CAMERON UNIVERSITY                      ,OK,73505-6377,Public       ,444,1024,1468,1913,3230,5143
00315100,OKLAHOMA WESLEYAN UNIVERSITY            ,OK,74006-6299,Private      ,85,250,335,594,873,1467
00315200,UNIV OF CENTRAL OKLAHOMA                ,OK,73034-5209,Public       ,1325,1673,2998,7394,6382,13776
00315300,CONNORS STATE COLLEGE                   ,OK,74469-9700,Public       ,200,351,551,891,1202,2093
00315400,EAST CENTRAL UNIVERSITY                 ,OK,74820-6999,Public       ,391,704,1095,2256,2523,4779
00315500,EASTERN OKLAHOMA STATE COLLEGE          ,OK,74578-4999,Public       ,196,353,549,791,1069,1860
00315600,REDLANDS COMMUNITY COLLEGE              ,OK,73036-5304,Public       ,162,356,518,653,1009,1662
00315700,LANGSTON UNIVERSITY                     ,OK,73050-0000,Public       ,457,563,1020,2003,1881,3884
00315800,MURRAY STATE COLLEGE                    ,OK,73460-3137,Public       ,229,579,808,1037,1705,2742
00316000,NORTHEASTERN OKLAHOMA A & M COLLEGE     ,OK,74354-6497,Public       ,306,349,655,1381,1030,2411
00316100,NORTHEASTERN STATE UNIVERSITY           ,OK,74464-2399,Public       ,681,1399,2080,4381,5658,10039
00316200,NORTHERN OKLAHOMA COLLEGE               ,OK,74653-0310,Public       ,466,704,1170,1704,1888,3592
00316300,NORTHWESTERN OKLAHOMA STATE UNIV        ,OK,73717-2799,Public       ,214,264,478,1107,878,1985
00316400,OKLAHOMA BAPTIST UNIVERSITY             ,OK,74801-2590,Private      ,162,69,231,1695,320,2015
00316500,OKLAHOMA CHRISTIAN UNIVERSITY           ,OK,73131-0000,Private      ,286,179,465,1967,577,2544
00316600,OKLAHOMA CITY UNIVERSITY                ,OK,73106-1493,Private      ,195,396,591,2121,2308,4429
00316700,UNIV OF SCIENCE & ARTS OF OKLAHOMA      ,OK,73018-5322,Public       ,113,130,243,690,451,1141
00316800,ROGERS STATE UNIVERSITY                 ,OK,74017-3252,Public       ,396,699,1095,2082,2622,4704
00317000,OKLAHOMA STATE UNIVERSITY               ,OK,74078-1015,Public       ,1899,1627,3526,12960,6746,19706
00317200,OKLAHOMA STATE UNIVERSITY-OKMULGEE      ,OK,74447-3901,Public       ,271,413,684,1515,1462,2977
00317400,OKLAHOMA PANHANDLE STATE UNIVERSITY     ,OK,73939-0000,Public       ,165,161,326,771,398,1169
00317600,CARL ALBERT STATE COLLEGE               ,OK,74953-5208,Public       ,196,430,626,1075,1722,2797
00317800,SEMINOLE STATE COLLEGE                  ,OK,74818-1902,Public       ,211,378,589,804,1188,1992
00317900,SOUTHEASTERN OKLAHOMA STATE UNIV        ,OK,74701-0609,Public       ,468,682,1150,2201,2087,4288
00318000,SOUTHWESTERN CHRISTIAN UNIVERSITY       ,OK,73008-2335,Private      ,36,71,107,167,186,353
00318100,SOUTHWESTERN OKLAHOMA STATE UNIV        ,OK,73096-3098,Public       ,473,504,977,2572,1737,4309
00318101,SOUTHWESTERN OK STATE UNIV AT SAYRE     ,OK,73662-0000,Public       ,45,97,142,138,234,372
00318300,ST GREGORY'S UNIVERSITY                 ,OK,74804-2499,Private      ,49,123,172,332,412,744
00318308,SAINT GREGORY'S UNIVERSITY - IPD TULSA  ,OK,74135-2499,Private      ,1,36,37,17,137,154
00318400,UNIVERSITY OF OKLAHOMA                  ,OK,73019-4078,Public       ,1541,1834,3375,14715,9181,23896
00318401,UNIVERSITY OF OKLAHOMA-HLTH SCI CTR     ,OK,73190-0000,Public       ,47,416,463,419,3466,3885
00318500,UNIVERSITY OF TULSA                     ,OK,74104-3189,Private      ,217,342,559,2683,1777,4460
00398500,ORAL ROBERTS UNIVERSITY                 ,OK,74171-0001,Private      ,345,410,755,2745,1424,4169
00458305,BROWN MACKIE COLLEGE-SOUTH BEND - BROWN ,OK,74146-5234,Proprietary  ,17,142,159,49,360,409
00531100,TULSA COUNTY AREA VOC TECH SCHOOL       ,OK,74145-0000,Public       ,61,322,383,212,991,1203
00531200,RED RIVER TECHNOLOGY CENTER             ,OK,73533-2700,Public       ,15,82,97,33,202,235
00533900,METRO TECHNOLOGY CENTERS SCH DIST22     ,OK,73111-0000,Public       ,63,406,469,174,1058,1232
00533903,METRO TECHNOLOGY CENTERS SCH DIST22     ,OK,73129-0000,Public       ,14,102,116,52,293,345
00694200,MID-AMERICA CHRISTIAN UNIVERSITY        ,OK,73170-4504,Private      ,81,384,465,432,1025,1457
00767800,SPARTAN COLLEGE OF AERONAUTICS AND TECHN,OK,74115-5800,Proprietary  ,168,245,413,1050,913,1963
00791100,VIRGILS BEAUTY COLLEGE                  ,OK,74401-6802,Proprietary  ,6,27,33,9,42,51
00834300,AUTRY TECHNOLOGY CENTER                 ,OK,73703-2598,Public       ,24,108,132,56,258,314
00861900,TRI COUNTY TECHNOLOGY CENTER            ,OK,74006-6029,Public       ,14,61,75,82,181,263
00918500,ROSE STATE COLLEGE                      ,OK,73110-2799,Public       ,599,1722,2321,2064,4699,6763
00920400,KIAMICHI AREA VOC TECH SCHOOL           ,OK,74578-0548,Public       ,118,440,558,256,1065,1321
00920408,KIAMICHI AREA VOC TECH SCHOOL           ,OK,74953-0000,Public       ,11,29,40,30,101,131
00961800,TULSA WELDING SCHOOL                    ,OK,74104-0000,Proprietary  ,248,459,707,959,1287,2246
00964700,"OKLAHOMA STATE UNIV, OKLA CITY          ",OK,73107-6159,Public       ,512,1580,2092,1851,4694,6545
00970800,EVES COLLEGE OF HAIRSTYLING             ,OK,73501-4359,Proprietary  ,13,80,93,21,98,119
00976300,TULSA COMMUNITY COLLEGE                 ,OK,74135-6198,Public       ,1210,3067,4277,6883,10053,16936
00996300,CADDO KIOWA VOC TECH CENTER             ,OK,73038-0000,Public       ,38,180,218,75,318,393
00996400,CENTRAL OKLAHOMA AREA VOC TECH SCH      ,OK,74030-9613,Public       ,20,105,125,67,240,307
00996500,CANADIAN VALLEY TECHNOLOGY CENTER       ,OK,73036-9117,Public       ,42,174,216,81,372,453
00996800,GORDON COOPER TECHNOLOGY CENTER         ,OK,74804-9913,Public       ,30,113,143,81,344,425
01005300,INDIAN CAPITAL TECHNOLGY CENTER #4      ,OK,74403-9907,Public       ,53,171,224,150,571,721
01026600,HILLSDALE FREE WILL BAPTIST COLLEGE     ,OK,73153-0000,Private      ,49,27,76,223,61,284
01034200,SOUTHERN OKLAHOMA TECHNOLOGY CENTER     ,OK,73401-2100,Public       ,28,72,100,74,237,311
01039100,OKLAHOMA CITY COMMUNITY COLLEGE         ,OK,73159-4444,Public       ,1172,2516,3688,3774,7160,10934
01050304,WTI TULSA CAMPUS                        ,OK,74112-3140,Proprietary  ,7,55,62,11,116,127
01071700,GREAT PLAINS TECHNOLOGY CENTER SCHOOL DI,OK,73505-8399,Public       ,28,129,157,75,372,447
01076200,WESTERN OK AREA VOC TECH SCH DIST12     ,OK,73624-1469,Public       ,24,46,70,49,118,167
01120600,PIONEER TECHNOLOGY CENTER               ,OK,74601-1106,Public       ,19,68,87,36,174,210
01128200,OKLAHOMA STATE UNV CLG OSTEOPTHC MD     ,OK,74107-0000,Public       ,9,51,60,48,551,599
01153700,MID-AMERICA TECHNOLOGY CENTER           ,OK,73095-0210,Public       ,15,36,51,28,90,118
01227200,MOORE-NORMAN TECHNOLOGY CENTER          ,OK,73069-8399,Public       ,46,214,260,126,659,785
02052700,NORTHEAST TECHNOLOGY CENTER             ,OK,74361-0487,Public       ,28,220,248,57,453,510
02052701,NORTHEAST TECHNOLOGY CENTER -           ,OK,74362-0825,Public       ,0,0,0,20,116,136
02060800,MERIDIAN TECHNOLOGY CENTER              ,OK,74074-0000,Public       ,18,96,114,87,332,419
02126500,ENID BEAUTY COLLEGE                     ,OK,73701-0000,Proprietary  ,11,32,43,22,61,83
02177900,STATE BARBER AND HAIR DESIGN CLG        ,OK,73108-0000,Proprietary  ,0,0,0,1,0,1
02184400,SAND SPRINGS BEAUTY COLLEGE             ,OK,74063-0000,Proprietary  ,19,45,64,31,102,133
02197300,HOLLYWOOD COSMETOLOGY CENTER            ,OK,73189-0000,Proprietary  ,1,17,18,7,37,44
02222700,FRANCIS TUTTLE TECHNOLOGY CENTER        ,OK,73142-0000,Public       ,72,368,440,202,1058,1260
02238500,CENTRAL STATE BEAUTY ACADEMY            ,OK,73162-6007,Proprietary  ,20,78,98,59,224,283
02250900,E OK COUNTY AREA VO-TECH                ,OK,73020-0000,Public       ,9,27,36,29,67,96
02256200,"BROKEN ARROW BEAUTY COLLEGE, INC        ",OK,74012-0000,Proprietary  ,18,47,65,40,101,141
02282100,HIGH PLAINS AREA VOC-TECH               ,OK,73801-0000,Public       ,9,49,58,28,93,121
02306800,PLATT COLLEGE                           ,OK,74145-0000,Proprietary  ,108,634,742,266,1674,1940
02510300,BEAUTY TECHNICAL COLLEGE                ,OK,74465-0000,Proprietary  ,7,15,22,11,23,34
02531200,WOODWARD BEAUTY COLLEGE                 ,OK,73801-0000,Proprietary  ,0,2,2,1,4,5
02554300,AMERICAN BEAUTY INSTITUTE               ,OK,74501-0000,Proprietary  ,3,16,19,11,32,43
02556500,YUKON BEAUTY COLLEGE                    ,OK,73099-4108,Proprietary  ,6,13,19,8,25,33
02560200,PHILLIPS THEOLOGICAL SEMINARY -         ,OK,74116-5612,Private      ,1,17,18,2,89,91
02581100,CLAREMORE BEAUTY COLLEGE                ,OK,74017-7034,Proprietary  ,5,10,15,12,25,37
02581200,CC'S COSMETOLOGY COLLEGE                ,OK,74129-0000,Proprietary  ,11,108,119,29,220,249
02591101,CAREER POINT INSTITUTE                  ,OK,74146-0000,Proprietary  ,2,29,31,12,99,111
02596501,ATI-CAREER TRAINING CENTER - OKLAHOMA CI,OK,73107-2442,Proprietary  ,2,31,33,10,88,98
02597400,PONTOTOC TECHNOLOGY CENTER SCHOOL       ,OK,74820-8621,Public       ,17,50,67,54,177,231
02599706,VATTEROTT COLLEGE - TULSA               ,OK,74146-2205,Proprietary  ,21,189,210,48,411,459
02600000,NORTHWEST TECHNOLOG CTR SCH DIST 10     ,OK,73717-9600,Public       ,10,27,37,19,57,76
02600500,WES WATKINS TECHNOLOGY CENTER           ,OK,74883-9660,Public       ,18,64,82,34,184,218
02609205,VATTEROTT COLLEGE - OKLAHOMA CITY       ,OK,73127-2103,Proprietary  ,11,169,180,44,517,561
03008700,SOUTHWEST TECHNOLOGY CENTER             ,OK,73521-1527,Public       ,9,48,57,19,92,111
03010300,POTEAU BEAUTY COLLEGE                   ,OK,74953-5400,Proprietary  ,0,0,0,6,22,28
03024700,STILLWATER BEAUTY ACADEMY               ,OK,74075-3467,Proprietary  ,2,22,24,11,38,49
03030700,OKLAHOMA SCHOOL OF PHOTOGRAPHY          ,OK,73160-3320,Proprietary  ,6,18,24,14,52,66
03030800,AMERICAN BROADCASTING SCHOOL            ,OK,73115-3334,Proprietary  ,17,63,80,34,163,197
03051100,CHISHOLM TRAIL TECHNOLOGY CENTER        ,OK,73764-9720,Public       ,10,28,38,18,54,72
03078500,TECH INST OF COSMETOLOGY ARTS & SCI     ,OK,74120-3610,Proprietary  ,9,14,23,15,35,50
03103800,SOUTHERN SCHOOL OF BEAUTY               ,OK,74701-5008,Proprietary  ,1,12,13,13,42,55
03109800,PONCA CITY BEAUTY COLLEGE               ,OK,74601-4201,Proprietary  ,0,12,12,0,15,15
03109801,BARTLESVILLE BEAUTY COLLEGE             ,OK,74003-2835,Proprietary  ,1,19,20,1,20,21
03115100,HERITAGE COLLEGE                        ,OK,73119-0000,Proprietary  ,94,331,425,226,885,1111
03124800,PLATT COLLEGE                           ,OK,73501-3808,Proprietary  ,16,77,93,43,190,233
03126200,GREEN COUNTRY AREA VOC TECH SCHOOL      ,OK,74447-1217,Public       ,4,31,35,28,98,126
03198400,MID-DEL AREA VOCATIONAL & TECH SCH      ,OK,73110-4825,Public       ,6,38,44,11,82,93
03329400,PRYOR BEAUTY COLLEGE                    ,OK,74361-0000,Proprietary  ,7,20,27,8,26,34
03329401,PRYOR BEAUTY COLLEGE - GROVE BEAUTY COLL,OK,74345-0009,Proprietary  ,2,12,14,3,18,21
03329402,PRYOR BEAUTY COLLEGE - NORTH EAST OKLAHO,OK,74338-0000,Proprietary  ,0,5,5,1,8,9
03367400,COMMUNITY CARE COLLEGE                  ,OK,74145-6420,Proprietary  ,144,505,649,337,1445,1782
03396300,OKLAHOMA HEALTH ACADEMY                 ,OK,74105-6220,Proprietary  ,19,85,104,43,187,230
03396400,OKLAHOMA HEALTH ACADEMY                 ,OK,73160-3667,Proprietary  ,18,87,105,43,205,248
03453400,SHAWNEE BEAUTY COLLEGE                  ,OK,74801-7014,Proprietary  ,8,31,39,18,45,63
03676300,FAMILY OF FAITH COLLEGE                 ,OK,74802-1805,Private      ,3,10,13,12,21,33
03831300,INSTITUTE OF HAIR DESIGN                ,OK,74804-0000,Proprietary  ,8,23,31,9,28,37
03928300,CENTRAL STATE MASSAGE ACADEMY           ,OK,73162-6007,Proprietary  ,10,41,51,37,95,132
04027300,4-STATES ACADEMY OF COSMETOLOGY         ,OK,74354-0000,Proprietary  ,4,43,47,14,85,99
04060300,AMERICAN INSTITUTE OF MEDICAL TECHNOLOGY,OK,74146-5201,Proprietary  ,6,30,36,31,103,134
04062300,OKLAHOMA TECHNOLOGY INSTITUTE           ,OK,73114-6318,Proprietary  ,1,26,27,10,87,97
04121300,4-STATES OKMULGEE ACADEMY OF COSMETOLOGY,OK,74447-0000,Proprietary  ,4,8,12,9,30,39
04133600,CUTTER'S EDGE SCHOOL OF COSMETOLOGY     ,OK,74023-2905,Proprietary  ,4,5,9,6,15,21
04144400,ACADEMY OF HAIR DESIGN (THE)            ,OK,73120-6808,Proprietary  ,16,27,43,29,34,63
00163700,BETHANY THEOLOGICAL SEMINARY            ,IN,47374-0000,Private      ,0,9,9,1,39,40
00178400,ANCILLA COLLEGE-FINANCIAL AID OFFC      ,IN,46513-0001,Private      ,33,81,114,464,559,1023
00178500,ANDERSON UNIVERSITY                     ,IN,46012-3495,Private      ,92,221,313,2801,1031,3832
00178600,BALL STATE UNIVERSITY                   ,IN,47306-0880,Public       ,594,833,1427,20112,8914,29026
00178700,BETHEL COLLEGE INC                      ,IN,46545-5591,Private      ,54,175,229,1583,1317,2900
00178800,BUTLER UNIVERSITY                       ,IN,46208-3487,Private      ,89,143,232,6213,1516,7729
00178900,CHRISTIAN THEOLOGICAL SEMINARY          ,IN,46208-0000,Private      ,0,32,32,2,212,214
00179200,DEPAUW UNIVERSITY                       ,IN,46135-0037,Private      ,45,12,57,3045,93,3138
00179300,EARLHAM COLLEGE                         ,IN,47374-4095,Private      ,37,20,57,1522,138,1660
00179301,EARLHAM SCHOOL OF RELIGION              ,IN,47374-0000,Private      ,0,6,6,16,59,75
00179500,UNIVERSITY OF EVANSVILLE                ,IN,47722-0002,Private      ,62,68,130,3776,705,4481
00179800,FRANKLIN COLLEGE OF INDIANA             ,IN,46131-2623,Private      ,17,10,27,1831,165,1996
00179900,GOSHEN COLLEGE                          ,IN,46526-4794,Private      ,29,63,92,1135,433,1568
00180000,GRACE COLLEGE & THEO SEMINARY           ,IN,46590-1224,Private      ,64,73,137,1508,772,2280
00180100,HANOVER COLLEGE                         ,IN,47243-0108,Private      ,25,5,30,1803,67,1870
00180300,HUNTINGTON UNIVERSITY                   ,IN,46750-1299,Private      ,30,80,110,1389,375,1764
00180400,UNIVERSITY OF INDIANAPOLIS              ,IN,46227-3697,Private      ,106,447,553,4891,3489,8380
00180500,INDIANA INSTITUTE OF TECHNOLOGY         ,IN,46803-1297,Private      ,69,488,557,1529,3058,4587
00180700,INDIANA STATE UNIVERSITY                ,IN,47809-2501,Public       ,357,812,1169,8746,6177,14923
00180800,UNIVERSITY OF SOUTHERN INDIANA          ,IN,47712-3596,Public       ,346,521,867,8553,3507,12060
00180900,INDIANA UNIVERSITY-BLOOMINGTON          ,IN,47405-1223,Public       ,948,1108,2056,30731,11432,42163
00181100,INDIANA UNIV-EAST                       ,IN,47374-1289,Public       ,116,382,498,1305,1986,3291
00181300,INDIANA UNIV-PURDUE UNIV INDPLS         ,IN,46202-5145,Public       ,751,2497,3248,15977,20214,36191
00181301,INDIANA UNIVERSITY - PURDUE UNIVERSITY I,IN,47203-1769,Public       ,72,238,310,1391,1549,2940
00181400,INDIANA UNIV KOKOMO                     ,IN,46902-3557,Public       ,82,320,402,1456,1993,3449
00181500,INDIANA UNIV-NORTHWEST                  ,IN,46408-1197,Public       ,269,739,1008,2647,4127,6774
00181600,INDIANA UNIVERSITY - SOUTH BEND         ,IN,46615-0000,Public       ,333,958,1291,4502,5367,9869
00181700,INDIANA UNIVERSITY-SOUTHEAST            ,IN,47150-6405,Public       ,301,658,959,3747,3703,7450
00182000,MANCHESTER COLLEGE                      ,IN,46962-1276,Private      ,23,8,31,2378,147,2525
00182100,MARIAN UNIVERSITY                       ,IN,46222-1997,Private      ,52,208,260,1907,1686,3593
00182200,INDIANA WESLEYAN UNIVERSITY             ,IN,46953-4974,Private      ,109,2826,2935,4146,10869,15015
00182300,ASSOCIATED MENNONITE BIBLICAL SEM       ,IN,46517-1999,Private      ,0,8,8,0,111,111
00182400,OAKLAND CITY UNIVERSITY                 ,IN,47660-1099,Private      ,9,93,102,634,2195,2829
00182500,PURDUE UNIVERSITY                       ,IN,47907-2050,Public       ,921,870,1791,30396,7699,38095
00182600,PURDUE UNIV NORTH CENTRAL CAMPUS        ,IN,46391-9528,Public       ,209,367,576,2478,2801,5279
00182700,PURDUE UNIV CALUMET                     ,IN,46323-2094,Public       ,539,1037,1576,5190,5455,10645
00182800,INDIANA UNIV-PURDUE UNIV FORT WAYNE     ,IN,46805-1499,Public       ,543,1207,1750,8463,7462,15925
00183000,ROSE HULMAN INSTITUTE OF TECHNOLOGY     ,IN,47803-3999,Private      ,71,12,83,3027,116,3143
00183200,UNIVERSITY OF SAINT FRANCIS             ,IN,46808-3994,Private      ,46,212,258,2125,1684,3809
00183300,ST JOSEPH'S COLLEGE                     ,IN,47978-0000,Private      ,25,13,38,1244,134,1378
00183400,CALUMET COLLEGE OF SAINT JOSEPH         ,IN,46394-2195,Private      ,90,185,275,486,816,1302
00183500,SAINT MARY-OF-THE-WOODS COLLEGE         ,IN,47876-0067,Private      ,20,240,260,441,1265,1706
00183600,ST MARY'S COLLEGE                       ,IN,46556-5007,Private      ,25,9,34,1787,71,1858
00183800,TAYLOR UNIVERSITY                       ,IN,46989-1001,Private      ,54,44,98,2446,221,2667
00183801,TAYLOR UNIVERSITY - FORT WAYNE          ,IN,46807-0000,Private      ,0,1,1,126,96,222
00183900,TRINE UNIVERSITY                        ,IN,46703-1764,Private      ,32,109,141,2371,752,3123
00184000,UNIVERSITY OF NOTRE DAME                ,IN,46556-5602,Private      ,145,190,335,12478,3429,15907
00184200,VALPARAISO UNIVERSITY                   ,IN,46383-6493,Private      ,115,220,335,4016,1909,5925
00184300,VINCENNES UNIVERSITY                    ,IN,47591-1523,Public       ,402,776,1178,5896,3949,9845
00184400,WABASH COLLEGE                          ,IN,47933-0352,Private      ,19,8,27,1305,53,1358
00224905,DAVENPORT UNIVERSITY-MERRILLVILLE       ,IN,46410-0000,Private      ,1,25,26,19,180,199
00420300,GOOD SAMARITAN HOSP RADIOGRAPHY PRG     ,IN,47591-0000,Public       ,0,3,3,3,16,19
00457900,INTERNATIONAL BUSINESS COLLEGE          ,IN,46804-0000,Proprietary  ,47,45,92,658,299,957
00457901,INTERNATIONAL BUSINESS COLLEGE          ,IN,46256-0000,Proprietary  ,22,48,70,514,266,780
00458300,BROWN MACKIE COLLEGE-SOUTH BEND         ,IN,46635-1776,Proprietary  ,133,661,794,543,3071,3614
00458301,BROWN MACKIE COLLEGE-SOUTH BEND - BROWN ,IN,46805-0000,Proprietary  ,46,289,335,232,1178,1410
00512730,BROWN MACKIE COLLEGE-MERRILLVILLE       ,IN,46410-0000,Proprietary  ,5,60,65,99,402,501
00512731,BROWN MACKIE COLLEGE-CINCINNATI - BROWN ,IN,46360-4362,Proprietary  ,27,139,166,100,417,517
00625700,SAINT ELIZABETH SCHOOL OF NURSING       ,IN,47904-2198,Private      ,1,13,14,138,264,402
00726300,HOLY CROSS COLLEGE                      ,IN,46556-0308,Private      ,39,9,48,544,100,644
00727600,SAINT MEINRAD SCHOOL OF THEOLOGY        ,IN,47577-1002,Private      ,0,56,56,3,106,109
00732700,ITT TECHNICAL INSTITUTE                 ,IN,47630-7430,Proprietary  ,580,1686,2266,1504,3708,5212
00732900,ITT TECHNICAL INSTITUTE                 ,IN,46268-1119,Proprietary  ,816,4140,4956,1978,9038,11016
00736200,MEDTECH COLLEGE                         ,IN,46250-3970,Proprietary  ,47,351,398,199,1475,1674
00736202,MEDTECH COLLEGE - GREENWOOD             ,IN,46143-6478,Proprietary  ,23,134,157,127,700,827
00736204,MEDTECH COLLEGE - FORT WAYNE            ,IN,46804-2209,Proprietary  ,17,126,143,64,486,550
00793800,LINCOLN COLLEGE OF TECHNOLOGY           ,IN,46202-0000,Proprietary  ,376,356,732,2298,1424,3722
00832900,ITT TECHNICAL INSTITUTE                 ,IN,46825-2393,Proprietary  ,520,1529,2049,1404,3760,5164
00842300,IVY TECH COMMUNITY COLLEGE OF INDIANA - ,IN,46601-3892,Public       ,381,1953,2334,2500,8702,11202
00854600,NOT FOR STUDENT USE                     ,IN,46208-4700,Public       ,5,9,14,52,115,167
00854700,IVY TECH COMMUNITY COLLEGE OF INDIANA - ,IN,47802-4898,Public       ,277,1075,1352,2050,5115,7165
00951500,J MICHAEL HARROLD BEAUTY ACADEMY        ,IN,47807-3390,Proprietary  ,9,24,33,24,41,65
00961200,"APEX SCHOOL OF BEAUTY CULTURE, INC      ",IN,46016-0000,Proprietary  ,3,11,14,9,36,45
00961300,MERRILLVILLE BEAUTY COLLEGE             ,IN,46410-3401,Proprietary  ,18,65,83,30,102,132
00967300,RUDAE'S SCHOOL OF BEAUTY CULTURE        ,IN,46825-5444,Proprietary  ,26,65,91,96,157,253
00967301,RUDAE'S SCHOOL OF BEAUTY CULTURE - FORT ,IN,46825-5444,Proprietary  ,0,0,0,0,1,1
00977700,KAPLAN COLLEGE                          ,IN,46278-1736,Proprietary  ,54,330,384,382,1611,1993
00977702,KAPLAN COLLEGE - TEMPORARY FACILITY EXPA,IN,46268-4111,Proprietary  ,1,9,10,17,55,72
00977703,KAPLAN COLLEGE -  SE INDY               ,IN,46227-0000,Proprietary  ,51,256,307,135,564,699
00991700,IVY TECH COMMUNITY COLLEGE OF INDIANA - ,IN,46208-1763,Public       ,1155,4114,5269,8575,18442,27017
00992300,IVY TECH COMMUNITY COLLEGE OF INDIANA - ,IN,47250-1881,Public       ,153,577,730,886,2258,3144
00992400,IVY TECH COMMUNITY COLLEGE OF INDIANA - ,IN,47302-9448,Public       ,412,1693,2105,3461,7656,11117
00992500,IVY TECH COMMUNITY COLLEGE OF INDIANA - ,IN,47710-3398,Public       ,320,1194,1514,2080,4778,6858
00992600,IVY TECH COMMUNITY COLLEGE OF INDIANA- R,IN,46805-1489,Public       ,608,2412,3020,4184,10459,14643
01003700,IVY TECH STATE COLLEGE - REGION 9       ,IN,47374-1220,Public       ,171,919,1090,1018,3820,4838
01003800,IVY TECH COMMUNITY COLLEGE OF INDIANA - ,IN,47203-1868,Public       ,226,842,1068,1610,3882,5492
01003900,IVY TECH COMMUNITY COLLEGE OF INDIANA - ,IN,47903-6299,Public       ,394,1173,1567,3061,5436,8497
01004000,IVY TECH COMMUNITY COLLEGE OF INDIANA - ,IN,46409-1303,Public       ,561,2147,2708,2519,7408,9927
01004100,IVY TECH STATE COLLEGE - REGION 5       ,IN,46903-1373,Public       ,237,1276,1513,1512,5215,6727
01010900,IVY TECH COMMUNITY COLLEGE OF INDIANA - ,IN,47172-1897,Public       ,251,837,1088,1332,3324,4656
01015100,VINCENNES BEAUTY COLLEGE                ,IN,47591-1297,Proprietary  ,8,13,21,25,44,69
01040900,LAFAYETTE BEAUTY ACADEMY                ,IN,47901-1149,Proprietary  ,10,28,38,36,96,132
01061800,MID-AMERICA CLG FUNERAL SERVICE         ,IN,47130-9990,Private      ,11,44,55,43,114,157
01150500,CREATIVE HAIR STYLING ACADEMY           ,IN,46322-1554,Proprietary  ,13,26,39,38,72,110
02084800,RAVENSCROFT BEAUTY COLLEGE              ,IN,46815-0000,Proprietary  ,22,95,117,65,178,243
02087600,CONCORDIA THEOLOGICAL SEMINARY          ,IN,46825-0000,Private      ,1,18,19,3,252,255
02100402,EVEREST INSTITUTE - EVEREST COLLEGE     ,IN,46410-5683,Proprietary  ,71,355,426,201,951,1152
02140800,MARTIN UNIVERSITY                       ,IN,46218-0000,Private      ,50,349,399,184,1271,1455
02158400,HARRISON COLLEGE                        ,IN,46204-2611,Proprietary  ,103,684,787,661,3184,3845
02158401,HARRISON COLLEGE - COLUMBUS             ,IN,47203-1843,Proprietary  ,11,68,79,81,382,463
02158402,HARRISON COLLEGE - LAFAYETTE            ,IN,47905-4859,Proprietary  ,10,70,80,91,404,495
02158404,HARRISON COLLEGE - MARION               ,IN,46952-0000,Proprietary  ,2,7,9,31,109,140
02158405,HARRISON COLLEGE - TERRE HAUTE          ,IN,47802-0000,Proprietary  ,14,89,103,87,469,556
02158407,HARRISON COLLEGE - ANDERSON             ,IN,46013-0000,Proprietary  ,11,86,97,95,409,504
02158409,HARRISON COLLEGE - EVANSVILLE           ,IN,47715-3901,Proprietary  ,4,71,75,89,403,492
02158410,HARRISON COLLEGE - EAST                 ,IN,46239-8903,Proprietary  ,27,161,188,214,935,1149
02158412,HARRISON COLLEGE - FORT WAYNE           ,IN,46825-0000,Proprietary  ,22,115,137,225,790,1015
02158413,HARRISON COLLEGE - NORTHWEST            ,IN,46278-0000,Proprietary  ,16,57,73,176,412,588
02158800,DON ROBERTS BEAUTY SCHOOLS              ,IN,46383-0000,Proprietary  ,10,20,30,27,34,61
02164300,DON ROBERTS SCHOOL OF HAIR DESIGN       ,IN,46375-9999,Proprietary  ,14,19,33,27,56,83
02201800,KAPLAN COLLEGE                          ,IN,46410-0000,Proprietary  ,41,199,240,157,696,853
02201802,KAPLAN COLLEGE - HAMMOND                ,IN,46324-3347,Proprietary  ,47,238,285,196,948,1144
02241700,PJ'S COLLEGE OF COSMETOLOGY             ,IN,47129-0000,Proprietary  ,30,69,99,53,151,204
02302700,J EVERETT LIGHT CAREER CENTER           ,IN,46240-0000,Public       ,4,20,24,51,186,237
02304800,PJ'S COLLEGE OF COSMETOLOGY             ,IN,47374-0000,Proprietary  ,5,26,31,17,71,88
02308900,MASTER'S OF COSMETOLOGY COLLEGE         ,IN,46809-0000,Proprietary  ,12,21,33,70,74,144
02339600,ROGER'S ACADEMY OF HAIR DESIGN          ,IN,47712-0000,Proprietary  ,33,59,92,91,145,236
02345200,EMPIRE BEAUTY SCHOOL                    ,IN,46237-0000,Proprietary  ,21,86,107,89,320,409
02351300,KNOX BEAUTY COLLEGE                     ,IN,46534-0000,Proprietary  ,0,9,9,6,29,35
02490500,HAIR FASHIONS BY KAYE BEAUTY CLG        ,IN,46250-0000,Proprietary  ,5,23,28,30,104,134
02490800,HAIR FASHIONS BY KAYE BEAUTY CLG        ,IN,46060-0000,Proprietary  ,14,63,77,42,160,202
02607000,HAIR ARTS ACADEMY                       ,IN,47404-3581,Proprietary  ,3,17,20,15,50,65
02615800,COLLEGE OF COURT REPORTING              ,IN,46342-5969,Proprietary  ,6,96,102,26,336,362
02616203,BROWN MACKIE COLLEGE-FINDLAY - INDIANAPO,IN,46204-1017,Proprietary  ,61,459,520,264,1677,1941
03009700,HARRISON COLLEGE                        ,IN,47303-6413,Proprietary  ,13,53,66,79,375,454
03009701,HARRISON COLLEGE - MUNCIE - ELKHART     ,IN,46516-9795,Proprietary  ,11,80,91,84,472,556
03084601,THE ART INSTITUTE OF INDIANAPOLIS       ,IN,46268-1170,Proprietary  ,111,212,323,1118,1066,2184
03100600,MARION COMM TUCKER AREA VOC SCHOOL      ,IN,46952-3831,Public       ,5,21,26,47,114,161
03176300,AMERICAN TRANS AIR AVIATION ACADEMY     ,IN,46241-1445,Proprietary  ,10,77,87,54,290,344
03262300,DAVID DEMUTH INSTITUTE OF COSM          ,IN,47374-4101,Proprietary  ,6,6,12,14,46,60
03456700,CROSSROADS BIBLE COLLEGE                ,IN,46219-4912,Private      ,8,61,69,66,216,282
03521300,IVY TECH COMMUNITY COLLEGE OF INDIANA - ,IN,47404-9772,Public       ,353,876,1229,2901,4337,7238
03538300,ALEXANDRIA SCH OF SCIENTIFIC THERAP     ,IN,46001-0287,Proprietary  ,4,15,19,30,66,96
04038700,IDEAL BEAUTY ACADEMY                    ,IN,47130-4215,Proprietary  ,9,27,36,22,62,84
04100300,SUCCESS SCHOOLS                         ,IN,46410-5310,Proprietary  ,10,49,59,24,118,142
04121000,TECHSKILLS - INDIANAPOLIS               ,IN,46240-4302,Proprietary  ,1,80,81,17,170,187
04130900,HONORS BEAUTY COLLEGE                   ,IN,46256-3317,Proprietary  ,13,46,59,61,163,224
00163203,AQUINAS INSTITUTE OF THEOLOGY - MINISTRY,KS,66109-3718,Private      ,0,2,2,0,2,2
00190100,ALLEN COUNTY COMMUNITY COLLEGE          ,KS,66749-1607,Public       ,254,435,689,886,1135,2021
00190200,COWLEY COUNTY COMMUNITY COLLEGE & AREA V,KS,67005-2662,Public       ,368,768,1136,1256,1998,3254
00190300,BAKER UNIVERSITY                        ,KS,66006-0065,Private      ,68,669,737,1562,2251,3813
00190400,BETHANY COLLEGE                         ,KS,67456-1897,Private      ,71,28,99,754,115,869
00190500,BETHEL COLLEGE                          ,KS,67117-0531,Private      ,33,29,62,469,115,584
00190600,BUTLER COUNTY COMMUNITY COLLEGE         ,KS,67042-3280,Public       ,810,1430,2240,3338,4047,7385
00190700,CENTRAL BAPTIST THEOLOGY SEMINARY       ,KS,66226-3513,Private      ,0,13,13,0,29,29
00190800,CENTRAL CHRISTIAN COLLEGE OF KANSAS     ,KS,67460-5799,Private      ,24,11,35,454,60,514
00190900,CLOUD COUNTY COMMUNITY COLLEGE          ,KS,66901-1002,Public       ,138,302,440,737,840,1577
00191000,COFFEYVILLE COMMUNITY COLLEGE           ,KS,67337-5064,Public       ,236,174,410,972,463,1435
00191100,COLBY COMMUNITY COLLEGE                 ,KS,67701-4099,Public       ,120,111,231,551,316,867
00191300,DODGE CITY COMMUNITY COLLEGE            ,KS,67801-2399,Public       ,149,243,392,586,483,1069
00191400,DONNELLY COLLEGE                        ,KS,66102-4298,Private      ,73,408,481,168,638,806
00191500,FORT HAYS STATE UNIVERSITY              ,KS,67601-4099,Public       ,361,896,1257,3367,3632,6999
00191600,FORT SCOTT COMMUNITY COLLEGE            ,KS,66701-3199,Public       ,221,266,487,1088,797,1885
00191700,BARCLAY COLLEGE                         ,KS,67059-0288,Private      ,27,34,61,112,87,199
00191800,FRIENDS UNIVERSITY                      ,KS,67213-3397,Private      ,105,615,720,1165,2485,3650
00191900,GARDEN CITY COMMUNITY COLLEGE           ,KS,67846-6398,Public       ,170,169,339,802,517,1319
00192000,HESSTON COLLEGE                         ,KS,67062-2093,Private      ,19,14,33,438,152,590
00192100,HIGHLAND COMMUNITY COLLEGE              ,KS,66035-4062,Public       ,245,392,637,1073,1007,2080
00192114,HIGHLAND COMMUNITY COLLEGE - NOTHEAST KA,KS,66002-1513,Public       ,20,42,62,71,114,185
00192300,HUTCHINSON COMMUNITY COLLEGE            ,KS,67501-5894,Public       ,355,769,1124,1809,1920,3729
00192400,INDEPENDENCE COMMUNITY COLLEGE          ,KS,67301-0000,Public       ,129,181,310,464,346,810
00192500,KANSAS CITY KANSAS COMMUNITY CLG        ,KS,66112-9978,Public       ,563,1394,1957,1542,3483,5025
00192502,"KANSAS CITY KS AREA TECH SCHOOL, KS     ",KS,66104-0000,Public       ,21,70,91,73,206,279
00192600,PITTSBURG STATE UNIVERSITY              ,KS,66762-7500,Public       ,624,665,1289,4408,2410,6818
00192700,EMPORIA STATE UNIVERSITY                ,KS,66801-5087,Public       ,375,469,844,3085,2497,5582
00192800,KANSAS STATE UNIVERSITY                 ,KS,66506-1104,Public       ,1214,1101,2315,13975,5526,19501
00192900,KANSAS WESLEYAN UNIVERSITY              ,KS,67401-6196,Private      ,31,78,109,884,391,1275
00193000,LABETTE COMMUNITY COLLEGE               ,KS,67357-4299,Public       ,144,306,450,545,722,1267
00193100,MANHATTAN CHRISTIAN COLLEGE             ,KS,66502-4081,Private      ,35,31,66,280,111,391
00193300,MCPHERSON COLLEGE                       ,KS,67460-3899,Private      ,18,22,40,633,154,787
00193600,NEOSHO COUNTY COMMUNITY COLLEGE         ,KS,66720-2699,Public       ,139,232,371,537,801,1338
00193700,OTTAWA UNIVERSITY                       ,KS,66067-3399,Private      ,77,790,867,927,2133,3060
00193800,PRATT COMMUNITY COLLEGE                 ,KS,67124-8432,Public       ,130,158,288,536,518,1054
00193900,NEWMAN UNIVERSITY                       ,KS,67213-2084,Private      ,91,302,393,1029,1297,2326
00194000,SOUTHWESTERN COLLEGE                    ,KS,67156-2499,Private      ,46,280,326,702,1090,1792
00194300,UNIVERSITY OF ST MARY                   ,KS,66048-5023,Private      ,70,193,263,564,598,1162
00194500,STERLING COLLEGE                        ,KS,67579-1533,Private      ,79,48,127,828,178,1006
00194600,TABOR COLLEGE                           ,KS,67063-1799,Private      ,38,69,107,655,190,845
00194800,UNIVERSITY OF KANSAS                    ,KS,66045-7535,Public       ,1318,1242,2560,15349,9315,24664
00194900,WASHBURN UNIVERSITY                     ,KS,66621-1110,Public       ,361,757,1118,2979,4093,7072
00195000,WICHITA STATE UNIVERSITY                ,KS,67208-0001,Public       ,900,1656,2556,6126,6981,13107
00460800,BARTON COUNTY COMMUNITY COLLEGE         ,KS,67530-9283,Public       ,141,436,577,739,1159,1898
00526400,FLINT HILLS TECHNICAL COLLEGE           ,KS,66801-5999,Public       ,64,98,162,221,314,535
00526500,NORTH CENTRAL KANSAS TECH COLG          ,KS,67420-0000,Public       ,71,78,149,363,273,636
00526700,NORTHWEST KANSAS TECHNICAL SCHOOL       ,KS,67735-3441,Public       ,37,38,75,209,103,312
00549800,WICHITA AREA TECHNICAL COLLEGE          ,KS,67211-2099,Public       ,149,748,897,378,1706,2084
00549900,SALINA AREA TECHNICAL COLLEGE           ,KS,67401-8195,Public       ,29,80,109,147,175,322
00550000,MANHATTAN AREA TECHNICAL COLLEGE        ,KS,66503-2499,Public       ,57,130,187,271,422,693
00675500,BROWN MACKIE COLLEGE (THE)              ,KS,67401-7307,Proprietary  ,133,496,629,278,1272,1550
00703200,MID AMERICA NAZARENE UNIVERSITY         ,KS,66062-1899,Private      ,65,240,305,963,865,1828
00822800,SEWARD CO COMM CO/AREA TECHNICAL SCHOOL ,KS,67905-0000,Public       ,136,154,290,409,381,790
00824400,JOHNSON COUNTY COMMUNITY COLLEGE        ,KS,66210-1299,Public       ,1039,1848,2887,5018,6099,11117
00833200,B-STREET DESIGN SCHOOL OF INTERNATIONAL ,KS,66502-6082,Proprietary  ,12,38,50,30,92,122
00868200,ACADEMY OF HAIR DESIGN                  ,KS,67401-2803,Proprietary  ,10,11,21,28,45,73
01025600,BENEDICTINE COLLEGE                     ,KS,66002-1499,Private      ,120,35,155,1870,122,1992
01043800,HASKELL INDIAN NATIONS UNIVERSITY       ,KS,66046-4800,Public       ,221,198,419,888,656,1544
01050300,WICHITA TECHNICAL INSTITUTE             ,KS,67213-1927,Proprietary  ,72,427,499,247,1643,1890
01050302,WICHITA TECHNICAL INSTITUTE - WTI TOPEKA,KS,66609-1217,Proprietary  ,19,122,141,21,133,154
01050305,WICHITA TECHNICAL INSTITUTE - EAST CAMPU,KS,67208-4243,Proprietary  ,11,91,102,17,128,145
01068900,KAW AREA TECHNICAL SCHOOL               ,KS,66604-2199,Public       ,49,123,172,188,423,611
02090700,CLEVELAND CHIROPRACTIC COLLEGE          ,KS,66210-1613,Private      ,10,116,126,42,538,580
02134800,OLD TOWN BARBER AND BEAUTY COLLEGE      ,KS,67211-0000,Proprietary  ,9,21,30,30,69,99
02196400,CAPITOL CITY HAIR DESIGN COLLEGE        ,KS,66102-0000,Proprietary  ,18,98,116,22,122,144
02257700,HAYS ACADEMY OF HAIR DESIGN             ,KS,67601-0000,Proprietary  ,12,24,36,39,59,98
02303500,AMERICAN INSTITUTE OF BAKING            ,KS,66502-0000,Private      ,0,4,4,5,9,14
02340700,LABARON HAIRDRESSING ACADEMY            ,KS,66204-0000,Proprietary  ,4,28,32,10,39,49
02590900,WRIGHT CAREER COLLEGE                   ,KS,66212-0000,Private      ,130,796,926,234,1691,1925
02599709,VATTEROTT COLLEGE - WICHITA             ,KS,67226-1304,Proprietary  ,25,182,207,73,486,559
02603100,XENON INTERNATIONAL ACADEMY             ,KS,67203-5428,Proprietary  ,40,70,110,119,200,319
02606300,PAUL MITCHELL THE SCHOOL WICHITA        ,KS,67226-2803,Proprietary  ,31,38,69,60,79,139
02611005,HERITAGE COLLEGE - WICHITA              ,KS,67210-1879,Proprietary  ,60,378,438,181,940,1121
02613000,PINNACLE CAREER INSTITUTE               ,KS,66046-2703,Proprietary  ,19,87,106,52,239,291
03031300,XENON INTERNATIONAL ACADEMY IV          ,KS,66061-3765,Proprietary  ,18,36,54,35,73,108
03066200,BRYAN COLLEGE                           ,KS,66604-2496,Proprietary  ,13,61,74,36,223,259
03450300,B-STREET DESIGN SCHOOL OF INTERNATIONAL ,KS,66611-2373,Proprietary  ,18,58,76,42,99,141
03450301,B-STREET DESIGN SCHOOL OF INTERNATIONAL ,KS,67207-5148,Proprietary  ,11,57,68,30,88,118
03450302,B-STREET DESIGN SCHOOL OF INTERNATIONAL ,KS,66212-5451,Proprietary  ,24,70,94,47,114,161
03529300,SIDNEY'S HAIRDRESSING COLLEGE           ,KS,67501-7094,Proprietary  ,10,17,27,36,57,93
03862300,BMSI INSTITUTE                          ,KS,66212-3388,Proprietary  ,0,1,1,3,11,14
04132900,Z HAIR ACADEMY                          ,KS,66046-4040,Proprietary  ,8,9,17,28,55,83
00203300,UNIVERSITY OF MAINE-PRESQUE ISLE        ,ME,04769-2888,Public       ,59,96,155,729,458,1187
00203500,BANGOR THEOLOGICAL SEMINARY             ,ME,04402-0411,Private      ,0,9,9,2,82,84
00203600,BATES COLLEGE                           ,ME,04240-6028,Private      ,32,9,41,2706,53,2759
00203800,BOWDOIN COLLEGE                         ,ME,04011-8451,Private      ,29,7,36,3604,60,3664
00203900,COLBY COLLEGE                           ,ME,04901-8841,Private      ,37,8,45,2842,52,2894
00204000,UNIVERSITY OF MAINE-FARMINGTON          ,ME,04938-1990,Public       ,70,61,131,2502,424,2926
00204100,UNIVERSITY OF MAINE-FORT KENT           ,ME,04743-1292,Public       ,33,65,98,474,287,761
00204300,HUSSON UNIVERSITY                       ,ME,04401-2999,Private      ,131,207,338,2344,1102,3446
00204400,MAINE MARITIME ACADEMY                  ,ME,04420-0001,Public       ,25,20,45,963,133,1096
00205000,UNIVERSITY OF NEW ENGLAND               ,ME,04005-9599,Private      ,62,335,397,3823,2538,6361
00205100,SAINT JOSEPH'S COLLEGE                  ,ME,04084-5263,Private      ,36,141,177,1563,494,2057
00205200,THOMAS COLLEGE                          ,ME,04901-5097,Private      ,65,50,115,900,213,1113
00205300,UNIVERSITY OF MAINE                     ,ME,04469-0001,Public       ,313,385,698,10465,2952,13417
00205400,UNIVERSITY OF SOUTHERN MAINE            ,ME,04104-0000,Public       ,354,661,1015,6288,4688,10976
00205500,UNIVERSITY OF MAINE-MACHIAS             ,ME,04654-1397,Public       ,44,74,118,510,292,802
00520400,BEAL COLLEGE                            ,ME,04401-6896,Proprietary  ,40,156,196,206,529,735
00527600,CENTRAL MAINE COMMUNITY COLLEGE         ,ME,04210-6498,Public       ,165,337,502,1392,1530,2922
00527700,EASTERN MAINE COMMUNITY COLLEGE         ,ME,04401-4280,Public       ,175,358,533,1416,1365,2781
00552500,SOUTHERN MAINE COMMUNITY  COLLEGE       ,ME,04106-1698,Public       ,460,630,1090,3082,2663,5745
00576000,NORTHERN MAINE COMMUNITY COLLEGE        ,ME,04769-2016,Public       ,74,188,262,457,730,1187
00577600,MERCY HOSP SCH OF RADIOLOGIC TECH       ,ME,04101-3795,Private      ,1,7,8,20,38,58
00630501,CENTRAL MAINE MEDICAL CENTER - COLLEGE O,ME,04240-4500,Private      ,5,24,29,52,207,259
00676000,UNIVERSITY OF MAINE-AUGUSTA             ,ME,04330-9410,Public       ,205,904,1109,1529,4663,6192
00685800,UNITY COLLEGE                           ,ME,04988-9502,Private      ,23,17,40,914,83,997
00903800,MR BERNARD'S SCH HAIR FASHION INC       ,ME,04243-1163,Proprietary  ,16,36,52,42,144,186
00923100,WASHINGTON COUNTY COMMUNITY COLLEGE     ,ME,04619-9704,Public       ,30,90,120,263,320,583
00929200,ANDOVER COLLEGE                         ,ME,04106-2415,Proprietary  ,55,187,242,209,767,976
00929201,ANDOVER COLLEGE -                       ,ME,04240-0000,Proprietary  ,47,181,228,179,875,1054
00945900,EMPIRE BEAUTY SCHOOL                    ,ME,04101-3348,Proprietary  ,44,102,146,151,306,457
00945902,PIERRE'S SCHOOL OF COSMETOLOGY - CARIBOU,ME,04736-2020,Proprietary  ,0,2,2,5,5,10
00945903,EMPIRE BEAUTY SCHOOL - BANGOR           ,ME,04401-6534,Proprietary  ,1,4,5,19,20,39
00982600,KENNEBEC VALLEY  COMMUNITY  COLLEGE     ,ME,04937-1367,Public       ,100,329,429,705,1466,2171
01138500,COLLEGE OF THE ATLANTIC                 ,ME,04609-1105,Private      ,9,11,20,414,63,477
01167300,MAINE COLLEGE OF ART                    ,ME,04101-3987,Private      ,14,22,36,527,214,741
02104400,SPA TECH INSTITUTE                      ,ME,04102-0000,Proprietary  ,64,164,228,149,385,534
02347100,NEW ENGLAND SCHOOL OF COMMUNICATIONS    ,ME,04401-0000,Private      ,29,21,50,575,102,677
02361300,LANDING SCHOOL OF BOATBUILDING & DESIGN ,ME,04046-1490,Private      ,4,18,22,25,56,81
03122900,YORK COUNTY COMMUNITY COLLEGE           ,ME,04090-0529,Public       ,113,199,312,471,624,1095
03429300,SEACOAST CAREER SCHOOLS                 ,ME,04073-0000,Proprietary  ,67,312,379,121,588,709
03612300,BIRTHWISE MIDWIFERY SCHOOL              ,ME,04009-1110,Proprietary  ,0,6,6,9,45,54
00209300,ST JOHN'S COLLEGE                       ,NM,87505-4599,Private      ,12,34,46,445,192,637
00264900,COLLEGE OF SANTA FE                     ,NM,87505-7634,Private      ,24,44,68,442,219,661
00265000,UNIVERSITY OF THE SOUTHWEST             ,NM,88240-9129,Private      ,43,150,193,319,382,701
00265100,EASTERN NEW MEXICO UNIV PORTALES        ,NM,88130-6000,Public       ,485,831,1316,2485,2229,4714
00265101,EASTERN NEW MEXICO UNIV-ROSWELL CAM     ,NM,88202-0000,Public       ,274,567,841,965,1388,2353
00265300,NEW MEXICO HIGHLANDS UNIVERSITY         ,NM,87701-4436,Public       ,240,495,735,1572,2038,3610
00265400,NEW MEXICO INST OF MINING & TECH        ,NM,87801-4796,Public       ,125,90,215,909,347,1256
00265500,NEW MEXICO JUNIOR COLLEGE               ,NM,88240-9123,Public       ,252,404,656,698,874,1572
00265600,NEW MEXICO MILITARY INSTITUTE           ,NM,88201-5173,Public       ,81,6,87,320,29,349
00265700,NEW MEXICO STATE UNIVERSITY             ,NM,88003-8001,Public       ,1454,2050,3504,10326,8358,18684
00265701,NEW MEXICO STATE UNIV-ALAMOGORDO        ,NM,88311-0000,Public       ,120,376,496,376,1002,1378
00265702,NEW MEXICO STATE UNIV.-DONA ANA CLG     ,NM,88003-0000,Public       ,442,886,1328,1879,2893,4772
00265703,NEW MEXICO STATE UNIV-CARLSBAD          ,NM,88220-0000,Public       ,130,242,372,308,578,886
00265704,NEW MEXICO STATE UNIV-GRANTS            ,NM,87020-0000,Public       ,77,185,262,178,419,597
00266000,SAN JUAN COLLEGE                        ,NM,87402-4699,Public       ,534,1215,1749,1483,3022,4505
00266300,THE UNIVERSITY OF NEW MEXICO            ,NM,87131-0001,Public       ,2367,3542,5909,13055,14300,27355
00266301,UNIV OF NEW MEXICO - GALLUP BRANCH      ,NM,87301-5697,Public       ,144,243,387,451,663,1114
00266302,UNIV OF NEW MEXICO - VALENCIA BRANCH    ,NM,87031-0000,Public       ,91,110,201,325,415,740
00266303,UNIV OF NEW MEXICO - LOS ALAMOS         ,NM,87544-0000,Public       ,22,22,44,125,90,215
00266304,UNIVERSITY OF NEW MEXICO                ,NM,87571-6401,Public       ,21,56,77,146,269,415
00266400,WESTERN NEW MEXICO UNIVERSITY           ,NM,88061-5417,Public       ,254,618,872,971,1753,2724
00369109,MIDDLEBURY COLLEGE - INSTITUTE OF AMERIC,NM,87505-0000,Private      ,1,1,2,4,2,6
00405701,NATIONAL AMERICAN UNIVERSITY            ,NM,87110-0000,Proprietary  ,8,81,89,21,280,301
00474200,CENTRAL NEW MEXICO COMMUNITY COLLEGE    ,NM,87106-4096,Public       ,2581,5950,8531,6189,13593,19782
00474300,CLOVIS COMMUNITY COLLEGE                ,NM,88101-8381,Public       ,226,779,1005,518,1409,1927
00996200,LUNA COMMUNITY COLLEGE                  ,NM,87701-0000,Public       ,127,210,337,390,516,906
01063200,DEWOLFF CLG HAIRSTYLING/COSMETOLOGY     ,NM,87112-4113,Proprietary  ,17,65,82,34,130,164
01300500,OLYMPIAN UNIVERSITY OF COSMETOLOGY      ,NM,88310-5051,Proprietary  ,105,269,374,338,898,1236
02083900,NORTHERN NEW MEXICO COLLEGE             ,NM,87530-0000,Public       ,204,331,535,583,885,1468
02146400,INSTITUTE OF AMERICAN INDIAN ARTS       ,NM,87508-0000,Public       ,42,64,106,157,224,381
02218808,BROOKLINE COLLEGE - ALBUQUERQUE         ,NM,87105-1649,Proprietary  ,48,190,238,76,321,397
02278100,SANTA FE COMMUNITY COLLEGE              ,NM,87507-0000,Public       ,298,575,873,726,1510,2236
02293203,ATI CAREER TRAINING CENTER - ALBUQUERQUE,NM,87109-2016,Proprietary  ,5,18,23,16,55,71
02357600,CROWNPOINT INSTITUTE OF TECHNOLOGY      ,NM,87313-0000,Public       ,123,300,423,249,539,788
02511000,SOUTHWESTERN INDIAN POLYTECH INST       ,NM,87184-0000,Public       ,145,169,314,278,368,646
02572003,COMPUTER CAREER CENTER - LAS CRUCES CAMP,NM,88011-8220,Proprietary  ,26,107,133,45,284,329
02622000,SOUTHWEST ACUPUNCTURE COLLEGE           ,NM,87505-0000,Proprietary  ,0,32,32,2,252,254
03076100,SOUTHWESTERN COLLEGE                    ,NM,87507-0000,Private      ,0,29,29,7,157,164
03206300,MESALANDS COMMUNITY COLLEGE             ,NM,88401-3352,Public       ,56,111,167,143,262,405
03430300,UNIVERSAL THERAPEUTIC MASSAGE INSTITUTE ,NM,87107-4403,Proprietary  ,8,39,47,22,81,103
03678300,PIMA MEDICAL INSTITUTE                  ,NM,87110-4127,Proprietary  ,13,36,49,43,112,155
03944300,MASSAGE THERAPY TRAINING INSTITUTE      ,NM,88007-0000,Proprietary  ,9,21,30,17,42,59
00223400,ADRIAN COLLEGE                          ,MI,49221-2575,Private      ,113,73,186,2686,253,2939
00223500,ALBION COLLEGE                          ,MI,49224-1831,Private      ,82,26,108,2245,97,2342
00223600,ALMA COLLEGE                            ,MI,48801-1599,Private      ,37,30,67,2116,116,2232
00223700,ALPENA COMMUNITY COLLEGE                ,MI,49707-1495,Public       ,275,424,699,1019,1141,2160
00223800,ANDREWS UNIVERSITY                      ,MI,49104-0750,Private      ,264,322,586,1696,1241,2937
00223900,AQUINAS COLLEGE                         ,MI,49506-1799,Private      ,100,171,271,2373,713,3086
00224000,BAY DE NOC COMMUNITY COLLEGE            ,MI,49829-2524,Public       ,270,599,869,1283,1489,2772
00224100,CALVIN COLLEGE                          ,MI,49546-4388,Private      ,129,86,215,4195,362,4557
00224200,CALVIN THEOLOGICAL SEMINARY             ,MI,49546-4387,Private      ,1,13,14,12,145,157
00224300,CENTRAL MICHIGAN UNIVERSITY             ,MI,48859-0001,Public       ,1336,2320,3656,20896,9575,30471
00224600,CLEARY UNIVERSITY                       ,MI,48105-2659,Private      ,46,220,266,169,769,938
00224700,CONCORDIA UNIVERSITY-ANN ARBOR          ,MI,48105-2797,Private      ,50,132,182,538,345,883
00224800,CRANBROOK ACADEMY OF ART                ,MI,48303-0000,Private      ,1,18,19,17,321,338
00224900,DAVENPORT UNIVERSITY                    ,MI,49503-0000,Private      ,483,3377,3860,3396,13297,16693
00225100,DELTA COLLEGE                           ,MI,48710-0001,Public       ,952,2249,3201,5908,7698,13606
00225400,MICHIGAN STATE UNIVERSITY COLLEGE OF LAW,MI,48824-1300,Private      ,26,146,172,333,1882,2215
00225900,EASTERN MICHIGAN UNIVERSITY             ,MI,48197-2214,Public       ,1811,3461,5272,14784,12404,27188
00226000,FERRIS STATE UNIVERSITY                 ,MI,49307-2251,Public       ,893,1302,2195,12300,6445,18745
00226100,CHARLES STEWART MOTT COMMUNITY CLG      ,MI,48503-2089,Public       ,1780,4258,6038,5504,10698,16202
00226200,KETTERING UNIVERSITY                    ,MI,48504-4898,Private      ,119,117,236,2482,414,2896
00226300,GLEN OAKS COMMUNITY COLLEGE             ,MI,49032-9784,Public       ,124,400,524,579,1114,1693
00226400,GOGEBIC COMMUNITY COLLEGE               ,MI,49938-1365,Public       ,113,191,304,631,608,1239
00226500,GRACE BIBLE COLLEGE                     ,MI,49509-1998,Private      ,20,15,35,239,69,308
00226600,CORNERSTONE UNIVERSITY                  ,MI,49525-5897,Private      ,80,470,550,1540,1713,3253
00226700,GRAND RAPIDS COMMUNITY COLLEGE          ,MI,49503-3295,Public       ,1673,3586,5259,9939,10937,20876
00226800,GRAND VALLEY STATE UNIVERSITY           ,MI,49401-9403,Public       ,1050,1550,2600,21157,7601,28758
00226900,GREAT LAKES CHRISTIAN COLLEGE           ,MI,48917-1299,Private      ,20,22,42,189,145,334
00227000,HENRY FORD COMMUNITY COLLEGE            ,MI,48128-1495,Public       ,2502,4736,7238,8973,14379,23352
00227300,HOPE COLLEGE                            ,MI,49423-3607,Private      ,71,30,101,3939,169,4108
00227400,JACKSON COMMUNITY COLLEGE               ,MI,49201-8399,Public       ,867,2454,3321,3710,6254,9964
00227500,KALAMAZOO COLLEGE                       ,MI,49006-3295,Private      ,42,40,82,1834,133,1967
00227600,KELLOGG COMMUNITY COLLEGE               ,MI,49017-3397,Public       ,585,1701,2286,2403,5076,7479
00227700,LAKE MICHIGAN COLLEGE                   ,MI,49022-1899,Public       ,452,1184,1636,1789,3134,4923
00227800,LANSING COMMUNITY COLLEGE               ,MI,48933-1293,Public       ,2053,4681,6734,8369,12641,21010
00227900,LAWRENCE TECHNOLOGICAL UNIVERSITY       ,MI,48075-1058,Private      ,191,666,857,1822,1871,3693
00228200,MADONNA UNIVERSITY                      ,MI,48150-1173,Private      ,199,829,1028,1485,3048,4533
00228400,MARYGROVE COLLEGE                       ,MI,48221-2599,Private      ,127,1135,1262,713,2882,3595
00228800,ROCHESTER COLLEGE                       ,MI,48307-2764,Private      ,90,169,259,584,622,1206
00228801,ROCHESTER COLLEGE - MACOMB COMMUNITY COL,MI,48038-1139,Private      ,145,351,496,574,787,1361
00228802,ROCHESTER COLLEGE - MOTT COMMUNITY COLLE,MI,48503-2089,Private      ,50,151,201,214,340,554
00228803,ROCHESTER COLLEGE  - SPECS HOWARD       ,MI,48075-3953,Private      ,4,21,25,27,48,75
00229000,MICHIGAN STATE UNIVERSITY               ,MI,48824-1113,Public       ,2105,1771,3876,34261,12244,46505
00229200,MICHIGAN TECHNOLOGICAL UNIV             ,MI,49931-1295,Public       ,272,151,423,5967,1006,6973
00229300,LAKE SUPERIOR STATE UNIVERSITY          ,MI,49783-1691,Public       ,175,212,387,2339,885,3224
00229400,MONROE COUNTY COMMUNITY CLG             ,MI,48161-9746,Public       ,389,817,1206,1539,2259,3798
00229500,MONTCALM COMMUNITY COLLEGE              ,MI,48885-9723,Public       ,207,629,836,954,1819,2773
00229700,MUSKEGON COMMUNITY COLLEGE              ,MI,49442-1432,Public       ,496,1256,1752,2902,4023,6925
00229900,NORTH CENTRAL MICHIGAN COLLEGE          ,MI,49770-8740,Public       ,183,536,719,960,1872,2832
00230100,NORTHERN MICHIGAN UNIVERSITY            ,MI,49855-5316,Public       ,746,657,1403,7542,2796,10338
00230200,NORTHWESTERN MICHIGAN COLLEGE           ,MI,49686-3061,Public       ,371,849,1220,2426,2981,5407
00230300,OAKLAND COMMUNITY COLLEGE               ,MI,48304-2266,Public       ,0,0,0,75,63,138
00230301,OAKLAND COMMUNITY COLLEGE - ORCHARD RIDG,MI,48334-4579,Public       ,649,1245,1894,2204,3224,5428
00230302,OAKLAND COMMUNITY COLLEGE - ROYAL OAK CA,MI,48067-3898,Public       ,819,1787,2606,2543,4630,7173
00230303,OAKLAND COMMUNITY COLLEGE - SOUTHFIELD C,MI,48075-4793,Public       ,568,1522,2090,1940,4374,6314
00230304,OAKLAND COMMUNITY COLLEGE - AUBURN HILLS,MI,48323-2845,Public       ,826,2032,2858,3127,5191,8318
00230305,OAKLAND COMMUNITY COLLEGE - HIGHLAND LAK,MI,48327-4187,Public       ,480,996,1476,1604,2771,4375
00230700,OAKLAND UNIVERSITY                      ,MI,48309-4401,Public       ,1327,2391,3718,12687,8818,21505
00230800,OLIVET COLLEGE                          ,MI,49076-9902,Private      ,63,71,134,1491,356,1847
00231000,ST. CLAIR COUNTY COMMUNITY COLLEGE      ,MI,48061-0000,Public       ,393,1132,1525,2086,3583,5669
00231100,KUYPER COLLEGE                          ,MI,49525-9749,Private      ,18,25,43,357,138,495
00231300,SACRED HEART MAJOR SEMINARY             ,MI,48206-1799,Private      ,3,45,48,36,155,191
00231400,SAGINAW VALLEY STATE UNIV               ,MI,48710-0001,Public       ,449,823,1272,8790,3882,12672
00231500,SCHOOLCRAFT COLLEGE                     ,MI,48152-2696,Public       ,1215,2572,3787,5373,7793,13166
00231600,SIENA HEIGHTS UNIVERSITY                ,MI,49221-1796,Private      ,108,413,521,1113,1691,2804
00231700,SOUTHWESTERN MICHIGAN COLLEGE           ,MI,49047-9793,Public       ,280,758,1038,1435,2101,3536
00231800,SPRING ARBOR UNIVERSITY                 ,MI,49283-9984,Private      ,103,859,962,2186,3264,5450
00232200,FINLANDIA UNIVERSITY                    ,MI,49930-1882,Private      ,56,73,129,540,292,832
00232300,UNIVERSITY OF DETROIT MERCY             ,MI,48221-3038,Private      ,256,1003,1259,3028,3768,6796
00232303,UNIV OF DETROIT MERCY - LAW SCHOOL      ,MI,48226-0000,Private      ,5,118,123,18,935,953
00232330,UNIV OF DETROIT MERCY - DENTAL SCHOOL   ,MI,48208-2576,Private      ,5,42,47,51,409,460
00232500,UNIVERSITY OF MICHIGAN - ANN ARBOR      ,MI,48109-1316,Public       ,803,1337,2140,26270,11642,37912
00232501,UNIVERSITY OF MICHIGAN-MEDICAL SCH      ,MI,48109-0000,Public       ,15,51,66,147,1133,1280
00232503,UNIVERSITY OF MICHIGAN LAW SCHOOL       ,MI,48109-0000,Public       ,5,59,64,44,2806,2850
00232600,UNIVERSITY OF MICHIGAN-DEARBORN         ,MI,48128-2406,Public       ,644,1385,2029,5014,4750,9764
00232700,UNIVERSITY OF MICHIGAN-FLINT            ,MI,48502-1950,Public       ,510,1375,1885,4305,5517,9822
00232800,WASHTENAW COMMUNITY COLLEGE             ,MI,48106-0000,Public       ,1617,3319,4936,4606,7575,12181
00232900,WAYNE STATE UNIVERSITY                  ,MI,48202-0000,Public       ,2246,5666,7912,16723,20476,37199
00232901,WAYNE STATE UNIV SCH OF MEDICINE        ,MI,48201-3359,Public       ,34,121,155,256,1662,1918
00232902,WAYNE STATE UNIVERSITY - LAW SCHOOL     ,MI,48202-3424,Public       ,31,183,214,151,1360,1511
00233000,WESTERN MICHIGAN UNIVERSITY             ,MI,49008-3899,Public       ,1735,1834,3569,18397,8811,27208
00233100,WESTERN THEOLOGICAL SEMINARY            ,MI,49423-0000,Private      ,0,27,27,0,135,135
00407100,WALSH COLLEGE OF ACCT & BUS ADMN        ,MI,48007-7006,Private      ,68,993,1061,277,2489,2766
00407200,NORTHWOOD UNIVERSITY                    ,MI,48640-2398,Private      ,126,440,566,2254,1801,4055
00467300,BAKER COLLEGE - FLINT                   ,MI,48507-5508,Private      ,551,2508,3059,2520,8165,10685
00467301,BAKER COLLEGE OF CADILLAC               ,MI,49601-0000,Private      ,131,606,737,535,2010,2545
00467302,BAKER COLLEGE OF CLINTON TOWNSHIP       ,MI,48035-0000,Private      ,534,1871,2405,2248,6359,8607
00467303,BAKER COLLEGE OF MUSKEGON               ,MI,49442-0000,Private      ,539,1671,2210,2947,5538,8485
00467304,BAKER COLLEGE OF OWOSSO                 ,MI,48867-0000,Private      ,267,759,1026,1832,2679,4511
00467305,BAKER COLLEGE OF AUBURN HILLS           ,MI,48326-0000,Private      ,291,1406,1697,1215,4437,5652
00467306,BAKER COLLEGE OF PORT HURON             ,MI,48060-0000,Private      ,153,609,762,644,1993,2637
00467309,BAKER COLLEGE OF JACKSON                ,MI,49202-0000,Private      ,190,965,1155,751,2733,3484
00467311,BAKER COLLEGE-CASS CITY                 ,MI,48726-0000,Private      ,37,166,203,244,563,807
00467313,BAKER COLLEGE - GRADUATE ON-LINE        ,MI,48507-0000,Private      ,84,1209,1293,334,5383,5717
00467317,BAKER COLLEGE-ALLEN PARK                ,MI,48101-0000,Private      ,322,1148,1470,1045,3634,4679
00469200,DORSEY SCHOOL OF BUSINESS               ,MI,48195-2334,Proprietary  ,41,224,265,70,437,507
00469201,DORSEY SCHOOL OF BUSINESS               ,MI,48184-0000,Proprietary  ,25,212,237,54,335,389
00469202,DORSEY SCHOOL OF BUSINESS               ,MI,48071-0000,Proprietary  ,28,208,236,46,367,413
00469204,DORSEY SCHOOL OF BUSINESS               ,MI,48066-0000,Proprietary  ,84,365,449,131,653,784
00469205,DORSEY BUSINESS SCHOOL - FARMINGTON HILL,MI,48334-3385,Proprietary  ,12,82,94,24,170,194
00469206,DORSEY BUSINESS SCHOOL - ROSEVILLE CULIN,MI,48066-4555,Proprietary  ,35,212,247,77,373,450
00491003,KAPLAN CAREER INSTITUTE - DEARBORN      ,MI,48228-0000,Proprietary  ,38,273,311,102,602,704
00676800,MID MICHIGAN COMMUNITY COLLEGE          ,MI,48625-9447,Public       ,568,909,1477,2462,3172,5634
00677100,COLLEGE FOR CREATIVE STUDIES            ,MI,48202-4034,Private      ,141,161,302,1502,571,2073
00694900,KALAMAZOO VALLEY COMMUNITY COLLEGE      ,MI,49003-4070,Public       ,1298,2567,3865,5311,6773,12084
00717100,KIRTLAND COMMUNITY COLLEGE              ,MI,48653-0000,Public       ,167,493,660,926,1808,2734
00761700,CARNEGIE INSTITUTE                      ,MI,48083-1159,Proprietary  ,23,198,221,70,531,601
00795000,WEST SHORE COMMUNITY COLLEGE            ,MI,49454-0000,Public       ,125,269,394,620,880,1500
00817800,EMPIRE BEAUTY SCHOOL                    ,MI,49525-2440,Proprietary  ,55,163,218,232,548,780
00817801,EMPIRE BEAUTY SCHOOL - KALAMAZOO CAMPUS ,MI,49024-2694,Proprietary  ,8,11,19,21,38,59
00890600,MACOMB COMMUNITY COLLEGE                ,MI,48088-3896,Public       ,2606,5436,8042,9371,13557,22928
00894600,PORT HURON COSMETOLOGY COLLEGE          ,MI,48329-1618,Proprietary  ,16,28,44,29,54,83
00923000,WAYNE COUNTY COMMUNITY CLG-DISTRICT     ,MI,48226-3095,Public       ,3427,9723,13150,8967,25467,34434
00973200,VIRGINIA FARRELL BEAUTY SCHOOL          ,MI,48080-1448,Proprietary  ,16,28,44,28,63,91
00973400,VIRGINIA FARRELL BEAUTY SCHOOL          ,MI,48220-1739,Proprietary  ,29,72,101,62,151,213
00982800,EVEREST INSTITUTE                       ,MI,48033-4400,Proprietary  ,141,641,782,359,1591,1950
00982801,EVEREST INSTITUTE- DEARBORN             ,MI,48124-1927,Proprietary  ,176,601,777,354,1311,1665
00982803,EVEREST INSTITUTE - DETROIT             ,MI,48207-4291,Proprietary  ,126,482,608,251,894,1145
01047000,KALAMAZOO BEAUTY ACADEMY                ,MI,49002-5220,Proprietary  ,18,38,56,29,54,83
01062700,ITT TECHNICAL INSTITUTE                 ,MI,49519-0000,Proprietary  ,460,1373,1833,1066,2710,3776
01082700,DAVID PRESSLEY PROF SCH OF COSMTLGY     ,MI,48067-3219,Proprietary  ,49,65,114,89,112,201
01109800,FLINT INSTITUTE OF BARBERING            ,MI,48504-4395,Proprietary  ,9,35,44,25,99,124
01164600,VIRGINIA FARRELL BEAUTY SCHOOL          ,MI,48185-3091,Proprietary  ,18,54,72,36,129,165
01229100,WRIGHT BEAUTY ACADEMY                   ,MI,49015-2696,Proprietary  ,9,43,52,30,94,124
01262700,THOMAS M. COOLEY LAW SCHOOL             ,MI,48901-1586,Private      ,2,1014,1016,15,4745,4760
01321800,M J MURPHY BTY CLG MT PLEASANT          ,MI,48858-2502,Proprietary  ,20,38,58,50,76,126
02060300,MICHIGAN INSTITUTE OF AERONAUTICS       ,MI,48111-0000,Proprietary  ,167,291,458,478,924,1402
02068700,ADRIAN BEAUTY ACADEMY                   ,MI,49221-0000,Proprietary  ,10,15,25,22,40,62
02099700,ROSS MEDICAL EDUCATION CENTER           ,MI,48532-0000,Proprietary  ,74,518,592,170,1242,1412
02099701,ROSS MEDICAL EDUCATION CENTER-SAGINAW   ,MI,48603-5227,Proprietary  ,4,49,53,25,112,137
02099702,ROSS MEDICAL EDUCATION CENTER-PORT HURON,MI,48060-1958,Proprietary  ,1,43,44,8,78,86
02099703,ROSS MEDICAL EDUCATION CENTER-ROOSEVELT ,MI,49441-4156,Proprietary  ,0,5,5,8,24,32
02100400,EVEREST INSTITUTE                       ,MI,49525-2301,Proprietary  ,78,462,540,208,1065,1273
02100401,EVEREST INSTITUTE - KALAMAZOO           ,MI,49009-3307,Proprietary  ,65,412,477,123,721,844
02125600,MICHIGAN COLLEGE OF BEAUTY              ,MI,48083-0000,Proprietary  ,52,149,201,127,292,419
02152103,ACADEMY OF COURT REPORTING & TECHNOLOGY ,MI,48017-1495,Proprietary  ,17,113,130,43,370,413
02158600,MR BELA'S SCHOOL OF COSMETOLOGY         ,MI,48092-4637,Proprietary  ,14,45,59,25,61,86
02160303,INTERNATIONAL ACADEMY OF DESIGN AND TECH,MI,48083-2160,Proprietary  ,151,248,399,683,849,1532
02180100,ROSS MEDICAL EDUCATION CENTER           ,MI,48092-0000,Proprietary  ,49,259,308,104,534,638
02180105,ROSS MEDICAL EDUCATION CENTER-REDFORD   ,MI,48239-1260,Proprietary  ,2,31,33,6,78,84
02198900,MICHIGAN SCHOOL OF PROFESSIONAL PSYCHOLO,MI,48334-4512,Private      ,2,27,29,7,151,158
02209200,TAYLORTOWN SCHOOL OF BEAUTY             ,MI,48180-0000,Proprietary  ,12,34,46,25,69,94
02237800,SPECS HOWARD SCHOOL OF MEDIA ARTS       ,MI,48075-0000,Proprietary  ,170,297,467,476,678,1154
02285700,BAYSHIRE BEAUTY ACADEMY                 ,MI,48708-5614,Proprietary  ,14,51,65,32,102,134
02289801,KAPLAN INSTITUTE - DETROIT CAMPUS       ,MI,48202-0000,Proprietary  ,114,406,520,253,1073,1326
02324500,MICHIGAN COLLEGE OF BEAUTY              ,MI,48161-0000,Proprietary  ,26,71,97,56,107,163
02339700,ROSS MEDICAL EDUCATION CENTER           ,MI,48116-0000,Proprietary  ,70,391,461,127,808,935
02339701,ROSS MEDICAL EDUCATION CENTER-ANN ARBOR ,MI,48108-1411,Proprietary  ,2,30,32,20,67,87
02361500,MICHIGAN BARBER COLLEGE                 ,MI,48204-2244,Private      ,45,157,202,101,306,407
02363800,YESHIVA GEDOLAH OF GREATER DETROIT      ,MI,48237-0000,Private      ,19,1,20,24,4,28
02491000,WEST MI COLG OF BARBERING & BEAUTY      ,MI,49008-0000,Proprietary  ,10,65,75,26,104,130
02498300,VIRGINIA FARRELL BEAUTY SCHOOL          ,MI,48154-0000,Proprietary  ,14,59,73,43,113,156
02533600,ROSS MEDICAL EDUCATION CENTER           ,MI,48917-2108,Proprietary  ,53,283,336,115,640,755
02533601,ROSS MEDICAL EDUCATION CENTER - GRAND RA,MI,49546-2430,Proprietary  ,7,70,77,27,147,174
02588200,DOUGLAS J AVEDA INSTITUTE               ,MI,48823-4351,Proprietary  ,134,182,316,463,513,976
02588201,DOUGLAS J AVEDA INSTITUTE - ANN ARBOR   ,MI,48104-2211,Proprietary  ,18,31,49,70,84,154
02595700,HILLSDALE BEAUTY COLLEGE                ,MI,49242-0000,Proprietary  ,3,5,8,43,20,63
02618400,MICHIGAN CAREER & TECHNICAL INST        ,MI,49080-9254,Public       ,69,54,123,167,95,262
03005700,DETROIT BUSINESS INST. DOWNRIVER        ,MI,48193-6761,Proprietary  ,38,110,148,48,152,200
03028500,LAWTON SCHOOL                           ,MI,48075-5406,Proprietary  ,19,80,99,46,196,242
03066600,BAY MILLS COMMUNITY COLLEGE             ,MI,49715-9750,Public       ,46,173,219,150,385,535
03075200,TWIN CITY BEAUTY COLLEGE                ,MI,49085-3305,Proprietary  ,30,80,110,42,125,167
03075201,TWIN CITY BEAUTY COLLEGE - TRAVERSE CITY,MI,49686-5119,Proprietary  ,0,10,10,13,27,40
03090000,SHARP'S ACADEMY OF HAIRSTYLING INC.     ,MI,48433-0000,Proprietary  ,5,14,19,17,46,63
03109700,HOUGHTON LAKE INST OF COSMETOLOGY       ,MI,48629-0669,Proprietary  ,4,8,12,10,12,22
03110300,THE SCHOOL OF CREATIVE HAIR DESIGN      ,MI,49036-1139,Proprietary  ,7,17,24,15,37,52
03124000,NORTHWESTERN TECHNOLOGICAL INST         ,MI,48075-2412,Proprietary  ,24,180,204,74,390,464
03135300,MICHIGAN THEOLOGICAL SEMINARY           ,MI,48170-4399,Private      ,1,41,42,4,113,117
03284300,MICHIGAN JEWISH INSTITUTE               ,MI,48237-0000,Private      ,372,127,499,591,145,736
03490300,PAUL MITCHELL THE SCHOOL ESCANABA       ,MI,49829-0000,Proprietary  ,62,68,130,94,109,203
03588300,IRENE'S MYOMASSOLOGY INSTITUTE          ,MI,48033-2404,Proprietary  ,19,124,143,64,335,399
03704300,BLUE WATER COLLEGE OF COSMETOLOGY       ,MI,48040-0000,Proprietary  ,10,19,29,20,42,62
03772300,SAGINAW CHIPPEWA TRIBAL COLLEGE         ,MI,48858-0000,Public       ,5,19,24,8,43,51
03815300,IN SESSION-ARTS OF COSMETOLOGY BEAU     ,MI,48609-0000,Proprietary  ,4,39,43,31,93,124
03907300,PAUL MITCHELL THE SCHOOL GREAT LAKES    ,MI,48060-0000,Proprietary  ,39,54,93,68,93,161
03915300,CAREER QUEST LEARNING CENTER            ,MI,48910-4732,Proprietary  ,26,211,237,69,609,678
03968300,LAKEWOOD SCHOOL OF THERAPEUTIC MASSAGE  ,MI,48060-0000,Proprietary  ,2,18,20,4,41,45
03976500,ANN ARBOR INSTITUTE OF MASSAGE THERAPY  ,MI,48103-0000,Proprietary  ,9,30,39,21,64,85
04002400,ECUMENICAL THEOLOGICAL SEMINARY         ,MI,48201-3035,Private      ,0,31,31,1,91,92
04006300,NUVO COLLEGE OF COSMETOLOGY             ,MI,49441-3822,Proprietary  ,12,50,62,22,86,108
04014300,P&A SCHOLARS BEAUTY SCHOOL              ,MI,48204-0000,Proprietary  ,51,120,171,96,190,286
04094300,ROBERT B. MILLER COLLEGE (THE)          ,MI,49017-3306,Private      ,15,96,111,56,312,368
04121100,GALLERY COLLEGE OF BEAUTY (THE)         ,MI,48036-3591,Proprietary  ,32,112,144,70,203,273
04136300,FOCUS:  HOPE INFORMATION TECHNOLOGIES CE,MI,48238-2949,Private      ,11,93,104,48,197,245
04138400,SCHOOL OF DESIGNING ARTS                ,MI,49037-7995,Proprietary  ,10,14,24,26,43,69
04139600,REGAL BEAUTY SCHOOL                     ,MI,48150-4013,Proprietary  ,4,23,27,12,58,70
04140900,INTERNATIONAL COSMETOLOGY ACADEMY       ,MI,49508-1308,Proprietary  ,8,50,58,27,126,153
04141100,FRENCH ACADEMY OF COSMETOLOGY           ,MI,49456-3207,Proprietary  ,10,17,27,30,47,77
00233200,ANOKA-RAMSEY CC-CAMBRIDGE/COONRAPID     ,MN,55433-3499,Public       ,1282,1638,2920,3085,3582,6667
00233400,AUGSBURG COLLEGE                        ,MN,55454-1351,Private      ,124,571,695,2608,1991,4599
00233500,RIVERLAND COMMUNITY COLLEGE             ,MN,55912-1473,Public       ,401,736,1137,1008,1654,2662
00233600,BEMIDJI STATE UNIVERSITY                ,MN,56601-2699,Public       ,461,604,1065,3132,1704,4836
00233700,BETHANY LUTHERAN COLLEGE INC            ,MN,56001-6163,Private      ,51,18,69,703,47,750
00233900,CENTRAL LAKES COLG-BRAINERD/STAPLES     ,MN,56401-3900,Public       ,483,773,1256,1399,1792,3191
00234000,CARLETON COLLEGE                        ,MN,55057-4001,Private      ,52,4,56,2985,42,3027
00234100,COLLEGE OF ST BENEDICT                  ,MN,56374-2099,Private      ,102,6,108,1994,45,2039
00234200,ST. CATHERINE UNIVERSITY                ,MN,55105-1789,Private      ,169,695,864,2266,3018,5284
00234300,COLLEGE OF ST SCHOLASTICA               ,MN,55811-4199,Private      ,240,551,791,2351,1510,3861
00234500,UNIVERSITY OF ST THOMAS                 ,MN,55105-1096,Private      ,387,952,1339,6135,3670,9805
00234600,CONCORDIA COLLEGE-MOORHEAD              ,MN,56562-0001,Private      ,255,41,296,3204,150,3354
00234700,"CONCORDIA UNIVERSITY, ST PAUL, MN       ",MN,55104-5494,Private      ,210,716,926,1296,1567,2863
00235000,VERMILION COMMUNITY COLLEGE             ,MN,55731-1996,Public       ,93,47,140,469,153,622
00235300,GUSTAVUS ADOLPHUS COLLEGE               ,MN,56082-1498,Private      ,112,5,117,3020,50,3070
00235400,HAMLINE UNIVERSITY                      ,MN,55104-1284,Private      ,232,644,876,2449,3120,5569
00235500,HIBBING COMMUNITY COLLEGE               ,MN,55746-3300,Public       ,258,409,667,653,966,1619
00235600,ITASCA COMMUNITY COLLEGE                ,MN,55744-3397,Public       ,164,207,371,705,565,1270
00235700,LUTHER SEMINARY                         ,MN,55108-0000,Private      ,0,53,53,2,424,426
00235800,MACALESTER COLLEGE                      ,MN,55105-1899,Private      ,55,26,81,3247,78,3325
00236000,"MINNESOTA STATE UNIVERSITY, MANKATO     ",MN,56002-0000,Public       ,1422,1025,2447,10559,3807,14366
00236100,MARTIN LUTHER COLLEGE                   ,MN,56073-3965,Private      ,10,8,18,653,44,697
00236200,MINNEAPOLIS COMM AND TECH COLLEGE       ,MN,55403-1779,Public       ,1298,3148,4446,3954,8240,12194
00236500,MINNEAPOLIS COLLEGE OF ART & DESIGN     ,MN,55404-4343,Private      ,34,35,69,895,334,1229
00236600,CROSSROADS COLLEGE                      ,MN,55902-2382,Private      ,25,30,55,110,79,189
00236700,MINNESOTA STATE UNIVERSITY MOORHEAD     ,MN,56563-0001,Public       ,849,633,1482,5011,2076,7087
00236900,NORTH CENTRAL UNIVERSITY                ,MN,55404-1391,Private      ,116,83,199,1148,322,1470
00237000,NORTH HENNEPIN COMMUNITY COLLEGE        ,MN,55445-2299,Public       ,1072,1704,2776,2547,4017,6564
00237100,NORTHWESTERN COLLEGE                    ,MN,55113-1598,Private      ,207,278,485,2287,709,2996
00237300,ROCHESTER COMMUNITY/TECH COLLEGE        ,MN,55904-4999,Public       ,750,958,1708,2727,2840,5567
00237500,SOUTHWEST MINNESOTA STATE UNIVERSITY    ,MN,56258-1598,Public       ,215,339,554,1965,974,2939
00237700,ST CLOUD STATE UNIVERSITY               ,MN,56301-4498,Public       ,1945,1553,3498,9937,4516,14453
00237900,SAINT JOHNS UNIVERSITY                  ,MN,56321-0000,Private      ,113,21,134,1819,82,1901
00238000,SAINT MARY'S UNIVERSITY                 ,MN,55987-1399,Private      ,105,974,1079,1535,2567,4102
00238200,ST OLAF COLLEGE                         ,MN,55057-1098,Private      ,62,9,71,3795,55,3850
00238300,CROWN COLLEGE                           ,MN,55375-9001,Private      ,95,226,321,739,579,1318
00238500,NORTHLAND COMMUNITY & TECHNICAL CLG     ,MN,56701-2598,Public       ,560,792,1352,1499,1885,3384
00238600,UNITED THEOLGCL SEMINRY TWIN CITIES     ,MN,55112-0000,Private      ,0,28,28,1,105,106
00238800,"UNIVERSITY OF MINNESOTA, DULUTH         ",MN,55812-2496,Public       ,1431,564,1995,9383,1921,11304
00238900,"UNIVERSITY OF MINNESOTA, MORRIS         ",MN,56267-2113,Public       ,135,45,180,1746,235,1981
00239100,WILLIAM MITCHELL COLLEGE OF LAW         ,MN,55105-0000,Private      ,0,102,102,0,1267,1267
00239300,MINNESOTA STATE COLLEGE-SE TECH         ,MN,55987-0409,Public       ,313,617,930,789,1394,2183
00239400,WINONA STATE UNIVERSITY                 ,MN,55987-5838,Public       ,1049,471,1520,6876,1320,8196
00396900,UNIVERSITY OF MINNESOTA-TWIN CITIES     ,MN,55455-0422,Public       ,2934,3763,6697,27882,17226,45108
00400900,MESABI RANGE CMNTY & TECH COLLEGE       ,MN,55792-0000,Public       ,181,336,517,507,658,1165
00405708,NATIONAL AMERICAN UNIVERSITY            ,MN,55113-0000,Proprietary  ,18,90,108,43,276,319
00405715,NATIONAL AMERICAN UNIVERSITY - BLOOMINGT,MN,55425-5550,Proprietary  ,10,98,108,31,277,308
00406900,UNIVERSITY OF MINNESOTA-CROOKSTON       ,MN,56716-5001,Public       ,153,171,324,955,430,1385
00438600,VETERAN'S MEDICAL CTR- SCH RAD TECH     ,MN,55417-2399,Public       ,0,4,4,1,15,16
00464100,DUNWOODY COLLEGE OF TECHNOLOGY          ,MN,55403-1192,Private      ,191,395,586,975,1393,2368
00464200,GLOBE UNIVERSITY                        ,MN,55125-5408,Proprietary  ,356,1136,1492,995,2774,3769
00464500,MINNEAPOLIS BUSINESS COLLEGE            ,MN,55113-4036,Proprietary  ,45,43,88,425,148,573
00464600,MINNESOTA SCHOOL OF BUSINESS            ,MN,55423-0000,Proprietary  ,677,1927,2604,2246,6190,8436
00464800,RASMUSSEN COLLEGE - EAGAN               ,MN,55122-1346,Proprietary  ,88,288,376,283,1072,1355
00525200,RIDGEWATER COLLEGE                      ,MN,56201-2098,Public       ,600,757,1357,1918,1835,3753
00526300,MINNESOTA WEST CMNTY & TECH COLG        ,MN,56241-1096,Public       ,299,539,838,933,1301,2234
00553300,"SAINT PAUL COLLEGE, COMMUNITY/TECHNICAL ",MN,55102-1800,Public       ,675,1926,2601,2237,4763,7000
00553400,ST CLOUD TECHNICAL COLLEGE              ,MN,56303-1240,Public       ,871,825,1696,2405,2064,4469
00553500,PINE TECHNICAL COLLEGE                  ,MN,55063-2198,Public       ,88,283,371,207,698,905
00553700,SOUTH CENTRAL COLLEGE                   ,MN,56003-0000,Public       ,529,729,1258,1524,1796,3320
00554100,MINNESOTA STATE COMMUNITY AND TECHNICAL ,MN,56573-1405,Public       ,829,1164,1993,2274,3031,5305
00554400,ALEXANDRIA TECHNICAL COLLEGE            ,MN,56308-3799,Public       ,267,301,568,1203,845,2048
00575700,LAKE SUPERIOR COLLEGE                   ,MN,55811-3399,Public       ,693,960,1653,1878,2319,4197
00575900,NORTHWEST TECHNICAL COLLEGE - BEMIDJI   ,MN,56601-4907,Public       ,131,325,456,407,859,1266
00677500,RAINY RIVER COMMUNITY COLLEGE           ,MN,56649-2187,Public       ,37,58,95,108,131,239
00735000,ANOKA-HENNEPIN TECHNICAL COLLEGE        ,MN,55303-1590,Public       ,319,843,1162,756,1901,2657
00735100,BROWN COLLEGE                           ,MN,55120-1004,Proprietary  ,166,289,455,901,970,1871
00746200,COLLEGE OF VISUAL ARTS                  ,MN,55102-2199,Private      ,35,11,46,196,50,246
00795400,NORMANDALE COMMUNITY COLLEGE            ,MN,55431-4399,Public       ,1302,1532,2834,3938,4088,8026
00826700,NORTHWEST TECHNICAL INSTITUTE           ,MN,55121-5001,Proprietary  ,34,12,46,119,38,157
00869400,RASMUSSEN COLLEGE                       ,MN,56301-3713,Proprietary  ,108,332,440,302,1145,1447
00869401,RASMUSSEN COLLEGE - BROOKLYN PARK       ,MN,55445-1512,Proprietary  ,93,406,499,290,1358,1648
00905800,BETHEL UNIVERSITY                       ,MN,55112-6999,Private      ,252,671,923,2976,1822,4798
00960000,COSMETOLOGY CAREERS UNLTD-DULUTH        ,MN,55802-2031,Proprietary  ,8,29,37,25,53,78
00972200,EMPIRE BEAUTY SCHOOL                    ,MN,55119-7003,Proprietary  ,23,56,79,78,238,316
00974000,INVER HILLS COMMUNITY COLLEGE           ,MN,55076-3224,Public       ,818,1217,2035,1918,2739,4657
00983100,MODEL COLLEGE OF HAIR DESIGN            ,MN,56301-4280,Proprietary  ,10,23,33,89,56,145
00987000,EMPIRE BEAUTY SCHOOL                    ,MN,55420-2919,Proprietary  ,23,66,89,77,216,293
00989200,"DULUTH BUSINESS UNIV, INC.              ",MN,55807-0000,Proprietary  ,49,154,203,129,393,522
00999200,OAK HILLS CHRISTIAN COLLEGE             ,MN,56601-0000,Private      ,30,35,65,119,69,188
01024800,ART INSTITUTES INTL MINNESOTA           ,MN,55402-3137,Proprietary  ,224,276,500,1602,1103,2705
01035602,EVEREST INSTITUTE - EAGAN               ,MN,55121-1696,Proprietary  ,65,411,476,108,709,817
01037400,METROPOLITAN STATE UNIVERSITY           ,MN,55106-5000,Public       ,372,1792,2164,1484,5567,7051
01040200,DAKOTA COUNTY TECHNICAL COLLEGE         ,MN,55068-2999,Public       ,443,763,1206,1072,1682,2754
01049000,REGENCY BEAUTY INSTITUTE                ,MN,55428-0000,Proprietary  ,1209,2014,3223,2819,4797,7616
01049100,HENNEPIN TECHNICAL COLLEGE              ,MN,55445-2399,Public       ,647,1595,2242,1608,3781,5389
01054600,CENTURY COMMUNITY AND TECHNICAL CLG     ,MN,55110-1894,Public       ,1733,2248,3981,4229,5307,9536
01101700,HERZING COLLEGE                         ,MN,55428-3548,Proprietary  ,58,151,209,164,422,586
01168600,RASMUSSEN COLLEGE - EDEN PRAIRIE        ,MN,55344-7220,Proprietary  ,126,851,977,290,2435,2725
01173200,"MAYO CLINIC, COLLEGE OF MEDICINE        ",MN,55905-0000,Private      ,5,19,24,30,368,398
01173201,MAYO SCHOOL OF HEALTH-RELATED SCIEN     ,MN,55905-0000,Private      ,3,17,20,48,112,160
01173206,MAYO GRAD SCHOOL                        ,MN,55901-0000,Private      ,0,12,12,3,42,45
01173207,MAYO MEDICAL SCHOOL                     ,MN,55901-0000,Private      ,0,6,6,1,134,135
01232800,NORTHWESTERN HEALTH SCIENCES UNIV       ,MN,55431-1599,Private      ,10,143,153,49,788,837
02050300,ACADEMY COLLEGE                         ,MN,55420-1554,Proprietary  ,13,73,86,35,208,243
02123200,AVEDA INSTITUTE                         ,MN,55414-0000,Proprietary  ,82,104,186,292,298,590
02159800,COSMETOLOGY CAREERS UNLTD - HIBBING     ,MN,55746-0000,Proprietary  ,11,13,24,24,23,47
02160901,"SALON PROFESSIONAL ACADEMY, THE - THE SA",MN,55428-4928,Proprietary  ,18,31,49,41,57,98
02238100,MINNESOTA SCHOOL OF COSMETOLOGY         ,MN,55125-0000,Proprietary  ,31,49,80,74,126,200
02260500,SUMMIT ACAD OPPORTUNITIES IND CTR       ,MN,55405-0000,Private      ,18,132,150,29,202,231
02263102,HIGH-TECH INSTITUTE - MINNEAPOLIS       ,MN,55416-2467,Proprietary  ,0,9,9,9,38,47
02503300,RASMUSSEN COLLEGE - MANKATO             ,MN,56001-8658,Proprietary  ,56,219,275,282,959,1241
02503302,RASMUSSEN COLLEGE - MANKATO -  LAKE ELMO,MN,55042-8624,Proprietary  ,71,270,341,198,785,983
02504200,WALDEN UNIVERSITY                       ,MN,55401-2511,Proprietary  ,20,11180,11200,76,30571,30647
02514100,AMERICAN INDIAN OPPORTUNITIES CTR       ,MN,55404-0000,Private      ,4,67,71,13,113,126
02543600,INGENUE                                 ,MN,56560-0000,Proprietary  ,4,13,17,11,20,31
02551200,EAST METRO OIC                          ,MN,55104-3435,Private      ,13,53,66,29,90,119
03001200,MCNALLY SMITH COLLEGE OF MUSIC          ,MN,55101-2220,Proprietary  ,151,83,234,731,227,958
03051900,ALFRED ADLER GRADUATE SCHOOL            ,MN,55305-0000,Private      ,0,103,103,0,225,225
03096400,LEECH LAKE TRIBAL COLLEGE               ,MN,56633-0000,Public       ,12,120,132,20,218,238
03129100,FOND DU LAC TRIBAL & COMMUNITY CLG      ,MN,55720-2984,Public       ,238,403,641,464,843,1307
03267300,CAPELLA UNIVERSITY                      ,MN,55402-3389,Proprietary  ,23,8907,8930,85,37570,37655
03833300,AMERICAN ACADEMY OF ACUPUNCTURE AND ORIE,MN,55113-0000,Proprietary  ,1,40,41,1,82,83
03921400,WHITE EARTH TRIBAL AND COMMUNITY COLLEGE,MN,56557-0478,Private      ,17,50,67,27,113,140
04044300,HAZELDEN GRADUATE SCHOOL OF ADDICTION ST,MN,55012-0000,Private      ,0,31,31,0,109,109
04130200,INST. OF PRODUCTION AND RECORDING       ,MN,55401-1315,Proprietary  ,95,52,147,380,173,553
00239600,ALCORN STATE UNIVERSITY                 ,MS,39096-7500,Public       ,427,927,1354,3120,2827,5947
00239700,BELHAVEN COLLEGE                        ,MS,39202-1789,Private      ,168,918,1086,1301,3071,4372
00239800,BLUE MOUNTAIN COLLEGE                   ,MS,38610-9370,Private      ,69,109,178,362,303,665
00240100,COAHOMA COMMUNITY COLLEGE               ,MS,38614-9799,Public       ,633,1444,2077,1483,2511,3994
00240200,COPIAH-LINCOLN COMMUNITY COLLEGE        ,MS,39191-0649,Public       ,591,956,1547,1919,2298,4217
00240300,DELTA STATE UNIVERSITY                  ,MS,38733-0000,Public       ,437,869,1306,2712,2986,5698
00240400,EAST CENTRAL COMMUNITY COLLEGE          ,MS,39327-0129,Public       ,454,767,1221,1566,1886,3452
00240500,EAST MISSISSIPPI COMM COLLEGE           ,MS,39358-0000,Public       ,910,1760,2670,2412,3618,6030
00240700,HINDS COMMUNITY COLLEGE                 ,MS,39154-9799,Public       ,2077,3422,5499,6323,9087,15410
00240800,HOLMES COMMUNITY COLLEGE                ,MS,39079-0000,Public       ,993,2054,3047,3132,5167,8299
00240900,ITAWAMBA COMMUNITY COLLEGE              ,MS,38843-1099,Public       ,1083,2443,3526,3601,5763,9364
00241000,JACKSON STATE UNIVERSITY                ,MS,39217-0001,Public       ,1080,2669,3749,7799,8716,16515
00241100,JONES COUNTY JUNIOR COLLEGE             ,MS,39437-3999,Public       ,799,962,1761,3263,2664,5927
00241300,MERIDIAN COMMUNITY COLLEGE              ,MS,39307-5890,Public       ,740,1211,1951,2082,2624,4706
00241400,MILLSAPS COLLEGE                        ,MS,39201-0000,Private      ,92,114,206,1350,394,1744
00241500,MISSISSIPPI COLLEGE                     ,MS,39058-0001,Private      ,376,722,1098,2377,2843,5220
00241501,MISSISSIPPI COLLEGE - SCHOOL OF LAW     ,MS,39201-1391,Private      ,8,76,84,27,826,853
00241502,MISSISSIPPI COLLEGE - RANKIN CAMPUS     ,MS,39042-0000,Private      ,2,19,21,18,56,74
00241600,MISSISSIPPI DELTA CMTY COLLEGE          ,MS,38761-0000,Public       ,639,967,1606,1911,2345,4256
00241700,MISSISSIPPI GULF CST CLG-PERKINSTON     ,MS,39573-0000,Public       ,390,335,725,1424,838,2262
00241701,MISSISSIPPI GULF CST CLG-JEFF DAVIS     ,MS,39507-0000,Public       ,478,1132,1610,1364,2838,4202
00241702,MISSISSIPPI GULF CST CLG-JACKSON CN     ,MS,39553-0000,Public       ,456,946,1402,1336,2255,3591
00242200,MISSISSIPPI UNIV FOR WOMEN              ,MS,39701-5818,Public       ,267,567,834,1451,1816,3267
00242300,MISSISSIPPI STATE UNIVERSITY            ,MS,39762-9698,Public       ,1615,1742,3357,11331,6247,17578
00242400,MISSISSIPPI VALLEY STATE UNIVERSITY     ,MS,38941-1400,Public       ,593,1274,1867,2825,3402,6227
00242600,NORTHEAST MS CMNTY COLLEGE              ,MS,38829-1731,Public       ,595,789,1384,2324,2260,4584
00242700,NORTHWEST MISSISSIPPI COMMUNITY CLG     ,MS,38668-1703,Public       ,1281,1903,3184,4738,5033,9771
00243000,PEARL RIVER COMMUNITY COLLEGE           ,MS,39470-2201,Public       ,940,1391,2331,2845,3326,6171
00243300,RUST COLLEGE                            ,MS,38635-2328,Private      ,232,174,406,1385,560,1945
00243500,SOUTHEASTERN BAPTIST COLLEGE            ,MS,39440-0000,Private      ,11,31,42,33,65,98
00243600,SOUTHWEST MISSISSIPPI CMNTY CLG         ,MS,39666-8099,Public       ,369,508,877,1349,1369,2718
00243900,TOUGALOO COLLEGE                        ,MS,39174-9799,Private      ,172,134,306,1470,520,1990
00244000,UNIVERSITY OF MISSISSIPPI               ,MS,38677-1848,Public       ,1461,1608,3069,9281,5981,15262
00244001,UNIVERSITY OF MISSISSIPPI - MED CTR     ,MS,39216-0000,Public       ,53,158,211,367,1587,1954
00244100,UNIVERSITY OF SOUTHERN MISSISSIPPI      ,MS,39406-0001,Public       ,1733,2563,4296,9702,8486,18188
00244700,WILLIAM CAREY UNIVERSITY                ,MS,39401-5499,Private      ,272,1037,1309,1119,2986,4105
01146100,WESLEY COLLEGE                          ,MS,39073-1070,Private      ,36,49,85,64,100,164
01289101,ANTONELLI COLLEGE - JACKSON             ,MS,39208-4526,Proprietary  ,47,429,476,99,830,929
01289102,ANTONELLI COLLEGE - HATTIESBURG         ,MS,39401-3056,Proprietary  ,52,198,250,135,608,743
02074900,CHRIS' BEAUTY COLLEGE                   ,MS,39501-0000,Proprietary  ,11,50,61,28,111,139
02160500,NORTH MISSISSIPPI MED CTR MED TECH      ,MS,38801-0000,Private      ,5,9,14,14,37,51
02235900,ACADEMY OF HAIR DESIGN #4               ,MS,39208-0000,Proprietary  ,11,35,46,42,104,146
02244300,ACADEMY OF HAIR DESIGN #1               ,MS,38901-0000,Proprietary  ,19,70,89,67,211,278
02249900,DELTA BEAUTY COLLEGE                    ,MS,38701-0000,Proprietary  ,4,29,33,26,71,97
02251600,ACADEMY OF HAIR DESIGN #6               ,MS,39401-7581,Proprietary  ,19,75,94,57,168,225
02251700,FOSTER'S COSMETOLOGY COLLEGE            ,MS,38663-0000,Proprietary  ,8,30,38,11,37,48
02302800,MISSISSIPPI COLLEGE OF BEAUTY CULT      ,MS,39440-0000,Proprietary  ,7,27,34,16,40,56
02320800,MAGNOLIA COLLEGE OF COSMETOLOGY         ,MS,39206-0000,Proprietary  ,18,95,113,40,157,197
02361200,MAGNOLIA BIBLE COLLEGE                  ,MS,39090-0000,Private      ,2,7,9,10,21,31
02502100,CREATIONS COLLEGE OF COSMETOLOGY        ,MS,38803-0000,Proprietary  ,9,43,52,19,96,115
02516200,WESLEY BIBLICAL SEMINARY                ,MS,39206-0000,Private      ,0,46,46,4,105,109
02554600,GIBSON'S BARBER AND BEAUTY COLLEGE      ,MS,39773-0000,Proprietary  ,1,10,11,13,35,48
02586000,J & J HAIR DESIGN COLLEGE               ,MS,39051-3716,Proprietary  ,12,53,65,24,105,129
03004000,FINAL TOUCH BEAUTY SCHOOL               ,MS,39307-2934,Proprietary  ,10,29,39,17,49,66
03010401,CRESCENT CITY BARTENDING SCHOOL         ,MS,39501-0000,Proprietary  ,1,12,13,4,36,40
03010404,CRESCENT CITY SCHOOL OF GAMING & BARTEND,MS,38664-1903,Proprietary  ,0,5,5,3,10,13
03010603,VIRGINIA COLLEGE - JACKSON              ,MS,39206-5602,Proprietary  ,84,615,699,172,1327,1499
03010610,VIRGINIA COLLEGE - BILOXI               ,MS,39532-2124,Proprietary  ,17,173,190,82,693,775
03263300,TRAXLER'S SCHOOL OF HAIR                ,MS,39212-2529,Proprietary  ,8,38,46,16,57,73
03464300,ACADEMY OF HAIR DESIGN                  ,MS,39562-0000,Proprietary  ,7,47,54,12,67,79
03525300,BLUE CLIFF COLLEGE                      ,MS,39507-0000,Proprietary  ,36,120,156,116,356,472
03848300,DAY SPA CAREER COLLEGE                  ,MS,39564-0000,Proprietary  ,6,25,31,16,53,69
03963300,HEALING TOUCH SCHOOL OF MASSAGE THERAPY ,MS,39402-1300,Proprietary  ,3,11,14,10,28,38
04131300,CORINTH ACADEMY OF COSMETOLOGY          ,MS,38834-4813,Proprietary  ,6,32,38,16,54,70
04140200,"MISSISSIPPI INSTITUTE OF AESTHETICS, NAI",MS,39056-5628,Proprietary  ,3,21,24,12,58,70
00252600,CARROLL COLLEGE                         ,MT,59625-0002,Private      ,75,59,134,1560,239,1799
00252700,UNIVERSITY OF GREAT FALLS               ,MT,59405-4996,Private      ,60,160,220,512,559,1071
00252800,MILES COMMUNITY COLLEGE                 ,MT,59301-4799,Public       ,63,68,131,319,220,539
00252900,DAWSON COMMUNITY COLLEGE                ,MT,59330-1405,Public       ,51,48,99,267,122,389
00253000,MONTANA STATE UNIVERSITY - BILLINGS     ,MT,59101-0298,Public       ,429,905,1334,2371,3163,5534
00253100,MONTANA TECH OF THE UNIV OF MONTANA     ,MT,59701-8997,Public       ,180,284,464,1440,1125,2565
00253200,MONTANA STATE UNIVERSITY - BOZEMAN      ,MT,59717-0001,Public       ,788,958,1746,8599,3873,12472
00253300,MONTANA STATE UNIVERSITY-NORTHERN       ,MT,59501-3148,Public       ,125,235,360,753,723,1476
00253400,ROCKY MOUNTAIN COLLEGE                  ,MT,59102-1796,Private      ,99,59,158,940,313,1253
00253600,UNIVERSITY OF MONTANA (THE)             ,MT,59812-0001,Public       ,898,1420,2318,8093,7046,15139
00253700,UNIVERSITY OF MONTANA WESTERN (THE)     ,MT,59725-3598,Public       ,96,100,196,1041,490,1531
00677700,FLATHEAD VALLEY COMMUNITY COLLEGE       ,MT,59901-2699,Public       ,173,548,721,736,1435,2171
00757000,HELENA COLLEGE OF TECHNOLOGY            ,MT,59601-3098,Public       ,88,299,387,405,849,1254
00790000,BUTTE ACADEMY OF BEAUTY CULTURE         ,MT,59701-9197,Proprietary  ,3,14,17,15,38,53
00894700,"DAHL'S COLLEGE OF BEAUTY,INC            ",MT,59401-3731,Proprietary  ,8,21,29,23,48,71
00931400,MSU COLLEGE OF TECH-GREAT FALLS         ,MT,59405-4907,Public       ,161,486,647,603,1396,1999
02143400,SALISH KOOTENAI COLLEGE                 ,MT,59855-0000,Public       ,89,357,446,267,840,1107
02286600,LITTLE BIG HORN COLLEGE                 ,MT,59022-0000,Public       ,52,168,220,92,230,322
02343000,FT PECK COMMUNITY COLLEGE               ,MT,59255-0000,Public       ,41,166,207,55,238,293
02510600,BLACKFEET COMMUNITY COLLEGE             ,MT,59417-0000,Private      ,78,260,338,160,434,594
02517500,FORT BELKNAP COLLEGE                    ,MT,59526-0000,Public       ,12,40,52,34,99,133
02545200,CHIEF DULL KNIFE COLLEGE                ,MT,59043-0098,Public       ,17,93,110,48,148,196
02610900,STONE CHILD COLLEGE                     ,MT,59521-9796,Public       ,24,113,137,62,166,228
02621300,ACADEMY OF COSMETOLOGY                  ,MT,59715-3544,Proprietary  ,6,10,16,22,29,51
03205300,MODERN BEAUTY SCHOOL                    ,MT,59801-8386,Proprietary  ,8,15,23,25,45,70
03763400,"ACADEMY OF NAIL, SKIN & HAIR            ",MT,59101-0000,Proprietary  ,15,48,63,69,116,185
03778300,HEALTH WORKS INSTITUTE                  ,MT,59715-0000,Proprietary  ,5,10,15,14,35,49
00253900,CHADRON STATE COLLEGE                   ,NE,69337-2690,Public       ,189,265,454,1585,950,2535
00254000,COLLEGE OF ST MARY                      ,NE,68106-2606,Private      ,53,288,341,398,1107,1505
00254100,CONCORDIA UNIVERSITY                    ,NE,68434-1594,Private      ,82,144,226,1378,379,1757
00254200,CREIGHTON UNIVERSITY                    ,NE,68178-0001,Private      ,256,523,779,4697,4598,9295
00254300,DANA COLLEGE                            ,NE,68008-9905,Private      ,43,20,63,856,102,958
00254400,DOANE COLLEGE                           ,NE,68333-2421,Private      ,68,324,392,1460,881,2341
00254700,GRACE UNIVERSITY                        ,NE,68108-3629,Private      ,42,80,122,314,268,582
00254800,HASTINGS COLLEGE                        ,NE,68901-7621,Private      ,99,40,139,1448,155,1603
00255100,UNIVERSITY OF NEBRASKA AT KEARNEY       ,NE,68849-0001,Public       ,454,446,900,3972,1544,5516
00255300,MIDLAND LUTHERAN COLLEGE                ,NE,68025-4254,Private      ,62,58,120,766,227,993
00255400,UNIVERSITY OF NEBRASKA-OMAHA            ,NE,68182-0001,Public       ,1123,1284,2407,7876,5549,13425
00255500,NEBRASKA WESLEYAN UNIVERSITY            ,NE,68504-2796,Private      ,153,97,250,1794,423,2217
00255700,MID-PLAINS COMM COLLEGE - NORTH PLATTE  ,NE,69101-9420,Public       ,115,224,339,449,554,1003
00255701,MID-PLAINS COMMUNITY COLLEGE - MCCOOK   ,NE,69001-2631,Public       ,55,54,109,226,146,372
00255900,PERU STATE COLLEGE                      ,NE,68421-0010,Public       ,130,241,371,939,909,1848
00256000,WESTERN NEBRASKA COMMUNITY COLLEGE      ,NE,69361-1815,Public       ,160,363,523,653,965,1618
00256300,UNION COLLEGE                           ,NE,68506-4387,Private      ,125,68,193,699,300,999
00256500,UNIVERSITY OF NEBRASKA-LINCOLN          ,NE,68588-0419,Public       ,1323,958,2281,14655,4921,19576
00256596,UNIVERSITY OF NEBRASKA - CURTIS         ,NE,69025-9522,Public       ,28,19,47,223,43,266
00256600,WAYNE STATE COLLEGE                     ,NE,68787-1172,Public       ,322,265,587,2767,825,3592
00256700,YORK COLLEGE                            ,NE,68467-2699,Private      ,75,47,122,559,139,698
00443100,MARY LANNING MEM HOSP SCH RAD TECH      ,NE,68901-4497,Private      ,0,1,1,7,5,12
00443600,REGNL WST MEDCL CTR SCHL RAD            ,NE,69361-0000,Private      ,0,3,3,5,7,12
00458608,KAPLAN UNIVERSITY - OMAHA               ,NE,68134-1002,Proprietary  ,58,373,431,215,1468,1683
00458609,KAPLAN UNIVERSITY - LINCOLN             ,NE,68508-2668,Proprietary  ,32,261,293,141,1035,1176
00639900,BRYANLGH COLLEGE OF HEALTH SCIENCES     ,NE,68506-1398,Private      ,28,31,59,296,237,533
00640400,NEBR METHODIST CLG OF NURS ALLD HLTH    ,NE,68114-2852,Private      ,43,148,191,349,543,892
00689500,UNIVERSITY OF NEBRASKA-MED CTR          ,NE,68198-4265,Public       ,32,197,229,537,2117,2654
00750100,VATTEROTT COLLEGE                       ,NE,68137-1237,Proprietary  ,66,220,286,162,781,943
00849200,ALEGENT HEALTH SCHOOLS                  ,NE,68114-2767,Private      ,10,25,35,30,79,109
00952300,BAHNER COLLEGE OF HAIRSTYLING           ,NE,68025-3297,Proprietary  ,7,14,21,25,26,51
00961700,CAPITOL BEAUTY SCHOOL                   ,NE,68144-3873,Proprietary  ,28,25,53,108,90,198
00974300,BELLEVUE UNIVERSITY                     ,NE,68005-0000,Private      ,228,2169,2397,679,5646,6325
00986200,CLARKSON COLLEGE                        ,NE,68131-2739,Private      ,60,153,213,440,762,1202
01151900,JOSEPH'S COLLEGE OF BEAUTY/ALL CAMPUSES ,NE,68510-2226,Proprietary  ,56,74,130,154,247,401
01151909,JOSEPH'S COLLEGE OF BEAUTY - OMAHA      ,NE,68131-0000,Proprietary  ,1,7,8,4,20,24
01166700,NORTHEAST COMMUNITY COLLEGE             ,NE,68702-0000,Public       ,299,383,682,1583,1121,2704
01258600,METROPOLITAN COMMUNITY COLLEGE          ,NE,68103-0000,Public       ,1094,2590,3684,3723,8403,12126
01297600,NEBRASKA CHRISTIAN COLLEGE              ,NE,68046-4256,Private      ,27,17,44,118,44,162
02079700,COLLEGE OF HAIR DESIGN                  ,NE,68508-0000,Proprietary  ,41,49,90,174,125,299
02099500,CENTRAL COMMUNITY COLLEGE- GI           ,NE,68801-0000,Public       ,186,405,591,579,1080,1659
02099501,CENTRAL COMMUNITY COLLEGE - HASTINGS    ,NE,68902-0000,Public       ,170,226,396,898,631,1529
02099502,CENTRAL COMMUNITY COLLEGE - COLUMBUS    ,NE,68602-0000,Public       ,106,165,271,418,401,819
02508300,SOUTHEAST COMM. COLLEGE-ALL CAMPUSES    ,NE,68520-0000,Public       ,1054,1334,2388,4682,5011,9693
02550800,NEBRASKA INDIAN COMMUNITY COLLEGE       ,NE,68039-0000,Private      ,13,58,71,16,80,96
02610500,XENON INTERNATIONAL ACADEMY II          ,NE,68127-3522,Proprietary  ,66,57,123,211,159,370
03127300,OMAHA SCHOOL OF MASSAGE THERAPY         ,NE,68127-5002,Proprietary  ,22,73,95,56,123,179
03164300,THE CREATIVE CENTER                     ,NE,68164-2911,Proprietary  ,21,5,26,167,25,192
03279300,MYOTHERAPY INSTITUTE                    ,NE,68516-3641,Proprietary  ,3,12,15,21,28,49
03323300,LITTLE PRIEST TRIBAL COLLEGE            ,NE,68071-0000,Private      ,19,63,82,25,84,109
03821400,UNIVERSAL COLLEGE OF HEALING ARTS       ,NE,68112-1810,Proprietary  ,4,26,30,8,56,64
00256800,UNIVERSITY OF NEVADA RENO               ,NV,89557-0002,Public       ,681,796,1477,7285,4642,11927
00256900,UNIVERSITY OF NEVADA-LAS VEGAS          ,NV,89154-1001,Public       ,1417,2343,3760,11498,12819,24317
00697700,GREAT BASIN COLLEGE                     ,NV,89801-3348,Public       ,162,384,546,519,973,1492
00736700,MARINELLO SCHOOLS OF BEAUTY             ,NV,89110-3563,Proprietary  ,60,112,172,131,293,424
00737100,MARINELLO SCHOOL OF BEAUTY              ,NV,89502-5982,Proprietary  ,18,55,73,41,126,167
00844103,ANTHEM INSTITUTE - MORRISON UNIVERSITY  ,NV,89521-4826,Proprietary  ,6,21,27,13,53,66
00919200,SIERRA NEVADA COLLEGE                   ,NV,89451-0000,Private      ,54,203,257,307,459,766
01036200,COLLEGE OF SOUTHERN NEVADA              ,NV,89146-1139,Public       ,2478,5085,7563,8499,16514,25013
01036300,WESTERN NEVADA COLLEGE                  ,NV,89703-0000,Public       ,269,690,959,950,2031,2981
01323200,ACADEMY OF HAIR DESIGN                  ,NV,89102-0000,Proprietary  ,59,53,112,108,133,241
02107700,TRUCKEE MEADOWS COMMUNITY CLG           ,NV,89512-0000,Public       ,696,1366,2062,2643,5029,7672
02237500,EVEREST COLLEGE                         ,NV,89103-0000,Proprietary  ,172,445,617,404,1039,1443
02338509,NEVADA CAREER INSTITUTE                 ,NV,89121-0000,Proprietary  ,18,114,132,44,272,316
02361001,ITT TECHNICAL INSTITUTE                 ,NV,89014-0000,Proprietary  ,159,427,586,357,915,1272
02616703,SCOTTSDALE CULINARY INSTITUTE - LE CORDO,NV,89144-7047,Proprietary  ,15,71,86,97,187,284
02621500,CAREER COLLEGE OF NORTHERN NEVADA       ,NV,89434-7905,Proprietary  ,40,145,185,150,600,750
03030603,UTAH CLG OF MASSAGE THERAPY-NSMT        ,NV,89123-0000,Proprietary  ,64,187,251,111,369,480
03031405,INTERNATIONAL ACADEMY OF DESIGN AND TECH,NV,89074-7750,Proprietary  ,91,124,215,293,406,699
03043200,KAPLAN COLLEGE                          ,NV,89102-8618,Proprietary  ,71,336,407,182,956,1138
03076404,HIGH-TECH INSTITUTE - LAS VEGAS         ,NV,89102-4514,Proprietary  ,7,38,45,41,139,180
03084600,THE ART INSTITUTE OF LAS VEGAS          ,NV,89074-7737,Proprietary  ,277,334,611,1150,1406,2556
03088200,CARSON CITY BEAUTY ACADEMY              ,NV,89706-0000,Proprietary  ,9,29,38,32,89,121
03110000,ACADEMY OF HEALING ARTS                 ,NV,89106-4031,Proprietary  ,112,268,380,208,666,874
03232306,EUPHORIA INSTITUTE - SUMMERLIN          ,NV,89117-8803,Proprietary  ,46,70,116,95,175,270
03232307,EUPHORIA INSTITUTE - GREEN VALLEY       ,NV,89052-4964,Proprietary  ,45,67,112,124,208,332
03232308,EUPHORIA INSTITUTE - ALIANTE            ,NV,89131-1036,Proprietary  ,36,51,87,118,210,328
03787300,EXPERTISE SCHOOL OF BEAUTY              ,NV,89106-2516,Private      ,20,88,108,33,187,220
03838500,NORTHWEST HEALTH CAREERS                ,NV,89128-0000,Proprietary  ,25,79,104,46,149,195
03975300,INSTITUTE OF PROFESSIONAL CAREERS       ,NV,89119-7825,Proprietary  ,8,31,39,23,80,103
04065300,UNIVERSITY OF SOUTHERN NEVADA           ,NV,89014-2333,Private      ,25,85,110,157,1317,1474
04114300,NEVADA STATE COLLEGE                    ,NV,89002-9455,Public       ,130,334,464,770,1397,2167
04147600,AVEDA INSTITUTE LAS VEGAS               ,NV,89119-6103,Proprietary  ,28,53,81,58,124,182
00257200,COLBY-SAWYER COLLEGE                    ,NH,03257-4648,Private      ,17,9,26,2503,82,2585
00257300,DARTMOUTH COLLEGE                       ,NH,03755-3529,Private      ,112,98,210,10417,1826,12243
00257500,FRANKLIN PIERCE UNIVERSITY              ,NH,03461-0060,Private      ,67,193,260,2591,1026,3617
00257900,NEW ENGLAND COLLEGE                     ,NH,03242-3293,Private      ,65,251,316,1339,896,2235
00258000,SOUTHERN NEW HAMPSHIRE UNIVERSITY       ,NH,03106-1045,Private      ,149,951,1100,3877,3676,7553
00258100,NHTI  - CONCORD'S COMMUNITY COLLEGE     ,NH,03301-7412,Public       ,376,382,758,2304,1503,3807
00258200,MANCHESTER COMMUNITY COLLEGE            ,NH,03102-8518,Public       ,265,325,590,995,1085,2080
00258202,NEW HAMPSHIRE COMMUNITY TECHNICAL COLLEG,NH,03038-0000,Public       ,2,1,3,19,5,24
00258300,GREAT BAY COMMUNITY COLLEGE             ,NH,03885-0000,Public       ,123,177,300,688,760,1448
00258600,RIVIER COLLEGE                          ,NH,03060-5086,Private      ,66,216,282,1418,865,2283
00258700,SAINT ANSELM COLLEGE                    ,NH,03102-1310,Private      ,34,7,41,3865,78,3943
00258900,UNIVERSITY OF NEW HAMPSHIRE             ,NH,03824-2511,Public       ,281,320,601,18873,3134,22007
00259000,KEENE STATE COLLEGE                     ,NH,03431-0000,Public       ,205,72,277,7116,568,7684
00259100,PLYMOUTH STATE UNIVERSITY               ,NH,03264-1595,Public       ,153,215,368,5945,1045,6990
00301004,ANTIOCH UNIVERSITY                      ,NH,03431-0000,Private      ,1,88,89,3,813,816
00472900,HESSER COLLEGE                          ,NH,03103-7230,Proprietary  ,221,382,603,785,1215,2000
00472901,HESSER COLLEGE - NASHUA CAMPUS          ,NH,03063-1286,Proprietary  ,51,148,199,183,629,812
00472904,HESSER COLLEGE - PORTSMOUTH CAMPUS      ,NH,03801-3245,Proprietary  ,59,144,203,157,486,643
00472905,HESSER COLLEGE - SALEM CAMPUS           ,NH,03079-2842,Proprietary  ,109,255,364,255,623,878
00472906,HESSER COLLEGE - CONCORD CAMPUS         ,NH,03301-3415,Proprietary  ,31,117,148,120,505,625
00473000,MCINTOSH COLLEGE INC                    ,NH,03820-3990,Proprietary  ,6,2,8,10,16,26
00473100,DANIEL WEBSTER COLLEGE                  ,NH,03063-1300,Proprietary  ,52,58,110,1050,223,1273
00473300,CHESTER COLLEGE OF NEW ENGLAND          ,NH,03036-4331,Private      ,17,7,24,260,35,295
00529100,WHITE MOUNTAINS COMMUNITY COLLEGE       ,NH,03570-3799,Public       ,71,162,233,341,565,906
00702500,LEBANON COLLEGE                         ,NH,03766-0000,Private      ,6,18,24,37,62,99
00755500,LAKES REGION COMMUNITY COLLEGE          ,NH,03246-1326,Public       ,134,140,274,583,487,1070
00756000,RIVER VALLEY COMMUNITY COLLEGE          ,NH,03743-9707,Public       ,77,171,248,292,589,881
00849300,CONTINENTAL ACADEMIE OF HAIR DESIGN     ,NH,03103-4901,Proprietary  ,7,8,15,22,15,37
00864500,EMPIRE BEAUTY SCHOOL                    ,NH,03220-0000,Proprietary  ,42,52,94,107,101,208
00923600,NASHUA COMMUNITY COLLEGE                ,NH,03063-2052,Public       ,232,223,455,793,784,1577
01318900,CONTINENTAL ACADEMIE OF HAIR DESIGN     ,NH,03051-3754,Proprietary  ,17,14,31,43,42,85
02097900,FRANKLIN PIERCE LAW CENTER              ,NH,03301-0000,Private      ,1,28,29,6,766,772
02140400,ST JOSEPH SCH OF PRAC NRSG              ,NH,03060-0000,Private      ,11,44,55,39,135,174
02174800,MICHAEL'S SCHOOL OF HAIR DESIGN & ESTHET,NH,03110-0000,Proprietary  ,27,17,44,69,44,113
02179600,EMPIRE BEAUTY SCHOOL                    ,NH,03878-0000,Proprietary  ,29,53,82,85,110,195
02211600,PORTSMOUTH BTY SCH OF HAIR DESIGN       ,NH,03801-4084,Proprietary  ,3,7,10,15,19,34
02223300,MAGDALEN COLLEGE                        ,NH,03278-4012,Private      ,9,2,11,51,5,56
02245400,KEENE BEAUTY ACADEMY                    ,NH,03431-0000,Proprietary  ,6,13,19,36,35,71
02247000,NEW ENGLAND SCHOOL OF HAIR DESIGN       ,NH,03784-0000,Proprietary  ,7,17,24,31,53,84
02300200,CONCORD ACADEMY OF HAIR DESIGN          ,NH,03301-0000,Proprietary  ,0,0,0,1,1,2
03043100,THOMAS MORE COLLEGE OF LIBERAL ARTS     ,NH,03054-4818,Private      ,9,1,10,83,6,89
03101300,GRANITE STATE COLLEGE                   ,NH,03301-6400,Public       ,69,284,353,256,1255,1511
03182300,NEW HAMPSHIRE INSTITUTE OF ART          ,NH,03104-4858,Private      ,20,13,33,580,100,680
03437300,UPPER VALLEY TEACHER TRANING PROGRAM    ,NH,03766-1358,Private      ,0,7,7,1,44,45
03729300,NH INSTITUTE FOR THERAPEUTIC ARTS       ,NH,03051-4906,Proprietary  ,2,18,20,14,43,57
00267000,BAPTIST BIBLE COLG OF PENNSYLVANIA      ,PA,18411-1297,Private      ,65,52,117,645,184,829
00322800,BRYN ATHYN COLLEGE OF THE NEW CHURCH    ,PA,19009-0717,Private      ,19,3,22,163,20,183
00322900,ALBRIGHT COLLEGE                        ,PA,19612-5234,Private      ,94,141,235,3549,894,4443
00323000,ALLEGHENY COLLEGE                       ,PA,16335-3902,Private      ,57,17,74,3442,94,3536
00323100,COMM CLG OF ALLEGHENY-ALLEGHENY CMP     ,PA,15212-0000,Public       ,501,1136,1637,2419,4303,6722
00323101,"COMM CLG OF ALLEGHENY, BOYCE CAMPUS     ",PA,15146-0000,Public       ,266,489,755,1308,2019,3327
00323102,"COMM CLG OF ALLEGHENY, NORTH CAMPUS     ",PA,15237-0000,Public       ,232,360,592,1070,1236,2306
00323103,"COMM CLG OF ALLEGHENY, SOUTH CAMPUS     ",PA,15122-0000,Public       ,337,515,852,1619,1980,3599
00323300,ALVERNIA UNIVERSITY                     ,PA,19607-1799,Private      ,63,261,324,2004,1396,3400
00323500,ARCADIA UNIVERSITY                      ,PA,19038-3295,Private      ,102,263,365,3940,1874,5814
00323700,BRYN MAWR COLLEGE                       ,PA,19010-2899,Private      ,31,32,63,1703,499,2202
00323800,BUCKNELL UNIVERSITY                     ,PA,17837-2122,Private      ,33,16,49,5184,169,5353
00323900,BUCKS COUNTY COMMUNITY COLLEGE          ,PA,18940-1320,Public       ,699,1057,1756,3522,3170,6692
00324000,BUTLER COUNTY COMMUNITY COLLEGE         ,PA,16001-0000,Public       ,320,459,779,1752,1824,3576
00324100,CABRINI COLLEGE                         ,PA,19087-3698,Private      ,85,514,599,2217,1238,3455
00324200,CARNEGIE MELLON UNIVERSITY              ,PA,15213-3890,Private      ,150,122,272,10274,1420,11694
00324201,CARNEGIE MELLON UNIV- THE HEINZ SCH     ,PA,15213-0000,Private      ,5,35,40,271,542,813
00324202,CARNEGIE MELLON- TEPPER SCHOOL OF BUSINE,PA,15213-0000,Private      ,7,88,95,246,559,805
00324300,CEDAR CREST COLLEGE                     ,PA,18104-6196,Private      ,35,152,187,1331,1117,2448
00324400,CHATHAM UNIVERSITY                      ,PA,15232-2826,Private      ,25,251,276,758,1419,2177
00324500,CHESTNUT HILL COLLEGE                   ,PA,19118-2693,Private      ,85,382,467,1848,1562,3410
00324700,MISERICORDIA  UNIVERSITY                ,PA,18612-1008,Private      ,56,214,270,2023,1042,3065
00324900,COMMUNITY COLLEGE OF PHILADELPHIA       ,PA,19130-3991,Public       ,2071,4182,6253,9799,15546,25345
00325100,CURTIS INSTITUTE OF MUSIC               ,PA,19103-6187,Private      ,2,6,8,212,97,309
00325200,DELAWARE VALLEY COLLEGE                 ,PA,18901-2697,Private      ,74,128,202,2264,362,2626
00325300,DICKINSON COLLEGE                       ,PA,17013-2896,Private      ,60,15,75,3175,174,3349
00325400,DICKINSON SCHOOL OF LAW                 ,PA,17013-2899,Private      ,0,0,0,4,35,39
00325600,DREXEL UNIVERSITY                       ,PA,19104-2875,Private      ,458,2407,2865,24133,13904,38037
00325800,DUQUESNE UNIVERSITY                     ,PA,15282-0001,Private      ,183,549,732,7851,4146,11997
00325900,EASTERN UNIVERSITY                      ,PA,19087-3696,Private      ,115,433,548,2172,2150,4322
00325908,EASTERN BAPTIST THEOLGCL SEMINARY       ,PA,19096-0000,Private      ,0,22,22,1,91,92
00326200,ELIZABETHTOWN COLLEGE                   ,PA,17022-2298,Private      ,49,88,137,3056,458,3514
00326300,EVANGELICAL SCHOOL OF THEOLOGY          ,PA,17067-0000,Private      ,0,15,15,1,98,99
00326500,FRANKLIN & MARSHALL COLLEGE             ,PA,17604-0000,Private      ,96,15,111,3072,106,3178
00326600,GANNON UNIVERSITY                       ,PA,16541-0001,Private      ,85,217,302,3489,1417,4906
00326700,GENEVA COLLEGE                          ,PA,15010-3599,Private      ,53,161,214,1766,868,2634
00326800,GETTYSBURG COLLEGE                      ,PA,17325-1486,Private      ,49,12,61,4093,90,4183
00326900,GROVE CITY COLLEGE                      ,PA,16127-0000,Private      ,19,5,24,1879,42,1921
00327000,GWYNEDD-MERCY COLLEGE                   ,PA,19437-0901,Private      ,76,255,331,1781,1114,2895
00327200,HARCUM COLLEGE                          ,PA,19010-3476,Private      ,59,179,238,546,1056,1602
00327300,HARRISBURG AREA COMMUNITY COLLEGE       ,PA,17110-2999,Public       ,1552,3074,4626,7895,12050,19945
00327400,HAVERFORD COLLEGE                       ,PA,19041-1392,Private      ,32,4,36,2178,29,2207
00327500,HOLY FAMILY UNIVERSITY                  ,PA,19114-2094,Private      ,89,266,355,2009,1688,3697
00327600,IMMACULATA UNIVERSITY                   ,PA,19345-0647,Private      ,96,458,554,1433,1456,2889
00327700,INDIANA UNIVERSITY OF PENNSYLVANIA      ,PA,15705-1097,Public       ,476,491,967,13332,3629,16961
00327900,JUNIATA COLLEGE                         ,PA,16652-2196,Private      ,23,14,37,2202,85,2287
00328000,KEYSTONE COLLEGE                        ,PA,18440-0200,Private      ,109,124,233,1558,763,2321
00328200,KINGS COLLEGE                           ,PA,18711-0801,Private      ,87,100,187,2829,489,3318
00328300,LACKAWANNA COLLEGE                      ,PA,18509-9961,Private      ,199,197,396,1372,872,2244
00328400,LAFAYETTE COLLEGE                       ,PA,18042-1768,Private      ,46,9,55,3758,80,3838
00328500,LANCASTER BIBLE COLLEGE                 ,PA,17601-5036,Private      ,31,105,136,571,338,909
00328600,LANCASTER THEOLOGICAL SEMINARY          ,PA,17603-0000,Private      ,0,13,13,1,104,105
00328700,LASALLE UNIVERSITY                      ,PA,19141-1199,Private      ,276,675,951,5339,3114,8453
00328800,LEBANON VALLEY COLLEGE                  ,PA,17003-1400,Private      ,36,22,58,2313,225,2538
00328900,LEHIGH UNIVERSITY                       ,PA,18015-1588,Private      ,98,151,249,8144,770,8914
00329000,LINCOLN UNIVERSITY                      ,PA,19352-0999,Public       ,240,304,544,4033,1232,5265
00329100,LUTHERAN THEOLOG SEMINARY-GETTYSBRG     ,PA,17325-0000,Private      ,0,11,11,0,142,142
00329200,LUTHERAN THEOLOGICAL SEMINARY           ,PA,19119-0000,Private      ,0,25,25,0,195,195
00329300,LYCOMING COLLEGE                        ,PA,17701-5192,Private      ,43,15,58,2009,102,2111
00329400,MANOR COLLEGE                           ,PA,19046-3399,Private      ,48,117,165,502,513,1015
00329600,MARYWOOD UNIVERSITY                     ,PA,18509-1598,Private      ,95,237,332,2684,1555,4239
00329700,MERCYHURST COLLEGE                      ,PA,16546-0001,Private      ,247,308,555,3963,1648,5611
00329800,MESSIAH COLLEGE                         ,PA,17027-0800,Private      ,121,32,153,3431,169,3600
00330000,MOORE COLLEGE OF ART & DESIGN           ,PA,19103-1179,Private      ,32,42,74,745,251,996
00330100,MORAVIAN COLLEGE                        ,PA,18018-6650,Private      ,45,49,94,2195,251,2446
00330101,MORAVIAN THEOLOGICAL SEMINARY           ,PA,18018-0000,Private      ,0,15,15,11,73,84
00330200,MOUNT ALOYSIUS COLLEGE                  ,PA,16630-1999,Private      ,30,83,113,1235,771,2006
00330300,CARLOW COLLEGE                          ,PA,15213-3165,Private      ,50,354,404,1217,1632,2849
00330400,MUHLENBERG COLLEGE                      ,PA,18104-5586,Private      ,71,69,140,3397,289,3686
00330600,VALLEY FORGE CHRISTIAN COLLEGE          ,PA,19460-2399,Private      ,68,53,121,889,240,1129
00330900,PEIRCE COLLEGE                          ,PA,19102-4699,Private      ,35,390,425,243,2066,2309
00331100,PENNSYLVANIA COLLEGE OF OPTOMETRY       ,PA,19027-1598,Private      ,0,26,26,6,912,918
00331300,WIDENER UNIVERSITY                      ,PA,19013-5792,Private      ,197,292,489,4230,2062,6292
00331302,WIDENER UNIV SCH OF LAW- HARRISBURG     ,PA,17106-9381,Private      ,1,49,50,7,843,850
00331500,BLOOMSBURG UNIVERSITY OF PA             ,PA,17815-1301,Public       ,502,266,768,11103,1831,12934
00331600,CALIFORNIA UNIV OF PENNSYLVANIA         ,PA,15419-1394,Public       ,319,661,980,6758,3842,10600
00331700,CHEYNEY UNIVERSITY OF PENNSYLVANIA      ,PA,19319-0200,Public       ,201,188,389,2139,912,3051
00331800,CLARION UNIVERSITY OF PENNSYLVANIA      ,PA,16214-1232,Public       ,289,371,660,5499,2145,7644
00332000,EAST STROUDSBURG UNIVERSITY             ,PA,18301-2999,Public       ,363,299,662,7832,1605,9437
00332100,EDINBORO UNIVERSITY OF PENNSYLVANIA     ,PA,16444-0001,Public       ,370,666,1036,6111,3335,9446
00332200,KUTZTOWN UNIVERSITY OF PENNSYLVANIA     ,PA,19530-9339,Public       ,491,331,822,10524,2017,12541
00332300,LOCK HAVEN UNIV OF PENNSYLVANIA         ,PA,17745-2439,Public       ,207,162,369,5363,1231,6594
00332400,MANSFIELD UNIVERSITY                    ,PA,16933-1123,Public       ,220,236,456,3073,1128,4201
00332500,MILLERSVILLE UNIVERSITY OF PA           ,PA,17551-1800,Public       ,338,267,605,8366,2029,10395
00332600,SHIPPENSBURG UNIVERSITY                 ,PA,17257-2299,Public       ,467,257,724,7997,1547,9544
00332700,SLIPPERY ROCK UNIVERSITY                ,PA,16057-1326,Public       ,419,329,748,8407,2073,10480
00332800,WEST CHESTER UNIVERSITY                 ,PA,19383-0001,Public       ,584,496,1080,14400,3476,17876
00332900,PENN STATE UNIVERSITY                   ,PA,16802-1503,Public       ,3522,3267,6789,69729,20963,90692
00332901,PENN STATE UNIV-HERSHEY MEDCL CTR       ,PA,17033-0000,Public       ,0,0,0,2,10,12
00335000,UNIVERSITY OF THE ARTS (THE)            ,PA,19102-9493,Private      ,140,95,235,3260,633,3893
00335100,PHILADELPHIA BIBLICAL UNIVERSITY        ,PA,19047-2942,Private      ,85,159,244,911,527,1438
00335200,PHILADELPHIA CLG OSTEOPATHIC MED        ,PA,19131-0000,Private      ,1,164,165,16,2716,2732
00335300,UNIVERSITY OF THE SCIENCES IN PHILADELPH,PA,19104-4495,Private      ,73,91,164,3415,920,4335
00335400,PHILADELPHIA UNIVERSITY                 ,PA,19144-5497,Private      ,139,229,368,4003,1171,5174
00335600,PITTSBURGH THEOLOGICAL SEMINARY         ,PA,15206-0000,Private      ,0,25,25,3,211,214
00335700,POINT PARK UNIVERSITY                   ,PA,15222-1912,Private      ,133,406,539,3208,2167,5375
00335800,REFORMED PRESBYTERIAN THEOL SEMINAR     ,PA,15208-0000,Private      ,0,6,6,0,25,25
00335900,ROBERT MORRIS UNIVERSITY                ,PA,15108-1189,Private      ,175,375,550,4087,1995,6082
00336000,ROSEMONT COLLEGE                        ,PA,19010-1699,Private      ,22,155,177,711,526,1237
00336200,SETON HILL UNIVERSITY                   ,PA,15601-1599,Private      ,77,141,218,1847,893,2740
00336400,ST. CHARLES BORROMEO SEMINARY           ,PA,19096-0000,Private      ,7,31,38,31,47,78
00336600,SAINT FRANCIS UNIVERSITY                ,PA,15940-0600,Private      ,108,103,211,2001,592,2593
00336700,SAINT JOSEPH'S UNIVERSITY               ,PA,19131-1395,Private      ,295,717,1012,6068,2257,8325
00336800,ST VINCENT COLLEGE                      ,PA,15650-2690,Private      ,61,52,113,2141,329,2470
00336900,SUSQUEHANNA UNIVERSITY                  ,PA,17870-1001,Private      ,62,7,69,3027,99,3126
00337000,SWARTHMORE COLLEGE                      ,PA,19081-1397,Private      ,41,9,50,3493,65,3558
00337100,TEMPLE UNIV - MAIN CAMPUS               ,PA,19122-6003,Private      ,1224,1191,2415,27691,7886,35577
00337101,TEMPLE UNIV - SCHOOL OF LAW             ,PA,19122-0000,Private      ,3,80,83,50,2726,2776
00337102,TEMPLE UNIV - SCHOOL OF MEDICINE        ,PA,19140-0000,Private      ,9,53,62,138,1418,1556
00337103,TEMPLE UNIV - SCHOOL OF DENTISTRY       ,PA,19140-0000,Private      ,0,33,33,22,599,621
00337104,TEMPLE UNIV - AMBLER CAMPUS             ,PA,19002-0000,Private      ,58,108,166,742,585,1327
00337105,TEMPLE UNIV - SCH OF ALLIED HEALTH      ,PA,19140-0000,Private      ,17,69,86,377,451,828
00337106,TEMPLE UNIV - SCHOOL OF PHARMACY        ,PA,19140-0000,Private      ,6,41,47,191,701,892
00337107,TEMPLE UNIV - TYLER SCHOOL OF ART       ,PA,19122-0000,Private      ,49,37,86,696,362,1058
00337108,TEMPLE UNIV - GRAD DIV HEALTH SCI       ,PA,19140-0000,Private      ,9,67,76,66,550,616
00337109,TEMPLE UNIV - GRADUATE DIVISION         ,PA,19122-0000,Private      ,8,480,488,160,3152,3312
00337111,TEMPLE UNIV-SCH OF PODIATRIC MED        ,PA,19107-0000,Private      ,1,22,23,7,404,411
00337600,THIEL COLLEGE                           ,PA,16125-2181,Private      ,44,31,75,1363,168,1531
00337800,UNIVERSITY OF PENNSYLVANIA              ,PA,19104-6216,Private      ,306,1053,1359,16155,12740,28895
00337900,UNIVERSITY OF PITTSBURGH                ,PA,15260-0000,Public       ,1056,1447,2503,26943,10336,37279
00337906,UNIVERSITY OF PITTSBURGH - SCHOOL OF MED,PA,15261-0001,Public       ,5,14,19,66,986,1052
00337907,UNIVERSITY OF PITTSBURGH - SCHOOL OF DEN,PA,15261-2523,Public       ,1,6,7,40,375,415
00338400,UNIVERSITY OF SCRANTON                  ,PA,18510-4622,Private      ,157,442,599,6998,1538,8536
00338500,URSINUS COLLEGE                         ,PA,19426-2562,Private      ,38,11,49,3650,123,3773
00338600,VALLEY FORGE MILITARY COLLEGE           ,PA,19087-3695,Private      ,36,8,44,351,35,386
00338800,VILLANOVA UNIVERSITY                    ,PA,19085-1699,Private      ,118,453,571,10814,2216,13030
00338801,VILLANOVA UNIV SCH OF LAW               ,PA,19085-0000,Private      ,1,67,68,22,1776,1798
00338900,WASHINGTON & JEFFERSON COLLEGE          ,PA,15301-4801,Private      ,59,9,68,2734,54,2788
00339100,WAYNESBURG UNIVERSITY                   ,PA,15370-1222,Private      ,54,237,291,1979,908,2887
00339200,WESTMINSTER COLLEGE                     ,PA,16172-0002,Private      ,27,22,49,2496,142,2638
00339300,WESTMINSTER THEOLOGICAL SEMINARY        ,PA,19038-0000,Private      ,0,21,21,2,244,246
00339400,WILKES UNIVERSITY                       ,PA,18766-0998,Private      ,158,233,391,3070,1014,4084
00339500,PENNSYLVANIA COLLEGE OF TECHNOLOGY      ,PA,17701-5779,Public       ,263,395,658,5436,2331,7767
00339600,WILSON COLLEGE                          ,PA,17201-1285,Private      ,18,98,116,449,459,908
00339900,YORK COLLEGE OF PENNSYLVANIA            ,PA,17405-7199,Private      ,253,241,494,7223,1171,8394
00398600,DESALES UNIVERSITY                      ,PA,18034-9568,Private      ,76,217,293,2223,1094,3317
00398700,LA ROCHE COLLEGE                        ,PA,15237-5898,Private      ,51,63,114,962,455,1417
00398800,NEUMANN COLLEGE                         ,PA,19014-1298,Private      ,133,207,340,2832,1023,3855
00405800,GRATZ COLLEGE                           ,PA,19027-3097,Private      ,0,38,38,2,114,116
00445200,MONTGOMERY COUNTY COMMUNITY COLLEGE     ,PA,19422-6300,Public       ,732,1161,1893,3919,4264,8183
00488700,BRANDYWINE SCHOOL OF NURSING            ,PA,19320-1536,Proprietary  ,1,5,6,23,55,78
00488900,CAMBRIA-ROWE BUSINESS COLLEGE           ,PA,15902-2494,Proprietary  ,28,66,94,162,278,440
00489000,CENTRAL PENNSYLVANIA COLLEGE            ,PA,17093-0309,Proprietary  ,73,132,205,1073,927,2000
00489300,DU BOIS BUSINESS COLLEGE                ,PA,15801-2401,Proprietary  ,43,87,130,207,355,562
00489400,ERIE BUSINESS CENTER                    ,PA,16501-1305,Proprietary  ,22,139,161,72,442,514
00489401,ERIE BUSINESS CENTER SOUTH              ,PA,16101-0000,Proprietary  ,5,32,37,20,97,117
00489800,MCCANN SCHOOL OF BUSINESS & TECHNOL     ,PA,17901-1335,Proprietary  ,247,612,859,932,2248,3180
00489900,MERCY HOSP SCH OF NURSING               ,PA,15219-5166,Private      ,5,16,21,88,128,216
00490100,NEWPORT BUSINESS INSTITUTE              ,PA,15068-3929,Proprietary  ,2,20,22,35,75,110
00490200,PENN COMMERCIAL BUSINESS/TECHNICAL SCHL ,PA,15301-2871,Proprietary  ,63,125,188,245,405,650
00491000,KAPLAN CAREER INSTITUTE                 ,PA,17111-3571,Proprietary  ,65,272,337,287,735,1022
00491001,THOMPSON INSTITUTE-PHILADEPHIA CAMPUS   ,PA,19104-3386,Proprietary  ,120,442,562,308,1098,1406
00491400,NEWPORT BUSINESS INSTITUTE              ,PA,17701-5855,Proprietary  ,5,36,41,22,173,195
00500701,WEST VIRGINIA CAREER INSTITUTE          ,PA,15456-0000,Proprietary  ,15,30,45,66,142,208
00531000,PITTSBURGH INST OF AERONAUTICS          ,PA,15236-0000,Private      ,52,36,88,247,131,378
00533000,FAYETTE CNTY AREA VOC TECH PRC NRSG     ,PA,15401-0000,Public       ,5,14,19,31,95,126
00533500,CENTRAL PENN INST OF SCI & TECH PNP     ,PA,16823-0000,Public       ,15,41,56,70,144,214
00536500,YORK CO AREA VOC-TECH SCH-PRAC NSG      ,PA,17402-0000,Public       ,5,74,79,22,164,186
00594200,UPMC PRESBYTERIAN SCH OF RADIOLOGIC     ,PA,15213-2582,Private      ,0,0,0,15,15,30
00594600,SCHOOL OF RADIOLOGIC TECHNOLOGY AT ST. C,PA,19134-1995,Proprietary  ,1,9,10,16,47,63
00653400,CITIZENS SCHOOL OF NURSING              ,PA,15068-6591,Private      ,4,14,18,100,131,231
00653700,CONEMAUGH VLY MEM HOSP SCH NRSNG        ,PA,15905-4398,Private      ,4,6,10,86,102,188
00653702,CONEMAUGH HOSP- SCH HISTOTECHNOLOGY     ,PA,15905-0000,Private      ,0,2,2,2,10,12
00653704,CONEMAUGH VLY MEM HOSP SCH RAD TECH     ,PA,15905-0000,Private      ,2,3,5,37,13,50
00653706,CONEMAUGH VLY MEM HOSP SCH  MED TECH    ,PA,15905-4398,Private      ,0,0,0,4,7,11
00653900,EPISCOPAL HOSPITAL SCHL OF NURSING      ,PA,19125-1000,Private      ,2,9,11,12,62,74
00655100,ST MARGARET SCHL OF NURSING             ,PA,15238-3205,Private      ,3,15,18,61,159,220
00656000,OHIO VALLEY HOSP SCH OF NURSING         ,PA,15136-1694,Private      ,8,12,20,41,55,96
00656500,READING HOSPITAL SCHOOL OF HEALTH SCIENC,PA,19611-1744,Private      ,16,39,55,218,331,549
00657400,"ST LUKE'S HOSPITAL OF BETHLEHEM, PA     ",PA,18015-1065,Private      ,5,23,28,59,147,206
00657600,SEWICKLEY VALLEY HOSP SCH NRSNG         ,PA,15143-1498,Private      ,6,6,12,46,69,115
00657700,UPMC SHADYSIDE SCHOOL OF NURSING        ,PA,15232-1381,Private      ,18,87,105,146,322,468
00657800,SHARON REGIONAL SCHOOL OF NURSING       ,PA,16146-3395,Private      ,0,16,16,10,53,63
00658200,WASHINGTON HOSP SCH OF NURSING          ,PA,15301-3398,Private      ,8,9,17,53,138,191
00658202,WASHINGTON HOSP SCH OF RAD TECH         ,PA,15301-3398,Private      ,2,3,5,20,16,36
00658300,WESTERN PENN HOSP-SCH OF NURSING        ,PA,15224-1790,Private      ,5,10,15,127,132,259
00680700,COMMUNITY COLLEGE OF BEAVER COUNTY      ,PA,15061-2588,Public       ,232,320,552,1234,1322,2556
00681000,LEHIGH CARBON COMMUNITY COLLEGE         ,PA,18078-2598,Public       ,445,827,1272,2877,3220,6097
00681100,LUZERNE COUNTY COMMUNITY COLLEGE        ,PA,18634-3899,Public       ,485,789,1274,3233,3161,6394
00708700,ABINGTON MEM HOSP SCHL OF NURSING       ,PA,19090-1284,Private      ,4,27,31,87,312,399
00709100,EVEREST INSTITUTE                       ,PA,15222-1320,Proprietary  ,76,294,370,199,835,1034
00711000,DELAWARE COUNTY COMMUNITY COLLEGE       ,PA,19063-1094,Public       ,890,1433,2323,4288,5108,9396
00719100,NORTHAMPTON COMMUNITY COLLEGE           ,PA,18020-7599,Public       ,681,1075,1756,5083,4761,9844
00739802,KATHERINE GIBBS-PHILADELPHIA            ,PA,19403-2422,Proprietary  ,1,1,2,14,31,45
00743000,ANTONELLI INST OF ART & PHOTOGRAPHY     ,PA,19038-8242,Proprietary  ,18,6,24,247,22,269
00743600,KAPLAN CAREER INSTITUTE - ICM CAMPUS    ,PA,15222-1977,Proprietary  ,99,286,385,501,1115,1616
00743700,PITTSBURGH TECHNICAL INSTITUTE          ,PA,15071-3205,Proprietary  ,212,192,404,2339,962,3301
00746900,"HUSSIAN SCHOOL OF ART, INC.             ",PA,19106-0000,Proprietary  ,12,3,15,120,30,150
00747000,"ART INSTITUTE OF PITTSBURGH, THE        ",PA,15219-1328,Proprietary  ,1326,8242,9568,5753,20446,26199
00752900,CTR ART TCH BRDYWN CMPS PRC NRS PRG     ,PA,19320-2459,Public       ,8,26,34,23,126,149
00775900,LINCOLN TECHNICAL INSTITUTE             ,PA,18104-3298,Proprietary  ,99,238,337,366,643,1009
00777900,LANSDALE SCHOOL OF BUSINESS             ,PA,19454-4148,Proprietary  ,42,127,169,114,444,558
00778000,NEW CASTLE SCHOOL OF TRADES             ,PA,16143-9721,Proprietary  ,65,230,295,225,616,841
00778100,CHI INSTITUTE/RETS CAMPUS               ,PA,19008-3516,Proprietary  ,76,252,328,187,623,810
00783200,LINCOLN TECH INSTITUTE                  ,PA,19136-1595,Proprietary  ,123,167,290,384,495,879
00783900,TRIANGLE TECH                           ,PA,15214-3897,Proprietary  ,37,77,114,199,254,453
00791200,THADDEUS STEVENS CLG OF TECHNOLOGY      ,PA,17602-0000,Public       ,109,69,178,1032,401,1433
00791600,FRANKLIN CNTY CAREER & TECH CTR-PNP     ,PA,17201-0000,Public       ,1,10,11,17,41,58
00820000,JAMESON MEMORIAL HOSP SCH NURSING       ,PA,16105-2595,Private      ,1,9,10,27,80,107
00826301,AWARD BEAUTY SCHOOL - CHAMBERSBURG BEAUT,PA,17201-2435,Proprietary  ,0,3,3,3,9,12
00835000,ART INSTITUTE OF PHILADELPHIA           ,PA,19103-5198,Proprietary  ,461,522,983,3853,2316,6169
00844100,ANTHEM INSTITUTE                        ,PA,19064-1243,Proprietary  ,108,326,434,255,705,960
00856800,VET TECH INSTITUTE                      ,PA,15222-3400,Proprietary  ,32,28,60,285,136,421
00865300,JEFFERSON CO DUBOIS VOC TECH-PR NSG     ,PA,15851-0000,Public       ,0,4,4,31,65,96
00888900,LEHIGH VALLEY COLLEGE                   ,PA,18034-8447,Proprietary  ,2,4,6,32,43,75
00895500,PRUONTOS HAIR DESIGN INSTITUTE & BEAUTY ,PA,16602-0000,Proprietary  ,6,4,10,19,22,41
00915705,WYOMING TECHNICAL INSTITUTE - BLAIRSVILL,PA,15717-8060,Proprietary  ,261,199,460,1459,550,2009
00918600,DEAN INSTITUTE OF TECHNOLOGY            ,PA,15226-1197,Proprietary  ,13,65,78,45,129,174
00944900,PENNCO TECH                             ,PA,19007-0000,Proprietary  ,96,223,319,291,556,847
00966400,EMPIRE BEAUTY SCHOOL                    ,PA,18052-5730,Proprietary  ,52,64,116,165,252,417
00966500,EMPIRE BEAUTY SCHOOL                    ,PA,17109-2210,Proprietary  ,21,52,73,69,226,295
00966600,EMPIRE BEAUTY SCHOOL                    ,PA,19605-2803,Proprietary  ,36,68,104,83,240,323
00972100,BRADFORD SCHOOL                         ,PA,15219-2602,Proprietary  ,47,30,77,632,131,763
00972300,FRANKFORD HOSP SCH OF NURSING           ,PA,19124-2696,Private      ,18,33,51,193,289,482
00978300,GORDON PHILLIPS SCH OF BEAUTY CULT      ,PA,19135-0000,Proprietary  ,56,103,159,203,338,541
00986300,LANCASTER GENERAL COLLEGE OF NURSING AND,PA,17602-4955,Private      ,24,91,115,387,624,1011
01000600,GREATER JOHNSTOWN AREA VOC TECH SCH     ,PA,15904-0000,Public       ,22,84,106,76,272,348
01005500,CRAWFORD CNTY AREA VO-TECH PRAC NUR     ,PA,16335-0000,Public       ,0,1,1,7,45,52
01017600,WESTMORELAND COUNTY COMMUNITY CLG       ,PA,15697-1895,Public       ,571,986,1557,2607,3210,5817
01038800,READING AREA COMMUNITY COLLEGE          ,PA,19603-1706,Public       ,485,1054,1539,2035,3506,5541
01054100,EMPIRE BEAUTY SCHOOL                    ,PA,15146-2229,Proprietary  ,55,94,149,150,282,432
01054200,EMPIRE BEAUTY SCHOOL                    ,PA,18701-0000,Proprietary  ,28,71,99,140,220,360
01054300,EMPIRE BEAUTY SCHOOL                    ,PA,17701-3914,Proprietary  ,37,42,79,87,159,246
01081400,PITTSBURGH INST MORTUARY SCIENCE        ,PA,15206-3706,Private      ,10,38,48,80,182,262
01086000,GREATER ALTOONA CAREER/TECH CENTER      ,PA,16602-0000,Public       ,10,70,80,56,248,304
01096300,GREENE COUNTY VOC-TECH SCHOOL           ,PA,15370-0000,Public       ,1,1,2,8,41,49
01097000,EMPIRE BEAUTY SCHOOL                    ,PA,17042-5209,Proprietary  ,14,24,38,28,58,86
01099800,PENNSYLVANIA INSTITUTE OF TECH          ,PA,19063-4098,Private      ,145,268,413,566,954,1520
01102000,EMPIRE BEAUTY SCHOOL                    ,PA,17604-4335,Proprietary  ,42,78,120,98,197,295
01102100,EMPIRE BEAUTY SCHOOL                    ,PA,17402-2862,Proprietary  ,51,131,182,145,440,585
01162100,AUTOMOTIVE TRAINING CENTER              ,PA,19341-1310,Proprietary  ,95,70,165,506,208,714
01162200,WELDER TRAINING & TESTING INST          ,PA,18109-3253,Proprietary  ,12,33,45,36,79,115
01163800,EMPIRE BEAUTY SCHOOL                    ,PA,17876-0000,Proprietary  ,7,13,20,32,56,88
01171500,POTTSVILLE HOSPITAL SCHOOL OF NURSING   ,PA,17901-3692,Private      ,0,2,2,56,44,100
01191900,BEAVER FALLS BEAUTY ACADEMY             ,PA,15010-4208,Proprietary  ,9,19,28,19,47,66
01205000,ROSEDALE TECHNICAL INSTITUTE            ,PA,15205-9791,Private      ,43,67,110,188,205,393
01239300,THOMAS JEFF UNIV-CLG ALLIED HEALTH      ,PA,19107-0000,Private      ,7,74,81,301,1025,1326
01239301,JEFFERSON MED CLG-T. JEFFERSON UNIV     ,PA,19107-5587,Private      ,3,61,64,165,1497,1662
01239303,THOMAS JEFFERSON UNIV-GRADUATE COLG     ,PA,19107-0000,Private      ,18,129,147,188,1034,1222
01246104,LINCOLN TECHNICAL INSTITUTE             ,PA,19104-0202,Proprietary  ,207,487,694,362,762,1124
01246105,LINCOLN TECHNICAL INSTITUTE             ,PA,19116-4202,Proprietary  ,84,163,247,242,436,678
01252300,TALMUDICAL YESHIVA OF PHILA             ,PA,19131-1296,Private      ,0,0,0,3,0,3
01260500,EMPIRE BEAUTY SCHOOL                    ,PA,17331-2405,Proprietary  ,15,24,39,41,73,114
01260600,EMPIRE BEAUTY SCHOOL                    ,PA,17901-2505,Proprietary  ,20,77,97,118,360,478
01260700,EMPIRE BEAUTY SCHOOL                    ,PA,16801-5218,Proprietary  ,5,5,10,13,16,29
01292900,SOUTH HILLS BEAUTY ACADEMY              ,PA,15216-2335,Proprietary  ,20,20,40,25,36,61
01301500,GORDON PHILLIPS SCH BEAUTY CULTURE      ,PA,19102-2701,Proprietary  ,68,142,210,224,486,710
01313400,YESHIVATH BETH MOSHE                    ,PA,18505-2196,Private      ,30,1,31,34,1,35
01321400,ROXBOROUGH MEM HOSP SCH OF NURSING      ,PA,19128-0000,Proprietary  ,3,10,13,70,170,240
01326300,SOUTH HILLS SCH OF BUS & TECHNOLOGY     ,PA,16801-4516,Proprietary  ,52,127,179,444,490,934
01326304,SOUTH HILLS SCHOOL OF BUSINESS & TECHNOL,PA,16602-1188,Proprietary  ,4,9,13,45,31,76
02061000,VENUS BEAUTY ACADEMY                    ,PA,19079-0000,Proprietary  ,25,27,52,49,44,93
02068300,DOUGLAS SCHOOL OF BUSINESS              ,PA,15062-0000,Proprietary  ,51,60,111,268,215,483
02090200,TRIANGLE TECH                           ,PA,16502-0000,Proprietary  ,11,58,69,105,174,279
02092500,LAUREL TECHNICAL INSTITUTE              ,PA,16146-0000,Proprietary  ,33,95,128,85,310,395
02092502,BUSINESS INSTITUTE OF PENNSYLVANIA      ,PA,16335-0000,Proprietary  ,1,3,4,4,19,23
02107300,PENNSYLVANIA ACADEMY OF FINE ARTS       ,PA,19102-1424,Private      ,11,16,27,217,251,468
02112200,GREAT LAKES INSTITUTE OF TECHNOLOGY     ,PA,16509-0000,Proprietary  ,71,162,233,238,494,732
02114200,JOHNSON COLLEGE                         ,PA,18508-0000,Private      ,39,41,80,435,228,663
02116001,SANFORD-BROWN INSTITUTE - TREVOSE       ,PA,19053-4700,Proprietary  ,126,333,459,354,1160,1514
02118000,LEVITTOWN BEAUTY ACADEMY LLC            ,PA,19054-1713,Proprietary  ,25,23,48,32,33,65
02119300,PA ACAD OF COSMETOLOGY ARTS & SCI       ,PA,15904-0000,Proprietary  ,28,37,65,66,75,141
02119301,PA ACAD OF COSMTLGY ARTS & SCI          ,PA,15801-0000,Proprietary  ,0,0,0,5,0,5
02120800,"YORKTOWNE BUSINESS INSTITUTE, INC.      ",PA,17404-0000,Proprietary  ,25,74,99,118,257,375
02127400,YORK TECHNICAL INSTITUTE                ,PA,17402-0000,Proprietary  ,214,471,685,1131,1525,2656
02129000,TRIANGLE TECH                           ,PA,15601-0000,Proprietary  ,44,111,155,254,277,531
02129001,TRIANGLE TECH - BUSINESS CAREERS INSTITU,PA,15601-3304,Proprietary  ,0,2,2,4,10,14
02144000,"VISION ACADEMY, THE                     ",PA,18103-0000,Proprietary  ,18,38,56,32,57,89
02149000,EMPIRE BEAUTY SCHOOL                    ,PA,19341-2804,Proprietary  ,15,39,54,61,103,164
02151500,CENTRAL SUSQUEHANNA LPN CENTER          ,PA,17847-0000,Public       ,1,15,16,29,150,179
02152105,ACADEMY OF COURT REPORTING AND TECHNOLOG,PA,15222-1710,Proprietary  ,16,38,54,37,218,255
02153500,OAKBRIDGE ACADEMY OF ARTS               ,PA,15068-0000,Proprietary  ,4,5,9,62,21,83
02158300,JUNIATA-MIFFLIN CO AREA VOC TECH        ,PA,17044-0000,Public       ,6,10,16,19,57,76
02161400,NORTHEASTERN HOSP SCH OF NRSG           ,PA,19134-0000,Private      ,3,18,21,44,129,173
02169600,CLEARFIELD CTY CAREER AND TECH CNTR     ,PA,16830-0000,Public       ,13,39,52,33,130,163
02174400,TRIANGLE TECH                           ,PA,15801-0000,Proprietary  ,60,103,163,300,374,674
02178900,ACADEMY OF HAIR DESIGN                  ,PA,18202-1465,Proprietary  ,13,19,32,17,23,40
02183000,ORLEANS TECHNICAL INSTITUTE             ,PA,19111-0000,Private      ,51,245,296,132,512,644
02192800,WALNUT HILL COLLEGE                     ,PA,19104-0000,Proprietary  ,52,64,116,431,243,674
02202300,SANFORD-BROWN INSTITUTE                 ,PA,15219-1907,Proprietary  ,67,208,275,354,975,1329
02202301,SANFORD-BROWN INSTITUTE                 ,PA,15146-2141,Proprietary  ,34,168,202,164,577,741
02203900,ERIE INSTITUTE OF TECHNOLOGY            ,PA,16565-1002,Proprietary  ,15,95,110,107,275,382
02206200,AMBLER BEAUTY ACADEMY                   ,PA,19002-0000,Proprietary  ,32,67,99,52,87,139
02206300,STROUDSBURG SCHOOL OF COSMETOLOGY       ,PA,18360-0000,Proprietary  ,6,11,17,16,22,38
02212700,LANCASTER SCHOOL OF COSMETOLOGY         ,PA,17602-0000,Proprietary  ,17,59,76,37,118,155
02234200,ACADEMY OF MEDICAL ARTS & BUSINESS      ,PA,17112-0000,Proprietary  ,30,86,116,120,252,372
02251200,SCHUYLKILL COUNTY AREA VOC TECH SCH     ,PA,17931-0000,Public       ,9,27,36,25,84,109
02251202,SCHUYLKILL COUNTY AREA VOC TECH SCH     ,PA,17931-0000,Public       ,3,18,21,11,48,59
02253900,BERKS TECHNICAL INSTITUTE               ,PA,19610-0000,Proprietary  ,93,193,286,492,725,1217
02255200,PENNSYLVANIA SCHOOL OF BUSINESS         ,PA,18101-1604,Proprietary  ,43,184,227,141,597,738
02269900,PENNSYLVANIA COLLEGE OF ART & DESIGN    ,PA,17603-3528,Private      ,23,10,33,391,54,445
02270500,BUCKS COUNTY SCHOOL OF BEAUTY CULT      ,PA,19053-0000,Proprietary  ,20,21,41,41,35,76
02273400,RECONSTRUCTIONIST RABBINICAL COLLEG     ,PA,19095-0000,Private      ,0,13,13,0,27,27
02276600,HANOVER PUBLIC SCH DIST PRAC NURSG      ,PA,17331-0000,Public       ,0,8,8,3,35,38
02282500,LENAPE SCHOOL OF PRACTICAL NURSING      ,PA,16226-0000,Public       ,4,18,22,30,147,177
02288800,EMPIRE BEAUTY SCHOOL                    ,PA,18974-4508,Proprietary  ,26,30,56,53,86,139
02289500,PACE INSTITUTE                          ,PA,19601-0000,Proprietary  ,18,69,87,88,285,373
02289600,CONSOLIDATED SCHOOL OF BUSINESS         ,PA,17404-0000,Proprietary  ,3,59,62,33,165,198
02289700,ACADEMY OF CREATIVE HAIR DESIGN         ,PA,18702-0000,Proprietary  ,22,52,74,33,77,110
02289800,CHI INSTITUTE - FRANKLIN MILLS          ,PA,19154-0000,Proprietary  ,155,421,576,420,1086,1506
02290400,"ALTOONA BEAUTY SCHOOL, INC              ",PA,16602-0000,Proprietary  ,5,17,22,22,49,71
02292700,LANSDALE SCHOOL OF COSMETOLOGY          ,PA,19446-0000,Proprietary  ,11,15,26,22,29,51
02299300,TRINITY EPISCOPAL SCHOOL MINISTRY       ,PA,15003-0000,Private      ,0,24,24,1,81,82
02301300,PJA SCHOOL (THE)                        ,PA,19082-1917,Proprietary  ,22,118,140,71,343,414
02304400,YTI CAREER INSTITUTE - MECHANICSBURG    ,PA,17055-0000,Proprietary  ,24,61,85,135,258,393
02306200,VENANGO COUNTY AREA VOC TECH SCHOOL     ,PA,16301-0000,Public       ,4,10,14,22,63,85
02310800,LANCASTER COUNTY CAREER & TECH CTR      ,PA,17584-0000,Public       ,52,232,284,156,616,772
02330300,LEBANON CO CAREER & TECHNOLOGY CTR      ,PA,17042-0000,Public       ,7,35,42,23,134,157
02330600,PENNSYLVANIA GUNSMITH SCHOOL            ,PA,15202-0000,Proprietary  ,6,11,17,30,51,81
02350100,WESTERN AREA CAREER & TECHNOLOGY CT     ,PA,15317-0000,Public       ,4,11,15,18,75,93
02350200,INDIANA COUNTY TECH CTR SCH PR NSG      ,PA,15701-1465,Public       ,8,29,37,34,95,129
02353100,NORTHERN TIER CAREER CENTER             ,PA,18848-0000,Public       ,1,7,8,18,55,73
02361002,ITT TECHNICAL INSTITUTE                 ,PA,19406-0000,Proprietary  ,98,178,276,300,461,761
02362300,MERCER COUNTY AREA VOC TECH SCHOOL      ,PA,16137-0000,Public       ,1,10,11,13,81,94
02492500,DELAWARE VLY ACAD MED DNTL ASSTS        ,PA,19114-0000,Proprietary  ,16,57,73,43,104,147
02492600,EASTERN CTR ARTS AND TECH PR NSG        ,PA,19090-0000,Public       ,4,40,44,17,138,155
02495500,ALL-STATE CAREER SCHOOL                 ,PA,19029-0000,Proprietary  ,89,373,462,217,747,964
02529800,WILKES BARRE AREA CAREER AND TECHNICAL C,PA,18705-0000,Public       ,11,61,72,51,181,232
02536600,COMMONWEALTH TECH INSTIT @ HIRAM G      ,PA,15905-0000,Public       ,54,23,77,222,105,327
02539900,STAR TECHNICAL INSTITUTE                ,PA,19082-0000,Proprietary  ,0,0,0,0,3,3
02544300,BUTLER BEAUTY SCHOOL                    ,PA,16001-0000,Proprietary  ,21,35,56,51,99,150
02545000,LAWRENCE COUNTY CAREER AND TECHNICAL CEN,PA,16101-0000,Public       ,4,19,23,18,69,87
02546200,LAUREL BUSINESS INSTITUTE               ,PA,15401-0877,Proprietary  ,37,68,105,181,248,429
02550000,CLARION CO AREA VOC-TECH PRAC NRSG      ,PA,16254-0000,Public       ,8,29,37,22,87,109
02554500,HAZLETON AREA CAREER CENTER PRACTICAL NU,PA,18201-0000,Public       ,2,7,9,18,42,60
02557800,ART INSTITUTE OF YORK (THE) - PENNSYLVAN,PA,17402-9012,Proprietary  ,79,54,133,706,251,957
02566400,ALBERT EINSTEIN MED CTR DEPT DNTL       ,PA,19141-3098,Private      ,1,4,5,10,18,28
02574800,PENNSYLVANIA INSTITUTE OF TAXIDERMY     ,PA,15931-0000,Proprietary  ,1,9,10,10,22,32
02609500,CAREER TRAINING ACADEMY                 ,PA,15068-6308,Proprietary  ,23,71,94,70,208,278
02609501,CAREER TRAINING ACADEMY                 ,PA,15146-0000,Proprietary  ,0,7,7,2,17,19
02615400,STAR TECHNICAL INSTITUTE                ,PA,19114-2204,Proprietary  ,0,0,0,3,9,12
02616100,JEAN MADELINE ED CTR FOR COSM           ,PA,19147-1542,Proprietary  ,56,79,135,276,240,516
03006800,PENNSYLVANIA CULINARY INSTITUTE         ,PA,15222-3511,Proprietary  ,111,206,317,548,515,1063
03010800,TRI-STATE BUSINESS INSTITUTE            ,PA,16506-1013,Proprietary  ,215,667,882,830,2281,3111
03011500,ALLIED MEDICAL AND TECHNICAL INSTITUTE  ,PA,18702-0000,Proprietary  ,48,185,233,184,370,554
03011600,ALLIED MEDICAL AND TECHNICAL INSTITUTE  ,PA,18509-2903,Proprietary  ,51,160,211,188,362,550
03029900,CONSOLIDATED SCHOOL OF BUSINESS         ,PA,17603-2389,Proprietary  ,5,33,38,30,156,186
03031600,DPT BUSINESS SCHOOL                     ,PA,19116-3961,Proprietary  ,26,167,193,51,360,411
03031601,DPT BUSINESS SCHOOL                     ,PA,19106-0000,Proprietary  ,35,155,190,47,243,290
03067000,ANTONELLI MEDICAL & PROF INST           ,PA,19464-9244,Proprietary  ,4,34,38,7,52,59
03072400,ALL-STATE CAREER SCHOOL                 ,PA,15122-1000,Proprietary  ,11,73,84,13,146,159
03072600,DCI CAREER INSTITUTE                    ,PA,15061-2307,Proprietary  ,24,59,83,45,145,190
03081900,YTI CAREER INSTITUTE - ALTOONA          ,PA,16602-4457,Proprietary  ,15,90,105,119,311,430
03090800,LAKE ERIE COLL OF OSTEOPATHIC MED       ,PA,16509-0000,Private      ,5,106,111,96,2883,2979
03098600,CAREER TECH CTR OF LACKAWANNA CNTY      ,PA,18508-0000,Public       ,8,43,51,28,120,148
03101500,BIDWELL TRAINING CENTER                 ,PA,15233-2233,Private      ,0,9,9,7,35,42
03103300,JNA INSTITUTE OF CULINARY ARTS          ,PA,19146-3119,Proprietary  ,8,25,33,47,104,151
03109100,METROPOLITAN CAREER CENTER              ,PA,19144-0000,Private      ,11,30,41,39,148,187
03110700,AVIATION INSTITUTE OF MAINTENANCE       ,PA,19114-1017,Proprietary  ,26,76,102,108,303,411
03120400,REGIONAL CAREER & TECHNICAL CENTER      ,PA,16509-4699,Public       ,0,4,4,1,11,12
03128400,DELAWARE COUNTY TECHNICAL SCHOOL        ,PA,19032-1998,Public       ,9,37,46,25,134,159
03180400,PENNSYLVANIA HIGHLANDS COMMUNITY COLLEGE,PA,15904-2927,Public       ,107,180,287,712,749,1461
03236400,LT INTERNATIONAL BEAUTY SCHOOL          ,PA,19130-2235,Proprietary  ,1,46,47,4,54,58
03353300,ACADEMY OF VOCAL ARTS                   ,PA,19103-6685,Private      ,1,5,6,9,33,42
03380301,CULINARY ACADEMY OF LONG ISLAND - STAR P,PA,19114-2204,Proprietary  ,37,154,191,79,369,448
03439400,NAWCC SCHOOL OF HOROLOGY                ,PA,17512-2130,Private      ,1,3,4,3,10,13
03535300,HUNTINGDON COUNTY CAREER AND TECHNO     ,PA,17060-0905,Public       ,6,10,16,10,34,44
03561400,SUSQUEHANNA COUNTY CAREER & TECHNOL     ,PA,18816-0100,Public       ,0,2,2,5,7,12
03766300,PENNSYLVANIA SCHOOL OF MUSCLE THERAPY   ,PA,19406-3101,Proprietary  ,12,51,63,38,110,148
03899300,CALVARY BAPTIST THEOLOGICAL SEMINARY    ,PA,19446-4718,Private      ,0,4,4,0,4,4
03923300,PRECISION MANUFACTURING INSTITUTE       ,PA,16335-8380,Private      ,1,19,20,13,55,68
03948300,HARRISBURG UNIVERSITY OF SCIENCE AND TEC,PA,17101-2116,Private      ,13,37,50,170,171,341
03949300,WON INSTITUTE OF GRADUATE STUDIES       ,PA,19038-4535,Private      ,0,8,8,1,34,35
03950500,NORTHWEST REGIONAL TECHNOLOGY INSTITUTE ,PA,16508-2820,Proprietary  ,3,39,42,6,46,52
03952300,NATIONAL MASSAGE THERAPY INSTITUTE      ,PA,19116-3965,Proprietary  ,66,182,248,113,367,480
04024300,EDUCATION AND TECHNOLOGY INSTITUTE      ,PA,15601-9214,Private      ,3,13,16,3,13,16
04119900,PENNSYLVANIA MYOTHERAPY INSTITUTE       ,PA,17350-8426,Proprietary  ,0,5,5,1,12,13
04127500,CAREER DEVELOPMENT & EMPLOYMENT         ,PA,18702-5253,Proprietary  ,1,8,9,4,18,22
04137100,KIMBERLY'S BEAUTY SCHOOL                ,PA,19134-0000,Proprietary  ,2,12,14,3,29,32
04138300,INTERNATIONAL BEAUTY ACADEMY            ,PA,19149-2710,Proprietary  ,4,15,19,10,40,50
04145800,PULSE BEAUTY ACADEMY A PAUL MITCHELL PAR,PA,19335-0000,Proprietary  ,30,23,53,30,23,53
00267813,BRYANT & STRATTON COLLEGE - MIL DOWNTOWN,WI,53203-2608,Proprietary  ,173,592,765,595,2227,2822
00383200,ALVERNO COLLEGE                         ,WI,53234-3922,Private      ,174,461,635,1384,2182,3566
00383500,BELOIT COLLEGE                          ,WI,53511-5595,Private      ,31,17,48,1858,100,1958
00383700,CARDINAL STRITCH UNIVERSITY             ,WI,53217-9884,Private      ,106,1401,1507,996,3785,4781
00383800,CARROLL UNIVERSITY                      ,WI,53186-5593,Private      ,163,151,314,3218,701,3919
00383900,CARTHAGE COLLEGE                        ,WI,53141-0000,Private      ,203,172,375,4327,676,5003
00384000,WESTERN TECHNICAL COLLEGE               ,WI,54601-0908,Public       ,553,942,1495,1872,2409,4281
00384200,CONCORDIA UNIVERSITY WISCONSIN          ,WI,53097-2402,Private      ,181,1108,1289,2319,3221,5540
00384800,EDGEWOOD COLLEGE                        ,WI,53711-1958,Private      ,129,247,376,1503,974,2477
00385000,SILVER LAKE COLLEGE                     ,WI,54220-9319,Private      ,16,114,130,193,378,571
00385400,LAKELAND COLLEGE                        ,WI,53082-0000,Private      ,84,663,747,1116,1825,2941
00385600,LAWRENCE UNIVERSITY                     ,WI,54912-0599,Private      ,49,15,64,2314,91,2405
00386100,MARIAN UNIVERSITY                       ,WI,54935-4699,Private      ,91,348,439,1353,1192,2545
00386300,MARQUETTE UNIVERSITY                    ,WI,53201-0000,Private      ,227,439,666,12309,4078,16387
00386600,MILWAUKEE AREA TECH COLLEGE             ,WI,53233-1443,Public       ,1981,5415,7396,5418,14306,19724
00386800,MILWAUKEE SCHOOL OF ENGINEERING         ,WI,53202-3109,Private      ,109,155,264,2619,659,3278
00386900,MOUNT MARY COLLEGE                      ,WI,53222-4597,Private      ,60,248,308,865,1397,2262
00387400,NASHOTAH HOUSE                          ,WI,53058-0000,Private      ,0,6,6,1,35,36
00387500,NORTHLAND COLLEGE                       ,WI,54806-3999,Private      ,77,33,110,738,117,855
00388400,RIPON COLLEGE                           ,WI,54971-0248,Private      ,93,14,107,1334,59,1393
00389200,ST. NORBERT COLLEGE                     ,WI,54115-2002,Private      ,141,22,163,2324,104,2428
00389500,UNIVERSITY OF WISCONSIN-MADISON         ,WI,53715-1382,Public       ,1694,1312,3006,22306,10566,32872
00389600,UNIVERSITY OF WISCONSIN-MILWAUKEE       ,WI,53201-3165,Public       ,2449,2574,5023,16998,10871,27869
00389700,UNIVERSITY OF WISCONSIN COLLEGES        ,WI,53708-8680,Public       ,393,409,802,1749,1310,3059
00389701,UNIVERSITY OF WISCONSIN-BARABOO         ,WI,53913-1098,Public       ,81,44,125,310,132,442
00389702,UNIVERSITY OF WISCONSIN-BARRON          ,WI,54868-2497,Public       ,61,58,119,255,160,415
00389703,UNIVERSITY OF WISCONSIN-FOND DU LAC     ,WI,54935-2998,Public       ,101,55,156,457,197,654
00389704,UNIVERSITY OF WISCONSIN-FOX VALLEY      ,WI,54952-1297,Public       ,150,129,279,799,449,1248
00389705,UNIVERSITY OF WISCONSIN-MANITOWOC       ,WI,54220-6699,Public       ,58,39,97,237,124,361
00389706,UNIVERSITY OF WISCONSIN-MARATHON        ,WI,54401-5396,Public       ,180,106,286,784,314,1098
00389707,UNIVERSITY OF WISCONSIN-MARINETTE       ,WI,54143-4299,Public       ,36,52,88,246,124,370
00389708,UNIVERSITY OF WISCONSIN-MARSHFIELD      ,WI,54449-3310,Public       ,67,54,121,292,161,453
00389709,UNIVERSITY OF WISCONSIN-RICHLAND        ,WI,53581-1399,Public       ,40,18,58,250,73,323
00389710,UNIVERSITY OF WISCONSIN COLLEGES - ROCK ,WI,53546-5699,Public       ,126,96,222,620,360,980
00389711,UNIVERSITY OF WISCONSIN-SHEBOYGAN       ,WI,53081-4789,Public       ,92,79,171,413,225,638
00389712,UNIVERSITY OF WISCONSIN-WASHINGTON      ,WI,53095-3699,Public       ,109,76,185,479,215,694
00389713,UNIVERSITY OF WISCONSIN-WAUKESHA        ,WI,53188-2799,Public       ,242,139,381,957,411,1368
00389900,UNIVERSITY OF WISCONSIN-GREEN BAY       ,WI,54311-7001,Public       ,550,430,980,4443,1826,6269
00391100,VITERBO UNIVERSITY                      ,WI,54601-4777,Private      ,86,268,354,1659,1058,2717
00391500,UNIVERSITY OF WISCONSIN-STOUT           ,WI,54751-0790,Public       ,912,595,1507,5923,1888,7811
00391700,UNIVERSITY OF WISCONSIN-EAU CLAIRE      ,WI,54702-4004,Public       ,978,396,1374,8265,1680,9945
00391900,UNIVERSITY OF WISCONSIN-LA CROSSE       ,WI,54601-3742,Public       ,577,334,911,7172,1546,8718
00392000,UNIVERSITY OF WISCONSIN-OSHKOSH         ,WI,54901-8604,Public       ,1018,820,1838,7425,3033,10458
00392100,UNIVERSITY OF WISCONSIN-PLATTEVILLE     ,WI,53818-3099,Public       ,622,426,1048,5536,1469,7005
00392300,UNIVERSITY OF WISCONSIN-RIVER FALLS     ,WI,54022-5013,Public       ,833,403,1236,4962,1196,6158
00392400,UNIVERSITY OF WISCONSIN-STEVENS POINT   ,WI,54481-3871,Public       ,712,306,1018,6975,1719,8694
00392500,UNIVERSITY OF WISCONSIN-SUPERIOR        ,WI,54880-2898,Public       ,312,387,699,1601,1254,2855
00392600,UNIVERSITY OF WISCONSIN-WHITEWATER      ,WI,53190-1792,Public       ,829,527,1356,8029,2274,10303
00400700,MADISON AREA TECHNICAL COLLEGE          ,WI,53704-2599,Public       ,1196,2239,3435,4116,6303,10419
00501500,UNIVERSITY OF WISCONSIN-PARKSIDE        ,WI,53141-2000,Public       ,656,633,1289,3340,2061,5401
00529400,WAUKESHA COUNTY TECHNICAL COLLEGE       ,WI,53072-4696,Public       ,469,894,1363,1500,2627,4127
00530100,NORTHEAST WISCONSIN TECHNICAL COLLEGE   ,WI,54307-9042,Public       ,670,1570,2240,2415,4438,6853
00530400,CHIPPEWA VALLEY TECHNICAL COLLEGE       ,WI,54701-6162,Public       ,589,980,1569,2205,3072,5277
00538000,MID-STATE TECHNICAL COLLEGE             ,WI,54494-5512,Public       ,277,626,903,800,1887,2687
00538400,NICOLET AREA TECHNICAL COLLEGE          ,WI,54501-0000,Public       ,121,290,411,441,787,1228
00538700,NORTHCENTRAL TECHNICAL COLLEGE          ,WI,54401-1899,Public       ,296,814,1110,972,2319,3291
00538900,GATEWAY TECHNICAL COLLEGE               ,WI,53144-1690,Public       ,540,1688,2228,1777,5727,7504
00539000,BLACKHAWK TECHNICAL COLLEGE             ,WI,53547-5009,Public       ,190,760,950,864,2607,3471
00610800,BELLIN HOSP SCH OF RAD TECH             ,WI,54305-3505,Private      ,3,8,11,20,17,37
00611500,MERCY MED CTR SCH OF RAD TECH           ,WI,54904-3370,Private      ,2,5,7,7,14,21
00612601,ST LUKE'S MEDCL CTR SCHL RAD TECH       ,WI,53215-4330,Private      ,1,16,17,8,39,47
00612603,ST LUKE'S MED CTR SCH OF SONOGRAPHY     ,WI,53215-0000,Private      ,3,12,15,8,30,38
00613100,THEDA CLARK REG MED CTR SCH RAD TEC     ,WI,54957-0000,Private      ,2,9,11,7,18,25
00663900,BELLIN COLLEGE                          ,WI,54305-0000,Private      ,21,33,54,214,164,378
00766900,SOUTHWEST WISCONSIN TECH COLLEGE        ,WI,53809-0000,Public       ,168,225,393,672,772,1444
00821700,WISCONSIN COLLEGE OF COSMETOLOGY        ,WI,54304-0000,Proprietary  ,17,15,32,49,48,97
00919400,LAKESHORE TECHNICAL COLLEGE             ,WI,53015-1412,Public       ,130,565,695,617,1879,2496
00925600,MORAINE PARK TECHNICAL COLLEGE          ,WI,54936-0000,Public       ,239,743,982,931,2454,3385
00941900,STATE CLG OF BEAUTY CULT-WAUSAU         ,WI,54403-4667,Proprietary  ,13,19,32,56,54,110
00962100,HERZING COLLEGE                         ,WI,53718-4236,Proprietary  ,191,1191,1382,688,4233,4921
00974400,FOX VALLEY TECHNICAL COLLEGE            ,WI,54913-0000,Public       ,648,1387,2035,2500,4212,6712
01091300,MADISON MEDIA INSTITUTE                 ,WI,53718-6787,Proprietary  ,110,80,190,371,266,637
01148400,ADVANCED INSTITUTE OF HAIR DESIGN       ,WI,53225-0000,Proprietary  ,58,74,132,165,192,357
01182400,WISCONSIN INDIANHEAD TECH CLG WITC      ,WI,54871-9300,Public       ,339,733,1072,1071,2053,3124
02077100,MILWAUKEE INST OF ART & DESIGN          ,WI,53202-0000,Private      ,57,32,89,816,167,983
02078000,SACRED HEART SCHOOL OF THEOLOGY         ,WI,53130-0000,Private      ,0,0,0,0,3,3
02136600,WISCONSIN LUTHERAN COLLEGE              ,WI,53226-0000,Private      ,45,22,67,884,84,968
02201803,KAPLAN COLLEGE - MILWAUKEE              ,WI,53212-3939,Proprietary  ,70,301,371,182,860,1042
02239204,HIGH-TECH INSTITUTE - MILWAUKEE         ,WI,53005-4207,Proprietary  ,2,5,7,17,18,35
02271300,WI SCH OF PROFESSIONAL PSYCHOLOGY       ,WI,53225-0000,Private      ,1,22,23,3,89,92
02317200,MARANATHA BAPTIST BIBLE COLLEGE         ,WI,53094-0000,Private      ,180,47,227,747,112,859
02324700,EMPIRE BEAUTY SCHOOL                    ,WI,53717-0000,Proprietary  ,13,45,58,55,151,206
02332100,EMPIRE BEAUTY SCHOOL                    ,WI,54220-0000,Proprietary  ,20,51,71,66,162,228
02332101,EMPIRE BEAUTY SCHOOL - APPLETON         ,WI,54914-4644,Proprietary  ,2,3,5,11,12,23
02453500,MEDICAL COLLEGE OF WISCONSIN            ,WI,53226-0000,Private      ,3,31,34,14,1144,1158
02494300,GILL-TECH ACADEMY OF HAIR DESIGN        ,WI,54911-0000,Proprietary  ,25,14,39,71,53,124
02503303,RASMUSSEN COLLEGE - MANKATO - GREEN BAY ,WI,54303-2349,Proprietary  ,62,278,340,159,854,1013
02532200,LAC COURTE OREILLES OJIBWA CMTY CLG     ,WI,54843-0000,Public       ,48,239,287,64,370,434
03007400,LAKESIDE SCHOOL OF MASSAGE THERAPY      ,WI,53719-1103,Private      ,18,44,62,32,89,121
03061200,MIDWEST COLLEGE OF ORIENTAL MEDICINE    ,WI,53403-9747,Proprietary  ,0,89,89,1,170,171
03077600,EMPIRE BEAUTY SCHOOL                    ,WI,54304-4838,Proprietary  ,47,82,129,159,320,479
03087500,ITT TECHNICAL INSTITUTE                 ,WI,53220-4612,Proprietary  ,505,1331,1836,996,2603,3599
03125100,COLLEGE OF MENOMINEE NATION             ,WI,54135-0000,Private      ,51,200,251,122,506,628
03125102,COLLEGE OF  THE MENOMINEE NATION - GREEN,WI,54304-4964,Private      ,8,14,22,18,79,97
03220300,"SALON PROFESSIONAL ACADEMY, THE         ",WI,54701-7633,Proprietary  ,20,22,42,63,65,128
03309300,MONTESSORI INSTITUTE OF MILWAUKEE       ,WI,53207-0000,Private      ,0,7,7,3,26,29
03808300,INSTITUTE OF BEAUTY AND WELLNESS (THE)  ,WI,53202-5715,Proprietary  ,16,42,58,63,105,168
03822300,FOUR SEASONS SALON AND COSMETOLOGY SCHOO,WI,53566-0000,Proprietary  ,6,10,16,12,18,30
03872500,NORTHLAND INTERNATIONAL UNIVERSITY      ,WI,54119-9285,Private      ,138,31,169,443,60,503
03925300,BLUE SKY SCHOOL OF PROFESSIONAL MASSAGE ,WI,53024-9699,Private      ,18,51,69,38,114,152
04117400,MILWAUKEE CAREER COLLEGE                ,WI,53222-4305,Proprietary  ,58,319,377,141,635,776
04118600,ACADEMY OF COSMETOLOGY                  ,WI,53548-3307,Proprietary  ,2,22,24,17,48,65
04124800,VISIONS IN HAIR DESIGN INSTITUTE OF COSM,WI,53210-1120,Proprietary  ,3,3,6,11,16,27
04132600,WISCONSIN ACADEMY (THE)                 ,WI,54157-1726,Proprietary  ,7,16,23,16,41,57
04137900,PC PROSCHOOLS                           ,WI,53005-6003,Proprietary  ,10,16,26,17,24,41
04138200,SALON PROFESSIONAL ACADEMY (THE)        ,WI,54914-3921,Proprietary  ,8,15,23,58,52,110
00290500,NORTH CAROLINA A&T STATE UNIV           ,NC,27411-0001,Public       ,1058,1093,2151,12583,5036,17619
00290600,APPALACHIAN STATE UNIVERSITY            ,NC,28608-2059,Public       ,762,555,1317,14570,3691,18261
00290700,UNIVERSITY OF NC AT ASHEVILLE           ,NC,28804-3299,Public       ,177,210,387,3362,1310,4672
00290800,BARTON COLLEGE                          ,NC,27893-3104,Private      ,81,153,234,1454,662,2116
00291000,BELMONT ABBEY COLLEGE                   ,NC,28012-1802,Private      ,94,277,371,1185,1083,2268
00291100,BENNETT COLLEGE                         ,NC,27401-3239,Private      ,68,53,121,1140,299,1439
00291200,BREVARD COLLEGE                         ,NC,28712-3306,Private      ,50,18,68,881,130,1011
00291300,CAMPBELL UNIVERSITY                     ,NC,27506-0036,Private      ,289,507,796,3889,3046,6935
00291400,CATAWBA COLLEGE                         ,NC,28144-2488,Private      ,73,105,178,1447,560,2007
00291500,CENTRAL PIEDMONT COMMUNITY COLLEGE      ,NC,28204-2297,Public       ,1666,4617,6283,6470,13689,20159
00291600,CHOWAN UNIVERSITY                       ,NC,27855-1850,Private      ,111,66,177,1480,323,1803
00291700,COLLEGE OF THE ALBEMARLE                ,NC,27909-2327,Public       ,165,478,643,675,1529,2204
00291800,DAVIDSON COLLEGE                        ,NC,28035-7157,Private      ,39,15,54,2994,91,3085
00291900,DAVIDSON COUNTY COMMUNITY COLLEGE       ,NC,27293-0000,Public       ,241,662,903,1237,3127,4364
00292000,DUKE UNIVERSITY                         ,NC,27708-0397,Private      ,213,162,375,14725,1514,16239
00292001,DUKE UNIV - SCHOOL OF MEDICINE          ,NC,27710-0000,Private      ,10,32,42,92,1247,1339
00292002,DUKE UNIV - SCHOOL OF LAW               ,NC,27708-0000,Private      ,4,47,51,34,2896,2930
00292003,DUKE UNIV - GRAD SCH ARTS & SCIENCE     ,NC,27708-0000,Private      ,6,91,97,80,863,943
00292004,DUKE UNIV - FUQUA SCH OF BUSINESS       ,NC,27708-0000,Private      ,5,82,87,48,1181,1229
00292005,DUKE UNIV/NICHOLAS SCH OF ENVIRON.      ,NC,27708-0000,Private      ,0,11,11,10,296,306
00292006,DUKE UNIV - DIVINITY SCHOOL             ,NC,27708-0000,Private      ,10,40,50,85,640,725
00292007,DUKE UNIV - SCHOOL OF NURSING           ,NC,27710-0000,Private      ,18,108,126,86,584,670
00292010,DUKE UNIVERSITY - SCHOOL OF PUBLIC POLIC,NC,27708-0239,Private      ,6,18,24,8,35,43
00292300,EAST CAROLINA UNIVERSITY                ,NC,27858-1818,Public       ,1245,1706,2951,19988,10449,30437
00292600,ELIZABETH CITY STATE UNIVERSITY         ,NC,27909-7806,Public       ,270,277,547,3815,1418,5233
00292700,ELON UNIVERSITY                         ,NC,27244-2010,Private      ,199,106,305,6175,1024,7199
00292800,FAYETTEVILLE STATE UNIVERSITY           ,NC,28301-4298,Public       ,548,1249,1797,5276,5827,11103
00292900,GARDNER-WEBB UNIVERSITY                 ,NC,28017-0000,Private      ,171,533,704,2379,2117,4496
00293000,GREENSBORO COLLEGE                      ,NC,27401-1875,Private      ,110,190,300,1349,818,2167
00293100,GUILFORD COLLEGE                        ,NC,27410-4171,Private      ,135,548,683,2733,2190,4923
00293300,HIGH POINT UNIVERSITY                   ,NC,27262-4221,Private      ,116,329,445,3793,1323,5116
00293400,ISOTHERMAL COMMUNITY COLLEGE            ,NC,28160-0804,Public       ,196,496,692,840,1699,2539
00293500,JOHN WESLEY COLLEGE                     ,NC,27265-0000,Private      ,10,43,53,38,144,182
00293600,JOHNSON C SMITH UNIVERSITY              ,NC,28216-5398,Private      ,220,209,429,3352,880,4232
00293700,KING'S COLLEGE-CHARLOTTE                ,NC,28204-2435,Proprietary  ,98,119,217,713,455,1168
00293900,LEES MCRAE COLLEGE                      ,NC,28604-0000,Private      ,88,64,152,996,291,1287
00294000,LENOIR COMMUNITY COLLEGE                ,NC,28502-0188,Public       ,265,780,1045,882,2255,3137
00294100,LENOIR-RHYNE UNIVERSITY                 ,NC,28603-0000,Private      ,142,113,255,2068,582,2650
00294200,LIVINGSTONE COLLEGE                     ,NC,28144-5298,Private      ,231,145,376,1463,443,1906
00294300,LOUISBURG COLLEGE                       ,NC,27549-2398,Private      ,151,44,195,955,142,1097
00294400,MARS HILL COLLEGE                       ,NC,28754-0000,Private      ,93,85,178,1473,409,1882
00294500,MEREDITH COLLEGE                        ,NC,27607-5298,Private      ,80,154,234,1889,870,2759
00294600,METHODIST UNIVERSITY                    ,NC,28311-1420,Private      ,148,344,492,2285,1183,3468
00294700,MITCHELL COMMUNITY COLLEGE              ,NC,28677-5264,Public       ,229,640,869,902,2184,3086
00294800,MONTREAT COLLEGE                        ,NC,28757-1267,Private      ,34,319,353,596,929,1525
00294900,MOUNT OLIVE COLLEGE                     ,NC,28365-1299,Private      ,100,862,962,1125,3360,4485
00295000,NORTH CAROLINA CENTRAL UNIVERSITY       ,NC,27707-3198,Public       ,519,1135,1654,7605,6969,14574
00295100,NORTH CAROLINA WESLEYAN COLLEGE         ,NC,27804-8699,Private      ,94,237,331,1129,956,2085
00295300,PEACE COLLEGE                           ,NC,27604-1194,Private      ,62,85,147,864,325,1189
00295400,UNIV OF NORTH CAROLINA AT PEMBROKE      ,NC,28372-1510,Public       ,532,931,1463,5337,3716,9053
00295500,PFEIFFER UNIVERSITY                     ,NC,28109-0000,Private      ,91,423,514,1004,1143,2147
00295600,PIEDMONT BAPTIST COLLEGE AND GRADUATE SC,NC,27101-5025,Private      ,28,40,68,205,164,369
00295700,QUEENS UNIVERSITY OF CHARLOTTE          ,NC,28274-0001,Private      ,156,592,748,1874,1952,3826
00295800,ROCKINGHAM COMMUNITY COLLEGE            ,NC,27375-0000,Public       ,206,478,684,773,1439,2212
00296000,SALEM COLLEGE                           ,NC,27108-0000,Private      ,55,171,226,568,580,1148
00296100,SANDHILLS COMMUNITY COLLEGE             ,NC,28374-8283,Public       ,402,873,1275,1306,2695,4001
00296200,SHAW UNIVERSITY                         ,NC,27601-2393,Private      ,428,611,1039,2679,2219,4898
00296300,SOUTHEASTERN BAPTIST THEOL SEMINARY     ,NC,27588-0000,Private      ,5,33,38,57,148,205
00296400,SOUTHEASTERN COMMUNITY COLLEGE          ,NC,28472-5422,Public       ,291,648,939,726,1511,2237
00296700,ST ANDREWS PRESBYTERIAN COLLEGE         ,NC,28352-9979,Private      ,52,30,82,723,131,854
00296800,ST AUGUSTINES COLLEGE                   ,NC,27610-2298,Private      ,199,175,374,1973,693,2666
00297000,SURRY COMMUNITY COLLEGE                 ,NC,27017-0304,Public       ,165,418,583,1124,1532,2656
00297200,NORTH CAROLINA STATE UNIV-RALEIGH       ,NC,27695-1751,Public       ,911,1205,2116,21705,8237,29942
00297300,GASTON COLLEGE                          ,NC,28034-1499,Public       ,409,1259,1668,1827,4556,6383
00297400,UNIVERSITY OF N C-CHAPEL HILL           ,NC,27514-0000,Public       ,554,926,1480,19000,11787,30787
00297500,UNIVERSITY OF NC AT CHARLOTTE           ,NC,28223-0001,Public       ,1376,2314,3690,16271,10954,27225
00297600,UNIVERSITY OF N C - GREENSBORO          ,NC,27412-0001,Public       ,824,1384,2208,14040,8462,22502
00297800,WAKE FOREST UNIV - UNDERGRADUATE        ,NC,27109-7246,Private      ,143,35,178,6733,321,7054
00297801,WAKE FOREST UNIV - SCH OF MEDICINE      ,NC,27157-1090,Private      ,6,24,30,50,925,975
00297803,WAKE FOREST UNIVERSITY - SCHOOLS OF BUSI,NC,27109-7659,Private      ,0,148,148,25,651,676
00297805,WAKE FOREST UNIV - SCH OF LAW           ,NC,27109-7206,Private      ,2,60,62,21,1463,1484
00297806,WAKE FOREST UNIV - GRAD A&S/DIVINITY    ,NC,27109-7246,Private      ,11,73,84,66,506,572
00297900,WARREN WILSON COLLEGE                   ,NC,28815-0000,Private      ,40,69,109,1234,336,1570
00298000,WAYNE COMMUNITY COLLEGE                 ,NC,27533-0000,Public       ,403,909,1312,1120,2305,3425
00298100,WESTERN CAROLINA UNIVERSITY             ,NC,28723-9731,Public       ,360,548,908,7534,3126,10660
00298200,WESTERN PIEDMONT COMMUNITY COLLEGE      ,NC,28655-4504,Public       ,279,647,926,1050,2107,3157
00298300,WILKES COMMUNITY COLLEGE                ,NC,28697-2100,Public       ,308,487,795,934,1420,2354
00298400,UNIVERSITY OF N C-WILMINGTON            ,NC,28403-3297,Public       ,653,633,1286,10714,3832,14546
00298500,WINGATE UNIVERSITY                      ,NC,28174-0159,Private      ,171,187,358,2267,892,3159
00298600,WINSTON-SALEM STATE UNIVERSITY          ,NC,27102-0000,Public       ,305,661,966,6926,4044,10970
00398100,UNC SCHOOL OF THE ARTS                  ,NC,27127-2188,Public       ,82,32,114,1180,324,1504
00403300,ASHEVILLE BUNCOMBE TECH CMTY CLG        ,NC,28801-4897,Public       ,417,1022,1439,1561,3296,4857
00406200,PITT COMMUNITY COLLEGE                  ,NC,28590-0000,Public       ,695,1176,1871,3045,4557,7602
00483500,CALDWELL COMMUNITY CLG & TECH INST      ,NC,28638-2626,Public       ,328,694,1022,1343,2420,3763
00483800,GUILFORD TECHNICAL COMMUNITY CLG        ,NC,27282-0309,Public       ,1311,2736,4047,5378,9839,15217
00484400,WAKE TECHNICAL COMMUNITY COLLEGE        ,NC,27603-5696,Public       ,962,2275,3237,4972,8825,13797
00484500,WILSON COMMUNITY COLLEGE                ,NC,27893-3310,Public       ,203,783,986,500,1703,2203
00499201,MILLER-MOTTE TECHNICAL COLLEGE - MILLER-,NC,27511-9209,Proprietary  ,76,372,448,141,713,854
00499202,MILLER-MOTTE TECHNICAL COLLEGE - MILLER-,NC,27604-6072,Proprietary  ,51,255,306,118,629,747
00531600,COASTAL CAROLINA COMMUNITY COLLEGE      ,NC,28546-6816,Public       ,354,1111,1465,1187,3260,4447
00531700,FORSYTH TECHNICAL COMMUNITY COLLEGE     ,NC,27103-5197,Public       ,568,1579,2147,2437,6076,8513
00531800,CATAWBA VALLEY COMMUNITY COLLEGE        ,NC,28602-8302,Public       ,293,742,1035,1828,3374,5202
00532000,CAPE FEAR COMMUNITY COLLEGE             ,NC,28401-3910,Public       ,844,1544,2388,3001,4372,7373
00544700,RANDOLPH COMMUNITY COLLEGE              ,NC,27204-1009,Public       ,181,573,754,782,1783,2565
00544800,DURHAM TECHNICAL CMNTY COLLEGE          ,NC,27703-5023,Public       ,391,1316,1707,1204,4087,5291
00544900,CENTRAL CAROLINA COMMUNITY COLLEGE      ,NC,27330-9000,Public       ,338,1108,1446,1131,3248,4379
00546300,ALAMANCE COMMUNITY COLLEGE              ,NC,27253-0000,Public       ,378,1031,1409,1288,3228,4516
00546400,RICHMOND COMMUNITY COLLEGE              ,NC,28345-4522,Public       ,202,582,784,547,1656,2203
00575400,ROWAN-CABARRUS COMMUNITY COLLEGE        ,NC,28145-1595,Public       ,645,1591,2236,1728,4208,5936
00647700,CABARRUS COLLEGE OF HEALTH SCIENCES     ,NC,28025-0000,Private      ,32,104,136,243,564,807
00647800,MERCY HOSP SCH OF NURSING               ,NC,28207-0000,Public       ,18,125,143,112,496,608
00648300,WATTS SCHOOL OF NURSING                 ,NC,27704-0000,Private      ,17,44,61,69,200,269
00679900,CRAVEN COMMUNITY COLLEGE                ,NC,28562-0000,Public       ,184,716,900,692,2366,3058
00703100,PAMLICO COMMUNITY COLLEGE               ,NC,28529-0000,Public       ,31,145,176,70,300,370
00764000,FAYETTEVILLE TECHNICAL CMTY COLLEGE     ,NC,28303-0236,Public       ,803,2828,3631,2901,10583,13484
00768700,JAMES SPRUNT COMMUNITY COLLEGE          ,NC,28349-0398,Public       ,85,340,425,350,1050,1400
00781400,BROOKSTONE COLLEGE OF BUSINESS          ,NC,28262-0000,Proprietary  ,38,152,190,68,364,432
00781401,BROOKSTONE COLLEGE OF BUSINESS          ,NC,27409-0000,Proprietary  ,19,178,197,46,324,370
00789200,SAMPSON COMMUNITY COLLEGE               ,NC,28328-0000,Public       ,108,296,404,472,1223,1695
00798500,SOUTH PIEDMONT COMMUNITY COLLEGE        ,NC,28135-9703,Public       ,182,626,808,652,1967,2619
00798600,HALIFAX COMMUNITY COLLEGE               ,NC,27890-0089,Public       ,201,533,734,559,1292,1851
00798700,BLADEN COMMUNITY COLLEGE                ,NC,28332-0266,Public       ,199,618,817,485,1453,1938
00798800,MARTIN COMMUNITY COLLEGE                ,NC,27892-8307,Public       ,50,206,256,214,644,858
00808100,CARTERET COMMUNITY COLLEGE              ,NC,28557-2989,Public       ,187,466,653,478,1188,1666
00808200,CLEVELAND COMMUNITY COLLEGE             ,NC,28150-0000,Public       ,324,1039,1363,854,2518,3372
00808300,HAYWOOD COMMUNITY COLLEGE               ,NC,28721-0000,Public       ,173,393,566,540,1051,1591
00808500,MCDOWELL TECHNICAL COMMUNITY CLG        ,NC,28752-8728,Public       ,121,361,482,326,885,1211
00808700,MONTGOMERY COMMUNITY COLLEGE            ,NC,27371-0787,Public       ,79,202,281,240,618,858
00846600,SOUTHWESTERN COMMUNITY COLLEGE          ,NC,28779-8581,Public       ,119,273,392,665,1298,1963
00855700,NASH COMMUNITY COLLEGE                  ,NC,27804-0488,Public       ,318,761,1079,889,1928,2817
00855800,BEAUFORT COUNTY COMMUNITY COLLEGE       ,NC,27889-7889,Public       ,122,409,531,467,1399,1866
00861200,ROBESON COMMUNITY COLLEGE               ,NC,28359-2151,Public       ,314,898,1212,912,2622,3534
00861300,ROANOKE-CHOWAN COMMUNITY COLLEGE        ,NC,27910-9522,Public       ,87,249,336,274,658,932
00885500,EDGECOMBE COMMUNITY COLLEGE             ,NC,27886-9399,Public       ,279,999,1278,650,2650,3300
00902500,SOUTH EASTERN CLG OF BEAUTY CULTURE     ,NC,28204-0000,Proprietary  ,35,89,124,100,360,460
00933600,JOHNSTON COMMUNITY COLLEGE              ,NC,27577-0000,Public       ,276,680,956,1070,2352,3422
00943000,TRI-COUNTY COMMUNITY COLLEGE            ,NC,28906-7919,Public       ,112,309,421,305,739,1044
00964600,PIEDMONT COMMUNITY COLLEGE              ,NC,27573-1197,Public       ,216,560,776,489,1269,1758
00968400,BLUE RIDGE COMMUNITY COLLEGE            ,NC,28731-9624,Public       ,171,415,586,510,1103,1613
00974701,GORDON-CONWELL THEO SEM - CHARLOTTE     ,NC,28273-0000,Private      ,0,52,52,3,171,174
00990300,VANCE-GRANVILLE CMTY COLLEGE            ,NC,27536-0917,Public       ,408,1062,1470,1088,2645,3733
01026400,SOUTH COLLEGE                           ,NC,28803-3152,Proprietary  ,19,189,208,60,439,499
01119400,STANLY COMMUNITY COLLEGE                ,NC,28001-7458,Public       ,234,661,895,677,1786,2463
01119700,MAYLAND COMMUNITY COLLEGE               ,NC,28777-2777,Public       ,97,171,268,333,539,872
01179900,PAUL MITCHELL THE SCHOOL FAYETTEVILLE   ,NC,28303-5364,Proprietary  ,18,43,61,40,133,173
01192600,LEON'S BEAUTY SCHOOL                    ,NC,27403-2812,Proprietary  ,31,67,98,93,202,295
02056500,MITCHELL'S HAIR STYLING ACADEMY         ,NC,27893-0000,Proprietary  ,31,53,84,62,120,182
02056501,MITCHELL'S HAIR STYLING ACADEMY - MITCHE,NC,27606-3326,Proprietary  ,5,21,26,24,57,81
02110500,ART INSTITUTE OF CHARLOTTE (THE)        ,NC,28217-0000,Proprietary  ,374,797,1171,1809,2201,4010
02170700,BRUNSWICK COMMUNITY COLLEGE             ,NC,28422-0000,Public       ,107,244,351,477,854,1331
02205000,COLLEGE OF WILMINGTON                   ,NC,28403-0000,Proprietary  ,12,46,58,52,138,190
02210400,FAYETTEVILLE BEAUTY COLLEGE             ,NC,28303-0000,Proprietary  ,14,61,75,38,145,183
02227800,MITCHELL'S HAIR STYLING ACADEMY         ,NC,27534-0000,Proprietary  ,0,5,5,3,15,18
02227900,MITCHELL'S HAIR STYLING ACADEMY         ,NC,27858-0000,Proprietary  ,2,5,7,12,24,36
02238700,HAIRSTYLING INSTITUTE OF CHARLOTTE      ,NC,28204-0000,Proprietary  ,13,52,65,48,175,223
02280900,ROANOKE BIBLE COLLEGE                   ,NC,27909-0000,Private      ,22,26,48,126,90,216
02286300,CAROLINA BEAUTY COLLEGE                 ,NC,27262-0000,Proprietary  ,31,117,148,74,342,416
02560600,PINNACLE INSTITUTE OF COSMETOLOGY       ,NC,28115-8020,Proprietary  ,16,14,30,33,56,89
02614201,MILLER-MOTTE BUSINESS COLLEGE           ,NC,28403-0000,Proprietary  ,138,732,870,261,1434,1695
02614205,MILLER - MOTTE TECHNICAL COLLEGE - MILLE,NC,27834-5052,Proprietary  ,38,230,268,77,453,530
03009500,WINSTON-SALEM BARBER SCHOOL             ,NC,27107-0000,Proprietary  ,13,43,56,40,114,154
03064400,REGENCY BEAUTY INSTITUTE                ,NC,27127-0000,Proprietary  ,39,77,116,41,101,142
03089300,HERITAGE BIBLE COLLEGE                  ,NC,28335-0000,Private      ,3,21,24,22,80,102
03104200,CAROLINAS COLLEGE OF HEALTH SCIENCE     ,NC,28232-2861,Public       ,42,192,234,271,780,1051
03109000,SCHOOL OF COMMUNICATION ARTS OF NORTH CA,NC,27614-7076,Proprietary  ,104,242,346,387,508,895
03361300,MEDICAL ARTS MASSAGE SCHOOL             ,NC,27616-6453,Proprietary  ,21,126,147,35,200,235
03513400,APEX SCHOOL OF THEOLOGY                 ,NC,27703-8024,Private      ,2,183,185,4,339,343
03555300,SOUTHEASTERN INSTITUTE                  ,NC,28217-0000,Proprietary  ,25,155,180,65,309,374
03555400,SOUTHEASTERN SCHOOL OF NEUROMUSCULAR  MA,NC,29406-0000,Proprietary  ,21,82,103,41,200,241
03570300,CAROLINA CHRISTIAN COLLEGE              ,NC,27105-3241,Private      ,2,22,24,5,46,51
03663300,HOOD THEOLOGICAL SEMINARY               ,NC,28144-5768,Private      ,0,117,117,0,235,235
03748500,LA SHE'S BEAUTY ACADEMY                 ,NC,27707-3569,Proprietary  ,13,56,69,23,86,109
03777300,CAROLINA ACAD OF COSMETIC ART & SCI     ,NC,28054-0460,Proprietary  ,37,88,125,70,173,243
03827300,NEW LIFE THEOLOGICAL SEMINARY           ,NC,28205-1648,Private      ,3,46,49,3,111,114
04098300,TECHSKILLS - CHARLOTTE                  ,NC,28217-0000,Proprietary  ,5,110,115,29,245,274
04101300,CAROLINA SCHOOL OF BROADCASTING         ,NC,28214-8085,Proprietary  ,16,45,61,53,133,186
04115700,REGINA'S COLLEGE OF BEAUTY              ,NC,28110-2831,Proprietary  ,5,58,63,9,83,92
04120300,"FILA ACADEMY, THE                       ",NC,27265-3114,Proprietary  ,7,28,35,14,58,72
04129400,CENTER FOR MASSAGE & NATURAL HEALTH     ,NC,28787-8331,Proprietary  ,8,25,33,8,25,33
04140700,AVEDA INSTITUTE CHAPEL HILL             ,NC,27516-2559,Proprietary  ,33,57,90,121,163,284
04143500,CHARLOTTE SCHOOL OF LAW                 ,NC,28208-2816,Proprietary  ,3,176,179,25,844,869
04146400,DAOIST TRADITIONS COLLEGE OF CHINESE MED,NC,28801-1060,Proprietary  ,0,15,15,3,43,46
04149300,PARK WEST BARBER SCHOOL                 ,NC,27701-4022,Proprietary  ,0,3,3,0,3,3
00298800,BISMARCK STATE COLLEGE                  ,ND,58501-1299,Public       ,351,454,805,1949,1392,3341
00298900,DICKINSON STATE UNIVERSITY              ,ND,58601-4896,Public       ,191,177,368,1211,671,1882
00299000,JAMESTOWN COLLEGE                       ,ND,58405-3401,Private      ,127,40,167,1003,134,1137
00299100,LAKE REGION STATE COLLEGE               ,ND,58301-1598,Public       ,84,135,219,305,362,667
00299200,UNIVERSITY OF MARY                      ,ND,58504-9652,Private      ,157,385,542,1496,1408,2904
00299300,MAYVILLE STATE UNIVERSITY               ,ND,58257-1299,Public       ,100,95,195,487,241,728
00299400,MINOT STATE UNIVERSITY                  ,ND,58707-0002,Public       ,232,395,627,1441,1365,2806
00299500,MINOT STATE UNIV-BOTTINEAU CAMPUS       ,ND,58318-1159,Public       ,73,76,149,277,234,511
00299600,NORTH DAKOTA STATE CLG OF SCIENCE       ,ND,58076-0002,Public       ,256,269,525,1286,687,1973
00299700,NORTH DAKOTA STATE UNIVERSITY           ,ND,58108-6050,Public       ,1292,737,2029,9046,2580,11626
00300500,UNIVERSITY OF NORTH DAKOTA              ,ND,58202-8193,Public       ,961,1021,1982,7373,4236,11609
00300700,WILLISTON STATE COLLEGE                 ,ND,58802-1326,Public       ,57,116,173,243,323,566
00300800,VALLEY CITY STATE UNIVERSITY            ,ND,58072-0000,Public       ,72,80,152,626,261,887
00484600,RASMUSSEN COLLEGE                       ,ND,58103-7196,Proprietary  ,105,321,426,348,1294,1642
00484601,RASMUSSEN COLLEGE - BISMARCK            ,ND,58503-0000,Proprietary  ,54,153,207,159,567,726
00775600,JOSEF'S SCHOOL OF HAIR DESIGN INC       ,ND,58102-4977,Proprietary  ,19,33,52,79,84,163
00935400,MEDCENTER ONE COLLEGE OF NURSING        ,ND,58501-4494,Private      ,13,18,31,59,63,122
01040600,JOSEF'S SCHOOL OF HAIR DESIGN           ,ND,58201-6394,Proprietary  ,20,25,45,57,64,121
01205900,TRINITY BIBLE COLLEGE                   ,ND,58436-7150,Private      ,61,53,114,217,103,320
01229500,R D HAIRSTYLING COLLEGE                 ,ND,58501-4001,Proprietary  ,14,9,23,42,32,74
02188200,SITTING BULL COLLEGE                    ,ND,58538-9721,Public       ,17,127,144,51,288,339
02236500,LITTLE HOOP COMMUNITY COLLEGE           ,ND,58335-0000,Public       ,24,128,152,30,170,200
02242900,UNITED TRIBES TECHNICAL COLLEGE         ,ND,58504-0000,Private      ,69,210,279,174,621,795
02298200,HEADQUARTERS ACADEMY OF HAIR DESIGN     ,ND,58701-0000,Proprietary  ,7,31,38,18,59,77
02301100,TURTLE MTN CMNTY COLG-FIN AID OFC       ,ND,58316-0000,Private      ,122,250,372,224,476,700
02553700,FORT BERTHOLD COMMUNITY COLLEGE         ,ND,58763-0000,Public       ,21,114,135,33,152,185
03087200,MOLER BARBER CLG OF HAIRSTYLING         ,ND,58103-0000,Proprietary  ,1,6,7,2,13,15
04031300,SALON PROFESSIONAL ACADEMY (THE)        ,ND,58103-3337,Proprietary  ,5,14,19,51,52,103
04139400,HAIR ACADEMY (THE)                      ,ND,58501-4929,Proprietary  ,11,8,19,54,35,89
00301005,ANTIOCH UNIV/SEATTLE                    ,WA,98121-0000,Private      ,20,235,255,62,1163,1225
00376900,BELLEVUE COMMUNITY COLLEGE              ,WA,98007-6484,Public       ,598,1502,2100,3287,5341,8628
00377000,BIG BEND COMMUNITY COLLEGE              ,WA,98837-3299,Public       ,222,464,686,897,1336,2233
00377100,"CENTRAL WASHINGTON UNIV., FIN AID       ",WA,98926-7495,Public       ,961,842,1803,8883,4178,13061
00377200,CENTRALIA COLLEGE                       ,WA,98531-4099,Public       ,183,526,709,921,1602,2523
00377300,CLARK COLLEGE                           ,WA,98663-3598,Public       ,913,2160,3073,4102,7774,11876
00377400,COLUMBIA BASIN COLLEGE                  ,WA,99301-3379,Public       ,412,910,1322,2139,3395,5534
00377500,EASTERN WASHINGTON UNIVERSITY           ,WA,99004-2447,Public       ,623,895,1518,8048,5742,13790
00377600,EVERETT COMMUNITY COLLEGE               ,WA,98201-1352,Public       ,481,1450,1931,2081,4754,6835
00377700,HERITAGE UNIVERSITY                     ,WA,98948-9562,Private      ,40,272,312,359,1386,1745
00377800,GONZAGA UNIVERSITY                      ,WA,99258-0083,Private      ,119,489,608,6445,3569,10014
00377900,GRAYS HARBOR COLLEGE                    ,WA,98520-7599,Public       ,204,460,664,720,1407,2127
00378000,GREEN RIVER COMMUNITY COLLEGE           ,WA,98092-3622,Public       ,505,1209,1714,2297,4006,6303
00378100,HIGHLINE COMMUNITY COLLEGE              ,WA,98198-9800,Public       ,456,1253,1709,2332,4474,6806
00378200,LOWER COLUMBIA COLLEGE                  ,WA,98632-0310,Public       ,290,891,1181,1022,2794,3816
00378300,NORTHWEST UNIVERSITY                    ,WA,98083-0000,Private      ,98,214,312,1100,742,1842
00378400,OLYMPIC COLLEGE                         ,WA,98337-1600,Public       ,392,1027,1419,1545,3741,5286
00378500,PACIFIC LUTHERAN UNIVERSITY             ,WA,98447-0003,Private      ,133,170,303,4110,1493,5603
00378600,PENINSULA COLLEGE                       ,WA,98362-6660,Public       ,124,509,633,444,1358,1802
00378700,SEATTLE CENTRAL COMMUNITY COLLEGE       ,WA,98122-2413,Public       ,490,1475,1965,2452,5468,7920
00378703,SEATTLE VOCATIONAL INSTITUTE            ,WA,98144-0000,Public       ,31,236,267,78,362,440
00378800,SEATTLE PACIFIC UNIVERSITY              ,WA,98119-1997,Private      ,161,345,506,4220,1979,6199
00379000,SEATTLE UNIVERSITY                      ,WA,98122-1090,Private      ,378,603,981,6855,6238,13093
00379100,SHORELINE COMMUNITY COLLEGE             ,WA,98133-5696,Public       ,356,805,1161,1675,3385,5060
00379200,SKAGIT VALLEY COLLEGE                   ,WA,98273-5899,Public       ,276,747,1023,1120,2637,3757
00379300,SPOKANE COMMUNITY COLLEGE               ,WA,99207-5399,Public       ,508,1854,2362,3190,8415,11605
00379400,ST MARTIN'S UNIVERSITY                  ,WA,98503-7500,Private      ,33,116,149,1279,962,2241
00379600,TACOMA COMMUNITY COLLEGE                ,WA,98466-6100,Public       ,443,1547,1990,2626,6604,9230
00379700,UNIVERSITY OF PUGET SOUND               ,WA,98416-1039,Private      ,76,104,180,4393,1048,5441
00379800,UNIVERSITY OF WASHINGTON                ,WA,98195-5880,Public       ,1373,2402,3775,27537,23981,51518
00379900,WALLA WALLA UNIVERSITY                  ,WA,99324-1198,Private      ,212,153,365,1437,637,2074
00380000,WASHINGTON STATE UNIVERSITY             ,WA,99164-1035,Public       ,1133,1520,2653,18765,10752,29517
00380100,WENATCHEE VALLEY COLLEGE                ,WA,98801-1799,Public       ,207,593,800,1212,2250,3462
00380200,WESTERN WASHINGTON UNIVERSITY           ,WA,98225-5946,Public       ,781,557,1338,14324,4042,18366
00380300,WHITMAN COLLEGE                         ,WA,99362-2067,Private      ,33,13,46,2799,95,2894
00380400,WHITWORTH UNIVERSITY                    ,WA,99251-0001,Private      ,88,195,283,3536,1017,4553
00380500,YAKIMA VALLEY COMMUNITY COLLEGE         ,WA,98907-2520,Public       ,366,865,1231,2297,4116,6413
00499900,BELLINGHAM TECHNICAL COLLEGE            ,WA,98225-0000,Public       ,186,656,842,652,2023,2675
00500000,PIERCE COLLEGE                          ,WA,98498-1919,Public       ,539,1505,2044,2522,5632,8154
00500100,EDMONDS COMMUNITY COLLEGE               ,WA,98036-5999,Public       ,463,1070,1533,1796,3835,5631
00500600,WALLA WALLA COMMUNITY COLLEGE           ,WA,99362-9267,Public       ,233,536,769,1483,2320,3803
00530600,BATES TECHNICAL COLLEGE                 ,WA,98405-0000,Public       ,161,809,970,584,2261,2845
00530601,BATES TECHNICAL COLLEGE - SOUTH CAMPUS  ,WA,98409-5847,Public       ,0,0,0,61,194,255
00537200,SOUTH PUGET SOUND COMMUNITY COLLEGE     ,WA,98512-6292,Public       ,331,915,1246,1826,3695,5521
00537300,LAKE WASHINGTON TECHNICAL COLLEGE       ,WA,98034-8505,Public       ,149,722,871,571,2162,2733
00575200,CLOVER PARK TECHNICAL COLLEGE           ,WA,98499-0000,Public       ,312,1372,1684,1093,4340,5433
00815500,EVERGREEN STATE COLLEGE (THE)           ,WA,98505-0002,Public       ,284,537,821,3486,3445,6931
00844300,ITT TECHNICAL INSTITUTE                 ,WA,98168-3334,Proprietary  ,167,625,792,445,1333,1778
00907901,EVEREST COLLEGE                         ,WA,98684-6950,Proprietary  ,40,183,223,108,492,600
00938700,PERRY TECHNICAL INSTITUTE               ,WA,98903-1239,Private      ,102,167,269,479,718,1197
00954400,SPOKANE FALLS COMMUNITY COLLEGE         ,WA,99224-5204,Public       ,539,1187,1726,3174,5150,8324
00970400,NORTH SEATTLE COMMUNITY COLLEGE         ,WA,98103-3599,Public       ,243,970,1213,1195,3624,4819
00970600,SOUTH SEATTLE COMMUNITY COLLEGE         ,WA,98106-1499,Public       ,245,827,1072,1329,2927,4256
00973900,GLEN DOW ACAD OF HAIR DESIGN            ,WA,99201-0209,Proprietary  ,32,49,81,83,138,221
01036400,WHATCOM COMMUNITY COLLEGE               ,WA,98226-8003,Public       ,331,590,921,1661,2162,3823
01043400,RENTON TECHNICAL COLLEGE                ,WA,98056-0000,Public       ,205,861,1066,716,2386,3102
01148100,DIVERS INSTITUTE OF TECHNOLOGY          ,WA,98107-0667,Proprietary  ,44,161,205,105,406,511
01231500,CORNISH COLLEGE OF THE ARTS             ,WA,98121-4604,Private      ,68,44,112,1261,360,1621
01249600,GREENWOOD BEAUTY SCHOOL                 ,WA,98103-0000,Proprietary  ,10,43,53,30,103,133
01302200,CITY UNIVERSITY OF SEATTLE              ,WA,98005-3030,Private      ,22,632,654,121,2373,2494
01309400,BELLINGHAM BEAUTY SCHOOL                ,WA,98225-0000,Proprietary  ,13,33,46,27,59,86
02091701,KAPLAN COLLEGE - SEATTLE                ,WA,98055-4910,Proprietary  ,8,64,72,72,358,430
02105300,BELLEVUE BEAUTY SCHOOL                  ,WA,98007-0000,Proprietary  ,11,36,47,33,75,108
02106700,TRINITY LUTHERAN COLLEGE                ,WA,98201-3569,Private      ,12,13,25,90,48,138
02180000,NORTHWEST INDIAN COLLEGE                ,WA,98226-9278,Public       ,65,241,306,121,505,626
02184200,PAROBA COLLEGE OF COSMETOLOGY           ,WA,98208-0000,Proprietary  ,18,34,52,26,67,93
02202200,STYLEMASTERS COLLEGE OF HAIR DESIGN     ,WA,98632-0000,Proprietary  ,10,44,54,17,80,97
02203300,GENE JUAREZ ACADEMY OF BEAUTY           ,WA,98125-0000,Proprietary  ,122,126,248,337,415,752
02203301,GENE JUAREZ ACADEMY OF BEAUTY           ,WA,98003-0000,Proprietary  ,16,27,43,70,96,166
02222900,INTERNATIONAL AIR & HOSPITALITY ACADEMY ,WA,98661-4835,Proprietary  ,91,206,297,209,360,569
02222906,INTERNATIONAL AIR & HOSPITALITY ACADEMY ,WA,98661-3805,Proprietary  ,2,2,4,5,8,13
02236800,PROFESSIONAL BEAUTY SCHOOL              ,WA,98902-0000,Proprietary  ,12,27,39,49,79,128
02242500,BASTYR UNIVERSITY                       ,WA,98028-0000,Private      ,14,154,168,89,1066,1155
02263107,CAMBRIDGE COLLEGE-BELLEVUE              ,WA,98007-0000,Proprietary  ,0,0,0,3,15,18
02291300,ART INSTITUTE OF SEATTLE                ,WA,98121-1622,Proprietary  ,321,374,695,2193,1768,3961
02300100,EVEREST COLLEGE                         ,WA,98367-1835,Proprietary  ,29,159,188,88,377,465
02300103,EVEREST COLLEGE - EVERETT               ,WA,98208-2610,Proprietary  ,73,283,356,141,602,743
02300104,EVEREST COLLEGE - TACOMA                ,WA,98402-3004,Proprietary  ,61,399,460,122,667,789
02326500,INTERFACE COLLEGE                       ,WA,99201-3209,Proprietary  ,7,85,92,20,211,231
02331400,NORTHWEST HAIR ACADEMY                  ,WA,98273-0000,Proprietary  ,43,45,88,73,86,159
02331402,NORTHWEST HAIR ACADEMY - EVERETT        ,WA,98204-0000,Proprietary  ,13,22,35,36,35,71
02504900,ACADEMY OF HAIR DESIGN (THE)            ,WA,98801-0000,Proprietary  ,10,21,31,31,67,98
02541900,BJ'S BEAUTY AND BARBER COLLEGE          ,WA,98409-0000,Proprietary  ,16,60,76,41,120,161
02602100,NORTHWEST COLLEGE OF ART                ,WA,98370-8625,Proprietary  ,3,8,11,158,44,202
02606200,EVEREST COLLEGE                         ,WA,98055-2990,Proprietary  ,105,409,514,154,637,791
02617500,EVEREST COLLEGE                         ,WA,98133-9018,Proprietary  ,45,140,185,79,239,318
02617501,EVEREST COLLEGE - FIFE                  ,WA,98424-2647,Proprietary  ,43,116,159,109,280,389
02617503,EVEREST COLLEGE - VANCOUVER             ,WA,98684-6951,Proprietary  ,28,101,129,73,276,349
03031406,INTERNATIONAL ACADEMY OF DESIGN AND TECH,WA,98188-3319,Proprietary  ,41,51,92,195,256,451
03065000,CLARE'S BEAUTY COLLEGE                  ,WA,99301-5505,Proprietary  ,9,31,40,25,68,93
03071800,ITT TECHNICAL INSTITUTE                 ,WA,99216-1589,Proprietary  ,177,690,867,401,1485,1886
03099000,CORTIVA INSTITUTE - SEATTLE             ,WA,98109-5474,Proprietary  ,25,106,131,104,310,414
03110800,BAKKE GRADUATE UNIVERSITY               ,WA,98104-1222,Private      ,0,10,10,0,19,19
03139500,MONTESSORI SCHOOLS OF WASHINGTON        ,WA,98203-6600,Private      ,0,0,0,0,6,6
03280300,SEATTLE INST OF ORIENTAL MEDICINE       ,WA,98115-0000,Proprietary  ,0,6,6,6,55,61
03283300,NORTHWEST HVAC/R ASSOCIATION & TRAINING ,WA,99202-2125,Private      ,6,27,33,11,91,102
03361600,SEATTLE MIDWIFERY SCHOOL                ,WA,98144-0000,Private      ,1,11,12,4,80,84
03466400,MARS HILL GRADUATE SCHOOL               ,WA,98121-0000,Private      ,0,27,27,1,299,300
03483500,CASCADIA COMMUNITY COLLEGE              ,WA,98011-9510,Public       ,165,302,467,741,1046,1787
03490400,EMIL FRIES PIANO HOSPITAL & TRAININ     ,WA,98661-4323,Private      ,0,2,2,1,7,8
03689400,FAITH EVANGELICAL SEMINARY              ,WA,98407-2607,Private      ,0,73,73,3,168,171
03707500,CHETTA'S ACADEMY OF HAIR AND NAILS      ,WA,98362-4310,Proprietary  ,0,4,4,4,14,18
03724300,DIGIPEN INSTITUTE OF TECHNOLOGY         ,WA,98052-5170,Proprietary  ,49,55,104,677,300,977
03917300,EVERGREEN BEAUTY AND BARBER COLLEGE     ,WA,98208-3759,Proprietary  ,12,71,83,37,164,201
03932500,TOTAL COSMETOLOGY TRAINING CENTER       ,WA,99217-6231,Proprietary  ,12,45,57,31,110,141
03953300,YAKIMA BEAUTY SCHOOL;BEAUTYWORKS        ,WA,98901-2202,Proprietary  ,5,12,17,24,38,62
04043400,ALPINE COLLEGE                          ,WA,99206-5097,Proprietary  ,11,81,92,35,240,275
04120000,SUNNYSIDE BEAUTY ACADEMY                ,WA,98944-8711,Proprietary  ,1,5,6,3,15,18
04127200,VICTORIA'S ACADEMY OF COSMETOLOGY       ,WA,99336-3826,Proprietary  ,9,31,40,49,90,139
04130500,PACIFIC NORTHWEST UNIV OF HEALTH SCIENCE,WA,98901-1471,Private      ,0,19,19,10,232,242
04130800,CASCADE BEAUTY COLLEGE                  ,WA,98002-5504,Proprietary  ,7,18,25,15,44,59
04132800,INLAND MASSAGE INSTITUTE                ,WA,99208-5923,Proprietary  ,7,31,38,15,66,81
00340100,BROWN UNIVERSITY                        ,RI,02912-9127,Private      ,112,26,138,17001,462,17463
00340101,BROWN UNIVERSITY - GRADUATE SCHOOL      ,RI,02912-1827,Private      ,4,109,113,35,1573,1608
00340102,BROWN MEDICAL SCHOOL                    ,RI,02912-0000,Private      ,3,10,13,18,428,446
00340200,BRYANT UNIVERSITY                       ,RI,02917-1284,Private      ,118,66,184,5432,413,5845
00340400,JOHNSON & WALES UNIVERSITY              ,RI,02903-3703,Private      ,1070,699,1769,18490,3933,22423
00340600,PROVIDENCE COLLEGE                      ,RI,02918-0001,Private      ,69,103,172,7282,602,7884
00340700,RHODE ISLAND COLLEGE                    ,RI,02908-1991,Public       ,307,448,755,7028,3298,10326
00340800,COMMUNITY COLLEGE OF RI - WARWICK       ,RI,02906-0000,Public       ,741,1174,1915,4460,5213,9673
00340801,COMMUNITY COLLEGE OF RI - LINCOLN       ,RI,02865-4585,Public       ,204,366,570,1709,1892,3601
00340802,COMMUNITY COLLEGE OF RI- PROVIDENCE     ,RI,02905-2313,Public       ,163,341,504,1471,2088,3559
00340900,RHODE ISLAND SCHOOL OF DESIGN           ,RI,02903-2784,Private      ,59,58,117,2575,1424,3999
00341000,ROGER WILLIAMS UNIVERSITY               ,RI,02809-2921,Private      ,40,97,137,7390,1579,8969
00341100,SALVE REGINA UNIVERSITY                 ,RI,02840-4192,Private      ,53,72,125,4496,356,4852
00341400,UNIVERSITY OF RHODE ISLAND              ,RI,02881-0000,Public       ,724,572,1296,18731,3565,22296
00659100,ST. JOSEPH HOSP SCH OF NURSING          ,RI,02904-5199,Private      ,2,19,21,51,146,197
00784400,GIBBS COLLEGE                           ,RI,02920-7807,Proprietary  ,3,6,9,34,92,126
00784500,NEW ENGLAND INSTITUTE OF TECHNOLOGY     ,RI,02886-2266,Private      ,413,484,897,2777,2054,4831
01115900,"SAWYER SCHOOL,THE                       ",RI,02860-4117,Proprietary  ,81,372,453,269,1222,1491
02071900,ARTHUR ANGELO SCH COSMET&HAIR DSGN      ,RI,02903-0000,Proprietary  ,14,31,45,93,180,273
02176900,WARWICK ACADEMY OF BEAUTY CULTURE       ,RI,02886-1534,Proprietary  ,15,17,32,71,122,193
02584400,NEW ENGLAND TRACTOR TRAILER TRAINING SCH,RI,02860-1752,Proprietary  ,23,222,245,46,427,473
03080000,NEWPORT SCHOOL OF HAIRDRESSING          ,RI,02860-4038,Proprietary  ,2,15,17,7,59,66
03232300,LINCOLN TECHNICAL INSTITUTE             ,RI,02865-4211,Proprietary  ,147,306,453,466,845,1311
03570500,ZION BIBLE COLLEGE                      ,RI,02806-1246,Private      ,28,16,44,156,93,249
03732300,INTERNATIONAL YACHT RESTORATION SCH     ,RI,02840-6720,Private      ,6,9,15,18,31,49
04141200,TONI & GUY HAIRDRESSING ACADEMY         ,RI,02920-0000,Proprietary  ,26,31,57,53,40,93
00341700,ALLEN UNIVERSITY                        ,SC,29204-1085,Private      ,174,121,295,1152,542,1694
00341800,ANDERSON UNIVERSITY                     ,SC,29621-4035,Private      ,85,174,259,2008,794,2802
00341900,CHARLESTON SOUTHERN UNIVERSITY          ,SC,29406-2160,Private      ,226,374,600,3793,1878,5671
00342000,BENEDICT COLLEGE                        ,SC,29204-1086,Private      ,506,295,801,3993,1442,5435
00342100,BOB JONES UNIVERSITY                    ,SC,29614-1000,Proprietary  ,365,119,484,2876,377,3253
00342200,SOUTHERN WESLEYAN UNIVERSITY            ,SC,29630-1020,Private      ,47,362,409,898,1898,2796
00342300,THE CITADEL                             ,SC,29409-0002,Public       ,184,293,477,2317,996,3313
00342400,CLAFLIN UNIVERSITY                      ,SC,29115-4498,Private      ,212,223,435,2487,967,3454
00342500,CLEMSON UNIVERSITY                      ,SC,29634-0001,Public       ,809,648,1457,15995,3439,19434
00342600,UNIV OF SC AT SUMTER                    ,SC,29150-2498,Public       ,138,171,309,730,556,1286
00342700,COKER COLLEGE                           ,SC,29550-3797,Private      ,65,174,239,959,905,1864
00342800,COLLEGE OF CHARLESTON                   ,SC,29424-0100,Public       ,738,497,1235,9510,2423,11933
00342900,COLUMBIA INTERNATIONAL UNIVERSITY       ,SC,29203-1599,Private      ,60,152,212,500,681,1181
00343000,COLUMBIA COLLEGE                        ,SC,29203-5998,Private      ,115,252,367,1305,1144,2449
00343100,CONVERSE COLLEGE                        ,SC,29302-0006,Private      ,38,147,185,702,690,1392
00343200,ERSKINE COLLEGE                         ,SC,29639-0000,Private      ,40,11,51,760,36,796
00343201,ERSKINE THEOLOGICAL SEMINARY            ,SC,29639-0000,Private      ,0,37,37,6,139,145
00343400,FURMAN UNIVERSITY                       ,SC,29613-5253,Private      ,91,83,174,3253,349,3602
00343500,LANDER UNIVERSITY                       ,SC,29649-2099,Public       ,252,161,413,3231,848,4079
00343600,LIMESTONE COLLEGE                       ,SC,29340-3799,Private      ,122,623,745,1274,2911,4185
00343700,LUTHERAN THEOLOGICAL SOUTHERN SEM       ,SC,29203-5898,Private      ,1,23,24,2,140,142
00343800,MEDICAL UNIV OF SOUTH CAROLINA - FA     ,SC,29425-1760,Public       ,19,249,268,208,2777,2985
00343900,MORRIS COLLEGE                          ,SC,29150-3599,Private      ,219,142,361,1392,524,1916
00344000,NEWBERRY COLLEGE                        ,SC,29108-2197,Private      ,61,50,111,1614,279,1893
00344100,NORTH GREENVILLE COLLEGE                ,SC,29688-1892,Private      ,160,77,237,2214,347,2561
00344500,PRESBYTERIAN COLLEGE                    ,SC,29325-2503,Private      ,61,17,78,1484,66,1550
00344600,SOUTH CAROLINA STATE UNIVERSITY         ,SC,29117-4427,Public       ,593,605,1198,6229,2761,8990
00344700,SPARTANBURG METHODIST COLLEGE           ,SC,29301-5899,Private      ,111,40,151,1265,191,1456
00344800,UNIVERSITY OF SOUTH CAROLINA            ,SC,29208-3999,Public       ,1766,1932,3698,19939,10705,30644
00344900,UNIVERSITY OF SOUTH CAROLINA AIKEN      ,SC,29801-6399,Public       ,267,232,499,3038,1257,4295
00345000,UNIV OF SC AT BEAUFORT                  ,SC,29902-4602,Public       ,164,209,373,1150,889,2039
00345100,COASTAL CAROLINA UNIVERSITY             ,SC,29528-0000,Public       ,752,435,1187,10078,2102,12180
00345300,UNIV OF SC AT LANCASTER                 ,SC,29721-0889,Public       ,184,196,380,889,658,1547
00345400,UNIV OF SC SYSTEM SALKEHATCHIE          ,SC,29810-0617,Public       ,125,171,296,476,531,1007
00345500,VOORHEES COLLEGE                        ,SC,29042-0000,Private      ,144,120,264,852,402,1254
00345600,WINTHROP UNIVERSITY                     ,SC,29733-0001,Public       ,501,460,961,5949,2166,8115
00345700,WOFFORD COLLEGE                         ,SC,29303-3663,Private      ,42,22,64,1839,115,1954
00399000,FLORENCE-DARLINGTON TECH COLLEGE        ,SC,29501-0548,Public       ,812,1603,2415,2641,4865,7506
00399100,GREENVILLE TECHNICAL COLLEGE            ,SC,29607-2439,Public       ,2064,3680,5744,6999,11966,18965
00399200,PIEDMONT TECHNICAL COLLEGE              ,SC,29648-1467,Public       ,721,1753,2474,2110,4571,6681
00399300,MIDLANDS TECHNICAL COLLEGE              ,SC,29202-0000,Public       ,1936,3126,5062,6626,10511,17137
00399400,SPARTANBURG COMMUNITY COLLEGE           ,SC,29305-4386,Public       ,765,1409,2174,2995,5018,8013
00399500,CENTRAL CAROLINA TECHNICAL COLLEGE      ,SC,29150-2499,Public       ,605,1541,2146,1404,3697,5101
00399600,YORK TECHNICAL COLLEGE                  ,SC,29730-3395,Public       ,879,1872,2751,2596,5463,8059
00492000,TRIDENT TECHNICAL COLLEGE               ,SC,29423-8067,Public       ,2364,3944,6308,6202,10715,16917
00492300,CLINTON JR COLLEGE                      ,SC,29730-5152,Private      ,54,32,86,127,63,190
00492400,FORREST JUNIOR COLLEGE                  ,SC,29624-2405,Proprietary  ,10,38,48,20,130,150
00492500,HORRY-GEORGETOWN TECH COLLEGE           ,SC,29526-9521,Public       ,1080,1894,2974,3133,5897,9030
00492600,TRI-COUNTY TECHNICAL COLLEGE            ,SC,29670-9133,Public       ,927,1397,2324,3384,4091,7475
00492700,UNIV OF SC AT UNION                     ,SC,29379-0729,Public       ,59,79,138,244,246,490
00536300,DENMARK TECHNICAL COLLEGE               ,SC,29042-0000,Public       ,383,522,905,892,964,1856
00681500,ORANGEBURG-CALHOUN TECHNICAL COLG       ,SC,29118-8299,Public       ,501,887,1388,1297,2367,3664
00695100,UNIVERSITY OF SOUTH CAROLINA UPSTATE    ,SC,29303-9972,Public       ,550,598,1148,4895,2610,7505
00760200,NORTHEASTERN TECHNICAL COLLEGE          ,SC,29520-7015,Public       ,184,415,599,505,1101,1606
00922600,FRANCIS MARION UNIVERSITY               ,SC,29501-0000,Public       ,359,358,717,4535,1630,6165
00932200,WILLIAMSBURG TECHNICAL COLLEGE          ,SC,29556-4197,Public       ,129,334,463,330,740,1070
00991000,TECHNICAL COLLEGE OF THE LOWCOUNTRY     ,SC,29902-5441,Public       ,347,986,1333,832,2426,3258
00991100,UNIV OF SC-REGIONAL CAMPUSES ADMIN      ,SC,29208-0001,Public       ,19,18,37,151,83,234
01005600,AIKEN TECHNICAL COLLEGE                 ,SC,29802-0696,Public       ,463,963,1426,1759,3357,5116
01209200,KENNETH SHULER SCHOOL OF COSMETOLOGY    ,SC,29732-2169,Proprietary  ,21,51,72,39,99,138
01303907,SOUTH UNIVERSITY                        ,SC,29203-6400,Proprietary  ,110,653,763,381,2115,2496
02063700,SHERMAN CLG STRAIGHT CHIROPRACTIC       ,SC,29316-0000,Private      ,0,33,33,5,253,258
02189800,NO AMER INST OF AVIATION OF SO CAR      ,SC,29527-0000,Proprietary  ,0,7,7,5,11,16
02338600,CHARZANNE BEAUTY COLLEGE                ,SC,29649-0000,Proprietary  ,8,34,42,16,55,71
02341100,KENNETH SHULER SCHOOL OF COSMETOLOGY & N,SC,29210-0000,Proprietary  ,93,258,351,137,481,618
02356600,CHARLESTON COSMETOLOGY INSTITUTE        ,SC,29420-0000,Proprietary  ,37,58,95,62,123,185
02552400,ACADEMY OF HAIR TECHNOLOGY              ,SC,29615-2363,Proprietary  ,32,56,88,53,100,153
02567600,SUMTER BEAUTY COLLEGE                   ,SC,29150-0000,Proprietary  ,5,28,33,16,92,108
02614202,MILLER - MOTTE TECHNICAL COLLEGE - NORTH,SC,29406-9239,Proprietary  ,108,369,477,300,1089,1389
03010614,VIRGINIA COLLEGE - GOLF ACADEMY OF AMERI,SC,29579-0000,Proprietary  ,45,114,159,192,307,499
03052300,KENNETH SHULER SCH COSM & HAIR DESG     ,SC,29841-2013,Proprietary  ,26,52,78,46,106,152
03088300,ACADEMY OF COSMETOLOGY                  ,SC,29418-5667,Proprietary  ,23,66,89,35,122,157
03293300,STRAND COLLEGE OF HAIR DESIGN           ,SC,29572-4310,Proprietary  ,17,45,62,32,90,122
03304300,CENTURA COLLEGE                         ,SC,29406-9235,Proprietary  ,59,257,316,110,568,678
03513300,LACY COSMETOLOGY SCHOOL                 ,SC,29803-9084,Proprietary  ,4,29,33,12,59,71
03513301,LACY COSMETOLOGY SCHOOL -               ,SC,29072-0000,Proprietary  ,3,17,20,9,38,47
03513302,LACY COSMETOLOGY SCHOOL -               ,SC,29445-0000,Proprietary  ,1,25,26,9,56,65
03595300,CHARLESTON SCHOOL OF MASSAGE            ,SC,29412-8270,Proprietary  ,2,20,22,7,45,52
03746300,LEGRAND INSTITUTE OF COSMETOLOGY        ,SC,29020-0000,Proprietary  ,8,12,20,23,43,66
03746400,SOUTHEASTERN INSTITUTE                  ,SC,29210-0000,Proprietary  ,22,111,133,75,249,324
03768400,STYLETRENDS BARBER AND HAIRSTYLING ACADE,SC,29730-4511,Proprietary  ,7,35,42,18,74,92
03856400,W. L. BONNER COLLEGE                    ,SC,29203-0000,Private      ,2,27,29,9,72,81
03892300,HARLEY'S BEAUTY & BARBER CAREER INST.   ,SC,29204-1919,Proprietary  ,8,38,46,16,73,89
04096300,CHARLESTON SCHOOL OF LAW                ,SC,29402-0535,Proprietary  ,1,245,246,6,1224,1230
00345800,AUGUSTANA COLLEGE                       ,SD,57197-0001,Private      ,116,60,176,1793,213,2006
00345900,BLACK HILLS STATE UNIVERSITY            ,SD,57799-9670,Public       ,334,408,742,2195,1526,3721
00346100,DAKOTA WESLEYAN UNIVERSITY              ,SD,57301-4398,Private      ,65,56,121,650,292,942
00346300,DAKOTA STATE UNIVERSITY                 ,SD,57042-1799,Public       ,180,169,349,1222,588,1810
00346500,MOUNT MARTY COLLEGE                     ,SD,57078-3724,Private      ,58,121,179,525,485,1010
00346600,NORTHERN STATE UNIVERSITY               ,SD,57401-7198,Public       ,108,154,262,1501,621,2122
00346700,PRESENTATION COLLEGE                    ,SD,57401-1299,Private      ,40,127,167,330,474,804
00346900,UNIVERSITY OF SIOUX FALLS               ,SD,57105-1699,Private      ,58,117,175,1287,458,1745
00347000,SOUTH DAKOTA SCH OF MINES & TECH        ,SD,57701-3995,Public       ,143,161,304,1366,535,1901
00347100,SOUTH DAKOTA STATE UNIVERSITY           ,SD,57007-2298,Public       ,1102,730,1832,7682,2870,10552
00347400,UNIVERSITY OF SOUTH DAKOTA              ,SD,57069-2390,Public       ,638,818,1456,4445,4011,8456
00405600,SIOUX FALLS SEMINARY                    ,SD,57105-2729,Private      ,0,26,26,1,83,84
00405700,NATIONAL AMERICAN UNIVERSITY            ,SD,57701-3692,Proprietary  ,261,2712,2973,539,6179,6718
00405707,NATIONAL AMERICAN UNIVERSITY            ,SD,57105-0000,Proprietary  ,19,81,100,49,300,349
00492900,MCKENNAN HOSP-RADOLOGICAL TECH          ,SD,57101-0000,Private      ,2,2,4,17,14,31
00530900,LAKE AREA TECHNICAL INSTITUTE           ,SD,57201-2869,Public       ,171,141,312,837,462,1299
00598700,AVERA SACRED HEART HOSPITAL SCHOOL OF RA,SD,57078-3899,Private      ,0,0,0,4,4,8
00776400,SOUTHEAST TECHNICAL INST                ,SD,57107-0000,Public       ,374,480,854,1340,1274,2614
00828400,MITCHELL TECHNICAL INSTITUTE            ,SD,57301-2002,Public       ,111,128,239,609,407,1016
01013800,STEWART SCHOOL                          ,SD,57104-0000,Proprietary  ,18,33,51,82,82,164
01014804,COLORADO TECHNICAL UNIVERSITY           ,SD,57108-2272,Proprietary  ,46,279,325,279,1130,1409
01017000,WESTERN DAKOTA TECHNICAL INSTITUTE      ,SD,57701-4018,Public       ,125,306,431,474,992,1466
01147701,SIOUX VALLEY HOSP-MEDICAL TECH          ,SD,57117-5039,Private      ,1,4,5,13,12,25
01465900,OGLALA LAKOTA COLLEGE                   ,SD,57752-0490,Public       ,152,693,845,271,1312,1583
02137100,BLACK HILLS BEAUTY COLLEGE              ,SD,57701-0000,Proprietary  ,15,30,45,62,69,131
02143700,SINTE GLESKA UNIVERSITY                 ,SD,57570-0000,Public       ,78,356,434,118,584,702
02144600,KILIAN COMMUNITY COLLEGE                ,SD,57103-7020,Private      ,37,152,189,84,371,455
02277300,SISSETON WAHPETON COLLEGE               ,SD,57262-0000,Public       ,25,123,148,34,158,192
02297800,HEADLINES ACADEMY                       ,SD,57701-0000,Proprietary  ,17,30,47,45,91,136
00347700,AQUINAS COLLEGE                         ,TN,37205-2086,Private      ,29,126,155,247,695,942
00347701,AQUINAS COLLEGE -  PRIMETIME PROGRAM    ,TN,37214-3644,Private      ,2,38,40,14,195,209
00347800,AUSTIN PEAY STATE UNIVERSITY            ,TN,37044-0002,Public       ,807,1673,2480,6434,6767,13201
00347900,BELMONT UNIVERSITY                      ,TN,37212-3757,Private      ,301,533,834,5359,2784,8143
00348000,BETHEL UNIVERSITY                       ,TN,38201-1705,Private      ,123,723,846,1240,2808,4048
00348100,CARSON-NEWMAN COLLEGE                   ,TN,37760-2204,Private      ,176,144,320,2991,653,3644
00348200,CHRISTIAN BROTHERS UNIVERSITY           ,TN,38104-5581,Private      ,106,394,500,2035,1514,3549
00348300,COLUMBIA STATE COMMUNITY COLLEGE        ,TN,38401-5653,Public       ,620,921,1541,2853,2993,5846
00348500,CUMBERLAND UNIVERSITY                   ,TN,37087-3554,Private      ,101,280,381,1346,844,2190
00348600,LIPSCOMB UNIVERSITY                     ,TN,37204-3951,Private      ,314,415,729,3013,1501,4514
00348700,EAST TENNESSEE STATE UNIV - MAIN CAMPUS ,TN,37614-2857,Public       ,1008,1384,2392,10080,6814,16894
00348701,EAST TENNESSEE STATE UNIV - MEDICINE    ,TN,37614-1708,Public       ,21,48,69,204,436,640
00348709,EAST TENNESSEE STATE UNIV - PHARMACY    ,TN,37614-1704,Public       ,3,19,22,71,386,457
00349000,FISK UNIVERSITY                         ,TN,37208-3045,Private      ,107,112,219,1174,426,1600
00349200,FREED-HARDEMAN UNIVERSITY               ,TN,38340-2399,Private      ,125,180,305,1712,863,2575
00349500,JOHNSON BIBLE COLLEGE                   ,TN,37998-9775,Private      ,57,64,121,579,295,874
00349600,KING COLLEGE                            ,TN,37620-2699,Private      ,59,246,305,1196,1078,2274
00349800,LAMBUTH UNIVERSITY                      ,TN,38301-5296,Private      ,63,44,107,1116,341,1457
00349900,LANE COLLEGE                            ,TN,38301-4598,Private      ,361,202,563,3079,1135,4214
00350000,LEE UNIVERSITY                          ,TN,37320-0000,Private      ,370,309,679,3448,1281,4729
00350100,LEMOYNE-OWEN COLLEGE                    ,TN,38126-6510,Private      ,154,374,528,970,1318,2288
00350200,LINCOLN MEMORIAL UNIVERSITY             ,TN,37752-7920,Private      ,131,674,805,1561,3479,5040
00350400,MARTIN METHODIST COLLEGE                ,TN,38478-2799,Private      ,68,79,147,833,476,1309
00350500,MARYVILLE COLLEGE                       ,TN,37804-5907,Private      ,38,35,73,1851,218,2069
00350600,MEHARRY MEDICAL COLLEGE                 ,TN,37208-0000,Private      ,2,74,76,36,1285,1321
00350700,MEMPHIS COLLEGE OF ART                  ,TN,38104-2764,Private      ,53,56,109,595,229,824
00350900,UNIVERSITY OF MEMPHIS (THE)             ,TN,38152-4611,Public       ,1605,3147,4752,14940,15555,30495
00351000,MIDDLE TENNESSEE STATE UNIV             ,TN,37130-0000,Public       ,2306,2487,4793,20679,11097,31776
00351100,MILLIGAN COLLEGE                        ,TN,37682-4001,Private      ,63,91,154,1063,551,1614
00351700,SOUTHERN COLLEGE OF OPTOMETRY           ,TN,38104-2222,Private      ,2,18,20,11,565,576
00351800,SOUTHERN ADVENTIST UNIVERSITY           ,TN,37315-0370,Private      ,234,117,351,2254,630,2884
00351900,RHODES COLLEGE                          ,TN,38112-1690,Private      ,137,56,193,2583,290,2873
00352200,TENNESSEE STATE UNIVERSITY              ,TN,37209-1561,Public       ,889,1723,2612,10143,7687,17830
00352201,TENNESSEE STATE UNIVERSITY - AVON WILLIA,TN,37203-3401,Public       ,0,0,0,205,106,311
00352300,TENNESSEE TECHNOLOGICAL UNIV            ,TN,38505-0001,Public       ,863,945,1808,8752,3751,12503
00352400,TENNESSEE TEMPLE UNIVERSITY             ,TN,37404-3587,Private      ,82,118,200,491,422,913
00352500,TENNESSEE WESLEYAN COLLEGE              ,TN,37371-0040,Private      ,82,68,150,1174,495,1669
00352600,TREVECCA NAZARENE UNIVERSITY            ,TN,37210-2877,Private      ,143,427,570,1282,1986,3268
00352700,TUSCULUM COLLEGE                        ,TN,37743-0001,Private      ,72,279,351,2080,1775,3855
00352800,UNION UNIVERSITY                        ,TN,38305-3697,Private      ,195,588,783,2580,2302,4882
00352900,UNIVERSITY OF TENNESSEE-CHATTANOOGA     ,TN,37403-2598,Public       ,1069,890,1959,11336,4127,15463
00353000,UNIVERSITY OF TENNESSEE-KNOXVILLE       ,TN,37996-0150,Public       ,2459,1617,4076,23754,9305,33059
00353006,UNIVERSITY OF TENNESSEE-HEALTH SCI CTR  ,TN,38103-0000,Public       ,29,230,259,288,2990,3278
00353100,UNIVERSITY OF TENNESSEE-MARTIN          ,TN,38238-0002,Public       ,590,783,1373,7044,3174,10218
00353400,UNIVERSITY OF THE SOUTH                 ,TN,37383-1000,Private      ,51,10,61,1712,83,1795
00353500,VANDERBILT UNIVERSITY                   ,TN,37240-0001,Private      ,319,583,902,12500,6307,18807
00353501,VANDERBILT UNIV MED CTR ALLIEDHEAL      ,TN,37232-5510,Private      ,5,36,41,42,212,254
00353502,VANDERBILT UNIV - SCH OF MED            ,TN,37232-0000,Private      ,9,29,38,99,1015,1114
00353600,BRYAN COLLEGE                           ,TN,37321-7000,Private      ,74,124,198,975,515,1490
00399800,CHATTANOOGA STATE COMMUNITY COLLEGE     ,TN,37406-1097,Public       ,1046,2264,3310,4449,7228,11677
00399900,CLEVELAND STATE COMMUNITY COLLEGE       ,TN,37312-2858,Public       ,285,620,905,1716,2394,4110
00402500,TN TECHNOLOGY CTR AT KNOXVILLE          ,TN,37919-2327,Public       ,115,398,513,390,1274,1664
00402600,TENNESSEE TECH. CNTR AT CROSSVILLE      ,TN,38555-4142,Public       ,72,131,203,306,534,840
00461700,NATIONAL COLLEGE OF BUSINESS & TECH     ,TN,37211-6605,Proprietary  ,133,683,816,360,2517,2877
00493400,DRAUGHONS JR CLG OF BUSINESS            ,TN,37217-1056,Proprietary  ,183,898,1081,429,2495,2924
00493700,JACKSON STATE COMMUNITY COLLEGE         ,TN,38301-3797,Public       ,414,986,1400,2714,3904,6618
00493800,SOUTH COLLEGE                           ,TN,37909-3323,Proprietary  ,89,534,623,394,1676,2070
00494700,WEST TENNESSEE BUSINESS COLLEGE         ,TN,38301-3256,Proprietary  ,40,176,216,108,544,652
00528000,TN TECHNOLOGY CTR AT COVINGTON          ,TN,38019-0249,Public       ,56,130,186,153,326,479
00528100,TN TECHNOLOGY CTR AT ELIZABETHTON       ,TN,37643-0789,Public       ,67,275,342,272,914,1186
00528200,TN TECHNOLOGY CTR AT HARTSVILLE         ,TN,37074-0000,Public       ,28,121,149,207,416,623
00528300,TN TECHNOLOGY CTR AT NEWBERN            ,TN,38059-1198,Public       ,38,107,145,179,492,671
00530700,TN TECHNOLOGY CTR AT MCMINNVILLE        ,TN,37110-1322,Public       ,23,98,121,161,519,680
00535100,TENNESSEE TECHNOLOGY CENTER AT MORRISTOW,TN,37813-2094,Public       ,74,273,347,440,1166,1606
00535200,TN TECHNOLOGY CENTER AT MCKENZIE        ,TN,38201-1620,Public       ,16,111,127,161,503,664
00535300,TN TECHNOLOGY CENTER AT LIVINGSTON      ,TN,38570-0219,Public       ,47,120,167,242,446,688
00535400,TN TECHNOLOGY CTR AT JACKSON            ,TN,38301-0000,Public       ,68,291,359,407,1275,1682
00535600,TENNESSEE TECHNOLOGY CENTER AT HOHENWALD,TN,38462-0000,Public       ,63,184,247,255,546,801
00535700,TENNESSEE TECHNOLOGY CENTER AT CRUMP    ,TN,38327-3402,Public       ,27,124,151,244,513,757
00535800,TN TECHNOLOGY CENTER AT ATHENS          ,TN,37371-0848,Public       ,42,77,119,273,495,768
00535900,TENNESSEE TECHNOLOGY CENTER AT NASHVILLE,TN,37209-0000,Public       ,130,497,627,413,1267,1680
00536000,TENNESSEE TECHNOLOGY CENTER AT MEMPHIS  ,TN,38105-3604,Public       ,217,664,881,751,2003,2754
00537800,NORTHEAST STATE TECH CMNTY COLG         ,TN,37617-0246,Public       ,598,1208,1806,2870,4227,7097
00537900,TN TECHNOLOGY CTR AT SHELBYVILLE        ,TN,37160-3697,Public       ,53,238,291,339,966,1305
00683500,DYERSBURG STATE COMMUNITY COLLEGE       ,TN,38024-0000,Public       ,266,759,1025,1603,2671,4274
00683600,MOTLOW STATE COMMUNITY COLLEGE          ,TN,37388-7972,Public       ,696,1008,1704,2691,3013,5704
00743900,FOUNTAINHEAD COLLEGE OF TECHNOLOGY      ,TN,37918-2583,Proprietary  ,32,138,170,111,349,460
00744000,NASHVILLE AUTO DIESEL COLLEGE           ,TN,37206-3298,Proprietary  ,392,281,673,2386,940,3326
00778200,TENNESSEE TECHNOLOGY CENTER AT DICKSON  ,TN,37055-0000,Public       ,82,291,373,317,797,1114
00778300,MIDDLE TENNESSEE SCH OF ANESTHESIA      ,TN,37116-0417,Private      ,1,13,14,17,160,177
00814500,NASHVILLE STATE TECH CMNTY COLLEGE      ,TN,37209-0000,Public       ,917,2109,3026,2926,6148,9074
00865500,GENESIS CAREER COLLEGE OF COOKEVILLE    ,TN,38501-1959,Proprietary  ,15,52,67,34,94,128
00885900,JOHN A GUPTON COLLEGE                   ,TN,37203-2934,Private      ,10,42,52,91,140,231
00886300,WALTERS STATE COMMUNITY COLLEGE         ,TN,37813-6899,Public       ,613,1150,1763,3849,4372,8221
00946400,TN TECHNOLOGY CTR AT PULASKI            ,TN,38478-4541,Public       ,49,169,218,126,431,557
00956700,TENNESSEE SCHOOL OF BEAUTY              ,TN,37921-3303,Proprietary  ,45,138,183,156,322,478
00971000,TENNESSEE TECHNOLOGY CENTER AT ONEIDA/HU,TN,37756-4149,Public       ,38,115,153,109,283,392
00991200,VOLUNTEER STATE COMMUNITY COLLEGE       ,TN,37066-3188,Public       ,816,1560,2376,3596,4770,8366
00991400,ROANE STATE COMMUNITY COLLEGE           ,TN,37748-8664,Public       ,590,1108,1698,3433,3960,7393
00998200,CRICHTON COLLEGE                        ,TN,38111-4745,Private      ,46,335,381,244,1180,1424
01021700,INTERNATIONAL ACADEMY OF DESIGN & TECH  ,TN,37212-0000,Proprietary  ,103,177,280,458,582,1040
01032600,TN TECHNOLOGY CTR AT HARRIMAN           ,TN,37748-1109,Public       ,61,116,177,193,367,560
01043900,SOUTHWEST TENNESSEE COMMUNITY COLLG     ,TN,38104-3322,Public       ,1778,4077,5855,6530,12923,19453
01044700,"PLAZA BEAUTY SCHOOL, INC.               ",TN,38117-4822,Proprietary  ,30,84,114,55,158,213
01046000,AMERICAN BAPTIST THEOLOGICAL SEMINA     ,TN,37207-4994,Private      ,3,31,34,16,110,126
01052900,MEMPHIS THEOLOGICAL SEMINARY            ,TN,38104-0000,Private      ,1,68,69,2,215,217
01070000,TN TECHNOLOGY CENTER AT JACKSBORO       ,TN,37757-2461,Public       ,19,61,80,127,303,430
01155300,WM R MOORE COLLEGE OF TECHNOLOGY        ,TN,38104-0000,Private      ,27,82,109,71,183,254
01216400,TENNESSEE TECHNICAL CNTR AT RIPLEY      ,TN,38063-7359,Public       ,16,109,125,69,371,440
01254700,EMMANUEL SCHOOL OF RELIGION             ,TN,37601-0000,Private      ,0,36,36,1,74,75
01269300,PELLISSIPPI STATE COMMUNITY COLLEGE     ,TN,37933-0990,Public       ,1245,1713,2958,5058,4898,9956
02069303,VATTEROTT COLLEGE -                     ,TN,38016-5877,Proprietary  ,35,121,156,67,268,335
02092800,TENNESSEE TECHNOLOGY CENTER AT WHITEVILL,TN,38075-0000,Public       ,36,117,153,152,354,506
02103500,TN TECHNOLOGY CTR AT MURFREESBORO       ,TN,37129-0000,Public       ,64,238,302,236,625,861
02106400,O'MORE COLLEGE OF DESIGN                ,TN,37064-0000,Private      ,35,16,51,178,57,235
02125300,NASHVILLE CLG OF MEDICAL CAREERS        ,TN,37115-0000,Proprietary  ,17,91,108,42,221,263
02153100,JON NAVE UNIVERSITY OF COSMETOLOGY      ,TN,37013-3347,Proprietary  ,60,87,147,132,182,314
02157100,CONCORDE CAREER COLLEGE                 ,TN,38137-0000,Proprietary  ,101,499,600,315,1497,1812
02188300,PENTECOSTAL THEOLOGICAL SEMINARY        ,TN,37320-0000,Private      ,1,59,60,4,207,211
02204200,"CHATTANOOGA COLLEGE - MEDICAL, DENTAL AN",TN,37411-0000,Proprietary  ,46,238,284,93,509,602
02237900,TN TECHNOLOGY CENTER AT PARIS           ,TN,38242-0000,Public       ,29,150,179,141,605,746
02257400,ARNOLD'S BEAUTY SCHOOL                  ,TN,38358-0000,Proprietary  ,12,23,35,32,49,81
02263104,HIGH-TECH INSTITUTE - NASHVILLE         ,TN,37214-2531,Proprietary  ,14,40,54,52,127,179
02275500,REUBEN-ALLEN COLLEGE                    ,TN,37922-0000,Proprietary  ,9,20,29,37,59,96
02278700,MR WAYNES SCH OF UNISEX HAIR DESIGN     ,TN,38501-0000,Proprietary  ,7,18,25,14,37,51
02293900,VOLUNTEER BEAUTY ACADEMY-NASHVILLE      ,TN,37115-2112,Proprietary  ,12,59,71,24,102,126
02294000,VOLUNTEER BEAUTY ACADEMY-DYERSBURG      ,TN,38024-1622,Proprietary  ,8,42,50,15,74,89
02326200,KAPLAN CAREER INSTITUTE                 ,TN,37217-1342,Proprietary  ,73,394,467,200,1104,1304
02326202,KAPLAN CAREER INSTITUTE - THOMPSON LANE ,TN,37204-3692,Proprietary  ,6,31,37,21,110,131
02326300,MEDVANCE INSTITUTE                      ,TN,38501-4305,Proprietary  ,38,188,226,117,473,590
02335900,VOLUNTEER BEAUTY ACADEMY-NASHVILLE      ,TN,37209-3033,Proprietary  ,4,35,39,16,77,93
02359800,ITT TECHNICAL INSTITUTE                 ,TN,37214-3717,Proprietary  ,437,1116,1553,968,2362,3330
02498000,NEW WAVE HAIR ACADEMY                   ,TN,38128-0000,Proprietary  ,6,30,36,29,90,119
02539800,QUEEN CITY COLLEGE                      ,TN,37042-0000,Proprietary  ,10,61,71,36,188,224
02540000,TENNESSEE ACADEMY OF COSMETOLOGY        ,TN,38133-0000,Proprietary  ,17,69,86,45,135,180
02578200,NOSSI COLLEGE OF ART                    ,TN,37072-0000,Proprietary  ,46,58,104,301,324,625
02595000,FAYETTEVILLE BEAUTY SCHOOL              ,TN,37334-2909,Proprietary  ,9,42,51,14,58,72
02597600,NEW WAVE HAIR ACADEMY                   ,TN,38301-3812,Proprietary  ,10,42,52,28,107,135
02599710,VATTEROTT COLLEGE - MEMPHIS             ,TN,38132-1714,Proprietary  ,57,261,318,141,805,946
02605501,REMINGTON COLLEGE - MEMPHIS CAMPUS      ,TN,38132-0000,Proprietary  ,117,468,585,377,1423,1800
02609204,VATTEROTT COLLEGE - VATTEROTT CAREER COL,TN,38133-4727,Proprietary  ,22,125,147,86,353,439
02614200,MILLER MOTTE BUSINESS COLLEGE           ,TN,37040-6023,Proprietary  ,132,422,554,250,965,1215
02614203,MILLER - MOTTE TECHNICAL COLLEGE - CHATT,TN,37421-7220,Proprietary  ,61,295,356,203,893,1096
02614204,MILLER - MOTTE TECHNICAL COLLEGE - GOODL,TN,37072-1870,Proprietary  ,20,100,120,72,324,396
03001800,FREE WILL BAPTIST BIBLE COLLEGE         ,TN,37205-2498,Private      ,46,45,91,224,136,360
03008800,FRANKLIN ACADEMY                        ,TN,37312-3939,Private      ,10,25,35,24,66,90
03010606,VIRGINIA COLLEGE - SCH OF BUSNSS & HLTH ,TN,37411-5600,Proprietary  ,14,79,93,45,269,314
03012500,NEW WAVE HAIR ACADEMY                   ,TN,38111-4253,Proprietary  ,15,73,88,50,173,223
03024900,TENNESSEE ACADEMY OF COSMETOLOGY        ,TN,38125-3442,Proprietary  ,18,81,99,47,134,181
03061100,GENESIS CAREER COLLEGE OF LEBANON       ,TN,37087-2718,Proprietary  ,53,153,206,85,250,335
03073400,ITT TECHNICAL INSTITUTE                 ,TN,37932-3343,Proprietary  ,463,1184,1647,1157,3012,4169
03076405,HIGH-TECH INSTITUTE - MEMPHIS           ,TN,38134-7345,Proprietary  ,11,65,76,58,222,280
03079100,NORTH CENTRAL INSTITUTE                 ,TN,37042-3116,Proprietary  ,7,24,31,15,70,85
03088800,WATKINS INSTITUTE COLLEGE OF ART & DESIG,TN,37228-1306,Private      ,35,41,76,440,263,703
03126900,STYLES & PROFILES BEAUTY COLLEGE        ,TN,38375-2109,Proprietary  ,6,17,23,7,23,30
03149300,NEW DIRECTIONS HAIR ACADEMY             ,TN,37209-0000,Proprietary  ,16,55,71,44,126,170
03355400,RICHMONT GRADUATE UNIVERSITY            ,TN,37404-0000,Private      ,0,69,69,4,216,220
03440300,BAPTIST MEMORIAL COLLEGE OF HEALTH      ,TN,38104-3104,Private      ,63,222,285,729,1463,2192
03480303,MEDVANCE INSTITUTE - NASHVILLE          ,TN,37203-1536,Proprietary  ,49,296,345,119,569,688
03513500,WILLIAMSON CHRISTIAN COLLEGE            ,TN,37067-8237,Private      ,1,14,15,3,43,46
03647300,NEW CONCEPTS SCHOOL OF COSMETOLOGY      ,TN,37311-7373,Proprietary  ,7,15,22,14,35,49
03683300,INTERNATIONAL BARBER & STYLE COLLEGE    ,TN,37209-0000,Proprietary  ,14,112,126,31,155,186
03701300,MEMPHIS INSTITUTE OF BARBERING          ,TN,38107-4334,Proprietary  ,19,99,118,54,204,258
03774400,SHEAR ACADEMY                           ,TN,38555-4177,Proprietary  ,0,12,12,5,24,29
03830300,SAE INSTITUTE OF TECHNOLOGY             ,TN,37203-4310,Proprietary  ,27,64,91,145,211,356
03841300,CAREER BEAUTY COLLEGE                   ,TN,38464-3634,Proprietary  ,4,10,14,11,24,35
03920300,INSTITUTE OF HAIR DESIGN                ,TN,38310-1801,Proprietary  ,5,10,15,19,29,48
03930300,BUCHANAN BEAUTY COLLEGE                 ,TN,37160-2741,Proprietary  ,8,33,41,12,70,82
03982300,VISIBLE SCHOOL - MUSIC AND WORSHIPS ARTS,TN,38104-5814,Private      ,13,5,18,86,32,118
04025300,LAST MINUTE CUTS SCHOOL OF BARBERING AND,TN,38109-7709,Proprietary  ,0,0,0,9,18,27
04035300,NAVE COSMETOLOGY ACADEMY                ,TN,38401-6335,Proprietary  ,19,77,96,38,144,182
04124100,ELITE COLLEGE OF COSMETOLOGY            ,TN,38351-1431,Proprietary  ,4,26,30,21,60,81
00353700,ABILENE CHRISTIAN UNIVERSITY            ,TX,79699-3701,Private      ,733,466,1199,4235,1445,5680
00353900,ALVIN COMMUNITY COLLEGE                 ,TX,77511-4807,Public       ,266,641,907,891,1814,2705
00354000,AMARILLO COLLEGE                        ,TX,79109-2446,Public       ,707,1795,2502,2731,5580,8311
00354100,ANGELO STATE UNIVERSITY                 ,TX,76909-5069,Public       ,584,526,1110,5734,2276,8010
00354300,AUSTIN COLLEGE                          ,TX,75090-4440,Private      ,85,25,110,1895,157,2052
00354400,AUSTIN PRESBYTERIAN THEOLOGICAL SEM     ,TX,78705-5797,Private      ,0,10,10,0,129,129
00354500,BAYLOR UNIVERSITY                       ,TX,76798-1458,Private      ,843,504,1347,17477,4054,21531
00354600,COASTAL BEND COLLEGE                    ,TX,78102-2197,Public       ,465,815,1280,1556,2152,3708
00354900,BLINN COLLEGE                           ,TX,77833-4098,Public       ,1546,999,2545,8509,3622,12131
00355300,CISCO JUNIOR COLLEGE                    ,TX,76437-9803,Public       ,469,730,1199,1756,2100,3856
00355400,CLARENDON COLLEGE                       ,TX,79226-0000,Public       ,138,271,409,470,484,954
00355600,COMMONWEALTH INST OF FUNERAL SVC        ,TX,77090-5918,Private      ,17,55,72,47,163,210
00355700,CONCORDIA UNIVERSITY TEXAS              ,TX,78726-4141,Private      ,151,582,733,1171,1823,2994
00355800,NORTH CENTRAL TEXAS COLLEGE             ,TX,76240-4699,Public       ,706,1098,1804,2415,3329,5744
00356000,DALLAS BAPTIST UNIVERSITY               ,TX,75211-9299,Private      ,389,1138,1527,2370,3662,6032
00356100,CEDAR VALLEY COLLEGE                    ,TX,75134-0000,Public       ,540,1377,1917,1671,3421,5092
00356200,DALLAS THEOLOGICAL SEM                  ,TX,75204-0000,Private      ,0,116,116,14,549,563
00356300,DEL MAR COLLEGE                         ,TX,78404-3897,Public       ,1030,1860,2890,4383,6342,10725
00356400,EAST TEXAS BAPTIST UNIVERSITY           ,TX,75670-1423,Private      ,176,83,259,1391,328,1719
00356500,TEXAS A&M UNIVERSITY - COMMERCE         ,TX,75429-3011,Public       ,577,1510,2087,3987,5607,9594
00356600,EPISCOPAL THEOL SEM OF THE STHWST       ,TX,78768-0000,Private      ,0,0,0,1,13,14
00356800,FRANK PHILLIPS COLLEGE                  ,TX,79008-0000,Public       ,147,228,375,410,499,909
00357000,GRAYSON COUNTY COLLEGE                  ,TX,75020-8299,Public       ,389,932,1321,1394,2863,4257
00357100,HARDIN-SIMMONS UNIVERSITY               ,TX,79698-6050,Private      ,157,163,320,2157,892,3049
00357200,TRINITY VALLEY COMMUNITY COLLEGE        ,TX,75751-2734,Public       ,526,1095,1621,1843,3304,5147
00357300,HILL COLLEGE                            ,TX,76645-2711,Public       ,219,371,590,749,963,1712
00357301,HILL COLLEGE                            ,TX,76031-0000,Public       ,181,478,659,567,1411,1978
00357400,HOWARD COLLEGE                          ,TX,79720-0213,Public       ,267,605,872,1107,1905,3012
00357500,HOWARD PAYNE UNIVERSITY                 ,TX,76801-2715,Private      ,110,84,194,1213,356,1569
00357600,HOUSTON BAPTIST UNIVERSITY              ,TX,77074-3298,Private      ,275,416,691,3746,1967,5713
00357700,HUSTON - TILLOTSON UNIVERSITY           ,TX,78702-2795,Private      ,153,144,297,924,561,1485
00357800,UNIVERSITY OF THE INCARNATE WORD        ,TX,78209-6398,Private      ,418,903,1321,4197,4278,8475
00357900,JACKSONVILLE COLLEGE                    ,TX,75766-4759,Private      ,68,68,136,209,144,353
00358000,KILGORE COLLEGE                         ,TX,75662-3299,Public       ,710,1279,1989,2627,3662,6289
00358100,LAMAR UNIVERSITY-BEAUMONT               ,TX,77710-0042,Public       ,1256,1831,3087,7159,5675,12834
00358200,LAREDO COMMUNITY COLLEGE                ,TX,78040-4395,Public       ,1254,1319,2573,4892,4108,9000
00358300,LEE COLLEGE                             ,TX,77520-4796,Public       ,434,1022,1456,1370,3062,4432
00358400,LETOURNEAU UNIVERSITY                   ,TX,75607-0000,Private      ,91,802,893,1499,2998,4497
00358500,LON MORRIS COLLEGE                      ,TX,75766-2900,Private      ,160,65,225,742,176,918
00358600,LUBBOCK CHRISTIAN UNIVERSITY            ,TX,79407-2099,Private      ,232,322,554,1279,1137,2416
00358800,UNIVERSITY OF MARY HARDIN-BAYLOR        ,TX,76513-2599,Private      ,199,236,435,3038,1208,4246
00359000,MCLENNAN COMMUNITY COLLEGE              ,TX,76708-1498,Public       ,766,1810,2576,3426,6025,9451
00359100,MCMURRY UNIVERSITY                      ,TX,79697-0001,Private      ,189,176,365,1716,664,2380
00359200,MIDWESTERN STATE UNIVERSITY             ,TX,76308-2099,Public       ,595,686,1281,3819,2656,6475
00359300,NAVARRO COLLEGE                         ,TX,75110-4818,Public       ,1059,1719,2778,3434,4400,7834
00359400,UNIVERSITY OF NORTH TEXAS               ,TX,76203-1370,Public       ,2731,3620,6351,23514,17054,40568
00359500,OBLATE SCHOOL OF THEOLOGY               ,TX,78216-0000,Private      ,0,4,4,4,19,23
00359600,ODESSA COLLEGE                          ,TX,79764-7127,Public       ,471,858,1329,1437,2446,3883
00359800,OUR LADY OF THE LAKE UNIVERSITY         ,TX,78207-4689,Private      ,124,536,660,1826,2448,4274
00359900,UNIVERSITY OF TEXAS - PAN AMERICAN      ,TX,78541-2999,Public       ,1232,1977,3209,13934,8996,22930
00360000,PANOLA COLLEGE                          ,TX,75633-2397,Public       ,214,446,660,744,1228,1972
00360100,PARIS JR COLLEGE                        ,TX,75460-6298,Public       ,544,1039,1583,1655,2709,4364
00360200,PAUL QUINN COLLEGE                      ,TX,75241-4398,Private      ,67,116,183,388,631,1019
00360300,RANGER COLLEGE                          ,TX,76470-3298,Public       ,113,71,184,411,320,731
00360400,RICE UNIVERSITY                         ,TX,77251-1892,Private      ,217,366,583,7823,2055,9878
00360600,SAM HOUSTON STATE UNIVERSITY            ,TX,77340-0000,Public       ,1573,1334,2907,13164,6023,19187
00360700,ALAMO CMTY CLG DISTRICT PROGRAM         ,TX,78207-0000,Public       ,110,200,310,448,625,1073
00360800,ST PHILLIPS COLLEGE                     ,TX,78203-2098,Public       ,1187,2859,4046,4235,8330,12565
00360900,SAN JACINTO CLG-CENTRAL-NORTH-SOUTH     ,TX,77501-0000,Public       ,2139,3355,5494,6402,9096,15498
00361000,SCHREINER UNIVERSITY                    ,TX,78028-5697,Private      ,95,111,206,1301,423,1724
00361100,SOUTH PLAINS COLLEGE                    ,TX,79336-6504,Public       ,1009,1347,2356,4245,4530,8775
00361200,UNIV OF HOUSTON-DOWNTOWN                ,TX,77002-1001,Public       ,995,2213,3208,5819,8969,14788
00361300,SOUTHERN METHODIST UNIVERSITY           ,TX,75275-0181,Private      ,384,816,1200,5790,5037,10827
00361400,SOUTHWEST TEXAS JR COLLEGE              ,TX,78801-6221,Public       ,632,1023,1655,2282,2750,5032
00361500,TEXAS STATE UNIVERSITY--SAN MARCOS      ,TX,78666-4602,Public       ,2081,2148,4229,23171,12499,35670
00361600,SOUTHWESTERN ASSEMBLIES OF GOD UNIV     ,TX,75165-2397,Private      ,313,358,671,1439,1063,2502
00361700,SOUTHWESTERN BAPTIST THEOL SEMINARY     ,TX,76122-0000,Private      ,9,40,49,42,160,202
00361800,SOUTHWESTERN CHRISTIAN COLLEGE          ,TX,75160-3400,Private      ,78,39,117,207,99,306
00361900,SOUTHWESTERN ADVENTIST UNIVERSITY       ,TX,76059-1922,Private      ,163,122,285,621,386,1007
00362000,SOUTHWESTERN UNIVERSITY                 ,TX,78626-6111,Private      ,50,38,88,2123,194,2317
00362100,ST EDWARDS UNIVERSITY                   ,TX,78704-0000,Private      ,191,409,600,4520,2441,6961
00362300,ST MARY'S UNIV OF SAN ANTONIO           ,TX,78228-8500,Private      ,160,397,557,3479,2728,6207
00362400,STEPHEN F AUSTIN STATE UNIVERSITY       ,TX,75962-0001,Public       ,1425,1182,2607,11847,4307,16154
00362500,SUL ROSS STATE UNIVERSITY               ,TX,79832-0113,Public       ,280,606,886,1482,1800,3282
00362600,TARRANT COUNTY COLLEGE                  ,TX,76102-6599,Public       ,3410,6226,9636,12244,19452,31696
00362700,TEMPLE COLLEGE                          ,TX,76504-7435,Public       ,463,1244,1707,1914,3840,5754
00362800,TEXARKANA COLLEGE                       ,TX,75599-0001,Public       ,394,783,1177,1571,2431,4002
00363000,PRAIRIE VIEW A&M UNIVERSITY             ,TX,77446-2967,Public       ,1172,1461,2633,9614,5492,15106
00363100,TARLETON STATE UNIVERSITY               ,TX,76402-0000,Public       ,853,1281,2134,5849,5044,10893
00363200,TEXAS A&M UNIVERSITY                    ,TX,77842-0000,Public       ,3082,1537,4619,33769,7988,41757
00363204,TEXAS A&M UNIVERSITY - GALVESTON        ,TX,77553-1675,Public       ,0,0,0,417,146,563
00363400,TEXAS STATE TECHNICAL CLG AT WACO       ,TX,76705-1695,Public       ,823,1402,2225,2772,3369,6141
00363500,TEXAS CHIROPRACTIC COLLEGE              ,TX,77505-1699,Private      ,2,53,55,11,404,415
00363600,TEXAS CHRISTIAN UNIVERSITY              ,TX,76129-0001,Private      ,417,424,841,8516,2782,11298
00363700,JARVIS CHRISTIAN COLLEGE                ,TX,75765-1470,Private      ,218,97,315,693,262,955
00363800,TEXAS COLLEGE                           ,TX,75702-4500,Private      ,209,200,409,824,623,1447
00363900,TEXAS A&M UNIVERSITY-KINGSVILLE         ,TX,78363-8203,Public       ,621,1116,1737,5848,4834,10682
00364100,TEXAS LUTHERAN UNIVERSITY               ,TX,78155-5999,Private      ,138,60,198,1781,264,2045
00364200,TEXAS SOUTHERN UNIVERSITY               ,TX,77004-4598,Public       ,1445,2452,3897,8895,10466,19361
00364300,TEXAS SOUTHMOST COLLEGE                 ,TX,78520-4992,Public       ,47,78,125,201,309,510
00364400,TEXAS TECH UNIVERSITY                   ,TX,79409-0000,Public       ,2404,1927,4331,20765,9013,29778
00364500,TEXAS WESLEYAN UNIVERSITY               ,TX,76105-1536,Private      ,152,450,602,1138,3543,4681
00364600,TEXAS WOMAN'S UNIVERSITY                ,TX,76204-5587,Public       ,507,1678,2185,5277,9501,14778
00364700,TRINITY UNIVERSITY                      ,TX,78212-7200,Private      ,125,82,207,3273,484,3757
00364800,TYLER JUNIOR COLLEGE                    ,TX,75701-3436,Public       ,1319,1783,3102,6163,5841,12004
00365100,UNIVERSITY OF DALLAS                    ,TX,75062-4799,Private      ,124,325,449,1834,1208,3042
00365200,UNIVERSITY OF HOUSTON                   ,TX,77204-2010,Public       ,2810,4120,6930,25360,21506,46866
00365400,UNIVERSITY OF ST THOMAS                 ,TX,77006-4626,Private      ,129,304,433,1502,1175,2677
00365600,UNIVERSITY OF TEXAS-ARLINGTON           ,TX,76019-0000,Public       ,1464,3252,4716,16529,18056,34585
00365800,UNIVERSITY OF TEXAS-AUSTIN              ,TX,78713-7758,Public       ,1823,1874,3697,38458,18664,57122
00365900,UT HEALTH CENTER-SAN ANTONIO            ,TX,78229-3900,Public       ,68,326,394,574,2954,3528
00366100,UNIVERSITY OF TEXAS-EL PASO             ,TX,79968-0629,Public       ,1354,2256,3610,11628,10224,21852
00366200,VICTORIA COLLEGE (THE)                  ,TX,77901-4494,Public       ,347,683,1030,1234,2199,3433
00366300,WAYLAND BAPTIST UNIVERSITY              ,TX,79072-6998,Private      ,191,922,1113,976,2863,3839
00366400,WEATHERFORD COLLEGE                     ,TX,76086-5699,Public       ,383,740,1123,1871,2385,4256
00366500,WEST TEXAS A&M UNIVERSITY               ,TX,79016-0000,Public       ,664,918,1582,4823,3366,8189
00366800,WHARTON COUNTY JR COLLEGE               ,TX,77488-3298,Public       ,600,848,1448,2072,2288,4360
00366900,WILEY COLLEGE                           ,TX,75670-5199,Private      ,240,272,512,931,748,1679
00400300,CENTRAL TEXAS COLLEGE                   ,TX,76540-4199,Public       ,593,3317,3910,2088,9407,11495
00407221,NORTHWOOD UNIVERSITY                    ,TX,75104-0000,Private      ,86,231,317,586,739,1325
00445300,EL CENTRO COLLEGE                       ,TX,75202-0000,Public       ,826,2531,3357,2797,6874,9671
00481102,EVEREST INSTITUTE - EVEREST COLLEGE     ,TX,76011-6750,Proprietary  ,104,352,456,203,800,1003
00494800,TEXAS A&M UNIV SYSTEM HEALTH SCI CT     ,TX,77840-7896,Public       ,48,122,170,514,1587,2101
00494900,BAYLOR COLLEGE OF MEDICINE              ,TX,77030-0000,Private      ,12,89,101,213,1310,1523
00495100,UNIV OF TEXAS HEALTH SCIENCE CENTER     ,TX,77225-0000,Public       ,46,355,401,369,2785,3154
00495200,UNIV OF TEXAS MEDICAL BRANCH            ,TX,77550-0000,Public       ,29,302,331,184,2074,2258
00497200,GALVESTON COLLEGE                       ,TX,77550-7447,Public       ,351,469,820,751,1191,1942
00497700,SOUTH TEXAS COLLEGE OF LAW              ,TX,77002-0000,Private      ,5,100,105,33,2056,2089
00520307,REMINGTON COLLEGE - DALLAS CAMPUS       ,TX,75041-9935,Proprietary  ,19,92,111,83,225,308
00660600,BAPTIST HS SCHOOL OF HEALTH PROFESSIONS ,TX,78229-3234,Proprietary  ,32,194,226,141,772,913
00661200,COVENANT SCH OF NSG & ALLIED HEALTH     ,TX,79410-0000,Private      ,15,59,74,120,324,444
00666100,ANGELINA COLLEGE                        ,TX,75902-0000,Public       ,530,1146,1676,1881,2962,4843
00694100,DALLAS CHRISTIAN COLLEGE                ,TX,75234-7229,Private      ,44,110,154,218,316,534
00709600,COLLEGE OF THE MAINLAND                 ,TX,77591-2499,Public       ,339,829,1168,869,2081,2950
00728700,BRAZOSPORT COLLEGE                      ,TX,77566-3199,Public       ,346,484,830,983,1321,2304
00732907,ITT TECHNICAL INSTITUTE                 ,TX,77063-3751,Proprietary  ,32,138,170,136,362,498
00754805,WESTWOOD COLLEGE OF TECHNOLOGY          ,TX,77074-0000,Proprietary  ,123,249,372,412,640,1052
00758602,REMINGTON COLLEGE - FORT WORTH CAMPUS   ,TX,76112-1280,Proprietary  ,110,344,454,282,853,1135
00835300,LINCOLN COLLEGE OF TECHNOLOGY           ,TX,75052-0000,Proprietary  ,410,393,803,994,1102,2096
00849800,MIMS CLASSIC BEAUTY COLLEGE             ,TX,78216-0000,Proprietary  ,7,21,28,23,53,76
00850300,MOUNTAIN VIEW COLLEGE                   ,TX,75211-6599,Public       ,812,1621,2433,2571,4475,7046
00850400,RICHLAND COLLEGE                        ,TX,75243-2199,Public       ,1108,1998,3106,3597,5451,9048
00851000,EASTFIELD COLLEGE                       ,TX,75150-2099,Public       ,945,1878,2823,2967,5182,8149
00907905,EVEREST COLLEGE                         ,TX,75206-5209,Proprietary  ,147,572,719,351,1415,1766
00908200,INTERNATIONAL BUSINESS COLLEGE          ,TX,79903-0000,Proprietary  ,53,245,298,116,411,527
00916300,SAN ANTONIO COLLEGE                     ,TX,78212-4299,Public       ,2501,4741,7242,10180,15376,25556
00922500,TEXAS STATE TECHNICAL COLLEGE  HARLINGEN,TX,78550-3697,Public       ,743,1289,2032,2963,3249,6212
00946600,KAPLAN CAREER INSTITUTE                 ,TX,78216-1899,Proprietary  ,91,395,486,279,1243,1522
00946607,SAN ANT COL OF MED & DENTAL - MCALLEN   ,TX,78503-1622,Proprietary  ,122,353,475,365,965,1330
00946609,CAREER CENTERS OF TX - CORPUS CHRISTI   ,TX,78416-9900,Proprietary  ,58,293,351,154,911,1065
00946610,KAPLAN CAREER INSTITUTE - CAREER CENTERS,TX,76103-2310,Proprietary  ,81,330,411,149,736,885
00954900,WESTERN TEXAS COLLEGE                   ,TX,79549-9501,Public       ,145,146,291,606,384,990
00965100,TEXAS A&M INTERNATIONAL UNIVERSITY      ,TX,78041-1900,Public       ,458,761,1219,4107,2946,7053
00974100,UNIVERSITY OF TEXAS AT DALLAS           ,TX,75083-0000,Public       ,770,1817,2587,7081,7761,14842
00976800,UNIVERSITY OF NORTH TEXAS HEALTH SCIENCE,TX,76107-2699,Public       ,18,118,136,122,1490,1612
00979700,MIDLAND COLLEGE                         ,TX,79705-6397,Public       ,410,752,1162,1495,2235,3730
00982802,EVEREST INSTITUTE- AUSTIN               ,TX,78754-0000,Proprietary  ,141,583,724,267,1217,1484
00993000,UNIVERSITY OF TEXAS-PERMIAN BASIN       ,TX,79762-0001,Public       ,347,668,1015,1578,1995,3573
00993200,TEXAS STATE TECH CLG-WEST TEXAS         ,TX,79556-4108,Public       ,137,304,441,568,822,1390
00993201,TEXAS STATE TECH COLLEGE-ABILENE        ,TX,79601-0000,Public       ,48,128,176,168,376,544
00993204,TEXAS STATE TECH CLG-BRECKENRIDGE       ,TX,76424-0000,Public       ,9,56,65,34,160,194
00993205,TEXAS STATE TECH COLLEGE-BROWNWOOD      ,TX,76801-0000,Public       ,31,118,149,96,314,410
01001900,UNIV OF TEXAS SOUTHWESTERN MED CTR      ,TX,75390-9096,Public       ,22,163,185,165,1710,1875
01005700,AMERICAN COMMERCIAL COLLEGE             ,TX,79602-1399,Proprietary  ,27,196,223,43,320,363
01005900,AMERICAN COMMERCIAL COLLEGE             ,TX,79761-0000,Proprietary  ,18,100,118,30,202,232
01005901,AMERICAN COMMERCIAL COLLEGE - AMERICAN C,TX,76310-2303,Proprietary  ,12,137,149,29,277,306
01006000,VERNON COLLEGE                          ,TX,76384-4092,Public       ,231,589,820,979,2086,3065
01011500,UNIVERSITY OF TEXAS-SAN ANTONIO         ,TX,78249-0600,Public       ,2172,2725,4897,23886,14618,38504
01013000,WADE COLLEGE                            ,TX,75207-3199,Proprietary  ,45,40,85,178,173,351
01038700,EL PASO COMMUNITY COLLEGE               ,TX,79998-0000,Public       ,2677,3602,6279,11915,12610,24525
01050900,HALLMARK COLLEGE OF AERONAUTICS         ,TX,78214-0000,Proprietary  ,126,394,520,254,928,1182
01062400,CENTRAL TEXAS COMMERCIAL COLLEGE        ,TX,75231-5033,Proprietary  ,12,69,81,25,106,131
01063300,HOUSTON COMMUNITY COLLEGE               ,TX,77002-0000,Public       ,4769,10510,15279,15403,30543,45946
01067400,TEXAS TECH U HEALTH SCIENCES CENTER     ,TX,79430-0000,Public       ,73,412,485,650,2878,3528
01076100,DALLAS INSTITUTE OF FUNERAL SERVICE     ,TX,75227-4314,Private      ,14,90,104,50,207,257
01114500,LONE STAR COLLEGE SYSTEM                ,TX,77073-3499,Public       ,1443,3104,4547,5071,9007,14078
01114501,LONE STAR COLLEGE-KINGWOOD              ,TX,77339-0000,Public       ,527,936,1463,1472,2730,4202
01114502,LONE STAR COLLEGE-TOMBALL               ,TX,77375-0000,Public       ,383,653,1036,1153,1955,3108
01114503,LONE STAR COLLEGE-MONTGOMERY            ,TX,77384-0000,Public       ,586,1103,1689,1765,3281,5046
01114504,LONE STAR COLLEGE-CY-FAIR               ,TX,77433-1383,Public       ,652,859,1511,2320,3089,5409
01116100,TEXAS A&M UNIV CORPUS CHRISTI           ,TX,78412-5599,Public       ,713,1016,1729,7423,4323,11746
01116300,UNIVERSITY OF TEXAS AT TYLER            ,TX,75799-6699,Public       ,549,958,1507,3768,3652,7420
01171100,UNIVERSITY OF HOUSTON-CLEAR LAKE        ,TX,77058-1002,Public       ,316,1435,1751,1563,5691,7254
01201500,AUSTIN COMMUNITY COLLEGE                ,TX,78752-4390,Public       ,2460,5204,7664,11594,18748,30342
01202000,VICTORIA BEAUTY COLLEGE                 ,TX,77901-6233,Proprietary  ,23,53,76,44,87,131
01226800,BALDWIN BEAUTY SCHOOL #5                ,TX,78704-4785,Proprietary  ,32,95,127,87,211,298
01229700,LAREDO BEAUTY COLLEGE                   ,TX,78040-1051,Proprietary  ,17,108,125,63,225,288
01248200,ATI TECHNICAL TRAINING CENTER           ,TX,75235-4622,Proprietary  ,368,1232,1600,671,2718,3389
01248209,ATI CAREER TRAINING CENTER - GARLAND    ,TX,75041-2497,Proprietary  ,4,27,31,14,64,78
01248210,ATI CAREER TRAINING CENTER - WACO       ,TX,76711-1682,Proprietary  ,8,44,52,11,49,60
01248300,COSMETOLOGY CAREER CENTER               ,TX,75006-2566,Proprietary  ,94,147,241,181,261,442
01248800,INTERNATIONAL BEAUTY COLLEGE NO 3       ,TX,75040-0000,Proprietary  ,5,19,24,19,58,77
01276400,METROPLEX BEAUTY SCHOOL                 ,TX,75149-0000,Proprietary  ,10,48,58,24,98,122
01293000,CHARLES & SUE'S SCH OF HAIR DESIGN      ,TX,77801-0000,Proprietary  ,18,28,46,41,57,98
01293200,TINT SCHOOL OF MAKEUP & COSMETOLOGY     ,TX,75061-4235,Proprietary  ,7,25,32,15,58,73
01300300,NEILSON BEAUTY COLLEGE                  ,TX,75208-4637,Proprietary  ,9,38,47,22,89,111
01301600,OGLE SCHOOL HAIR SKIN NAILS             ,TX,76013-7400,Proprietary  ,61,105,166,120,226,346
01323100,UNIVERSITY OF HOUSTON-VICTORIA          ,TX,77901-5731,Public       ,98,728,826,411,2458,2869
02058600,CONLEE'S COLLEGE OF COSMETOLOGY         ,TX,78028-0000,Proprietary  ,3,14,17,10,36,46
02069302,VATTEROTT COLLEGE - VATTEROTT EDUCATION ,TX,75220-5441,Proprietary  ,38,121,159,83,344,427
02074100,CAPITOL CITY TRADE & TECHNICAL SCH      ,TX,78704-0000,Proprietary  ,104,256,360,249,544,793
02077400,NORTH LAKE COLLEGE                      ,TX,75038-0000,Public       ,600,1216,1816,2000,3342,5342
02078100,STEPHENVILLE BEAUTY COLLEGE             ,TX,76401-0000,Proprietary  ,3,7,10,9,24,33
02081400,ARLINGTON BAPTIST COLLEGE               ,TX,76012-0000,Private      ,30,50,80,89,144,233
02093600,SOUTHWEST SCHOOL OF ELECTRONIC          ,TX,78735-0000,Proprietary  ,3,12,15,22,35,57
02098300,WESTERN TECHNICAL COLLEGE               ,TX,79927-2105,Proprietary  ,414,563,977,798,1014,1812
02100200,BROOKHAVEN COLLEGE                      ,TX,75244-0000,Public       ,596,1422,2018,1909,4035,5944
02113610,AMERICAN INTERCONTINENTAL UNIV - HOUSTON,TX,77042-4516,Proprietary  ,46,209,255,149,652,801
02116008,SANFORD-BROWN COLLEGE - HOUSTON         ,TX,77036-8507,Proprietary  ,176,536,712,378,1230,1608
02116012,SANFORD-BROWN INSTITUTE - HOUSTON NORTH ,TX,77008-1058,Proprietary  ,46,211,257,115,516,631
02117100,ART INSTITUTE OF HOUSTON                ,TX,77056-0000,Proprietary  ,590,677,1267,2686,2360,5046
02119200,COURT REPORTING INSTITUTE OF DALLAS     ,TX,75247-6913,Proprietary  ,36,219,255,92,740,832
02119202,COURT REPORTING INSTIUTE OF HOUSTON     ,TX,77040-6315,Proprietary  ,29,115,144,64,474,538
02128302,INSTITUTE FOR BUSINESS & TECHNOLOGY - LA,TX,78230-2520,Proprietary  ,24,141,165,75,300,375
02136800,AMERICAN COMMERCIAL COLLEGE             ,TX,76904-0000,Proprietary  ,12,90,102,39,198,237
02144800,VET TECH INSTITUTE OF HOUSTON           ,TX,77027-9881,Proprietary  ,73,66,139,165,182,347
02176100,PIPO ACADEMY OF HAIR DESIGN             ,TX,79903-0000,Proprietary  ,6,23,29,22,54,76
02200800,AMERICAN COMMERCIAL COLLEGE             ,TX,79411-0000,Proprietary  ,12,141,153,28,254,282
02218300,SOUTHWEST SCHOOL OF BUSINESS & TECHNICAL,TX,78221-0000,Proprietary  ,79,271,350,116,472,588
02218305,SOUTHWEST SCHOOL OF BUSINESS AND TECHNIC,TX,78501-6053,Proprietary  ,27,98,125,47,184,231
02218306,SOUTHWEST SCHOOL OF BUSINESS AND TECHNIC,TX,78413-2045,Proprietary  ,13,69,82,27,125,152
02224600,TRI-STATE BEAUTY SCHOOL #1              ,TX,79915-0000,Proprietary  ,41,133,174,100,294,394
02230500,OGLE SCHOOL HAIR SKIN NAILS             ,TX,76132-3638,Proprietary  ,113,221,334,215,447,662
02230600,OGLE SCHOOL HAIR SKIN NAILS             ,TX,76053-4650,Proprietary  ,48,62,110,72,138,210
02239100,CENTRAL TEXAS BEAUTY COLLEGE #2         ,TX,78664-4204,Proprietary  ,19,116,135,30,174,204
02248200,MILAN INSTITUTE OF COSMETOLOGY          ,TX,79103-0000,Proprietary  ,214,549,763,502,1295,1797
02254800,TEXAS VOCATIONAL SCHOOLS                ,TX,77901-0000,Proprietary  ,22,46,68,42,104,146
02259400,AMBERTON UNIVERSITY                     ,TX,75041-0000,Private      ,1,90,91,18,235,253
02261300,EVEREST INSTITUTE                       ,TX,78213-3841,Proprietary  ,87,536,623,196,1174,1370
02261302,EVEREST INSTITUTE - HOUSTON GREENSPOINT ,TX,77060-3249,Proprietary  ,113,526,639,218,1056,1274
02261303,EVEREST INSTITUTE - HOUSTON HOBBY       ,TX,77087-2737,Proprietary  ,93,445,538,195,920,1115
02267100,EXPOSITO SCHOOL OF HAIR DESIGN          ,TX,79109-0000,Proprietary  ,7,28,35,22,75,97
02276000,FRANKLIN BEAUTY SCHOOL #2               ,TX,77021-0000,Proprietary  ,12,65,77,30,112,142
02285900,UNIVERSITY OF COSMETOLOGY ARTS&SCI      ,TX,78504-0000,Proprietary  ,81,258,339,162,461,623
02294800,CAPITOL CITY CAREERS                    ,TX,78745-0000,Proprietary  ,12,56,68,34,115,149
02298501,EVEREST COLLEGE- FORT WORTH             ,TX,76137-2472,Proprietary  ,94,462,556,174,800,974
02305300,PARKER COLLEGE OF CHIROPRACTIC          ,TX,75229-0000,Private      ,13,114,127,60,1169,1229
02306700,FORT WORTH BEAUTY SCHOOL                ,TX,76116-3299,Proprietary  ,17,72,89,36,152,188
02312200,TEXAS SCHOOL OF BUSINESS                ,TX,77073-6032,Proprietary  ,105,244,349,227,670,897
02312201,TEXAS SCHOOL OF BUSINESS - SOUTHWEST CAM,TX,77057-0000,Proprietary  ,49,213,262,148,534,682
02312202,TEXAS SCHOOL OF BUSINESS - FRIENDSWOOD C,TX,77546-8938,Proprietary  ,36,185,221,74,485,559
02312203,TEXAS SCHOOL OF BUSINESS - EAST CAMPUS  ,TX,77029-1916,Proprietary  ,52,137,189,148,496,644
02313901,WESTWOOD COLLEGE - DALLAS               ,TX,75243-0000,Proprietary  ,94,293,387,478,1012,1490
02315400,NORTHEAST TEXAS COMMUNITY COLLEGE       ,TX,75456-0000,Public       ,364,716,1080,1129,1621,2750
02318200,"KD STUDIO, ACTOR'S CONSERVATORY         ",TX,75207-2111,Proprietary  ,43,53,96,141,162,303
02320200,HOUSTON GRADUATE SCHOOL OF THEOLOGY     ,TX,77004-0000,Private      ,0,29,29,2,145,147
02326000,SAN ANTONIO BEAUTY COLLEGE NO 3         ,TX,78217-0000,Proprietary  ,14,30,44,31,79,110
02328600,ITT TECHNICAL INSTITUTE                 ,TX,76011-0000,Proprietary  ,174,467,641,388,1003,1391
02331200,BAPTIST MISSIONARY ASSN THEOL SEM       ,TX,75766-0000,Private      ,2,13,15,6,27,33
02331300,INTERACTIVE LEARNING SYSTEMS            ,TX,77502-1201,Proprietary  ,3,27,30,4,37,41
02331301,INTERACTIVE LEARNING SYSTEMS            ,TX,77081-0000,Proprietary  ,29,154,183,53,323,376
02331303,INTERACTIVE LEARNING SYSTEMS            ,TX,77502-0000,Proprietary  ,12,90,102,20,146,166
02331304,INTERACTIVE LEARNING SYSTEMS            ,TX,77060-0000,Proprietary  ,16,185,201,24,263,287
02341300,PALO ALTO COLLEGE                       ,TX,78224-0000,Public       ,904,1709,2613,4016,5406,9422
02348500,LAMAR STATE COLLEGE-PORT ARTHUR         ,TX,77640-0000,Public       ,257,451,708,782,1233,2015
02357700,ACADEMY OF HAIR DESIGN                  ,TX,77090-0000,Proprietary  ,64,116,180,115,191,306
02358200,LAMAR STATE COLLEGE-ORANGE              ,TX,77630-0000,Public       ,257,611,868,627,1506,2133
02361400,COLLIN COUNTY COMMUNITY COLLEGE         ,TX,75071-0000,Public       ,1451,2355,3806,4876,6837,11713
02362000,UNIVERSAL TECHNICAL INSTITUTE           ,TX,77073-0000,Proprietary  ,659,599,1258,4559,2460,7019
02362800,AUSTIN GRADUATE SCHOOL OF THEOLOGY      ,TX,78752-1333,Private      ,3,16,19,9,51,60
02521200,ARLINGTON CAREER INSTITUTE              ,TX,75050-0000,Proprietary  ,27,136,163,54,386,440
02521800,SEGUIN BEAUTY SCHOOL                    ,TX,78155-0000,Proprietary  ,18,37,55,37,89,126
02521801,SEGUIN BEAUTY SCHOOL-NEW BRAUNFELS      ,TX,78130-7937,Proprietary  ,1,4,5,3,6,9
02527500,HOUSTON TRAINING SCHOOLS                ,TX,77020-0000,Proprietary  ,74,510,584,90,607,697
02530700,SEBRING CAREER SCHOOLS                  ,TX,77083-1510,Proprietary  ,14,57,71,17,73,90
02539600,ART INSTITUTE OF DALLAS                 ,TX,75231-5993,Proprietary  ,325,405,730,2013,1702,3715
02548800,SOUTH TEXAS VO-TECH INSTITUTE           ,TX,78596-0000,Proprietary  ,200,414,614,474,1164,1638
02548802,SOUTH TEXAS VOCATIONAL TECHNICAL INSTITU,TX,78520-8710,Proprietary  ,1,12,13,25,35,60
02549400,SOUTH TEXAS VO-TECH INSTITUTE           ,TX,78501-0000,Proprietary  ,285,661,946,685,1625,2310
02549402,SOUTH TEXAS VOCATIONAL TECHNICAL INSTITU,TX,78416-1141,Proprietary  ,5,11,16,25,35,60
02555400,UNIV OF TX MD ANDERSON CANCER CTR       ,TX,77030-0000,Public       ,12,47,59,75,225,300
02567200,OFFICE CAREER CENTER                    ,TX,76180-0000,Proprietary  ,0,0,0,0,2,2
02568100,TEXAS BARBER COLLEGES & HAIRSTYLING     ,TX,75208-0000,Proprietary  ,146,419,565,286,1013,1299
02569300,TEXAS CULINARY ACADEMY                  ,TX,78758-3403,Proprietary  ,472,1563,2035,1568,4503,6071
02572000,COMPUTER CAREER CENTER                  ,TX,79925-2021,Proprietary  ,56,266,322,118,498,616
02572004,COMPUTER CAREER CENTER - AMARILLO CAMPUS,TX,79101-2404,Proprietary  ,13,70,83,30,185,215
02572005,COMPUTER CAREER CENTER - LUBBOCK CAMPUS ,TX,79414-3517,Proprietary  ,8,70,78,13,129,142
02572100,"CAREER ACADEMY, INC.                    ",TX,75501-0000,Proprietary  ,0,0,0,0,2,2
02580100,IVERSON BUSINESS SCH & COURT REPORT     ,TX,76011-1344,Proprietary  ,44,176,220,90,411,501
02591100,CAREER POINT INSTITUTE                  ,TX,78201-2027,Proprietary  ,141,834,975,318,1932,2250
02591900,CAREER CENTERS OF TEXAS - EL PASO       ,TX,79907-1525,Proprietary  ,137,451,588,425,1204,1629
02591905,CAREER CENTERS OF TEXAS-BROWNSVILLE     ,TX,78521-9905,Proprietary  ,70,192,262,229,551,780
02596400,REDSTONE COLLEGE - LOS ANGELES          ,TX,77061-0000,Proprietary  ,54,82,136,203,287,490
02596500,ATI CAREER TRAINING CENTER              ,TX,76180-1599,Proprietary  ,292,880,1172,708,2297,3005
02596600,ATI-CAREER TRAINING CENTER              ,TX,75220-4443,Proprietary  ,278,906,1184,621,2331,2952
02596601,ATI CAREER TRAINING CENTER - RICHARDSON ,TX,75081-6745,Proprietary  ,4,33,37,19,97,116
02596602,ATI CAREER TRAINING CENTER - DALLAS (STE,TX,75247-6103,Proprietary  ,18,85,103,63,222,285
02600200,OCEAN CORPORATION (THE)                 ,TX,77099-3479,Proprietary  ,44,250,294,114,572,686
02604700,CENTER FOR ADVANCED LEGAL STUDIES       ,TX,77098-4151,Proprietary  ,9,112,121,18,224,242
02606202,EVEREST COLLEGE - EVEREST INSTITUTE - BI,TX,77036-8014,Proprietary  ,133,463,596,269,961,1230
02615000,SANFORD-BROWN INSTITUTE                 ,TX,75247-6931,Proprietary  ,255,734,989,556,2066,2622
03009400,SW SCH BUS & TECH CAREERS               ,TX,78212-2840,Proprietary  ,10,32,42,19,48,67
03010604,VIRGINIA COLLEGE - VIRGINIA COLLEGE AT A,TX,78723-0000,Proprietary  ,73,290,363,232,1093,1325
03011800,UNIVERSITY OF COSMETOLOGY ARTS & SCIENCE,TX,78226-1160,Proprietary  ,8,24,32,26,77,103
03019800,PCI HEALTH TRAINING CENTER              ,TX,75247-4720,Proprietary  ,159,302,461,310,704,1014
03021500,SW SCH BUS & TECH CAREERS               ,TX,78852-4859,Proprietary  ,11,39,50,48,88,136
03025000,TEXAS COLLEGE OF COSMETOLOGY            ,TX,79605-2001,Proprietary  ,19,78,97,58,189,247
03026500,REMINGTON COLLEGE - HOUSTON CAMPUS      ,TX,77082-1849,Proprietary  ,281,654,935,627,1621,2248
03026501,REMINGTON COLLEGE - NORTH HOUSTON CAMPUS,TX,77067-1849,Proprietary  ,30,75,105,78,211,289
03028800,CIRCLE J BEAUTY SCHOOL                  ,TX,77587-3714,Proprietary  ,15,46,61,40,136,176
03031408,INTERNATIONAL ACADEMY OF DESIGN AND TECH,TX,78229-2263,Proprietary  ,110,134,244,277,428,705
03032300,SCHOOL OF AUTOMOTIVE MACHINISTS         ,TX,77055-1803,Proprietary  ,27,40,67,78,115,193
03035200,TINT SCHOOL OF MAKEUP & COSMETOLOGY     ,TX,75229-3734,Proprietary  ,12,56,68,35,146,181
03035300,SOUTHERN CAREERS INSTITUTE              ,TX,78704-5252,Proprietary  ,181,570,751,394,1463,1857
03035301,SOUTHERN CAREERS INSTITUTE              ,TX,78577-0000,Proprietary  ,93,245,338,205,598,803
03035302,SOUTHERN CAREERS INSTITUTE - CORPUS CHRI,TX,78414-2904,Proprietary  ,41,124,165,94,341,435
03035303,SOUTHERN CAREERS INSTITUTE - #1         ,TX,78221-4351,Proprietary  ,73,285,358,172,724,896
03035305,SOUTHERN CAREERS INSTITUTE - BROWNSVILLE,TX,78520-8680,Proprietary  ,0,4,4,2,9,11
03035306,SOUTHERN CAREERS INSTITUTE - HARLINGEN  ,TX,78550-7911,Proprietary  ,4,10,14,11,29,40
03035307,SOUTHERN CAREERS INSTITUTE - CORPUS CHRI,TX,78410-1609,Proprietary  ,5,12,17,10,16,26
03061800,STAR COLLEGE OF COSMETOLOGY             ,TX,75702-8214,Proprietary  ,19,51,70,49,121,170
03064600,UNIVERSITY OF TEXAS AT BROWNSVILLE      ,TX,78520-4993,Public       ,938,1762,2700,6987,7293,14280
03071400,ITT TECHNICAL INSTITUTE                 ,TX,78249-3303,Proprietary  ,88,273,361,275,687,962
03075400,ICC TECHNICAL INSTITUTE                 ,TX,77004-2930,Private      ,11,51,62,29,83,112
03076403,HIGH-TECH INSTITUTE - DALLAS            ,TX,75038-4201,Proprietary  ,15,27,42,39,102,141
03079201,WESTWOOD COLLEGE OF TECHNOLOGY          ,TX,76180-0000,Proprietary  ,61,128,189,214,503,717
03103400,SOUTH TEXAS COLLEGE                     ,TX,78501-6699,Public       ,2605,4212,6817,10624,11509,22133
03104700,TEXAS COLLEGE OF COSMETOLOGY            ,TX,76903-4708,Proprietary  ,13,61,74,34,153,187
03108700,ROYAL BEAUTY CAREERS                    ,TX,77069-4611,Proprietary  ,33,107,140,99,318,417
03111000,MID-CITIES BARBER COLLEGE               ,TX,75051-4810,Proprietary  ,20,43,63,32,87,119
03115800,TEXAS CAREERS                           ,TX,78238-4203,Proprietary  ,51,314,365,174,1199,1373
03115802,TEXAS CAREERS - LAREDO                  ,TX,78041-6181,Proprietary  ,63,146,209,146,397,543
03115803,TEXAS CAREERS - BEAUMONT                ,TX,77701-3706,Proprietary  ,60,207,267,151,536,687
03115804,TEXAS CAREERS - LUBBOCK                 ,TX,79401-2601,Proprietary  ,63,205,268,147,595,742
03128100,ACADEMY OF HEALTH CARE PROFESSIONS      ,TX,77092-8108,Proprietary  ,193,461,654,282,814,1096
03144300,NATIONAL BEAUTY COLLEGE                 ,TX,75043-4046,Proprietary  ,4,19,23,12,30,42
03153300,AMER COLL OF ACUPUNCTURE & O.M.         ,TX,77063-4104,Proprietary  ,3,31,34,3,86,89
03156400,ACADEMY OF ORIENTAL MEDICINE AT AUSTIN  ,TX,78757-1132,Proprietary  ,0,46,46,3,217,220
03159300,ARLINGTON MEDICAL INSTITUTE             ,TX,76011-2645,Proprietary  ,8,67,75,42,187,229
03170300,TEXAS A&M UNIVERSITY-TEXARKANA          ,TX,75501-0000,Public       ,78,372,450,344,1167,1511
03179500,TEXAS COLG TRADITIONAL CHINESE MED      ,TX,78704-6748,Proprietary  ,0,44,44,2,120,122
03189400,COLLEGE OF SAINT THOMAS MORE            ,TX,76109-2323,Private      ,5,2,7,23,17,40
03237400,FARIS COMPUTER SCHOOL                   ,TX,77627-3829,Proprietary  ,1,9,10,2,16,18
03272300,KAPLAN COLLEGE                          ,TX,75234-7288,Proprietary  ,38,146,184,76,395,471
03272301,KAPLAN COLLEGE - MIDLAND                ,TX,79703-5531,Proprietary  ,41,221,262,104,595,699
03275300,TOUCH OF CLASS SCHOOL OF COSM           ,TX,75402-6314,Proprietary  ,14,43,57,28,88,116
03276300,ACADEMY OF HAIR DESIGN                  ,TX,75901-4900,Proprietary  ,28,69,97,36,119,155
03277300,ACADEMY OF HAIR DESIGN                  ,TX,77701-4650,Proprietary  ,22,58,80,31,77,108
03303300,NORTHWEST EDUCATIONAL CENTER            ,TX,77092-7055,Proprietary  ,19,145,164,38,269,307
03371300,TONI&GUY HAIRDRESSING ACADEMY           ,TX,75006-2351,Proprietary  ,37,37,74,99,126,225
03372300,NORTHWEST VISTA COLLEGE                 ,TX,78251-4217,Public       ,1505,2069,3574,6328,6612,12940
03396500,TEXAS STATE TECHNICAL COLG/MARSHALL     ,TX,75672-7402,Public       ,123,240,363,383,521,904
03400300,CAREER QUEST                            ,TX,78229-3539,Proprietary  ,20,292,312,46,569,615
03412300,ADVANCED BARBER COLLEGE & HAIR DESI     ,TX,78596-0000,Proprietary  ,16,75,91,27,100,127
03416500,DALLAS NURSING INSTITUTE                ,TX,75243-5502,Proprietary  ,42,352,394,147,1251,1398
03422300,MILAN INSTITUTE                         ,TX,78238-3327,Proprietary  ,136,350,486,370,789,1159
03422400,COLLEGE OF BIBLICAL STUDIES-HOUSTON     ,TX,77036-3211,Private      ,10,140,150,48,473,521
03424400,MEDVANCE INSTITUTE                      ,TX,77057-7386,Proprietary  ,116,401,517,205,874,1079
03424401,MEDVANCE INSTITUTE -                    ,TX,77060-3551,Proprietary  ,8,40,48,18,94,112
03426300,CAREER ADVANCEMENT CENTER               ,TX,78752-1470,Proprietary  ,21,87,108,35,201,236
03480304,MEDVANCE INSTITUTE OF BATON ROUGE - GRAN,TX,75050-2342,Proprietary  ,58,186,244,105,414,519
03509400,CORYELL COSMETOLOGY COLLEGE             ,TX,76528-2036,Proprietary  ,4,8,12,5,15,20
03520300,LUBBOCK HAIR ACADEMY                    ,TX,79410-3524,Proprietary  ,7,44,51,21,78,99
03542300,CONCORDE CAREER INSTITUTE               ,TX,76011-4016,Proprietary  ,98,408,506,235,1134,1369
03551400,STATE BEAUTY ACADEMY                    ,TX,75116-3501,Proprietary  ,5,27,32,8,50,58
03556400,KUSSAD INSTITUTE OF COURT REPORTING     ,TX,78704-5712,Proprietary  ,2,7,9,3,29,32
03563300,ACADEMY OF COSEMTOLOGY                  ,TX,78745-2858,Proprietary  ,0,0,0,9,10,19
03573300,AVIATION INSTITUTE OF MAINTENANCE       ,TX,75209-3017,Proprietary  ,48,188,236,152,694,846
03610300,MJ'S BEAUTY ACADEMY INC                 ,TX,75224-4409,Proprietary  ,13,34,47,20,45,65
03612400,VALLEY GRANDE INSTITUTE FOR ACADEMI     ,TX,78596-0000,Private      ,62,213,275,119,458,577
03627300,LAMAR INSTITUTE OF TECHNOLOGY           ,TX,77705-4142,Public       ,460,683,1143,1408,1988,3396
03676400,HEALTHY HAIR ACADEMY                    ,TX,75227-0000,Proprietary  ,42,119,161,61,176,237
03680300,JAY'S TECHNICAL INSTITUTE               ,TX,77031-3509,Proprietary  ,16,66,82,31,178,209
03682400,DALLAS BARBER & STYLIST COLLEGE         ,TX,75231-0000,Proprietary  ,27,122,149,59,227,286
03714300,TREND BARBER COLLEGE                    ,TX,77071-2104,Proprietary  ,38,165,203,69,319,388
03723300,CULINARY INST ALAIN & MARIE LENOTRE     ,TX,77022-4322,Proprietary  ,50,120,170,113,235,348
03727600,CULINARY ACADEMY OF AUSTIN              ,TX,78752-0000,Proprietary  ,9,38,47,92,117,209
03733300,BAPTIST UNIVERSITY OF THE AMERICAS      ,TX,78224-1336,Private      ,15,53,68,50,174,224
03756300,ANAMARC EDUCATIONAL INSTITUTE           ,TX,79930-6230,Proprietary  ,49,376,425,93,678,771
03885400,COMPUTER LABS                           ,TX,79906-5924,Proprietary  ,0,0,0,2,1,3
03885700,HOUSTON'S TRAINING AND EDUCATION CENTER ,TX,77036-2021,Proprietary  ,6,92,98,12,123,135
03922300,SOUTH TEXAS BARBER COLLEGE              ,TX,78415-3463,Proprietary  ,10,20,30,20,38,58
03944400,PROFESSIONAL CAREERS INSTITUTE          ,TX,77036-2252,Proprietary  ,21,106,127,25,139,164
03970300,HANDS ON THERAPY                        ,TX,75149-2294,Proprietary  ,11,41,52,28,124,152
03987300,TEXAS HEALTH SCHOOL                     ,TX,77079-2106,Proprietary  ,19,86,105,47,164,211
04036300,SOUTHEAST TEXAS CAREER INSTITUTE        ,TX,77656-8601,Proprietary  ,18,51,69,28,82,110
04045300,NORTHWEST BEAUTY SCHOOL                 ,TX,77091-1208,Proprietary  ,6,30,36,15,64,79
04045400,MAI-TRIX BEAUTY COLLEGE                 ,TX,77040-0000,Proprietary  ,5,29,34,20,68,88
04082300,PROFESSIONAL CAREER TRAINING INSTITUTE  ,TX,77090-0000,Proprietary  ,1,6,7,1,6,7
04089400,CCI TRAINING CENTER                     ,TX,76011-4857,Proprietary  ,14,125,139,26,241,267
04117900,CHAMPION BEAUTY COLLEGE                 ,TX,77069-4611,Proprietary  ,11,54,65,29,118,147
04125400,ACADEMY AT AUSTIN (THE)                 ,TX,78660-3287,Proprietary  ,37,76,113,74,153,227
04125500,MANUEL AND THERESA'S SCHOOL OF HAIR DESI,TX,77803-3236,Proprietary  ,6,10,16,9,20,29
04129800,MEDIATECH INSTITUTE DALLAS              ,TX,75039-3105,Proprietary  ,52,68,120,139,196,335
04129801,MEDIATECH INSTITUTE AUSTIN              ,TX,78704-8933,Proprietary  ,24,28,52,86,91,177
04129802,MEDIATECH INSTITUTE HOUSTON             ,TX,77042-4712,Proprietary  ,28,43,71,87,136,223
04131700,SOUTHWEST CAREER COLLEGE                ,TX,79925-6230,Proprietary  ,106,287,393,182,669,851
04136500,PCCENTER                                ,TX,75115-4214,Proprietary  ,1,21,22,4,47,51
04142300,AVEDA INSTITUTE SAN ANTONIO             ,TX,78215-1260,Proprietary  ,42,102,144,108,216,324
04146600,360 DEGREES BEAUTY ACADEMY              ,TX,77084-2714,Proprietary  ,5,22,27,21,59,80
04146800,SOUTH TEXAS TRAINING CENTER             ,TX,78586-7721,Proprietary  ,5,26,31,5,33,38
04154800,DUVALL'S SCHOOL OF COSMETOLOGY          ,TX,76021-4159,Proprietary  ,15,11,26,15,11,26
00367000,BRIGHAM YOUNG UNIVERSITY                ,UT,84602-8406,Private      ,1668,3105,4773,10491,11729,22220
00367100,DIXIE STATE COLLEGE OF UTAH             ,UT,84770-3876,Public       ,804,1344,2148,2548,3348,5896
00367200,LDS BUSINESS COLLEGE                    ,UT,84101-3500,Private      ,204,258,462,545,555,1100
00367400,STEVENS HENAGER COLLEGE                 ,UT,84401-1420,Proprietary  ,375,2254,2629,822,5414,6236
00367500,UNIVERSITY OF UTAH                      ,UT,84112-9055,Public       ,1470,3276,4746,8659,14098,22757
00367600,COLLEGE OF EASTERN UTAH                 ,UT,84501-2699,Public       ,256,336,592,781,776,1557
00367700,UTAH STATE UNIVERSITY                   ,UT,84322-1400,Public       ,1431,2519,3950,6794,8752,15546
00367800,SOUTHERN UTAH UNIVERSITY                ,UT,84720-2470,Public       ,722,974,1696,3388,2792,6180
00367900,SNOW COLLEGE                            ,UT,84627-1299,Public       ,441,297,738,1779,742,2521
00368000,WEBER STATE UNIVERSITY                  ,UT,84408-1136,Public       ,1318,2945,4263,4609,9607,14216
00368100,WESTMINSTER COLLEGE                     ,UT,84105-3697,Private      ,103,359,462,1853,1541,3394
00402700,UTAH VALLEY UNIVERSITY                  ,UT,84058-5999,Public       ,2367,4800,7167,6727,13130,19857
00522000,SALT LAKE COMMUNITY COLLEGE             ,UT,84123-0000,Public       ,2549,5619,8168,5916,13080,18996
00943300,SHERMAN KENDALL'S ACADEMY OF BEAUTY     ,UT,84106-1836,Proprietary  ,13,29,42,27,55,82
01009800,NEUMONT UNIVERSITY                      ,UT,84095-0000,Proprietary  ,24,20,44,334,105,439
01116500,UINTAH BASIN APPLIED TECHNOLOGY CLG     ,UT,84066-0000,Public       ,2,41,43,5,81,86
01116600,UTAH CAREER COLLEGE                     ,UT,84088-4021,Proprietary  ,197,534,731,435,1506,1941
02078800,SHERMAN KENDALL'S ACADEMY OF BEAUTY     ,UT,84047-0000,Proprietary  ,13,14,27,26,37,63
02115400,BRIDGERLAND APPLIED TECHNOLOGY COLLEGE  ,UT,84321-0000,Public       ,78,288,366,195,646,841
02156600,DAVIS APPLIED TECHNOLOGY COLLEGE        ,UT,84037-0000,Public       ,87,497,584,209,1222,1431
02178500,EAGLE GATE COLLEGE                      ,UT,84123-0000,Proprietary  ,121,436,557,232,1142,1374
02270800,AMERITECH COLLEGE                       ,UT,84604-6927,Proprietary  ,23,128,151,49,229,278
02270802,AMERITECH COLLEGE - DRAPER              ,UT,84020-6545,Proprietary  ,11,59,70,19,142,161
02298500,EVEREST COLLEGE                         ,UT,84119-2668,Proprietary  ,48,290,338,105,738,843
02346500,OGDEN-WEBER APPLIED TECHNOLOGY COLG     ,UT,84404-0000,Public       ,78,458,536,210,1200,1410
02360800,PROVO COLLEGE                           ,UT,84601-0000,Proprietary  ,101,306,407,233,757,990
02361000,ITT TECHNICAL INSTITUTE                 ,UT,84123-0000,Proprietary  ,122,468,590,188,823,1011
02504000,MARINELLO SCHOOL OF BEAUTY              ,UT,84041-0000,Proprietary  ,27,44,71,57,111,168
02516100,MARINELLO SCHOOL OF BEAUTY              ,UT,84405-1501,Proprietary  ,23,50,73,36,96,132
02531800,VON CURTIS ACADEMY OF HAIR DESIGN       ,UT,84606-0000,Proprietary  ,362,346,708,646,615,1261
02556800,HAIRITAGE COLLEGE OF BEAUTY             ,UT,84117-7204,Proprietary  ,79,144,223,107,187,294
02557700,PREMIER HAIR ACADEMY                    ,UT,84120-3603,Proprietary  ,4,15,19,9,47,56
02572700,EVANS HAIRSTYLING COLLEGE               ,UT,84770-0000,Proprietary  ,5,17,22,14,36,50
02572800,VISTA COLLEGE                           ,UT,84015-0000,Proprietary  ,17,67,84,33,142,175
02572801,CERTIFIED CAREERS INSTITUTE             ,UT,84015-0000,Proprietary  ,0,0,0,1,3,4
02572802,VISTA COLLEGE - SALT LAKE CITY          ,UT,84119-1458,Proprietary  ,1,10,11,3,25,28
02573100,EVANS HAIRSTYLING COLLEGE               ,UT,84720-0000,Proprietary  ,6,7,13,19,35,54
02612200,MARINELLO SCHOOL OF BEAUTY              ,UT,84604-1585,Proprietary  ,24,36,60,51,72,123
03030600,UTAH COLLEGE OF MASSAGE THERAPY         ,UT,84111-1606,Proprietary  ,102,164,266,316,534,850
03030601,UTAH CLG OF MASSAGE THER-PROVO CMPS     ,UT,84042-0000,Proprietary  ,25,60,85,54,155,209
03082100,MYOTHERAPY COLLEGE OF UTAH              ,UT,84115-2522,Proprietary  ,10,34,44,23,69,92
03108200,ECHELON EDGE ACADEMY OF HAIR SKIN & NAIL,UT,84070-2004,Proprietary  ,13,28,41,16,37,53
03110400,HAIRITAGE HAIR ACADEMY                  ,UT,84770-5233,Proprietary  ,4,7,11,18,43,61
03339400,WESTERN GOVERNORS UNIVERSITY            ,UT,84107-2533,Private      ,198,7530,7728,424,16679,17103
03413300,MOUNTAINLAND APPLIED TECHNOLOGY COLLEGE ,UT,84058-5857,Public       ,43,112,155,93,252,345
03463300,CAREERS UNLIMITED                       ,UT,84058-0000,Proprietary  ,7,11,18,47,98,145
03617300,HEALING MOUNTAIN MASSAGE SCHOOL         ,UT,84111-3232,Proprietary  ,4,28,32,12,63,75
03829500,SKINWORKS SCHOOL OF ADVANCED SKINCARE   ,UT,84115-0000,Proprietary  ,8,29,37,10,62,72
03838300,OGDEN INSTITUTE OF MASSAGE THERAPY      ,UT,84403-0000,Proprietary  ,13,18,31,14,31,45
03902300,RENAISSANCE SCHOOL OF THERAPEUTIC MASSAG,UT,84010-2835,Proprietary  ,3,5,8,6,12,18
03909300,MAXIMUM STYLE TEC SCHOOL OF COSMETOLOGY ,UT,84323-4679,Proprietary  ,9,23,32,27,52,79
03921300,CAMEO COLLEGE OF ESSENTIAL BEAUTY       ,UT,84115-0000,Proprietary  ,33,127,160,57,211,268
04054300,SOUTHWEST APPLIED TECHNOLOGY COLLEGE    ,UT,84720-6608,Public       ,16,64,80,27,130,157
04072300,DALLAS ROBERTS ACADEMY OF HAIR DESIGN & ,UT,84604-1008,Proprietary  ,11,18,29,32,51,83
04118100,IMAGEWORKS ACADEMY OF HAIR DESIGN       ,UT,84660-1210,Proprietary  ,7,18,25,10,31,41
04121700,DIXIE APPLIED TECHNOLOGY COLLEGE        ,UT,84770-3025,Public       ,53,103,156,176,206,382
04142100,SKIN INSTITUTE (THE)                    ,UT,84770-6452,Proprietary  ,8,12,20,14,25,39
04145500,SKIN SCIENCE INSTITUTE (THE)            ,UT,84115-0000,Proprietary  ,14,40,54,34,90,124
04153000,RENAISSANCE ACADEMIE                    ,UT,84604-0000,Proprietary  ,2,3,5,2,3,5
00368200,BENNINGTON COLLEGE                      ,VT,05201-6001,Private      ,15,46,61,1039,291,1330
00368300,CASTLETON STATE COLLEGE                 ,VT,05735-0000,Public       ,164,74,238,2878,439,3317
00368400,CHAMPLAIN COLLEGE                       ,VT,05401-3950,Private      ,80,220,300,3206,938,4144
00368402,WOODBURY COLLEGE                        ,VT,05602-0000,Private      ,1,11,12,1,42,43
00368500,COLLEGE OF ST JOSEPH                    ,VT,05701-3899,Private      ,19,71,90,166,280,446
00368600,GODDARD COLLEGE                         ,VT,05667-0000,Private      ,33,197,230,81,909,990
00368700,GREEN MOUNTAIN COLLEGE                  ,VT,05764-1199,Private      ,53,48,101,1160,206,1366
00368800,JOHNSON STATE COLLEGE                   ,VT,05656-9898,Public       ,125,186,311,1490,896,2386
00368900,LYNDON STATE COLLEGE                    ,VT,05851-0919,Public       ,115,36,151,1656,313,1969
00369000,MARLBORO COLLEGE                        ,VT,05344-0300,Private      ,17,34,51,504,92,596
00369100,MIDDLEBURY COLLEGE                      ,VT,05753-0000,Private      ,56,17,73,3631,428,4059
00369106,MIDDLEBURY COLLEGE - BREAD LOAF SCHOOL O,VT,05753-0000,Private      ,0,0,0,11,101,112
00369200,NORWICH UNIVERSITY                      ,VT,05663-1035,Private      ,127,422,549,2637,1606,4243
00369300,SOUTHERN VERMONT COLLEGE                ,VT,05201-6002,Private      ,44,22,66,562,157,719
00369400,ST MICHAELS COLLEGE                     ,VT,05439-0001,Private      ,52,56,108,3174,193,3367
00369600,UNIVERSITY OF VERMONT                   ,VT,05405-0160,Public       ,273,271,544,17642,3000,20642
00369700,VERMONT COLLEGE OF FINE ARTS            ,VT,05602-3128,Private      ,2,63,65,3,70,73
00369800,VERMONT TECHNICAL COLLEGE               ,VT,05061-0000,Public       ,129,98,227,1174,752,1926
00857500,SALON PROFESSIONAL ACADEMY (THE)        ,VT,05495-4001,Proprietary  ,10,13,23,57,56,113
00865800,O'BRIENS AVEDA INSTITUTE                ,VT,05403-7747,Proprietary  ,8,20,28,25,43,68
00886000,SIT                                     ,VT,05301-4801,Private      ,0,88,88,14,519,533
01116700,COMMUNITY COLLEGE OF VERMONT            ,VT,05676-1552,Public       ,615,1228,1843,1615,3514,5129
01193400,VERMONT LAW SCHOOL                      ,VT,05068-0000,Private      ,0,26,26,3,1038,1041
01218300,BURLINGTON COLLEGE                      ,VT,05401-8477,Private      ,15,33,48,164,125,289
02143500,STERLING COLLEGE                        ,VT,05827-0000,Private      ,9,6,15,161,27,188
02254000,NEW ENGLAND CULINARY INSTITUTE          ,VT,05602-0000,Proprietary  ,60,90,150,434,355,789
02532600,LANDMARK COLLEGE                        ,VT,05346-0000,Private      ,58,11,69,401,56,457
03708300,BURLINGTON TECHNICAL CENTER             ,VT,05401-2721,Public       ,1,2,3,15,11,26
04146900,ADVANCED WELDING INSTITUTE              ,VT,05403-0000,Proprietary  ,7,7,14,10,8,18
00392800,CASPER COLLEGE                          ,WY,82601-4612,Public       ,304,485,789,1199,1328,2527
00392900,EASTERN WYOMING COLLEGE                 ,WY,82240-1603,Public       ,84,134,218,393,303,696
00393000,SHERIDAN COLLEGE                        ,WY,82801-9133,Public       ,193,353,546,809,946,1755
00393100,NORTHWEST COLLEGE                       ,WY,82435-1895,Public       ,170,242,412,856,583,1439
00393200,UNIVERSITY OF WYOMING                   ,WY,82071-3663,Public       ,778,888,1666,5994,4132,10126
00393300,WESTERN WYOMING COMMUNITY COLLEGE       ,WY,82902-0000,Public       ,213,347,560,800,949,1749
00728900,CENTRAL WYOMING COLLEGE                 ,WY,82501-0000,Public       ,131,260,391,470,719,1189
00915700,WYOMING TECHNICAL INSTITUTE             ,WY,82072-9519,Proprietary  ,375,258,633,2155,959,3114
00925900,LARAMIE COUNTY COMMUNITY CLG            ,WY,82007-3299,Public       ,263,478,741,1211,1716,2927
02211900,CHEEKS INTERNATIONAL ACDMY              ,WY,82001-0000,Proprietary  ,21,74,95,42,141,183
00393500,UNIV OF GUAM                            ,GU,96923-0000,Public       ,563,454,1017,1835,1395,3230
01536100,GUAM COMMUNITY COLLEGE                  ,GU,96921-0000,Public       ,404,371,775,884,1077,1961
03438300,PACIFIC ISLANDS BIBLE COLLEGE           ,GU,96913-2619,Private      ,29,26,55,45,50,95
00393600,PONTIFICAL CATHOLIC UNIV OF PR          ,PR,00717-0777,Private      ,976,1966,2942,5163,4776,9939
00393700,UNIVERSITY OF THE SACRED HEART          ,PR,00914-0383,Private      ,754,884,1638,3207,2143,5350
00393800,INTER-AMER UNIV PR-CNTRL ADMN           ,PR,00936-0000,Private      ,963,2403,3366,2649,5937,8586
00393801,INTER-AMER UNIV PR SCHL LAW             ,PR,00936-8351,Private      ,2,85,87,18,365,383
00393802,INTER AMERICAN UNIVERSITY OF PUERTO RICO,PR,00926-0000,Private      ,151,477,628,712,1122,1834
00393803,INTER AMERICAN UNIVERSITY OF PR         ,PR,00683-0000,Private      ,912,897,1809,3526,2130,5656
00393804,INTER-AMER UNIV PR-RECINTO AGUADILA     ,PR,00605-2000,Private      ,660,1033,1693,2011,2584,4595
00393805,INTER-AMER UNIV PR-ARECIBO CAMPUS       ,PR,00614-4050,Private      ,600,902,1502,2295,2907,5202
00393806,INTER-AMER UNIV PR-BARRANQUITAS REG     ,PR,00794-0517,Private      ,293,437,730,1304,1203,2507
00393807,INTER-AMER UNIV PR-FAJARDO REGIONAL     ,PR,00738-0000,Private      ,327,452,779,1249,1204,2453
00393808,INTER-AMER UNIV PR - GUAYAMA CAMPUS     ,PR,00785-4004,Private      ,287,550,837,1025,1453,2478
00393809,INTER-AMER UNIV PR-PONCE REGIONAL       ,PR,00715-0000,Private      ,543,1146,1689,2988,3722,6710
00393811,INTER-AMER UNIV PR-BAYAMON REG CLG      ,PR,00959-0000,Private      ,1020,941,1961,3437,2347,5784
00394100,COLEGIO UNIVERSITARIO DEL ESTE          ,PR,00983-0000,Private      ,2152,3811,5963,6023,7860,13883
00394200,UNIVERSITY OF PR-CENTRAL ADMINISTRATION ,PR,00936-4984,Public       ,9,22,31,333,113,446
00394201,UNIVERSITY OF PR-RIO PIEDRAS CAMPUS     ,PR,00931-3300,Public       ,640,574,1214,9693,3235,12928
00394202,UNIV OF PUERTO RICO-MAYAGUEZ CAMPUS     ,PR,00681-5000,Public       ,556,390,946,9529,1921,11450
00394203,"UNIVERSITY OF PR, MED. SCIENCES CAMPUS  ",PR,00936-5067,Public       ,33,228,261,382,1286,1668
00394204,"UNIVERSITY OF PUERTO RICO, CAYEY CAMPUS ",PR,00736-0000,Public       ,66,47,113,3254,610,3864
00394205,"UNIVERSITY OF PR, HUMACAO CAMPUS        ",PR,00791-4057,Public       ,234,115,349,3788,704,4492
00394206,UNIVERSITY OF PR-AGUADILLA CAMPUS       ,PR,00604-6150,Public       ,194,127,321,2594,582,3176
00394207,UNIVERSITY OF PUERTO RICO-ARECIBO CAMPUS,PR,00614-0000,Public       ,136,95,231,3986,637,4623
00394208,UNIVERSITY OF PUERTO RICO-BAYAMON CAMPUS,PR,00959-0000,Public       ,267,130,397,4288,691,4979
00394209,UNIVERSITY OF PUERTO RICO-CAROLINA      ,PR,00984-4800,Public       ,266,133,399,3536,630,4166
00394210,UNIVERSITY OF PUERTO RICO-PONCE         ,PR,00732-0000,Public       ,96,58,154,3394,480,3874
00394211,"UNIVERSITY OF PR, UTUADO CAMPUS         ",PR,00641-0000,Public       ,117,46,163,1422,261,1683
00501900,UNIV ADVENTISTA DE LAS ANTILLAS         ,PR,00681-0118,Private      ,174,127,301,608,388,996
00502200,BAYAMON CENTRAL UNIVERSITY              ,PR,00960-0000,Private      ,264,437,701,936,1060,1996
00890200,COLUMBIA CENTRO UNIVERSITARIO           ,PR,00726-0000,Proprietary  ,306,586,892,743,1192,1935
01056700,COLEGIO TECNOLOGICO DE SAN JUAN         ,PR,00918-2973,Public       ,320,436,756,702,982,1684
01072400,CARLOS ALBIZU UNIVERSITY                ,PR,00902-3711,Private      ,12,112,124,83,712,795
01081900,CONSERVATORIO DE MUSICA DE PUERTO RICO  ,PR,00907-3373,Public       ,81,42,123,256,88,344
01120300,RYDER MEMORIAL HOSP SCH OF NURSING      ,PR,00792-0000,Private      ,0,1,1,4,4,8
01171900,UNIVERSIDAD DEL TURABO                  ,PR,00778-0000,Private      ,1955,4293,6248,6970,9689,16659
01194000,ICPR JUNIOR COLLEGE                     ,PR,00919-0000,Proprietary  ,495,606,1101,841,1015,1856
01194002,INSTITUTO COMERCIAL DE PUERTO RICO JUNIO,PR,00681-1108,Proprietary  ,0,0,0,1,0,1
01194100,AMERICAN UNIVERSITY OF PUERTO RICO      ,PR,00960-2037,Private      ,282,280,562,864,685,1549
01194101,AMERICAN UNIVERSITY OF PUERTO RICO      ,PR,00674-0000,Private      ,216,357,573,674,673,1347
01252500,CARIBBEAN UNIVERSITY                    ,PR,00960-0493,Private      ,728,1396,2124,2370,3242,5612
01314800,RAMIREZ COLLEGE OF BUS & TECH           ,PR,00918-0000,Proprietary  ,111,200,311,221,459,680
02063100,MBTI BUSINESS TRNG INSTITUTE            ,PR,00907-3917,Proprietary  ,124,278,402,300,597,897
02100000,POLYTECHNIC UNIVERSITY OF PR            ,PR,00917-0000,Private      ,558,804,1362,2764,2222,4986
02163300,UNIVERSIDAD CENTRAL DEL CARIBE          ,PR,00960-0000,Private      ,24,87,111,155,443,598
02165100,EDP COLLEGE OF PUERTO RICO              ,PR,00919-0000,Private      ,516,953,1469,799,1414,2213
02166400,INSTITUTO DE BANCA Y COMERCIO           ,PR,00925-0000,Proprietary  ,3445,4412,7857,7538,9402,16940
02170300,INST EDUC TECNIA OCUP LA REINA          ,PR,00674-0000,Proprietary  ,134,219,353,284,388,672
02170301,INST EDUC TECNICA OCUPLA LA REINA       ,PR,00603-0000,Proprietary  ,1,0,1,3,4,7
02189100,CENTRO DE ESTUDIOS MULTIDISCIPLIN       ,PR,00926-0000,Private      ,955,1411,2366,1129,1650,2779
02189300,EMMA'S BEAUTY ACADEMY                   ,PR,00680-0000,Proprietary  ,75,92,167,197,190,387
02195400,MODERN HAIRSTYLING INSTITUTE            ,PR,00960-0000,Proprietary  ,335,332,667,428,418,846
02195500,MODERN HAIRSTYLING INSTITUTE            ,PR,00612-0000,Proprietary  ,1,0,1,3,1,4
02195800,LICEO E ARTE Y TECNOLGIA                ,PR,00919-0000,Private      ,181,176,357,623,545,1168
02195900,MODERN HAIRSTYLING INSTITUTE            ,PR,00980-0000,Proprietary  ,2,1,3,7,6,13
02234900,ANTILLES SCHOOL OF TECH CAREERS         ,PR,00909-0000,Proprietary  ,73,134,207,125,180,305
02241901,COMMONWEALTH OF PR DEPT OF EDUC - CARLOS,PR,00986-0000,Public       ,23,37,60,25,38,63
02241902,COMMONWEALTH OF PR DEPT OF EDUC - TOMAS ,PR,00613-0000,Public       ,4,17,21,11,28,39
02241904,COMMONWEALTH OF PR DEPT OF EDUC - ITPR R,PR,00655-0000,Public       ,154,78,232,491,256,747
02241905,COMMONWEALTH OF PR DEPT OF EDUC - JOSE A,PR,00674-0000,Public       ,4,2,6,67,11,78
02241907,COMMONWEALTH OF PR DEPT OF EDUC - ITPR R,PR,00928-0000,Public       ,132,55,187,446,193,639
02241908,COMMONWEALTH OF PR DEPT OF EDUC - ITPR R,PR,00732-0000,Public       ,54,42,96,517,237,754
02241909,COMMONWEALTH OF PR DEPT OF EDUC - TROQUE,PR,00959-0000,Public       ,6,5,11,45,13,58
02241910,COMMONWEALTH OF PR DEPT OF EDUC - ITPR R,PR,00701-1091,Public       ,55,29,84,658,204,862
02260600,NATIONAL COLLEGE OF BUSINESS & TECH     ,PR,00960-2036,Proprietary  ,916,1460,2376,3452,4304,7756
02260601,NATIONAL COLLEGE OF BUSINESS & TECHNOLOG,PR,00612-0000,Proprietary  ,8,14,22,42,28,70
02260602,NATIONAL COLLEGE OF BUSINESS & TECHNOLOG,PR,00745-9903,Proprietary  ,1,8,9,16,21,37
02260800,HUERTAS JUNIOR COLLEGE                  ,PR,00726-0000,Proprietary  ,398,658,1056,1026,1312,2338
02297700,AUTOMECA TECHNICAL COLLEGE              ,PR,00957-0000,Proprietary  ,484,359,843,1153,656,1809
02303800,AMERICAN EDUCATIONAL COLLEGE            ,PR,00961-0000,Proprietary  ,260,369,629,379,546,925
02335500,COLEGIO BIBLICO PENTECOSTAL DE PR       ,PR,00978-0000,Private      ,14,76,90,20,138,158
02340600,HUMACAO COMMUNITY COLLEGE               ,PR,00792-0000,Private      ,268,357,625,327,410,737
02343600,INSTITUTE OF BEAUTY CAREERS             ,PR,00613-0000,Proprietary  ,63,101,164,253,370,623
02482400,PONCE SCHOOL OF MEDICINE                ,PR,00716-2347,Private      ,1,56,57,14,623,637
02502400,SERBIA'S SCHOOL OF BEAUTY CULTURE       ,PR,00785-0000,Proprietary  ,90,137,227,156,191,347
02504500,INSTITUCION CHAVIANO DE MAYAGUEZ        ,PR,00708-0000,Proprietary  ,10,79,89,11,94,105
02505400,ATLANTIC COLLEGE                        ,PR,00970-0000,Private      ,404,276,680,736,529,1265
02534900,PONCE PARAMEDICAL COLLEGE (POPAC)       ,PR,00731-0000,Proprietary  ,803,803,1606,1906,1534,3440
02549700,ACADEMIA MAISON D'ESTHETIQUE            ,PR,00907-0000,Proprietary  ,31,56,87,66,162,228
02552300,COLEGIO MAYOR DE TECHNOLOGIA            ,PR,00714-0000,Proprietary  ,108,89,197,199,227,426
02562500,INTERNATIONAL TECHNICAL COLLEGE         ,PR,00918-0000,Proprietary  ,13,43,56,43,118,161
02563500,ROGIES SCHOOL OF BEAUTY CULTURE         ,PR,00910-0000,Proprietary  ,97,127,224,134,195,329
02569400,ESCUELA DE ARTES PLASTICAS              ,PR,00902-1112,Public       ,64,40,104,357,157,514
02570400,EDUCATIONAL TECHNICAL COLLEGE           ,PR,00925-3404,Proprietary  ,202,383,585,396,735,1131
02576100,ESCUELA TECNICA DE ELECTRICIDAD         ,PR,00731-0000,Proprietary  ,102,140,242,292,290,582
02587500,UNIVERSIDAD METROPOLITANA               ,PR,00928-0000,Private      ,2108,4409,6517,4930,7737,12667
02588600,SEMINARIO EVANGELICO DE PUERTO RICO     ,PR,00925-0000,Private      ,0,17,17,1,35,36
02593700,HISPANIC AMERICAN COLLEGE               ,PR,00725-0000,Proprietary  ,89,108,197,156,173,329
02611100,INSTITUTO MERLIX                        ,PR,00961-0000,Proprietary  ,0,0,0,2,1,3
03021900,EDIC COLLEGE                            ,PR,00726-0000,Proprietary  ,301,526,827,803,1022,1825
03025500,MECH TECH COLLEGE                       ,PR,00725-6118,Proprietary  ,1075,831,1906,2636,1422,4058
03025900,"LICEO DE ARTE, DISENOS Y COMERCIO       ",PR,00726-0000,Proprietary  ,111,196,307,327,432,759
03029700,"UNIVERSAL TECHNOLOGY CLG OF PR, INC     ",PR,00605-1955,Private      ,260,474,734,671,1141,1812
03061900,COLEGIO TECHNOLOGICO Y COMERCIAL        ,PR,00602-0000,Proprietary  ,27,44,71,27,45,72
03068400,STAR BEAUTY ACADEMY                     ,PR,00961-6312,Proprietary  ,45,63,108,51,64,115
03070500,D'MART INSTITUTE                        ,PR,00794-3517,Proprietary  ,387,526,913,828,1026,1854
03075600,EMMA'S BEAUTY ACADEMY                   ,PR,00795-0000,Proprietary  ,138,124,262,290,220,510
03076000,PUERTO RICO BARBER COLLEGE              ,PR,00738-4632,Proprietary  ,0,0,0,1,0,1
03085700,PROFESSIONAL TECHNICAL INSTITUTION      ,PR,00960-7061,Proprietary  ,173,128,301,200,154,354
03104400,PROFESSIONAL ELECTRIC SCHOOL            ,PR,00674-1797,Proprietary  ,38,45,83,57,66,123
03106900,ESCUELA DE PERITOS ELECTRICITAS         ,PR,00662-0457,Proprietary  ,18,21,39,39,50,89
03112100,JOHN DEWEY COLLEGE                      ,PR,00915-9538,Private      ,1290,2545,3835,1790,3532,5322
03112101,JOHN DEWEY COLLEGE                      ,PR,00986-0000,Private      ,343,455,798,493,625,1118
03112102,JOHN DEWEY COLLEGE-BAYAMON CAMPUS       ,PR,00959-0000,Private      ,311,494,805,385,575,960
03112104,JOHN DEWEY COLLEGE - YABUCOA LRNING SITE,PR,00767-0767,Private      ,94,245,339,113,293,406
03112105,JOHN DEWEY COLLEGE - FAJARDO BRANCH     ,PR,00738-0738,Private      ,85,126,211,175,279,454
03112106,JOHN DEWEY COLLEGE - ARROYO BRANCH      ,PR,00714-0714,Private      ,55,107,162,103,178,281
03112107,JOHN DEWEY COLLEGE - JUANA DIAZ BRANCH  ,PR,00795-0000,Private      ,107,132,239,138,191,329
03112108,JOHN DEWEY COLLEGE - HATILLO CAMPUS     ,PR,00659-0000,Private      ,1,2,3,1,2,3
03112109,JOHN DEWEY COLLEGE - MANATI             ,PR,00674-0000,Private      ,0,1,1,0,1,1
03115900,TRINITY COLLEGE OF PUERTO RICO          ,PR,00734-0000,Private      ,77,107,184,93,135,228
03122500,ACADEMIA SERRANT INC.                   ,PR,00717-1568,Proprietary  ,58,155,213,81,199,280
03123100,GLOBELLE TECHNICAL INSTITUTE            ,PR,00693-4218,Proprietary  ,98,42,140,98,43,141
03124200,NOVA COLLEGE DE PUERTO RICO             ,PR,00960-4016,Proprietary  ,29,76,105,62,172,234
03157600,"COLEGIO DE CINEMATOGRAFIA, ARTES Y TELEV",PR,00961-6345,Proprietary  ,202,124,326,309,164,473
03177300,SAN JUAN BAUTISTA SCH OF MEDICINE       ,PR,00726-0000,Private      ,0,12,12,3,274,277
03326300,UNIVERSAL CAREER COMMUNITY COLLEGE      ,PR,00907-0000,Proprietary  ,235,350,585,385,576,961
03336300,CENTURY COLLEGE                         ,PR,00603-4802,Proprietary  ,40,91,131,92,148,240
03414300,MONTECLARO                              ,PR,00745-9612,Private      ,16,0,16,19,0,19
03452300,INSTITUTO PRE-VOCACIONAL E INDUSTRI     ,PR,00613-1800,Private      ,55,108,163,70,125,195
03469300,IVAEM COLLEGE                           ,PR,00725-0000,Proprietary  ,39,25,64,137,63,200
03531300,COLEGIO PENTECOSTAL MIZPA               ,PR,00928-0966,Private      ,7,66,73,15,191,206
03544300,ATENAS COLLEGE                          ,PR,00674-0000,Private      ,225,434,659,706,1077,1783
03552300,LESTON COLLEGE                          ,PR,00961-6309,Proprietary  ,31,56,87,45,94,139
03608300,CARIBBEAN FORENSIC & TECHNICAL COLL     ,PR,00926-0000,Proprietary  ,19,45,64,36,66,102
03638300,ROSSLYN TRAINING ACADEMY OF COSMETOLOGY ,PR,00602-3225,Proprietary  ,7,20,27,12,33,45
03735400,"CHARLIES GUARD,DETECTIVE BUREAU&ACA     ",PR,00605-0000,Proprietary  ,41,116,157,51,157,208
03751300,ESCUELA HOTELERA DE SAN JUAN            ,PR,00917-0091,Proprietary  ,172,171,343,418,296,714
03758300,BAYAMON COMMUNITY COLLEGE               ,PR,00960-0000,Proprietary  ,28,101,129,36,111,147
03781400,INDUSTRIAL TECHNICAL COLLEGE            ,PR,00792-0000,Proprietary  ,48,82,130,79,115,194
03785300,J.G. GUAYNABO TECHNICAL COLLEGE         ,PR,00960-0000,Proprietary  ,10,41,51,21,56,77
03800300,COLEGIO TECNICO DE ELECTRICIDAD GALLOSA ,PR,00602-0000,Proprietary  ,15,45,60,16,45,61
03800400,INSTITUTE OF BEAUTY OCCUPATIONS AND TECH,PR,00676-5071,Proprietary  ,43,60,103,43,61,104
03843300,ADVANCED TECH COLLEGE                   ,PR,00961-6321,Proprietary  ,93,194,287,102,224,326
03849300,AGUADILLA TECHNICAL COLLEGE             ,PR,00603-0000,Proprietary  ,5,16,21,7,18,25
03965400,MYRANGEL BEAUTY INSTITUTE               ,PR,00754-3917,Proprietary  ,57,172,229,58,173,231
04030300,ASPIRA  DE PUERTO RICO                  ,PR,00987-0000,Private      ,1,6,7,2,7,9
04107300,CARIB TECHNOLOGICAL INSTITUTE           ,PR,00960-0000,Proprietary  ,65,52,117,66,54,120
04117200,INSTITUTO EDUCATIVO PREMIER             ,PR,00731-0000,Proprietary  ,44,73,117,70,125,195
04131600,LIBERTY TECHNICAL COLLEGE               ,PR,00737-1298,Proprietary  ,10,21,31,10,24,34
00394600,UNIVERSITY OF THE VIRGIN ISLANDS        ,VI,00802-6000,Public       ,156,152,308,1004,727,1731
00394601,UNIV OF THE VIRGIN ISLANDS-ST CROIX     ,VI,00850-0000,Public       ,90,129,219,437,508,945
00667400,CANADIAN THEOLOGICAL SEMINARY           ,CN,00000-0000,Private      ,0,0,0,2,1,3
00667700,MCGILL UNIVERSITY                       ,CN,00000-0000,Public       ,108,60,168,1717,408,2125
00667900,QUEEN'S UNIVERSITY AT KINGSTON          ,CN,00000-0000,Public       ,8,7,15,103,38,141
00668100,ST FRANCIS XAVIER UNIVERSITY            ,CN,00000-0000,Public       ,9,5,14,34,11,45
00668200,ST THOMAS UNIVERSITY                    ,CN,00000-0000,Public       ,4,2,6,11,4,15
00668300,UNIVERSITY OF GUELPH                    ,CN,00000-0000,Public       ,1,9,10,31,52,83
00668400,UNIVERSITY OF MANITOBA                  ,CN,00000-0000,Public       ,6,4,10,30,33,63
00668500,UNIVERSITY OF NEW BRUNSWICK (THE)       ,CN,00000-0000,Public       ,2,1,3,14,9,23
00668600,UNIVERSITY OF OTTAWA                    ,CN,00000-0000,Public       ,2,9,11,32,32,64
00668800,UNIVERSITY OF TORONTO                   ,CN,00000-0000,Public       ,28,56,84,291,443,734
00668900,UNIVERSITY OF WINDSOR                   ,CN,00000-0000,Public       ,1,8,9,17,44,61
00683700,UNIVERSITE LAVAL                        ,CN,00000-0000,Public       ,0,2,2,7,12,19
00683800,DALHOUSIE UNIVERSITY                    ,CN,00000-0000,Public       ,10,11,21,138,59,197
00685200,BISHOP'S UNIVERSITY                     ,CN,00000-0000,Private      ,2,0,2,38,1,39
00685300,MCMASTER UNIVERSITY                     ,CN,00000-0000,Public       ,1,6,7,24,24,48
00767900,YORK UNIVERSITY                         ,CN,00000-0000,Public       ,11,26,37,103,102,205
00787400,UNIVERSITY AT CALGARY (THE)             ,CN,00000-0000,Public       ,4,13,17,28,54,82
00814800,UNIVERSITY OF WINNIPEG                  ,CN,00000-0000,Public       ,1,1,2,6,5,11
00836200,UNIVERSITY OF ALBERTA (THE)             ,CN,00000-0000,Public       ,0,9,9,20,54,74
00836300,MOUNT SAINT VINCENT UNIVERSITY          ,CN,00000-0000,Private      ,0,2,2,0,3,3
00836400,SAINT MARY'S UNIVERSITY                 ,CN,00000-0000,Public       ,4,4,8,23,15,38
00836500,CONCORDIA UNIVERSITY - SIR GEORGE W     ,CN,00000-0000,Public       ,31,26,57,232,156,388
00836600,UNIVERSITE DE MONTREAL                  ,CN,00000-0000,Public       ,1,6,7,16,35,51
00836800,CARLETON UNIVERSITY                     ,CN,00000-0000,Public       ,8,2,10,49,27,76
00836900,UNIVERSITY OF BRITISH COLUMBIA          ,CN,00000-0000,Public       ,49,71,120,703,502,1205
00837000,"SAFA, UNIVERSITY OF VICTORIA            ",CN,00000-0000,Public       ,4,7,11,72,53,125
00844400,SIMON FRASER UNIVERSITY                 ,CN,00000-0000,Public       ,4,21,25,65,86,151
00844600,UNIVERSITY OF WESTERN ONTARIO (THE)     ,CN,00000-0000,Public       ,4,8,12,43,48,91
00844800,UNIVERSITY OF REGINA                    ,CN,00000-0000,Public       ,2,3,5,9,10,19
00844900,ACADIA UNIVERSITY                       ,CN,00000-0000,Public       ,5,2,7,42,15,57
00852600,UNIVERSITY OF WATERLOO                  ,CN,00000-0000,Public       ,3,5,8,37,21,58
00858200,WILFRID LAURIER UNIVERSITY              ,CN,00000-0000,Public       ,1,1,2,8,6,14
00891300,LAKEHEAD UNIVERSITY                     ,CN,00000-0000,Public       ,2,0,2,7,5,12
00911900,UNIVERSITE DE MONCTON                   ,CN,00000-0000,Public       ,0,0,0,0,2,2
00925200,BROCK UNIVERSITY                        ,CN,00000-0000,Public       ,1,10,11,7,20,27
00936700,UNIVERSITY OF PRINCE EDWARD ISLAND      ,CN,00000-0000,Public       ,3,20,23,11,110,121
00942100,BRANDON UNIVERSITY                      ,CN,00000-0000,Public       ,3,3,6,7,5,12
00948600,TRINITY WESTERN UNIVERSITY              ,CN,00000-0000,Private      ,22,4,26,304,43,347
00950100,UNIVERSITY OF KING'S COLLEGE            ,CN,00000-0000,Public       ,4,2,6,23,5,28
00950300,MOUNT ALLISON UNIVERSITY                ,CN,00000-0000,Public       ,2,0,2,36,4,40
00950400,NOVA SCOTIA AGRICULTURAL COLLEGE        ,CN,00000-0000,Public       ,0,0,0,2,5,7
00950500,TRENT UNIVERSITY                        ,CN,00000-0000,Public       ,0,4,4,8,6,14
00969700,LETHBRIDGE COLLEGE                      ,CN,00000-0000,Public       ,0,1,1,2,6,8
00969800,MEDICINE HAT COLLEGE                    ,CN,00000-0000,Public       ,1,0,1,6,0,6
00970100,SENECA COLG OF APPLIED ARTS & TECH      ,CN,00000-0000,Public       ,2,7,9,13,21,34
01012300,NOVA SCOTIA COLLEGE OF ART & DESIGN     ,CN,00000-0000,Public       ,2,2,4,12,10,22
01022100,SAINT PAUL UNIVERSITY                   ,CN,00000-0000,Public       ,0,1,1,1,5,6
01045800,SHERIDAN COLLEGE OF APPLIED ARTS AN     ,CN,00000-0000,Public       ,2,3,5,16,13,29
01067500,REGENT COLLEGE                          ,CN,00000-0000,Private      ,1,22,23,2,90,92
01070300,UNIVERSITY OF LETHBRIDGE                ,CN,00000-0000,Public       ,0,3,3,5,9,14
01072000,RYERSON UNIVERSITY                      ,CN,00000-0000,Public       ,2,12,14,45,57,102
01172200,BRIERCREST BIBLE COLLEGE                ,CN,00000-0000,Private      ,5,4,9,11,8,19
01221100,ALGONQUIN CLG OF APPLIED ARTS &TECH     ,CN,00000-0000,Public       ,2,1,3,7,8,15
01222800,HUMBER COLLEGE                          ,CN,00000-0000,Public       ,2,3,5,12,14,26
01227400,PROVIDENCE COLLEGE                      ,CN,00000-0000,Private      ,1,5,6,9,7,16
02102100,BETHANY BIBLE COLLEGE                   ,CN,00000-0000,Private      ,19,10,29,57,22,79
02116600,CANADIAN MEMORIAL CHIROPRACTIC COLL     ,CN,00000-0000,Private      ,0,1,1,0,2,2
02167000,PRAIRIE BIBLE INST                      ,CN,00000-0000,Private      ,4,3,7,30,14,44
02184600,INSTITUTE FOR CHRISTIAN STUDIES         ,CN,00000-0000,Private      ,0,2,2,1,5,6
02195600,LASALLE COLLEGE                         ,CN,00000-0000,Private      ,1,3,4,13,6,19
02195700,TAYLOR UNIVERSITY COLLEGE AND SEMINARY  ,CN,00000-0000,Private      ,0,0,0,0,2,2
02201100,COLUMBIA BIBLE COLLEGE                  ,CN,00000-0000,Private      ,3,4,7,19,10,29
02216400,TYNDALE COLLEGE & SEMINARY              ,CN,00000-0000,Private      ,0,0,0,1,2,3
02219000,ST. LAWRENCE COLLEGE                    ,CN,00000-0000,Public       ,0,0,0,4,5,9
02219200,UNIVERSITY OF SASKATCHEWAN              ,CN,00000-0000,Public       ,1,2,3,10,20,30
02324900,EMMANUEL BIBLE COLLEGE                  ,CN,00000-0000,Private      ,0,1,1,0,1,1
02338800,EMILY CARR UNIVERSITY OF ART AND DESIGN ,CN,00000-0000,Public       ,6,4,10,44,41,85
02354700,RED DEER COLLEGE                        ,CN,00000-0000,Public       ,0,0,0,1,3,4
02577200,SALVATION ARMY WM & CATHERINE BOOTH     ,CN,00000-0000,Private      ,0,0,0,1,0,1
02593800,CONCORDIA UNIVERSITY COLLEGE            ,CN,00000-0000,Private      ,0,1,1,5,6,11
02611900,THE KING'S UNIVERSITY COLLEGE           ,CN,00000-0000,Private      ,0,0,0,1,4,5
03018300,ROCKY MOUNTAIN COLLEGE: CENTRE FOR      ,CN,00000-0000,Private      ,0,1,1,1,5,6
03033800,UNIVERSITY COLLEGE OF CAPE BRETON       ,CN,00000-0000,Public       ,1,1,2,3,1,4
03078300,VANCOUVER SCHOOL OF THEOLOGY            ,CN,00000-0000,Private      ,0,0,0,0,6,6
03273300,CANADIAN COLLEGE OF NATUROPATHIC ME     ,CN,00000-0000,Private      ,0,3,3,0,27,27
03298300,ALBERTA COLLEGE OF ART & DESIGN         ,CN,00000-0000,Public       ,7,1,8,22,8,30
03332500,KWANTLEN UNIVERSITY COLLEGE             ,CN,00000-0000,Public       ,0,3,3,7,11,18
03335400,CANADIAN UNIVERSITY COLLEGE             ,CN,00000-0000,Private      ,10,2,12,21,11,32
03339300,ST. STEPHENS UNIVERSITY                 ,CN,00000-0000,Private      ,0,1,1,4,4,8
03348500,REDEEMER UNIVERSITY COLLEGE             ,CN,00000-0000,Private      ,2,1,3,13,2,15
03408300,CANDIAN NAZARENE UNIVERSITY COLLEGE     ,CN,00000-0000,Private      ,0,1,1,1,3,4
03420300,HOLLAND COLLEGE                         ,CN,00000-0000,Public       ,0,1,1,0,3,3
03421300,LOYALIST COLLEGE OF APPLIED ARTS &      ,CN,00000-0000,Public       ,0,1,1,3,2,5
03465300,NIPISSING UNIVERSITY                    ,CN,00000-0000,Public       ,0,0,0,2,0,2
03511300,CN CLG ACUPUNCTURE & ORIENTAL MED       ,CN,00000-0000,Private      ,0,1,1,0,6,6
03551300,INTERNATIONAL BIBLE COLLEGE             ,CN,00000-0000,Private      ,0,1,1,0,1,1
03560400,NIAGARA COLLEGE-WELLAND CAMPUS          ,CN,00000-0000,Public       ,2,0,2,2,4,6
03613300,UNIV OF NORTHERN BRITISH COLUMBIA       ,CN,00000-0000,Public       ,0,0,0,6,9,15
03644400,CANADIAN MENNONITE UNIVERSITY           ,CN,00000-0000,Private      ,2,2,4,12,3,15
03674400,CANADIAN SOUTHERN BAPTIST SEMINARY      ,CN,00000-0000,Private      ,0,0,0,0,1,1
03711300,CAPILANO UNIVERSITY                     ,CN,00000-0000,Public       ,1,3,4,10,15,25
03745300,BRITISH COLUMBIA INSTITUTE OF TECHNOLOGY,CN,00000-0000,Public       ,1,3,4,3,14,17
03846300,PACIFIC LIFE BIBLE COLLEGE              ,CN,00000-0000,Private      ,2,2,4,4,3,7
03847300,ATLANTIC BAPTIST UNIVERSITY             ,CN,00000-0000,Private      ,1,1,2,11,1,12
04122700,MCMASTER DIVINITY COLLEGE               ,CN,00000-0000,Private      ,0,3,3,0,5,5
00814700,UNIVERSIDAD AUTONOMA DE GUADALAJARA     ,MX,00000-0000,Private      ,6,132,138,59,896,955
01041800,INST TEC Y DE ESTSUPER DE MONTERRE      ,MX,00000-0000,Private      ,13,10,23,84,66,150
01067600,UNIVERSIDAD DE MONTERREY                ,MX,00000-0000,Private      ,4,13,17,31,49,80
01093800,UNIVERSIDAD DE GUANAJUATO               ,MX,00000-0000,Public       ,0,6,6,6,27,33
01097600,INSTITUTO ALLENDE                       ,MX,00000-0000,Private      ,1,5,6,2,16,18
02053300,CENTRO DE ESTUDIOS UNIVERSITARIOS D     ,MX,00000-0000,Private      ,40,32,72,100,136,236
01001000,AMERICAN SAMOA CMNTY COLLEGE            ,AS,96799-2609,Public       ,995,205,1200,1556,336,1892
01034300,COLLEGE OF MICRONESIA - FSM             ,FM,96941-0159,Public       ,709,283,992,2182,938,3120
01100900,PALAU COMMUNITY COLLEGE                 ,PW,96940-0009,Public       ,100,61,161,736,319,1055
03022400,COLLEGE OF THE MARSHALL ISLANDS         ,MH,96960-1258,Public       ,493,250,743,564,287,851
03033000,NORTHERN MARIANAS COLLEGE               ,MP,96950-0000,Public       ,296,203,499,405,309,714
