OPE ID,School,State,Zip Code,School Type,20102011Qtr5_Dependent Students,20102011Qtr5_Independent Students,Quarterly Total,YTD_20102011Qtr5_Dependent Students,YTD_20102011Qtr5_Independent Students,Award Year To Date Total
00100200,ALABAMA AGRCLTL & MECHL UNIV            ,AL,35762-1357,Public       ,105,132,237,6074,3477,9551
00100300,FAULKNER UNIVERSITY                     ,AL,36109-3398,Private      ,45,254,299,1611,4150,5761
00100400,UNIVERSITY OF MONTEVALLO                ,AL,35115-6000,Public       ,43,47,90,2110,1554,3664
00100500,ALABAMA STATE UNIVERSITY                ,AL,36101-0000,Public       ,190,175,365,8409,5194,13603
00100700,CENTRAL ALABAMA COMMUNITY COLLEGE       ,AL,35011-0000,Public       ,108,122,230,1534,2369,3903
00100800,ATHENS STATE UNIVERSITY                 ,AL,35611-1999,Public       ,17,128,145,811,3454,4265
00100900,AUBURN UNIVERSITY                       ,AL,36849-5113,Public       ,350,208,558,16503,6220,22723
00101200,BIRMINGHAM SOUTHERN COLLEGE             ,AL,35254-0002,Private      ,32,25,57,2121,612,2733
00101300,CALHOUN COMMUNITY COLLEGE               ,AL,35609-2216,Public       ,195,438,633,5112,8794,13906
00101500,ENTERPRISE STATE COMMUNITY COLLEGE      ,AL,36331-1300,Public       ,51,111,162,1344,2353,3697
00101600,UNIVERSITY OF NORTH ALABAMA             ,AL,35632-0001,Public       ,110,123,233,4795,2977,7772
00101700,GADSDEN STATE COMMUNITY COLLEGE         ,AL,35903-2269,Public       ,143,400,543,3526,6928,10454
00101800,GEORGE C WALLACE COMMUNITY COLLEGE      ,AL,36303-0943,Public       ,95,296,391,2207,4794,7001
00101900,HUNTINGDON COLLEGE                      ,AL,36106-2148,Private      ,25,32,57,1301,595,1896
00102000,JACKSONVILLE STATE UNIVERSITY           ,AL,36265-1602,Public       ,133,237,370,6538,5882,12420
00102100,JEFFERSON DAVIS COMMUNITY COLLEGE       ,AL,36427-2790,Public       ,36,49,85,700,1162,1862
00102200,JEFFERSON STATE COMMUNITY COLLEGE       ,AL,35215-3098,Public       ,157,442,599,4589,8743,13332
00102300,JUDSON COLLEGE                          ,AL,36756-2504,Private      ,6,7,13,356,122,478
00102400,UNIVERSITY OF WEST ALABAMA              ,AL,35470-0000,Public       ,83,280,363,2081,5238,7319
00102600,MARION MILITARY INSTITUTE               ,AL,36756-3214,Public       ,10,2,12,590,78,668
00102800,MILES COLLEGE                           ,AL,35064-2697,Private      ,51,51,102,2261,1445,3706
00102900,UNIVERSITY OF MOBILE                    ,AL,36613-0000,Private      ,19,70,89,1452,1928,3380
00103000,BISHOP STATE COMMUNITY COLLEGE          ,AL,36603-5898,Public       ,92,279,371,2155,5096,7251
00103001,BISHOP STATE COMM COLG-CARVER CMPS      ,AL,36617-0000,Public       ,0,0,0,179,480,659
00103002,BISHOP STAT COMM CLG-SW CMPS            ,AL,36605-0000,Public       ,0,0,0,128,292,420
00103100,NORTHEAST ALABAMA STATE CMNTY COLG      ,AL,35986-0159,Public       ,85,183,268,1382,2681,4063
00103300,OAKWOOD COLLEGE                         ,AL,35896-0001,Private      ,41,46,87,1962,930,2892
00103400,ALABAMA SOUTHERN COMMUNITY COLLEGE      ,AL,36460-5698,Public       ,50,69,119,1189,1443,2632
00103600,SAMFORD UNIVERSITY                      ,AL,35229-7000,Private      ,43,86,129,3164,3133,6297
00103700,SELMA UNIVERSITY                        ,AL,36701-0000,Private      ,0,0,0,0,3,3
00103800,SNEAD STATE COMMUNITY COLLEGE           ,AL,35957-0734,Public       ,39,109,148,1284,2207,3491
00104000,SOUTHERN UNION STATE COMMUNITY CLG      ,AL,36276-0000,Public       ,86,185,271,3216,3495,6711
00104100,SPRING HILL COLLEGE                     ,AL,36608-1791,Private      ,17,30,47,2017,750,2767
00104400,STILLMAN COLLEGE                        ,AL,35403-1430,Private      ,41,21,62,2223,644,2867
00104600,TALLADEGA COLLEGE                       ,AL,35160-2354,Private      ,15,17,32,684,421,1105
00104700,TROY UNIVERSITY                         ,AL,36082-0001,Public       ,219,1412,1631,8515,26651,35166
00105000,TUSKEGEE UNIVERSITY                     ,AL,36088-1645,Private      ,88,27,115,4913,1289,6202
00105100,UNIVERSITY OF ALABAMA (THE)             ,AL,35487-0120,Public       ,386,352,738,20180,10685,30865
00105200,UNIVERSITY OF ALABAMA AT BIRMINGHAM     ,AL,35294-1150,Public       ,217,386,603,9001,11851,20852
00105500,UNIVERSITY OF ALABAMA IN HUNTSVILLE     ,AL,35899-0001,Public       ,93,150,243,4325,4364,8689
00105700,UNIVERSITY OF SOUTH ALABAMA             ,AL,36688-0002,Public       ,182,428,610,8429,10095,18524
00105900,LAWSON STATE COMMUNITY COLLEGE          ,AL,35221-1798,Public       ,173,333,506,2805,5043,7848
00105901,LAWSON STATE COMMUNITY COLLEGE - BESSEME,AL,35021-0308,Public       ,43,95,138,639,1588,2227
00106000,FAULKNER STATE COMMUNITY COLLEGE        ,AL,36507-2698,Public       ,98,161,259,3138,3798,6936
00526000,J.F. DRAKE STATE TECH COLLEGE           ,AL,35811-1584,Public       ,36,160,196,590,2133,2723
00569100,SHELTON STATE COMMUNITY CLG             ,AL,35405-4017,Public       ,221,207,428,4619,4671,9290
00569200,REID STATE TECHNICAL COLLEGE            ,AL,36401-0000,Public       ,18,42,60,321,938,1259
00569700,NORTHWEST- SHOALS COMMUNITY COLLEGE     ,AL,35661-0000,Public       ,144,168,312,2226,2997,5223
00569702,NORTHWEST-SHOALS C.C.-PHIL CAMPBELL     ,AL,35581-0000,Public       ,0,0,0,334,351,685
00569900,GEORGE C WALLACE STATE CMTY COLLEGE     ,AL,36703-0000,Public       ,63,101,164,1250,2195,3445
00573300,BEVILL STATE CMTY COLLEGE-WALKER        ,AL,35148-0000,Public       ,104,203,307,1577,3179,4756
00573301,BEVILL STATE COMMUNITY COLLEGE - FAYETTE,AL,35555-0000,Public       ,0,0,0,468,805,1273
00573302,BEVILL STATE CMTY CLG-HAMILTON CAMP     ,AL,35570-0000,Public       ,0,0,0,210,417,627
00573305,BEVILL STATE CMTY CLG-WALKER CLG        ,AL,35501-0000,Public       ,0,0,0,403,575,978
00573400,H. COUNCILL TRENHOLM STATE TECH COLLEGE ,AL,36108-0020,Public       ,54,181,235,949,2464,3413
00573401,H. C. TRENHOLM ST TECH COL-PATTERSON CAM,AL,36116-2612,Public       ,20,67,87,435,987,1422
00787100,GEORGE C WALLACE STATE CMTY CLG         ,AL,35077-2000,Public       ,121,264,385,3436,5345,8781
00831000,AUBURN UNIVERSITY-MONTGOMERY            ,AL,36124-0000,Public       ,96,224,320,3764,5042,8806
00898800,LURLEEN B WALLACE COMMUNITY COLLEGE     ,AL,36420-0418,Public       ,43,76,119,1080,1577,2657
00962107,HERZING UNIVERSITY - BIRMINGHAM         ,AL,35209-4816,Proprietary  ,4,65,69,148,1377,1525
01055400,CONCORDIA COLLEGE                       ,AL,36701-3323,Private      ,23,21,44,693,501,1194
01218200,CHATTAHOOCHEE VALLEY CMTY CLG           ,AL,36869-7917,Public       ,29,102,131,912,1709,2621
01303906,SOUTH UNIVERSITY - MONTGOMERY           ,AL,36116-1120,Proprietary  ,33,123,156,439,1769,2208
02170600,UNITED STATES SPORTS ACADEMY            ,AL,36526-7055,Private      ,2,58,60,35,773,808
02199700,HERITAGE CHRISTIAN UNIVERSITY           ,AL,35630-0000,Private      ,1,4,5,21,97,118
02270400,SOUTHEASTERN BIBLE COLLEGE              ,AL,35244-2083,Private      ,1,11,12,93,220,313
02285000,PAUL MITCHELL THE SCHOOL HUNTSVILLE     ,AL,35758-0000,Proprietary  ,11,19,30,72,123,195
02296000,PRINCE INSTITUTE OF PROFESSIONAL STUDIES,AL,36117-0000,Proprietary  ,0,20,20,31,225,256
02341000,FORTIS COLLEGE                          ,AL,36609-0000,Proprietary  ,66,254,320,663,1686,2349
02341002,CAPPS COLLEGE - MONTGOMERY              ,AL,36109-3624,Proprietary  ,0,0,0,60,190,250
02341004,FORTIS COLLEGE - SCHOOL OF COSMETOLOGY  ,AL,36609-1981,Proprietary  ,0,0,0,19,76,95
02503400,AMRIDGE UNIVERSITY                      ,AL,36124-0000,Private      ,8,49,57,70,1049,1119
02605500,REMINGTON COLLEGE - MOBILE CAMPUS       ,AL,36609-5593,Proprietary  ,118,462,580,838,2776,3614
03010600,VIRGINIA COLLEGE                        ,AL,35209-5154,Proprietary  ,272,2701,2973,1974,21196,23170
03010602,VIRGINIA COLLEGE - HUNTSVILLE           ,AL,35805-0000,Proprietary  ,31,220,251,325,1824,2149
03010607,VIRGINIA COLLEGE - MOBILE               ,AL,36608-1626,Proprietary  ,28,178,206,267,1576,1843
03010616,VIRGINIA COLLEGE - MONTGOMERY           ,AL,36117-2802,Proprietary  ,49,204,253,517,2146,2663
03010803,TRI-STATE BUSINESS INSTITUTE - TRI-STATE,AL,35211-0000,Proprietary  ,0,0,0,16,75,91
03032500,ALABAMA STATE CLG BARBER STYLING        ,AL,35215-8308,Proprietary  ,2,19,21,80,168,248
03361400,FORTIS COLLEGE                          ,AL,36535-3547,Proprietary  ,19,80,99,102,448,550
03459300,SOUTHEASTERN SCHOOL OF COSMETOLOGY      ,AL,35228-0000,Private      ,7,48,55,45,240,285
03783300,BLUE CLIFF CAREER COLLEGE               ,AL,63306-4749,Proprietary  ,8,34,42,81,307,388
03894300,HUNTSVILLE BIBLE COLLEGE                ,AL,35811-0000,Private      ,1,5,6,18,95,113
04066300,CARDIAC AND VASCULAR INSTITUTE OF ULTRAS,AL,36604-1411,Proprietary  ,2,12,14,25,154,179
04067300,SELMA UNIVERSITY                        ,AL,36701-0000,Private      ,8,46,54,179,567,746
04121500,COLUMBIA SOUTHERN UNIVERSITY            ,AL,36561-3815,Proprietary  ,39,1025,1064,356,9582,9938
04149200,XCELL ACADEMY-A PAUL MITCHELL PARTNER SC,AL,35216-4990,Proprietary  ,7,31,38,93,232,325
00111100,ALLAN HANCOCK COLLEGE                   ,CA,93454-6399,Public       ,182,362,544,4042,5109,9151
00111300,ANTELOPE VALLEY COLLEGE                 ,CA,93536-5426,Public       ,413,951,1364,6461,10777,17238
00111600,ART CENTER COLLEGE OF DESIGN            ,CA,91103-1999,Private      ,33,46,79,1593,1544,3137
00111700,AZUSA PACIFIC UNIVERSITY                ,CA,91702-7000,Private      ,139,449,588,8488,7373,15861
00111800,BAKERSFIELD COLLEGE                     ,CA,93305-1299,Public       ,293,714,1007,10149,12627,22776
00111900,BARSTOW COMMUNITY COLLEGE               ,CA,92311-6608,Public       ,64,468,532,1155,4620,5775
00112000,AMER BAPT SEM OF THE WEST-BERKELEY      ,CA,94704-0000,Private      ,1,8,9,13,76,89
00112100,BETHANY UNIVERSITY /  ASSEMBLIES OF GOD ,CA,95066-2896,Private      ,9,9,18,456,357,813
00112200,BIOLA UNIVERSITY                        ,CA,90639-0001,Private      ,75,86,161,5668,2345,8013
00112300,BROOKS INSTITUTE                        ,CA,93103-1809,Proprietary  ,25,41,66,996,815,1811
00112400,CABRILLO COLLEGE                        ,CA,95003-3194,Public       ,276,531,807,4582,5829,10411
00112500,CALIFORNIA BAPTIST UNIVERSITY           ,CA,92504-3297,Private      ,75,197,272,4687,3353,8040
00112700,CALIFORNIA COLLEGE OF THE ARTS          ,CA,94107-2206,Private      ,28,38,66,2057,2011,4068
00113100,CALIFORNIA INSTITUTE OF TECHNOLOGY      ,CA,91125-0001,Private      ,28,23,51,3347,620,3967
00113200,CALIFORNIA INSTITUTE OF THE ARTS        ,CA,91355-2397,Private      ,26,21,47,1946,1581,3527
00113300,CALIFORNIA LUTHERAN UNIVERSITY          ,CA,91360-2787,Private      ,46,83,129,4205,1928,6133
00113400,CALIFORNIA MARITIME ACADEMY             ,CA,94590-8181,Public       ,11,11,22,751,334,1085
00113700,CALIF STATE UNIV-FULLERTON              ,CA,92831-3599,Public       ,586,646,1232,38675,20376,59051
00113800,"CALIFORNIA STATE UNIVERSITY, EAST BAY   ",CA,94542-3000,Public       ,214,496,710,11712,11332,23044
00113900,CALIF STATE UNIV-LONG BEACH             ,CA,90840-0006,Public       ,714,573,1287,46691,22016,68707
00114000,CALIF STATE UNIV-LOS ANGELES            ,CA,90032-4226,Public       ,421,656,1077,25677,19120,44797
00114100,"CALIF STATE UNIV, DOMINGUEZ HILLS       ",CA,90747-0001,Public       ,210,494,704,13691,14185,27876
00114200,CALIF STATE UNIV SAN BERNARDINO         ,CA,92407-2397,Public       ,307,558,865,16225,13009,29234
00114300,CAL POLY STATE UNIVERSITY               ,CA,93407-0001,Public       ,341,159,500,31210,4631,35841
00114400,CALIF STATE POLYTECHNIC UNIV POMONA     ,CA,91768-2500,Public       ,350,346,696,25839,10276,36115
00114600,CALIF STATE UNIV - CHICO                ,CA,95929-0001,Public       ,239,139,378,16250,6316,22566
00114700,CALIF STATE UNIV - FRESNO               ,CA,93740-8026,Public       ,214,249,463,19799,11211,31010
00114900,HUMBOLDT STATE UNIVERSITY               ,CA,95521-8299,Public       ,130,76,206,10013,3909,13922
00115000,CALIF STATE UNIV-SACRAMENTO             ,CA,95819-6044,Public       ,402,546,948,25502,17984,43486
00115100,SAN DIEGO STATE UNIVERSITY              ,CA,92182-1690,Public       ,776,632,1408,44128,18894,63022
00115300,CALIF STATE UNIV-NORTHRIDGE             ,CA,91330-8307,Public       ,464,527,991,32267,19137,51404
00115400,SAN FRANCISCO STATE UNIVERSITY          ,CA,94132-1740,Public       ,438,440,878,32045,20069,52114
00115500,SAN JOSE STATE UNIVERSITY               ,CA,95192-0036,Public       ,388,456,844,25513,16243,41756
00115600,SONOMA STATE UNIVERSITY                 ,CA,94928-3609,Public       ,107,115,222,10075,3498,13573
00115700,CALIF STATE UNIV-STANISLAUS             ,CA,95382-0299,Public       ,115,188,303,8072,5820,13892
00116100,CERRITOS COLLEGE                        ,CA,90650-6296,Public       ,439,713,1152,14963,12619,27582
00116200,CHABOT COLLEGE                          ,CA,94545-2400,Public       ,291,567,858,5777,7706,13483
00116300,CHAFFEY COLLEGE                         ,CA,91737-9400,Public       ,430,798,1228,12203,14168,26371
00116400,CHAPMAN UNIVERSITY                      ,CA,92866-1099,Private      ,96,152,248,8705,5552,14257
00116415,CHAPMAN UNIVERSITY - IRVINE CAMPUS      ,CA,92618-3801,Private      ,0,0,0,409,3960,4369
00116453,CHAPMAN UNIVERSITY SCHOOL OF LAW        ,CA,92866-0000,Private      ,3,14,17,78,2057,2135
00116500,CHURCH DIV SCH OF THE PACIFIC           ,CA,94709-0000,Private      ,0,0,0,2,58,60
00116600,CITRUS COLLEGE                          ,CA,91741-1899,Public       ,519,604,1123,8283,6730,15013
00116900,CLAREMONT GRADUATE UNIVERSITY           ,CA,91711-0000,Private      ,2,51,53,18,2040,2058
00117000,CLAREMONT MCKENNA COLLEGE               ,CA,91711-6400,Private      ,22,3,25,3140,179,3319
00117100,HARVEY MUDD COLLEGE                     ,CA,91711-5990,Private      ,10,2,12,2092,65,2157
00117200,PITZER COLLEGE                          ,CA,91711-6101,Private      ,20,2,22,2831,197,3028
00117300,POMONA COLLEGE                          ,CA,91711-6301,Private      ,33,12,45,4696,190,4886
00117400,SCRIPPS COLLEGE                         ,CA,91711-3948,Private      ,11,4,15,1617,102,1719
00117600,WEST HILLS COMMUNITY COLLEGE            ,CA,93210-1399,Public       ,35,113,148,1256,1537,2793
00117700,COGSWELL POLYTECHNICAL COLLEGE          ,CA,94089-1210,Private      ,8,10,18,154,119,273
00117800,COLLEGE OF MARIN                        ,CA,94904-2590,Public       ,75,262,337,1057,2650,3707
00117801,COLG OF MARIN-INDIAN VALLEY CMPS        ,CA,94949-0000,Public       ,6,16,22,60,191,251
00117900,NOTRE DAME DE NAMUR UNIVERSITY          ,CA,94002-1997,Private      ,23,56,79,1092,1203,2295
00118100,COLLEGE OF SAN MATEO                    ,CA,94402-3784,Public       ,147,270,417,2602,2877,5479
00118200,COLLEGE OF THE DESERT                   ,CA,92260-9305,Public       ,219,426,645,4744,5281,10025
00118300,HOLY NAMES UNIVERSITY                   ,CA,94619-1699,Private      ,14,57,71,812,981,1793
00118500,COLLEGE OF THE REDWOODS                 ,CA,95501-9300,Public       ,106,288,394,2876,4951,7827
00118600,COLLEGE OF THE SEQUOIAS                 ,CA,93277-2234,Public       ,241,603,844,6722,8610,15332
00118700,COLLEGE OF THE SISKIYOUS                ,CA,96094-2899,Public       ,30,59,89,1026,1496,2522
00118701,COLLEGE OF THE SISKIYOUS - YREKA CENTER ,CA,96097-9538,Public       ,4,14,18,76,241,317
00119000,CONTRA COSTA COLLEGE                    ,CA,94806-3195,Public       ,157,397,554,2331,4463,6794
00119100,DIABLO VALLEY COLLEGE                   ,CA,94523-1544,Public       ,294,461,755,4863,5333,10196
00119200,CUESTA COLLEGE                          ,CA,93403-8106,Public       ,184,358,542,4179,4175,8354
00119300,CYPRESS COLLEGE                         ,CA,90630-5897,Public       ,302,564,866,8280,8431,16711
00119600,DOMINICAN UNIVERSITY OF CALIFORNIA      ,CA,94901-2298,Private      ,22,39,61,2551,1469,4020
00119700,EL CAMINO COLLEGE                       ,CA,90506-0002,Public       ,646,1073,1719,11578,11668,23246
00119701,COMPTON COMMUNITY COLLEGE               ,CA,90221-5393,Public       ,200,555,755,2510,4912,7422
00119900,FOOTHILL COLLEGE                        ,CA,94022-4597,Public       ,154,362,516,2756,4011,6767
00120000,FULLER THEOLOGICAL SEMINARY             ,CA,91182-0000,Private      ,1,92,93,18,2431,2449
00120100,FULLERTON COLLEGE                       ,CA,92832-2095,Public       ,405,564,969,11491,8346,19837
00120200,GAVILAN COLLEGE                         ,CA,95020-9599,Public       ,100,199,299,1749,2296,4045
00120300,GLENDALE COMMUNITY COLLEGE              ,CA,91208-2894,Public       ,459,670,1129,8189,8802,16991
00120400,GOLDEN GATE BAPT THEOL SEMINARY         ,CA,94941-0000,Private      ,0,0,0,3,68,71
00120500,GOLDEN GATE UNIVERSITY                  ,CA,94105-2967,Private      ,14,133,147,176,4261,4437
00120600,GOLDEN WEST COLLEGE                     ,CA,92647-2748,Public       ,272,509,781,6988,7074,14062
00120700,GRADUATE THEOLOGICAL UNION              ,CA,94709-0000,Private      ,1,3,4,6,326,332
00120800,GROSSMONT COLLEGE                       ,CA,92020-1798,Public       ,334,620,954,7716,10171,17887
00120900,HARTNELL COMMUNITY COLLEGE              ,CA,93901-1697,Public       ,167,279,446,3366,3221,6587
00121200,HUMPHREYS COLLEGE                       ,CA,95207-3896,Private      ,24,121,145,339,1449,1788
00121400,IMPERIAL VALLEY COLLEGE                 ,CA,92251-9787,Public       ,356,611,967,5001,4313,9314
00121500,LA SIERRA UNIVERSITY                    ,CA,92515-3332,Private      ,59,72,131,2318,1069,3387
00121600,UNIVERSITY OF LA VERNE                  ,CA,91750-4443,Private      ,64,453,517,3812,7445,11257
00121700,LASSEN COLLEGE                          ,CA,96130-3000,Public       ,28,90,118,484,852,1336
00121800,LOMA LINDA UNIVERSITY                   ,CA,92350-0001,Private      ,25,146,171,939,5553,6492
00121900,LONG BEACH CITY COLLEGE                 ,CA,90808-1780,Public       ,471,1120,1591,14256,16719,30975
00122000,MASTER'S COLLEGE & SEMINARY (THE)       ,CA,91321-1200,Private      ,23,33,56,1265,454,1719
00122300,LOS ANGELES CITY COLLEGE                ,CA,90029-3588,Public       ,467,1271,1738,6887,12043,18930
00122400,LOS ANGELES HARBOR COLLEGE              ,CA,90744-2397,Public       ,292,541,833,3742,5027,8769
00122600,LOS ANGELES PIERCE COLLEGE              ,CA,91371-0001,Public       ,592,882,1474,9674,8965,18639
00122700,LOS ANGELES TRADE TECH COLLEGE          ,CA,90015-4181,Public       ,455,1387,1842,4983,10533,15516
00122800,LOS ANGELES VALLEY COLLEGE              ,CA,91401-4096,Public       ,461,885,1346,7292,9257,16549
00122900,SO CA UNIV  HEALTH SCIENCES             ,CA,90604-4051,Private      ,3,42,45,45,732,777
00123000,SOUTHERN CA COLLEGE OF OPTOMETRY        ,CA,92831-1699,Private      ,0,2,2,8,497,505
00123200,AMERICAN RIVER COLLEGE                  ,CA,95841-4286,Public       ,515,1559,2074,12019,22789,34808
00123300,SACRAMENTO CITY COLLEGE                 ,CA,95822-1386,Public       ,450,1140,1590,12238,17965,30203
00123600,MENLO COLLEGE                           ,CA,94027-4301,Private      ,23,5,28,1326,166,1492
00123700,MERCED COMMUNITY COLLEGE                ,CA,95348-2898,Public       ,261,480,741,6230,6653,12883
00123800,MILLS COLLEGE                           ,CA,94613-1301,Private      ,23,48,71,1858,1919,3777
00123900,MIRACOSTA COLLEGE                       ,CA,92056-3899,Public       ,175,427,602,3501,5471,8972
00124000,MODESTO JUNIOR COLLEGE                  ,CA,95350-5800,Public       ,363,694,1057,9606,11936,21542
00124200,MONTEREY PENINSULA COLLEGE              ,CA,93940-4799,Public       ,137,253,390,2553,2750,5303
00124300,MOUNT ST MARYS COLLEGE                  ,CA,90049-1599,Private      ,32,106,138,2714,2261,4975
00124500,MT. SAN ANTONIO COLLEGE                 ,CA,91789-1399,Public       ,918,1430,2348,16081,13631,29712
00124600,MT SAN JACINTO COLLEGE                  ,CA,92583-2399,Public       ,287,737,1024,7663,12302,19965
00124700,NAPA VALLEY COLLEGE                     ,CA,94558-6236,Public       ,108,234,342,2281,2829,5110
00124900,OCCIDENTAL COLLEGE                      ,CA,90041-3314,Private      ,44,11,55,5084,323,5407
00125000,ORANGE COAST COLLEGE - FIN AID OFF      ,CA,92628-5005,Public       ,435,615,1050,11719,9175,20894
00125100,OTIS COLLEGE OF ART AND DESIGN          ,CA,90045-3505,Private      ,26,27,53,1644,746,2390
00125200,HOPE INTERNATIONAL UNIVERSITY           ,CA,92631-0000,Private      ,19,82,101,672,968,1640
00125300,FRESNO PACIFIC UNIVERSITY               ,CA,93702-4798,Private      ,40,261,301,2187,3766,5953
00125400,PACIFIC LUTHERAN THEOLOGICAL SEM        ,CA,94708-0000,Private      ,0,0,0,2,81,83
00125500,PACIFIC OAKS COLLEGE                    ,CA,91103-3592,Private      ,1,46,47,27,614,641
00125600,PACIFIC SCHOOL OF RELIGION              ,CA,94709-0000,Private      ,0,2,2,1,178,179
00125800,PACIFIC UNION COLLEGE                   ,CA,94508-9797,Private      ,20,25,45,1716,527,2243
00125900,PALO VERDE COLLEGE                      ,CA,92225-0000,Public       ,14,55,69,268,600,868
00126000,PALOMAR COLLEGE                         ,CA,92069-1486,Public       ,311,635,946,7977,8193,16170
00126100,PASADENA CITY COLLEGE                   ,CA,91106-2003,Public       ,808,1144,1952,16624,11872,28496
00126200,POINT LOMA NAZARENE UNIVERSITY          ,CA,92106-2899,Private      ,57,106,163,4301,1669,5970
00126600,LANEY COLLEGE                           ,CA,94607-4893,Public       ,215,702,917,3938,8164,12102
00126700,MERRITT COLLEGE                         ,CA,94619-3196,Public       ,103,468,571,1927,4708,6635
00126800,PORTERVILLE COLLEGE                     ,CA,93257-6059,Public       ,72,162,234,2007,2721,4728
00126900,RIO HONDO COLLEGE                       ,CA,90601-1699,Public       ,420,520,940,9674,7978,17652
00127000,RIVERSIDE CITY COLLEGE                  ,CA,92506-1299,Public       ,1289,2307,3596,22806,26511,49317
00127200,SAN BERNARDINO VALLEY COLLEGE           ,CA,92410-2798,Public       ,331,839,1170,7557,12963,20520
00127300,SAN DIEGO CITY COLLEGE                  ,CA,92101-4787,Public       ,356,1143,1499,8561,14607,23168
00127500,SAN DIEGO MESA COLLEGE                  ,CA,92111-4996,Public       ,381,860,1241,8700,10794,19494
00127800,SAN FRANCISCO CONSERVATORY OF MUSIC     ,CA,94122-4498,Private      ,3,4,7,332,401,733
00127900,SAN FRANCISCO THEOLOGICAL SEMINARY      ,CA,94960-0000,Private      ,0,2,2,1,117,118
00128000,SAN JOAQUIN DELTA COLLEGE               ,CA,95207-6370,Public       ,387,893,1280,9316,12431,21747
00128100,WILLIAM JESSUP UNIVERSITY               ,CA,95765-3707,Private      ,6,44,50,759,563,1322
00128200,SAN JOSE CITY COLLEGE                   ,CA,95128-2797,Public       ,219,550,769,4046,6385,10431
00128400,SANTA ANA COLLEGE                       ,CA,92706-3398,Public       ,325,685,1010,6572,7202,13774
00128500,SANTA BARBARA CITY COLLEGE              ,CA,93109-2394,Public       ,351,462,813,6766,5535,12301
00128600,SANTA MONICA COLLEGE                    ,CA,90405-1644,Public       ,693,891,1584,15651,10282,25933
00128700,SANTA ROSA JUNIOR COLLEGE               ,CA,95401-4395,Public       ,328,683,1011,5776,7873,13649
00128800,CLAREMONT SCHOOL OF THEOLOGY            ,CA,91711-0000,Private      ,0,3,3,3,223,226
00128900,SHASTA COLLEGE                          ,CA,96049-7692,Public       ,137,404,541,4001,6197,10198
00129000,SIERRA COLLEGE                          ,CA,95677-3397,Public       ,363,753,1116,7350,9627,16977
00129100,SIMPSON UNIVERSITY                      ,CA,96003-8606,Private      ,12,42,54,1164,987,2151
00129200,SOLANO COMMUNITY COLLEGE                ,CA,94534-3197,Public       ,243,502,745,3648,6248,9896
00129300,VANGUARD UNIVERSITY OF SOUTHERN CA      ,CA,92626-6597,Private      ,26,90,116,1934,1125,3059
00129400,SOUTHWESTERN COLLEGE                    ,CA,91910-7299,Public       ,359,615,974,8297,7466,15763
00129500,SOUTHWESTERN LAW SCHOOL                 ,CA,90010-1106,Private      ,3,22,25,37,2968,3005
00129600,DOMINICAN SCH PHILOSOPHY & THEOLOGY     ,CA,94709-0000,Private      ,2,3,5,15,61,76
00129900,ST JOHN'S SEMINARY COLLEGE              ,CA,93010-0000,Private      ,0,1,1,6,3,9
00130200,SAINT MARY'S COLLEGE OF CALIFORNIA      ,CA,94556-2744,Private      ,57,102,159,4357,1726,6083
00130500,STANFORD UNIVERSITY                     ,CA,94305-6106,Private      ,199,172,371,21569,3776,25345
00130501,STANFORD UNIVERSITY - GRADUATE SCHOOL OF,CA,94305-5301,Private      ,1,44,45,83,1573,1656
00130502,STANFORD UNIVERSITY - GRADUATE SCHOOL OF,CA,94305-5015,Private      ,2,35,37,69,1553,1622
00130503,STANFORD UNIVERSITY - STANFORD LAW SCHOO,CA,94305-3096,Private      ,1,19,20,67,2301,2368
00130700,FRESNO CITY COLLEGE                     ,CA,93741-0002,Public       ,368,969,1337,15835,18398,34233
00130800,REEDLEY COLLEGE                         ,CA,93654-2099,Public       ,194,326,520,6349,5782,12131
00130900,TAFT COLLEGE                            ,CA,93268-2317,Public       ,51,121,172,1428,1637,3065
00131200,UNIVERSITY OF CALIFORNIA-BERKELEY       ,CA,94720-1520,Public       ,493,554,1047,49489,20156,69645
00131300,UNIVERSITY OF CALIFORNIA-DAVIS          ,CA,95616-8558,Public       ,424,220,644,47364,15260,62624
00131400,UNIVERSITY OF CALIFORNIA-IRVINE         ,CA,92697-2825,Public       ,473,286,759,50287,12336,62623
00131500,UNIVERSITY OF CALIFORNIA (UCLA)         ,CA,90095-9000,Public       ,634,571,1205,61774,28980,90754
00131502,UNIV OF CALIFORNIA LOS ANG SCH MED      ,CA,90095-0000,Public       ,4,7,11,146,965,1111
00131503,UNIV OF CALIFORNIA LOS ANG DENTAL       ,CA,90095-0000,Public       ,3,4,7,45,150,195
00131600,UNIVERSITY OF CALIFORNIA-RIVERSIDE      ,CA,92521-0209,Public       ,360,271,631,32068,7936,40004
00131700,UNIVERSITY OF CALIFORNIA-SAN DIEGO      ,CA,92093-0013,Public       ,409,219,628,46078,10276,56354
00131900,UNIVERSITY OF CALIFORNIA-SFRANCISCO     ,CA,94143-0246,Public       ,25,106,131,1073,4175,5248
00132000,UNIVERSITY OF CALIFORNIA-SANTA BARB     ,CA,93106-3180,Public       ,448,155,603,45765,7420,53185
00132100,UNIVERSITY OF CALIFORNIA-SANTA CRUZ     ,CA,95064-0001,Public       ,263,120,383,29446,4612,34058
00132200,UNIVERSITY OF REDLANDS                  ,CA,92373-0999,Private      ,35,296,331,4331,2979,7310
00132500,UNIVERSITY OF SAN FRANCISCO             ,CA,94117-1080,Private      ,143,274,417,9245,8724,17969
00132600,SANTA CLARA UNIVERSITY                  ,CA,95053-4956,Private      ,70,156,226,9773,5199,14972
00132604,JESUIT SCHOOL OF THEOLOGY - BERKELEY    ,CA,94709-1193,Private      ,0,0,0,0,44,44
00132800,UNIVERSITY OF SOUTHERN CALIFORNIA       ,CA,90089-0914,Private      ,330,799,1129,31898,26724,58622
00132900,UNIVERSITY OF THE PACIFIC               ,CA,95211-0197,Private      ,120,66,186,11569,3373,14942
00132901,UNIVERSITY OF THE PACIFIC - MCGEORGE SCH,CA,95817-2799,Private      ,4,13,17,123,2329,2452
00132902,UNIV OF THE PACIFIC SCH OF DENT         ,CA,94115-0000,Private      ,0,2,2,39,588,627
00133400,VENTURA COLLEGE                         ,CA,93003-3899,Public       ,222,342,564,5201,5127,10328
00133500,VICTOR VALLEY COLLEGE                   ,CA,92395-5849,Public       ,474,1048,1522,6442,11854,18296
00133800,WEST VALLEY COLLEGE                     ,CA,95070-5697,Public       ,179,261,440,2624,3086,5710
00134100,WESTMONT COLLEGE                        ,CA,93108-1099,Private      ,29,7,36,2320,110,2430
00134200,WHITTIER COLLEGE                        ,CA,90601-4413,Private      ,43,24,67,3024,486,3510
00134201,WHITTIER COLLEGE - COLLEGE OF LAW       ,CA,92626-1501,Private      ,0,8,8,21,1509,1530
00134300,WOODBURY UNIVERSITY                     ,CA,91510-7846,Private      ,18,32,50,1087,988,2075
00134400,YUBA COLLEGE                            ,CA,95901-7699,Public       ,207,461,668,3312,5369,8681
00134401,YUBA COLLEGE - WOODLAND COLLEGE - YOLO C,CA,95776-9327,Public       ,0,0,0,715,780,1495
00177212,TRINITY INTERNATIONAL UNIV-CA           ,CA,92705-0000,Private      ,0,7,7,5,248,253
00274100,AMERICAN JEWISH UNIVERSITY              ,CA,90077-1599,Private      ,3,3,6,106,167,273
00301002,ANTIOCH UNIV/LOS ANGELES                ,CA,90230-7615,Private      ,2,65,67,74,1163,1237
00301003,ANTIOCH  UNIV/SANTA BARBARA             ,CA,93101-0000,Private      ,13,25,38,499,605,1104
00369110,MIDDLEBURY COLLEGE - MONTEREY INSTITUTE ,CA,93940-2691,Private      ,2,16,18,27,920,947
00394700,UC-HASTINGS COLLEGE OF THE LAW          ,CA,94102-0000,Public       ,0,23,23,22,4006,4028
00394800,SAN FRANCISCO ART INSTITUTE             ,CA,94133-2299,Private      ,41,41,82,1585,1081,2666
00405500,HEBREW UNION COLLEGE - JEWISH INSTITUTE ,CA,90007-3796,Private      ,0,0,0,2,89,91
00408000,STARR KING SCHOOL FOR THE MINISTRY      ,CA,94709-1299,Private      ,1,1,2,1,75,76
00448000,DE ANZA COLLEGE                         ,CA,95014-5793,Public       ,362,618,980,7379,6503,13882
00448100,OHLONE COLLEGE                          ,CA,94539-5847,Public       ,171,224,395,2901,2817,5718
00448101,OHLONE COLLEGE - NEWARK CENTER FOR HEALT,CA,94560-4902,Public       ,0,0,0,181,184,365
00448400,JOHN F. KENNEDY UNIVERSITY              ,CA,94523-4817,Private      ,4,116,120,45,1790,1835
00449000,PATTEN UNIVERSITY                       ,CA,94601-2699,Private      ,11,49,60,278,532,810
00449400,EVEREST COLLEGE                         ,CA,92408-3752,Proprietary  ,60,164,224,551,1305,1856
00450200,CITY COLLEGE OF SAN FRANCISCO           ,CA,94112-0000,Public       ,504,1395,1899,9570,15529,25099
00450302,EVEREST COLLEGE - SANTA ANA             ,CA,92701-4559,Proprietary  ,42,74,116,127,287,414
00563800,DOWNEY ADULT SCHOOL                     ,CA,90241-5610,Public       ,22,70,92,117,446,563
00565500,HACIENDA LA PUENTE ADULT EDUC CTR       ,CA,91746-0000,Public       ,18,105,123,158,609,767
00616500,LA CNTY CLG OF NURSING & ALLD HLTH      ,CA,90033-1018,Public       ,2,26,28,95,483,578
00672000,COLLEGE OF ALAMEDA                      ,CA,94501-2109,Public       ,119,282,401,2138,3264,5402
00673100,CASA LOMA COLLEGE                       ,CA,91405-4523,Private      ,23,81,104,252,711,963
00686300,VENTURA COUNTY CMTY CLG DISTRICT        ,CA,93010-8552,Public       ,0,0,0,34,34,68
00697300,CANADA COLLEGE                          ,CA,94061-1099,Public       ,74,217,291,1080,1900,2980
00697500,LINCOLN UNIVERSITY                      ,CA,94612-2801,Private      ,1,10,11,26,130,156
00701200,SAMUEL MERRITT COLLEGE                  ,CA,94609-3108,Private      ,11,86,97,391,2501,2892
00704700,LOS ANGELES SOUTHWEST COLLEGE           ,CA,90047-4810,Public       ,171,751,922,2910,7013,9923
00705000,BAY VISTA COLLEGE OF BEAUTY             ,CA,91950-3616,Proprietary  ,10,33,43,97,216,313
00711500,MOORPARK COLLEGE                        ,CA,93021-1695,Public       ,198,267,465,4087,3431,7518
00713000,NEWBERRY SCHOOLS OF BEAUTY              ,CA,91344-7404,Proprietary  ,16,22,38,68,115,183
00714200,LYLE'S COLLEGE OF BEAUTY                ,CA,93710-3948,Proprietary  ,3,26,29,117,213,330
00714201,LYLE'S CLG OF BTY BAKERSFIELD           ,CA,93301-0000,Proprietary  ,0,0,0,61,77,138
00716400,BRYAN COLLEGE                           ,CA,90057-0000,Proprietary  ,28,201,229,233,1618,1851
00717801,WESTERN SEMINARY - BAY AREA CENTER      ,CA,95032-0000,Private      ,0,0,0,2,20,22
00717804,WESTERN SEMINARY - SACRAMENTO           ,CA,95821-3939,Private      ,0,0,0,15,51,66
00718700,NORTH ADRIAN'S COLLEGE OF BEAUTY        ,CA,95350-2381,Proprietary  ,17,22,39,184,271,455
00719000,WYOTECH                                 ,CA,94539-7663,Proprietary  ,114,293,407,1032,2098,3130
00720300,SALON SUCCESS ACADEMY                   ,CA,91786-4060,Proprietary  ,15,17,32,117,136,253
00720400,MODERN BEAUTY ACADEMY                   ,CA,93030-7016,Proprietary  ,6,6,12,63,52,115
00722900,WESTERN BEAUTY INSTITUTE                ,CA,91402-3104,Proprietary  ,44,124,168,299,634,933
00723400,HEALD COLLEGE                           ,CA,94105-2206,Proprietary  ,82,286,368,852,2361,3213
00723600,ART INST OF CALIFORNIA-LOS ANGELES      ,CA,90405-3035,Proprietary  ,355,478,833,7118,5863,12981
00725300,FEDERICO BEAUTY INSTITUTE               ,CA,95834-1905,Proprietary  ,26,48,74,268,390,658
00729600,COLEMAN COLLEGE                         ,CA,92123-0000,Private      ,24,102,126,259,951,1210
00732909,ITT TECHNICAL INSTITUTE                 ,CA,92868-3506,Proprietary  ,147,332,479,977,2494,3471
00732971,ITT TECHNICAL INSTITUTE                 ,CA,95670-6047,Proprietary  ,100,289,389,860,2415,3275
00732976,ITT TECHNICAL INSTITUTE                 ,CA,92408-3519,Proprietary  ,124,331,455,1320,2748,4068
00732981,ITT TECHNICAL INSTITUTE                 ,CA,92123-2662,Proprietary  ,100,334,434,1051,2929,3980
00732985,ITT TECHNICAL INSTITUTE                 ,CA,91773-2933,Proprietary  ,130,209,339,1011,2035,3046
00732989,ITT TECHNICAL INSTITUTE                 ,CA,90502-1356,Proprietary  ,76,295,371,904,2761,3665
00732994,ITT TECHNICAL INSTITUTE                 ,CA,91342-3664,Proprietary  ,113,284,397,969,2170,3139
00746501,AMERICAN ACADEMY OF DRAMATIC ARTS - HOLL,CA,90028-7504,Private      ,14,9,23,340,173,513
00747600,MARINELLO SCHOOLS OF BEAUTY             ,CA,90023-2666,Proprietary  ,196,379,575,1193,2265,3458
00747602,MARINELLO SCHOOLS OF BEAUTY - SPA ACADEM,CA,90048-5101,Proprietary  ,3,7,10,67,81,148
00747603,MARINELLO SCHOOLS OF BEAUTY - INGLEWOOD ,CA,90301-2306,Proprietary  ,2,3,5,15,21,36
00747604,MARINELLO SCHOOLS OF BEAUTY - RESEDA    ,CA,91335-4218,Proprietary  ,0,5,5,18,27,45
00747605,MARINELLO SCHOOLS OF BEAUTY - NORTH HOLL,CA,91606-3210,Proprietary  ,2,7,9,38,49,87
00747606,MARINELLO SCHOOLS OF BEAUTY - WEST COVIN,CA,91790-2805,Proprietary  ,1,7,8,25,43,68
00747607,MARINELLO SCHOOLS OF BEAUTY - SAN BERNAR,CA,92410-3261,Proprietary  ,4,9,13,99,80,179
00747608,MARINELLO SCHOOLS OF BEAUTY - ONTARIO   ,CA,91762-2113,Proprietary  ,1,16,17,94,107,201
00747609,MARINELLO SCHOOLS OF BEAUTY - WHITTIER  ,CA,90601-4107,Proprietary  ,3,3,6,49,30,79
00747611,MARINELLO SCHOOLS OF BEAUTY - SAN DIEGO ,CA,92126-4217,Proprietary  ,6,23,29,117,164,281
00747700,"HEALD COLLEGE,SCHOOLS OF BUS & TECH     ",CA,95670-6005,Proprietary  ,50,263,313,612,2137,2749
00753100,ACADEMY OF ART UNIVERSITY               ,CA,94105-3410,Proprietary  ,338,796,1134,8332,13857,22189
00753600,COSUMNES RIVER COLLEGE                  ,CA,95823-5799,Public       ,292,548,840,7138,9103,16241
00754802,WESTWOOD COLLEGE OF TECHNOLOGY          ,CA,92801-0000,Proprietary  ,48,56,104,1304,888,2192
00754803,WESTWOOD COLLEGE OF TECHNOLOGY          ,CA,91786-0000,Proprietary  ,55,64,119,1243,1033,2276
00760600,EVEREST COLLEGE                         ,CA,90010-2221,Proprietary  ,26,75,101,405,729,1134
00760700,CONCORDE CAREER INSTITUTE               ,CA,91606-3134,Proprietary  ,45,73,118,400,890,1290
00770700,COLUMBIA COLLEGE                        ,CA,95370-8580,Public       ,43,87,130,1049,1488,2537
00771300,SKYLINE COLLEGE                         ,CA,94066-1698,Public       ,166,279,445,2988,3234,6222
00793000,CONCORDE CAREER INSTITUTE               ,CA,92108-0000,Proprietary  ,35,122,157,336,1130,1466
00799300,CALIF STATE UNIV BAKERSFIELD            ,CA,93311-1022,Public       ,117,271,388,7465,6609,14074
00807100,CONCORDE CAREER INSTITUTE               ,CA,92840-9201,Proprietary  ,41,115,156,442,975,1417
00807300,BUTTE COMMUNITY COLLEGE                 ,CA,95965-0000,Public       ,258,497,755,6703,8818,15521
00809000,EVEREST COLLEGE                         ,CA,91803-1310,Proprietary  ,58,248,306,430,908,1338
00809300,HEALD COLLEGE                           ,CA,93704-1706,Proprietary  ,111,346,457,1367,3058,4425
00853200,HEALD COLLEGE                           ,CA,94545-2352,Proprietary  ,80,286,366,1150,2711,3861
00853202,HEALD COLLEGE - MODESTO                 ,CA,95368-9095,Proprietary  ,62,150,212,223,592,815
00853700,CONCORDE CAREER INSTITUTE               ,CA,92401-0000,Proprietary  ,45,172,217,535,1491,2026
00859600,WEST LOS ANGELES COLLEGE                ,CA,90230-3500,Public       ,255,660,915,3354,6585,9939
00859700,FEATHER RIVER COLLEGE                   ,CA,95971-9124,Public       ,21,58,79,769,662,1431
00884400,CALIFORNIA CHRISTIAN COLLEGE            ,CA,93703-3599,Private      ,1,10,11,77,110,187
00884600,WRIGHT INSTITUTE                        ,CA,94704-0000,Private      ,0,3,3,1,502,503
00890300,COLLEGE OF THE CANYONS                  ,CA,91355-1899,Public       ,420,493,913,5457,4553,10010
00891800,SADDLEBACK COLLEGE                      ,CA,92692-3699,Public       ,209,458,667,4238,5659,9897
00902200,ASSOCIATED TECHNICAL COLLEGE            ,CA,90017-0000,Proprietary  ,29,150,179,273,991,1264
00903200,EMPIRE COLLEGE                          ,CA,95403-2122,Proprietary  ,35,98,133,207,617,824
00915706,WYOMING TECHNICAL INSTITUTE - WEST SACRA,CA,95605-1507,Proprietary  ,80,191,271,1153,1746,2899
00927200,CRAFTON HILLS COLLEGE                   ,CA,92399-1799,Public       ,119,208,327,3159,3623,6782
00932500,ABRAM FRIEDMAN OCCUP CTR                ,CA,90015-3507,Public       ,5,41,46,114,318,432
00950900,SKILLS & BUSINESS EDUCATION CENTER      ,CA,95824-1529,Public       ,28,181,209,319,1384,1703
00974800,CARRINGTON COLLEGE CALIFORNIA           ,CA,95826-3203,Proprietary  ,96,314,410,1066,3012,4078
00974801,CARRINGTON COLLEGE CALIFORNIA - SAN LEAN,CA,94578-3711,Proprietary  ,33,101,134,470,1116,1586
00974802,CARRINGTON COLLEGE CALIFORNIA - PLEASANT,CA,94523-1984,Proprietary  ,30,79,109,295,645,940
00974803,CARRINGTON COLLEGE CALIFORNIA - STOCKTON,CA,95207-5509,Proprietary  ,43,99,142,481,804,1285
00974804,CARRINGTON COLLEGE CALIFORNIA - CITRUS H,CA,95621-5577,Proprietary  ,36,128,164,396,1021,1417
00974806,CARRINGTON COLLEGE CALIFORNIA -  ANTIOCH,CA,94531-1604,Proprietary  ,26,81,107,246,692,938
00974807,CARRINGTON COLLEGE CALIFORNIA - SAN JOSE,CA,95119-1325,Proprietary  ,55,139,194,632,1372,2004
00974808,CARRINGTON COLLEGE CALIFORNIA - EMERYVIL,CA,94608-3006,Proprietary  ,28,59,87,144,426,570
00974809,WESTERN CAREER COLLEGE -  EMERYVILLE SHE,CA,94608-3006,Proprietary  ,1,5,6,5,12,17
00974810,CARRINGTON COLLEGE CALIFORNIA - CONCORD ,CA,94520-5671,Proprietary  ,0,0,0,21,37,58
00998900,SANTA BARBARA BUSINESS COLLEGE          ,CA,93111-0000,Proprietary  ,23,74,97,278,680,958
01011100,CERRO-COSO COMMUNITY COLLEGE            ,CA,93555-9571,Public       ,41,189,230,772,2208,2980
01014225,TOURO CLG OSEOPATHIC MEDICINE           ,CA,94592-1115,Private      ,0,0,0,11,593,604
01014900,PEPPERDINE UNIVERSITY                   ,CA,90263-0000,Private      ,83,190,273,7709,7482,15191
01034000,LOS MEDANOS COLLEGE                     ,CA,94565-5197,Public       ,247,482,729,3237,4830,8067
01036500,CHARLES R DREW UNIV OF MED & SCI        ,CA,90059-0000,Private      ,2,62,64,124,633,757
01036800,MENNONITE BRETHREN BIBLICAL SEM         ,CA,93727-0000,Private      ,0,1,1,1,40,41
01039500,UNIVERSITY OF SAN DIEGO                 ,CA,92110-2492,Private      ,222,202,424,14386,5414,19800
01039501,UNIVERSITY OF SAN DIEGO - SCHOOL OF LAW ,CA,92110-2492,Private      ,15,48,63,625,3947,4572
01044100,PARDEE RAND GRADUATE SCHOOL             ,CA,90407-2138,Private      ,0,4,4,5,41,46
01047400,MARYMOUNT COLLEGE OF PALOS VERDES       ,CA,90275-0000,Private      ,21,2,23,1221,96,1317
01072706,DEVRY INST. TECH.                       ,CA,91768-0000,Proprietary  ,0,0,0,301,377,678
01083200,WESTERN STATE UNIV COLLEGE OF LAW       ,CA,92831-3014,Proprietary  ,1,12,13,12,1167,1179
01085400,THOMAS JEFFERSON SCHOOL OF LAW          ,CA,92110-0000,Private      ,2,48,50,27,2362,2389
01102400,EVEREST COLLEGE                         ,CA,94103-2091,Proprietary  ,37,82,119,255,675,930
01110700,EVEREST  COLLEGE                        ,CA,92801-5231,Proprietary  ,64,123,187,609,1138,1747
01110900,EVEREST COLLEGE                         ,CA,91335-4631,Proprietary  ,79,271,350,536,1218,1754
01111200,FIDM-FASHION INSTITUTE OF DESIGN        ,CA,90015-1421,Proprietary  ,201,159,360,6843,2676,9519
01111700,ALLIANT INTERNATIONAL UNIVERSITY        ,CA,92131-1799,Private      ,10,91,101,156,2950,3106
01111705,ALLIANT INTERNATIONAL UNIVERSITY - LOS A,CA,91803-1360,Private      ,0,11,11,13,617,630
01111706,ALLIANT INTERNATIONAL UNIVERSITY - SAN F,CA,94133-1221,Private      ,0,23,23,39,826,865
01111707,ALLIANT INTERNATIONAL UNIVERSITY - FRESN,CA,93727-2014,Private      ,0,28,28,57,566,623
01112100,EVEREST COLLEGE                         ,CA,94541-4007,Proprietary  ,16,73,89,198,706,904
01112300,EVEREST COLLEGE                         ,CA,90247-4163,Proprietary  ,38,117,155,429,1106,1535
01146000,NATIONAL UNIVERSITY                     ,CA,92037-1011,Private      ,70,2331,2401,710,17477,18187
01162600,PRACTICAL SCHOOLS                       ,CA,92805-0000,Proprietary  ,27,60,87,487,944,1431
01164900,LOYOLA MARYMOUNT UNIVERSITY             ,CA,90045-0000,Private      ,101,87,188,10889,3662,14551
01164901,LMU  - LOYOLA LAW SCHOOL                ,CA,90015-0019,Private      ,2,34,36,475,3946,4421
01167200,MENDOCINO COLLEGE                       ,CA,95482-3000,Public       ,79,257,336,1196,2110,3306
01169600,NATIONAL POLYTECHNIC COLLEGE OF SCIENCE ,CA,90744-6399,Private      ,0,0,0,30,143,173
01170700,NORTH-WEST COLLEGE                      ,CA,91790-2097,Proprietary  ,48,79,127,283,493,776
01179200,FRANCISCAN SCHOOL OF THEOLOGY           ,CA,94709-0000,Private      ,0,2,2,4,40,44
01182000,SAN DIEGO MIRAMAR COLLEGE               ,CA,92126-0000,Public       ,178,471,649,3539,5445,8984
01186500,CALIFORNIA HAIR DESIGN ACADEMY          ,CA,92115-0000,Proprietary  ,19,41,60,174,251,425
01186600,LU ROSS ACADEMY                         ,CA,93001-2927,Proprietary  ,33,31,64,137,191,328
01202600,JE BOUTIQUE COLLEGE OF BEAUTY           ,CA,92021-6247,Proprietary  ,9,23,32,64,150,214
01202700,GALEN COLLEGE OF CALIFORNIA             ,CA,93728-2381,Proprietary  ,7,22,29,88,159,247
01203100,SAN DIEGO CHRISTIAN COLLEGE             ,CA,92019-1157,Private      ,58,236,294,698,525,1223
01206100,EVEREST COLLEGE                         ,CA,95128-3908,Proprietary  ,32,78,110,307,723,1030
01215400,CALIFORNIA INSTITUTE OF INTEGRAL STUDIES,CA,94103-2557,Private      ,0,36,36,35,1698,1733
01231600,MANCHESTER BEAUTY COLLEGE               ,CA,93726-5306,Proprietary  ,10,36,46,159,325,484
01231700,TULARE BEAUTY COLLEGE                   ,CA,93274-3432,Proprietary  ,3,7,10,35,85,120
01244600,UNIVERSAL COLLEGE OF BEAUTY             ,CA,90044-0044,Proprietary  ,6,11,17,75,119,194
01245200,EVERGREEN VALLEY COLLEGE                ,CA,95135-1598,Public       ,188,311,499,4545,4744,9289
01255000,LOS ANGELES MISSION COLLEGE             ,CA,91342-3200,Public       ,298,483,781,4057,4774,8831
01265000,MARINELLO SCHOOL OF BEAUTY              ,CA,91502-2828,Proprietary  ,37,72,109,199,448,647
01265100,MARINELLO SCHOOL OF BEAUTY              ,CA,91748-1674,Proprietary  ,12,29,41,61,155,216
01284200,OXNARD COLLEGE                          ,CA,93030-0000,Public       ,114,280,394,2970,3871,6841
01287200,NORTH-WEST COLLEGE                      ,CA,91768-3199,Proprietary  ,21,59,80,214,505,719
01287300,WYOTECH                                 ,CA,90810-3800,Proprietary  ,131,266,397,1111,1999,3110
01287301,WYOTECH - EVEREST  COLLEGE              ,CA,90034-3158,Proprietary  ,22,106,128,221,781,1002
01287302,WYOTECH - EVEREST  COLLEGE              ,CA,91746-3412,Proprietary  ,80,154,234,630,1116,1746
01290700,LAKE TAHOE COMMUNITY COLLEGE            ,CA,96150-4524,Public       ,31,123,154,685,1051,1736
01291100,MARINELLO SCHOOL OF BEAUTY              ,CA,92646-2552,Proprietary  ,17,29,46,90,159,249
01291200,MTI COLLEGE                             ,CA,95841-0000,Proprietary  ,47,207,254,556,1771,2327
01294200,ROSEMEAD BEAUTY SCHOOL                  ,CA,91770-1639,Proprietary  ,4,41,45,46,320,366
01298400,PROFESSIONAL INSTITUTE OF BEAUTY        ,CA,91731-2613,Proprietary  ,12,27,39,52,145,197
01298500,HAIR CALIFORNIA BEAUTY ACADEMY          ,CA,92867-7127,Proprietary  ,7,8,15,49,78,127
01298900,OCEANSIDE COLLEGE OF BEAUTY             ,CA,92054-5393,Proprietary  ,6,27,33,94,155,249
01301000,LANCASTER BEAUTY SCHOOL                 ,CA,93534-3098,Proprietary  ,14,38,52,116,263,379
01307400,AMERICAN BEAUTY COLLEGE                 ,CA,91790-2906,Proprietary  ,5,8,13,72,81,153
01309500,SALON SUCCESS ACADEMY                   ,CA,92879-6561,Proprietary  ,34,43,77,185,229,414
01310300,CALIFORNIA WESTERN SCHOOL OF LAW        ,CA,92101-0000,Private      ,4,28,32,111,2366,2477
01324000,LYTLE'S REDWOOD EMPIRE BEAUTY CLG       ,CA,95403-0000,Proprietary  ,12,29,41,146,223,369
02054900,MARINELLO SCHOOL OF BEAUTY              ,CA,92630-0000,Proprietary  ,14,26,40,75,140,215
02059800,PARIS BEAUTY COLLEGE                    ,CA,94520-2611,Proprietary  ,11,39,50,77,220,297
02063500,COASTLINE COMMUNITY COLLEGE             ,CA,92708-0000,Public       ,49,501,550,1316,5439,6755
02064300,SIERRA COLLEGE OF BEAUTY                ,CA,95340-0000,Proprietary  ,13,28,41,93,158,251
02065700,CALIFORNIA BEAUTY COLLEGE               ,CA,95354-0000,Proprietary  ,8,28,36,146,197,343
02070500,CONCORDIA UNIVERSITY                    ,CA,92612-0000,Private      ,23,249,272,2239,2088,4327
02075800,SOUTHERN CA INST OF ARCHITECTURE        ,CA,90013-0000,Private      ,5,8,13,176,617,793
02086400,MARINELLO SCHOOL OF BEAUTY              ,CA,95050-0000,Proprietary  ,67,112,179,352,712,1064
02091200,ELEGANCE INTERNATIONAL                  ,CA,90028-0000,Proprietary  ,13,20,33,151,192,343
02091700,KAPLAN COLLEGE                          ,CA,92123-1509,Proprietary  ,51,213,264,737,2360,3097
02091702,KAPLAN COLLEGE - CHULA VISTA            ,CA,91910-5342,Proprietary  ,21,51,72,198,320,518
02096100,FIELDING GRADUATE UNIVERSITY            ,CA,93105-0000,Private      ,0,42,42,10,1456,1466
02099200,AMERICAN CONSERVATORY THEATER           ,CA,94108-0000,Private      ,1,7,8,54,210,264
02110200,COLUMBIA COLLEGE                        ,CA,91356-0000,Private      ,11,12,23,362,193,555
02110800,CALIFORNIA COLLEGE SAN DIEGO            ,CA,92108-3821,Proprietary  ,79,273,352,1303,2536,3839
02111300,CUYAMACA COLLEGE                        ,CA,92019-0000,Public       ,159,329,488,3556,5846,9402
02113601,AMERICAN INTERCONTINENTAL UNIV - LOS ANG,CA,90066-7008,Proprietary  ,0,1,1,45,195,240
02119100,MISSION COLLEGE                         ,CA,95054-1897,Public       ,141,408,549,2717,4731,7448
02120600,SAYBROOK GRADUATE SCHOOL                ,CA,94111-1920,Private      ,0,28,28,2,727,729
02120700,SAN JOAQUIN VALLEY COLLEGE              ,CA,93291-0000,Proprietary  ,264,833,1097,3191,7534,10725
02125000,CAREER ACADEMY OF BEAUTY                ,CA,92845-0000,Proprietary  ,15,29,44,87,163,250
02128200,"VICTOR VALLEY BEAUTY COLLEGE, INC       ",CA,92392-0000,Proprietary  ,18,24,42,142,240,382
02128300,INSTITUTE FOR BUSINESS & TECHNOLOGY     ,CA,95050-0000,Proprietary  ,41,222,263,154,1000,1154
02128301,INSTITUTE FOR BUSINESS & TECHNOLOGY - NA,CA,95670-6351,Proprietary  ,20,111,131,87,644,731
02138300,PALO ALTO UNIVERSITY                    ,CA,94304-1337,Private      ,0,3,3,41,700,741
02147400,CLEVELAND CHIROPRACTIC COLLEGE          ,CA,90004-0000,Private      ,3,10,13,49,356,405
02161800,MUSICIANS INSTITUTE                     ,CA,90028-6157,Proprietary  ,114,106,220,1711,1374,3085
02167800,ESTES INSTITUTE OF COSMETOLOGY          ,CA,93291-0000,Proprietary  ,16,10,26,137,148,285
02174600,MARINELLO SCHOOL OF BEAUTY              ,CA,90201-0000,Proprietary  ,15,27,42,109,159,268
02180600,BRIDGES  ACADEMY OF BEAUTY              ,CA,92311-2327,Proprietary  ,0,2,2,19,39,58
02184900,PALMER COLLEGE OF CHIROPRACTIC WEST     ,CA,95134-0000,Private      ,1,8,9,20,388,408
02185800,MOLER BARBER COLLEGE                    ,CA,94611-0000,Proprietary  ,5,9,14,47,99,146
02187500,"HEALD COLLEGE, SCH OF BUS & TECH        ",CA,94520-0000,Proprietary  ,117,335,452,1054,2528,3582
02188400,SIERRA VALLEY COLLEGE OF COURT REPORTING,CA,93726-0000,Proprietary  ,5,23,28,83,224,307
02208600,MADERA BEAUTY COLLEGE                   ,CA,93637-3519,Proprietary  ,4,17,21,72,119,191
02211000,SALON SUCCESS ACADEMY                   ,CA,92405-0000,Proprietary  ,3,9,12,62,79,141
02220000,COLLEEN O'HARA BEAUTY ACADEMY           ,CA,92701-0000,Proprietary  ,21,30,51,145,247,392
02220200,CALIFORNIA CULINARY ACADEMY             ,CA,94102-3336,Proprietary  ,48,122,170,812,1157,1969
02221300,MARINELLO SCHOOL OF BEAUTY              ,CA,92553-0000,Proprietary  ,24,35,59,218,414,632
02222000,AMERICAN FILM INSTITUTE                 ,CA,90027-0000,Private      ,15,32,47,268,764,1032
02226000,EAST LOS ANGELES COLLEGE                ,CA,91754-0000,Public       ,794,1120,1914,12762,11534,24296
02228500,LIFE CHIROPRACTIC COLLEGE WEST          ,CA,94545-0000,Private      ,0,16,16,12,417,429
02230900,FREDRICK & CHARLES BEAUTY COLLEGE       ,CA,95501-0000,Proprietary  ,5,11,16,62,90,152
02231900,GEMOLOGICAL INSTITUTE OF AMERICA        ,CA,92008-4698,Private      ,4,18,22,64,317,381
02234300,FASHION CAREERS OF CALIFORNIA           ,CA,92110-0000,Proprietary  ,6,16,22,203,178,381
02236400,"THANH LE COLG, SCH OF COSMETOLOGY       ",CA,92840-0000,Proprietary  ,1,10,11,8,62,70
02237200,PHILLIPS GRADUATE INSTITUTE             ,CA,91316-0000,Private      ,0,14,14,1,295,296
02241600,SAN DIEGO CONTINUING EDUCATION          ,CA,92113-0000,Public       ,5,106,111,146,711,857
02241800,AMERICAN CAREER COLLEGE                 ,CA,90004-0000,Proprietary  ,267,568,835,2090,4148,6238
02242700,BERKELEY CITY COLLEGE                   ,CA,94704-0000,Public       ,139,335,474,2456,3573,6029
02250602,EVEREST COLLEGE                         ,CA,91761-8525,Proprietary  ,36,111,147,488,1583,2071
02255400,INTERNATIONAL SCHOOL OF COSMETOLOGY     ,CA,90250-0000,Proprietary  ,25,38,63,115,178,293
02255600,MARINELLO SCHOOL OF BEAUTY              ,CA,90723-0000,Proprietary  ,9,23,32,114,201,315
02258600,ALAMEDA BEAUTY COLLEGE                  ,CA,94501-0000,Proprietary  ,17,34,51,187,310,497
02262400,YESHIVA OHR ELCHONON CHABAD             ,CA,90046-0000,Private      ,15,0,15,62,2,64
02263101,ANTHEM COLLEGE - SACRAMENTO             ,CA,95827-3378,Proprietary  ,2,22,24,37,130,167
02267600,INSTITUTE OF TRANSPERSONAL PSYCHLGY     ,CA,94303-4624,Private      ,0,14,14,4,520,524
02270600,LIFE PACIFIC COLLEGE                    ,CA,91773-0000,Private      ,3,13,16,334,242,576
02276800,WESTMINSTER SEMINARY CALIFORNIA         ,CA,92027-0000,Private      ,0,3,3,3,168,171
02277400,SOUTH COAST COLLEGE                     ,CA,92868-2616,Proprietary  ,9,45,54,157,505,662
02282300,ALHAMBRA BEAUTY COLLEGE                 ,CA,91802-0000,Proprietary  ,8,26,34,59,194,253
02285100,HILLTOP BEAUTY SCHOOL                   ,CA,94014-0000,Proprietary  ,7,17,24,50,190,240
02298000,DESIGN INSTITUTE OF SAN DIEGO           ,CA,92121-0000,Proprietary  ,3,15,18,201,302,503
02304300,"PLATT COLLEGE, SAN DIEGO                ",CA,92115-0000,Proprietary  ,11,47,58,243,467,710
02306300,KAPLAN COLLEGE                          ,CA,95368-0000,Proprietary  ,35,109,144,590,1067,1657
02306302,KAPLAN COLLEGE - FRESNO                 ,CA,93612-3802,Proprietary  ,25,60,85,347,732,1079
02309500,CLOVIS ADULT EDUC                       ,CA,93611-0000,Public       ,6,28,34,53,394,447
02312400,LA COLLEGE INTERNATIONAL                ,CA,90010-0000,Proprietary  ,12,190,202,165,2201,2366
02327600,ART INSTITUTE OF CALIFORNIA - SAN DIEGO ,CA,92108-4401,Proprietary  ,217,386,603,4072,3992,8064
02330500,LAGUNA COLLEGE OF ART AND DESIGN        ,CA,92651-0000,Private      ,18,10,28,470,217,687
02332800,CENTER FOR EMPLOYMENT TRAINING          ,CA,95110-0000,Private      ,149,692,841,667,2892,3559
02338500,GLENDALE CAREER COLLEGE                 ,CA,91203-1207,Proprietary  ,20,79,99,209,506,715
02338700,MARINELLO SCHOOL OF BEAUTY              ,CA,94103-0000,Proprietary  ,40,74,114,229,476,705
02342400,ACADEMY OF RADIO BROADCASTING           ,CA,92647-3809,Proprietary  ,11,57,68,110,383,493
02343400,"BELLUS ACADEMY, THE ACADEMY OF BEAUTY AN",CA,92064-4633,Proprietary  ,39,79,118,191,463,654
02345800,MONTEBELLO BEAUTY COLLEGE               ,CA,90640-0000,Proprietary  ,6,16,22,53,83,136
02351900,KAPLAN COLLEGE                          ,CA,95660-5512,Proprietary  ,38,137,175,478,1378,1856
02351901,KAPLAN COLLEGE - BAKERSFIELD            ,CA,93304-0000,Proprietary  ,43,118,161,627,1216,1843
02358000,THOMAS AQUINAS COLLEGE                  ,CA,93060-9622,Private      ,3,2,5,345,25,370
02359300,SHASTA BIBLE COLLEGE                    ,CA,96002-0000,Private      ,2,4,6,52,79,131
02482700,WESTERN UNIVERSITY OF HEALTH S          ,CA,91766-1854,Private      ,5,39,44,108,4501,4609
02494800,LOLA BEAUTY COLLEGE                     ,CA,92641-0000,Proprietary  ,8,8,16,25,38,63
02497300,TRINITY COLLEGE                         ,CA,93277-8109,Proprietary  ,30,157,187,256,967,1223
02500000,SAN JOAQUIN COLLEGE OF LAW              ,CA,93612-0000,Private      ,0,5,5,20,329,349
02518400,THE NATIONAL HISPANIC UNIVERSITY        ,CA,95127-0000,Proprietary  ,9,56,65,371,565,936
02519800,AVANCE BEAUTY COLLEGE                   ,CA,92154-0000,Proprietary  ,6,17,23,101,176,277
02520200,CALIFORNIA CAREER SCHOOLS               ,CA,92805-0000,Proprietary  ,5,32,37,55,198,253
02520300,INTERIOR DESIGNERS INSTITUTE            ,CA,92660-0000,Proprietary  ,5,29,34,40,174,214
02520400,ADRIAN'S BEAUTY COLLEGE OF TURLOCK      ,CA,95382-0000,Proprietary  ,16,26,42,148,201,349
02537200,PALOMAR INSTITUTE OF COSMETOLOGY        ,CA,92069-0000,Proprietary  ,14,40,54,154,259,413
02539100,KAPLAN COLLEGE                          ,CA,91606-3231,Proprietary  ,58,120,178,616,1486,2102
02539102,KAPLAN COLLEGE -  RIVERSIDE             ,CA,92507-4223,Proprietary  ,29,71,100,517,1113,1630
02539500,IRVINE VALLEY COLLEGE                   ,CA,92620-0000,Public       ,166,287,453,3865,3690,7555
02542300,NATIONAL HOLISTIC INSTITUTE             ,CA,94608-0000,Proprietary  ,30,116,146,230,808,1038
02543400,BROWNSON TECHNICAL SCHOOL               ,CA,92805-0000,Proprietary  ,3,55,58,58,229,287
02545900,HYPNOSIS MOTIVATION INSTITUTE           ,CA,91356-0000,Private      ,0,34,34,4,167,171
02546400,MTI BUSINESS COLLEGE INC                ,CA,95207-0000,Proprietary  ,4,36,40,51,223,274
02549000,KAPLAN COLLEGE                          ,CA,92083-7736,Proprietary  ,63,163,226,629,1490,2119
02549005,KAPLAN COLLEGE -  PALM SPRINGS          ,CA,92262-7011,Proprietary  ,28,50,78,426,783,1209
02553500,ASSOCIATED TECHNICAL COLLEGE            ,CA,92101-0000,Proprietary  ,11,74,85,128,397,525
02553600,DIVERSIFIED LANGUAGE INSTITUTE          ,CA,90017-0000,Proprietary  ,15,206,221,73,891,964
02559300,UNITED EDUCATION INSTITUTE              ,CA,90020-0000,Proprietary  ,1011,2287,3298,4912,10557,15469
02559301,UNITED EDUCATION INSTITUTE - SAN BERNARD,CA,92408-3740,Proprietary  ,0,0,0,35,67,102
02559303,UNITED EDUCATION INSTITUTE - SAN DIEGO  ,CA,92123-1949,Proprietary  ,0,0,0,59,134,193
02559304,UNITED EDUCATION INSTITUTE - ONTARIO    ,CA,91764-5574,Proprietary  ,0,0,0,32,54,86
02559305,UNITED EDUCATION INSTITUTE  - VAN NUYS  ,CA,91405-1951,Proprietary  ,0,0,0,20,22,42
02559400,INTERCOAST COLLEGES                     ,CA,92868-1656,Proprietary  ,53,559,612,384,3352,3736
02565400,KAPLAN COLLEGE                          ,CA,95207-6216,Proprietary  ,25,83,108,420,867,1287
02570300,LOS ANGELES ORT COLLEGE                 ,CA,90048-0000,Private      ,41,139,180,193,922,1115
02577900,SANTA BARBARA BUSINESS COLLEGE          ,CA,93309-1664,Proprietary  ,45,136,181,630,1418,2048
02578000,SANTA BARBARA BUSINESS COLLEGE          ,CA,93454-6943,Proprietary  ,21,52,73,241,538,779
02584200,NEWBRIDGE COLLEGE                       ,CA,92701-0000,Proprietary  ,45,108,153,246,679,925
02591600,NORTH-WEST COLLEGE                      ,CA,91101-1744,Proprietary  ,11,21,32,82,217,299
02593100,HEALD COLLEGE                           ,CA,95678-5303,Proprietary  ,82,312,394,747,2417,3164
02593200,HEALD COLLEGE                           ,CA,95035-8008,Proprietary  ,91,291,382,873,2321,3194
02593300,HEALD COLLEGE                           ,CA,95210-5667,Proprietary  ,118,381,499,1308,3352,4660
02595600,ASIAN AMERICAN INTERNATIONAL BTY CG     ,CA,92683-4043,Proprietary  ,5,26,31,27,95,122
02597300,SOUTH BAYLO UNIVERSITY                  ,CA,92801-1701,Private      ,0,21,21,4,262,266
02602300,CENTRAL COAST COLLEGE                   ,CA,93901-3301,Proprietary  ,23,46,69,248,489,737
02608900,PINNACLE COLLEGE                        ,CA,91803-8842,Proprietary  ,15,15,30,95,110,205
02608901,PINNACLE COLLEGE - SACRAMENTO           ,CA,95670-6386,Proprietary  ,10,25,35,76,182,258
02609000,EMPERORS COLG OF TRAD ORIENTAL MED      ,CA,90403-5609,Proprietary  ,0,12,12,18,212,230
02612800,LOS ANGELES RECORDING SCHOOL            ,CA,90028-3112,Proprietary  ,36,45,81,461,447,908
02619300,SAMRA UNIV OF ORIENTAL MEDICINE         ,CA,90015-1019,Private      ,0,0,0,5,43,48
03010611,VIRGINIA COLLEGE - GOLF ACADEMY OF AMERI,CA,92008-6512,Proprietary  ,5,24,29,99,307,406
03011300,"CALIF STATE UNIV, SAN MARCOS            ",CA,92096-0001,Public       ,170,244,414,11183,6335,17518
03019900,CAPSTONE COLLEGE                        ,CA,91402-4924,Proprietary  ,5,18,23,42,110,152
03025600,DELL'ARTE SCH OF PHYSICAL THEATRE       ,CA,95525-0816,Private      ,0,0,0,6,47,53
03027700,PACIFIC COLLEGE OF ORIENTAL MED         ,CA,92108-4408,Proprietary  ,7,32,39,54,675,729
03029600,POMONA ADULT SCHOOL                     ,CA,91766-0000,Public       ,14,45,59,101,287,388
03031409,INTERNATIONAL ACADEMY OF DESIGN AND TECH,CA,95834-9664,Proprietary  ,22,55,77,415,753,1168
03034000,HEALD COLLEGE                           ,CA,93906-5100,Proprietary  ,83,232,315,1010,1882,2892
03035700,LAS POSITAS COLLEGE                     ,CA,94551-6750,Public       ,130,210,340,2381,2635,5016
03039900,FREMONT COLLEGE                         ,CA,90703-5342,Proprietary  ,18,43,61,261,507,768
03043900,NEWSCHOOL OF ARCHITECTURE & DESIGN      ,CA,92101-6634,Proprietary  ,14,13,27,347,681,1028
03044500,KAPLAN COLLEGE                          ,CA,91402-4222,Proprietary  ,18,46,64,149,355,504
03054100,ROYALE COLLEGE OF BEAUTY                ,CA,92590-2525,Proprietary  ,7,12,19,74,90,164
03062300,WESTECH COLLEGE                         ,CA,91764-4988,Proprietary  ,29,144,173,193,793,986
03062400,MT DIABLO ADULT EDUC LOMA VISTA CTR     ,CA,94518-1122,Public       ,1,25,26,79,213,292
03062700,PLATT COLLEGE                           ,CA,90041-0000,Proprietary  ,9,35,44,197,264,461
03062701,PLATT COLLEGE                           ,CA,91764-0000,Proprietary  ,28,68,96,333,540,873
03063400,MODERN TECHNOLOGY SCHOOL                ,CA,92708-9821,Proprietary  ,10,32,42,81,225,306
03067400,BALDWIN PARK ADULT SCHOOL               ,CA,91706-4897,Public       ,29,91,120,161,420,581
03067500,INSTITUTE OF TECHNOLOGY                 ,CA,93612-3217,Proprietary  ,199,756,955,1282,4123,5405
03067505,INSTITUTE OF TECHNOLOGY - REDDING       ,CA,96002-0926,Proprietary  ,0,0,0,62,181,243
03069500,SAGE COLLEGE                            ,CA,92557-6720,Proprietary  ,19,63,82,176,755,931
03072300,EVEREST COLLEGE                         ,CA,91761-3222,Proprietary  ,68,129,197,538,1136,1674
03072700,WESTWOOD COLLEGE - LOS ANGELES          ,CA,90010-1577,Proprietary  ,131,367,498,2259,7573,9832
03074900,MARTINEZ ADULT CENTER                   ,CA,94553-3298,Public       ,1,18,19,7,100,107
03078200,AMERICAN CLG TRADITIONAL CHINESE MD     ,CA,94107-2813,Private      ,1,17,18,9,325,334
03084700,VENTURA ADULT\CONTINUING EDUCATION      ,CA,93003-7313,Public       ,12,46,58,58,237,295
03094400,ELITE PROGRESSIVE SCHOOL OF COSM        ,CA,95841-2909,Proprietary  ,41,75,116,336,627,963
03097700,CENTRAL CALIF SCH CONTINUING EDUC       ,CA,93401-6739,Proprietary  ,3,34,37,56,293,349
03098200,YO SAN UNIV TRADITIONAL CHINESE MED     ,CA,90066-1103,Private      ,1,11,12,6,186,192
03108100,SUMMIT CAREER COLLEGE                   ,CA,92324-3956,Proprietary  ,59,243,302,469,1578,2047
03109500,DONGGUK  UNIVERSITY LOS ANGELES         ,CA,90020-1765,Private      ,1,9,10,8,117,125
03113300,UEI COLLEGE                             ,CA,93727-1620,Proprietary  ,66,218,284,200,595,795
03113600,SOUTHERN CALIFORNIA INST OF TECHNOL     ,CA,92805-3758,Proprietary  ,22,151,173,132,1092,1224
03116600,EAST SAN GABRIEL VLY REG OCCUP PROG     ,CA,91790-2105,Public       ,36,213,249,142,745,887
03125300,JOHN WESLEY INTER. BARBER & BTY CLG     ,CA,90813-4321,Proprietary  ,8,6,14,66,103,169
03125400,ART INSTITUTE OF CALIFORNIA-HOLLYWOOD (T,CA,91601-3112,Proprietary  ,181,191,372,3148,2508,5656
03125800,PREMIERE CAREER COLLEGE                 ,CA,91706-3746,Proprietary  ,21,56,77,190,434,624
03126800,PACIFICA GRADUATE INSTITUTE             ,CA,93013-0000,Proprietary  ,0,37,37,3,1027,1030
03128700,MT SIERRA COLLEGE                       ,CA,91016-3414,Proprietary  ,22,39,61,305,523,828
03131300,FIVE BRANCHES UNIVERSITY                ,CA,95062-4669,Private      ,1,21,22,44,423,467
03144400,AMERICAN CLG OF HEALTH PROFESSIONS      ,CA,92505-3038,Proprietary  ,26,128,154,175,546,721
03150500,VIRGINIA SEWING MACHINES & SCH CTR      ,CA,90015-3535,Proprietary  ,3,35,38,9,124,133
03162300,FOUR-D SUCCESS ACADEMY                  ,CA,92324-4218,Proprietary  ,35,155,190,254,1062,1316
03163300,PACIFIC STATES UNIVERSITY               ,CA,90006-4298,Private      ,0,2,2,28,44,72
03195400,EVEREST COLLEGE                         ,CA,90501-2867,Proprietary  ,14,35,49,169,334,503
03210300,LE CORDON BLEU COLLEGE OF CULINARY ARTS ,CA,91101-5221,Proprietary  ,286,1022,1308,2790,6905,9695
03225300,AMERICAN UNIVERSITY OF HEALTH SCIENCES  ,CA,90755-3612,Proprietary  ,8,20,28,85,213,298
03242300,CAREER NETWORK INSTITUTE                ,CA,92868-4710,Proprietary  ,36,111,147,183,733,916
03250300,COMMUNITY BASED EDUCATION AND DEVEL     ,CA,90036-1137,Private      ,4,14,18,66,215,281
03260300,CALIFORNIA STATE U-MONTEREY BAY         ,CA,93955-8001,Public       ,110,103,213,8174,2882,11056
03266300,BETHESDA UNIVERSITY OF CALIFORNIA       ,CA,92801-4132,Private      ,2,11,13,25,94,119
03278300,CLARITA CAREER COLLEGE                  ,CA,91351-5432,Proprietary  ,132,320,452,850,1868,2718
03282300,KIM ANH ACADEMY OF BEAUTY               ,CA,92683-4605,Proprietary  ,0,0,0,10,110,120
03288300,ACAD CHINESE CULTURE & HEALTH SCIS      ,CA,94512-0000,Private      ,0,11,11,27,195,222
03299300,PACIFIC COLLEGE                         ,CA,92626-3160,Proprietary  ,12,68,80,93,583,676
03308300,KENSINGTON COLLEGE                      ,CA,92705-8708,Proprietary  ,0,7,7,5,64,69
03321300,SCRIPPS RESEARCH INSTITUTE (THE)        ,CA,92037-0000,Private      ,0,0,0,12,41,53
03327400,ACUPUNCTURE AND INTEGRATIVE MEDICINE COL,CA,94704-2724,Private      ,1,22,23,57,284,341
03332300,SOUTHERN CA BIBLE CLG & SEMINARY        ,CA,92019-1109,Private      ,0,10,10,13,185,198
03359300,ST. FRANCIS CAREER COLLEGE              ,CA,90262-2659,Private      ,5,23,28,83,274,357
03367300,PROFESSIONAL GOLFERS CAREER COLLEGE     ,CA,92591-6013,Proprietary  ,10,27,37,262,428,690
03394300,REMINGTON COLLEGE - SAN DIEGO CAMPUS    ,CA,92108-3002,Proprietary  ,0,0,0,192,360,552
03395300,INTERNATIONAL CAREER DEVELOPMENT        ,CA,90027-5794,Proprietary  ,226,1245,1471,1068,5537,6605
03399300,NORTHWESTERN TECHNICAL COLLEGE          ,CA,95670-4443,Proprietary  ,20,71,91,181,695,876
03403300,TRINITY LIFE BIBLE COLLEGE              ,CA,95842-3546,Private      ,1,44,45,97,446,543
03413400,ENGLISH CENTER  (THE)                   ,CA,94607-3734,Private      ,11,37,48,42,287,329
03427400,CAREER COLLEGES OF AMERICA              ,CA,90280-7420,Proprietary  ,85,290,375,577,2170,2747
03427500,ANTELOPE VALLEY MEDICAL COLLEGE         ,CA,93534-3324,Proprietary  ,57,136,193,549,1046,1595
03440400,MARIAN HEALTH CAREERS CENTER            ,CA,90010-1728,Proprietary  ,16,37,53,99,206,305
03441400,VALLEY CAREER COLLEGE                   ,CA,92020-3057,Proprietary  ,19,67,86,139,535,674
03458300,MY LE'S BEAUTY COLLEGE                  ,CA,95824-3039,Proprietary  ,3,38,41,101,253,354
03467300,MARINELLO SCHOOL OF BEAUTY              ,CA,92545-3661,Proprietary  ,31,70,101,216,491,707
03467301,CALIFORNIA BEAUTY COLLEGE - DESERT HOT S,CA,92240-1307,Proprietary  ,0,0,0,12,14,26
03479300,PROFESSIONAL CAREER INSTITUTE           ,CA,90703-2522,Proprietary  ,6,15,21,87,159,246
03485400,JAMES ALBERT SCHOOL OF COSMETOLOGY      ,CA,92627-3831,Proprietary  ,17,50,67,142,206,348
03485401,JAMES ALBERT SCHOOL OF COSMETOLOGY - ANA,CA,92804-5384,Proprietary  ,0,0,0,15,16,31
03516300,KING'S UNIVERSITY (THE)                 ,CA,91405-2233,Private      ,5,30,35,89,377,466
03532400,ADVANCED TRAINING ASSOCIATES            ,CA,92020-1236,Proprietary  ,10,18,28,27,123,150
03542400,COPPER MOUNTAIN COLLEGE                 ,CA,92252-6102,Public       ,23,113,136,758,2151,2909
03577300,COBA ACADEMY                            ,CA,92866-1407,Proprietary  ,13,7,20,78,84,162
03590400,NTMA TRAINING CENTERS OF SOUTHERN C     ,CA,90650-6099,Private      ,39,168,207,142,587,729
03592400,IRELL & MANELLA GRADUATE SCHOOL OF BIOLO,CA,91010-0000,Private      ,0,1,1,0,9,9
03598300,AVALON BEAUTY COLLEGE                   ,CA,93103-3137,Proprietary  ,16,11,27,112,121,233
03614300,UNITED BEAUTY COLLEGE                   ,CA,91733-0000,Proprietary  ,2,18,20,11,104,115
03621300,LIBERTY TRAINING INSTITUTE              ,CA,90057-3202,Proprietary  ,0,0,0,1,0,1
03639300,WEST COAST ULTRASOUND INSTITUTE         ,CA,90211-3312,Proprietary  ,32,139,171,360,1568,1928
03646300,DESIGN'S SCHOOL OF COSMETOLOGY          ,CA,93446-1471,Proprietary  ,14,30,44,92,185,277
03681300,CALIFORNIA HEALING ARTS COLLEGE         ,CA,90025-2589,Proprietary  ,9,42,51,67,226,293
03695300,COMMUNITY ENHANCEMENT SERVICES          ,CA,91502-2750,Private      ,1,11,12,17,141,158
03695700,SANTIAGO CANYON COLLEGE                 ,CA,92869-4512,Public       ,150,189,339,2557,1894,4451
03696300,UNIVERSITY OF THE WEST                  ,CA,91770-3709,Private      ,1,4,5,12,63,75
03698300,WEST COAST UNIVERSITY                   ,CA,91606-3206,Proprietary  ,155,347,502,1464,2928,4392
03698400,CA COLLEGE OF VOCATIONAL CAREER         ,CA,93301-1800,Proprietary  ,8,53,61,126,446,572
03736300,ADVANCE BEAUTY COLLEGE                  ,CA,92843-4752,Proprietary  ,12,106,118,79,554,633
03740400,ATI COLLEGE                             ,CA,90650-0000,Proprietary  ,9,42,51,108,306,414
03759300,COMPUTER TUTOR BUSINESS & TECH INST     ,CA,95356-0000,Proprietary  ,6,33,39,79,247,326
03786300,ADVANCED COLLEGE                        ,CA,90280-5255,Proprietary  ,19,62,81,120,469,589
03797400,CAREER CARE INSTITUTE                   ,CA,93534-4766,Proprietary  ,33,91,124,384,860,1244
03797401,CAREER CARE INSTITUTE - VENTURA         ,CA,93003-0000,Proprietary  ,0,4,4,24,98,122
03797402,CAREER CARE INSTITUTE - MORENO VALLEY   ,CA,92553-7519,Proprietary  ,3,13,16,8,41,49
03814400,SOKA UNIVERSITY OF AMERICA              ,CA,92656-8081,Private      ,3,4,7,513,38,551
03838400,WALTER JAY M.D. INSTITUTE AN EDUCATIONAL,CA,90057-0000,Proprietary  ,0,0,0,2,11,13
03852500,CIT COLLEGE OF INFOMEDICAL TECHNOLOGY   ,CA,92831-3703,Proprietary  ,34,126,160,190,802,992
03852501,CIT COLLEGE OF INFOMEDICAL TECHNOLOGY - ,CA,90010-1308,Proprietary  ,0,0,0,22,29,51
03853300,KECK GRADUATE INSTITUTE OF APPLIED LIFE ,CA,91711-4817,Private      ,0,2,2,1,105,106
03853400,LADERA CAREER PATHS TRAINING CENTERS    ,CA,90045-1931,Proprietary  ,0,10,10,6,46,52
03868300,WORLD MISSION UNIVERSITY                ,CA,90020-1789,Private      ,2,6,8,12,80,92
03868400,LOS ANGELES MUSIC ACADEMY               ,CA,91105-2540,Proprietary  ,10,10,20,112,100,212
03871300,FOLSOM LAKE COLLEGE                     ,CA,95630-6798,Public       ,132,279,411,2672,3732,6404
03874300,CAMBRIDGE JUNIOR COLLEGE                ,CA,95993-0000,Proprietary  ,17,68,85,165,367,532
03874400,COMMMUNITY CHRISTIAN COLLEGE            ,CA,92373-4465,Private      ,7,13,20,152,158,310
03889300,STANBRIDGE COLLEGE                      ,CA,92612-0000,Proprietary  ,34,102,136,211,766,977
03901300,PACIFIC COAST TRADE SCHOOL              ,CA,93033-2441,Proprietary  ,14,37,51,79,238,317
03910400,NATIONAL POLYTECHNIC COLLEGE            ,CA,90040-3066,Proprietary  ,17,41,58,105,263,368
03933300,MUELLER COLLEGE OF HOLISTIC STUDIES     ,CA,92116-2630,Proprietary  ,8,54,62,53,397,450
03933301,MUELLER COLLEGE OF HOLISTIC STUDIES -   ,CA,92120-3449,Proprietary  ,0,0,0,3,35,38
03935300,CALIFORNIA NURSES EDUCATIONAL INSTITUTE ,CA,92234-7248,Proprietary  ,3,19,22,73,191,264
03962300,AMERICAN INSTITUTE OF MASSAGE THERAPY   ,CA,92705-5463,Proprietary  ,3,13,16,45,89,134
03964400,INTERNATIONAL SCHOOL OF BEAUTY          ,CA,92260-2740,Proprietary  ,18,52,70,130,297,427
03969600,AMERICAN AUTO INSTITUTE                 ,CA,90703-2637,Proprietary  ,147,320,467,325,587,912
03971300,AMERICAN CAREER COLLEGE                 ,CA,91764-4906,Proprietary  ,129,274,403,1057,2095,3152
03973300,EX'PRESSION COLLEGE FOR DIGTAL ARTS     ,CA,94608-1021,Proprietary  ,43,62,105,807,772,1579
03974500,CALIFORNIA CAREER COLLEGE               ,CA,91303-2006,Proprietary  ,12,46,58,67,202,269
03980300,CALIFORNIA STATE UNIVERSITY CHANNEL ISLA,CA,93012-8599,Public       ,80,82,162,4651,2257,6908
03995300,UNIVERSITY OF EAST-WEST MEDICINE        ,CA,94087-6106,Proprietary  ,1,4,5,10,71,81
03999300,BEAUMONT ADULT SCHOOL                   ,CA,92223-1927,Public       ,4,23,27,43,198,241
04001300,PALACE BEAUTY COLLEGE                   ,CA,90006-4233,Proprietary  ,11,28,39,62,159,221
04001400,MOJAVE BARBER COLLEGE                   ,CA,92395-3201,Proprietary  ,7,23,30,32,119,151
04003300,CSI CAREER COLLEGE                      ,CA,95687-3100,Proprietary  ,31,88,119,181,601,782
04004300,THUY PRINCESS BEAUTY COLLEGE            ,CA,91766-0000,Proprietary  ,2,17,19,26,116,142
04005300,INTERAMERICAN COLLEGE                   ,CA,91950-4437,Proprietary  ,4,37,41,29,358,387
04014400,PALLADIUM TECHNICAL ACADEMY             ,CA,91731-2429,Proprietary  ,11,30,41,37,91,128
04023400,PROTEUS                                 ,CA,93291-3014,Private      ,1,4,5,23,41,64
04037300,LOS ANGELES FILM SCHOOL (THE)           ,CA,90028-7300,Proprietary  ,192,234,426,1540,1780,3320
04049300,MAXINE WATERS EMPLOYMENT PREPARATION CEN,CA,90059-1023,Public       ,5,21,26,39,142,181
04056300,CAREER COLLEGE OF CALIFORNIA            ,CA,92705-5805,Proprietary  ,14,62,76,67,252,319
04057300,TECHSKILLS OF CALIFORNIA                ,CA,95815-4025,Proprietary  ,16,136,152,114,772,886
04076400,GNOMON SCHOOL OF VISUAL EFFECTS         ,CA,90038-2616,Proprietary  ,7,21,28,85,246,331
04092300,COASTLINE BEAUTY COLLEGE                ,CA,92708-3847,Proprietary  ,6,32,38,29,243,272
04092400,MAKE-UP DESIGNORY                       ,CA,91502-1322,Proprietary  ,36,40,76,364,395,759
04100400,TAFT UNIVERSITY SYSTEM (THE)            ,CA,92704-6954,Proprietary  ,0,47,47,2,475,477
04109300,ACADEMY OF BARBERING ARTS (THE)         ,CA,91324-3406,Proprietary  ,13,35,48,114,233,347
04111300,WEST HILLS COLLEGE LEMOORE              ,CA,93245-9248,Public       ,41,196,237,1622,2707,4329
04114500,VALLEY COLLEGE OF MEDICAL CAREERS       ,CA,91304-2354,Proprietary  ,6,25,31,83,282,365
04115300,COACHELLA VALLEY BEAUTY COLLEGE         ,CA,92253-2051,Proprietary  ,2,12,14,47,101,148
04115600,MAYFIELD COLLEGE                        ,CA,92234-7014,Proprietary  ,18,80,98,123,473,596
04116000,VIDEO SYMPHONY ENTERTRAINING            ,CA,91502-3253,Proprietary  ,19,54,73,90,405,495
04118800,NEW YORK FILM ACADEMY                   ,CA,91608-1002,Proprietary  ,32,41,73,180,300,480
04119200,CAREER COLLEGE CONSULTANTS              ,CA,90041-2088,Proprietary  ,9,35,44,46,157,203
04126400,CHAMPION INSTITUTE OF COSMETOLOGY       ,CA,92264-7458,Proprietary  ,1,7,8,34,76,110
04126500,COAST CAREER INSTITUTE                  ,CA,90015-3040,Proprietary  ,51,172,223,212,786,998
04127100,"UNIVERSITY OF CALIFORNIA, MERCED        ",CA,95343-5001,Public       ,104,38,142,10171,1461,11632
04127800,HEALTHY HAIR ACADEMY                    ,CA,90303-3137,Proprietary  ,9,27,36,48,161,209
04127900,TUI UNIVERSITY                          ,CA,90630-5023,Proprietary  ,6,405,411,38,2676,2714
04129700,INTERNATIONAL POLYTECHNIC INSTITUTE     ,CA,92231-1737,Private      ,13,22,35,30,107,137
04132300,INSTITUTE OF MEDICAL EDUCATION          ,CA,95113-2207,Proprietary  ,26,116,142,202,979,1181
04132400,ACADEMY OF ESTHETICS AND COSMETOLOGY    ,CA,91342-3373,Proprietary  ,7,13,20,68,108,176
04132700,INFOTECH CAREER COLLEGE                 ,CA,90706-5579,Proprietary  ,21,77,98,97,384,481
04133000,BIOHEALTH COLLEGE                       ,CA,95134-2033,Proprietary  ,5,52,57,65,285,350
04134500,CAREER COLLEGE OF SAN DIEGO             ,CA,92102-3348,Proprietary  ,10,69,79,165,466,631
04134700,INTERNATL PROFESSIONAL SCHL OF BODYWORK ,CA,92123-1520,Proprietary  ,3,17,20,35,263,298
04137200,BORNER'S BARBER COLLEGE                 ,CA,90047-3856,Proprietary  ,1,7,8,33,61,94
04138700,CAO INSTITUTE OF AESTHETICS (THE)       ,CA,91801-3903,Proprietary  ,15,27,42,71,121,192
04140500,HORIZON COLLEGE SAN DIEGO               ,CA,92131-9906,Private      ,2,13,15,30,90,120
04140600,MODERN INSTITUTE OF TECHNOLOGY          ,CA,93036-1387,Proprietary  ,1,19,20,10,51,61
04141300,SAN FRANCISCO INSTITUTE OF ESTHETICS    ,CA,94103-4083,Proprietary  ,28,29,57,157,263,420
04141400,LAURUS COLLEGE                          ,CA,93401-5405,Proprietary  ,14,92,106,91,435,526
04141700,HEALING HANDS SCHOOL OF HOLISTIC HEALTH ,CA,92025-1722,Proprietary  ,2,23,25,23,160,183
04142500,TOURO COLLEGE LOS ANGELES               ,CA,90046-4506,Private      ,3,5,8,29,22,51
04142600,TOURO UNIVERSITY                        ,CA,94592-1118,Private      ,1,34,35,14,1708,1722
04143800,WOODLAND COMMUNITY COLLEGE              ,CA,95776-5156,Public       ,60,139,199,288,592,880
04144200,CAREER DEVELOPMENT INSTITUTE            ,CA,90035-4364,Proprietary  ,0,5,5,34,98,132
04145000,SAN DIEGO CULINARY INSTITUTE            ,CA,91941-6435,Proprietary  ,15,50,65,203,356,559
04145600,INTERNATIONAL COLLEGE OF COSMETOLOGY    ,CA,94601-3525,Proprietary  ,8,49,57,12,74,86
04146000,NATIONAL CAREER COLLEGE                 ,CA,91605-1400,Proprietary  ,4,8,12,27,54,81
04148200,BEYOND 21ST CENTURY BEAUTY ACADEMY      ,CA,90670-6316,Proprietary  ,2,2,4,23,38,61
04148900,N CALIF INSTITUTE OF COSMETOLOGY        ,CA,94577-2820,Proprietary  ,0,8,8,5,58,63
04149700,HOMESTEAD SCHOOLS                       ,CA,90505-5945,Private      ,16,43,59,71,217,288
04150000,CENTRAL NURSING COLLEGE                 ,CA,90010-2444,Proprietary  ,6,28,34,189,318,507
04150100,GOLDEN STATE COLLEGE OF COURT REPORTING ,CA,94568-2948,Proprietary  ,2,4,6,8,42,50
04150300,RWM FIBER OPTICS                        ,CA,90746-1051,Proprietary  ,3,13,16,8,59,67
04150500,"PREFERRED COLLEGE OF NURSING, LOS ANGELE",CA,90010-2202,Proprietary  ,13,21,34,49,165,214
04152800,CALIFORNIA ACADEMY (THE) - A PAUL MITCHE,CA,95825-2276,Proprietary  ,22,55,77,305,480,785
04153900,PROVIDENCE CHRISTIAN COLLEGE            ,CA,91104-2635,Private      ,0,4,4,49,19,68
04154300,AMERICANA COLLEGE                       ,CA,90029-3765,Proprietary  ,3,10,13,8,25,33
04154400,FRANKLIN CAREER COLLEGE                 ,CA,91761-1522,Proprietary  ,10,10,20,56,178,234
04155500,"ACADEMY FOR JEWISH RELIGION, CALIFORNIA ",CA,90024-3234,Private      ,2,8,10,19,84,103
04156100,DIOR SCHOOL OF COSMETOLOGY              ,CA,95355-9695,Proprietary  ,10,33,43,16,51,67
04158200,PAUL MITCHELL THE SCHOOL SHERMAN OAKS   ,CA,91403-5882,Proprietary  ,9,52,61,214,253,467
04158700,HOLLYWOOD BEAUTY COLLEGE                ,CA,95210-3514,Proprietary  ,13,42,55,120,313,433
04159700,AMERICAN MEDICAL SCIENCES CENTER        ,CA,91204-5108,Proprietary  ,11,22,33,28,69,97
04160100,TRINITY VOCATIONAL CENTER               ,CA,90248-4334,Proprietary  ,6,20,26,36,135,171
04160400,ANGELES COLLEGE OF NURSING              ,CA,90010-2100,Proprietary  ,13,47,60,190,338,528
04161700,SHASTA SCHOOL OF COSMETOLOGY            ,CA,96003-0000,Proprietary  ,5,18,23,45,112,157
04161800,BRANDMAN UNIVERSITY                     ,CA,92618-3801,Private      ,27,581,608,75,1546,1621
04162800,S.I.C.E PAUL MITCHELL PARTNER SCHOOL    ,CA,95350-1440,Proprietary  ,29,42,71,100,132,232
04163400,COSMO BEAUTY ACADEMY                    ,CA,95605-1904,Proprietary  ,9,31,40,48,163,211
04163900,L.A. BARBER COLLEGE                     ,CA,90013-1121,Proprietary  ,5,17,22,33,79,112
04164400,ANGELES INSTITUTE                       ,CA,90712-2903,Proprietary  ,9,13,22,52,131,183
04165900,PAUL MITCHELL THE SCHOOL FRESNO         ,CA,93710-7617,Proprietary  ,19,28,47,87,86,173
04167000,ESTHETIQUES COSMETOLOGY INSTITUTE       ,CA,92591-4663,Proprietary  ,20,26,46,182,214,396
04169200,TRAMY BEAUTY SCHOOL                     ,CA,92115-6347,Proprietary  ,8,83,91,14,110,124
04169700,UNITEK COLLEGE                          ,CA,94538-3185,Proprietary  ,21,138,159,150,654,804
04169800,GURNICK ACADEMY OF MEDICAL ARTS         ,CA,94403-1849,Proprietary  ,8,71,79,117,694,811
04172000,SOUTHERN CALIFORNIA UNIVERSITY SOMA     ,CA,90017-2211,Proprietary  ,4,11,15,16,41,57
04173400,SANTA ANA BEAUTY ACADEMY                ,CA,92705-7820,Proprietary  ,3,4,7,5,19,24
04175200,PAUL MITCHELL THE SCHOOL EAST BAY       ,CA,94523-5515,Proprietary  ,17,37,54,96,119,215
04175400,ELITE COSMETOLOGY SCHOOL                ,CA,92284-2860,Proprietary  ,1,23,24,7,44,51
04176200,TWIN RIVERS ADULT SCHOOL                ,CA,95660-5523,Public       ,4,63,67,4,63,67
04176300,BERGIN UNIVERSITY OF CANINE STUDIES     ,CA,95407-6834,Private      ,0,0,0,3,13,16
04177200,REAL BARBERS COLLEGE (THE)              ,CA,92805-2533,Proprietary  ,8,10,18,13,19,32
04178900,HANDS-ON MEDICAL MASSAGE SCHOOL         ,CA,92373-6271,Proprietary  ,3,11,14,3,11,14
04180000,CINTA AVEDA INSTITUTE                   ,CA,94108-3204,Proprietary  ,14,39,53,47,111,158
04181200,IPPT CAREER SCHOOL                      ,CA,91601-2028,Proprietary  ,1,6,7,1,6,7
04185200,SALINAS BEAUTY COLLEGE                  ,CA,93901-2405,Proprietary  ,1,6,7,1,6,7
04189800,ACADEMY FOR SALON PROFESSIONALS         ,CA,91304-2305,Proprietary  ,0,2,2,0,2,2
00184600,BRIAR CLIFF UNIVERSITY                  ,IA,51104-2100,Private      ,9,10,19,1220,513,1733
00184700,BUENA VISTA UNIVERSITY                  ,IA,50588-9987,Private      ,11,94,105,1837,2048,3885
00184800,SOUTHEASTERN COMMUNITY COLLEGE          ,IA,52655-0000,Public       ,50,146,196,1290,2507,3797
00185000,CENTRAL COLLEGE                         ,IA,50219-1999,Private      ,15,6,21,2485,148,2633
00185200,CLARKE UNIVERSITY                       ,IA,52001-3198,Private      ,4,20,24,1026,581,1607
00185400,COE COLLEGE                             ,IA,52402-5092,Private      ,8,5,13,2024,244,2268
00185500,DES MOINES UNIV-OSTEOPATHIC MED CTR     ,IA,50312-0000,Private      ,0,26,26,34,1837,1871
00185600,CORNELL COLLEGE                         ,IA,52314-1098,Private      ,8,1,9,2000,93,2093
00185700,SOUTHWESTERN COMMUNITY COLLEGE          ,IA,50801-1098,Public       ,14,36,50,699,893,1592
00185800,DIVINE WORD COLLEGE                     ,IA,52045-0380,Private      ,0,1,1,16,18,34
00185900,DORDT COLLEGE                           ,IA,51250-1697,Private      ,5,4,9,1496,99,1595
00186000,DRAKE UNIVERSITY                        ,IA,50311-4505,Private      ,26,68,94,4720,2526,7246
00186200,ELLSWORTH COMMUNITY COLLEGE             ,IA,50126-1199,Public       ,4,24,28,819,419,1238
00186400,IOWA LAKES COMMUNITY COLLEGE            ,IA,51334-2234,Public       ,31,83,114,1389,1628,3017
00186500,IOWA CENTRAL COMMUNITY COLLEGE          ,IA,50501-0000,Public       ,83,291,374,2685,3227,5912
00186600,GRACELAND UNIVERSITY                    ,IA,50140-1699,Private      ,10,94,104,1071,1437,2508
00186700,GRAND VIEW UNIVERSITY                   ,IA,50316-1599,Private      ,21,62,83,1816,1419,3235
00186800,GRINNELL COLLEGE                        ,IA,50112-1690,Private      ,19,1,20,2283,59,2342
00186900,IOWA STATE UNIV SCIENCE & TECHNOLOG     ,IA,50011-2028,Public       ,160,162,322,21865,6113,27978
00187100,IOWA WESLEYAN COLLEGE                   ,IA,52641-1398,Private      ,3,12,15,764,453,1217
00187300,LORAS COLLEGE                           ,IA,52004-0178,Private      ,11,2,13,2259,193,2452
00187400,LUTHER COLLEGE                          ,IA,52101-1045,Private      ,17,3,20,3336,90,3426
00187500,MARSHALLTOWN COMMUNITY COLLEGE          ,IA,50158-4760,Public       ,21,74,95,727,1180,1907
00187700,NORTH IOWA AREA COMMUNITY COLLEGE       ,IA,50401-7299,Public       ,40,102,142,1567,1574,3141
00187900,MORNINGSIDE COLLEGE                     ,IA,51106-1751,Private      ,11,41,52,1738,627,2365
00188000,MOUNT MERCY UNIVERSITY                  ,IA,52402-4797,Private      ,5,41,46,1004,995,1999
00188100,ASHFORD UNIVERSITY                      ,IA,52732-3910,Proprietary  ,559,16808,17367,3798,112718,116516
00188300,NORTHWESTERN COLLEGE                    ,IA,51041-1996,Private      ,3,5,8,1589,118,1707
00188700,SIMPSON COLLEGE                         ,IA,50125-1297,Private      ,8,30,38,2174,640,2814
00188900,ST AMBROSE UNIVERSITY                   ,IA,52803-2898,Private      ,18,47,65,2880,1417,4297
00189000,UNIVERSITY OF NORTHERN IOWA             ,IA,50614-0002,Public       ,68,95,163,10834,3293,14127
00189100,UNIVERSITY OF DUBUQUE                   ,IA,52001-5099,Private      ,7,33,40,1887,744,2631
00189200,UNIVERSITY OF IOWA                      ,IA,52242-1316,Public       ,162,242,404,19526,10585,30111
00189300,UPPER IOWA UNIVERSITY                   ,IA,52142-9206,Private      ,19,313,332,1482,5582,7064
00189500,WALDORF COLLEGE                         ,IA,50436-1700,Proprietary  ,7,26,33,804,217,1021
00189600,WARTBURG COLLEGE                        ,IA,50677-2200,Private      ,3,2,5,2490,99,2589
00189700,WARTBURG THEOLOGICAL SEMINARY           ,IA,52004-5004,Private      ,0,0,0,8,131,139
00190000,WILLIAM PENN UNIVERSITY                 ,IA,52577-1799,Private      ,9,90,99,1214,1390,2604
00396300,AIB COLLEGE OF BUSINESS                 ,IA,50321-1799,Private      ,12,51,63,620,806,1426
00407500,ESTRN IOWA COMMUNITY COLLEGE DIST       ,IA,52801-1221,Public       ,5,30,35,112,314,426
00407501,CLINTON COMMUNITY COLLEGE               ,IA,52732-0000,Public       ,30,75,105,477,1018,1495
00407502,MUSCATINE COMMUNITY COLLEGE             ,IA,52761-0000,Public       ,22,54,76,551,810,1361
00407503,SCOTT COMMUNITY COLLEGE                 ,IA,52722-0000,Public       ,56,250,306,1577,3788,5365
00407600,KIRKWOOD COMMUNITY COLLEGE              ,IA,52406-2068,Public       ,187,594,781,8155,10313,18468
00423300,MERCY/ST. LUKE'S SCH RAD TECH           ,IA,52402-0000,Private      ,0,1,1,19,38,57
00458600,KAPLAN UNIVERSITY                       ,IA,52807-2095,Proprietary  ,612,8632,9244,6275,116161,122436
00458604,KAPLAN UNIVERSITY - CEDAR RAPIDS        ,IA,52404-2998,Proprietary  ,11,153,164,225,2159,2384
00458605,KAPLAN UNIVERSITY - DES MOINES          ,IA,50323-5702,Proprietary  ,20,170,190,349,2608,2957
00458606,KAPLAN UNIVERSITY - MASON CITY          ,IA,50401-4665,Proprietary  ,5,73,78,104,1060,1164
00458607,KAPLAN UNIVERSITY - CEDAR FALLS         ,IA,50613-6309,Proprietary  ,9,107,116,233,1862,2095
00458610,KAPLAN UNIVERSITY - COUNCIL BLUFFS      ,IA,51503-5289,Proprietary  ,6,79,85,94,1015,1109
00458700,NORTHEAST IOWA COMMUNITY COLLEGE        ,IA,52132-0400,Public       ,13,41,54,730,981,1711
00458701,NORTHEAST IOWA COMMUNITY COLLEGE        ,IA,52068-0000,Public       ,29,79,108,1221,1732,2953
00459500,HAWKEYE COMMUNITY COLLEGE               ,IA,50701-0000,Public       ,76,218,294,3533,3538,7071
00459800,IOWA WESTERN CMTY CLG-COUNCIL BLUFF     ,IA,51502-0000,Public       ,88,197,285,3338,3491,6829
00460000,NORTHWEST IOWA COMMUNITY COLLEGE        ,IA,51201-1046,Public       ,7,27,34,572,557,1129
00626700,IOWA METHODIST MEDICAL CENTER SCHOOLS   ,IA,50309-1499,Private      ,0,3,3,29,97,126
00627300,MERCY COLLEGE OF HEALTH SCIENCES        ,IA,50309-1239,Private      ,19,40,59,494,1066,1560
00712000,DES MOINES AREA CMTY COLLEGE            ,IA,50021-0000,Public       ,197,804,1001,7265,12823,20088
00712100,FAITH BAPTIST BIBLE CLG & THEOL SEM     ,IA,50021-0000,Private      ,4,5,9,330,76,406
00729100,ST LUKE'S COLLEGE                       ,IA,51104-0263,Private      ,1,2,3,99,164,263
00731600,WESTERN IOWA TECH COMMUNITY COLLEGE     ,IA,51106-0000,Public       ,67,280,347,1989,3830,5819
00758800,CAPRI COLLEGE                           ,IA,52004-0873,Proprietary  ,8,25,33,109,170,279
00761100,EQ SCHOOL OF HAIR DESIGN                ,IA,51503-0813,Proprietary  ,3,8,11,44,55,99
00765600,AMERICAN COLLEGE OF HARISTYLING -CR     ,IA,52402-0000,Proprietary  ,0,7,7,7,42,49
00765800,AMER COLL OF HAIRSTYLING-DES MOINES     ,IA,50309-5446,Proprietary  ,1,12,13,11,84,95
00765900,LA JAMES COLLEGE OF HAIRSTYLING         ,IA,50401-3308,Proprietary  ,8,13,21,89,119,208
00771700,CAPRI COLLEGE                           ,IA,52807-2622,Proprietary  ,18,28,46,122,212,334
00794100,COLLEGE OF HAIR DESIGN                  ,IA,50703-1834,Proprietary  ,4,7,11,37,65,102
00826000,IOWA SCHOOL OF BEAUTY INC               ,IA,50322-0000,Proprietary  ,15,43,58,95,265,360
00840300,INDIAN HILLS COMMUNITY COLLEGE          ,IA,52501-1398,Public       ,63,281,344,2001,3289,5290
00840301,INDIAN HILLS COMMUNITY COLLEGE          ,IA,52544-0000,Public       ,16,40,56,286,434,720
00842400,LA JAMES INTERNATIONAL COLLEGE          ,IA,50501-5577,Proprietary  ,9,23,32,102,130,232
00959300,LA'JAMES COLLEGE OF HAIRSTYLING         ,IA,52240-0000,Proprietary  ,9,11,20,103,103,206
01111300,MAHARISHI UNIV OF MANAGEMENT            ,IA,52557-0001,Private      ,9,20,29,237,399,636
01206400,HAMILTON TECHNICAL COLLEGE              ,IA,52807-2653,Proprietary  ,13,44,57,145,416,561
01230000,PALMER COLLEGE OF CHIROPRACTIC          ,IA,52803-5287,Private      ,2,44,46,77,2347,2424
01300600,LA' JAMES INTERNATIONAL COLLEGE-CF      ,IA,50613-5242,Proprietary  ,7,16,23,86,112,198
02090300,CAPRI COLLEGE                           ,IA,52404-0000,Proprietary  ,14,24,38,135,208,343
02134500,LA JAMES INTERNATIONAL COLLEGE - DAV    ,IA,52806-3952,Proprietary  ,9,20,29,48,149,197
02160900,"SALON PROFESSIONAL ACADEMY, THE         ",IA,50010-0000,Proprietary  ,6,10,16,110,97,207
02262500,FAUST INSTITUTE OF COSMETOLOGY          ,IA,50588-0000,Proprietary  ,4,5,9,37,52,89
02274100,LA' JAMES INTERNATIONAL COLLEGE - DM    ,IA,50131-0000,Proprietary  ,7,32,39,136,237,373
02289000,AMERICAN HAIR ACADEMY                   ,IA,52627-4530,Proprietary  ,4,8,12,22,54,76
02306900,IOWA SCHOOL OF BEAUTY                   ,IA,52501-0000,Proprietary  ,4,12,16,40,75,115
02328900,EMMAUS BIBLE COLLEGE                    ,IA,52001-0000,Private      ,5,2,7,232,44,276
02330900,IOWA SCHOOL OF BEAUTY                   ,IA,50158-0000,Proprietary  ,0,8,8,12,45,57
02609200,VATTEROTT COLLEGE                       ,IA,50321-4704,Proprietary  ,11,80,91,157,1037,1194
03069100,ALLEN COLLEGE                           ,IA,50703-1916,Private      ,3,11,14,321,421,742
03441300,IOWA SCHOOL OF BEAUTY                   ,IA,51106-5111,Proprietary  ,5,8,13,42,92,134
03607400,TOTAL LOOK SCHOOL OF COSMETOLOGY AND MAS,IA,52136-1053,Proprietary  ,1,0,1,5,16,21
03720300,CARLSON COLLEGE OF MASSAGE THERAPY      ,IA,52205-7519,Proprietary  ,0,10,10,13,46,59
04051313,ART INSTITUTE OF PHOENIX (THE) - BROWN M,IA,52722-3628,Proprietary  ,25,77,102,154,649,803
04089300,BIO-CHI INSTITUTE OF MASSAGE THERAPY    ,IA,51103-2138,Proprietary  ,0,7,7,8,49,57
00259600,ATLANTIC COMMUNITY COLLEGE              ,NJ,08330-2699,Public       ,119,285,404,4220,5135,9355
00259700,BLOOMFIELD COLLEGE                      ,NJ,07003-3425,Private      ,35,62,97,2935,1659,4594
00259800,CALDWELL COLLEGE                        ,NJ,07006-6195,Private      ,21,51,72,1584,1255,2839
00259900,CENTENARY COLLEGE                       ,NJ,07840-2184,Private      ,24,69,93,1608,1009,2617
00260000,COLLEGE OF SAINT ELIZABETH              ,NJ,07960-6989,Private      ,5,38,43,724,804,1528
00260100,CUMBERLAND COUNTY COLLEGE               ,NJ,08362-0517,Public       ,30,127,157,2381,3411,5792
00260300,DREW UNIVERSITY                         ,NJ,07940-4063,Private      ,45,13,58,4246,793,5039
00260700,FAIRLEIGH DICKINSON UNIV-TEANECK        ,NJ,07666-1996,Private      ,61,140,201,4128,2659,6787
00260701,FAIRLEIGH DICKINSON UNIV-FLORHAM        ,NJ,07940-0000,Private      ,28,25,53,2803,684,3487
00260702,FAIRLEIGH DICKINSON UNIV-ED WMS CLG     ,NJ,07601-0000,Private      ,8,14,22,274,253,527
00260703,FAIRLEIGH DICKINSON UNIVERSITY          ,NJ,07940-0000,Private      ,33,53,86,2209,1129,3338
00260800,GEORGIAN COURT UNIVERSITY               ,NJ,08701-2697,Private      ,18,54,72,1548,1696,3244
00260900,ROWAN UNIVERSITY                        ,NJ,08028-1702,Public       ,99,148,247,13337,4550,17887
00261000,FELICIAN COLLEGE                        ,NJ,07644-2198,Private      ,24,103,127,1851,1550,3401
00261300,NEW JERSEY CITY UNIVERSITY              ,NJ,07305-1597,Public       ,63,193,256,4929,6151,11080
00261500,MIDDLESEX COUNTY COLLEGE                ,NJ,08818-3050,Public       ,157,272,429,6629,5334,11963
00261600,MONMOUTH UNIVERSITY                     ,NJ,07764-1898,Private      ,78,60,138,7453,2539,9992
00261700,MONTCLAIR STATE UNIVERSITY              ,NJ,07043-9987,Public       ,183,228,411,16846,7741,24587
00261900,NEW BRUNSWICK THEOLOGICAL SEMINARY      ,NJ,08901-0000,Private      ,1,6,7,29,166,195
00262100,NEW JERSEY INST OF TECHNOLOGY           ,NJ,07102-1982,Public       ,74,113,187,5884,3015,8899
00262200,KEAN UNIVERSITY                         ,NJ,07083-7131,Public       ,139,258,397,12374,8991,21365
00262400,OCEAN COUNTY COLLEGE                    ,NJ,08754-2001,Public       ,136,255,391,5580,4350,9930
00262500,WILLIAM PATERSON UNIVERSITY             ,NJ,07470-2152,Public       ,109,140,249,11417,4999,16416
00262600,PRINCETON THEOLOGICAL SEMINARY          ,NJ,08542-0000,Private      ,0,1,1,17,676,693
00262700,PRINCETON UNIVERSITY                    ,NJ,08544-0001,Private      ,130,36,166,16779,1745,18524
00262800,RIDER UNIVERSITY                        ,NJ,08648-3099,Private      ,79,87,166,7665,1833,9498
00262900,"RUTGERS, THE STATE UNIVERSITY OF NJ     ",NJ,08901-1281,Public       ,420,588,1008,45576,23647,69223
00263200,SETON HALL UNIVERSITY                   ,NJ,07079-2697,Private      ,66,170,236,10790,4281,15071
00263201,SETON HALL UNIVERSITY - SCHOOL OF LAW   ,NJ,07079-5210,Private      ,2,26,28,332,2505,2837
00263800,ST PETER'S COLLEGE                      ,NJ,07306-5997,Private      ,26,85,111,3956,1372,5328
00263900,STEVENS INSTITUTE OF TECHNOLOGY         ,NJ,07030-5370,Private      ,25,38,63,3661,774,4435
00264200,COLLEGE OF NEW JERSEY (THE)             ,NJ,08628-0718,Public       ,73,66,139,11121,1330,12451
00264300,UNION COUNTY COLLEGE                    ,NJ,07016-1598,Public       ,159,460,619,5378,8381,13759
00473600,BERGEN COMMUNITY COLLEGE                ,NJ,07652-1595,Public       ,222,302,524,8310,6087,14397
00474000,MERCER COUNTY COMMUNITY COLLEGE         ,NJ,08690-0000,Public       ,126,357,483,3511,4977,8488
00539900,MONMOUTH COUNTY VOCATIONAL SCH DIST     ,NJ,07728-5033,Public       ,1,12,13,60,131,191
00545200,TETERBORO SCH OF AERONAUTICS            ,NJ,07608-1083,Proprietary  ,13,9,22,109,115,224
00546000,SOMERSET COUNTY TECHNICAL INSTITUTE     ,NJ,08807-0350,Public       ,0,0,0,14,63,77
00546100,SALEM COMMUNITY COLLEGE                 ,NJ,08069-2799,Public       ,18,50,68,710,888,1598
00641700,HOLY NAME HOSPITAL SCH OF NURSING       ,NJ,07666-4254,Private      ,1,9,10,79,195,274
00642000,MOUNTAINSIDE HOSP SCH NRSG              ,NJ,07042-4898,Proprietary  ,0,2,2,18,89,107
00642100,MUHLENBERG SNYDER SCHOOLS               ,NJ,07061-3399,Private      ,3,27,30,145,598,743
00642900,ST FRANCIS MEDICAL CTR SCH NURSING      ,NJ,08629-1986,Private      ,0,5,5,24,101,125
00642902,ST FRANCIS MED CTR RAD TECH             ,NJ,08629-0000,Private      ,0,1,1,10,37,47
00686500,CAMDEN COUNTY COLLEGE                   ,NJ,08012-3240,Public       ,143,548,691,6901,9473,16374
00690100,GLOUCESTER COUNTY COLLEGE               ,NJ,08080-4249,Public       ,70,158,228,3271,3170,6441
00710700,ESSEX COUNTY COLLEGE                    ,NJ,07102-1798,Public       ,163,398,561,6028,9847,15875
00750200,BERKELEY COLLEGE                        ,NJ,07424-3367,Proprietary  ,35,112,147,1799,1953,3752
00750201,BERKELEY COLLEGE                        ,NJ,07095-0000,Proprietary  ,24,68,92,875,974,1849
00750202,BERKELEY COLLEGE - PARAMUS              ,NJ,07652-2931,Proprietary  ,13,51,64,610,710,1320
00750600,LINCOLN TECHNICAL INSTITUTE             ,NJ,07083-5032,Proprietary  ,96,134,230,997,1356,2353
00750601,LINCOLN TECHNICAL INSTITUTE             ,NJ,07430-0000,Proprietary  ,58,54,112,606,586,1192
00750700,GIBBS COLLEGE                           ,NJ,07039-1611,Proprietary  ,0,0,0,1,4,5
00759300,PARISIAN BEAUTY ACADEMY                 ,NJ,07601-5509,Proprietary  ,11,15,26,147,176,323
00772900,COUNTY COLLEGE OF MORRIS                ,NJ,07869-0000,Public       ,94,113,207,3724,2090,5814
00773000,BURLINGTON COUNTY COLLEGE               ,NJ,08068-1599,Public       ,102,314,416,4362,4918,9280
00773100,RARITAN VALLEY COMMUNITY COLLEGE        ,NJ,08876-1265,Public       ,87,134,221,2704,2301,5005
00780401,STAR CAREER ACADEMY - STAR LAKEWOOD     ,NJ,08701-5900,Proprietary  ,21,81,102,152,571,723
00780402,STAR CAREER ACADEMY - STAR EGG HARBOR   ,NJ,08234-4863,Proprietary  ,18,86,104,89,555,644
00794700,BETH MEDRASH GOVOHA OF AMERICA          ,NJ,08701-0000,Private      ,77,219,296,333,1991,2324
00840400,BROOKDALE COMMUNITY COLLEGE             ,NJ,07738-1597,Public       ,223,357,580,6607,5015,11622
00844101,ANTHEM INSTITUTE                        ,NJ,08002-0000,Proprietary  ,3,19,22,46,166,212
00849400,HO HO KUS SCHL OF TRADE & TECH SCIENCES ,NJ,07513-1402,Proprietary  ,15,38,53,116,254,370
00860900,RABBINICAL COLLEGE OF AMERICA           ,NJ,07960-3600,Private      ,19,0,19,107,6,113
00907800,CAPRI INSTITUTE OF HAIR DESIGN          ,NJ,07011-2111,Proprietary  ,15,41,56,105,220,325
00922800,DEVRY INSTITUTE                         ,NJ,08902-3362,Proprietary  ,0,0,0,126,183,309
00934400,RAMAPO COLLEGE OF NEW JERSEY            ,NJ,07430-1680,Public       ,56,41,97,6937,1215,8152
00934500,RICHARD STOCKTON COLLEGE OF NJ          ,NJ,08240-0195,Public       ,88,97,185,7968,3187,11155
00982804,EVEREST INSTITUTE - SOUTH PLAINFIELD    ,NJ,07080-1125,Proprietary  ,41,162,203,254,933,1187
00999400,PASSAIC COUNTY COMMUNITY COLLEGE        ,NJ,07505-1179,Public       ,239,476,715,4168,6124,10292
01039400,UNIV OF MEDICINE & DENTISTRY OF NJ      ,NJ,07107-0000,Public       ,6,134,140,320,5394,5714
01062900,P B COSMETOLOGY EDUCATION CENTRE        ,NJ,08030-1750,Proprietary  ,8,23,31,103,154,257
01085100,ANTHEM INSTITUTE                        ,NJ,07054-3409,Proprietary  ,76,180,256,556,1186,1742
01085101,ANTHEM INSTITUTE                        ,NJ,07306-0000,Proprietary  ,4,17,21,59,175,234
01085102,ANTHEM INSTITUTE                        ,NJ,08902-0000,Proprietary  ,2,11,13,42,87,129
01090300,RIZZIERI INSTITUTE                      ,NJ,08043-4600,Proprietary  ,7,21,28,118,193,311
01152300,MORRIS COUNTY SCHOOL OF TECHNOLOGY      ,NJ,07834-0000,Public       ,1,3,4,62,68,130
01170800,NATURAL MOTION INST OF HAIR DESIGN      ,NJ,07306-5496,Proprietary  ,6,16,22,52,132,184
01198900,TALMUDICAL ACADEMY                      ,NJ,07710-0000,Private      ,2,3,5,56,6,62
01209000,REIGNBOW BEAUTY ACADEMY                 ,NJ,08861-4118,Proprietary  ,12,28,40,59,153,212
01234600,DOVER BUSINESS COLLEGE                  ,NJ,07011-2161,Proprietary  ,27,127,154,470,1199,1669
01234602,DOVER BUSINESS COLLEGE                  ,NJ,07801-4643,Proprietary  ,13,57,70,178,550,728
01246100,LINCOLN TECHNICAL INSTITUTE             ,NJ,08820-2896,Proprietary  ,47,167,214,479,1277,1756
01246102,LINCOLN TECHNICAL INSTITUTE             ,NJ,08057-3212,Proprietary  ,34,112,146,348,1420,1768
01246103,LINCOLN TECHNICAL INSTITUTE             ,NJ,07652-2106,Proprietary  ,41,106,147,543,1194,1737
01246200,HOHOKUS - HACKENSACK SCHOOL OF BUSINESS ,NJ,07601-7197,Proprietary  ,23,101,124,158,662,820
01295400,HUDSON COUNTY COMMUNITY COLLEGE         ,NJ,07306-4012,Public       ,256,429,685,4880,7343,12223
02053700,EASTWICK COLLEGE                        ,NJ,07446-0000,Proprietary  ,25,95,120,356,1249,1605
02061800,ROMAN ACADEMY OF BEAUTY CULTURE         ,NJ,07506-0000,Proprietary  ,10,5,15,47,52,99
02092300,HOHOKUS SCHOOL - RETS/NUTLEY            ,NJ,07110-0000,Proprietary  ,32,103,135,251,669,920
02103700,CAPRI INSTITUTE OF HAIR DESIGN          ,NJ,07652-0000,Proprietary  ,11,17,28,77,124,201
02104000,HARRIS SCHOOL OF BUSINESS               ,NJ,08002-2983,Proprietary  ,37,203,240,314,1378,1692
02106601,AMERICAN INSTITUTE - CLIFTON            ,NJ,07011-2345,Proprietary  ,29,96,125,164,677,841
02131100,DU CRET SCHOOL OF THE ARTS              ,NJ,07060-0000,Private      ,2,2,4,41,32,73
02131600,PENNCO TECH                             ,NJ,08012-0000,Proprietary  ,70,177,247,492,998,1490
02132300,BERDAN INSTITUTE                        ,NJ,07512-0000,Proprietary  ,33,105,138,290,588,878
02146800,JOE KUBERT SCH OF CARTOON & GRAPHIC     ,NJ,07801-0000,Proprietary  ,1,1,2,61,65,126
02149800,EMPIRE BEAUTY SCHOOL                    ,NJ,08021-0000,Proprietary  ,23,50,73,112,347,459
02149801,EMPIRE BEAUTY SCHOOL - BORDENTOWN       ,NJ,08505-1513,Proprietary  ,1,12,13,28,64,92
02154000,DIVERS ACAD OF EASTERN SEABOARD         ,NJ,08081-1139,Proprietary  ,10,27,37,114,224,338
02183600,CAPRI INSTITUTE OF HAIR DESIGN          ,NJ,07033-0000,Proprietary  ,18,17,35,92,161,253
02192200,THOMAS EDISON STATE COLLEGE             ,NJ,08608-0000,Public       ,34,638,672,396,6215,6611
02219600,OMEGA INSTITUTE                         ,NJ,08109-0000,Proprietary  ,10,40,50,53,245,298
02223700,NEW HORIZON INST OF COSMETOLOGY         ,NJ,07093-0000,Proprietary  ,3,28,31,29,231,260
02223900,DRAKE COLLEGE OF BUSINESS               ,NJ,07201-0000,Proprietary  ,32,207,239,220,1514,1734
02223902,DRAKE COLLEGE OF BUSINESS - NEWARK CAMPU,NJ,07112-2760,Proprietary  ,50,284,334,356,1697,2053
02232500,UNION COUNTY VOCATIONAL TECH INST       ,NJ,07076-0000,Public       ,3,8,11,84,112,196
02234600,SHORE BEAUTY SCHOOL                     ,NJ,08232-0000,Proprietary  ,7,35,42,70,159,229
02246000,ROSS UNIVERSITY - MEDICAL SCHOOL        ,NJ,08837-0000,Proprietary  ,2,171,173,31,4600,4631
02248600,COOPER HEALTH SYS-CTR ALLIED HEALTH     ,NJ,08103-0000,Private      ,0,18,18,30,208,238
02252700,CONCORDE SCHOOL OF HAIR DESIGN          ,NJ,07712-0000,Proprietary  ,16,43,59,141,345,486
02252701,CONCORDE SCHOOL OF HAIR DESIGN - BLOOMFI,NJ,07003-2517,Proprietary  ,2,3,5,28,45,73
02261800,EUROPEAN ACADEMY OF COSMETOLOGY         ,NJ,07083-0000,Proprietary  ,10,20,30,84,191,275
02265500,CAPRI INSTITUTE OF HAIR DESIGN          ,NJ,08724-0000,Proprietary  ,11,28,39,59,147,206
02277900,ROSS UNIV - SCH OF VETERINARY MED       ,NJ,08837-0000,Proprietary  ,1,58,59,9,1308,1317
02291000,LINCOLN TECHNICAL INSTITUTE             ,NJ,07080-2424,Proprietary  ,18,37,55,180,267,447
02312000,BERGEN COUNTY TECHNICAL SCHOOLS         ,NJ,07601-6110,Public       ,6,18,24,69,178,247
02344200,EMPIRE BEAUTY SCHOOL                    ,NJ,08002-0000,Proprietary  ,23,43,66,163,384,547
02503900,WARREN COUNTY COMMUNITY COLLEGE         ,NJ,07882-0000,Public       ,25,43,68,779,746,1525
02523700,OCEAN COUNTY VOCATIONAL-TECH SCHOOL     ,NJ,08753-0000,Public       ,3,12,15,190,331,521
02525900,ARTISTIC ACADEMY OF HAIR DESIGN         ,NJ,07950-1409,Proprietary  ,14,22,36,118,128,246
02528200,REIGNBOW BEAUTY ACADEMY                 ,NJ,07060-0000,Proprietary  ,2,32,34,25,135,160
02558700,PRISM CAREER INSTITUTE                  ,NJ,08037-0000,Proprietary  ,4,22,26,229,1339,1568
02568800,SUSSEX COUNTY COMMUNITY COLLEGE         ,NJ,07860-1149,Public       ,64,104,168,1729,1240,2969
02586900,HARRIS SCHOOL OF BUSINESS               ,NJ,08043-2604,Proprietary  ,41,195,236,185,971,1156
02616402,SANFORD-BROWN INSTITUTE - ISELIN        ,NJ,08830-0000,Proprietary  ,67,149,216,545,1247,1792
03077500,RABBI JACOB JOSEPH SCHOOL               ,NJ,08817-4494,Private      ,2,0,2,20,3,23
03122600,EASTERN INTERNATIONAL COLLEGE           ,NJ,07306-3906,Proprietary  ,13,61,74,107,390,497
03187300,STENOTECH CAREER INSTITUTE              ,NJ,07004-3490,Proprietary  ,3,11,14,56,119,175
03197300,INSTITUTE FOR HEALTH EDUCATION(THE)     ,NJ,07306-2929,Proprietary  ,4,56,60,56,334,390
03324300,CENTRAL CAREER SCHOOL                   ,NJ,07080-2408,Proprietary  ,9,37,46,48,192,240
03380302,STAR CAREER ACADEMY - STAR NEWARK       ,NJ,07102-4510,Proprietary  ,14,111,125,119,729,848
03380303,STAR CAREER ACADEMY - STAR CLIFTON      ,NJ,07011-2248,Proprietary  ,15,71,86,69,442,511
03389300,ACADEMY OF MASSAGE THERAPY              ,NJ,07631-0000,Proprietary  ,4,22,26,43,190,233
03424500,NEW COMMUNITY WORKFORCE DEVELOPMENT     ,NJ,07103-2402,Private      ,3,25,28,47,525,572
03530300,"KEY SKILLS LEARNING, INC.               ",NJ,07013-1900,Proprietary  ,0,10,10,5,67,72
03536300,INSTITUTE FOR THERAPEUTIC MASSAGE       ,NJ,07420-1452,Proprietary  ,4,35,39,25,177,202
03574400,CORTIVA INSTITUTE - SOMERSET SCHOOL OF M,NJ,08854-3908,Proprietary  ,0,0,0,6,26,32
03625300,PERFORMANCE TRAINING INSTITUTE          ,NJ,08753-0000,Proprietary  ,9,214,223,57,924,981
03637300,METRO AUTO ELECTRONICS TRAINING INSTITUT,NJ,07033-1798,Proprietary  ,4,54,58,19,171,190
03650600,PC AGE                                  ,NJ,07306-3936,Proprietary  ,6,49,55,42,273,315
03650603,PC AGE                                  ,NJ,08817-2842,Proprietary  ,0,5,5,7,33,40
03666300,SOMERSET CHRISTIAN COLLEGE              ,NJ,08890-9035,Private      ,0,34,34,81,437,518
03769300,PC TECH LEARNING CENTER                 ,NJ,07306-9900,Proprietary  ,0,0,0,3,17,20
03803300,HEALTHCARE TRAINING INSTITUTE           ,NJ,07083-3504,Proprietary  ,7,29,36,89,367,456
03811300,EASTERN SCHOOL OF ACUPUNCTURE AND TRADIT,NJ,07042-3562,Proprietary  ,0,3,3,8,74,82
04081300,BAIS MEDRASH TORAS CHESED               ,NJ,08701-0000,Private      ,2,1,3,33,18,51
04123400,YESHIVAS BE'ER YITZCHOK                 ,NJ,07208-2380,Private      ,4,5,9,9,43,52
04125000,GENTLE HEALING SCHOOL OF MASSAGE        ,NJ,08512-3600,Proprietary  ,0,6,6,8,55,63
04131100,YESHIVA TORAS CHAIM                     ,NJ,08701-2120,Private      ,11,0,11,129,2,131
04131200,TOTAL IMAGE BEAUTY ACADEMY              ,NJ,07307-2943,Proprietary  ,2,22,24,14,65,79
04134100,CENTER FOR ALLIED HEALTH & NURSING EDUCA,NJ,07601-5801,Proprietary  ,15,154,169,126,1230,1356
04136400,AMERICAN INSTITUTE OF MEDICAL SCIENCES &,NJ,07080-1183,Proprietary  ,2,26,28,45,225,270
04154500,STARTING POINTS FOR CHILDREN            ,NJ,07306-0001,Private      ,3,37,40,3,115,118
04154900,NATIONAL CAREER INSTITUTE               ,NJ,07018-2011,Proprietary  ,6,59,65,43,273,316
04173100,LAB PAUL MITCHELL PARTNER SCHOOL (THE)  ,NJ,08628-2500,Proprietary  ,7,12,19,37,35,72
04180300,MESIVTA KESER TORAH                     ,NJ,07719-2409,Private      ,2,0,2,2,0,2
00266500,VAUGHN COLLEGE OF AERONAUTICS AND TECHNO,NY,11369-9997,Private      ,31,41,72,1118,865,1983
00266600,ADELPHI UNIVERSITY                      ,NY,11530-4299,Private      ,92,136,228,8258,5093,13351
00266700,DOWLING COLLEGE                         ,NY,11769-1999,Private      ,46,114,160,2856,2301,5157
00266800,ALFRED UNIVERSITY                       ,NY,14802-1205,Private      ,21,25,46,3465,746,4211
00266900,BANK STREET COLLEGE OF EDUCATION        ,NY,10025-0000,Private      ,0,37,37,12,1007,1019
00267100,BARD COLLEGE                            ,NY,12504-5000,Private      ,13,17,30,2725,716,3441
00267400,NEW YORK THEOLOGICAL SEMINARY           ,NY,10115-0002,Private      ,0,11,11,3,220,223
00267700,BROOKLYN LAW SCHOOL                     ,NY,11201-0000,Private      ,2,30,32,78,3892,3970
00267800,BRYANT & STRATTON COLLEGE               ,NY,14203-1713,Proprietary  ,265,1342,1607,2970,13303,16273
00267803,BRYANT & STRATTON COLLEGE - GREECE      ,NY,14606-4227,Proprietary  ,33,139,172,356,1408,1764
00267805,BRYANT & STRATTON COLLEGE - SYRACUSE    ,NY,13203-2502,Proprietary  ,41,111,152,769,1839,2608
00267807,BRYANT & STRATTON COLLEGE - ALBANY      ,NY,12205-5230,Proprietary  ,21,70,91,362,1088,1450
00268100,CANISIUS COLLEGE                        ,NY,14208-1098,Private      ,36,77,113,4438,2026,6464
00268300,SEMINARY OF THE IMMACULATE CONCEPT      ,NY,11743-0000,Private      ,0,0,0,2,1,3
00268500,CAZENOVIA COLLEGE                       ,NY,13035-1085,Private      ,18,6,24,1885,194,2079
00268700,CUNY-BROOKLYN COLLEGE                   ,NY,11210-2814,Public       ,289,422,711,16706,11928,28634
00268800,CITY COLLEGE-CUNY                       ,NY,10031-9198,Public       ,327,417,744,19452,10522,29974
00268900,CUNY-HUNTER COLLEGE                     ,NY,10021-0000,Public       ,436,507,943,26712,16645,43357
00269000,QUEENS COLLEGE-CUNY                     ,NY,11367-1597,Public       ,296,396,692,16623,9281,25904
00269100,CUNY- BOROUGH OF MANHATTAN CMTY CLG     ,NY,10007-1047,Public       ,763,681,1444,23053,15381,38434
00269200,CUNY BRONX COMMUNITY COLLEGE            ,NY,10453-3102,Public       ,284,320,604,11131,9427,20558
00269300,CUNY-JOHN JAY CLG CRIMINAL JUSTICE      ,NY,10019-1093,Public       ,222,269,491,15593,7796,23389
00269400,KINGSBOROUGH COMMUNITY COLLEGE          ,NY,11235-2398,Public       ,659,500,1159,13514,8032,21546
00269600,NY CITY COLLEGE OF TECHNOLOGY-CUNY      ,NY,11201-2983,Public       ,494,494,988,14949,8440,23389
00269700,QUEENSBOROUGH COMMUNITY COLLEGE         ,NY,11364-1497,Public       ,370,282,652,12246,5897,18143
00269800,CUNY THE COLLEGE OF STATEN ISLAND       ,NY,10314-6600,Public       ,213,218,431,10904,5027,15931
00269900,CLARKSON UNIVERSITY                     ,NY,13699-5615,Private      ,29,7,36,4619,404,5023
00270000,COLGATE ROCHESTER CROZER DIVINITY S     ,NY,14620-0000,Private      ,1,1,2,11,94,105
00270100,COLGATE UNIVERSITY                      ,NY,13346-1386,Private      ,37,0,37,4196,81,4277
00270300,COLLEGE OF MOUNT SAINT VINCENT          ,NY,10471-1093,Private      ,22,17,39,2174,518,2692
00270400,COLLEGE OF NEW ROCHELLE                 ,NY,10805-2339,Private      ,41,358,399,1193,5274,6467
00270500,COLLEGE OF SAINT ROSE                   ,NY,12203-1490,Private      ,39,71,110,4892,2424,7316
00270700,COLUMBIA UNIVERSITY                     ,NY,10027-0000,Private      ,235,604,839,7153,6868,14021
00270701,COLUMBIA UNIV ARCHITECTURE              ,NY,10027-0000,Private      ,0,0,0,70,889,959
00270702,COLUMBIA UNIV SCHOOL OF THE ARTS        ,NY,10027-0000,Private      ,0,0,0,121,1387,1508
00270703,COLUMBIA UNIV BUSINESS GRAD             ,NY,10027-0000,Private      ,0,0,0,34,1561,1595
00270704,COLUMBIA UNIV SCHOOL ENGIN-UNDERGRA     ,NY,10027-0000,Private      ,0,0,0,1888,79,1967
00270705,COLUMBIA UNIV SCHOOL GENERAL STUDIE     ,NY,10027-0000,Private      ,0,0,0,377,1280,1657
00270706,COLUMBIA UNIV GRAD SCHL ARTS & SCI      ,NY,10027-0000,Private      ,0,0,0,63,1816,1879
00270707,COLUMBIA UNIV SCH INTL PUB AFFAIRS      ,NY,10027-0000,Private      ,0,0,0,13,1357,1370
00270708,COLUMBIA UNIV JOURNALISM GRAD           ,NY,10027-0000,Private      ,0,0,0,22,590,612
00270710,COLUMBIA UNIV COLUMBIA COLLEGE          ,NY,10027-0000,Private      ,0,0,0,8623,619,9242
00270711,COLUMBIA UNIV SCHOOL OF LAW             ,NY,10027-0000,Private      ,0,0,0,54,4500,4554
00270712,COLUMBIA UNIV SOCIAL WORK               ,NY,10025-0000,Private      ,0,0,0,19,1151,1170
00270713,COLUMBIA UNIV SCHL DENT & ORAL SURG     ,NY,10032-0000,Private      ,0,0,0,5,391,396
00270714,COLUMBIA UNIV INST HUMAN NUTRITION      ,NY,10032-0000,Private      ,0,0,0,10,130,140
00270715,COLUMBIA UNIV NURSING                   ,NY,10032-0000,Private      ,0,0,0,99,804,903
00270716,COLUMBIA UNIV COLL PHYS & SURGEONS      ,NY,10032-0000,Private      ,0,0,0,49,1155,1204
00270717,COLUMBIA UNIV PHYSICAL THERAPY          ,NY,10032-0000,Private      ,0,0,0,20,150,170
00270718,COLUMBIA UNIV OCCUPATIONAL THERAPY      ,NY,10032-0000,Private      ,0,0,0,7,127,134
00270719,COLUMBIA UNIV PUBLIC HEALTH             ,NY,10032-0000,Private      ,0,0,0,17,1179,1196
00270720,COLUMBIA UNIV - ENGINEERING (GRAD)      ,NY,10027-0000,Private      ,0,0,0,96,379,475
00270721,COLUMBIA UNIV-CONT ED & SP PROGMS       ,NY,10027-0000,Private      ,0,0,0,7,421,428
00270800,BARNARD COLLEGE-COLUMBIA UNIV           ,NY,10027-6598,Private      ,36,4,40,4078,244,4322
00270900,CONCORDIA COLLEGE                       ,NY,10708-1998,Private      ,11,15,26,848,421,1269
00271000,COOPER UNION                            ,NY,10003-7120,Private      ,25,3,28,1715,278,1993
00271100,CORNELL UNIVERSITY                      ,NY,14853-2801,Private      ,210,87,297,26444,7393,33837
00271101,WEILL CORNELL MEDICAL COLLEGE AND GRADUA,NY,10021-0000,Private      ,3,36,39,47,843,890
00271200,D'YOUVILLE COLLEGE                      ,NY,14201-1084,Private      ,17,59,76,1852,2139,3991
00271300,DOMINICAN COLLEGE                       ,NY,10962-1299,Private      ,21,48,69,1730,1016,2746
00271800,ELMIRA COLLEGE                          ,NY,14901-2099,Private      ,15,24,39,2421,630,3051
00272200,FORDHAM UNIVERSITY                      ,NY,10458-5157,Private      ,185,221,406,21266,11084,32350
00272600,GENERAL THEOLOGICAL SEMINARY            ,NY,10011-0000,Private      ,0,0,0,1,116,117
00272800,HAMILTON COLLEGE                        ,NY,13323-1218,Private      ,13,1,14,2913,57,2970
00272900,HARTWICK COLLEGE                        ,NY,13820-4020,Private      ,35,3,38,3173,133,3306
00273100,HOBART & WILLIAM SMITH COLLEGES         ,NY,14456-3397,Private      ,10,0,10,3385,80,3465
00273200,HOFSTRA UNIVERSITY                      ,NY,11549-1010,Private      ,159,157,316,14899,6630,21529
00273400,HOUGHTON COLLEGE                        ,NY,14744-0128,Private      ,3,27,30,1490,201,1691
00273500,HILBERT COLLEGE                         ,NY,14075-1597,Private      ,14,14,28,1079,326,1405
00273700,IONA COLLEGE                            ,NY,10801-1890,Private      ,64,47,111,7321,1341,8662
00273900,ITHACA COLLEGE                          ,NY,14850-7130,Private      ,73,12,85,13252,922,14174
00274000,JEWISH THEOLOGICAL SEMINARY OF AMER     ,NY,10027-4649,Private      ,0,1,1,144,199,343
00274200,THE JUILLIARD SCHOOL                    ,NY,10023-6588,Private      ,20,9,29,1310,700,2010
00274400,KEUKA COLLEGE                           ,NY,14478-0000,Private      ,13,94,107,1300,1332,2632
00274800,LEMOYNE COLLEGE                         ,NY,13214-1399,Private      ,40,32,72,4576,1050,5626
00274900,NEW YORK COLLEGE OF PODIATRIC MED       ,NY,10035-1940,Private      ,0,2,2,46,392,438
00275100,LONG ISLAND UNIVERSITY                  ,NY,11548-1326,Private      ,233,577,810,12649,11590,24239
00275800,MANHATTAN COLLEGE                       ,NY,10471-4098,Private      ,45,24,69,5888,670,6558
00275900,MANHATTAN SCHOOL OF MUSIC               ,NY,10027-4689,Private      ,4,6,10,696,812,1508
00276000,MANHATTANVILLE COLLEGE                  ,NY,10577-2132,Private      ,31,73,104,3073,1102,4175
00276300,MARIA COLLEGE                           ,NY,12208-1798,Private      ,8,25,33,230,964,1194
00276500,MARIST COLLEGE                          ,NY,12601-1387,Private      ,80,76,156,9416,1460,10876
00276900,MARYMOUNT MANHATTAN COLLEGE             ,NY,10021-4597,Private      ,34,8,42,3796,410,4206
00277200,MERCY COLLEGE                           ,NY,10522-1189,Private      ,145,514,659,4460,8209,12669
00277500,MOLLOY COLLEGE                          ,NY,11570-1100,Private      ,39,89,128,3179,2063,5242
00277700,MEDAILLE COLLEGE                        ,NY,14214-2695,Private      ,20,97,117,1755,1593,3348
00277800,MOUNT SAINT MARY COLLEGE                ,NY,12550-3494,Private      ,43,67,110,2850,1217,4067
00277900,NAZARETH COLLEGE OF ROCHESTER           ,NY,14618-3790,Private      ,22,34,56,3296,1720,5016
00278200,NEW YORK INSTITUTE OF TECHNOLOGY        ,NY,11568-8000,Private      ,91,134,225,5305,3095,8400
00278202,NY INSTITUTE OF TECHNOLOGY-OSTEOPATHIC M,NY,11568-0000,Private      ,2,5,7,74,1197,1271
00278300,NEW YORK LAW SCHOOL                     ,NY,10013-0000,Private      ,0,19,19,35,3538,3573
00278400,NEW YORK MEDICAL COLLEGE                ,NY,10595-0000,Private      ,1,19,20,31,2158,2189
00278500,NEW YORK UNIVERSITY                     ,NY,10012-1091,Private      ,404,724,1128,36429,32678,69107
00278800,NIAGARA UNIVERSITY                      ,NY,14109-2010,Private      ,23,41,64,3847,964,4811
00279000,NYACK COLLEGE                           ,NY,10960-3698,Private      ,20,148,168,1386,2303,3689
00279100,PACE UNIVERSITY - NEW YORK              ,NY,10038-1598,Private      ,117,163,280,8531,3684,12215
00279101,PACE UNIVERSITY-PLEASANTVILLE           ,NY,10570-0000,Private      ,41,64,105,3607,1281,4888
00279102,PACE UNIVERSITY - WHITE PLAINS          ,NY,10603-0000,Private      ,11,53,64,371,2318,2689
00279500,PAUL SMITHS CLG OF ARTS & SCIENCES      ,NY,12970-0000,Private      ,10,2,12,1276,159,1435
00279600,POLYTECHNIC INTSTITUTE OF NEW YORK UNIV ,NY,11201-3840,Private      ,27,49,76,2606,1142,3748
00279800,PRATT INSTITUTE                         ,NY,11205-3899,Private      ,49,46,95,4832,2916,7748
00280300,RENSSELAER POLYTECHNIC INSTITUTE        ,NY,12180-3590,Private      ,54,18,72,10493,860,11353
00280500,ROBERTS WESLEYAN COLLEGE                ,NY,14624-1997,Private      ,9,88,97,1486,1382,2868
00280600,ROCHESTER INSTITUTE OF TECHNOLOGY       ,NY,14623-5608,Private      ,129,108,237,15283,3375,18658
00280700,ROCKEFELLER UNIVERSITY                  ,NY,10021-0000,Private      ,1,2,3,16,32,48
00280800,DAEMEN COLLEGE                          ,NY,14226-3592,Private      ,27,60,87,2429,1160,3589
00281000,THE SAGE COLLEGES                       ,NY,12180-4199,Private      ,14,57,71,1629,1988,3617
00281200,TROCAIRE COLLEGE                        ,NY,14220-2094,Private      ,20,65,85,674,1733,2407
00281300,SARAH LAWRENCE COLLEGE                  ,NY,10708-5999,Private      ,12,5,17,1757,718,2475
00281400,SKIDMORE COLLEGE                        ,NY,12866-1632,Private      ,31,3,34,3824,111,3935
00281401,SKIDMORE COLL-UNIV WITHOUT WALLS        ,NY,12866-0000,Private      ,1,1,2,33,7,40
00281500,ST BERNARDS SCH THEOLOGY & MINISTRY     ,NY,14618-3822,Private      ,0,1,1,2,43,45
00281600,SIENA COLLEGE                           ,NY,12211-1462,Private      ,40,9,49,6551,316,6867
00281700,ST BONAVENTURE UNIVERSITY               ,NY,14778-2284,Private      ,16,13,29,2692,610,3302
00282000,ST FRANCIS COLLEGE                      ,NY,11201-4398,Private      ,61,32,93,2535,668,3203
00282100,ST JOHN FISHER COLLEGE                  ,NY,14618-3597,Private      ,21,36,57,4636,1955,6591
00282200,CHRIST THE KING SEMINARY                ,NY,14052-0607,Private      ,0,0,0,1,10,11
00282300,ST JOHN'S UNIVERSITY                    ,NY,11439-1343,Private      ,294,146,440,24110,7294,31404
00282500,ST JOSEPH'S COLLEGE                     ,NY,11205-3688,Private      ,24,48,72,1253,791,2044
00282501,ST JOSEPH'S COLLEGE-SUFFOLK CAMPUS      ,NY,11772-0000,Private      ,46,53,99,3154,1491,4645
00282600,ST JOSEPH'S SEMINARY                    ,NY,10704-0000,Private      ,0,0,0,1,3,4
00282900,ST LAWRENCE UNIVERSITY                  ,NY,13617-1455,Private      ,21,5,26,2980,140,3120
00283200,ST THOMAS AQUINAS COLLEGE               ,NY,10976-1050,Private      ,22,11,33,1929,368,2297
00283300,ST VLADIMIR ORTHODOX THEOL SEM          ,NY,10707-0000,Private      ,0,0,0,1,46,47
00283400,EXCELSIOR COLLEGE                       ,NY,12203-5159,Private      ,32,896,928,291,7715,8006
00283500,SUNY AT ALBANY                          ,NY,12222-0001,Public       ,218,135,353,21440,5641,27081
00283600,BINGHAMTON UNIVERSITY (SUNY)            ,NY,13902-6000,Public       ,219,80,299,23783,3313,27096
00283700,SUNY AT BUFFALO                         ,NY,14260-0001,Public       ,225,162,387,23638,10491,34129
00283800,SUNY AT STONY BROOK                     ,NY,11794-0001,Public       ,346,233,579,25713,8118,33831
00283900,SUNY-DOWNSTATE MEDICAL CENTER           ,NY,11203-2098,Public       ,7,31,38,159,2186,2345
00284000,SUNY UPSTATE MEDICAL UNIVERSITY         ,NY,13210-2375,Public       ,4,22,26,220,1450,1670
00284100,SUNY BROCKPORT - FIN AID OFF            ,NY,14420-2914,Public       ,87,95,182,9981,3327,13308
00284200,BUFFALO STATE COLLEGE - SUNY            ,NY,14222-1095,Public       ,190,235,425,13187,5927,19114
00284300,SUNY COLLEGE-CORTLAND                   ,NY,13045-0900,Public       ,86,40,126,11929,1806,13735
00284400,SUNY AT FREDONIA                        ,NY,14063-1145,Public       ,69,42,111,7689,1125,8814
00284500,SUNY GENESEO                            ,NY,14454-1401,Public       ,59,9,68,9281,647,9928
00284600,SUNY COLLEGE-NEW PALTZ                  ,NY,12561-2499,Public       ,131,76,207,12361,2403,14764
00284700,SUNY COLLEGE-ONEONTA                    ,NY,13820-4015,Public       ,87,20,107,10989,887,11876
00284800,SUNY OSWEGO                             ,NY,13126-3599,Public       ,98,64,162,10845,2367,13212
00284900,SUNY COLLEGE AT PLATTSBURGH             ,NY,12901-2681,Public       ,79,46,125,7341,1597,8938
00285000,SUNY COLLEGE-POTSDAM                    ,NY,13676-2294,Public       ,59,35,94,5325,1145,6470
00285100,SUNY COLLEGE OF ENVIRONMENT SCIENCE AND ,NY,13210-2778,Public       ,16,16,32,2207,653,2860
00285300,SUNY MARITIME COLLEGE                   ,NY,10465-4198,Public       ,21,14,35,1621,367,1988
00285400,SUNY COLLEGE OF TECHNOLOGY-ALFRED       ,NY,14802-9951,Public       ,49,35,84,4139,1022,5161
00285500,SUNY CANTON COLG OF TECHNOLOGY          ,NY,13617-1098,Public       ,32,76,108,3192,1711,4903
00285600,SUNY AG & TECH COLLEGE-COBLESKILL       ,NY,12043-9986,Public       ,39,28,67,3119,571,3690
00285700,SUNY DELHI                              ,NY,13753-1190,Public       ,56,30,86,3734,950,4684
00285800,SUNY FARMINGDALE                        ,NY,11735-1021,Public       ,125,99,224,6010,2348,8358
00285900,SUNY COLLEGE OF AG & TECH AT MORRISVILLE,NY,13408-0901,Public       ,44,55,99,3711,1252,4963
00286000,ADIRONDACK COMMUNITY COLLEGE            ,NY,12804-2004,Public       ,59,98,157,2059,1942,4001
00286100,CAYUGA COMMUNITY COLLEGE                ,NY,13021-3099,Public       ,66,215,281,2054,2643,4697
00286200,BROOME COMMUNITY COLLEGE                ,NY,13902-0000,Public       ,94,132,226,3667,2942,6609
00286300,CORNING COMMUNITY COLLEGE               ,NY,14830-3297,Public       ,87,163,250,2182,2498,4680
00286400,DUTCHESS COMMUNITY COLLEGE              ,NY,12601-1595,Public       ,145,197,342,3619,2742,6361
00286600,FASHION INSTITUTE OF TECHNOLOGY         ,NY,10001-5992,Public       ,117,116,233,8242,3667,11909
00286700,SUNY FULTON MONTGOMERY COMM CLG         ,NY,12095-3790,Public       ,42,78,120,1474,1328,2802
00286800,HUDSON VALLEY COMMUNITY COLLEGE         ,NY,12180-6096,Public       ,164,259,423,7456,5378,12834
00286900,JAMESTOWN COMMUNITY COLLEGE             ,NY,14702-0020,Public       ,66,99,165,2994,2491,5485
00287000,JEFFERSON COMMUNITY COLLEGE             ,NY,13601-1897,Public       ,59,236,295,1616,2472,4088
00287100,"SUNY, MOHAWK VALLEY COMMUNITY CLG       ",NY,13501-5394,Public       ,92,173,265,4646,3759,8405
00287200,MONROE COMMUNITY COLLEGE                ,NY,14623-5780,Public       ,377,662,1039,10792,10602,21394
00287300,NASSAU COMMUNITY COLLEGE                ,NY,11530-6793,Public       ,433,410,843,12682,7116,19798
00287400,NIAGARA COUNTY COMMUNITY COLLEGE        ,NY,14132-9460,Public       ,93,122,215,4413,3392,7805
00287500,ONONDAGA COMMUNITY COLLEGE              ,NY,13215-4585,Public       ,198,294,492,6735,4800,11535
00287600,ORANGE COUNTY COMMUNITY COLLEGE         ,NY,10940-6441,Public       ,114,139,253,3291,2664,5955
00287700,ROCKLAND COMMUNITY COLLEGE              ,NY,10901-3611,Public       ,153,143,296,2871,2192,5063
00287800,SUFFOLK COMMUNITY COLLEGE               ,NY,11784-2899,Public       ,239,259,498,8333,4533,12866
00287801,SUFFOLK COMMUNITY CLG-W. CAMPUS         ,NY,11717-0000,Public       ,140,128,268,3607,2634,6241
00287803,SUFFOLK COMMUNITY CLG-EASTRN CAMPUS     ,NY,11901-0000,Public       ,61,75,136,1190,982,2172
00287900,SULLIVAN COUNTY COMMUNITY COLLEGE       ,NY,12759-5151,Public       ,35,40,75,1495,933,2428
00288000,ULSTER COUNTY COMMUNITY COLLEGE         ,NY,12484-0557,Public       ,56,74,130,1366,1158,2524
00288100,SUNY WESTCHESTER COMMUNITY COLLEGE      ,NY,10595-1698,Public       ,208,247,455,6049,5076,11125
00288200,SYRACUSE UNIVERSITY                     ,NY,13244-2130,Private      ,175,200,375,22146,6615,28761
00288300,UTICA COLLEGE- UTICA                    ,NY,13502-4892,Private      ,24,54,78,3606,1918,5524
00288500,ALBANY COLLEGE OF PHARMACY AND HEALTH SC,NY,12208-3492,Private      ,12,4,16,1565,823,2388
00288600,ALBANY LAW SCHOOL                       ,NY,12208-0000,Private      ,1,8,9,73,1665,1738
00288700,ALBANY MEDICAL COLLEGE                  ,NY,12208-0000,Private      ,2,11,13,104,1092,1196
00288900,UNION COLLEGE                           ,NY,12308-2311,Private      ,25,4,29,3430,142,3572
00289000,UNION THEOLOGICAL SEMINARY              ,NY,10027-0000,Private      ,0,2,2,0,343,343
00289200,UNITED STATES MERCHANT MARINE ACADEMY   ,NY,11024-1699,Public       ,9,0,9,380,17,397
00289400,UNIVERSITY OF ROCHESTER                 ,NY,14627-9000,Private      ,54,104,158,8236,2119,10355
00289401,EASTMAN SCH OF MUSIC/UNIV ROCHESTER     ,NY,14604-0000,Private      ,5,3,8,784,423,1207
00289402,UNIV OF ROCHESTER SCHL OF MEDICINE      ,NY,14642-0000,Private      ,2,6,8,63,729,792
00289500,VASSAR COLLEGE                          ,NY,12604-0008,Private      ,19,3,22,5081,122,5203
00289600,VILLA MARIA COLLEGE-BUFFALO             ,NY,14225-3999,Private      ,13,16,29,492,312,804
00289900,WAGNER COLLEGE                          ,NY,10301-4495,Private      ,35,28,63,2722,482,3204
00290000,WEBB INSTITUTE                          ,NY,11542-1398,Private      ,0,0,0,52,8,60
00290100,WELLS COLLEGE                           ,NY,13026-0500,Private      ,14,1,15,1434,103,1537
00290300,YESHIVA UNIVERSITY                      ,NY,10033-3201,Private      ,27,32,59,2183,3578,5761
00290302,YESHIVA UNIVERSITY - BRONX CAMPUS       ,NY,10461-1975,Private      ,1,18,19,33,1243,1276
00397400,MESIVTHA TIFERETH JERUSALEM OF AMER     ,NY,10002-6382,Private      ,5,1,6,37,3,40
00397600,RABBINICAL ACAD MESIVTA RABBI CHAIM     ,NY,11230-4715,Private      ,13,1,14,30,5,35
00397700,RABBINICAL COLLEGE CH'SAN SOFER         ,NY,11204-1252,Private      ,0,2,2,19,24,43
00397800,RABBINICAL SEMINARY OF AMERICA          ,NY,11375-0000,Private      ,6,16,22,32,51,83
00397900,COLUMBIA UNIV TEACHERS COLLEGE          ,NY,10027-0000,Private      ,3,242,245,58,5187,5245
00405400,HEBREW UNION COL-JEWISH INST OF REL     ,NY,10012-0000,Private      ,0,0,0,3,79,82
00475900,"CUNY, YORK COLLEGE                      ",NY,11451-0001,Public       ,183,220,403,9912,5441,15353
00476500,CUNY GRADUATE SCH & UNIV CTR            ,NY,10016-4309,Public       ,8,141,149,116,3421,3537
00477600,CENTRAL YESHIVA TOMCHEI TMIMIM LUBA     ,NY,11230-2798,Private      ,127,12,139,295,47,342
00478800,HERKIMER COUNTY COMMUNITY COLLEGE       ,NY,13350-1598,Public       ,62,93,155,3056,1565,4621
00479800,MIRRER YESHIVA CENTRAL INST             ,NY,11223-2010,Private      ,11,4,15,102,61,163
00479900,MONROE COLLEGE                          ,NY,10468-4305,Proprietary  ,178,491,669,3592,6021,9613
00481100,EVEREST INSTITUTE                       ,NY,14621-3007,Proprietary  ,23,156,179,380,2090,2470
00506400,SAINT JAMES MERCY HOSPITAL SCHOOL OF RAD,NY,14843-2197,Private      ,1,0,1,13,14,27
00506600,FAXTON ST. LUKE'S SCHOOL OF RADIOGRAPHY ,NY,13502-4856,Private      ,1,1,2,23,55,78
00520800,THE COLLEGE OF WESTCHESTER              ,NY,10602-0000,Proprietary  ,34,65,99,871,956,1827
00587700,ROBERT J HOCHSTIM SCHOOL OF RADIOG      ,NY,11572-1151,Private      ,0,0,0,2,13,15
00643501,ARNOT OGDEN MEDICAL CENTER              ,NY,14905-1676,Private      ,2,4,6,43,65,108
00643800,PHILLIPS BETH ISRAEL SCH OF NURSING     ,NY,10001-6354,Private      ,2,10,12,116,361,477
00644300,COCHRAN SCH NSG-ST JOHN RVSDE HOSP      ,NY,10701-1399,Private      ,0,4,4,39,325,364
00644500,CROUSE HOSP SCH OF NURSING              ,NY,13210-1690,Private      ,3,13,16,148,308,456
00644800,ELLIS HOSPITAL SCHOOL OF NURSING        ,NY,12308-0000,Private      ,0,1,1,53,172,225
00646101,ST ELIZABETH COLLEGE OF NURSING         ,NY,13501-2998,Private      ,0,4,4,123,241,364
00646102,ST ELIZABETH SCH OF RADIOGRAPHY         ,NY,13501-0000,Private      ,1,1,2,19,44,63
00646700,SAINT JOSEPH'S COLLEGE OF NURSING       ,NY,13203-1806,Private      ,0,9,9,181,314,495
00678200,GENESEE COMMUNITY COLLEGE               ,NY,14020-9704,Public       ,72,183,255,3059,3043,6102
00678500,SCHENECTADY COUNTY COMMUNITY CLG        ,NY,12305-2294,Public       ,84,146,230,2206,2529,4735
00678700,CLINTON COMMUNITY COLLEGE               ,NY,12901-5690,Public       ,35,71,106,1424,955,2379
00678800,TOMPKINS CORTLAND COMMUNITY COLLEGE     ,NY,13053-8504,Public       ,83,106,189,2989,1860,4849
00678900,COLUMBIA-GREENE COMMUNITY COLLEGE       ,NY,12534-9543,Public       ,43,51,94,1039,942,1981
00679100,SUNY AT PURCHASE                        ,NY,10577-1400,Public       ,87,32,119,7553,1035,8588
00702200,CUNY-LEHMAN COLLEGE                     ,NY,10468-1589,Public       ,190,368,558,12490,10382,22872
00702600,MOUNT SINAI SCHOOL OF MEDICINE          ,NY,10029-0000,Private      ,2,8,10,18,1065,1083
00710900,SUNY COLLEGE-OLD WESTBURY               ,NY,11568-0210,Public       ,66,64,130,5794,2185,7979
00711100,NORTH COUNTRY COMMUNITY COLLEGE         ,NY,12983-2046,Public       ,29,43,72,806,836,1642
00726400,MESIFTA TORAH VODAATH RABBINCAL SEM     ,NY,11218-5209,Private      ,2,2,4,26,27,53
00727300,CUNY-BERNARD BARUCH COLLEGE             ,NY,10010-5518,Public       ,275,344,619,16857,9280,26137
00730400,CULINARY INSTITUTE OF AMERICA           ,NY,12538-1499,Private      ,166,149,315,3462,1795,5257
00732916,ITT TECHNICAL INSTITUTE                 ,NY,12205-1003,Proprietary  ,25,79,104,260,724,984
00737200,AUSTIN'S SCHOOL OF SPA TECHNOLOGY       ,NY,12206-1513,Proprietary  ,19,77,96,198,459,657
00737500,ISLAND DRAFTING & TECHNICAL INST        ,NY,11701-2704,Proprietary  ,3,7,10,75,97,172
00738700,LONG ISLAND BEAUTY SCHOOL               ,NY,11788-4346,Proprietary  ,38,53,91,167,282,449
00738800,LONG ISLAND BEAUTY SCHOOL               ,NY,11550-3704,Proprietary  ,8,24,32,50,180,230
00739100,BEAUTY SCHOOL OF MIDDLETOWN             ,NY,10940-6574,Proprietary  ,8,17,25,35,87,122
00739400,BERKELEY COLLEGE                        ,NY,10017-0000,Proprietary  ,140,339,479,3256,4045,7301
00739402,BERKELEY COLLEGE-WESTCHESTER CAMPUS     ,NY,10601-1533,Proprietary  ,22,35,57,890,598,1488
00739800,KATHARINE GIBBS SCHOOL                  ,NY,10018-2602,Proprietary  ,0,0,0,4,2,6
00740100,MANDL SCHOOL                            ,NY,10019-5516,Proprietary  ,14,90,104,224,943,1167
00740500,WOOD TOBE-COBURN SCHOOL                 ,NY,10016-0102,Proprietary  ,20,8,28,642,166,808
00746500,AMERICAN ACADEMY OF DRAMATIC ARTS       ,NY,10016-7089,Private      ,11,11,22,572,297,869
00746600,LIM COLLEGE                             ,NY,10022-5268,Proprietary  ,24,15,39,2002,302,2304
00746800,SCHOOL OF VISUAL ARTS                   ,NY,10010-3994,Proprietary  ,38,37,75,4203,1783,5986
00750602,LINCOLN TECHNICAL INSTITUTE             ,NY,11357-6092,Proprietary  ,57,58,115,691,480,1171
00751800,APEX TECHNICAL SCHOOL                   ,NY,10011-2008,Proprietary  ,176,444,620,1029,2604,3633
00752200,CONTINENTAL SCH OF BEAUTY CULTURE       ,NY,14623-3231,Proprietary  ,26,88,114,230,633,863
00752205,CONTINENTAL SCHOOL OF BEAUTY CULTURE - M,NY,13211-1003,Proprietary  ,1,0,1,3,7,10
00753200,FINGER LAKES COMMUNITY COLLEGE          ,NY,14424-8395,Public       ,96,144,240,3773,2788,6561
00757200,AMERICAN MUSICAL AND DRAMATIC ACAD      ,NY,10023-2106,Private      ,46,14,60,1949,407,2356
00757300,EMPIRE BEAUTY SCHOOL                    ,NY,11103-4028,Proprietary  ,31,57,88,161,384,545
00780400,STAR CAREER ACADEMY                     ,NY,10011-7307,Proprietary  ,36,177,213,240,953,1193
00818900,CONTINENTAL SCHOOL OF BEAUTY CULTURE - B,NY,14224-3402,Proprietary  ,23,44,67,100,203,303
00818903,CONTINENTAL SCHOOL OF BEAUTY CULTURE - B,NY,14223-2911,Proprietary  ,1,2,3,7,17,24
00843700,CHAMPLAIN VALLEY - TEC/PRN              ,NY,12901-0000,Public       ,0,1,1,18,59,77
00849500,JAMESTOWN BUSINESS COLLEGE              ,NY,14702-0429,Proprietary  ,2,29,31,210,396,606
00861100,"CUNY, HOSTOS CMTY COLLEGE               ",NY,10451-1499,Public       ,221,251,472,6706,6463,13169
00861400,RABBINICAL CLG BOBOVER YESHIVA BNEI     ,NY,11219-3293,Private      ,49,14,63,142,39,181
00861700,RABBINICAL SEM MKOR CHAIM-YESHIVA       ,NY,11219-4300,Private      ,9,0,9,16,0,16
00878800,STATE UNIVERSITY OF NEW YORK STUDENT LOA,NY,12246-0000,Public       ,13,14,27,51,60,111
00900300,OLEAN BUSINESS INSTITUTE INC            ,NY,14760-2691,Proprietary  ,0,2,2,15,104,119
00902900,NEIGHBORHOOD PLAYHOUSE                  ,NY,10022-5017,Private      ,0,0,0,31,62,93
00904300,ELMIRA BUSINESS INSTITUTE               ,NY,14901-2731,Proprietary  ,16,120,136,138,1020,1158
00907700,UTICA SCHOOL OF COMMERCE                ,NY,13501-2280,Proprietary  ,7,35,42,165,565,730
00924800,SAMARITAN HOSPITAL SCH NURSING          ,NY,12180-2475,Private      ,1,1,2,50,186,236
00928300,MIDWAY-PARIS BEAUTY SCHOOL              ,NY,11385-3453,Proprietary  ,8,25,33,32,148,180
00928400,LEARNING INST FOR BEAUTY SCIENCES       ,NY,11756-1345,Proprietary  ,18,68,86,113,289,402
00933500,MESIVTA EASTERN PKWY RABBINICAL CLG     ,NY,11218-5559,Private      ,3,0,3,25,7,32
00947900,SAINT VINCENTS CMC SI NURSING SCHOOL    ,NY,10304-3850,Proprietary  ,6,10,16,125,314,439
00976900,METROPOLITAN COLLEGE OF NEW YORK        ,NY,10013-1919,Private      ,12,106,118,260,1838,2098
00992900,SUNY COLLEGE OF OPTOMETRY               ,NY,10036-8003,Public       ,1,1,2,23,330,353
01005100,LA GUARDIA CMTY COLLEGE - CUNY          ,NY,11101-3083,Public       ,615,667,1282,13405,10477,23882
01005200,JEFFERSON-LEWIS BOCES PRAC NRSGPRG      ,NY,13601-9509,Public       ,3,4,7,21,138,159
01009700,CUNY-MEDGAR W EVERS COLLEGE             ,NY,11225-2010,Public       ,159,303,462,5818,6191,12009
01014200,TOURO COLLEGE                           ,NY,10010-4202,Private      ,284,694,978,3941,11556,15497
01014700,WESTERN SUFFOLK BOCES                   ,NY,11768-3499,Public       ,24,90,114,134,455,589
01015300,HELENE FULD COL OF NRSNG/N GEN HOSP     ,NY,10035-0000,Private      ,1,70,71,38,724,762
01028600,EMPIRE STATE COLLEGE                    ,NY,12866-4391,Public       ,47,784,831,917,12854,13771
01037800,RABBINICAL COLLEGE OF LONG ISLAND       ,NY,11561-3244,Private      ,14,0,14,43,1,44
01054900,KEHILATH YAKOV RABBINICAL SEMINARY      ,NY,10562-1001,Private      ,20,13,33,38,33,71
01055100,NEW YORK SCH MED & DENTAL ASSISTANT     ,NY,11101-2327,Proprietary  ,29,60,89,153,395,548
01064100,SOUTHERN WESTCHESTER BOCES              ,NY,10543-0000,Public       ,0,3,3,12,160,172
01068400,ERIE COMMUNITY COLLEGE-ALL CAMPUSES     ,NY,14203-2698,Public       ,294,366,660,8989,8843,17832
01081300,AMERICAN ACAD MCALLISTER INST           ,NY,10019-3604,Private      ,4,22,26,114,461,575
01083700,SIMMONS INST OF FUNERAL SERVICE         ,NY,13207-2098,Proprietary  ,0,0,0,29,43,72
01093000,SUBURBAN TECHNICAL SCHOOL               ,NY,11550-3771,Proprietary  ,7,42,49,268,1069,1337
01094300,RABBINICAL COLLEGE BETH SHRAGA          ,NY,10952-3033,Private      ,9,0,9,22,0,22
01095200,PNW BOCES LPN PROGRAM                   ,NY,10598-0000,Public       ,0,3,3,10,87,97
01103100,TECHNICAL CAREER INSTITUTE              ,NY,10001-2789,Proprietary  ,227,422,649,2241,5306,7547
01118900,UNITED TALMUDICAL SEMINARY              ,NY,11211-7984,Private      ,182,217,399,632,403,1035
01119200,BETH HAMEDRASH SHAAREI YOSHER INST      ,NY,11204-1052,Private      ,11,7,18,12,9,21
01161400,CHAMPLAIN VALLEY HOSP SCH RAD TECH      ,NY,12901-1490,Private      ,1,2,3,27,21,48
01161700,NEW YORK METHODIST HOSPITAL             ,NY,11229-9023,Private      ,3,9,12,77,248,325
01164700,SBI CAMPUS - AN AFFILIATE OF SANFORD-BRO,NY,11747-3785,Proprietary  ,54,199,253,349,747,1096
01167000,YESHIVA OF NITRA RABBINICAL COLLEGE     ,NY,11211-7108,Private      ,55,13,68,96,13,109
01167700,MEMORIAL SLOAN KETTERING CANCER CTR     ,NY,10021-6094,Private      ,0,3,3,4,29,33
01167800,SUNY INST OF TECHNOLOGY UTICA ROME      ,NY,13504-3050,Public       ,24,25,49,1790,1257,3047
01182100,YESHIVATH ZICHRON MOSHE                 ,NY,12779-0580,Private      ,10,0,10,85,3,88
01183000,BERK TRADE AND BUSINESS SCHOOL          ,NY,11101-0000,Proprietary  ,11,43,54,55,169,224
01185900,WORD OF LIFE BIBLE INSTITUTE            ,NY,12860-0129,Private      ,14,3,17,569,90,659
01186000,MERCY MED CNTR SCHL OF RADIOGRAPHY      ,NY,11570-1098,Private      ,0,1,1,7,28,35
01192100,WESTCHESTER SCH OF BEAUTY CULTURE       ,NY,10550-2295,Proprietary  ,1,15,16,14,105,119
01192200,BETH HATALMUD RABBINICAL CLG            ,NY,11214-2594,Private      ,34,1,35,35,2,37
01198400,OHR HAMEIR THEOLOGICAL SEMINARY         ,NY,10566-0990,Private      ,16,0,16,58,0,58
01201100,TALMUDICAL SEM OHOLEI TORAH             ,NY,11213-3310,Private      ,107,0,107,253,1,254
01207200,PHILLIPS HAIRSTYLING INSTITUTE          ,NY,13210-1509,Proprietary  ,4,25,29,39,131,170
01210700,INSTITUTE OF DESIGN & CONSTRUCTION      ,NY,11201-5380,Private      ,8,13,21,55,164,219
01220300,MEMORIAL HOSPITAL SCH OF NURSING        ,NY,12204-1083,Private      ,1,2,3,56,182,238
01227700,NEW YORK CHIROPRACTIC COLLEGE           ,NY,13148-0800,Private      ,0,13,13,22,777,799
01229300,VEEB NASSAU CNTY SCHL OF PRACT NURS     ,NY,11553-3037,Public       ,0,0,0,55,226,281
01235800,PLAZA COLLEGE                           ,NY,11372-6300,Proprietary  ,81,111,192,430,1067,1497
01236400,SAINT VINCENTS CATHOLIC MEDICAL CENTERS ,NY,11354-0000,Proprietary  ,1,14,15,54,337,391
01240700,SCHUYLER-CHEMUNG-TIOGA BOCES            ,NY,14903-1089,Public       ,1,5,6,18,163,181
01240701,STEUBEN SCHUYLER CHEMUNG TIOGA ALLEGANY ,NY,14870-9518,Public       ,0,0,0,0,4,4
01256100,FIVE TOWNS COLLEGE                      ,NY,11746-5871,Proprietary  ,25,23,48,1463,379,1842
01258900,ERIE 1 BOCES                            ,NY,14224-0000,Public       ,2,7,9,57,280,337
01265200,ONONDAGA CORTLAND MADISON BOCES         ,NY,13090-4500,Public       ,20,74,94,212,915,1127
01278300,OSWEGO COUNTY BOCES ADULT CAREERS       ,NY,13114-4498,Public       ,0,3,3,39,88,127
01292700,CENTRAL TECH NURSING PROGRAM            ,NY,13202-3092,Public       ,3,3,6,30,114,144
01302600,MACHZIKEI HADATH RABBINICAL COLLEGE     ,NY,11204-1805,Private      ,32,21,53,36,22,58
01302700,YESHIVATH VIZNITZ                       ,NY,10952-3021,Private      ,34,0,34,34,0,34
01302900,BORICUA COLLEGE                         ,NY,10032-1599,Private      ,65,141,206,548,1372,1920
02056400,CAPRI COSMETOLOGY LEARNING CENTER       ,NY,10954-0000,Proprietary  ,19,64,83,134,279,413
02056401,CAPRI COSMETOLOGY LEARNING CENTER       ,NY,12550-2118,Proprietary  ,0,0,0,7,11,18
02066200,THE NEW SCHOOL                          ,NY,10011-0000,Private      ,72,156,228,5429,6468,11897
02069000,NEW YORK SCHOOL OF INTERIOR DESIGN      ,NY,10021-0000,Private      ,3,15,18,180,429,609
02075700,BRIARCLIFFE COLLEGE                     ,NY,11714-0000,Proprietary  ,19,68,87,962,961,1923
02075702,BRIARCLIFFE COLLEGE - PATCHOGUE         ,NY,11772-3019,Proprietary  ,27,60,87,693,821,1514
02092400,RIDLEY-LOWELL SCHOOL OF BUSINESS        ,NY,13905-0000,Proprietary  ,7,41,48,35,303,338
02093700,LONG ISLAND BUSINESS INSTITUTE          ,NY,11725-0000,Proprietary  ,75,125,200,545,1194,1739
02093701,LONG ISLAND BUSINESS INSTITUTE - FLUSHIN,NY,11354-4429,Proprietary  ,0,0,0,11,27,38
02098400,HERKIMER COUNTY BOCES                   ,NY,13350-0000,Public       ,0,4,4,49,149,198
02104300,OTSEGO AREA SCHOOL OF PRAC NURSING      ,NY,12167-0000,Public       ,0,1,1,18,34,52
02105900,HAIR DESIGN INSTITUTE AT FIFTH AVE      ,NY,11220-0000,Proprietary  ,31,74,105,124,357,481
02106800,BRAMSON ORT COLLEGE                     ,NY,11375-0000,Private      ,93,117,210,492,811,1303
02110900,CATTARAUGUS/ALLEGANY BOCES              ,NY,14760-0000,Public       ,1,0,1,30,136,166
02112301,RIDLEY - LOWELL BUSINESS & TECHNICAL INS,NY,12601-3328,Proprietary  ,16,77,93,88,500,588
02116011,SANFORD-BROWN INSTITUTE - NEW YORK      ,NY,10003-2103,Proprietary  ,134,384,518,911,2380,3291
02118700,LONG ISLAND COLLEGE HOSPITAL - SCHOOL OF,NY,11201-6001,Private      ,2,9,11,131,375,506
02118702,LONG ISLAND COLLEGE HOSPITAL - SCHOOL OF,NY,11201-6001,Private      ,1,9,10,139,279,418
02124000,ORANGE ULSTER BOCES SCH OF PRAC NRS     ,NY,10924-9401,Public       ,2,6,8,33,145,178
02125500,CIRCLE IN THE SQUARE THEATRE SCHOOL     ,NY,10019-0000,Private      ,0,6,6,56,58,114
02126300,MADISON-ONEIDA BOCES PRAC NRS           ,NY,13478-0000,Public       ,1,16,17,27,159,186
02138500,BOCES RENSSELAER SCHOOL OF PN           ,NY,12033-3221,Public       ,0,0,0,27,95,122
02145800,CAYUGA ONONDAGA BOCES                   ,NY,13021-9430,Public       ,1,7,8,21,90,111
02146000,WAYNE-FINGER LAKES BOCES                ,NY,14513-0000,Public       ,0,3,3,32,172,204
02152000,YESHIVA SHAAR HATORAH ITRI TORAH        ,NY,11418-0000,Private      ,0,0,0,4,0,4
02153600,BROOME-TIOGA BOCES PN PROG              ,NY,13905-0000,Public       ,0,2,2,27,163,190
02157900,ROCHESTER GENERAL HOSPITAL              ,NY,14621-3001,Private      ,0,3,3,33,121,154
02158200,WSHNGTN-SARTGA-WARN-HMLTN-ESX BOCES     ,NY,12839-1051,Public       ,0,1,1,28,102,130
02160100,GENEVA GENERAL HOSPITAL                 ,NY,14456-0000,Private      ,0,3,3,32,144,176
02163400,NEW YORK CAREER INSTITUTE               ,NY,10007-2801,Proprietary  ,22,88,110,282,880,1162
02169100,DAVIS COLLEGE                           ,NY,13790-0000,Private      ,1,2,3,168,105,273
02170000,SWEDISH INSTITUTE                       ,NY,10001-0000,Proprietary  ,13,45,58,144,703,847
02170200,ALBANY SCHOHARIE SCHENECTADY            ,NY,12205-0000,Public       ,2,7,9,66,183,249
02171900,AILEY SCHOOL (THE)                      ,NY,10019-4402,Private      ,5,3,8,132,78,210
02172100,HAMILTON-FULTON-MONTGOMERY BOCES        ,NY,12095-0665,Public       ,0,1,1,61,94,155
02172800,DUTCHESS COUNTY BOCES SCH PRAC NURS     ,NY,12601-0000,Public       ,5,12,17,64,200,264
02173200,EMPIRE BEAUTY SCHOOL                    ,NY,10001-0000,Proprietary  ,82,145,227,563,1137,1700
02173201,LEARNING INSTITUTES FOR BEAUTY SCIENCES-,NY,11214-4347,Proprietary  ,0,0,0,6,21,27
02173900,ULSTER COUNTY BOCES PRACTICAL NRSG      ,NY,12466-0000,Public       ,1,6,7,40,191,231
02176000,CHERYL FELL'S SCHOOL OF BUSINESS        ,NY,14304-0000,Proprietary  ,1,9,10,10,83,93
02179400,EASTERN SUFFOLK BOCES                   ,NY,11713-0000,Public       ,1,10,11,198,488,686
02182200,NEW SCHOOL OF RADIO & TELEVISION        ,NY,12206-1106,Proprietary  ,4,18,22,53,103,156
02187300,DARKEI NOAM RABBINICAL COLLEGE          ,NY,11210-0000,Private      ,0,1,1,1,6,7
02191600,TORAH TEMIMAH TALMUDICAL SEMINARY       ,NY,11218-0000,Private      ,22,0,22,79,1,80
02192500,BELLEVUE HOSP CTR SCH RAD TECH          ,NY,10016-0000,Public       ,0,6,6,19,65,84
02193700,SAINT LAWRENCE LEWIS COUNTY BOCES       ,NY,13617-0000,Public       ,0,0,0,21,2,23
02199300,ORLEANS-NIAGARA BOCES                   ,NY,14132-0000,Public       ,2,4,6,18,78,96
02206000,HUNTER BUSINESS SCHOOL                  ,NY,11756-0000,Proprietary  ,30,187,217,302,902,1204
02217800,D.HOPFER SCH NURSING AT MT.VRN HOSP     ,NY,10550-0000,Private      ,1,3,4,45,270,315
02219500,MILDRED ELLEY                           ,NY,12206-1513,Proprietary  ,76,407,483,522,2567,3089
02235600,ERIE 2-CHAUTAUQUA-CATTARAUGUS BOCES     ,NY,14006-0000,Public       ,1,1,2,19,143,162
02256700,KOL YAAKOV TORAH CENTER                 ,NY,10952-0000,Private      ,0,0,0,3,3,6
02265100,YESHIVA DERECH CHAIM                    ,NY,11218-0000,Private      ,20,3,23,52,14,66
02265200,GLOBAL BUSINESS INSTITUTE               ,NY,11691-0000,Private      ,28,99,127,342,1222,1564
02272900,ROCKLAND COUNTY BOCES PRAC NRSG SCH     ,NY,10994-0000,Public       ,0,1,1,21,114,135
02275900,"MODERN WELDING SCHOOL, INC.             ",NY,12304-0000,Proprietary  ,10,28,38,51,140,191
02287800,NATIONAL TRACTOR TRAILER SCHOOL         ,NY,13088-2505,Proprietary  ,11,138,149,45,642,687
02294900,INSTITUTE OF AUDIO RESEARCH             ,NY,10003-0000,Proprietary  ,50,53,103,460,483,943
02306500,PROFESSIONAL BUSINESS INSTITUTE         ,NY,10002-0000,Private      ,83,103,186,569,852,1421
02314200,NORTHERN WESTCHESTER SCH COSMETOL       ,NY,10566-0000,Proprietary  ,4,6,10,30,49,79
02320100,OHR SOMAYACH TANENBAUM EDUCATIONAL CENTE,NY,10952-0000,Private      ,0,0,0,1,0,1
02325600,NEW YORK INSTITUTE OF ENGLISH & BUS     ,NY,10001-0000,Private      ,36,64,100,178,363,541
02350600,YESHIVA AND KOLLEL HARBOTZAS TORAH      ,NY,11230-0000,Private      ,0,13,13,0,22,22
02491400,SPANISH AMERICAN INSTITUTE              ,NY,10036-0000,Private      ,0,12,12,2,30,32
02505800,YESHIVA KARLIN STOLIN RAB INSTITUTE     ,NY,11204-0000,Private      ,7,37,44,23,49,72
02505900,SH-OR YOSHUV RABBINICAL COLLEGE         ,NY,11691-0000,Private      ,2,0,2,41,17,58
02506000,ASSOCIATED BETH RIVKAH SCHOOLS          ,NY,11225-0000,Private      ,2,5,7,71,24,95
02506100,CITY UNIV OF NEW YORK-CENTRAL           ,NY,10021-0000,Public       ,14,35,49,1020,633,1653
02506200,MERCE CUNNINGHAM STUDIO                 ,NY,10014-0000,Private      ,1,1,2,5,4,9
02506800,YESHIVAT MIKDASH MELECH                 ,NY,11230-0000,Private      ,9,5,14,45,9,54
02511500,JOFFREY BALLET SCHOOL                   ,NY,10011-0000,Proprietary  ,3,0,3,75,9,84
02513500,MAR JON SCHOOL OF BEAUTY CULTURE        ,NY,14150-0000,Proprietary  ,5,26,31,26,84,110
02525600,ART INSTITUTE OF NEW YORK CITY (THE)    ,NY,10013-2429,Proprietary  ,151,131,282,2364,1471,3835
02540800,"GLOBE INSTITUTE OF TECHNOLOGY, INC.     ",NY,10007-0000,Proprietary  ,51,72,123,436,471,907
02546000,TRI-STATE COLLEGE OF ACUPUNCTURE        ,NY,10011-0000,Proprietary  ,0,5,5,1,158,159
02546300,YESHIVA OF THE TELSHE ALUMNI            ,NY,10471-0000,Private      ,27,0,27,28,2,30
02550600,TALMUDICAL INST OF UPSTATE NY           ,NY,14607-0000,Private      ,5,1,6,7,7,14
02556700,SEMINAR L'MOROS BAIS YAAKOV             ,NY,11219-0000,Private      ,6,0,6,281,0,281
02572900,BUSINESS INFORMATICS CENTER             ,NY,11580-0000,Proprietary  ,1,11,12,26,120,146
02575400,FRENCH CULINARY INSTITUTE               ,NY,10013-2618,Proprietary  ,46,149,195,439,1213,1652
02587600,ORLO SCH HAIR DESIGN & COSMETOLOGY      ,NY,12206-1723,Proprietary  ,7,18,25,74,109,183
02599400,NEW YORK COLLEGE OF HEALTH PROFESSIONS  ,NY,11791-4413,Private      ,3,24,27,209,744,953
02600100,NEW YORK ACADEMY OF ART (THE)           ,NY,10013-2911,Private      ,4,9,13,108,247,355
02614900,SANFORD-BROWN INSTITUTE                 ,NY,10604-2910,Proprietary  ,35,109,144,280,823,1103
02615001,SANFORD-BROWN COLLEGE - SANFORD-BROWN IN,NY,11530-4734,Proprietary  ,4,15,19,59,154,213
02616600,SHEAR EGO INTERNATIONAL SCHOOL OF HAIR D,NY,14617-3501,Proprietary  ,5,23,28,74,162,236
02617000,CONTINENTAL SCH OF BEAUTY CULTURE       ,NY,14020-1908,Proprietary  ,10,22,32,73,156,229
02617001,CONTINENTAL SCHOOL OF BEAUTY CULTURE - O,NY,14760-2618,Proprietary  ,0,0,0,7,10,17
02622900,BAIS MEDRASH ELYON                      ,NY,10952-3013,Private      ,1,0,1,1,1,2
03000100,YESHIVA GEDOLAH IMREI YOSEF DSPINKA     ,NY,11219-4696,Private      ,4,52,56,5,91,96
03007200,DANCE THEATRE OF HARLEM                 ,NY,10031-0000,Private      ,2,0,2,38,21,59
03027701,PACIFIC COLLEGE OF ORIENTAL MEDICINE - N,NY,10010-7108,Proprietary  ,2,54,56,31,617,648
03081600,DELAWARE CHENANGO MADISON OT. BOCES     ,NY,13815-9554,Public       ,5,24,29,27,118,145
03089700,COMPUTER CAREER CENTER                  ,NY,11530-3334,Proprietary  ,44,130,174,307,1138,1445
03095500,ASA INST BUSINESS & COMPUTER TECH       ,NY,11201-5208,Proprietary  ,448,780,1228,3026,6247,9273
03096200,CHARLES STUART SCHOOL                   ,NY,11229-2004,Proprietary  ,1,10,11,8,52,60
03097801,CARSTEN INSTITUTE                       ,NY,10003-1901,Proprietary  ,0,0,0,10,24,34
03099100,SUNBRIDGE COLLEGE                       ,NY,10977-0000,Private      ,0,0,0,1,1,2
03103700,ADIRONDACK BEAUTY SCHOOL                ,NY,12801-3158,Proprietary  ,1,2,3,28,45,73
03104900,SULLIVAN COUNTY BOCES                   ,NY,12754-2116,Public       ,0,1,1,24,70,94
03115300,GENESEE VALLEY BOCES                    ,NY,14020-1099,Public       ,4,16,20,51,215,266
03120700,NEW YORK CONSERVATORY FOR DRAMATIC ARTS ,NY,10011-4225,Proprietary  ,5,5,10,485,143,628
03127100,YESHIVAS NOVOMINSK                      ,NY,11219-0000,Private      ,22,0,22,44,0,44
03129200,RABBINICAL CLG OHR SHIMAR YISROEL       ,NY,11211-8102,Private      ,4,36,40,31,119,150
03147300,YESHIVA D'MONSEY                        ,NY,10952-3106,Private      ,0,33,33,0,33,33
03169300,STUDIO JEWELERS                         ,NY,10016-4112,Proprietary  ,2,9,11,4,33,37
03181400,MERKAZ BNOS                             ,NY,11214-4911,Private      ,4,44,48,28,338,366
03191300,CUNY SCHOOL OF LAW @ QUEENS COLLEGE     ,NY,11367-0000,Public       ,12,20,32,498,1583,2081
03193300,MANHATTAN SCHOOL OF COMPUTER TECH       ,NY,11230-1617,Private      ,25,107,132,161,729,890
03203300,NEW YORK INSTITUTE OF MASSAGE           ,NY,14221-6021,Proprietary  ,5,21,26,63,171,234
03216300,UNIFICATION THEOLOGICAL SEMINARY        ,NY,12507-5021,Private      ,0,5,5,0,22,22
03315300,HARLEM SCHOOL OF TECHNOLOGY             ,NY,10027-4426,Proprietary  ,0,0,0,15,38,53
03328300,FRANKLIN CAREER INSTITUTE               ,NY,11550-3003,Private      ,14,37,51,110,318,428
03328301,FRANKLIN CAREER INSTITUTE - BROOKLYN    ,NY,11220-3110,Private      ,19,54,73,180,437,617
03342400,AMERICAN BARBER INSTITUTE               ,NY,10001-5271,Proprietary  ,12,23,35,60,135,195
03358300,ALLEN SCHOOL                            ,NY,11432-4901,Proprietary  ,56,375,431,242,1383,1625
03358301,ALLEN SCHOOL - BROOKLYN                 ,NY,11201-0000,Proprietary  ,31,152,183,238,918,1156
03380300,STAR CAREER ACADEMY                     ,NY,11791-5311,Proprietary  ,28,79,107,163,364,527
03419400,NORTHEASTERN SEMINARY                   ,NY,14624-1997,Private      ,0,7,7,10,124,134
03426400,ANTHEM INSTITUTE                        ,NY,10018-0000,Proprietary  ,45,145,190,392,770,1162
03433500,LIA SCHORR INSTITUTE OF COSMETIC SK     ,NY,10022-2614,Proprietary  ,3,16,19,16,82,98
03443300,NEW YORK COLLEGE OF TRADITIONAL CHINESE ,NY,11501-0000,Private      ,0,3,3,5,116,121
03496300,YESHIVA SHAAREI TORAH OF ROCKLAND       ,NY,10901-4003,Private      ,0,0,0,1,6,7
03537300,NEW YORK AUTOMOTIVE & DIESEL INSTIT     ,NY,11101-0000,Proprietary  ,39,72,111,206,465,671
03568300,LEON STUDIO ONE SCHOOL OF HAIR DESI     ,NY,14221-5323,Proprietary  ,9,15,24,53,93,146
03651300,SAINT JOSEPH'S MEDICAL CENTER SCHOO     ,NY,10701-4080,Private      ,0,2,2,7,23,30
03652300,METROPOLITAN LEARNING INSTITUTE         ,NY,11374-2101,Private      ,12,197,209,93,1231,1324
03691300,USA BEAUTY SCHOOL INTERNATIONAL         ,NY,10013-3530,Proprietary  ,4,12,16,35,104,139
03713300,BEIS MEDRASH HEICHAL DOVID              ,NY,11691-4433,Private      ,6,2,8,36,6,42
03773300,CENTER FOR NATURAL WELLNESS SCHOOL OF MA,NY,12205-1601,Proprietary  ,3,39,42,34,213,247
03802300,UTA MESIVTA OF KIRYAS JOEL              ,NY,10950-2169,Private      ,113,179,292,356,488,844
03809400,MICROPOWER CAREER INSTITUTE             ,NY,10001-2812,Proprietary  ,16,114,130,58,645,703
03819400,HUDSON VALLEY SCHOOL OF ADVANCED AESTHET,NY,12493-0000,Proprietary  ,1,5,6,16,37,53
03839300,AVEDA INSTITUTE NEW YORK                ,NY,10013-1522,Proprietary  ,8,43,51,120,350,470
03881300,UNION GRADUATE COLLEGE                  ,NY,12308-3131,Private      ,1,8,9,20,249,269
03903400,AMERICAN BEAUTY SCHOOL                  ,NY,10462-8003,Proprietary  ,12,77,89,131,497,628
03941400,ELITE ACADEMY OF BEAUTY ARTS            ,NY,11223-1630,Proprietary  ,0,10,10,25,87,112
03983300,"SCHOOL OF PROFESSIONAL HORTICULTURE, AT ",NY,10458-5126,Private      ,0,1,1,4,24,28
03988300,"SAE INSTITUTE OF TECHNOLOGY, NEW YORK   ",NY,10001-2915,Proprietary  ,36,49,85,199,239,438
04043300,ACE COMPUTER TRAINING CENTER            ,NY,11375-5337,Proprietary  ,4,13,17,26,124,150
04092401,MAKE-UP DESIGNORY -                     ,NY,10012-0041,Proprietary  ,20,41,61,262,354,616
04095300,KING'S COLLEGE (THE)                    ,NY,10018-0110,Private      ,10,3,13,639,73,712
04102300,NEW AGE TRAINING                        ,NY,10001-4006,Proprietary  ,2,26,28,10,95,105
04115500,TALMUDICAL SEMINARY OF BOBOV            ,NY,11219-3826,Private      ,33,39,72,66,93,159
04117100,EDP SCHOOL OF COMPUTER PROGRAMMING      ,NY,11235-0000,Private      ,6,54,60,19,230,249
04117700,"MONROE 2-ORLEANS BOCES, CENTER FOR WORK ",NY,14624-1119,Public       ,4,25,29,40,150,190
04123200,INSTITUTE OF ALLIED MEDICAL PROFESSIONS ,NY,11373-5541,Private      ,1,17,18,82,406,488
04123300,HUDSON VALLEY SCHOOL OF MASSAGE THERAPY ,NY,12493-0000,Proprietary  ,1,16,17,20,97,117
04125600,CAREER SCHOOL OF NY                     ,NY,10301-2416,Private      ,7,14,21,73,108,181
04133700,NEW YORK MEDICAL CAREER TRAINING CENTER ,NY,11354-6504,Proprietary  ,10,31,41,44,161,205
04134000,"JOHN PAOLO'S XTREME BEAUTY INSTITUTE, GO",NY,12020-1245,Proprietary  ,3,19,22,18,80,98
04137700,ANN MARIE'S WORLD OF BEAUTY SCHOOL      ,NY,13901-2308,Proprietary  ,1,5,6,12,31,43
04138100,YESHIVA OF MACHZIKAI HADAS              ,NY,11219-1408,Private      ,10,37,47,11,136,147
04144300,INSTITUTE OF CULINARY EDUCATION         ,NY,10010-5205,Proprietary  ,40,122,162,474,1087,1561
04148000,NEW LIFE BUSINESS INSTITUTE             ,NY,11432-6149,Proprietary  ,8,55,63,36,203,239
04151200,SALON PROFESSIONAL ACADEMY (THE)        ,NY,14150-9200,Proprietary  ,3,5,8,48,72,120
04155300,ONONDAGA SCHOOL OF THERAPEUTIC MASSAGE  ,NY,13210-1533,Proprietary  ,1,3,4,70,259,329
04156000,ACADEMY OF COSMETOLOGY & ESTHETICS NYC (,NY,10306-3003,Proprietary  ,10,14,24,99,121,220
04165700,"JOHN PAOLO'S XTREME BEAUTY INSTITUTE, GO",NY,12110-3053,Proprietary  ,0,11,11,5,33,38
04166000,MANHATTAN INSTITUTE (THE)               ,NY,10016-6516,Proprietary  ,2,10,12,2,10,12
04167600,FINGER LAKES SCHOOL OF MASSAGE (THE)    ,NY,14850-1384,Proprietary  ,7,23,30,41,145,186
04167601,FINGER LAKES SCHOOL OF MASSAGE (THE) -  ,NY,10549-1103,Proprietary  ,6,13,19,15,54,69
04178700,ATELIER ESTHETIQUE INSTITUTE OF ESTHETIC,NY,10016-8804,Proprietary  ,8,63,71,8,79,87
04180200,LONG ISLAND NAIL & SKIN CARE INSTITUTE  ,NY,11756-1316,Proprietary  ,10,28,38,10,28,38
00267808,BRYANT & STRATTON COLLEGE - PARMA       ,OH,44130-0000,Proprietary  ,42,208,250,820,3998,4818
00301000,ANTIOCH UNIVERSITY                      ,OH,45387-1608,Private      ,1,68,69,40,1169,1209
00301100,ART ACADEMY OF CINCINNATI               ,OH,45202-7106,Private      ,4,12,16,380,150,530
00301200,ASHLAND UNIVERSITY                      ,OH,44805-3799,Private      ,25,190,215,3933,3627,7560
00301221,ASHLAND UNIVERSITY - MANSFIELD          ,OH,44903-2269,Private      ,0,0,0,328,289,617
00301300,ATHENAEUM OF OHIO                       ,OH,45230-2000,Private      ,0,1,1,5,17,22
00301400,BALDWIN-WALLACE COLLEGE                 ,OH,44017-2088,Private      ,37,54,91,4694,1753,6447
00301600,BLUFFTON UNIVERSITY                     ,OH,45817-2104,Private      ,13,13,26,1586,408,1994
00301800,BOWLING GREEN STATE UNIVERSITY          ,OH,43403-0001,Public       ,175,202,377,18939,7276,26215
00302300,CAPITAL UNIVERSITY                      ,OH,43209-2394,Private      ,27,110,137,4136,3165,7301
00302400,CASE WESTERN RESERVE UNIV               ,OH,44106-0000,Private      ,46,36,82,6713,1341,8054
00302401,CASE WESTERN RESERVE UNIV - MED         ,OH,44106-0000,Private      ,3,9,12,62,1132,1194
00302402,CASE WESTERN RESERVE UNIV - DENTAL      ,OH,44106-0000,Private      ,0,2,2,25,304,329
00302403,CASE WESTERN RESERVE UNIV - LAW         ,OH,44106-0000,Private      ,0,5,5,26,1286,1312
00302404,CASE WESTERN RESERVE UNIV - UG          ,OH,44106-0000,Private      ,2,3,5,381,66,447
00302405,CASE WESTERN RESERVE UNIV - MSASS       ,OH,44106-0000,Private      ,0,6,6,48,521,569
00302406,CASE WESTERN RESERVE UNIV - NURS UG     ,OH,44106-0000,Private      ,4,10,14,226,209,435
00302407,CASE WESTERN RESERVE UNIV - WSOM        ,OH,44106-0000,Private      ,0,8,8,20,290,310
00302408,CASE WESTERN RESERVE UNIV -A&S GRAD     ,OH,44106-0000,Private      ,0,14,14,19,388,407
00302409,CASE WESTERN RESERVE UNIV -ENG GRAD     ,OH,44106-0000,Private      ,0,5,5,30,115,145
00302410,CASE WESTERN RESERVE UNIV -NURS GRD     ,OH,44106-0000,Private      ,1,13,14,15,418,433
00302500,CEDARVILLE UNIVERSITY                   ,OH,45314-8564,Private      ,31,14,45,3998,291,4289
00302600,CENTRAL STATE UNIVERSITY                ,OH,45384-1004,Public       ,57,30,87,3528,1635,5163
00302900,CINCINNATI CHRISTIAN UNIVERSITY         ,OH,45204-3200,Private      ,4,45,49,599,738,1337
00303000,OHIO CHRISTIAN UNIVERSITY               ,OH,43113-9487,Private      ,17,295,312,550,2134,2684
00303100,CLEVELAND INSTITUTE OF MUSIC            ,OH,44106-1776,Private      ,2,5,7,487,456,943
00303200,CLEVELAND STATE UNIVERSITY              ,OH,44115-2214,Public       ,120,519,639,8817,15483,24300
00303300,COLLEGE OF MT ST JOSEPH                 ,OH,45233-1670,Private      ,12,56,68,1835,1440,3275
00303500,OHIO DOMINICAN UNIVERSITY               ,OH,43219-2099,Private      ,29,149,178,2258,2899,5157
00303600,FRANCISCAN UNIV OF STEUBENVILLE         ,OH,43952-1763,Private      ,13,24,37,2269,716,2985
00303700,COLLEGE OF WOOSTER                      ,OH,44691-2363,Private      ,20,3,23,3116,116,3232
00303900,COLUMBUS COLLEGE OF ART AND DESIGN      ,OH,43215-1758,Private      ,19,21,40,1788,612,2400
00304000,CUYAHOGA COMMUNITY COLLEGE              ,OH,44115-2878,Public       ,358,1410,1768,11648,29654,41302
00304100,"DEFIANCE COLLEGE, THE                   ",OH,43512-1695,Private      ,14,7,21,1452,564,2016
00304200,DENISON UNIVERSITY                      ,OH,43023-1329,Private      ,7,4,11,2915,94,3009
00304300,CHANCELLOR UNIVERSITY                   ,OH,44114-1096,Proprietary  ,3,64,67,53,1015,1068
00304400,TRINITY LUTHERAN SEMINARY               ,OH,43209-0000,Private      ,0,2,2,2,160,162
00304500,UNIVERSITY OF FINDLAY                   ,OH,45840-3695,Private      ,15,51,66,3323,1750,5073
00304600,FRANKLIN UNIVERSITY                     ,OH,43215-5399,Private      ,36,464,500,1065,11226,12291
00304700,HEBREW UNION COLLEGE MAIN CAMPUS        ,OH,45220-0000,Private      ,0,1,1,4,116,120
00304800,HEIDELBERG UNIVERSITY                   ,OH,44883-2462,Private      ,18,13,31,2065,450,2515
00304900,HIRAM COLLEGE                           ,OH,44234-1808,Private      ,10,10,20,1769,396,2165
00305000,JOHN CARROLL UNIVERSITY                 ,OH,44118-4581,Private      ,24,34,58,4267,1181,5448
00305100,KENT STATE UNIV - KENT CAMPUS           ,OH,44242-0001,Public       ,204,335,539,22056,12196,34252
00305101,KENT STATE UNIV - GEAUGA CAMPUS         ,OH,44021-0000,Public       ,9,30,39,462,809,1271
00305102,KENT STATE UNIV - STARK CAMPUS          ,OH,44720-0000,Public       ,35,91,126,2613,3205,5818
00305103,KENT STATE UNIV - TUSCARAWAS CAMPUS     ,OH,44663-0000,Public       ,17,69,86,1085,1966,3051
00305104,KENT STATE UNIV - TRUMBULL CAMPUS       ,OH,44483-0000,Public       ,18,70,88,1007,2302,3309
00305105,KENT STATE UNIV - ASHTABULA CAMPUS      ,OH,44004-0000,Public       ,22,51,73,1003,2127,3130
00305106,KENT STATE UNIV -E.LIVERPOOL CAMPUS     ,OH,43920-0000,Public       ,5,16,21,408,887,1295
00305107,KENT STATE UNIV - SALEM CAMPUS          ,OH,44460-0000,Public       ,7,39,46,882,1408,2290
00306500,KENYON COLLEGE                          ,OH,43022-9623,Private      ,12,2,14,2522,40,2562
00306600,LAKE ERIE COLLEGE                       ,OH,44077-3389,Private      ,7,21,28,1633,539,2172
00306800,LORAIN COUNTY COMMUNITY COLLEGE         ,OH,44035-1691,Public       ,151,461,612,4138,9769,13907
00306900,LOURDES COLLEGE                         ,OH,43560-2898,Private      ,13,81,94,907,2515,3422
00307200,MALONE UNIVERSITY                       ,OH,44709-3897,Private      ,9,84,93,2243,1600,3843
00307300,MARIETTA COLLEGE                        ,OH,45750-4033,Private      ,16,16,32,2610,342,2952
00307500,METHODIST THEOLOGICAL SCH IN OHIO       ,OH,43015-0000,Private      ,0,2,2,1,219,220
00307600,MIAMI-JACOBS COLLEGE                    ,OH,45401-0000,Proprietary  ,12,106,118,226,1444,1670
00307602,MIAMI - JACOBS CAREER COLLEGE - SPRINGBO,OH,45066-1115,Proprietary  ,8,54,62,131,632,763
00307603,MIAMI - JACOBS CAREER COLLEGE - TROY    ,OH,45373-3837,Proprietary  ,10,89,99,217,988,1205
00307700,MIAMI UNIVERSITY                        ,OH,45056-1831,Public       ,190,264,454,19920,6412,26332
00307800,WRIGHT STATE UNIVERSITY                 ,OH,45435-0002,Public       ,201,462,663,14329,11959,26288
00308300,UNIVERSITY OF MOUNT UNION               ,OH,44601-3993,Private      ,17,15,32,3663,323,3986
00308400,MUSKINGUM UNIVERSITY                    ,OH,43762-1199,Private      ,10,50,60,2390,807,3197
00308500,NOTRE DAME COLLEGE OF OHIO              ,OH,44121-4293,Private      ,11,76,87,1939,1591,3530
00308600,OBERLIN COLLEGE                         ,OH,44074-1090,Private      ,22,4,26,5086,182,5268
00308800,OHIO COLLEGE OF PODIATRIC MEDICINE      ,OH,44131-7304,Private      ,0,3,3,2,491,493
00308900,OHIO NORTHERN UNIVERSITY                ,OH,45810-1555,Private      ,24,12,36,4005,1220,5225
00309000,OHIO STATE UNIVERSITY-ALL CAMPUSES      ,OH,43210-1358,Public       ,567,843,1410,49079,27035,76114
00310000,OHIO UNIVERSITY                         ,OH,45701-2979,Public       ,185,630,815,20997,9367,30364
00310002,"OHIO UNIVERSITY, ZANESVILLE CAMPUS      ",OH,43701-0000,Public       ,22,109,131,1193,1588,2781
00310003,"OHIO UNIVERSITY, LANCASTER CAMPUS       ",OH,43130-0000,Public       ,41,144,185,1283,2052,3335
00310004,"OHIO UNIVERSITY, SOUTHERN CAMPUS        ",OH,45638-0000,Public       ,34,149,183,1000,2121,3121
00310005,"OHIO UNIVERSITY, CHILLICOTHE CAMPUS     ",OH,45601-0000,Public       ,53,194,247,1177,2752,3929
00310006,"OHIO UNIVERSITY, EASTERN CAMPUS         ",OH,43950-0000,Public       ,9,20,29,551,360,911
00310008,OHIO UNIV COLL OF OSTEOPATHIC MED       ,OH,45701-0000,Public       ,0,0,0,8,480,488
00310900,OHIO WESLEYAN UNIVERSITY                ,OH,43015-2398,Private      ,17,13,30,2953,197,3150
00311000,OTTERBEIN UNIVERSITY                    ,OH,43081-2006,Private      ,33,76,109,4029,1229,5258
00311300,PONTIFICAL COLLEGE JOSEPHINUM           ,OH,43235-1498,Private      ,0,2,2,26,32,58
00311400,FIRELANDS REGIONAL MEDICAL CENTER - SOUT,OH,44870-4788,Private      ,0,2,2,60,174,234
00311500,RABBINICAL COLLEGE OF TELSHE            ,OH,44092-2584,Private      ,1,0,1,6,12,18
00311600,UNIV OF RIO GRANDE                      ,OH,45674-3131,Private      ,21,109,130,1610,2086,3696
00311900,SINCLAIR COMMUNITY COLLEGE              ,OH,45402-1460,Public       ,384,1684,2068,9339,22851,32190
00312100,TIFFIN UNIVERSITY                       ,OH,44883-2161,Private      ,122,1178,1300,2763,6702,9465
00312200,UNITED THEOLOGICAL SEMINARY             ,OH,45406-0000,Private      ,0,20,20,2,388,390
00312300,UNIVERSITY OF AKRON                     ,OH,44325-6211,Public       ,185,362,547,20623,16068,36691
00312500,UNIVERSITY OF CINCINNATI                ,OH,45221-0125,Public       ,372,1102,1474,26259,23779,50038
00312504,UNIVERSITY OF CINCINNATI - MEDICINE     ,OH,45267-0553,Public       ,7,33,40,711,1702,2413
00312700,UNIVERSITY OF DAYTON                    ,OH,45469-0002,Private      ,87,162,249,10742,4257,14999
00313100,UNIVERSITY OF TOLEDO                    ,OH,43606-3390,Public       ,185,274,459,18340,11000,29340
00313101,UNIVERSITY OF TOLEDO - HEALTH SCIENCE CA,OH,43614-2598,Public       ,5,43,48,885,1682,2567
00313300,URBANA UNIVERSITY                       ,OH,43078-2091,Private      ,5,33,38,1005,754,1759
00313400,URSULINE COLLEGE                        ,OH,44124-4398,Private      ,3,57,60,647,1402,2049
00313500,WALSH UNIVERSITY                        ,OH,44720-3396,Private      ,13,48,61,2445,1273,3718
00314100,WILBERFORCE UNIVERSITY                  ,OH,45384-1001,Private      ,18,16,34,935,511,1446
00314200,WILMINGTON COLLEGE                      ,OH,45177-2499,Private      ,11,17,28,1753,567,2320
00314300,WITTENBERG UNIVERSITY                   ,OH,45501-2199,Private      ,29,15,44,2839,298,3137
00314400,XAVIER UNIVERSITY                       ,OH,45207-1035,Private      ,61,140,201,6914,3553,10467
00314500,YOUNGSTOWN STATE UNIVERSITY             ,OH,44555-0001,Public       ,137,263,400,10000,8878,18878
00398200,CLEVELAND INSTITUTE OF ART              ,OH,44106-1700,Private      ,11,10,21,967,271,1238
00406000,WINEBRENNER THEOLOGICAL SEMINARY        ,OH,45840-0000,Private      ,0,4,4,2,63,65
00485200,CLARK STATE COMMUNITY COLLEGE           ,OH,45505-4795,Public       ,88,465,553,1863,6114,7977
00485300,BRADFORD SCHOOL                         ,OH,43219-0000,Proprietary  ,20,48,68,769,748,1517
00485500,DAVIS COLLEGE                           ,OH,43623-4307,Proprietary  ,11,51,62,182,925,1107
00486100,UNIVERSITY OF NORTHWESTERN OHIO         ,OH,45805-1498,Private      ,162,157,319,4639,2178,6817
00486600,STAUTZENBERGER COLLEGE                  ,OH,43537-4007,Proprietary  ,46,150,196,485,1939,2424
00510200,SCH OF DIAGNOSTIC IMAGING-CLEVELAND     ,OH,44119-0000,Private      ,0,2,2,7,47,54
00512728,BROWN MACKIE COLLEGE-CINCINNATI - LANDMA,OH,45215-1231,Proprietary  ,0,0,0,1,12,13
00521000,CLEVELAND INSTITUTE OF ELECTRONICS      ,OH,44114-0000,Proprietary  ,0,0,0,12,184,196
00531300,NORTH CENTRAL STATE COLLEGE             ,OH,44901-0000,Public       ,48,257,305,1505,3798,5303
00575300,OWENS STATE COMMUNITY COLLEGE           ,OH,43699-0000,Public       ,175,661,836,6713,15663,22376
00648700,AULTMAN COLLEGE OF NURSING AND HEALTH SC,OH,44710-1799,Private      ,2,13,15,156,457,613
00648900,CHRIST COLLEGE OF NURSING AND HEALTH SCI,OH,45219-2906,Private      ,4,31,35,98,324,422
00649400,GOOD SAMARITAN COLG-NURSING/HEALTH      ,OH,45220-2489,Private      ,3,16,19,245,493,738
00649800,MERIDIA HURON SCHOOL OF NURSING         ,OH,44112-4308,Private      ,1,2,3,74,698,772
00650700,TRINIT HEALTH SYSTEM SCH OF NURSING     ,OH,43952-2667,Private      ,0,3,3,53,111,164
00680400,LAKELAND COMMUNITY COLLEGE              ,OH,44094-5198,Public       ,109,425,534,3381,7380,10761
00686700,COLUMBUS STATE COMMUNITY COLLEGE        ,OH,43215-1786,Public       ,531,2369,2900,14156,32226,46382
00703500,KETTERING COLLEGE OF MEDICAL ARTS       ,OH,45429-1299,Private      ,8,55,63,573,1110,1683
00708500,MOUNT VERNON NAZARENE UNIVERSITY        ,OH,43050-9500,Private      ,4,44,48,1606,723,2329
00708501,MOUNT VERNON NAZARENE UNIV - AGS        ,OH,43050-0000,Private      ,2,86,88,100,1104,1204
00727500,EASTERN GATEWAY COMMUNITY COLLEGE       ,OH,43952-3598,Public       ,25,94,119,967,1776,2743
00732920,ITT TECHNICAL INSTITUTE                 ,OH,45414-3456,Proprietary  ,50,206,256,653,2582,3235
00732992,ITT TECHNICAL INSTITUTE                 ,OH,44509-4098,Proprietary  ,63,201,264,745,2012,2757
00747300,CHOFFIN CAREER & TECHNICAL CENTER       ,OH,44503-1628,Public       ,3,12,15,65,371,436
00759800,HOCKING TECHNICAL COLLEGE               ,OH,45764-9582,Public       ,91,366,457,4253,5197,9450
00777700,REMINGTON COLLEGE - CLEVELAND CAMPUS    ,OH,44125-1957,Proprietary  ,63,279,342,355,1803,2158
00777704,REMINGTON COLLEGE-CLEVELAND WEST CAMPUS ,OH,44070-3129,Proprietary  ,15,68,83,150,634,784
00812900,ADULT AND COMMUNITY EDUCATION @ HUDSON  ,OH,43211-2017,Public       ,4,44,48,56,533,589
00813200,TOLEDO SCHOOL OF PRACTICAL NURSING      ,OH,43613-5110,Public       ,5,17,22,92,422,514
00813300,ZANE STATE COLLEGE                      ,OH,43701-2626,Public       ,51,236,287,1230,3096,4326
00819400,AKRON SCHOOL OF PRACTICAL NRSG          ,OH,44311-0000,Public       ,4,21,25,86,251,337
00827800,TERRA COMMUNITY COLLEGE                 ,OH,43420-9670,Public       ,32,172,204,1053,2841,3894
00867700,NORTHWEST STATE COMMUNITY COLLEGE       ,OH,43502-9542,Public       ,30,147,177,1181,3414,4595
00888600,PORTAGE LAKES CAREER CENTER             ,OH,44685-9554,Public       ,0,7,7,24,187,211
00915600,WAYNE COUNTY SCHOOLS CAREER CENTER      ,OH,44677-9672,Public       ,0,20,20,51,286,337
00917200,SPRINGFIELD REGIONAL SCHOOL OF NURSING  ,OH,45501-0000,Private      ,1,3,4,53,138,191
00941200,FORTIS COLLEGE                          ,OH,44221-2998,Proprietary  ,35,189,224,390,1433,1823
00953000,GERBER AKRON BEAUTY SCHOOL              ,OH,44313-6995,Proprietary  ,3,12,15,22,130,152
00953100,SPA SCHOOL (THE)                        ,OH,43214-1524,Proprietary  ,5,28,33,74,242,316
00962105,HERZING UNIVERSITY - AKRON INSTITUTE    ,OH,44306-3958,Proprietary  ,10,88,98,396,1626,2022
00966000,TIFFIN ACADEMY OF HAIR DESIGN           ,OH,44883-2833,Proprietary  ,6,10,16,47,90,137
00994100,BELMONT TECHNICAL COLLEGE               ,OH,43950-9766,Public       ,29,176,205,1108,2268,3376
00994200,SHAWNEE STATE UNIVERSITY                ,OH,45662-4344,Public       ,57,101,158,4297,2669,6966
01001700,PAYNE THEOLOGICAL SEMINARY              ,OH,45384-0474,Private      ,0,10,10,2,163,165
01002700,JAMES A. RHODES STATE COLLEGE           ,OH,45804-3597,Public       ,48,260,308,1911,4266,6177
01016800,NATIONWIDE BEAUTY ACADEMY               ,OH,43228-1000,Proprietary  ,8,43,51,153,328,481
01028000,OHIO STATE BEAUTY ACADEMY               ,OH,45801-4950,Proprietary  ,1,21,22,92,228,320
01032300,HANNAH E MULLINS SCH-PRAC NRSG          ,OH,44460-2906,Public       ,1,5,6,31,134,165
01034500,CINCINNATI STATE TECH & COMM CLG        ,OH,45223-2690,Public       ,278,1233,1511,5853,14408,20261
01045300,WASHINGTON STATE CMTY COLLEGE           ,OH,45750-9225,Public       ,30,137,167,1046,1924,2970
01063000,NORTHERN INSTITUTE OF COSMETOLOGY       ,OH,44052-1803,Proprietary  ,1,5,6,21,70,91
01073600,MARION TECHNICAL COLLEGE                ,OH,43302-5694,Public       ,18,167,185,919,2621,3540
01088000,CHATFIELD COLLEGE                       ,OH,45118-9705,Private      ,10,32,42,84,370,454
01088100,STARK STATE COLLEGE OF TECHNOLOGY       ,OH,44720-7299,Public       ,117,517,634,4275,13438,17713
01090600,CINCINNATI CLG OF MORTUARY SCIENCE      ,OH,45224-1428,Private      ,3,15,18,90,201,291
01092300,UNION INSTITUTE & UNIVERSITY            ,OH,45206-1925,Private      ,1,166,167,49,2059,2108
01099300,HOBART INSTITUTE OF WELDING TECHNOLOGY  ,OH,45373-2400,Private      ,14,24,38,280,314,594
01100500,KAPLAN COLLEGE                          ,OH,43232-4827,Proprietary  ,21,139,160,259,1709,1968
01104600,CENTRAL OHIO TECHNICAL COLLEGE          ,OH,43055-1767,Public       ,86,401,487,1737,5682,7419
01170300,PENTA COUNTY JOINT VOCATIONAL SCH       ,OH,43551-0000,Public       ,0,6,6,28,142,170
01174400,NATIONAL BEAUTY COLLEGE                 ,OH,44720-0000,Proprietary  ,2,32,34,40,177,217
01174500,OHIO TECHNICAL COLLEGE                  ,OH,44103-1228,Proprietary  ,36,87,123,1530,1072,2602
01182500,OHIO STATE SCHOOL OF COSMETOLOGY        ,OH,43224-1107,Proprietary  ,3,21,24,80,245,325
01212800,SOUTHWESTERN COLLEGE                    ,OH,45402-3003,Proprietary  ,16,99,115,239,1914,2153
01212802,SOUTHWESTERN COLLEGE                    ,OH,45005-2267,Proprietary  ,6,48,54,77,671,748
01212803,SOUTHWESTERN COLLEGE                    ,OH,45202-4304,Proprietary  ,10,77,87,224,1686,1910
01212804,SOUTHWESTERN COLLEGE                    ,OH,45246-3121,Proprietary  ,23,139,162,324,1983,2307
01212806,SOUTHWESTERN COLLEGE - TOLEDO           ,OH,43615-6800,Proprietary  ,12,64,76,205,1362,1567
01216600,CAROUSEL BEAUTY COLLEGE                 ,OH,45402-8935,Proprietary  ,5,33,38,77,230,307
01224800,CENTRAL SCHOOL OF PRACTICAL NURSING     ,OH,44103-4371,Private      ,6,31,37,95,491,586
01267200,CAROUSEL BEAUTY COLLEGE                 ,OH,45044-5113,Proprietary  ,2,6,8,17,42,59
01267400,CAROUSEL OF MIAMI VALLEY BEAUTY CLG     ,OH,45424-2063,Proprietary  ,0,1,1,3,17,20
01275000,EDISON COMMUNITY COLLEGE                ,OH,45356-9239,Public       ,30,130,160,1186,3029,4215
01283800,LAURA AND ALVIN SIEGAL COLLEGE OF JUDAIC,OH,44122-7197,Private      ,0,0,0,0,9,9
01284800,MOLER-HOLLYWOOD BEAUTY COLLEGE          ,OH,45202-2577,Proprietary  ,3,22,25,36,125,161
01287000,SOUTHERN STATE COMMUNITY COLLEGE        ,OH,45133-9406,Public       ,51,292,343,1269,3624,4893
01289100,ANTONELLI COLLEGE                       ,OH,45202-2592,Proprietary  ,8,56,64,238,649,887
01289600,VIRGINIA MARTI COLLEGE OF ART AND DESIGN,OH,44107-0778,Proprietary  ,10,11,21,229,225,454
01313200,INTERNATIONAL CLG OF BROADCASTING       ,OH,45431-1898,Proprietary  ,6,12,18,65,164,229
02052000,KAPLAN COLLEGE                          ,OH,45439-1984,Proprietary  ,15,136,151,287,1294,1581
02054300,TRUMBULL BUSINESS COLLEGE               ,OH,44484-0000,Proprietary  ,4,45,49,80,625,705
02056800,DAYMAR COLLEGE                          ,OH,45601-1038,Proprietary  ,7,59,66,91,866,957
02056802,DAYMAR COLLEGE - LANCASTER              ,OH,43130-0000,Proprietary  ,5,35,40,35,318,353
02056803,DAYMAR COLLEGE - NEW BOSTON             ,OH,45662-4900,Proprietary  ,4,59,63,52,385,437
02056804,DAYMAR COLLEGE - JACKSON                ,OH,45640-1728,Proprietary  ,5,57,62,30,269,299
02066100,OHIO STATE COLLEGE/BARBER STYLING       ,OH,43213-0000,Proprietary  ,9,38,47,93,265,358
02073300,GALLIA-JACKSON-VINTON SCH ADULT ED      ,OH,45674-0000,Public       ,3,7,10,76,247,323
02110700,CLEVELAND INST OF DENTAL-MED ASST       ,OH,44115-2285,Proprietary  ,16,109,125,172,818,990
02116009,SANFORD-BROWN COLLEGE - MIDDLEBURG HEIGH,OH,44130-8362,Proprietary  ,29,150,179,375,1877,2252
02116900,UPPER VALLEY JVS                        ,OH,45356-0000,Public       ,1,12,13,20,360,380
02117300,GREAT OAKS INSTITUTE OF TECHNOLOGY      ,OH,45241-1581,Public       ,13,73,86,220,879,1099
02128600,THE ART INSTITUTE OF CINCINNATI         ,OH,45246-0000,Proprietary  ,11,16,27,344,226,570
02140700,COMMUNITY EDUCATIONAL SERVICES          ,OH,44702-1710,Public       ,0,8,8,32,259,291
02152100,ACADEMY OF COURT REPORTING AND TECHNOLOG,OH,44115-0000,Proprietary  ,3,57,60,82,625,707
02152101,ACADEMY OF COURT REPORTING & TECHNOLOGY ,OH,43215-3902,Proprietary  ,8,89,97,123,833,956
02152102,ACADEMY OF COURT REPORTING - MIAMI-JACOB,OH,44313-3607,Proprietary  ,0,0,0,13,88,101
02152104,ACADEMY OF COURT REPORTING AND TECHNOLOG,OH,45202-2123,Proprietary  ,0,0,0,13,81,94
02152106,ACADEMY OF COURT REPORTING AND TECHNOLOG,OH,45241-5428,Proprietary  ,3,43,46,47,325,372
02158500,OHIO BUSINESS COLLEGE                   ,OH,44035-0701,Proprietary  ,13,69,82,126,940,1066
02158501,OHIO BUSINESS COLLEGE                   ,OH,44870-9953,Proprietary  ,10,65,75,97,766,863
02168100,TRI-COUNTY JOINT VOCATIONAL SCHOOL      ,OH,45764-0000,Public       ,2,20,22,47,160,207
02187900,ASHTABULA CO JOINT VOC SCH ADULT ED     ,OH,44047-0000,Public       ,1,10,11,31,261,292
02189000,ADULT CENTER FOR EDUCATION              ,OH,43701-0000,Public       ,2,26,28,97,458,555
02190700,FORTIS COLLEGE                          ,OH,45459-0000,Proprietary  ,46,511,557,534,3745,4279
02192100,BUTLER TECHNOLOGY AND CAREER DEVELOPMENT,OH,45011-0000,Public       ,15,87,102,208,885,1093
02196300,COLLINS CAREER CENTER                   ,OH,45619-0000,Public       ,8,31,39,253,667,920
02210800,MEDINA COUNTY CAREER CENTER             ,OH,44256-0000,Public       ,2,12,14,49,217,266
02215400,OHIO STATE SCHOOL OF COSMETOLOGY        ,OH,43207-0000,Proprietary  ,5,28,33,96,229,325
02220500,GOD'S BIBLE SCHOOL & COLLEGE            ,OH,45210-0000,Private      ,3,5,8,189,85,274
02220800,CAREER & TECHNOLOGY EDUCATION CENTERS OF,OH,43055-0000,Public       ,5,38,43,61,334,395
02239800,PIONEER CAREER & TECHNOLOGY CENTER      ,OH,44875-0000,Public       ,0,5,5,7,74,81
02245600,WARREN COUNTY CAREER CENTER             ,OH,45036-0000,Public       ,13,67,80,56,403,459
02246300,INSTITUTE OF MEDICAL-DENTAL TECH        ,OH,45246-3317,Proprietary  ,2,48,50,57,290,347
02263700,MIAMI VALLEY CAREER TECHNOLOGY CTR      ,OH,45315-0000,Public       ,3,36,39,110,578,688
02269400,EASTERN HILLS ACAD OF HAIR DESIGN       ,OH,45255-0000,Proprietary  ,2,17,19,31,120,151
02269500,WESTERN HILLS SCHOOL OF BEAUTY & HAIR DE,OH,45211-0000,Proprietary  ,4,31,35,61,312,373
02270100,OHIO HI-POINT CAREER CENTER             ,OH,43311-0000,Public       ,4,27,31,48,401,449
02272700,COLUMBIANA COUNTY CAREER CENTER         ,OH,44432-0000,Public       ,1,19,20,38,248,286
02287900,RAPHAEL'S SCHOOL OF BEAUTY CULTURE      ,OH,44446-0000,Proprietary  ,9,50,59,64,266,330
02289802,KAPLAN COLLEGE                          ,OH,45203-0000,Proprietary  ,16,121,137,183,1268,1451
02301400,OHIO VALLEY COLLEGE OF TECHNOLOGY       ,OH,43920-9139,Proprietary  ,5,15,20,107,282,389
02303600,FORTIS COLLEGE - RAVENNA CAMPUS         ,OH,44266-0000,Proprietary  ,12,74,86,139,822,961
02304700,TRI-RIVERS CAREER CENTER                ,OH,43302-0000,Public       ,4,18,22,59,293,352
02311200,AMERICAN SCHOOL OF TECHNOLOGY           ,OH,43229-0000,Proprietary  ,9,83,92,83,742,825
02315500,TOLEDO ACADEMY OF BEAUTY CULTURE - EAST ,OH,43616-0000,Proprietary  ,1,21,22,19,140,159
02324400,ALLSTATE HAIRSTYLING & BARBER CLG       ,OH,44113-0000,Proprietary  ,3,37,40,5,74,79
02328500,MOLER-PICKENS BEAUTY COLLEGE            ,OH,45014-0000,Proprietary  ,2,4,6,11,78,89
02334300,INTERNATIONAL ACAD OF HAIR DESIGN       ,OH,45239-0000,Proprietary  ,4,15,19,60,131,191
02336300,KNOX COUNTY CAREER CENTER               ,OH,43050-4298,Public       ,2,18,20,33,318,351
02336700,CUYAHOGA VALLEY CAREER CENTER           ,OH,44141-1296,Public       ,1,12,13,95,307,402
02337700,PROFESSIONAL SKILLS INSTITUTE           ,OH,43607-0000,Proprietary  ,1,14,15,129,850,979
02351500,WILLOUGHBY EASTLAKE SCH OF PRAC NSG     ,OH,44094-0000,Public       ,0,2,2,16,130,146
02352800,POLARIS CAREER CENTER-ADULT ED DEPT     ,OH,44130-0000,Public       ,9,47,56,90,444,534
02354200,SCIOTO COUNTY JOINT VOCATIONAL SCH      ,OH,45648-0000,Public       ,3,29,32,90,357,447
02454400,NORTHEASTERN OHIO UNIVS COL OF MED      ,OH,44272-0000,Public       ,5,1,6,123,831,954
02497800,GREENE COUNTY CAREER CENTER             ,OH,45385-0000,Public       ,4,25,29,42,266,308
02512600,ADULT VOCATIONAL SERVICES               ,OH,44308-0000,Public       ,0,6,6,3,69,72
02519300,OHIO STATE SCH COSMETOLOGY              ,OH,43110-2754,Proprietary  ,7,16,23,73,160,233
02522700,EASTLAND-FAIRFIELD CAREER AND TECHNICAL ,OH,43125-0000,Public       ,4,50,54,68,407,475
02528300,TDDS TECHNICAL INSTITUTE                ,OH,44429-0000,Proprietary  ,15,147,162,93,770,863
02529500,HAMRICK SCHOOL                          ,OH,44256-0000,Proprietary  ,4,62,66,32,357,389
02541400,TOLEDO ACADEMY OF BEAUTY CULTURE-SO     ,OH,43614-0000,Proprietary  ,1,24,25,58,225,283
02545800,INNER STATE BEAUTY SCHOOLS              ,OH,44124-0000,Proprietary  ,5,31,36,53,255,308
02553000,SCHOOL OF ADVERTISING ART               ,OH,45440-0000,Proprietary  ,0,0,0,180,33,213
02560000,CASAL AVEDA INSTITUTE                   ,OH,44515-0000,Proprietary  ,10,15,25,107,126,233
02560700,PICKAWAY ROSS CO JOINT VOC TECH SCH     ,OH,45601-0000,Public       ,4,34,38,69,460,529
02560701,PICKAWAY ROSS COUNTY JOINT VOCATIONAL SC,OH,45601-9010,Public       ,3,9,12,26,163,189
02562300,APOLLO CAREER CENTER-ADULT EDUC         ,OH,45806-0000,Public       ,4,52,56,106,767,873
02563000,RAPHAELS SCHOOL OF BEAUTY CULTURE       ,OH,44601-2847,Proprietary  ,4,25,29,29,124,153
02568600,MAHONING COUNTY CAREER & TECH CENTR     ,OH,44406-0000,Public       ,1,8,9,16,114,130
02582900,KAPLAN CAREER INSTITUTE                 ,OH,44129-6810,Proprietary  ,17,96,113,218,1123,1341
02586400,TRUMBULL CAREER & TECH CENTER-ADULT     ,OH,44483-1997,Public       ,1,17,18,69,417,486
02588500,OHIO STATE SCHOOL OF COSMETOLOGY        ,OH,43081-0000,Proprietary  ,10,27,37,117,213,330
02599711,VATTEROTT COLLEGE - CLEVELAND           ,OH,44147-3502,Proprietary  ,4,61,65,54,670,724
02603800,LORAIN COUNTY JVS ADULT CAREER CTR      ,OH,44074-9799,Public       ,2,27,29,73,374,447
02620000,SANDUSKY CAREER CENTER                  ,OH,44870-4786,Public       ,1,12,13,30,241,271
03007900,GALLIPOLIS CAREER COLLEGE               ,OH,45631-2600,Proprietary  ,2,24,26,25,265,290
03009702,"HARRISON COLLEGE - MUNCIE - COLUMBUS, OH",OH,43123-0000,Proprietary  ,13,55,68,57,251,308
03015100,ALLIANCE HIGH SCH-CMTY SERVICES DIV     ,OH,44601-2899,Public       ,1,17,18,32,184,216
03015300,EHOVE CAREER CENTER                     ,OH,44846-9500,Public       ,8,46,54,84,549,633
03023700,MADISON ADULT CAREER CENTER             ,OH,44905-2718,Public       ,0,25,25,39,270,309
03024300,VALLEY BEAUTY SCHOOL                    ,OH,43725-2332,Proprietary  ,5,17,22,48,132,180
03027100,FAIRVIEW ACADEMY                        ,OH,44126-2214,Proprietary  ,0,14,14,18,64,82
03034200,WASHINGTON COUNTY CAREER CENTER ADULT TE,OH,45750-9290,Public       ,2,19,21,73,464,537
03051400,AUBURN CAREER CENTER                    ,OH,44077-9723,Public       ,0,9,9,69,250,319
03051500,US GRANT JOINT VOCATIONAL SCHOOL        ,OH,45106-9502,Public       ,0,2,2,3,33,36
03065800,OHIO INSTITUTE OF HEALTH CAREERS        ,OH,44035-2394,Proprietary  ,0,0,0,52,204,256
03065900,BUCKEYE CAREER CENTER                   ,OH,44663-9437,Public       ,1,10,11,81,276,357
03067600,RAPHAEL'S SCHOOL OF BEAUTY CULTURE      ,OH,44512-2222,Proprietary  ,3,11,14,28,87,115
03068200,OHIO CENTER FOR BROADCASTING            ,OH,44125-6273,Proprietary  ,13,44,57,105,380,485
03068202,OHIO CENTER FOR BROADCASTING - COLUMBUS ,OH,43213-2571,Proprietary  ,5,44,49,71,289,360
03071900,MOUNT CARMEL COLLEGE OF NURSING         ,OH,43222-1598,Private      ,11,39,50,695,988,1683
03072303,EVEREST INSTITUTE - COLUMBUS            ,OH,43230-6653,Proprietary  ,19,193,212,196,1355,1551
03078000,OHIO CENTER FOR BROADCASTING            ,OH,45227-1509,Proprietary  ,2,12,14,42,133,175
03079000,ETI TECHNICAL COLLEGE                   ,OH,44446-4398,Proprietary  ,9,24,33,119,466,585
03084800,DELAWARE AREA CAREER CENTER             ,OH,43015-8969,Public       ,0,5,5,9,59,68
03084801,DELAWARE AREA CAREER CENTER -           ,OH,43015-9001,Public       ,0,2,2,1,28,29
03095600,VANTAGE CAREER CENTER                   ,OH,45891-1378,Public       ,2,6,8,17,168,185
03097000,MERCY COLLEGE OF NORTHWEST OHIO         ,OH,43604-1132,Private      ,6,34,40,636,1385,2021
03100100,PARAMOUNT BEAUTY ACADEMY                ,OH,45662-4136,Proprietary  ,4,22,26,49,127,176
03105400,CLEVELAND EXTENSION HIGH SCH-WEST       ,OH,44102-2298,Public       ,0,0,0,6,32,38
03116200,DAYTON BARBER COLLEGE                   ,OH,45342-0000,Proprietary  ,2,12,14,40,154,194
03116300,OHIO COLLEGE OF MASSOTHERAPY            ,OH,44321-1363,Private      ,7,9,16,52,208,260
03116400,VANGUARD-SENTINELL VOC SCH DISTRICT     ,OH,43420-1197,Public       ,0,7,7,7,69,76
03117000,ASHLAND COUNTY-W HOLMES CAREER CTR      ,OH,44805-0000,Public       ,0,7,7,27,217,244
03319300,CREATIVE IMAGES-A CERTIFIED MATRIX      ,OH,45414-2557,Proprietary  ,4,24,28,76,261,337
03319301,CREATIVE IMAGES-A CERTIFIED MATRIX      ,OH,45459-0000,Proprietary  ,10,18,28,57,233,290
03416400,VALLEY BEAUTY SCHOOL                    ,OH,43701-3624,Proprietary  ,4,6,10,16,83,99
03425300,ROSEDALE BIBLE COLLEGE                  ,OH,43029-9517,Private      ,1,0,1,85,18,103
03457300,ALLEGHENY WESLEYAN COLLEGE              ,OH,44460-9598,Private      ,3,1,4,45,31,76
03468400,NATIONAL INSTITUTE OF MASSOTHERAPY      ,OH,44319-2100,Proprietary  ,1,8,9,23,142,165
03468500,ATS INSTITUTE OF TECHNOLOGY             ,OH,44143-2216,Proprietary  ,2,49,51,47,791,838
03475400,TRI-STATE BIBLE COLLEGE                 ,OH,45680-8402,Private      ,0,3,3,3,48,51
03534400,AMERICAN INST OF ALTERNATIVE MEDICI     ,OH,43229-1113,Proprietary  ,9,56,65,52,404,456
03626300,BROWN AVEDA INSTITUTE                   ,OH,44060-6212,Proprietary  ,14,32,46,207,367,574
03693300,CARNEGIE CAREER COLLEGE                 ,OH,44260-9608,Private      ,6,66,72,25,359,384
03700300,REGENCY BEAUTY INSTITUTE - CLEVELAND    ,OH,44094-0000,Proprietary  ,8,26,34,150,378,528
03726300,TEMPLE BAPTIST COLLEGE                  ,OH,45240-0000,Private      ,0,7,7,14,47,61
03747300,BEXLEY HALL SEMINARY                    ,OH,43209-2325,Private      ,0,0,0,2,21,23
03776400,HEALING ARTS INSTITUTE                  ,OH,43551-3138,Proprietary  ,0,8,8,18,76,94
03837300,AVEDA FREDRIC'S INSTITUTE               ,OH,45208-1304,Proprietary  ,29,41,70,166,244,410
03882300,OREGON CAREER CENTER                    ,OH,43616-2631,Public       ,2,11,13,11,103,114
04050400,DESIGNER'S BEAUTY ACADEMY               ,OH,43920-0000,Proprietary  ,0,9,9,15,42,57
04051307,ART INSTITUTE OF PHOENIX (THE) - BROWN M,OH,45215-1107,Proprietary  ,131,624,755,1699,7336,9035
04051317,ART INSTITUTE OF PHOENIX (THE) - BROWN M,OH,45840-6848,Proprietary  ,98,479,577,867,4458,5325
04051326,ART INSTITUTE OF PHOENIX (THE) - BROWN M,OH,44718-3674,Proprietary  ,16,127,143,266,1722,1988
04068300,FOUR COUNTY CAREER CENTER               ,OH,43512-9541,Public       ,0,1,1,8,58,66
04074300,HONDROS COLLEGE                         ,OH,43081-3855,Proprietary  ,13,138,151,303,1910,2213
04116700,NEWLIFE TECHNICAL INSTITUTE             ,OH,43920-2920,Private      ,2,5,7,14,47,61
04117300,DAYTON SCHOOL OF MEDICAL MASSAGE        ,OH,45429-1111,Proprietary  ,36,119,155,240,739,979
04118300,NORTHCOAST MEDICAL TRAINING ACADEMY     ,OH,44240-4174,Proprietary  ,14,36,50,130,416,546
04124500,TECHSKILLS                              ,OH,43231-0000,Proprietary  ,6,59,65,28,312,340
04125700,CUT BEAUTY SCHOOL (THE)                 ,OH,44118-2918,Proprietary  ,0,19,19,63,281,344
04126000,OHIO ACADEMY PAUL MITCHELL PARTNER SCHOO,OH,44087-3107,Proprietary  ,15,18,33,111,160,271
04137800,AVEDA INSTITUTE COLUMBUS                ,OH,43201-2333,Proprietary  ,15,43,58,157,291,448
04138000,INSTITUTE OF THERAPEUTIC MASSAGE        ,OH,45875-0350,Proprietary  ,4,9,13,25,99,124
04140100,CISORIA ACADEMY OF COSMETOLOGY          ,OH,44137-2915,Proprietary  ,5,11,16,26,99,125
04149100,CINCINNATI ACADEMY A PAUL MITCHELL PARTN,OH,45241-1702,Proprietary  ,20,23,43,154,188,342
04151400,VANITY SCHOOL OF COSMETOLOGY            ,OH,44035-0000,Proprietary  ,0,6,6,16,65,81
04152100,TOLEDO RESTAURANT TRAINING CENTER       ,OH,43604-6508,Private      ,0,4,4,3,63,66
04152600,PIKE COUNTY CAREER TECHNOLOGY CENTER    ,OH,45661-9114,Public       ,0,3,3,22,126,148
04153300,OHIO ACADEMY COLUMBUS (THE)             ,OH,43231-6038,Proprietary  ,9,21,30,106,161,267
04154000,TOLLES CAREER & TECHNICAL CENTER        ,OH,43064-8854,Public       ,1,1,2,8,24,32
04166800,SALON PROFESSIONAL ACADEMY (THE)        ,OH,45551-0000,Proprietary  ,2,7,9,60,142,202
04167700,ARTISAN COLLEGE OF COSMETOLOGY (THE)    ,OH,45840-6848,Proprietary  ,4,9,13,18,42,60
        ,INVALID SCHOOL CODE                     ,  ,00000-0000,,278,1098,1376,2533,8369,10902
00134500,ADAMS STATE COLLEGE                     ,CO,81102-2373,Public       ,66,164,230,2604,2350,4954
00134600,ARAPAHOE COMMUNITY COLLEGE              ,CO,80160-9002,Public       ,127,558,685,2713,6814,9527
00134700,COLORADO COLLEGE                        ,CO,80903-3294,Private      ,26,42,68,2703,619,3322
00134800,COLORADO SCHOOL OF MINES                ,CO,80401-1887,Public       ,53,27,80,5320,1248,6568
00134900,UNIVERSITY OF NORTHERN COLORADO         ,CO,80639-0001,Public       ,128,258,386,10459,4886,15345
00135000,COLORADO STATE UNIVERSITY               ,CO,80523-0100,Public       ,348,482,830,21936,11090,33026
00135200,DENVER  SEMINARY                        ,CO,80120-2192,Private      ,0,24,24,4,742,746
00135300,FORT LEWIS COLLEGE                      ,CO,81301-3999,Public       ,68,58,126,4022,1566,5588
00135400,ILIFF SCHOOL OF THEOLOGY                ,CO,80210-0000,Private      ,0,9,9,2,297,299
00135500,LAMAR COMMUNITY COLLEGE                 ,CO,81052-3999,Public       ,22,56,78,404,465,869
00135800,MESA STATE COLLEGE                      ,CO,81501-7682,Public       ,141,247,388,5825,4232,10057
00135900,COLORADO NORTHWESTERN COMMUNITY COLLEGE ,CO,81648-3598,Public       ,18,56,74,467,673,1140
00136000,METROPOLITAN STATE CLG OF DENVER        ,CO,80204-0000,Public       ,381,824,1205,11863,17982,29845
00136100,NORTHEASTERN JUNIOR COLLEGE             ,CO,80751-2399,Public       ,29,44,73,1274,659,1933
00136200,OTERO JUNIOR COLLEGE                    ,CO,81050-3346,Public       ,13,72,85,647,935,1582
00136300,REGIS UNIVERSITY                        ,CO,80221-1099,Private      ,37,598,635,2695,10266,12961
00136500,COLORADO STATE UNIVERSITY-PUEBLO        ,CO,81001-4901,Public       ,90,375,465,4933,4506,9439
00136800,TRINIDAD STATE JR COLLEGE               ,CO,81082-2396,Public       ,38,132,170,709,1443,2152
00137000,UNIVERSITY OF COLORADO-BOULDER          ,CO,80309-0077,Public       ,313,299,612,23332,10257,33589
00137100,UNIVERSITY OF DENVER                    ,CO,80208-2000,Private      ,72,358,430,7231,10687,17918
00137200,WESTERN STATE COLLEGE                   ,CO,81231-0000,Public       ,37,21,58,2345,650,2995
00163202,AQUINAS INSTITUTE OF THEOLOGY - AQUINAS ,CO,80903-1498,Private      ,0,0,0,5,36,41
00405702,NATIONAL AMERICAN UNIVERSITY - COLORADO ,CO,80920-4001,Proprietary  ,2,21,23,35,290,325
00405703,NATIONAL AMERICAN UNIVERSITY            ,CO,80222-0000,Proprietary  ,0,30,30,34,348,382
00450300,EVEREST COLLEGE                         ,CO,80916-3548,Proprietary  ,17,125,142,220,1333,1553
00450600,COLORADO MOUNTAIN COLLEGE               ,CO,81602-0000,Public       ,47,129,176,1536,1764,3300
00450700,EVEREST COLLEGE                         ,CO,80229-4339,Proprietary  ,19,129,148,217,1328,1545
00450701,"EVEREST COLLEGE- EVEREST COLLEGE, AURORA",CO,80012-5692,Proprietary  ,28,134,162,214,1123,1337
00450800,UNIVERSITY OF COLORADO DENVER           ,CO,80204-2029,Public       ,157,601,758,7722,15922,23644
00450900,UNIV OF COLORADO AT COLO SPRINGS        ,CO,80918-3735,Public       ,134,260,394,5999,5364,11363
00559600,EMILY GRIFFITH OPPORTUNITY SCH          ,CO,80204-2197,Public       ,41,286,327,605,2474,3079
00729700,REDSTONE COLLEGE                        ,CO,80020-9988,Proprietary  ,42,156,198,354,1218,1572
00732912,ITT TECHNICAL INSTITUTE                 ,CO,80229-5338,Proprietary  ,82,250,332,482,1937,2419
00754700,LINCOLN COLLEGE OF TECHNOLOGY           ,CO,80223-2013,Proprietary  ,53,129,182,916,1072,1988
00754800,WESTWOOD COLLEGE - DENVER NORTH         ,CO,80221-3653,Proprietary  ,36,130,166,735,3044,3779
00754801,WESTWOOD COLLEGE - DENVER SOUTH         ,CO,80227-3653,Proprietary  ,12,101,113,277,1411,1688
00758200,AIMS COMMUNITY COLLEGE                  ,CO,80632-0000,Public       ,78,311,389,2306,4333,6639
00764900,ROCKY MOUNTAIN COLG OF ART & DESIGN     ,CO,80214-0000,Proprietary  ,20,37,57,967,485,1452
00793300,FRONT RANGE COMMUNITY COLLEGE           ,CO,80031-2199,Public       ,350,989,1339,7492,14376,21868
00863500,INTELLITEC MEDICAL INSTITUTE            ,CO,80909-1570,Proprietary  ,15,78,93,120,790,910
00887100,CONCORDE CAREER INSTITUTE               ,CO,80203-0000,Proprietary  ,25,198,223,295,1456,1751
00889600,PIKES PEAK COMMUNITY COLLEGE            ,CO,80906-5498,Public       ,328,1245,1573,5013,13208,18221
00940100,COLORADO CHRISTIAN UNIVERSITY           ,CO,80226-7449,Private      ,25,257,282,1689,2845,4534
00954200,COMMUNITY COLLEGE OF DENVER             ,CO,80217-2026,Public       ,217,887,1104,5048,12165,17213
00954300,RED ROCKS COMMUNITY COLLEGE             ,CO,80228-1255,Public       ,167,519,686,3122,7022,10144
00998100,MORGAN COMMUNITY COLLEGE                ,CO,80701-4399,Public       ,43,85,128,357,1198,1555
01014800,COLORADO TECHNICAL UNIVERSITY           ,CO,80907-3896,Proprietary  ,50,820,870,544,9273,9817
01014802,COLORADO TECHNICAL UNIV - DENVER        ,CO,80111-3201,Proprietary  ,9,109,118,166,1246,1412
01014805,COLORADO TECH UNIV - ON LINE            ,CO,80907-0000,Proprietary  ,307,5723,6030,1903,48177,50080
01014806,COLORADO TECH UNIV - FED EXPRESS        ,CO,80921-3800,Proprietary  ,1,15,16,15,174,189
01014808,COLORADO TECH UNIV - USAA               ,CO,80920-1005,Proprietary  ,2,12,14,18,121,139
01014809,COLORADO TECH UNIV - SCHRIEVER AFB      ,CO,80912-7298,Proprietary  ,0,0,0,1,10,11
01014810,COLORADO TECH UNIV - PETERSON AFB       ,CO,80914-1586,Proprietary  ,0,0,0,5,25,30
01014811,COLORADO TECH UNIV-HEWLETT PACKARD      ,CO,80919-2303,Proprietary  ,0,6,6,10,72,82
01014812,COLORADO TECHNICAL UNIVERSITY - WESTMINS,CO,80021-3498,Proprietary  ,9,169,178,190,1838,2028
01014813,COLORADO TECH UNIV - ORACLE             ,CO,80921-3660,Proprietary  ,0,14,14,13,134,147
01014815,COLORADO TECHNCL UNIV PUEBLO            ,CO,81003-2315,Proprietary  ,7,55,62,96,618,714
01070900,EMPIRE BEAUTY SCHOOL-LAKEWOOD           ,CO,80215-0000,Proprietary  ,3,17,20,58,175,233
01073200,SAN JUAN BASIN TECHNICAL COLLEGE        ,CO,81328-9196,Public       ,1,3,4,35,63,98
01129100,PENROSE HOSPITAL SCHOOL OF MEDICAL TECHN,CO,80933-0000,Private      ,0,0,0,0,1,1
01157200,COLORADO SCHOOL OF TRADES               ,CO,80215-2996,Proprietary  ,8,34,42,92,334,426
01267000,BEL-REA INST OF ANIMAL TECH             ,CO,80247-3048,Proprietary  ,25,57,82,560,951,1511
01285000,INTERNATIONAL SALON AND SPA ACADEMY     ,CO,80918-3684,Proprietary  ,12,48,60,105,286,391
01287500,PICKENS TECHNICAL COLLEGE               ,CO,80011-9307,Public       ,18,53,71,301,995,1296
01300700,NAZARENE BIBLE COLLEGE                  ,CO,80910-3717,Private      ,3,47,50,73,755,828
02072200,EMPIRE BEAUTY SCHOOL -ARVADA            ,CO,80212-0000,Proprietary  ,2,22,24,62,187,249
02078900,ART INSTITUTE OF COLORADO (THE)         ,CO,80203-2983,Proprietary  ,88,202,290,1934,2502,4436
02116300,PUEBLO COMMUNITY COLLEGE                ,CO,81004-0000,Public       ,130,497,627,2228,6894,9122
02117500,NAROPA UNIVERSITY                       ,CO,80302-0000,Private      ,10,37,47,390,1351,1741
02133100,COLORADO CENTER FOR MEDICAL LABORATORY S,CO,80218-0000,Private      ,1,6,7,32,139,171
02141100,EMPIRE BEAUTY SCHOOL-LITTLETON          ,CO,80030-0000,Proprietary  ,12,38,50,83,288,371
02141103,ARTISTIC BEAUTY COLLEGES-AURORA         ,CO,80017-3194,Proprietary  ,0,0,0,26,72,98
02156200,DELTA - MONTROSE TECHNICAL COLLEGE      ,CO,81416-0000,Public       ,4,13,17,110,279,389
02160600,EMPIRE BEAUTY SCHOOL -THORNTON          ,CO,80241-1659,Proprietary  ,5,23,28,90,211,301
02165200,SALON PROFESSIONAL ACADEMY (THE)        ,CO,81504-5309,Proprietary  ,5,9,14,45,90,135
02167600,KAPLAN COLLEGE                          ,CO,80229-5309,Proprietary  ,15,113,128,118,872,990
02171300,TRINIDAD STATE JUNIOR COLLEGE           ,CO,81101-0000,Proprietary  ,0,0,0,0,1,1
02188700,DENVER ACAD OF COURT REPORTING          ,CO,80030-0000,Proprietary  ,0,22,22,31,264,295
02211901,CHEEKS INTERNATIONAL ACADEMY OF BEAUTY C,CO,80525-3053,Proprietary  ,0,4,4,15,46,61
02211902,CHEEKS INTERNATIONAL ACDMY BTY CULT     ,CO,80631-0000,Proprietary  ,0,8,8,13,33,46
02253700,INTELLITEC COLLEGE                      ,CO,80909-0000,Proprietary  ,27,130,157,174,851,1025
02267500,GLENWOOD BEAUTY ACADEMY                 ,CO,81601-0000,Proprietary  ,3,17,20,17,70,87
02276900,COMMUNITY COLLEGE OF AURORA             ,CO,80011-9036,Public       ,125,598,723,2333,7035,9368
02518500,HAIR DYNAMICS EDUCATION CENTER          ,CO,80525-0000,Proprietary  ,13,36,49,142,219,361
02594300,COLLEGE AMERICA - DENVER                ,CO,80222-3380,Proprietary  ,75,442,517,666,3814,4480
02611000,HERITAGE COLLEGE                        ,CO,80212-7413,Proprietary  ,34,158,192,280,1063,1343
03006300,INST OF BUSINESS & MEDICAL CAREERS      ,CO,80525-3044,Proprietary  ,46,174,220,324,1429,1753
03010622,VIRGINIA COLLEGE - ECOTECH INSTITUTE - A,CO,80014-1405,Proprietary  ,23,89,112,36,173,209
03012100,REMINGTON COLLEGE - COLORADO SPRINGS CAM,CO,80215-0000,Proprietary  ,1,36,37,54,288,342
03013100,BOULDER COLLEGE OF MASSAGE THERAPY      ,CO,80301-3295,Private      ,5,20,25,102,261,363
03014900,PLATT COLLEGE                           ,CO,80014-3141,Proprietary  ,2,18,20,53,300,353
03027400,XENON INTERNATIONAL ACADEMY III         ,CO,80014-1193,Proprietary  ,6,21,27,81,170,251
03030606,UTAH COLLEGE OF MASSAGE THERAPY - DENVER,CO,80031-2921,Proprietary  ,27,61,88,149,326,475
03030607,UTAH COLLEGE OF MASSAGE THERAPY - DENVER,CO,80012-2523,Proprietary  ,28,50,78,132,306,438
03066900,INTELLITEC COLLEGE                      ,CO,81506-3994,Proprietary  ,26,153,179,233,1055,1288
03068201,OHIO CENTER FOR BROADCASTING - COLORADO ,CO,80214-4129,Proprietary  ,9,33,42,60,238,298
03076401,BRYMAN SCHOOL OF ARIZONA (THE) - ANTHEM ,CO,80014-2622,Proprietary  ,1,4,5,8,49,57
03289300,COLORADO HEIGHTS UNIVERSITY             ,CO,80236-2711,Private      ,6,41,47,55,266,321
03306300,MONTESSORI EDUC CRT OF THE ROCKIES      ,CO,80301-2587,Private      ,0,4,4,4,51,55
03534300,JONES INTERNATIONAL UNIVERSITY          ,CO,80112-3446,Proprietary  ,77,1349,1426,618,9843,10461
03545300,UNIVERSITY OF THE ROCKIES               ,CO,80903-3612,Proprietary  ,0,350,350,38,2537,2575
03584400,COLORADO SCHOOL OF HEALING ARTS         ,CO,80226-4332,Proprietary  ,7,40,47,95,320,415
03670300,TONI & GUY HAIRDRESSING ACADEMY         ,CO,80911-1713,Proprietary  ,10,34,44,124,230,354
03686300,COLORADO SCHOOL OF TRADITIONAL CHINESE M,CO,80206-2127,Proprietary  ,0,8,8,9,200,209
03776300,CULINARY SCHOOL OF THE ROCKIES          ,CO,80305-5961,Proprietary  ,16,46,62,116,226,342
03972300,CUTTIN' UP BEAUTY ACADEMY               ,CO,80220-0000,Proprietary  ,4,8,12,34,94,128
03976300,MASSAGE THERAPY INSTITUTE OF COLORADO   ,CO,80206-2127,Proprietary  ,2,20,22,61,179,240
04080300,ASPEN UNIVERSITY                        ,CO,80246-1930,Proprietary  ,7,40,47,64,340,404
04093300,ACADEMY OF NATURAL THERAPY              ,CO,80631-3425,Proprietary  ,3,10,13,36,128,164
04121200,INSTITUTE OF TAOIST EDUCATION AND ACUPUN,CO,80027-1028,Private      ,0,1,1,4,59,63
04125100,MONTESSORI CASA INTERNATIONAL           ,CO,80111-5263,Private      ,0,0,0,3,15,18
04127700,AMERICAN SENTINEL UNIVERSITY            ,CO,80014-6510,Proprietary  ,1,131,132,3,301,304
04139300,NATIONAL BEAUTY COLLEGE                 ,CO,80221-0000,Proprietary  ,3,23,26,39,161,200
04140400,ACADEMY OF MEDICAL & HEALTH SCIENCE     ,CO,81005-2195,Proprietary  ,2,14,16,11,73,84
04148300,DENVER SCHOOL OF NURSING                ,CO,80202-1213,Proprietary  ,11,51,62,215,1113,1328
04151100,SUMMIT SALON & BEAUTY SCHOOL            ,CO,80866-4569,Proprietary  ,0,5,5,2,18,20
04167100,AVEDA INSTITUTE DENVER                  ,CO,80202-0000,Proprietary  ,20,56,76,159,264,423
04170200,PAUL MITCHELL THE SCHOOL COLORADO SPRING,CO,80903-0000,Proprietary  ,16,45,61,112,217,329
04172500,ROLF INSTITUTE OF STRUCTURAL INTEGRATION,CO,80301-0000,Private      ,0,24,24,3,58,61
04173800,SALON PROFESSIONAL ACADEMY (THE)        ,CO,80918-2932,Proprietary  ,4,27,31,48,117,165
04177100,PIMA MEDICAL INSTITUTE-SOUTH DENVER     ,CO,80231-0000,Proprietary  ,6,46,52,15,115,130
04185000,COLORADO ACADEMY OF VETERINARY TECHNOLOG,CO,80906-4944,Proprietary  ,2,7,9,2,7,9
00267811,BRYANT & STRATTON COLLEGE - VIRGINIA BEA,VA,23462-4417,Proprietary  ,44,278,322,583,2890,3473
00370200,AVERETT UNIVERSITY                      ,VA,24541-3692,Private      ,19,234,253,1458,2075,3533
00370300,BLUEFIELD COLLEGE                       ,VA,24605-1799,Private      ,6,26,32,671,562,1233
00370400,BRIDGEWATER COLLEGE                     ,VA,22812-1599,Private      ,26,2,28,3390,168,3558
00370500,COLLEGE OF WILLIAM & MARY               ,VA,23187-8795,Public       ,81,65,146,10464,4833,15297
00370600,CHRISTOPHER NEWPORT UNIVERSITY          ,VA,23606-2998,Public       ,64,58,122,7206,1262,8468
00370700,RICHARD BLAND COLLEGE                   ,VA,23805-7100,Public       ,25,32,57,1342,639,1981
00370800,EASTERN MENNONITE UNIVERSITY            ,VA,22802-2462,Private      ,4,26,30,1116,594,1710
00370900,EMORY & HENRY COLLEGE                   ,VA,24327-0010,Private      ,16,5,21,1377,148,1525
00371100,FERRUM COLLEGE                          ,VA,24088-2612,Private      ,28,9,37,3050,281,3331
00371200,TIDEWATER COMMUNITY COLLEGE             ,VA,23510-1910,Public       ,382,1735,2117,11534,25116,36650
00371300,HAMPDEN-SYDNEY COLLEGE                  ,VA,23943-0128,Private      ,13,0,13,1331,52,1383
00371400,HAMPTON UNIVERSITY                      ,VA,23668-0099,Private      ,142,148,290,9309,3586,12895
00371500,HOLLINS UNIVERSITY                      ,VA,24020-0000,Private      ,12,30,42,973,695,1668
00371900,LONGWOOD UNIVERSITY                     ,VA,23909-1899,Public       ,56,45,101,5349,878,6227
00372000,LYNCHBURG COLLEGE                       ,VA,24501-3199,Private      ,34,31,65,3486,858,4344
00372100,JAMES MADISON UNIVERSITY                ,VA,22807-3780,Public       ,217,62,279,22225,2648,24873
00372300,MARY BALDWIN COLLEGE                    ,VA,24401-3610,Private      ,17,42,59,1460,1150,2610
00372400,MARYMOUNT UNIVERSITY                    ,VA,22207-4224,Private      ,37,84,121,2522,2379,4901
00372600,NATIONAL COLLEGE                        ,VA,24153-4524,Proprietary  ,58,584,642,886,8244,9130
00372700,NORTHERN VA CMTY CLG                    ,VA,22003-3743,Public       ,539,1335,1874,13479,18361,31840
00372800,OLD DOMINION UNIVERSITY                 ,VA,23529-0052,Public       ,242,533,775,18531,14092,32623
00373200,RADFORD UNIVERSITY                      ,VA,24142-6905,Public       ,106,69,175,9083,2439,11522
00373300,RANDOLPH-MACON COLLEGE                  ,VA,23005-5505,Private      ,28,5,33,2587,164,2751
00373400,RANDOLPH COLLEGE                        ,VA,24503-1526,Private      ,4,5,9,816,155,971
00373500,VIRGINIA COMMONWEALTH UNIVERSITY        ,VA,23284-9004,Public       ,283,436,719,22602,14518,37120
00373600,ROANOKE COLLEGE                         ,VA,24153-3794,Private      ,14,8,22,3248,263,3511
00373700,SHENANDOAH UNIVERSITY                   ,VA,22601-5195,Private      ,23,62,85,2695,2134,4829
00373800,SOUTHERN VIRGINIA UNIVERSITY            ,VA,24416-3038,Private      ,15,7,22,1066,250,1316
00373900,ST PAULS COLLEGE                        ,VA,23868-1299,Private      ,12,33,45,635,471,1106
00374200,SWEET BRIAR COLLEGE                     ,VA,24595-9998,Private      ,6,1,7,771,62,833
00374300,UNION PRESBYTERIAN SEMINARY             ,VA,23227-0000,Private      ,0,3,3,2,122,124
00374400,UNIVERSITY OF RICHMOND                  ,VA,23173-0001,Private      ,43,60,103,6324,2774,9098
00374500,UNIVERSITY OF VIRGINIA - SFS            ,VA,22903-0000,Public       ,202,175,377,19436,9850,29286
00374600,UNIVERSITY OF MARY WASHINGTON           ,VA,22401-5358,Public       ,55,55,110,5036,1355,6391
00374700,UNIV OF VIRGINIA'S COLLEGE AT WISE      ,VA,24293-4412,Public       ,12,16,28,1937,482,2419
00374800,EASTERN SHORE COMMUNITY COLLEGE         ,VA,23410-3000,Public       ,8,51,59,423,784,1207
00374900,GEORGE MASON UNIVERSITY                 ,VA,22030-4444,Public       ,314,562,876,18353,16082,34435
00375100,PATRICK HENRY COMMUNITY COLLEGE         ,VA,24112-5311,Public       ,32,179,211,1129,2866,3995
00375200,VIRGINIA INTERMONT COLLEGE              ,VA,24201-4298,Private      ,3,15,18,847,389,1236
00375300,VIRGINIA MILITARY INSTITUTE             ,VA,24450-2138,Public       ,28,2,30,1935,85,2020
00375400,VIRGINIA POLYTECH INST & STATE UNIV     ,VA,24061-2000,Public       ,245,182,427,25459,5536,30995
00375800,DANVILLE COMMUNITY COLLEGE              ,VA,24541-4004,Public       ,45,185,230,1485,3254,4739
00375900,J. SARGEANT REYNOLDS COMMUNITY CLG      ,VA,23285-0000,Public       ,140,588,728,5136,10910,16046
00376000,VIRGINIA WESTERN CMTY COLLEGE           ,VA,24038-0000,Public       ,66,295,361,2839,4871,7710
00376100,WYTHEVILLE COMMUNITY COLLEGE            ,VA,24382-3308,Public       ,55,148,203,1396,2366,3762
00376200,VIRGINIA UNIVERSITY OF LYNCHBURG        ,VA,24501-6400,Private      ,28,56,84,182,624,806
00376400,VIRGINIA STATE UNIVERSITY               ,VA,23806-0001,Public       ,125,87,212,9866,3255,13121
00376500,NORFOLK STATE UNIVERSITY                ,VA,23504-8000,Public       ,106,239,345,8749,7046,15795
00376600,VIRGINIA UNION UNIVERSITY               ,VA,23220-1711,Private      ,76,60,136,4516,1459,5975
00376700,VIRGINIA WESLEYAN COLLEGE               ,VA,23502-5599,Private      ,35,27,62,1975,726,2701
00376800,WASHINGTON & LEE UNIVERSITY             ,VA,24450-0303,Private      ,8,4,12,2559,1801,4360
00400400,JOHN TYLER COMMUNITY COLLEGE            ,VA,23831-5316,Public       ,91,356,447,3605,6302,9907
00450301,"EVEREST COLLEGE- EVEREST COLLEGE, MCLEAN",VA,22102-3000,Proprietary  ,25,89,114,201,685,886
00450702,"EVEREST COLLEGE- EVEREST COLLEGE, ARLING",VA,22203-1905,Proprietary  ,35,106,141,293,1093,1386
00498800,CENTRAL VIRGINIA COMMUNITY COLLEGE      ,VA,24502-2498,Public       ,38,140,178,1658,2699,4357
00499200,MILLER-MOTTE TECHNICAL COLLEGE          ,VA,24505-0000,Proprietary  ,26,120,146,208,720,928
00499600,DABNEY S LANCASTER COMMUNITY CLG        ,VA,24422-1000,Public       ,7,43,50,547,746,1293
00522300,NEW RIVER COMMUNITY COLLEGE             ,VA,24084-1127,Public       ,54,144,198,1680,2714,4394
00607500,ROANOKE MEM HOSP SCH RAD ONCOLOGY       ,VA,24033-0000,Private      ,0,0,0,12,21,33
00607501,ROANOKE MEM HOSP SCH RAD TECH           ,VA,24014-1850,Private      ,0,0,0,11,32,43
00662200,COLLEGE OF HEALTH SCIENCES - CHRV       ,VA,24031-0000,Private      ,5,19,24,561,1055,1616
00681900,BLUE RIDGE COMMUNITY COLLEGE            ,VA,24486-0080,Public       ,44,153,197,2012,2533,4545
00687100,THOMAS NELSON COMMUNITY COLLEGE         ,VA,23670-0000,Public       ,122,534,656,4027,8888,12915
00709900,VIRGINIA HIGHLANDS COMMUNITY CLG        ,VA,24210-4210,Public       ,25,89,114,1214,1925,3139
00726000,SOUTHWEST VIRGINIA COMMUNITY CLG        ,VA,24641-1510,Public       ,52,173,225,1190,2145,3335
00859200,LOUISE OBICI SCHOOL OF NURSING          ,VA,23434-8038,Private      ,4,6,10,27,100,127
00865900,LORD FAIRFAX COMMUNITY COLLEGE          ,VA,22645-0047,Public       ,69,175,244,1996,2998,4994
00866000,GERMANNA COMMUNITY COLLEGE              ,VA,22508-0339,Public       ,71,221,292,2224,3549,5773
00866100,SOUTHSIDE VIRGINIA CMTY CLG             ,VA,23821-2930,Public       ,97,333,430,1760,3891,5651
00915900,PAUL D CAMP COMMUNITY COLLEGE           ,VA,23851-0737,Public       ,16,128,144,533,1527,2060
00916000,RAPPAHANNOCK COMMUNITY COLLEGE          ,VA,23149-2616,Public       ,32,147,179,914,1486,2400
00926700,EVEREST COLLEGE                         ,VA,23606-4203,Proprietary  ,9,124,133,146,1111,1257
00926701,EVEREST COLLEGE - CHESAPEAKE            ,VA,23320-2637,Proprietary  ,35,212,247,210,1353,1563
00942000,SANFORD-BROWN COLLEGE                   ,VA,22182-3913,Proprietary  ,48,158,206,394,1192,1586
00953500,STAUNTON SCHOOL OF COSMETOLOGY          ,VA,24401-4323,Proprietary  ,5,15,20,23,54,77
00953700,VIRGINIA SCH OF HAIR DESIGN             ,VA,23669-0000,Proprietary  ,4,16,20,52,214,266
00962900,MOUNTAIN EMPIRE COMMUNITY COLLEGE       ,VA,24219-0700,Public       ,30,115,145,1283,2177,3460
00992800,PIEDMONT VIRGINIA COMMUNITY COLLEGE     ,VA,22902-7589,Public       ,61,231,292,1533,2865,4398
01004300,BON SECOURS MEMORIAL COLLEGE OF NURSING ,VA,23227-4612,Private      ,2,18,20,225,593,818
01019800,ECPI COLLEGE OF TECHNOLOGY              ,VA,23462-6542,Proprietary  ,263,1309,1572,3629,13900,17529
01033800,EASTERN VIRGINIA MEDICAL SCHOOL         ,VA,23501-1980,Private      ,1,25,26,62,1446,1508
01159600,RALPH'S VIRGINIA SCH OF COSMETOLOGY     ,VA,24501-2652,Proprietary  ,2,6,8,23,82,105
01162601,WESTWOOD COLLEGE - SOUTH BAY - ARLINGTON,VA,22203-4167,Proprietary  ,20,64,84,466,766,1232
01162602,WESTWOOD COLLEGE - SOUTH BAY - ANNANDALE,VA,22003-2602,Proprietary  ,13,33,46,303,658,961
01274400,SOUTHSIDE REGIONAL MED CTR PROF SCHOOLS ,VA,23803-5133,Proprietary  ,2,14,16,61,263,324
01274402,SOUTHSIDE REG MED CTR SCH RAD TECH      ,VA,23803-0000,Proprietary  ,0,0,0,12,61,73
02053000,LIBERTY UNIVERSITY                      ,VA,24502-0000,Private      ,344,4753,5097,18391,49842,68233
02108800,WARDS CORNER BEAUTY ACADEMY             ,VA,23505-0000,Proprietary  ,9,36,45,88,421,509
02111600,DANVILLE REGIONAL MEDICAL CENTER SCHOOL ,VA,24541-0000,Proprietary  ,0,7,7,53,138,191
02128700,CENTRAL SCHOOL OF PRACTICAL NURSING     ,VA,23502-2230,Public       ,3,9,12,76,215,291
02140000,RIVERSIDE SCHOOL OF HEALTH CAREERS      ,VA,23608-3802,Private      ,5,44,49,157,705,862
02175800,LYNCHBURG GENERAL HOSP SCH OF NURSG     ,VA,24501-0000,Private      ,2,6,8,107,267,374
02197600,WOODROW WILSON REHABILITATION CTR       ,VA,22939-0000,Public       ,13,5,18,51,36,87
02242400,HENRICO CTY ST MARYS HOSP PRAC NRSG     ,VA,23075-0000,Public       ,1,3,4,18,67,85
02247200,MEDSPA CAREERS INSTITUTE                ,VA,23606-0000,Proprietary  ,1,7,8,80,312,392
02304500,HERITAGE INSTITUTE                      ,VA,20111-0000,Proprietary  ,1,13,14,99,455,554
02320900,TIDEWATER TECH                          ,VA,23502-1747,Proprietary  ,16,128,144,191,981,1172
02334400,CENTURA COLLEGE                         ,VA,23452-0000,Proprietary  ,73,710,783,670,6260,6930
02342700,FORTIS COLLEGE                          ,VA,23502-4101,Proprietary  ,12,69,81,130,711,841
02342701,FORTIS COLLEGE - RICHMOND CAMPUS        ,VA,23236-3472,Proprietary  ,22,72,94,254,714,968
02358500,BON SECOURS SAINT MARY'S HOSPITAL SCHOOL,VA,23227-4612,Private      ,3,11,14,58,223,281
02535400,SKYLINE COLLEGE - RICHMOND              ,VA,23236-0000,Proprietary  ,0,6,6,198,547,745
02538800,SUFFOLK BEAUTY ACADEMY                  ,VA,23434-0000,Proprietary  ,2,21,23,23,114,137
02541200,STRATFORD UNIVERSITY                    ,VA,22043-0000,Proprietary  ,20,165,185,245,1382,1627
02541201,STRATFORD UNIVERSITY-WOODBRIDGE         ,VA,22192-0000,Proprietary  ,9,54,63,114,517,631
02610100,WASHINGTON COUNTY ADULT SKILL CTR       ,VA,24210-2346,Public       ,7,20,27,30,150,180
03002400,GRAHAM WEBB INTERNATIONAL ACAD HAIR     ,VA,22209-2129,Proprietary  ,17,36,53,77,185,262
03010700,BAR PALMA BEAUTY CAREERS  ACADEMY       ,VA,24014-2255,Proprietary  ,2,16,18,34,124,158
03042800,"VIRGINIA BEACH CITY SCHOOLS, SCH.-PR.NSG",VA,23456-0038,Public       ,0,5,5,37,117,154
03091100,ACT COLLEGE                             ,VA,22209-2297,Proprietary  ,15,78,93,111,525,636
03091300,REGENT UNIVERSITY                       ,VA,23464-9800,Private      ,29,326,355,1249,6879,8128
03092700,SKYLINE COLLEGE                         ,VA,24012-1603,Proprietary  ,8,52,60,160,527,687
03096500,SPRINGFIELD BEAUTY ACADEMY              ,VA,22003-3016,Proprietary  ,0,28,28,6,115,121
03106500,SENTARA NORFOLK GENERAL HOSPITAL        ,VA,23320-2843,Private      ,4,32,36,136,641,777
03116900,BAPTIST THEOLOGICAL SEM.-RICHMOND       ,VA,23227-0000,Private      ,0,5,5,5,107,112
03126300,AVIATION INSTITUTE OF MAINTENANCE       ,VA,23320-5987,Proprietary  ,20,107,127,169,758,927
03126400,CENTURA COLLEGE                         ,VA,23235-5230,Proprietary  ,11,167,178,219,1232,1451
03126401,CENTURA COLLEGE - WEST                  ,VA,23294-0000,Proprietary  ,0,0,0,33,166,199
03127500,ADVANCED TECHNOLOGY INSTITUTE           ,VA,23462-2409,Proprietary  ,38,106,144,708,1041,1749
03280400,VIRGINIA SCHOOL OF MASSAGE              ,VA,22903-0000,Proprietary  ,17,41,58,90,233,323
03409500,RICHMOND SCHOOL OF HEALTH AND TECH      ,VA,23227-0000,Proprietary  ,18,116,134,207,948,1155
03455300,CRESCENT COSMETOLOGY UNIVERSITY         ,VA,23666-3115,Proprietary  ,1,3,4,18,44,62
03559300,APPALACHIAN SCHOOL OF LAW               ,VA,24614-0000,Private      ,0,0,0,11,705,716
03638400,TAP THIS VALLEY WORKS CTR FOR EMPLO     ,VA,24016-1901,Private      ,0,0,0,3,26,29
03645400,RUDY & KELLY ACADEMY OF HAIR AND NA     ,VA,23464-6857,Proprietary  ,13,36,49,136,319,455
03654300,CAREER TRAINING SOLUTIONS               ,VA,22406-1014,Proprietary  ,9,55,64,101,585,686
03709300,EDWARD VIA VIRGINIA CLG OSTEOPATHIC MED ,VA,24060-6360,Private      ,0,2,2,10,803,813
03872400,INSTITUTE FOR THE PSYCHOLOGICAL SCIENCES,VA,22202-3609,Private      ,0,3,3,11,129,140
03876300,CULPEPER COSMETOLOGY TRAINING CENTER    ,VA,22701-3155,Public       ,2,8,10,22,75,97
03883400,AVIATION INSTITUTE OF MAINTENANCE       ,VA,20110-4156,Proprietary  ,15,70,85,191,735,926
04038400,AVI CAREER INSTITUTE                    ,VA,22066-1839,Proprietary  ,2,24,26,11,122,133
04110300,UNIVERSITY OF MANAGEMENT AND TECHNOLOGY ,VA,22209-1609,Proprietary  ,2,17,19,2,46,48
04124000,DOMINION SCHOOL OF HAIR DESIGN          ,VA,23062-2221,Proprietary  ,2,9,11,17,52,69
04127300,COLUMBIA COLLEGE                        ,VA,22031-4413,Proprietary  ,5,87,92,43,377,420
04133400,CENTURA COLLEGE                         ,VA,22312-2670,Proprietary  ,6,37,43,50,314,364
04133800,SOUTHEAST CULINARY & HOSPITALITY COLLEGE,VA,24201-4159,Proprietary  ,4,17,21,76,143,219
04137300,CAYCE/REILLY SCHOOL OF MASSOTHERAPY     ,VA,23451-2061,Private      ,0,17,17,18,88,106
04140000,GLOBAL HEALTH NURSE TRAINING SERVICES   ,VA,22314-4585,Proprietary  ,4,30,34,50,392,442
04153800,BETHEL COLLEGE                          ,VA,23666-3122,Private      ,4,7,11,28,74,102
04156200,INSTITUTE OF ADVANCED MEDICAL ESTHETICS ,VA,23294-4701,Proprietary  ,1,10,11,14,157,171
04171500,COSMOPOLITAN BEAUTY & TECH SCHOOL       ,VA,22003-3204,Proprietary  ,2,48,50,3,64,67
00107000,THUNDERBIRD SCHOOL OF GLOBAL MANAGEMENT ,AZ,85306-6000,Private      ,0,34,34,12,910,922
00107100,ARIZONA WESTERN COLLEGE                 ,AZ,85366-0000,Public       ,156,208,364,4693,5438,10131
00107200,COCHISE COLLEGE                         ,AZ,85607-6190,Public       ,62,230,292,1641,3057,4698
00107300,EASTERN ARIZONA COLLEGE                 ,AZ,85552-0769,Public       ,55,143,198,1831,2172,4003
00107400,GRAND CANYON UNIVERSITY                 ,AZ,85017-3030,Proprietary  ,239,5019,5258,5119,59187,64306
00107600,GLENDALE COMMUNITY COLLEGE              ,AZ,85302-3090,Public       ,361,907,1268,10327,14164,24491
00107700,MESA COMMUNITY COLLEGE                  ,AZ,85202-4866,Public       ,494,1216,1710,11441,18675,30116
00107800,PHOENIX COLLEGE                         ,AZ,85013-4234,Public       ,217,931,1148,5869,13382,19251
00107900,YAVAPAI COLLEGE                         ,AZ,86301-3297,Public       ,76,276,352,2372,4575,6947
00108100,ARIZONA STATE UNIV (ALL CAMPUSES)       ,AZ,85287-0412,Public       ,902,1367,2269,49472,36524,85996
00108200,NORTHERN ARIZONA UNIVERSITY             ,AZ,86011-0001,Public       ,388,502,890,24288,13726,38014
00108300,UNIVERSITY OF ARIZONA                   ,AZ,85721-0066,Public       ,610,497,1107,29218,16281,45499
00165701,MIDWESTERN UNIVERSITY                   ,AZ,85308-0000,Private      ,3,48,51,122,3294,3416
00446700,TUCSON COLLEGE                          ,AZ,85711-3781,Proprietary  ,41,140,181,247,966,1213
00711300,SOUTHWESTERN COLLEGE                    ,AZ,85032-7097,Private      ,7,21,28,530,335,865
00726600,PIMA COUNTY COMMUNITY COLLEGE           ,AZ,85709-1110,Public       ,466,1347,1813,11509,20714,32223
00728300,CENTRAL ARIZONA COLLEGE                 ,AZ,85228-9779,Public       ,95,376,471,2732,5220,7952
00732911,ITT TECHNICAL INSTITUTE                 ,AZ,85282-9272,Proprietary  ,91,404,495,833,3650,4483
00732990,ITT TECHNICAL INSTITUTE                 ,AZ,85704-5829,Proprietary  ,138,324,462,999,2805,3804
00822100,UNIVERSAL TECHNICAL INSTITUTE           ,AZ,85323-7946,Proprietary  ,682,886,1568,10463,9611,20074
00824600,DINè COLLEGE                            ,AZ,86556-0126,Public       ,62,167,229,1014,1690,2704
00830300,GATEWAY COMMUNITY COLLEGE               ,AZ,85034-1795,Public       ,115,589,704,2401,7701,10102
00830302,MARICOPA SKILL CENTER                   ,AZ,85034-0000,Public       ,39,180,219,461,2053,2514
00830400,SCOTTSDALE COMMUNITY COLLEGE            ,AZ,85250-0000,Public       ,163,352,515,4160,5235,9395
00832200,DEVRY INSTITUTE OF TECHNOLOGY           ,AZ,85021-2995,Proprietary  ,0,0,0,151,300,451
00886400,ARIZONA ACADEMY OF BEAUTY               ,AZ,85712-5021,Proprietary  ,4,13,17,70,155,225
00886500,ARTISTIC BEAUTY COLLEGES-TUCSON         ,AZ,85716-3999,Proprietary  ,17,32,49,167,404,571
00886501,ARTISTIC BEAUTY COLLEGES - TUCSON  - NOR,AZ,85705-1665,Proprietary  ,0,0,0,12,32,44
01084700,ARIZONA AUTOMOTIVE INSTITUTE            ,AZ,85301-3503,Proprietary  ,103,294,397,741,2244,2985
01085800,AVALON SCHOOL OF COSMETOLOGY            ,AZ,85210-4010,Proprietary  ,48,90,138,284,604,888
01168900,REFRIGERATION SCHOOL                    ,AZ,85034-0000,Proprietary  ,34,181,215,184,1167,1351
01180200,ARIZONA ACADEMY OF BEAUTY-NORTH         ,AZ,85705-2720,Proprietary  ,1,14,15,44,105,149
01180800,ARTISTIC BEAUTY COLLEGES-FLAGSTAFF      ,AZ,86004-5119,Proprietary  ,26,51,77,183,387,570
01180801,CLG OF BEAUTY ARTS & SCI/CHANDLER       ,AZ,85224-0000,Proprietary  ,0,0,0,8,28,36
01180802,CLG OF BEAUTY ARTS & SCI/PRESCOTT       ,AZ,86303-0000,Proprietary  ,0,0,0,15,23,38
01186200,NORTHLAND PIONEER COLLEGE               ,AZ,86025-2996,Public       ,32,129,161,732,2120,2852
01186400,MOHAVE COMMUNITY COLLEGE                ,AZ,86409-1238,Public       ,101,418,519,1801,6114,7915
01218400,INTERNATIONAL ACAD OF HAIR DESIGN       ,AZ,85225-7198,Proprietary  ,6,33,39,131,288,419
01234300,ARTISTIC BEAUTY COLLEGES-PHOENIX        ,AZ,85304-0000,Proprietary  ,22,45,67,180,357,537
01293700,ARTISTIC BEAUTY COLLEGES - PARADISE VALL,AZ,85257-0000,Proprietary  ,4,17,21,50,145,195
02065300,PRESCOTT COLLEGE                        ,AZ,86301-0000,Private      ,11,45,56,605,1253,1858
02071200,KAPLAN COLLEGE                          ,AZ,85029-4349,Proprietary  ,34,193,227,432,2310,2742
02098800,UNIVERSITY OF PHOENIX                   ,AZ,85040-0000,Proprietary  ,3722,67853,71575,27941,523966,551907
02100500,UNIVERSAL TECHNICAL INSTITUTE           ,AZ,85027-0000,Proprietary  ,511,1021,1532,8000,11478,19478
02100600,CARRINGTON COLLEGE                      ,AZ,85015-4096,Proprietary  ,158,641,799,1996,7485,9481
02113800,ROBERTO-VENN SCH OF LUTHIERY            ,AZ,85040-0000,Proprietary  ,1,5,6,43,76,119
02146600,SOUTH MOUNTAIN COMMUNITY COLLEGE        ,AZ,85040-0000,Public       ,109,303,412,2267,4055,6322
02160305,COLLINS COLLEGE                         ,AZ,85040-4000,Proprietary  ,47,75,122,1061,1244,2305
02160306,INTERNATIONAL ACADEMY OF DESIGN AND TECH,AZ,85281-6705,Proprietary  ,3,5,8,15,31,46
02171500,WESTERN INTERNATIONAL UNIVERSITY        ,AZ,85021-0000,Proprietary  ,13,572,585,87,3464,3551
02177500,RIO SALADO COMMUNITY COLLEGE            ,AZ,85281-6948,Public       ,244,2665,2909,2609,21286,23895
02179907,ARGOSY UNIVERSITY  -  PHOENIX           ,AZ,85021-0000,Proprietary  ,0,0,0,0,1,1
02190702,FORTIS COLLEGE - PHOENIX CAMPUS         ,AZ,85006-3759,Proprietary  ,0,0,0,14,68,82
02192300,MARICOPA BEAUTY COLLEGE                 ,AZ,85323-0000,Proprietary  ,11,20,31,88,185,273
02199900,AMERICAN INDIAN CLG-ASSEMBLIES GOD      ,AZ,85021-0000,Private      ,3,6,9,74,115,189
02217100,PIMA MEDICAL INSTITUTE                  ,AZ,85716-0000,Proprietary  ,473,1330,1803,3221,9763,12984
02218800,BROOKLINE COLLEGE                       ,AZ,85021-5815,Proprietary  ,69,494,563,443,3095,3538
02218804,BROOKLINE COLLEGE - MESA                ,AZ,85204-4448,Proprietary  ,24,159,183,193,938,1131
02218805,BROOKLINE COLLEGE - TUCSON              ,AZ,85711-5444,Proprietary  ,49,221,270,336,1340,1676
02220300,ARTISTIC BEAUTY COLLEGES-GLENDALE       ,AZ,85051-0000,Proprietary  ,15,35,50,150,443,593
02263100,ANTHEM COLLEGE                          ,AZ,85014-0000,Proprietary  ,187,963,1150,935,5092,6027
02280500,CHARLES OF ITALY BEAUTY COLLEGE         ,AZ,86403-0000,Proprietary  ,2,11,13,48,89,137
02295000,EVEREST COLLEGE                         ,AZ,85021-1610,Proprietary  ,47,192,239,1187,10400,11587
02295002,EVEREST COLLEGE - MESA                  ,AZ,85206-4704,Proprietary  ,13,103,116,257,1302,1559
02317800,AMERICAN INSTITUTE OF TECHNOLOGY        ,AZ,85043-0000,Proprietary  ,26,393,419,137,2119,2256
02491500,THE ART CENTER DESIGN COLLEGE           ,AZ,85716-0000,Proprietary  ,11,28,39,269,539,808
02521500,LAMSON COLLEGE                          ,AZ,85284-1141,Proprietary  ,14,69,83,97,502,599
02533200,FRANK LLOYD WRIGHT SCHOOL OF ARCHITECTUR,AZ,85261-4430,Private      ,3,7,10,21,67,88
02559000,UNIVERSITY OF ADVANCING TECHNOLOGY      ,AZ,85283-0000,Proprietary  ,49,71,120,1144,907,2051
02561900,BRILLARE HAIRDRESSING ACADEMY           ,AZ,85254-3301,Proprietary  ,8,16,24,163,196,359
02582700,CORTIVA INSTITUTE - TUCSON              ,AZ,85710-3503,Proprietary  ,8,43,51,66,313,379
02616700,LE CORDON BLEU COLLEGE OF CULINARY ARTS ,AZ,85251-2729,Proprietary  ,64,237,301,1117,2807,3924
02623600,PARADISE VALLEY COMMUNITY COLLEGE       ,AZ,85032-1210,Public       ,123,397,520,3323,5165,8488
02623800,CORTIVA INSTITUTE - SCOTTSDALE          ,AZ,85257-4218,Proprietary  ,7,13,20,55,206,261
03005000,SAFFORD COLLEGE OF BEAUTY CULTURE       ,AZ,85546-3309,Proprietary  ,2,12,14,17,86,103
03010613,VIRGINIA COLLEGE - GOLF ACADEMY OF ARIZO,AZ,85225-6742,Proprietary  ,6,20,26,119,291,410
03030604,UTAH COLLEGE OF MASSAGE THERAPY - ARIZON,AZ,85282-0000,Proprietary  ,33,67,100,226,495,721
03030605,UTAH COLLEGE OF MASSAGE THERAPY - ARIZON,AZ,85051-3470,Proprietary  ,28,67,95,263,523,786
03034400,CONSERVATORY RECORDING ARTS & SCIS      ,AZ,85282-1707,Proprietary  ,53,73,126,720,889,1609
03072200,CHANDLER-GILBERT COMMUNITY COLLEGE      ,AZ,85225-2499,Public       ,159,414,573,4944,6305,11249
03076400,BRYMAN SCHOOL OF ARIZONA                ,AZ,85029-4919,Proprietary  ,196,642,838,1323,4188,5511
03097800,CARSTEN INSTITUTE OF HAIR & BEAUTY      ,AZ,85282-5404,Proprietary  ,13,32,45,135,291,426
03100400,COCONINO COUNTY COMMUNITY COLLEGE       ,AZ,86001-2701,Public       ,56,144,200,1467,2458,3925
03107000,SOUTHWEST CLG OF NATUROPATHIC MED       ,AZ,85282-0000,Private      ,1,6,7,18,508,526
03115000,ARIZONA COLLEGE OF ALLIED HEALTH        ,AZ,85302-3843,Proprietary  ,28,161,189,319,1339,1658
03120300,COLLEGE AMERICA                         ,AZ,86004-3936,Proprietary  ,29,159,188,262,1189,1451
03156300,ESTRELLA MOUNTAIN COMMUNITY COLLEGE     ,AZ,85392-1010,Public       ,147,483,630,3656,6083,9739
03156301,ESTRELLA MOUNTAIN COMMUNITY COLLEGE - SO,AZ,85392-1010,Public       ,0,0,0,1131,1782,2913
03347300,INTERNATIONAL BAPTIST COLLEGE           ,AZ,85282-6799,Private      ,0,3,3,57,33,90
03445300,HDS TRUCK DRIVING INSTITUTE             ,AZ,85731-0000,Proprietary  ,1,25,26,6,167,173
03478400,PHOENIX SEMINARY                        ,AZ,85018-7611,Private      ,0,11,11,4,134,138
03572300,EAST VALLEY INSTITUTE OF TECHNOLOGY     ,AZ,85201-6910,Public       ,16,52,68,193,348,541
03593300,SOUTHWEST INSTITUTE OF HEALING ARTS     ,AZ,85281-3658,Proprietary  ,16,145,161,174,1169,1343
03617500,PHOENIX INSTITUTE OF HERBAL MEDICINE & A,AZ,85012-0000,Proprietary  ,6,16,22,41,254,295
03695500,ARIZONA SCHOOL OF ACUPUNCTURE AND ORIENT,AZ,85712-1100,Proprietary  ,1,5,6,13,144,157
03784400,TOHONO O'ODHAM COMMUNITY COLLEGE        ,AZ,85634-3129,Public       ,1,10,11,28,91,119
03813300,NORTHCENTRAL UNIVERSITY                 ,AZ,86314-2336,Proprietary  ,6,700,706,61,4840,4901
03814300,TURNING POINT BEAUTY COLLEGE            ,AZ,85222-4229,Proprietary  ,2,14,16,28,90,118
04051300,ART INSTITUTE OF PHOENIX (THE)          ,AZ,85021-2859,Proprietary  ,776,3147,3923,8287,29920,38207
04051306,ART INSTITUTE OF PHOENIX (THE) - ART INS,AZ,85712-2732,Proprietary  ,23,43,66,462,658,1120
04051325,ART INSTITUTE OF PHOENIX (THE) - BROWN M,AZ,85712-5300,Proprietary  ,105,567,672,1239,5439,6678
04051327,ART INSTITUTE OF PHOENIX (THE) - BROWN M,AZ,85029-1348,Proprietary  ,6,8,14,6,8,14
04059300,TUCSON COLLEGE OF BEAUTY                ,AZ,85705-2451,Proprietary  ,6,15,21,60,147,207
04120900,ARIZONA CULINARY INSTITUTE              ,AZ,85259-4939,Proprietary  ,13,40,53,284,508,792
04131400,PHOENIX SCHOOL OF LAW                   ,AZ,85012-3330,Proprietary  ,2,38,40,68,1525,1593
04138800,MODERN TECHNIQUES BEAUTY COLLEGE        ,AZ,86403-2974,Proprietary  ,0,0,0,13,26,39
04139200,UNIVERSAL BARBER COLLEGE                ,AZ,85007-3914,Proprietary  ,8,37,45,66,238,304
04148700,AMERICAN INSTITUTE OF INTERIOR DESIGN   ,AZ,85268-3827,Proprietary  ,1,9,10,5,31,36
04152900,STUDIO ACADEMY OF BEAUTY (THE)          ,AZ,85224-3600,Proprietary  ,8,24,32,73,167,240
04157400,NATIONAL PARALEGAL COLLEGE              ,AZ,85014-1262,Proprietary  ,6,210,216,13,421,434
04172100,CCIC BEAUTY COLLEGE                     ,AZ,85345-2410,Proprietary  ,2,12,14,3,13,16
04174100,PAUL MITCHELL THE SCHOOL PHOENIX        ,AZ,85017-1919,Proprietary  ,20,35,55,97,156,253
04174200,ALL BEAUTY COLLEGE                      ,AZ,86426-8326,Proprietary  ,6,8,14,18,65,83
04175300,KOHLER ACADEMY                          ,AZ,85254-4065,Proprietary  ,13,23,36,52,94,146
00142800,DELAWARE STATE UNIVERSITY               ,DE,19901-2277,Public       ,105,73,178,7635,2221,9856
00142900,GOLDEY BEACOM COLLEGE                   ,DE,19808-1993,Private      ,7,38,45,550,533,1083
00143100,UNIVERSITY OF DELAWARE                  ,DE,19716-0099,Public       ,197,132,329,23289,3325,26614
00143300,WESLEY COLLEGE                          ,DE,19901-3875,Private      ,26,28,54,2675,695,3370
00143301,WESLEY COLLEGE-CTR FOR ADULT STUDIE     ,DE,19720-0000,Private      ,1,23,24,36,371,407
00331301,WIDENER UNIV SCHOOL OF LAW - DE         ,DE,19803-0000,Private      ,0,19,19,46,1748,1794
00705300,DELAWARE TECH & CMTY COLLEGE-OWENS      ,DE,19947-0000,Public       ,58,215,273,2292,3553,5845
00794800,WILMINGTON UNIVERSITY                   ,DE,19720-6491,Private      ,68,524,592,2453,8091,10544
01172700,DELAWARE TECH & CMTY CLG-TERRY          ,DE,19901-8736,Public       ,60,171,231,1839,2671,4510
02125200,BEEBE SCHOOL OF NURSING                 ,DE,19958-1462,Private      ,1,8,9,58,133,191
02144900,DELAWARE TECH & CMTY CLG-STANTN/WLM     ,DE,19801-0000,Public       ,84,242,326,3554,4443,7997
02190400,SCHILLING DOUGLAS SCH OF HAIR DSGN      ,DE,19711-0000,Proprietary  ,8,14,22,77,170,247
02586902,STAR TECHNICAL INSTITUTE -              ,DE,19901-4615,Proprietary  ,1,1,2,17,71,88
03025800,DAWN TRAINING CENTRE                    ,DE,19805-1511,Proprietary  ,31,190,221,163,1235,1398
03543300,HARRIS SCHOOL OF BUSINESS               ,DE,19803-5341,Proprietary  ,30,144,174,173,868,1041
03702300,DELAWARE LEARNING INSTITUTE OF COSMETOLO,DE,19939-9759,Proprietary  ,4,33,37,43,179,222
04130700,ACADEMY OF MASSAGE AND BODYWORK         ,DE,19701-1321,Proprietary  ,2,9,11,18,75,93
04139800,DELAWARE COLLEGE OF ART & DESIGN        ,DE,19801-3007,Private      ,4,6,10,415,114,529
04171100,DELAWARE ACADEMY PAUL MITCHELL PARTNER S,DE,19702-5108,Proprietary  ,12,19,31,62,117,179
        ,FEDERAL STUDENT AID USE ONLY            ,DC,20202-0000,,0,0,0,0,1,1
        ,OFFICIAL USE ONLY                       ,DC,20202-0000,,1,0,1,1,0,1
00143400,AMERICAN UNIVERSITY                     ,DC,20016-8020,Private      ,117,133,250,13042,11522,24564
00143700,CATHOLIC UNIVERSITY OF AMERICA          ,DC,20064-0002,Private      ,54,72,126,5733,3076,8809
00143711,"CATHOLIC UNIV AMERICA, LAW SCHOOL       ",DC,20064-0000,Private      ,1,11,12,39,1596,1635
00144100,UNIV OF THE DISTRICT OF COLUMBIA        ,DC,20008-0000,Public       ,76,257,333,2305,5775,8080
00144102,UNIV OF THE DIST OF COLU -SCHOOL OF LAW ,DC,20008-1173,Public       ,11,39,50,639,2156,2795
00144300,GALLAUDET UNIVERSITY                    ,DC,20002-3695,Private      ,11,27,38,919,1002,1921
00144400,GEORGE WASHINGTON UNIVERSITY            ,DC,20052-2353,Private      ,113,419,532,13460,12732,26192
00144402,GEORGE WASHINGTON UNIV LAW SCHL         ,DC,20052-0000,Private      ,2,12,14,63,4560,4623
00144403,GEORGE WASHINGTON UNIV SCH MED          ,DC,20052-0000,Private      ,3,18,21,54,1441,1495
00144500,GEORGETOWN UNIVERSITY                   ,DC,20057-1252,Private      ,107,183,290,12273,4875,17148
00144501,"GEORGETOWN UNIV, SCH OF MEDICINE        ",DC,20007-0000,Private      ,4,14,18,72,1340,1412
00144502,GEORGETOWN UNIVERSITY - GRADUATE SCHOOL ,DC,20057-0004,Private      ,2,79,81,64,3673,3737
00144503,GEORGETOWN UNIV LAW CENTER              ,DC,20001-0000,Private      ,3,24,27,45,6437,6482
00144800,HOWARD UNIVERSITY                       ,DC,20059-0001,Private      ,189,213,402,14674,9628,24302
00145900,STRAYER UNIVERSITY                      ,DC,20005-2603,Proprietary  ,296,5604,5900,2956,66704,69660
00146000,TRINITY UNIVERSITY                      ,DC,20017-1004,Private      ,14,104,118,1231,2568,3799
00146400,WESLEY THEOLOGICAL SEMINARY             ,DC,20016-0000,Private      ,0,21,21,0,371,371
00207701,JOHNS HOPKINS UNIV SCH ADV INTL STU     ,DC,20036-0000,Private      ,2,17,19,54,1567,1621
01006500,WASHINGTON THEOLOGICAL UNION            ,DC,20012-0000,Private      ,0,2,2,4,50,54
01195000,THE CORCORAN COLLEGE OF ART & DESIG     ,DC,20006-4804,Private      ,3,10,13,551,486,1037
01280300,DOMINICAN HOUSE OF STUDIES              ,DC,20017-1584,Private      ,0,2,2,3,27,30
02132800,NAT'L CONSERVATORY DRAMATIC ARTS        ,DC,20007-2758,Private      ,2,0,2,15,38,53
02279200,DUDLEY BEAUTY COLG-WASHINGTON           ,DC,20018-0000,Proprietary  ,6,30,36,69,201,270
02588900,SANZ SCHOOL                             ,DC,20006-0000,Proprietary  ,101,420,521,383,1812,2195
03104300,CAREER BLAZERS LEARNING CENTER OF WASHIN,DC,20037-1881,Proprietary  ,28,206,234,122,894,1016
03218300,POTOMAC COLLEGE                         ,DC,20016-1860,Proprietary  ,6,51,57,61,600,661
03409600,BENNETT CAREER INSTITUTE                ,DC,20017-1754,Proprietary  ,11,41,52,123,400,523
03750300,TECHNICAL LEARNING CENTERS              ,DC,20006-3749,Proprietary  ,16,197,213,84,661,745
04114400,INSTITUTE OF WORLD POLITICS (THE)       ,DC,20036-1464,Private      ,0,3,3,4,210,214
04142700,PONTIFICAL JOHN PAUL II INSTITUTE FOR ST,DC,20064-0001,Private      ,0,0,0,0,31,31
00154100,ABRAHAM BALDWIN AGRICULTURAL CLG        ,GA,31794-0000,Public       ,87,76,163,3229,1981,5210
00154200,AGNES SCOTT COLLEGE                     ,GA,30030-3797,Private      ,14,13,27,1481,521,2002
00154300,DARTON COLLEGE                          ,GA,31707-3098,Public       ,92,303,395,3573,6599,10172
00154400,ALBANY STATE UNIVERSITY                 ,GA,31705-2796,Public       ,131,172,303,7274,5074,12348
00154500,ANDREW COLLEGE                          ,GA,39840-1395,Private      ,11,2,13,439,83,522
00154600,ARMSTRONG ATLANTIC STATE UNIVERSITY     ,GA,31419-1997,Public       ,126,269,395,5902,6523,12425
00154700,ATLANTA CHRISTIAN COLLEGE               ,GA,30344-1999,Private      ,12,93,105,508,1440,1948
00155200,AUGUSTA STATE UNIVERSITY                ,GA,30904-2200,Public       ,98,213,311,5547,5623,11170
00155400,BERRY COLLEGE                           ,GA,30149-5007,Private      ,31,9,40,3164,355,3519
00155500,THOMAS UNIVERSITY                       ,GA,31792-7499,Private      ,11,88,99,346,1419,1765
00155600,BRENAU UNIVERSITY                       ,GA,30501-3668,Private      ,26,149,175,1394,3353,4747
00155700,BREWTON PARKER COLLEGE                  ,GA,30445-0000,Private      ,3,21,24,599,411,1010
00155800,COASTAL GEORGIA COMMUNITY COLLEGE       ,GA,31520-3644,Public       ,62,129,191,2041,3617,5658
00155900,CLARK ATLANTA UNIVERSITY                ,GA,30314-4385,Private      ,214,161,375,13383,5640,19023
00156000,COLUMBIA THEOLOGICAL SEMINARY           ,GA,30031-0000,Private      ,0,2,2,6,252,258
00156100,COLUMBUS STATE UNIVERSITY               ,GA,31907-5645,Public       ,132,283,415,6650,6469,13119
00156200,GEORGIA PERIMETER COLLEGE               ,GA,30021-0000,Public       ,504,1261,1765,17342,25574,42916
00156300,EMMANUEL COLLEGE                        ,GA,30639-0000,Private      ,2,6,8,818,251,1069
00156400,EMORY UNIVERSITY                        ,GA,30322-1960,Private      ,136,247,383,11842,10856,22698
00156600,FORT VALLEY STATE UNIVERSITY            ,GA,31030-3298,Public       ,124,117,241,6547,2812,9359
00156700,GAINESVILLE STATE COLLEGE               ,GA,30503-0000,Public       ,156,192,348,6872,4118,10990
00156800,INTERDENOMINATIONAL THEOLOGY CENTER     ,GA,30314-0000,Private      ,0,20,20,4,611,615
00156900,GEORGIA INSTITUTE OF TECHNOLOGY         ,GA,30332-0002,Public       ,226,171,397,16724,5894,22618
00157000,SOUTHERN POLYTECHNIC STATE UNIV         ,GA,30060-2896,Public       ,58,151,209,3713,3847,7560
00157100,GEORGIA MILITARY COLLEGE                ,GA,31061-3398,Public       ,215,426,641,4244,5652,9896
00157200,GEORGIA SOUTHERN UNIVERSITY             ,GA,30460-8065,Public       ,540,330,870,21610,7706,29316
00157300,GEORGIA SOUTHWESTERN STATE UNIV         ,GA,31709-4693,Public       ,49,101,150,2702,2317,5019
00157400,GEORGIA STATE UNIVERSITY                ,GA,30303-3010,Public       ,487,1028,1515,29010,29964,58974
00157500,GORDON COLLEGE                          ,GA,30204-1762,Public       ,121,135,256,6057,3566,9623
00157700,KENNESAW STATE UNIVERSITY               ,GA,30144-5591,Public       ,368,706,1074,18364,16330,34694
00157800,LAGRANGE COLLEGE                        ,GA,30240-2999,Private      ,20,47,67,1334,772,2106
00157900,MEDICAL COLLEGE OF GEORGIA              ,GA,30912-0004,Public       ,19,87,106,736,2976,3712
00158000,MERCER UNIVERSITY                       ,GA,31207-0003,Private      ,78,293,371,4597,9555,14152
00158100,MIDDLE GEORGIA COLLEGE                  ,GA,31014-1599,Public       ,63,109,172,3646,2512,6158
00158200,MOREHOUSE COLLEGE                       ,GA,30314-3773,Private      ,91,49,140,5067,1370,6437
00158500,NORTH GEORGIA COLLEGE & STATE UNIV      ,GA,30597-0001,Public       ,109,113,222,5371,2672,8043
00158600,OGLETHORPE UNIVERSITY                   ,GA,30319-2737,Private      ,28,32,60,2088,834,2922
00158700,PAINE COLLEGE                           ,GA,30901-3182,Private      ,44,37,81,1721,729,2450
00158800,PIEDMONT COLLEGE                        ,GA,30535-5644,Private      ,10,167,177,983,2678,3661
00158900,REINHARDT UNIVERSITY                    ,GA,30183-2981,Private      ,14,23,37,1138,669,1807
00159000,SAVANNAH STATE UNIVERSITY               ,GA,31404-5298,Public       ,134,130,264,7551,3486,11037
00159100,SHORTER UNIVERSITY                      ,GA,30165-4298,Private      ,41,317,358,2159,4026,6185
00159200,SOUTH GEORGIA COLLEGE                   ,GA,31533-8104,Public       ,47,44,91,1930,1542,3472
00159400,SPELMAN COLLEGE                         ,GA,30314-4399,Private      ,122,46,168,6868,1689,8557
00159600,TOCCOA FALLS COLLEGE                    ,GA,30598-0001,Private      ,10,13,23,870,265,1135
00159700,TRUETT MCCONNELL COLLEGE                ,GA,30528-1264,Private      ,4,10,14,547,190,737
00159800,UNIVERSITY OF GEORGIA                   ,GA,30602-6114,Public       ,436,352,788,25951,13667,39618
00159900,VALDOSTA STATE UNIVERSITY               ,GA,31698-0001,Public       ,235,313,548,14500,6768,21268
00160000,WESLEYAN COLLEGE                        ,GA,31210-4407,Private      ,10,27,37,507,585,1092
00160100,UNIV OF WEST GEORGIA                    ,GA,30118-0002,Public       ,142,255,397,11181,6166,17347
00160200,GEORGIA COLLEGE & STATE UNIVERSITY      ,GA,31061-0490,Public       ,119,106,225,6632,2657,9289
00160400,YOUNG HARRIS COLLEGE                    ,GA,30582-4137,Private      ,13,4,17,1154,129,1283
00348400,COVENANT COLLEGE                        ,GA,30750-4164,Private      ,15,8,23,1223,348,1571
00395600,DALTON STATE COLLEGE                    ,GA,30720-3797,Public       ,63,173,236,4235,4614,8849
00402300,APPALACHIAN TECHNICAL COLLEGE           ,GA,30143-0000,Public       ,0,0,0,3,25,28
00402400,GEORGIA NORTHWESTERN TECHNICAL COLLEGE  ,GA,30161-6757,Public       ,162,792,954,2742,9306,12048
00411700,GRADY HEALTH SYSTEM                     ,GA,30303-3050,Public       ,6,37,43,135,691,826
00525400,LANIER TECHNICAL COLLEGE                ,GA,30566-3499,Public       ,74,463,537,1397,5113,6510
00525500,MOULTRIE TECHNICAL COLLEGE              ,GA,31768-0000,Public       ,73,317,390,863,3173,4036
00525600,WIREGRASS GEORGIA TECHNICAL COLLEGE     ,GA,31602-0929,Public       ,130,669,799,1977,6685,8662
00525602,WIREGRASS GEORGIA TECHNICAL COLLEGE - BE,GA,31750-8806,Public       ,0,0,0,321,1286,1607
00551100,OKEFENOKEE TECHNICAL COLLEGE            ,GA,31501-4016,Public       ,36,227,263,560,2196,2756
00559900,AUGUSTA TECHNICAL COLLEGE               ,GA,30906-3399,Public       ,141,511,652,2564,7709,10273
00560000,ATHENS TECHNICAL COLLEGE                ,GA,30601-1579,Public       ,125,461,586,2841,7237,10078
00560100,ALBANY TECHNICAL COLLEGE                ,GA,31701-2648,Public       ,127,573,700,1915,7622,9537
00561400,WEST GEORGIA TECHNICAL COLLEGE          ,GA,30240-5957,Public       ,0,0,0,42,91,133
00561500,SOUTHWEST GEORGIA TECHNICAL COLLEGE     ,GA,31792-2622,Public       ,49,193,242,847,2977,3824
00561600,SWAINSBORO TECHNICAL COLLEGE (FORMERLY S,GA,30401-5700,Public       ,3,16,19,78,274,352
00561700,SOUTH GEORGIA TECHNICAL COLLEGE         ,GA,31709-8167,Public       ,93,297,390,1179,2958,4137
00561800,SAVANNAH TECHNICAL COLLEGE              ,GA,31405-5594,Public       ,200,930,1130,2960,10637,13597
00561900,NORTH GEORGIA TECHNICAL COLLEGE         ,GA,30523-0000,Public       ,81,265,346,1530,3610,5140
00562000,CHATTAHOOCHEE TECHNICAL COLLEGE         ,GA,30060-3398,Public       ,353,1209,1562,6386,15880,22266
00562004,NORTH METRO TECHNICAL COLLEGE           ,GA,30102-3129,Public       ,0,0,0,17,46,63
00562100,GRIFFIN TECHNICAL COLLEGE               ,GA,30223-2097,Public       ,144,519,663,2198,7185,9383
00562101,FLINT RIVER TECHNICAL INSTITUTE         ,GA,30286-0014,Public       ,12,39,51,259,1031,1290
00562200,DEKALB TECHNICAL COLLEGE                ,GA,30021-0000,Public       ,138,729,867,2535,10779,13314
00562400,COLUMBUS TECHNICAL COLLEGE              ,GA,31904-6572,Public       ,136,517,653,2147,5918,8065
00576300,CENTRAL GEORGIA TECHNICAL COLLEGE       ,GA,31206-3628,Public       ,148,809,957,2766,11664,14430
00772800,MACON STATE COLLEGE                     ,GA,31206-5145,Public       ,83,284,367,3913,6557,10470
00854300,ATLANTA TECHNICAL COLLEGE               ,GA,30310-4499,Public       ,180,806,986,2873,11119,13992
00897600,CLAYTON STATE UNIVERSITY                ,GA,30260-0285,Public       ,115,437,552,5947,10888,16835
00927000,ART INSTITUTE OF ATLANTA (THE)          ,GA,30328-1649,Proprietary  ,395,755,1150,9542,8596,18138
00950700,GEORGIA HIGHLANDS COLLEGE               ,GA,30162-0000,Public       ,124,193,317,3894,3924,7818
00962106,HERZING UNIVERSITY - ATLANTA            ,GA,30326-1162,Proprietary  ,13,96,109,289,1793,2082
01031903,MEDIX SCHOOL                            ,GA,30080-7630,Proprietary  ,37,175,212,308,1307,1615
01035601,EVEREST INSTITUTE - DEKALB              ,GA,30035-3420,Proprietary  ,29,171,200,299,1530,1829
01048700,WEST GEORGIA TECHNICAL COLLEGE          ,GA,30182-6476,Public       ,175,706,881,3497,9453,12950
01077100,GUPTON JONES COLLEGE                    ,GA,30035-4022,Private      ,6,35,41,176,498,674
01099700,EAST GEORGIA COLLEGE                    ,GA,30401-2699,Public       ,75,72,147,2937,1631,4568
01107400,BAINBRIDGE COLLEGE                      ,GA,39819-8400,Public       ,82,268,350,1497,4672,6169
01110901,EVEREST COLLEGE - EVEREST INSTITUTE     ,GA,30067-8340,Proprietary  ,19,93,112,191,1159,1350
01110902,EVEREST COLLEGE - ATLANTA               ,GA,30331-2620,Proprietary  ,17,53,70,22,93,115
01112301,EVEREST COLLEGE - EVEREST INSTITUTE- NOR,GA,30093-2813,Proprietary  ,24,159,183,255,1314,1569
01157400,BAUDER COLLEGE                          ,GA,30313-2439,Proprietary  ,33,84,117,799,1551,2350
01205100,PRO WAY HAIR SCHOOL                     ,GA,30083-2884,Proprietary  ,6,49,55,106,531,637
01216500,ATLANTA METROPOLITAN COLLEGE            ,GA,30310-4498,Public       ,113,361,474,3393,6328,9721
01303900,SOUTH UNIVERSITY                        ,GA,31406-4881,Proprietary  ,600,6955,7555,4073,47389,51462
02055000,WAYCROSS COLLEGE                        ,GA,31503-0000,Public       ,21,45,66,720,998,1718
02060900,BROWN CLG OF COURT REPORTING & M.T.     ,GA,30318-2570,Proprietary  ,3,39,42,47,531,578
02074800,LIFE UNIVERSITY                         ,GA,30060-0000,Private      ,18,72,90,442,2858,3300
02113613,AMERICAN INTERCONTINENTAL UNIVERSITY    ,GA,30328-1649,Proprietary  ,83,377,460,1574,4557,6131
02116000,SANFORD-BROWN COLLEGE                   ,GA,30328-4803,Proprietary  ,43,205,248,480,2546,3026
02141500,SAVANNAH COLLEGE OF ART & DESIGN        ,GA,31402-3146,Private      ,162,209,371,10292,5193,15485
02202800,AUGUSTA AREA DIET INTERN UNIV HOSP      ,GA,30901-0000,Private      ,1,2,3,8,46,54
02217200,PORTFOLIO CENTER                        ,GA,30309-0000,Proprietary  ,2,6,8,27,143,170
02266200,AMERICAN PROFESSIONAL INSTITUTE         ,GA,31201-3185,Proprietary  ,63,185,248,482,2261,2743
02279500,HEART OF GEORGIA TECHNICAL COLLEGE      ,GA,31021-0000,Public       ,41,163,204,626,2207,2833
02284300,INTERACTIVE COLLEGE OF TECHNOLOGY       ,GA,30341-0000,Proprietary  ,61,317,378,336,2291,2627
02284308,INTERACTIVE LEARNING SYSTEMS            ,GA,30260-0000,Proprietary  ,13,49,62,66,381,447
02284309,INTERACTIVE COLLEGE OF TECHNOLOGY       ,GA,30501-0000,Proprietary  ,7,103,110,45,383,428
02285500,"CREATIVE CIRCUS, THE                    ",GA,30324-0000,Proprietary  ,3,14,17,83,342,425
02288400,GWINNETT TECHNICAL INSTITUTE            ,GA,30043-5702,Public       ,181,775,956,3753,11281,15034
02313902,WESTWOOD COLLEGE - O'HARE AIRPORT - ATLA,GA,30345-2807,Proprietary  ,19,64,83,393,957,1350
02321400,ROFFLER-MOLER HAIRSTYLING COLLEGE       ,GA,30062-0000,Proprietary  ,6,13,19,61,210,271
02354500,SOUTHEASTERN BEAUTY SCHOOLS             ,GA,31906-0000,Proprietary  ,7,40,47,69,210,279
02482100,MOREHOUSE SCHOOL OF MEDICINE            ,GA,30310-0000,Private      ,3,10,13,163,739,902
02502700,ADVANCED CAREER TRAINING                ,GA,30329-0000,Proprietary  ,117,425,542,691,2402,3093
02502701,ADVANCED CAREER TRAINING-RIVERDALE      ,GA,30274-0000,Proprietary  ,56,235,291,258,1151,1409
02508600,MIDDLE GEORGIA TECHNICAL COLLEGE        ,GA,31088-0000,Public       ,94,470,564,1510,4975,6485
02520000,INTERNATIONAL SCH SKIN & NAILCARE       ,GA,30342-1119,Proprietary  ,16,73,89,67,469,536
02577000,ESANI INSTITUTE                         ,GA,30297-0000,Proprietary  ,5,40,45,108,327,435
02577700,BEAUTY COLLEGE OF AMERICA               ,GA,30297-0000,Proprietary  ,9,13,22,61,157,218
02578300,INTERNATIONAL CITY BEAUTY COLLEGE       ,GA,31093-3631,Proprietary  ,0,0,0,10,22,32
02580200,ATLANTA SCHOOL OF MASSAGE               ,GA,30338-0000,Proprietary  ,13,87,100,106,551,657
02583000,GWINNETT COLLEGE OF BUSINESS            ,GA,30047-3447,Proprietary  ,10,77,87,197,924,1121
02607600,CAPELLI LEARNING CTR FOR COSM           ,GA,30324-0000,Proprietary  ,10,45,55,131,408,539
02614206,MILLER - MOTTE TECHNICAL COLLEGE - COLUM,GA,31907-3222,Proprietary  ,10,111,121,111,777,888
02614207,MILLER - MOTTE TECHNICAL COLLEGE - AUGUS,GA,30907-0921,Proprietary  ,13,61,74,25,122,147
03005400,ARTISTIC BEAUTY COLLEGE                 ,GA,30013-2076,Proprietary  ,39,81,120,316,856,1172
03010619,VIRGINIA COLLEGE - AUGUSTA              ,GA,30909-5515,Proprietary  ,20,163,183,273,1733,2006
03010623,VIRGINIA COLLEGE - MACON                ,GA,31206-3180,Proprietary  ,7,67,74,7,67,74
03022601,WESTERN CULINARY INSTITUTE - LE CORDON B,GA,30084-5893,Proprietary  ,9,22,31,247,391,638
03030000,OGEECHEE TECHNICAL COLLEGE              ,GA,30458-8049,Public       ,114,362,476,1659,3928,5587
03032100,ALTAMAHA TECHNICAL COLLEGE              ,GA,31545-4465,Public       ,51,201,252,616,2334,2950
03042700,LAURUSTECHNICAL INSTITUTE               ,GA,30030-1506,Proprietary  ,19,73,92,131,656,787
03066500,SOUTHEASTERN TECHNICAL COLLEGE          ,GA,30474-8817,Public       ,50,250,300,627,2501,3128
03072304,EVEREST COLLEGE - EVEREST INSTITUTE     ,GA,30236-0000,Proprietary  ,14,140,154,273,1398,1671
03076300,BEULAH HEIGHTS BIBLE COLLEGE            ,GA,30316-1873,Private      ,4,29,33,62,903,965
03079202,WESTWOOD COLLEGE - ATLANTA MIDTOWN      ,GA,30309-2848,Proprietary  ,40,121,161,886,1928,2814
03081500,SOUTHEASTERN BEAUTY SCHOOL              ,GA,31917-0000,Proprietary  ,2,35,37,54,178,232
03089100,GEORGIA INSTITUTE OF COSMETOLOGY        ,GA,30606-3152,Proprietary  ,16,62,78,199,492,691
03090600,COBB BEAUTY COLLEGE                     ,GA,30144-2828,Proprietary  ,4,13,17,53,141,194
03100900,LUTHER RICE UNIVERSITY                  ,GA,30038-2454,Private      ,0,39,39,35,973,1008
03102000,RIVERTOWN SCHOOL OF BEAUTY              ,GA,31904-4747,Proprietary  ,9,38,47,88,268,356
03104500,ATLANTA INSTITUTE OF MUSIC              ,GA,30096-4988,Proprietary  ,29,40,69,382,415,797
03116100,VOGUE BEAUTY AND BARBER SCHOOL          ,GA,30141-2226,Proprietary  ,13,20,33,59,180,239
03155500,SANDERSVILLE REGIONAL TECH INST         ,GA,31082-6179,Public       ,23,104,127,308,1029,1337
03173300,ATLANTA'S JOHN MARSHALL LAW SCHOOL      ,GA,30309-0000,Proprietary  ,3,19,22,47,1519,1566
03232304,LINCOLN COLLEGE OF TECHNOLOGY           ,GA,30067-8638,Proprietary  ,15,93,108,249,900,1149
03418300,GWINNETT COLLEGE-SANDY SPRINGS          ,GA,30328-3161,Proprietary  ,4,37,41,84,412,496
03445500,FAYETTE BEAUTY ACADEMY                  ,GA,30214-1191,Proprietary  ,1,8,9,25,124,149
03523300,AVIATION INSTITUTE OF MAINTENANCE       ,GA,30045-6716,Proprietary  ,29,145,174,266,994,1260
03635300,CARVER BIBLE COLLEGE                    ,GA,30331-1300,Private      ,0,14,14,28,164,192
03748300,KEVOSNIK SCHOOL OF HAIR DESIGN          ,GA,31021-0000,Proprietary  ,1,8,9,8,41,49
03753400,MICHAEL'S SCHOOL OF BEAUTY              ,GA,31211-1493,Proprietary  ,0,10,10,24,149,173
03804400,JAVELIN TECHNICAL TRAINING CENTER       ,GA,30339-6040,Proprietary  ,43,262,305,370,1831,2201
03804401,JAVELIN TECHNICAL TRAINING CENTER -     ,GA,30260-1756,Proprietary  ,0,0,0,26,174,200
03804402,JAVELIN TECHNICAL TRAINING CENTER -     ,GA,30084-5252,Proprietary  ,0,0,0,12,139,151
03812300,OMNITECH INSTITUTE                      ,GA,30035-1206,Proprietary  ,15,69,84,194,626,820
04021300,AUGUSTA SCHOOL OF MASSAGE               ,GA,30809-0000,Proprietary  ,5,16,21,26,92,118
04051331,ART INSTITUTE OF PHOENIX (THE) - BROWN M,GA,30319-3054,Proprietary  ,21,59,80,429,1285,1714
04091300,SAVANNAH SCHOOL OF MASSAGE THERAPY      ,GA,31406-2711,Private      ,5,22,27,51,201,252
04126800,ACADEMY OF SOMATIC HEALING ARTS (ASHA)  ,GA,30071-1024,Proprietary  ,2,25,27,47,284,331
04128500,SOUTHERN CATHOLIC COLLEGE               ,GA,30534-3111,Private      ,0,0,0,79,19,98
04142900,GEORGIA GWINNETT COLLEGE                ,GA,30043-7409,Public       ,135,225,360,4672,3915,8587
04147000,PAUL MITCHELL THE SCHOOL ATLANTA        ,GA,30318-5241,Proprietary  ,26,51,77,237,472,709
04147700,LAKE LANIER SCHOOL OF MASSAGE           ,GA,30501-4546,Proprietary  ,9,29,38,50,236,286
04149900,PROFILE INSTITUTE OF BARBER-STYLING     ,GA,30315-8459,Proprietary  ,2,18,20,57,217,274
04150900,PROCESS INSTITUTE OF COSMETOLOGY (THE)  ,GA,30043-7344,Proprietary  ,5,9,14,83,158,241
04152300,GEORGIA BEAUTY ACADEMY                  ,GA,30721-3952,Proprietary  ,7,17,24,55,160,215
04160200,ATLANTA BEAUTY ACADEMY                  ,GA,30340-1334,Proprietary  ,2,40,42,52,291,343
00162800,AMERICAN ACADEMY OF ART                 ,IL,60604-4302,Proprietary  ,19,8,27,892,268,1160
00163300,AUGUSTANA COLLEGE                       ,IL,61201-2296,Private      ,30,7,37,4031,203,4234
00163400,AURORA UNIVERSITY                       ,IL,60506-4892,Private      ,24,117,141,3033,3047,6080
00163600,SOUTHWESTERN ILLINOIS COLLEGE           ,IL,62221-5899,Public       ,179,509,688,4411,8047,12458
00163800,BLACK HAWK COLLEGE                      ,IL,61265-5899,Public       ,69,185,254,2372,3703,6075
00163900,BLACKBURN COLLEGE                       ,IL,62626-1498,Private      ,4,3,7,829,156,985
00164000,PRAIRIE STATE COLLEGE                   ,IL,60411-8226,Public       ,121,340,461,2892,5605,8497
00164100,BRADLEY UNIVERSITY                      ,IL,61625-0002,Private      ,54,36,90,7185,1330,8515
00164300,SPOON RIVER COLLEGE                     ,IL,61520-8907,Public       ,20,43,63,806,1012,1818
00164700,CITY COLLEGES OF CHICAGO                ,IL,60606-6998,Public       ,38,142,180,896,1664,2560
00164800,TRUMAN COLLEGE                          ,IL,60640-5691,Public       ,154,451,605,4217,6906,11123
00164900,RICHARD J DALEY COLLEGE                 ,IL,60652-1299,Public       ,139,428,567,3418,5780,9198
00165000,CITY COLLEGES OF CHICAGO-MALCOLM X      ,IL,60612-3197,Public       ,165,569,734,3717,8520,12237
00165200,HAROLD WASHINGTON COLLEGE               ,IL,60601-2403,Public       ,244,553,797,7083,9090,16173
00165400,KENNEDY KING COLLEGE                    ,IL,60621-3798,Public       ,147,603,750,4120,10699,14819
00165500,WRIGHT COLLEGE                          ,IL,60634-1591,Public       ,157,352,509,5992,6970,12962
00165700,MIDWESTERN UNIVERSITY                   ,IL,60515-1200,Private      ,3,32,35,155,2972,3127
00165900,ROSALIND FRANKLIN UNIVERSITY OF MEDICINE,IL,60064-3095,Private      ,0,45,45,37,2433,2470
00166100,CHICAGO THEOLOGICAL SEMINARY            ,IL,60637-0000,Private      ,0,2,2,26,209,235
00166300,SPERTUS COLLEGE                         ,IL,60605-1995,Private      ,1,11,12,9,91,100
00166400,UNIVERSITY OF ST FRANCIS                ,IL,60435-6188,Private      ,9,97,106,1582,1999,3581
00166500,COLUMBIA COLLEGE                        ,IL,60605-1996,Private      ,213,181,394,14216,5833,20049
00166600,CONCORDIA UNIVERSITY                    ,IL,60305-1499,Private      ,23,290,313,2398,3971,6369
00166900,DANVILLE AREA COMMUNITY COLLEGE         ,IL,61832-5199,Public       ,43,139,182,1110,2272,3382
00167100,DEPAUL UNIVERSITY                       ,IL,60604-2287,Private      ,236,706,942,18632,18574,37206
00167400,EASTERN ILLINOIS UNIVERSITY             ,IL,61920-3099,Public       ,126,155,281,11682,4026,15708
00167500,ELGIN COMMUNITY COLLEGE                 ,IL,60123-7193,Public       ,121,293,414,3926,5347,9273
00167600,ELMHURST COLLEGE                        ,IL,60126-3296,Private      ,46,41,87,3843,1363,5206
00167800,EUREKA COLLEGE                          ,IL,61530-9976,Private      ,7,5,12,1106,264,1370
00168100,HIGHLAND COMMUNITY COLLEGE              ,IL,61032-9341,Public       ,30,98,128,1027,1607,2634
00168200,GARRETT-EVANGELICAL THEOLOGICAL SEM     ,IL,60201-0000,Private      ,0,3,3,3,228,231
00168400,GREENVILLE COLLEGE                      ,IL,62246-1199,Private      ,14,44,58,1624,884,2508
00168500,HEBREW THEOLOGICAL COLLEGE              ,IL,60077-3263,Private      ,12,5,17,452,31,483
00168800,ILLINOIS COLLEGE                        ,IL,62650-2299,Private      ,13,3,16,1429,158,1587
00168900,ILLINOIS COLLEGE OF OPTOMETRY           ,IL,60616-3878,Private      ,1,2,3,25,712,737
00169100,ILLINOIS INSTITUTE OF TECHNOLOGY        ,IL,60616-0000,Private      ,27,93,120,2627,2429,5056
00169101,ILLINOIS INSTITUTE OF TECHNOLOGY - IIT D,IL,60661-3691,Private      ,0,0,0,468,646,1114
00169103,CHICAGO KENT COLLEGE OF LAW             ,IL,60661-0000,Private      ,1,19,20,41,2281,2322
00169200,ILLINOIS STATE UNIVERSITY               ,IL,61790-1000,Public       ,185,106,291,21268,5300,26568
00169300,NORTHEASTERN ILLINOIS UNIV              ,IL,60625-4699,Public       ,113,290,403,7514,8595,16109
00169400,CHICAGO STATE UNIVERSITY                ,IL,60628-1598,Public       ,132,492,624,6442,12710,19152
00169600,ILLINOIS WESLEYAN UNIVERSITY            ,IL,61701-0000,Private      ,23,4,27,3282,199,3481
00169800,JOHN MARSHALL LAW SCHOOL                ,IL,60604-0000,Private      ,0,25,25,53,2855,2908
00169900,JOLIET JUNIOR COLLEGE                   ,IL,60431-8938,Public       ,193,415,608,7344,8119,15463
00170000,JUDSON UNIVERSITY                       ,IL,60123-1498,Private      ,13,88,101,1020,938,1958
00170100,KASKASKIA COLLEGE                       ,IL,62801-7878,Public       ,48,153,201,1648,2794,4442
00170300,KENDALL COLLEGE                         ,IL,60622-4278,Proprietary  ,42,162,204,1366,2816,4182
00170400,KNOX COLLEGE                            ,IL,61401-4999,Private      ,17,4,21,2258,120,2378
00170500,ILLINOIS VALLEY COMMUNITY COLLEGE       ,IL,61348-9692,Public       ,28,119,147,1609,2279,3888
00170600,LAKE FOREST COLLEGE                     ,IL,60045-2399,Private      ,18,10,28,1859,209,2068
00170700,LEWIS UNIVERSITY                        ,IL,60446-2200,Private      ,60,219,279,4661,3989,8650
00170800,LINCOLN CHRISTIAN UNIVERSITY            ,IL,62656-2167,Private      ,5,39,44,502,690,1192
00170900,LINCOLN COLLEGE                         ,IL,62656-1699,Private      ,23,41,64,1439,748,2187
00171000,LOYOLA UNIVERSITY CHICAGO               ,IL,60626-0000,Private      ,119,295,414,16131,12567,28698
00171002,LOYOLA STRITCH SCHOOL OF MEDICINE       ,IL,60153-0000,Private      ,0,0,0,32,460,492
00171200,LUTHERAN SCHOOL OF THEOL AT CHICAGO     ,IL,60615-0000,Private      ,0,5,5,5,149,154
00171600,MACCORMAC COLLEGE                       ,IL,60602-4405,Private      ,4,21,25,59,246,305
00171700,MACMURRAY COLLEGE                       ,IL,62650-2590,Private      ,9,5,14,618,305,923
00172100,MCCORMICK THEOLOGICAL SEMINARY          ,IL,60615-5108,Private      ,0,5,5,8,161,169
00172200,MCKENDREE UNIVERSITY                    ,IL,62254-1299,Private      ,24,90,114,1857,1719,3576
00172300,MEADVILLE LOMBARD THEOLOGICAL SCHOOL    ,IL,60637-1602,Private      ,0,2,2,1,93,94
00172400,MILLIKIN UNIVERSITY                     ,IL,62522-2084,Private      ,29,40,69,2935,970,3905
00172500,MONMOUTH COLLEGE                        ,IL,61462-1963,Private      ,18,2,20,2083,137,2220
00172700,MOODY BIBLE INSTITUTE                   ,IL,60610-3214,Private      ,37,65,102,1156,841,1997
00172800,MORTON COLLEGE                          ,IL,60804-4398,Public       ,109,165,274,2379,2527,4906
00173200,NATIONAL UNIV OF HEALTH SCIENCES        ,IL,60148-4583,Private      ,1,25,26,78,1087,1165
00173300,NATIONAL-LOUIS UNIVERSITY               ,IL,60603-3032,Private      ,10,466,476,378,7708,8086
00173400,NORTH CENTRAL COLLEGE                   ,IL,60540-4690,Private      ,37,40,77,3490,1037,4527
00173500,NORTH PARK UNIVERSITY                   ,IL,60625-4895,Private      ,46,97,143,2765,1966,4731
00173600,NORTHERN BAPTIST THEOL SEMINARY         ,IL,60148-0000,Private      ,0,4,4,3,63,66
00173700,NORTHERN ILLINOIS UNIVERSITY            ,IL,60115-2854,Public       ,278,298,576,23623,11423,35046
00173900,NORTHWESTERN UNIV                       ,IL,60208-0001,Private      ,131,351,482,18286,11757,30043
00174100,OLIVET NAZARENE UNIVERSITY              ,IL,60914-2271,Private      ,18,217,235,3380,2358,5738
00174200,IL EASTERN COMM COLGS-OLNEY CENTRAL     ,IL,62450-1099,Public       ,35,44,79,679,939,1618
00174500,QUINCY UNIVERSITY                       ,IL,62301-2699,Private      ,13,47,60,1591,1267,2858
00174600,ROBERT MORRIS UNIVERSITY ILLINOIS       ,IL,60605-1225,Private      ,100,326,426,5613,6774,12387
00174700,ROCK VALLEY COLLEGE                     ,IL,61114-5699,Public       ,100,368,468,3655,6930,10585
00174800,ROCKFORD COLLEGE                        ,IL,61108-2393,Private      ,20,62,82,1107,1567,2674
00174900,ROOSEVELT UNIVERSITY                    ,IL,60605-1394,Private      ,68,238,306,4993,8262,13255
00175000,DOMINICAN UNIVERSITY                    ,IL,60305-1066,Private      ,24,76,100,2871,2254,5125
00175200,SAUK VALLEY COMMUNITY COLLEGE           ,IL,61021-9112,Public       ,25,73,98,1186,1528,2714
00175300,SCHOOL OF ART INSTITUTE OF CHICAGO      ,IL,60603-3013,Private      ,68,65,133,3952,2814,6766
00175400,SEABURY-WESTERN THEO SEMINARY           ,IL,60201-0000,Private      ,0,0,0,2,1,3
00175600,SHIMER COLLEGE                          ,IL,60616-3893,Private      ,0,3,3,179,73,252
00175700,SOUTHEASTERN ILLINOIS COLLEGE           ,IL,62946-4925,Public       ,22,42,64,797,1059,1856
00175800,SOUTHERN ILL UNIV-CARBONDALE            ,IL,62901-0000,Public       ,213,375,588,16441,9562,26003
00175900,SOUTHERN ILL UNIV-EDWARDSVILLE          ,IL,62026-1060,Public       ,141,191,332,11804,6591,18395
00175924,SO IL UNIV-SCHL OF DENTAL MEDICINE      ,IL,62002-0000,Public       ,0,2,2,14,202,216
00176100,SPRINGFIELD COLLEGE IN ILLINOIS         ,IL,62702-2694,Private      ,2,14,16,383,542,925
00176500,UNIVERSITY OF ST MARY OF THE LAKE       ,IL,60060-0000,Private      ,0,1,1,2,17,19
00176700,BENEDICTINE UNIVERSITY                  ,IL,60532-0900,Private      ,28,357,385,2931,4773,7704
00176800,ST XAVIER UNIVERSITY                    ,IL,60655-3199,Private      ,56,143,199,4824,3959,8783
00176900,SOUTH SUBURBAN COLLEGE                  ,IL,60473-9978,Public       ,115,429,544,3246,8520,11766
00177100,TRINITY CHRISTIAN COLLEGE               ,IL,60463-0929,Private      ,23,45,68,1333,1044,2377
00177200,TRINITY INTERNATIONAL UNIVERSITY        ,IL,60015-1283,Private      ,16,66,82,927,1330,2257
00177300,TRITON COLLEGE                          ,IL,60171-1995,Public       ,224,433,657,4371,6266,10637
00177400,UNIVERSITY OF CHICAGO                   ,IL,60637-1476,Private      ,126,97,223,14567,3517,18084
00177401,UNIV OF CHICAGO PRITZKER SCH OF MED     ,IL,60637-0000,Private      ,0,2,2,60,646,706
00177403,"UNIV OF CHICAGO, BOOTH SCH OF BUS       ",IL,60637-0000,Private      ,1,71,72,56,1492,1548
00177405,UNIVERSITY OF CHICAGO GRADUATE          ,IL,60637-0000,Private      ,3,75,78,155,6013,6168
00177500,UNIV OF ILLINOIS @ URBANA-CHAMPAIGN     ,IL,61820-5796,Public       ,243,242,485,29020,10196,39216
00177600,UNIV OF ILLINOIS AT CHICAGO             ,IL,60607-0000,Public       ,251,455,706,22855,18509,41364
00177800,VANDERCOOK COLLEGE OF MUSIC             ,IL,60616-3731,Private      ,3,6,9,196,105,301
00177900,IL EASTERN COMM COLGS-WABASH VALLEY     ,IL,62863-2699,Public       ,16,41,57,491,633,1124
00178000,WESTERN ILLINOIS UNIVERSITY             ,IL,61455-1390,Public       ,155,145,300,11421,4423,15844
00178100,WHEATON COLLEGE                         ,IL,60187-5535,Private      ,10,17,27,2840,701,3541
00178300,WORSHAM COLLEGE OF MORTUARY SCIENCE     ,IL,60090-2646,Proprietary  ,5,9,14,77,167,244
00396100,HARPER COLLEGE                          ,IL,60067-7398,Public       ,217,522,739,5801,6384,12185
00418100,ADVOCATE TRINITY HOSPITAL SCHOOL OF RADI,IL,60617-3982,Private      ,4,7,11,66,256,322
00456000,GEM CITY COLLEGE                        ,IL,62301-4949,Proprietary  ,0,13,13,26,84,110
00456800,MIDSTATE COLLEGE                        ,IL,61614-3558,Proprietary  ,16,87,103,137,1171,1308
00621400,BLESSING RIEMAN COLLEGE OF NURSING      ,IL,62301-0000,Private      ,0,9,9,82,125,207
00621401,BLESSING HOSPITAL - SCHOOL OF MEDICAL LA,IL,62305-7005,Private      ,0,1,1,5,21,26
00621402,BLESSING HOSPITAL - SCHOOL OF RADIOLOGIC,IL,62305-7005,Private      ,0,1,1,16,24,40
00621403,BLESSING HOSPITAL - COLLEGE OF NURSING  ,IL,62305-7005,Private      ,0,0,0,22,27,49
00622500,TRINITY COLLEGE OF NURSING AND HEALTH SC,IL,61201-5317,Private      ,3,10,13,116,268,384
00622800,METHODIST MED CTR OF ILL SCH NRSNG      ,IL,61636-0000,Private      ,2,9,11,259,534,793
00624000,ST FRANCIS MED CLG OF NRSG              ,IL,61603-3783,Private      ,1,8,9,217,408,625
00665600,COLLEGE OF DUPAGE                       ,IL,60137-6599,Public       ,333,711,1044,9097,10143,19240
00675300,ILLINOIS CENTRAL COLLEGE                ,IL,61635-0001,Public       ,103,433,536,4495,7103,11598
00693100,WAUBONSEE COMMUNITY COLLEGE             ,IL,60554-0000,Public       ,119,335,454,2828,4150,6978
00711800,PARKLAND COLLEGE                        ,IL,61821-1899,Public       ,110,223,333,4636,4809,9445
00711900,REND LAKE COLLEGE                       ,IL,62846-9801,Public       ,26,111,137,1429,1896,3325
00717000,LINCOLN LAND COMMUNITY COLLEGE          ,IL,62794-9256,Public       ,58,161,219,2732,4762,7494
00726500,CARL SANDBURG COLLEGE                   ,IL,61401-9576,Public       ,35,108,143,1078,1958,3036
00754900,COYNE AMERICAN INSTITUTE                ,IL,60607-1300,Proprietary  ,40,178,218,459,1621,2080
00764400,LAKE LAND COLLEGE                       ,IL,61938-9366,Public       ,44,129,173,2434,3012,5446
00768400,KISHWAUKEE COLLEGE                      ,IL,60150-9699,Public       ,49,91,140,2240,2502,4742
00769000,KANKAKEE COMMUNITY COLLEGE              ,IL,60901-6505,Public       ,53,185,238,1645,3230,4875
00769100,MCHENRY COUNTY COLLEGE                  ,IL,60012-2761,Public       ,56,161,217,2797,2490,5287
00769200,MORAINE VALLEY COMMUNITY COLLEGE        ,IL,60465-0937,Public       ,221,437,658,6285,6227,12512
00769300,SHAWNEE COMMUNITY COLLEGE               ,IL,62992-9725,Public       ,52,132,184,908,1610,2518
00769400,COLLEGE OF LAKE COUNTY                  ,IL,60030-1198,Public       ,252,502,754,4499,6344,10843
00793700,MS ROBERTS ACADEMY OF BEAUTY CULT       ,IL,60181-2930,Proprietary  ,7,22,29,38,91,129
00807600,JOHN A LOGAN COLLEGE                    ,IL,62918-2500,Public       ,92,195,287,2337,3227,5564
00814604,EVEREST UNIVERSITY - EVEREST  COLLEGE   ,IL,60803-4517,Proprietary  ,25,111,136,228,1198,1426
00825900,EDUCATORS OF BEAUTY                     ,IL,61081-3611,Proprietary  ,5,22,27,66,183,249
00825901,EDUCATORS OF BEAUTY                     ,IL,61104-0000,Proprietary  ,1,4,5,26,123,149
00832800,ALVAREITA'S COLLEGE OF COSMETOLOGY      ,IL,62025-2041,Proprietary  ,1,19,20,43,149,192
00854500,ROCKFORD BUSINESS COLLEGE               ,IL,61103-0000,Proprietary  ,15,87,102,248,1285,1533
00869402,RASMUSSEN COLLEGE - ROCKFORD            ,IL,61108-2513,Proprietary  ,19,162,181,435,2218,2653
00869403,RASMUSSEN COLLEGE - AURORA              ,IL,60506-6219,Proprietary  ,14,69,83,240,856,1096
00869404,RASMUSSEN COLLEGE - ROMEOVILLE          ,IL,60446-0000,Proprietary  ,10,72,82,192,700,892
00869418,RASMUSSEN COLLEGE -  MOKENA             ,IL,60448-0000,Proprietary  ,6,40,46,29,142,171
00888000,MORRISON INSTITUTE OF TECHNOLOGY        ,IL,61270-2959,Private      ,0,0,0,123,40,163
00893800,GRAHAM HOSPITAL SCH OF NURSING          ,IL,61520-2497,Private      ,0,2,2,28,93,121
00893900,CANNELLA SCHOOL OF HAIR DESIGN          ,IL,60406-2130,Proprietary  ,2,24,26,43,178,221
00914500,GOVERNORS STATE UNIVERSITY              ,IL,60466-0975,Public       ,32,300,332,1081,7136,8217
00923200,CATHOLIC THEOLOGICAL UNION              ,IL,60615-0000,Private      ,0,2,2,5,82,87
00933300,UNIV OF ILLINOIS AT SPRINGFIELD         ,IL,62703-5407,Public       ,30,104,134,2375,3349,5724
00947500,EDUCATORS OF BEAUTY                     ,IL,61301-2404,Proprietary  ,10,9,19,37,79,116
00959500,CANNELLA SCHOOL OF HAIR DESIGN          ,IL,60617-4303,Proprietary  ,3,28,31,74,200,274
00976700,OLIVE-HARVEY COLLEGE                    ,IL,60628-1696,Public       ,97,324,421,2036,5592,7628
00978600,IL EASTERN COMM COLGS-LINCOLN TRAIL     ,IL,62454-5708,Public       ,8,34,42,428,481,909
00980000,RUSH UNIVERSITY                         ,IL,60612-3806,Private      ,4,67,71,278,2954,3232
00989600,OAKTON COMMUNITY COLLEGE                ,IL,60016-1268,Public       ,140,266,406,3651,3806,7457
00998700,SAINT ANTHONY COLLEGE OF NURSING        ,IL,61108-2468,Private      ,2,8,10,159,375,534
01002000,LEWIS AND CLARK COMMUNITY COLLEGE       ,IL,62035-2466,Public       ,83,205,288,2254,3316,5570
01031600,LINCOLN COLLEGE OF TECHNOLOGY           ,IL,60160-1605,Proprietary  ,82,139,221,1224,1444,2668
01050100,LAKEVIEW  COLLEGE OF NURSING            ,IL,61832-3781,Private      ,2,5,7,165,267,432
01069500,TRI-COUNTY BEAUTY ACADEMY               ,IL,62056-2036,Proprietary  ,2,7,9,12,53,65
01071000,CAPITAL AREA SCH OF PRAC NRSG           ,IL,62707-0000,Public       ,1,10,11,83,553,636
01072700,DEVRY UNIVERSITY                        ,IL,60618-5994,Proprietary  ,1310,8229,9539,24472,99564,124036
01083600,PIVOT POINT INTNL CSMTLGY RSRCH CTR     ,IL,60626-0000,Proprietary  ,32,59,91,444,634,1078
01087900,RICHLAND COMMUNITY COLLEGE              ,IL,62521-8513,Public       ,48,159,207,1043,2546,3589
01102401,EVEREST COLLEGE - CHICAGO               ,IL,60604-2052,Proprietary  ,41,217,258,678,2315,2993
01151002,EVEREST INSTITUTE - EVEREST COLLEGE     ,IL,60542-1610,Proprietary  ,24,122,146,209,814,1023
01181000,TAYLOR BUSINESS INSTITUTE               ,IL,60606-5111,Proprietary  ,6,15,21,53,278,331
01185800,EVEREST COLLEGE                         ,IL,60077-1074,Proprietary  ,56,224,280,435,1353,1788
01185802,EVEREST COLLEGE - BURR RIDGE            ,IL,60527-7826,Proprietary  ,22,83,105,157,627,784
01236200,NORTHWESTERN COLLEGE                    ,IL,60630-2298,Proprietary  ,75,339,414,1903,4381,6284
01238500,BLOOMINGTON-NORMAL SCH RADIOGRAPHY      ,IL,61761-4604,Private      ,0,2,2,22,38,60
01258400,ILLINOIS INSTITUTE OF ART (THE)         ,IL,60654-1593,Proprietary  ,243,415,658,5937,4991,10928
01281300,JOHN WOOD COMMUNITY COLLEGE             ,IL,62305-0401,Public       ,40,127,167,1296,1782,3078
01308700,CAPRI GARFIELD RIDGE SCH OF BTY CLR     ,IL,60629-1613,Proprietary  ,6,21,27,79,238,317
01308800,CAPRI OAK FOREST COLLEGE OF BEAUTY      ,IL,60452-2798,Proprietary  ,15,20,35,139,219,358
02055200,HARRINGTON COLLEGE OF DESIGN            ,IL,60606-3433,Proprietary  ,15,66,81,672,1005,1677
02068100,ADLER SCH OF PROFESSIONAL PSYCHLGY      ,IL,60601-0000,Private      ,9,19,28,66,1291,1357
02069300,VATTEROTT COLLEGE                       ,IL,62305-5938,Proprietary  ,11,40,51,176,703,879
02073200,TELSHE YESHIVA-CHICAGO                  ,IL,60625-0000,Private      ,1,1,2,33,10,43
02074400,IL EASTERN COMM COLGS-FRONTIER          ,IL,62837-0000,Public       ,14,28,42,209,496,705
02075400,KELLER GRADUATE SCHOOL OF MGMT.         ,IL,60515-5683,Proprietary  ,2,1487,1489,61,21468,21529
02113600,AMERICAN INTERCONTINENTAL UNIVERSITY    ,IL,60192-3713,Proprietary  ,343,4313,4656,2829,45063,47892
02117400,BECK AREA CAREER CENTER                 ,IL,62278-0000,Public       ,1,12,13,32,194,226
02124400,UNIVERSITY OF SPA & COSMETOLOGY ART     ,IL,62704-0000,Proprietary  ,12,25,37,118,205,323
02150600,COSMETOLOGY AND SPA INSTITUTE (THE)     ,IL,60014-4003,Proprietary  ,18,30,48,115,217,332
02155300,THE CHICAGO SCHOOL OF PROF PSYCHOLOGY   ,IL,60610-4705,Private      ,6,165,171,64,4844,4908
02160300,INTERNATIONAL ACAD OF DESIGN & TECH     ,IL,60602-3319,Proprietary  ,30,73,103,1082,1533,2615
02160304,INTERNATIONAL ACADEMY OF DESIGN AND TECH,IL,60173-5160,Proprietary  ,3,4,7,225,317,542
02168600,EAST WEST UNIVERSITY                    ,IL,60605-0000,Private      ,38,69,107,1210,1787,2997
02179900,ARGOSY UNIVERSITY                       ,IL,60601-7757,Proprietary  ,874,5653,6527,9787,55061,64848
02185400,ST AUGUSTINE COLLEGE                    ,IL,60640-0000,Private      ,40,202,242,566,2268,2834
02192400,MR JOHNS SCHOOL OF COSMETOLOGY          ,IL,62521-0000,Proprietary  ,6,21,27,32,117,149
02202600,CANNELLA SCHOOL OF HAIR DESIGN          ,IL,60181-1321,Proprietary  ,2,27,29,22,130,152
02214100,RESURRECTION UNIVERSITY                 ,IL,60302-2519,Private      ,3,11,14,124,476,600
02228100,MAC DANIEL'S BEAUTY SCHOOL              ,IL,60640-0000,Proprietary  ,2,10,12,40,108,148
02261200,HAIR PROFESSIONALS ACAD COSMETOLOGY     ,IL,60118-0000,Proprietary  ,9,32,41,84,275,359
02261201,HAIR PROFESSIONALS ACADEMY OF COSMETOLOG,IL,60118-9333,Proprietary  ,0,1,1,3,14,17
02262100,HAIR PROFESSIONALS SCH COSMETOLOGY      ,IL,60543-0000,Proprietary  ,10,17,27,50,110,160
02291200,CANNELLA SCHOOL OF HAIR DESIGN          ,IL,60639-0000,Proprietary  ,3,28,31,71,238,309
02295500,CANNELLA SCHOOL OF HAIR DESIGN          ,IL,60120-0000,Proprietary  ,4,15,19,28,108,136
02297500,OEHRLEIN SCHOOL OF COSMETOLOGY          ,IL,61611-0000,Proprietary  ,3,13,16,45,119,164
02312300,LA' JAMES COLLEGE HAIRSTYLING           ,IL,61244-0000,Proprietary  ,1,7,8,29,60,89
02313900,WESTWOOD COLLEGE - O'HARE AIRPORT       ,IL,60631-2801,Proprietary  ,30,87,117,640,1222,1862
02317300,CONCEPT COLLEGE OF COSMETOLOGY          ,IL,61832-0000,Proprietary  ,8,11,19,66,117,183
02319200,LAKE FOREST GRAD SCHL OF MGMT           ,IL,60045-4824,Private      ,0,33,33,9,369,378
02323300,PROFESSIONAL'S CHOICE HAIR DSN ACAD     ,IL,60435-0000,Proprietary  ,3,12,15,31,94,125
02332200,HAIR PROFESSIONALS CAREER COLLEGE       ,IL,60178-0000,Proprietary  ,9,12,21,24,88,112
02337800,THE COLLEGE OF OFFICE TECHNOLOGY        ,IL,60622-0000,Proprietary  ,30,91,121,232,691,923
02349400,ALVAREITA'S COLLEGE OF COSMETOLOGY      ,IL,62035-0000,Proprietary  ,5,7,12,32,81,113
02349500,CANNELLA SCHOOL OF HAIR DESIGN          ,IL,60632-0000,Proprietary  ,5,28,33,68,182,250
02352200,LE CORDON BLEU COLLEGE OF CULINARY ARTS ,IL,60610-3050,Proprietary  ,59,168,227,940,1906,2846
02498200,G SKIN & BEAUTY INSTITUTE               ,IL,60523-1805,Proprietary  ,6,49,55,74,272,346
02498201,HAIR PROFESSIONALS ACADEMY OF COSMETOLOG,IL,60563-0000,Proprietary  ,3,7,10,24,60,84
02522800,FOX COLLEGE                             ,IL,60453-0000,Proprietary  ,32,30,62,572,489,1061
02527600,LEXINGTON COLLEGE                       ,IL,60607-0000,Private      ,0,7,7,89,87,176
02536700,BELL MAR BEAUTY COLLEGE                 ,IL,60650-0000,Proprietary  ,2,4,6,20,71,91
02556100,ENVIRONMENTAL TECHNICAL INSTITUTE       ,IL,60143-0000,Proprietary  ,18,73,91,103,424,527
02556600,NILES SCHOOL OF COSMETOLOGY             ,IL,60714-0000,Proprietary  ,1,7,8,32,94,126
02570305,LOS ANGELES ORT TECHNICAL INSTITUTE -D/B,IL,60077-0000,Private      ,0,0,0,0,3,3
02573700,INSTITUTE FOR CLINICAL SOCIAL WORK      ,IL,60605-1229,Private      ,0,7,7,9,182,191
02579200,INGALLS MEMORIAL HOSPITAL               ,IL,60426-0000,Private      ,1,3,4,8,68,76
02584900,"FIRST INSTITUTE, INC.                   ",IL,60014-7489,Proprietary  ,20,55,75,89,406,495
02587700,HAIR PROFESSIONALS CAREER COLLEGE       ,IL,60465-1929,Proprietary  ,5,20,25,57,136,193
02599500,HANOVER PARK COLLEGE OF BEAUTY CULT     ,IL,60133-5421,Proprietary  ,2,12,14,69,124,193
02622700,KNOWLEDGE SYSTEMS INSTITUTE             ,IL,60076-0000,Private      ,1,1,2,2,9,11
03002000,HAIRMASTERS INST OF COSMETOLOGY         ,IL,61701-5547,Proprietary  ,1,12,13,33,93,126
03027702,PACIFIC COLLEGE OF ORIENTAL MEDICINE - C,IL,60613-4418,Proprietary  ,2,26,28,26,349,375
03065300,TREND SETTERS COLL OF COSMETOLOGY       ,IL,60915-2101,Proprietary  ,33,48,81,194,256,450
03072701,WESTWOOD COLLEGE OF TECHNOLOGY          ,IL,60409-0000,Proprietary  ,14,85,99,350,1199,1549
03072702,WESTWOOD COLLEGE OF TECHNOLOGY          ,IL,60602-0000,Proprietary  ,37,118,155,715,1787,2502
03078400,CAMEO BEAUTY ACADEMY                    ,IL,60453-3196,Proprietary  ,6,14,20,65,131,196
03079200,WESTWOOD COLLEGE - DUPAGE               ,IL,60517-2321,Proprietary  ,16,54,70,517,745,1262
03082900,ROSEL SCHOOL OF COSMETOLOGY             ,IL,60659-1913,Proprietary  ,3,19,22,51,133,184
03083800,HEARTLAND COMMUNITY COLLEGE             ,IL,61761-9446,Public       ,56,144,200,2272,2830,5102
03098000,ST JOHN'S COLLEGE OF NURSING            ,IL,62702-5321,Private      ,1,2,3,126,143,269
03098002,ST JOHN'S HOSP SCH MED TECH             ,IL,62769-5324,Private      ,0,0,0,19,44,63
03099700,CAIN'S BARBER COLLEGE                   ,IL,60615-3510,Proprietary  ,9,51,60,133,435,568
03099800,ILLINOIS SCHOOL OF HEALTH CAREERS       ,IL,60604-0000,Proprietary  ,32,144,176,402,1145,1547
03101800,ILLINOIS CENTER FOR BROADCASTING        ,IL,60148-7015,Proprietary  ,18,88,106,152,509,661
03128300,PYRAMID CAREER INSTITUTE                ,IL,60657-4207,Proprietary  ,0,0,0,4,16,20
03128500,NATIONAL LATINO EDUCATION INSTITUTE     ,IL,60609-2205,Private      ,8,29,37,52,142,194
03199300,CHRISTIAN LIFE COLLEGE                  ,IL,60056-2522,Private      ,1,3,4,27,25,52
03368300,MIDWEST TECHNICAL INSTITUTE             ,IL,62707-8805,Proprietary  ,66,351,417,548,2278,2826
03416300,COMPUTER SYSTEMS INSTITUTE              ,IL,60077-0000,Proprietary  ,57,298,355,322,1450,1772
03448300,BUSINESS INDUSTRIAL RESOURCES           ,IL,60659-1298,Proprietary  ,25,250,275,105,1191,1296
03455700,CORTIVA INSTITUTE - CHICAGO             ,IL,60602-3315,Proprietary  ,15,76,91,224,695,919
03455701,CORTIVA INSTITUTE - CHICAGO             ,IL,60014-6285,Proprietary  ,0,1,1,16,46,62
03510300,ERIKSON INSTITUTE                       ,IL,60654-4510,Private      ,1,7,8,7,350,357
03623300,VEE'S SCHOOL OF BEAUTY CULTURE          ,IL,62205-2326,Proprietary  ,0,5,5,6,30,36
03643300,"MR. JOHN'S SCHOOL OF JACKSONVILLE,  INC,",IL,62650-3488,Proprietary  ,6,7,13,20,52,72
03684300,NORTHSHORE UNIVERSITY HEALTHSYSTEM SCHOO,IL,60201-9872,Private      ,0,4,4,25,76,101
03721400,AMERICAN CAREER COLLEGE                 ,IL,60402-0000,Proprietary  ,4,21,25,43,181,224
03881400,EUROPEAN MASSAGE THERAPY SCHOOL         ,IL,60077-2269,Proprietary  ,7,33,40,28,177,205
03891300,SOMA INSTITUTE - THE NATIONAL SCHOOL OF ,IL,60604-4466,Proprietary  ,9,49,58,87,327,414
03914300,"CALC, INSTITUTE OF TECHNOLOGY           ",IL,62002-5931,Proprietary  ,3,35,38,35,261,296
04117500,SOLEX MEDICAL ACADEMY                   ,IL,60090-3104,Proprietary  ,0,8,8,8,81,89
04118400,ZAREM /GOLDE ORT TECHNICAL INSTITUTE    ,IL,60077-3210,Private      ,16,96,112,76,535,611
04124700,AMERICARE INSTITUTE                     ,IL,60133-5456,Proprietary  ,7,59,66,121,656,777
04136900,UNIVERSITY OF AESTHETICS (THE)          ,IL,60622-2151,Proprietary  ,2,13,15,15,57,72
04137000,UNIVERSITY OF AESTHETICS (THE)          ,IL,60515-5602,Proprietary  ,1,5,6,6,28,34
04137500,TRICOCI UNIVERSITY OF BEAUTY CULTURE    ,IL,60656-1805,Proprietary  ,8,31,39,183,326,509
04139000,CITI COLLEGE OF ALLIED HEALTH           ,IL,60602-1032,Proprietary  ,6,25,31,83,517,600
04141000,AVEDA INSTITUTE CHICAGO                 ,IL,60647-0000,Proprietary  ,15,26,41,156,298,454
04147100,TRICOCI UNIVERSITY OF BEAUTY CULTURE    ,IL,60048-2906,Proprietary  ,16,18,34,82,175,257
04147200,TRICOCI UNIVERSITY OF BEAUTY CULTURE    ,IL,60455-1824,Proprietary  ,6,24,30,76,223,299
04147300,TRICOCI UNIVERSITY OF BEAUTY CULTURE    ,IL,60139-3119,Proprietary  ,6,16,22,63,88,151
04147400,TRICOCI UNIVERSITY OF BEAUTY CULTURE    ,IL,61614-4831,Proprietary  ,6,12,18,46,112,158
04147500,TRICOCI UNIVERSITY OF BEAUTY CULTURE    ,IL,61108-2337,Proprietary  ,8,27,35,84,262,346
04160600,PAUL MITCHELL THE SCHOOL NORMAL         ,IL,61761-0000,Proprietary  ,16,32,48,116,176,292
04167800,INNOVATIONS DESIGN ACADEMY              ,IL,61520-2625,Proprietary  ,3,7,10,13,54,67
04168500,SOLEX COLLEGE                           ,IL,60090-3192,Proprietary  ,2,10,12,5,66,71
04170800,UNITY COSMETOLOGY COLLEGE               ,IL,61764-9652,Proprietary  ,4,6,10,14,48,62
04171600,SALON PROFESSIONAL ACADEMY OF ELGIN (THE,IL,60123-2319,Proprietary  ,4,7,11,12,24,36
04174900,SKIN CARE AND SPA INSTITUTE             ,IL,60077-2200,Proprietary  ,4,36,40,12,91,103
04175000,UNIVERSAL SPA TRAINING ACADEMY          ,IL,60515-0000,Proprietary  ,7,22,29,12,68,80
00195100,ALICE LLOYD COLLEGE                     ,KY,41844-9703,Private      ,4,6,10,911,178,1089
00195200,ASBURY COLLEGE                          ,KY,40390-1198,Private      ,12,22,34,1652,586,2238
00195300,ASBURY THEOLOGICAL SEMINARY             ,KY,40390-0000,Private      ,0,43,43,21,1458,1479
00195400,BELLARMINE UNIVERSITY                   ,KY,40205-1877,Private      ,40,98,138,3902,1853,5755
00195500,BEREA COLLEGE                           ,KY,40403-0000,Private      ,25,13,38,2840,764,3604
00195800,BRESCIA UNIVERSITY                      ,KY,42301-3023,Private      ,10,25,35,842,641,1483
00195900,CAMPBELLSVILLE UNIVERSITY               ,KY,42718-2799,Private      ,30,87,117,2523,1837,4360
00196000,SPALDING UNIVERSITY                     ,KY,40203-2188,Private      ,15,162,177,879,2972,3851
00196100,CENTRE COLLEGE                          ,KY,40422-1394,Private      ,19,5,24,2271,141,2412
00196200,UNIVERSITY OF THE CUMBERLANDS           ,KY,40769-1372,Private      ,29,131,160,2590,2034,4624
00196300,EASTERN KENTUCKY UNIVERSITY             ,KY,40475-3102,Public       ,205,418,623,12817,9888,22705
00196400,GEORGETOWN COLLEGE                      ,KY,40324-1628,Private      ,32,58,90,2281,937,3218
00196500,KENTUCKY CHRISTIAN UNIVERSITY           ,KY,41143-2205,Private      ,7,6,13,751,192,943
00196800,KENTUCKY STATE UNIVERSITY               ,KY,40601-2355,Public       ,57,85,142,3870,2166,6036
00196900,KENTUCKY WESLEYAN COLLEGE               ,KY,42301-6057,Private      ,13,13,26,1195,370,1565
00197100,LEXINGTON THEOLOGICAL SEMINARY          ,KY,40508-0000,Private      ,0,5,5,2,88,90
00197200,LINDSEY WILSON COLLEGE                  ,KY,42728-1223,Private      ,35,64,99,2759,1888,4647
00197400,LOUISVILLE PRESBYTERIAN THEOL SEM       ,KY,40205-0000,Private      ,1,11,12,5,176,181
00197500,MIDWAY COLLEGE                          ,KY,40347-1120,Private      ,11,142,153,691,2196,2887
00197600,MOREHEAD STATE UNIVERSITY               ,KY,40351-1689,Public       ,119,235,354,6389,5705,12094
00197700,MURRAY STATE UNIVERSITY                 ,KY,42071-0009,Public       ,96,179,275,6628,4426,11054
00197900,WEST KENTUCKY CMNTY & TECHNICAL COLG    ,KY,42002-7380,Public       ,45,193,238,1961,4307,6268
00198000,PIKEVILLE COLLEGE                       ,KY,41501-1194,Private      ,21,17,38,1675,500,2175
00198001,PIKEVILLE CLG-SCH OSTEOPATHIC MEDIC     ,KY,41501-0000,Private      ,1,1,2,23,348,371
00198200,SOUTHERN BAPTIST THEOL SEMINARY         ,KY,40280-0000,Private      ,0,0,0,59,214,273
00198300,ST. CATHARINE COLLEGE                   ,KY,40061-9499,Private      ,6,18,24,763,543,1306
00198700,TRANSYLVANIA UNIVERSITY                 ,KY,40508-1797,Private      ,17,19,36,1788,239,2027
00198800,UNION COLLEGE                           ,KY,40906-1499,Private      ,20,88,108,1308,1144,2452
00198900,UNIVERSITY OF KENTUCKY                  ,KY,40506-0054,Public       ,291,293,584,19498,10295,29793
00198901,UNIV OF KY-COLLEGE OF DENTISTRY         ,KY,40536-0000,Public       ,0,2,2,23,245,268
00198902,UNIV OF KY-COLLEGE OF MEDICINE          ,KY,40536-0000,Public       ,3,7,10,83,569,652
00199000,ASHLAND COMMUNITY AND TECHNICAL COLLEGE ,KY,41101-3683,Public       ,42,138,180,1692,3264,4956
00199100,ELIZABETHTOWN COMMUNITY  AND TECHNICAL C,KY,42701-3081,Public       ,100,444,544,2617,6374,8991
00199300,HENDERSON COMMUNITY COLLEGE             ,KY,42420-4699,Public       ,10,74,84,612,1752,2364
00199400,HOPKINSVILLE COMMUNITY COLLEGE          ,KY,42241-2621,Public       ,47,276,323,1218,4469,5687
00199600,BIG SANDY COMMUNITY AND TECHNICAL COLG  ,KY,41653-1815,Public       ,59,182,241,2055,3112,5167
00199700,SOMERSET COMMUNITY COLLEGE              ,KY,42501-2973,Public       ,86,447,533,3306,8093,11399
00199800,SOUTHEAST KENTUCKY COMMUNITY AND TECHNIC,KY,40823-1099,Public       ,71,150,221,1288,2082,3370
00199802,CUMBERLAND VLY TEC CLG MIDDLESBORO      ,KY,40965-2265,Public       ,0,0,0,55,53,108
00199804,SOUTHEAST COMMUNITY COLLEGE             ,KY,40831-1796,Public       ,0,0,0,159,209,368
00199900,UNIVERSITY OF LOUISVILLE                ,KY,40292-0000,Public       ,207,406,613,14047,13604,27651
00200100,THOMAS MORE COLLEGE                     ,KY,41017-3495,Private      ,14,123,137,1526,1057,2583
00200200,WESTERN KENTUCKY UNIVERSITY             ,KY,42101-3576,Public       ,271,410,681,15116,10707,25823
00461800,SPENCERIAN COLLEGE                      ,KY,40216-2605,Proprietary  ,66,248,314,853,2892,3745
00461900,SULLIVAN UNIVERSITY                     ,KY,40205-3000,Proprietary  ,179,643,822,2721,7413,10134
00493402,DAYMAR COLLEGE - BOWLING GREEN          ,KY,42101-4063,Proprietary  ,0,0,0,10,49,59
00493406,DAYMAR COLLEGE - RUSSELLVILLE           ,KY,42276-1622,Proprietary  ,0,0,0,1,0,1
00524400,BLUEGRASS COMMUNITY & TECHNICAL COLLEGE ,KY,40506-0235,Public       ,187,680,867,5508,12098,17606
00527100,BOWLING GREEN TECHNICAL COLLEGE         ,KY,42101-3601,Public       ,28,198,226,1336,3775,5111
00527300,GATEWAY COMMUNITY & TECHNOLOGY COLL     ,KY,41011-0000,Public       ,76,347,423,1528,4666,6194
00696000,MAYSVILLE CMNTY & TECHNCL COLG          ,KY,41056-8910,Public       ,43,220,263,1121,3423,4544
00696100,JEFFERSON COMMUNITY AND TECHNICAL COLLEG,KY,40202-2005,Public       ,204,612,816,6871,14520,21391
00696200,HAZARD COMMUNITY COLLEGE                ,KY,41701-2402,Public       ,41,150,191,1557,2718,4275
00696203,KY TECH-KNOTT CO. TECHNOLOGY CTR        ,KY,41822-0000,Public       ,0,0,0,8,16,24
00696204,KY TECH-LESLIE COUNTY AREA TECH CTR     ,KY,41749-0000,Public       ,0,0,0,3,10,13
00696205,KY TECH-LEE COUNTY AREA TECH CTR        ,KY,41311-0000,Public       ,0,0,0,2,7,9
00696206,KY TECH-LETCHER CNTY AREA TECH CTR      ,KY,41858-0000,Public       ,0,3,3,17,36,53
00696207,KY TECH-BREATHITT COUNTY VOC ED CTR     ,KY,41339-0000,Public       ,0,1,1,7,31,38
00736205,MEDTECH COLLEGE - LEXINGTON             ,KY,40511-1200,Proprietary  ,10,83,93,72,586,658
00842500,DAYMAR COLLEGE                          ,KY,42001-0000,Proprietary  ,4,64,68,102,747,849
00901000,MADISONVILLE COMMUNITY COLLEGE          ,KY,42431-9199,Public       ,44,103,147,1336,3126,4462
00927500,NORTHERN KENTUCKY UNIVERSITY            ,KY,41099-0001,Public       ,133,281,414,9965,8543,18508
00931300,DAYMAR COLLEGE                          ,KY,42301-5830,Proprietary  ,62,425,487,410,3471,3881
00931302,DAYMAR COLLEGE - LOUISVILLE CAMPUS      ,KY,40219-1973,Proprietary  ,0,0,0,94,585,679
00931304,DAYMAR COLLEGE - ALBANY                 ,KY,42602-1235,Proprietary  ,0,0,0,0,3,3
00931305,DAYMAR COLLEGE - BELLEVUE               ,KY,41073-2416,Proprietary  ,0,0,0,0,1,1
00931307,DAYMAR COLLEGE - PADUCAH                ,KY,42001-4181,Proprietary  ,0,0,0,0,1,1
00931308,DAYMAR COLLEGE -  SCOTTSVILLE           ,KY,42164-1505,Proprietary  ,0,0,0,0,1,1
00931309,DAYMAR COLLEGE - LOUISVILLE EAST        ,KY,40245-1629,Proprietary  ,0,0,0,0,2,2
01042400,SALON PROFESSIONAL ACADEMY THE          ,KY,40502-1776,Proprietary  ,9,37,46,80,230,310
01048901,NATIONAL COLLEGE - FLORENCE CAMPUS      ,KY,41042-1812,Proprietary  ,3,21,24,5,44,49
01048902,NATIONAL COLLEGE - PIKEVILLE CAMPUS     ,KY,41501-1518,Proprietary  ,5,21,26,7,48,55
01048903,NATIONAL COLLEGE - DANVILLE CAMPUS      ,KY,40422-1517,Proprietary  ,3,30,33,5,60,65
01048904,NATIONAL COLLEGE - RICHMOND CAMPUS      ,KY,40475-2309,Proprietary  ,2,27,29,6,68,74
01048906,NATIONAL COLLEGE - LOUISVILLE CAMPUS    ,KY,40216-4147,Proprietary  ,8,69,77,19,145,164
01048907,NATIONAL COLLEGE - LEXINGTON CAMPUS     ,KY,40509-2256,Proprietary  ,3,67,70,8,139,147
01172500,COLLINS SCHOOL OF COSMETOLOGY           ,KY,40965-2809,Proprietary  ,1,12,13,29,105,134
01208800,SULLIVAN COLLEGE OF TECHNOLOGY AND DESIG,KY,40218-4528,Proprietary  ,43,111,154,582,1201,1783
01212801,SOUTHWESTERN COLLEGE                    ,KY,41042-1466,Proprietary  ,7,77,84,174,1061,1235
01272300,KY TECH-WAYNE COUNTY AREA TECH CTR      ,KY,42633-1088,Public       ,0,1,1,4,12,16
01291400,EMPIRE BEAUTY SCHOOL                    ,KY,40218-0000,Proprietary  ,15,42,57,150,483,633
01291500,EMPIRE BEAUTY SCHOOL                    ,KY,41042-5113,Proprietary  ,7,24,31,115,218,333
01291600,EMPIRE BEAUTY SCHOOL                    ,KY,40216-4212,Proprietary  ,5,21,26,43,244,287
01291700,EMPIRE BEAUTY SCHOOL                    ,KY,40160-0000,Proprietary  ,13,39,52,110,294,404
01296800,EMPIRE BEAUTY SCHOOL                    ,KY,40207-2695,Proprietary  ,6,14,20,59,195,254
02159100,"APPALACHIAN BEAUTY SCHOOL, INC.         ",KY,41503-0000,Proprietary  ,1,6,7,28,48,76
02177100,EMPIRE BEAUTY SCHOOL                    ,KY,40204-0000,Proprietary  ,4,24,28,84,267,351
02251500,TREND SETTERS ACAD OF BEAUTY CULT       ,KY,40258-0000,Proprietary  ,19,47,66,70,294,364
02275000,JENNY LEA ACADEMY OF COSMETOLOGY        ,KY,40831-0000,Proprietary  ,7,57,64,76,345,421
02284306,INTERACTIVE LEARNING SYSTEMS            ,KY,41042-0000,Proprietary  ,0,17,17,9,112,121
02323700,PAT WILSON'S BEAUTY COLLEGE             ,KY,42420-0000,Proprietary  ,0,5,5,9,81,90
02337200,PJ'S COLLEGE OF COSMETOLOGY             ,KY,42101-0000,Proprietary  ,9,95,104,147,753,900
02340800,PAUL MITCHELL THE SCHOOL LEXINGTON      ,KY,40514-1545,Proprietary  ,14,31,45,134,220,354
02351700,PAUL MITCHELL THE SCHOOL - LOUISVILLE   ,KY,40222-0000,Proprietary  ,14,25,39,159,257,416
02491100,BECKFIELD COLLEGE                       ,KY,41042-0000,Proprietary  ,32,244,276,370,2314,2684
02518900,BARRETT & COMPANY SCH HAIR DESIGN       ,KY,40356-0000,Proprietary  ,4,25,29,46,156,202
02526100,JENNY LEA ACADEMY OF COSMETOLOGY        ,KY,41858-0000,Proprietary  ,2,0,2,16,36,52
02535600,CLEAR CREEK BAPTIST BIBLE COLLEGE       ,KY,40977-0000,Private      ,0,4,4,32,187,219
02551100,PJ'S COLLEGE OF COSMETOLOGY             ,KY,42141-2434,Proprietary  ,7,19,26,44,154,198
02560800,SOUTHEAST SCHOOL OF COSMETOLOGY         ,KY,40962-0000,Proprietary  ,0,9,9,19,65,84
02576200,MID-CONTINENT UNIVERSITY                ,KY,42066-9007,Private      ,3,238,241,402,3412,3814
03002100,KENTUCKY MOUNTAIN BIBLE COLLEGE         ,KY,41385-0010,Private      ,0,0,0,51,39,90
03007000,FRONTIER SCH OF MIDWIFERY&FAMILY NU     ,KY,41749-0000,Private      ,0,145,145,3,1455,1458
03026200,HEAD'S WEST KENTUCKY BEAUTY COLLEGE     ,KY,42431-0000,Proprietary  ,0,7,7,11,61,72
03029200,NU-TEK ACADEMY OF BEAUTY                ,KY,40353-9767,Proprietary  ,1,14,15,13,62,75
03034500,OWENSBORO COMMUNITY & TECHNICAL COLLEGE ,KY,42303-1899,Public       ,52,146,198,1701,3778,5479
03083700,GALEN HEALTH INSTITUTES                 ,KY,40207-1047,Proprietary  ,51,334,385,766,4470,5236
03103500,MR JIM'S BEAUTY COLLEGE                 ,KY,42301-2646,Proprietary  ,1,5,6,19,64,83
03516500,EZELL'S COSMETOLOGY SCHOOL              ,KY,42071-2530,Proprietary  ,1,2,3,29,90,119
03611300,BRIGHTON CENTER'S CENTER FOR EMPLOY     ,KY,41071-1968,Private      ,0,41,41,6,154,160
03804300,BELLEFONTE ACADEMY OF BEAUTY            ,KY,41169-2015,Proprietary  ,2,38,40,36,169,205
03885300,EMPLOYMENT SOLUTIONS                    ,KY,40517-3260,Private      ,8,61,69,38,317,355
03886300,REGENCY SCHOOL OF HAIR DESIGN           ,KY,41653-1278,Proprietary  ,1,5,6,15,59,74
04038300,ATA CAREER EDUCATION                    ,KY,40223-3832,Proprietary  ,8,139,147,252,1560,1812
04051316,ART INSTITUTE OF PHOENIX (THE) - ATS - (,KY,41017-2136,Proprietary  ,0,13,13,52,237,289
04051319,ART INSTITUTE OF PHOENIX (THE) - BROWN M,KY,40219-1916,Proprietary  ,5,38,43,260,912,1172
04051320,ART INSTITUTE OF PHOENIX (THE) - BROWN M,KY,42240-3579,Proprietary  ,10,55,65,107,706,813
04123900,LEXINGTON HEALING ARTS ACADEMY          ,KY,40503-1932,Proprietary  ,4,31,35,37,179,216
04177600,LINDSEY INSTITUTE OF COSMETOLOGY        ,KY,42103-8036,Proprietary  ,3,11,14,14,32,46
04178000,SIMMONS COLLEGE OF KENTUCKY             ,KY,40203-3322,Private      ,0,22,22,0,22,22
00200300,CENTENARY COLLEGE OF LOUISIANA          ,LA,71104-3396,Private      ,12,17,29,1183,356,1539
00200400,DILLARD UNIVERSITY                      ,LA,70122-3097,Private      ,50,29,79,2530,1086,3616
00200500,NICHOLLS STATE UNIVERSITY               ,LA,70310-0001,Public       ,74,101,175,5742,3061,8803
00200600,GRAMBLING STATE UNIVERSITY              ,LA,71245-2215,Public       ,122,163,285,6499,3420,9919
00200700,LOUISIANA COLLEGE                       ,LA,71359-0000,Private      ,16,58,74,1193,882,2075
00200800,LOUISIANA TECH UNIVERSITY               ,LA,71272-0001,Public       ,94,171,265,6873,3338,10211
00201000,LOUISIANA STATE UNIV & A&M COLG         ,LA,70803-5710,Public       ,269,245,514,22642,8394,31036
00201100,LOUISIANA STATE UNIV-ALEXANDRIA         ,LA,71302-9121,Public       ,25,94,119,1630,2396,4026
00201200,LOUISIANA STATE UNIV-EUNICE             ,LA,70535-6726,Public       ,67,77,144,2253,2123,4376
00201300,LOUISIANA STATE UNIV-SHREVEPORT         ,LA,71115-2399,Public       ,37,140,177,2695,3566,6261
00201400,LA STATE UNIV HEALTH SCIENCES CTR       ,LA,70112-2223,Public       ,13,62,75,520,2284,2804
00201409,LOUISIANA STATE UNIVERSITY HEALTH SCIENC,LA,70119-2799,Public       ,0,0,0,75,133,208
00201500,(THE) UNIVERSITY OF NEW ORLEANS         ,LA,70148-0001,Public       ,138,286,424,6833,7882,14715
00201600,LOYOLA UNIVERSITY NEW ORLEANS           ,LA,70118-6195,Private      ,61,85,146,3915,3126,7041
00201700,MCNEESE STATE UNIVERSITY                ,LA,70609-4510,Public       ,104,144,248,5529,4371,9900
00201900,NEW ORLEANS BAPTIST THEOL SEMINARY      ,LA,70126-0000,Private      ,0,8,8,45,194,239
00202000,UNIVERSITY OF LOUISIANA AT MONROE       ,LA,71209-9001,Public       ,75,196,271,6190,5041,11231
00202100,NORTHWESTERN STATE UNIVERSITY           ,LA,71497-0001,Public       ,101,283,384,6264,6048,12312
00202200,NOTRE DAME SEMINARY                     ,LA,70118-0000,Private      ,0,1,1,7,29,36
00202300,OUR LADY OF HOLY CROSS COLLEGE          ,LA,70131-7399,Private      ,13,52,65,682,1417,2099
00202400,SOUTHEASTERN LOUISIANA UNIV             ,LA,70402-0001,Public       ,235,233,468,11585,6598,18183
00202500,SOUTHERN UNIVERSITY A & M COLLEGE       ,LA,70813-9374,Public       ,137,222,359,7981,7593,15574
00202600,SOUTHERN UNIV NEW ORLEANS               ,LA,70126-0002,Public       ,52,167,219,2416,4586,7002
00202700,ST JOSEPH SEMINARY COLLEGE              ,LA,70457-9990,Private      ,1,0,1,31,20,51
00202900,TULANE UNIVERSITY                       ,LA,70118-5698,Private      ,113,180,293,13294,7793,21087
00203100,UNIV OF LOUISIANA AT LAFAYETTE          ,LA,70504-0001,Public       ,212,168,380,13135,5815,18950
00203200,XAVIER UNIVERSITY OF LOUISIANA          ,LA,70125-1098,Private      ,88,47,135,5083,2083,7166
00462100,AYERS CAREER COLLEGE                    ,LA,71108-5845,Proprietary  ,23,74,97,83,513,596
00462500,DELGADO COMMUNITY COLLEGE               ,LA,70119-0000,Public       ,372,859,1231,8980,17856,26836
00546700,SOWELA TECHNICAL COMMUNITY COLLEGE      ,LA,70616-6950,Public       ,42,79,121,1112,1646,2758
00548800,LOUISIANA TECH COLG-BATON ROUGE         ,LA,70807-0000,Public       ,38,106,144,629,1543,2172
00548802,LOUISIANA TECH COLG-ACADIAN CMPS        ,LA,70526-0000,Public       ,5,24,29,138,314,452
00548803,LOUISIANA TECH COLG-ALEXANDRIA CMPS     ,LA,71302-3137,Public       ,12,52,64,259,822,1081
00548804,LOUISIANA TECHNICAL COLLEGE - ASCENSION ,LA,70778-3007,Public       ,6,27,33,126,273,399
00548805,LA TECH COLLEGE-AVOYELLES CAMPUS        ,LA,71327-0000,Public       ,21,27,48,116,196,312
00548806,LA TECHNICAL COLG-BASTROP CMPS          ,LA,71221-0000,Public       ,5,8,13,73,246,319
00548808,LA TECH COLG CHARLES B COREILCMPS       ,LA,70586-0000,Public       ,5,18,23,128,283,411
00548809,LA TECHNICAL COLG-DELTA-OUACHITA        ,LA,71292-9064,Public       ,10,73,83,218,796,1014
00548810,EVANGELINE TECHNICAL INST               ,LA,70582-3104,Public       ,9,22,31,92,270,362
00548811,LA TECHN COLLEGE - FLORIDA PARISHES     ,LA,70441-0000,Public       ,9,18,27,140,318,458
00548812,LOUISIANA TECH COLG-FOLKES CAMPUS       ,LA,70748-0000,Public       ,5,11,16,23,97,120
00548813,LA TECHNICAL INST-GULF AREA CMPS        ,LA,70510-0878,Public       ,7,38,45,190,398,588
00548814,LOUISIANA TECH COLG-HAMMOND CMPS        ,LA,70404-0000,Public       ,27,53,80,312,685,997
00548815,LA TECH COLG-HUEY P. LONG CAMPUS        ,LA,71483-0000,Public       ,5,18,23,86,199,285
00548816,LA TECH COLLEGE-JEFFERSON CAMPUS        ,LA,70001-5605,Public       ,0,0,0,91,338,429
00548817,LOUISIANA TEC CLG-JUMONVILLE MEM CP     ,LA,70760-0000,Public       ,10,31,41,74,225,299
00548818,LA TECH COLLEGE-LAFAYETTE CAMPUS        ,LA,70506-0000,Public       ,29,70,99,756,1405,2161
00548819,LOUISIANA TECHNICAL COLLEGE-LAFOURC     ,LA,70301-4336,Public       ,12,16,28,165,312,477
00548820,LOUISIANA TEC CLG-LAMAR SALTER CMPS     ,LA,71446-0000,Public       ,5,19,24,103,351,454
00548822,LOUISIANA TECHNICAL CLG-MANSFIELD       ,LA,71052-1236,Public       ,6,14,20,78,171,249
00548823,LA. TECH COLG.-MORGAN SMITH CAMPUS      ,LA,70546-0000,Public       ,6,15,21,70,171,241
00548824,LOUISIANA TEC CLG-NATCHITOCHES CMPS     ,LA,71458-0000,Public       ,11,23,34,126,326,452
00548825,LOUISIANA TECH COLG-NORTH CTRL CMPS     ,LA,71241-0000,Public       ,0,9,9,45,144,189
00548826,LOUISIANA TECH CLG-NORTHEAST LA CMP     ,LA,71295-2999,Public       ,10,20,30,80,223,303
00548827,LOUISIANA TEC CLG-NW LOUISIANA CMPS     ,LA,71058-0000,Public       ,17,37,54,228,585,813
00548828,LA TECHNICAL COLG-OAKDALE CMPS          ,LA,71463-0000,Public       ,11,8,19,79,162,241
00548829,LTC-RIVER PARISHES CAMPUS               ,LA,70084-0000,Public       ,13,32,45,249,475,724
00548830,LOUISIANA TECHNICAL COLLEGE-RUSTON      ,LA,71273-0000,Public       ,7,29,36,367,431,798
00548831,LTC - SABINE VALLEY CAMPUS              ,LA,71449-3839,Public       ,5,23,28,47,152,199
00548832,LOUISIANA TECH COLG-SHELBY JACKSON      ,LA,71334-0000,Public       ,7,21,28,67,287,354
00548833,LA TECH COLG SHREVEPORT-BOSSIER         ,LA,71137-0000,Public       ,17,93,110,350,1514,1864
00548837,LOUISIANA TECH COLG-SULLIVAN CAMPUS     ,LA,70427-5866,Public       ,27,75,102,273,771,1044
00548839,LA TECH COLG-TECHE AREA CAMPUS          ,LA,70562-0000,Public       ,6,33,39,248,441,689
00548840,LOUISIANA TECH COLG-T.H.HARRIS CMPS     ,LA,70570-6113,Public       ,22,31,53,421,687,1108
00548841,LOUISIANA TECH COLG W JEFFERSON CMP     ,LA,70058-0000,Public       ,0,0,0,54,232,286
00548842,LOUISIANA TECHNICAL COLLEGE - WESTSIDE C,LA,70765-0733,Public       ,1,4,5,30,87,117
00548843,LTC-YOUNG MEMORIAL CAMPUS               ,LA,70381-0000,Public       ,12,33,45,142,472,614
00576100,L. E. FLETCHER TECHNICAL COMMUNITY COLLE,LA,70360-2863,Public       ,16,45,61,879,1341,2220
00768600,SOUTHERN UNIV AT SHREVEPORT/BOSSIER     ,LA,71107-4795,Public       ,80,185,265,1665,3342,5007
00777707,REMINGTON COLLEGE - CLEVELAND CAMPUS - L,LA,70508-5760,Proprietary  ,18,76,94,602,1534,2136
00777708,REMINGTON COLLEGE - CLEVELAND CAMPUS - B,LA,70816-4040,Proprietary  ,17,99,116,264,792,1056
00806700,LSU HEALTH SCIENCES CENTR-SHREVEPOR     ,LA,71130-3932,Public       ,21,33,54,388,1119,1507
00962110,HERZING UNIVERSITY - NEW ORLEANS        ,LA,70062-5538,Proprietary  ,5,20,25,93,573,666
00989800,DEMMON SCHOOL OF BEAUTY                 ,LA,70607-2128,Proprietary  ,0,8,8,23,87,110
01005701,AMERICAN COMMERCIAL COLLEGE             ,LA,71105-2502,Proprietary  ,5,35,40,33,311,344
01109700,CLOYD'S BEAUTY SCHOOL #1                ,LA,71291-3131,Proprietary  ,9,37,46,61,217,278
01163100,"D-JAY'S SCHL OF BEAUTY, ARTS & SCI      ",LA,70806-0000,Proprietary  ,4,20,24,55,142,197
01184100,JOHN JAY BEAUTY COLLEGE                 ,LA,70124-2592,Proprietary  ,6,10,16,76,125,201
01261100,RONNIE & DORMANS SCHOOL HAIR DESIGN     ,LA,70501-0000,Proprietary  ,0,0,0,7,8,15
01282300,PAT GOINS RUSTON BEAUTY SCHOOL          ,LA,71270-4301,Proprietary  ,2,6,8,30,64,94
01287900,PAT GOINS BENTON ROAD BEAUTY SCHOOL     ,LA,71111-4838,Proprietary  ,1,1,2,17,80,97
01288000,PAT GOINS BEAUTY SCHOOL                 ,LA,71201-5167,Proprietary  ,3,5,8,20,39,59
02055400,BOSSIER PARISH COMMUNITY COLLEGE        ,LA,71111-0000,Public       ,143,303,446,2924,5002,7926
02055500,DELTA SCH OF BUSINESS & TECHNOLOGY      ,LA,70601-0000,Proprietary  ,9,51,60,133,688,821
02117800,AVEDA INSTITUTE LAFAYETTE               ,LA,70503-3246,Proprietary  ,11,18,29,159,192,351
02166100,NUNEZ COMMUNITY COLLEGE                 ,LA,70043-0000,Public       ,49,142,191,664,1710,2374
02166200,ITI TECHNICAL COLLEGE                   ,LA,70817-0000,Proprietary  ,34,86,120,393,754,1147
02197500,BATON ROUGE SCHOOL OF COMPUTERS         ,LA,70809-8188,Proprietary  ,0,15,15,46,122,168
02234000,CAMERON COLLEGE                         ,LA,70119-0000,Proprietary  ,11,54,65,74,284,358
02258400,AVEDA INSTITUTE BATON ROUGE             ,LA,70816-2246,Proprietary  ,11,31,42,167,282,449
02260200,DIESEL DRIVING ACADEMY                  ,LA,71109-5617,Proprietary  ,11,112,123,61,488,549
02265600,JOHN JAY KENNER ACADEMY                 ,LA,70062-0000,Proprietary  ,6,11,17,56,111,167
02269300,STEVENSON'S ACADEMY OF HAIR DESIGN      ,LA,70116-0000,Proprietary  ,6,26,32,90,189,279
02327800,PINEVILLE BEAUTY SCHOOL                 ,LA,71360-0000,Proprietary  ,2,8,10,38,121,159
02335700,BATON ROUGE GENERAL MEDICAL CENTER      ,LA,70806-3889,Private      ,2,8,10,15,49,64
02335701,BATON ROUGE GEN MED CTR SCH NSG         ,LA,70821-0000,Private      ,1,10,11,93,265,358
02335702,BATON ROUGE GEN MED CTR-RAD TECH        ,LA,70806-0000,Private      ,1,5,6,37,108,145
02338000,"CLOYD'S BEAUTY SCHOOL #2, INC           ",LA,71202-3539,Proprietary  ,9,34,43,54,193,247
02352500,"CLOYD'S BEAUTY SCHOOL #3, INC           ",LA,71201-3211,Proprietary  ,9,37,46,62,219,281
02358600,"STAGE ONE THE HAIR SCHOOL, INC.         ",LA,70605-0000,Proprietary  ,4,21,25,71,125,196
02518300,SOUTH LOUISIANA BEAUTY COLLEGE          ,LA,70363-0000,Proprietary  ,7,11,18,33,68,101
02536400,LOUISIANA ACADEMY OF BEAUTY             ,LA,70535-0000,Proprietary  ,1,12,13,39,66,105
02538300,DELTA COLLEGE OF ARTS & TECH INC        ,LA,70806-1529,Proprietary  ,21,68,89,166,720,886
02538301,DELTA COLLEGE OF ARTS & TECHNOLOGY - LAF,LA,70508-6831,Proprietary  ,6,31,37,65,271,336
02548500,COSMETOLOGY TRAINING CENTER             ,LA,70503-0000,Proprietary  ,5,14,19,84,99,183
02554800,VANGUARD COLLEGE OF COSMETOLOGY         ,LA,70458-8823,Proprietary  ,22,42,64,152,210,362
02582200,"GUY'S ACADEMY HAIR, SKIN & NAILS        ",LA,71105-2404,Proprietary  ,6,27,33,86,236,322
02600900,AVEDA INSTITUTE                         ,LA,70433-2922,Proprietary  ,98,239,337,848,1685,2533
02601000,AMERICAN SCHOOL OF BUSINESS             ,LA,71105-5646,Proprietary  ,0,15,15,21,187,208
02601100,OPELOUSAS SCHOOL OF COSMETOLOGY         ,LA,70570-6156,Proprietary  ,2,3,5,21,50,71
02606800,CAREER TRAINING SPECIALISTS             ,LA,71201-6046,Proprietary  ,26,90,116,417,1086,1503
02606801,CAREER TECHNICAL COLLEGE - SHREVEPORT   ,LA,71105-2405,Proprietary  ,14,73,87,186,697,883
02617100,BATON ROUGE COLLEGE                     ,LA,70816-0000,Proprietary  ,3,20,23,104,227,331
02619200,DENHAM SPRINGS BEAUTY COLLEGE           ,LA,70726-3829,Proprietary  ,8,19,27,48,128,176
03010400,CRESCENT CITY SCH GAMING & BARTENDG     ,LA,70119-5507,Proprietary  ,13,181,194,91,814,905
03010624,VIRGINIA COLLEGE - BATON ROUGE          ,LA,70815-8604,Proprietary  ,20,133,153,21,144,165
03023500,CAMELOT CAREER COLLEGE                  ,LA,70805-7539,Proprietary  ,15,46,61,145,373,518
03030900,DIESEL DRIVING ACADEMY                  ,LA,70815-8109,Proprietary  ,15,104,119,64,552,616
03061400,ASCENSION COLLEGE                       ,LA,70737-2912,Proprietary  ,0,0,0,36,66,102
03095100,GRETNA CAREER COLLEGE                   ,LA,70053-2436,Proprietary  ,11,41,52,81,424,505
03106200,OUR LADY OF THE LAKE COLLEGE            ,LA,70808-4345,Private      ,11,74,85,962,2301,3263
03253300,JONESVILLE BEAUTY SCHOOL                ,LA,71343-0000,Proprietary  ,19,45,64,87,162,249
03294300,BLUE CLIFF SCH THERAPEUTIC MASSAGE      ,LA,70002-3458,Proprietary  ,35,168,203,375,1329,1704
03332600,DELTA COLLEGE                           ,LA,70433-9042,Proprietary  ,9,39,48,108,418,526
03332601,DELTA COLLEGE - SLIDELL                 ,LA,70460-2624,Proprietary  ,4,26,30,68,314,382
03356300,MEDICAL TRAINING COLLEGE                ,LA,70816-5820,Proprietary  ,7,48,55,181,508,689
03422500,BLUE CLIFF COLLEGE                      ,LA,71107-6520,Proprietary  ,29,153,182,240,1165,1405
03422600,BLUE CLIFF COLLEGE                      ,LA,70508-3858,Proprietary  ,27,154,181,242,1032,1274
03480300,MEDVANCE INSTITUTE                      ,LA,70809-1908,Proprietary  ,44,103,147,280,905,1185
03498400,OMEGA INSTITUTE OF COSMETOLOGY          ,LA,70360-0000,Proprietary  ,3,5,8,53,70,123
03727500,MOORE CAREER COLLEGE                    ,LA,70808-4191,Proprietary  ,0,6,6,22,69,91
03730300,BATON ROUGE COMMUNITY COLLEGE           ,LA,78806-4129,Public       ,200,408,608,5576,7054,12630
03752400,SCHOOL OF URBAN MISSIONS                ,LA,70053-0000,Private      ,5,15,20,132,193,325
03789300,UNITECH TRAINING ACADEMY                ,LA,70503-5132,Proprietary  ,12,45,57,118,341,459
03789301,UNITECH TRAINING ACADEMY - WEST MONROE  ,LA,71291-2913,Proprietary  ,6,65,71,63,352,415
03789302,UNITECH TRAINING ACADEMY - HOUMA        ,LA,70363-5556,Proprietary  ,6,26,32,69,205,274
03789303,UNITECH TRAINING ACADEMY -  ALEXANDRIA  ,LA,71303-3625,Proprietary  ,10,73,83,59,375,434
03789304,UNITECH TRAINING ACADEMY - LAKE CHARLES ,LA,70601-7887,Proprietary  ,16,47,63,82,258,340
03789400,RIVER PARISHES COMMUNITY COLLEGE        ,LA,70778-0310,Public       ,38,79,117,653,997,1650
03810500,COURT REPORTING INSTITUTE OF LOUISI     ,LA,70816-0000,Proprietary  ,0,6,6,12,106,118
03956300,SOUTH LOUISIANA COMMUNITY COLLEGE       ,LA,70506-0000,Public       ,49,103,152,1880,2085,3965
04040300,COMPASS CAREER COLLEGE                  ,LA,70403-0653,Proprietary  ,4,41,45,104,320,424
04112300,LOUISIANA CULINARY INSTITUTE            ,LA,70816-4109,Proprietary  ,13,35,48,181,283,464
04120700,ALDEN'S SCHOOL OF COSMETOLOGY           ,LA,70714-1502,Proprietary  ,1,17,18,24,122,146
04130100,LOUISIANA DELTA COMMUNITY COLLEGE       ,LA,71203-3618,Public       ,55,170,225,1345,2275,3620
04130101,LOUISIANA TECHNICAL COLG - TALLULAH     ,LA,71284-0000,Public       ,3,25,28,110,338,448
04149500,A & W HEALTHCARE EDUCATORS              ,LA,70122-3146,Proprietary  ,4,25,29,29,200,229
04151600,MY-LE'S BEAUTY COLLEGE                  ,LA,70056-3150,Proprietary  ,8,19,27,46,182,228
00143600,CAPITOL COLLEGE                         ,MD,20708-9759,Private      ,9,39,48,421,448,869
00146200,WASHINGTON BIBLE COLLEGE                ,MD,20706-3599,Private      ,3,31,34,98,449,547
00205700,ALLEGANY COLLEGE OF MARYLAND            ,MD,21502-2596,Public       ,48,126,174,2398,2151,4549
00205800,ANNE ARUNDEL COMMUNITY COLLEGE          ,MD,21012-1895,Public       ,248,776,1024,4879,8501,13380
00206100,BALTIMORE CITY COMMUNITY COLLEGE        ,MD,21215-7893,Public       ,156,675,831,3740,10216,13956
00206200,BOWIE STATE UNIVERSITY                  ,MD,20715-9465,Public       ,143,221,364,7798,5478,13276
00206300,COMMUNITY COLLEGE OF BALTIMORE COUNTY   ,MD,21228-5381,Public       ,447,1208,1655,9221,16814,26035
00206400,COLLEGE OF SOUTHERN MARYLAND            ,MD,20646-0910,Public       ,112,368,480,3276,4866,8142
00206500,CLG NOTRE DAME OF MARYLAND              ,MD,21210-2476,Private      ,15,90,105,840,1816,2656
00206700,WASHINGTON ADVENTIST UNIVERSITY         ,MD,20912-7796,Private      ,12,63,75,749,1169,1918
00206800,COPPIN STATE UNIVERSITY                 ,MD,21216-3698,Public       ,84,198,282,4185,5023,9208
00207100,FREDERICK COMMUNITY COLLEGE             ,MD,21702-9745,Public       ,82,231,313,2031,2833,4864
00207200,FROSTBURG STATE UNIVERSITY              ,MD,21532-1099,Public       ,73,52,125,6871,1497,8368
00207300,GOUCHER COLLEGE                         ,MD,21204-2794,Private      ,25,42,67,2989,885,3874
00207400,HAGERSTOWN COMMUNITY COLLEGE            ,MD,21742-6590,Public       ,64,210,274,1862,3281,5143
00207500,HARFORD COMMUNITY COLLEGE               ,MD,21015-1696,Public       ,82,230,312,2178,3031,5209
00207600,HOOD COLLEGE                            ,MD,21701-8575,Private      ,30,34,64,2085,922,3007
00207700,JOHNS HOPKINS UNIVERSITY                ,MD,21218-2693,Private      ,76,114,190,8308,2722,11030
00207702,JOHNS HOPKINS UNIV SCH ARTS/SCI/ENG     ,MD,21218-0000,Private      ,24,117,141,4228,2372,6600
00207703,JOHNS HOPKINS UNIV SCH OF BUS/ED        ,MD,21046-0000,Private      ,5,74,79,90,1820,1910
00207705,JOHNS HOPKINS BLOOMBERG SCH OF PH       ,MD,21205-0000,Private      ,0,36,36,26,1551,1577
00207706,JOHNS HOPKINS UNIV SCH OF MEDICINE      ,MD,21205-0000,Private      ,7,19,26,189,1114,1303
00207707,JOHNS HOPKINS UNIV SCH OF NURSING       ,MD,21205-0000,Private      ,5,42,47,285,1172,1457
00207708,JOHNS HOPKINS UNIV PEABODY CONSERV      ,MD,21202-2397,Private      ,5,7,12,680,512,1192
00207800,LOYOLA UNIVERSITY MARYLAND              ,MD,21210-2699,Private      ,56,68,124,7826,2534,10360
00208000,MARYLAND INST COLLEGE OF ART            ,MD,21217-4191,Private      ,23,27,50,2923,848,3771
00208300,MORGAN STATE UNIVERSITY                 ,MD,21251-0002,Public       ,171,221,392,11953,6266,18219
00208600,MOUNT SAINT MARY'S UNIVERSITY           ,MD,21727-7799,Private      ,23,28,51,2977,470,3447
00208700,NER ISRAEL RABBINICAL COLLEGE           ,MD,21208-1198,Private      ,9,10,19,102,63,165
00208900,PRINCE GEORGES COMMUNITY COLLEGE        ,MD,20774-2199,Public       ,259,730,989,6554,11151,17705
00209100,SALISBURY UNIVERSITY                    ,MD,21801-6862,Public       ,126,60,186,10874,2190,13064
00209200,ST JOHN'S COLLEGE                       ,MD,21404-0000,Private      ,5,16,21,610,221,831
00209500,ST. MARY'S COLLEGE OF MARYLAND          ,MD,20686-3001,Public       ,32,17,49,2586,262,2848
00209600,ST MARY'S SEMINARY & UNIV               ,MD,21210-1994,Private      ,1,3,4,23,45,68
00209900,TOWSON UNIVERSITY                       ,MD,21252-0002,Public       ,289,276,565,22459,8209,30668
00210200,UNIVERSITY OF BALTIMORE                 ,MD,21201-5779,Public       ,41,197,238,1811,7310,9121
00210300,"UNIVERSITY OF MARYLAND, COLLEGE PARK    ",MD,20742-5145,Public       ,409,568,977,31557,15094,46651
00210400,"UNIVERSITY OF MARYLAND, BALTIMORE       ",MD,21201-1691,Public       ,56,274,330,2588,10243,12831
00210500,UMBC                                    ,MD,21250-0002,Public       ,174,226,400,10073,5250,15323
00210600,UNIVERSITY MARYLAND EASTERN SHORE       ,MD,21853-4053,Public       ,82,64,146,5910,2117,8027
00210700,STEVENSON UNIVERSITY                    ,MD,21153-0641,Private      ,77,108,185,5021,1724,6745
00210800,WASHINGTON COLLEGE                      ,MD,21620-1197,Private      ,20,5,25,2726,111,2837
00210900,MCDANIEL COLLEGE                        ,MD,21157-4390,Private      ,32,34,66,3025,776,3801
00458612,KAPLAN COLLEGE                          ,MD,21742-2797,Proprietary  ,25,159,184,467,1792,2259
00458614,KAPLAN COLLEGE - FREDERICK              ,MD,21704-8307,Proprietary  ,0,18,18,46,313,359
00465000,CHESAPEAKE COLLEGE                      ,MD,21679-0008,Public       ,50,115,165,1283,1901,3184
00691100,MONTGOMERY COLLEGE                      ,MD,20850-1195,Public       ,363,674,1037,10580,11250,21830
00734100,INTERNATIONAL BEAUTY SCHOOL             ,MD,21502-2370,Proprietary  ,11,82,93,103,746,849
00744700,DEL-MAR-VA BEAUTY ACADEMY               ,MD,21804-0000,Proprietary  ,1,6,7,58,116,174
00749100,TESST COLLEGE OF TECHNOLOGY             ,MD,21227-1063,Proprietary  ,39,205,244,443,1751,2194
00793600,LINCOLN TECHNICAL INSTITUTE             ,MD,21046-1544,Proprietary  ,86,125,211,943,1275,2218
00817500,HOWARD COMMUNITY COLLEGE                ,MD,21044-3197,Public       ,128,291,419,3264,4309,7573
00826300,AWARD BEAUTY SCHOOL                     ,MD,21740-5624,Proprietary  ,20,85,105,87,388,475
00830800,CECIL COLLEGE                           ,MD,21901-1999,Public       ,26,83,109,997,1334,2331
00907906,EVEREST COLLEGE- EVEREST INSTITUTE      ,MD,20910-3737,Proprietary  ,43,134,177,328,1050,1378
01001400,GARRETT COMMUNITY COLLEGE               ,MD,21541-1265,Public       ,15,23,38,781,386,1167
01031900,MEDIX SCHOOL                            ,MD,21204-2538,Proprietary  ,76,368,444,726,2772,3498
01041000,TESST COLLEGE OF TECHNOLOGY             ,MD,21286-2201,Proprietary  ,24,92,116,223,782,1005
01164400,UNIV OF MARYLAND UNIVERSITY COLLEGE     ,MD,20783-8078,Public       ,151,2845,2996,2968,31671,34639
01164402,U OF MD UNIVERSITY COLLEGE - EUROPE     ,MD,20832-0000,Public       ,6,124,130,310,1163,1473
01164404,U OF MD UNIVERSITY COLLEGE - ASIA       ,MD,31207-0000,Public       ,2,110,112,115,842,957
02073900,WOR-WIC COMMUNITY COLLEGE               ,MD,21804-0000,Public       ,60,227,287,1631,3257,4888
02083600,TESST COLLEGE OF TECHNOLOGY             ,MD,20705-2698,Proprietary  ,37,142,179,350,1030,1380
02116005,SANFORD-BROWN INSTITUTE - LANDOVER      ,MD,20785-2287,Proprietary  ,39,154,193,300,1295,1595
02127900,SOJOURNER DOUGLASS COLLEGE              ,MD,21205-0000,Private      ,9,204,213,259,3103,3362
02155100,MARYLAND COLLEGE OF ART AND DESIGN      ,MD,20902-0000,Private      ,3,10,13,126,126,252
02269700,INTERNATIONAL BEAUTY SCHOOL             ,MD,21014-0000,Proprietary  ,4,9,13,48,74,122
02314800,BALTIMORE INTERNATIONAL COLLEGE         ,MD,21202-0000,Private      ,13,44,57,621,758,1379
02331000,MARYLAND BEAUTY ACADEMY OF ESSEX        ,MD,21221-0000,Proprietary  ,13,30,43,70,216,286
02333000,HAIR ACADEMY                            ,MD,20784-0000,Proprietary  ,33,86,119,226,497,723
02343800,MONTGOMERY BEAUTY SCHOOL                ,MD,20901-0000,Proprietary  ,13,47,60,86,219,305
02494700,BALTIMORE STUDIO OF HAIR DESIGN         ,MD,21201-0000,Proprietary  ,7,40,47,88,299,387
02495000,ROBERT PAUL ACAD COSMTGY ARTS & SCI     ,MD,21093-0000,Proprietary  ,3,7,10,62,95,157
02495100,MARYLAND BEAUTY ACADEMY                 ,MD,21136-0000,Proprietary  ,5,14,19,44,69,113
02545400,NORTH AMERICAN TRADE SCHOOLS            ,MD,21244-0069,Proprietary  ,34,193,227,241,1153,1394
02573800,"L' ACADEMIE DE CUISINE, INC.            ",MD,20877-0000,Proprietary  ,6,24,30,63,221,284
02578400,TAI SOPHIA INSTITUTE                    ,MD,20723-6010,Private      ,0,49,49,0,373,373
03010802,TRI-STATE BUSINESS INSTITUTE -  FORTIS C,MD,20785-2223,Proprietary  ,0,0,0,3,11,14
03027200,BLADES SCHOOL OF HAIR DESIGN            ,MD,20619-0226,Proprietary  ,5,23,28,39,124,163
03064900,AARON'S ACADEMY OF BEAUTY               ,MD,20602-2715,Proprietary  ,2,6,8,40,99,139
03097200,AESTHETICS INSTITUTE OF COSMETOLOGY     ,MD,20877-1305,Proprietary  ,3,11,14,23,77,100
03100700,CARROLL COMMUNITY COLLEGE               ,MD,21157-6913,Public       ,54,101,155,1144,1282,2426
03148300,AMERICAN BEAUTY ACADEMY                 ,MD,20902-1911,Proprietary  ,50,123,173,306,797,1103
03296300,BALTIMORE SCHOOL OF MASSAGE             ,MD,21090-2261,Proprietary  ,35,160,195,283,829,1112
03327300,NEW CREATIONS ACADEMY OF HAIR DSN       ,MD,20746-2960,Proprietary  ,1,12,13,32,104,136
03455500,NATIONAL LABOR COLLEGE                  ,MD,20903-1790,Private      ,0,44,44,11,172,183
03493300,ALL-STATE CAREER SCHOOL                 ,MD,21224-6658,Proprietary  ,70,594,664,606,2891,3497
03771300,AMERICAN CAREER INSTITUTE               ,MD,20902-4637,Proprietary  ,137,691,828,622,3119,3741
03822400,MAPLE SPRINGS BAPTIST BIBLE COLLEGE & SE,MD,20743-5711,Private      ,0,5,5,3,63,66
03937300,YESHIVA COLLEGE OF THE NATION'S CAPITAL ,MD,20902-1700,Private      ,1,1,2,9,19,28
03965500,HAIR EXPRESSIONS ACADEMY                ,MD,20852-1729,Proprietary  ,6,17,23,56,146,202
04121600,FILA ACADEMY (THE)                      ,MD,21061-1634,Proprietary  ,8,22,30,68,209,277
04139700,FREDERICK SCHOOL OF COSMETOLOGY         ,MD,21701-0000,Proprietary  ,0,11,11,23,66,89
04141600,OMEGA STUDIOS' SCHOOL OF APPLIED RECORDI,MD,20852-1731,Proprietary  ,4,10,14,58,118,176
04151800,TEMPLE (THE): A PAUL MITCHELL PARTNER SC,MD,21701-5409,Proprietary  ,12,38,50,111,161,272
00211400,AMERICAN INTERNATIONAL COLLEGE          ,MA,01109-3189,Private      ,16,93,109,2298,2749,5047
00211500,AMHERST COLLEGE                         ,MA,01002-5000,Private      ,29,11,40,4887,275,5162
00211600,ANDOVER NEWTON THEOLOGICAL SCHOOL       ,MA,02459-0000,Private      ,0,6,6,2,215,217
00211700,ANNA MARIA COLLEGE                      ,MA,01612-1198,Private      ,14,48,62,2072,623,2695
00211800,ASSUMPTION COLLEGE                      ,MA,01615-1294,Private      ,31,20,51,4619,755,5374
00211900,ATLANTIC UNION COLLEGE                  ,MA,01561-1000,Private      ,4,9,13,361,403,764
00212000,MERRIMACK COLLEGE                       ,MA,01845-5800,Private      ,33,17,50,3989,310,4299
00212100,BABSON COLLEGE                          ,MA,02457-0310,Private      ,23,64,87,2366,934,3300
00212200,BAY PATH COLLEGE                        ,MA,01106-2212,Private      ,11,122,133,905,2094,2999
00212300,BECKER COLLEGE-WORCESTER                ,MA,01615-0071,Private      ,21,42,63,2382,1060,3442
00212400,BENTLEY UNIVERSITY                      ,MA,02452-4705,Private      ,43,27,70,5452,939,6391
00212600,BERKLEE COLLEGE OF MUSIC                ,MA,02215-3693,Private      ,84,55,139,4709,1350,6059
00212800,BOSTON COLLEGE                          ,MA,02467-3800,Private      ,138,101,239,19590,7526,27116
00212900,BOSTON CONSERVATORY OF MUSIC            ,MA,02215-9830,Private      ,9,5,14,1155,349,1504
00213000,BOSTON UNIVERSITY                       ,MA,02215-1789,Private      ,281,424,705,31845,20019,51864
00213300,BRANDEIS UNIVERSITY                     ,MA,02453-2700,Private      ,34,27,61,5042,1441,6483
00213900,CLARK UNIVERSITY                        ,MA,01610-1473,Private      ,27,26,53,3693,774,4467
00214000,ELMS COLLEGE                            ,MA,01013-2839,Private      ,5,11,16,1117,759,1876
00214100,COLLEGE OF THE HOLY CROSS               ,MA,01610-2395,Private      ,30,3,33,5666,137,5803
00214300,CURRY COLLEGE                           ,MA,02186-2395,Private      ,43,51,94,4445,1318,5763
00214400,DEAN COLLEGE                            ,MA,02038-1994,Private      ,33,9,42,1804,261,2065
00214500,EASTERN NAZARENE COLLEGE                ,MA,02170-2999,Private      ,1,42,43,829,562,1391
00214507,EASTERN NAZARENE CLG - LEAD PROGRAM     ,MA,02170-0000,Private      ,0,9,9,21,88,109
00214600,EMERSON COLLEGE                         ,MA,02116-4624,Private      ,50,24,74,6830,1692,8522
00214700,EMMANUEL COLLEGE                        ,MA,02115-5798,Private      ,41,22,63,4720,542,5262
00214800,ENDICOTT COLLEGE                        ,MA,01915-2098,Private      ,32,57,89,4082,514,4596
00214900,EPISCOPAL DIVINITY SCHOOL               ,MA,02138-0000,Private      ,0,2,2,0,81,81
00215000,FISHER COLLEGE                          ,MA,02116-1500,Private      ,25,118,143,1410,1168,2578
00215100,BENJAMIN FRANKLIN INSTITUTE OF TECH     ,MA,02116-6296,Public       ,8,7,15,743,368,1111
00215300,GORDON COLLEGE                          ,MA,01984-1899,Private      ,14,11,25,2008,149,2157
00215400,HELLENIC COLLEGE                        ,MA,02445-7496,Private      ,1,2,3,75,153,228
00215500,HARVARD UNIVERSITY                      ,MA,02138-3800,Private      ,121,56,177,7270,1534,8804
00215501,AMRCN REPERTORY THTR INST ADV THTR      ,MA,02138-0000,Private      ,0,0,0,4,140,144
00215502,HARVARD BUSINESS SCHOOL                 ,MA,02163-0000,Private      ,13,22,35,200,1730,1930
00215503,HARVARD EXTENSION SCHOOL                ,MA,02138-0000,Private      ,7,100,107,181,1500,1681
00215504,HARVARD SCH OF DENTAL MEDICINE          ,MA,02115-0000,Private      ,0,2,2,30,212,242
00215505,HARVARD UNIV GRAD SCH DESIGN            ,MA,02138-0000,Private      ,0,11,11,16,1375,1391
00215506,HARVARD DIVINITY SCHOOL                 ,MA,02138-0000,Private      ,2,4,6,20,570,590
00215507,HARVARD UNIV GRAD SCH ED                ,MA,02138-0000,Private      ,0,12,12,5,1603,1608
00215508,HARVARD UNIV GRAD S OF ARTS & SCIEN     ,MA,02138-0000,Private      ,3,19,22,116,941,1057
00215509,HARVARD KENNEDY SCHOOL                  ,MA,02138-0000,Private      ,1,20,21,16,1506,1522
00215510,HARVARD LAW SCHOOL                      ,MA,02138-0000,Private      ,6,16,22,123,3898,4021
00215511,HARVARD UNIV MEDICAL SCHOOL             ,MA,02115-0000,Private      ,2,13,15,133,1118,1251
00215512,HARVARD UNIV SCH PUBLIC HEALTH          ,MA,02115-0000,Private      ,3,9,12,40,832,872
00215513,HARVARD UNIVERSITY-HARVARD COLLEGE      ,MA,02138-0000,Private      ,96,13,109,14823,440,15263
00215700,HEBREW COLLEGE                          ,MA,02459-2237,Private      ,0,3,3,1,103,104
00215800,LASELL COLLEGE                          ,MA,02466-2716,Private      ,19,11,30,3132,287,3419
00216000,LESLEY UNIVERSITY                       ,MA,02138-2790,Private      ,18,319,337,2817,5054,7871
00216100,UMASS LOWELL                            ,MA,01854-3089,Public       ,147,263,410,11890,5724,17614
00216400,NEW ENGLAND COLLEGE OF OPTOMETRY        ,MA,02115-1129,Private      ,0,1,1,11,411,422
00216500,MASS. COLLEGE OF PHARMACY  & HEALTH SCIE,MA,02115-5804,Private      ,34,25,59,4545,2923,7468
00216700,BERKSHIRE COMMUNITY COLLEGE             ,MA,01201-5786,Public       ,34,77,111,1016,1601,2617
00216800,CAPE COD COMMUNITY COLLEGE              ,MA,02668-1599,Public       ,59,149,208,1846,2465,4311
00216900,GREENFIELD COMMUNITY COLLEGE            ,MA,01301-9739,Public       ,37,72,109,965,1624,2589
00217000,HOLYOKE COMMUNITY COLLEGE               ,MA,01040-1099,Public       ,103,203,306,3965,4957,8922
00217100,MASSACHUSETTS BAY COMMUNITY COLLEGE     ,MA,02181-0000,Public       ,46,113,159,2363,2601,4964
00217200,MOUNT WACHUSETT COMMUNITY COLLEGE       ,MA,01440-1000,Public       ,50,178,228,2025,3357,5382
00217300,NORTH SHORE COMMUNITY COLLEGE           ,MA,01923-4093,Public       ,75,203,278,3539,4563,8102
00217400,NORTHERN ESSEX COMMUNITY COLLEGE        ,MA,01830-2399,Public       ,113,276,389,3062,4347,7409
00217500,QUINSIGAMOND COMMUNITY COLLEGE          ,MA,01606-2092,Public       ,107,274,381,4304,5518,9822
00217600,BRISTOL COMMUNITY COLLEGE               ,MA,02720-7399,Public       ,107,260,367,4374,5094,9468
00217700,MASSASOIT COMMUNITY COLLEGE             ,MA,02302-3996,Public       ,70,152,222,3581,4261,7842
00217800,MASSACHUSETTS INST OF TECHNOLOGY        ,MA,02139-4307,Private      ,73,157,230,11142,3387,14529
00218000,MASSACHUSETTS COLLEGE OF ART AND DESIGN ,MA,02115-5803,Public       ,21,12,33,2450,871,3321
00218100,MASSACHUSETTS MARITIME ACADEMY          ,MA,02532-3400,Public       ,10,8,18,1319,132,1451
00218300,BRIDGEWATER STATE COLLEGE               ,MA,02325-0001,Public       ,107,118,225,11793,3609,15402
00218400,FITCHBURG STATE COLLEGE                 ,MA,01420-2697,Public       ,38,63,101,5680,1637,7317
00218500,FRAMINGHAM STATE COLLEGE                ,MA,01702-2471,Public       ,34,37,71,5310,1398,6708
00218700,MASSACHUSETTS CLG OF LIBERAL ARTS       ,MA,01247-4100,Public       ,10,22,32,2243,610,2853
00218800,SALEM STATE UNIVERSITY                  ,MA,01970-5353,Public       ,104,116,220,8484,4078,12562
00218900,WESTFIELD STATE COLLEGE                 ,MA,01086-1630,Public       ,44,34,78,7761,1645,9406
00219000,WORCESTER STATE COLLEGE                 ,MA,01602-2597,Public       ,46,85,131,6291,2373,8664
00219200,MOUNT HOLYOKE COLLEGE                   ,MA,01075-1492,Private      ,16,4,20,2649,335,2984
00219300,MOUNT IDA COLLEGE                       ,MA,02459-3323,Private      ,21,7,28,2250,408,2658
00219400,NEW ENGLAND CONSERVATORY OF MUSIC       ,MA,02115-5018,Private      ,4,5,9,792,646,1438
00219700,NICHOLS COLLEGE                         ,MA,01571-6346,Private      ,20,27,47,2037,456,2493
00219900,NORTHEASTERN UNIVERSITY                 ,MA,02115-5000,Private      ,303,540,843,32561,12847,45408
00220100,PINE MANOR COLLEGE                      ,MA,02167-0000,Private      ,3,2,5,562,187,749
00220200,BLESSED JOHN XXIII NATIONAL SEMINARY    ,MA,02493-0000,Private      ,0,1,1,0,6,6
00220500,QUINCY COLLEGE                          ,MA,02169-4501,Public       ,60,164,224,1622,3337,4959
00220600,REGIS COLLEGE                           ,MA,02193-0000,Private      ,18,31,49,2066,797,2863
00220800,SIMMONS COLLEGE                         ,MA,02115-5898,Private      ,35,94,129,2933,4006,6939
00220900,SMITH COLLEGE                           ,MA,01063-2936,Private      ,27,16,43,3430,1009,4439
00220901,"SMITH COLLEGE, SCH FOR SOCIAL WORK      ",MA,01063-0000,Private      ,0,15,15,3,47,50
00221000,UNIV OF MASSACHUSETTS-DARTMOUTH         ,MA,02747-2300,Public       ,73,112,185,11727,2910,14637
00221007,UNIVERSITY OF MASSACHUSETTS - DARTMOUTH ,MA,02747-1252,Public       ,0,0,0,2,345,347
00221100,SPRINGFIELD COLLEGE                     ,MA,01109-3797,Private      ,30,179,209,4129,4618,8747
00221400,ST JOHN'S SEMINARY                      ,MA,02135-8839,Private      ,1,4,5,18,57,75
00221700,STONEHILL COLLEGE                       ,MA,02357-6110,Private      ,50,1,51,6581,158,6739
00221800,SUFFOLK UNIVERSITY                      ,MA,02108-2770,Private      ,71,60,131,9774,5162,14936
00221810,SUFFOLK UNIVERSITY - LAW SCHOOL         ,MA,02108-4977,Private      ,0,0,0,17,357,374
00221900,TUFTS UNIVERSITY                        ,MA,02155-5808,Private      ,62,49,111,10086,2870,12956
00221901,TUFTS UNIV SCH OF DENTAL MEDICINE       ,MA,02111-0000,Private      ,0,5,5,21,828,849
00221902,TUFTS UNIVERSITY - CUMMINGS SCHOOL OF VE,MA,01536-0000,Private      ,0,2,2,27,482,509
00221904,TUFTS UNIV SCHOOL OF MEDICINE           ,MA,02111-0000,Private      ,1,11,12,64,1946,2010
00222100,UNIV OF MASSACHUSETTS-AMHERST           ,MA,01003-0000,Public       ,272,214,486,35090,7534,42624
00222200,UNIV OF MASSACHUSETTS-BOSTON            ,MA,02125-3393,Public       ,134,339,473,11334,10521,21855
00222400,WELLESLEY COLLEGE                       ,MA,02481-8203,Private      ,21,5,26,3508,210,3718
00222500,WENTWORTH INSTITUTE OF TECHNOLOGY       ,MA,02115-5998,Private      ,45,37,82,4859,868,5727
00222600,WESTERN NEW ENGLAND COLLEGE             ,MA,01119-2654,Private      ,50,40,90,5289,1773,7062
00222700,WHEATON COLLEGE                         ,MA,02766-2322,Private      ,18,3,21,2591,90,2681
00222800,WHEELOCK COLLEGE                        ,MA,02215-4176,Private      ,14,8,22,1571,675,2246
00222900,WILLIAMS COLLEGE                        ,MA,01267-2600,Private      ,20,1,21,3894,116,4010
00223300,WORCESTER POLYTECHNIC INSTITUTE         ,MA,01609-2280,Private      ,29,23,52,6328,591,6919
00396500,BAY STATE COLLEGE                       ,MA,02116-2901,Proprietary  ,30,48,78,1495,937,2432
00396600,BOSTON ARCHITECTURAL COLLEGE            ,MA,02115-2795,Private      ,10,23,33,518,1065,1583
00466100,HAMPSHIRE COLLEGE                       ,MA,01002-3359,Private      ,16,2,18,2489,158,2647
00466600,SALTER COLLEGE                          ,MA,01583-1700,Proprietary  ,60,411,471,672,3414,4086
00466700,SCHOOL OF MUSEUM OF FINE ARTS           ,MA,02115-5534,Private      ,8,4,12,876,314,1190
00466900,UPPER CAPE COD REGIONAL VOC TECH        ,MA,02532-3310,Public       ,1,5,6,22,119,141
00527900,GREATER LOWELL REGNL VOC TECH SCH       ,MA,01879-0000,Public       ,0,1,1,23,100,123
00551900,DIMAN REGIONAL VOC TECH INST            ,MA,02723-3519,Public       ,1,1,2,24,93,117
00552300,BLUE HILLS REGIONAL VOC TECH            ,MA,02021-1398,Public       ,0,3,3,31,144,175
00555700,MCCANN TECHNICAL SCHOOL                 ,MA,01247-0000,Public       ,0,1,1,26,97,123
00613600,NATIONAL AVIATION ACADEMY - NEW ENGLAND ,MA,01730-2620,Proprietary  ,4,29,33,114,225,339
00632200,BROCKTON HOSPITAL SCH OF NURSING        ,MA,02302-0000,Private      ,1,7,8,124,494,618
00632400,LABOURE COLLEGE                         ,MA,02124-5698,Private      ,6,26,32,218,884,1102
00633100,LAWRENCE MEM HOSPITAL SCH OF NRSNG      ,MA,02155-1643,Private      ,0,11,11,66,402,468
00635200,BAYSTATE MEDICAL CENTER                 ,MA,01199-0001,Private      ,1,2,3,22,63,85
00687300,MARIAN COURT COLLEGE                    ,MA,01907-2896,Private      ,7,4,11,199,122,321
00748100,GIBBS COLLEGE                           ,MA,02116-2904,Proprietary  ,18,41,59,168,463,631
00748400,NEWBURY COLLEGE                         ,MA,02445-5796,Private      ,27,14,41,2279,313,2592
00748600,THE NEW ENGLAND INSTITUTE OF ART        ,MA,02445-7295,Proprietary  ,42,34,76,2005,798,2803
00748800,KAPLAN CAREER INSTITUTE                 ,MA,02129-1644,Proprietary  ,24,96,120,184,766,950
00748801,KAPLAN CAREER INSTITUTE -               ,MA,02215-2606,Proprietary  ,13,46,59,110,522,632
00807800,SPRINGFIELD TECHNICAL COMMUNITY CLG     ,MA,01105-0000,Public       ,76,201,277,3206,5627,8833
00809002,EVEREST COLLEGE - EVEREST INSTITUTE     ,MA,02150-2333,Proprietary  ,30,82,112,172,580,752
00891600,NEW ENGLAND SCHOOL OF LAW               ,MA,02116-0000,Private      ,0,11,11,10,2320,2330
00964500,BARD COLLEGE AT SIMON'S ROCK            ,MA,01230-9702,Private      ,3,1,4,517,24,541
00974700,GORDON-CONWELL THEOLOGICAL SEMINARY     ,MA,01982-0000,Private      ,0,17,17,11,550,561
00975600,UNIVERSITY OF MASS MEDICAL CENTER       ,MA,01655-0000,Public       ,0,16,16,43,869,912
00987700,HENRI'S SCHOOL OF HAIR DESIGN           ,MA,01420-5675,Proprietary  ,2,3,5,29,24,53
00989900,LOWELL ACADEMY HAIRSTYLING INST         ,MA,01852-1909,Proprietary  ,0,0,0,25,41,66
00993600,MIDDLESEX COMMUNITY COLLEGE             ,MA,01730-1197,Public       ,63,77,140,1839,1524,3363
00993602,"MIDDLESEX COMMUNITY COLLEGE, LOWELL     ",MA,01852-0000,Public       ,99,204,303,2736,2765,5501
01121000,BUNKER HILL COMMUNITY COLLEGE           ,MA,02129-2991,Public       ,134,277,411,5810,9166,14976
01151000,EVEREST INSTITUTE                       ,MA,02135-7638,Proprietary  ,22,81,103,189,661,850
01193000,ROXBURY COMMUNITY COLLEGE               ,MA,02120-3400,Public       ,52,144,196,1224,3126,4350
01204200,MANSFIELD BEAUTY SCHOOLS                ,MA,02169-5061,Proprietary  ,2,11,13,35,96,131
01206800,MANSFIELD BEAUTY SCHOOL                 ,MA,01103-1410,Proprietary  ,2,2,4,20,60,80
01218700,BLACKSTONE VALLEY VOCATIONAL REGIONAL SC,MA,01568-1499,Public       ,0,3,3,2,58,60
01238600,SOUTHEASTERN TECHNICAL INSTITUTE        ,MA,02375-1780,Public       ,0,3,3,49,189,238
01288100,MONTACHUSETT REG VOC TECH SCH           ,MA,01420-4649,Public       ,0,2,2,15,82,97
01292100,EMPIRE BEAUTY SCHOOL                    ,MA,02215-0000,Proprietary  ,33,49,82,192,392,584
01292101,EMPIRE BEAUTY SCHOOL - HYANNIS          ,MA,02601-2022,Proprietary  ,0,0,0,14,29,43
01294800,ROB ROY ACADEMY                         ,MA,02721-5330,Proprietary  ,8,23,31,79,128,207
02063000,MONTSERRAT COLLEGE OF ART               ,MA,01915-0000,Private      ,5,2,7,661,78,739
02063800,BUTERA SCHOOL OF ART                    ,MA,02116-0000,Proprietary  ,0,0,0,38,16,54
02076700,EMPIRE BEAUTY SCHOOL                    ,MA,02148-0000,Proprietary  ,8,32,40,79,221,300
02079400,EMPIRE BEAUTY SCHOOL                    ,MA,01702-5232,Proprietary  ,7,30,37,80,267,347
02092100,MASSACHUSETTS SCHOOL OF BARBERING       ,MA,02169-5058,Proprietary  ,7,20,27,35,135,170
02092200,EMPIRE BEAUTY SCHOOL                    ,MA,01852-0000,Proprietary  ,10,37,47,69,196,265
02122000,NEW ENGLAND HAIR ACADEMY                ,MA,02148-0000,Proprietary  ,19,23,42,98,170,268
02137000,ROB ROY ACADEMY                         ,MA,02780-0000,Proprietary  ,1,9,10,39,61,100
02137200,MASS GEN HOSP DIETETIC INTERNSHIP       ,MA,02114-0000,Private      ,0,0,0,2,19,21
02143000,LONGY SCHOOL OF MUSIC                   ,MA,02138-3599,Private      ,0,2,2,61,170,231
02163500,NEW ENGLAND SCHOOL OF PHOTOGRAPHY       ,MA,02215-0000,Proprietary  ,1,8,9,154,168,322
02163600,MASS SCH OF PROFESSIONAL PSYCHOLOGY     ,MA,02132-0000,Private      ,0,6,6,13,646,659
02169900,ASSABET VALLEY REGIONAL VOC SCHOOL      ,MA,01752-0000,Public       ,0,5,5,18,104,122
02181600,ROB ROY ACADEMY                         ,MA,01609-0000,Proprietary  ,14,29,43,145,237,382
02182900,CAMBRIDGE COLLEGE                       ,MA,02138-5304,Private      ,52,376,428,399,4757,5156
02197900,NORTH BENNET STREET SCHOOL              ,MA,02113-0000,Private      ,1,2,3,50,130,180
02215100,HALLMARK INSTITUTE OF PHOTOGRAPHY       ,MA,01376-0000,Proprietary  ,5,2,7,263,194,457
02219501,MILDRED ELLEY - PITTSFIELD              ,MA,01201-5300,Proprietary  ,0,2,2,14,38,52
02220400,CATHERINE HINDS INST OF ESTHETICS       ,MA,01801-0000,Proprietary  ,2,34,36,58,200,258
02231600,MGH INSTITUTE OF HEALTH PROFESSION      ,MA,02129-0000,Private      ,4,58,62,57,1396,1453
02274300,CONWAY SCHOOL OF LANDSCAPE DESIGN       ,MA,01341-0179,Private      ,0,0,0,2,18,20
02325700,LABARON HAIRDRESSING ACADEMY            ,MA,02740-0000,Proprietary  ,6,8,14,25,69,94
02325800,LABARON HAIRDRESSING ACAD-BROCKTON      ,MA,02301-0000,Proprietary  ,5,3,8,27,52,79
02337400,BANCROFT SCHOOL OF MASSAGE THERAPY      ,MA,01604-4614,Proprietary  ,0,14,14,15,87,102
02338200,BAY STATE SCHOOL OF TECHNOLOGY          ,MA,02021-0000,Proprietary  ,9,67,76,66,381,447
02339400,ROB ROY ACADEMY                         ,MA,02746-0000,Proprietary  ,3,7,10,13,31,44
02491700,CORTIVA INSTITUTE -  BOSTON             ,MA,02472-2577,Proprietary  ,8,46,54,42,271,313
02523900,ELIZABETH GRADY SCHOOL OF ESTHETICS     ,MA,02155-0000,Proprietary  ,7,25,32,49,175,224
02579800,NEW ENGLAND SCHOOL OF ACUPUNCTURE       ,MA,02458-0000,Private      ,0,3,3,4,166,170
03006802,PENNSYLVANIA CULINARY INSTITUTE - LE COR,MA,02142-1221,Proprietary  ,24,56,80,366,805,1171
03066700,AILANO SCHOOL OF COSMETOLOGY            ,MA,02303-4740,Proprietary  ,4,12,16,25,65,90
03104000,SHAWSHEEN ADULT TECHNICAL INSTITUTE     ,MA,01821-5499,Public       ,0,1,1,12,66,78
03115200,MOTORING TECHNICAL TRAINING INST        ,MA,02771-5933,Proprietary  ,14,34,48,124,236,360
03120800,KAY HARVEY HAIRDRESSING ACADEMY         ,MA,01089-2701,Proprietary  ,4,15,19,21,73,94
03130500,URBAN COLLEGE OF BOSTON                 ,MA,02111-1093,Private      ,12,49,61,49,703,752
03194300,BOSTON GRAD SCH OF PSYCHOANALYSIS       ,MA,02446-4602,Private      ,0,6,6,0,90,90
03196300,LINCOLN TECHNICAL INSTITUTE             ,MA,02145-1102,Proprietary  ,27,87,114,303,856,1159
03196302,LINCOLN TECHNICAL INSTITUTE             ,MA,01852-5119,Proprietary  ,10,82,92,259,713,972
03205400,JOLIE HAIR & BEAUTY ACADEMY             ,MA,01056-2769,Proprietary  ,16,48,64,65,191,256
03232302,LINCOLN TECHNICAL INSTITUTE             ,MA,02401-1818,Proprietary  ,5,11,16,121,420,541
03235300,MASSACHUSETTS SCHOOL OF LAW             ,MA,01810-1094,Private      ,0,12,12,9,712,721
03240300,TONI & GUY HAIRDRESSING ACADEMY         ,MA,01605-2213,Proprietary  ,4,6,10,35,47,82
03248300,BOSTON BAPTIST COLLEGE                  ,MA,02136-4000,Private      ,1,4,5,138,77,215
03316400,FUNERAL INSTITUTE OF THE NORTHEAST      ,MA,02062-4766,Proprietary  ,2,6,8,25,87,112
03504300,NATL GRAD SCH OF QUALITY SYSTM MGMT     ,MA,02540-0000,Private      ,0,35,35,2,69,71
03570500,ZION BIBLE COLLEGE                      ,MA,01835-0000,Private      ,3,7,10,191,113,304
03763300,MEDICAL PROFESSIONAL INSTITUTE          ,MA,02148-8143,Proprietary  ,1,18,19,22,193,215
03859300,E.I.N.E.                                ,MA,01876-4709,Proprietary  ,1,7,8,3,73,76
03946300,FRANKLIN W. OLIN COLLEGE OF ENGINEERING ,MA,02492-1200,Private      ,1,0,1,401,9,410
03965300,NEW ENGLAND COLLEGE OF FINANCE          ,MA,02110-1605,Proprietary  ,6,136,142,53,664,717
04039300,SULLIVAN AND COGLIANO TRAINING CENTER   ,MA,02301-4921,Proprietary  ,20,416,436,94,1955,2049
04116900,DIGRIGOLI SCHOOL OF COSMETOLOGY         ,MA,01089-4623,Proprietary  ,2,6,8,35,75,110
04122000,TRI COUNTY REGIONAL VOCATIONAL TECHNICAL,MA,02038-0000,Public       ,0,3,3,6,40,46
04128000,MILLENNIUM TRAINING INSTITUTE           ,MA,01801-6386,Proprietary  ,4,41,45,15,181,196
04128900,CENTRAL MASS SCHOOL OF MASSAGE AND THERA,MA,01562-1712,Proprietary  ,0,5,5,3,40,43
04153200,SOUTHERN WORCESTER COUNTY REGIONAL VOC S,MA,01507-1331,Public       ,0,3,3,4,37,41
00324204,CARNEGIE MELLON UNIVERSITY - QATAR      ,FC,00000-0000,Private      ,0,1,1,2,4,6
00324206,CARNEGIE MELLON UNIVERSITY THE HEINZ COL,FC,00000-0000,Private      ,0,0,0,0,1,1
00337112,TEMPLE UNIVERSITY - JAPAN               ,FC,00000-0000,Private      ,0,0,0,63,48,111
00369101,MIDDLEBURY COLLEGE - FRANCE             ,FC,00000-0000,Private      ,0,0,0,5,8,13
00369102,MIDDLEBURY COLLEGE - GERMANY            ,FC,00000-0000,Private      ,0,0,0,3,5,8
00369103,MIDDLEBURY COLLEGE - ITALY              ,FC,00000-0000,Private      ,0,0,0,5,4,9
00369104,MIDDLEBURY COLLEGE - SPAIN              ,FC,00000-0000,Private      ,0,0,0,11,20,31
00369105,MIDDLEBURY COLLEGE - RUSSIA             ,FC,00000-0000,Private      ,0,0,0,1,5,6
00369107,MIDDLEBURY COLLEGE - BREAD LOAF SCHOOL/E,FC,00000-0000,Private      ,0,0,0,0,1,1
00401000,INSTITUT INTERNAT'L D'ETUDES FRANCA     ,FC,00000-0000,Public       ,0,0,0,1,4,5
00401200,HEBREW UNIVERSITY OF JERUSALEM (THE)    ,FC,00000-0000,Public       ,0,0,0,41,120,161
00403000,UNIVERSITY OF CAMBRIDGE                 ,FC,00000-0000,Public       ,0,3,3,2,101,103
00503400,AMERICAN UNIVERSITY OF CAIRO            ,FC,00000-0000,Private      ,3,6,9,82,257,339
00667100,KATHOLIEKE UNIVERSITEIT LEUVEN          ,FC,00000-0000,Private      ,0,1,1,0,45,45
00669100,UNIVERSITY OF CAMBRIDGE - PEMBROKE      ,FC,00000-0000,Public       ,0,0,0,2,13,15
00669200,UNIVERSITY OF LEEDS                     ,FC,00000-0000,Public       ,0,2,2,8,118,126
00669300,UNIV OF LONDON-LONDON SCHOOL ECON       ,FC,00000-0000,Public       ,1,5,6,17,495,512
00669400,SCH OF ORIENTAL & AFRICAN STUDIES       ,FC,00000-0000,Public       ,0,1,1,11,181,192
00669500,UNIV OF LONDON-UNIVERSITY COLLEGE       ,FC,00000-0000,Public       ,0,1,1,30,454,484
00669600,UNIV OF LONDON-SCH ADVANCED STUDY       ,FC,00000-0000,Public       ,1,0,1,1,23,24
00669700,"QUEEN MARY, UNIVERSITY OF LONDON        ",FC,00000-0000,Public       ,2,1,3,30,157,187
00669900,UNIVERSITY OF SUSSEX                    ,FC,00000-0000,Public       ,0,0,0,14,97,111
00670000,"UNIVERSITY OF YORK, THE                 ",FC,00000-0000,Public       ,0,3,3,11,131,142
00670400,UNIVERSITY COLLEGE CORK                 ,FC,00000-0000,Public       ,0,3,3,10,71,81
00671300,UPPSALA UNIVERSITY                      ,FC,00000-0000,Public       ,0,0,0,2,47,49
00671500,UNIVERSITY OF GENEVA                    ,FC,00000-0000,Public       ,0,0,0,3,84,87
00683900,UNIVERSITY OF EDINBURGH                 ,FC,00000-0000,Public       ,2,6,8,140,671,811
00684200,UNIVERSITY OF DUBLIN TRINITY COLLEG     ,FC,00000-0000,Public       ,1,4,5,43,195,238
00685000,UNIVERSITY OF CAMBRIDGE - DOWNING C     ,FC,00000-0000,Public       ,0,0,0,0,8,8
00763200,UNIVERSITY OF BRISTOL                   ,FC,00000-0000,Public       ,0,0,0,16,98,114
00768100,COLLEGE OF EUROPE                       ,FC,00000-0000,Private      ,1,0,1,1,9,10
00770500,ROYAL COLLEGE OF SURGEONS IN IRELAN     ,FC,00000-0000,Private      ,0,1,1,9,65,74
00788100,AMERICAN UNIVERSITY OF PARIS            ,FC,00000-0000,Private      ,3,2,5,246,280,526
00837100,AMERICAN UNIVERSITY OF BEIRUT           ,FC,00000-0000,Private      ,3,3,6,97,112,209
00837300,TEL-AVIV UNIVERSITY                     ,FC,00000-0000,Public       ,1,0,1,11,69,80
00837600,VRIJE UNIVERSITEIT AMSTERDAM            ,FC,00000-0000,Public       ,0,1,1,3,38,41
00837700,UNIVERSITEIT VAN AMSTERDAM(UNIVERSI     ,FC,00000-0000,Public       ,0,1,1,12,142,154
00838000,UNIVERSITY OF WARWICK                   ,FC,00000-0000,Public       ,0,2,2,9,78,87
00838300,UNIVERSITY OF GLASGOW                   ,FC,00000-0000,Public       ,0,2,2,39,391,430
00839300,UNIVERSITY OF OSLO                      ,FC,00000-0000,Public       ,0,2,2,3,21,24
00839400,UNIVERSITY OF OXFORD                    ,FC,00000-0000,Public       ,1,5,6,20,370,390
00839800,UNIVERSITY OF SHEFFIELD (THE)           ,FC,00000-0000,Public       ,0,0,0,8,102,110
00839900,UNIVERSITY OF SOUTHAMPTON               ,FC,00000-0000,Public       ,0,1,1,9,47,56
00845200,ABERYSTWYTH UNIVERSITY                  ,FC,00000-0000,Public       ,0,1,1,10,33,43
00845800,LOUGHBOROUGH UNIVERSITY                 ,FC,00000-0000,Public       ,0,1,1,2,12,14
00846000,UNIVERSITY OF NEWCASTLE UPON TYNE       ,FC,00000-0000,Public       ,0,1,1,14,94,108
00846100,UNIVERSITY OF SAINT ANDREWS             ,FC,00000-0000,Public       ,0,6,6,213,209,422
00850500,UNIVERSITY OF MELBOURNE                 ,FC,00000-0000,Public       ,0,14,14,18,181,199
00858600,SWANSEA UNIVERSITY                      ,FC,00000-0000,Public       ,0,0,0,13,30,43
00858700,UNIVERSITY OF DURHAM                    ,FC,00000-0000,Public       ,0,1,1,12,202,214
00866500,UNIVERSITY OF KENT AT CANTERBURY (THE)  ,FC,00000-0000,Public       ,0,2,2,19,146,165
00867000,UNIVERSITY OF NEW SOUTH WALES           ,FC,00000-0000,Public       ,0,10,10,10,131,141
00868700,UNIVERSITY OF ESSEX                     ,FC,00000-0000,Public       ,0,1,1,15,85,100
00869300,CITY UNIVERSITY                         ,FC,00000-0000,Public       ,0,3,3,15,192,207
00890800,THE UNIVERSITY OF BIRMINGHAM            ,FC,00000-0000,Public       ,0,0,0,10,105,115
00891000,UNIVERSITY OF HULL                      ,FC,00000-0000,Public       ,0,0,0,6,17,23
00892000,UNIVERSITY OF NOTTINGHAM                ,FC,00000-0000,Public       ,0,1,1,6,123,129
00900600,UNIVERSITY OF SALFORD (THE)             ,FC,00000-0000,Public       ,0,0,0,1,22,23
00908400,"UNIV OF LONDON, BIRKBECK                ",FC,00000-0000,Public       ,0,0,0,2,104,106
00908500,UNIV OF LONDON KING'S COLLEGE           ,FC,00000-0000,Public       ,2,3,5,38,351,389
00908600,UNIVERSITY OF LONDON - ROYAL HOLLOWAY   ,FC,00000-0000,Public       ,0,1,1,25,83,108
00914300,BAR-ILAN UNIVERSITY                     ,FC,00000-0000,Private      ,0,1,1,11,20,31
00924700,ARCHITECTURAL ASSOC SCH OF ARCHITEC     ,FC,00000-0000,Private      ,0,0,0,0,27,27
00924900,UNIVERSITY OF LIVERPOOL                 ,FC,00000-0000,Public       ,1,3,4,17,75,92
00936800,UNIVERSITY OF ABERDEEN                  ,FC,00000-0000,Public       ,1,1,2,52,122,174
00942300,ROYAL COLLEGE OF ART                    ,FC,00000-0000,Public       ,0,0,0,6,48,54
00942800,TECHNION-ISRAEL INST OF TECHLGY         ,FC,00000-0000,Public       ,0,1,1,1,89,90
00944200,UNIVERSITY OF EXETER                    ,FC,00000-0000,Public       ,0,0,0,8,83,91
00944400,UNIVERSITY OF LANCASTER                 ,FC,00000-0000,Public       ,0,1,1,5,36,41
00963400,UNIVERSITY OF OXFORD ST CATHERINE'S     ,FC,00000-0000,Public       ,0,0,0,0,6,6
00980800,UNIVERSITY OF STRATHCLYDE               ,FC,00000-0000,Public       ,0,0,0,1,38,39
00986000,UNIVERSITY OF SURREY                    ,FC,00000-0000,Public       ,0,0,0,5,24,29
00990600,PONTIFICAL NORTH AMERICAN COLLEGE       ,FC,00000-0000,Private      ,0,0,0,1,10,11
00992700,UNIVERSITY OF CAMBRIDGE - FITZWILLI     ,FC,00000-0000,Public       ,0,1,1,0,5,5
01006700,LUND UNIVERSITY                         ,FC,00000-0000,Public       ,0,2,2,1,100,101
01008400,UNIVERSITY OF CAPE TOWN                 ,FC,00000-0000,Private      ,0,14,14,10,90,100
01008700,UNIVERSITY OF OXFORD ST PETER'S COL     ,FC,00000-0000,Public       ,0,0,0,1,4,5
01008800,UNIVERSITY OF OXFORD - CORPUS CHRIS     ,FC,00000-0000,Public       ,0,0,0,0,6,6
01008900,CENTRAL SCHOOL OF SPEECH AND DRAMA      ,FC,00000-0000,Private      ,0,1,1,9,55,64
01009000,UNIVERSITY OF OXFORD - BALLIOL COLL     ,FC,00000-0000,Public       ,0,0,0,1,19,20
01014300,UNIVERSITY OF READING                   ,FC,00000-0000,Public       ,0,0,0,6,39,45
01015700,CARDIFF UNIVERSITY                      ,FC,00000-0000,Public       ,0,2,2,15,65,80
01015900,PONTIFICIA UNIVERSITA GREGORIANA        ,FC,00000-0000,Private      ,0,0,0,0,4,4
01016000,CG JUNG INST                            ,FC,00000-0000,Private      ,0,0,0,0,3,3
01018800,UNIVERSITY COLLEGE DUBLIN               ,FC,00000-0000,Public       ,0,4,4,10,201,211
01019000,UNIVERSITY OF CAMBRIDGE CHURCHILL C     ,FC,00000-0000,Public       ,0,0,0,0,10,10
01022800,UNIVERSITY OF STIRLING                  ,FC,00000-0000,Public       ,2,1,3,13,45,58
01033200,UNIVERSITY OF CAMBRIDGE - CLARE COL     ,FC,00000-0000,Public       ,1,0,1,2,8,10
01045600,UNIVERSITY OF HAIFA                     ,FC,00000-0000,Public       ,0,0,0,6,13,19
01047200,INST EUROPEEN OPEEN D'ADMINISTRATIO     ,FC,00000-0000,Private      ,0,2,2,0,75,75
01049300,CRANFIELD UNIVERSITY                    ,FC,00000-0000,Public       ,0,2,2,0,25,25
01052000,TRINITY LABAN CONSERVATOIRE OF MUSIC AND,FC,00000-0000,Public       ,1,0,1,5,8,13
01052001,LABAN CENTER FOR MOVEMENT & DANCE       ,FC,00000-0000,Public       ,0,0,0,3,12,15
01052500,UNIVERSITY OF HERTFORDSHIRE             ,FC,00000-0000,Public       ,0,0,0,17,20,37
01057400,LONDON INTRNTL FILM SCHOOL              ,FC,00000-0000,Private      ,0,2,2,4,37,41
01058600,INSTITUTE OF SOCIAL STUDIES             ,FC,00000-0000,Private      ,0,0,0,0,3,3
01058800,AUSTRALIAN NATIONAL UNIVERSITY          ,FC,00000-0000,Public       ,0,4,4,9,54,63
01058900,BANGOR UNIVERSITY                       ,FC,00000-0000,Public       ,0,1,1,6,25,31
01059400,"RICHMOND, THE AMERICAN INT UNI IN LONDON",FC,00000-0000,Private      ,4,2,6,318,73,391
01059900,INST D'ETUDES POLITIQUES DE PARIS       ,FC,00000-0000,Public       ,0,1,1,4,68,72
01068100,MACQUARIE UNIVERSITY                    ,FC,00000-0000,Public       ,0,5,5,11,89,100
01069200,UNIVERSITY OF QUEENSLAND (THE)          ,FC,00000-0000,Public       ,0,37,37,22,219,241
01078900,UNIVERSITY OF OXFORD - WORCESTER CO     ,FC,00000-0000,Public       ,0,0,0,0,8,8
01079200,CITY AND GUILDS OF LONDON INSTITUTE     ,FC,00000-0000,Private      ,0,0,0,0,5,5
01079700,"NATIONAL UNIVERSITY OF IRELAND, MAY     ",FC,00000-0000,Public       ,0,0,0,7,13,20
01080300,SEMMELWEIS UNIVERSITY OF BUDAPEST       ,FC,00000-0000,Public       ,0,0,0,4,24,28
01081600,KINGSTON UNIVERSITY                     ,FC,00000-0000,Public       ,1,2,3,33,138,171
01083800,UNIVERSITITY OF BERGEN (UOB)            ,FC,00000-0000,Public       ,0,1,1,0,9,9
01086400,UNIV OF DUNDEE                          ,FC,00000-0000,Public       ,0,2,2,10,50,60
01086600,UNIVERSITY OF OXFORD - MAGDALEN COLLEGE ,FC,00000-0000,Public       ,0,0,0,2,17,19
01086700,UNIVERSITY OF OXFORD ST JOHN'S COLL     ,FC,00000-0000,Public       ,0,0,0,2,10,12
01091400,MONASH UNIVERSITY                       ,FC,00000-0000,Public       ,3,6,9,12,56,68
01091500,UNIV OF EAST ANGLIA                     ,FC,00000-0000,Public       ,0,0,0,17,64,81
01094200,UNIVERSITY OF OXFORD - ST HUGH'S CO     ,FC,00000-0000,Public       ,0,0,0,1,4,5
01097700,UNIVERSIDAD CENTRAL DEL ESTE            ,FC,00000-0000,Private      ,7,53,60,159,1040,1199
01098000,SOMERVILLE COLLEGE                      ,FC,00000-0000,Public       ,0,0,0,1,2,3
01099900,UNIV OF OXFORD - WADHAM COLLEGE         ,FC,00000-0000,Public       ,0,0,0,1,4,5
01104400,PONTIFICIA UNIVERSITA SAN TOMMASO       ,FC,00000-0000,Private      ,0,2,2,5,22,27
01105300,UNIVERSITY OF OXFORD - ST HILDA'S C     ,FC,00000-0000,Public       ,0,0,0,0,5,5
01105400,UNIVERSITY OF OXFORD - ST ANNE'S CO     ,FC,00000-0000,Public       ,0,0,0,0,7,7
01105500,UNIV OF OXFORD - LADY MARGARET HALL     ,FC,00000-0000,Public       ,0,0,0,0,7,7
01105600,UNIVERSITY OF OXFORD - UNIVERSITY C     ,FC,00000-0000,Public       ,0,0,0,1,12,13
01105700,UNIVERSITY OF OXFORD - TRINITY COLL     ,FC,00000-0000,Public       ,0,0,0,1,11,12
01105800,UNIVERSITY OF OXFORD-ST EDMUND HALL     ,FC,00000-0000,Public       ,0,0,0,1,9,10
01105900,UNIVERSITY OF OXFORD ST ANTONY'S CO     ,FC,00000-0000,Public       ,0,0,0,0,33,33
01106000,UNIVERSITY OF OXFORD - QUEEN'S COLL     ,FC,00000-0000,Public       ,0,1,1,1,13,14
01106100,UNIVERSITY OF OXFORD - PEMBROKE COL     ,FC,00000-0000,Public       ,0,0,0,0,6,6
01106200,UNIVERSITY OF OXFORD - ORIEL COLLEG     ,FC,00000-0000,Public       ,0,0,0,1,9,10
01106300,UNIVERSITY OF OXFORD - NUFFIELD COL     ,FC,00000-0000,Public       ,0,0,0,0,2,2
01106400,UNIVERSITY OF OXFORD - NEW COLLEGE      ,FC,00000-0000,Public       ,0,0,0,0,10,10
01106500,UNIVERSITY OF OXFORD MERTON COLLEGE     ,FC,00000-0000,Public       ,0,0,0,0,16,16
01106600,UNIVERSITY OF OXFORD - LINCOLN COLL     ,FC,00000-0000,Public       ,0,0,0,0,15,15
01106700,UNIVERSITY OF OXFORD - KEBLE COLLEG     ,FC,00000-0000,Public       ,0,0,0,0,7,7
01106800,UNIVERSITY OF OXFORD - JESUS COLLEG     ,FC,00000-0000,Public       ,0,0,0,0,11,11
01106900,UNIVERSITY OF OXFORD - HERTFORD COL     ,FC,00000-0000,Public       ,0,0,0,0,10,10
01107000,UNIVERSITY OF OXFORD EXETER COLLEGE     ,FC,00000-0000,Public       ,0,0,0,2,17,19
01107100,UNIV OF OXFORD - CHRIST CHURCH          ,FC,00000-0000,Public       ,0,0,0,0,17,17
01107200,UNIVERSITY OF OXFORD - BRASENOSE CO     ,FC,00000-0000,Public       ,0,0,0,1,10,11
01109100,FLINDERS UNIVERSITY OF S AUSTRALIA      ,FC,00000-0000,Public       ,0,2,2,3,21,24
01109400,UNIVERSITY OF WESTERN AUSTRALIA (THE)   ,FC,00000-0000,Public       ,2,0,2,6,22,28
01122600,AARHUS UNIVERSITY                       ,FC,00000-0000,Public       ,0,0,0,0,6,6
01156700,"IMPERIAL COLLEGE OF SCIENCE, TECHNOLOGY ",FC,00000-0000,Public       ,0,0,0,9,85,94
01167900,UNIVERSITY OF BATH                      ,FC,00000-0000,Public       ,0,2,2,5,33,38
01168300,FRANKLIN COLLEGE  SWITZERLAND           ,FC,00000-0000,Private      ,2,1,3,343,12,355
01175800,UNIV OF CAMBRIDGE - PETERHOUSE          ,FC,00000-0000,Public       ,0,0,0,1,8,9
01176400,ROYAL ACADEMY OF MUSIC                  ,FC,00000-0000,Public       ,0,0,0,10,19,29
01176500,GOLDSMITHS' COLLEGE-UNIV OF LONDON      ,FC,00000-0000,Public       ,0,2,2,32,177,209
01176600,UNIV OF LONDON - INST OF EDUC           ,FC,00000-0000,Public       ,0,0,0,2,39,41
01178000,BRUNEL UNIVERSITY                       ,FC,00000-0000,Public       ,0,0,0,4,40,44
01183800,UNIVERSITY OF OXFORD - MANSFIELD CO     ,FC,00000-0000,Public       ,0,0,0,0,2,2
01207500,UNIVERSITY CAMBRIDGE - TRINITY COLL     ,FC,00000-0000,Public       ,0,0,0,3,11,14
01207800,VICTORIA UNIV OF WELLINGTON             ,FC,00000-0000,Public       ,4,7,11,16,57,73
01209600,ECOLE HåTELIERE DE LAUSANNE             ,FC,00000-0000,Private      ,0,0,0,0,9,9
01210100,UNIVERSITY OF CAMBRIDGE - GIRTON CO     ,FC,00000-0000,Public       ,0,0,0,2,6,8
01213600,VICTORIA UNIV OF MANCHESTER (THE)       ,FC,00000-0000,Public       ,0,3,3,22,171,193
01219800,UNIVERSITY OF BRADFORD                  ,FC,00000-0000,Public       ,0,0,0,1,30,31
01220100,UNIVERSITY OF OXFORD - REGENT'S PAR     ,FC,00000-0000,Public       ,0,0,0,0,6,6
01220600,JAMES COOK UNIVERSITY                   ,FC,00000-0000,Public       ,2,4,6,37,87,124
01221500,BIRMINGHAM CITY UNIVERSITY              ,FC,00000-0000,Public       ,0,0,0,4,12,16
01222300,JAGIELLONIAN UNIVERSITY COLLEGIUM M     ,FC,00000-0000,Public       ,0,2,2,2,52,54
01222500,UNIVERSITY OF SZEGED FACULTY OF MEDICINE,FC,00000-0000,Public       ,0,0,0,1,8,9
01225800,ASTON UNIVERSITY                        ,FC,00000-0000,Public       ,0,0,0,3,14,17
01227500,UNIVERSITY OF OXFORD - WOLFSON COLL     ,FC,00000-0000,Public       ,0,0,0,0,27,27
01230200,GONVILLE & CAIUS COLLEGE                ,FC,00000-0000,Public       ,0,0,0,1,4,5
01233300,UNIV OF THE ARTS LONDON- CAMBERWELL COLL,FC,00000-0000,Public       ,0,0,0,10,15,25
01233500,ROYAL COLLEGE OF MUSIC                  ,FC,00000-0000,Public       ,0,0,0,6,23,29
01234100,UNIVERSITY OF WALES - ST DAVID'S UN     ,FC,00000-0000,Public       ,0,2,2,4,22,26
01236000,EDINBURGH COLLEGE OF ART                ,FC,00000-0000,Public       ,1,1,2,11,51,62
01242100,UNIV OF AUCKLAND                        ,FC,00000-0000,Public       ,1,10,11,21,99,120
01253900,UNIVERSITY OF THE ARTS LONDON IDO - CENT,FC,00000-0000,Public       ,1,1,2,45,82,127
01254000,UNIVERSIDAD DE NAVARRA                  ,FC,00000-0000,Private      ,0,0,0,5,16,21
01276500,UNIVERSITY OF OXFORD - LINACRE COLL     ,FC,00000-0000,Public       ,0,0,0,0,17,17
01276600,"NATIONAL UNIVERSITY IRELAND, GALWAY     ",FC,00000-0000,Public       ,1,3,4,28,80,108
01280200,PONTIFICIA UNIV CATOLICA MAD Y MAES     ,FC,00000-0000,Private      ,15,14,29,151,205,356
01281100,INST TECNOLOGICO DE SANTO DOMINGO       ,FC,00000-0000,Private      ,3,0,3,37,164,201
01283900,UNIVERSITY OF CAMBRIDGE - SAINT JOH     ,FC,00000-0000,Public       ,0,0,0,0,16,16
01286200,MOUNTVIEW ACADEMY OF THEATRE ARTS       ,FC,00000-0000,Private      ,0,0,0,1,5,6
01297800,UNIVERSITY OF HUDDERSFIELD (THE)        ,FC,00000-0000,Public       ,0,0,0,3,9,12
01315300,MASSEY UNIVERSITY                       ,FC,00000-0000,Public       ,0,2,2,8,104,112
01322500,COLLEGE OF LAW                          ,FC,00000-0000,Private      ,0,1,1,1,32,33
02052400,DARWIN COLLEGE                          ,FC,00000-0000,Public       ,0,0,0,0,15,15
02082400,UNIVERSITY OF CAMBRIDGE - QUEEN'S C     ,FC,00000-0000,Public       ,0,0,0,1,14,15
02083400,UNIVERSITY OF CAMBRIDGE - WOLFSON C     ,FC,00000-0000,Public       ,0,1,1,0,14,14
02087400,UNIVERSITY OF CAMBRIDGE - NEWNHAM C     ,FC,00000-0000,Public       ,1,0,1,2,10,12
02087900,OXFORD BROOKES UNIVERSITY               ,FC,00000-0000,Public       ,0,1,1,20,64,84
02094100,BEN-GURION UNIV                         ,FC,00000-0000,Public       ,0,1,1,3,154,157
02094400,UNIV OF CAMBRIDGE - ST EDMUND'S HOU     ,FC,00000-0000,Public       ,0,0,0,0,9,9
02095500,LONDON BUS SCHOOL                       ,FC,00000-0000,Private      ,0,2,2,1,158,159
02098700,FATIMA COLLEGE OF MEDICINE              ,FC,00000-0000,Private      ,0,4,4,8,89,97
02101900,ROEHAMPTON UNIVERSITY                   ,FC,00000-0000,Public       ,0,0,0,10,70,80
02108600,LONDON ACADEMY OF MUSIC & DRAMATIC      ,FC,00000-0000,Private      ,0,0,0,9,20,29
02115900,UNIVERSITY OF PORTSMOUTH                ,FC,00000-0000,Public       ,0,0,0,4,20,24
02116700,UNIVERSITY OF CAMBRIDGE - LUCY CAVE     ,FC,00000-0000,Public       ,0,0,0,0,10,10
02120000,UNIV OF LONDON - COURTALD INST OF A     ,FC,00000-0000,Public       ,0,0,0,0,38,38
02133400,UNIVERSITY OF CAMBRIDGE - SIDNEY SU     ,FC,00000-0000,Public       ,0,0,0,2,8,10
02142000,UNIVERSITY OF CAMBRIDGE - HOMERTON      ,FC,00000-0000,Public       ,0,0,0,0,7,7
02149700,UNIVERSITY OF WINCHESTER (THE)          ,FC,00000-0000,Public       ,0,0,0,6,9,15
02156800,UNIV OF OTAGO                           ,FC,00000-0000,Public       ,0,8,8,8,51,59
02162300,"IESE BUSINESS SCH, UNIV OF NAVARRA      ",FC,00000-0000,Private      ,0,0,0,5,79,84
02167400,UNIVERSITY OF CAMBRIDGE - CORPUS CH     ,FC,00000-0000,Public       ,0,0,0,0,7,7
02175700,OHR SOMAYACH INSTITUTIONS               ,FC,00000-0000,Private      ,0,0,0,0,4,4
02177700,KING'S COLLEGE- UNIV OF CAMBRIDGE       ,FC,00000-0000,Public       ,0,1,1,6,31,37
02180500,MIDDLESEX UNIVERSITY                    ,FC,00000-0000,Public       ,0,1,1,21,80,101
02181000,UNIVERSITY OF SOUTH AUSTRALIA           ,FC,00000-0000,Public       ,1,2,3,3,16,19
02183500,UNIV OF OXFORD - WYCLIFFE HALL          ,FC,00000-0000,Public       ,0,1,1,0,2,2
02186000,UNIVERSITY OF CAMBRIDGE - MAGDALENE     ,FC,00000-0000,Public       ,0,0,0,1,3,4
02186100,UNIVERSITY OF CAMBRIDGE - EMMANUEL      ,FC,00000-0000,Public       ,0,0,0,0,7,7
02189600,UNIVERSITY OF GRONINGEN                 ,FC,00000-0000,Public       ,0,0,0,3,24,27
02194800,UNIVERSITY OF THE WEST OF ENGLAND -     ,FC,00000-0000,Public       ,0,0,0,6,19,25
02195100,UNIV OF WESTMINSTER                     ,FC,00000-0000,Public       ,0,1,1,27,121,148
02196700,GUILDHALL SCHOOL OF MUSIC & DRAMA       ,FC,00000-0000,Public       ,0,0,0,8,14,22
02207300,UNIVERSITY OF CAMBRIDGE - CHRIST'S      ,FC,00000-0000,Public       ,0,0,0,1,4,5
02207400,CHINESE UNIVERSITY OF HONG KONG (THE)   ,FC,00000-0000,Public       ,0,1,1,10,43,53
02209500,UNIVERSITEIT UTRECHT                    ,FC,00000-0000,Public       ,1,1,2,8,71,79
02210000,UNIV OF LONDON - LONDON SCHOOL OF H     ,FC,00000-0000,Public       ,1,0,1,3,43,46
02212300,UNIVERSITY OF CAMBRIDGE - ROBINSON      ,FC,00000-0000,Public       ,0,0,0,0,3,3
02225300,UNIV OF CANTERBURY                      ,FC,00000-0000,Public       ,1,4,5,12,48,60
02229100,UNIVERSITY OF LEICESTER                 ,FC,00000-0000,Public       ,0,3,3,8,91,99
02229600,SACKLER SCHOOL OF MEDICINE              ,FC,00000-0000,Public       ,0,0,0,0,181,181
02232100,UNIVERSITY OF CAMBRIDGE                 ,FC,00000-0000,Public       ,0,1,1,3,27,30
02233300,"ST GEORGE'S UNIVERSITY, SCHOOL OF MEDICI",FC,00000-0000,Proprietary  ,1,31,32,10,3122,3132
02235300,LONDON METROPOLITAN UNIVERSITY          ,FC,00000-0000,Public       ,0,0,0,26,175,201
02244400,AMERICAN UNIV OF THE CARIBBEAN          ,FC,00000-0000,Proprietary  ,0,63,63,10,1395,1405
02257100,COVENTRY UNIVERSITY                     ,FC,00000-0000,Public       ,0,0,0,1,3,4
02266600,UNIVERSITY OF LONDON - SAINT GEORGE     ,FC,00000-0000,Public       ,1,0,1,2,18,20
02271700,UNIVERSITY OF CAMBRIDGE - CLARE HAL     ,FC,00000-0000,Public       ,0,0,0,0,12,12
02271800,UNIV OF OXFORD - CAMPION HALL           ,FC,00000-0000,Public       ,0,0,0,0,3,3
02271900,UNIVERSITY OF OXFORD - BLACKFRIARS      ,FC,00000-0000,Public       ,0,0,0,0,3,3
02272100,UNIV OF OXFORD - GREYFRIARS             ,FC,00000-0000,Public       ,0,0,0,0,1,1
02272200,UNIV OF CAMBRIDGE - NEW HALL            ,FC,00000-0000,Public       ,0,1,1,0,4,4
02273600,QUEEN'S UNIV OF BELFAST (THE)           ,FC,00000-0000,Public       ,0,0,0,16,81,97
02273900,HERIOT WATT UNIVERSITY                  ,FC,00000-0000,Public       ,0,0,0,6,37,43
02276700,NYENRODE BUSINESS UNIVERSITEIT          ,FC,00000-0000,Private      ,0,0,0,0,4,4
02293400,ECOLE DES HAUTES ETUDES COMERCIALS      ,FC,00000-0000,Public       ,0,4,4,0,57,57
02296300,UNIVERSITY OF CAMBRIDGE - JESUS COL     ,FC,00000-0000,Public       ,0,0,0,0,10,10
02310500,DE MONTFORT UNIVERSITY                  ,FC,00000-0000,Public       ,0,0,0,1,13,14
02320500,ROYAL NORTHERN COLLEGE OF MUSIC         ,FC,00000-0000,Public       ,0,0,0,2,6,8
02335100,UNIV OF CAMBRIDGE - TRINITY HALL        ,FC,00000-0000,Public       ,0,1,1,1,13,14
02338900,UNIVERSITY  FOR THE CREATIVE ARTS       ,FC,00000-0000,Public       ,0,0,0,1,2,3
02338903,KENT INSTITUTE OF ART & DESIGN          ,FC,00000-0000,Public       ,0,0,0,2,4,6
02351800,UNIVERSIDAD IBEROAMERICANA (UNIBE       ,FC,00000-0000,Private      ,6,15,21,144,1140,1284
02355200,ECOLE SUPERIEURE DE CUISINE FRANCAISE-FE,FC,00000-0000,Public       ,0,2,2,2,36,38
02363000,GSA CONSERVATOIRE                       ,FC,00000-0000,Private      ,0,0,0,1,3,4
02496700,NATIONAL FILM & TV SCHOOL               ,FC,00000-0000,Public       ,0,0,0,0,1,1
02502600,PECSI ORVOSTUDOMANYI EGYETEM (PECS      ,FC,00000-0000,Public       ,0,2,2,2,21,23
02545700,GLASGOW SCHOOL OF ART                   ,FC,00000-0000,Public       ,0,0,0,14,32,46
02561600,SOUTHAMPTON SOLENT UNIVERSITY           ,FC,00000-0000,Public       ,0,0,0,0,4,4
02579600,MURDOCH UNIVERSITY                      ,FC,00000-0000,Public       ,0,13,13,6,69,75
02588000,UNIVERSITY OF ULSTER                    ,FC,00000-0000,Public       ,0,0,0,4,17,21
02591800,CURTIN UNIVERSITY OF TECHNOLOGY         ,FC,00000-0000,Public       ,0,2,2,4,16,20
02592300,MILLTOWN INST OF THEOLOGY & PHILOSO     ,FC,00000-0000,Private      ,0,0,0,1,1,2
02604300,AALBORG UNIVERSITY                      ,FC,00000-0000,Public       ,0,1,1,2,14,16
02611500,HELSINKI SCH OF ECONOMICS & BUS ADM     ,FC,00000-0000,Public       ,0,0,0,1,6,7
02611600,ECOL NATIONAL DES PONTS ET CHAUSSEE     ,FC,00000-0000,Public       ,0,0,0,4,7,11
02611700,DUBLIN CITY UNIVERSITY                  ,FC,00000-0000,Public       ,0,2,2,6,37,43
02622500,DENMARKS TEKNISKE UNIVERSITET           ,FC,00000-0000,Public       ,0,0,0,0,7,7
02623200,UNIVERSITY OF NEWCASTLE (THE)           ,FC,00000-0000,Public       ,1,1,2,12,30,42
03012700,UNIVERSITY OF BUCKINGHAM                ,FC,00000-0000,Private      ,0,0,0,8,14,22
03029400,KEELE UNIVERSITY                        ,FC,00000-0000,Public       ,0,0,0,4,12,16
03029500,NORTHUMBRIA UNIVERSITY                  ,FC,00000-0000,Public       ,0,0,0,4,31,35
03029800,NORGES HANDELSHOYSKOLE                  ,FC,00000-0000,Public       ,0,1,1,1,16,17
03033300,MANCHESTER METROPOLITAN UNIV            ,FC,00000-0000,Public       ,0,1,1,14,44,58
03045000,UNIVERSITY OF EAST LONDON               ,FC,00000-0000,Public       ,2,1,3,8,49,57
03050100,STUDIO ART CENTERS INTERNATIONAL        ,FC,00000-0000,Private      ,0,2,2,20,39,59
03061000,CHALMERS TEKNISKA HOGSKOLA AB           ,FC,00000-0000,Private      ,0,0,0,1,6,7
03066800,PONTIFICIO ATENEO DELLA SANTA CROCE     ,FC,00000-0000,Private      ,0,1,1,0,13,13
03067200,UNIVERSITY OF SYDNEY                    ,FC,00000-0000,Public       ,6,27,33,30,279,309
03073800,UNIV OF DEBRECEN MED & HEALTH SCI       ,FC,00000-0000,Public       ,0,1,1,4,27,31
03080300,SHEFFIELD HALLAM UNIVERSITY             ,FC,00000-0000,Public       ,0,0,0,1,11,12
03084300,UNIVERSITY OF LIMERICK                  ,FC,00000-0000,Public       ,1,0,1,11,37,48
03088700,ROYAL SCOTTISH ACAD MUSIC & DRAMA       ,FC,00000-0000,Public       ,0,1,1,16,20,36
03091400,UNIVERSITY OF WOLLONGONG                ,FC,00000-0000,Public       ,0,4,4,6,32,38
03091500,UNIVERSITY OF CANBERRA                  ,FC,00000-0000,Public       ,1,1,2,6,15,21
03091700,KAROL MARCINKOWSKI UNIV OF MED SCI      ,FC,00000-0000,Public       ,0,1,1,12,223,235
03092500,NOTTINGHAM TRENT UNIVERSITY             ,FC,00000-0000,Public       ,0,0,0,7,24,31
03095000,RMIT UNIVERSITY                         ,FC,00000-0000,Public       ,1,3,4,7,39,46
03095400,BOND UNIVERSITY                         ,FC,00000-0000,Private      ,2,3,5,42,100,142
03095900,ESSEC BUSINESS SCHOOL                   ,FC,00000-0000,Private      ,0,1,1,0,21,21
03096100,LA TROBE UNIVERSITY                     ,FC,00000-0000,Public       ,1,6,7,11,34,45
03096900,DEAKIN UNIVERSITY                       ,FC,00000-0000,Public       ,0,4,4,4,20,24
03097100,UNIVERSITY OF WESTERN SYDNEY            ,FC,00000-0000,Public       ,0,1,1,4,13,17
03097300,VICTORIA UNIVERSITY OF TECHNOLOGY       ,FC,00000-0000,Public       ,0,1,1,3,16,19
03097500,CENTRAL QUEENSLAND UNIVERSITY           ,FC,00000-0000,Public       ,0,1,1,3,7,10
03100000,UNIVERSITY OF ADELAIDE (THE)            ,FC,00000-0000,Public       ,2,1,3,7,29,36
03100200,INST DE MANAGEMENT HOTELIER INTERNA     ,FC,00000-0000,Private      ,0,0,0,0,1,1
03101600,ASIAN INSTITUTE OF MANAGEMENT           ,FC,00000-0000,Private      ,0,1,1,5,10,15
03102500,AMERICAN UNIVERSITY OF ROME             ,FC,00000-0000,Private      ,4,1,5,100,63,163
03102800,ROBERT GORDON UNIVERSITY (THE)          ,FC,00000-0000,Public       ,0,3,3,0,26,26
03104800,GRIFFITH UNIVERSITY                     ,FC,00000-0000,Public       ,0,7,7,16,58,74
03104801,GRIFFITH UNIVERSITY - MOUNT GRAVATT CAMP,FC,00000-0000,Public       ,0,0,0,3,7,10
03104802,GRIFFITH UNIVERSITY - GOLD COAST CAMPUS ,FC,00000-0000,Public       ,0,0,0,3,10,13
03104803,GRIFFITH UNIVERSITY - QUEENSLAND CONSERV,FC,00000-0000,Public       ,0,0,0,1,8,9
03104804,GRIFFITH UNIVERSITY - QUEENSLAND COLLEGE,FC,00000-0000,Public       ,0,0,0,6,8,14
03104805,GRIFFITH UNIVERSITY - LOGAN CAMPUS      ,FC,00000-0000,Public       ,0,0,0,1,1,2
03136300,AUSTRALIAN CATHOLIC UNIVERSITY          ,FC,00000-0000,Public       ,0,0,0,5,16,21
03140300,EDITH COWAN UNIVERSITY                  ,FC,00000-0000,Public       ,0,1,1,3,19,22
03140400,NORTHERN TERRITORY UNIVERSITY           ,FC,00000-0000,Public       ,0,0,0,0,2,2
03140500,QUEENSLAND UNIVERSITY OF TECHNOLOGY     ,FC,00000-0000,Public       ,1,4,5,5,39,44
03140600,SOUTHERN CROSS UNIVERSITY               ,FC,00000-0000,Public       ,0,1,1,3,18,21
03140700,SWINBURNE UNIVERSITY OF TECHNOLOGY      ,FC,00000-0000,Public       ,2,0,2,8,18,26
03140900,UNIVERSITY OF BALLARAT                  ,FC,00000-0000,Public       ,0,0,0,0,1,1
03150300,UNIVERSITY OF TASMANIA                  ,FC,00000-0000,Public       ,0,2,2,7,12,19
03150400,"UNIVERSITY OF TECHNOLOGY, SYDNEY        ",FC,00000-0000,Public       ,0,5,5,8,46,54
03274300,"KUNGLIGA TEKNISKA HOGSKOLAN, KTH        ",FC,00000-0000,Public       ,0,0,0,3,24,27
03287300,LIVERPOOL INSTITUTE FOR PERFORMING ARTS ,FC,00000-0000,Public       ,0,0,0,23,4,27
03300300,"2ND SCHOOL OF MEDICINE, CHARLES UNI     ",FC,00000-0000,Public       ,0,0,0,0,2,2
03300400,"FIRST FACULTY OF MEDICINE, CHARLES UNIV.",FC,00000-0000,Public       ,1,0,1,2,27,29
03329300,JOHN CABOT UNIVERSITY                   ,FC,00000-0000,Private      ,4,2,6,157,28,185
03332400,AGRICULTURE UNIVERSITY OF WROCLAW       ,FC,00000-0000,Public       ,0,0,0,1,1,2
03333300,MEDICAL UNIVERSITY SCHOOL OF LUBLIN     ,FC,00000-0000,Public       ,0,16,16,11,250,261
03334300,UNIVERSIDAD NORDESTANA                  ,FC,00000-0000,Private      ,0,4,4,7,76,83
03335300,MEDICAL UNIVERSITY OF SILESIA           ,FC,00000-0000,Public       ,0,9,9,7,106,113
03349400,"QUEEN MARGARET UNIVERSITY COLLEGE, EDINB",FC,00000-0000,Public       ,0,0,0,3,19,22
03350300,BOURNEMOUTH UNIVERSITY                  ,FC,00000-0000,Public       ,0,0,0,8,24,32
03352300,LONDON SOUTH BANK UNIVERSITY            ,FC,00000-0000,Private      ,0,1,1,12,39,51
03364300,"FACULTY OF MEDICINE, PALACKY UNIVER     ",FC,00000-0000,Public       ,0,0,0,1,6,7
03365400,AUCKLAND INSTITUTE OF TECHNOLOGY        ,FC,00000-0000,Public       ,0,3,3,5,20,25
03377300,"UNIVERSITY OF WALES INSTITUTE, CARD     ",FC,00000-0000,Public       ,0,0,0,2,13,15
03378300,"THE 3RD FACULTY OF MEDICINE, CHARLE     ",FC,00000-0000,Public       ,0,0,0,0,3,3
03386300,CHARLES UNIVERSITY-MEDICAL FACULTY      ,FC,00000-0000,Public       ,0,0,0,1,8,9
03406300,"THE SCHOOL OF PHARMACY, UNIVERSITY      ",FC,00000-0000,Public       ,0,0,0,0,5,5
03418400,NAPIER UNIVERSITY                       ,FC,00000-0000,Public       ,0,0,0,4,25,29
03435300,ANGLIA POLYTECHNIC UNIVERSITY HIGHE     ,FC,00000-0000,Public       ,0,0,0,6,11,17
03460300,INTERNATIONALES THEOLOGISCHES INSTI     ,FC,00000-0000,Private      ,0,2,2,2,18,20
03462400,UNIV OF ARTS LONDON - LON COLL OF COMMUN,FC,00000-0000,Public       ,0,0,0,20,47,67
03466300,INSTITUTO CENTROAMERICANO DE ADMINI     ,FC,00000-0000,Private      ,0,1,1,0,11,11
03473300,UNIV OF ARTS LONDON - LON COLL FASHION  ,FC,00000-0000,Public       ,1,1,2,45,74,119
03475300,UNIV OF THE ARTS  LONDON - CHELSEA COLL ,FC,00000-0000,Public       ,1,1,2,13,24,37
03478300,ROYAL WELSH COLLEGE OF MUSIC AND DRAMA  ,FC,00000-0000,Public       ,0,0,0,6,8,14
03492300,UNIVERSITY OF OXFORD - GREEN TEMPLETON C,FC,00000-0000,Public       ,0,0,0,0,4,4
03492400,UNIV OF CAMBRIDGE-ST CATHERINE'S CG     ,FC,00000-0000,Public       ,0,0,0,0,4,4
03494400,UNIV OF CAMBRIDGE-SELWYN COLLEGE        ,FC,00000-0000,Public       ,0,0,0,0,6,6
03494500,UNIV OF OXFORD-SAINT BENET'S HALL       ,FC,00000-0000,Public       ,0,0,0,0,1,1
03494600,UNIV OF OXFORD-HARRIS MANCHESTER        ,FC,00000-0000,Public       ,0,0,0,2,6,8
03500300,WIMBLEDON COLLEGE OF ART                ,FC,00000-0000,Public       ,0,0,0,9,6,15
03501400,LEEDS METROPOLITAN UNIVERSITY           ,FC,00000-0000,Public       ,0,1,1,6,24,30
03507300,UNIVERSITY OF SUNDERLAND                ,FC,00000-0000,Public       ,0,1,1,3,8,11
03515300,UNIVERSITY OF CENTRAL LANCASHIRE        ,FC,00000-0000,Public       ,0,0,0,7,19,26
03517300,UNIVERSITY OF BRIGHTON                  ,FC,00000-0000,Public       ,0,0,0,9,25,34
03518300,EUROPEAN GRADUATE SCHOOL                ,FC,00000-0000,Private      ,0,33,33,0,105,105
03526300,INST CENTROAMERICANO DE ADM DE EMP      ,FC,00000-0000,Private      ,0,0,0,3,5,8
03527300,SOFIA UNIVERSITY ST. KLIMENT OHRIDSKI   ,FC,00000-0000,Public       ,0,0,0,0,4,4
03533300,BATH SPA UNIVERSITY                     ,FC,00000-0000,Public       ,0,1,1,7,23,30
03547300,UNIVERSITY OF GLAMORGAN                 ,FC,00000-0000,Public       ,0,0,0,4,9,13
03580300,LIVERPOOL JOHN MOORES UNIVERSITY        ,FC,00000-0000,Public       ,0,0,0,7,12,19
03589400,ARTS INSTITUTE AT BOURNEMOUTH (THE)     ,FC,00000-0000,Public       ,0,1,1,6,9,15
03590300,AVONDALE COLLEGE LIMITED                ,FC,00000-0000,Private      ,0,0,0,10,4,14
03594300,GROUP ESC GRENOBLE GRAD SCH OF BUS.     ,FC,00000-0000,Private      ,0,1,1,1,46,47
03597300,JAGIELLONIAN UNIVERSITY                 ,FC,00000-0000,Public       ,0,0,0,0,33,33
03601300,UNIVERSITAT JAUME I DE CASTELLO/UJI     ,FC,00000-0000,Public       ,0,0,0,1,5,6
03603300,LEEDS COLLEGE OF MUSIC                  ,FC,00000-0000,Public       ,0,0,0,2,1,3
03619300,UNIVERSITY OF GREENWICH                 ,FC,00000-0000,Public       ,2,1,3,8,45,53
03653400,UNIVERSIDAD DE IBEROAMERICA - UNIBE     ,FC,00000-0000,Private      ,0,1,1,2,23,25
03674300,UNIVERSITY OF ABERTAY DUNDEE            ,FC,00000-0000,Public       ,0,0,0,1,7,8
03684400,UNIVERSITY OF LINCOLN                   ,FC,00000-0000,Public       ,0,0,0,2,13,15
03684500,MEDICAL UNIVERSITY OF GDANSK            ,FC,00000-0000,Public       ,0,0,0,3,24,27
03685300,UNIVERSITAT POMPEU FABRA                ,FC,00000-0000,Public       ,0,0,0,4,52,56
03716300,"UNIVERSITY OF WALES, NEWPORT            ",FC,00000-0000,Public       ,0,0,0,2,9,11
03721300,WRITTLE COLLEGE                         ,FC,00000-0000,Public       ,0,0,0,2,1,3
03727400,UNIVERSITY OF WAIKATO (THE)             ,FC,00000-0000,Public       ,1,1,2,10,8,18
03738300,LONDON SCHOOL OF THEOLOGY               ,FC,00000-0000,Private      ,0,1,1,0,6,6
03741300,ALRA (ACADEMY OF LIVE AND RECORDED ARTS),FC,00000-0000,Private      ,0,0,0,1,6,7
03770300,NAZARENE THEOLOGICAL COLLEGE            ,FC,00000-0000,Private      ,0,2,2,0,13,13
03794400,ANGLO EUROPEAN COLLEGE OF CHIROPRACTIC  ,FC,00000-0000,Private      ,0,0,0,0,3,3
03807300,ROSE BRUFORD COLLEGE                    ,FC,00000-0000,Public       ,0,0,0,1,0,1
03816400,AMERICAN GRAD SCH OF INTERNTL REL & DIPL,FC,00000-0000,Private      ,0,1,1,6,86,92
03818300,LEIPZIG GRADUATE SCHOOL OF MANAGEMENT   ,FC,00000-0000,Private      ,0,0,0,0,18,18
03824300,"ROYAL VETERINARY COLLEGE (THE), UNIVERSI",FC,00000-0000,Public       ,0,0,0,4,118,122
03850400,UNIVERSITY OF NOTRE DAME AUSTRALIA (THE),FC,00000-0000,Private      ,0,0,0,1,1,2
03850500,MEDICAL UNIVERSITY OF LODZ              ,FC,00000-0000,Public       ,0,0,0,5,73,78
03859400,UNIVERSITY COLLEGE FALMOUTH             ,FC,00000-0000,Public       ,0,1,1,5,8,13
03867300,UNIVERSITAT AUTONOMA DE BARCELONA       ,FC,00000-0000,Public       ,0,0,0,1,24,25
03880300,UNIVERSITY OF GLOUCESTERSHIRE (THE)     ,FC,00000-0000,Public       ,0,0,0,2,11,13
03897400,INTERNATIONAL SPACE UNIVERSITY          ,FC,00000-0000,Private      ,0,0,0,1,9,10
03926400,NATIONAL COLLEGE OF ART AND DESIGN      ,FC,00000-0000,Public       ,0,1,1,3,6,9
03941301,AVE MARIA UNIVERSITY - LATIN AMERICA    ,FC,00000-0000,Private      ,13,2,15,205,33,238
03974300,"ST. GEORGE'S UNIVERSITY, SCHOOL OF VETER",FC,00000-0000,Proprietary  ,0,115,115,0,115,115
03978300,SPURGEON'S COLLEGE                      ,FC,00000-0000,Private      ,0,0,0,1,0,1
03993400,TRINITY UNIVERSITY COLLEGE CARMARTHEN   ,FC,00000-0000,Public       ,0,0,0,0,2,2
04021400,"AMERICAN COLLEGE, DUBLIN LIMITED (THE)  ",FC,00000-0000,Private      ,0,1,1,8,14,22
04021500,CENTRAL EUROPEAN UNIVERSITY             ,FC,00000-0000,Private      ,0,1,1,5,82,87
04032300,YORK ST JOHN UNIVERSITY                 ,FC,00000-0000,Public       ,0,1,1,2,3,5
04046300,HK UNIVERSITY OF SCI & TECH (HKUST)     ,FC,00000-0000,Public       ,0,0,0,1,22,23
04070300,"RAPHAEL RECANATI INTERNATIONAL SCHOOL, T",FC,00000-0000,Private      ,1,3,4,61,74,135
04085400,NEW ZEALAND COLLEGE OF CHIROPRACTIC     ,FC,00000-0000,Private      ,0,0,0,0,2,2
04113300,LEBANESE AMERICAN UNIVERSITY            ,FC,00000-0000,Private      ,1,0,1,17,11,28
04115900,LIVERPOOL HOPE UNIVERSITY               ,FC,00000-0000,Public       ,1,0,1,5,14,19
04116300,EDHEC BUSINESS SCHOOL                   ,FC,00000-0000,Private      ,0,0,0,1,19,20
04121400,ISAPZURICH (INTERNATIONAL SCHOOL OF ANAL,FC,00000-0000,Private      ,0,0,0,1,6,7
04128600,UNIVERSITY OF WORCESTER                 ,FC,00000-0000,Public       ,0,0,0,2,2,4
04139100,UNIVERSITA DEGLI STUDI DI SCIENZE GASTRO,FC,00000-0000,Private      ,0,6,6,2,38,40
04143700,ST MARY'S UNIVERSITY COLLEGE TWICKENHAM ,FC,00000-0000,Public       ,0,16,16,3,103,106
00380600,ALDERSON-BROADDUS COLLEGE               ,WV,26416-1051,Private      ,3,13,16,829,286,1115
00380700,MOUNTAIN STATE UNIVERSITY               ,WV,25801-5624,Private      ,57,605,662,1476,7913,9389
00380800,BETHANY COLLEGE                         ,WV,26032-0417,Private      ,9,1,10,1354,157,1511
00380900,BLUEFIELD STATE COLLEGE                 ,WV,24701-2198,Public       ,21,89,110,1250,1833,3083
00381000,CONCORD UNIVERSITY                      ,WV,24712-0000,Public       ,19,43,62,3023,1277,4300
00381100,DAVIS & ELKINS COLLEGE                  ,WV,26241-3996,Private      ,7,14,21,902,358,1260
00381200,FAIRMONT STATE UNIVERSITY               ,WV,26554-2470,Public       ,55,161,216,5079,4133,9212
00381300,GLENVILLE STATE COLLEGE                 ,WV,26351-1292,Public       ,13,31,44,1371,649,2020
00381500,MARSHALL UNIVERSITY                     ,WV,25755-3300,Public       ,104,241,345,9530,7451,16981
00381600,SOUTHERN WV COMMUNITY COLLEGE           ,WV,25637-2900,Public       ,23,63,86,1138,1358,2496
00381800,UNIVERSITY OF CHARLESTON                ,WV,25304-1099,Private      ,16,12,28,1580,910,2490
00381900,OHIO VALLEY COLLEGE                     ,WV,26105-8000,Private      ,1,12,13,481,225,706
00382000,SALEM INTERNATIONAL UNIVERSITY          ,WV,26426-0500,Proprietary  ,19,143,162,354,1185,1539
00382200,SHEPHERD UNIVERSITY                     ,WV,25443-3210,Public       ,45,55,100,3855,1588,5443
00382300,WEST LIBERTY UNIVERSITY                 ,WV,26074-0295,Public       ,20,23,43,2897,884,3781
00382600,WEST VIRGINIA STATE UNIVERSITY          ,WV,25112-0000,Public       ,21,71,92,2670,2801,5471
00382700,WEST VIRGINIA UNIVERSITY                ,WV,26506-6201,Public       ,205,223,428,24823,9875,34698
00382711,WEST VIRGINIA UNIVERSITY - POTOMAC STATE,WV,26726-3000,Public       ,20,18,38,1738,577,2315
00382721,WEST VIRGINIA UNIV INST OF TECH         ,WV,25136-2436,Public       ,11,13,24,1073,445,1518
00382800,WEST VIRGINIA UNIV AT PARKERSBURG       ,WV,26101-9577,Public       ,29,186,215,1720,3687,5407
00383000,WEST VIRGINIA WESLEYAN COLLEGE          ,WV,26201-2600,Private      ,15,14,29,1901,295,2196
00383100,WHEELING JESUIT UNIVERSITY              ,WV,26003-6243,Private      ,7,52,59,1252,731,1983
00500700,WEST VIRGINIA JUNIOR COLLEGE            ,WV,26505-5596,Proprietary  ,7,18,25,157,283,440
00500800,MOUNTAIN STATE COLLEGE                  ,WV,26101-3993,Proprietary  ,2,37,39,92,395,487
00754400,APPALACHIAN BIBLE COLLEGE               ,WV,25818-1353,Private      ,2,1,3,267,75,342
00757800,HUNTINGTON SCHOOL OF BEAUTY CULTURE     ,WV,25705-2030,Proprietary  ,4,22,26,51,165,216
00760000,INTERNATIONAL BEAUTY SCHOOL             ,WV,25401-3231,Proprietary  ,1,28,29,40,155,195
00835500,JAMES RUMSEY TECHNICAL INSTITUTE        ,WV,25403-0259,Public       ,3,28,31,93,332,425
00895900,CLARKSBURG BEAUTY ACADEMY               ,WV,26301-2903,Proprietary  ,11,19,30,64,95,159
00904700,HUNTINGTON JUNIOR COLLEGE               ,WV,25701-2004,Proprietary  ,11,133,144,246,1587,1833
00905400,WEST VIRGINIA NORTHERN CMTY COLLEGE     ,WV,26003-0000,Public       ,26,150,176,1245,2952,4197
01014000,MINERAL COUNTY VOCATIONAL TECH CTR      ,WV,26726-0000,Public       ,0,2,2,13,57,70
01035600,EVEREST INSTITUTE                       ,WV,25313-1304,Proprietary  ,8,82,90,209,1204,1413
01057300,WEST VIRGINIA JUNIOR COLLEGE            ,WV,25322-0000,Proprietary  ,11,35,46,191,439,630
01057302,WEST VIRGINIA JUNIOR COLLEGE            ,WV,26330-0000,Proprietary  ,15,54,69,208,438,646
01086100,WEST VIRGINIA BUSINESS COLLEGE          ,WV,26301-0000,Proprietary  ,2,34,36,44,256,300
01124500,WEST VIRGINIA SCH OSTEOPATHIC MED       ,WV,24901-1128,Public       ,0,4,4,7,868,875
01174900,WOOD COUNTY SCH OF PRAC NURSING         ,WV,26101-6424,Public       ,0,8,8,31,111,142
01235900,B M SPURR SCHOOL OF PRAC NURSING        ,WV,26038-1660,Private      ,0,0,0,14,27,41
01257300,WEST VIRGINIA UNIV-HOSP-RAD TECH        ,WV,26506-8062,Private      ,1,1,2,74,86,160
01274300,BENJAMIN FRANKLIN CAREER&TECH           ,WV,25064-0000,Public       ,4,17,21,70,205,275
01290400,MONONGALIA CNTY TECH ED CTR             ,WV,26501-6841,Public       ,1,2,3,66,163,229
01290500,ACADEMY OF CAREERS AND TECHNOLOGY       ,WV,25801-0000,Public       ,5,20,25,84,367,451
02057400,ROANE-JACKSON TECHNICAL CENTER          ,WV,25252-0000,Public       ,0,3,3,25,85,110
02068000,UNITED TECHNICAL CENTER                 ,WV,26301-0000,Public       ,0,14,14,36,131,167
02070100,BECKLEY BEAUTY ACADEMY                  ,WV,25801-0000,Proprietary  ,5,11,16,35,95,130
02073400,CARVER CAREER TECH ED CTR               ,WV,25306-6397,Public       ,4,21,25,183,341,524
02145100,SCOTT COLLEGE OF COSMETOLOGY            ,WV,26003-0000,Proprietary  ,2,9,11,68,63,131
02178200,CHARLESTON SCHOOL OF BEAUTY CULTURE     ,WV,25301-0000,Proprietary  ,6,33,39,48,159,207
02218200,GARNET CAREER CENTER                    ,WV,25301-0000,Public       ,3,25,28,101,403,504
02275300,CABELL COUNTY CAREER TECHNOLOGY CTR     ,WV,25705-0000,Public       ,5,11,16,106,238,344
02524500,RALPH R WILLIS VOCATIONAL CENTER        ,WV,25601-0000,Public       ,0,0,0,23,57,80
02534800,FRED W EBERLE TECHNICAL CENTER          ,WV,26201-0000,Public       ,2,13,15,66,176,242
02535500,MERCER COUNTY TECH EDUC CNTR            ,WV,24740-0000,Public       ,1,13,14,73,201,274
02579900,NORTH CENTRAL OPPORTUNITIES INDUSTRIALIZ,WV,26554-2936,Private      ,0,24,24,34,156,190
02609400,VALLEY COLLEGE                          ,WV,25404-5711,Proprietary  ,1,28,29,31,191,222
03052000,MEREDITH MANOR EQUESTRIAN CENTRE        ,WV,26184-9707,Proprietary  ,8,4,12,228,134,362
03076500,FAYETTE INSTITUTE OF TECHNOLOGY         ,WV,25901-2174,Public       ,0,3,3,28,100,128
03084200,VALLEY COLLEGE                          ,WV,24740-3141,Proprietary  ,3,21,24,19,92,111
03084400,VALLEY COLLEGE                          ,WV,25801-2643,Proprietary  ,2,22,24,28,150,178
03098300,PUTNAM CAREER & TECHNICAL CENTER        ,WV,25070-0000,Public       ,2,3,5,33,107,140
03099200,"MOUNTAINEER BEAUTY COLLEGE, INC         ",WV,25177-2917,Proprietary  ,4,18,22,44,88,132
03102100,MORGANTOWN BEAUTY COLLEGE               ,WV,26505-5430,Proprietary  ,3,13,16,61,123,184
03123200,STANLEY TECHNICAL INSTITUTE             ,WV,26505-3751,Private      ,0,10,10,12,75,87
03327500,SOUTH BRANCH VOCATIONAL TECH CENTER     ,WV,26847-1698,Public       ,0,4,4,12,39,51
03734300,JOHN D. ROCKEFELLER IV CAREER CENTER    ,WV,26047-9424,Public       ,0,0,0,6,35,41
03819300,AMERICAN PUBLIC UNIVERSITY SYSTEM       ,WV,25414-1621,Proprietary  ,155,4143,4298,834,23495,24329
03957300,BLUE RIDGE COMMUNITY AND TECHNICAL COLLE,WV,25401-3244,Public       ,27,123,150,792,1986,2778
03960300,NEW RIVER COMMUNITY AND TECHNICAL COLLEG,WV,25801-2636,Public       ,33,175,208,1064,2854,3918
04028300,MOUNTAIN STATE SCHOOL OF MASSAGE        ,WV,25304-2025,Proprietary  ,0,4,4,23,65,88
04038500,PIERPONT COMMUNITY & TECHNICAL COLLEGE  ,WV,26554-2451,Public       ,25,89,114,1329,1598,2927
04038600,KANAWHA VALLEY COMMUNITY & TECH COLLEGE ,WV,25112-1000,Public       ,17,87,104,632,1646,2278
04041400,MOUNTWEST COMMUNITY AND TECHNICAL COLLEG,WV,25755-3300,Public       ,28,150,178,1093,2247,3340
04047300,BRIDGEMONT COMMUNITY & TECHNICAL COLLEGE,WV,25136-2435,Public       ,11,25,36,438,382,820
04119000,EASTERN WEST VIRGINIA COMMUNITY & TECHNI,WV,26836-0000,Public       ,8,39,47,137,472,609
00106100,ALASKA PACIFIC UNIVERSITY               ,AK,99508-4672,Private      ,2,51,53,434,840,1274
00106300,UNIVERSITY OF ALASKA FAIRBANKS          ,AK,99775-7500,Public       ,115,305,420,2856,4018,6874
00106500,UNIVERSITY OF ALASKA SOUTHEAST          ,AK,99801-8680,Public       ,28,125,153,768,1557,2325
00884300,ALASKA BIBLE COLLEGE                    ,AK,99588-0000,Private      ,0,4,4,19,37,56
01146200,UNIVERSITY OF ALASKA ANCHORAGE          ,AK,99514-1608,Public       ,184,538,722,5909,9471,15380
02541000,CAREER ACADEMY                          ,AK,99507-0000,Proprietary  ,30,87,117,164,816,980
02576900,CHARTER COLLEGE                         ,AK,99508-0000,Proprietary  ,167,686,853,791,3884,4675
03160300,AVTEC                                   ,AK,99664-0889,Public       ,10,24,34,205,437,642
03461300,ILISAGVIK COLLEGE                       ,AK,99723-0749,Public       ,3,4,7,22,84,106
04138600,ALASKA CHRISTIAN COLLEGE                ,AK,99669-9755,Private      ,4,4,8,35,41,76
00108500,UNIV ARKANSAS MONTICELLO                ,AR,71656-0000,Public       ,69,107,176,2409,2581,4990
00108600,UNIV OF ARKANSAS AT PINE BLUFF          ,AR,71601-2790,Public       ,67,54,121,4302,2224,6526
00108700,ARKANSAS BAPTIST COLLEGE                ,AR,72202-6099,Private      ,29,64,93,1068,1277,2345
00108800,LYON COLLEGE                            ,AR,72501-3699,Private      ,4,4,8,898,181,1079
00108900,ARKANSAS TECH UNIVERSITY                ,AR,72801-2222,Public       ,60,158,218,6684,4761,11445
00109000,ARKANSAS STATE UNIVERSITY               ,AR,72467-0000,Public       ,167,503,670,9038,11743,20781
00109002,ARKANSAS STATE UNIVERSITY - NEWPORT     ,AR,72112-1120,Public       ,0,0,0,26,84,110
00109003,ARKANSAS STATE UNIVERSITY - MOUNTAIN HOM,AR,72653-4405,Public       ,0,0,0,61,104,165
00109006,DELTA TECHNICAL INSTITUTE               ,AR,72365-9558,Public       ,3,11,14,78,172,250
00109100,ARKANSAS STATE UNIVERSITY - BEEBE       ,AR,72012-1000,Public       ,46,143,189,2208,3589,5797
00109200,UNIVERSITY OF CENTRAL ARKANSAS          ,AR,72035-0001,Public       ,116,141,257,9280,5095,14375
00109300,CENTRAL BAPTIST COLLEGE                 ,AR,72034-6470,Private      ,7,22,29,544,483,1027
00109400,UNIVERSITY OF THE OZARKS                ,AR,72830-2880,Private      ,9,4,13,806,197,1003
00109500,CROWLEYS RIDGE COLLEGE                  ,AR,72450-9775,Private      ,3,7,10,209,148,357
00109700,HARDING UNIVERSITY                      ,AR,72149-0001,Private      ,52,75,127,3805,1894,5699
00109800,HENDERSON STATE UNIVERSITY              ,AR,71999-0001,Public       ,49,84,133,3708,1994,5702
00109900,HENDRIX COLLEGE                         ,AR,72032-3080,Private      ,20,4,24,2234,250,2484
00110000,JOHN BROWN UNIVERSITY                   ,AR,72761-2747,Private      ,15,67,82,1405,1265,2670
00110100,UNIV ARKANSAS LITTLE ROCK               ,AR,72204-1099,Public       ,75,299,374,5372,11270,16642
00110200,OUACHITA BAPTIST UNIVERSITY             ,AR,71998-0001,Private      ,15,3,18,1862,189,2051
00110300,PHILANDER SMITH COLLEGE                 ,AR,72202-3718,Private      ,8,22,30,1040,920,1960
00110400,PHILLIPS COUNTY COMMUNITY COLLEGE       ,AR,72342-0000,Public       ,50,82,132,598,1184,1782
00110401,RICE BELT TECH INST                     ,AR,72042-0000,Public       ,0,0,0,5,14,19
00110600,WILLIAMS BAPTIST COLLEGE                ,AR,72476-4661,Private      ,7,3,10,602,243,845
00110700,SOUTHERN ARKANSAS UNIVERSITY            ,AR,71754-0000,Public       ,43,75,118,2688,2002,4690
00110800,UNIV ARKANSAS FAYETTEVILLE              ,AR,72701-0000,Public       ,187,216,403,14569,7119,21688
00110900,UNIV OF ARKANSAS FOR MEDCL SCIENCES     ,AR,72205-7102,Public       ,6,45,51,648,2268,2916
00110901,UNIV OF ARKANSAS COLG OF MEDICINE       ,AR,72205-0000,Public       ,0,7,7,110,870,980
00111000,UNIVERSITY OF ARKANSAS-FORT SMITH       ,AR,72904-7397,Public       ,67,171,238,4431,5243,9674
00524500,U OF A COMM COLLEGE AT MORRILTON        ,AR,72110-9601,Public       ,21,75,96,1392,2227,3619
00570700,SEARK COLLEGE                           ,AR,71603-0000,Public       ,28,96,124,851,2460,3311
00573200,UNIV AR COMMUNITY COLLEGE AT HOPE       ,AR,71801-0000,Public       ,27,81,108,597,1491,2088
00704400,CROWLEYS RIDGE TECHNICAL INSTITUTE      ,AR,72336-0000,Public       ,21,22,43,148,366,514
00732967,ITT TECHNICAL INSTITUTE                 ,AR,72204-7739,Proprietary  ,31,86,117,395,1129,1524
00773800,SOUTHERN ARKANSAS UNIVERSITY TECH       ,AR,71701-1900,Public       ,11,41,52,559,1062,1621
00792100,PAUL MITCHELL THE SCHOOL ARKANSAS       ,AR,72701-0000,Proprietary  ,5,14,19,79,144,223
00997600,OUACHITA TECHNICAL COLLEGE              ,AR,72104-0816,Public       ,7,50,57,417,1240,1657
01074100,MELLIE'S BEAUTY COLLEGE                 ,AR,72901-3886,Proprietary  ,4,24,28,52,198,250
01210500,NATIONAL PARK COMMUNITY COLLEGE         ,AR,71913-9174,Public       ,42,146,188,1361,3386,4747
01226000,EAST ARKANSAS COMMUNITY COLLEGE         ,AR,72335-2204,Public       ,29,70,99,603,1140,1743
01226100,NORTH ARKANSAS COLLEGE                  ,AR,72601-5508,Public       ,8,84,92,1104,2193,3297
01286000,ARKANSAS NORTHEASTERN COLLEGE           ,AR,72316-1109,Public       ,42,144,186,879,1930,2809
02052200,BLACK RIVER TECHNICAL COLLEGE           ,AR,72455-0000,Public       ,39,82,121,882,2447,3329
02073500,UNIVERSITY OF ARKANSAS COMMUNITY COLLEGE,AR,72503-0000,Public       ,19,75,94,709,1614,2323
02073700,NORTHWEST TECHNICAL INSTITUTE           ,AR,72765-0000,Public       ,8,19,27,232,677,909
02074600,SOUTH ARKANSAS COMMUNITY COLLEGE        ,AR,71731-0000,Public       ,17,67,84,633,1910,2543
02075300,PULASKI TECHNICAL COLLEGE               ,AR,72118-0000,Public       ,80,385,465,4098,14364,18462
02087000,OZARKA COLLEGE                          ,AR,72556-0000,Public       ,27,90,117,414,1509,1923
02111100,RICH MOUNTAIN COMMUNITY COLLEGE         ,AR,71953-0000,Public       ,14,47,61,383,778,1161
02202400,PROFESSIONAL COSMETOLOGY EDUC CTR       ,AR,71730-5828,Proprietary  ,2,3,5,16,102,118
02220900,COSSATOT COMMUNITY COLLEGE              ,AR,71832-0000,Public       ,18,51,69,494,1206,1700
02260400,BEE JAY'S HAIRSTYLING ACADEMY           ,AR,72212-0000,Proprietary  ,1,11,12,16,86,102
02260401,BEE JAY'S HAIRSTYLING ACADEMY - BATESVIL,AR,72501-6709,Proprietary  ,1,7,8,15,52,67
02272400,EASTERN COLLEGE OF HEALTH VOCATIONS     ,AR,72205-3535,Proprietary  ,35,122,157,203,874,1077
02284200,NEW TYLER BARBER COLLEGE INC            ,AR,72114-0000,Proprietary  ,2,24,26,63,223,286
02287400,MARSHA KAY BEAUTY COLLEGE               ,AR,72653-0000,Proprietary  ,5,9,14,14,38,52
02330800,JEFFERSON SCHOOL OF NURSING             ,AR,71603-0000,Private      ,1,7,8,74,175,249
02339800,SOUTHERN INSTITUTE OF COSMETOLOGY       ,AR,72301-0000,Proprietary  ,6,16,22,44,98,142
02341700,CAREER ACADEMY OF HAIR DESIGN           ,AR,72764-4304,Proprietary  ,1,19,20,51,161,212
02341701,CAREER ACADEMY OF HAIR DESIGN - ROGERS  ,AR,72756-2102,Proprietary  ,5,28,33,53,174,227
02341702,CAREER ACADEMY OF HAIR DESIGN - SILOAM  ,AR,72761-4217,Proprietary  ,1,10,11,14,66,80
02348200,MID-SOUTH COMMUNITY COLLEGE             ,AR,72301-0000,Public       ,57,207,264,958,2410,3368
02363500,ARTHUR'S BEAUTY COLLEGE                 ,AR,72901-0000,Proprietary  ,2,22,24,35,138,173
02525800,LEE'S SCHOOL OF COSMETOLOGY             ,AR,72114-0000,Proprietary  ,0,7,7,31,116,147
02538500,ARTHUR'S BEAUTY COLLEGE                 ,AR,72076-0000,Proprietary  ,13,33,46,57,228,285
02569600,SEARCY BEAUTY COLLEGE                   ,AR,72143-0000,Proprietary  ,3,15,18,23,100,123
03005100,ARKANSAS BEAUTY SCHOOL                  ,AR,72209-5116,Proprietary  ,0,12,12,42,169,211
03007100,HOT SPRINGS BEAUTY COLLEGE              ,AR,71901-5432,Proprietary  ,5,15,20,44,100,144
03007600,ARKANSAS BEAUTY SCHOOL-CONWAY           ,AR,72032-4354,Proprietary  ,4,8,12,48,107,155
03023400,ARKANSAS COLLEGE OF BARBERING           ,AR,72114-5615,Proprietary  ,5,16,21,62,200,262
03063300,NORTHWEST ARKANSAS COMMUNITY COLLEG     ,AR,72712-5190,Public       ,93,255,348,3253,5936,9189
03065100,ABC BEAUTY COLLEGE                      ,AR,71923-4206,Proprietary  ,2,5,7,35,82,117
03066302,BRYAN COLLEGE -                         ,AR,72756-1825,Proprietary  ,8,35,43,94,436,530
03105200,BAPTIST HEALTH SCHOOLS LITTLE ROCK      ,AR,72210-2820,Private      ,7,40,47,470,1688,2158
03115102,HERITAGE COLLEGE - LITTLE ROCK          ,AR,72227-5544,Proprietary  ,27,114,141,191,995,1186
03116800,"DELUXE BEAUTY SCHOOL, L.L.C.            ",AR,71603-0000,Proprietary  ,0,0,0,7,6,13
03124900,IMAGINE -  PAUL MITCHELL PARTNER SCHOOL ,AR,72117-2516,Proprietary  ,14,37,51,199,360,559
03127200,ASKINS VO-TECH                          ,AR,72908-8028,Proprietary  ,2,11,13,13,73,86
03214300,VELVATEX COLLEGE OF BEAUTY CULTURE      ,AR,72202-5452,Proprietary  ,0,4,4,19,48,67
03254300,MARGARET'S HAIR ACADEMY                 ,AR,71655-4905,Proprietary  ,2,6,8,28,75,103
03519400,LYNNDALE FUNDAMENTALS OF BEAUTY SCH     ,AR,71730-4804,Proprietary  ,1,0,1,11,48,59
03855300,ECCLESIA COLLEGE                        ,AR,72762-8159,Private      ,4,8,12,98,95,193
03912300,CROSSETT SCHOOL OF COSMETOLOGY          ,AR,71635-0000,Proprietary  ,1,0,1,5,41,46
03997300,ARKANSAS BEAUTY COLLEGE                 ,AR,72801-3741,Proprietary  ,3,12,15,33,81,114
04183400,SALON PROFESSIONAL ACADEMY (THE)        ,AR,72116-7310,Proprietary  ,2,5,7,2,5,7
00133900,CORBAN UNIVERSITY                       ,OR,97301-9392,Private      ,33,37,70,1559,701,2260
00316505,CASCADE COLLEGE                         ,OR,97216-0000,Private      ,0,0,0,37,85,122
00318600,BLUE MOUNTAIN COMMUNITY COLLEGE         ,OR,97801-0000,Public       ,33,211,244,1097,2401,3498
00318800,CENTRAL OREGON COMMUNITY COLLEGE        ,OR,97701-5998,Public       ,170,662,832,3054,7528,10582
00318900,CLATSOP COMMUNITY COLLEGE               ,OR,97103-3698,Public       ,35,124,159,463,1257,1720
00319100,CONCORDIA UNIVERSITY                    ,OR,97211-6099,Private      ,33,277,310,1641,2799,4440
00319300,EASTERN OREGON UNIVERSITY               ,OR,97850-2899,Public       ,56,159,215,2553,3288,5841
00319400,GEORGE FOX UNIVERSITY                   ,OR,97132-2697,Private      ,43,105,148,3140,2358,5498
00319600,LANE COMMUNITY COLLEGE                  ,OR,97405-0640,Public       ,340,1122,1462,7232,15448,22680
00319700,LEWIS & CLARK COLLEGE                   ,OR,97219-7899,Private      ,40,93,133,4701,4107,8808
00319800,LINFIELD COLLEGE                        ,OR,97128-6894,Private      ,53,76,129,3218,1242,4460
00319801,LINFIELD COLLEGE - PORTLAND CAMPUS      ,OR,97210-0000,Private      ,11,46,57,437,1018,1455
00319900,MARYLHURST UNIVERSITY                   ,OR,97036-7036,Private      ,5,184,189,184,2398,2582
00320300,MOUNT ANGEL SEMINARY                    ,OR,97373-0505,Private      ,0,2,2,14,34,48
00320400,MOUNT HOOD COMMUNITY COLLEGE            ,OR,97030-3300,Public       ,266,753,1019,5016,9752,14768
00320600,MULTNOMAH BIBLE COLLEGE/SEMINARY        ,OR,97220-5898,Private      ,13,37,50,568,852,1420
00320700,PACIFIC NORTHWEST COLLEGE OF ART        ,OR,97209-3023,Private      ,13,28,41,773,771,1544
00320800,NORTHWEST CHRISTIAN UNIVERSITY          ,OR,97401-3727,Private      ,11,22,33,802,706,1508
00320900,WESTERN OREGON UNIVERSITY               ,OR,97361-1394,Public       ,143,124,267,6616,3028,9644
00321000,OREGON STATE UNIVERSITY                 ,OR,97331-8507,Public       ,407,486,893,21369,11599,32968
00321100,OREGON INSTITUTE OF TECHNOLOGY          ,OR,97601-8801,Public       ,47,124,171,2500,2463,4963
00321200,PACIFIC UNIVERSITY                      ,OR,97116-1797,Private      ,56,80,136,3430,3208,6638
00321300,PORTLAND COMMUNITY COLLEGE              ,OR,97219-7198,Public       ,725,2864,3589,13139,34627,47766
00321312,PORTLAND COMMUNITY COLLEGE - COLUMBIA GO,OR,97058-3447,Public       ,23,113,136,374,993,1367
00321600,PORTLAND STATE UNIVERSITY               ,OR,97207-0000,Public       ,394,1097,1491,14507,24758,39265
00321700,REED COLLEGE                            ,OR,97202-8199,Private      ,33,28,61,2822,659,3481
00321800,CHEMEKETA COMMUNITY COLLEGE             ,OR,97309-1500,Public       ,240,926,1166,6188,14724,20912
00321900,SOUTHERN OREGON UNIVERSITY              ,OR,97520-5010,Public       ,98,190,288,5159,3705,8864
00322000,SOUTHWESTERN OREGON COMMUNITY CLG       ,OR,97420-2956,Public       ,44,132,176,1733,2072,3805
00322100,TREASURE VALLEY COMMUNITY COLLEGE       ,OR,97914-3423,Public       ,95,280,375,1667,3197,4864
00322200,UMPQUA COMMUNITY COLLEGE                ,OR,97470-0226,Public       ,68,305,373,1579,4567,6146
00322300,UNIVERSITY OF OREGON                    ,OR,97403-1226,Public       ,458,569,1027,24870,15001,39871
00322400,UNIVERSITY OF PORTLAND                  ,OR,97203-5798,Private      ,141,142,283,8966,2918,11884
00322500,WARNER PACIFIC COLLEGE                  ,OR,97215-4099,Private      ,19,176,195,838,2030,2868
00322700,WILLAMETTE UNIVERSITY                   ,OR,97301-3930,Private      ,60,59,119,4721,2124,6845
00487800,CLACKAMAS COMMUNITY COLLEGE             ,OR,97045-7998,Public       ,225,633,858,3821,6666,10487
00488200,OREGON HEALTH & SCIENCE UNIVERSITY      ,OR,97239-0000,Public       ,19,116,135,584,3857,4441
00693800,LINN BENTON COMMUNITY COLLEGE           ,OR,97321-3774,Public       ,171,430,601,4131,6684,10815
00717800,WESTERN SEMINARY                        ,OR,97215-0000,Private      ,1,17,18,7,390,397
00723402,HEALD COLLEGE - PORTLAND                ,OR,97205-3432,Proprietary  ,49,214,263,427,2000,2427
00732969,ITT TECHNICAL INSTITUTE                 ,OR,97220-6819,Proprietary  ,69,217,286,768,2266,3034
00781900,ART INSTITUTE OF PORTLAND (THE)         ,OR,97209-2911,Proprietary  ,72,135,207,2026,2356,4382
00888700,CONCORDE CAREER INSTITUTE               ,OR,97232-2242,Proprietary  ,29,153,182,364,1550,1914
00907900,EVEREST COLLEGE                         ,OR,97204-2296,Proprietary  ,24,146,170,380,1670,2050
00958100,SPRINGFIELD COLLEGE OF BEAUTY           ,OR,97477-5474,Proprietary  ,4,18,22,79,225,304
01012200,PHAGANS' MEDFORD BEAUTY SCHOOL          ,OR,97504-5297,Proprietary  ,5,25,30,62,188,250
01018200,ROGUE COMMUNITY COLLEGE                 ,OR,97527-0000,Public       ,132,562,694,2865,7433,10298
01050700,ACADEMY OF HAIR DESIGN                  ,OR,97301-3526,Proprietary  ,5,15,20,62,167,229
01230900,UNIVERSITY OF WESTERN STATES            ,OR,97230-3099,Private      ,3,23,26,52,628,680
01234700,PHAGANS CENTRAL OREGON BEAUTY CLG       ,OR,97701-5175,Proprietary  ,7,48,55,115,350,465
01234800,PHAGANS BEAUTY COLLEGE                  ,OR,97333-4716,Proprietary  ,5,13,18,52,130,182
01235000,PHAGANS SCHOOL OF HAIR DESIGN           ,OR,97267-4808,Proprietary  ,10,20,30,50,145,195
01235100,PHAGANS SCHOOL OF BEAUTY                ,OR,97301-4732,Proprietary  ,6,24,30,73,200,273
01300800,PHAGANS TIGARD BEAUTY SCHOOL            ,OR,97223-0000,Proprietary  ,2,1,3,24,84,108
02101000,NORTHWEST COLLEGE OF HAIR DESIGN        ,OR,97086-7702,Proprietary  ,28,50,78,201,511,712
02101002,NORTHWEST COLLEGE                       ,OR,97007-3954,Proprietary  ,2,6,8,28,89,117
02104900,COLLEGE OF LEGAL ARTS                   ,OR,97219-9998,Proprietary  ,11,53,64,80,433,513
02106100,COLLEGE OF COSMETOLOGY                  ,OR,97601-0000,Proprietary  ,6,8,14,45,100,145
02154400,BEAU MONDE CLG OF HAIR DESIGN           ,OR,97205-0000,Proprietary  ,7,39,46,134,381,515
02159700,NEW HOPE CHRISTIAN COLLEGE              ,OR,97405-1194,Private      ,5,10,15,146,162,308
02201900,PHAGANS' SCHOOL OF HAIR DESIGN          ,OR,97232-0000,Proprietary  ,9,48,57,137,410,547
02239203,ANTHEM COLLEGE - BEAVERTON              ,OR,97005-0000,Proprietary  ,2,16,18,63,187,250
02330100,PIONEER PACIFIC COLLEGE                 ,OR,97070-0000,Proprietary  ,46,191,237,464,1875,2339
02330102,PIONEER PACIFIC COLLEGE                 ,OR,97403-0000,Proprietary  ,24,110,134,227,1252,1479
02337900,COLLEGE OF HAIR DESIGN CAREERS          ,OR,97301-0000,Proprietary  ,8,11,19,80,128,208
02344100,ROSEBURG BEAUTY COLLEGE                 ,OR,97470-0000,Proprietary  ,3,10,13,33,107,140
02534000,NATIONAL COLLEGE OF NATURAL MEDICINE    ,OR,97201-0000,Private      ,2,20,22,47,843,890
02578800,NORTHWEST NANNIES INSTITUTE             ,OR,97035-0000,Proprietary  ,2,3,5,23,34,57
02603700,OREGON COL OF ORIENTAL MEDICINE         ,OR,97216-0000,Private      ,1,15,16,29,461,490
02617506,EVEREST COLLEGE - EVEREST INSTITUTE     ,OR,97223-6581,Proprietary  ,14,82,96,147,550,697
03007300,OREGON COLLEGE OF ART & CRAFT           ,OR,97225-6399,Private      ,4,23,27,204,399,603
03022600,LE CORDON BLEU COLLEGE OF CULINARY ARTS ,OR,97205-2793,Proprietary  ,83,345,428,1577,3172,4749
03042500,CARRINGTON COLLEGE                      ,OR,97232-1302,Proprietary  ,57,261,318,532,2192,2724
03074400,PHAGANS NEWPORT ACAD CSMTLGY CAREER     ,OR,97365-4963,Proprietary  ,1,12,13,17,79,96
03074500,EAST-WEST COLLEGE OF THE HEALING ARTS   ,OR,97232-2765,Proprietary  ,8,51,59,130,497,627
03185300,PHAGANS GRANTS PASS COLLEGE OF BTY      ,OR,97527-3039,Proprietary  ,4,19,23,45,122,167
03428300,KLAMATH COMMUNITY COLLEGE               ,OR,97603-7121,Public       ,44,222,266,640,1965,2605
03642300,VALLEY MEDICAL COLLEGE                  ,OR,97305-1373,Proprietary  ,25,101,126,153,697,850
03668300,BIRTHINGWAY COLLEGE OF MIDWIFERY        ,OR,97266-4042,Private      ,2,16,18,31,241,272
03783400,ABDILL CAREER COLLEGE                   ,OR,97504-7137,Proprietary  ,5,36,41,67,361,428
04146500,PORTLAND ACTORS CONSERVATORY            ,OR,97201-2557,Private      ,1,1,2,32,85,117
04167400,SAGE SCHOOL OF MASSAGE & HEALING ARTS   ,OR,97701-4082,Proprietary  ,4,12,16,17,67,84
04171400,AVEDA INSTITUTE PORTLAND                ,OR,97209-3144,Proprietary  ,27,45,72,122,177,299
00137400,ALBERTUS MAGNUS COLLEGE                 ,CT,06511-1189,Private      ,9,67,76,875,1247,2122
00137403,ALBERTUS MAGNUS CLG-NEW DIMENSIONS      ,CT,06511-0000,Private      ,4,55,59,64,822,886
00137800,CENTRAL CONNECTICUT STATE UNIV          ,CT,06050-2490,Public       ,114,191,305,10122,5020,15142
00137900,CONNECTICUT COLLEGE                     ,CT,06320-4196,Private      ,26,5,31,3334,166,3500
00138000,WESTERN CONNECTICUT STATE UNIV          ,CT,06810-6826,Public       ,83,66,149,6258,1821,8079
00138500,FAIRFIELD UNIVERSITY                    ,CT,06430-0000,Private      ,50,65,115,6521,1247,7768
00138700,HARTFORD SEMINARY                       ,CT,06105-0000,Private      ,0,4,4,9,74,83
00138900,HOLY APOSTLES COLLEGE & SEMINARY        ,CT,06416-2005,Private      ,0,1,1,12,73,85
00139200,MANCHESTER COMMUNITY COLLEGE            ,CT,06045-1046,Public       ,101,206,307,3811,3958,7769
00139300,MITCHELL COLLEGE                        ,CT,06320-4498,Private      ,10,11,21,1196,270,1466
00139700,UNIVERSITY OF NEW HAVEN                 ,CT,06516-1999,Private      ,104,78,182,7684,2193,9877
00139800,NORTHWESTERN CT COMMUNITY COLLEGE       ,CT,06098-1747,Public       ,14,34,48,665,833,1498
00139900,NORWALK COMMUNITY TECHNICAL COLLEGE     ,CT,06854-1655,Public       ,86,143,229,2318,2902,5220
00140100,POST UNIVERSITY                         ,CT,06723-3240,Proprietary  ,100,717,817,1765,4804,6569
00140200,QUINNIPIAC UNIVERSITY                   ,CT,06518-1908,Private      ,100,77,177,12243,1992,14235
00140201,QUINNIPIAC UNIVERSITY SCHOOL OF LAW     ,CT,06518-0000,Private      ,2,6,8,143,1328,1471
00140300,SACRED HEART UNIVERSITY                 ,CT,06825-1000,Private      ,55,125,180,7921,2151,10072
00140600,SOUTHERN CONNECTICUT STATE UNIV         ,CT,06515-1355,Public       ,99,147,246,9829,5553,15382
00140900,SAINT JOSEPH COLLEGE                    ,CT,06117-2791,Private      ,9,107,116,1330,1687,3017
00141400,TRINITY COLLEGE                         ,CT,06106-3100,Private      ,20,8,28,2904,290,3194
00141600,UNIVERSITY OF BRIDGEPORT                ,CT,06601-5650,Private      ,44,117,161,3353,3197,6550
00141700,UNIVERSITY OF CONNECTICUT-STORRS        ,CT,06269-2151,Public       ,249,194,443,26776,6152,32928
00141702,UNIV CONN STAMFORD                      ,CT,06901-0000,Public       ,10,25,35,576,408,984
00141703,UNIV OF CONNECTICUT - TORINGTON         ,CT,06790-0000,Public       ,2,4,6,174,86,260
00141706,UNIV OF CONNECTICUT SCH LAW             ,CT,06105-0000,Public       ,2,10,12,31,1351,1382
00141707,UNIV OF CT - SCH OF SOCIAL WORK         ,CT,06117-0000,Public       ,4,11,15,109,571,680
00141708,UNIVERSITY OF CONNECTICUT - SCHOOL OF ME,CT,06030-1920,Public       ,8,11,19,257,755,1012
00141709,UNIVERSITY OF CONNECTICUT - SCHOOL OF DE,CT,06030-1920,Public       ,14,8,22,503,678,1181
00142200,UNIVERSITY OF HARTFORD                  ,CT,06117-1599,Private      ,88,57,145,9661,2141,11802
00142400,WESLEYAN UNIVERSITY                     ,CT,06459-3208,Private      ,35,8,43,5535,215,5750
00142500,EASTERN CONNECTICUT STATE UNIV          ,CT,06226-2295,Public       ,61,53,114,5801,1438,7239
00142600,YALE UNIVERSITY                         ,CT,06520-8288,Private      ,112,93,205,16023,9102,25125
00280301,RENSSELAER POLYTECHNIC INSTITUTE-RENSSEL,CT,06120-2991,Private      ,0,11,11,15,76,91
00451300,HOUSATONIC COMMUNITY COLLEGE            ,CT,06604-4704,Public       ,71,147,218,3011,4476,7487
00618100,BRIDGEPORT HOSP SCHL OF NURSING         ,CT,06610-2896,Private      ,2,14,16,166,481,647
00619100,ST. VINCENT'S COLLEGE                   ,CT,06606-9966,Private      ,4,22,26,311,779,1090
00698200,NAUGATUCK VALLEY COMM-TECH COLG         ,CT,06708-3089,Public       ,107,185,292,3188,3847,7035
00730000,ELI WHITNEY TECHNICAL HIGH SCHOOL       ,CT,06514-0000,Public       ,0,5,5,12,78,90
00730300,LINCOLN TECHNICAL INSTITUTE             ,CT,06051-0000,Proprietary  ,113,288,401,1072,2661,3733
00730500,PORTER AND CHESTER INSTITUTE OF BRANFORD,CT,06405-4022,Proprietary  ,26,91,117,306,631,937
00731100,WINDHAM TECHNICAL HIGH SCHOOL           ,CT,06226-2100,Public       ,0,0,0,3,21,24
00745900,PAIER COLLEGE OF ART                    ,CT,06514-3902,Proprietary  ,0,7,7,190,80,270
00763500,CAPITAL COMMUNITY COLLEGE               ,CT,06103-1207,Public       ,46,140,186,1871,4572,6443
00803700,GATEWAY COMMUNITY-TECHNICAL COLLEGE     ,CT,06511-0000,Public       ,86,261,347,3030,5131,8161
00803800,MIDDLESEX COMMUNITY CLG                 ,CT,06457-4889,Public       ,31,112,143,1238,1628,2866
00887300,PAUL MITCHELL THE SCHOOL                ,CT,06810-6716,Proprietary  ,10,19,29,92,120,212
00887400,BRIO ACADEMY OF COSMETOLOGY             ,CT,06450-4836,Proprietary  ,22,84,106,188,497,685
00887403,BRIO ACADEMY OF COSMETOLOGY - WILLIMANTI,CT,06226-1940,Proprietary  ,0,0,0,8,23,31
00906500,THE HARTFORD CONSERVATORY               ,CT,06105-2891,Private      ,1,0,1,25,17,42
00927700,E C GOODWIN TECHNICAL HIGH SCHOOL       ,CT,06053-0000,Public       ,0,1,1,28,33,61
00929100,J M WRIGHT TECHNICAL HIGH SCHOOL        ,CT,06904-0000,Public       ,0,0,0,1,8,9
00940700,LINCOLN COLLEGE OF NEW ENGLAND          ,CT,06489-1057,Proprietary  ,44,116,160,923,903,1826
00940701,CLEMENS COLLEGE                         ,CT,06078-0000,Proprietary  ,2,2,4,144,53,197
00976400,TUNXIS COMMUNITY COLLEGE                ,CT,06032-3187,Public       ,53,109,162,1949,2342,4291
00976500,THREE RIVERS COMMUNITY TECH COLLEGE     ,CT,06360-0000,Public       ,60,169,229,1833,3048,4881
00982200,ALBERT I PRINCE TECHNICAL HIGH SCHOOL   ,CT,06106-3799,Public       ,0,1,1,12,74,86
01041700,BRIO ACADEMY OF EAST HARTFORD           ,CT,06108-2220,Proprietary  ,7,22,29,66,190,256
01053000,QUINEBAUG VALLEY COMMUNITY COLLEGE      ,CT,06239-1440,Public       ,26,65,91,879,1459,2338
01077900,PORTER AND CHESTER INSTITUTE-ALLCAMPUSES,CT,06615-7158,Proprietary  ,244,674,918,1714,4185,5899
01115000,ASNUNTUCK COMMUNITY COLLEGE             ,CT,06082-3800,Public       ,25,65,90,571,901,1472
01149600,BULLARD HAVENS VOC TECH SCHOOL          ,CT,06610-3499,Public       ,2,6,8,24,70,94
01169700,VINAL REGIONAL VOC TECH SCHOOL          ,CT,06457-4918,Public       ,0,6,6,4,37,41
01184300,NORWICH TECHNICAL HIGH SCHOOL           ,CT,06360-7097,Public       ,0,3,3,13,50,63
01218500,H C WILCOX TECHNICAL HIGH SCHOOL        ,CT,06450-0000,Public       ,0,0,0,3,4,7
01242500,STONE ACADEMY                           ,CT,06514-4125,Proprietary  ,27,144,171,235,1096,1331
01242503,STONE ACADEMY -WATERBURY                ,CT,06705-3823,Proprietary  ,1,6,7,28,93,121
01242504,STONE ACADEMY -  EAST HARTFORD          ,CT,06118-0000,Proprietary  ,4,12,16,23,136,159
01287700,SANFORD-BROWN COLLEGE                   ,CT,06855-1436,Proprietary  ,19,87,106,110,390,500
01291300,LEON INSTITUTE OF HAIR DESIGN           ,CT,06604-4226,Proprietary  ,3,2,5,15,63,78
01326400,HENRY ABBOTT TECHNICAL HIGH SCHOOL      ,CT,06811-4881,Public       ,1,0,1,6,27,33
02058900,HARVARD H ELLIS TECHNICAL HIGH SCHOOL   ,CT,06239-0000,Public       ,0,0,0,3,9,12
02074000,BRANFORD HALL CAREER INSTITUTE          ,CT,06405-0000,Proprietary  ,181,786,967,1161,4989,6150
02106600,AMERICAN INSTITUTE                      ,CT,06110-1922,Proprietary  ,12,95,107,117,731,848
02112300,RIDLEY LOWELL BUSINESS & TECH INST      ,CT,06320-0000,Proprietary  ,24,114,138,120,692,812
02112700,NORTH HAVEN ACADEMY                     ,CT,06473-3108,Proprietary  ,5,16,21,190,196,386
02115100,BUTLER BUSINESS SCHOOL                  ,CT,06604-0000,Proprietary  ,10,72,82,97,472,569
02148700,CONNECTICUT INST OF HAIR DESIGN         ,CT,06716-0000,Proprietary  ,3,2,5,29,55,84
02202500,NEW ENGLAND TRACTOR TRAILER SCH         ,CT,06071-2036,Proprietary  ,40,397,437,117,1562,1679
02213000,ELLA T GRASSO SOUTHEASTERN TECHNICAL HIG,CT,06340-0000,Public       ,0,0,0,3,12,15
02228800,LINCOLN TECHNICAL INSTITUTE - EAST WINDS,CT,06088-9631,Proprietary  ,94,125,219,1177,847,2024
02244900,GOODWIN COLLEGE                         ,CT,06118-9980,Private      ,60,406,466,1114,4613,5727
02245300,HOWELL CHENEY TECHNICAL HIGH SCHOOL     ,CT,06040-0000,Public       ,0,3,3,8,15,23
02265900,WINDHAM COMMUNITY MEM HOSP-RAD TECH     ,CT,06226-0000,Private      ,0,1,1,12,31,43
02296100,YALE-NEW HAVEN HOSP DIETETIC INTERN     ,CT,06510-8900,Private      ,0,4,4,18,31,49
02300000,W F KAYNOR TECHNICAL HIGH SCHOOL        ,CT,06708-0000,Public       ,0,10,10,14,53,67
02316600,CONNECTICUT CTR FOR MASSAGE THERAPY     ,CT,06111-3975,Proprietary  ,1,45,46,71,398,469
02316601,CONNECTICUT CENTER FOR MASSAGE THERAPY -,CT,06880-4619,Proprietary  ,6,32,38,40,222,262
02316603,CONNECTICUT CENTER FOR MASSAGE THERAPY -,CT,06340-4619,Proprietary  ,3,20,23,36,197,233
02562400,EMMETT O BRIEN REG VOC TECH SCHOOL      ,CT,06401-2500,Public       ,0,0,0,1,3,4
02565000,PLATT TECHNICAL HIGH SCHOOL             ,CT,06460-2105,Public       ,1,8,9,12,48,60
03079400,LYME ACADEMY COLLEGE OF FINE ARTS       ,CT,06371-2333,Private      ,0,0,0,80,45,125
03094800,INDUSTRIAL MANAGEMENT & TRAINING        ,CT,06706-1211,Proprietary  ,4,37,41,45,191,236
03231400,OLIVER WOLCOTT TECHNICAL HIGH SCHOOL    ,CT,06790-3859,Public       ,0,0,0,1,7,8
03234300,CHARTER OAK STATE COLLEGE               ,CT,06053-2150,Public       ,6,113,119,106,1572,1678
03316300,LINCOLN TECHNICAL INSTITUTE - HARTFORD  ,CT,06105-3630,Proprietary  ,23,88,111,608,765,1373
03381300,CONNECTICUT TRAINING CENTER             ,CT,06108-2705,Private      ,17,49,66,48,238,286
03927300,ALBERT SCHOOL (THE)                     ,CT,06357-2447,Proprietary  ,20,44,64,126,246,372
04104300,ACADEMY DI CAPELLI - SCHOOL OF COSMETOLO,CT,06492-0000,Proprietary  ,9,15,24,36,56,92
04128800,BRANFORD ACADEMY OF HAIR & COSMETOLOGY  ,CT,06405-0000,Proprietary  ,5,12,17,37,67,104
04145400,OXFORD ACADEMY OF HAIR DESIGN           ,CT,06483-2911,Proprietary  ,7,8,15,37,52,89
04148400,EUROPEAN ACADEMY OF COSMETOLOGY AND HAIR,CT,06437-0000,Proprietary  ,0,2,2,11,18,29
04152400,INTERNATIONAL INSTITUTE OF COSMETOLOGY  ,CT,06109-0000,Proprietary  ,7,6,13,71,79,150
04162900,TONSORIAL ACADEMY OF COSMETOLOGY AND BAR,CT,06516-0000,Proprietary  ,1,3,4,8,37,45
00146600,BARRY UNIVERSITY                        ,FL,33161-6695,Private      ,126,328,454,5211,9194,14405
00146601,BARRY UNIVERSITY - ORLANDO              ,FL,32807-3673,Private      ,9,36,45,219,1880,2099
00146700,BETHUNE COOKMAN UNIVERSITY              ,FL,32114-3099,Private      ,203,75,278,7907,1804,9711
00146800,ST THOMAS UNIVERSITY                    ,FL,33054-0000,Private      ,51,91,142,1465,2882,4347
00146900,FLORIDA INSTITUTE OF TECHNOLOGY         ,FL,32901-6988,Private      ,61,777,838,3730,9769,13499
00147000,BREVARD COMMUNITY COLLEGE               ,FL,32922-6503,Public       ,268,733,1001,6054,10872,16926
00147100,CENTRAL FLORIDA COMMUNITY COLLEGE       ,FL,34478-1388,Public       ,144,459,603,4975,8996,13971
00147200,CHIPOLA  COLLEGE                        ,FL,32446-2053,Public       ,26,76,102,1022,1469,2491
00147300,CLEARWATER CHRISTIAN COLLEGE            ,FL,33759-0000,Private      ,12,15,27,849,215,1064
00147500,DAYTONA STATE COLLEGE                   ,FL,32114-2800,Public       ,356,1065,1421,8513,16278,24791
00147700,EDISON STATE COLLEGE                    ,FL,33906-6210,Public       ,245,523,768,8037,11935,19972
00147800,EDWARD WATERS COLLEGE                   ,FL,32209-6199,Private      ,36,48,84,1493,921,2414
00147900,EMBRY-RIDDLE AERONAUTICAL UNIV          ,FL,32114-3900,Private      ,125,736,861,7396,7040,14436
00148000,FLORIDA A & M UNIVERSITY                ,FL,32307-3100,Public       ,606,206,812,19479,8998,28477
00148100,FLORIDA ATLANTIC UNIVERSITY             ,FL,33431-6498,Public       ,1110,680,1790,19328,15668,34996
00148101,FLORIDA ATLANTIC UNIVERSITY/DAVIE       ,FL,33314-0000,Public       ,60,137,197,1701,3504,5205
00148103,FLORIDA ATLANTIC UNIV-JUPITER/PSL       ,FL,33458-0000,Public       ,22,36,58,604,754,1358
00148200,FLORIDA COLLEGE                         ,FL,33617-5578,Private      ,6,4,10,472,122,594
00148400,FLORIDA STATE COLLEGE AT JACKSONVILLE   ,FL,32202-4030,Public       ,636,2141,2777,13550,29598,43148
00148500,FLORIDA KEYS COMMUNITY COLLEGE          ,FL,33040-4397,Public       ,19,79,98,572,1082,1654
00148600,FLORIDA MEMORIAL UNIVERSITY             ,FL,33054-6199,Private      ,74,74,148,3056,1645,4701
00148700,ECKERD COLLEGE                          ,FL,33711-4744,Private      ,36,87,123,2855,1285,4140
00148800,FLORIDA SOUTHERN COLLEGE                ,FL,33801-5698,Private      ,56,46,102,3325,1124,4449
00148900,FLORIDA STATE UNIVERSITY                ,FL,32306-2430,Public       ,1976,552,2528,39547,19023,58570
00149000,GULF COAST COMMUNITY COLLEGE            ,FL,32401-1058,Public       ,83,301,384,2417,5526,7943
00149300,INDIAN RIVER STATE COLLEGE              ,FL,34981-5596,Public       ,259,697,956,6449,11629,18078
00149500,JACKSONVILLE UNIVERSITY                 ,FL,32211-3394,Private      ,145,298,443,5202,4322,9524
00149700,JONES COLLEGE                           ,FL,32211-5588,Private      ,7,41,48,131,1180,1311
00149900,EVEREST UNIVERSITY                      ,FL,32810-5601,Proprietary  ,46,269,315,603,3282,3885
00149901,EVEREST UNIVERSITY - ORLANDO SOUTH      ,FL,32819-7666,Proprietary  ,585,6030,6615,2680,28617,31297
00149902,EVEREST UNIVERSITY - MELBOURNE          ,FL,32905-6609,Proprietary  ,18,141,159,222,1756,1978
00150000,BROWARD COLLEGE- DOWNTOWN CTR           ,FL,33301-2298,Public       ,365,855,1220,7496,12830,20326
00150001,BROWARD COLLEGE - DAVIE CAMPUS          ,FL,33314-0000,Public       ,296,508,804,8234,8982,17216
00150002,BROWARD COLLEGE- NORTH CAMPUS           ,FL,33066-0000,Public       ,185,442,627,5176,7444,12620
00150003,BROWARD COLLEGE- SOUTH CAMPUS           ,FL,33024-0000,Public       ,198,417,615,5716,7254,12970
00150100,LAKE CITY COMMUNITY COLLEGE             ,FL,32025-2007,Public       ,51,165,216,1246,3236,4482
00150200,LAKE SUMTER COMMUNITY COLLEGE           ,FL,34788-8751,Public       ,83,185,268,2380,3400,5780
00150400,MANATEE COMMUNITY COLLEGE               ,FL,34207-3596,Public       ,128,339,467,5488,9368,14856
00150500,LYNN UNIVERSITY                         ,FL,33431-5598,Private      ,59,45,104,1992,982,2974
00150600,MIAMI DADE COLLEGE ADMINISTRATION ONLY  ,FL,33176-3393,Public       ,70,134,204,1914,1962,3876
00150601,MIAMI DADE COLLEGE - NORTH CAMPUS       ,FL,33167-3495,Public       ,528,1039,1567,11654,15816,27470
00150602,MIAMI DADE COLLEGE - KENDALL CAMPUS     ,FL,33176-3393,Public       ,762,1058,1820,16779,15362,32141
00150603,MIAMI DADE COLLEGE - WOLFSON CAMPUS     ,FL,33132-2297,Public       ,435,657,1092,8265,9741,18006
00150604,MIAMI DADE COLLEGE - MEDICAL CAMPUS     ,FL,33127-4693,Public       ,111,339,450,2477,5814,8291
00150605,MIAMI DADE COLLEGE - HOMESTEAD CAMPUS   ,FL,33030-6009,Public       ,112,209,321,2174,2916,5090
00150606,MIAMI DADE COLLEGE -INTERAMERICAN CAMPUS,FL,33135-0000,Public       ,223,519,742,3831,7070,10901
00150607,MIAMI DADE COLLEGE - HIALEAH CAMPUS     ,FL,33012-2918,Public       ,138,302,440,2669,3499,6168
00150800,NORTH FLORIDA COMMUNITY COLLEGE         ,FL,32340-1699,Public       ,34,65,99,574,1116,1690
00150900,NOVA SOUTHEASTERN UNIVERSITY            ,FL,33314-7796,Private      ,168,1534,1702,6609,34645,41254
00151000,NORTHWEST FLORIDA STATE COLLEGE         ,FL,32578-1295,Public       ,59,338,397,2322,5444,7766
00151200,PALM BEACH COMMUNITY COLLEGE            ,FL,33461-4796,Public       ,456,932,1388,13599,17429,31028
00151300,PENSACOLA STATE COLLEGE                 ,FL,32504-8998,Public       ,190,614,804,4693,10016,14709
00151400,POLK STATE COLLEGE                      ,FL,33881-4299,Public       ,143,387,530,4558,7599,12157
00151500,ROLLINS COLLEGE                         ,FL,32789-4499,Private      ,56,66,122,2607,1516,4123
00151900,SANTA FE COLLEGE                        ,FL,32606-6200,Public       ,283,549,832,8886,9551,18437
00152000,SEMINOLE STATE COLLEGE OF FLORIDA       ,FL,32773-6199,Public       ,310,860,1170,8565,14883,23448
00152100,SOUTHEASTERN UNIVERSITY                 ,FL,33801-6099,Private      ,47,54,101,2892,1416,4308
00152200,SOUTH FLORIDA COMMUNITY COLLEGE         ,FL,33825-9399,Public       ,50,116,166,1507,2342,3849
00152300,SAINT JOHNS RIVER STATE COLLEGE         ,FL,32177-3897,Public       ,93,249,342,2412,4575,6987
00152600,SAINT LEO UNIVERSITY                    ,FL,33574-6665,Private      ,68,902,970,3497,15269,18766
00152800,ST. PETERSBURG COLLEGE                  ,FL,33760-3768,Public       ,364,1291,1655,9429,22980,32409
00153100,STETSON UNIVERSITY                      ,FL,32723-3761,Private      ,62,52,114,2894,1013,3907
00153101,STETSON UNIVERSITY - COLLEGE OF LAW     ,FL,33707-3299,Private      ,4,21,25,46,2028,2074
00153300,TALLAHASSEE COMMUNITY COLLEGE           ,FL,32304-2895,Public       ,407,469,876,9740,10057,19797
00153400,EVEREST UNIVERSITY                      ,FL,33614-5801,Proprietary  ,99,496,595,824,6008,6832
00153408,EVEREST UNIVERSITY - TAMPA BRANDON CAMPU,FL,33619-1354,Proprietary  ,208,2323,2531,1721,22875,24596
00153409,EVEREST UNIVERSITY - ORANGE PARK        ,FL,32073-1111,Proprietary  ,25,172,197,307,1945,2252
00153500,UNIVERSITY OF FLORIDA                   ,FL,32611-3150,Public       ,1604,597,2201,36253,20417,56670
00153600,UNIVERSITY OF MIAMI                     ,FL,33146-6531,Private      ,437,215,652,18336,6970,25306
00153601,UNIV OF MIAMI SCHOOL OF LAW             ,FL,33124-0000,Private      ,6,4,10,95,1971,2066
00153602,UNIV OF MIAMI-SCH OF MEDICINE           ,FL,33136-0000,Private      ,45,38,83,731,1390,2121
00153700,UNIVERSITY OF SOUTH FLORIDA             ,FL,33620-6960,Public       ,1951,799,2750,36204,26309,62513
00153701,UNIV OF SOUTH FLORIDA-ST PETERSBURG     ,FL,33701-0000,Public       ,64,73,137,687,878,1565
00153702,UNIV OF SOUTH FLORIDA-SARASOTA          ,FL,34243-2025,Public       ,17,44,61,323,836,1159
00153705,UNIV OF SOUTH FLORIDA                   ,FL,33803-0000,Public       ,91,51,142,1046,844,1890
00153706,UNIV OF SOUTH FLORIDA- MEDICINE         ,FL,33612-0000,Public       ,89,31,120,761,1248,2009
00153800,UNIVERSITY OF TAMPA                     ,FL,33606-1490,Private      ,216,116,332,9242,3088,12330
00154000,WEBBER INTERNATIONAL UNIVERSITY         ,FL,33827-0096,Private      ,16,11,27,839,296,1135
00173308,NATIONAL-LOUIS UNIVERSITY               ,FL,33609-0000,Private      ,0,6,6,16,105,121
00177201,TRINITY INTERNATIONAL UNIVERSITY - SOUTH,FL,33324-4611,Private      ,1,56,57,38,507,545
00395400,UNIV OF CENTRAL FLORIDA                 ,FL,32816-0001,Public       ,2507,1011,3518,50193,25789,75982
00395500,UNIVERSITY OF WEST FLORIDA              ,FL,32514-5750,Public       ,219,284,503,7011,6808,13819
00407215,NORTHWOOD UNIVERSITY                    ,FL,33409-0000,Private      ,4,20,24,588,409,997
00491004,KAPLAN CAREER INSTITUTE - KAPLAN COLLEGE,FL,33026-3978,Proprietary  ,16,177,193,240,3689,3929
00491005,KAPLAN COLLEGE JACKSONVILLE             ,FL,32216-3216,Proprietary  ,15,189,204,29,494,523
00558500,LIVELY TECHNICAL CENTER                 ,FL,32304-0000,Public       ,19,82,101,510,2154,2664
00558501,LIVELY TECHNICAL CENTER - AVIATION SCHOO,FL,32304-8723,Public       ,0,0,0,55,135,190
00558600,LINDSEY HOPKINS TECHNICAL ED CENTER     ,FL,33127-4692,Public       ,20,101,121,276,1162,1438
00559400,D G ERWIN TECHNICAL CENTER              ,FL,33610-8255,Public       ,26,183,209,643,2513,3156
00560500,PINELLAS TECH ED CTR-CLEARWATER         ,FL,33760-2194,Public       ,47,208,255,429,1973,2402
00560700,SARASOTA COUNTY TECHNICAL INSTITUTE     ,FL,34233-0000,Public       ,13,78,91,281,1054,1335
00560800,TRAVISS TECHNICAL CENTER                ,FL,33803-0000,Public       ,19,94,113,363,1419,1782
00561200,MANATEE TECHNICAL INSTITUTE             ,FL,34210-0000,Public       ,31,112,143,479,1617,2096
00561201,MANATEE TECHNICAL INSTITUTE-EAST        ,FL,34211-0000,Public       ,6,47,53,254,1005,1259
00675000,VALENCIA COMMUNITY COLLEGE              ,FL,32802-3028,Public       ,1729,1770,3499,27618,29296,56914
00732910,ITT TECHNICAL INSTITUTE                 ,FL,33634-7515,Proprietary  ,193,562,755,1484,4435,5919
00732947,ITT TECHNICAL INSTITUTE                 ,FL,32746-1607,Proprietary  ,169,432,601,1366,3975,5341
00752500,SUWANNEE-HAMILTON AREA VOC TECH CTR     ,FL,32060-0000,Public       ,9,45,54,89,376,465
00752600,WASHINGTON HOLMES TECHNICAL CENTER      ,FL,32428-1699,Public       ,20,61,81,163,626,789
00755800,LEE COUNTY HIGH TECH CENTER CENTRAL     ,FL,33916-2299,Public       ,20,97,117,427,1416,1843
00758600,REMINGTON COLLEGE - TAMPA CAMPUS        ,FL,33612-8410,Proprietary  ,10,68,78,202,917,1119
00758604,REMINGTON COLLEGE-LARGO CAMPUS          ,FL,33771-0000,Proprietary  ,0,0,0,0,1,1
00787000,HILLSBOROUGH COMMUNITY COLLEGE          ,FL,33606-3572,Public       ,437,1158,1595,14988,23355,38343
00789300,FLAGLER COLLEGE                         ,FL,32085-1027,Private      ,53,16,69,3518,680,4198
00789301,FLAGLER COLLEGE - TALLAHASSEE COMMUNITY ,FL,32304-2895,Private      ,12,21,33,438,801,1239
00807500,ST JOHN VIANNEY COLLEGE SEMINARY        ,FL,33165-3244,Private      ,2,1,3,25,12,37
00814600,EVEREST UNIVERSITY - POMPANO BEACH      ,FL,33062-2522,Proprietary  ,28,313,341,468,3634,4102
00822300,ST VINCENT DE PAUL REGIONL SEMINARY     ,FL,33436-0000,Private      ,2,0,2,4,7,11
00841700,STENOTYPE INST OF JACKSONVILLE          ,FL,32207-0000,Proprietary  ,4,53,57,46,527,573
00869410,RASMUSSEN COLLEGE - OCALA               ,FL,34471-7051,Proprietary  ,94,809,903,881,6959,7840
00869411,RASMUSSEN COLLEGE - NEW PORT RICHEY     ,FL,34690-4554,Proprietary  ,23,122,145,317,1508,1825
00869413,RASMUSSEN COLLEGE - FORT MYERS          ,FL,33905-7805,Proprietary  ,27,125,152,327,1243,1570
00869420,RASMUSSEN COLLEGE - TAMPA               ,FL,33610-9558,Proprietary  ,10,56,66,28,159,187
00884800,WARNER UNIVERSITY                       ,FL,33859-8725,Private      ,12,44,56,636,785,1421
00884900,PALM BEACH ATLANTIC UNIVERSITY          ,FL,33401-6505,Private      ,49,98,147,2944,2731,5675
00887800,MIAMI INTERNATIONAL UNIV ART&DESIGN     ,FL,33132-1418,Proprietary  ,153,312,465,3742,3533,7275
00910400,RIVERSIDE HAIRSTYLING ACADEMY           ,FL,32207-3810,Proprietary  ,1,19,20,39,132,171
00962111,HERZING UNIVERSITY - ORLANDO            ,FL,32792-5544,Proprietary  ,1,18,19,60,339,399
00963500,FLORIDA INTERNATIONAL UNIVERSITY        ,FL,33199-0001,Public       ,1599,1029,2628,30226,29656,59882
00984100,UNIVERSITY OF NORTH FLORIDA             ,FL,32224-2645,Public       ,736,374,1110,13875,9265,23140
00990200,SHERIDAN TECHNICAL CENTER               ,FL,33021-3399,Public       ,52,262,314,603,2309,2912
01016100,"LORAINE'S ACADEMY, INC                  ",FL,33710-0000,Proprietary  ,9,37,46,57,309,366
01019500,ART INSTITUTE OF FT LAUDERDALE          ,FL,33316-3000,Proprietary  ,95,217,312,2613,2889,5502
01065200,PASCO-HERNANDO COMMUNITY CLG            ,FL,34654-5199,Public       ,161,433,594,4880,8708,13588
01072401,CARLOS ALBIZU UNIVERSITY                ,FL,33172-0000,Private      ,7,52,59,147,1315,1462
01082600,TOM P. HANEY TECHNICAL CENTER           ,FL,32405-5099,Public       ,10,91,101,228,1258,1486
01112700,GOODING INST OF NUR ANES BAY MED CT     ,FL,32401-0000,Public       ,0,1,1,11,116,127
01226300,ATLANTIC TECHNICAL CENTER               ,FL,33063-3902,Public       ,48,135,183,539,1898,2437
01254400,FIRST COAST TECHNICAL COLLEGE           ,FL,32084-1921,Public       ,37,94,131,326,1131,1457
01257400,RINGLING SCHOOL OF ART AND DESIGN       ,FL,34234-5895,Private      ,28,15,43,1981,429,2410
01303904,SOUTH UNIVERSITY - WEST PALM BEACH CAMPU,FL,33409-5149,Proprietary  ,24,173,197,503,2102,2605
01323400,LORENZO WALKER INST OF TECHNOLOGY       ,FL,34104-4405,Public       ,12,34,46,260,848,1108
02052002,FLORIDA EDUCATION CENTER - LAUDERHILL   ,FL,33313-5857,Proprietary  ,0,0,0,10,32,42
02089600,CONCORDE CAREER INSTITUTE               ,FL,32211-0000,Proprietary  ,19,174,193,273,1775,2048
02106602,AMERICAN INSTITUTE - AMERICAN INSTITUTE ,FL,34747-5161,Proprietary  ,0,1,1,0,1,1
02113609,AMERICAN INTERCONTINENTAL UNIV - WESTON ,FL,33326-3233,Proprietary  ,25,111,136,450,1197,1647
02115300,PINELLAS TECHNICAL EDUCATION CENTERS - S,FL,33711-0000,Public       ,33,238,271,412,2169,2581
02116006,SANFORD-BROWN INSTITUTE - FT. LAUDERDALE,FL,33309-1906,Proprietary  ,27,123,150,254,1158,1412
02121800,EVEREST INSTITUTE                       ,FL,33169-4759,Proprietary  ,42,237,279,466,1891,2357
02121801,EVEREST INSTITUTE  - HIALEAH            ,FL,33012-7193,Proprietary  ,8,31,39,320,674,994
02148200,FASHION FOCUS HAIR ACADEMY              ,FL,34231-0000,Proprietary  ,5,10,15,30,114,144
02148300,MANHATTAN BEAUTY SCHOOL                 ,FL,33611-0000,Proprietary  ,27,133,160,163,713,876
02149900,PAUL MITCHELL THE SCHOOL-JACKSONVILLE   ,FL,32205-0000,Proprietary  ,33,81,114,243,520,763
02151900,KEISER  UNIVERSITY                      ,FL,33309-0000,Proprietary  ,390,2014,2404,5187,20460,25647
02156300,MARGATE SCHOOL OF BEAUTY                ,FL,33063-0000,Proprietary  ,24,96,120,149,594,743
02156700,FLORIDA CHRISTIAN COLLEGE               ,FL,34744-0000,Private      ,5,9,14,301,278,579
02159600,BAPTIST COLLEGE OF FLORIDA (THE)        ,FL,32440-0000,Private      ,6,22,28,346,362,708
02172700,CONCORDE CAREER INSTITUTE               ,FL,33607-0000,Proprietary  ,22,107,129,192,980,1172
02188900,HOBE SOUND BIBLE COLLEGE                ,FL,33475-0000,Private      ,5,3,8,93,100,193
02200100,BRADENTON BEAUTY & BARBER ACADEMY       ,FL,34209-0000,Proprietary  ,5,22,27,68,236,304
02215900,ATI CAREER TRAINING CENTER              ,FL,33309-1785,Proprietary  ,59,196,255,382,1351,1733
02218700,FLORIDA TECHNICAL COLLEGE               ,FL,32826-2707,Proprietary  ,45,267,312,540,2806,3346
02218707,FLORIDA TECHNICAL COLLEGE - LAKELAND    ,FL,33813-2101,Proprietary  ,4,24,28,93,586,679
02218709,FLORIDA TECHNICAL COLLEGE - DELAND      ,FL,32720-7415,Proprietary  ,21,131,152,90,477,567
02228300,LAKE TECHNICAL CENTER                   ,FL,32726-0000,Public       ,15,74,89,340,1214,1554
02245500,FORTIS COLLEGE                          ,FL,32789-4679,Proprietary  ,24,118,142,546,1024,1570
02257900,INTERNATIONAL ACADEMY                   ,FL,32119-3541,Proprietary  ,15,55,70,94,291,385
02275100,CONCORDE CAREER INSTITUTE               ,FL,33025-0000,Proprietary  ,17,105,122,169,820,989
02278800,SOUTHWEST FLORIDA COLLEGE               ,FL,33907-0000,Proprietary  ,41,233,274,547,2441,2988
02278801,SOUTHWEST FLORIDA COLLEGE - TAMPA       ,FL,33619-1344,Proprietary  ,15,62,77,350,870,1220
02278802,SOUTHWEST FLORIDA COLLEGE - INSTITUTUE O,FL,33928-9469,Proprietary  ,0,6,6,14,29,43
02278803,SOUTHWEST FLORIDA COLLEGE - PORT CHARLOT,FL,33953-3100,Proprietary  ,17,85,102,128,688,816
02279600,CORTIVA INSTITUTE - FLORIDA             ,FL,33781-0000,Proprietary  ,9,32,41,71,307,378
02280800,NEW ENGLAND INST TECH-PALM BEACH        ,FL,33407-0000,Proprietary  ,72,333,405,1045,3656,4701
02283800,BEAUTY SCHOOLS OF AMERICA               ,FL,33012-3322,Proprietary  ,120,628,748,734,3299,4033
02287100,LA BELLE BEAUTY SCHOOL                  ,FL,33012-3224,Proprietary  ,9,77,86,42,342,384
02293200,ATI CAREER TRAINING CENTER              ,FL,33309-5916,Proprietary  ,281,802,1083,1596,5920,7516
02293201,ATI CAREER TRAINING CENTER - MIAMI      ,FL,33122-1707,Proprietary  ,6,28,34,67,230,297
02293202,ATI CAREER TAINING CENTER - ATI COLLEGE ,FL,87109-2016,Proprietary  ,18,64,82,74,313,387
02293600,ADVANCED TECHNICAL CENTERS              ,FL,33266-1597,Private      ,0,14,14,24,105,129
02297000,CHARLOTTE TECHNICAL CENTER              ,FL,33948-0000,Public       ,12,30,42,215,710,925
02300900,WITHLACOOCHEE TECHNICAL INSTITUTE       ,FL,34450-0000,Public       ,9,54,63,227,850,1077
02305700,FORTIS COLLEGE                          ,FL,33619-1283,Proprietary  ,8,59,67,175,757,932
02305800,FLORIDA CAREER COLLEGE                  ,FL,33012-7028,Proprietary  ,271,877,1148,2255,7502,9757
02307400,GEORGE STONE AREA VOCATIONAL TECHNICAL  ,FL,32526-0000,Public       ,39,156,195,314,1309,1623
02314100,SCHILLER INTERNATIONAL UNIVERSITY       ,FL,33770-0000,Proprietary  ,5,37,42,70,237,307
02316200,MIAMI LAKES TECHNICAL EDUCATION CTR     ,FL,33014-0000,Public       ,46,151,197,423,1345,1768
02321200,ORANGE TECH EDUC CTR- WESTSIDE TECH     ,FL,34787-0000,Public       ,29,114,143,283,959,1242
02325100,KEY COLLEGE                             ,FL,33004-3046,Proprietary  ,3,17,20,31,135,166
02326303,MEDVANCE INSTITUTE - WEST PALM          ,FL,33461-2171,Proprietary  ,28,153,181,298,1152,1450
02326306,MEDVANCE INSTITUTE - MIAMI              ,FL,33173-3431,Proprietary  ,13,43,56,111,443,554
02326800,MERIDIAN COLLEGE                        ,FL,34240-8478,Proprietary  ,16,52,68,85,444,529
02326801,MERIDIAN CAREER INSTITUTE -             ,FL,33619-1378,Proprietary  ,2,21,23,38,204,242
02326900,SUNSTATE ACADEMY OF HAIR DESIGN         ,FL,33907-1415,Proprietary  ,13,57,70,176,371,547
02329900,FLORIDA INSTITUTE OF ULTRASOUND         ,FL,32514-0000,Proprietary  ,2,12,14,84,334,418
02338400,FT PIERCE BEAUTY ACADEMY                ,FL,34982-0000,Proprietary  ,26,97,123,113,468,581
02341001,FORTIS COLLEGE - DBA FORTIS INSTITUTE   ,FL,32504-7322,Proprietary  ,0,0,0,56,233,289
02346200,WYOTECH                                 ,FL,32174-1010,Proprietary  ,61,159,220,730,1270,2000
02362100,FULL SAIL UNIVERSITY                    ,FL,32792-0000,Proprietary  ,797,2516,3313,11707,19055,30762
02499000,ACADEMY OF COSMETOLOGY                  ,FL,32953-3311,Proprietary  ,9,39,48,71,211,282
02501500,"O*TEC, MID-FLORIDA TECH                 ",FL,32809-0000,Public       ,42,204,246,505,1622,2127
02504600,WINTER PARK TECH                        ,FL,32789-0000,Public       ,22,91,113,167,793,960
02508900,TALMUDIC COLLEGE OF FLORIDA             ,FL,33139-0000,Private      ,3,0,3,40,13,53
02511700,RIDGE TECHNICAL CENTER                  ,FL,33881-0000,Public       ,18,89,107,283,1214,1497
02513200,ORLANDO TECHNICAL CENTER                ,FL,32801-0000,Public       ,29,140,169,464,1768,2232
02515400,CITY COLLEGE                            ,FL,33309-3073,Private      ,27,198,225,537,2461,2998
02517100,SARASOTA SCHOOL OF MASSAGE THERAPY      ,FL,34243-6130,Proprietary  ,4,17,21,41,158,199
02524000,SUNSTATE ACADEMY OF HAIR DESIGN         ,FL,34624-0000,Proprietary  ,12,30,42,112,194,306
02524200,ROBERT MORGAN EDUCATIONAL CENTER        ,FL,33177-0000,Public       ,45,125,170,508,1275,1783
02547600,FLORIDA NATIONAL COLLEGE                ,FL,33012-0000,Proprietary  ,100,358,458,1073,3274,4347
02554200,RADFORD LOCKLIN TECH CENTER             ,FL,32570-0000,Public       ,4,15,19,64,243,307
02573200,LA BELLE BEAUTY ACADEMY                 ,FL,33135-0000,Proprietary  ,7,63,70,75,411,486
02586200,FLORIDA CAREER COLLEGE                  ,FL,33759-3924,Proprietary  ,19,103,122,165,894,1059
02586201,FLORIDA CAREER COLLEGE -                ,FL,33569-2553,Proprietary  ,0,0,0,17,42,59
02597100,HERITAGE INSTITUTE                      ,FL,33912-7132,Proprietary  ,47,165,212,411,1594,2005
02598200,SOUTHERN CAREER COLLEGE                 ,FL,32211-5123,Proprietary  ,4,59,63,131,571,702
02599800,EVEREST UNIVERSITY                      ,FL,33770-2556,Proprietary  ,11,140,151,237,1552,1789
02599801,EVEREST UNIVERSITY - TAMPA LAKELAND CAMP,FL,33801-3801,Proprietary  ,19,137,156,296,1852,2148
02599805,EVEREST UNIVERSITY - JACKSONVILLE       ,FL,32256-0000,Proprietary  ,23,189,212,410,2372,2782
02601600,HENRY W BREWSTER TECHNICAL CENTER       ,FL,33602-0000,Public       ,17,89,106,208,945,1153
02612700,ACADEMY OF COSMETOLOGY-PALM BAY         ,FL,32905-2805,Proprietary  ,7,28,35,29,168,197
02616400,SANFORD-BROWN INSTITUTE                 ,FL,32256-3520,Proprietary  ,64,304,368,661,3513,4174
02616401,SANFORD-BROWN INSTITUTE - TAMPA         ,FL,33610-8304,Proprietary  ,41,155,196,389,1853,2242
03003200,EVEREST INSTITUTE                       ,FL,33186-1410,Proprietary  ,32,101,133,456,1156,1612
03003201,EVEREST INSTITUTE - FT. LAUDERDALE      ,FL,33304-2522,Proprietary  ,12,86,98,179,832,1011
03003600,MCFATTER TECHNICAL CENTER               ,FL,33317-7499,Public       ,36,143,179,489,1536,2025
03006801,PENNSYLVANIA CULINARY INSTITUTE - LE COR,FL,33025-3929,Proprietary  ,26,127,153,512,1729,2241
03008600,FLORIDA COLLEGE OF NATURAL HEALTH       ,FL,33064-1342,Proprietary  ,40,203,243,395,1635,2030
03010608,VIRGINIA COLLEGE - PENSACOLA            ,FL,32501-5650,Proprietary  ,15,127,142,182,1420,1602
03010612,VIRGINIA COLLEGE - GOLF ACADEMY OF AMERI,FL,32701-0000,Proprietary  ,5,34,39,129,327,456
03010618,VIRGINIA COLLEGE - JACKSONVILLE         ,FL,32207-5167,Proprietary  ,8,49,57,78,564,642
03012300,ASM BEAUTY WORLD ACADEMY                ,FL,33021-0000,Proprietary  ,7,35,42,28,174,202
03018500,BENE'S INTERNATIONAL SCHOOL OF BEAUTY   ,FL,34652-1637,Proprietary  ,34,69,103,125,426,551
03028200,TRINITY COLLEGE OF FLORIDA              ,FL,34655-4401,Private      ,4,9,13,158,143,301
03031400,INTERNATIONAL ACADEMY OF DESIGN AND TECH,FL,33634-6313,Proprietary  ,178,665,843,2481,6406,8887
03031402,INTERNATIONAL ACADEMY OF DESIGN AND TECH,FL,32809-4613,Proprietary  ,33,73,106,912,1203,2115
03031403,IADT - ORLANDO CULINARY ACADEMY         ,FL,32819-0000,Proprietary  ,7,38,45,302,502,804
03035800,HERITAGE INSTITUTE                      ,FL,32216-0948,Proprietary  ,14,101,115,128,731,859
03035900,NATIONAL AVIATION ACADEMY               ,FL,33760-3931,Proprietary  ,21,94,115,291,749,1040
03037500,HODGES UNIVERSITY                       ,FL,34119-7932,Private      ,44,352,396,707,4268,4975
03054200,FORTIS COLLEGE                          ,FL,33144-2373,Proprietary  ,31,70,101,520,567,1087
03071600,COLLEGE OF BUSINESS & TECHNOLOGY        ,FL,33176-0000,Proprietary  ,29,251,280,246,1635,1881
03071601,COLLEGE OF BUSINESS & TECHNOLOGY -      ,FL,33144-2072,Proprietary  ,0,0,0,55,87,142
03071602,COLLEGE OF BUSINESS & TECHNOLOGY -      ,FL,33012-3436,Proprietary  ,0,0,0,10,35,45
03076402,BRYMAN SCHOOL OF ARIZONA (THE) - ANTHEM ,FL,32803-3509,Proprietary  ,1,9,10,95,290,385
03079800,GEORGE T BAKER AVIATION                 ,FL,33142-5687,Public       ,35,45,80,336,473,809
03079900,CITY COLLEGE                            ,FL,32707-5342,Private      ,5,60,65,78,597,675
03083702,GALEN HEALTH INSTITUTES - FLORIDA CAMPUS,FL,33702-2455,Proprietary  ,0,0,0,23,112,135
03089200,NOUVELLE INSTITUTE                      ,FL,33125-4141,Proprietary  ,9,93,102,51,559,610
03096300,FORTIS INSTITUTE                        ,FL,33860-0000,Proprietary  ,5,29,34,59,261,320
03099600,MERCY HOSPITAL SCHOOL OF PRACTICAL NSG  ,FL,33133-4237,Private      ,2,17,19,86,269,355
03100800,TAYLOR TECHNICAL INSTITUTE              ,FL,32348-0894,Public       ,3,23,26,72,306,378
03101900,TRINITY BAPTIST COLLEGE                 ,FL,32221-1398,Private      ,7,13,20,215,174,389
03103900,MARION COUNTY COMMUNITY TECH & ADUL     ,FL,34474-3172,Public       ,12,64,76,391,1435,1826
03108500,EVERGLADES UNIVERSITY                   ,FL,33431-0000,Private      ,18,236,254,222,1842,2064
03108600,COM-PU-MED VOCATIONAL CAREERS           ,FL,33012-4861,Proprietary  ,13,97,110,71,506,577
03113400,ACADEMY OF HEALING ARTS                 ,FL,33463-2113,Proprietary  ,5,32,37,32,190,222
03114700,PRAXIS INSTITUTE                        ,FL,33135-2657,Proprietary  ,31,232,263,144,1077,1221
03115500,FLORIDA HOSPITAL COLG OF HEALTH SCI     ,FL,32803-1237,Private      ,59,203,262,1352,3373,4725
03123900,KEISER CAREER COLLEGE                   ,FL,33413-0000,Proprietary  ,43,165,208,591,2148,2739
03125600,MIAMI AD SCHOOL                         ,FL,33139-5203,Proprietary  ,6,32,38,80,451,531
03127900,TECHNICAL EDUCATION CTR OSCEOLA         ,FL,34744-4459,Public       ,24,142,166,337,1103,1440
03158300,LEE COUNTY HIGH TECH CENTER NORTH       ,FL,33993-2479,Public       ,19,47,66,184,646,830
03171300,UNIVERSITY OF ST. AUGUSTINE FOR HEALTH S,FL,32084-4215,Proprietary  ,1,79,80,38,1352,1390
03178400,CORAL RIDGE NURSES ASST TRAINING        ,FL,33306-0000,Proprietary  ,1,7,8,25,153,178
03224300,NEW PROFESSIONS TECHNICAL INSTITUTE     ,FL,33134-1640,Proprietary  ,16,162,178,69,805,874
03230300,CHOICE HIGH SCHOOL AND TECHNICAL CENTER ,FL,32547-1299,Public       ,11,45,56,123,725,848
03238300,FLORIDA COLLEGE OF INTEGRATIVE MED      ,FL,32809-5721,Proprietary  ,3,25,28,58,368,426
03255300,FLORIDA GULF COAST UNIVERSITY           ,FL,33965-6565,Public       ,420,181,601,10938,5025,15963
03256300,YESHIVA GEDOLAH RABBINICAL COLLEGE      ,FL,33139-4708,Private      ,5,0,5,23,7,30
03264300,SOUTH FLORIDA BIBLE COLLEGE AND THEOLOGI,FL,33441-5768,Private      ,0,1,1,10,84,94
03346300,ACAD FOR PRAC NURSING & HEALTH OCCP     ,FL,33417-4574,Private      ,16,99,115,218,908,1126
03348400,PROFESSIONAL TRAINING CENTERS           ,FL,33184-0000,Proprietary  ,18,65,83,157,749,906
03373300,BEACON COLLEGE                          ,FL,34748-5224,Private      ,3,5,8,145,90,235
03374300,FLORIDA COASTAL SCHOOL OF LAW           ,FL,32256-0000,Proprietary  ,3,37,40,54,3228,3282
03382300,BRADFORD-UNION AREA CAREERTECHNICAL CENT,FL,32091-2434,Public       ,3,14,17,46,286,332
03390300,LINCOLN TECHNICAL INSTITUTE             ,FL,32730-2351,Proprietary  ,18,81,99,186,990,1176
03411400,INTERNATIONAL TRAINING CAREERS          ,FL,33155-1462,Private      ,8,84,92,52,449,501
03414500,ACUPUNCTURE AND MASSAGE COLLEGE         ,FL,33176-1509,Proprietary  ,12,28,40,59,333,392
03425400,CENTRAL FLORIDA INSTITUTE               ,FL,34684-4436,Proprietary  ,27,72,99,261,939,1200
03429600,ATLANTIC INST OF ORIENTAL MEDICINE      ,FL,33316-0000,Private      ,0,8,8,16,184,200
03429700,EAST WEST COLLG OF NATURAL MEDICINE     ,FL,34236-4959,Proprietary  ,0,12,12,24,224,248
03433400,NEW CONCEPT MASSAGE AND BEAUTY SCHO     ,FL,33135-0000,Proprietary  ,4,45,49,23,159,182
03434300,FORTIS COLLEGE                          ,FL,32073-2999,Proprietary  ,21,126,147,236,969,1205
03459400,SAINT PETERSBURG THEOLOGICAL SEMINA     ,FL,33708-3116,Private      ,0,0,0,5,29,34
03480301,MEDVANCE INSTITUTE - FORT LAUDERDALE    ,FL,33313-7261,Proprietary  ,15,48,63,147,678,825
03480302,MEDVANCE INSTITUTE - STUART             ,FL,34994-3000,Proprietary  ,8,70,78,95,731,826
03491400,AMERICAN ADVANCED TECHNICIANS INST      ,FL,33014-4430,Proprietary  ,10,80,90,44,228,272
03549300,ULTIMATE MEDICAL ACADEMY                ,FL,33756-5802,Proprietary  ,180,2453,2633,818,9917,10735
03553300,KEISER CAREER COLLEGE                   ,FL,32216-0000,Proprietary  ,10,107,117,232,1174,1406
03557300,NORTH FLORIDA COSMETOLOGY INSTITUTE     ,FL,32312-0000,Proprietary  ,11,27,38,109,372,481
03564300,"INTERNATIONAL SCHOOL OF HEALTH, BEAUTY &",FL,33311-1141,Proprietary  ,11,99,110,84,516,600
03570400,ENGLISH CENTER (THE)                    ,FL,33133-2703,Public       ,4,54,58,31,304,335
03595400,ANGLEY COLLEGE                          ,FL,32720-4257,Proprietary  ,6,86,92,66,483,549
03611400,FLORIDA BARBER ACADEMY                  ,FL,33441-0000,Proprietary  ,20,122,142,75,541,616
03618300,FLORIDA INSTITUTE OF ANIMAL ARTS        ,FL,32792-1740,Proprietary  ,22,50,72,137,293,430
03627400,JACKSONVILLE BEAUTY INSTITUTE           ,FL,32208-1885,Proprietary  ,6,43,49,90,307,397
03627600,FLORIDA EDUCATION INSTITUTE             ,FL,33144-5036,Proprietary  ,9,71,80,97,515,612
03661400,SOUTH FLORIDA INSTITUTE OF TECHNOLO     ,FL,33135-0000,Proprietary  ,17,158,175,107,897,1004
03691400,AVE MARIA SCHOOL OF LAW                 ,FL,34119-1376,Private      ,1,2,3,51,1014,1065
03696400,SABER                                   ,FL,33134-1604,Private      ,3,99,102,36,492,528
03706300,AMERICAN INSTITUTE                      ,FL,33319-5613,Proprietary  ,23,54,77,213,744,957
03757300,ADVANCE SCIENCE INSTITUTE               ,FL,33012-0000,Proprietary  ,7,28,35,35,161,196
03801400,BEAUTY INSTITUTE (THE)                  ,FL,33409-2972,Proprietary  ,8,38,46,42,216,258
03801401,BEAUTY INSTITUTE (THE) - MARGATE        ,FL,33068-5704,Proprietary  ,2,3,5,8,32,40
03816300,ARTISTIC NAILS & BEAUTY ACADEMY         ,FL,33605-5919,Proprietary  ,17,102,119,138,453,591
03823300,FLORIDA ACADEMY OF HEALTH & BEAUTY      ,FL,33311-0000,Proprietary  ,3,13,16,31,99,130
03832300,DADE MEDICAL COLLEGE                    ,FL,33126-5534,Proprietary  ,57,396,453,580,2113,2693
03842500,CAMBRIDGE INSTITUTE OF ALLIED HEALTH    ,FL,32750-0000,Proprietary  ,2,41,43,48,290,338
03856300,UNIVERSAL BEAUTY SCHOOL                 ,FL,33174-4406,Proprietary  ,2,34,36,16,112,128
03856500,FLORIDA SCHOOL OF TRADITIONAL MIDWIFERY ,FL,32601-5507,Private      ,0,5,5,12,133,145
03866300,GALIANO CAREER ACADEMY                  ,FL,32701-5039,Proprietary  ,0,0,0,12,66,78
03875300,MCI INSTITUTE OF TECHNOLOGY             ,FL,33409-4937,Proprietary  ,26,129,155,135,593,728
03888300,DRAGON RISES COLLEGE OF ORIENTAL MEDICIN,FL,32601-5089,Proprietary  ,1,5,6,8,83,91
03903500,SOUTHERN TECHNICAL COLLEGE              ,FL,32809-0000,Proprietary  ,32,220,252,281,1865,2146
03906300,CAREER INSTITUTE OF FLORIDA             ,FL,33773-3434,Proprietary  ,4,47,51,50,468,518
03911300,TOTAL INTERNATIONAL CAREER INSTITUTE    ,FL,33012-0000,Proprietary  ,8,153,161,26,554,580
03939300,WOLFORD COLLEGE                         ,FL,34108-1931,Proprietary  ,0,5,5,19,357,376
03939400,CENTURA INSTITUTE                       ,FL,32807-3566,Proprietary  ,5,92,97,90,754,844
03939600,DAYTONA COLLEGE                         ,FL,32174-8445,Proprietary  ,12,67,79,136,417,553
03941300,AVE MARIA UNIVERSITY                    ,FL,34142-9505,Private      ,10,9,19,806,212,1018
03957400,NEW COLLEGE OF FLORIDA                  ,FL,34243-2109,Public       ,24,23,47,1613,425,2038
03985300,COMMERCIAL DIVING ACADEMY               ,FL,32208-0000,Proprietary  ,26,105,131,290,880,1170
03986300,AVIATOR COLLEGE OF AERONAUTICAL SCIENCE ,FL,34946-9022,Proprietary  ,3,21,24,73,164,237
04016500,AMERICAN INSTITUTE OF BEAUTY            ,FL,33773-0000,Proprietary  ,17,37,54,99,279,378
04029300,TRENDSETTERS OF FLORIDA SCHOOL OF BEAUTY,FL,32205-4737,Proprietary  ,0,7,7,24,102,126
04058300,HEALTH OPPORTUNITY TECHNICAL CENTER     ,FL,33169-4517,Proprietary  ,2,22,24,43,381,424
04083400,INSTITUTE OF ALLIED MEDICAL PROFESSIONS ,FL,33484-6543,Proprietary  ,2,14,16,60,444,504
04105400,PENSACOLA SCHOOL OF MASSAGE THERAPY & HE,FL,32504-7337,Proprietary  ,7,30,37,62,327,389
04106300,PALM BEACH ACADEMY OF HEALTH & BEAUTY   ,FL,33403-2130,Proprietary  ,5,27,32,47,194,241
04116400,FUTURE-TECH INSTITUTE                   ,FL,33135-4142,Proprietary  ,0,12,12,9,39,48
04116600,TAYLOR COLLEGE                          ,FL,34420-8714,Proprietary  ,3,24,27,51,405,456
04119400,AVEDA INSTITUTE - SAINT PETERSBURG      ,FL,33701-4242,Proprietary  ,72,106,178,521,887,1408
04120400,HI-TECH SCHOOL OF COSMETOLOGY           ,FL,33174-0000,Proprietary  ,14,18,32,100,150,250
04126900,ACADEMY OF CAREER TRAINING              ,FL,34741-4644,Proprietary  ,15,61,76,164,501,665
04127400,DIGITAL MEDIA ARTS COLLEGE              ,FL,33431-5919,Proprietary  ,11,16,27,284,275,559
04128400,MANAGEMENT RESOURCES INSTITUTE          ,FL,33126-5473,Proprietary  ,2,144,146,27,852,879
04129300,INTERNATIONAL B NATURALE BEAUTY SCHOOL  ,FL,33311-1152,Proprietary  ,0,3,3,6,35,41
04129900,FLORIDA SCHOOL OF MASSAGE               ,FL,32608-5419,Proprietary  ,8,24,32,100,284,384
04130400,SHEAR EXCELLENCE INTERNATIONAL HAIR ACAD,FL,33614-2783,Private      ,0,0,0,51,126,177
04131900,FASTTRAIN OF MIAMI                      ,FL,33134-1065,Proprietary  ,49,78,127,86,351,437
04132000,FASTTRAIN OF FORT LAUDERDALE            ,FL,33317-3127,Proprietary  ,32,123,155,98,525,623
04132100,FASTTRAIN OF TAMPA                      ,FL,33607-4153,Proprietary  ,4,31,35,38,206,244
04132200,FASTTRAIN OF JACKSONVILLE               ,FL,32256-4849,Proprietary  ,7,52,59,39,340,379
04133500,ACADEMY FOR FIVE ELEMENT ACUPUNCTURE    ,FL,32601-6811,Private      ,0,5,5,10,141,151
04134800,AVEDA INSTITUTE - TALLAHASSEE           ,FL,32304-3186,Proprietary  ,25,50,75,168,327,495
04134900,ORANGE PARK BEAUTY ACADEMY              ,FL,32073-5524,Proprietary  ,6,23,29,22,105,127
04135000,COZMO THE SCHOOL                        ,FL,34135-4810,Proprietary  ,7,22,29,44,102,146
04135900,ALLIED HEALTH INSTITUTE                 ,FL,33068-0000,Proprietary  ,11,146,157,74,1047,1121
04140800,NORTH FLORIDA ACADEMY                   ,FL,32065-7758,Proprietary  ,1,8,9,29,89,118
04143100,PROFESSIONAL HANDS INSTITUTE            ,FL,33135-1939,Proprietary  ,12,161,173,48,657,705
04145900,CELEBRITY SCHOOL OF BEAUTY              ,FL,33144-4153,Proprietary  ,12,58,70,85,293,378
04146200,WALTON CAREER DEVELOPMENT CENTER        ,FL,32433-1557,Public       ,1,4,5,27,157,184
04146300,MARCHMAN TECHNICAL EDUCATION CENTER     ,FL,34653-1211,Public       ,5,9,14,39,139,178
04147800,ROSE TRAINING INSTITUTE                 ,FL,33881-4094,Proprietary  ,0,17,17,12,185,197
04148500,MEDICAL INSTITUTE OF PALM BEACH         ,FL,33460-5042,Proprietary  ,12,82,94,71,296,367
04150800,IMMOKALEE TECHNICAL CENTER              ,FL,34142-3146,Public       ,8,21,29,107,204,311
04151500,AMERICAN ACADEMY OF COSMETOLOGY         ,FL,32065-8026,Proprietary  ,9,19,28,44,146,190
04156300,UNIVERSITY OF FORT LAUDERDALE           ,FL,33313-5809,Private      ,3,16,19,20,96,116
04156400,AVIATION INSTITUTE OF MAINTENANCE       ,FL,32803-6487,Proprietary  ,7,43,50,98,336,434
04157100,AEROSIM FLIGHT ACADEMY                  ,FL,32773-9683,Proprietary  ,6,22,28,37,90,127
04158300,FLAGLER TECHNICAL INSTITUTE             ,FL,32137-4714,Public       ,4,52,56,4,52,56
04162500,HOLLYWOOD INSTITUTE OF BEAUTY CAREERS   ,FL,33020-4807,Proprietary  ,17,96,113,65,360,425
04163000,SALON PROFESSIONAL ACADEMY (THE)        ,FL,33624-6321,Proprietary  ,6,11,17,70,136,206
04163100,SALON PROFESSIONAL ACADEMY (THE)        ,FL,32607-1672,Proprietary  ,6,11,17,60,132,192
04163200,SALON PROFESSIONAL ACADEMY (THE)        ,FL,32162-9311,Proprietary  ,12,37,49,73,187,260
04164500,EUREKA INSTITUTE OF HEALTH AND BEAUTY   ,FL,33174-4205,Proprietary  ,0,24,24,4,59,63
04167300,SALON PROFESSIONAL ACADEMY (THE)        ,FL,33904-4824,Proprietary  ,12,12,24,41,74,115
04170300,BEAUTY ACADEMY OF SOUTH FLORIDA         ,FL,33012-3221,Proprietary  ,6,40,46,16,65,81
04173600,NOTTER SCHOOL OF PASTRY ARTS            ,FL,32809-7755,Proprietary  ,4,23,27,19,69,88
04176900,AMERICAN HEALTH INSTITUTE               ,FL,34654-3743,Proprietary  ,4,25,29,9,44,53
00160500,CHAMINADE UNIV OF HONOLULU              ,HI,96816-1578,Private      ,43,144,187,1798,2033,3831
00160600,BRIGHAM YOUNG UNIV-HAWAII CAMPUS        ,HI,96762-1294,Private      ,73,49,122,1619,939,2558
00161000,UNIVERSITY OF HAWAII AT MANOA           ,HI,96822-2399,Public       ,208,236,444,12247,9569,21816
00161100,UNIVERSITY OF HAWAII AT HILO            ,HI,96720-4091,Public       ,44,45,89,3459,2782,6241
00161200,HONOLULU COMMUNITY COLLEGE              ,HI,96817-4598,Public       ,43,89,132,1942,2408,4350
00161300,KAPIOLANI COMMUNITY COLLEGE             ,HI,96816-4421,Public       ,77,149,226,3232,3717,6949
00161400,KAUAI COMMUNITY COLLEGE                 ,HI,96766-9591,Public       ,19,28,47,485,756,1241
00161500,UNIVERSITY OF HAWAII MAUI COLLEGE       ,HI,96732-1644,Public       ,39,88,127,1556,3260,4816
00454900,LEEWARD COMMUNITY COLLEGE               ,HI,96782-3393,Public       ,72,143,215,2519,3171,5690
00525800,HAWAII COMMUNITY COLLEGE                ,HI,96720-4075,Public       ,32,60,92,1784,2722,4506
00723401,HEALD COLLEGE - HONOLULU                ,HI,96814-0000,Proprietary  ,123,290,413,1295,2437,3732
00727900,HAWAII PACIFIC UNIVERSITY               ,HI,96813-2882,Private      ,72,233,305,4738,4096,8834
01122000,WINDWARD COMMUNITY COLLEGE              ,HI,96744-0000,Public       ,33,63,96,1002,1523,2525
02100300,MED-ASSIST SCHOOL OF HAWAII             ,HI,96813-0000,Proprietary  ,12,34,46,94,318,412
02107800,UNIVERSITY OF HAWAII - WEST OAHU        ,HI,96782-0000,Public       ,21,50,71,968,1464,2432
02139500,HAWAII INSTITUTE OF HAIR DESIGN         ,HI,96817-5195,Proprietary  ,10,19,29,65,194,259
03017800,TRAVEL INSTITUTE OF THE PACIFIC         ,HI,96814-1946,Proprietary  ,6,30,36,60,172,232
03072500,WORLD MEDICINE INSTITUTE                ,HI,96826-0000,Private      ,1,1,2,29,107,136
03649300,HAWAII TECHNOLOGY INSTITUTE             ,HI,96813-3036,Private      ,1,18,19,44,165,209
03735300,INST OF CLINICAL ACUPUNCTURE & ORIENT MD,HI,96813-2307,Proprietary  ,0,2,2,5,51,56
03999400,TRADITIONAL CHINESE MEDICAL COLLEGE OF H,HI,96743-8324,Private      ,0,1,1,6,62,68
04154100,PACIFIC RIM CHRISTIAN COLLEGE           ,HI,96819-2228,Private      ,0,11,11,55,99,154
04169600,HEISEI INTERNATIONAL INSTITUTE OF MASSAG,HI,96814-2254,Proprietary  ,1,3,4,4,21,25
04175100,PAUL MITCHELL THE SCHOOL HONOLULU       ,HI,96816-2433,Proprietary  ,14,34,48,18,54,72
04182200,HAWAII MEDICAL INSTITUTE                ,HI,96814-3518,Proprietary  ,13,106,119,13,106,119
00161600,BOISE STATE UNIVERSITY                  ,ID,83725-1000,Public       ,215,481,696,12586,13703,26289
00161700,"COLLEGE OF IDAHO, THE                   ",ID,83605-4432,Private      ,21,28,49,1545,421,1966
00161900,COLLEGE OF SOUTHERN IDAHO               ,ID,83301-0000,Public       ,118,337,455,3517,5140,8657
00161908,COLLEGE OF WESTERN IDAHO                ,ID,83687-1515,Public       ,145,487,632,3354,6892,10246
00162000,IDAHO STATE UNIVERSITY                  ,ID,83209-5377,Public       ,120,307,427,5701,10533,16234
00162100,LEWIS-CLARK STATE COLLEGE               ,ID,83501-2698,Public       ,43,91,134,2509,2715,5224
00162300,NORTH IDAHO COLLEGE                     ,ID,83814-2199,Public       ,84,228,312,3209,5091,8300
00162400,NORTHWEST NAZARENE UNIVERSITY           ,ID,83686-5897,Private      ,21,73,94,1541,1449,2990
00162500,BRIGHAM YOUNG UNIVERSITY-IDAHO          ,ID,83460-1650,Private      ,658,586,1244,11034,8447,19481
00162600,UNIVERSITY OF IDAHO                     ,ID,83844-4291,Public       ,133,131,264,9564,5204,14768
00732915,ITT TECHNICAL INSTITUTE                 ,ID,83713-1529,Proprietary  ,91,351,442,925,2894,3819
00987300,MR JUAN'S CLG OF HAIR DESIGN            ,ID,83301-4154,Proprietary  ,0,5,5,29,63,92
01113300,EASTERN IDAHO TECHNICAL COLLEGE         ,ID,83404-5788,Public       ,14,64,78,432,1573,2005
02218000,CARRINGTON COLLEGE                      ,ID,83704-0000,Proprietary  ,21,145,166,376,1558,1934
02234500,BOISE BIBLE COLLEGE                     ,ID,83714-1220,Private      ,1,2,3,185,118,303
02275800,MR LEONS SCHOOL OF HAIR DESIGN          ,ID,83843-8384,Proprietary  ,3,13,16,32,67,99
02275801,MR. LEON'S SCHOOL OF HAIR DESIGN        ,ID,83501-1910,Proprietary  ,1,4,5,7,29,36
02314000,SCHOOL OF HAIRSTYLING (THE)             ,ID,83202-0000,Proprietary  ,0,5,5,44,103,147
02319800,HEADMASTERS SCHOOL OF HAIR DESIGN       ,ID,83814-0000,Proprietary  ,23,21,44,148,271,419
02349200,HEADMASTERS SCHOOL OF HAIR DESIGN       ,ID,83501-0000,Proprietary  ,2,10,12,38,72,110
02559500,RAZZLE DAZZLE CLG OF HAIR DESIGN        ,ID,83686-5104,Proprietary  ,6,29,35,61,195,256
02607100,SCOT LEWIS SCHOOLS                      ,ID,83709-1662,Proprietary  ,22,25,47,155,273,428
03098700,ACADEMY OF COURT REPORTING              ,ID,83704-8320,Proprietary  ,27,164,191,250,1114,1364
03832400,COSMETOLOGY SCHOOL OF ARTS & SCIENCES   ,ID,83318-1327,Proprietary  ,0,11,11,17,96,113
04051323,ART INSTITUTE OF PHOENIX (THE) - BROWN M,ID,83709-2746,Proprietary  ,8,59,67,235,1162,1397
04134300,EVANS HAIRSTYLING COLLEGE               ,ID,83440-5277,Proprietary  ,11,9,20,57,67,124
04144500,HAIR ACDMY PAUL MITCHELL PARTNER SCHOOL ,ID,83440-2600,Proprietary  ,16,18,34,130,186,316
04150600,D & L ACADEMY OF HAIR DESIGN            ,ID,83301-6229,Proprietary  ,2,5,7,21,39,60
04155200,OLIVER FINLEY ACADEMY OF COSMETOLOGY    ,ID,83704-8011,Proprietary  ,7,22,29,98,206,304
04163800,MASTER EDUCATORS BEAUTY SCHOOL          ,ID,83301-4118,Proprietary  ,5,6,11,26,65,91
04168600,COLLEGE OF MASSAGE THERAPY              ,ID,83221-1758,Proprietary  ,1,12,13,11,31,42
04176700,D'SHAW INSTITUTE OF COSMETOLOGY         ,ID,83704-4406,Proprietary  ,1,8,9,15,26,41
00163200,AQUINAS INSTITUTE OF THEOLOGY           ,MO,63108-3323,Private      ,1,6,7,8,90,98
00244900,AVILA COLLEGE                           ,MO,64145-1698,Private      ,15,85,100,1181,1716,2897
00245000,CALVARY BIBLE COLLEGE                   ,MO,64147-1341,Private      ,8,18,26,168,250,418
00245200,CENTRAL BIBLE COLLEGE                   ,MO,65803-1096,Private      ,8,10,18,630,401,1031
00245300,CENTRAL METHODIST UNIVERSITY            ,MO,65248-1198,Private      ,14,104,118,1590,1304,2894
00245301,CENTRAL METHODIST UNIVERSITY            ,MO,63601-0000,Private      ,0,0,0,82,229,311
00245302,CENTRAL METHODIST UNIVERSITY- UNION     ,MO,63084-0000,Private      ,0,0,0,45,96,141
00245400,UNIVERSITY OF CENTRAL MISSOURI          ,MO,64093-5178,Public       ,89,171,260,8151,5070,13221
00245500,DEVRY INSTITUTE OF TECHNOLOGY           ,MO,64131-3626,Proprietary  ,0,0,0,181,278,459
00245600,COLUMBIA COLLEGE                        ,MO,65216-4581,Private      ,120,1480,1600,3081,19527,22608
00245700,CONCORDIA SEMINARY                      ,MO,63105-3199,Private      ,0,12,12,5,482,487
00245800,COTTEY COLLEGE                          ,MO,64772-2790,Private      ,4,3,7,345,52,397
00245900,CROWDER COLLEGE                         ,MO,64850-9165,Public       ,98,287,385,2505,3679,6184
00246000,CULVER STOCKTON COLLEGE                 ,MO,63435-1299,Private      ,11,3,14,1092,170,1262
00246100,DRURY UNIVERSITY                        ,MO,65802-3791,Private      ,57,255,312,2757,4612,7369
00246200,EDEN THEOLOGICAL SEMINARY               ,MO,63119-0000,Private      ,0,4,4,5,127,132
00246300,EVANGEL UNIVERSITY                      ,MO,65802-2125,Private      ,15,25,40,2265,953,3218
00246400,FONTBONNE UNIVERSITY                    ,MO,63105-3098,Private      ,25,122,147,1262,2940,4202
00246600,HARRIS-STOWE STATE COLLEGE              ,MO,63103-2199,Public       ,26,70,96,1648,2106,3754
00246700,CONCEPTION SEMINARY COLLEGE             ,MO,64433-0502,Private      ,1,1,2,68,18,86
00246800,JEFFERSON COLLEGE                       ,MO,63050-2441,Public       ,72,192,264,2991,3763,6754
00247100,ST LOUIS COMMUNITY COLLEGE              ,MO,63102-0000,Public       ,466,1300,1766,11667,20395,32062
00247300,KANSAS CITY ART INSTITUTE               ,MO,64111-1874,Private      ,16,14,30,1321,373,1694
00247400,KANSAS CITY UNIV OF MED AND BIOSCIENCES ,MO,64106-0000,Private      ,0,8,8,57,1133,1190
00247600,KENRICK-GLENNON SEMINARY                ,MO,63119-0000,Private      ,0,0,0,1,2,3
00247600,KENRICK-GLENNON SEMINARY                ,MO,63119-4330,Private      ,0,0,0,5,7,12
00247700,A.T. STILL UNIV OF HEALTH SCIENCES      ,MO,63501-0000,Private      ,1,92,93,17,3070,3087
00247900,LINCOLN UNIVERSITY                      ,MO,65101-3500,Public       ,38,74,112,2926,2117,5043
00248000,LINDENWOOD UNIVERSITY                   ,MO,63301-1695,Private      ,66,483,549,5988,8230,14218
00248200,MARYVILLE UNIVERSITY                    ,MO,63141-7299,Private      ,31,110,141,2311,2795,5106
00248400,METROPOLITAN COMMUNITY COLLEGE          ,MO,64111-2408,Public       ,255,896,1151,10382,17969,28351
00248500,MIDWESTERN BAPTIST THEOL SEMINARY       ,MO,64118-4697,Private      ,4,20,24,76,330,406
00248600,MINERAL AREA COLLEGE                    ,MO,63601-1000,Public       ,54,155,209,2176,3082,5258
00248800,MISSOURI SOUTHERN STATE UNIVERSITY      ,MO,64801-1595,Public       ,63,134,197,4102,4124,8226
00248900,MISSOURI VALLEY COLLEGE                 ,MO,65340-3197,Private      ,12,14,26,1641,492,2133
00249000,MISSOURI WESTERN STATE UNIVERSITY       ,MO,64507-2294,Public       ,79,132,211,4805,3078,7883
00249100,MOBERLY AREA COMMUNITY COLLEGE          ,MO,65270-1304,Public       ,70,156,226,3045,3844,6889
00249400,NAZARENE THEOLOGICAL SEMINARY           ,MO,64131-1246,Private      ,0,9,9,5,220,225
00249500,TRUMAN STATE UNIVERSITY                 ,MO,63501-4221,Public       ,42,8,50,5932,646,6578
00249600,NORTHWEST MISSOURI STATE UNIV           ,MO,64468-6001,Public       ,47,49,96,7058,1547,8605
00249800,PARK UNIVERSITY                         ,MO,64152-3795,Private      ,28,643,671,1414,8709,10123
00249900,ROCKHURST UNIVERSITY                    ,MO,64110-2561,Private      ,12,58,70,1999,1506,3505
00250000,COLLEGE OF THE OZARKS                   ,MO,65726-2502,Private      ,27,11,38,3246,406,3652
00250100,SOUTHEAST MISSOURI STATE UNIV           ,MO,63701-4799,Public       ,106,180,286,8416,4640,13056
00250200,SOUTHWEST BAPTIST UNIVERSITY            ,MO,65613-2597,Private      ,24,62,86,2271,1785,4056
00250300,MISSOURI STATE UNIVERSITY               ,MO,65897-0094,Public       ,174,267,441,14641,8115,22756
00250400,ST LOUIS COLLEGE OF PHARMACY            ,MO,63110-1088,Private      ,3,9,12,822,639,1461
00250600,SAINT LOUIS UNIVERSITY                  ,MO,63103-2097,Private      ,72,232,304,9367,8589,17956
00250900,SAINT PAUL SCHOOL OF THEOLOGY           ,MO,64127-2499,Private      ,0,4,4,4,189,193
00251200,STEPHENS COLLEGE                        ,MO,65215-0001,Private      ,9,23,32,1033,700,1733
00251400,NORTH CENTRAL MISSOURI COLLEGE          ,MO,64683-1824,Public       ,22,66,88,882,1237,2119
00251600,UNIVERSITY OF MISSOURI-COLUMBIA         ,MO,65211-1600,Public       ,254,299,553,24379,9272,33651
00251700,MISSOURI UNIVERSITY OF SCIENCE & TECHNOL,MO,65409-0250,Public       ,50,41,91,5266,1361,6627
00251800,UNIVERSITY OF MISSOURI-KANSAS CITY      ,MO,64110-2497,Public       ,114,299,413,7402,10320,17722
00251900,UNIVERSITY OF MISSOURI-ST LOUIS         ,MO,63121-4499,Public       ,105,364,469,6144,10754,16898
00252000,WASHINGTON UNIVERSITY                   ,MO,63130-4899,Private      ,84,126,210,13506,6625,20131
00252001,WASHINGTON UNIV-SCHOOL OF MEDICINE      ,MO,63110-0000,Private      ,3,3,6,92,1353,1445
00252100,WEBSTER UNIVERSITY                      ,MO,63119-3194,Private      ,44,670,714,3349,14302,17651
00252200,WENTWORTH MILITARY ACADEMY              ,MO,64067-1799,Private      ,17,16,33,222,258,480
00252300,WESTMINSTER COLLEGE                     ,MO,65251-1299,Private      ,11,5,16,1408,137,1545
00252400,WILLIAM JEWELL COLLEGE                  ,MO,64068-1896,Private      ,18,21,39,1655,364,2019
00252500,WILLIAM WOODS UNIVERSITY                ,MO,65251-2388,Private      ,6,191,197,1151,2013,3164
00405704,NATIONAL AMERICAN UNIVERSITY            ,MO,64057-1791,Proprietary  ,3,40,43,79,697,776
00441300,ST JOHNS HOSP SCH RAD TECH              ,MO,65802-0000,Private      ,1,3,4,72,129,201
00470300,LOGAN COLLEGE OF CHIROPRACTIC           ,MO,63006-1065,Private      ,1,22,23,80,1187,1267
00470700,COVENANT THEOLOGICAL SEMINARY           ,MO,63141-8697,Private      ,0,8,8,7,567,574
00471100,LINN STATE TECHNICAL COLLEGE            ,MO,65051-9607,Public       ,14,18,32,1278,519,1797
00471300,THREE RIVERS COMMUNITY COLLEGE          ,MO,63901-2393,Public       ,64,197,261,1974,3310,5284
00528800,KIRKSVILLE AREA TECHNICAL CENTER        ,MO,63501-0000,Public       ,0,3,3,39,86,125
00528900,WAYNESVILLE CAREER CENTER               ,MO,65583-2131,Public       ,1,9,10,74,146,220
00542400,SOUTH CENTRAL CAREER CENTER             ,MO,65775-3334,Public       ,0,3,3,59,182,241
00542600,SIKESTON CAREER AND TECHNOLOGY CTR      ,MO,63801-0000,Public       ,2,6,8,65,170,235
00542900,ROLLA TECHNICAL INSTITUTE               ,MO,65401-3601,Public       ,4,19,23,299,364,663
00543000,POPLAR BLUFF TECHNICAL CAREER CNTR      ,MO,63901-0000,Public       ,2,6,8,56,162,218
00543800,SALINE COUNTY CAREER CENTER             ,MO,65340-0000,Public       ,0,2,2,15,78,93
00544500,TRUMAN MEDICAL CENTER SCHOOL OF NURSE AN,MO,64108-2677,Private      ,1,13,14,71,222,293
00553100,GRAND RIVER TECHNICAL SCHOOL            ,MO,64601-1299,Public       ,1,2,3,98,65,163
00553200,CAPE GIRARDEAU CAREER & TECHNOLOGY CENTE,MO,63703-7511,Public       ,6,22,28,172,507,679
00638500,CHAMBERLAIN COLLEGE OF NURSING          ,MO,63146-0000,Proprietary  ,49,1348,1397,1366,12052,13418
00638900,BARNES JEWISH COLLEGE OF NURSING AND ALL,MO,63110-1091,Private      ,11,33,44,368,974,1342
00639200,RESEARCH COLLEGE OF NURSING             ,MO,64132-1199,Proprietary  ,3,20,23,136,392,528
00639201,RESEARCH MEDICAL CENTER - COLLEGE OF NUR,MO,64132-1199,Proprietary  ,1,6,7,24,87,111
00639202,RESEARCH MED CTR SCHL OF RAD TECH       ,MO,64132-0000,Proprietary  ,1,4,5,23,77,100
00666600,LUTHERAN  SCHOOL OF NURSING             ,MO,63118-3909,Proprietary  ,4,12,16,111,453,564
00732923,ITT TECHNICAL INSTITUTE                 ,MO,63045-1122,Proprietary  ,132,461,593,1526,4848,6374
00754000,MISSOURI BAPTIST UNIVERSITY             ,MO,63141-8698,Private      ,16,140,156,1612,2531,4143
00808000,STATE FAIR COMMUNITY COLLEGE            ,MO,65301-0000,Public       ,72,256,328,2441,3694,6135
00826900,HILLYARD TECHNICAL CENTER               ,MO,64506-0000,Public       ,1,10,11,120,287,407
00855200,STEVENS INSTITUTE OF BUSINESS & ARTS    ,MO,63103-0000,Proprietary  ,2,12,14,100,197,297
00860600,TRI-COUNTY TECHNICAL SCHOOL             ,MO,65026-0000,Public       ,1,3,4,18,97,115
00886200,EAST CENTRAL COLLEGE                    ,MO,63084-0529,Public       ,63,137,200,2235,2865,5100
00908900,HANNIBAL-LAGRANGE COLLEGE               ,MO,63401-1999,Private      ,5,21,26,833,587,1420
00952000,NATIONAL ACADEMY OF BEAUTY ARTS         ,MO,63128-1307,Proprietary  ,5,40,45,175,454,629
00959000,INDEPENDENCE COLLEGE OF COSMETOLOGY     ,MO,64055-1105,Proprietary  ,3,21,24,59,142,201
00960700,HOUSE OF HEAVILIN BEAUTY COLLEGE        ,MO,64110-2826,Proprietary  ,4,14,18,38,154,192
00978200,SAINT LUKE'S COLLEGE OF HEALTH SCIENCES ,MO,64114-3237,Private      ,1,3,4,88,267,355
00979500,MISSOURI COLLEGE                        ,MO,63144-2901,Proprietary  ,42,131,173,516,1507,2023
01014814,COLORADO TECHNL UNIV NORTH KANSAS CITY  ,MO,64116-3614,Proprietary  ,16,134,150,271,1654,1925
01027900,HICKEY COLLEGE                          ,MO,63146-0000,Proprietary  ,29,30,59,517,373,890
01040500,PINNACLE CAREER INSTITUTE               ,MO,64131-3367,Proprietary  ,50,464,514,344,3044,3388
01040501,PINNACLE CAREER INSTITUTE - NORTH KANSAS,MO,64153-1151,Proprietary  ,9,76,85,75,541,616
01050303,WICHITA TECHNICAL INSTITUTE - WTI JOPLIN,MO,64801-2970,Proprietary  ,7,43,50,56,389,445
01102600,WARRENSBURG AREA VOC TECH SCH           ,MO,64093-0000,Public       ,1,3,4,33,82,115
01173500,PIKE/LINCOLN TECHNICAL CENTER           ,MO,63344-0000,Public       ,0,4,4,49,125,174
01212000,ASSEMBLIES OF GOD THEO. SEMINARY        ,MO,65802-0000,Private      ,0,12,12,18,286,304
01250000,RANKEN TECHNICAL COLLEGE                ,MO,63113-2811,Private      ,31,91,122,1622,1928,3550
01258000,ST LOUIS CHRISTIAN COLLEGE              ,MO,63033-6499,Private      ,2,12,14,213,272,485
01320800,BAPTIST BIBLE COLLEGE                   ,MO,65803-3498,Private      ,4,11,15,366,263,629
02056100,FOUR RIVERS CAREER CENTER               ,MO,63090-0000,Public       ,1,1,2,20,71,91
02066900,NICHOLS CAREER CENTER                   ,MO,65101-2814,Public       ,1,7,8,97,170,267
02068200,COX HEALTH - COX COLLEGE                ,MO,65802-0000,Private      ,6,36,42,263,968,1231
02068202,COX HEALTH - RADIOLOGIC TECHNOLOGY      ,MO,65802-0000,Private      ,1,4,5,56,160,216
02068204,COX HEALTH - MEDICAL TECHNOLOGY         ,MO,65807-0000,Private      ,2,7,9,56,131,187
02073600,KENNETT CAREER & TECHNOLOGY CENTER      ,MO,63857-0000,Public       ,0,1,1,15,88,103
02090400,BOONSLICK TECHNICAL EDUCATION CTR       ,MO,65233-0000,Public       ,0,4,4,19,78,97
02121100,MIDWEST INSTITUTE                       ,MO,63122-0000,Proprietary  ,10,66,76,115,456,571
02124500,FRANKLIN TECHNOLOGY CENTER              ,MO,64801-0000,Public       ,2,23,25,108,472,580
02142200,LEX LA RAY TECHNICAL CENTER             ,MO,64067-0000,Public       ,2,5,7,27,97,124
02151000,HANNIBAL CAREER AND TECHNICAL CENTE     ,MO,63401-2285,Public       ,0,3,3,35,116,151
02154900,MISSOURI SCH OF BARB & HAIR             ,MO,63031-0000,Proprietary  ,4,14,18,5,24,29
02164200,FOREST INST PROFESSIONAL PSYCHOLOGY     ,MO,65807-0000,Private      ,1,8,9,20,410,430
02165900,CHILLICOTHE BEAUTY ACADEMY              ,MO,64601-0000,Proprietary  ,0,2,2,14,48,62
02180200,METRO BUSINESS COLLEGE                  ,MO,63701-0000,Proprietary  ,13,100,113,174,1173,1347
02188000,NORTHWEST TECHNICAL SCHOOL              ,MO,64468-0000,Public       ,1,1,2,5,2,7
02188100,NORTHLAND CAREER CENTER                 ,MO,64079-8333,Public       ,0,0,0,23,106,129
02202700,OZARK CHRISTIAN COLLEGE                 ,MO,64801-0000,Private      ,11,7,18,596,214,810
02203400,NEVADA REGIONAL TECHNICAL CENTER        ,MO,64772-0000,Public       ,0,2,2,35,68,103
02205200,SANFORD-BROWN COLLEGE                   ,MO,63026-7305,Proprietary  ,26,151,177,361,1887,2248
02205203,SANFORD BROWN COLLEGE-ST. PETERS        ,MO,63301-4042,Proprietary  ,14,91,105,261,1392,1653
02214500,SALEM COLLEGE OF HAIRSTYLING            ,MO,65401-0000,Proprietary  ,2,8,10,15,50,65
02239200,ANTHEM COLLEGE                          ,MO,63043-0000,Proprietary  ,75,199,274,624,1603,2227
02239202,ANTHEM COLLEGE - METRO SOUTH            ,MO,63026-0000,Proprietary  ,4,13,17,48,145,193
02250600,EVEREST COLLEGE                         ,MO,65807-2446,Proprietary  ,10,74,84,151,950,1101
02263106,ANTHEM COLLEGE - ANTHEM COLLEGE - KANSAS,MO,64114-3232,Proprietary  ,0,11,11,28,115,143
02263400,LAKE CAREER AND TECHNICAL CENTER        ,MO,65020-0000,Public       ,0,4,4,10,61,71
02266400,CENTRAL CHRISTIAN CLG OF THE BIBLE      ,MO,65270-0000,Private      ,7,8,15,242,172,414
02277500,HOUSE OF HEAVILIN OF BLUE SPRINGS       ,MO,64014-3953,Proprietary  ,12,17,29,81,147,228
02289200,COLUMBIA AREA CAREER CENTER             ,MO,65203-0000,Public       ,3,21,24,87,328,415
02295700,MISSOURI BEAUTY ACADEMY                 ,MO,63640-1827,Proprietary  ,8,20,28,68,185,253
02300105,EVEREST COLLEGE - EARTH CITY            ,MO,63045-1100,Proprietary  ,37,167,204,286,1447,1733
02304000,MISSOURI TECH                           ,MO,63303-3887,Proprietary  ,1,12,13,81,228,309
02309100,AMERICAN COLLEGE OF HAIR DESIGN         ,MO,65301-2144,Proprietary  ,2,21,23,39,88,127
02313000,CASS CAREER CENTER                      ,MO,64701-0000,Public       ,1,1,2,26,83,109
02340500,ST LOUIS COLLEGE OF HEALTH CAREERS      ,MO,63110-0000,Proprietary  ,26,137,163,236,1079,1315
02340501,ST LOUIS COLLEGE OF HEALTH              ,MO,63129-0000,Proprietary  ,0,0,0,39,121,160
02342100,CAREER & TECHNOLOGY CTR AT FT OSAGE     ,MO,64058-0000,Public       ,1,3,4,15,68,83
02361600,CONCORDE CAREER COLLEGE                 ,MO,64111-0000,Proprietary  ,24,158,182,288,1510,1798
02497500,CLINTON TECHNICAL SCHOOL                ,MO,64735-2966,Public       ,1,1,2,22,73,95
02520800,MERRELL UNIV OF BTY ARTS & SCIENCES     ,MO,65109-0000,Proprietary  ,8,19,27,85,200,285
02530600,SAINT CHARLES COMMUNITY COLLEGE         ,MO,63376-0975,Public       ,82,176,258,4144,3927,8071
02543800,PARIS II EDUCATIONAL CENTER (THE)       ,MO,64118-0000,Proprietary  ,12,35,47,85,229,314
02555300,PATSY AND ROB'S ACADEMY OF BEAUTY       ,MO,63074-0000,Proprietary  ,4,15,19,61,121,182
02564700,ELAINE STEVEN BEAUTY COLLEGE            ,MO,63136-0000,Proprietary  ,8,30,38,70,244,314
02564701,ELAINE STEVEN BEAUTY COLLEGE - ADVANCE B,MO,63383-2006,Proprietary  ,1,1,2,2,13,15
02564702,ELAINE STEVEN BEAUTY COLLEGE - ADVANCE B,MO,63401-2269,Proprietary  ,0,1,1,8,12,20
02568500,GRABBER SCHOOL OF HAIR DESIGN           ,MO,63011-0000,Proprietary  ,8,25,33,63,153,216
02599700,VATTEROTT COLLEGE                       ,MO,63134-2900,Proprietary  ,47,175,222,519,2345,2864
02599701,VATTEROTT COLLEGE - KANSAS CITY         ,MO,64129-1692,Proprietary  ,14,101,115,225,1498,1723
02599702,VATTEROTT COLLEGE - SPRINGFIELD LOCATION,MO,65807-5340,Proprietary  ,12,92,104,162,1038,1200
02599703,VATTEROTT COLLEGE - JOPLIN              ,MO,64801-5033,Proprietary  ,5,67,72,126,850,976
02599705,VATTEROTT COLLEGE - SUNSET HILLS        ,MO,63127-1516,Proprietary  ,16,90,106,162,1094,1256
02599712,VATTEROTT COLLEGE - O'FALLON            ,MO,63366-2748,Proprietary  ,8,62,70,115,604,719
02608000,NEOSHO BEAUTY COLLEGE                   ,MO,64850-1525,Proprietary  ,1,9,10,22,75,97
02609202,VATTEROTT COLLEGE-ST JOSEPH             ,MO,64501-2911,Proprietary  ,11,46,57,154,572,726
02609203,VATTEROTT COLLEGE - L'ECOLE CULINAIRE   ,MO,63124-1103,Proprietary  ,15,66,81,217,893,1110
02611004,HERITAGE COLLEGE-KANSAS CITY            ,MO,64131-4203,Proprietary  ,41,164,205,274,1269,1543
03042400,LEBANON TECHNOLOGY & CAREER CENTER      ,MO,65536-3296,Public       ,1,8,9,44,171,215
03066300,BRYAN CAREER COLLEGE                    ,MO,65806-2507,Proprietary  ,17,143,160,97,814,911
03066303,BRYAN COLLEGE - COLUMBIA                ,MO,65201-8248,Proprietary  ,1,2,3,1,2,3
03068600,SPECIAL SCHOOL DISTRICT OF ST. LOUIS CO.,MO,63127-0000,Public       ,6,44,50,52,613,665
03070200,CENTRAL COLLEGE OF COSMETOLOGY          ,MO,65583-0000,Proprietary  ,2,14,16,31,134,165
03070900,SE MO HOSP CLG NURSING & HEALTH SCI     ,MO,63703-4507,Private      ,6,18,24,155,358,513
03077200,COSMETOLOGY CONCEPTS INSTITUTE          ,MO,65202-1972,Proprietary  ,2,9,11,36,124,160
03083000,OZARKS TECHNICAL COMMUNITY COLLEGE      ,MO,65802-3601,Public       ,182,667,849,7463,12205,19668
03092600,MESSENGER COLLEGE                       ,MO,64804-4909,Private      ,0,3,3,38,81,119
03097600,ST LOUIS HAIR ACADEMY                   ,MO,63107-1737,Proprietary  ,2,9,11,25,89,114
03101000,NEW DIMENSION SCHOOL OF HAIR DESIGN     ,MO,64801-5017,Proprietary  ,2,12,14,23,74,97
03106000,MISSOURI STATE UNIVERSITY - WEST PLAINS ,MO,65775-2715,Public       ,36,72,108,1235,1574,2809
03110900,HOUSE OF HEAVILIN BEAUTY COLLEGE        ,MO,64083-9195,Proprietary  ,0,11,11,24,63,87
03166300,MOBERLY AREA TECHNICAL CENTER           ,MO,65270-1904,Public       ,0,2,2,52,75,127
03174300,HERNDON CAREER CENTER                   ,MO,64138-2695,Public       ,3,2,5,5,4,9
03519300,MISSOURI COLLEGE OF COSMETOLOGY NORTH   ,MO,65803-1235,Proprietary  ,7,26,33,93,273,366
03528300,MIDWEST UNIVERSITY                      ,MO,63385-2905,Private      ,0,0,0,14,74,88
03579300,TEXAS COUNTY TECHNICAL INSTITUTE        ,MO,65483-2700,Private      ,7,20,27,48,325,373
03616300,AVIATION INSTITUTE OF MAINTENANCE       ,MO,64129-1811,Proprietary  ,6,41,47,82,517,599
03663400,UNIVERSITY OF COSMETOLOGY               ,MO,63080-1910,Proprietary  ,1,1,2,9,33,42
03878300,PROFESSIONAL MASSAGE TRAINING CENTER    ,MO,65803-2939,Proprietary  ,0,16,16,52,182,234
03916300,ECLIPS SCHOOL OF COSMETOLOGY AND BARBERI,MO,63703-5809,Proprietary  ,8,24,32,39,161,200
03924300,HAIR ACADEMY 110 (THE)                  ,MO,63501-2915,Proprietary  ,0,2,2,18,35,53
03970400,WELLSPRING SCHOOL OF ALLIED HEALTH      ,MO,64114-3313,Proprietary  ,4,24,28,40,179,219
04037500,ACADEMY OF HAIR DESIGN                  ,MO,65804-2303,Proprietary  ,3,23,26,66,237,303
04051329,ART INSTITUTE OF PHOENIX (THE) - BROWN M,MO,63026-2564,Proprietary  ,0,5,5,0,5,5
04118700,AMERICAN COLLEGE OF TECHNOLOGY          ,MO,64506-2006,Proprietary  ,2,22,24,32,190,222
04119100,CITY VISION COLLEGE                     ,MO,64141-3188,Private      ,0,14,14,15,118,133
04122300,GRANTHAM UNIVERSITY                     ,MO,64153-2262,Proprietary  ,2,147,149,2,220,222
04127000,PEMISCOT COUNTY SPECIAL SCHOOL DISTRICT ,MO,63851-1666,Public       ,0,0,0,8,63,71
04130300,VICTORY TRADE SCHOOL                    ,MO,65803-2754,Private      ,1,8,9,4,52,56
04130600,"CENTER FOR HEALING ARTS (THE), LLC      ",MO,63143-2103,Proprietary  ,3,16,19,34,149,183
04133300,TREND SETTERS SCHOOL OF COSMETOLOGY     ,MO,63702-7607,Proprietary  ,5,8,13,46,111,157
04145200,TRANSFORMED BARBER AND COSMETOLOGY ACADE,MO,64137-1207,Proprietary  ,5,19,24,72,281,353
04145700,THE SYSTEM A PAUL MITCHELL PARTNER SCHL ,MO,65807-5969,Proprietary  ,4,27,31,143,229,372
04146100,URSHAN GRADUATE SCHOOL OF THEOLOGY      ,MO,63031-7526,Private      ,0,3,3,7,45,52
04170600,SALON PROFESSIONAL ACADEMY (THE)        ,MO,63301-1021,Proprietary  ,2,5,7,17,39,56
04170700,PAUL MITCHELL THE SCHOOL ST LOUIS       ,MO,63108-1554,Proprietary  ,16,22,38,61,77,138
04173900,COSMETOLOGY COLLEGE OF FRANKLIN COUNTY  ,MO,63077-3448,Proprietary  ,1,3,4,1,3,4
04174000,SKIN INSTITUTE                          ,MO,63128-1307,Proprietary  ,2,15,17,6,42,48
04174800,AMERICAN TRADE SCHOOL                   ,MO,63074-1807,Proprietary  ,0,33,33,11,76,87
04184400,SEYMOUR BEAUTY ACADEMY                  ,MO,65746-8743,Proprietary  ,2,6,8,2,6,8
00163201,AQUINAS INSTITUTE OF THEOLOGY - MINISTRY,OK,73123-0380,Private      ,0,0,0,0,23,23
00314600,WESTERN OKLAHOMA STATE COLLEGE          ,OK,73521-1397,Public       ,22,110,132,702,1267,1969
00314700,BACONE COLLEGE                          ,OK,74403-1597,Private      ,18,69,87,1066,952,2018
00314900,SOUTHERN NAZARENE UNIVERSITY            ,OK,73008-2694,Private      ,21,194,215,1298,2018,3316
00315000,CAMERON UNIVERSITY                      ,OK,73505-6377,Public       ,72,268,340,2366,4217,6583
00315100,OKLAHOMA WESLEYAN UNIVERSITY            ,OK,74006-6299,Private      ,8,86,94,798,1103,1901
00315200,UNIV OF CENTRAL OKLAHOMA                ,OK,73034-5209,Public       ,135,282,417,9040,8117,17157
00315300,CONNORS STATE COLLEGE                   ,OK,74469-9700,Public       ,31,88,119,1193,1830,3023
00315400,EAST CENTRAL UNIVERSITY                 ,OK,74820-6999,Public       ,52,133,185,2688,3397,6085
00315500,EASTERN OKLAHOMA STATE COLLEGE          ,OK,74578-4999,Public       ,36,94,130,936,1441,2377
00315600,REDLANDS COMMUNITY COLLEGE              ,OK,73036-5304,Public       ,33,91,124,859,1485,2344
00315700,LANGSTON UNIVERSITY                     ,OK,73050-0000,Public       ,61,106,167,2078,2177,4255
00315800,MURRAY STATE COLLEGE                    ,OK,73460-3137,Public       ,51,128,179,1312,2297,3609
00316000,NORTHEASTERN OKLAHOMA A & M COLLEGE     ,OK,74354-6497,Public       ,58,66,124,1740,1417,3157
00316100,NORTHEASTERN STATE UNIVERSITY           ,OK,74464-2399,Public       ,87,240,327,5329,6930,12259
00316200,NORTHERN OKLAHOMA COLLEGE               ,OK,74653-0310,Public       ,61,131,192,2012,2617,4629
00316300,NORTHWESTERN OKLAHOMA STATE UNIV        ,OK,73717-2799,Public       ,20,32,52,1428,1055,2483
00316400,OKLAHOMA BAPTIST UNIVERSITY             ,OK,74801-2590,Private      ,28,23,51,2022,436,2458
00316500,OKLAHOMA CHRISTIAN UNIVERSITY           ,OK,73131-0000,Private      ,22,29,51,2149,844,2993
00316600,OKLAHOMA CITY UNIVERSITY                ,OK,73106-1493,Private      ,39,94,133,2603,2934,5537
00316700,UNIV OF SCIENCE & ARTS OF OKLAHOMA      ,OK,73018-5322,Public       ,19,22,41,811,545,1356
00316800,ROGERS STATE UNIVERSITY                 ,OK,74017-3252,Public       ,49,119,168,2639,3295,5934
00317000,OKLAHOMA STATE UNIVERSITY               ,OK,74078-1026,Public       ,273,269,542,15579,8398,23977
00317200,OKLAHOMA STATE UNIVERSITY-OKMULGEE      ,OK,74447-3901,Public       ,55,127,182,1935,2127,4062
00317400,OKLAHOMA PANHANDLE STATE UNIVERSITY     ,OK,73939-0000,Public       ,25,23,48,917,493,1410
00317600,CARL ALBERT STATE COLLEGE               ,OK,74953-5208,Public       ,37,100,137,1361,2288,3649
00317800,SEMINOLE STATE COLLEGE                  ,OK,74818-1902,Public       ,37,114,151,978,1618,2596
00317900,SOUTHEASTERN OKLAHOMA STATE UNIV        ,OK,74701-0609,Public       ,76,137,213,2585,2673,5258
00318000,SOUTHWESTERN CHRISTIAN UNIVERSITY       ,OK,73008-2335,Private      ,8,27,35,343,383,726
00318100,SOUTHWESTERN OKLAHOMA STATE UNIV        ,OK,73096-3098,Public       ,49,76,125,3079,2197,5276
00318101,SOUTHWESTERN OK STATE UNIV AT SAYRE     ,OK,73662-0000,Public       ,6,26,32,182,319,501
00318300,ST GREGORY'S UNIVERSITY                 ,OK,74804-2499,Private      ,5,55,60,352,532,884
00318308,SAINT GREGORY'S UNIVERSITY - IPD TULSA  ,OK,74135-2499,Private      ,2,9,11,41,259,300
00318400,UNIVERSITY OF OKLAHOMA                  ,OK,73019-4078,Public       ,257,388,645,16661,10833,27494
00318401,UNIVERSITY OF OKLAHOMA-HLTH SCI CTR     ,OK,73190-0000,Public       ,13,83,96,579,3736,4315
00318500,UNIVERSITY OF TULSA                     ,OK,74104-3189,Private      ,43,50,93,3108,2182,5290
00398500,ORAL ROBERTS UNIVERSITY                 ,OK,74171-0001,Private      ,24,64,88,3146,1808,4954
00531100,TULSA COUNTY AREA VOC TECH SCHOOL       ,OK,74145-0000,Public       ,12,82,94,338,1830,2168
00531200,RED RIVER TECHNOLOGY CENTER             ,OK,73533-2700,Public       ,2,15,17,41,214,255
00533900,METRO TECHNOLOGY CENTERS SCH DIST22     ,OK,73111-0000,Public       ,20,128,148,262,1771,2033
00533903,METRO TECHNOLOGY CENTERS SCH DIST22     ,OK,73129-0000,Public       ,5,41,46,110,607,717
00694200,MID-AMERICA CHRISTIAN UNIVERSITY        ,OK,73170-4504,Private      ,10,263,273,447,2133,2580
00767800,SPARTAN COLLEGE OF AERONAUTICS AND TECHN,OK,74115-5800,Proprietary  ,47,92,139,1159,1228,2387
00791100,VIRGILS BEAUTY COLLEGE                  ,OK,74401-6802,Proprietary  ,1,4,5,30,61,91
00834300,AUTRY TECHNOLOGY CENTER                 ,OK,73703-2598,Public       ,2,13,15,96,375,471
00861900,TRI COUNTY TECHNOLOGY CENTER            ,OK,74006-6029,Public       ,0,7,7,107,269,376
00918500,ROSE STATE COLLEGE                      ,OK,73110-2799,Public       ,122,451,573,2877,6641,9518
00920400,KIAMICHI AREA VOC TECH SCHOOL           ,OK,74578-0548,Public       ,14,68,82,336,1151,1487
00920408,KIAMICHI AREA VOC TECH SCHOOL           ,OK,74953-0000,Public       ,0,11,11,55,199,254
00961800,TULSA WELDING SCHOOL                    ,OK,74104-0000,Proprietary  ,192,458,650,1336,2124,3460
00964700,"OKLAHOMA STATE UNIV, OKLA CITY          ",OK,73107-6159,Public       ,112,452,564,2590,6790,9380
00970800,EVES COLLEGE OF HAIRSTYLING             ,OK,73501-4359,Proprietary  ,5,20,25,34,148,182
00976300,TULSA COMMUNITY COLLEGE                 ,OK,74135-6198,Public       ,187,823,1010,8317,14384,22701
00996300,CADDO KIOWA VOC TECH CENTER             ,OK,73038-0000,Public       ,8,29,37,101,438,539
00996400,CENTRAL OKLAHOMA AREA VOC TECH SCH      ,OK,74030-9613,Public       ,3,22,25,99,362,461
00996500,CANADIAN VALLEY TECHNOLOGY CENTER       ,OK,73036-9117,Public       ,8,47,55,106,551,657
00996800,GORDON COOPER TECHNOLOGY CENTER         ,OK,74804-9913,Public       ,3,31,34,122,533,655
01005300,INDIAN CAPITAL TECHNOLGY CENTER #4      ,OK,74403-9907,Public       ,6,31,37,187,800,987
01026600,HILLSDALE FREE WILL BAPTIST COLLEGE     ,OK,73153-0000,Private      ,3,3,6,215,86,301
01034200,SOUTHERN OKLAHOMA TECHNOLOGY CENTER     ,OK,73401-2100,Public       ,6,30,36,86,332,418
01039100,OKLAHOMA CITY COMMUNITY COLLEGE         ,OK,73159-4444,Public       ,229,730,959,4919,10708,15627
01050304,WTI TULSA CAMPUS                        ,OK,74112-3140,Proprietary  ,0,28,28,21,267,288
01071700,GREAT PLAINS TECHNOLOGY CENTER SCHOOL DI,OK,73505-8399,Public       ,5,45,50,143,640,783
01076200,WESTERN OK AREA VOC TECH SCH DIST12     ,OK,73624-1469,Public       ,2,11,13,64,171,235
01120600,PIONEER TECHNOLOGY CENTER               ,OK,74601-1106,Public       ,0,14,14,44,270,314
01128200,OKLAHOMA STATE UNV CLG OSTEOPTHC MD     ,OK,74107-0000,Public       ,3,8,11,82,693,775
01153700,MID-AMERICA TECHNOLOGY CENTER           ,OK,73095-0210,Public       ,2,8,10,49,120,169
01227200,MOORE-NORMAN TECHNOLOGY CENTER          ,OK,73069-8399,Public       ,5,66,71,209,963,1172
02052700,NORTHEAST TECHNOLOGY CENTER             ,OK,74361-0487,Public       ,4,48,52,142,676,818
02060800,MERIDIAN TECHNOLOGY CENTER              ,OK,74074-0000,Public       ,4,13,17,124,433,557
02126500,ENID BEAUTY COLLEGE                     ,OK,73701-0000,Proprietary  ,2,9,11,26,72,98
02184400,SAND SPRINGS BEAUTY COLLEGE             ,OK,74063-0000,Proprietary  ,4,25,29,41,177,218
02197300,HOLLYWOOD COSMETOLOGY CENTER            ,OK,73189-0000,Proprietary  ,1,6,7,14,60,74
02222700,FRANCIS TUTTLE TECHNOLOGY CENTER        ,OK,73142-0000,Public       ,19,122,141,344,1709,2053
02238500,CENTRAL STATE BEAUTY ACADEMY            ,OK,73162-6007,Proprietary  ,4,56,60,67,311,378
02250900,E OK COUNTY AREA VO-TECH                ,OK,73020-0000,Public       ,3,6,9,49,123,172
02256200,"BROKEN ARROW BEAUTY COLLEGE, INC        ",OK,74012-0000,Proprietary  ,9,32,41,105,290,395
02282100,HIGH PLAINS AREA VOC-TECH               ,OK,73801-0000,Public       ,0,4,4,40,131,171
02306800,PLATT COLLEGE                           ,OK,74145-0000,Proprietary  ,34,335,369,406,2647,3053
02510300,BEAUTY TECHNICAL COLLEGE                ,OK,74465-0000,Proprietary  ,3,4,7,15,54,69
02531200,WOODWARD BEAUTY COLLEGE                 ,OK,73801-0000,Proprietary  ,2,3,5,8,51,59
02554300,AMERICAN BEAUTY INSTITUTE               ,OK,74501-0000,Proprietary  ,1,11,12,19,78,97
02556500,YUKON BEAUTY COLLEGE                    ,OK,73099-4108,Proprietary  ,1,7,8,12,47,59
02560200,PHILLIPS THEOLOGICAL SEMINARY -         ,OK,74116-5612,Private      ,0,4,4,1,103,104
02581100,CLAREMORE BEAUTY COLLEGE                ,OK,74017-7034,Proprietary  ,0,3,3,6,39,45
02581200,CC'S COSMETOLOGY COLLEGE                ,OK,74129-0000,Proprietary  ,2,26,28,51,314,365
02591101,CAREER POINT INSTITUTE                  ,OK,74146-0000,Proprietary  ,0,18,18,41,226,267
02596501,ATI-CAREER TRAINING CENTER - OKLAHOMA CI,OK,73107-2442,Proprietary  ,8,34,42,33,189,222
02596502,ATI- CAREER TRAINING CENTER - OKLAHOMA C,OK,76101-2740,Proprietary  ,5,23,28,24,175,199
02597400,PONTOTOC TECHNOLOGY CENTER SCHOOL       ,OK,74820-8621,Public       ,1,10,11,84,255,339
02599706,VATTEROTT COLLEGE - TULSA               ,OK,74146-2205,Proprietary  ,4,46,50,78,636,714
02600000,NORTHWEST TECHNOLOG CTR SCH DIST 10     ,OK,73717-9600,Public       ,1,2,3,37,74,111
02600500,WES WATKINS TECHNOLOGY CENTER           ,OK,74883-9660,Public       ,2,18,20,39,236,275
02609205,VATTEROTT COLLEGE - OKLAHOMA CITY       ,OK,73127-2103,Proprietary  ,8,62,70,79,864,943
03008700,SOUTHWEST TECHNOLOGY CENTER             ,OK,73521-1527,Public       ,1,11,12,40,124,164
03024700,STILLWATER BEAUTY ACADEMY               ,OK,74075-3467,Proprietary  ,0,7,7,15,53,68
03030700,OKLAHOMA SCHOOL OF PHOTOGRAPHY          ,OK,73160-3320,Proprietary  ,2,17,19,41,158,199
03030800,AMERICAN BROADCASTING SCHOOL            ,OK,73115-3334,Proprietary  ,6,53,59,68,383,451
03051100,CHISHOLM TRAIL TECHNOLOGY CENTER        ,OK,73764-9720,Public       ,0,11,11,19,89,108
03078500,TECH INST OF COSMETOLOGY ARTS & SCI     ,OK,74120-3610,Proprietary  ,1,9,10,23,98,121
03103800,SOUTHERN SCHOOL OF BEAUTY               ,OK,74701-5008,Proprietary  ,3,8,11,23,71,94
03109800,PONCA CITY BEAUTY COLLEGE               ,OK,74601-4201,Proprietary  ,0,4,4,3,29,32
03109801,BARTLESVILLE BEAUTY COLLEGE             ,OK,74003-2835,Proprietary  ,1,5,6,4,45,49
03115100,HERITAGE COLLEGE                        ,OK,73119-0000,Proprietary  ,22,177,199,298,1527,1825
03124800,PLATT COLLEGE                           ,OK,73501-3808,Proprietary  ,8,68,76,76,463,539
03124901,IMAGINE -  PAUL MITCHELL PARTNER SCHOOL ,OK,73072-4831,Proprietary  ,10,30,40,42,86,128
03126200,GREEN COUNTRY AREA VOC TECH SCHOOL      ,OK,74447-1217,Public       ,4,6,10,38,146,184
03198400,MID-DEL AREA VOCATIONAL & TECH SCH      ,OK,73110-4825,Public       ,1,18,19,30,176,206
03329400,PRYOR BEAUTY COLLEGE                    ,OK,74361-0000,Proprietary  ,1,5,6,7,44,51
03329401,PRYOR BEAUTY COLLEGE - GROVE BEAUTY COLL,OK,74345-0009,Proprietary  ,2,5,7,10,26,36
03329402,PRYOR BEAUTY COLLEGE - NORTH EAST OKLAHO,OK,74338-0000,Proprietary  ,1,2,3,4,12,16
03367400,COMMUNITY CARE COLLEGE                  ,OK,74145-6420,Proprietary  ,52,231,283,502,2044,2546
03396300,OKLAHOMA HEALTH ACADEMY                 ,OK,74105-6220,Proprietary  ,5,35,40,73,355,428
03396400,OKLAHOMA HEALTH ACADEMY                 ,OK,73160-3667,Proprietary  ,8,51,59,64,257,321
03453400,SHAWNEE BEAUTY COLLEGE                  ,OK,74801-7014,Proprietary  ,2,9,11,14,53,67
03676300,FAMILY OF FAITH COLLEGE                 ,OK,74802-1805,Private      ,0,3,3,21,24,45
03831300,INSTITUTE OF HAIR DESIGN                ,OK,74804-0000,Proprietary  ,0,5,5,10,41,51
03928300,CENTRAL STATE MASSAGE ACADEMY           ,OK,73162-6007,Proprietary  ,1,13,14,32,122,154
04027300,4-STATES ACADEMY OF COSMETOLOGY         ,OK,74354-0000,Proprietary  ,2,7,9,13,49,62
04051324,ART INSTITUTE OF PHOENIX (THE) - BROWN M,OK,74146-5234,Proprietary  ,11,50,61,126,733,859
04060300,AMERICAN INSTITUTE OF MEDICAL TECHNOLOGY,OK,74146-5201,Proprietary  ,3,18,21,51,250,301
04062300,BROOKLINE COLLEGE                       ,OK,73114-6318,Proprietary  ,3,20,23,59,229,288
04121300,4-STATES OKMULGEE ACADEMY OF COSMETOLOGY,OK,74447-0000,Proprietary  ,0,5,5,8,45,53
04133600,CUTTER'S EDGE SCHOOL OF COSMETOLOGY     ,OK,74023-2905,Proprietary  ,0,6,6,8,29,37
04144400,ACADEMY OF HAIR DESIGN (THE)            ,OK,73120-6808,Proprietary  ,0,13,13,65,176,241
00163700,BETHANY THEOLOGICAL SEMINARY            ,IN,47374-0000,Private      ,0,4,4,4,66,70
00178400,ANCILLA COLLEGE-FINANCIAL AID OFFC      ,IN,46513-0001,Private      ,3,31,34,532,678,1210
00178500,ANDERSON UNIVERSITY                     ,IN,46012-3495,Private      ,23,54,77,2751,1273,4024
00178600,BALL STATE UNIVERSITY                   ,IN,47306-0880,Public       ,173,356,529,22193,10443,32636
00178700,BETHEL COLLEGE INC                      ,IN,46545-5591,Private      ,9,80,89,1701,1608,3309
00178800,BUTLER UNIVERSITY                       ,IN,46208-3487,Private      ,65,84,149,6723,2057,8780
00178900,CHRISTIAN THEOLOGICAL SEMINARY          ,IN,46208-0000,Private      ,0,7,7,5,290,295
00179200,DEPAUW UNIVERSITY                       ,IN,46135-0037,Private      ,23,4,27,3327,169,3496
00179300,EARLHAM COLLEGE                         ,IN,47374-4095,Private      ,12,6,18,1594,192,1786
00179301,EARLHAM SCHOOL OF RELIGION              ,IN,47374-0000,Private      ,1,4,5,19,64,83
00179500,UNIVERSITY OF EVANSVILLE                ,IN,47722-0002,Private      ,19,25,44,4062,980,5042
00179800,FRANKLIN COLLEGE OF INDIANA             ,IN,46131-2623,Private      ,12,11,23,1929,264,2193
00179900,GOSHEN COLLEGE                          ,IN,46526-4794,Private      ,5,20,25,1062,514,1576
00180000,GRACE COLLEGE & THEO SEMINARY           ,IN,46590-1224,Private      ,15,25,40,1615,888,2503
00180100,HANOVER COLLEGE                         ,IN,47243-0108,Private      ,20,1,21,2140,107,2247
00180300,HUNTINGTON UNIVERSITY                   ,IN,46750-1299,Private      ,10,24,34,1467,483,1950
00180400,UNIVERSITY OF INDIANAPOLIS              ,IN,46227-3697,Private      ,49,203,252,6036,4983,11019
00180500,INDIANA INSTITUTE OF TECHNOLOGY         ,IN,46803-1297,Private      ,22,277,299,2023,4199,6222
00180700,INDIANA STATE UNIVERSITY                ,IN,47809-2501,Public       ,122,229,351,11392,7806,19198
00180800,UNIVERSITY OF SOUTHERN INDIANA          ,IN,47712-3596,Public       ,68,141,209,9440,4236,13676
00180900,INDIANA UNIVERSITY-BLOOMINGTON          ,IN,47405-1223,Public       ,271,303,574,32759,13313,46072
00181100,INDIANA UNIV-EAST                       ,IN,47374-1289,Public       ,23,98,121,1574,2522,4096
00181300,INDIANA UNIV-PURDUE UNIV INDPLS         ,IN,46202-5145,Public       ,210,778,988,18005,23669,41674
00181301,INDIANA UNIVERSITY - PURDUE UNIVERSITY I,IN,47203-1769,Public       ,24,89,113,1740,2219,3959
00181400,INDIANA UNIV KOKOMO                     ,IN,46902-3557,Public       ,19,78,97,1799,2611,4410
00181500,INDIANA UNIV-NORTHWEST                  ,IN,46408-1197,Public       ,70,226,296,3369,5540,8909
00181600,INDIANA UNIVERSITY - SOUTH BEND         ,IN,46615-0000,Public       ,77,230,307,5162,6717,11879
00181700,INDIANA UNIVERSITY-SOUTHEAST            ,IN,47150-6405,Public       ,62,189,251,4378,4725,9103
00182000,MANCHESTER COLLEGE                      ,IN,46962-1276,Private      ,13,5,18,2392,203,2595
00182100,MARIAN UNIVERSITY                       ,IN,46222-1997,Private      ,18,94,112,2144,2386,4530
00182200,INDIANA WESLEYAN UNIVERSITY             ,IN,46953-4974,Private      ,44,1507,1551,4386,15894,20280
00182300,ASSOCIATED MENNONITE BIBLICAL SEM       ,IN,46517-1999,Private      ,0,1,1,5,120,125
00182400,OAKLAND CITY UNIVERSITY                 ,IN,47660-1099,Private      ,4,23,27,597,2138,2735
00182500,PURDUE UNIVERSITY                       ,IN,47907-2050,Public       ,213,209,422,32468,9056,41524
00182600,PURDUE UNIV NORTH CENTRAL CAMPUS        ,IN,46391-9542,Public       ,43,76,119,2942,3341,6283
00182700,PURDUE UNIV CALUMET                     ,IN,46323-2094,Public       ,78,251,329,5685,6630,12315
00182800,INDIANA UNIV-PURDUE UNIV FORT WAYNE     ,IN,46805-1499,Public       ,93,274,367,9815,9304,19119
00183000,ROSE HULMAN INSTITUTE OF TECHNOLOGY     ,IN,47803-3999,Private      ,13,5,18,3031,158,3189
00183200,UNIVERSITY OF SAINT FRANCIS             ,IN,46808-3994,Private      ,19,77,96,2211,2145,4356
00183300,ST JOSEPH'S COLLEGE                     ,IN,47978-0000,Private      ,14,6,20,1325,198,1523
00183400,CALUMET COLLEGE OF SAINT JOSEPH         ,IN,46394-2195,Private      ,13,58,71,588,1028,1616
00183500,SAINT MARY-OF-THE-WOODS COLLEGE         ,IN,47876-0067,Private      ,6,69,75,504,1461,1965
00183600,ST MARY'S COLLEGE                       ,IN,46556-5007,Private      ,7,2,9,1804,104,1908
00183800,TAYLOR UNIVERSITY                       ,IN,46989-1001,Private      ,18,13,31,2542,349,2891
00183900,TRINE UNIVERSITY                        ,IN,46703-1764,Private      ,14,35,49,2635,948,3583
00184000,UNIVERSITY OF NOTRE DAME                ,IN,46556-5602,Private      ,87,50,137,12487,3885,16372
00184200,VALPARAISO UNIVERSITY                   ,IN,46383-6493,Private      ,36,48,84,4445,2255,6700
00184300,VINCENNES UNIVERSITY                    ,IN,47591-1523,Public       ,92,235,327,7053,5273,12326
00184400,WABASH COLLEGE                          ,IN,47933-0352,Private      ,15,3,18,1366,76,1442
00420300,GOOD SAMARITAN HOSP RADIOGRAPHY PRG     ,IN,47591-0000,Public       ,0,0,0,17,28,45
00457900,INTERNATIONAL BUSINESS COLLEGE          ,IN,46804-0000,Proprietary  ,17,27,44,818,522,1340
00457901,INTERNATIONAL BUSINESS COLLEGE          ,IN,46256-0000,Proprietary  ,17,41,58,670,576,1246
00625700,SAINT ELIZABETH SCHOOL OF NURSING       ,IN,47904-2198,Private      ,4,3,7,145,365,510
00726300,HOLY CROSS COLLEGE                      ,IN,46556-0308,Private      ,9,5,14,654,129,783
00727600,SAINT MEINRAD SCHOOL OF THEOLOGY        ,IN,47577-1002,Private      ,0,4,4,1,135,136
00732900,ITT TECHNICAL INSTITUTE                 ,IN,46268-1119,Proprietary  ,360,2678,3038,3260,17930,21190
00732908,ITT TECHNICAL INSTITUTE                 ,IN,46143-1067,Proprietary  ,4,14,18,4,24,28
00732933,ITT TECHNICAL INSTITUTE                 ,IN,46635-1512,Proprietary  ,5,20,25,10,42,52
00732962,ITT TECHNICAL INSTITUTE                 ,IN,47630-7430,Proprietary  ,174,644,818,1907,6025,7932
00732968,ITT TECHNICAL INSTITUTE                 ,IN,46410-0000,Proprietary  ,3,18,21,7,33,40
00732993,ITT TECHNICAL INSTITUTE                 ,IN,46825-2393,Proprietary  ,157,543,700,1891,5728,7619
00736200,MEDTECH COLLEGE                         ,IN,46250-3970,Proprietary  ,18,158,176,318,2256,2574
00736202,MEDTECH COLLEGE - GREENWOOD             ,IN,46143-6478,Proprietary  ,11,118,129,170,1180,1350
00736204,MEDTECH COLLEGE - FORT WAYNE            ,IN,46804-2209,Proprietary  ,8,78,86,173,1021,1194
00793800,LINCOLN COLLEGE OF TECHNOLOGY           ,IN,46202-0000,Proprietary  ,106,171,277,2440,1992,4432
00842300,IVY TECH COMMUNITY COLLEGE OF INDIANA - ,IN,46601-3892,Public       ,97,545,642,3298,11937,15235
00854600,NOT FOR STUDENT USE                     ,IN,46208-4700,Public       ,1,3,4,38,72,110
00854700,IVY TECH COMMUNITY COLLEGE OF INDIANA - ,IN,47802-4898,Public       ,52,297,349,2399,6621,9020
00931306,DAYMAR COLLEGE - ROCKPORT               ,IN,47635-1506,Proprietary  ,0,0,0,0,1,1
00951500,J MICHAEL HARROLD BEAUTY ACADEMY        ,IN,47807-3390,Proprietary  ,5,15,20,40,105,145
00961200,"APEX SCHOOL OF BEAUTY CULTURE, INC      ",IN,46016-0000,Proprietary  ,4,5,9,27,63,90
00961300,MERRILLVILLE BEAUTY COLLEGE             ,IN,46410-3401,Proprietary  ,2,15,17,55,173,228
00967300,RUDAE'S SCHOOL OF BEAUTY CULTURE        ,IN,46825-5444,Proprietary  ,13,20,33,136,305,441
00977700,KAPLAN COLLEGE                          ,IN,46278-1736,Proprietary  ,36,181,217,388,1974,2362
00977702,KAPLAN COLLEGE - TEMPORARY FACILITY EXPA,IN,46268-4111,Proprietary  ,0,12,12,32,169,201
00977703,KAPLAN COLLEGE -  SE INDY               ,IN,46227-0000,Proprietary  ,32,147,179,279,1431,1710
00991700,IVY TECH COMMUNITY COLLEGE OF INDIANA   ,IN,46208-1763,Public       ,384,2026,2410,11388,29056,40444
00992300,IVY TECH COMMUNITY COLLEGE OF INDIANA - ,IN,47250-1881,Public       ,35,183,218,1236,3272,4508
00992400,IVY TECH COMMUNITY COLLEGE OF INDIANA - ,IN,47302-9448,Public       ,98,519,617,4295,11315,15610
00992500,IVY TECH COMMUNITY COLLEGE OF INDIANA - ,IN,47710-3398,Public       ,65,320,385,2389,6721,9110
00992600,IVY TECH COMMUNITY COLLEGE OF INDIANA- R,IN,46805-1489,Public       ,119,623,742,5517,15069,20586
01003700,IVY TECH STATE COLLEGE - REGION 9       ,IN,47374-1220,Public       ,45,279,324,1318,5438,6756
01003800,IVY TECH COMMUNITY COLLEGE OF INDIANA - ,IN,47203-1868,Public       ,67,277,344,2092,5575,7667
01003900,IVY TECH COMMUNITY COLLEGE OF INDIANA - ,IN,47903-6299,Public       ,71,363,434,3776,7916,11692
01004000,IVY TECH COMMUNITY COLLEGE OF INDIANA - ,IN,46409-1303,Public       ,147,640,787,3823,11848,15671
01004100,IVY TECH STATE COLLEGE - REGION 5       ,IN,46903-1373,Public       ,45,367,412,1953,7359,9312
01010900,IVY TECH COMMUNITY COLLEGE OF INDIANA - ,IN,47172-1897,Public       ,53,232,285,1741,5106,6847
01015100,VINCENNES BEAUTY COLLEGE                ,IN,47591-1297,Proprietary  ,1,8,9,64,80,144
01040900,LAFAYETTE BEAUTY ACADEMY                ,IN,47901-1149,Proprietary  ,6,20,26,62,206,268
01048900,NATIONAL COLLEGE                        ,IN,46250-1930,Proprietary  ,10,136,146,524,4844,5368
01048910,NATIONAL COLLEGE - SOUTH BEND           ,IN,46617-3123,Proprietary  ,1,14,15,4,61,65
01048911,NATIONAL COLLEGE - FORT WAYNE           ,IN,46826-4905,Proprietary  ,1,20,21,3,24,27
01061800,MID-AMERICA CLG FUNERAL SERVICE         ,IN,47130-9990,Private      ,4,12,16,64,165,229
01150500,CREATIVE HAIR STYLING ACADEMY           ,IN,46322-1554,Proprietary  ,6,18,24,83,114,197
02084800,RAVENSCROFT BEAUTY COLLEGE              ,IN,46815-0000,Proprietary  ,7,31,38,89,298,387
02087600,CONCORDIA THEOLOGICAL SEMINARY          ,IN,46825-0000,Private      ,0,9,9,5,298,303
02100402,EVEREST INSTITUTE - EVEREST COLLEGE     ,IN,46410-7064,Proprietary  ,23,142,165,325,1599,1924
02140800,MARTIN UNIVERSITY                       ,IN,46218-0000,Private      ,18,125,143,263,1812,2075
02158400,HARRISON COLLEGE                        ,IN,46204-2611,Proprietary  ,49,453,502,806,4793,5599
02158401,HARRISON COLLEGE - COLUMBUS             ,IN,47203-1843,Proprietary  ,5,42,47,116,552,668
02158402,HARRISON COLLEGE - LAFAYETTE            ,IN,47905-4859,Proprietary  ,5,57,62,137,593,730
02158404,HARRISON COLLEGE - MARION               ,IN,46952-0000,Proprietary  ,0,1,1,28,100,128
02158405,HARRISON COLLEGE - TERRE HAUTE          ,IN,47802-0000,Proprietary  ,11,63,74,101,654,755
02158407,HARRISON COLLEGE - ANDERSON             ,IN,46013-0000,Proprietary  ,6,54,60,136,627,763
02158409,HARRISON COLLEGE - EVANSVILLE           ,IN,47715-3901,Proprietary  ,12,50,62,123,529,652
02158410,HARRISON COLLEGE - EAST                 ,IN,46239-8903,Proprietary  ,15,79,94,233,1070,1303
02158412,HARRISON COLLEGE - FORT WAYNE           ,IN,46825-0000,Proprietary  ,12,82,94,212,1092,1304
02158413,HARRISON COLLEGE - NORTHWEST            ,IN,46278-0000,Proprietary  ,5,46,51,254,558,812
02158800,DON ROBERTS BEAUTY SCHOOLS              ,IN,46383-0000,Proprietary  ,3,18,21,36,80,116
02164300,DON ROBERTS SCHOOL OF HAIR DESIGN       ,IN,46375-9999,Proprietary  ,1,15,16,37,112,149
02180108,ROSS MEDICAL EDUCATION CENTER -         ,IN,46530-4479,Proprietary  ,0,5,5,14,89,103
02201800,KAPLAN COLLEGE                          ,IN,46410-0000,Proprietary  ,12,73,85,174,1023,1197
02201802,KAPLAN COLLEGE - HAMMOND                ,IN,46324-3347,Proprietary  ,12,82,94,216,1234,1450
02241700,PJ'S COLLEGE OF COSMETOLOGY             ,IN,47129-0000,Proprietary  ,6,39,45,81,286,367
02245505,FORTIS COLLEGE - INDIANAPOLIS CAMPUS    ,IN,46268-0000,Proprietary  ,6,41,47,33,272,305
02302700,J EVERETT LIGHT CAREER CENTER           ,IN,46240-0000,Public       ,3,22,25,76,442,518
02304800,PJ'S COLLEGE OF COSMETOLOGY             ,IN,47374-0000,Proprietary  ,1,12,13,26,125,151
02308900,MASTER'S OF COSMETOLOGY COLLEGE         ,IN,46809-0000,Proprietary  ,9,12,21,116,177,293
02339600,ROGER'S ACADEMY OF HAIR DESIGN          ,IN,47712-0000,Proprietary  ,7,27,34,100,228,328
02345200,EMPIRE BEAUTY SCHOOL                    ,IN,46237-0000,Proprietary  ,18,83,101,152,660,812
02351300,KNOX BEAUTY COLLEGE                     ,IN,46534-0000,Proprietary  ,4,6,10,12,39,51
02490500,HAIR FASHIONS BY KAYE BEAUTY CLG        ,IN,46250-0000,Proprietary  ,1,40,41,55,245,300
02490800,HAIR FASHIONS BY KAYE BEAUTY CLG        ,IN,46060-0000,Proprietary  ,3,11,14,47,201,248
02607000,HAIR ARTS ACADEMY                       ,IN,47404-3581,Proprietary  ,2,16,18,37,124,161
02615800,COLLEGE OF COURT REPORTING              ,IN,46342-5969,Proprietary  ,2,19,21,45,384,429
03009700,HARRISON COLLEGE                        ,IN,47303-6413,Proprietary  ,7,32,39,111,489,600
03009701,HARRISON COLLEGE - MUNCIE - ELKHART     ,IN,46516-9795,Proprietary  ,6,43,49,113,683,796
03100600,MARION COMM TUCKER AREA VOC SCHOOL      ,IN,46952-3831,Public       ,4,12,16,50,154,204
03176300,AVIATION INSTITUTE OF MAINTENANCE       ,IN,46241-1445,Proprietary  ,15,92,107,156,589,745
03262300,DAVID DEMUTH INSTITUTE OF COSM          ,IN,47374-4101,Proprietary  ,0,7,7,14,60,74
03456700,CROSSROADS BIBLE COLLEGE                ,IN,46219-4912,Private      ,1,29,30,82,355,437
03521300,IVY TECH COMMUNITY COLLEGE OF INDIANA - ,IN,47404-9772,Public       ,55,267,322,3423,6322,9745
03538300,ALEXANDRIA SCH OF SCIENTIFIC THERAP     ,IN,46001-0287,Proprietary  ,0,2,2,40,90,130
04038700,IDEAL BEAUTY ACADEMY                    ,IN,47130-4215,Proprietary  ,5,16,21,34,90,124
04051304,ART INSTITUTE OF PHOENIX (THE) - ART  IN,IN,46268-1170,Proprietary  ,54,100,154,1477,1551,3028
04051311,ART INSTITUTE OF PHOENIX (THE) - BROWN M,IN,46410-5608,Proprietary  ,13,102,115,298,1630,1928
04051312,ART INSTITUTE OF PHOENIX (THE) - BROWN M,IN,46360-7362,Proprietary  ,7,65,72,158,921,1079
04051318,ART INSTITUTE OF PHOENIX (THE) - BROWN M,IN,46204-1017,Proprietary  ,44,246,290,534,3150,3684
04051321,ART INSTITUTE OF PHOENIX (THE) - BROWN M,IN,46635-1176,Proprietary  ,42,209,251,618,2794,3412
04051322,ART INSTITUTE OF PHOENIX (THE) - BROWN M,IN,46805-0000,Proprietary  ,42,162,204,538,3148,3686
04100300,SUCCESS SCHOOLS                         ,IN,46410-5310,Proprietary  ,15,29,44,75,242,317
04121000,TECHSKILLS - INDIANAPOLIS               ,IN,46240-4302,Proprietary  ,2,81,83,34,362,396
04130900,HONORS BEAUTY COLLEGE                   ,IN,46256-3317,Proprietary  ,7,35,42,102,313,415
04155900,AVEDA FREDRIC'S INSTITUTE               ,IN,46250-4746,Proprietary  ,6,14,20,144,203,347
04166700,REM SPA INC                             ,IN,46013-3136,Proprietary  ,9,17,26,51,116,167
04171700,AVANT GARD THE SCHOOL                   ,IN,46214-6500,Proprietary  ,3,9,12,11,41,52
04172700,SALON PROFESSIONAL ACADEMY (THE)        ,IN,47715-7822,Proprietary  ,4,22,26,30,84,114
04184000,PAUL MITCHELL THE SCHOOL INDIANAPOLIS   ,IN,46227-6252,Proprietary  ,15,39,54,15,39,54
00163203,AQUINAS INSTITUTE OF THEOLOGY - MINISTRY,KS,66109-3718,Private      ,0,0,0,5,7,12
00190100,ALLEN COUNTY COMMUNITY COLLEGE          ,KS,66749-1607,Public       ,25,118,143,1061,1570,2631
00190200,COWLEY COUNTY COMMUNITY COLLEGE & AREA V,KS,67005-2662,Public       ,67,196,263,1642,2994,4636
00190300,BAKER UNIVERSITY                        ,KS,66006-0065,Private      ,24,292,316,1493,2821,4314
00190400,BETHANY COLLEGE                         ,KS,67456-1897,Private      ,9,1,10,845,105,950
00190500,BETHEL COLLEGE                          ,KS,67117-0531,Private      ,7,9,16,548,149,697
00190600,BUTLER COUNTY COMMUNITY COLLEGE         ,KS,67042-3280,Public       ,135,346,481,4397,5875,10272
00190700,CENTRAL BAPTIST THEOLOGY SEMINARY       ,KS,66226-3513,Private      ,0,3,3,0,44,44
00190800,CENTRAL CHRISTIAN COLLEGE OF KANSAS     ,KS,67460-5799,Private      ,1,26,27,449,109,558
00190900,CLOUD COUNTY COMMUNITY COLLEGE          ,KS,66901-1002,Public       ,21,78,99,894,1182,2076
00191000,COFFEYVILLE COMMUNITY COLLEGE           ,KS,67337-5064,Public       ,82,41,123,1140,633,1773
00191100,COLBY COMMUNITY COLLEGE                 ,KS,67701-4099,Public       ,14,24,38,612,411,1023
00191300,DODGE CITY COMMUNITY COLLEGE            ,KS,67801-2399,Public       ,45,69,114,771,729,1500
00191400,DONNELLY COLLEGE                        ,KS,66102-4298,Private      ,26,104,130,227,890,1117
00191500,FORT HAYS STATE UNIVERSITY              ,KS,67601-4099,Public       ,42,199,241,3737,4708,8445
00191600,FORT SCOTT COMMUNITY COLLEGE            ,KS,66701-3199,Public       ,38,68,106,1381,1251,2632
00191700,BARCLAY COLLEGE                         ,KS,67059-0288,Private      ,2,9,11,159,129,288
00191800,FRIENDS UNIVERSITY                      ,KS,67213-3397,Private      ,20,181,201,1345,3137,4482
00191900,GARDEN CITY COMMUNITY COLLEGE           ,KS,67846-6398,Public       ,43,51,94,1009,725,1734
00192000,HESSTON COLLEGE                         ,KS,67062-2093,Private      ,2,2,4,453,209,662
00192100,HIGHLAND COMMUNITY COLLEGE              ,KS,66035-4062,Public       ,34,83,117,1314,1754,3068
00192114,HIGHLAND COMMUNITY COLLEGE - NOTHEAST KA,KS,66002-1513,Public       ,0,0,0,13,30,43
00192300,HUTCHINSON COMMUNITY COLLEGE            ,KS,67501-5894,Public       ,87,165,252,2327,2780,5107
00192400,INDEPENDENCE COMMUNITY COLLEGE          ,KS,67301-0000,Public       ,53,65,118,575,590,1165
00192500,KANSAS CITY KANSAS COMMUNITY CLG        ,KS,66112-9978,Public       ,91,411,502,2047,5357,7404
00192502,"KANSAS CITY KS AREA TECH SCHOOL, KS     ",KS,66104-0000,Public       ,1,22,23,113,379,492
00192600,PITTSBURG STATE UNIVERSITY              ,KS,66762-7500,Public       ,80,127,207,4792,3041,7833
00192700,EMPORIA STATE UNIVERSITY                ,KS,66801-5087,Public       ,34,94,128,3356,2977,6333
00192800,KANSAS STATE UNIVERSITY                 ,KS,66506-1104,Public       ,192,272,464,15110,6818,21928
00192900,KANSAS WESLEYAN UNIVERSITY              ,KS,67401-6196,Private      ,7,14,21,1047,411,1458
00193000,LABETTE COMMUNITY COLLEGE               ,KS,67357-4299,Public       ,19,56,75,619,1039,1658
00193100,MANHATTAN CHRISTIAN COLLEGE             ,KS,66502-4081,Private      ,0,6,6,338,133,471
00193300,MCPHERSON COLLEGE                       ,KS,67460-3899,Private      ,3,6,9,814,190,1004
00193600,NEOSHO COUNTY COMMUNITY COLLEGE         ,KS,66720-2699,Public       ,21,70,91,694,1189,1883
00193700,OTTAWA UNIVERSITY                       ,KS,66067-3399,Private      ,18,310,328,934,3168,4102
00193800,PRATT COMMUNITY COLLEGE                 ,KS,67124-8432,Public       ,11,48,59,610,707,1317
00193900,NEWMAN UNIVERSITY                       ,KS,67213-2084,Private      ,20,82,102,1295,1728,3023
00194000,SOUTHWESTERN COLLEGE                    ,KS,67156-2499,Private      ,10,71,81,798,1360,2158
00194300,UNIVERSITY OF ST MARY                   ,KS,66048-5023,Private      ,15,52,67,698,658,1356
00194500,STERLING COLLEGE                        ,KS,67579-1533,Private      ,10,9,19,918,199,1117
00194600,TABOR COLLEGE                           ,KS,67063-1799,Private      ,6,20,26,757,238,995
00194800,UNIVERSITY OF KANSAS                    ,KS,66045-7535,Public       ,196,296,492,16037,10904,26941
00194900,WASHBURN UNIVERSITY                     ,KS,66621-1110,Public       ,55,151,206,3457,4852,8309
00194901,WASHBURN UNIVERSITY -TOPEKA - WASHBURN I,KS,66604-2199,Public       ,7,32,39,281,750,1031
00195000,WICHITA STATE UNIVERSITY                ,KS,67208-0001,Public       ,110,363,473,6977,9040,16017
00460800,BARTON COUNTY COMMUNITY COLLEGE         ,KS,67530-9283,Public       ,31,206,237,910,1963,2873
00526400,FLINT HILLS TECHNICAL COLLEGE           ,KS,66801-5999,Public       ,10,20,30,268,478,746
00526500,NORTH CENTRAL KANSAS TECH COLG          ,KS,67420-0000,Public       ,6,15,21,416,340,756
00526700,NORTHWEST KANSAS TECHNICAL SCHOOL       ,KS,67735-3441,Public       ,5,7,12,248,171,419
00549800,WICHITA AREA TECHNICAL COLLEGE          ,KS,67211-2099,Public       ,46,279,325,591,3069,3660
00549900,SALINA AREA TECHNICAL COLLEGE           ,KS,67401-8195,Public       ,0,11,11,185,287,472
00550000,MANHATTAN AREA TECHNICAL COLLEGE        ,KS,66503-2499,Public       ,8,30,38,417,694,1111
00675500,BROWN MACKIE COLLEGE (THE)              ,KS,67401-7307,Proprietary  ,25,165,190,413,1886,2299
00703200,MID AMERICA NAZARENE UNIVERSITY         ,KS,66062-1899,Private      ,9,105,114,1044,1267,2311
00822800,SEWARD CO COMM CO/AREA TECHNICAL SCHOOL ,KS,67905-0000,Public       ,13,34,47,514,561,1075
00824400,JOHNSON COUNTY COMMUNITY COLLEGE        ,KS,66210-1299,Public       ,190,496,686,6191,8830,15021
00833200,B-STREET DESIGN SCHOOL OF INTERNATIONAL ,KS,66502-6082,Proprietary  ,8,16,24,53,159,212
00868200,ACADEMY OF HAIR DESIGN                  ,KS,67401-2803,Proprietary  ,0,11,11,13,106,119
01025600,BENEDICTINE COLLEGE                     ,KS,66002-1499,Private      ,19,10,29,2069,192,2261
01043800,HASKELL INDIAN NATIONS UNIVERSITY       ,KS,66046-4800,Public       ,38,34,72,1054,795,1849
01050300,WICHITA TECHNICAL INSTITUTE             ,KS,67213-1927,Proprietary  ,25,157,182,236,1581,1817
01050302,WICHITA TECHNICAL INSTITUTE - WTI TOPEKA,KS,66609-1217,Proprietary  ,9,56,65,79,507,586
01050305,WICHITA TECHNICAL INSTITUTE - EAST CAMPU,KS,67208-4243,Proprietary  ,4,57,61,71,571,642
02090700,CLEVELAND CHIROPRACTIC COLLEGE          ,KS,66210-1613,Private      ,1,14,15,66,623,689
02134800,OLD TOWN BARBER AND BEAUTY COLLEGE      ,KS,67211-0000,Proprietary  ,2,10,12,41,111,152
02196400,CAPITOL CITY HAIR DESIGN COLLEGE        ,KS,66102-0000,Proprietary  ,2,23,25,44,201,245
02257700,HAYS ACADEMY OF HAIR DESIGN             ,KS,67601-0000,Proprietary  ,3,3,6,40,75,115
02303500,AMERICAN INSTITUTE OF BAKING            ,KS,66502-0000,Private      ,0,1,1,13,25,38
02340700,LABARON HAIRDRESSING ACADEMY            ,KS,66204-0000,Proprietary  ,2,9,11,16,84,100
02590900,WRIGHT CAREER COLLEGE                   ,KS,66212-0000,Private      ,78,354,432,475,2945,3420
02599709,VATTEROTT COLLEGE - WICHITA             ,KS,67226-1304,Proprietary  ,9,77,86,101,881,982
02603100,XENON INTERNATIONAL ACADEMY             ,KS,67203-5428,Proprietary  ,7,38,45,138,294,432
02606300,PAUL MITCHELL THE SCHOOL WICHITA        ,KS,67226-2803,Proprietary  ,6,7,13,95,145,240
02611005,HERITAGE COLLEGE - WICHITA              ,KS,67210-1879,Proprietary  ,37,146,183,293,1321,1614
02613000,PINNACLE CAREER INSTITUTE               ,KS,66046-2703,Proprietary  ,14,54,68,97,464,561
03031300,XENON INTERNATIONAL ACADEMY IV          ,KS,66061-3765,Proprietary  ,5,15,20,56,110,166
03066200,BRYAN COLLEGE                           ,KS,66604-2496,Proprietary  ,4,48,52,48,396,444
03450300,B-STREET DESIGN SCHOOL OF INTERNATIONAL ,KS,66611-2373,Proprietary  ,5,14,19,64,190,254
03450301,B-STREET DESIGN SCHOOL OF INTERNATIONAL ,KS,67207-5148,Proprietary  ,5,29,34,36,157,193
03450302,B-STREET DESIGN SCHOOL OF INTERNATIONAL ,KS,66212-5451,Proprietary  ,10,34,44,79,211,290
03529300,SIDNEY'S HAIRDRESSING COLLEGE           ,KS,67501-7094,Proprietary  ,1,10,11,47,75,122
04132900,Z HAIR ACADEMY                          ,KS,66046-4040,Proprietary  ,2,10,12,37,62,99
04162700,ERIC FISHER ACADEMY                     ,KS,67212-3376,Proprietary  ,9,26,35,125,201,326
04175700,ACADEMY OF AESTHETIC ARTS               ,KS,66203-3502,Proprietary  ,3,20,23,3,20,23
04179600,ENTOURAGE INSTITUTE OF BEAUTY AND ESTHET,KS,66215-3803,Proprietary  ,0,4,4,0,4,4
00203300,UNIVERSITY OF MAINE-PRESQUE ISLE        ,ME,04769-2888,Public       ,7,28,35,807,603,1410
00203500,BANGOR THEOLOGICAL SEMINARY             ,ME,04402-0411,Private      ,0,2,2,1,84,85
00203600,BATES COLLEGE                           ,ME,04240-6028,Private      ,27,4,31,2702,110,2812
00203800,BOWDOIN COLLEGE                         ,ME,04011-8451,Private      ,36,4,40,3599,79,3678
00203900,COLBY COLLEGE                           ,ME,04901-8841,Private      ,15,4,19,2664,87,2751
00204000,UNIVERSITY OF MAINE-FARMINGTON          ,ME,04938-1990,Public       ,20,18,38,2753,546,3299
00204100,UNIVERSITY OF MAINE-FORT KENT           ,ME,04743-1292,Public       ,7,17,24,632,396,1028
00204300,HUSSON UNIVERSITY                       ,ME,04401-2999,Private      ,21,58,79,2533,1464,3997
00204400,MAINE MARITIME ACADEMY                  ,ME,04420-0001,Public       ,7,2,9,1066,180,1246
00205000,UNIVERSITY OF NEW ENGLAND               ,ME,04005-9599,Private      ,25,150,175,3843,3625,7468
00205100,SAINT JOSEPH'S COLLEGE                  ,ME,04084-5263,Private      ,9,125,134,1724,964,2688
00205200,THOMAS COLLEGE                          ,ME,04901-5097,Private      ,9,17,26,1043,272,1315
00205300,UNIVERSITY OF MAINE                     ,ME,04469-0001,Public       ,93,81,174,10850,3531,14381
00205400,UNIVERSITY OF SOUTHERN MAINE            ,ME,04104-0000,Public       ,71,178,249,6801,5716,12517
00205500,UNIVERSITY OF MAINE-MACHIAS             ,ME,04654-1397,Public       ,13,24,37,532,387,919
00520400,BEAL COLLEGE                            ,ME,04401-6896,Proprietary  ,13,69,82,241,752,993
00527600,CENTRAL MAINE COMMUNITY COLLEGE         ,ME,04210-6498,Public       ,19,73,92,1578,2236,3814
00527700,EASTERN MAINE COMMUNITY COLLEGE         ,ME,04401-4280,Public       ,23,52,75,1619,1820,3439
00552500,SOUTHERN MAINE COMMUNITY  COLLEGE       ,ME,04106-1698,Public       ,67,159,226,3816,4077,7893
00576000,NORTHERN MAINE COMMUNITY COLLEGE        ,ME,04769-2016,Public       ,12,32,44,546,885,1431
00577600,MERCY HOSP SCH OF RADIOLOGIC TECH       ,ME,04101-3795,Private      ,0,0,0,29,52,81
00630501,CENTRAL MAINE MEDICAL CENTER - COLLEGE O,ME,04240-4500,Private      ,0,12,12,79,306,385
00676000,UNIVERSITY OF MAINE-AUGUSTA             ,ME,04330-9410,Public       ,22,159,181,1715,5738,7453
00685800,UNITY COLLEGE                           ,ME,04988-9502,Private      ,4,1,5,941,120,1061
00903800,MR BERNARD'S SCH HAIR FASHION INC       ,ME,04243-1163,Proprietary  ,7,22,29,54,193,247
00923100,WASHINGTON COUNTY COMMUNITY COLLEGE     ,ME,04619-9704,Public       ,4,6,10,287,342,629
00929200,ANDOVER COLLEGE                         ,ME,04106-2415,Proprietary  ,13,102,115,221,997,1218
00929201,ANDOVER COLLEGE -                       ,ME,04240-0000,Proprietary  ,16,101,117,165,1087,1252
00945900,EMPIRE BEAUTY SCHOOL                    ,ME,04101-3348,Proprietary  ,24,62,86,186,482,668
00945902,PIERRE'S SCHOOL OF COSMETOLOGY - CARIBOU,ME,04736-2020,Proprietary  ,0,0,0,11,13,24
00945903,EMPIRE BEAUTY SCHOOL - BANGOR           ,ME,04401-6534,Proprietary  ,0,0,0,28,34,62
00982600,KENNEBEC VALLEY  COMMUNITY  COLLEGE     ,ME,04937-1367,Public       ,14,71,85,848,1953,2801
01138500,COLLEGE OF THE ATLANTIC                 ,ME,04609-1105,Private      ,5,0,5,521,79,600
01167300,MAINE COLLEGE OF ART                    ,ME,04101-3987,Private      ,3,9,12,602,221,823
02104400,SPA TECH INSTITUTE                      ,ME,04102-0000,Proprietary  ,21,89,110,191,712,903
02347100,NEW ENGLAND SCHOOL OF COMMUNICATIONS    ,ME,04401-0000,Private      ,7,3,10,594,122,716
02361300,LANDING SCHOOL OF BOATBUILDING & DESIGN ,ME,04046-1490,Private      ,0,0,0,19,54,73
03122900,YORK COUNTY COMMUNITY COLLEGE           ,ME,04090-0529,Public       ,20,70,90,631,1034,1665
03429300,SEACOAST CAREER SCHOOLS                 ,ME,04073-0000,Proprietary  ,38,179,217,243,1158,1401
03612300,BIRTHWISE MIDWIFERY SCHOOL              ,ME,04009-1110,Proprietary  ,0,5,5,9,70,79
04177400,CAPILO SCHOOL OF HAIR DESIGN            ,ME,04330-0000,Proprietary  ,21,36,57,30,61,91
00209300,ST JOHN'S COLLEGE                       ,NM,87505-4599,Private      ,4,14,18,474,227,701
00264900,SANTA FE UNIVERSITY OF ART AND DESIGN   ,NM,87505-7634,Proprietary  ,15,17,32,517,254,771
00265000,UNIVERSITY OF THE SOUTHWEST             ,NM,88240-9129,Private      ,4,24,28,307,464,771
00265100,EASTERN NEW MEXICO UNIV PORTALES        ,NM,88130-6000,Public       ,57,148,205,2793,2937,5730
00265101,EASTERN NEW MEXICO UNIV-ROSWELL CAM     ,NM,88202-0000,Public       ,49,160,209,1192,2080,3272
00265102,EASTERN NEW MEXICO UNIVERSITY - RUIDOSO ,NM,88345-0001,Public       ,3,27,30,12,72,84
00265300,NEW MEXICO HIGHLANDS UNIVERSITY         ,NM,87701-4436,Public       ,31,83,114,1753,2474,4227
00265400,NEW MEXICO INST OF MINING & TECH        ,NM,87801-4796,Public       ,20,12,32,1081,441,1522
00265500,NEW MEXICO JUNIOR COLLEGE               ,NM,88240-9123,Public       ,19,83,102,846,1350,2196
00265600,NEW MEXICO MILITARY INSTITUTE           ,NM,88201-5173,Public       ,6,2,8,493,50,543
00265700,NEW MEXICO STATE UNIVERSITY             ,NM,88003-8001,Public       ,227,354,581,12005,9425,21430
00265701,NEW MEXICO STATE UNIV-ALAMOGORDO        ,NM,88311-0000,Public       ,22,80,102,516,1463,1979
00265702,NEW MEXICO STATE UNIV.-DONA ANA CLG     ,NM,88003-0000,Public       ,102,230,332,2805,4661,7466
00265703,NEW MEXICO STATE UNIV-CARLSBAD          ,NM,88220-0000,Public       ,11,43,54,380,815,1195
00265704,NEW MEXICO STATE UNIV-GRANTS            ,NM,87020-0000,Public       ,12,50,62,267,613,880
00266000,SAN JUAN COLLEGE                        ,NM,87402-4699,Public       ,63,285,348,1982,4686,6668
00266300,THE UNIVERSITY OF NEW MEXICO            ,NM,87131-0001,Public       ,449,811,1260,16048,18382,34430
00266301,UNIV OF NEW MEXICO - GALLUP BRANCH      ,NM,87301-5697,Public       ,28,60,88,697,1013,1710
00266302,UNIV OF NEW MEXICO - VALENCIA BRANCH    ,NM,87031-0000,Public       ,20,46,66,398,684,1082
00266303,UNIV OF NEW MEXICO - LOS ALAMOS         ,NM,87544-0000,Public       ,3,12,15,152,159,311
00266304,UNIVERSITY OF NEW MEXICO                ,NM,87571-6401,Public       ,6,29,35,365,520,885
00266400,WESTERN NEW MEXICO UNIVERSITY           ,NM,88061-5417,Public       ,20,80,100,1192,2264,3456
00369109,MIDDLEBURY COLLEGE - INSTITUTE OF AMERIC,NM,87505-0000,Private      ,0,0,0,6,2,8
00405701,NATIONAL AMERICAN UNIVERSITY            ,NM,87110-0000,Proprietary  ,2,43,45,62,489,551
00474200,CENTRAL NEW MEXICO COMMUNITY COLLEGE    ,NM,87106-4096,Public       ,344,1490,1834,8385,20712,29097
00474300,CLOVIS COMMUNITY COLLEGE                ,NM,88101-8381,Public       ,44,171,215,780,2122,2902
00996200,LUNA COMMUNITY COLLEGE                  ,NM,87701-0000,Public       ,27,73,100,476,739,1215
01063200,DEWOLFF CLG HAIRSTYLING/COSMETOLOGY     ,NM,87112-4113,Proprietary  ,4,25,29,64,221,285
01300500,OLYMPIAN UNIVERSITY OF COSMETOLOGY      ,NM,88310-5051,Proprietary  ,72,239,311,492,1593,2085
02083900,NORTHERN NEW MEXICO COLLEGE             ,NM,87530-0000,Public       ,23,86,109,726,1213,1939
02146400,INSTITUTE OF AMERICAN INDIAN ARTS       ,NM,87508-0000,Public       ,7,8,15,187,305,492
02218808,BROOKLINE COLLEGE - ALBUQUERQUE         ,NM,87105-1649,Proprietary  ,41,170,211,256,985,1241
02278100,SANTA FE COMMUNITY COLLEGE              ,NM,87507-0000,Public       ,54,257,311,1016,2707,3723
02293203,ATI CAREER TRAINING CENTER - ALBUQUERQUE,NM,87109-2016,Proprietary  ,2,16,18,63,241,304
02357600,NAVAJO TECHNICAL COLLEGE                ,NM,87313-0000,Public       ,47,111,158,422,973,1395
02511000,SOUTHWESTERN INDIAN POLYTECH INST       ,NM,87184-0000,Public       ,39,45,84,438,495,933
02572003,COMPUTER CAREER CENTER - LAS CRUCES CAMP,NM,88011-8220,Proprietary  ,16,93,109,139,661,800
02622000,SOUTHWEST ACUPUNCTURE COLLEGE           ,NM,87505-0000,Proprietary  ,0,13,13,4,298,302
03076100,SOUTHWESTERN COLLEGE                    ,NM,87507-0000,Private      ,1,11,12,11,204,215
03206300,MESALANDS COMMUNITY COLLEGE             ,NM,88401-3352,Public       ,9,36,45,188,311,499
03430300,UNIVERSAL THERAPEUTIC MASSAGE INSTITUTE ,NM,87107-4403,Proprietary  ,5,20,25,48,173,221
03678300,PIMA MEDICAL INSTITUTE                  ,NM,87110-4127,Proprietary  ,8,26,34,124,267,391
03944300,MASSAGE THERAPY TRAINING INSTITUTE      ,NM,88007-0000,Proprietary  ,2,5,7,37,83,120
04162400,URBAN ACADEMY                           ,NM,87106-4404,Proprietary  ,9,20,29,79,164,243
04174500,AVEDA INSTITUTE OF NEW MEXICO (THE)     ,NM,87110-3640,Proprietary  ,1,10,11,1,10,11
00223400,ADRIAN COLLEGE                          ,MI,49221-2575,Private      ,22,15,37,2786,357,3143
00223500,ALBION COLLEGE                          ,MI,49224-1831,Private      ,17,4,21,2445,146,2591
00223600,ALMA COLLEGE                            ,MI,48801-1599,Private      ,12,7,19,2331,157,2488
00223700,ALPENA COMMUNITY COLLEGE                ,MI,49707-1495,Public       ,31,96,127,1115,1517,2632
00223800,ANDREWS UNIVERSITY                      ,MI,49104-0750,Private      ,21,53,74,1907,1487,3394
00223900,AQUINAS COLLEGE                         ,MI,49506-1799,Private      ,20,29,49,2623,943,3566
00224000,BAY DE NOC COMMUNITY COLLEGE            ,MI,49829-2524,Public       ,22,108,130,1427,2057,3484
00224100,CALVIN COLLEGE                          ,MI,49546-4388,Private      ,23,25,48,4318,532,4850
00224200,CALVIN THEOLOGICAL SEMINARY             ,MI,49546-4387,Private      ,0,5,5,25,207,232
00224300,CENTRAL MICHIGAN UNIVERSITY             ,MI,48859-0001,Public       ,205,509,714,24264,11500,35764
00224600,CLEARY UNIVERSITY                       ,MI,48105-2659,Private      ,7,86,93,175,1031,1206
00224700,CONCORDIA UNIVERSITY-ANN ARBOR          ,MI,48105-2797,Private      ,6,28,34,628,402,1030
00224800,CRANBROOK ACADEMY OF ART                ,MI,48303-0000,Private      ,0,11,11,45,369,414
00224900,DAVENPORT UNIVERSITY                    ,MI,49503-0000,Private      ,86,802,888,3651,16283,19934
00225100,DELTA COLLEGE                           ,MI,48710-0001,Public       ,146,549,695,7060,10512,17572
00225400,MICHIGAN STATE UNIVERSITY COLLEGE OF LAW,MI,48824-1300,Private      ,12,28,40,613,2202,2815
00225900,EASTERN MICHIGAN UNIVERSITY             ,MI,48197-2214,Public       ,257,549,806,17011,15763,32774
00226000,FERRIS STATE UNIVERSITY                 ,MI,49307-2251,Public       ,152,237,389,13882,8037,21919
00226100,CHARLES STEWART MOTT COMMUNITY CLG      ,MI,48503-2089,Public       ,237,749,986,6471,14054,20525
00226200,KETTERING UNIVERSITY                    ,MI,48504-4898,Private      ,25,32,57,2284,550,2834
00226300,GLEN OAKS COMMUNITY COLLEGE             ,MI,49032-9784,Public       ,16,67,83,676,1295,1971
00226400,GOGEBIC COMMUNITY COLLEGE               ,MI,49938-1365,Public       ,15,21,36,754,811,1565
00226500,GRACE BIBLE COLLEGE                     ,MI,49509-1998,Private      ,4,27,31,304,162,466
00226600,CORNERSTONE UNIVERSITY                  ,MI,49525-5897,Private      ,14,158,172,1893,2205,4098
00226700,GRAND RAPIDS COMMUNITY COLLEGE          ,MI,49503-3295,Public       ,229,826,1055,12180,15249,27429
00226800,GRAND VALLEY STATE UNIVERSITY           ,MI,49401-9403,Public       ,146,283,429,23084,9148,32232
00226900,GREAT LAKES CHRISTIAN COLLEGE           ,MI,48917-1299,Private      ,3,3,6,223,163,386
00227000,HENRY FORD COMMUNITY COLLEGE            ,MI,48128-1495,Public       ,302,850,1152,11553,19262,30815
00227300,HOPE COLLEGE                            ,MI,49423-3607,Private      ,20,5,25,4242,246,4488
00227400,JACKSON COMMUNITY COLLEGE               ,MI,49201-8399,Public       ,85,427,512,4290,8063,12353
00227500,KALAMAZOO COLLEGE                       ,MI,49006-3295,Private      ,12,11,23,1938,260,2198
00227600,KELLOGG COMMUNITY COLLEGE               ,MI,49017-3397,Public       ,57,322,379,2827,6655,9482
00227700,LAKE MICHIGAN COLLEGE                   ,MI,49022-1899,Public       ,64,271,335,2037,4216,6253
00227800,LANSING COMMUNITY COLLEGE               ,MI,48933-1293,Public       ,170,747,917,10472,18207,28679
00227900,LAWRENCE TECHNOLOGICAL UNIVERSITY       ,MI,48075-1058,Private      ,24,93,117,1961,2067,4028
00228200,MADONNA UNIVERSITY                      ,MI,48150-1173,Private      ,11,130,141,1805,3903,5708
00228400,MARYGROVE COLLEGE                       ,MI,48221-2599,Private      ,21,188,209,1028,3993,5021
00228800,ROCHESTER COLLEGE                       ,MI,48307-2764,Private      ,12,39,51,799,937,1736
00228801,ROCHESTER COLLEGE - MACOMB COMMUNITY COL,MI,48038-1139,Private      ,0,0,0,428,560,988
00228802,ROCHESTER COLLEGE - MOTT COMMUNITY COLLE,MI,48503-2089,Private      ,0,0,0,230,361,591
00228803,ROCHESTER COLLEGE  - SPECS HOWARD       ,MI,48075-3953,Private      ,0,0,0,43,78,121
00229000,MICHIGAN STATE UNIVERSITY               ,MI,48824-1113,Public       ,409,504,913,37245,14787,52032
00229200,MICHIGAN TECHNOLOGICAL UNIV             ,MI,49931-1295,Public       ,30,23,53,5958,1231,7189
00229300,LAKE SUPERIOR STATE UNIVERSITY          ,MI,49783-1691,Public       ,19,38,57,2729,1125,3854
00229400,MONROE COUNTY COMMUNITY CLG             ,MI,48161-9746,Public       ,65,194,259,1989,3258,5247
00229500,MONTCALM COMMUNITY COLLEGE              ,MI,48885-9723,Public       ,23,130,153,1082,2139,3221
00229700,MUSKEGON COMMUNITY COLLEGE              ,MI,49442-1432,Public       ,73,270,343,3441,4660,8101
00229900,NORTH CENTRAL MICHIGAN COLLEGE          ,MI,49770-8740,Public       ,21,85,106,1189,2242,3431
00230100,NORTHERN MICHIGAN UNIVERSITY            ,MI,49855-5316,Public       ,91,108,199,8252,3354,11606
00230200,NORTHWESTERN MICHIGAN COLLEGE           ,MI,49686-3061,Public       ,64,189,253,2936,4065,7001
00230301,OAKLAND COMMUNITY COLLEGE - ORCHARD RIDG,MI,48334-4579,Public       ,95,290,385,3462,5613,9075
00230302,OAKLAND COMMUNITY COLLEGE - ROYAL OAK CA,MI,48067-3898,Public       ,123,418,541,3896,7373,11269
00230303,OAKLAND COMMUNITY COLLEGE - SOUTHFIELD C,MI,48075-4793,Public       ,99,357,456,3070,7406,10476
00230304,OAKLAND COMMUNITY COLLEGE - AUBURN HILLS,MI,48323-2845,Public       ,139,419,558,4451,7520,11971
00230305,OAKLAND COMMUNITY COLLEGE - HIGHLAND LAK,MI,48327-4187,Public       ,78,211,289,2548,4405,6953
00230700,OAKLAND UNIVERSITY                      ,MI,48309-4401,Public       ,203,393,596,14712,10697,25409
00230800,OLIVET COLLEGE                          ,MI,49076-9902,Private      ,7,16,23,1556,384,1940
00231000,ST. CLAIR COUNTY COMMUNITY COLLEGE      ,MI,48061-0000,Public       ,65,225,290,2517,4121,6638
00231100,KUYPER COLLEGE                          ,MI,49525-9749,Private      ,3,6,9,417,189,606
00231300,SACRED HEART MAJOR SEMINARY             ,MI,48206-1799,Private      ,0,8,8,40,185,225
00231400,SAGINAW VALLEY STATE UNIV               ,MI,48710-0001,Public       ,80,165,245,10005,4781,14786
00231500,SCHOOLCRAFT COLLEGE                     ,MI,48152-2696,Public       ,163,531,694,6885,10669,17554
00231600,SIENA HEIGHTS UNIVERSITY                ,MI,49221-1796,Private      ,19,100,119,1327,2162,3489
00231700,SOUTHWESTERN MICHIGAN COLLEGE           ,MI,49047-9793,Public       ,33,153,186,1947,2904,4851
00231800,SPRING ARBOR UNIVERSITY                 ,MI,49283-9984,Private      ,24,243,267,2451,3901,6352
00232200,FINLANDIA UNIVERSITY                    ,MI,49930-1882,Private      ,6,7,13,690,340,1030
00232300,UNIVERSITY OF DETROIT MERCY             ,MI,48221-3038,Private      ,45,157,202,3509,4720,8229
00232303,UNIV OF DETROIT MERCY - LAW SCHOOL      ,MI,48226-0000,Private      ,0,12,12,33,955,988
00232330,UNIV OF DETROIT MERCY - DENTAL SCHOOL   ,MI,48208-2576,Private      ,2,11,13,89,472,561
00232500,UNIVERSITY OF MICHIGAN - ANN ARBOR      ,MI,48109-1316,Public       ,296,337,633,29025,13594,42619
00232501,UNIVERSITY OF MICHIGAN-MEDICAL SCH      ,MI,48109-0000,Public       ,12,9,21,288,1151,1439
00232503,UNIVERSITY OF MICHIGAN LAW SCHOOL       ,MI,48109-0000,Public       ,2,15,17,102,3097,3199
00232600,UNIVERSITY OF MICHIGAN-DEARBORN         ,MI,48128-2406,Public       ,113,216,329,6129,6061,12190
00232700,UNIVERSITY OF MICHIGAN-FLINT            ,MI,48502-1950,Public       ,81,280,361,4953,6911,11864
00232800,WASHTENAW COMMUNITY COLLEGE             ,MI,48106-0000,Public       ,161,537,698,5890,10084,15974
00232900,WAYNE STATE UNIVERSITY                  ,MI,48202-0000,Public       ,332,850,1182,19863,25061,44924
00232901,WAYNE STATE UNIV SCH OF MEDICINE        ,MI,48201-3359,Public       ,11,24,35,467,1926,2393
00232902,WAYNE STATE UNIVERSITY - LAW SCHOOL     ,MI,48202-3424,Public       ,7,35,42,231,1574,1805
00233000,WESTERN MICHIGAN UNIVERSITY             ,MI,49008-3899,Public       ,190,315,505,21501,10618,32119
00233100,WESTERN THEOLOGICAL SEMINARY            ,MI,49423-0000,Private      ,0,2,2,8,158,166
00407100,WALSH COLLEGE OF ACCT & BUS ADMN        ,MI,48007-7006,Private      ,11,198,209,338,3208,3546
00407200,NORTHWOOD UNIVERSITY                    ,MI,48640-2398,Private      ,12,75,87,2314,2102,4416
00467300,BAKER COLLEGE - FLINT                   ,MI,48507-5508,Private      ,176,739,915,3213,9976,13189
00467301,BAKER COLLEGE OF CADILLAC               ,MI,49601-0000,Private      ,34,234,268,604,2463,3067
00467302,BAKER COLLEGE OF CLINTON TOWNSHIP       ,MI,48035-0000,Private      ,119,481,600,2477,7213,9690
00467303,BAKER COLLEGE OF MUSKEGON               ,MI,49442-0000,Private      ,96,440,536,3131,6425,9556
00467304,BAKER COLLEGE OF OWOSSO                 ,MI,48867-0000,Private      ,59,210,269,1998,3139,5137
00467305,BAKER COLLEGE OF AUBURN HILLS           ,MI,48326-0000,Private      ,58,393,451,1441,5366,6807
00467306,BAKER COLLEGE OF PORT HURON             ,MI,48060-0000,Private      ,29,158,187,710,2185,2895
00467309,BAKER COLLEGE OF JACKSON                ,MI,49202-0000,Private      ,54,291,345,1044,3826,4870
00467311,BAKER COLLEGE-CASS CITY                 ,MI,48726-0000,Private      ,10,53,63,263,702,965
00467313,BAKER COLLEGE - GRADUATE ON-LINE        ,MI,48507-0000,Private      ,29,525,554,502,7351,7853
00467317,BAKER COLLEGE-ALLEN PARK                ,MI,48101-0000,Private      ,52,328,380,1440,4926,6366
00469200,DORSEY SCHOOL OF BUSINESS               ,MI,48195-2334,Proprietary  ,10,63,73,127,645,772
00469201,DORSEY SCHOOL OF BUSINESS               ,MI,48184-0000,Proprietary  ,9,42,51,101,521,622
00469202,DORSEY SCHOOL OF BUSINESS               ,MI,48071-0000,Proprietary  ,12,30,42,84,428,512
00469204,DORSEY SCHOOL OF BUSINESS               ,MI,48066-0000,Proprietary  ,18,92,110,149,769,918
00469205,DORSEY BUSINESS SCHOOL - FARMINGTON HILL,MI,48334-3385,Proprietary  ,5,34,39,55,359,414
00469206,DORSEY BUSINESS SCHOOL - ROSEVILLE CULIN,MI,48066-4555,Proprietary  ,13,74,87,111,543,654
00469207,DORSEY BUSINESS SCHOOL - WATERFORD/PONTI,MI,48341-1037,Proprietary  ,18,93,111,100,549,649
00469208,DORSEY BUSINESS SCHOOL - SAGINAW CAMPUS ,MI,48603-5201,Proprietary  ,16,64,80,54,228,282
00491003,KAPLAN CAREER INSTITUTE - DEARBORN      ,MI,48228-0000,Proprietary  ,6,89,95,193,1152,1345
00676800,MID MICHIGAN COMMUNITY COLLEGE          ,MI,48625-9447,Public       ,49,192,241,2929,4216,7145
00677100,COLLEGE FOR CREATIVE STUDIES            ,MI,48202-4034,Private      ,23,35,58,1607,797,2404
00694900,KALAMAZOO VALLEY COMMUNITY COLLEGE      ,MI,49003-4070,Public       ,158,504,662,6324,9493,15817
00717100,KIRTLAND COMMUNITY COLLEGE              ,MI,48653-0000,Public       ,29,77,106,1115,2127,3242
00732991,ITT TECHNICAL INSTITUTE                 ,MI,49519-1851,Proprietary  ,138,442,580,1351,4295,5646
00761700,CARNEGIE INSTITUTE                      ,MI,48083-1159,Proprietary  ,13,44,57,86,587,673
00795000,WEST SHORE COMMUNITY COLLEGE            ,MI,49454-0000,Public       ,11,35,46,699,1112,1811
00817800,EMPIRE BEAUTY SCHOOL                    ,MI,49525-2440,Proprietary  ,15,65,80,209,663,872
00817801,EMPIRE BEAUTY SCHOOL - KALAMAZOO CAMPUS ,MI,49024-2694,Proprietary  ,0,0,0,29,48,77
00832903,ITT TECHNICAL INSTITUTE                 ,MI,48083-2008,Proprietary  ,0,0,0,0,1,1
00890600,MACOMB COMMUNITY COLLEGE                ,MI,48088-3896,Public       ,364,911,1275,12454,17195,29649
00894600,PORT HURON COSMETOLOGY COLLEGE          ,MI,48329-1618,Proprietary  ,7,13,20,30,64,94
00923000,WAYNE COUNTY COMMUNITY CLG-DISTRICT     ,MI,48226-3095,Public       ,437,1629,2066,11019,33733,44752
00973200,VIRGINIA FARRELL BEAUTY SCHOOL          ,MI,48080-1448,Proprietary  ,4,7,11,45,92,137
00973400,VIRGINIA FARRELL BEAUTY SCHOOL          ,MI,48220-1739,Proprietary  ,3,19,22,85,230,315
00982800,EVEREST INSTITUTE                       ,MI,48033-4400,Proprietary  ,38,170,208,425,2153,2578
00982801,EVEREST INSTITUTE- DEARBORN             ,MI,48124-1927,Proprietary  ,38,164,202,394,1539,1933
00982803,EVEREST INSTITUTE - DETROIT             ,MI,48207-4291,Proprietary  ,22,153,175,335,1255,1590
01047000,KALAMAZOO BEAUTY ACADEMY                ,MI,49002-5220,Proprietary  ,2,5,7,32,79,111
01082700,DAVID PRESSLEY PROF SCH OF COSMTLGY     ,MI,48067-3219,Proprietary  ,19,31,50,138,237,375
01109800,FLINT INSTITUTE OF BARBERING            ,MI,48504-4395,Proprietary  ,4,14,18,49,156,205
01164600,VIRGINIA FARRELL BEAUTY SCHOOL          ,MI,48185-3091,Proprietary  ,4,14,18,46,164,210
01229100,WRIGHT BEAUTY ACADEMY                   ,MI,49015-2696,Proprietary  ,5,14,19,35,129,164
01262700,THOMAS M. COOLEY LAW SCHOOL             ,MI,48901-1586,Private      ,3,117,120,27,5409,5436
01321800,M J MURPHY BTY CLG MT PLEASANT          ,MI,48858-2502,Proprietary  ,3,9,12,43,110,153
02060300,MICHIGAN INSTITUTE OF AERONAUTICS       ,MI,48188-2533,Proprietary  ,32,128,160,492,1078,1570
02068700,FISER'S COLLEGE OF COSMETOLOGY          ,MI,49221-0000,Proprietary  ,2,4,6,31,71,102
02099700,ROSS MEDICAL EDUCATION CENTER           ,MI,48532-0000,Proprietary  ,34,272,306,312,1794,2106
02099701,ROSS MEDICAL EDUCATION CENTER-SAGINAW   ,MI,48603-5227,Proprietary  ,2,9,11,37,171,208
02099702,ROSS MEDICAL EDUCATION CENTER-PORT HURON,MI,48060-1958,Proprietary  ,2,5,7,21,94,115
02099703,ROSS MEDICAL EDUCATION CENTER-ROOSEVELT ,MI,49441-4156,Proprietary  ,0,3,3,3,33,36
02100400,EVEREST INSTITUTE                       ,MI,49525-2301,Proprietary  ,22,180,202,264,1388,1652
02100401,EVEREST INSTITUTE - KALAMAZOO           ,MI,49009-3307,Proprietary  ,29,168,197,241,1124,1365
02125600,MICHIGAN COLLEGE OF BEAUTY              ,MI,48083-0000,Proprietary  ,12,33,45,167,431,598
02152103,ACADEMY OF COURT REPORTING & TECHNOLOGY ,MI,48017-1495,Proprietary  ,3,10,13,53,389,442
02158600,MR BELA'S SCHOOL OF COSMETOLOGY         ,MI,48092-4637,Proprietary  ,2,13,15,46,133,179
02160303,INTERNATIONAL ACADEMY OF DESIGN AND TECH,MI,48083-2160,Proprietary  ,34,57,91,816,1121,1937
02180100,ROSS MEDICAL EDUCATION CENTER           ,MI,48092-0000,Proprietary  ,27,192,219,237,1074,1311
02180105,ROSS MEDICAL EDUCATION CENTER-REDFORD   ,MI,48239-1260,Proprietary  ,0,9,9,20,134,154
02198900,MICHIGAN SCHOOL OF PROFESSIONAL PSYCHOLO,MI,48334-4512,Private      ,1,4,5,16,223,239
02209200,TAYLORTOWN SCHOOL OF BEAUTY             ,MI,48180-0000,Proprietary  ,1,9,10,23,118,141
02237800,SPECS HOWARD SCHOOL OF MEDIA ARTS       ,MI,48075-0000,Proprietary  ,43,110,153,652,1044,1696
02285700,BAYSHIRE BEAUTY ACADEMY                 ,MI,48708-5614,Proprietary  ,7,17,24,42,167,209
02289801,KAPLAN INSTITUTE - DETROIT CAMPUS       ,MI,48202-0000,Proprietary  ,18,106,124,290,1340,1630
02324500,MICHIGAN COLLEGE OF BEAUTY              ,MI,48161-3901,Proprietary  ,5,17,22,79,214,293
02339700,ROSS MEDICAL EDUCATION CENTER           ,MI,48116-0000,Proprietary  ,39,227,266,276,1349,1625
02339701,ROSS MEDICAL EDUCATION CENTER-ANN ARBOR ,MI,48108-1411,Proprietary  ,2,7,9,27,154,181
02339703,ROSS MEDICAL EDUCATION CENTER - DAVISON ,MI,48423-1751,Proprietary  ,1,10,11,18,87,105
02361500,MICHIGAN BARBER COLLEGE                 ,MI,48204-2244,Private      ,13,55,68,157,505,662
02363800,YESHIVA GEDOLAH OF GREATER DETROIT      ,MI,48237-0000,Private      ,9,0,9,35,7,42
02491000,WEST MI COLG OF BARBERING & BEAUTY      ,MI,49008-0000,Proprietary  ,2,20,22,33,138,171
02498300,VIRGINIA FARRELL BEAUTY SCHOOL          ,MI,48154-0000,Proprietary  ,1,17,18,39,147,186
02533600,ROSS MEDICAL EDUCATION CENTER           ,MI,48917-2108,Proprietary  ,26,188,214,262,1335,1597
02533601,ROSS MEDICAL EDUCATION CENTER - GRAND RA,MI,49546-2430,Proprietary  ,0,11,11,43,239,282
02588200,DOUGLAS J AVEDA INSTITUTE               ,MI,48823-4351,Proprietary  ,39,75,114,559,767,1326
02588201,DOUGLAS J AVEDA INSTITUTE - ANN ARBOR   ,MI,48104-2211,Proprietary  ,5,13,18,85,164,249
02595700,HILLSDALE BEAUTY COLLEGE                ,MI,49242-0000,Proprietary  ,1,1,2,68,48,116
02618400,MICHIGAN CAREER & TECHNICAL INST        ,MI,49080-9254,Public       ,37,16,53,340,179,519
03005700,DETROIT BUSINESS INST. DOWNRIVER        ,MI,48193-6761,Proprietary  ,5,27,32,61,226,287
03028500,LAWTON SCHOOL                           ,MI,48075-0000,Proprietary  ,10,52,62,66,315,381
03066600,BAY MILLS COMMUNITY COLLEGE             ,MI,49715-9750,Public       ,8,35,43,211,567,778
03075200,TWIN CITY BEAUTY COLLEGE                ,MI,49085-3305,Proprietary  ,7,52,59,85,306,391
03075201,TWIN CITY BEAUTY COLLEGE - TRAVERSE CITY,MI,49686-5119,Proprietary  ,2,1,3,21,24,45
03090000,SHARP'S ACADEMY OF HAIRSTYLING INC.     ,MI,48433-0000,Proprietary  ,2,5,7,18,60,78
03109700,HOUGHTON LAKE INST OF COSMETOLOGY       ,MI,48629-0669,Proprietary  ,1,5,6,13,33,46
03110300,THE SCHOOL OF CREATIVE HAIR DESIGN      ,MI,49036-1139,Proprietary  ,3,11,14,22,69,91
03124000,NORTHWESTERN TECHNOLOGICAL INST         ,MI,48075-2412,Proprietary  ,16,87,103,134,656,790
03135300,MICHIGAN THEOLOGICAL SEMINARY           ,MI,48170-4399,Private      ,0,0,0,2,34,36
03284300,MICHIGAN JEWISH INSTITUTE               ,MI,48237-0000,Private      ,5,3,8,1214,398,1612
03490300,PAUL MITCHELL THE SCHOOL ESCANABA       ,MI,49829-0000,Proprietary  ,29,47,76,287,353,640
03588300,IRENE'S MYOMASSOLOGY INSTITUTE          ,MI,48033-2404,Proprietary  ,7,49,56,99,513,612
03704300,BLUE WATER COLLEGE OF COSMETOLOGY       ,MI,48040-0000,Proprietary  ,7,18,25,38,75,113
03772300,SAGINAW CHIPPEWA TRIBAL COLLEGE         ,MI,48858-0000,Public       ,0,7,7,26,71,97
03815300,IN SESSION-ARTS OF COSMETOLOGY BEAU     ,MI,48609-0000,Proprietary  ,5,17,22,40,148,188
03907300,PAUL MITCHELL THE SCHOOL GREAT LAKES    ,MI,48060-0000,Proprietary  ,6,16,22,87,124,211
03915300,CAREER QUEST LEARNING CENTER            ,MI,48910-4732,Proprietary  ,23,254,277,164,1344,1508
03968300,LAKEWOOD SCHOOL OF THERAPEUTIC MASSAGE  ,MI,48060-0000,Proprietary  ,3,8,11,17,70,87
03976500,ANN ARBOR INSTITUTE OF MASSAGE THERAPY  ,MI,48103-0000,Proprietary  ,2,16,18,56,174,230
04002400,ECUMENICAL THEOLOGICAL SEMINARY         ,MI,48201-3035,Private      ,0,6,6,6,153,159
04006300,NUVO COLLEGE OF COSMETOLOGY             ,MI,49441-3822,Proprietary  ,3,7,10,26,102,128
04014300,P&A SCHOLARS BEAUTY SCHOOL              ,MI,48204-0000,Proprietary  ,10,43,53,170,421,591
04094300,ROBERT B. MILLER COLLEGE (THE)          ,MI,49017-3306,Private      ,2,13,15,77,499,576
04121100,GALLERY COLLEGE OF BEAUTY (THE)         ,MI,48036-3591,Proprietary  ,6,44,50,107,355,462
04136300,FOCUS:  HOPE INFORMATION TECHNOLOGIES CE,MI,48238-2949,Private      ,1,23,24,85,349,434
04138400,SCHOOL OF DESIGNING ARTS                ,MI,49015-2853,Proprietary  ,3,6,9,57,84,141
04139600,REGAL BEAUTY SCHOOL                     ,MI,48150-4013,Proprietary  ,0,0,0,3,6,9
04140900,INTERNATIONAL COSMETOLOGY ACADEMY       ,MI,49508-1308,Proprietary  ,3,27,30,43,232,275
04141100,FRENCH ACADEMY OF COSMETOLOGY           ,MI,49456-3207,Proprietary  ,2,8,10,32,101,133
04158400,L'ESPRIT ACADEMY                        ,MI,48150-0000,Proprietary  ,6,17,23,71,121,192
04159300,MARKETTI ACADEMY OF COSMETOLOGY         ,MI,48329-3506,Proprietary  ,4,21,25,44,147,191
04163300,COMPASS FILM ACADEMY                    ,MI,49504-5296,Private      ,1,4,5,14,38,52
04164700,KEWEENAW BAY OJIBWA COMMUNITY COLLEGE   ,MI,49908-0000,Public       ,2,29,31,2,30,32
04169300,SCHOLARS COSMETOLOGY UNIVERSITY         ,MI,48108-0000,Proprietary  ,1,7,8,1,7,8
04183300,ABCOTT INSTITUTE                        ,MI,48075-5227,Proprietary  ,3,21,24,3,21,24
04184700,PROTEGE ACADEMY                         ,MI,48823-8660,Proprietary  ,5,12,17,8,21,29
00233200,ANOKA-RAMSEY CC-CAMBRIDGE/COONRAPID     ,MN,55433-3499,Public       ,81,238,319,3830,5395,9225
00233400,AUGSBURG COLLEGE                        ,MN,55454-1351,Private      ,29,102,131,2943,2558,5501
00233500,RIVERLAND COMMUNITY COLLEGE             ,MN,55912-1473,Public       ,20,88,108,1151,2112,3263
00233600,BEMIDJI STATE UNIVERSITY                ,MN,56601-2699,Public       ,35,98,133,3616,2243,5859
00233700,BETHANY LUTHERAN COLLEGE INC            ,MN,56001-6163,Private      ,2,4,6,719,91,810
00233900,CENTRAL LAKES COLG-BRAINERD/STAPLES     ,MN,56401-3900,Public       ,32,121,153,1637,2492,4129
00234000,CARLETON COLLEGE                        ,MN,55057-4001,Private      ,25,2,27,3008,65,3073
00234100,COLLEGE OF ST BENEDICT                  ,MN,56374-2099,Private      ,11,3,14,2106,71,2177
00234200,ST. CATHERINE UNIVERSITY                ,MN,55105-1789,Private      ,32,133,165,2667,3647,6314
00234300,COLLEGE OF ST SCHOLASTICA               ,MN,55811-4199,Private      ,12,123,135,2505,2044,4549
00234500,UNIVERSITY OF ST THOMAS                 ,MN,55105-1096,Private      ,46,215,261,6634,4365,10999
00234600,CONCORDIA COLLEGE-MOORHEAD              ,MN,56562-0001,Private      ,13,10,23,3240,212,3452
00234700,"CONCORDIA UNIVERSITY, ST PAUL, MN       ",MN,55104-5494,Private      ,10,190,200,1329,2449,3778
00235000,VERMILION COMMUNITY COLLEGE             ,MN,55731-1996,Public       ,6,2,8,549,219,768
00235300,GUSTAVUS ADOLPHUS COLLEGE               ,MN,56082-1498,Private      ,20,4,24,2963,65,3028
00235400,HAMLINE UNIVERSITY                      ,MN,55104-1284,Private      ,19,194,213,2619,3628,6247
00235500,HIBBING COMMUNITY COLLEGE               ,MN,55746-3300,Public       ,21,61,82,736,1191,1927
00235600,ITASCA COMMUNITY COLLEGE                ,MN,55744-3397,Public       ,18,36,54,824,734,1558
00235700,LUTHER SEMINARY                         ,MN,55108-0000,Private      ,0,6,6,2,462,464
00235800,MACALESTER COLLEGE                      ,MN,55105-1899,Private      ,14,7,21,3358,163,3521
00236000,"MINNESOTA STATE UNIVERSITY, MANKATO     ",MN,56002-0000,Public       ,158,167,325,11476,4701,16177
00236100,MARTIN LUTHER COLLEGE                   ,MN,56073-3965,Private      ,3,4,7,678,87,765
00236200,MINNEAPOLIS COMM AND TECH COLLEGE       ,MN,55403-1779,Public       ,117,447,564,4638,11515,16153
00236500,MINNEAPOLIS COLLEGE OF ART & DESIGN     ,MN,55404-4343,Private      ,6,16,22,994,471,1465
00236600,CROSSROADS COLLEGE                      ,MN,55902-2382,Private      ,3,1,4,125,99,224
00236700,MINNESOTA STATE UNIVERSITY MOORHEAD     ,MN,56563-0001,Public       ,38,99,137,5351,2594,7945
00236900,NORTH CENTRAL UNIVERSITY                ,MN,55404-1391,Private      ,11,14,25,1310,491,1801
00237000,NORTH HENNEPIN COMMUNITY COLLEGE        ,MN,55445-2299,Public       ,85,275,360,3089,5632,8721
00237100,NORTHWESTERN COLLEGE                    ,MN,55113-1598,Private      ,15,52,67,2338,1009,3347
00237300,ROCHESTER COMMUNITY/TECH COLLEGE        ,MN,55904-4999,Public       ,61,150,211,2939,3832,6771
00237500,SOUTHWEST MINNESOTA STATE UNIVERSITY    ,MN,56258-1598,Public       ,14,51,65,2152,1155,3307
00237700,ST CLOUD STATE UNIVERSITY               ,MN,56301-4498,Public       ,87,201,288,11042,5703,16745
00237900,SAINT JOHNS UNIVERSITY                  ,MN,56321-0000,Private      ,12,7,19,1954,111,2065
00238000,SAINT MARY'S UNIVERSITY                 ,MN,55987-1399,Private      ,14,175,189,1708,3413,5121
00238200,ST OLAF COLLEGE                         ,MN,55057-1098,Private      ,23,4,27,3854,98,3952
00238300,CROWN COLLEGE                           ,MN,55375-9001,Private      ,11,63,74,781,744,1525
00238500,NORTHLAND COMMUNITY & TECHNICAL CLG     ,MN,56701-2598,Public       ,31,91,122,1600,2331,3931
00238600,UNITED THEOLGCL SEMINRY TWIN CITIES     ,MN,55112-0000,Private      ,0,4,4,2,123,125
00238800,"UNIVERSITY OF MINNESOTA, DULUTH         ",MN,55812-2496,Public       ,89,67,156,10336,2210,12546
00238900,"UNIVERSITY OF MINNESOTA, MORRIS         ",MN,56267-2113,Public       ,13,12,25,2084,274,2358
00239100,WILLIAM MITCHELL COLLEGE OF LAW         ,MN,55105-0000,Private      ,1,10,11,6,1378,1384
00239300,MINNESOTA STATE COLLEGE-SE TECH         ,MN,55987-0409,Public       ,30,99,129,976,1850,2826
00239400,WINONA STATE UNIVERSITY                 ,MN,55987-5838,Public       ,52,51,103,7226,1616,8842
00396900,UNIVERSITY OF MINNESOTA-TWIN CITIES     ,MN,55455-0422,Public       ,275,656,931,32465,21320,53785
00400900,MESABI RANGE CMNTY & TECH COLLEGE       ,MN,55792-0000,Public       ,17,40,57,623,819,1442
00405708,NATIONAL AMERICAN UNIVERSITY            ,MN,55113-0000,Proprietary  ,3,27,30,49,351,400
00405715,NATIONAL AMERICAN UNIVERSITY - BLOOMINGT,MN,55425-5550,Proprietary  ,0,26,26,47,388,435
00406900,UNIVERSITY OF MINNESOTA-CROOKSTON       ,MN,56716-5001,Public       ,13,31,44,1128,614,1742
00438600,VETERAN'S MEDICAL CTR- SCH RAD TECH     ,MN,55417-2399,Public       ,0,1,1,3,26,29
00464100,DUNWOODY COLLEGE OF TECHNOLOGY          ,MN,55403-1192,Private      ,27,91,118,929,1777,2706
00464200,GLOBE UNIVERSITY                        ,MN,55125-5408,Proprietary  ,137,618,755,1856,6221,8077
00464500,MINNEAPOLIS BUSINESS COLLEGE            ,MN,55113-4036,Proprietary  ,1,10,11,491,243,734
00464600,MINNESOTA SCHOOL OF BUSINESS            ,MN,55423-0000,Proprietary  ,120,559,679,2383,8001,10384
00525200,RIDGEWATER COLLEGE                      ,MN,56201-2098,Public       ,38,92,130,2135,2366,4501
00526300,MINNESOTA WEST CMNTY & TECH COLG        ,MN,56241-1096,Public       ,17,92,109,982,1875,2857
00553300,"SAINT PAUL COLLEGE, COMMUNITY/TECHNICAL ",MN,55102-1800,Public       ,56,324,380,2676,7547,10223
00553400,SAINT CLOUD TECHNICAL COLLEGE AND COMMUN,MN,56303-1240,Public       ,55,114,169,2775,3202,5977
00553500,PINE TECHNICAL COLLEGE                  ,MN,55063-2198,Public       ,9,29,38,308,937,1245
00553700,SOUTH CENTRAL COLLEGE                   ,MN,56003-0000,Public       ,33,90,123,1829,2330,4159
00554100,MINNESOTA STATE COMMUNITY AND TECHNICAL ,MN,56573-1405,Public       ,64,171,235,2576,4071,6647
00554400,ALEXANDRIA TECHNICAL COLLEGE            ,MN,56308-3799,Public       ,15,34,49,1340,1090,2430
00575700,LAKE SUPERIOR COLLEGE                   ,MN,55811-3399,Public       ,34,120,154,2083,3154,5237
00575900,NORTHWEST TECHNICAL COLLEGE - BEMIDJI   ,MN,56601-4907,Public       ,10,75,85,446,1147,1593
00677500,RAINY RIVER COMMUNITY COLLEGE           ,MN,56649-2187,Public       ,4,3,7,143,139,282
00735000,ANOKA-HENNEPIN TECHNICAL COLLEGE        ,MN,55303-1590,Public       ,34,146,180,937,2848,3785
00735100,BROWN COLLEGE                           ,MN,55120-1004,Proprietary  ,41,112,153,858,1367,2225
00746200,COLLEGE OF VISUAL ARTS                  ,MN,55102-2199,Private      ,3,3,6,281,87,368
00795400,NORMANDALE COMMUNITY COLLEGE            ,MN,55431-4399,Public       ,106,245,351,4794,5844,10638
00826700,NORTHWEST TECHNICAL INSTITUTE           ,MN,55121-5001,Proprietary  ,3,3,6,117,84,201
00869400,RASMUSSEN COLLEGE - ST. CLOUD           ,MN,56301-3713,Proprietary  ,34,166,200,383,1991,2374
00869401,RASMUSSEN COLLEGE - BROOKLYN PARK       ,MN,55445-1512,Proprietary  ,24,167,191,401,1950,2351
00869406,RASMUSSEN COLLEGE - EAGAN               ,MN,55122-1346,Proprietary  ,25,163,188,349,1698,2047
00869407,RASMUSSEN COLLEGE - EDEN PRAIRIE        ,MN,55344-7220,Proprietary  ,84,711,795,608,5212,5820
00869409,RASMUSSEN COLLEGE - MANKATO             ,MN,56001-8658,Proprietary  ,16,111,127,369,1337,1706
00869412,RASMUSSEN COLLEGE - LAKE ELMO           ,MN,55042-8624,Proprietary  ,10,134,144,241,1268,1509
00869416,RASMUSSEN COLLEGE - MOORHEAD            ,MN,56560-4513,Proprietary  ,21,124,145,190,805,995
00869417,RASMUSSEN COLLEGE - BLAINE              ,MN,55014-0000,Proprietary  ,17,93,110,112,462,574
00905800,BETHEL UNIVERSITY                       ,MN,55112-6999,Private      ,14,176,190,3187,2503,5690
00960000,COSMETOLOGY CAREERS UNLTD-DULUTH        ,MN,55802-2031,Proprietary  ,2,15,17,26,67,93
00962108,HERZING UNIVERSITY - MINNEAPOLIS        ,MN,55428-3568,Proprietary  ,8,45,53,198,636,834
00972200,EMPIRE BEAUTY SCHOOL                    ,MN,55119-7003,Proprietary  ,13,34,47,112,362,474
00974000,INVER HILLS COMMUNITY COLLEGE           ,MN,55076-3224,Public       ,68,235,303,2488,4080,6568
00983100,MODEL COLLEGE OF HAIR DESIGN            ,MN,56301-4280,Proprietary  ,7,20,27,120,111,231
00987000,EMPIRE BEAUTY SCHOOL                    ,MN,55420-2919,Proprietary  ,16,45,61,125,404,529
00989200,"DULUTH BUSINESS UNIV, INC.              ",MN,55807-0000,Proprietary  ,5,41,46,163,594,757
00999200,OAK HILLS CHRISTIAN COLLEGE             ,MN,56601-0000,Private      ,1,2,3,126,64,190
01024800,ART INSTITUTES INTL MINNESOTA           ,MN,55402-3137,Proprietary  ,50,130,180,1837,1641,3478
01035602,EVEREST INSTITUTE - EAGAN               ,MN,55121-1696,Proprietary  ,25,153,178,240,1202,1442
01037400,METROPOLITAN STATE UNIVERSITY           ,MN,55106-5000,Public       ,25,282,307,1760,7922,9682
01040200,DAKOTA COUNTY TECHNICAL COLLEGE         ,MN,55068-2999,Public       ,47,134,181,1258,2445,3703
01049000,REGENCY BEAUTY INSTITUTE                ,MN,55428-0000,Proprietary  ,405,1080,1485,4031,9104,13135
01049100,HENNEPIN TECHNICAL COLLEGE              ,MN,55445-2399,Public       ,56,285,341,2181,6041,8222
01054600,CENTURY COLLEGE                         ,MN,55110-1894,Public       ,114,348,462,5181,7841,13022
01173200,"MAYO CLINIC, COLLEGE OF MEDICINE        ",MN,55905-0000,Private      ,0,3,3,44,379,423
01173201,MAYO SCHOOL OF HEALTH-RELATED SCIEN     ,MN,55905-0000,Private      ,2,6,8,50,157,207
01173206,MAYO GRAD SCHOOL                        ,MN,55901-0000,Private      ,0,3,3,4,41,45
01173207,MAYO MEDICAL SCHOOL                     ,MN,55901-0000,Private      ,2,1,3,15,166,181
01232800,NORTHWESTERN HEALTH SCIENCES UNIV       ,MN,55431-1599,Private      ,4,23,27,72,900,972
02050300,ACADEMY COLLEGE                         ,MN,55420-1554,Proprietary  ,5,26,31,51,294,345
02097300,HASTINGS BEAUTY SCHOOL                  ,MN,55033-1205,Proprietary  ,4,5,9,25,42,67
02123200,AVEDA INSTITUTE                         ,MN,55414-0000,Proprietary  ,25,49,74,434,508,942
02159800,COSMETOLOGY CAREERS UNLTD - HIBBING     ,MN,55746-0000,Proprietary  ,1,5,6,12,53,65
02160901,"SALON PROFESSIONAL ACADEMY, THE - THE SA",MN,55428-4928,Proprietary  ,3,9,12,39,81,120
02238100,MINNESOTA SCHOOL OF COSMETOLOGY         ,MN,55125-0000,Proprietary  ,12,27,39,154,244,398
02260500,SUMMIT ACAD OPPORTUNITIES IND CTR       ,MN,55405-0000,Private      ,12,89,101,64,477,541
02263102,ANTHEM COLLEGE - ST. LOUIS PARK         ,MN,55416-2467,Proprietary  ,0,10,10,21,99,120
02504200,WALDEN UNIVERSITY                       ,MN,55401-2511,Proprietary  ,14,5113,5127,184,51267,51451
02514100,AMERICAN INDIAN OPPORTUNITIES CTR       ,MN,55404-0000,Private      ,1,34,35,11,218,229
02543600,INGENUE                                 ,MN,56560-0000,Proprietary  ,0,0,0,6,5,11
02551200,EAST METRO OIC                          ,MN,55104-3435,Private      ,0,0,0,2,3,5
03001200,MCNALLY SMITH COLLEGE OF MUSIC          ,MN,55101-2220,Proprietary  ,14,11,25,809,286,1095
03051900,ALFRED ADLER GRADUATE SCHOOL            ,MN,55305-0000,Private      ,0,30,30,4,310,314
03096400,LEECH LAKE TRIBAL COLLEGE               ,MN,56633-0000,Public       ,3,14,17,47,301,348
03129100,FOND DU LAC TRIBAL & COMMUNITY CLG      ,MN,55720-2984,Public       ,22,51,73,554,1073,1627
03267300,CAPELLA UNIVERSITY                      ,MN,55402-3389,Proprietary  ,17,3075,3092,175,56309,56484
03833300,AMERICAN ACADEMY OF ACUPUNCTURE AND ORIE,MN,55113-0000,Proprietary  ,0,8,8,1,121,122
03921400,WHITE EARTH TRIBAL AND COMMUNITY COLLEGE,MN,56557-0478,Private      ,2,11,13,26,139,165
04044300,HAZELDEN GRADUATE SCHOOL OF ADDICTION ST,MN,55012-0000,Private      ,0,15,15,4,164,168
04130200,INST. OF PRODUCTION AND RECORDING       ,MN,55401-1315,Proprietary  ,21,23,44,591,424,1015
04148800,CENTERPOINT MASSAGE & SHIATSU THERAPY SC,MN,55414-4525,Proprietary  ,0,11,11,29,155,184
04157600,NOVA ACADEMY OF COSMETOLOGY             ,MN,55906-4103,Proprietary  ,4,17,21,18,57,75
04160000,ALLURE SCHOOL OF COSMETOLOGY            ,MN,55066-2086,Proprietary  ,1,2,3,23,52,75
04160500,AVALON SCHOOL OF COSMETOLOGY            ,MN,56187-1930,Proprietary  ,0,5,5,19,35,54
04175600,PARK AVENUE SCHOOL OF COSMETOLOGY       ,MN,56470-3361,Proprietary  ,1,11,12,2,19,21
00239600,ALCORN STATE UNIVERSITY                 ,MS,39096-7500,Public       ,154,163,317,3834,3785,7619
00239700,BELHAVEN UNIVERSITY                     ,MS,39202-1789,Private      ,34,259,293,1601,4213,5814
00239800,BLUE MOUNTAIN COLLEGE                   ,MS,38610-9370,Private      ,12,21,33,521,415,936
00240100,COAHOMA COMMUNITY COLLEGE               ,MS,38614-9799,Public       ,120,250,370,1831,3074,4905
00240200,COPIAH-LINCOLN COMMUNITY COLLEGE        ,MS,39191-0649,Public       ,119,170,289,2445,3086,5531
00240300,DELTA STATE UNIVERSITY                  ,MS,38733-0000,Public       ,99,136,235,3213,3397,6610
00240400,EAST CENTRAL COMMUNITY COLLEGE          ,MS,39327-0129,Public       ,66,119,185,1869,2580,4449
00240500,EAST MISSISSIPPI COMM COLLEGE           ,MS,39358-0000,Public       ,144,211,355,3206,4731,7937
00240700,HINDS COMMUNITY COLLEGE                 ,MS,39154-9799,Public       ,320,679,999,8064,13509,21573
00240800,HOLMES COMMUNITY COLLEGE                ,MS,39079-0000,Public       ,210,403,613,4238,6965,11203
00240900,ITAWAMBA COMMUNITY COLLEGE              ,MS,38843-1099,Public       ,133,367,500,4393,7269,11662
00241000,JACKSON STATE UNIVERSITY                ,MS,39217-0001,Public       ,225,366,591,8602,10355,18957
00241100,JONES COUNTY JUNIOR COLLEGE             ,MS,39437-3999,Public       ,168,213,381,4050,3552,7602
00241300,MERIDIAN COMMUNITY COLLEGE              ,MS,39307-5890,Public       ,86,233,319,2463,3518,5981
00241400,MILLSAPS COLLEGE                        ,MS,39201-0000,Private      ,26,28,54,1482,650,2132
00241500,MISSISSIPPI COLLEGE                     ,MS,39058-0001,Private      ,52,121,173,2828,3534,6362
00241501,MISSISSIPPI COLLEGE - SCHOOL OF LAW     ,MS,39201-1391,Private      ,6,21,27,80,944,1024
00241502,MISSISSIPPI COLLEGE - RANKIN CAMPUS     ,MS,39042-0000,Private      ,0,0,0,65,184,249
00241600,MISSISSIPPI DELTA CMTY COLLEGE          ,MS,38761-0000,Public       ,111,156,267,2351,2798,5149
00241700,MISSISSIPPI GULF CST CLG-PERKINSTON     ,MS,39573-0000,Public       ,67,68,135,2118,1346,3464
00241701,MISSISSIPPI GULF CST CLG-JEFF DAVIS     ,MS,39507-0000,Public       ,81,243,324,2037,4227,6264
00241702,MISSISSIPPI GULF CST CLG-JACKSON CN     ,MS,39553-0000,Public       ,75,176,251,1863,3063,4926
00242200,MISSISSIPPI UNIV FOR WOMEN              ,MS,39701-5818,Public       ,47,104,151,1755,2586,4341
00242300,MISSISSIPPI STATE UNIVERSITY            ,MS,39762-9698,Public       ,334,263,597,14695,8046,22741
00242400,MISSISSIPPI VALLEY STATE UNIVERSITY     ,MS,38941-1400,Public       ,124,129,253,3268,3558,6826
00242600,NORTHEAST MS CMNTY COLLEGE              ,MS,38829-1731,Public       ,64,117,181,2930,2841,5771
00242700,NORTHWEST MISSISSIPPI COMMUNITY CLG     ,MS,38668-1703,Public       ,168,286,454,5803,6272,12075
00243000,PEARL RIVER COMMUNITY COLLEGE           ,MS,39470-2201,Public       ,145,257,402,3455,4600,8055
00243300,RUST COLLEGE                            ,MS,38635-2328,Private      ,32,29,61,1360,675,2035
00243500,SOUTHEASTERN BAPTIST COLLEGE            ,MS,39440-0000,Private      ,2,4,6,24,104,128
00243600,SOUTHWEST MISSISSIPPI CMNTY CLG         ,MS,39666-8099,Public       ,65,72,137,1583,1702,3285
00243900,TOUGALOO COLLEGE                        ,MS,39174-9799,Private      ,31,27,58,1691,745,2436
00244000,UNIVERSITY OF MISSISSIPPI               ,MS,38677-1848,Public       ,299,258,557,12541,7479,20020
00244001,UNIVERSITY OF MISSISSIPPI - MED CTR     ,MS,39216-0000,Public       ,25,65,90,615,2124,2739
00244100,UNIVERSITY OF SOUTHERN MISSISSIPPI      ,MS,39406-0001,Public       ,310,485,795,11913,10830,22743
00244700,WILLIAM CAREY UNIVERSITY                ,MS,39401-5499,Private      ,76,236,312,1602,4225,5827
01146100,WESLEY COLLEGE                          ,MS,39073-1070,Private      ,0,0,0,31,62,93
01289101,ANTONELLI COLLEGE - JACKSON             ,MS,39232-9514,Proprietary  ,12,133,145,206,1609,1815
01289102,ANTONELLI COLLEGE - HATTIESBURG         ,MS,39401-3056,Proprietary  ,18,88,106,200,928,1128
02074900,CHRIS' BEAUTY COLLEGE                   ,MS,39501-0000,Proprietary  ,2,20,22,43,165,208
02160500,NORTH MISSISSIPPI MED CTR MED TECH      ,MS,38801-0000,Private      ,3,3,6,34,149,183
02235900,ACADEMY OF HAIR DESIGN #4               ,MS,39208-0000,Proprietary  ,2,20,22,51,172,223
02244300,ACADEMY OF HAIR DESIGN #1               ,MS,38901-0000,Proprietary  ,11,43,54,116,298,414
02249900,DELTA BEAUTY COLLEGE                    ,MS,38701-0000,Proprietary  ,2,13,15,31,124,155
02251600,ACADEMY OF HAIR DESIGN #6               ,MS,39401-7581,Proprietary  ,13,32,45,101,312,413
02251700,FOSTER'S COSMETOLOGY COLLEGE            ,MS,38663-0000,Proprietary  ,2,7,9,18,40,58
02302800,MISSISSIPPI COLLEGE OF BEAUTY CULT      ,MS,39440-0000,Proprietary  ,6,14,20,35,124,159
02320800,MAGNOLIA COLLEGE OF COSMETOLOGY         ,MS,39206-0000,Proprietary  ,7,25,32,103,302,405
02361200,MAGNOLIA BIBLE COLLEGE                  ,MS,39090-0000,Private      ,0,0,0,2,6,8
02502100,CREATIONS COLLEGE OF COSMETOLOGY        ,MS,38803-0000,Proprietary  ,1,7,8,37,151,188
02516200,WESLEY BIBLICAL SEMINARY                ,MS,39206-0000,Private      ,0,4,4,7,134,141
02586000,J & J HAIR DESIGN COLLEGE               ,MS,39051-3716,Proprietary  ,4,21,25,36,185,221
03004000,FINAL TOUCH BEAUTY SCHOOL               ,MS,39307-2934,Proprietary  ,3,10,13,25,101,126
03010401,CRESCENT CITY BARTENDING SCHOOL         ,MS,39501-0000,Proprietary  ,0,0,0,10,57,67
03010404,CRESCENT CITY SCHOOL OF GAMING & BARTEND,MS,38664-1903,Proprietary  ,0,0,0,6,35,41
03010603,VIRGINIA COLLEGE - JACKSON              ,MS,39206-5602,Proprietary  ,23,126,149,278,1726,2004
03010610,VIRGINIA COLLEGE - BILOXI               ,MS,39532-2124,Proprietary  ,10,117,127,132,1020,1152
03263300,TRAXLER'S SCHOOL OF HAIR                ,MS,39212-2529,Proprietary  ,2,16,18,22,122,144
03464300,ACADEMY OF HAIR DESIGN                  ,MS,39562-0000,Proprietary  ,4,15,19,22,108,130
03525300,BLUE CLIFF COLLEGE                      ,MS,39507-0000,Proprietary  ,14,97,111,196,741,937
03848300,DAY SPA CAREER COLLEGE                  ,MS,39564-0000,Proprietary  ,0,8,8,35,124,159
03963300,HEALING TOUCH SCHOOL OF MASSAGE THERAPY ,MS,39402-1300,Proprietary  ,1,5,6,25,96,121
04131300,CORINTH ACADEMY OF COSMETOLOGY          ,MS,38834-4813,Proprietary  ,2,5,7,32,81,113
04137400,MISSISSIPPI SCHOOL OF THERAPEUTIC MASSAG,MS,39216-5023,Proprietary  ,1,2,3,31,102,133
04140200,"MISSISSIPPI INSTITUTE OF AESTHETICS, NAI",MS,39056-5628,Proprietary  ,2,9,11,39,111,150
00252600,CARROLL COLLEGE                         ,MT,59625-0002,Private      ,16,15,31,1824,301,2125
00252700,UNIVERSITY OF GREAT FALLS               ,MT,59405-4996,Private      ,10,48,58,674,742,1416
00252800,MILES COMMUNITY COLLEGE                 ,MT,59301-4799,Public       ,7,11,18,360,282,642
00252900,DAWSON COMMUNITY COLLEGE                ,MT,59330-1405,Public       ,4,10,14,327,178,505
00253000,MONTANA STATE UNIVERSITY - BILLINGS     ,MT,59101-0298,Public       ,54,153,207,2862,4134,6996
00253100,MONTANA TECH OF THE UNIV OF MONTANA     ,MT,59701-8997,Public       ,32,50,82,1586,1550,3136
00253200,MONTANA STATE UNIVERSITY - BOZEMAN      ,MT,59717-0001,Public       ,153,194,347,10250,5020,15270
00253300,MONTANA STATE UNIVERSITY-NORTHERN       ,MT,59501-3148,Public       ,13,37,50,882,930,1812
00253400,ROCKY MOUNTAIN COLLEGE                  ,MT,59102-1796,Private      ,12,9,21,1286,421,1707
00253600,UNIVERSITY OF MONTANA (THE)             ,MT,59812-0001,Public       ,167,338,505,9444,9010,18454
00253700,UNIVERSITY OF MONTANA WESTERN (THE)     ,MT,59725-3598,Public       ,7,24,31,1257,683,1940
00677700,FLATHEAD VALLEY COMMUNITY COLLEGE       ,MT,59901-2699,Public       ,42,153,195,1050,2090,3140
00757000,HELENA COLLEGE OF TECHNOLOGY            ,MT,59601-3098,Public       ,10,60,70,528,1286,1814
00790000,BUTTE ACADEMY OF BEAUTY CULTURE         ,MT,59701-9197,Proprietary  ,4,6,10,35,54,89
00894700,"DAHL'S COLLEGE OF BEAUTY,INC            ",MT,59401-3731,Proprietary  ,3,10,13,13,67,80
00931400,MSU COLLEGE OF TECH-GREAT FALLS         ,MT,59405-4907,Public       ,19,115,134,723,1913,2636
02143400,SALISH KOOTENAI COLLEGE                 ,MT,59855-0000,Public       ,25,102,127,390,1204,1594
02286600,LITTLE BIG HORN COLLEGE                 ,MT,59022-0000,Public       ,15,47,62,140,347,487
02343000,FT PECK COMMUNITY COLLEGE               ,MT,59255-0000,Public       ,9,48,57,98,334,432
02510600,BLACKFEET COMMUNITY COLLEGE             ,MT,59417-0000,Private      ,29,88,117,198,498,696
02517500,FORT BELKNAP COLLEGE                    ,MT,59526-0000,Public       ,9,27,36,71,181,252
02545200,CHIEF DULL KNIFE COLLEGE                ,MT,59043-0098,Public       ,15,33,48,73,202,275
02610900,STONE CHILD COLLEGE                     ,MT,59521-9796,Public       ,13,71,84,67,266,333
02621300,ACADEMY OF COSMETOLOGY                  ,MT,59715-3544,Proprietary  ,1,6,7,36,60,96
03205300,MODERN BEAUTY SCHOOL                    ,MT,59801-8386,Proprietary  ,6,21,27,53,136,189
03763400,"ACADEMY OF NAIL, SKIN & HAIR            ",MT,59101-0000,Proprietary  ,6,23,29,60,168,228
03778300,HEALTH WORKS INSTITUTE                  ,MT,59715-0000,Proprietary  ,4,18,22,22,86,108
04163700,BITTERROOT SCHOOL OF COSMETOLOGY        ,MT,59840-3118,Proprietary  ,2,4,6,10,41,51
04164100,SALON PROFESSIONAL ACADEMY (THE)        ,MT,59405-0000,Proprietary  ,4,9,13,60,141,201
04187700,CREVIER'S SCHOOL OF COSMETOLOGY         ,MT,59901-4402,Proprietary  ,2,3,5,2,3,5
00253900,CHADRON STATE COLLEGE                   ,NE,69337-2690,Public       ,16,64,80,1637,1205,2842
00254000,COLLEGE OF ST MARY                      ,NE,68106-2606,Private      ,2,37,39,496,1237,1733
00254100,CONCORDIA UNIVERSITY                    ,NE,68434-1594,Private      ,8,58,66,1345,658,2003
00254200,CREIGHTON UNIVERSITY                    ,NE,68178-0001,Private      ,26,117,143,5101,5327,10428
00254300,DANA COLLEGE                            ,NE,68008-9905,Proprietary  ,0,0,0,965,117,1082
00254400,DOANE COLLEGE                           ,NE,68333-2421,Private      ,13,103,116,1640,1204,2844
00254700,GRACE UNIVERSITY                        ,NE,68108-3629,Private      ,2,20,22,350,344,694
00254800,HASTINGS COLLEGE                        ,NE,68901-7621,Private      ,10,7,17,1487,193,1680
00255100,UNIVERSITY OF NEBRASKA AT KEARNEY       ,NE,68849-0001,Public       ,33,96,129,4250,2110,6360
00255300,MIDLAND UNIVERSITY                      ,NE,68025-4254,Private      ,14,14,28,754,314,1068
00255400,UNIVERSITY OF NEBRASKA-OMAHA            ,NE,68182-0001,Public       ,124,277,401,8833,7003,15836
00255500,NEBRASKA WESLEYAN UNIVERSITY            ,NE,68504-2796,Private      ,17,23,40,1964,608,2572
00255700,MID-PLAINS COMM COLLEGE - NORTH PLATTE  ,NE,69101-9420,Public       ,14,58,72,527,783,1310
00255701,MID-PLAINS COMMUNITY COLLEGE - MCCOOK   ,NE,69001-2631,Public       ,7,18,25,267,254,521
00255900,PERU STATE COLLEGE                      ,NE,68421-0010,Public       ,11,50,61,1063,1115,2178
00256000,WESTERN NEBRASKA COMMUNITY COLLEGE      ,NE,69361-1815,Public       ,26,107,133,847,1353,2200
00256300,UNION COLLEGE                           ,NE,68506-4387,Private      ,10,7,17,781,378,1159
00256500,UNIVERSITY OF NEBRASKA-LINCOLN          ,NE,68588-0419,Public       ,147,176,323,15780,5906,21686
00256596,UNIVERSITY OF NEBRASKA - CURTIS         ,NE,69025-9522,Public       ,4,0,4,240,49,289
00256600,WAYNE STATE COLLEGE                     ,NE,68787-1172,Public       ,25,34,59,2994,953,3947
00256700,YORK COLLEGE                            ,NE,68467-2699,Private      ,4,7,11,560,150,710
00443100,MARY LANNING MEM HOSP SCH RAD TECH      ,NE,68901-4497,Private      ,0,0,0,7,10,17
00443600,REGNL WST MEDCL CTR SCHL RAD            ,NE,69361-0000,Private      ,0,1,1,17,12,29
00458608,KAPLAN UNIVERSITY - OMAHA               ,NE,68134-1002,Proprietary  ,15,152,167,258,1921,2179
00458609,KAPLAN UNIVERSITY - LINCOLN             ,NE,68508-2668,Proprietary  ,17,106,123,194,1273,1467
00639900,BRYANLGH COLLEGE OF HEALTH SCIENCES     ,NE,68506-1398,Private      ,2,15,17,350,342,692
00640400,NEBR METHODIST CLG OF NURS ALLD HLTH    ,NE,68114-2852,Private      ,3,14,17,450,810,1260
00689500,UNIVERSITY OF NEBRASKA-MED CTR          ,NE,68198-4265,Public       ,5,62,67,582,2437,3019
00750100,VATTEROTT COLLEGE                       ,NE,68137-1237,Proprietary  ,17,87,104,219,1166,1385
00849200,ALEGENT HEALTH SCHOOLS                  ,NE,68114-2767,Private      ,0,10,10,40,206,246
00952300,BAHNER COLLEGE OF HAIRSTYLING           ,NE,68025-3297,Proprietary  ,4,12,16,41,38,79
00961700,CAPITOL BEAUTY SCHOOL                   ,NE,68144-0000,Proprietary  ,11,21,32,137,172,309
00962109,HERZING UNIVERSITY - OMAHA SCHOOL OF MAS,NE,68127-5002,Proprietary  ,7,15,22,121,312,433
00974300,BELLEVUE UNIVERSITY                     ,NE,68005-0000,Private      ,43,831,874,845,8486,9331
00986200,CLARKSON COLLEGE                        ,NE,68131-2739,Private      ,7,51,58,525,1125,1650
01151900,JOSEPH'S COLLEGE OF BEAUTY/ALL CAMPUSES ,NE,68510-2226,Proprietary  ,12,42,54,173,349,522
01151909,JOSEPH'S COLLEGE OF BEAUTY - OMAHA      ,NE,68131-0000,Proprietary  ,0,0,0,15,30,45
01166700,NORTHEAST COMMUNITY COLLEGE             ,NE,68702-0000,Public       ,36,73,109,1800,1504,3304
01258600,METROPOLITAN COMMUNITY COLLEGE          ,NE,68103-0000,Public       ,291,1109,1400,5275,14005,19280
01297600,NEBRASKA CHRISTIAN COLLEGE              ,NE,68046-4256,Private      ,4,4,8,148,67,215
02079700,COLLEGE OF HAIR DESIGN                  ,NE,68508-0000,Proprietary  ,13,33,46,216,254,470
02099500,CENTRAL COMMUNITY COLLEGE- GI           ,NE,68801-0000,Public       ,23,105,128,718,1606,2324
02099501,CENTRAL COMMUNITY COLLEGE - HASTINGS    ,NE,68902-0000,Public       ,19,48,67,1063,978,2041
02099502,CENTRAL COMMUNITY COLLEGE - COLUMBUS    ,NE,68602-0000,Public       ,13,42,55,552,592,1144
02508300,SOUTHEAST COMM. COLLEGE-ALL CAMPUSES    ,NE,68520-0000,Public       ,202,564,766,5572,7308,12880
02550800,NEBRASKA INDIAN COMMUNITY COLLEGE       ,NE,68039-0000,Public       ,3,13,16,26,97,123
02610500,XENON INTERNATIONAL ACADEMY II          ,NE,68127-3522,Proprietary  ,12,32,44,262,287,549
03164300,THE CREATIVE CENTER                     ,NE,68164-2911,Proprietary  ,0,3,3,175,57,232
03279300,MYOTHERAPY INSTITUTE                    ,NE,68516-3641,Proprietary  ,0,2,2,33,62,95
03323300,LITTLE PRIEST TRIBAL COLLEGE            ,NE,68071-0000,Private      ,3,23,26,38,114,152
03821400,UNIVERSAL COLLEGE OF HEALING ARTS       ,NE,68112-1810,Proprietary  ,0,12,12,15,79,94
00256800,UNIVERSITY OF NEVADA RENO               ,NV,89557-0002,Public       ,265,262,527,9859,6250,16109
00256900,UNIVERSITY OF NEVADA-LAS VEGAS          ,NV,89154-1001,Public       ,413,695,1108,15230,16993,32223
00697700,GREAT BASIN COLLEGE                     ,NV,89801-3348,Public       ,30,109,139,657,1480,2137
00732954,ITT TECHNICAL INSTITUTE                 ,NV,89014-6712,Proprietary  ,42,136,178,423,1223,1646
00736700,MARINELLO SCHOOLS OF BEAUTY             ,NV,89110-3563,Proprietary  ,32,93,125,206,502,708
00737100,MARINELLO SCHOOL OF BEAUTY              ,NV,89502-5982,Proprietary  ,21,60,81,130,296,426
00844103,ANTHEM INSTITUTE - MORRISON UNIVERSITY  ,NV,89521-4826,Proprietary  ,1,30,31,22,197,219
00919200,SIERRA NEVADA COLLEGE                   ,NV,89451-0000,Private      ,14,47,61,475,606,1081
01036200,COLLEGE OF SOUTHERN NEVADA              ,NV,89146-1139,Public       ,704,1619,2323,13327,26550,39877
01036300,WESTERN NEVADA COLLEGE                  ,NV,89703-0000,Public       ,57,229,286,1378,3333,4711
01323200,ACADEMY OF HAIR DESIGN                  ,NV,89146-1617,Proprietary  ,11,42,53,141,310,451
02107700,TRUCKEE MEADOWS COMMUNITY CLG           ,NV,89512-0000,Public       ,204,521,725,4095,8376,12471
02237500,EVEREST COLLEGE                         ,NV,89103-0000,Proprietary  ,74,198,272,781,1889,2670
02338509,NEVADA CAREER INSTITUTE                 ,NV,89121-0000,Proprietary  ,0,0,0,12,48,60
02338512,GLENDALE CAREER COLLEGE - NEVADA CAREER ,NV,89131-3268,Proprietary  ,0,13,13,12,130,142
02616703,SCOTTSDALE CULINARY INSTITUTE - LE CORDO,NV,89144-7047,Proprietary  ,3,25,28,170,385,555
02621500,CAREER COLLEGE OF NORTHERN NEVADA       ,NV,89434-7905,Proprietary  ,15,96,111,173,1013,1186
03030603,UTAH CLG OF MASSAGE THERAPY-NSMT        ,NV,89123-0000,Proprietary  ,31,69,100,215,477,692
03031405,INTERNATIONAL ACADEMY OF DESIGN AND TECH,NV,89074-7750,Proprietary  ,50,87,137,489,847,1336
03043200,KAPLAN COLLEGE                          ,NV,89102-8618,Proprietary  ,46,205,251,505,1981,2486
03076404,BRYMAN SCHOOL OF ARIZONA (THE) - ANTHEM ,NV,89102-4514,Proprietary  ,3,18,21,75,313,388
03088200,CARSON CITY BEAUTY ACADEMY              ,NV,89706-0000,Proprietary  ,3,15,18,44,148,192
03110000,ACADEMY OF HEALING ARTS                 ,NV,89106-4031,Proprietary  ,43,171,214,382,970,1352
03232306,EUPHORIA INSTITUTE - SUMMERLIN          ,NV,89117-8803,Proprietary  ,15,38,53,182,410,592
03232307,EUPHORIA INSTITUTE - GREEN VALLEY       ,NV,89052-4964,Proprietary  ,14,57,71,164,376,540
03232308,EUPHORIA INSTITUTE - ALIANTE            ,NV,89131-1036,Proprietary  ,11,37,48,186,390,576
03787300,EXPERTISE SCHOOL OF BEAUTY              ,NV,89106-2516,Private      ,7,49,56,65,317,382
03838500,NORTHWEST HEALTH CAREERS                ,NV,89128-0255,Proprietary  ,17,72,89,105,468,573
03975300,INSTITUTE OF PROFESSIONAL CAREERS       ,NV,89119-7825,Proprietary  ,4,35,39,70,328,398
04051303,ART INSTITUTE OF PHOENIX (THE) - ART INS,NV,89074-7737,Proprietary  ,90,181,271,1691,2166,3857
04065300,UNIVERSITY OF SOUTHERN NEVADA           ,NV,89014-2333,Private      ,30,74,104,416,1735,2151
04114300,NEVADA STATE COLLEGE                    ,NV,89002-9455,Public       ,61,129,190,1362,2522,3884
04142601,TOURO UNIVERSITY - NEVADA               ,NV,89014-8800,Private      ,4,17,21,18,218,236
04144800,INTERNATIONAL ACADEMY OF STYLE          ,NV,89509-3450,Proprietary  ,8,27,35,50,134,184
04147600,AVEDA INSTITUTE LAS VEGAS               ,NV,89119-6103,Proprietary  ,10,28,38,133,293,426
04171000,ADVANCED TRAINING INSTITUTE             ,NV,89115-7504,Proprietary  ,16,119,135,38,281,319
00257200,COLBY-SAWYER COLLEGE                    ,NH,03257-4648,Private      ,16,1,17,2566,90,2656
00257300,DARTMOUTH COLLEGE                       ,NH,03755-3529,Private      ,82,25,107,10687,1843,12530
00257500,FRANKLIN PIERCE UNIVERSITY              ,NH,03461-0060,Private      ,21,59,80,2489,1285,3774
00257900,NEW ENGLAND COLLEGE                     ,NH,03242-3293,Private      ,16,97,113,1524,1069,2593
00258000,SOUTHERN NEW HAMPSHIRE UNIVERSITY       ,NH,03106-1045,Private      ,53,659,712,4699,6263,10962
00258100,NHTI  - CONCORD'S COMMUNITY COLLEGE     ,NH,03301-7412,Public       ,53,84,137,2935,2080,5015
00258200,MANCHESTER COMMUNITY COLLEGE            ,NH,03102-8518,Public       ,37,104,141,1364,1705,3069
00258202,NEW HAMPSHIRE COMMUNITY TECHNICAL COLLEG,NH,03038-0000,Public       ,0,0,0,31,25,56
00258300,GREAT BAY COMMUNITY COLLEGE             ,NH,03801-0000,Public       ,28,62,90,891,1182,2073
00258600,RIVIER COLLEGE                          ,NH,03060-5086,Private      ,9,47,56,1419,1147,2566
00258700,SAINT ANSELM COLLEGE                    ,NH,03102-1310,Private      ,32,4,36,3878,146,4024
00258900,UNIVERSITY OF NEW HAMPSHIRE             ,NH,03824-2511,Public       ,117,92,209,19686,3724,23410
00259000,KEENE STATE COLLEGE                     ,NH,03431-0000,Public       ,53,18,71,8285,709,8994
00259100,PLYMOUTH STATE UNIVERSITY               ,NH,03264-1595,Public       ,46,65,111,6720,1509,8229
00301004,ANTIOCH UNIVERSITY                      ,NH,03431-0000,Private      ,0,6,6,4,940,944
00472900,HESSER COLLEGE                          ,NH,03103-7230,Proprietary  ,22,88,110,713,1474,2187
00472901,HESSER COLLEGE - NASHUA CAMPUS          ,NH,03063-1286,Proprietary  ,8,56,64,215,791,1006
00472904,HESSER COLLEGE - PORTSMOUTH CAMPUS      ,NH,03801-3245,Proprietary  ,20,81,101,227,776,1003
00472905,HESSER COLLEGE - SALEM CAMPUS           ,NH,03079-2842,Proprietary  ,21,71,92,320,838,1158
00472906,HESSER COLLEGE - CONCORD CAMPUS         ,NH,03301-3415,Proprietary  ,10,44,54,147,653,800
00473100,DANIEL WEBSTER COLLEGE                  ,NH,03063-1300,Proprietary  ,7,8,15,909,240,1149
00473300,CHESTER COLLEGE OF NEW ENGLAND          ,NH,03036-4331,Private      ,4,2,6,222,49,271
00529100,WHITE MOUNTAINS COMMUNITY COLLEGE       ,NH,03570-3799,Public       ,4,29,33,421,793,1214
00702500,LEBANON COLLEGE                         ,NH,03766-0000,Private      ,3,11,14,44,103,147
00755500,LAKES REGION COMMUNITY COLLEGE          ,NH,03246-1326,Public       ,13,35,48,698,744,1442
00756000,RIVER VALLEY COMMUNITY COLLEGE          ,NH,03743-9707,Public       ,7,35,42,362,821,1183
00849300,CONTINENTAL ACADEMIE OF HAIR DESIGN     ,NH,03103-4901,Proprietary  ,1,4,5,22,34,56
00864500,EMPIRE BEAUTY SCHOOL                    ,NH,03220-0000,Proprietary  ,15,31,46,153,171,324
00923600,NASHUA COMMUNITY COLLEGE                ,NH,03063-2052,Public       ,39,61,100,1064,1148,2212
01318900,CONTINENTAL ACADEMIE OF HAIR DESIGN     ,NH,03051-3754,Proprietary  ,2,4,6,61,52,113
02097900,UNIVERSITY NEW HAMPSHIRE SCHOOL OF LAW  ,NH,03301-0000,Private      ,1,3,4,18,841,859
02140400,ST JOSEPH SCH OF PRAC NRSG              ,NH,03060-0000,Private      ,1,14,15,70,184,254
02174800,MICHAEL'S SCHOOL OF HAIR DESIGN & ESTHET,NH,03110-0000,Proprietary  ,6,11,17,113,89,202
02179600,EMPIRE BEAUTY SCHOOL                    ,NH,03878-0000,Proprietary  ,14,22,36,129,163,292
02211600,PORTSMOUTH BTY SCH OF HAIR DESIGN       ,NH,03801-4084,Proprietary  ,1,1,2,23,26,49
02223300,MAGDALEN COLLEGE                        ,NH,03278-4012,Private      ,0,0,0,55,6,61
02245400,KEENE BEAUTY ACADEMY                    ,NH,03431-0000,Proprietary  ,8,4,12,50,40,90
02247000,NEW ENGLAND SCHOOL OF HAIR DESIGN       ,NH,03784-0000,Proprietary  ,3,7,10,31,61,92
03043100,THOMAS MORE COLLEGE OF LIBERAL ARTS     ,NH,03054-4818,Private      ,2,1,3,102,13,115
03101300,GRANITE STATE COLLEGE                   ,NH,03301-6400,Public       ,20,158,178,323,1712,2035
03182300,NEW HAMPSHIRE INSTITUTE OF ART          ,NH,03104-4858,Private      ,2,2,4,689,134,823
03437300,UPPER VALLEY TEACHER TRANING PROGRAM    ,NH,03766-1358,Private      ,0,1,1,2,47,49
03729300,NH INSTITUTE FOR THERAPEUTIC ARTS       ,NH,03051-4906,Proprietary  ,0,2,2,14,63,77
04162200,LAIRD INSTITUTE OF SPA THERAPY          ,NH,03102-5263,Proprietary  ,1,12,13,3,51,54
00267000,BAPTIST BIBLE COLG OF PENNSYLVANIA      ,PA,18411-1297,Private      ,7,22,29,610,285,895
00322800,BRYN ATHYN COLLEGE OF THE NEW CHURCH    ,PA,19009-0717,Private      ,4,2,6,271,29,300
00322900,ALBRIGHT COLLEGE                        ,PA,19612-5234,Private      ,43,86,129,3776,1197,4973
00323000,ALLEGHENY COLLEGE                       ,PA,16335-3902,Private      ,23,4,27,3586,122,3708
00323100,COMM CLG OF ALLEGHENY-ALLEGHENY CMP     ,PA,15212-0000,Public       ,116,351,467,3293,6010,9303
00323101,"COMM CLG OF ALLEGHENY, BOYCE CAMPUS     ",PA,15146-0000,Public       ,39,147,186,1683,2700,4383
00323102,"COMM CLG OF ALLEGHENY, NORTH CAMPUS     ",PA,15237-0000,Public       ,47,140,187,1451,1912,3363
00323103,"COMM CLG OF ALLEGHENY, SOUTH CAMPUS     ",PA,15122-0000,Public       ,40,142,182,2143,2706,4849
00323300,ALVERNIA UNIVERSITY                     ,PA,19607-1799,Private      ,13,75,88,2158,1713,3871
00323500,ARCADIA UNIVERSITY                      ,PA,19038-3295,Private      ,39,55,94,4558,2306,6864
00323700,BRYN MAWR COLLEGE                       ,PA,19010-2899,Private      ,10,21,31,1792,639,2431
00323800,BUCKNELL UNIVERSITY                     ,PA,17837-2122,Private      ,19,1,20,4974,179,5153
00323900,BUCKS COUNTY COMMUNITY COLLEGE          ,PA,18940-1320,Public       ,123,239,362,4159,3992,8151
00324000,BUTLER COUNTY COMMUNITY COLLEGE         ,PA,16001-0000,Public       ,25,117,142,2092,2315,4407
00324100,CABRINI COLLEGE                         ,PA,19087-3698,Private      ,14,142,156,2133,1847,3980
00324200,CARNEGIE MELLON UNIVERSITY              ,PA,15213-3890,Private      ,55,24,79,11356,1732,13088
00324201,CARNEGIE MELLON UNIV- THE HEINZ COLLEGE ,PA,15213-0000,Private      ,2,5,7,207,588,795
00324202,CARNEGIE MELLON- TEPPER SCHOOL OF BUSINE,PA,15213-0000,Private      ,5,9,14,222,603,825
00324300,CEDAR CREST COLLEGE                     ,PA,18104-6196,Private      ,15,38,53,1042,1235,2277
00324400,CHATHAM UNIVERSITY                      ,PA,15232-2826,Private      ,6,45,51,782,1845,2627
00324500,CHESTNUT HILL COLLEGE                   ,PA,19118-2693,Private      ,8,76,84,2063,2103,4166
00324700,MISERICORDIA  UNIVERSITY                ,PA,18612-1008,Private      ,10,31,41,2121,1242,3363
00324900,COMMUNITY COLLEGE OF PHILADELPHIA       ,PA,19130-3991,Public       ,251,929,1180,12301,21124,33425
00325100,CURTIS INSTITUTE OF MUSIC               ,PA,19103-6187,Private      ,1,0,1,294,136,430
00325200,DELAWARE VALLEY COLLEGE                 ,PA,18901-2697,Private      ,18,56,74,2342,528,2870
00325300,DICKINSON COLLEGE                       ,PA,17013-2896,Private      ,18,5,23,3175,169,3344
00325600,DREXEL UNIVERSITY                       ,PA,19104-2875,Private      ,283,694,977,27360,17669,45029
00325800,DUQUESNE UNIVERSITY                     ,PA,15282-0001,Private      ,27,108,135,7936,4587,12523
00325900,EASTERN UNIVERSITY                      ,PA,19087-3696,Private      ,35,129,164,2326,2864,5190
00326200,ELIZABETHTOWN COLLEGE                   ,PA,17022-2298,Private      ,17,40,57,3007,624,3631
00326300,EVANGELICAL SCHOOL OF THEOLOGY          ,PA,17067-0000,Private      ,0,1,1,0,101,101
00326500,FRANKLIN & MARSHALL COLLEGE             ,PA,17604-0000,Private      ,20,3,23,3197,121,3318
00326600,GANNON UNIVERSITY                       ,PA,16541-0001,Private      ,19,35,54,3508,1504,5012
00326700,GENEVA COLLEGE                          ,PA,15010-3599,Private      ,3,52,55,2007,1059,3066
00326800,GETTYSBURG COLLEGE                      ,PA,17325-1486,Private      ,26,2,28,4129,132,4261
00326900,GROVE CITY COLLEGE                      ,PA,16127-0000,Private      ,0,0,0,1832,51,1883
00327000,GWYNEDD-MERCY COLLEGE                   ,PA,19437-0901,Private      ,17,90,107,1817,1614,3431
00327200,HARCUM COLLEGE                          ,PA,19010-3476,Private      ,12,30,42,669,1468,2137
00327300,HARRISBURG AREA COMMUNITY COLLEGE       ,PA,17110-2999,Public       ,225,836,1061,9538,16251,25789
00327400,HAVERFORD COLLEGE                       ,PA,19041-1392,Private      ,11,1,12,2147,64,2211
00327500,HOLY FAMILY UNIVERSITY                  ,PA,19114-2094,Private      ,21,53,74,2165,2073,4238
00327600,IMMACULATA UNIVERSITY                   ,PA,19345-0647,Private      ,16,129,145,1594,2101,3695
00327700,INDIANA UNIVERSITY OF PENNSYLVANIA      ,PA,15705-1097,Public       ,158,116,274,14614,4135,18749
00327900,JUNIATA COLLEGE                         ,PA,16652-2196,Private      ,15,2,17,2321,86,2407
00328000,KEYSTONE COLLEGE                        ,PA,18440-0200,Private      ,15,26,41,1655,965,2620
00328200,KINGS COLLEGE                           ,PA,18711-0801,Private      ,22,41,63,3019,679,3698
00328300,LACKAWANNA COLLEGE                      ,PA,18509-9961,Private      ,39,72,111,1669,1272,2941
00328400,LAFAYETTE COLLEGE                       ,PA,18042-1768,Private      ,21,4,25,3853,107,3960
00328500,LANCASTER BIBLE COLLEGE                 ,PA,17601-5036,Private      ,10,42,52,682,563,1245
00328600,LANCASTER THEOLOGICAL SEMINARY          ,PA,17603-0000,Private      ,0,2,2,1,123,124
00328700,LASALLE UNIVERSITY                      ,PA,19141-1199,Private      ,48,130,178,5868,4025,9893
00328800,LEBANON VALLEY COLLEGE                  ,PA,17003-1400,Private      ,12,10,22,2646,296,2942
00328900,LEHIGH UNIVERSITY                       ,PA,18015-1588,Private      ,52,26,78,7782,1013,8795
00329000,LINCOLN UNIVERSITY                      ,PA,19352-0999,Public       ,62,31,93,3917,1380,5297
00329100,LUTHERAN THEOLOG SEMINARY-GETTYSBRG     ,PA,17325-0000,Private      ,0,1,1,2,149,151
00329200,LUTHERAN THEOLOGICAL SEMINARY           ,PA,19119-0000,Private      ,0,3,3,2,224,226
00329300,LYCOMING COLLEGE                        ,PA,17701-5192,Private      ,14,5,19,2027,173,2200
00329400,MANOR COLLEGE                           ,PA,19046-3399,Private      ,15,31,46,594,631,1225
00329600,MARYWOOD UNIVERSITY                     ,PA,18509-1598,Private      ,14,41,55,2899,1728,4627
00329700,MERCYHURST COLLEGE                      ,PA,16546-0001,Private      ,36,103,139,4137,2026,6163
00329800,MESSIAH COLLEGE                         ,PA,17027-0800,Private      ,12,17,29,3376,295,3671
00330000,MOORE COLLEGE OF ART & DESIGN           ,PA,19103-1179,Private      ,3,28,31,762,318,1080
00330100,MORAVIAN COLLEGE                        ,PA,18018-6650,Private      ,11,7,18,2315,321,2636
00330101,MORAVIAN THEOLOGICAL SEMINARY           ,PA,18018-0000,Private      ,0,1,1,21,78,99
00330200,MOUNT ALOYSIUS COLLEGE                  ,PA,16630-1999,Private      ,11,26,37,1333,889,2222
00330300,CARLOW UNIVERSITY                       ,PA,15213-3165,Private      ,9,61,70,1232,2030,3262
00330400,MUHLENBERG COLLEGE                      ,PA,18104-5586,Private      ,26,16,42,3540,371,3911
00330600,VALLEY FORGE CHRISTIAN COLLEGE          ,PA,19460-2399,Private      ,4,6,10,886,274,1160
00330900,PEIRCE COLLEGE                          ,PA,19102-4699,Private      ,16,145,161,349,2580,2929
00331100,PENNSYLVANIA COLLEGE OF OPTOMETRY       ,PA,19027-1598,Private      ,0,1,1,11,957,968
00331300,WIDENER UNIVERSITY                      ,PA,19013-5792,Private      ,41,56,97,4337,2486,6823
00331302,WIDENER UNIV SCH OF LAW- HARRISBURG     ,PA,17106-9381,Private      ,0,9,9,12,802,814
00331500,BLOOMSBURG UNIVERSITY OF PA             ,PA,17815-1301,Public       ,103,61,164,12553,2237,14790
00331600,CALIFORNIA UNIV OF PENNSYLVANIA         ,PA,15419-1394,Public       ,39,168,207,7360,4812,12172
00331700,CHEYNEY UNIVERSITY OF PENNSYLVANIA      ,PA,19319-0200,Public       ,37,26,63,2414,1051,3465
00331800,CLARION UNIVERSITY OF PENNSYLVANIA      ,PA,16214-1232,Public       ,43,100,143,5703,2703,8406
00332000,EAST STROUDSBURG UNIVERSITY             ,PA,18301-2999,Public       ,84,50,134,8194,1965,10159
00332100,EDINBORO UNIVERSITY OF PENNSYLVANIA     ,PA,16444-0001,Public       ,83,106,189,6756,3852,10608
00332200,KUTZTOWN UNIVERSITY OF PENNSYLVANIA     ,PA,19530-9339,Public       ,83,59,142,11946,2406,14352
00332300,LOCK HAVEN UNIV OF PENNSYLVANIA         ,PA,17745-2439,Public       ,58,57,115,6007,1508,7515
00332400,MANSFIELD UNIVERSITY                    ,PA,16933-1123,Public       ,25,49,74,3253,1248,4501
00332500,MILLERSVILLE UNIVERSITY OF PA           ,PA,17551-1800,Public       ,73,65,138,8914,2510,11424
00332600,SHIPPENSBURG UNIVERSITY                 ,PA,17257-2299,Public       ,60,49,109,8515,1730,10245
00332700,SLIPPERY ROCK UNIVERSITY                ,PA,16057-1326,Public       ,63,80,143,8897,2320,11217
00332800,WEST CHESTER UNIVERSITY                 ,PA,19383-0001,Public       ,186,124,310,16154,4338,20492
00332900,PENN STATE UNIVERSITY                   ,PA,16802-1503,Public       ,1215,978,2193,74103,26507,100610
00335000,UNIVERSITY OF THE ARTS (THE)            ,PA,19102-9493,Private      ,27,27,54,3254,660,3914
00335100,PHILADELPHIA BIBLICAL UNIVERSITY        ,PA,19047-2942,Private      ,3,31,34,954,575,1529
00335200,PHILADELPHIA CLG OSTEOPATHIC MED        ,PA,19131-0000,Private      ,0,27,27,20,2894,2914
00335300,UNIVERSITY OF THE SCIENCES IN PHILADELPH,PA,19104-4495,Private      ,26,13,39,3629,1010,4639
00335400,PHILADELPHIA UNIVERSITY                 ,PA,19144-5497,Private      ,36,50,86,4310,1518,5828
00335600,PITTSBURGH THEOLOGICAL SEMINARY         ,PA,15206-0000,Private      ,0,6,6,1,245,246
00335700,POINT PARK UNIVERSITY                   ,PA,15222-1912,Private      ,23,76,99,3454,2469,5923
00335800,REFORMED PRESBYTERIAN THEOL SEMINAR     ,PA,15208-0000,Private      ,0,2,2,0,33,33
00335900,ROBERT MORRIS UNIVERSITY                ,PA,15108-1189,Private      ,39,86,125,4773,2206,6979
00336000,ROSEMONT COLLEGE                        ,PA,19010-1699,Private      ,9,26,35,743,592,1335
00336200,SETON HILL UNIVERSITY                   ,PA,15601-1599,Private      ,14,30,44,2028,1044,3072
00336400,ST. CHARLES BORROMEO SEMINARY           ,PA,19096-0000,Private      ,1,1,2,50,60,110
00336600,SAINT FRANCIS UNIVERSITY                ,PA,15940-0600,Private      ,11,38,49,2025,713,2738
00336700,SAINT JOSEPH'S UNIVERSITY               ,PA,19131-1395,Private      ,48,237,285,6476,3404,9880
00336800,ST VINCENT COLLEGE                      ,PA,15650-2690,Private      ,10,7,17,2092,338,2430
00336900,SUSQUEHANNA UNIVERSITY                  ,PA,17870-1001,Private      ,18,3,21,3181,137,3318
00337000,SWARTHMORE COLLEGE                      ,PA,19081-1397,Private      ,16,0,16,3870,102,3972
00337100,TEMPLE UNIVERSITY                       ,PA,19122-6003,Private      ,325,321,646,29155,9345,38500
00337101,TEMPLE UNIV - SCHOOL OF LAW             ,PA,19122-0000,Private      ,1,14,15,76,2820,2896
00337102,TEMPLE UNIV - SCHOOL OF MEDICINE        ,PA,19140-0000,Private      ,6,9,15,179,1584,1763
00337103,TEMPLE UNIV - SCHOOL OF DENTISTRY       ,PA,19140-0000,Private      ,0,5,5,37,623,660
00337104,TEMPLE UNIV - AMBLER CAMPUS             ,PA,19002-0000,Private      ,7,9,16,798,750,1548
00337105,TEMPLE UNIV - SCH OF ALLIED HEALTH      ,PA,19140-0000,Private      ,3,19,22,490,622,1112
00337106,TEMPLE UNIV - SCHOOL OF PHARMACY        ,PA,19140-0000,Private      ,4,4,8,239,755,994
00337107,TEMPLE UNIV - TYLER SCHOOL OF ART       ,PA,19122-0000,Private      ,7,8,15,1412,586,1998
00337108,TEMPLE UNIV - GRAD DIV HEALTH SCI       ,PA,19140-0000,Private      ,3,17,20,159,779,938
00337109,TEMPLE UNIV - GRADUATE DIVISION         ,PA,19122-0000,Private      ,2,46,48,156,3458,3614
00337111,TEMPLE UNIV-SCH OF PODIATRIC MED        ,PA,19107-0000,Private      ,1,2,3,8,447,455
00337600,THIEL COLLEGE                           ,PA,16125-2181,Private      ,13,2,15,1579,190,1769
00337800,UNIVERSITY OF PENNSYLVANIA              ,PA,19104-6216,Private      ,169,195,364,18656,13583,32239
00337900,UNIVERSITY OF PITTSBURGH                ,PA,15260-0000,Public       ,186,314,500,27590,11857,39447
00337906,UNIVERSITY OF PITTSBURGH - SCHOOL OF MED,PA,15261-0001,Public       ,7,11,18,245,1277,1522
00337907,UNIVERSITY OF PITTSBURGH - SCHOOL OF DEN,PA,15261-2523,Public       ,3,12,15,282,785,1067
00338400,UNIVERSITY OF SCRANTON                  ,PA,18510-4622,Private      ,41,110,151,6875,1984,8859
00338500,URSINUS COLLEGE                         ,PA,19426-2562,Private      ,13,3,16,3576,109,3685
00338600,VALLEY FORGE MILITARY COLLEGE           ,PA,19087-3695,Private      ,5,2,7,441,53,494
00338800,VILLANOVA UNIVERSITY                    ,PA,19085-1699,Private      ,72,171,243,12148,3002,15150
00338801,VILLANOVA UNIV SCH OF LAW               ,PA,19085-0000,Private      ,0,7,7,36,1872,1908
00338900,WASHINGTON & JEFFERSON COLLEGE          ,PA,15301-4801,Private      ,21,4,25,2695,72,2767
00339100,WAYNESBURG UNIVERSITY                   ,PA,15370-1222,Private      ,13,37,50,2086,984,3070
00339200,WESTMINSTER COLLEGE                     ,PA,16172-0002,Private      ,16,4,20,2651,131,2782
00339300,WESTMINSTER THEOLOGICAL SEMINARY        ,PA,19038-0000,Private      ,0,4,4,2,272,274
00339400,WILKES UNIVERSITY                       ,PA,18766-0998,Private      ,20,94,114,3040,1300,4340
00339500,PENNSYLVANIA COLLEGE OF TECHNOLOGY      ,PA,17701-5779,Public       ,28,36,64,5436,2773,8209
00339600,WILSON COLLEGE                          ,PA,17201-1285,Private      ,5,16,21,470,533,1003
00339900,YORK COLLEGE OF PENNSYLVANIA            ,PA,17405-7199,Private      ,88,48,136,8509,1374,9883
00398600,DESALES UNIVERSITY                      ,PA,18034-9568,Private      ,18,91,109,2339,1375,3714
00398700,LA ROCHE COLLEGE                        ,PA,15237-5898,Private      ,5,21,26,1105,520,1625
00398800,NEUMANN UNIVERSITY                      ,PA,19014-1298,Private      ,33,33,66,3077,1224,4301
00405800,GRATZ COLLEGE                           ,PA,19027-3097,Private      ,0,11,11,8,151,159
00445200,MONTGOMERY COUNTY COMMUNITY COLLEGE     ,PA,19422-6300,Public       ,112,345,457,4873,6016,10889
00488700,BRANDYWINE SCHOOL OF NURSING            ,PA,19320-1536,Proprietary  ,0,0,0,14,30,44
00488900,CAMBRIA-ROWE BUSINESS COLLEGE           ,PA,15902-2494,Proprietary  ,7,34,41,155,370,525
00489000,CENTRAL PENNSYLVANIA COLLEGE            ,PA,17093-0309,Proprietary  ,34,105,139,1369,1495,2864
00489300,DU BOIS BUSINESS COLLEGE                ,PA,15801-2401,Proprietary  ,6,29,35,199,421,620
00489400,ERIE BUSINESS CENTER                    ,PA,16501-1305,Proprietary  ,4,35,39,87,466,553
00489401,ERIE BUSINESS CENTER - NEW CASTLE CAMPUS,PA,16101-3950,Proprietary  ,0,3,3,26,118,144
00489800,MCCANN SCHOOL OF BUSINESS & TECHNOL     ,PA,17901-1335,Proprietary  ,112,470,582,1457,4076,5533
00489807,MCCANN SCHOOL OF BUSINESS & TECHNOLOGY -,PA,17013-3180,Proprietary  ,0,6,6,19,48,67
00489900,MERCY HOSP SCH OF NURSING               ,PA,15219-5166,Private      ,0,6,6,94,220,314
00490100,NEWPORT BUSINESS INSTITUTE              ,PA,15068-3929,Proprietary  ,0,6,6,29,105,134
00490200,PENN COMMERCIAL BUSINESS/TECHNICAL SCHL ,PA,15301-2871,Proprietary  ,13,58,71,272,593,865
00491000,KAPLAN CAREER INSTITUTE                 ,PA,17111-3571,Proprietary  ,20,113,133,377,1210,1587
00491001,THOMPSON INSTITUTE-PHILADEPHIA CAMPUS   ,PA,19104-3386,Proprietary  ,49,141,190,375,1251,1626
00491400,NEWPORT BUSINESS INSTITUTE              ,PA,17701-5855,Proprietary  ,0,12,12,21,194,215
00500701,WEST VIRGINIA CAREER INSTITUTE          ,PA,15456-0000,Proprietary  ,3,19,22,79,210,289
00531000,PITTSBURGH INST OF AERONAUTICS          ,PA,15236-0000,Private      ,13,23,36,278,218,496
00533000,FAYETTE CNTY AREA VOC TECH PRC NRSG     ,PA,15401-0000,Public       ,3,5,8,27,89,116
00533500,CENTRAL PENN INST OF SCI & TECH PNP     ,PA,16823-0000,Public       ,4,12,16,85,200,285
00536500,YORK CO AREA VOC-TECH SCH-PRAC NSG      ,PA,17402-0000,Public       ,0,14,14,32,205,237
00594600,SCHOOL OF RADIOLOGIC TECHNOLOGY AT ST. C,PA,19134-1995,Proprietary  ,1,0,1,28,61,89
00653400,CITIZENS SCHOOL OF NURSING              ,PA,15068-6591,Private      ,1,2,3,111,174,285
00653700,CONEMAUGH VLY MEM HOSP SCH NRSNG        ,PA,15905-4398,Private      ,0,2,2,85,99,184
00653702,CONEMAUGH HOSP- SCH HISTOTECHNOLOGY     ,PA,15905-0000,Private      ,0,2,2,14,11,25
00653704,CONEMAUGH VLY MEM HOSP SCH RAD TECH     ,PA,15905-0000,Private      ,0,3,3,29,21,50
00653706,CONEMAUGH VLY MEM HOSP SCH  MED TECH    ,PA,15905-4398,Private      ,1,2,3,7,16,23
00653900,EPISCOPAL HOSPITAL SCHL OF NURSING      ,PA,19125-1000,Private      ,0,0,0,12,14,26
00655100,ST MARGARET SCHL OF NURSING             ,PA,15238-3205,Private      ,5,18,23,80,236,316
00656000,OHIO VALLEY HOSP SCH OF NURSING         ,PA,15136-1694,Private      ,1,1,2,35,69,104
00656500,READING HOSPITAL SCHOOL OF HEALTH SCIENC,PA,19611-1744,Private      ,1,12,13,209,367,576
00657400,"ST LUKE'S HOSPITAL OF BETHLEHEM, PA     ",PA,18015-1065,Private      ,0,7,7,51,188,239
00657600,SEWICKLEY VALLEY HOSP SCH NRSNG         ,PA,15143-1498,Private      ,1,0,1,47,61,108
00657700,UPMC SHADYSIDE SCHOOL OF NURSING        ,PA,15232-1381,Private      ,5,26,31,163,476,639
00657800,SHARON REGIONAL SCHOOL OF NURSING       ,PA,16146-3395,Private      ,0,1,1,15,62,77
00658200,WASHINGTON HOSP SCH OF NURSING          ,PA,15301-3398,Private      ,1,1,2,62,139,201
00658202,WASHINGTON HOSP SCH OF RAD TECH         ,PA,15301-3398,Private      ,1,1,2,20,26,46
00658300,WESTERN PENN HOSP-SCH OF NURSING        ,PA,15224-1790,Private      ,2,4,6,110,155,265
00680700,COMMUNITY COLLEGE OF BEAVER COUNTY      ,PA,15061-2588,Public       ,28,66,94,1386,1800,3186
00681000,LEHIGH CARBON COMMUNITY COLLEGE         ,PA,18078-2598,Public       ,74,222,296,3252,4266,7518
00681100,LUZERNE COUNTY COMMUNITY COLLEGE        ,PA,18634-3899,Public       ,88,206,294,3714,4271,7985
00708700,ABINGTON MEM HOSP SCHL OF NURSING       ,PA,19090-1284,Private      ,3,11,14,124,372,496
00709100,EVEREST INSTITUTE                       ,PA,15222-1320,Proprietary  ,22,136,158,268,1260,1528
00711000,DELAWARE COUNTY COMMUNITY COLLEGE       ,PA,19063-1094,Public       ,135,328,463,5336,6889,12225
00719100,NORTHAMPTON COMMUNITY COLLEGE           ,PA,18020-7599,Public       ,134,354,488,6128,6469,12597
00732955,ITT TECHNICAL INSTITUTE                 ,PA,19406-1212,Proprietary  ,24,71,95,431,712,1143
00739802,KATHERINE GIBBS-PHILADELPHIA            ,PA,19403-2422,Proprietary  ,0,0,0,0,1,1
00743000,ANTONELLI INST OF ART & PHOTOGRAPHY     ,PA,19038-8242,Proprietary  ,2,1,3,143,21,164
00743600,KAPLAN CAREER INSTITUTE - ICM CAMPUS    ,PA,15222-1977,Proprietary  ,29,124,153,530,1616,2146
00743700,PITTSBURGH TECHNICAL INSTITUTE          ,PA,15071-3205,Proprietary  ,41,73,114,2381,1142,3523
00746900,"HUSSIAN SCHOOL OF ART, INC.             ",PA,19106-0000,Proprietary  ,0,0,0,159,27,186
00747000,"ART INSTITUTE OF PITTSBURGH, THE        ",PA,15219-1328,Proprietary  ,682,4960,5642,7646,36933,44579
00752900,CTR ART TCH BRDYWN CMPS PRC NRS PRG     ,PA,19320-2459,Public       ,3,11,14,41,178,219
00775900,LINCOLN TECHNICAL INSTITUTE             ,PA,18104-3298,Proprietary  ,35,118,153,453,970,1423
00777900,LANSDALE SCHOOL OF BUSINESS             ,PA,19454-4114,Proprietary  ,14,60,74,146,619,765
00778000,NEW CASTLE SCHOOL OF TRADES             ,PA,16143-9721,Proprietary  ,30,95,125,305,904,1209
00778100,CHI INSTITUTE/RETS CAMPUS               ,PA,19008-3516,Proprietary  ,42,116,158,296,813,1109
00783200,LINCOLN TECH INSTITUTE                  ,PA,19136-1595,Proprietary  ,40,65,105,540,630,1170
00783900,TRIANGLE TECH                           ,PA,15214-3897,Proprietary  ,21,36,57,235,389,624
00791200,THADDEUS STEVENS CLG OF TECHNOLOGY      ,PA,17602-0000,Public       ,8,10,18,1100,450,1550
00791600,FRANKLIN CNTY CAREER & TECH CTR-PNP     ,PA,17201-0000,Public       ,1,2,3,26,81,107
00820000,JAMESON MEMORIAL HOSP SCH NURSING       ,PA,16105-2595,Private      ,0,1,1,34,104,138
00826301,AWARD BEAUTY SCHOOL - CHAMBERSBURG BEAUT,PA,17201-2435,Proprietary  ,0,0,0,5,4,9
00835000,ART INSTITUTE OF PHILADELPHIA           ,PA,19103-5198,Proprietary  ,134,220,354,4174,3028,7202
00844100,ANTHEM INSTITUTE                        ,PA,19064-1243,Proprietary  ,62,173,235,323,1046,1369
00856800,VET TECH INSTITUTE                      ,PA,15222-3400,Proprietary  ,0,4,4,334,188,522
00865300,JEFFERSON CO DUBOIS VOC TECH-PR NSG     ,PA,15851-0000,Public       ,0,4,4,34,56,90
00888900,LEHIGH VALLEY COLLEGE                   ,PA,18034-8447,Proprietary  ,0,0,0,30,10,40
00895500,PRUONTOS HAIR DESIGN INSTITUTE          ,PA,16602-0000,Proprietary  ,0,4,4,17,41,58
00915705,WYOMING TECHNICAL INSTITUTE - BLAIRSVILL,PA,15717-8060,Proprietary  ,104,109,213,1957,1650,3607
00918600,DEAN INSTITUTE OF TECHNOLOGY            ,PA,15226-1197,Proprietary  ,7,25,32,53,191,244
00944900,PENNCO TECH                             ,PA,19007-0000,Proprietary  ,69,119,188,400,841,1241
00966400,EMPIRE BEAUTY SCHOOL                    ,PA,18052-5730,Proprietary  ,15,41,56,163,353,516
00966500,EMPIRE BEAUTY SCHOOL                    ,PA,17109-2210,Proprietary  ,13,33,46,109,254,363
00966600,EMPIRE BEAUTY SCHOOL                    ,PA,19605-2803,Proprietary  ,19,48,67,154,353,507
00972100,BRADFORD SCHOOL                         ,PA,15219-2602,Proprietary  ,3,4,7,758,178,936
00972300,ARIA HEALTH SCHOOL OF NURSING           ,PA,19124-2696,Private      ,5,9,14,207,401,608
00978300,GORDON PHILLIPS SCH OF BEAUTY CULT      ,PA,19135-0000,Proprietary  ,27,80,107,248,613,861
00986300,LANCASTER GENERAL COLLEGE OF NURSING AND,PA,17602-4955,Private      ,4,16,20,524,871,1395
01000600,GREATER JOHNSTOWN AREA VOC TECH SCH     ,PA,15904-0000,Public       ,6,31,37,89,348,437
01005500,CRAWFORD CNTY AREA VO-TECH PRAC NUR     ,PA,16335-0000,Public       ,1,1,2,12,36,48
01017600,WESTMORELAND COUNTY COMMUNITY CLG       ,PA,15697-1895,Public       ,98,242,340,3145,4139,7284
01038800,READING AREA COMMUNITY COLLEGE          ,PA,19603-1706,Public       ,73,313,386,2363,4724,7087
01054100,EMPIRE BEAUTY SCHOOL                    ,PA,15146-2229,Proprietary  ,14,51,65,141,335,476
01054200,EMPIRE BEAUTY SCHOOL                    ,PA,18701-0000,Proprietary  ,20,57,77,182,345,527
01054300,EMPIRE BEAUTY SCHOOL                    ,PA,17701-3914,Proprietary  ,12,35,47,115,249,364
01081400,PITTSBURGH INST MORTUARY SCIENCE        ,PA,15206-3706,Private      ,3,15,18,99,259,358
01086000,GREATER ALTOONA CAREER/TECH CENTER      ,PA,16602-0000,Public       ,0,10,10,60,230,290
01096300,GREENE COUNTY VOC-TECH SCHOOL           ,PA,15370-0000,Public       ,1,1,2,11,33,44
01097000,EMPIRE BEAUTY SCHOOL                    ,PA,17042-5209,Proprietary  ,3,11,14,35,91,126
01099800,PENNSYLVANIA INSTITUTE OF TECH          ,PA,19063-4098,Private      ,43,107,150,646,1189,1835
01102000,EMPIRE BEAUTY SCHOOL                    ,PA,17604-4335,Proprietary  ,24,62,86,152,341,493
01102100,EMPIRE BEAUTY SCHOOL                    ,PA,17402-2862,Proprietary  ,20,65,85,162,527,689
01162100,AUTOMOTIVE TRAINING CENTER              ,PA,19341-1310,Proprietary  ,67,45,112,732,398,1130
01162200,WELDER TRAINING & TESTING INST          ,PA,18109-3253,Proprietary  ,7,20,27,39,114,153
01163800,EMPIRE BEAUTY SCHOOL                    ,PA,17876-0000,Proprietary  ,2,19,21,41,73,114
01171500,SCHUYLKILL HEALTH SCHOOL OF NURSING     ,PA,17901-3692,Private      ,1,1,2,51,41,92
01191900,BEAVER FALLS BEAUTY ACADEMY             ,PA,15010-4208,Proprietary  ,3,5,8,30,57,87
01205000,ROSEDALE TECHNICAL INSTITUTE            ,PA,15205-9791,Private      ,14,13,27,243,331,574
01239300,THOMAS JEFF UNIV-CLG ALLIED HEALTH      ,PA,19107-0000,Private      ,2,15,17,295,1147,1442
01239301,THOMAS JEFFERSON UNIVERSITY - JEFFERSON ,PA,19107-5001,Private      ,4,38,42,235,1870,2105
01239303,THOMAS JEFFERSON UNIVERSITY - COLLEGE OF,PA,19107-6731,Private      ,3,21,24,219,1164,1383
01246104,LINCOLN TECHNICAL INSTITUTE             ,PA,19104-0202,Proprietary  ,36,158,194,535,1443,1978
01246105,LINCOLN TECHNICAL INSTITUTE             ,PA,19116-4202,Proprietary  ,24,49,73,285,587,872
01252300,TALMUDICAL YESHIVA OF PHILA             ,PA,19131-1296,Private      ,4,0,4,42,1,43
01260500,EMPIRE BEAUTY SCHOOL                    ,PA,17331-2405,Proprietary  ,9,51,60,94,238,332
01260600,EMPIRE BEAUTY SCHOOL                    ,PA,17901-2505,Proprietary  ,16,71,87,151,556,707
01260700,EMPIRE BEAUTY SCHOOL                    ,PA,16801-5218,Proprietary  ,2,10,12,21,61,82
01292900,SOUTH HILLS BEAUTY ACADEMY              ,PA,15216-2335,Proprietary  ,7,26,33,49,108,157
01301500,GORDON PHILLIPS SCH BEAUTY CULTURE      ,PA,19102-2701,Proprietary  ,43,91,134,355,848,1203
01313400,YESHIVATH BETH MOSHE                    ,PA,18505-2196,Private      ,4,0,4,48,1,49
01321400,ROXBOROUGH MEM HOSP SCH OF NURSING      ,PA,19128-0000,Proprietary  ,0,1,1,66,201,267
01326300,SOUTH HILLS SCHOOL OF BUSINESS & TECHNOL,PA,16801-4516,Proprietary  ,5,7,12,557,631,1188
01326304,SOUTH HILLS SCHOOL OF BUSINESS & TECHNOL,PA,16602-1188,Proprietary  ,0,0,0,10,16,26
02061000,VENUS BEAUTY ACADEMY                    ,PA,19079-0000,Proprietary  ,4,10,14,55,72,127
02068300,DOUGLAS SCHOOL OF BUSINESS              ,PA,15062-0000,Proprietary  ,15,20,35,294,347,641
02090200,TRIANGLE TECH                           ,PA,16502-0000,Proprietary  ,4,22,26,117,216,333
02092500,LAUREL TECHNICAL INSTITUTE              ,PA,16146-0000,Proprietary  ,9,38,47,121,438,559
02092502,BUSINESS INSTITUTE OF PENNSYLVANIA      ,PA,16335-0000,Proprietary  ,1,2,3,16,30,46
02107300,PENNSYLVANIA ACADEMY OF FINE ARTS       ,PA,19102-1424,Private      ,5,7,12,302,287,589
02112200,GREAT LAKES INSTITUTE OF TECHNOLOGY     ,PA,16509-0000,Proprietary  ,25,54,79,301,643,944
02114200,JOHNSON COLLEGE                         ,PA,18508-0000,Private      ,3,5,8,508,314,822
02116001,SANFORD-BROWN INSTITUTE - TREVOSE       ,PA,19053-4700,Proprietary  ,38,161,199,452,1582,2034
02118000,LEVITTOWN BEAUTY ACADEMY LLC            ,PA,19054-1713,Proprietary  ,5,10,15,31,46,77
02119300,PA ACAD OF COSMETOLOGY ARTS & SCI       ,PA,15904-0000,Proprietary  ,6,12,18,62,84,146
02119301,PA ACAD OF COSMTLGY ARTS & SCI          ,PA,15801-0000,Proprietary  ,0,0,0,4,2,6
02120800,"YORKTOWNE BUSINESS INSTITUTE, INC.      ",PA,17404-0000,Proprietary  ,5,33,38,139,355,494
02127400,YORK TECHNICAL INSTITUTE                ,PA,17402-0000,Proprietary  ,73,223,296,1441,2342,3783
02129000,TRIANGLE TECH                           ,PA,15601-0000,Proprietary  ,28,38,66,314,342,656
02129001,TRIANGLE TECH - BUSINESS CAREERS INSTITU,PA,15601-3304,Proprietary  ,0,2,2,8,13,21
02144000,"VISION ACADEMY, THE                     ",PA,18103-0000,Proprietary  ,7,20,27,51,103,154
02149000,EMPIRE BEAUTY SCHOOL                    ,PA,19341-2804,Proprietary  ,21,70,91,132,307,439
02151500,CENTRAL SUSQUEHANNA LPN CENTER          ,PA,17837-8818,Public       ,0,2,2,36,188,224
02152105,ACADEMY OF COURT REPORTING AND TECHNOLOG,PA,15222-1710,Proprietary  ,1,1,2,28,145,173
02153500,OAKBRIDGE ACADEMY OF ARTS               ,PA,15068-0000,Proprietary  ,5,0,5,84,24,108
02158300,JUNIATA-MIFFLIN CO AREA VOC TECH        ,PA,17044-0000,Public       ,6,13,19,28,71,99
02161400,NORTHEASTERN HOSP SCH OF NRSG           ,PA,19134-0000,Private      ,1,9,10,57,215,272
02169600,CLEARFIELD CTY CAREER AND TECH CNTR     ,PA,16830-0000,Public       ,2,10,12,52,132,184
02174400,TRIANGLE TECH                           ,PA,15801-0000,Proprietary  ,20,32,52,336,448,784
02178900,ACADEMY OF HAIR DESIGN                  ,PA,18202-1465,Proprietary  ,7,9,16,22,59,81
02183000,ORLEANS TECHNICAL INSTITUTE             ,PA,19111-0000,Private      ,26,98,124,230,724,954
02192800,WALNUT HILL COLLEGE                     ,PA,19104-0000,Proprietary  ,24,32,56,463,346,809
02202300,SANFORD-BROWN INSTITUTE                 ,PA,15219-1907,Proprietary  ,37,112,149,386,1298,1684
02202301,SANFORD-BROWN INSTITUTE                 ,PA,15146-2141,Proprietary  ,22,92,114,192,787,979
02203900,ERIE INSTITUTE OF TECHNOLOGY            ,PA,16565-1002,Proprietary  ,5,49,54,130,451,581
02206200,"VISION ACADEMY, THE                     ",PA,19002-0000,Proprietary  ,9,33,42,76,147,223
02206300,STROUDSBURG SCHOOL OF COSMETOLOGY       ,PA,18360-0000,Proprietary  ,5,4,9,42,49,91
02212700,LANCASTER SCHOOL OF COSMETOLOGY         ,PA,17602-0000,Proprietary  ,3,23,26,51,147,198
02234200,ACADEMY OF MEDICAL ARTS & BUSINESS      ,PA,17112-0000,Proprietary  ,25,60,85,226,540,766
02251200,SCHUYLKILL COUNTY AREA VOC TECH SCH     ,PA,17931-0000,Public       ,1,8,9,26,104,130
02251202,SCHUYLKILL COUNTY AREA VOC TECH SCH     ,PA,17931-0000,Public       ,1,3,4,20,49,69
02253900,BERKS TECHNICAL INSTITUTE               ,PA,19610-0000,Proprietary  ,34,111,145,692,1100,1792
02255200,PENNSYLVANIA SCHOOL OF BUSINESS         ,PA,18101-1604,Proprietary  ,23,69,92,203,787,990
02269900,PENNSYLVANIA COLLEGE OF ART & DESIGN    ,PA,17603-3528,Private      ,5,2,7,450,90,540
02270500,BUCKS COUNTY SCHOOL OF BEAUTY CULT      ,PA,19053-0000,Proprietary  ,6,9,15,44,47,91
02273400,RECONSTRUCTIONIST RABBINICAL COLLEG     ,PA,19095-0000,Private      ,0,0,0,0,27,27
02276600,HANOVER PUBLIC SCH DIST PRAC NURSG      ,PA,17331-0000,Public       ,2,3,5,17,58,75
02282500,LENAPE SCHOOL OF PRACTICAL NURSING      ,PA,16226-0000,Public       ,1,15,16,38,213,251
02288800,EMPIRE BEAUTY SCHOOL                    ,PA,18974-4508,Proprietary  ,13,64,77,75,215,290
02289500,PACE INSTITUTE                          ,PA,19601-0000,Proprietary  ,8,32,40,87,357,444
02289600,CONSOLIDATED SCHOOL OF BUSINESS         ,PA,17404-0000,Proprietary  ,1,29,30,39,254,293
02289700,ACADEMY OF CREATIVE HAIR DESIGN         ,PA,18702-0000,Proprietary  ,9,30,39,81,186,267
02289800,CHI INSTITUTE - FRANKLIN MILLS          ,PA,19154-0000,Proprietary  ,47,116,163,522,1261,1783
02290400,"ALTOONA BEAUTY SCHOOL, INC              ",PA,16602-0000,Proprietary  ,4,21,25,39,92,131
02292700,LANSDALE SCHOOL OF COSMETOLOGY          ,PA,19446-0000,Proprietary  ,0,10,10,40,45,85
02299300,TRINITY EPISCOPAL SCHOOL MINISTRY       ,PA,15003-0000,Private      ,0,2,2,1,92,93
02301300,PRISM CAREER INSTITUTE                  ,PA,19082-2448,Proprietary  ,28,184,212,164,890,1054
02304400,YTI CAREER INSTITUTE - MECHANICSBURG    ,PA,17055-0000,Proprietary  ,13,55,68,184,377,561
02306200,VENANGO COUNTY AREA VOC TECH SCHOOL     ,PA,16301-0000,Public       ,0,1,1,18,54,72
02310800,LANCASTER COUNTY CAREER & TECH CTR      ,PA,17584-0000,Public       ,6,41,47,158,548,706
02323000,BIBLICAL THEOLOGICAL SEMINARY           ,PA,19440-2421,Private      ,0,5,5,0,76,76
02330300,LEBANON CO CAREER & TECHNOLOGY CTR      ,PA,17042-0000,Public       ,2,6,8,37,151,188
02330600,PENNSYLVANIA GUNSMITH SCHOOL            ,PA,15202-0000,Proprietary  ,2,4,6,60,86,146
02350100,WESTERN AREA CAREER & TECHNOLOGY CT     ,PA,15317-0000,Public       ,0,4,4,20,98,118
02350200,INDIANA COUNTY TECH CTR SCH PR NSG      ,PA,15701-1465,Public       ,1,7,8,38,141,179
02353100,NORTHERN TIER CAREER CENTER             ,PA,18848-0000,Public       ,0,0,0,18,78,96
02362300,MERCER COUNTY AREA VOC TECH SCHOOL      ,PA,16137-0000,Public       ,0,1,1,13,105,118
02492500,DELAWARE VLY ACAD MED DNTL ASSTS        ,PA,19114-0000,Proprietary  ,6,13,19,37,96,133
02492600,EASTERN CTR ARTS AND TECH PR NSG        ,PA,19090-0000,Public       ,3,14,17,26,165,191
02495500,ALL-STATE CAREER SCHOOL                 ,PA,19029-0000,Proprietary  ,43,248,291,297,1229,1526
02529800,WILKES BARRE AREA CAREER AND TECHNICAL C,PA,18705-0000,Public       ,6,25,31,57,242,299
02536600,COMMONWEALTH TECH INSTIT @ HIRAM G      ,PA,15905-0000,Public       ,16,9,25,264,135,399
02544300,BUTLER BEAUTY SCHOOL                    ,PA,16001-0000,Proprietary  ,11,20,31,64,129,193
02545000,LAWRENCE COUNTY CAREER AND TECHNICAL CEN,PA,16101-0000,Public       ,3,5,8,18,103,121
02546200,LAUREL BUSINESS INSTITUTE               ,PA,15401-0877,Proprietary  ,10,29,39,196,339,535
02550000,CLARION CO AREA VOC-TECH PRAC NRSG      ,PA,16254-4637,Public       ,0,1,1,16,87,103
02554500,HAZLETON AREA CAREER CENTER PRACTICAL NU,PA,18201-0000,Public       ,1,2,3,27,82,109
02557800,ART INSTITUTE OF YORK (THE) - PENNSYLVAN,PA,17402-9012,Proprietary  ,22,22,44,841,375,1216
02566400,ALBERT EINSTEIN MED CTR DEPT DNTL       ,PA,19141-3098,Private      ,2,1,3,16,48,64
02574800,PENNSYLVANIA INSTITUTE OF TAXIDERMY     ,PA,15931-0000,Proprietary  ,2,3,5,13,35,48
02609500,CAREER TRAINING ACADEMY                 ,PA,15068-6308,Proprietary  ,7,29,36,81,289,370
02609501,CAREER TRAINING ACADEMY                 ,PA,15146-0000,Proprietary  ,0,2,2,8,27,35
02616100,JEAN MADELINE ED CTR FOR COSM           ,PA,19147-1542,Proprietary  ,24,35,59,363,350,713
03006800,LE CORDON BLEU INSTITUTE OF CULINARY ART,PA,15222-3511,Proprietary  ,26,24,50,665,719,1384
03010800,TRI-STATE BUSINESS INSTITUTE            ,PA,16506-1013,Proprietary  ,92,350,442,1094,3211,4305
03011500,FORTIS INSTITUTE                        ,PA,18702-0000,Proprietary  ,18,31,49,200,388,588
03011600,FORTIS INSTITUTE                        ,PA,18509-2903,Proprietary  ,19,62,81,179,485,664
03029900,CONSOLIDATED SCHOOL OF BUSINESS         ,PA,17603-2389,Proprietary  ,1,15,16,57,220,277
03031600,DPT BUSINESS SCHOOL                     ,PA,19116-3961,Proprietary  ,9,90,99,99,560,659
03031601,DPT BUSINESS SCHOOL                     ,PA,19106-0000,Proprietary  ,16,51,67,101,276,377
03067000,ANTONELLI MEDICAL & PROF INST           ,PA,19464-9244,Proprietary  ,5,12,17,32,99,131
03072400,ALL-STATE CAREER SCHOOL                 ,PA,15122-0000,Proprietary  ,15,75,90,56,349,405
03072600,DCI CAREER INSTITUTE                    ,PA,15061-2307,Proprietary  ,11,28,39,43,196,239
03081900,YTI CAREER INSTITUTE - ALTOONA          ,PA,16602-4457,Proprietary  ,11,41,52,188,404,592
03090800,LAKE ERIE COLL OF OSTEOPATHIC MED       ,PA,16509-0000,Private      ,0,11,11,79,3270,3349
03098600,CAREER TECH CTR OF LACKAWANNA CNTY      ,PA,18508-0000,Public       ,0,11,11,45,175,220
03101400,FORBES ROAD CAREER & TECHNOLOGY CTR     ,PA,15146-1550,Public       ,0,0,0,7,14,21
03101500,BIDWELL TRAINING CENTER                 ,PA,15233-2233,Private      ,3,45,48,24,98,122
03103300,JNA INSTITUTE OF CULINARY ARTS          ,PA,19146-3119,Proprietary  ,6,17,23,93,165,258
03109100,METROPOLITAN CAREER CENTER              ,PA,19144-0000,Private      ,3,26,29,54,231,285
03110700,AVIATION INSTITUTE OF MAINTENANCE       ,PA,19114-1017,Proprietary  ,5,61,66,130,491,621
03120400,REGIONAL CAREER & TECHNICAL CENTER      ,PA,16509-4699,Public       ,1,1,2,7,11,18
03128400,DELAWARE COUNTY TECHNICAL SCHOOL        ,PA,19008-1928,Public       ,8,23,31,52,186,238
03180400,PENNSYLVANIA HIGHLANDS COMMUNITY COLLEGE,PA,15904-2927,Public       ,19,62,81,858,932,1790
03236400,LT INTERNATIONAL BEAUTY SCHOOL          ,PA,19130-2235,Proprietary  ,7,32,39,27,123,150
03353300,ACADEMY OF VOCAL ARTS                   ,PA,19103-6685,Private      ,0,2,2,22,57,79
03380301,STAR CAREER ACADEMY - STAR PHILADELPHIA ,PA,19114-2204,Proprietary  ,49,190,239,238,999,1237
03380304,STAR CAREER ACADEMY - STAR NORRISTOWN   ,PA,19403-2422,Proprietary  ,2,4,6,2,4,6
03439400,NAWCC SCHOOL OF HOROLOGY                ,PA,17512-2130,Private      ,0,0,0,1,17,18
03535300,HUNTINGDON COUNTY CAREER AND TECHNO     ,PA,17060-0905,Public       ,0,2,2,6,36,42
03561400,SUSQUEHANNA COUNTY CAREER & TECHNOL     ,PA,18816-0100,Public       ,0,0,0,11,14,25
03766300,PENNSYLVANIA SCHOOL OF MUSCLE THERAPY   ,PA,19406-3101,Proprietary  ,7,39,46,56,251,307
03781300,PRINCETON INFORMATION TECHNOLOGY CENTER ,PA,19038-4535,Proprietary  ,2,51,53,6,109,115
03899300,CALVARY BAPTIST THEOLOGICAL SEMINARY    ,PA,19446-4718,Private      ,0,5,5,1,66,67
03923300,PRECISION MANUFACTURING INSTITUTE       ,PA,16335-8380,Private      ,0,9,9,14,68,82
03948300,HARRISBURG UNIVERSITY OF SCIENCE AND TEC,PA,17101-2116,Private      ,7,14,21,311,243,554
03949300,WON INSTITUTE OF GRADUATE STUDIES       ,PA,19038-4535,Private      ,0,0,0,0,38,38
03950500,NORTHWEST REGIONAL TECHNOLOGY INSTITUTE ,PA,16508-2820,Proprietary  ,1,17,18,7,74,81
03952300,NATIONAL MASSAGE THERAPY INSTITUTE      ,PA,19116-3965,Proprietary  ,35,174,209,194,857,1051
04024300,EDUCATION AND TECHNOLOGY INSTITUTE      ,PA,15601-9214,Private      ,0,4,4,10,51,61
04118000,BYZANTINE CATHOLIC SEMINARY OF SAINTS CY,PA,15214-2229,Private      ,0,1,1,0,8,8
04119900,PENNSYLVANIA MYOTHERAPY INSTITUTE       ,PA,17350-8426,Proprietary  ,0,0,0,3,20,23
04127500,CAREER DEVELOPMENT & EMPLOYMENT         ,PA,18702-5253,Proprietary  ,2,11,13,8,89,97
04137100,KIMBERLY'S BEAUTY SCHOOL                ,PA,19134-0000,Proprietary  ,1,1,2,13,48,61
04138300,INTERNATIONAL BEAUTY ACADEMY            ,PA,19149-2710,Proprietary  ,1,12,13,17,77,94
04145800,PULSE BEAUTY ACADEMY A PAUL MITCHELL PAR,PA,19335-0000,Proprietary  ,10,11,21,84,83,167
04149800,SOMERSET COUNTY TECHNOLOGY CENTER       ,PA,15501-1444,Public       ,1,2,3,5,27,32
04151700,BELLA CAPELLI ACADEMY                   ,PA,15146-2388,Proprietary  ,2,6,8,30,31,61
04155100,INSTITUTE OF MEDICAL CAREERS            ,PA,15235-3718,Proprietary  ,1,3,4,2,12,14
04158000,METRO BEAUTY ACADEMY                    ,PA,18106-9693,Proprietary  ,15,32,47,83,155,238
04164900,BARONE BEAUTY ACADEMY                   ,PA,17701-5316,Proprietary  ,1,10,11,21,38,59
04167200,COMMONWEALTH MEDICAL COLLEGE (THE)      ,PA,18503-3251,Private      ,1,6,7,3,27,30
00267813,BRYANT & STRATTON COLLEGE - MIL DOWNTOWN,WI,53203-2608,Proprietary  ,64,231,295,934,3401,4335
00383200,ALVERNO COLLEGE                         ,WI,53234-3922,Private      ,14,64,78,1543,2677,4220
00383500,BELOIT COLLEGE                          ,WI,53511-5595,Private      ,10,5,15,1966,142,2108
00383700,CARDINAL STRITCH UNIVERSITY             ,WI,53217-9884,Private      ,21,376,397,1160,5306,6466
00383800,CARROLL UNIVERSITY                      ,WI,53186-5593,Private      ,16,30,46,3413,881,4294
00383900,CARTHAGE COLLEGE                        ,WI,53141-0000,Private      ,39,46,85,4859,942,5801
00384000,WESTERN TECHNICAL COLLEGE               ,WI,54601-0908,Public       ,55,136,191,2226,3134,5360
00384200,CONCORDIA UNIVERSITY WISCONSIN          ,WI,53097-2402,Private      ,19,267,286,2606,4505,7111
00384800,EDGEWOOD COLLEGE                        ,WI,53711-1958,Private      ,17,72,89,1717,1326,3043
00385000,SILVER LAKE COLLEGE                     ,WI,54220-9319,Private      ,1,34,35,181,490,671
00385400,LAKELAND COLLEGE                        ,WI,53082-0000,Private      ,17,103,120,1198,2289,3487
00385600,LAWRENCE UNIVERSITY                     ,WI,54912-0599,Private      ,19,7,26,2494,111,2605
00386100,MARIAN UNIVERSITY                       ,WI,54935-4699,Private      ,9,79,88,1387,1496,2883
00386300,MARQUETTE UNIVERSITY                    ,WI,53201-1881,Private      ,100,84,184,13801,4825,18626
00386600,MILWAUKEE AREA TECH COLLEGE             ,WI,53233-1443,Public       ,186,556,742,7144,19378,26522
00386800,MILWAUKEE SCHOOL OF ENGINEERING         ,WI,53202-3109,Private      ,14,26,40,2774,913,3687
00386900,MOUNT MARY COLLEGE                      ,WI,53222-4597,Private      ,3,39,42,874,1704,2578
00387400,NASHOTAH HOUSE                          ,WI,53058-0000,Private      ,0,1,1,0,41,41
00387500,NORTHLAND COLLEGE                       ,WI,54806-3999,Private      ,8,6,14,680,130,810
00388400,RIPON COLLEGE                           ,WI,54971-0248,Private      ,6,3,9,1411,71,1482
00389200,ST. NORBERT COLLEGE                     ,WI,54115-2002,Private      ,15,4,19,2524,137,2661
00389500,UNIVERSITY OF WISCONSIN-MADISON         ,WI,53715-1382,Public       ,230,184,414,23266,11743,35009
00389600,UNIVERSITY OF WISCONSIN-MILWAUKEE       ,WI,53201-3165,Public       ,253,453,706,18604,13616,32220
00389700,UNIVERSITY OF WISCONSIN COLLEGES        ,WI,53708-8680,Public       ,78,137,215,3376,2575,5951
00389701,UNIVERSITY OF WISCONSIN-BARABOO         ,WI,53913-1098,Public       ,6,13,19,368,209,577
00389702,UNIVERSITY OF WISCONSIN-BARRON          ,WI,54868-2497,Public       ,6,10,16,332,218,550
00389703,UNIVERSITY OF WISCONSIN-FOND DU LAC     ,WI,54935-2998,Public       ,13,16,29,519,294,813
00389704,UNIVERSITY OF WISCONSIN-FOX VALLEY      ,WI,54952-1297,Public       ,23,16,39,905,535,1440
00389705,UNIVERSITY OF WISCONSIN-MANITOWOC       ,WI,54220-6699,Public       ,7,6,13,301,175,476
00389706,UNIVERSITY OF WISCONSIN-MARATHON        ,WI,54401-5396,Public       ,12,27,39,925,438,1363
00389707,UNIVERSITY OF WISCONSIN-MARINETTE       ,WI,54143-4299,Public       ,2,10,12,250,173,423
00389708,UNIVERSITY OF WISCONSIN-MARSHFIELD      ,WI,54449-3310,Public       ,4,12,16,340,208,548
00389709,UNIVERSITY OF WISCONSIN-RICHLAND        ,WI,53581-1399,Public       ,3,8,11,286,120,406
00389710,UNIVERSITY OF WISCONSIN COLLEGES - ROCK ,WI,53546-5699,Public       ,20,21,41,723,551,1274
00389711,UNIVERSITY OF WISCONSIN-SHEBOYGAN       ,WI,53081-4789,Public       ,20,19,39,512,308,820
00389712,UNIVERSITY OF WISCONSIN-WASHINGTON      ,WI,53095-3699,Public       ,11,16,27,555,299,854
00389713,UNIVERSITY OF WISCONSIN-WAUKESHA        ,WI,53188-2799,Public       ,21,30,51,1123,520,1643
00389900,UNIVERSITY OF WISCONSIN-GREEN BAY       ,WI,54311-7001,Public       ,52,76,128,4708,2359,7067
00391100,VITERBO UNIVERSITY                      ,WI,54601-4777,Private      ,8,58,66,1788,1354,3142
00391500,UNIVERSITY OF WISCONSIN-STOUT           ,WI,54751-0790,Public       ,61,97,158,6323,2473,8796
00391700,UNIVERSITY OF WISCONSIN-EAU CLAIRE      ,WI,54702-4004,Public       ,96,83,179,8976,2102,11078
00391900,UNIVERSITY OF WISCONSIN-LA CROSSE       ,WI,54601-3742,Public       ,58,66,124,7714,1790,9504
00392000,UNIVERSITY OF WISCONSIN-OSHKOSH         ,WI,54901-8604,Public       ,107,145,252,8302,3700,12002
00392100,UNIVERSITY OF WISCONSIN-PLATTEVILLE     ,WI,53818-3099,Public       ,57,75,132,6227,1886,8113
00392300,UNIVERSITY OF WISCONSIN-RIVER FALLS     ,WI,54022-5013,Public       ,54,76,130,5318,1614,6932
00392400,UNIVERSITY OF WISCONSIN-STEVENS POINT   ,WI,54481-3871,Public       ,81,46,127,7742,2066,9808
00392500,UNIVERSITY OF WISCONSIN-SUPERIOR        ,WI,54880-2898,Public       ,22,64,86,1789,1513,3302
00392600,UNIVERSITY OF WISCONSIN-WHITEWATER      ,WI,53190-1792,Public       ,104,99,203,9065,2800,11865
00400700,MADISON AREA TECHNICAL COLLEGE          ,WI,53704-2599,Public       ,129,326,455,5001,8849,13850
00501500,UNIVERSITY OF WISCONSIN-PARKSIDE        ,WI,53141-2000,Public       ,71,83,154,3898,2489,6387
00529400,WAUKESHA COUNTY TECHNICAL COLLEGE       ,WI,53072-4696,Public       ,61,139,200,1982,3750,5732
00530100,NORTHEAST WISCONSIN TECHNICAL COLLEGE   ,WI,54307-9042,Public       ,99,286,385,2997,6113,9110
00530400,CHIPPEWA VALLEY TECHNICAL COLLEGE       ,WI,54701-6162,Public       ,46,121,167,2667,4154,6821
00538000,MID-STATE TECHNICAL COLLEGE             ,WI,54494-5512,Public       ,29,110,139,1041,2405,3446
00538400,NICOLET AREA TECHNICAL COLLEGE          ,WI,54501-0000,Public       ,25,52,77,582,1132,1714
00538700,NORTHCENTRAL TECHNICAL COLLEGE          ,WI,54401-1899,Public       ,51,195,246,1228,3281,4509
00538900,GATEWAY TECHNICAL COLLEGE               ,WI,53144-1690,Public       ,70,308,378,2560,8539,11099
00539000,BLACKHAWK TECHNICAL COLLEGE             ,WI,53547-5009,Public       ,26,159,185,1094,3581,4675
00610800,BELLIN HOSP SCH OF RAD TECH             ,WI,54305-3505,Private      ,0,0,0,26,26,52
00611500,MERCY MED CTR SCH OF RAD TECH           ,WI,54904-3370,Private      ,0,0,0,10,24,34
00612601,ST LUKE'S MEDCL CTR SCHL RAD TECH       ,WI,53215-4330,Private      ,2,6,8,21,91,112
00612603,ST LUKE'S MED CTR SCH OF SONOGRAPHY     ,WI,53215-0000,Private      ,0,0,0,11,51,62
00613100,THEDA CLARK REG MED CTR SCH RAD TEC     ,WI,54957-0000,Private      ,0,0,0,13,13,26
00663900,BELLIN COLLEGE                          ,WI,54305-0000,Private      ,4,6,10,245,193,438
00732934,ITT TECHNICAL INSTITUTE                 ,WI,53220-4612,Proprietary  ,134,375,509,1324,3941,5265
00766900,SOUTHWEST WISCONSIN TECH COLLEGE        ,WI,53809-0000,Public       ,11,29,40,726,1019,1745
00821700,WISCONSIN COLLEGE OF COSMETOLOGY        ,WI,54324-0257,Proprietary  ,10,10,20,75,72,147
00869405,RASMUSSEN COLLEGE - WAUSAU              ,WI,54401-7804,Proprietary  ,15,106,121,132,628,760
00869414,RASMUSSEN COLLEGE - GREEN BAY           ,WI,54303-2349,Proprietary  ,15,97,112,262,1437,1699
00869419,RASMUSSEN COLLEGE - APPLETON            ,WI,54915-7305,Proprietary  ,6,74,80,30,225,255
00919400,LAKESHORE TECHNICAL COLLEGE             ,WI,53015-1412,Public       ,24,79,103,758,2327,3085
00925600,MORAINE PARK TECHNICAL COLLEGE          ,WI,54936-0000,Public       ,23,109,132,1177,3339,4516
00941900,STATE CLG OF BEAUTY CULT-WAUSAU         ,WI,54403-4667,Proprietary  ,5,12,17,55,108,163
00962100,HERZING UNIVERSITY                      ,WI,53718-4236,Proprietary  ,100,757,857,1111,8635,9746
00974400,FOX VALLEY TECHNICAL COLLEGE            ,WI,54913-0000,Public       ,71,276,347,3111,6252,9363
01091300,MADISON MEDIA INSTITUTE                 ,WI,53718-6787,Proprietary  ,36,44,80,581,566,1147
01148400,ADVANCED INSTITUTE OF HAIR DESIGN       ,WI,53225-0000,Proprietary  ,14,18,32,254,257,511
01182400,WISCONSIN INDIANHEAD TECH CLG WITC      ,WI,54871-9300,Public       ,18,83,101,1229,2752,3981
02077100,MILWAUKEE INST OF ART & DESIGN          ,WI,53202-0000,Private      ,15,7,22,976,303,1279
02078000,SACRED HEART SCHOOL OF THEOLOGY         ,WI,53130-0000,Private      ,0,1,1,1,9,10
02136600,WISCONSIN LUTHERAN COLLEGE              ,WI,53226-0000,Private      ,10,11,21,1075,197,1272
02201803,KAPLAN COLLEGE - MILWAUKEE              ,WI,53212-3939,Proprietary  ,24,109,133,259,1367,1626
02239204,ANTHEM COLLEGE - BROOKFIELD             ,WI,53005-4207,Proprietary  ,2,6,8,16,59,75
02271300,WI SCH OF PROFESSIONAL PSYCHOLOGY       ,WI,53225-0000,Private      ,0,6,6,22,136,158
02317200,MARANATHA BAPTIST BIBLE COLLEGE         ,WI,53094-0000,Private      ,20,7,27,847,139,986
02324700,EMPIRE BEAUTY SCHOOL                    ,WI,53717-0000,Proprietary  ,7,30,37,57,258,315
02332100,EMPIRE BEAUTY SCHOOL                    ,WI,54220-0000,Proprietary  ,17,45,62,135,376,511
02332101,EMPIRE BEAUTY SCHOOL - APPLETON         ,WI,54914-4644,Proprietary  ,1,4,5,23,33,56
02453500,MEDICAL COLLEGE OF WISCONSIN            ,WI,53226-0000,Private      ,2,8,10,63,1270,1333
02494300,GILL-TECH ACADEMY OF HAIR DESIGN        ,WI,54911-0000,Proprietary  ,18,13,31,98,93,191
02532200,LAC COURTE OREILLES OJIBWA CMTY CLG     ,WI,54843-0000,Public       ,9,55,64,83,463,546
03007400,LAKESIDE SCHOOL OF MASSAGE THERAPY      ,WI,53212-3969,Private      ,5,18,23,47,185,232
03061200,MIDWEST COLLEGE OF ORIENTAL MEDICINE    ,WI,53403-9747,Proprietary  ,0,5,5,5,215,220
03077600,EMPIRE BEAUTY SCHOOL                    ,WI,54304-4838,Proprietary  ,24,54,78,201,573,774
03125100,COLLEGE OF MENOMINEE NATION             ,WI,54135-0000,Private      ,11,61,72,166,709,875
03125102,COLLEGE OF  THE MENOMINEE NATION - GREEN,WI,54304-4964,Private      ,4,16,20,35,133,168
03220300,"SALON PROFESSIONAL ACADEMY, THE         ",WI,54701-7633,Proprietary  ,9,10,19,74,101,175
03309300,MONTESSORI INSTITUTE OF MILWAUKEE       ,WI,53207-0000,Private      ,1,1,2,3,27,30
03808300,INSTITUTE OF BEAUTY AND WELLNESS (THE)  ,WI,53202-5715,Proprietary  ,6,25,31,116,226,342
03822300,FOUR SEASONS SALON AND COSMETOLOGY SCHOO,WI,53566-0000,Proprietary  ,1,7,8,22,52,74
03872500,NORTHLAND INTERNATIONAL UNIVERSITY      ,WI,54119-9285,Private      ,8,5,13,517,78,595
03925300,BLUE SKY SCHOOL OF PROFESSIONAL MASSAGE ,WI,53024-9699,Private      ,4,28,32,44,178,222
04117400,MILWAUKEE CAREER COLLEGE                ,WI,53222-4305,Proprietary  ,19,74,93,226,1026,1252
04118600,ACADEMY OF COSMETOLOGY                  ,WI,53548-3307,Proprietary  ,0,8,8,32,107,139
04124800,VISIONS IN HAIR DESIGN INSTITUTE OF COSM,WI,53210-1120,Proprietary  ,1,2,3,22,69,91
04132600,WISCONSIN ACADEMY (THE)                 ,WI,54157-1726,Proprietary  ,0,6,6,14,57,71
04137900,PC PROSCHOOLS                           ,WI,53005-6003,Proprietary  ,16,150,166,86,561,647
04138200,SALON PROFESSIONAL ACADEMY (THE)        ,WI,54914-3921,Proprietary  ,3,7,10,55,78,133
04157700,SALON PROFESSIONAL ACADEMY (THE)        ,WI,54650-8699,Proprietary  ,5,12,17,68,102,170
04165300,ACADEMY WAUKESHA (THE)                  ,WI,53072-5524,Proprietary  ,8,25,33,73,115,188
04179200,ADVANCED COLLEGE OF COSMETOLOGY         ,WI,53963-0000,Proprietary  ,1,1,2,18,22,40
04182100,FIRST CLASS COSMETOLOGY SCHOOL          ,WI,52511-0000,Proprietary  ,4,11,15,4,11,15
04183600,SALON PROFESSIONAL ACADEMY OF KENOSHA (T,WI,53142-4950,Proprietary  ,8,19,27,21,53,74
00145944,STRAYER UNIVERSITY - GREENSBORO         ,NC,27407-2638,Proprietary  ,0,0,0,0,1,1
00290500,NORTH CAROLINA A&T STATE UNIV           ,NC,27411-0001,Public       ,160,136,296,14389,6689,21078
00290600,APPALACHIAN STATE UNIVERSITY            ,NC,28608-2059,Public       ,157,114,271,15901,4691,20592
00290700,UNIVERSITY OF NC AT ASHEVILLE           ,NC,28804-3299,Public       ,41,45,86,3740,1844,5584
00290800,BARTON COLLEGE                          ,NC,27893-3104,Private      ,17,36,53,1594,911,2505
00291000,BELMONT ABBEY COLLEGE                   ,NC,28012-1802,Private      ,12,35,47,1374,1431,2805
00291100,BENNETT COLLEGE                         ,NC,27401-3239,Private      ,14,11,25,1283,485,1768
00291200,BREVARD COLLEGE                         ,NC,28712-3306,Private      ,8,11,19,1044,180,1224
00291300,CAMPBELL UNIVERSITY                     ,NC,27506-0036,Private      ,61,135,196,4547,3701,8248
00291400,CATAWBA COLLEGE                         ,NC,28144-2488,Private      ,14,25,39,1660,723,2383
00291500,CENTRAL PIEDMONT COMMUNITY COLLEGE      ,NC,28204-2297,Public       ,250,1046,1296,8925,20491,29416
00291600,CHOWAN UNIVERSITY                       ,NC,27855-1850,Private      ,21,11,32,1878,436,2314
00291700,COLLEGE OF THE ALBEMARLE                ,NC,27909-2327,Public       ,28,95,123,933,2185,3118
00291800,DAVIDSON COLLEGE                        ,NC,28035-7157,Private      ,21,4,25,2989,172,3161
00291900,DAVIDSON COUNTY COMMUNITY COLLEGE       ,NC,27293-0000,Public       ,45,198,243,1681,4564,6245
00292000,DUKE UNIVERSITY                         ,NC,27708-0397,Private      ,132,68,200,16386,2183,18569
00292001,DUKE UNIV - SCHOOL OF MEDICINE          ,NC,27710-0000,Private      ,4,20,24,146,1362,1508
00292002,DUKE UNIV - SCHOOL OF LAW               ,NC,27708-0000,Private      ,3,28,31,63,3510,3573
00292003,DUKE UNIV - GRAD SCH ARTS & SCIENCE     ,NC,27708-0000,Private      ,2,16,18,139,736,875
00292004,DUKE UNIV - FUQUA SCH OF BUSINESS       ,NC,27708-0000,Private      ,3,21,24,84,1308,1392
00292005,DUKE UNIV/NICHOLAS SCH OF ENVIRON.      ,NC,27708-0000,Private      ,0,3,3,26,386,412
00292006,DUKE UNIV - DIVINITY SCHOOL             ,NC,27708-0000,Private      ,5,10,15,165,741,906
00292007,DUKE UNIV - SCHOOL OF NURSING           ,NC,27710-0000,Private      ,2,27,29,142,968,1110
00292010,DUKE UNIVERSITY - SCHOOL OF PUBLIC POLIC,NC,27708-0239,Private      ,3,8,11,83,371,454
00292300,EAST CAROLINA UNIVERSITY                ,NC,27858-1818,Public       ,216,364,580,21815,12975,34790
00292600,ELIZABETH CITY STATE UNIVERSITY         ,NC,27909-7806,Public       ,51,51,102,4073,1744,5817
00292700,ELON UNIVERSITY                         ,NC,27244-2010,Private      ,52,39,91,6963,1312,8275
00292800,FAYETTEVILLE STATE UNIVERSITY           ,NC,28301-4298,Public       ,84,238,322,5235,7025,12260
00292900,GARDNER-WEBB UNIVERSITY                 ,NC,28017-0000,Private      ,30,139,169,2874,3143,6017
00293000,GREENSBORO COLLEGE                      ,NC,27401-1875,Private      ,10,58,68,1767,1272,3039
00293100,GUILFORD COLLEGE                        ,NC,27410-4171,Private      ,26,112,138,3117,3084,6201
00293300,HIGH POINT UNIVERSITY                   ,NC,27262-4221,Private      ,48,58,106,4839,1499,6338
00293400,ISOTHERMAL COMMUNITY COLLEGE            ,NC,28160-0804,Public       ,36,133,169,1058,2358,3416
00293500,JOHN WESLEY COLLEGE                     ,NC,27265-0000,Private      ,1,22,23,48,244,292
00293600,JOHNSON C SMITH UNIVERSITY              ,NC,28216-5398,Private      ,45,64,109,2999,1497,4496
00293700,KING'S COLLEGE-CHARLOTTE                ,NC,28204-2435,Proprietary  ,24,34,58,878,824,1702
00293900,LEES MCRAE COLLEGE                      ,NC,28604-0000,Private      ,7,5,12,1100,325,1425
00294000,LENOIR COMMUNITY COLLEGE                ,NC,28502-0188,Public       ,29,100,129,997,3041,4038
00294100,LENOIR-RHYNE UNIVERSITY                 ,NC,28603-0000,Private      ,23,28,51,2540,844,3384
00294200,LIVINGSTONE COLLEGE                     ,NC,28144-5298,Private      ,23,22,45,1816,553,2369
00294300,LOUISBURG COLLEGE                       ,NC,27549-2398,Private      ,13,1,14,1227,198,1425
00294400,MARS HILL COLLEGE                       ,NC,28754-0000,Private      ,20,14,34,1567,480,2047
00294500,MEREDITH COLLEGE                        ,NC,27607-5298,Private      ,17,42,59,2004,1117,3121
00294600,METHODIST UNIVERSITY                    ,NC,28311-1420,Private      ,28,85,113,2788,1853,4641
00294700,MITCHELL COMMUNITY COLLEGE              ,NC,28677-5264,Public       ,25,129,154,1331,3213,4544
00294800,MONTREAT COLLEGE                        ,NC,28757-1267,Private      ,3,53,56,628,836,1464
00294900,MOUNT OLIVE COLLEGE                     ,NC,28365-1299,Private      ,19,272,291,1390,4333,5723
00295000,NORTH CAROLINA CENTRAL UNIVERSITY       ,NC,27707-3198,Public       ,125,181,306,10452,8226,18678
00295100,NORTH CAROLINA WESLEYAN COLLEGE         ,NC,27804-8699,Private      ,12,56,68,1181,1269,2450
00295300,PEACE COLLEGE                           ,NC,27604-1194,Private      ,9,25,34,1037,566,1603
00295400,UNIV OF NORTH CAROLINA AT PEMBROKE      ,NC,28372-1510,Public       ,68,131,199,5827,4573,10400
00295500,PFEIFFER UNIVERSITY                     ,NC,28109-0000,Private      ,11,70,81,1050,1542,2592
00295600,PIEDMONT BAPTIST COLLEGE AND GRADUATE SC,NC,27101-5025,Private      ,4,19,23,233,269,502
00295700,QUEENS UNIVERSITY OF CHARLOTTE          ,NC,28274-0001,Private      ,36,134,170,2297,2699,4996
00295800,ROCKINGHAM COMMUNITY COLLEGE            ,NC,27375-0000,Public       ,19,91,110,926,2167,3093
00296000,SALEM COLLEGE                           ,NC,27108-0000,Private      ,12,35,47,698,863,1561
00296100,SANDHILLS COMMUNITY COLLEGE             ,NC,28374-8283,Public       ,42,178,220,1685,3848,5533
00296200,SHAW UNIVERSITY                         ,NC,27601-2393,Private      ,25,72,97,3193,2684,5877
00296300,SOUTHEASTERN BAPTIST THEOL SEMINARY     ,NC,27588-0000,Private      ,0,0,0,48,125,173
00296400,SOUTHEASTERN COMMUNITY COLLEGE          ,NC,28472-5422,Public       ,39,110,149,832,2009,2841
00296700,ST ANDREWS PRESBYTERIAN COLLEGE         ,NC,28352-9979,Private      ,2,7,9,580,152,732
00296800,ST AUGUSTINES COLLEGE                   ,NC,27610-2298,Private      ,30,25,55,2345,901,3246
00297000,SURRY COMMUNITY COLLEGE                 ,NC,27017-0304,Public       ,29,79,108,1333,2231,3564
00297200,NORTH CAROLINA STATE UNIV-RALEIGH       ,NC,27695-7001,Public       ,230,322,552,24598,10856,35454
00297300,GASTON COLLEGE                          ,NC,28034-1499,Public       ,59,280,339,2335,6069,8404
00297400,UNIVERSITY OF N C-CHAPEL HILL           ,NC,27514-0000,Public       ,185,330,515,21714,13980,35694
00297500,UNIVERSITY OF NC AT CHARLOTTE           ,NC,28223-0001,Public       ,196,401,597,19075,14034,33109
00297600,UNIVERSITY OF N C - GREENSBORO          ,NC,27412-0001,Public       ,136,235,371,16074,10733,26807
00297800,WAKE FOREST UNIV - UNDERGRADUATE        ,NC,27109-7246,Private      ,61,11,72,6545,489,7034
00297801,WAKE FOREST UNIV - SCH OF MEDICINE      ,NC,27157-1090,Private      ,6,21,27,105,979,1084
00297803,WAKE FOREST GRAD SCHOOLS OF BUSINESS    ,NC,27109-7659,Private      ,1,13,14,640,910,1550
00297805,WAKE FOREST UNIV - SCH OF LAW           ,NC,27109-7206,Private      ,1,11,12,42,1496,1538
00297806,WAKE FOREST UNIV - GRAD A&S/DIVINITY    ,NC,27109-7246,Private      ,3,8,11,82,578,660
00297900,WARREN WILSON COLLEGE                   ,NC,28815-0000,Private      ,11,20,31,1287,469,1756
00298000,WAYNE COMMUNITY COLLEGE                 ,NC,27533-0000,Public       ,43,202,245,1440,3470,4910
00298100,WESTERN CAROLINA UNIVERSITY             ,NC,28723-9731,Public       ,120,102,222,8674,4022,12696
00298200,WESTERN PIEDMONT COMMUNITY COLLEGE      ,NC,28655-4504,Public       ,36,108,144,1201,2757,3958
00298300,WILKES COMMUNITY COLLEGE                ,NC,28697-2100,Public       ,20,89,109,1119,2041,3160
00298400,UNIVERSITY OF N C-WILMINGTON            ,NC,28403-3297,Public       ,124,136,260,12188,5052,17240
00298500,WINGATE UNIVERSITY                      ,NC,28174-0159,Private      ,30,27,57,2931,1093,4024
00298600,WINSTON-SALEM STATE UNIVERSITY          ,NC,27102-0000,Public       ,67,134,201,7106,5128,12234
00398100,UNC SCHOOL OF THE ARTS                  ,NC,27127-2188,Public       ,15,9,24,1233,420,1653
00403300,ASHEVILLE BUNCOMBE TECH CMTY CLG        ,NC,28801-4897,Public       ,73,345,418,2130,5443,7573
00406200,PITT COMMUNITY COLLEGE                  ,NC,28590-0000,Public       ,71,231,302,4101,6743,10844
00483500,CALDWELL COMMUNITY CLG & TECH INST      ,NC,28638-2626,Public       ,44,149,193,1667,3539,5206
00483800,GUILFORD TECHNICAL COMMUNITY CLG        ,NC,27282-0309,Public       ,154,566,720,6814,15264,22078
00484400,WAKE TECHNICAL COMMUNITY COLLEGE        ,NC,27603-5696,Public       ,178,727,905,6929,14263,21192
00484500,WILSON COMMUNITY COLLEGE                ,NC,27893-3310,Public       ,16,96,112,681,2507,3188
00499201,MILLER-MOTTE TECHNICAL COLLEGE - MILLER-,NC,27511-9209,Proprietary  ,17,116,133,176,1065,1241
00499202,MILLER-MOTTE TECHNICAL COLLEGE - MILLER-,NC,27604-6072,Proprietary  ,23,136,159,270,1381,1651
00499203,MILLER-MOTTE TECHNICAL COLLEGE - FAYETTE,NC,28311-7651,Proprietary  ,42,191,233,281,1438,1719
00499205,MILLER-MOTTE TECHNICAL COLLEGE - MILLER-,NC,28540-5901,Proprietary  ,14,169,183,44,491,535
00531600,COASTAL CAROLINA COMMUNITY COLLEGE      ,NC,28546-6816,Public       ,55,284,339,1448,4963,6411
00531700,FORSYTH TECHNICAL COMMUNITY COLLEGE     ,NC,27103-5197,Public       ,91,438,529,3546,9542,13088
00531800,CATAWBA VALLEY COMMUNITY COLLEGE        ,NC,28602-8302,Public       ,48,221,269,2437,4744,7181
00532000,CAPE FEAR COMMUNITY COLLEGE             ,NC,28401-3910,Public       ,116,311,427,4041,7099,11140
00544700,RANDOLPH COMMUNITY COLLEGE              ,NC,27204-1009,Public       ,42,142,184,1058,2676,3734
00544800,DURHAM TECHNICAL CMNTY COLLEGE          ,NC,27703-5023,Public       ,39,248,287,1748,6311,8059
00544900,CENTRAL CAROLINA COMMUNITY COLLEGE      ,NC,27330-9000,Public       ,42,208,250,1451,4554,6005
00546300,ALAMANCE COMMUNITY COLLEGE              ,NC,27253-0000,Public       ,47,196,243,1686,4536,6222
00546400,RICHMOND COMMUNITY COLLEGE              ,NC,28345-4522,Public       ,24,94,118,728,2326,3054
00575400,ROWAN-CABARRUS COMMUNITY COLLEGE        ,NC,28146-8357,Public       ,52,269,321,2288,6154,8442
00647700,CABARRUS COLLEGE OF HEALTH SCIENCES     ,NC,28025-0000,Private      ,3,29,32,301,839,1140
00647800,MERCY HOSP SCH OF NURSING               ,NC,28207-0000,Public       ,5,44,49,182,855,1037
00648300,WATTS SCHOOL OF NURSING                 ,NC,27704-0000,Private      ,2,25,27,99,385,484
00679900,CRAVEN COMMUNITY COLLEGE                ,NC,28562-0000,Public       ,31,222,253,863,3461,4324
00703100,PAMLICO COMMUNITY COLLEGE               ,NC,28529-0000,Public       ,8,33,41,103,419,522
00764000,FAYETTEVILLE TECHNICAL CMTY COLLEGE     ,NC,28303-0236,Public       ,116,777,893,3690,14715,18405
00768700,JAMES SPRUNT COMMUNITY COLLEGE          ,NC,28349-0398,Public       ,12,76,88,458,1420,1878
00781400,BROOKSTONE COLLEGE OF BUSINESS          ,NC,28262-1294,Proprietary  ,9,62,71,113,682,795
00781401,BROOKSTONE COLLEGE OF BUSINESS          ,NC,27409-0000,Proprietary  ,12,60,72,100,614,714
00789200,SAMPSON COMMUNITY COLLEGE               ,NC,28328-0000,Public       ,12,33,45,583,1507,2090
00798500,SOUTH PIEDMONT COMMUNITY COLLEGE        ,NC,28135-9703,Public       ,22,93,115,914,2629,3543
00798600,HALIFAX COMMUNITY COLLEGE               ,NC,27890-0089,Public       ,13,74,87,729,1851,2580
00798700,BLADEN COMMUNITY COLLEGE                ,NC,28332-0266,Public       ,25,87,112,612,2164,2776
00798800,MARTIN COMMUNITY COLLEGE                ,NC,27892-8307,Public       ,3,30,33,291,976,1267
00808100,CARTERET COMMUNITY COLLEGE              ,NC,28557-2989,Public       ,19,99,118,664,1861,2525
00808200,CLEVELAND COMMUNITY COLLEGE             ,NC,28150-0000,Public       ,33,149,182,1113,3250,4363
00808300,HAYWOOD COMMUNITY COLLEGE               ,NC,28721-0000,Public       ,28,140,168,716,1690,2406
00808500,MCDOWELL TECHNICAL COMMUNITY CLG        ,NC,28752-8728,Public       ,22,64,86,367,1288,1655
00808700,MONTGOMERY COMMUNITY COLLEGE            ,NC,27371-0787,Public       ,15,43,58,297,842,1139
00846600,SOUTHWESTERN COMMUNITY COLLEGE          ,NC,28779-8581,Public       ,25,114,139,917,1872,2789
00855700,NASH COMMUNITY COLLEGE                  ,NC,27804-0488,Public       ,35,130,165,1175,2829,4004
00855800,BEAUFORT COUNTY COMMUNITY COLLEGE       ,NC,27889-7889,Public       ,8,64,72,679,1869,2548
00861200,ROBESON COMMUNITY COLLEGE               ,NC,28359-2151,Public       ,34,118,152,1211,3638,4849
00861300,ROANOKE-CHOWAN COMMUNITY COLLEGE        ,NC,27910-9522,Public       ,11,21,32,342,907,1249
00885500,EDGECOMBE COMMUNITY COLLEGE             ,NC,27886-9399,Public       ,35,172,207,888,3775,4663
00902500,EMPIRE BEAUTY SCHOOL                    ,NC,28105-2508,Proprietary  ,14,94,108,208,753,961
00933600,JOHNSTON COMMUNITY COLLEGE              ,NC,27577-0000,Public       ,37,83,120,1508,3687,5195
00943000,TRI-COUNTY COMMUNITY COLLEGE            ,NC,28906-7919,Public       ,13,75,88,378,1104,1482
00964600,PIEDMONT COMMUNITY COLLEGE              ,NC,27573-1197,Public       ,14,74,88,551,1693,2244
00968400,BLUE RIDGE COMMUNITY COLLEGE            ,NC,28731-9624,Public       ,39,110,149,794,1761,2555
00974701,GORDON-CONWELL THEO SEM - CHARLOTTE     ,NC,28273-0000,Private      ,0,13,13,8,250,258
00990300,VANCE-GRANVILLE CMTY COLLEGE            ,NC,27536-0917,Public       ,34,137,171,1356,3556,4912
01026400,SOUTH COLLEGE                           ,NC,28803-3152,Proprietary  ,11,94,105,87,667,754
01119400,STANLY COMMUNITY COLLEGE                ,NC,28001-7458,Public       ,35,147,182,922,2728,3650
01119700,MAYLAND COMMUNITY COLLEGE               ,NC,28777-2777,Public       ,9,38,47,402,757,1159
01179900,PAUL MITCHELL THE SCHOOL FAYETTEVILLE   ,NC,28303-5364,Proprietary  ,27,73,100,107,386,493
01192600,LEON'S BEAUTY SCHOOL                    ,NC,27403-2812,Proprietary  ,8,33,41,122,324,446
02056500,MITCHELL'S HAIR STYLING ACADEMY         ,NC,27893-0000,Proprietary  ,10,17,27,76,164,240
02056501,MITCHELL'S HAIR STYLING ACADEMY - MITCHE,NC,27606-3326,Proprietary  ,2,8,10,57,129,186
02110500,ART INSTITUTE OF CHARLOTTE (THE)        ,NC,28217-0000,Proprietary  ,150,362,512,2651,3587,6238
02170700,BRUNSWICK COMMUNITY COLLEGE             ,NC,28422-0000,Public       ,23,68,91,599,1173,1772
02205000,COLLEGE OF WILMINGTON                   ,NC,28403-0000,Proprietary  ,3,29,32,134,277,411
02210400,FAYETTEVILLE BEAUTY COLLEGE             ,NC,28303-0000,Proprietary  ,3,21,24,72,309,381
02227800,MITCHELL'S HAIR STYLING ACADEMY         ,NC,27534-0000,Proprietary  ,0,1,1,9,34,43
02227900,MITCHELL'S HAIR STYLING ACADEMY         ,NC,27858-0000,Proprietary  ,1,6,7,21,63,84
02238700,HAIRSTYLING INSTITUTE OF CHARLOTTE      ,NC,28204-0000,Proprietary  ,7,33,40,98,326,424
02280900,MID-ATLANTIC CHRISTIAN UNIVERSITY       ,NC,27909-0000,Private      ,0,7,7,126,124,250
02326203,KAPLAN CAREER INSTITUTE - KAPLAN COLLEGE,NC,28212-6830,Proprietary  ,24,193,217,89,574,663
02560600,PINNACLE INSTITUTE OF COSMETOLOGY       ,NC,28115-8020,Proprietary  ,3,16,19,55,116,171
02614201,MILLER-MOTTE BUSINESS COLLEGE           ,NC,28403-0000,Proprietary  ,59,422,481,509,2933,3442
02614205,MILLER - MOTTE TECHNICAL COLLEGE - MILLE,NC,27834-5052,Proprietary  ,17,94,111,220,1162,1382
03009500,WINSTON-SALEM BARBER SCHOOL             ,NC,27107-0000,Proprietary  ,4,17,21,80,176,256
03064400,REGENCY BEAUTY INSTITUTE                ,NC,27127-0000,Proprietary  ,9,45,54,241,504,745
03089300,HERITAGE BIBLE COLLEGE                  ,NC,28335-0000,Private      ,1,4,5,25,100,125
03104200,CAROLINAS COLLEGE OF HEALTH SCIENCE     ,NC,28232-2861,Public       ,3,56,59,326,1296,1622
03109000,LIVING ARTS COLLEGE                     ,NC,27614-7076,Proprietary  ,39,82,121,514,695,1209
03109001,LIVING ARTS INSTITUTE                   ,NC,27107-3217,Proprietary  ,0,0,0,44,102,146
03361300,MEDICAL ARTS MASSAGE SCHOOL             ,NC,27616-6453,Proprietary  ,2,34,36,52,334,386
03513400,APEX SCHOOL OF THEOLOGY                 ,NC,27703-8024,Private      ,9,103,112,38,947,985
03555300,SOUTHEASTERN INSTITUTE                  ,NC,28217-0000,Proprietary  ,18,110,128,151,798,949
03555400,SOUTHEASTERN SCHOOL OF NEUROMUSCULAR  MA,NC,29406-0000,Proprietary  ,18,65,83,84,308,392
03570300,CAROLINA CHRISTIAN COLLEGE              ,NC,27105-3241,Private      ,1,8,9,14,114,128
03663300,HOOD THEOLOGICAL SEMINARY               ,NC,28144-5768,Private      ,0,10,10,3,254,257
03748500,LA SHE'S BEAUTY ACADEMY                 ,NC,27707-3569,Proprietary  ,1,20,21,38,161,199
03777300,CAROLINA ACAD OF COSMETIC ART & SCI     ,NC,28054-0460,Proprietary  ,22,50,72,118,339,457
03827300,NEW LIFE THEOLOGICAL SEMINARY           ,NC,28205-1648,Private      ,1,19,20,10,201,211
04098300,TECHSKILLS - CHARLOTTE                  ,NC,28217-0000,Proprietary  ,0,47,47,65,439,504
04101300,CAROLINA SCHOOL OF BROADCASTING         ,NC,28214-8085,Proprietary  ,3,21,24,87,302,389
04115700,REGINA'S COLLEGE OF BEAUTY              ,NC,28110-2831,Proprietary  ,4,42,46,44,278,322
04120300,"FILA ACADEMY, THE                       ",NC,27265-3114,Proprietary  ,1,14,15,32,122,154
04129400,CENTER FOR MASSAGE & NATURAL HEALTH     ,NC,28787-8331,Proprietary  ,5,19,24,34,139,173
04140700,AVEDA INSTITUTE CHAPEL HILL             ,NC,27516-2559,Proprietary  ,18,33,51,158,319,477
04143500,CHARLOTTE SCHOOL OF LAW                 ,NC,28208-2816,Proprietary  ,2,40,42,63,1994,2057
04146400,DAOIST TRADITIONS COLLEGE OF CHINESE MED,NC,28801-1060,Proprietary  ,0,3,3,1,102,103
04149300,PARK WEST BARBER SCHOOL                 ,NC,27701-4022,Proprietary  ,7,39,46,55,235,290
04154200,CAROLINA BIBLE COLLEGE                  ,NC,29303-5157,Private      ,2,28,30,5,79,84
04172800,BODY THERAPY INSTITUTE                  ,NC,27344-6728,Proprietary  ,3,27,30,5,57,62
04173700,GRACE COLLEGE OF DIVINITY               ,NC,28314-2343,Private      ,2,3,5,2,3,5
04178100,CAROLINA COLLEGE OF HAIR DESIGN         ,NC,28802-1232,Proprietary  ,6,25,31,6,26,32
00298800,BISMARCK STATE COLLEGE                  ,ND,58501-1299,Public       ,36,94,130,2160,1853,4013
00298900,DICKINSON STATE UNIVERSITY              ,ND,58601-4896,Public       ,15,29,44,1219,833,2052
00299000,JAMESTOWN COLLEGE                       ,ND,58405-3401,Private      ,6,6,12,984,158,1142
00299100,LAKE REGION STATE COLLEGE               ,ND,58301-1598,Public       ,3,30,33,387,480,867
00299200,UNIVERSITY OF MARY                      ,ND,58504-9652,Private      ,14,85,99,1550,1691,3241
00299300,MAYVILLE STATE UNIVERSITY               ,ND,58257-1299,Public       ,7,26,33,581,346,927
00299400,MINOT STATE UNIVERSITY                  ,ND,58707-0002,Public       ,13,64,77,1627,1610,3237
00299500,DAKOTA COLLEGE AT BOTTINEAU             ,ND,58318-1159,Public       ,5,22,27,327,338,665
00299600,NORTH DAKOTA STATE CLG OF SCIENCE       ,ND,58076-0002,Public       ,13,37,50,1529,839,2368
00299700,NORTH DAKOTA STATE UNIVERSITY           ,ND,58108-6050,Public       ,96,114,210,9732,3134,12866
00300500,UNIVERSITY OF NORTH DAKOTA              ,ND,58202-8193,Public       ,69,182,251,8038,5317,13355
00300700,WILLISTON STATE COLLEGE                 ,ND,58802-1326,Public       ,12,26,38,291,431,722
00300800,VALLEY CITY STATE UNIVERSITY            ,ND,58072-0000,Public       ,9,24,33,758,381,1139
00775600,JOSEF'S SCHOOL OF HAIR DESIGN INC       ,ND,58102-4977,Proprietary  ,5,8,13,93,111,204
00869408,RASMUSSEN COLLEGE - FARGO               ,ND,58103-7196,Proprietary  ,28,113,141,355,1454,1809
00869415,RASMUSSEN COLLEGE - BISMARCK            ,ND,58503-0000,Proprietary  ,3,44,47,147,692,839
00935400,MEDCENTER ONE COLLEGE OF NURSING        ,ND,58501-4494,Private      ,2,2,4,78,85,163
01040600,JOSEF'S SCHOOL OF HAIR DESIGN           ,ND,58201-6394,Proprietary  ,4,20,24,64,103,167
01205900,TRINITY BIBLE COLLEGE                   ,ND,58436-7150,Private      ,2,4,6,244,142,386
01229500,JZ TREND ACADEMY PAUL MITCHELL PARTNER S,ND,58501-0000,Proprietary  ,3,3,6,54,62,116
02188200,SITTING BULL COLLEGE                    ,ND,58538-9701,Public       ,6,24,30,76,374,450
02236500,LITTLE HOOP COMMUNITY COLLEGE           ,ND,58335-0000,Public       ,17,72,89,48,258,306
02242900,UNITED TRIBES TECHNICAL COLLEGE         ,ND,58504-0000,Private      ,15,46,61,278,866,1144
02298200,HEADQUARTERS ACADEMY OF HAIR DESIGN     ,ND,58701-0000,Proprietary  ,0,9,9,22,81,103
02301100,TURTLE MTN CMNTY COLG-FIN AID OFC       ,ND,58316-0000,Private      ,18,59,77,277,693,970
02553700,FORT BERTHOLD COMMUNITY COLLEGE         ,ND,58763-0000,Public       ,13,34,47,56,210,266
03087200,MOLER BARBER CLG OF HAIRSTYLING         ,ND,58103-0000,Proprietary  ,0,1,1,3,25,28
04031300,SALON PROFESSIONAL ACADEMY (THE)        ,ND,58103-3337,Proprietary  ,3,8,11,72,87,159
04139400,HAIR ACADEMY (THE)                      ,ND,58501-4929,Proprietary  ,1,4,5,60,58,118
00301005,ANTIOCH UNIV/SEATTLE                    ,WA,98121-0000,Private      ,4,62,66,81,1382,1463
00376900,BELLEVUE COLLEGE                        ,WA,98007-6484,Public       ,248,655,903,4751,8437,13188
00377000,BIG BEND COMMUNITY COLLEGE              ,WA,98837-3299,Public       ,43,143,186,1137,1947,3084
00377100,"CENTRAL WASHINGTON UNIV., FIN AID       ",WA,98926-7495,Public       ,208,198,406,10734,5399,16133
00377200,CENTRALIA COLLEGE                       ,WA,98531-4099,Public       ,56,224,280,1252,2621,3873
00377300,CLARK COLLEGE                           ,WA,98663-3598,Public       ,339,1148,1487,5738,12218,17956
00377400,COLUMBIA BASIN COLLEGE                  ,WA,99301-3379,Public       ,147,395,542,2926,4800,7726
00377500,EASTERN WASHINGTON UNIVERSITY           ,WA,99004-2447,Public       ,192,341,533,9643,7109,16752
00377600,EVERETT COMMUNITY COLLEGE               ,WA,98201-1352,Public       ,207,720,927,2994,7202,10196
00377700,HERITAGE UNIVERSITY                     ,WA,98948-9562,Private      ,5,34,39,472,1650,2122
00377800,GONZAGA UNIVERSITY                      ,WA,99258-0083,Private      ,83,170,253,7862,4554,12416
00377900,GRAYS HARBOR COLLEGE                    ,WA,98520-7599,Public       ,42,182,224,909,2085,2994
00378000,GREEN RIVER COMMUNITY COLLEGE           ,WA,98092-3622,Public       ,216,580,796,3376,6442,9818
00378100,HIGHLINE COMMUNITY COLLEGE              ,WA,98198-9800,Public       ,190,624,814,3422,6874,10296
00378200,LOWER COLUMBIA COLLEGE                  ,WA,98632-0310,Public       ,99,364,463,1385,4091,5476
00378300,NORTHWEST UNIVERSITY                    ,WA,98083-0000,Private      ,17,61,78,1288,1079,2367
00378400,OLYMPIC COLLEGE                         ,WA,98337-1600,Public       ,122,450,572,2248,6064,8312
00378500,PACIFIC LUTHERAN UNIVERSITY             ,WA,98447-0003,Private      ,51,92,143,4606,1938,6544
00378600,PENINSULA COLLEGE                       ,WA,98362-6660,Public       ,38,205,243,678,2106,2784
00378700,SEATTLE CENTRAL COMMUNITY COLLEGE       ,WA,98122-2413,Public       ,175,636,811,3349,8336,11685
00378703,SEATTLE VOCATIONAL INSTITUTE            ,WA,98144-0000,Public       ,15,134,149,126,797,923
00378800,SEATTLE PACIFIC UNIVERSITY              ,WA,98119-1997,Private      ,96,97,193,5999,2650,8649
00379000,SEATTLE UNIVERSITY                      ,WA,98122-1090,Private      ,111,228,339,8698,7633,16331
00379100,SHORELINE COMMUNITY COLLEGE             ,WA,98133-5696,Public       ,89,389,478,2335,5091,7426
00379200,SKAGIT VALLEY COLLEGE                   ,WA,98273-5899,Public       ,104,358,462,1817,4123,5940
00379300,SPOKANE COMMUNITY COLLEGE               ,WA,99207-5399,Public       ,247,1081,1328,4539,12303,16842
00379400,ST MARTIN'S UNIVERSITY                  ,WA,98503-7500,Private      ,13,77,90,1466,1314,2780
00379600,TACOMA COMMUNITY COLLEGE                ,WA,98466-6100,Public       ,211,864,1075,3688,10102,13790
00379700,UNIVERSITY OF PUGET SOUND               ,WA,98416-1039,Private      ,52,73,125,4972,1556,6528
00379800,UNIVERSITY OF WASHINGTON                ,WA,98195-5880,Public       ,546,936,1482,32244,29399,61643
00379900,WALLA WALLA UNIVERSITY                  ,WA,99324-1198,Private      ,31,34,65,1610,797,2407
00380000,WASHINGTON STATE UNIVERSITY             ,WA,99164-1035,Public       ,349,464,813,21785,13241,35026
00380100,WENATCHEE VALLEY COLLEGE                ,WA,98801-1799,Public       ,85,274,359,1673,3330,5003
00380200,WESTERN WASHINGTON UNIVERSITY           ,WA,98225-5946,Public       ,225,186,411,16099,5001,21100
00380300,WHITMAN COLLEGE                         ,WA,99362-2067,Private      ,19,4,23,2936,109,3045
00380400,WHITWORTH UNIVERSITY                    ,WA,99251-0001,Private      ,41,85,126,4326,1445,5771
00380500,YAKIMA VALLEY COMMUNITY COLLEGE         ,WA,98907-2520,Public       ,107,303,410,3091,5422,8513
00499900,BELLINGHAM TECHNICAL COLLEGE            ,WA,98225-0000,Public       ,59,223,282,1025,3349,4374
00500000,PIERCE COLLEGE                          ,WA,98498-1919,Public       ,200,755,955,3765,8806,12571
00500100,EDMONDS COMMUNITY COLLEGE               ,WA,98036-5999,Public       ,134,546,680,2660,6018,8678
00500600,WALLA WALLA COMMUNITY COLLEGE           ,WA,99362-9267,Public       ,80,201,281,1785,3114,4899
00530600,BATES TECHNICAL COLLEGE                 ,WA,98405-0000,Public       ,96,399,495,940,4002,4942
00537200,SOUTH PUGET SOUND COMMUNITY COLLEGE     ,WA,98512-6292,Public       ,114,438,552,2499,5924,8423
00537300,LAKE WASHINGTON TECHNICAL COLLEGE       ,WA,98034-8505,Public       ,48,294,342,876,3352,4228
00575200,CLOVER PARK TECHNICAL COLLEGE           ,WA,98499-0000,Public       ,133,557,690,1668,6772,8440
00815500,EVERGREEN STATE COLLEGE (THE)           ,WA,98505-0002,Public       ,74,179,253,4054,4390,8444
00907901,EVEREST COLLEGE                         ,WA,98684-6950,Proprietary  ,17,69,86,172,744,916
00938700,PERRY TECHNICAL INSTITUTE               ,WA,98903-1239,Private      ,30,74,104,632,1136,1768
00954400,SPOKANE FALLS COMMUNITY COLLEGE         ,WA,99224-5204,Public       ,216,707,923,4715,8012,12727
00970400,NORTH SEATTLE COMMUNITY COLLEGE         ,WA,98103-3599,Public       ,81,541,622,1768,5618,7386
00970600,SOUTH SEATTLE COMMUNITY COLLEGE         ,WA,98106-1499,Public       ,116,398,514,1968,4945,6913
00973900,GLEN DOW ACAD OF HAIR DESIGN            ,WA,99201-0209,Proprietary  ,21,46,67,141,301,442
01036400,WHATCOM COMMUNITY COLLEGE               ,WA,98226-8003,Public       ,102,260,362,2379,3518,5897
01043400,RENTON TECHNICAL COLLEGE                ,WA,98056-0000,Public       ,67,283,350,1038,3797,4835
01148100,DIVERS INSTITUTE OF TECHNOLOGY          ,WA,98107-0000,Proprietary  ,24,68,92,195,630,825
01231500,CORNISH COLLEGE OF THE ARTS             ,WA,98121-4604,Private      ,16,20,36,1589,499,2088
01249600,"BEAUTIWORKS SEATTLE, LLC                ",WA,98133-5615,Proprietary  ,5,12,17,47,132,179
01260100,NORTHWEST BAPTIST SEMINARY              ,WA,98402-6699,Private      ,1,3,4,8,41,49
01302200,CITY UNIVERSITY OF SEATTLE              ,WA,98005-3030,Private      ,13,172,185,206,2893,3099
01309400,BELLINGHAM BEAUTY SCHOOL                ,WA,98225-0000,Proprietary  ,4,18,22,49,121,170
02091701,KAPLAN COLLEGE - SEATTLE                ,WA,98055-4910,Proprietary  ,0,0,0,8,57,65
02105300,BELLEVUE BEAUTY SCHOOL                  ,WA,98007-0000,Proprietary  ,8,27,35,83,202,285
02106700,TRINITY LUTHERAN COLLEGE                ,WA,98201-3569,Private      ,9,9,18,169,121,290
02180000,NORTHWEST INDIAN COLLEGE                ,WA,98226-9278,Public       ,24,96,120,207,804,1011
02184200,PAROBA COLLEGE OF COSMETOLOGY           ,WA,98208-0000,Proprietary  ,9,29,38,75,155,230
02202200,STYLEMASTERS COLLEGE OF HAIR DESIGN     ,WA,98632-0000,Proprietary  ,10,26,36,49,137,186
02203300,GENE JUAREZ ACADEMY OF BEAUTY           ,WA,98125-0000,Proprietary  ,48,97,145,406,696,1102
02203301,GENE JUAREZ ACADEMY OF BEAUTY           ,WA,98003-0000,Proprietary  ,0,0,0,70,127,197
02222900,INTERNATIONAL AIR & HOSPITALITY ACADEMY ,WA,98661-4835,Proprietary  ,48,117,165,307,673,980
02222906,INTERNATIONAL AIR & HOSPITALITY ACADEMY ,WA,98661-3805,Proprietary  ,0,0,0,19,25,44
02236800,PROFESSIONAL BEAUTY SCHOOL              ,WA,98902-0000,Proprietary  ,5,11,16,44,96,140
02242500,BASTYR UNIVERSITY                       ,WA,98028-0000,Private      ,5,40,45,144,1392,1536
02242504,SEATTLE MIDWIFERY SCHOOL                ,WA,98144-0000,Private      ,0,0,0,9,124,133
02291300,ART INSTITUTE OF SEATTLE                ,WA,98121-1622,Proprietary  ,96,208,304,2746,2653,5399
02300100,EVEREST COLLEGE                         ,WA,98367-1835,Proprietary  ,15,99,114,167,674,841
02300103,EVEREST COLLEGE - EVERETT               ,WA,98208-2610,Proprietary  ,43,163,206,326,1211,1537
02300104,EVEREST COLLEGE - TACOMA                ,WA,98402-3004,Proprietary  ,54,278,332,421,1934,2355
02326500,INTERFACE COLLEGE                       ,WA,99201-4326,Proprietary  ,5,40,45,33,322,355
02331400,NORTHWEST HAIR ACADEMY                  ,WA,98273-0000,Proprietary  ,24,26,50,119,195,314
02331402,NORTHWEST HAIR ACADEMY - EVERETT        ,WA,98204-0000,Proprietary  ,3,6,9,33,59,92
02504900,ACADEMY OF HAIR DESIGN (THE)            ,WA,98801-0000,Proprietary  ,6,12,18,59,105,164
02541900,BJ'S BEAUTY AND BARBER COLLEGE          ,WA,98409-0000,Proprietary  ,9,47,56,56,259,315
02602100,NORTHWEST COLLEGE OF ART                ,WA,98370-8625,Proprietary  ,6,3,9,204,58,262
02606200,EVEREST COLLEGE                         ,WA,98055-2990,Proprietary  ,37,147,184,299,1218,1517
02617500,EVEREST COLLEGE                         ,WA,98133-9018,Proprietary  ,20,88,108,190,675,865
02617501,EVEREST COLLEGE - FIFE                  ,WA,98424-2649,Proprietary  ,7,11,18,59,216,275
02617503,EVEREST COLLEGE - VANCOUVER             ,WA,98684-6951,Proprietary  ,15,49,64,138,435,573
03031406,INTERNATIONAL ACADEMY OF DESIGN & TECH  ,WA,98188-3319,Proprietary  ,4,18,22,185,309,494
03065000,CLARE'S BEAUTY COLLEGE                  ,WA,99301-0000,Proprietary  ,7,21,28,66,176,242
03071800,ITT TECHNICAL INSTITUTE                 ,WA,99216-1589,Proprietary  ,88,356,444,709,2758,3467
03071805,ITT TECHNICAL INSTITUTE - SEATTLE       ,WA,98168-3346,Proprietary  ,93,334,427,677,2584,3261
03099000,CORTIVA INSTITUTE - SEATTLE             ,WA,98109-5474,Proprietary  ,15,41,56,136,442,578
03110800,BAKKE GRADUATE UNIVERSITY               ,WA,98104-1222,Private      ,0,3,3,3,53,56
03139500,MONTESSORI SCHOOLS OF WASHINGTON        ,WA,98203-6600,Private      ,0,1,1,3,18,21
03280300,SEATTLE INST OF ORIENTAL MEDICINE       ,WA,98115-0000,Proprietary  ,3,4,7,27,96,123
03283300,NORTHWEST HVAC/R ASSOCIATION & TRAINING ,WA,99202-2125,Private      ,0,8,8,22,104,126
03466400,MARS HILL GRADUATE SCHOOL               ,WA,98121-0000,Private      ,0,5,5,0,310,310
03483500,CASCADIA COMMUNITY COLLEGE              ,WA,98011-9510,Public       ,57,146,203,1101,1687,2788
03490400,EMIL FRIES PIANO HOSPITAL & TRAININ     ,WA,98661-4323,Private      ,0,0,0,5,24,29
03670301,TONI&GUY HAIRDRESSING ACADEMY -         ,WA,98225-4526,Proprietary  ,0,0,0,0,1,1
03689400,FAITH EVANGELICAL COLLEGE & SEMINARY    ,WA,98407-2607,Private      ,0,23,23,23,283,306
03724300,DIGIPEN INSTITUTE OF TECHNOLOGY         ,WA,98052-5170,Proprietary  ,6,10,16,754,407,1161
03917300,EVERGREEN BEAUTY AND BARBER COLLEGE     ,WA,98208-3759,Proprietary  ,20,43,63,122,336,458
03932500,TOTAL COSMETOLOGY TRAINING CENTER       ,WA,99217-6231,Proprietary  ,11,36,47,69,266,335
03953300,YAKIMA BEAUTY SCHOOL                    ,WA,98901-2202,Proprietary  ,7,8,15,44,94,138
04043400,ALPINE COLLEGE                          ,WA,99206-5097,Proprietary  ,8,45,53,86,452,538
04120000,SUNNYSIDE BEAUTY ACADEMY                ,WA,98944-8711,Proprietary  ,4,5,9,17,58,75
04127200,VICTORIA'S ACADEMY OF COSMETOLOGY       ,WA,99336-3826,Proprietary  ,11,12,23,74,191,265
04130500,PACIFIC NORTHWEST UNIV OF HEALTH SCIENCE,WA,98901-1471,Private      ,2,2,4,30,364,394
04130800,CASCADE BEAUTY COLLEGE                  ,WA,98002-5504,Proprietary  ,3,17,20,29,75,104
04132800,INLAND MASSAGE INSTITUTE                ,WA,99218-5016,Proprietary  ,5,23,28,44,158,202
04135200,NORTHWEST AVIATION COLLEGE              ,WA,98002-1609,Proprietary  ,6,23,29,8,27,35
04149400,GARY MANUEL AVEDA INSTITUTE             ,WA,98122-3807,Proprietary  ,19,49,68,200,421,621
04149600,GP INSTITUTE OF COSMETOLOGY             ,WA,98118-2353,Proprietary  ,2,17,19,2,17,19
04155000,NORTHWEST SCHOOL OF WOODEN BOAT BUILDING,WA,98339-8706,Private      ,0,4,4,8,71,79
04161200,BAINBRIDGE GRADUATE INSTITUTE           ,WA,98110-2870,Private      ,0,5,5,0,161,161
04170100,SALON PROFESSIONAL ACADEMY (THE)        ,WA,98409-7360,Proprietary  ,8,23,31,58,147,205
04172900,ACADEMY OF COSMETOLOGY                  ,WA,99354-2651,Proprietary  ,3,13,16,6,29,35
00340100,BROWN UNIVERSITY                        ,RI,02912-9127,Private      ,132,11,143,20032,776,20808
00340101,BROWN UNIVERSITY - GRADUATE SCHOOL      ,RI,02912-1827,Private      ,5,25,30,92,1698,1790
00340102,BROWN MEDICAL SCHOOL                    ,RI,02912-0000,Private      ,0,3,3,27,476,503
00340200,BRYANT UNIVERSITY                       ,RI,02917-1284,Private      ,42,30,72,5046,546,5592
00340400,JOHNSON & WALES UNIVERSITY              ,RI,02903-3703,Private      ,232,209,441,20189,5295,25484
00340600,PROVIDENCE COLLEGE                      ,RI,02918-0001,Private      ,57,45,102,7675,886,8561
00340700,RHODE ISLAND COLLEGE                    ,RI,02908-1991,Public       ,94,162,256,7759,4356,12115
00340800,COMMUNITY COLLEGE OF RI - WARWICK       ,RI,02906-0000,Public       ,155,395,550,6238,8338,14576
00340801,COMMUNITY COLLEGE OF RI - LINCOLN       ,RI,02865-4585,Public       ,61,136,197,2063,2625,4688
00340802,COMMUNITY COLLEGE OF RI- PROVIDENCE     ,RI,02905-2313,Public       ,36,92,128,1694,2507,4201
00340900,RHODE ISLAND SCHOOL OF DESIGN           ,RI,02903-2784,Private      ,26,27,53,2810,1548,4358
00341000,ROGER WILLIAMS UNIVERSITY               ,RI,02809-2921,Private      ,72,41,113,8083,1826,9909
00341100,SALVE REGINA UNIVERSITY                 ,RI,02840-4192,Private      ,28,38,66,4399,528,4927
00341400,UNIVERSITY OF RHODE ISLAND              ,RI,02881-0000,Public       ,191,164,355,21662,4618,26280
00659100,ST. JOSEPH HOSP SCH OF NURSING          ,RI,02904-5199,Private      ,0,12,12,61,197,258
00784500,NEW ENGLAND INSTITUTE OF TECHNOLOGY     ,RI,02886-2266,Private      ,97,250,347,2901,3076,5977
01115900,"SAWYER SCHOOL,THE                       ",RI,02860-4117,Proprietary  ,48,249,297,376,1773,2149
01164702,SBI CAMPUS - AN AFFILIATE OF SANFORD-BRO,RI,02920-7807,Proprietary  ,36,158,194,175,720,895
02071900,ARTHUR ANGELO SCH COSMET&HAIR DSGN      ,RI,02903-0000,Proprietary  ,6,26,32,118,254,372
02176900,WARWICK ACADEMY OF BEAUTY CULTURE       ,RI,02886-1534,Proprietary  ,11,20,31,91,178,269
02584400,NEW ENGLAND TRACTOR TRAILER TRAINING SCH,RI,02860-1752,Proprietary  ,36,310,346,90,805,895
03080000,NEWPORT SCHOOL OF HAIRDRESSING          ,RI,02860-4038,Proprietary  ,4,14,18,20,105,125
03232300,LINCOLN TECHNICAL INSTITUTE             ,RI,02865-4211,Proprietary  ,57,186,243,649,1611,2260
03732300,INTERNATIONAL YACHT RESTORATION SCH     ,RI,02840-6720,Private      ,0,1,1,23,38,61
04141200,TONI & GUY HAIRDRESSING ACADEMY         ,RI,02920-0000,Proprietary  ,9,12,21,124,108,232
00341700,ALLEN UNIVERSITY                        ,SC,29204-1085,Private      ,17,16,33,1404,600,2004
00341800,ANDERSON UNIVERSITY                     ,SC,29621-4035,Private      ,16,64,80,2364,1192,3556
00341900,CHARLESTON SOUTHERN UNIVERSITY          ,SC,29406-2160,Private      ,58,117,175,4179,2448,6627
00342000,BENEDICT COLLEGE                        ,SC,29204-1086,Private      ,62,41,103,4508,1610,6118
00342100,BOB JONES UNIVERSITY                    ,SC,29614-1000,Proprietary  ,44,22,66,3049,498,3547
00342200,SOUTHERN WESLEYAN UNIVERSITY            ,SC,29630-1020,Private      ,9,145,154,1013,2002,3015
00342300,THE CITADEL                             ,SC,29409-0002,Public       ,62,62,124,2685,1268,3953
00342400,CLAFLIN UNIVERSITY                      ,SC,29115-4498,Private      ,26,47,73,2830,1112,3942
00342500,CLEMSON UNIVERSITY                      ,SC,29634-0001,Public       ,181,118,299,17480,4161,21641
00342600,UNIV OF SC AT SUMTER                    ,SC,29150-2498,Public       ,11,37,48,831,760,1591
00342700,COKER COLLEGE                           ,SC,29550-3797,Private      ,10,25,35,1101,961,2062
00342800,COLLEGE OF CHARLESTON                   ,SC,29424-0100,Public       ,121,81,202,10801,3159,13960
00342900,COLUMBIA INTERNATIONAL UNIVERSITY       ,SC,29203-1599,Private      ,6,39,45,623,823,1446
00343000,COLUMBIA COLLEGE                        ,SC,29203-5998,Private      ,20,63,83,1493,1456,2949
00343100,CONVERSE COLLEGE                        ,SC,29302-0006,Private      ,5,31,36,885,877,1762
00343200,ERSKINE COLLEGE                         ,SC,29639-0000,Private      ,7,3,10,720,67,787
00343201,ERSKINE THEOLOGICAL SEMINARY            ,SC,29639-0000,Private      ,0,3,3,5,147,152
00343400,FURMAN UNIVERSITY                       ,SC,29613-5253,Private      ,27,23,50,3520,546,4066
00343500,LANDER UNIVERSITY                       ,SC,29649-2099,Public       ,32,28,60,4015,1024,5039
00343600,LIMESTONE COLLEGE                       ,SC,29340-3799,Private      ,17,133,150,1442,3343,4785
00343700,LUTHERAN THEOLOGICAL SOUTHERN SEM       ,SC,29203-5898,Private      ,0,3,3,5,148,153
00343800,MEDICAL UNIV OF SOUTH CAROLINA - FA     ,SC,29425-1760,Public       ,3,76,79,284,3205,3489
00343900,MORRIS COLLEGE                          ,SC,29150-3599,Private      ,18,20,38,1583,621,2204
00344000,NEWBERRY COLLEGE                        ,SC,29108-2197,Private      ,15,11,26,1866,364,2230
00344100,NORTH GREENVILLE COLLEGE                ,SC,29688-1892,Private      ,12,15,27,2428,478,2906
00344500,PRESBYTERIAN COLLEGE                    ,SC,29325-2503,Private      ,15,8,23,1557,259,1816
00344600,SOUTH CAROLINA STATE UNIVERSITY         ,SC,29117-4427,Public       ,90,79,169,6698,3057,9755
00344700,SPARTANBURG METHODIST COLLEGE           ,SC,29301-5899,Private      ,13,5,18,1352,243,1595
00344800,UNIVERSITY OF SOUTH CAROLINA            ,SC,29208-3999,Public       ,206,311,517,23161,12818,35979
00344900,UNIVERSITY OF SOUTH CAROLINA AIKEN      ,SC,29801-6399,Public       ,26,35,61,3432,1491,4923
00345000,UNIV OF SC AT BEAUFORT                  ,SC,29902-4602,Public       ,15,43,58,1543,1205,2748
00345100,COASTAL CAROLINA UNIVERSITY             ,SC,29528-0000,Public       ,121,103,224,12027,2843,14870
00345300,UNIV OF SC AT LANCASTER                 ,SC,29721-0889,Public       ,15,32,47,945,816,1761
00345400,UNIV OF SC SYSTEM SALKEHATCHIE          ,SC,29810-0617,Public       ,13,46,59,650,849,1499
00345500,VOORHEES COLLEGE                        ,SC,29042-0000,Private      ,12,18,30,1153,461,1614
00345600,WINTHROP UNIVERSITY                     ,SC,29733-0001,Public       ,59,76,135,6163,2521,8684
00345700,WOFFORD COLLEGE                         ,SC,29303-3663,Private      ,15,11,26,2140,209,2349
00399000,FLORENCE-DARLINGTON TECH COLLEGE        ,SC,29501-0548,Public       ,107,298,405,3335,6706,10041
00399100,GREENVILLE TECHNICAL COLLEGE            ,SC,29607-2439,Public       ,177,606,783,8334,14935,23269
00399200,PIEDMONT TECHNICAL COLLEGE              ,SC,29648-1467,Public       ,99,341,440,2490,6026,8516
00399300,MIDLANDS TECHNICAL COLLEGE              ,SC,29202-0000,Public       ,150,619,769,7498,13184,20682
00399400,SPARTANBURG COMMUNITY COLLEGE           ,SC,29305-4386,Public       ,84,272,356,3562,6234,9796
00399500,CENTRAL CAROLINA TECHNICAL COLLEGE      ,SC,29150-2499,Public       ,68,318,386,1773,4954,6727
00399600,YORK TECHNICAL COLLEGE                  ,SC,29730-3395,Public       ,80,400,480,3048,6736,9784
00492000,TRIDENT TECHNICAL COLLEGE               ,SC,29423-8067,Public       ,247,854,1101,7338,15060,22398
00492300,CLINTON JR COLLEGE                      ,SC,29730-5152,Private      ,6,5,11,164,120,284
00492400,FORREST JUNIOR COLLEGE                  ,SC,29624-2405,Proprietary  ,4,34,38,42,285,327
00492500,HORRY-GEORGETOWN TECH COLLEGE           ,SC,29526-9521,Public       ,97,355,452,4009,8269,12278
00492600,TRI-COUNTY TECHNICAL COLLEGE            ,SC,29670-9133,Public       ,80,236,316,4303,5404,9707
00492700,UNIV OF SC AT UNION                     ,SC,29379-0729,Public       ,4,11,15,297,338,635
00499204,MILLER-MOTTE TECHNICAL COLLEGE - CONWAY ,SC,29526-9508,Proprietary  ,21,147,168,118,676,794
00536300,DENMARK TECHNICAL COLLEGE               ,SC,29042-0000,Public       ,76,134,210,949,1310,2259
00681500,ORANGEBURG-CALHOUN TECHNICAL COLG       ,SC,29118-8299,Public       ,85,125,210,1624,2920,4544
00695100,UNIVERSITY OF SOUTH CAROLINA UPSTATE    ,SC,29303-9972,Public       ,49,72,121,5972,3260,9232
00760200,NORTHEASTERN TECHNICAL COLLEGE          ,SC,29520-7015,Public       ,30,65,95,644,1435,2079
00922600,FRANCIS MARION UNIVERSITY               ,SC,29501-0000,Public       ,41,67,108,4884,2188,7072
00932200,WILLIAMSBURG TECHNICAL COLLEGE          ,SC,29556-4197,Public       ,18,46,64,383,923,1306
00991000,TECHNICAL COLLEGE OF THE LOWCOUNTRY     ,SC,29902-5441,Public       ,45,210,255,1120,3533,4653
00991100,UNIV OF SC-REGIONAL CAMPUSES ADMIN      ,SC,29208-0001,Public       ,0,9,9,116,134,250
01005600,AIKEN TECHNICAL COLLEGE                 ,SC,29802-0696,Public       ,59,200,259,2076,4160,6236
01031906,MEDIX SCHOOL - FORTIS COLLEGE           ,SC,29210-0000,Proprietary  ,0,0,0,12,44,56
01209200,KENNETH SHULER SCHOOL OF COSMETOLOGY    ,SC,29732-2169,Proprietary  ,15,51,66,129,283,412
01303907,SOUTH UNIVERSITY                        ,SC,29203-6400,Proprietary  ,29,271,300,588,3290,3878
02063700,SHERMAN CLG STRAIGHT CHIROPRACTIC       ,SC,29316-0000,Private      ,0,1,1,18,249,267
02189800,NO AMER INST OF AVIATION OF SO CAR      ,SC,29527-0000,Proprietary  ,0,0,0,8,24,32
02338600,CHARZANNE BEAUTY COLLEGE                ,SC,29649-0000,Proprietary  ,1,11,12,20,94,114
02341100,KENNETH SHULER SCHOOL OF COSMETOLOGY & N,SC,29210-0000,Proprietary  ,15,106,121,196,742,938
02356600,CHARLESTON COSMETOLOGY INSTITUTE        ,SC,29420-0000,Proprietary  ,8,32,40,85,180,265
02552400,ACADEMY OF HAIR TECHNOLOGY              ,SC,29615-2363,Proprietary  ,6,14,20,79,179,258
02567600,SUMTER BEAUTY COLLEGE                   ,SC,29150-0000,Proprietary  ,2,9,11,33,109,142
02614202,MILLER - MOTTE TECHNICAL COLLEGE - NORTH,SC,29406-9239,Proprietary  ,11,126,137,322,1305,1627
03010614,VIRGINIA COLLEGE - GOLF ACADEMY OF AMERI,SC,29579-0000,Proprietary  ,19,28,47,221,388,609
03010617,VIRGINIA COLLEGE - GREENVILLE           ,SC,29607-7200,Proprietary  ,24,146,170,343,1650,1993
03010620,VIRGINIA COLLEGE - CHARLESTON           ,SC,29406-4999,Proprietary  ,23,145,168,257,1282,1539
03010621,VIRGINIA COLLEGE - COLUMBIA             ,SC,29223-7527,Proprietary  ,22,155,177,182,1052,1234
03052300,KENNETH SHULER SCH COSM & HAIR DESG     ,SC,29841-2013,Proprietary  ,6,47,53,96,370,466
03088300,ACADEMY OF COSMETOLOGY                  ,SC,29418-5667,Proprietary  ,2,30,32,58,201,259
03293300,STRAND COLLEGE OF HAIR DESIGN           ,SC,29572-4310,Proprietary  ,4,16,20,47,153,200
03304300,CENTURA COLLEGE                         ,SC,29406-9235,Proprietary  ,20,192,212,186,1365,1551
03513300,LACY COSMETOLOGY SCHOOL                 ,SC,29803-9084,Proprietary  ,2,9,11,27,79,106
03513301,LACY COSMETOLOGY SCHOOL -               ,SC,29072-0000,Proprietary  ,2,7,9,13,67,80
03513302,LACY COSMETOLOGY SCHOOL -               ,SC,29445-0000,Proprietary  ,3,9,12,23,79,102
03595300,CHARLESTON SCHOOL OF MASSAGE            ,SC,29412-8270,Proprietary  ,2,4,6,24,72,96
03709301,EDWARD VIA VIRGINIA COLLEGE OF OSTEOPATH,SC,29303-3639,Private      ,3,16,19,3,16,19
03746300,LEGRAND INSTITUTE OF COSMETOLOGY        ,SC,29020-0000,Proprietary  ,3,12,15,28,73,101
03746400,SOUTHEASTERN INSTITUTE                  ,SC,29210-0000,Proprietary  ,6,47,53,81,442,523
03768400,STYLETRENDS BARBER AND HAIRSTYLING ACADE,SC,29730-4511,Proprietary  ,2,7,9,27,98,125
03856400,W. L. BONNER COLLEGE                    ,SC,29203-0000,Private      ,0,9,9,5,71,76
03892300,HARLEY'S BEAUTY & BARBER CAREER INST.   ,SC,29204-1919,Proprietary  ,2,11,13,36,115,151
04083300,MARION COUNTY TECHNICAL EDUCATION CENTER,SC,29571-0000,Public       ,0,2,2,14,135,149
04096300,CHARLESTON SCHOOL OF LAW                ,SC,29402-0535,Proprietary  ,1,11,12,23,1359,1382
04158100,AIKEN SCHOOL OF COSMETOLOGY             ,SC,29801-4026,Proprietary  ,1,10,11,36,88,124
04166900,COSMETIC ARTS INSTITUTE                 ,SC,29488-2753,Proprietary  ,2,6,8,2,6,8
04172600,SALON 496 BARBER ACADEMY                ,SC,29607-2548,Proprietary  ,6,21,27,10,55,65
00345800,AUGUSTANA COLLEGE                       ,SD,57197-0001,Private      ,9,12,21,1871,271,2142
00345900,BLACK HILLS STATE UNIVERSITY            ,SD,57799-9670,Public       ,26,69,95,2472,2017,4489
00346100,DAKOTA WESLEYAN UNIVERSITY              ,SD,57301-4398,Private      ,2,5,7,647,312,959
00346300,DAKOTA STATE UNIVERSITY                 ,SD,57042-1799,Public       ,11,21,32,1290,841,2131
00346500,MOUNT MARTY COLLEGE                     ,SD,57078-3724,Private      ,4,14,18,557,535,1092
00346600,NORTHERN STATE UNIVERSITY               ,SD,57401-7198,Public       ,5,20,25,1603,806,2409
00346700,PRESENTATION COLLEGE                    ,SD,57401-1299,Private      ,3,20,23,349,497,846
00346900,UNIVERSITY OF SIOUX FALLS               ,SD,57105-1699,Private      ,14,42,56,1318,649,1967
00347000,SOUTH DAKOTA SCH OF MINES & TECH        ,SD,57701-3995,Public       ,13,27,40,1483,721,2204
00347100,SOUTH DAKOTA STATE UNIVERSITY           ,SD,57007-2298,Public       ,55,94,149,8426,3336,11762
00347400,UNIVERSITY OF SOUTH DAKOTA              ,SD,57069-2390,Public       ,56,147,203,4936,4831,9767
00405600,SIOUX FALLS SEMINARY                    ,SD,57105-2729,Private      ,0,3,3,3,88,91
00405700,NATIONAL AMERICAN UNIVERSITY            ,SD,57701-3692,Proprietary  ,100,1359,1459,999,11576,12575
00405707,NATIONAL AMERICAN UNIVERSITY            ,SD,57105-0000,Proprietary  ,5,38,43,78,525,603
00492900,MCKENNAN HOSP-RADOLOGICAL TECH          ,SD,57101-0000,Private      ,0,2,2,23,29,52
00530900,LAKE AREA TECHNICAL INSTITUTE           ,SD,57201-2869,Public       ,11,17,28,959,652,1611
00598700,AVERA SACRED HEART HOSPITAL SCHOOL OF RA,SD,57078-3899,Private      ,0,2,2,6,17,23
00776400,SOUTHEAST TECHNICAL INST                ,SD,57107-0000,Public       ,44,86,130,1536,1719,3255
00828400,MITCHELL TECHNICAL INSTITUTE            ,SD,57301-2002,Public       ,5,12,17,719,481,1200
01013800,STEWART SCHOOL                          ,SD,57104-0000,Proprietary  ,10,16,26,106,117,223
01014804,COLORADO TECHNICAL UNIVERSITY           ,SD,57108-2272,Proprietary  ,17,99,116,321,1497,1818
01017000,WESTERN DAKOTA TECHNICAL INSTITUTE      ,SD,57701-4018,Public       ,14,63,77,596,1237,1833
01147701,SIOUX VALLEY HOSP-MEDICAL TECH          ,SD,57117-5039,Private      ,0,4,4,16,33,49
01465900,OGLALA LAKOTA COLLEGE                   ,SD,57752-0490,Public       ,41,211,252,366,1742,2108
02137100,BLACK HILLS BEAUTY COLLEGE              ,SD,57701-0000,Proprietary  ,11,20,31,85,121,206
02143700,SINTE GLESKA UNIVERSITY                 ,SD,57570-0000,Public       ,24,119,143,147,764,911
02144600,KILIAN COMMUNITY COLLEGE                ,SD,57103-7020,Private      ,8,53,61,118,537,655
02277300,SISSETON WAHPETON COLLEGE               ,SD,57262-0000,Public       ,5,42,47,50,256,306
02297800,HEADLINES ACADEMY                       ,SD,57701-0000,Proprietary  ,7,20,27,53,148,201
00347700,AQUINAS COLLEGE                         ,TN,37205-2086,Private      ,3,13,16,279,980,1259
00347701,AQUINAS COLLEGE -  PRIMETIME PROGRAM    ,TN,37214-3644,Private      ,0,5,5,11,168,179
00347800,AUSTIN PEAY STATE UNIVERSITY            ,TN,37044-0002,Public       ,117,387,504,7980,8685,16665
00347900,BELMONT UNIVERSITY                      ,TN,37212-3757,Private      ,55,107,162,6296,3796,10092
00348000,BETHEL UNIVERSITY                       ,TN,38201-1705,Private      ,29,449,478,1696,4524,6220
00348100,CARSON-NEWMAN COLLEGE                   ,TN,37760-2204,Private      ,38,25,63,3265,834,4099
00348200,CHRISTIAN BROTHERS UNIVERSITY           ,TN,38104-5581,Private      ,32,76,108,2289,1836,4125
00348300,COLUMBIA STATE COMMUNITY COLLEGE        ,TN,38401-5653,Public       ,49,169,218,3250,4242,7492
00348500,CUMBERLAND UNIVERSITY                   ,TN,37087-3554,Private      ,22,44,66,1591,1290,2881
00348600,LIPSCOMB UNIVERSITY                     ,TN,37204-3951,Private      ,26,85,111,3373,2198,5571
00348700,EAST TENNESSEE STATE UNIV - MAIN CAMPUS ,TN,37614-2857,Public       ,133,263,396,11739,8480,20219
00348701,EAST TENNESSEE STATE UNIV - MEDICINE    ,TN,37614-1708,Public       ,7,13,20,316,617,933
00348709,EAST TENNESSEE STATE UNIV - PHARMACY    ,TN,37614-1704,Public       ,4,6,10,136,482,618
00349000,FISK UNIVERSITY                         ,TN,37208-3045,Private      ,25,20,45,1337,619,1956
00349200,FREED-HARDEMAN UNIVERSITY               ,TN,38340-2399,Private      ,11,36,47,1864,990,2854
00349400,HIWASSEE COLLEGE                        ,TN,37354-4001,Private      ,8,7,15,39,31,70
00349500,JOHNSON BIBLE COLLEGE                   ,TN,37998-9775,Private      ,5,9,14,658,419,1077
00349600,KING COLLEGE                            ,TN,37620-2699,Private      ,16,72,88,1330,1483,2813
00349800,LAMBUTH UNIVERSITY                      ,TN,38301-5296,Private      ,18,10,28,982,432,1414
00349900,LANE COLLEGE                            ,TN,38301-4598,Private      ,35,26,61,3461,1349,4810
00350000,LEE UNIVERSITY                          ,TN,37320-0000,Private      ,42,44,86,3846,1546,5392
00350100,LEMOYNE-OWEN COLLEGE                    ,TN,38126-6510,Private      ,33,94,127,1420,2135,3555
00350200,LINCOLN MEMORIAL UNIVERSITY             ,TN,37752-7920,Private      ,30,257,287,2013,4369,6382
00350400,MARTIN METHODIST COLLEGE                ,TN,38478-2799,Private      ,9,19,28,906,605,1511
00350500,MARYVILLE COLLEGE                       ,TN,37804-5907,Private      ,19,9,28,1868,333,2201
00350600,MEHARRY MEDICAL COLLEGE                 ,TN,37208-0000,Private      ,1,16,17,79,1438,1517
00350700,MEMPHIS COLLEGE OF ART                  ,TN,38104-2764,Private      ,15,7,22,737,361,1098
00350900,UNIVERSITY OF MEMPHIS (THE)             ,TN,38152-4611,Public       ,229,522,751,17154,19001,36155
00351000,MIDDLE TENNESSEE STATE UNIV             ,TN,37130-0000,Public       ,276,440,716,24053,14534,38587
00351100,MILLIGAN COLLEGE                        ,TN,37682-4001,Private      ,12,25,37,1175,644,1819
00351700,SOUTHERN COLLEGE OF OPTOMETRY           ,TN,38104-2222,Private      ,2,4,6,37,596,633
00351800,SOUTHERN ADVENTIST UNIVERSITY           ,TN,37315-0370,Private      ,32,20,52,2547,914,3461
00351900,RHODES COLLEGE                          ,TN,38112-1690,Private      ,46,18,64,3005,527,3532
00352200,TENNESSEE STATE UNIVERSITY              ,TN,37209-1561,Public       ,164,310,474,11757,10049,21806
00352300,TENNESSEE TECHNOLOGICAL UNIV            ,TN,38505-0001,Public       ,92,120,212,10191,4397,14588
00352400,TENNESSEE TEMPLE UNIVERSITY             ,TN,37404-3587,Private      ,11,102,113,439,1026,1465
00352500,TENNESSEE WESLEYAN COLLEGE              ,TN,37371-0040,Private      ,13,17,30,1241,599,1840
00352600,TREVECCA NAZARENE UNIVERSITY            ,TN,37210-2877,Private      ,19,113,132,1494,2432,3926
00352700,TUSCULUM COLLEGE                        ,TN,37743-0001,Private      ,33,101,134,2408,2059,4467
00352800,UNION UNIVERSITY                        ,TN,38305-3697,Private      ,33,123,156,2994,3016,6010
00352900,UNIVERSITY OF TENNESSEE-CHATTANOOGA     ,TN,37403-2598,Public       ,148,170,318,13078,5525,18603
00353000,UNIVERSITY OF TENNESSEE-KNOXVILLE       ,TN,37996-0150,Public       ,352,289,641,26555,11359,37914
00353006,UNIVERSITY OF TENNESSEE-HEALTH SCI CTR  ,TN,38103-0000,Public       ,10,53,63,457,3515,3972
00353100,UNIVERSITY OF TENNESSEE-MARTIN          ,TN,38238-0002,Public       ,93,136,229,7869,4055,11924
00353400,UNIVERSITY OF THE SOUTH                 ,TN,37383-1000,Private      ,17,7,24,1903,127,2030
00353500,VANDERBILT UNIVERSITY                   ,TN,37240-0001,Private      ,144,119,263,14667,7174,21841
00353501,VANDERBILT UNIV MED CTR ALLIEDHEAL      ,TN,37232-5510,Private      ,4,11,15,86,344,430
00353502,VANDERBILT UNIV - SCH OF MED            ,TN,37232-0000,Private      ,4,6,10,184,1082,1266
00353600,BRYAN COLLEGE                           ,TN,37321-7000,Private      ,17,73,90,1214,712,1926
00399800,CHATTANOOGA STATE COMMUNITY COLLEGE     ,TN,37406-1097,Public       ,162,519,681,5775,10731,16506
00399900,CLEVELAND STATE COMMUNITY COLLEGE       ,TN,37312-2858,Public       ,48,143,191,1919,3251,5170
00402500,TN TECHNOLOGY CTR AT KNOXVILLE          ,TN,37919-2327,Public       ,23,111,134,652,1818,2470
00402600,TENNESSEE TECH. CNTR AT CROSSVILLE      ,TN,38555-4142,Public       ,20,25,45,388,599,987
00461700,NATIONAL COLLEGE OF BUSINESS & TECH     ,TN,37211-6605,Proprietary  ,19,197,216,515,3115,3630
00493400,DAYMAR INSTITUTE                        ,TN,37217-1056,Proprietary  ,78,382,460,604,3504,4108
00493401,DAYMAR INSTITUTE - CLARKSVILLE          ,TN,37040-6718,Proprietary  ,0,0,0,38,192,230
00493404,DAYMAR INSTITUTE - MURFREESBORO         ,TN,37128-5508,Proprietary  ,0,0,0,0,6,6
00493700,JACKSON STATE COMMUNITY COLLEGE         ,TN,38301-3797,Public       ,62,195,257,3327,5320,8647
00493800,SOUTH COLLEGE                           ,TN,37909-3323,Proprietary  ,20,212,232,509,2452,2961
00494700,WEST TENNESSEE BUSINESS COLLEGE         ,TN,38301-3256,Proprietary  ,11,50,61,150,762,912
00528000,TN TECHNOLOGY CTR AT COVINGTON          ,TN,38019-0249,Public       ,5,26,31,153,492,645
00528100,TN TECHNOLOGY CTR AT ELIZABETHTON       ,TN,37643-0789,Public       ,17,80,97,337,1155,1492
00528200,TN TECHNOLOGY CTR AT HARTSVILLE         ,TN,37074-0000,Public       ,6,34,40,228,530,758
00528300,TN TECHNOLOGY CTR AT NEWBERN            ,TN,38059-1198,Public       ,5,51,56,174,568,742
00530700,TN TECHNOLOGY CTR AT MCMINNVILLE        ,TN,37110-1322,Public       ,8,40,48,196,610,806
00535100,TENNESSEE TECHNOLOGY CENTER AT MORRISTOW,TN,37813-2094,Public       ,18,61,79,494,1299,1793
00535200,TN TECHNOLOGY CENTER AT MCKENZIE        ,TN,38201-1620,Public       ,11,17,28,171,449,620
00535300,TN TECHNOLOGY CENTER AT LIVINGSTON      ,TN,38570-0219,Public       ,12,39,51,295,507,802
00535400,TN TECHNOLOGY CTR AT JACKSON            ,TN,38301-0000,Public       ,15,47,62,423,1456,1879
00535600,TENNESSEE TECHNOLOGY CENTER AT HOHENWALD,TN,38462-0000,Public       ,13,64,77,298,718,1016
00535700,TENNESSEE TECHNOLOGY CENTER AT CRUMP    ,TN,38327-3402,Public       ,6,34,40,257,639,896
00535800,TN TECHNOLOGY CENTER AT ATHENS          ,TN,37371-0848,Public       ,2,13,15,265,593,858
00535900,TENNESSEE TECHNOLOGY CENTER AT NASHVILLE,TN,37209-0000,Public       ,24,174,198,614,2292,2906
00536000,TENNESSEE TECHNOLOGY CENTER AT MEMPHIS  ,TN,38105-3604,Public       ,53,152,205,940,2581,3521
00537800,NORTHEAST STATE COMMUNITY COLLEGE       ,TN,37617-0246,Public       ,67,245,312,3579,5959,9538
00537900,TN TECHNOLOGY CTR AT SHELBYVILLE        ,TN,37160-3697,Public       ,4,46,50,341,1024,1365
00683500,DYERSBURG STATE COMMUNITY COLLEGE       ,TN,38024-0000,Public       ,35,142,177,1981,3771,5752
00683600,MOTLOW STATE COMMUNITY COLLEGE          ,TN,37388-7972,Public       ,69,172,241,3337,3961,7298
00732941,ITT TECHNICAL INSTITUTE                 ,TN,37932-3343,Proprietary  ,183,467,650,1505,4483,5988
00732958,ITT TECHNICAL INSTITUTE                 ,TN,37214-3717,Proprietary  ,112,400,512,1340,3631,4971
00743900,FOUNTAINHEAD COLLEGE OF TECHNOLOGY      ,TN,37918-2583,Proprietary  ,4,18,22,172,626,798
00744000,NASHVILLE AUTO DIESEL COLLEGE           ,TN,37206-3298,Proprietary  ,270,145,415,3138,1513,4651
00778200,TENNESSEE TECHNOLOGY CENTER AT DICKSON  ,TN,37055-0000,Public       ,29,103,132,372,1010,1382
00778300,MIDDLE TENNESSEE SCH OF ANESTHESIA      ,TN,37116-0000,Private      ,4,2,6,45,197,242
00814500,NASHVILLE STATE TECH CMNTY COLLEGE      ,TN,37209-0000,Public       ,104,436,540,4026,9962,13988
00865500,GENESIS CAREER COLLEGE OF COOKEVILLE    ,TN,38501-1959,Proprietary  ,30,84,114,144,484,628
00885900,JOHN A GUPTON COLLEGE                   ,TN,37203-2934,Private      ,3,13,16,113,208,321
00886300,WALTERS STATE COMMUNITY COLLEGE         ,TN,37813-6899,Public       ,95,209,304,4529,5775,10304
00946400,TN TECHNOLOGY CTR AT PULASKI            ,TN,38478-4541,Public       ,9,31,40,165,628,793
00956700,TENNESSEE SCHOOL OF BEAUTY              ,TN,37921-3303,Proprietary  ,8,67,75,270,586,856
00971000,TENNESSEE TECHNOLOGY CENTER AT ONEIDA/HU,TN,37756-4149,Public       ,8,22,30,137,469,606
00991200,VOLUNTEER STATE COMMUNITY COLLEGE       ,TN,37066-3188,Public       ,98,319,417,4338,6561,10899
00991400,ROANE STATE COMMUNITY COLLEGE           ,TN,37748-8664,Public       ,70,227,297,3975,5451,9426
00998200,CRICHTON COLLEGE                        ,TN,38111-4745,Proprietary  ,8,67,75,292,1639,1931
01032600,TN TECHNOLOGY CTR AT HARRIMAN           ,TN,37748-1109,Public       ,6,22,28,190,442,632
01043900,SOUTHWEST TENNESSEE COMMUNITY COLLG     ,TN,38104-3322,Public       ,235,710,945,8500,16983,25483
01044700,"PLAZA BEAUTY SCHOOL, INC.               ",TN,38117-4822,Proprietary  ,9,29,38,127,322,449
01046000,AMERICAN BAPTIST THEOLOGICAL SEMINA     ,TN,37207-4994,Private      ,2,5,7,21,176,197
01052900,MEMPHIS THEOLOGICAL SEMINARY            ,TN,38104-0000,Private      ,0,12,12,8,304,312
01070000,TN TECHNOLOGY CENTER AT JACKSBORO       ,TN,37757-2461,Public       ,9,10,19,153,332,485
01155300,WM R MOORE COLLEGE OF TECHNOLOGY        ,TN,38104-0000,Private      ,8,33,41,121,342,463
01216400,TENNESSEE TECHNICAL CNTR AT RIPLEY      ,TN,38063-7359,Public       ,4,24,28,107,433,540
01254700,EMMANUEL SCHOOL OF RELIGION             ,TN,37601-0000,Private      ,0,6,6,3,83,86
01269300,PELLISSIPPI STATE COMMUNITY COLLEGE     ,TN,37933-0990,Public       ,155,354,509,6108,7511,13619
02069303,VATTEROTT COLLEGE -                     ,TN,38016-5877,Proprietary  ,14,66,80,175,712,887
02092800,TENNESSEE TECHNOLOGY CENTER AT WHITEVILL,TN,38075-0000,Public       ,9,38,47,164,405,569
02103500,TN TECHNOLOGY CTR AT MURFREESBORO       ,TN,37129-0000,Public       ,13,52,65,359,980,1339
02106400,O'MORE COLLEGE OF DESIGN                ,TN,37064-0000,Private      ,2,4,6,213,107,320
02125300,NASHVILLE CLG OF MEDICAL CAREERS        ,TN,37115-0000,Proprietary  ,8,44,52,69,374,443
02153100,JON NAVE UNIVERSITY OF COSMETOLOGY      ,TN,37013-3347,Proprietary  ,25,81,106,255,517,772
02157100,CONCORDE CAREER COLLEGE                 ,TN,38137-0000,Proprietary  ,28,170,198,465,2248,2713
02160307,INTERNATIONAL ACADEMY OF DESIGN & TECH  ,TN,37212-0000,Proprietary  ,38,66,104,570,851,1421
02188300,PENTECOSTAL THEOLOGICAL SEMINARY        ,TN,37320-0000,Private      ,0,12,12,3,229,232
02204200,"CHATTANOOGA COLLEGE - MEDICAL, DENTAL AN",TN,37411-0000,Proprietary  ,12,98,110,216,872,1088
02237900,TN TECHNOLOGY CENTER AT PARIS           ,TN,38242-0000,Public       ,11,22,33,196,644,840
02255000,KNOXVILLE INSTITUTE OF HAIR DESIGN      ,TN,37917-0000,Proprietary  ,6,27,33,38,171,209
02257400,ARNOLD'S BEAUTY SCHOOL                  ,TN,38358-0000,Proprietary  ,1,9,10,58,88,146
02263104,ANTHEM COLLEGE - ANTHEM CAREER COLLEGE -,TN,37214-2531,Proprietary  ,6,17,23,68,236,304
02275500,REUBEN-ALLEN COLLEGE                    ,TN,37922-0000,Proprietary  ,7,25,32,63,154,217
02278700,MR WAYNES SCH OF UNISEX HAIR DESIGN     ,TN,38501-0000,Proprietary  ,3,10,13,21,69,90
02293900,VOLUNTEER BEAUTY ACADEMY-NASHVILLE      ,TN,37115-2112,Proprietary  ,2,12,14,32,115,147
02294000,VOLUNTEER BEAUTY ACADEMY-DYERSBURG      ,TN,38024-1622,Proprietary  ,2,14,16,25,123,148
02326200,KAPLAN CAREER INSTITUTE                 ,TN,37212-5318,Proprietary  ,29,152,181,382,2200,2582
02326300,MEDVANCE INSTITUTE                      ,TN,38501-4305,Proprietary  ,13,72,85,132,589,721
02335900,VOLUNTEER BEAUTY ACADEMY-NASHVILLE      ,TN,37209-3033,Proprietary  ,2,19,21,40,148,188
02539800,QUEEN CITY COLLEGE                      ,TN,37042-0000,Proprietary  ,10,37,47,64,295,359
02540000,TENNESSEE ACADEMY OF COSMETOLOGY        ,TN,38133-0000,Proprietary  ,5,29,34,104,329,433
02578200,NOSSI COLLEGE OF ART                    ,TN,37115-5138,Proprietary  ,6,14,20,317,330,647
02595000,FAYETTEVILLE BEAUTY SCHOOL              ,TN,37334-2909,Proprietary  ,5,15,20,28,97,125
02599710,VATTEROTT COLLEGE - MEMPHIS             ,TN,38132-1714,Proprietary  ,32,146,178,261,1178,1439
02605501,REMINGTON COLLEGE - MEMPHIS CAMPUS      ,TN,38132-0000,Proprietary  ,54,226,280,515,2016,2531
02609204,VATTEROTT COLLEGE - VATTEROTT CAREER COL,TN,38133-4727,Proprietary  ,13,77,90,148,793,941
02614200,MILLER MOTTE BUSINESS COLLEGE           ,TN,37040-6023,Proprietary  ,21,132,153,317,1369,1686
02614203,MILLER - MOTTE TECHNICAL COLLEGE - CHATT,TN,37421-7220,Proprietary  ,11,106,117,314,1229,1543
02614204,MILLER - MOTTE TECHNICAL COLLEGE - MADIS,TN,37072-1870,Proprietary  ,25,126,151,191,794,985
03001800,FREE WILL BAPTIST BIBLE COLLEGE         ,TN,37205-2498,Private      ,2,6,8,226,158,384
03008800,FRANKLIN ACADEMY                        ,TN,37312-3939,Private      ,7,24,31,43,140,183
03010606,VIRGINIA COLLEGE - SCH OF BUSNSS & HLTH ,TN,37411-5600,Proprietary  ,6,61,67,93,524,617
03024900,TENNESSEE ACADEMY OF COSMETOLOGY        ,TN,38125-3442,Proprietary  ,9,27,36,120,292,412
03061100,GENESIS CAREER COLLEGE OF LEBANON       ,TN,37087-2718,Proprietary  ,15,56,71,137,372,509
03076405,BRYMAN SCHOOL OF ARIZONA (THE) - ANTHEM ,TN,38134-7345,Proprietary  ,1,4,5,114,350,464
03079100,NORTH CENTRAL INSTITUTE                 ,TN,37042-3116,Proprietary  ,5,20,25,44,149,193
03088800,"WATKINS COLLEGE OF ART, DESIGN & FILM   ",TN,37228-1306,Private      ,8,11,19,554,373,927
03126900,STYLES & PROFILES BEAUTY COLLEGE        ,TN,38375-2109,Proprietary  ,0,3,3,15,43,58
03355400,RICHMONT GRADUATE UNIVERSITY            ,TN,37404-0000,Private      ,0,8,8,9,279,288
03440300,BAPTIST MEMORIAL COLLEGE OF HEALTH      ,TN,38104-3104,Private      ,12,42,54,837,2040,2877
03480303,MEDVANCE INSTITUTE - NASHVILLE          ,TN,37203-1536,Proprietary  ,26,149,175,213,1117,1330
03513500,WILLIAMSON CHRISTIAN COLLEGE            ,TN,37067-8237,Private      ,2,14,16,43,248,291
03647300,NEW CONCEPTS SCHOOL OF COSMETOLOGY      ,TN,37311-7373,Proprietary  ,4,12,16,22,86,108
03683300,INTERNATIONAL BARBER & STYLE COLLEGE    ,TN,37209-0000,Proprietary  ,13,39,52,71,247,318
03701300,MEMPHIS INSTITUTE OF BARBERING          ,TN,38107-4334,Proprietary  ,7,42,49,122,362,484
03774400,SHEAR ACADEMY                           ,TN,38555-4177,Proprietary  ,1,5,6,25,52,77
03830300,SAE INSTITUTE OF TECHNOLOGY             ,TN,37203-4310,Proprietary  ,14,23,37,208,373,581
03840300,OXFORD GRADUATE SCHOOL                  ,TN,37321-6736,Private      ,0,4,4,0,15,15
03841300,CAREER BEAUTY COLLEGE                   ,TN,38464-3634,Proprietary  ,1,13,14,18,68,86
03920300,INSTITUTE OF HAIR DESIGN                ,TN,38310-1801,Proprietary  ,1,2,3,29,46,75
03930300,BUCHANAN BEAUTY COLLEGE                 ,TN,37160-2741,Proprietary  ,0,16,16,18,108,126
03982300,VISIBLE SCHOOL - MUSIC AND WORSHIPS ARTS,TN,38104-5814,Private      ,0,1,1,118,79,197
04035300,NAVE COSMETOLOGY ACADEMY                ,TN,38401-6335,Proprietary  ,1,23,24,60,221,281
04124100,ELITE COLLEGE OF COSMETOLOGY            ,TN,38351-1431,Proprietary  ,0,13,13,32,82,114
04157200,LOVE BEAUTY SCHOOL                      ,TN,37355-2950,Proprietary  ,5,15,20,36,109,145
04165000,MERIDIAN INSTITUTE OF SURGICAL ASSISTING,TN,37080-0758,Proprietary  ,1,22,23,1,22,23
00353700,ABILENE CHRISTIAN UNIVERSITY            ,TX,79699-3701,Private      ,65,84,149,4650,1833,6483
00353900,ALVIN COMMUNITY COLLEGE                 ,TX,77511-4807,Public       ,54,207,261,1358,3045,4403
00354000,AMARILLO COLLEGE                        ,TX,79109-2446,Public       ,91,401,492,3514,7959,11473
00354100,ANGELO STATE UNIVERSITY                 ,TX,76909-5069,Public       ,84,117,201,6844,3111,9955
00354300,AUSTIN COLLEGE                          ,TX,75090-4440,Private      ,29,17,46,2097,289,2386
00354400,AUSTIN PRESBYTERIAN THEOLOGICAL SEM     ,TX,78705-5797,Private      ,0,1,1,2,151,153
00354500,BAYLOR UNIVERSITY                       ,TX,76798-1458,Private      ,447,137,584,21177,5220,26397
00354600,COASTAL BEND COLLEGE                    ,TX,78102-2197,Public       ,69,135,204,1802,2873,4675
00354900,BLINN COLLEGE                           ,TX,77833-4098,Public       ,249,256,505,10498,5205,15703
00355300,CISCO JUNIOR COLLEGE                    ,TX,76437-9803,Public       ,47,109,156,2131,3201,5332
00355400,CLARENDON COLLEGE                       ,TX,79226-0000,Public       ,27,66,93,523,744,1267
00355600,COMMONWEALTH INST OF FUNERAL SVC        ,TX,77090-5918,Private      ,4,30,34,88,283,371
00355700,CONCORDIA UNIVERSITY TEXAS              ,TX,78726-4141,Private      ,30,138,168,1487,2814,4301
00355800,NORTH CENTRAL TEXAS COLLEGE             ,TX,76240-4699,Public       ,108,270,378,3130,5124,8254
00356000,DALLAS BAPTIST UNIVERSITY               ,TX,75211-9299,Private      ,48,231,279,2928,4697,7625
00356100,CEDAR VALLEY COLLEGE                    ,TX,75134-0000,Public       ,89,287,376,2241,5043,7284
00356200,DALLAS THEOLOGICAL SEM                  ,TX,75204-0000,Private      ,0,31,31,15,745,760
00356300,DEL MAR COLLEGE                         ,TX,78404-3897,Public       ,172,531,703,5360,9069,14429
00356400,EAST TEXAS BAPTIST UNIVERSITY           ,TX,75670-1423,Private      ,14,20,34,1546,442,1988
00356500,TEXAS A&M UNIVERSITY - COMMERCE         ,TX,75429-3011,Public       ,72,306,378,4771,7395,12166
00356600,EPISCOPAL THEOL SEM OF THE STHWST       ,TX,78768-0000,Private      ,0,0,0,2,19,21
00356800,FRANK PHILLIPS COLLEGE                  ,TX,79008-0000,Public       ,19,44,63,479,655,1134
00357000,GRAYSON COUNTY COLLEGE                  ,TX,75020-8299,Public       ,54,219,273,1857,4372,6229
00357100,HARDIN-SIMMONS UNIVERSITY               ,TX,79698-6050,Private      ,22,35,57,2393,1046,3439
00357200,TRINITY VALLEY COMMUNITY COLLEGE        ,TX,75751-2734,Public       ,129,318,447,2514,5013,7527
00357300,HILL COLLEGE                            ,TX,76645-2711,Public       ,36,100,136,981,1427,2408
00357301,HILL COLLEGE                            ,TX,76031-0000,Public       ,33,129,162,850,2250,3100
00357400,HOWARD COLLEGE                          ,TX,79720-0213,Public       ,46,125,171,1461,2783,4244
00357500,HOWARD PAYNE UNIVERSITY                 ,TX,76801-2715,Private      ,17,13,30,1512,432,1944
00357600,HOUSTON BAPTIST UNIVERSITY              ,TX,77074-3298,Private      ,81,96,177,4485,2596,7081
00357700,HUSTON - TILLOTSON UNIVERSITY           ,TX,78702-2795,Private      ,20,30,50,1210,843,2053
00357800,UNIVERSITY OF THE INCARNATE WORD        ,TX,78209-6398,Private      ,99,234,333,5084,5523,10607
00357900,JACKSONVILLE COLLEGE                    ,TX,75766-4759,Private      ,7,5,12,251,235,486
00358000,KILGORE COLLEGE                         ,TX,75662-3299,Public       ,81,219,300,3376,5228,8604
00358100,LAMAR UNIVERSITY-BEAUMONT               ,TX,77710-0042,Public       ,206,566,772,8747,8524,17271
00358200,LAREDO COMMUNITY COLLEGE                ,TX,78040-4395,Public       ,148,167,315,6305,5094,11399
00358300,LEE COLLEGE                             ,TX,77520-4796,Public       ,67,232,299,1901,4675,6576
00358400,LETOURNEAU UNIVERSITY                   ,TX,75607-0000,Private      ,12,174,186,1688,3412,5100
00358500,LON MORRIS COLLEGE                      ,TX,75766-2900,Private      ,21,10,31,1072,317,1389
00358600,LUBBOCK CHRISTIAN UNIVERSITY            ,TX,79407-2099,Private      ,19,78,97,1618,1472,3090
00358800,UNIVERSITY OF MARY HARDIN-BAYLOR        ,TX,76513-2599,Private      ,61,54,115,3488,1440,4928
00359000,MCLENNAN COMMUNITY COLLEGE              ,TX,76708-1498,Public       ,106,282,388,4350,8301,12651
00359100,MCMURRY UNIVERSITY                      ,TX,79697-0001,Private      ,15,26,41,1733,794,2527
00359200,MIDWESTERN STATE UNIVERSITY             ,TX,76308-2099,Public       ,83,121,204,4429,3396,7825
00359300,NAVARRO COLLEGE                         ,TX,75110-4818,Public       ,149,378,527,4732,6825,11557
00359400,UNIVERSITY OF NORTH TEXAS               ,TX,76203-5017,Public       ,423,708,1131,27527,21311,48838
00359500,OBLATE SCHOOL OF THEOLOGY               ,TX,78216-0000,Private      ,0,4,4,8,49,57
00359600,ODESSA COLLEGE                          ,TX,79764-7127,Public       ,54,144,198,1893,3471,5364
00359800,OUR LADY OF THE LAKE UNIVERSITY         ,TX,78207-4689,Private      ,40,74,114,2462,3106,5568
00359900,UNIVERSITY OF TEXAS - PAN AMERICAN      ,TX,78541-2999,Public       ,422,337,759,16173,10520,26693
00360000,PANOLA COLLEGE                          ,TX,75633-2397,Public       ,28,111,139,929,1971,2900
00360100,PARIS JR COLLEGE                        ,TX,75460-6298,Public       ,75,240,315,2092,4120,6212
00360200,PAUL QUINN COLLEGE                      ,TX,75241-4398,Private      ,8,29,37,356,661,1017
00360300,RANGER COLLEGE                          ,TX,76470-3298,Public       ,13,41,54,610,623,1233
00360305,RANGER COLLEGE-STEPHENVILE BEAUTY COLLEG,TX,76401-5136,Public       ,0,3,3,5,36,41
00360400,RICE UNIVERSITY                         ,TX,77251-1892,Private      ,100,104,204,9173,2966,12139
00360600,SAM HOUSTON STATE UNIVERSITY            ,TX,77340-0000,Public       ,287,324,611,16576,8236,24812
00360700,ALAMO CMTY CLG DISTRICT PROGRAM         ,TX,78207-0000,Public       ,44,180,224,969,1693,2662
00360800,ST PHILLIPS COLLEGE                     ,TX,78203-2098,Public       ,169,694,863,5072,11639,16711
00360900,SAN JACINTO CLG-CENTRAL-NORTH-SOUTH     ,TX,77501-0000,Public       ,419,943,1362,9314,14812,24126
00361000,SCHREINER UNIVERSITY                    ,TX,78028-5697,Private      ,23,34,57,1447,517,1964
00361100,SOUTH PLAINS COLLEGE                    ,TX,79336-6504,Public       ,106,217,323,5066,5828,10894
00361200,UNIV OF HOUSTON-DOWNTOWN                ,TX,77002-1001,Public       ,169,420,589,7127,11622,18749
00361300,SOUTHERN METHODIST UNIVERSITY           ,TX,75275-0181,Private      ,99,202,301,7079,6075,13154
00361400,SOUTHWEST TEXAS JR COLLEGE              ,TX,78801-6221,Public       ,93,173,266,2848,3647,6495
00361500,TEXAS STATE UNIVERSITY--SAN MARCOS      ,TX,78666-4602,Public       ,479,464,943,28056,15585,43641
00361600,SOUTHWESTERN ASSEMBLIES OF GOD UNIV     ,TX,75165-2397,Private      ,32,46,78,1690,1297,2987
00361700,SOUTHWESTERN BAPTIST THEOL SEMINARY     ,TX,76122-0000,Private      ,0,0,0,31,177,208
00361800,SOUTHWESTERN CHRISTIAN COLLEGE          ,TX,75160-3400,Private      ,5,11,16,224,128,352
00361900,SOUTHWESTERN ADVENTIST UNIVERSITY       ,TX,76059-1922,Private      ,12,23,35,654,435,1089
00362000,SOUTHWESTERN UNIVERSITY                 ,TX,78626-6111,Private      ,21,14,35,2407,261,2668
00362100,ST EDWARDS UNIVERSITY                   ,TX,78704-0000,Private      ,56,107,163,5191,3192,8383
00362300,ST MARY'S UNIV OF SAN ANTONIO           ,TX,78228-8500,Private      ,74,81,155,4270,3416,7686
00362400,STEPHEN F AUSTIN STATE UNIVERSITY       ,TX,75962-0001,Public       ,279,188,467,13779,5139,18918
00362500,SUL ROSS STATE UNIVERSITY               ,TX,79832-0113,Public       ,43,99,142,1710,2161,3871
00362600,TARRANT COUNTY COLLEGE                  ,TX,76102-6599,Public       ,603,1876,2479,16994,30386,47380
00362700,TEMPLE COLLEGE                          ,TX,76504-7435,Public       ,62,230,292,2261,5745,8006
00362800,TEXARKANA COLLEGE                       ,TX,75599-0001,Public       ,40,108,148,1874,3150,5024
00363000,PRAIRIE VIEW A&M UNIVERSITY             ,TX,77446-2967,Public       ,180,197,377,11356,6634,17990
00363100,TARLETON STATE UNIVERSITY               ,TX,76402-0000,Public       ,148,225,373,6885,6236,13121
00363200,TEXAS A&M UNIVERSITY                    ,TX,77842-0000,Public       ,793,339,1132,38915,9934,48849
00363400,TEXAS STATE TECHNICAL CLG AT WACO       ,TX,76705-1695,Public       ,97,232,329,3196,4718,7914
00363500,TEXAS CHIROPRACTIC COLLEGE              ,TX,77505-1699,Private      ,0,8,8,14,366,380
00363600,TEXAS CHRISTIAN UNIVERSITY              ,TX,76129-0001,Private      ,222,135,357,11293,3809,15102
00363700,JARVIS CHRISTIAN COLLEGE                ,TX,75765-1470,Private      ,15,9,24,718,277,995
00363800,TEXAS COLLEGE                           ,TX,75702-4500,Private      ,19,27,46,911,784,1695
00363900,TEXAS A&M UNIVERSITY-KINGSVILLE         ,TX,78363-8203,Public       ,137,209,346,7389,6127,13516
00364100,TEXAS LUTHERAN UNIVERSITY               ,TX,78155-5999,Private      ,36,16,52,2049,353,2402
00364200,TEXAS SOUTHERN UNIVERSITY               ,TX,77004-4598,Public       ,191,420,611,10281,13139,23420
00364300,TEXAS SOUTHMOST COLLEGE                 ,TX,78520-4992,Public       ,0,0,0,379,467,846
00364400,TEXAS TECH UNIVERSITY                   ,TX,79409-0000,Public       ,422,364,786,24506,11255,35761
00364500,TEXAS WESLEYAN UNIVERSITY               ,TX,76105-1536,Private      ,39,83,122,1451,4133,5584
00364600,TEXAS WOMAN'S UNIVERSITY                ,TX,76204-5587,Public       ,102,355,457,6379,11940,18319
00364700,TRINITY UNIVERSITY                      ,TX,78212-7200,Private      ,50,29,79,3488,735,4223
00364800,TYLER JUNIOR COLLEGE                    ,TX,75701-3436,Public       ,151,340,491,7659,7972,15631
00365100,UNIVERSITY OF DALLAS                    ,TX,75062-4799,Private      ,29,77,106,1896,1545,3441
00365200,UNIVERSITY OF HOUSTON                   ,TX,77204-2010,Public       ,671,953,1624,31529,27986,59515
00365400,UNIVERSITY OF ST THOMAS                 ,TX,77006-4626,Private      ,33,129,162,1582,2362,3944
00365600,UNIVERSITY OF TEXAS-ARLINGTON           ,TX,76019-0000,Public       ,291,1117,1408,20067,25235,45302
00365800,UNIVERSITY OF TEXAS-AUSTIN              ,TX,78713-7758,Public       ,478,498,976,42367,22183,64550
00365900,UT HEALTH CENTER-SAN ANTONIO            ,TX,78229-3900,Public       ,36,92,128,975,3732,4707
00366100,UNIVERSITY OF TEXAS-EL PASO             ,TX,79968-0629,Public       ,316,491,807,13915,12839,26754
00366200,VICTORIA COLLEGE                        ,TX,77901-4494,Public       ,62,169,231,1760,3211,4971
00366300,WAYLAND BAPTIST UNIVERSITY              ,TX,79072-6998,Private      ,21,328,349,1219,3896,5115
00366400,WEATHERFORD COLLEGE                     ,TX,76086-5699,Public       ,61,163,224,2268,3589,5857
00366500,WEST TEXAS A&M UNIVERSITY               ,TX,79016-0000,Public       ,94,146,240,5487,3930,9417
00366800,WHARTON COUNTY JR COLLEGE               ,TX,77488-3298,Public       ,104,200,304,2708,3584,6292
00366900,WILEY COLLEGE                           ,TX,75670-5199,Private      ,17,47,64,1106,935,2041
00400300,CENTRAL TEXAS COLLEGE                   ,TX,76540-4199,Public       ,147,1744,1891,2962,16214,19176
00407221,NORTHWOOD UNIVERSITY                    ,TX,75104-0000,Private      ,5,47,52,594,965,1559
00445300,EL CENTRO COLLEGE                       ,TX,75202-0000,Public       ,136,689,825,4186,11950,16136
00450303,EVEREST COLLEGE - FORT WORTH SOUTH      ,TX,76115-1407,Proprietary  ,22,197,219,161,1087,1248
00481102,EVEREST INSTITUTE - EVEREST COLLEGE     ,TX,76011-6630,Proprietary  ,27,134,161,268,1386,1654
00494800,TEXAS A&M UNIV SYSTEM HEALTH SCI CT     ,TX,77840-7896,Public       ,19,27,46,823,1907,2730
00494900,BAYLOR COLLEGE OF MEDICINE              ,TX,77030-0000,Private      ,14,39,53,572,1661,2233
00495100,UNIV OF TEXAS HEALTH SCIENCE CENTER     ,TX,77225-0000,Public       ,9,92,101,531,3633,4164
00495200,UNIV OF TEXAS MEDICAL BRANCH            ,TX,77550-0000,Public       ,12,53,65,339,2456,2795
00497200,GALVESTON COLLEGE                       ,TX,77550-7447,Public       ,41,103,144,1214,2143,3357
00497700,SOUTH TEXAS COLLEGE OF LAW              ,TX,77002-0000,Private      ,3,30,33,64,2278,2342
00660600,BAPTIST HS SCHOOL OF HEALTH PROFESSIONS ,TX,78229-3234,Proprietary  ,3,38,41,216,1305,1521
00661200,COVENANT SCH OF NSG & ALLIED HEALTH     ,TX,79410-0000,Private      ,1,9,10,132,413,545
00666100,ANGELINA COLLEGE                        ,TX,75902-0000,Public       ,83,190,273,2538,4507,7045
00694100,DALLAS CHRISTIAN COLLEGE                ,TX,75234-7229,Private      ,7,22,29,318,498,816
00709600,COLLEGE OF THE MAINLAND                 ,TX,77591-2499,Public       ,63,211,274,1281,3343,4624
00728700,BRAZOSPORT COLLEGE                      ,TX,77566-3199,Public       ,61,113,174,1383,2092,3475
00732907,ITT TECHNICAL INSTITUTE                 ,TX,77063-3751,Proprietary  ,12,63,75,310,856,1166
00732913,ITT TECHNICAL INSTITUTE                 ,TX,76011-3919,Proprietary  ,82,223,305,581,1773,2354
00732975,ITT TECHNICAL INSTITUTE                 ,TX,78249-3303,Proprietary  ,43,137,180,431,1255,1686
00754805,WESTWOOD COLLEGE OF TECHNOLOGY          ,TX,77074-0000,Proprietary  ,26,68,94,476,873,1349
00835300,LINCOLN COLLEGE OF TECHNOLOGY           ,TX,75052-0000,Proprietary  ,62,116,178,1092,1470,2562
00849800,MIMS CLASSIC BEAUTY COLLEGE             ,TX,78216-0000,Proprietary  ,1,11,12,43,113,156
00850300,MOUNTAIN VIEW COLLEGE                   ,TX,75211-6599,Public       ,134,375,509,3634,6716,10350
00850400,RICHLAND COLLEGE                        ,TX,75243-2199,Public       ,198,636,834,4922,9235,14157
00851000,EASTFIELD COLLEGE                       ,TX,75150-2099,Public       ,156,490,646,4088,8537,12625
00907905,EVEREST COLLEGE                         ,TX,75206-5209,Proprietary  ,32,236,268,609,2534,3143
00908200,INTERNATIONAL BUSINESS COLLEGE          ,TX,79903-0000,Proprietary  ,37,125,162,207,777,984
00916300,SAN ANTONIO COLLEGE                     ,TX,78212-4299,Public       ,407,1164,1571,12979,21569,34548
00922500,TEXAS STATE TECHNICAL COLLEGE  HARLINGEN,TX,78550-3697,Public       ,118,244,362,3507,4516,8023
00946600,KAPLAN COLLEGE                          ,TX,78216-1899,Proprietary  ,31,191,222,372,1834,2206
00946607,KAPLAN COLLEGE - MCALLEN                ,TX,78503-1622,Proprietary  ,45,109,154,468,1027,1495
00946609,KAPLAN COLLEGE - CAREER CENTERS OF TEXAS,TX,78416-9900,Proprietary  ,18,132,150,233,1110,1343
00946610,KAPLAN COLLEGE - CAREER CENTERS OF TEXAS,TX,76103-2310,Proprietary  ,26,106,132,250,1154,1404
00954900,WESTERN TEXAS COLLEGE                   ,TX,79549-9501,Public       ,20,32,52,668,524,1192
00965100,TEXAS A&M INTERNATIONAL UNIVERSITY      ,TX,78041-1900,Public       ,100,97,197,5324,3499,8823
00974100,UNIVERSITY OF TEXAS AT DALLAS           ,TX,75083-0000,Public       ,149,331,480,8296,9713,18009
00976800,UNIVERSITY OF NORTH TEXAS HEALTH SCIENCE,TX,76107-2699,Public       ,15,59,74,282,1985,2267
00979700,MIDLAND COLLEGE                         ,TX,79705-6397,Public       ,49,153,202,1851,3116,4967
00982802,EVEREST INSTITUTE- AUSTIN               ,TX,78754-0000,Proprietary  ,51,218,269,402,1766,2168
00993000,UNIVERSITY OF TEXAS-PERMIAN BASIN       ,TX,79762-0001,Public       ,37,97,134,1984,2721,4705
00993200,TEXAS STATE TECH CLG-WEST TEXAS         ,TX,79556-4108,Public       ,6,32,38,497,988,1485
00993201,TEXAS STATE TECH COLLEGE-ABILENE        ,TX,79601-0000,Public       ,6,34,40,169,575,744
00993204,TEXAS STATE TECH CLG-BRECKENRIDGE       ,TX,76424-0000,Public       ,2,2,4,36,170,206
00993205,TEXAS STATE TECH COLLEGE-BROWNWOOD      ,TX,76801-0000,Public       ,3,5,8,96,342,438
01001900,UNIV OF TEXAS SOUTHWESTERN MED CTR      ,TX,75390-9096,Public       ,8,60,68,260,2111,2371
01005700,AMERICAN COMMERCIAL COLLEGE             ,TX,79602-1399,Proprietary  ,12,60,72,66,540,606
01005900,AMERICAN COMMERCIAL COLLEGE             ,TX,79761-0000,Proprietary  ,6,32,38,45,291,336
01005901,AMERICAN COMMERCIAL COLLEGE - AMERICAN C,TX,76310-2303,Proprietary  ,5,59,64,58,414,472
01006000,VERNON COLLEGE                          ,TX,76384-4092,Public       ,41,126,167,1241,2854,4095
01011500,UNIVERSITY OF TEXAS-SAN ANTONIO         ,TX,78249-0600,Public       ,549,555,1104,29004,18300,47304
01013000,WADE COLLEGE                            ,TX,75207-3199,Proprietary  ,15,31,46,252,307,559
01038700,EL PASO COMMUNITY COLLEGE               ,TX,79998-0000,Public       ,397,919,1316,14909,18011,32920
01050900,HALLMARK COLLEGE OF AERONAUTICS         ,TX,78214-0000,Proprietary  ,30,184,214,252,1270,1522
01050901,HALLMARK COLLEGE OF  TECHNOLOGY-        ,TX,78230-1736,Proprietary  ,0,1,1,0,4,4
01062400,CENTRAL TEXAS COMMERCIAL COLLEGE        ,TX,75231-5033,Private      ,0,0,0,61,240,301
01063300,HOUSTON COMMUNITY COLLEGE               ,TX,77002-0000,Public       ,992,3383,4375,21901,48589,70490
01067400,TEXAS TECH U HEALTH SCIENCES CENTER     ,TX,79430-0000,Public       ,17,84,101,967,3767,4734
01076100,DALLAS INSTITUTE OF FUNERAL SERVICE     ,TX,75227-4314,Private      ,5,28,33,86,391,477
01114500,LONE STAR COLLEGE SYSTEM                ,TX,77073-3499,Public       ,763,2047,2810,16780,31504,48284
01114501,LONE STAR COLLEGE-KINGWOOD              ,TX,77339-0000,Public       ,0,0,0,100,293,393
01114502,LONE STAR COLLEGE-TOMBALL               ,TX,77375-0000,Public       ,0,0,0,102,205,307
01114503,LONE STAR COLLEGE-MONTGOMERY            ,TX,77384-0000,Public       ,0,0,0,172,339,511
01114504,LONE STAR COLLEGE-CY-FAIR               ,TX,77433-1383,Public       ,0,0,0,178,305,483
01116100,TEXAS A&M UNIV CORPUS CHRISTI           ,TX,78412-5599,Public       ,166,183,349,8784,5587,14371
01116300,UNIVERSITY OF TEXAS AT TYLER            ,TX,75799-6699,Public       ,69,159,228,4479,4727,9206
01171100,UNIVERSITY OF HOUSTON-CLEAR LAKE        ,TX,77058-1002,Public       ,65,278,343,2262,7939,10201
01201500,AUSTIN COMMUNITY COLLEGE                ,TX,78752-4390,Public       ,568,1811,2379,15563,28771,44334
01202000,VICTORIA BEAUTY COLLEGE                 ,TX,77901-6233,Proprietary  ,3,20,23,45,161,206
01226800,BALDWIN BEAUTY SCHOOL #5                ,TX,78704-4785,Proprietary  ,15,38,53,138,358,496
01229700,LAREDO BEAUTY COLLEGE                   ,TX,78040-1051,Proprietary  ,11,51,62,116,323,439
01248200,ATI TECHNICAL TRAINING CENTER           ,TX,75235-4622,Proprietary  ,166,577,743,1081,4133,5214
01248209,ATI CAREER TRAINING CENTER - GARLAND    ,TX,75041-2497,Proprietary  ,4,24,28,49,189,238
01248210,ATI CAREER TRAINING CENTER - WACO       ,TX,76711-1682,Proprietary  ,1,16,17,94,303,397
01248300,COSMETOLOGY CAREER CENTER-A PAUL MITCHEL,TX,75006-2567,Proprietary  ,48,85,133,342,553,895
01248800,INTERNATIONAL BEAUTY COLLEGE NO 3       ,TX,75040-0000,Proprietary  ,2,12,14,25,113,138
01276400,METROPLEX BEAUTY SCHOOL                 ,TX,75149-0000,Proprietary  ,3,18,21,32,181,213
01293000,CHARLES & SUE'S SCH OF HAIR DESIGN      ,TX,77801-0000,Proprietary  ,7,6,13,56,105,161
01293200,TINT SCHOOL OF MAKEUP & COSMETOLOGY     ,TX,75061-4235,Proprietary  ,4,12,16,28,89,117
01300300,NEILSON BEAUTY COLLEGE                  ,TX,75208-4637,Proprietary  ,2,11,13,31,147,178
01301600,OGLE SCHOOL HAIR SKIN NAILS             ,TX,76013-7400,Proprietary  ,18,57,75,201,446,647
01303912,SOUTH UNIVERSITY - THE ART INSTITUTE OF ,TX,75231-5993,Proprietary  ,85,201,286,2607,2675,5282
01323100,UNIVERSITY OF HOUSTON-VICTORIA          ,TX,77901-5731,Public       ,29,175,204,1148,3514,4662
02058600,CONLEE'S COLLEGE OF COSMETOLOGY         ,TX,78028-0000,Proprietary  ,2,5,7,13,50,63
02069302,VATTEROTT COLLEGE - VATTEROTT EDUCATION ,TX,75220-5441,Proprietary  ,9,35,44,95,443,538
02074100,CAPITOL CITY TRADE & TECHNICAL SCH      ,TX,78704-0000,Proprietary  ,54,94,148,353,685,1038
02077400,NORTH LAKE COLLEGE                      ,TX,75038-0000,Public       ,79,308,387,2803,5637,8440
02081400,ARLINGTON BAPTIST COLLEGE               ,TX,76012-0000,Private      ,2,14,16,220,274,494
02093600,SOUTHWEST SCHOOL OF ELECTRONIC          ,TX,78735-0000,Proprietary  ,1,9,10,46,87,133
02098300,WESTERN TECHNICAL COLLEGE               ,TX,79927-2105,Proprietary  ,91,227,318,1099,1666,2765
02100200,BROOKHAVEN COLLEGE                      ,TX,75244-0000,Public       ,105,399,504,2646,6769,9415
02113610,AMERICAN INTERCONTINENTAL UNIV - HOUSTON,TX,77042-4516,Proprietary  ,19,91,110,212,1068,1280
02116008,SANFORD-BROWN COLLEGE - HOUSTON         ,TX,77042-8900,Proprietary  ,65,261,326,534,2261,2795
02116012,SANFORD-BROWN COLLEGE - HOUSTON NORTH LO,TX,77008-1058,Proprietary  ,20,103,123,188,925,1113
02117100,ART INSTITUTE OF HOUSTON                ,TX,77056-0000,Proprietary  ,222,391,613,4208,4067,8275
02119200,COURT REPORTING INSTITUTE OF DALLAS     ,TX,75247-6913,Proprietary  ,6,67,73,84,875,959
02119202,COURT REPORTING INSTIUTE OF DALLAS - COU,TX,77040-6315,Proprietary  ,2,9,11,31,418,449
02128302,INSTITUTE FOR BUSINESS & TECHNOLOGY - LA,TX,78230-2520,Proprietary  ,24,116,140,163,602,765
02136800,AMERICAN COMMERCIAL COLLEGE             ,TX,76904-0000,Proprietary  ,6,42,48,59,348,407
02144800,VET TECH INSTITUTE OF HOUSTON           ,TX,77027-9881,Proprietary  ,16,32,48,282,295,577
02176100,PIPO ACADEMY OF HAIR DESIGN             ,TX,79903-0000,Proprietary  ,3,13,16,33,97,130
02200800,AMERICAN COMMERCIAL COLLEGE             ,TX,79411-0000,Proprietary  ,5,50,55,38,363,401
02218300,SOUTHWEST SCHOOL OF BUSINESS & TECHNICAL,TX,78221-0000,Proprietary  ,26,102,128,203,898,1101
02218305,SOUTHWEST SCHOOL OF BUSINESS AND TECHNIC,TX,78501-6053,Proprietary  ,9,25,34,75,205,280
02218306,SOUTHWEST SCHOOL OF BUSINESS AND TECHNIC,TX,78413-2045,Proprietary  ,0,25,25,32,256,288
02224600,TRI-STATE BEAUTY SCHOOL #1              ,TX,79915-0000,Proprietary  ,13,75,88,128,442,570
02228400,TEXAS AERO TECHNOLOGY                   ,TX,75209-0000,Proprietary  ,0,0,0,0,1,1
02230500,OGLE SCHOOL HAIR SKIN NAILS             ,TX,76132-3638,Proprietary  ,52,129,181,343,906,1249
02230600,OGLE SCHOOL HAIR SKIN NAILS             ,TX,76053-4650,Proprietary  ,12,36,48,88,208,296
02239100,CENTRAL TEXAS BEAUTY COLLEGE #2         ,TX,78664-4204,Proprietary  ,11,37,48,72,309,381
02248200,MILAN INSTITUTE OF COSMETOLOGY          ,TX,79103-0000,Proprietary  ,159,452,611,981,2601,3582
02254800,TEXAS VOCATIONAL SCHOOLS                ,TX,77901-0000,Proprietary  ,13,43,56,64,203,267
02259400,AMBERTON UNIVERSITY                     ,TX,75041-0000,Private      ,1,36,37,38,419,457
02261300,EVEREST INSTITUTE                       ,TX,78213-3841,Proprietary  ,22,151,173,260,1379,1639
02261302,EVEREST INSTITUTE - HOUSTON GREENSPOINT ,TX,77060-3249,Proprietary  ,16,97,113,338,1533,1871
02261303,EVEREST INSTITUTE - HOUSTON HOBBY       ,TX,77087-2737,Proprietary  ,25,137,162,284,1390,1674
02267100,EXPOSITO SCHOOL OF HAIR DESIGN          ,TX,79109-0000,Proprietary  ,3,8,11,39,96,135
02276000,FRANKLIN BEAUTY SCHOOL #2               ,TX,77021-0000,Proprietary  ,10,25,35,75,251,326
02285900,UNIVERSITY OF COSMETOLOGY ARTS&SCI      ,TX,78504-0000,Proprietary  ,15,80,95,203,686,889
02294800,CAPITOL CITY CAREERS                    ,TX,78745-0000,Proprietary  ,4,49,53,43,275,318
02298501,EVEREST COLLEGE- FORT WORTH             ,TX,76137-2472,Proprietary  ,25,125,150,274,1357,1631
02305300,PARKER COLLEGE OF CHIROPRACTIC          ,TX,75229-0000,Private      ,5,30,35,75,1284,1359
02306700,FORT WORTH BEAUTY SCHOOL                ,TX,76116-3299,Proprietary  ,6,32,38,74,323,397
02312200,TEXAS SCHOOL OF BUSINESS                ,TX,77073-6032,Proprietary  ,34,124,158,325,961,1286
02312201,TEXAS SCHOOL OF BUSINESS - SOUTHWEST CAM,TX,77057-5914,Proprietary  ,26,97,123,137,748,885
02312202,TEXAS SCHOOL OF BUSINESS - FRIENDSWOOD C,TX,77546-8938,Proprietary  ,10,78,88,88,597,685
02312203,TEXAS SCHOOL OF BUSINESS - EAST CAMPUS  ,TX,77029-1916,Proprietary  ,8,55,63,110,525,635
02313901,WESTWOOD COLLEGE - DALLAS               ,TX,75243-0000,Proprietary  ,27,82,109,494,1403,1897
02315400,NORTHEAST TEXAS COMMUNITY COLLEGE       ,TX,75456-0000,Public       ,66,140,206,1541,2394,3935
02318200,"KD STUDIO, ACTOR'S CONSERVATORY         ",TX,75207-2111,Proprietary  ,17,21,38,198,276,474
02320200,HOUSTON GRADUATE SCHOOL OF THEOLOGY     ,TX,77092-0000,Private      ,1,17,18,23,261,284
02326000,SAN ANTONIO BEAUTY COLLEGE NO 3         ,TX,78217-0000,Proprietary  ,4,15,19,42,149,191
02331200,BAPTIST MISSIONARY ASSN THEOL SEM       ,TX,75766-0000,Private      ,0,1,1,5,56,61
02331300,INTERACTIVE LEARNING SYSTEMS            ,TX,77502-1201,Proprietary  ,7,55,62,50,327,377
02331301,INTERACTIVE LEARNING SYSTEMS            ,TX,77081-0000,Proprietary  ,23,123,146,101,668,769
02331304,INTERACTIVE LEARNING SYSTEMS            ,TX,77060-0000,Proprietary  ,3,90,93,37,483,520
02341300,PALO ALTO COLLEGE                       ,TX,78224-0000,Public       ,167,411,578,5002,7499,12501
02348500,LAMAR STATE COLLEGE-PORT ARTHUR         ,TX,77640-0000,Public       ,45,123,168,1136,2093,3229
02357700,ACADEMY OF HAIR DESIGN                  ,TX,77043-3412,Proprietary  ,29,69,98,170,339,509
02358200,LAMAR STATE COLLEGE-ORANGE              ,TX,77630-0000,Public       ,22,92,114,930,2346,3276
02361400,COLLIN COUNTY COMMUNITY COLLEGE         ,TX,75071-0000,Public       ,237,748,985,6998,11694,18692
02362000,UNIVERSAL TECHNICAL INSTITUTE           ,TX,77073-0000,Proprietary  ,346,461,807,5605,3931,9536
02362800,AUSTIN GRADUATE SCHOOL OF THEOLOGY      ,TX,78752-1333,Private      ,0,10,10,23,125,148
02521200,ARLINGTON CAREER INSTITUTE              ,TX,75050-0000,Proprietary  ,5,50,55,72,539,611
02521800,SEGUIN BEAUTY SCHOOL                    ,TX,78155-0000,Proprietary  ,8,19,27,59,123,182
02521801,SEGUIN BEAUTY SCHOOL-NEW BRAUNFELS      ,TX,78130-7937,Proprietary  ,0,0,0,6,5,11
02527500,HOUSTON TRAINING SCHOOLS                ,TX,77029-0000,Proprietary  ,33,206,239,219,1143,1362
02530700,SEBRING CAREER SCHOOLS                  ,TX,77083-1510,Proprietary  ,1,16,17,20,145,165
02548800,SOUTH TEXAS VO-TECH INSTITUTE           ,TX,78596-0000,Proprietary  ,86,258,344,783,1743,2526
02548802,SOUTH TEXAS VOCATIONAL TECHNICAL INSTITU,TX,78520-8710,Proprietary  ,13,33,46,85,124,209
02549400,SOUTH TEXAS VO-TECH INSTITUTE           ,TX,78501-0000,Proprietary  ,140,405,545,999,2652,3651
02549402,SOUTH TEXAS VOCATIONAL TECHNICAL INSTITU,TX,78416-1141,Proprietary  ,7,51,58,56,175,231
02555400,UNIV OF TX MD ANDERSON CANCER CTR       ,TX,77030-0000,Public       ,1,16,17,123,433,556
02568100,TEXAS BARBER COLLEGES & HAIRSTYLING     ,TX,75208-0000,Proprietary  ,92,230,322,501,1632,2133
02569300,LE CORDON BLEU COLLEGE OF CULINARY ARTS ,TX,78758-3647,Proprietary  ,199,784,983,2126,7050,9176
02572000,COMPUTER CAREER CENTER                  ,TX,79925-2021,Proprietary  ,59,304,363,372,1516,1888
02572004,COMPUTER CAREER CENTER - AMARILLO CAMPUS,TX,79101-2404,Proprietary  ,12,99,111,103,489,592
02572005,COMPUTER CAREER CENTER - LUBBOCK CAMPUS ,TX,79414-3517,Proprietary  ,6,80,86,59,410,469
02580100,IVERSON BUSINESS SCH & COURT REPORT     ,TX,76011-1344,Proprietary  ,14,43,57,87,508,595
02591100,CAREER POINT COLLEGE                    ,TX,78201-2027,Proprietary  ,74,380,454,521,3069,3590
02591900,KAPLAN COLLEGE                          ,TX,79907-1525,Proprietary  ,67,274,341,529,1764,2293
02591905,KAPLAN COLLEGE - BROWNSVILLE            ,TX,78521-9905,Proprietary  ,32,90,122,271,683,954
02596400,REDSTONE COLLEGE - LOS ANGELES          ,TX,77061-0000,Proprietary  ,25,49,74,229,426,655
02596500,ATI CAREER TRAINING CENTER              ,TX,76180-1599,Proprietary  ,167,747,914,1215,5018,6233
02596503,ATI- CAREER TRAINING CENTER - HOUSTON (#,TX,77029-1978,Proprietary  ,13,44,57,75,257,332
02596600,ATI-CAREER TRAINING CENTER              ,TX,75220-4443,Proprietary  ,105,295,400,946,3179,4125
02596601,ATI CAREER TRAINING CENTER - RICHARDSON ,TX,75081-1948,Proprietary  ,4,20,24,47,201,248
02596602,ATI CAREER TRAINING CENTER - DALLAS (STE,TX,75247-6103,Proprietary  ,10,63,73,132,547,679
02600200,OCEAN CORPORATION (THE)                 ,TX,77099-3479,Proprietary  ,16,128,144,165,982,1147
02604700,CENTER FOR ADVANCED LEGAL STUDIES       ,TX,77098-4151,Proprietary  ,0,52,52,29,472,501
02606202,EVEREST COLLEGE - EVEREST INSTITUTE - BI,TX,77036-8014,Proprietary  ,52,291,343,430,1994,2424
02615000,SANFORD-BROWN COLLEGE                   ,TX,75247-6931,Proprietary  ,96,372,468,895,3566,4461
03009400,SW SCH BUS & TECH CAREERS               ,TX,78212-2840,Proprietary  ,10,32,42,56,196,252
03010604,VIRGINIA COLLEGE - VIRGINIA COLLEGE AT A,TX,78723-0000,Proprietary  ,27,157,184,275,1461,1736
03011800,UNIVERSITY OF COSMETOLOGY ARTS & SCIENCE,TX,78226-1160,Proprietary  ,3,22,25,40,181,221
03019800,PCI HEALTH TRAINING CENTER              ,TX,75247-4720,Proprietary  ,62,159,221,470,1258,1728
03021500,SW SCH BUS & TECH CAREERS               ,TX,78852-4859,Proprietary  ,4,29,33,101,178,279
03025000,TEXAS COLLEGE OF COSMETOLOGY            ,TX,79605-2001,Proprietary  ,7,45,52,61,264,325
03026000,DALFORTH AIRCRAFT TECH                  ,TX,75209-3091,Proprietary  ,0,0,0,0,1,1
03026500,REMINGTON COLLEGE - HOUSTON CAMPUS      ,TX,77082-1849,Proprietary  ,111,482,593,840,2699,3539
03026501,REMINGTON COLLEGE - NORTH HOUSTON CAMPUS,TX,77067-1849,Proprietary  ,6,26,32,138,488,626
03026505,REMINGTON COLLEGE - HOUSTON CAMPUS - DAL,TX,75041-9935,Proprietary  ,7,25,32,128,410,538
03026506,REMINGTON COLLEGE - FT. WORTH CAMPUS    ,TX,76112-1280,Proprietary  ,20,107,127,348,1158,1506
03028800,CIRCLE J BEAUTY SCHOOL                  ,TX,77587-3714,Proprietary  ,6,36,42,59,193,252
03031408,INTERNATIONAL ACADEMY OF DESIGN & TECHNO,TX,78229-2263,Proprietary  ,18,64,82,445,842,1287
03032300,SCHOOL OF AUTOMOTIVE MACHINISTS         ,TX,77055-1803,Proprietary  ,5,23,28,152,236,388
03035200,TINT SCHOOL OF MAKEUP & COSMETOLOGY     ,TX,75229-3734,Proprietary  ,12,46,58,76,294,370
03035300,SOUTHERN CAREERS INSTITUTE              ,TX,78704-5252,Proprietary  ,165,755,920,802,3540,4342
03035301,SOUTHERN CAREERS INSTITUTE              ,TX,78577-0000,Proprietary  ,20,81,101,276,911,1187
03035302,SOUTHERN CAREERS INSTITUTE - CORPUS CHRI,TX,78414-2904,Proprietary  ,13,98,111,114,602,716
03035303,SOUTHERN CAREERS INSTITUTE - #1         ,TX,78221-4351,Proprietary  ,1,16,17,38,252,290
03035305,SOUTHERN CAREERS INSTITUTE - BROWNSVILLE,TX,78520-8680,Proprietary  ,1,1,2,24,47,71
03035306,SOUTHERN CAREERS INSTITUTE - HARLINGEN  ,TX,78550-7911,Proprietary  ,1,5,6,32,64,96
03035307,SOUTHERN CAREERS INSTITUTE - CORPUS CHRI,TX,78410-1609,Proprietary  ,0,10,10,22,71,93
03061800,STAR COLLEGE OF COSMETOLOGY             ,TX,75702-8214,Proprietary  ,7,26,33,90,189,279
03064600,UNIVERSITY OF TEXAS AT BROWNSVILLE      ,TX,78520-4993,Public       ,210,337,547,8691,9249,17940
03075400,ICC TECHNICAL INSTITUTE                 ,TX,77004-2930,Private      ,12,31,43,65,218,283
03076403,BRYMAN SCHOOL OF ARIZONA (THE) - ANTHEM ,TX,75038-4201,Proprietary  ,1,9,10,54,189,243
03079201,WESTWOOD COLLEGE OF TECHNOLOGY          ,TX,76180-0000,Proprietary  ,8,33,41,224,612,836
03083701,GALEN HEALTH INSTITUTES - TEXAS CAMPUS  ,TX,78229-6041,Proprietary  ,0,0,0,48,188,236
03103400,SOUTH TEXAS COLLEGE                     ,TX,78501-6699,Public       ,624,851,1475,13825,15207,29032
03104700,TEXAS COLLEGE OF COSMETOLOGY            ,TX,76903-4708,Proprietary  ,7,41,48,57,225,282
03108700,ROYAL BEAUTY CAREERS                    ,TX,77069-4611,Proprietary  ,23,67,90,138,481,619
03111000,MID-CITIES BARBER COLLEGE               ,TX,75051-4810,Proprietary  ,11,41,52,77,208,285
03115800,KAPLAN COLLEGE                          ,TX,78238-4203,Proprietary  ,28,166,194,301,1632,1933
03115802,KAPLAN COLLEGE - LAREDO                 ,TX,78041-6181,Proprietary  ,26,53,79,211,463,674
03115803,KAPLAN COLLEGE-BEAUMONT                 ,TX,77701-3706,Proprietary  ,19,112,131,260,971,1231
03115804,KAPLAN COLLEGE - LUBBOCK                ,TX,79401-2601,Proprietary  ,27,104,131,221,763,984
03128100,ACADEMY OF HEALTH CARE PROFESSIONS      ,TX,77092-8108,Proprietary  ,59,209,268,493,1581,2074
03144300,NATIONAL BEAUTY COLLEGE                 ,TX,75043-4046,Proprietary  ,4,19,23,19,69,88
03153300,AMER COLL OF ACUPUNCTURE & O.M.         ,TX,77063-4104,Proprietary  ,0,8,8,5,139,144
03156400,ACADEMY OF ORIENTAL MEDICINE AT AUSTIN  ,TX,78757-1132,Proprietary  ,4,9,13,43,314,357
03159300,ARLINGTON MEDICAL INSTITUTE             ,TX,76011-0000,Proprietary  ,5,34,39,147,478,625
03170300,TEXAS A&M UNIVERSITY-TEXARKANA          ,TX,75501-0000,Public       ,11,66,77,830,1909,2739
03179500,TEXAS COLG TRADITIONAL CHINESE MED      ,TX,78704-6748,Proprietary  ,0,3,3,3,131,134
03189400,COLLEGE OF SAINT THOMAS MORE            ,TX,76109-2323,Private      ,2,5,7,40,74,114
03237400,FARIS COMPUTER SCHOOL                   ,TX,77627-3829,Proprietary  ,1,6,7,4,51,55
03272300,KAPLAN COLLEGE                          ,TX,75234-7288,Proprietary  ,25,120,145,248,1453,1701
03272301,KAPLAN COLLEGE - MIDLAND                ,TX,79703-5531,Proprietary  ,15,82,97,161,708,869
03272303,KAPLAN COLLEGE - ARLINGTON              ,TX,76010-8121,Proprietary  ,23,126,149,195,975,1170
03275300,TOUCH OF CLASS SCHOOL OF COSM           ,TX,75402-6314,Proprietary  ,10,23,33,47,150,197
03276300,ACADEMY OF HAIR DESIGN                  ,TX,75901-4900,Proprietary  ,11,48,59,75,238,313
03277300,ACADEMY OF HAIR DESIGN                  ,TX,77701-4650,Proprietary  ,5,17,22,50,167,217
03303300,NORTHWEST EDUCATIONAL CENTER            ,TX,77092-7055,Proprietary  ,10,60,70,63,486,549
03371300,TONI&GUY HAIRDRESSING ACADEMY           ,TX,75006-2351,Proprietary  ,33,38,71,125,190,315
03372300,NORTHWEST VISTA COLLEGE                 ,TX,78251-4217,Public       ,259,511,770,8414,9919,18333
03396500,TEXAS STATE TECHNICAL COLG/MARSHALL     ,TX,75672-7402,Public       ,9,39,48,475,687,1162
03400300,CAREER QUEST                            ,TX,78229-3539,Proprietary  ,7,101,108,67,698,765
03412300,ADVANCED BARBER COLLEGE & HAIR DESI     ,TX,78596-0000,Proprietary  ,11,39,50,60,251,311
03416500,DALLAS NURSING INSTITUTE                ,TX,75243-5502,Proprietary  ,23,222,245,343,2452,2795
03422300,MILAN INSTITUTE                         ,TX,78238-4103,Proprietary  ,102,277,379,750,1769,2519
03422400,COLLEGE OF BIBLICAL STUDIES-HOUSTON     ,TX,77036-3211,Private      ,1,62,63,79,829,908
03424400,MEDVANCE INSTITUTE                      ,TX,77057-7386,Proprietary  ,73,274,347,424,1645,2069
03424401,MEDVANCE INSTITUTE -                    ,TX,77060-3551,Proprietary  ,0,0,0,47,243,290
03426300,CAREER ADVANCEMENT CENTER               ,TX,78752-1470,Proprietary  ,11,49,60,75,385,460
03480304,MEDVANCE INSTITUTE OF BATON ROUGE - GRAN,TX,75050-2342,Proprietary  ,16,65,81,150,550,700
03509400,CORYELL COSMETOLOGY COLLEGE             ,TX,76528-2036,Proprietary  ,1,3,4,5,16,21
03520300,LUBBOCK HAIR ACADEMY                    ,TX,79410-3524,Proprietary  ,3,11,14,29,153,182
03542300,CONCORDE CAREER INSTITUTE               ,TX,76011-4016,Proprietary  ,20,165,185,295,1529,1824
03551400,STATE BEAUTY ACADEMY                    ,TX,75116-3501,Proprietary  ,1,3,4,10,49,59
03556400,KUSSAD INSTITUTE OF COURT REPORTING     ,TX,78704-5712,Proprietary  ,0,6,6,6,62,68
03573300,AVIATION INSTITUTE OF MAINTENANCE       ,TX,75209-3017,Proprietary  ,37,115,152,238,1005,1243
03610300,MJ'S BEAUTY ACADEMY INC                 ,TX,75224-4409,Proprietary  ,2,15,17,38,118,156
03612400,VALLEY GRANDE INSTITUTE FOR ACADEMI     ,TX,78596-0000,Private      ,20,76,96,160,624,784
03627300,LAMAR INSTITUTE OF TECHNOLOGY           ,TX,77705-4142,Public       ,71,150,221,1850,3143,4993
03676400,HEALTHY HAIR ACADEMY                    ,TX,75227-0000,Proprietary  ,15,73,88,71,433,504
03680300,JAY'S TECHNICAL INSTITUTE               ,TX,77031-3509,Proprietary  ,5,25,30,50,206,256
03682400,DALLAS BARBER & STYLIST COLLEGE         ,TX,75231-0000,Proprietary  ,19,92,111,138,536,674
03714300,TREND BARBER COLLEGE                    ,TX,77071-2104,Proprietary  ,20,78,98,151,548,699
03723300,CULINARY INST ALAIN & MARIE LENOTRE     ,TX,77022-4322,Proprietary  ,10,49,59,186,512,698
03727600,CULINARY ACADEMY OF AUSTIN              ,TX,78752-0000,Proprietary  ,18,62,80,223,390,613
03731300,INTERNATIONAL RENOWNED BEAUTY ACADE     ,TX,76103-2504,Proprietary  ,1,13,14,12,73,85
03733300,BAPTIST UNIVERSITY OF THE AMERICAS      ,TX,78224-1336,Private      ,3,18,21,76,247,323
03756300,ANAMARC COLLEGE                         ,TX,79930-6230,Proprietary  ,17,128,145,178,1070,1248
03885700,HOUSTON'S TRAINING AND EDUCATION CENTER ,TX,77036-2021,Proprietary  ,2,2,4,34,176,210
03922300,SOUTH TEXAS BARBER COLLEGE              ,TX,78415-3463,Proprietary  ,1,9,10,35,86,121
03944400,PROFESSIONAL CAREERS INSTITUTE          ,TX,77036-2252,Proprietary  ,17,62,79,73,359,432
03970300,HANDS ON THERAPY                        ,TX,75149-2294,Proprietary  ,3,20,23,31,181,212
03987300,TEXAS HEALTH SCHOOL                     ,TX,77079-2106,Proprietary  ,8,48,56,104,352,456
04036300,SOUTHEAST TEXAS CAREER INSTITUTE        ,TX,77656-8601,Proprietary  ,3,16,19,32,107,139
04045300,NORTHWEST BEAUTY SCHOOL                 ,TX,77091-1208,Proprietary  ,5,31,36,39,176,215
04045400,MAI-TRIX BEAUTY COLLEGE                 ,TX,77040-0000,Proprietary  ,5,26,31,36,138,174
04082300,PROFESSIONAL CAREER TRAINING INSTITUTE  ,TX,77090-0000,Proprietary  ,7,30,37,28,240,268
04089400,CCI TRAINING CENTER                     ,TX,76011-4857,Proprietary  ,5,49,54,46,454,500
04117900,CHAMPION BEAUTY COLLEGE                 ,TX,77069-4611,Proprietary  ,3,14,17,43,188,231
04125400,ACADEMY AT AUSTIN (THE)                 ,TX,78660-3287,Proprietary  ,22,30,52,156,301,457
04125500,MANUEL AND THERESA'S SCHOOL OF HAIR DESI,TX,77803-3236,Proprietary  ,6,7,13,36,71,107
04129800,MEDIATECH INSTITUTE DALLAS              ,TX,75039-3105,Proprietary  ,24,30,54,213,374,587
04129801,MEDIATECH INSTITUTE AUSTIN              ,TX,78704-8933,Proprietary  ,5,16,21,114,164,278
04129802,MEDIATECH INSTITUTE HOUSTON             ,TX,77042-4712,Proprietary  ,14,27,41,138,236,374
04131700,SOUTHWEST CAREER COLLEGE                ,TX,79925-6230,Proprietary  ,57,222,279,347,1155,1502
04135600,CANNON INSTITUTE OF HIGHER LEARNING     ,TX,75247-9998,Proprietary  ,1,5,6,12,61,73
04136500,PCCENTER                                ,TX,75115-4214,Proprietary  ,2,18,20,15,134,149
04138500,CARDIOTECH ULTRASOUND SCHOOL            ,TX,77099-1440,Proprietary  ,1,27,28,56,361,417
04142300,AVEDA INSTITUTE SAN ANTONIO             ,TX,78215-1260,Proprietary  ,21,45,66,203,414,617
04146600,360 DEGREES BEAUTY ACADEMY              ,TX,77084-2714,Proprietary  ,4,16,20,27,109,136
04146700,AVIATION INSTITUTE OF MAINTENANCE       ,TX,77061-4004,Proprietary  ,45,119,164,45,119,164
04146800,SOUTH TEXAS TRAINING CENTER             ,TX,78586-7721,Proprietary  ,7,14,21,28,86,114
04152700,ASTRODOME CAREER CENTERS                ,TX,77054-2678,Proprietary  ,5,26,31,31,137,168
04154800,DUVALL'S SCHOOL OF COSMETOLOGY          ,TX,76021-4159,Proprietary  ,6,16,22,60,96,156
04155800,ADVANCED BEAUTY COLLEGE                 ,TX,75061-1918,Proprietary  ,1,6,7,18,88,106
04158500,TEXAS BEAUTY COLLEGE                    ,TX,76117-3201,Proprietary  ,2,12,14,10,83,93
04160700,AVENUE FIVE INSTITUTE                   ,TX,78757-7000,Proprietary  ,13,46,59,102,341,443
04161100,CORPUS CHRISTI BEAUTY ACADEMY           ,TX,78412-3900,Proprietary  ,0,13,13,26,89,115
04165800,SALON PROFESSIONAL ACADEMY (THE)        ,TX,75067-5390,Proprietary  ,5,18,23,60,159,219
04168700,LAWYER'S ASSISTANT SCHOOL OF DALLAS     ,TX,75201-2829,Proprietary  ,3,13,16,26,138,164
04168800,ABC BEAUTY ACADEMY                      ,TX,75042-8682,Proprietary  ,3,19,22,12,57,69
04169000,SALON & SPA INSTITUTE                   ,TX,78521-1727,Proprietary  ,4,25,29,17,71,88
04169100,DIAMONDS COSMETOLOGY COLLEGE            ,TX,75090-2657,Proprietary  ,1,7,8,8,28,36
04177900,BUCKNER BARBER SCHOOL                   ,TX,75217-1775,Proprietary  ,5,25,30,13,45,58
04179500,NORTH AMERICAN COLLEGE                  ,TX,77038-0000,Private      ,1,2,3,1,2,3
00367000,BRIGHAM YOUNG UNIVERSITY                ,UT,84602-8406,Private      ,689,746,1435,12542,14163,26705
00367100,DIXIE STATE COLLEGE OF UTAH             ,UT,84770-3876,Public       ,162,274,436,3974,5483,9457
00367200,LDS BUSINESS COLLEGE                    ,UT,84101-3500,Private      ,57,77,134,962,996,1958
00367400,STEVENS HENAGER COLLEGE                 ,UT,84401-1420,Proprietary  ,250,2241,2491,1566,12125,13691
00367500,UNIVERSITY OF UTAH                      ,UT,84112-9055,Public       ,368,819,1187,11410,18415,29825
00367600,COLLEGE OF EASTERN UTAH                 ,UT,84501-2699,Public       ,42,102,144,1035,1251,2286
00367700,UTAH STATE UNIVERSITY                   ,UT,84322-1400,Public       ,268,497,765,9477,11896,21373
00367800,SOUTHERN UTAH UNIVERSITY                ,UT,84720-2470,Public       ,144,142,286,4975,3762,8737
00367900,SNOW COLLEGE                            ,UT,84627-1299,Public       ,99,67,166,2564,1193,3757
00368000,WEBER STATE UNIVERSITY                  ,UT,84408-1136,Public       ,251,651,902,7011,13457,20468
00368100,WESTMINSTER COLLEGE                     ,UT,84105-3697,Private      ,35,102,137,2291,2142,4433
00402700,UTAH VALLEY UNIVERSITY                  ,UT,84058-5999,Public       ,491,993,1484,9962,18877,28839
00522000,SALT LAKE COMMUNITY COLLEGE             ,UT,84123-0000,Public       ,550,1573,2123,9193,20796,29989
00732953,ITT TECHNICAL INSTITUTE                 ,UT,84123-2500,Proprietary  ,59,278,337,534,2160,2694
00943300,SHERMAN KENDALL'S ACADEMY OF BEAUTY     ,UT,84106-1836,Proprietary  ,4,19,23,27,121,148
01009800,NEUMONT UNIVERSITY                      ,UT,84095-0000,Proprietary  ,9,5,14,507,114,621
01116500,UINTAH BASIN APPLIED TECHNOLOGY CLG     ,UT,84066-0000,Public       ,1,20,21,32,228,260
01116600,BROADVIEW UNIVERSITY                    ,UT,84088-4021,Proprietary  ,59,153,212,564,2101,2665
02078800,SHERMAN KENDALL'S ACADEMY OF BEAUTY     ,UT,84047-0000,Proprietary  ,1,7,8,29,69,98
02115400,BRIDGERLAND APPLIED TECHNOLOGY COLLEGE  ,UT,84321-0000,Public       ,38,123,161,329,1058,1387
02156600,DAVIS APPLIED TECHNOLOGY COLLEGE        ,UT,84037-0000,Public       ,58,217,275,555,2134,2689
02178500,EAGLE GATE COLLEGE                      ,UT,84123-0000,Proprietary  ,35,195,230,337,1881,2218
02178501,EAGLE GATE COLLEGE - LAYTON CAMPUS      ,UT,84041-2383,Proprietary  ,0,0,0,2,22,24
02178502,EAGLE GATE COLLEGE - SLC DOWNTOWN LEARNI,UT,84111-3407,Proprietary  ,0,0,0,4,19,23
02270800,AMERITECH COLLEGE                       ,UT,84604-6927,Proprietary  ,10,79,89,58,502,560
02270802,AMERITECH COLLEGE - DRAPER              ,UT,84020-6545,Proprietary  ,2,16,18,38,267,305
02298500,EVEREST COLLEGE                         ,UT,84119-2668,Proprietary  ,19,120,139,183,1090,1273
02346500,OGDEN-WEBER APPLIED TECHNOLOGY COLG     ,UT,84404-0000,Public       ,48,234,282,386,1996,2382
02360800,PROVO COLLEGE                           ,UT,84601-0000,Proprietary  ,37,75,112,353,1117,1470
02360802,PROVO COLLEGE - AMERICAN FORK CAMPUS    ,UT,84003-3395,Proprietary  ,0,0,0,2,6,8
02504000,MARINELLO SCHOOL OF BEAUTY              ,UT,84041-0000,Proprietary  ,6,35,41,63,182,245
02504001,MARINELLO SCHOOL OF BEAUTY - MAIN STREET,UT,84041-3002,Proprietary  ,0,2,2,8,18,26
02516100,MARINELLO SCHOOL OF BEAUTY              ,UT,84405-1501,Proprietary  ,12,61,73,70,220,290
02531800,VON CURTIS ACADEMY OF HAIR DESIGN       ,UT,84606-0000,Proprietary  ,142,188,330,997,1152,2149
02556800,PAUL MITCHELL THE SCHOOL                ,UT,84117-7204,Proprietary  ,32,46,78,237,390,627
02556801,PAUL MITCHELL THE SCHOOL                ,UT,84780-0000,Proprietary  ,0,3,3,8,11,19
02557700,PREMIER HAIR ACADEMY                    ,UT,84120-3603,Proprietary  ,5,9,14,22,73,95
02572700,EVANS HAIRSTYLING COLLEGE               ,UT,84770-0000,Proprietary  ,3,4,7,43,62,105
02572800,VISTA COLLEGE                           ,UT,84015-0000,Proprietary  ,2,29,31,33,185,218
02572802,VISTA COLLEGE - SALT LAKE CITY          ,UT,84119-1458,Proprietary  ,0,0,0,7,22,29
02573100,EVANS HAIRSTYLING COLLEGE               ,UT,84720-0000,Proprietary  ,3,7,10,38,66,104
02612200,MARINELLO SCHOOL OF BEAUTY              ,UT,84604-1585,Proprietary  ,11,20,31,103,154,257
03030600,UTAH COLLEGE OF MASSAGE THERAPY         ,UT,84111-1606,Proprietary  ,37,86,123,378,716,1094
03030601,UTAH CLG OF MASSAGE THER-PROVO CMPS     ,UT,84042-0000,Proprietary  ,14,32,46,95,198,293
03082100,MYOTHERAPY COLLEGE OF UTAH              ,UT,84115-2522,Proprietary  ,2,12,14,24,136,160
03108200,ECHELON EDGE ACADEMY OF HAIR SKIN & NAIL,UT,84070-2004,Proprietary  ,9,15,24,43,107,150
03110400,HAIRITAGE HAIR ACADEMY                  ,UT,84770-5233,Proprietary  ,2,6,8,36,69,105
03339400,WESTERN GOVERNORS UNIVERSITY            ,UT,84107-2533,Private      ,90,3469,3559,791,28998,29789
03413300,MOUNTAINLAND APPLIED TECHNOLOGY COLLEGE ,UT,84058-5857,Public       ,14,67,81,187,667,854
03463300,CAREERS UNLIMITED                       ,UT,84058-0000,Proprietary  ,7,19,26,53,166,219
03617300,HEALING MOUNTAIN MASSAGE SCHOOL         ,UT,84111-0000,Proprietary  ,3,7,10,30,108,138
03829500,SKINWORKS SCHOOL OF ADVANCED SKINCARE   ,UT,84115-0000,Proprietary  ,1,10,11,20,97,117
03838300,OGDEN INSTITUTE OF MASSAGE THERAPY      ,UT,84403-0000,Proprietary  ,2,17,19,32,103,135
03902300,RENAISSANCE SCHOOL OF THERAPEUTIC MASSAG,UT,84010-2835,Proprietary  ,0,10,10,7,47,54
03909300,MAXIMUM STYLE TEC SCHOOL OF COSMETOLOGY ,UT,84323-4679,Proprietary  ,3,8,11,52,86,138
03921300,CAMEO COLLEGE OF ESSENTIAL BEAUTY       ,UT,84115-0000,Proprietary  ,16,50,66,124,410,534
04054300,SOUTHWEST APPLIED TECHNOLOGY COLLEGE    ,UT,84720-6608,Public       ,2,36,38,85,282,367
04072300,AVEDA INSTITUTE PROVO                   ,UT,84604-1008,Proprietary  ,8,15,23,48,96,144
04118100,IMAGEWORKS ACADEMY OF HAIR DESIGN       ,UT,84660-1210,Proprietary  ,2,16,18,34,88,122
04121700,DIXIE APPLIED TECHNOLOGY COLLEGE        ,UT,84770-3025,Public       ,13,53,66,278,509,787
04142100,SKIN INSTITUTE (THE)                    ,UT,84770-6452,Proprietary  ,1,3,4,19,49,68
04145500,SKIN SCIENCE INSTITUTE (THE)            ,UT,84115-0000,Proprietary  ,3,16,19,40,162,202
04153000,RENAISSANCE ACADEMIE                    ,UT,84604-0000,Proprietary  ,3,5,8,31,47,78
04161900,MANDALYN ACADEMY                        ,UT,84003-2161,Proprietary  ,4,14,18,12,34,46
04165500,ACAYDIA SCHOOL OF AESTHETICS            ,UT,84601-0000,Proprietary  ,1,9,10,6,26,32
04169900,AMERICAN BEAUTY ACADEMY                 ,UT,84651-0000,Proprietary  ,3,13,16,19,41,60
04173200,TAYLOR ANDREWS ACADEMY OF HAIR DESIGN   ,UT,84088-6577,Proprietary  ,11,28,39,11,28,39
00368200,BENNINGTON COLLEGE                      ,VT,05201-6001,Private      ,9,19,28,1119,335,1454
00368300,CASTLETON STATE COLLEGE                 ,VT,05735-0000,Public       ,16,11,27,3039,474,3513
00368400,CHAMPLAIN COLLEGE                       ,VT,05401-3950,Private      ,33,83,116,3602,1173,4775
00368402,WOODBURY COLLEGE                        ,VT,05602-0000,Private      ,0,2,2,3,26,29
00368500,COLLEGE OF ST JOSEPH                    ,VT,05701-3899,Private      ,2,6,8,181,307,488
00368600,GODDARD COLLEGE                         ,VT,05667-0000,Private      ,5,54,59,88,1067,1155
00368700,GREEN MOUNTAIN COLLEGE                  ,VT,05764-1199,Private      ,7,9,16,1137,212,1349
00368800,JOHNSON STATE COLLEGE                   ,VT,05656-9898,Public       ,12,34,46,1514,1048,2562
00368900,LYNDON STATE COLLEGE                    ,VT,05851-0919,Public       ,17,14,31,1749,363,2112
00369000,MARLBORO COLLEGE                        ,VT,05344-0300,Private      ,3,9,12,447,127,574
00369100,MIDDLEBURY COLLEGE                      ,VT,05753-0000,Private      ,27,16,43,4057,536,4593
00369200,NORWICH UNIVERSITY                      ,VT,05663-1035,Private      ,20,129,149,2979,1750,4729
00369300,SOUTHERN VERMONT COLLEGE                ,VT,05201-6002,Private      ,3,15,18,612,223,835
00369400,ST MICHAELS COLLEGE                     ,VT,05439-0001,Private      ,26,14,40,3210,227,3437
00369600,UNIVERSITY OF VERMONT                   ,VT,05405-0160,Public       ,125,87,212,18594,3387,21981
00369700,VERMONT COLLEGE OF FINE ARTS            ,VT,05602-3128,Private      ,1,14,15,18,403,421
00369800,VERMONT TECHNICAL COLLEGE               ,VT,05061-0000,Public       ,10,21,31,1304,934,2238
00857500,SALON PROFESSIONAL ACADEMY (THE)        ,VT,05495-4001,Proprietary  ,4,10,14,54,88,142
00865800,O'BRIENS AVEDA INSTITUTE                ,VT,05403-7747,Proprietary  ,1,9,10,39,78,117
00886000,SIT                                     ,VT,05301-4801,Private      ,0,10,10,8,593,601
01116700,COMMUNITY COLLEGE OF VERMONT            ,VT,05676-0000,Public       ,79,326,405,1969,5012,6981
01193400,VERMONT LAW SCHOOL                      ,VT,05068-0000,Private      ,0,12,12,6,1166,1172
01218300,BURLINGTON COLLEGE                      ,VT,05401-8477,Private      ,1,5,6,211,150,361
02143500,STERLING COLLEGE                        ,VT,05827-0000,Private      ,2,0,2,145,34,179
02254000,NEW ENGLAND CULINARY INSTITUTE          ,VT,05602-0000,Proprietary  ,19,21,40,451,388,839
02532600,LANDMARK COLLEGE                        ,VT,05346-0000,Private      ,14,3,17,462,85,547
03708300,BURLINGTON TECHNICAL CENTER             ,VT,05401-2721,Public       ,0,2,2,11,23,34
04146900,ADVANCED WELDING INSTITUTE              ,VT,05403-0000,Proprietary  ,1,3,4,18,34,52
00392800,CASPER COLLEGE                          ,WY,82601-4612,Public       ,47,115,162,1292,2143,3435
00392900,EASTERN WYOMING COLLEGE                 ,WY,82240-1603,Public       ,9,29,38,454,476,930
00393000,SHERIDAN COLLEGE                        ,WY,82801-9133,Public       ,31,54,85,983,1263,2246
00393100,NORTHWEST COLLEGE                       ,WY,82435-1895,Public       ,31,32,63,992,859,1851
00393200,UNIVERSITY OF WYOMING                   ,WY,82071-3663,Public       ,101,178,279,6609,5062,11671
00393300,WESTERN WYOMING COMMUNITY COLLEGE       ,WY,82902-0000,Public       ,21,81,102,980,1379,2359
00728900,CENTRAL WYOMING COLLEGE                 ,WY,82501-0000,Public       ,19,63,82,577,1069,1646
00915700,WYOMING TECHNICAL INSTITUTE             ,WY,82072-9519,Proprietary  ,116,78,194,2566,1495,4061
00925900,LARAMIE COUNTY COMMUNITY CLG            ,WY,82007-3299,Public       ,46,141,187,1437,2387,3824
02211900,CHEEKS INTERNATIONAL ACDMY              ,WY,82001-0000,Proprietary  ,11,28,39,73,211,284
00393500,UNIV OF GUAM                            ,GU,96923-0000,Public       ,117,108,225,2349,1728,4077
01536100,GUAM COMMUNITY COLLEGE                  ,GU,96921-0000,Public       ,115,103,218,1420,1546,2966
03438300,PACIFIC ISLANDS UNIVERSITY              ,GU,96913-2619,Private      ,5,9,14,75,80,155
00393600,PONTIFICAL CATHOLIC UNIV OF PR          ,PR,00717-0777,Private      ,114,253,367,5956,5530,11486
00393700,UNIVERSITY OF THE SACRED HEART          ,PR,00914-0383,Private      ,111,219,330,3828,2736,6564
00393800,INTER-AMER UNIV PR-CNTRL ADMN           ,PR,00936-0000,Private      ,220,555,775,3565,6592,10157
00393801,INTER-AMER UNIV PR SCHL LAW             ,PR,00936-8351,Private      ,1,5,6,27,431,458
00393802,INTER AMERICAN UNIVERSITY OF PUERTO RICO,PR,00926-0000,Private      ,26,91,117,1146,1562,2708
00393803,INTER AMERICAN UNIVERSITY OF PR         ,PR,00683-0000,Private      ,114,166,280,3812,2267,6079
00393804,INTER-AMER UNIV PR-RECINTO AGUADILA     ,PR,00605-2000,Private      ,130,252,382,2825,2745,5570
00393805,INTER-AMER UNIV PR-ARECIBO CAMPUS       ,PR,00614-4050,Private      ,83,178,261,3243,3081,6324
00393806,INTER-AMER UNIV PR-BARRANQUITAS REG     ,PR,00794-0517,Private      ,143,92,235,1789,1150,2939
00393807,INTER-AMER UNIV PR-FAJARDO REGIONAL     ,PR,00738-0000,Private      ,59,90,149,1525,1301,2826
00393808,INTER-AMER UNIV PR - GUAYAMA CAMPUS     ,PR,00785-4004,Private      ,76,145,221,1304,1639,2943
00393809,INTER-AMER UNIV PR-PONCE REGIONAL       ,PR,00715-0000,Private      ,75,260,335,3628,4017,7645
00393811,INTER-AMER UNIV PR-BAYAMON REG CLG      ,PR,00959-0000,Private      ,89,113,202,4179,2174,6353
00394100,COLEGIO UNIVERSITARIO DEL ESTE          ,PR,00983-0000,Private      ,277,751,1028,7217,9392,16609
00394200,UNIVERSITY OF PR-CENTRAL ADMINISTRATION ,PR,00936-4984,Public       ,6,27,33,199,136,335
00394300,UNIVERSITY OF PUERTO RICO - HUMACAO UNIV,PR,00791-4300,Public       ,43,28,71,3735,738,4473
00394400,UNIVERSITY OF PUERTO RICO - MAYAGUEZ    ,PR,00680-0000,Public       ,183,287,470,10117,2422,12539
00501900,UNIV ADVENTISTA DE LAS ANTILLAS         ,PR,00681-0118,Private      ,30,33,63,801,476,1277
00502200,BAYAMON CENTRAL UNIVERSITY              ,PR,00960-0000,Private      ,50,123,173,1140,1325,2465
00710800,UNIVERSITY OF PUERTO RICO - RIO PIEDRAS ,PR,00931-3300,Public       ,148,446,594,10089,4072,14161
00720600,UNIVERSITY OF PUERTO RICO - CAYEY UNIVER,PR,00736-5534,Public       ,19,15,34,3412,596,4008
00722800,UNIVERSITY OF PUERTO RICO - ARECIBO     ,PR,00614-4010,Public       ,32,22,54,4054,701,4755
00890200,COLUMBIA CENTRO UNIVERSITARIO           ,PR,00726-0000,Proprietary  ,85,164,249,1119,1724,2843
00965200,"UNIVERSITY OF PUERTO RICO, PONCE TECH UN",PR,00716-0000,Public       ,30,17,47,3525,550,4075
01056700,COLEGIO TECNOLOGICO DE SAN JUAN         ,PR,00918-2973,Public       ,37,88,125,887,1133,2020
01072400,CARLOS ALBIZU UNIVERSITY                ,PR,00902-3711,Private      ,2,12,14,96,827,923
01081900,CONSERVATORIO DE MUSICA DE PUERTO RICO  ,PR,00907-3373,Public       ,2,8,10,303,113,416
01092200,UNIVERSITY OF PUERTO RICO - UTUADO      ,PR,00641-2500,Public       ,15,6,21,1433,287,1720
01097500,UNIVERSITY OF PUERTO RICO BAYAMON TECHNI,PR,00959-1911,Public       ,68,57,125,4563,848,5411
01120300,RYDER MEMORIAL HOSP SCH OF NURSING      ,PR,00792-0000,Private      ,0,0,0,21,11,32
01171900,UNIVERSIDAD DEL TURABO                  ,PR,00778-0000,Private      ,247,944,1191,7504,11104,18608
01194000,ICPR JUNIOR COLLEGE                     ,PR,00919-0000,Proprietary  ,165,242,407,1345,1829,3174
01194100,AMERICAN UNIVERSITY OF PUERTO RICO      ,PR,00960-2037,Private      ,59,73,132,980,773,1753
01194101,AMERICAN UNIVERSITY OF PUERTO RICO      ,PR,00674-0000,Private      ,66,61,127,794,680,1474
01212300,"UNIVERSITY OF PUERTO RICO, AGUADILLA REG",PR,00604-0160,Public       ,19,29,48,2639,649,3288
01252500,CARIBBEAN UNIVERSITY                    ,PR,00960-0493,Private      ,133,350,483,2833,4016,6849
01314800,RAMIREZ COLLEGE OF BUS & TECH           ,PR,00918-0000,Proprietary  ,0,0,0,0,3,3
02063100,MBTI BUSINESS TRNG INSTITUTE            ,PR,00907-3917,Proprietary  ,131,412,543,551,1672,2223
02100000,POLYTECHNIC UNIVERSITY OF PR            ,PR,00917-0000,Private      ,66,154,220,2834,2550,5384
02163300,UNIVERSIDAD CENTRAL DEL CARIBE          ,PR,00960-0000,Private      ,4,22,26,212,496,708
02165100,EDP COLLEGE OF PUERTO RICO              ,PR,00919-0000,Private      ,69,138,207,958,1676,2634
02166000,CENTER FOR ADVANCED STUDIES OF PUER     ,PR,00902-0000,Private      ,0,38,38,0,170,170
02166400,INSTITUTO DE BANCA Y COMERCIO           ,PR,00925-0000,Proprietary  ,1277,2207,3484,7375,10557,17932
02170300,INST EDUC TECNIA OCUP LA REINA          ,PR,00674-0000,Proprietary  ,45,115,160,345,529,874
02170301,INST EDUC TECNICA OCUPLA LA REINA       ,PR,00603-0000,Proprietary  ,0,0,0,1,6,7
02189100,CENTRO DE ESTUDIOS MULTIDISCIPLIN       ,PR,00926-0000,Private      ,134,224,358,1802,2401,4203
02189300,EMMA'S BEAUTY ACADEMY                   ,PR,00680-0000,Proprietary  ,21,42,63,261,251,512
02195400,MODERN HAIRSTYLING INSTITUTE            ,PR,00961-0000,Proprietary  ,154,119,273,861,718,1579
02195500,MODERN HAIRSTYLING INSTITUTE            ,PR,00612-0000,Proprietary  ,0,0,0,7,6,13
02195800,LICEO E ARTE Y TECNOLGIA                ,PR,00919-0000,Proprietary  ,44,65,109,656,755,1411
02195900,MODERN HAIRSTYLING INSTITUTE            ,PR,00980-0000,Proprietary  ,0,1,1,11,11,22
02234900,ANTILLES SCHOOL OF TECH CAREERS         ,PR,00909-3006,Proprietary  ,15,38,53,159,224,383
02241901,COMMONWEALTH OF PR DEPT OF EDUC - CARLOS,PR,00986-0000,Public       ,1,2,3,32,58,90
02241902,COMMONWEALTH OF PR DEPT OF EDUC - TOMAS ,PR,00613-0000,Public       ,0,0,0,42,37,79
02241904,COMMONWEALTH OF PR DEPT OF EDUC - ITPR R,PR,00655-0000,Public       ,21,12,33,556,269,825
02241905,COMMONWEALTH OF PR DEPT OF EDUC - JOSE A,PR,00674-0000,Public       ,0,1,1,107,30,137
02241907,COMMONWEALTH OF PR DEPT OF EDUC - ITPR R,PR,00928-0000,Public       ,14,13,27,454,235,689
02241908,COMMONWEALTH OF PR DEPT OF EDUC - ITPR R,PR,00732-0000,Public       ,10,11,21,506,285,791
02241909,COMMONWEALTH OF PR DEPT OF EDUC - TROQUE,PR,00959-0000,Public       ,0,0,0,37,9,46
02241910,COMMONWEALTH OF PR DEPT OF EDUC - ITPR R,PR,00701-1091,Public       ,1,6,7,623,289,912
02260600,NATIONAL COLLEGE OF BUSINESS & TECH     ,PR,00960-2036,Proprietary  ,267,723,990,3860,5888,9748
02260601,NATIONAL COLLEGE OF BUSINESS & TECHNOLOG,PR,00612-0000,Proprietary  ,0,0,0,60,37,97
02260602,NATIONAL COLLEGE OF BUSINESS & TECHNOLOG,PR,00745-9903,Proprietary  ,0,0,0,35,36,71
02260800,HUERTAS JUNIOR COLLEGE                  ,PR,00726-0000,Proprietary  ,89,203,292,1071,1594,2665
02297700,AUTOMECA TECHNICAL COLLEGE              ,PR,00957-0000,Proprietary  ,100,78,178,1199,789,1988
02303800,AMERICAN EDUCATIONAL COLLEGE            ,PR,00961-0000,Proprietary  ,84,131,215,586,925,1511
02335500,COLEGIO BIBLICO PENTECOSTAL DE PR       ,PR,00978-0000,Private      ,0,21,21,21,184,205
02340600,HUMACAO COMMUNITY COLLEGE               ,PR,00792-0000,Private      ,33,69,102,346,460,806
02343600,INSTITUTE OF BEAUTY CAREERS             ,PR,00613-0000,Proprietary  ,43,94,137,376,537,913
02460000,UNIVERSITY OF PUERTO RICO - MEDICAL SCIE,PR,00936-0000,Public       ,8,135,143,638,1559,2197
02482400,PONCE SCHOOL OF MEDICINE AND HEALTH SCIE,PR,00716-2347,Private      ,0,9,9,54,652,706
02502400,SERBIA'S SCHOOL OF BEAUTY CULTURE       ,PR,00785-0000,Proprietary  ,17,60,77,183,278,461
02504500,INSTITUCION CHAVIANO DE MAYAGUEZ        ,PR,00708-0000,Proprietary  ,11,50,61,50,195,245
02505400,ATLANTIC COLLEGE                        ,PR,00970-0000,Private      ,49,61,110,1067,553,1620
02534900,PONCE PARAMEDICAL COLLEGE (POPAC)       ,PR,00731-0000,Proprietary  ,208,251,459,2041,1819,3860
02552300,COLEGIO MAYOR DE TECHNOLOGIA            ,PR,00714-0000,Proprietary  ,54,68,122,230,319,549
02562500,INTERNATIONAL TECHNICAL COLLEGE         ,PR,00918-0000,Proprietary  ,7,33,40,46,159,205
02563500,ROGIES SCHOOL OF BEAUTY CULTURE         ,PR,00910-0000,Proprietary  ,0,0,0,128,214,342
02569400,ESCUELA DE ARTES PLASTICAS              ,PR,00902-1112,Public       ,4,7,11,406,205,611
02570400,EDUCATIONAL TECHNICAL COLLEGE           ,PR,00925-3404,Proprietary  ,107,243,350,578,1061,1639
02576100,ESCUELA TECNICA DE ELECTRICIDAD         ,PR,00731-0000,Proprietary  ,27,63,90,240,399,639
02587500,UNIVERSIDAD METROPOLITANA               ,PR,00928-0000,Private      ,259,985,1244,5736,9485,15221
02588600,SEMINARIO EVANGELICO DE PUERTO RICO     ,PR,00925-0000,Private      ,0,4,4,0,34,34
02593700,HISPANIC AMERICAN COLLEGE               ,PR,00725-0000,Proprietary  ,29,41,70,197,298,495
03016000,UNIVERSITY OF PUERTO RICO CAROLINA REGIO,PR,00985-0000,Public       ,42,46,88,3677,765,4442
03021900,EDIC COLLEGE                            ,PR,00726-0000,Proprietary  ,76,193,269,977,1342,2319
03025500,MECH TECH COLLEGE                       ,PR,00725-6118,Proprietary  ,216,299,515,3336,2291,5627
03025900,"LICEO DE ARTE, DISENOS Y COMERCIO       ",PR,00726-0000,Proprietary  ,22,58,80,321,446,767
03029700,"UNIVERSAL TECHNOLOGY CLG OF PR, INC     ",PR,00605-1955,Private      ,85,184,269,499,1087,1586
03061900,COLEGIO TECHNOLOGICO Y COMERCIAL        ,PR,00602-0960,Proprietary  ,3,8,11,35,75,110
03068400,STAR BEAUTY ACADEMY                     ,PR,00961-6312,Proprietary  ,15,19,34,59,93,152
03070500,D'MART INSTITUTE                        ,PR,00794-3517,Proprietary  ,103,211,314,883,1342,2225
03075600,EMMA'S BEAUTY ACADEMY                   ,PR,00795-0000,Proprietary  ,25,67,92,376,351,727
03085700,PROFESSIONAL TECHNICAL INSTITUTION      ,PR,00960-7061,Proprietary  ,31,46,77,216,258,474
03104400,PROFESSIONAL ELECTRIC SCHOOL            ,PR,00674-1797,Proprietary  ,4,10,14,36,46,82
03106900,ESCUELA DE PERITOS ELECTRICITAS         ,PR,00662-0457,Proprietary  ,2,15,17,44,73,117
03112100,JOHN DEWEY COLLEGE                      ,PR,00915-9538,Private      ,358,749,1107,2664,5154,7818
03112101,JOHN DEWEY COLLEGE                      ,PR,00986-0000,Private      ,103,157,260,686,889,1575
03112102,JOHN DEWEY COLLEGE-BAYAMON CAMPUS       ,PR,00959-0000,Private      ,43,81,124,504,798,1302
03112104,JOHN DEWEY COLLEGE - YABUCOA LRNING SITE,PR,00767-0767,Private      ,30,81,111,207,508,715
03112105,JOHN DEWEY COLLEGE - FAJARDO BRANCH     ,PR,00738-0738,Private      ,23,37,60,219,329,548
03112106,JOHN DEWEY COLLEGE - ARROYO BRANCH      ,PR,00714-0714,Private      ,11,35,46,67,169,236
03112107,JOHN DEWEY COLLEGE - JUANA DIAZ BRANCH  ,PR,00795-0000,Private      ,35,41,76,215,256,471
03112108,JOHN DEWEY COLLEGE - HATILLO CAMPUS     ,PR,00659-0000,Private      ,25,68,93,113,236,349
03112109,JOHN DEWEY COLLEGE - MANATI             ,PR,00674-0000,Private      ,30,73,103,244,452,696
03115900,TRINITY COLLEGE OF PUERTO RICO          ,PR,00734-0000,Private      ,10,23,33,108,185,293
03122500,ACADEMIA SERRANT INC.                   ,PR,00717-1568,Proprietary  ,18,66,84,144,359,503
03123100,GLOBELLE TECHNICAL INSTITUTE            ,PR,00693-4218,Proprietary  ,23,6,29,230,97,327
03124200,NOVA COLLEGE DE PUERTO RICO             ,PR,00960-4016,Proprietary  ,15,88,103,119,364,483
03157600,"COLEGIO DE CINEMATOGRAFIA, ARTES Y TELEV",PR,00961-6345,Proprietary  ,45,38,83,512,342,854
03177300,SAN JUAN BAUTISTA SCH OF MEDICINE       ,PR,00726-0000,Private      ,0,2,2,8,315,323
03326300,UNIVERSAL CAREER COMMUNITY COLLEGE      ,PR,00907-0000,Proprietary  ,93,182,275,623,883,1506
03336300,CENTURY COLLEGE                         ,PR,00603-0000,Proprietary  ,19,30,49,164,282,446
03414300,MONTECLARO                              ,PR,00745-9612,Private      ,0,0,0,6,3,9
03452300,INSTITUTO PRE-VOCACIONAL E INDUSTRI     ,PR,00613-1800,Private      ,22,48,70,74,158,232
03469300,IVAEM COLLEGE                           ,PR,00725-0000,Proprietary  ,3,6,9,154,80,234
03531300,COLEGIO PENTECOSTAL MIZPA               ,PR,00928-0966,Private      ,0,40,40,21,295,316
03544300,ATENAS COLLEGE                          ,PR,00674-0000,Private      ,60,85,145,860,1287,2147
03552300,LESTON COLLEGE                          ,PR,00961-6309,Proprietary  ,20,27,47,88,103,191
03608300,CARIBBEAN FORENSIC & TECHNICAL COLL     ,PR,00926-0000,Proprietary  ,5,16,21,48,115,163
03638300,ROSSLYN TRAINING ACADEMY OF COSMETOLOGY ,PR,00602-3225,Proprietary  ,3,13,16,27,73,100
03735400,"CHARLIES GUARD,DETECTIVE BUREAU&ACA     ",PR,00605-0000,Proprietary  ,13,29,42,77,182,259
03751300,ESCUELA HOTELERA DE SAN JUAN            ,PR,00917-0091,Proprietary  ,28,36,64,691,519,1210
03758300,BAYAMON COMMUNITY COLLEGE               ,PR,00960-0000,Proprietary  ,17,38,55,74,188,262
03781400,INDUSTRIAL TECHNICAL COLLEGE            ,PR,00792-0000,Proprietary  ,13,40,53,98,248,346
03785300,J.G. GUAYNABO TECHNICAL COLLEGE         ,PR,00960-0000,Proprietary  ,10,20,30,61,141,202
03800300,COLEGIO TECNICO DE ELECTRICIDAD GALLOSA ,PR,00602-0000,Proprietary  ,4,14,18,18,66,84
03800400,INSTITUTE OF BEAUTY OCCUPATIONS AND TECH,PR,00676-5071,Proprietary  ,6,12,18,64,105,169
03843300,ADVANCED TECH COLLEGE                   ,PR,00961-6321,Proprietary  ,28,66,94,148,309,457
03849300,AGUADILLA TECHNICAL COLLEGE             ,PR,00603-0000,Proprietary  ,1,11,12,26,61,87
03965400,MYRANGEL BEAUTY INSTITUTE               ,PR,00754-3917,Proprietary  ,20,57,77,96,233,329
04030300,"ASPIRA DE PUERTO RICO, ACADEMIA DE TECNO",PR,00987-0000,Private      ,0,0,0,6,9,15
04107300,CARIB TECHNOLOGICAL INSTITUTE           ,PR,00960-0000,Proprietary  ,27,37,64,195,219,414
04117200,INSTITUTO EDUCATIVO PREMIER             ,PR,00731-0000,Proprietary  ,13,49,62,105,232,337
04131600,LIBERTY TECHNICAL COLLEGE               ,PR,00737-1298,Proprietary  ,14,41,55,64,157,221
04158600,SCOTLAND EDUCATIONAL INSTITUTE          ,PR,00961-6312,Proprietary  ,0,2,2,4,23,27
00394600,UNIVERSITY OF THE VIRGIN ISLANDS        ,VI,00802-6000,Public       ,32,25,57,1145,949,2094
00394601,UNIV OF THE VIRGIN ISLANDS-ST CROIX     ,VI,00850-0000,Public       ,12,22,34,542,663,1205
00667700,MCGILL UNIVERSITY                       ,CN,00000-0000,Public       ,14,4,18,1798,454,2252
00667900,QUEEN'S UNIVERSITY AT KINGSTON          ,CN,00000-0000,Public       ,0,1,1,101,49,150
00668100,ST FRANCIS XAVIER UNIVERSITY            ,CN,00000-0000,Public       ,1,0,1,33,8,41
00668200,ST THOMAS UNIVERSITY                    ,CN,00000-0000,Public       ,0,0,0,18,4,22
00668300,UNIVERSITY OF GUELPH                    ,CN,00000-0000,Public       ,0,2,2,38,55,93
00668400,UNIVERSITY OF MANITOBA                  ,CN,00000-0000,Public       ,0,2,2,32,34,66
00668500,UNIVERSITY OF NEW BRUNSWICK (THE)       ,CN,00000-0000,Public       ,1,0,1,14,12,26
00668600,UNIVERSITY OF OTTAWA                    ,CN,00000-0000,Public       ,0,1,1,43,41,84
00668800,UNIVERSITY OF TORONTO                   ,CN,00000-0000,Public       ,4,6,10,328,384,712
00668900,UNIVERSITY OF WINDSOR                   ,CN,00000-0000,Public       ,0,0,0,17,51,68
00683700,UNIVERSITE LAVAL                        ,CN,00000-0000,Public       ,0,0,0,5,17,22
00683800,DALHOUSIE UNIVERSITY                    ,CN,00000-0000,Public       ,4,3,7,114,82,196
00685200,BISHOP'S UNIVERSITY                     ,CN,00000-0000,Private      ,1,1,2,44,6,50
00685300,MCMASTER UNIVERSITY                     ,CN,00000-0000,Public       ,1,0,1,31,34,65
00767900,YORK UNIVERSITY                         ,CN,00000-0000,Public       ,0,4,4,113,116,229
00787400,UNIVERSITY AT CALGARY (THE)             ,CN,00000-0000,Public       ,0,2,2,41,51,92
00814800,UNIVERSITY OF WINNIPEG                  ,CN,00000-0000,Public       ,0,1,1,15,5,20
00836200,UNIVERSITY OF ALBERTA (THE)             ,CN,00000-0000,Public       ,0,0,0,35,51,86
00836300,MOUNT SAINT VINCENT UNIVERSITY          ,CN,00000-0000,Private      ,0,0,0,8,3,11
00836400,SAINT MARY'S UNIVERSITY                 ,CN,00000-0000,Public       ,1,0,1,24,12,36
00836500,CONCORDIA UNIVERSITY - SIR GEORGE W     ,CN,00000-0000,Public       ,6,2,8,238,163,401
00836600,UNIVERSITE DE MONTREAL                  ,CN,00000-0000,Public       ,1,2,3,10,35,45
00836800,CARLETON UNIVERSITY                     ,CN,00000-0000,Public       ,0,2,2,49,37,86
00836900,UNIVERSITY OF BRITISH COLUMBIA          ,CN,00000-0000,Public       ,8,9,17,755,550,1305
00837000,"SAFA, UNIVERSITY OF VICTORIA            ",CN,00000-0000,Public       ,1,3,4,115,84,199
00844400,SIMON FRASER UNIVERSITY                 ,CN,00000-0000,Public       ,3,6,9,114,127,241
00844600,UNIVERSITY OF WESTERN ONTARIO (THE)     ,CN,00000-0000,Public       ,0,0,0,35,53,88
00844800,UNIVERSITY OF REGINA                    ,CN,00000-0000,Public       ,0,0,0,8,8,16
00844900,ACADIA UNIVERSITY                       ,CN,00000-0000,Public       ,0,1,1,58,13,71
00852600,UNIVERSITY OF WATERLOO                  ,CN,00000-0000,Public       ,1,0,1,41,22,63
00858200,WILFRID LAURIER UNIVERSITY              ,CN,00000-0000,Public       ,0,0,0,11,8,19
00891300,LAKEHEAD UNIVERSITY                     ,CN,00000-0000,Public       ,0,0,0,7,4,11
00911900,UNIVERSITE DE MONCTON                   ,CN,00000-0000,Public       ,0,0,0,0,3,3
00925200,BROCK UNIVERSITY                        ,CN,00000-0000,Public       ,0,0,0,15,7,22
00936700,UNIVERSITY OF PRINCE EDWARD ISLAND      ,CN,00000-0000,Public       ,0,1,1,21,110,131
00942100,BRANDON UNIVERSITY                      ,CN,00000-0000,Public       ,0,1,1,6,9,15
00948600,TRINITY WESTERN UNIVERSITY              ,CN,00000-0000,Private      ,3,2,5,174,46,220
00950000,MEMORIAL UNIVERSITY OF NEWFOUNDLAND     ,CN,00000-0000,Public       ,1,1,2,18,24,42
00950100,UNIVERSITY OF KING'S COLLEGE            ,CN,00000-0000,Public       ,0,0,0,25,3,28
00950300,MOUNT ALLISON UNIVERSITY                ,CN,00000-0000,Public       ,1,0,1,45,2,47
00950400,NOVA SCOTIA AGRICULTURAL COLLEGE        ,CN,00000-0000,Public       ,0,0,0,3,2,5
00950500,TRENT UNIVERSITY                        ,CN,00000-0000,Public       ,0,0,0,10,7,17
00969700,LETHBRIDGE COLLEGE                      ,CN,00000-0000,Public       ,0,0,0,1,3,4
00969800,MEDICINE HAT COLLEGE                    ,CN,00000-0000,Public       ,0,0,0,1,1,2
00970100,SENECA COLG OF APPLIED ARTS & TECH      ,CN,00000-0000,Public       ,0,3,3,21,41,62
01012300,NOVA SCOTIA COLLEGE OF ART & DESIGN     ,CN,00000-0000,Public       ,1,1,2,24,17,41
01022100,SAINT PAUL UNIVERSITY                   ,CN,00000-0000,Public       ,0,0,0,0,7,7
01045800,SHERIDAN COLLEGE OF APPLIED ARTS AN     ,CN,00000-0000,Public       ,0,1,1,23,12,35
01067500,REGENT COLLEGE                          ,CN,00000-0000,Private      ,0,5,5,4,91,95
01070300,UNIVERSITY OF LETHBRIDGE                ,CN,00000-0000,Public       ,0,0,0,10,7,17
01072000,RYERSON UNIVERSITY                      ,CN,00000-0000,Public       ,0,2,2,55,59,114
01172200,BRIERCREST BIBLE COLLEGE                ,CN,00000-0000,Private      ,0,0,0,15,4,19
01221100,ALGONQUIN CLG OF APPLIED ARTS &TECH     ,CN,00000-0000,Public       ,0,2,2,14,14,28
01222800,HUMBER COLLEGE                          ,CN,00000-0000,Public       ,1,0,1,28,30,58
01227400,PROVIDENCE COLLEGE                      ,CN,00000-0000,Private      ,0,0,0,9,5,14
02102100,BETHANY BIBLE COLLEGE                   ,CN,00000-0000,Private      ,0,0,0,52,23,75
02116600,CANADIAN MEMORIAL CHIROPRACTIC COLL     ,CN,00000-0000,Private      ,0,0,0,3,3,6
02167000,PRAIRIE BIBLE INST                      ,CN,00000-0000,Private      ,0,0,0,25,6,31
02184600,INSTITUTE FOR CHRISTIAN STUDIES         ,CN,00000-0000,Private      ,0,0,0,0,6,6
02195600,LASALLE COLLEGE                         ,CN,00000-0000,Private      ,0,0,0,13,13,26
02195700,TAYLOR UNIVERSITY COLLEGE AND SEMINARY  ,CN,00000-0000,Private      ,0,0,0,0,1,1
02201100,COLUMBIA BIBLE COLLEGE                  ,CN,00000-0000,Private      ,0,0,0,17,6,23
02216400,TYNDALE COLLEGE & SEMINARY              ,CN,00000-0000,Private      ,0,0,0,4,4,8
02219000,ST. LAWRENCE COLLEGE                    ,CN,00000-0000,Public       ,0,0,0,5,4,9
02219200,UNIVERSITY OF SASKATCHEWAN              ,CN,00000-0000,Public       ,0,1,1,8,20,28
02324900,EMMANUEL BIBLE COLLEGE                  ,CN,00000-0000,Private      ,0,0,0,3,1,4
02338800,EMILY CARR UNIVERSITY OF ART AND DESIGN ,CN,00000-0000,Public       ,3,0,3,71,43,114
02354700,RED DEER COLLEGE                        ,CN,00000-0000,Public       ,0,0,0,2,0,2
02577200,SALVATION ARMY WM & CATHERINE BOOTH     ,CN,00000-0000,Private      ,0,0,0,0,1,1
02593800,CONCORDIA UNIVERSITY COLLEGE            ,CN,00000-0000,Private      ,0,0,0,6,3,9
02611900,THE KING'S UNIVERSITY COLLEGE           ,CN,00000-0000,Private      ,0,0,0,2,1,3
03018300,ROCKY MOUNTAIN COLLEGE: CENTRE FOR BIBLI,CN,00000-0000,Private      ,0,0,0,2,1,3
03033800,UNIVERSITY COLLEGE OF CAPE BRETON       ,CN,00000-0000,Public       ,0,0,0,2,4,6
03078300,VANCOUVER SCHOOL OF THEOLOGY            ,CN,00000-0000,Private      ,0,2,2,4,7,11
03273300,CANADIAN COLLEGE OF NATUROPATHIC ME     ,CN,00000-0000,Private      ,0,2,2,2,23,25
03298300,ALBERTA COLLEGE OF ART & DESIGN         ,CN,00000-0000,Public       ,0,1,1,17,12,29
03332500,KWANTLEN UNIVERSITY COLLEGE             ,CN,00000-0000,Public       ,1,1,2,5,10,15
03335400,CANADIAN UNIVERSITY COLLEGE             ,CN,00000-0000,Private      ,1,1,2,31,15,46
03339300,ST. STEPHENS UNIVERSITY                 ,CN,00000-0000,Private      ,0,0,0,1,5,6
03348500,REDEEMER UNIVERSITY COLLEGE             ,CN,00000-0000,Private      ,0,0,0,11,1,12
03408300,CANDIAN NAZARENE UNIVERSITY COLLEGE     ,CN,00000-0000,Private      ,0,0,0,1,1,2
03420300,HOLLAND COLLEGE                         ,CN,00000-0000,Public       ,0,0,0,5,6,11
03511300,CN CLG ACUPUNCTURE & ORIENTAL MED       ,CN,00000-0000,Private      ,1,0,1,3,9,12
03560400,NIAGARA COLLEGE-WELLAND CAMPUS          ,CN,00000-0000,Public       ,0,0,0,5,4,9
03613300,UNIV OF NORTHERN BRITISH COLUMBIA       ,CN,00000-0000,Public       ,1,0,1,7,8,15
03644400,CANADIAN MENNONITE UNIVERSITY           ,CN,00000-0000,Private      ,0,0,0,6,2,8
03674400,CANADIAN SOUTHERN BAPTIST SEMINARY      ,CN,00000-0000,Private      ,0,0,0,0,4,4
03711300,CAPILANO UNIVERSITY                     ,CN,00000-0000,Public       ,1,1,2,22,14,36
03745300,BRITISH COLUMBIA INSTITUTE OF TECHNOLOGY,CN,00000-0000,Public       ,0,3,3,4,20,24
03846300,PACIFIC LIFE BIBLE COLLEGE              ,CN,00000-0000,Private      ,0,0,0,4,5,9
03847300,ATLANTIC BAPTIST UNIVERSITY             ,CN,00000-0000,Private      ,0,0,0,6,3,9
04122700,MCMASTER DIVINITY COLLEGE               ,CN,00000-0000,Private      ,0,0,0,0,9,9
04123100,ATLANTIC SCHOOL OF THEOLOGY             ,CN,00000-0000,Public       ,0,0,0,1,1,2
04156700,AMBROSE UNIVERSITY COLLEGE              ,CN,00000-0000,Private      ,0,1,1,10,7,17
00814700,UNIVERSIDAD AUTONOMA DE GUADALAJARA     ,MX,00000-0000,Private      ,0,27,27,70,1155,1225
01041800,INST TEC Y DE ESTSUPER DE MONTERRE      ,MX,00000-0000,Private      ,6,4,10,89,76,165
01067600,UNIVERSIDAD DE MONTERREY                ,MX,00000-0000,Private      ,2,1,3,23,38,61
01093800,UNIVERSIDAD DE GUANAJUATO               ,MX,00000-0000,Public       ,1,0,1,17,16,33
01097600,INSTITUTO ALLENDE                       ,MX,00000-0000,Private      ,0,0,0,7,18,25
02053300,CENTRO DE ESTUDIOS UNIVERSITARIOS D     ,MX,00000-0000,Private      ,6,26,32,100,209,309
01001000,AMERICAN SAMOA CMNTY COLLEGE            ,AS,96799-2609,Public       ,108,59,167,1772,491,2263
01034300,COLLEGE OF MICRONESIA - FSM             ,FM,96941-0159,Public       ,123,124,247,2385,1262,3647
01100900,PALAU COMMUNITY COLLEGE                 ,PW,96940-0009,Public       ,20,41,61,829,375,1204
03022400,COLLEGE OF THE MARSHALL ISLANDS         ,MH,96960-1258,Public       ,134,57,191,829,399,1228
03033000,NORTHERN MARIANAS COLLEGE               ,MP,96950-0000,Public       ,75,47,122,692,495,1187
,,,,,,,,,,
Source:  Central Processing System (CPS),,,,,,,,,,
"Data Run:  April 5, 2011",,,,,,,,,,
