OPE ID,School,State,Zip Code,School Type,20112012Qtr4_Dependent Students,20112012Qtr4_Independent Students,Quarterly Total,YTD_20112012Qtr4_Dependent Students,YTD_20112012Qtr4_Independent Students,Award Year To Date Total
00100200,ALABAMA AGRCLTL & MECHL UNIV            ,AL,35762-1357,Public       ,147,223,370,5762,3453,9215
00100300,FAULKNER UNIVERSITY                     ,AL,36109-3398,Private      ,80,282,362,1660,4100,5760
00100400,UNIVERSITY OF MONTEVALLO                ,AL,35115-6000,Public       ,71,108,179,2180,1565,3745
00100500,ALABAMA STATE UNIVERSITY                ,AL,36101-0000,Public       ,326,413,739,7835,5337,13172
00100700,CENTRAL ALABAMA COMMUNITY COLLEGE       ,AL,35011-0000,Public       ,91,276,367,1509,2435,3944
00100800,ATHENS STATE UNIVERSITY                 ,AL,35611-1999,Public       ,32,252,284,879,3406,4285
00100900,AUBURN UNIVERSITY                       ,AL,36849-5113,Public       ,622,440,1062,18712,6770,25482
00101200,BIRMINGHAM SOUTHERN COLLEGE             ,AL,35254-0002,Private      ,64,77,141,1846,653,2499
00101300,CALHOUN COMMUNITY COLLEGE               ,AL,35609-2216,Public       ,382,1079,1461,5112,8798,13910
00101500,ENTERPRISE STATE COMMUNITY COLLEGE      ,AL,36331-1300,Public       ,99,232,331,1320,2148,3468
00101600,UNIVERSITY OF NORTH ALABAMA             ,AL,35632-0001,Public       ,146,260,406,4618,3004,7622
00101700,GADSDEN STATE COMMUNITY COLLEGE         ,AL,35903-2269,Public       ,276,869,1145,3528,7095,10623
00101800,GEORGE C WALLACE COMMUNITY COLLEGE      ,AL,36303-0943,Public       ,164,554,718,2284,4661,6945
00101900,HUNTINGDON COLLEGE                      ,AL,36106-2148,Private      ,46,62,108,1389,689,2078
00102000,JACKSONVILLE STATE UNIVERSITY           ,AL,36265-1602,Public       ,270,506,776,7018,6162,13180
00102100,JEFFERSON DAVIS COMMUNITY COLLEGE       ,AL,36427-2790,Public       ,47,87,134,610,1007,1617
00102200,JEFFERSON STATE COMMUNITY COLLEGE       ,AL,35215-3098,Public       ,363,1070,1433,4604,9110,13714
00102300,JUDSON COLLEGE                          ,AL,36756-2504,Private      ,13,19,32,364,160,524
00102400,UNIVERSITY OF WEST ALABAMA              ,AL,35470-0000,Public       ,76,446,522,2145,5487,7632
00102600,MARION MILITARY INSTITUTE               ,AL,36756-3214,Public       ,21,13,34,495,86,581
00102800,MILES COLLEGE                           ,AL,35064-2697,Private      ,79,86,165,2101,1416,3517
00102900,UNIVERSITY OF MOBILE                    ,AL,36613-0000,Private      ,80,175,255,1520,1976,3496
00103000,BISHOP STATE COMMUNITY COLLEGE          ,AL,36603-5898,Public       ,226,712,938,2376,5611,7987
00103100,NORTHEAST ALABAMA STATE CMNTY COLG      ,AL,35986-0159,Public       ,103,264,367,1376,2546,3922
00103300,OAKWOOD COLLEGE                         ,AL,35896-0001,Private      ,45,105,150,1854,1045,2899
00103400,ALABAMA SOUTHERN COMMUNITY COLLEGE      ,AL,36460-5698,Public       ,61,149,210,1131,1366,2497
00103600,SAMFORD UNIVERSITY                      ,AL,35229-7000,Private      ,87,199,286,3214,2926,6140
00103800,SNEAD STATE COMMUNITY COLLEGE           ,AL,35957-0734,Public       ,81,230,311,1352,2053,3405
00104000,SOUTHERN UNION STATE COMMUNITY CLG      ,AL,36276-0000,Public       ,202,453,655,3454,3597,7051
00104100,SPRING HILL COLLEGE                     ,AL,36608-1791,Private      ,40,68,108,2234,806,3040
00104400,STILLMAN COLLEGE                        ,AL,35403-1430,Private      ,45,55,100,1791,673,2464
00104600,TALLADEGA COLLEGE                       ,AL,35160-2354,Private      ,36,36,72,706,455,1161
00104700,TROY UNIVERSITY                         ,AL,36082-0001,Public       ,370,1990,2360,8537,25294,33831
00105000,TUSKEGEE UNIVERSITY                     ,AL,36088-1645,Private      ,132,93,225,5123,1516,6639
00105100,UNIVERSITY OF ALABAMA (THE)             ,AL,35487-0120,Public       ,770,796,1566,21904,10677,32581
00105200,UNIVERSITY OF ALABAMA AT BIRMINGHAM     ,AL,35294-1150,Public       ,406,1019,1425,9633,12255,21888
00105500,UNIVERSITY OF ALABAMA IN HUNTSVILLE     ,AL,35899-0001,Public       ,173,371,544,4438,4357,8795
00105700,UNIVERSITY OF SOUTH ALABAMA             ,AL,36688-0002,Public       ,437,866,1303,9036,10192,19228
00105900,LAWSON STATE COMMUNITY COLLEGE          ,AL,35221-1798,Public       ,125,418,543,2618,4665,7283
00105901,LAWSON STATE COMMUNITY COLLEGE - BESSEME,AL,35021-0308,Public       ,39,154,193,662,1464,2126
00106000,FAULKNER STATE COMMUNITY COLLEGE        ,AL,36507-2698,Public       ,346,520,866,3362,4052,7414
00526000,J.F. DRAKE STATE TECH COLLEGE           ,AL,35811-1584,Public       ,67,262,329,590,2147,2737
00569100,SHELTON STATE COMMUNITY CLG             ,AL,35405-4017,Public       ,334,595,929,4337,4585,8922
00569200,REID STATE TECHNICAL COLLEGE            ,AL,36401-0000,Public       ,26,109,135,317,928,1245
00569700,NORTHWEST- SHOALS COMMUNITY COLLEGE     ,AL,35661-0000,Public       ,163,348,511,2163,2925,5088
00569900,GEORGE C WALLACE STATE CMTY COLLEGE     ,AL,36703-0000,Public       ,82,241,323,1137,2258,3395
00573300,BEVILL STATE CMTY COLLEGE-WALKER        ,AL,35148-0000,Public       ,157,429,586,2262,4007,6269
00573400,H. COUNCILL TRENHOLM STATE TECH COLLEGE ,AL,36108-0020,Public       ,95,338,433,987,2560,3547
00573401,H. C. TRENHOLM ST TECH COL-PATTERSON CAM,AL,36116-2612,Public       ,35,129,164,419,1046,1465
00787100,GEORGE C WALLACE STATE CMTY CLG         ,AL,35077-2000,Public       ,200,517,717,3255,5175,8430
00831000,AUBURN UNIVERSITY-MONTGOMERY            ,AL,36124-0000,Public       ,171,405,576,3956,4910,8866
00898800,LURLEEN B WALLACE COMMUNITY COLLEGE     ,AL,36420-0418,Public       ,57,172,229,1113,1570,2683
01055400,CONCORDIA COLLEGE                       ,AL,36701-3323,Private      ,29,47,76,758,564,1322
01218200,CHATTAHOOCHEE VALLEY CMTY CLG           ,AL,36869-7917,Public       ,54,214,268,922,1785,2707
01303906,SOUTH UNIVERSITY - MONTGOMERY           ,AL,36116-1120,Proprietary  ,43,192,235,417,1704,2121
02170600,UNITED STATES SPORTS ACADEMY            ,AL,36526-7055,Private      ,3,107,110,30,760,790
02199700,HERITAGE CHRISTIAN UNIVERSITY           ,AL,35630-0000,Private      ,2,13,15,20,82,102
02270400,SOUTHEASTERN BIBLE COLLEGE              ,AL,35244-2083,Private      ,3,19,22,75,202,277
02285000,PAUL MITCHELL THE SCHOOL HUNTSVILLE     ,AL,35758-0000,Proprietary  ,8,27,35,78,175,253
02296000,PRINCE INSTITUTE OF PROFESSIONAL STUDIES,AL,36117-0000,Proprietary  ,5,45,50,32,293,325
02341000,FORTIS COLLEGE                          ,AL,36609-0000,Proprietary  ,87,295,382,687,2075,2762
02503400,AMRIDGE UNIVERSITY                      ,AL,36124-0000,Private      ,4,106,110,65,1114,1179
02605500,REMINGTON COLLEGE - MOBILE CAMPUS       ,AL,36609-5593,Private      ,129,472,601,1035,2839,3874
03010600,VIRGINIA COLLEGE                        ,AL,35209-5154,Proprietary  ,322,2508,2830,1979,20257,22236
03010602,VIRGINIA COLLEGE - HUNTSVILLE           ,AL,35805-0000,Proprietary  ,25,182,207,294,1651,1945
03010607,VIRGINIA COLLEGE - MOBILE               ,AL,36608-1626,Proprietary  ,36,158,194,318,1537,1855
03010616,VIRGINIA COLLEGE - MONTGOMERY           ,AL,36117-2802,Proprietary  ,45,212,257,452,2076,2528
03032500,ALABAMA STATE CLG BARBER STYLING        ,AL,35215-8308,Proprietary  ,8,26,34,58,141,199
03361400,FORTIS COLLEGE                          ,AL,36535-0000,Proprietary  ,20,117,137,130,650,780
03459300,SOUTHEASTERN SCHOOL OF COSMETOLOGY      ,AL,35228-0000,Private      ,6,36,42,49,235,284
03783300,BLUE CLIFF CAREER COLLEGE               ,AL,63306-4749,Proprietary  ,13,62,75,77,296,373
03894300,HUNTSVILLE BIBLE COLLEGE                ,AL,35811-0000,Private      ,1,16,17,16,125,141
04066300,CARDIAC AND VASCULAR INSTITUTE OF ULTRAS,AL,36604-1411,Proprietary  ,1,25,26,30,203,233
04067300,SELMA UNIVERSITY                        ,AL,36701-0000,Private      ,8,34,42,180,477,657
04121500,COLUMBIA SOUTHERN UNIVERSITY            ,AL,36561-3815,Proprietary  ,47,1409,1456,403,11280,11683
04149200,XCELL ACADEMY-A PAUL MITCHELL PARTNER SC,AL,35216-4990,Proprietary  ,6,29,35,108,243,351
04187200,NEW BEGINNING COLLEGE OF COSMETOLOGY    ,AL,35950-2415,Proprietary  ,7,20,27,26,87,113
04187300,HAIR ACADEMY (THE)                      ,AL,36111-2201,Proprietary  ,5,21,26,18,67,85
00111100,ALLAN HANCOCK COLLEGE                   ,CA,93454-6399,Public       ,361,719,1080,4397,5317,9714
00111300,ANTELOPE VALLEY COLLEGE                 ,CA,93536-5426,Public       ,512,1505,2017,6619,11578,18197
00111600,ART CENTER COLLEGE OF DESIGN            ,CA,91103-1999,Private      ,77,93,170,1713,1582,3295
00111700,AZUSA PACIFIC UNIVERSITY                ,CA,91702-7000,Private      ,262,690,952,9678,7981,17659
00111800,BAKERSFIELD COLLEGE                     ,CA,93305-1299,Public       ,676,1563,2239,10464,13151,23615
00111900,BARSTOW COMMUNITY COLLEGE               ,CA,92311-6608,Public       ,130,710,840,1138,4557,5695
00112000,AMER BAPT SEM OF THE WEST-BERKELEY      ,CA,94704-0000,Private      ,0,3,3,8,75,83
00112100,BETHANY UNIVERSITY /  ASSEMBLIES OF GOD ,CA,95066-2896,Private      ,0,4,4,357,266,623
00112200,BIOLA UNIVERSITY                        ,CA,90639-0001,Private      ,143,141,284,6430,2382,8812
00112300,BROOKS INSTITUTE                        ,CA,93103-1809,Proprietary  ,64,57,121,814,664,1478
00112400,CABRILLO COLLEGE                        ,CA,95003-3194,Public       ,336,675,1011,4868,5971,10839
00112500,CALIFORNIA BAPTIST UNIVERSITY           ,CA,92504-3297,Private      ,132,257,389,5294,3897,9191
00112700,CALIFORNIA COLLEGE OF THE ARTS          ,CA,94107-2206,Private      ,59,100,159,2155,2049,4204
00113100,CALIFORNIA INSTITUTE OF TECHNOLOGY      ,CA,91125-0001,Private      ,68,51,119,3399,679,4078
00113200,CALIFORNIA INSTITUTE OF THE ARTS        ,CA,91355-2397,Private      ,56,55,111,2115,1593,3708
00113300,CALIFORNIA LUTHERAN UNIVERSITY          ,CA,91360-2787,Private      ,68,105,173,5011,2010,7021
00113400,CALIFORNIA MARITIME ACADEMY             ,CA,94590-8181,Public       ,11,16,27,837,379,1216
00113700,CALIF STATE UNIV-FULLERTON              ,CA,92831-3599,Public       ,992,1119,2111,42407,22300,64707
00113800,"CALIFORNIA STATE UNIVERSITY, EAST BAY   ",CA,94542-3000,Public       ,313,694,1007,12251,12429,24680
00113900,CALIF STATE UNIV-LONG BEACH             ,CA,90840-0006,Public       ,1118,1078,2196,53272,24414,77686
00114000,CALIF STATE UNIV-LOS ANGELES            ,CA,90032-4226,Public       ,628,886,1514,28868,21455,50323
00114100,"CALIF STATE UNIV, DOMINGUEZ HILLS       ",CA,90747-0001,Public       ,316,710,1026,15404,15413,30817
00114200,CALIF STATE UNIV SAN BERNARDINO         ,CA,92407-2397,Public       ,406,674,1080,18077,14056,32133
00114300,CAL POLY STATE UNIVERSITY               ,CA,93407-0001,Public       ,546,281,827,31537,4983,36520
00114400,CALIF STATE POLYTECHNIC UNIV POMONA     ,CA,91768-2500,Public       ,459,491,950,26276,11043,37319
00114600,CALIF STATE UNIV - CHICO                ,CA,95929-0001,Public       ,459,364,823,17284,6660,23944
00114700,CALIF STATE UNIV - FRESNO               ,CA,93740-8026,Public       ,512,629,1141,21852,12309,34161
00114900,HUMBOLDT STATE UNIVERSITY               ,CA,95521-8299,Public       ,235,171,406,10872,4211,15083
00115000,CALIF STATE UNIV-SACRAMENTO             ,CA,95819-6044,Public       ,685,1011,1696,26865,19631,46496
00115100,SAN DIEGO STATE UNIVERSITY              ,CA,92182-1690,Public       ,1113,1162,2275,47626,20909,68535
00115300,CALIF STATE UNIV-NORTHRIDGE             ,CA,91330-8307,Public       ,753,1069,1822,36049,21645,57694
00115400,SAN FRANCISCO STATE UNIVERSITY          ,CA,94132-1740,Public       ,764,944,1708,33627,20881,54508
00115500,SAN JOSE STATE UNIVERSITY               ,CA,95192-0036,Public       ,556,921,1477,27168,17729,44897
00115600,SONOMA STATE UNIVERSITY                 ,CA,94928-3609,Public       ,215,190,405,10888,3864,14752
00115700,CALIF STATE UNIV-STANISLAUS             ,CA,95382-0299,Public       ,178,280,458,8766,6474,15240
00116100,CERRITOS COLLEGE                        ,CA,90650-6296,Public       ,829,1430,2259,16172,13699,29871
00116200,CHABOT COLLEGE                          ,CA,94545-2400,Public       ,378,998,1376,6102,8252,14354
00116300,CHAFFEY COLLEGE                         ,CA,91737-9400,Public       ,822,1718,2540,13357,15215,28572
00116400,CHAPMAN UNIVERSITY                      ,CA,92866-1099,Private      ,215,178,393,9913,3921,13834
00116453,CHAPMAN UNIVERSITY SCHOOL OF LAW        ,CA,92866-0000,Private      ,7,26,33,75,2068,2143
00116500,CHURCH DIV SCH OF THE PACIFIC           ,CA,94709-0000,Private      ,0,1,1,0,55,55
00116600,CITRUS COLLEGE                          ,CA,91741-1899,Public       ,390,608,998,9047,7235,16282
00116900,CLAREMONT GRADUATE UNIVERSITY           ,CA,91711-0000,Private      ,1,88,89,19,1942,1961
00117000,CLAREMONT MCKENNA COLLEGE               ,CA,91711-6400,Private      ,56,10,66,3263,192,3455
00117100,HARVEY MUDD COLLEGE                     ,CA,91711-5990,Private      ,17,3,20,2366,93,2459
00117200,PITZER COLLEGE                          ,CA,91711-6101,Private      ,46,18,64,2859,218,3077
00117300,POMONA COLLEGE                          ,CA,91711-6301,Private      ,61,26,87,4880,232,5112
00117400,SCRIPPS COLLEGE                         ,CA,91711-3948,Private      ,38,9,47,1733,199,1932
00117600,WEST HILLS COMMUNITY COLLEGE            ,CA,93210-1399,Public       ,51,171,222,1332,1333,2665
00117700,COGSWELL POLYTECHNICAL COLLEGE          ,CA,94089-1210,Proprietary  ,24,22,46,263,185,448
00117800,COLLEGE OF MARIN                        ,CA,94904-2590,Public       ,79,295,374,1098,2698,3796
00117801,COLG OF MARIN-INDIAN VALLEY CMPS        ,CA,94949-0000,Public       ,8,32,40,79,198,277
00117900,NOTRE DAME DE NAMUR UNIVERSITY          ,CA,94002-1997,Private      ,39,101,140,1476,1326,2802
00118100,COLLEGE OF SAN MATEO                    ,CA,94402-3784,Public       ,193,408,601,2841,3182,6023
00118200,COLLEGE OF THE DESERT                   ,CA,92260-9305,Public       ,287,747,1034,5524,6123,11647
00118300,HOLY NAMES UNIVERSITY                   ,CA,94619-1699,Private      ,26,99,125,902,1120,2022
00118500,COLLEGE OF THE REDWOODS                 ,CA,95501-9300,Public       ,164,597,761,2644,4872,7516
00118600,COLLEGE OF THE SEQUOIAS                 ,CA,93277-2234,Public       ,414,1039,1453,6814,8167,14981
00118700,COLLEGE OF THE SISKIYOUS                ,CA,96094-2899,Public       ,58,187,245,1056,1414,2470
00118701,COLLEGE OF THE SISKIYOUS - YREKA CENTER ,CA,96097-9538,Public       ,7,39,46,77,219,296
00119000,CONTRA COSTA COLLEGE                    ,CA,94806-3195,Public       ,189,553,742,2467,4539,7006
00119100,DIABLO VALLEY COLLEGE                   ,CA,94523-1544,Public       ,374,719,1093,5183,5717,10900
00119200,CUESTA COLLEGE                          ,CA,93403-8106,Public       ,281,589,870,4445,4391,8836
00119300,CYPRESS COLLEGE                         ,CA,90630-5897,Public       ,567,999,1566,9224,9011,18235
00119600,DOMINICAN UNIVERSITY OF CALIFORNIA      ,CA,94901-2298,Private      ,51,85,136,3038,1448,4486
00119700,EL CAMINO COLLEGE                       ,CA,90506-0002,Public       ,644,1284,1928,12792,13025,25817
00119701,COMPTON COMMUNITY COLLEGE               ,CA,90221-5393,Public       ,143,436,579,2786,5230,8016
00119900,FOOTHILL COLLEGE                        ,CA,94022-4597,Public       ,200,420,620,3068,4230,7298
00120000,FULLER THEOLOGICAL SEMINARY             ,CA,91182-0000,Private      ,3,97,100,13,2369,2382
00120100,FULLERTON COLLEGE                       ,CA,92832-2095,Public       ,630,1014,1644,12298,9052,21350
00120200,GAVILAN COLLEGE                         ,CA,95020-9599,Public       ,106,262,368,1847,2481,4328
00120300,GLENDALE COMMUNITY COLLEGE              ,CA,91208-2894,Public       ,294,685,979,8953,9211,18164
00120500,GOLDEN GATE UNIVERSITY                  ,CA,94105-2967,Private      ,10,234,244,146,3953,4099
00120600,GOLDEN WEST COLLEGE                     ,CA,92647-2748,Public       ,473,832,1305,7876,7807,15683
00120700,GRADUATE THEOLOGICAL UNION              ,CA,94709-0000,Private      ,0,4,4,0,340,340
00120800,GROSSMONT COLLEGE                       ,CA,92020-1798,Public       ,582,1308,1890,8507,11005,19512
00120900,HARTNELL COMMUNITY COLLEGE              ,CA,93901-1697,Public       ,198,418,616,3613,3542,7155
00121200,HUMPHREYS COLLEGE                       ,CA,95207-3896,Private      ,20,104,124,368,1430,1798
00121400,IMPERIAL VALLEY COLLEGE                 ,CA,92251-9787,Public       ,261,518,779,4708,4029,8737
00121500,LA SIERRA UNIVERSITY                    ,CA,92515-3332,Private      ,68,91,159,2776,1298,4074
00121600,UNIVERSITY OF LA VERNE                  ,CA,91750-4443,Private      ,125,433,558,4862,7430,12292
00121700,LASSEN COLLEGE                          ,CA,96130-3000,Public       ,36,84,120,518,774,1292
00121800,LOMA LINDA UNIVERSITY                   ,CA,92350-0001,Private      ,43,192,235,1098,5969,7067
00121900,LONG BEACH CITY COLLEGE                 ,CA,90808-1780,Public       ,877,1958,2835,16167,17899,34066
00122000,MASTER'S COLLEGE & SEMINARY (THE)       ,CA,91321-1200,Private      ,24,55,79,1423,519,1942
00122300,LOS ANGELES CITY COLLEGE                ,CA,90029-3588,Public       ,466,1353,1819,8817,14397,23214
00122400,LOS ANGELES HARBOR COLLEGE              ,CA,90744-2397,Public       ,282,501,783,4332,5469,9801
00122600,LOS ANGELES PIERCE COLLEGE              ,CA,91371-0001,Public       ,607,1087,1694,11366,10338,21704
00122700,LOS ANGELES TRADE TECH COLLEGE          ,CA,90015-4181,Public       ,390,1425,1815,6013,12185,18198
00122800,LOS ANGELES VALLEY COLLEGE              ,CA,91401-4096,Public       ,493,1009,1502,8276,10371,18647
00122900,SO CA UNIV  HEALTH SCIENCES             ,CA,90604-4051,Private      ,2,50,52,34,814,848
00123000,SOUTHERN CA COLLEGE OF OPTOMETRY        ,CA,92831-1699,Private      ,0,3,3,12,535,547
00123200,AMERICAN RIVER COLLEGE                  ,CA,95841-4286,Public       ,978,3164,4142,12934,24560,37494
00123300,SACRAMENTO CITY COLLEGE                 ,CA,95822-1386,Public       ,888,2478,3366,13276,19335,32611
00123600,MENLO COLLEGE                           ,CA,94027-4301,Private      ,37,15,52,1588,216,1804
00123700,MERCED COMMUNITY COLLEGE                ,CA,95348-2898,Public       ,365,913,1278,6691,6979,13670
00123800,MILLS COLLEGE                           ,CA,94613-1301,Private      ,41,91,132,1963,1876,3839
00123900,MIRACOSTA COLLEGE                       ,CA,92056-3899,Public       ,307,713,1020,3977,6086,10063
00124000,MODESTO JUNIOR COLLEGE                  ,CA,95350-5800,Public       ,675,1644,2319,10089,13170,23259
00124200,MONTEREY PENINSULA COLLEGE              ,CA,93940-4799,Public       ,145,320,465,2581,2801,5382
00124300,MOUNT ST MARYS COLLEGE                  ,CA,90049-1599,Private      ,46,162,208,2828,2497,5325
00124500,MT. SAN ANTONIO COLLEGE                 ,CA,91789-1399,Public       ,659,1147,1806,17462,14679,32141
00124600,MT SAN JACINTO COLLEGE                  ,CA,92583-2399,Public       ,679,1595,2274,8171,12518,20689
00124700,NAPA VALLEY COLLEGE                     ,CA,94558-6236,Public       ,159,372,531,2699,3166,5865
00124900,OCCIDENTAL COLLEGE                      ,CA,90041-3314,Private      ,73,21,94,5331,382,5713
00125000,ORANGE COAST COLLEGE - FIN AID OFF      ,CA,92628-5005,Public       ,642,1090,1732,13043,10236,23279
00125100,OTIS COLLEGE OF ART AND DESIGN          ,CA,90045-3505,Private      ,52,56,108,1698,821,2519
00125200,HOPE INTERNATIONAL UNIVERSITY           ,CA,92631-0000,Private      ,19,113,132,722,1100,1822
00125300,FRESNO PACIFIC UNIVERSITY               ,CA,93702-4798,Private      ,77,271,348,2239,3834,6073
00125307,FRESNO PACIFIC UNIVERSITY - BIBLICAL SEM,CA,93702-4798,Private      ,0,0,0,10,71,81
00125400,PACIFIC LUTHERAN THEOLOGICAL SEM        ,CA,94708-0000,Private      ,1,1,2,4,85,89
00125500,PACIFIC OAKS COLLEGE                    ,CA,91103-3606,Private      ,0,117,117,35,813,848
00125600,PACIFIC SCHOOL OF RELIGION              ,CA,94709-0000,Private      ,0,4,4,1,183,184
00125800,PACIFIC UNION COLLEGE                   ,CA,94508-9797,Private      ,37,52,89,1874,555,2429
00125900,PALO VERDE COLLEGE                      ,CA,92225-0000,Public       ,18,61,79,267,580,847
00126000,PALOMAR COLLEGE                         ,CA,92069-1486,Public       ,542,1154,1696,9034,9271,18305
00126100,PASADENA CITY COLLEGE                   ,CA,91106-2003,Public       ,678,1241,1919,17982,13307,31289
00126200,POINT LOMA NAZARENE UNIVERSITY          ,CA,92106-2899,Private      ,105,129,234,4517,1696,6213
00126600,LANEY COLLEGE                           ,CA,94607-4893,Public       ,234,985,1219,3830,8585,12415
00126700,MERRITT COLLEGE                         ,CA,94619-3196,Public       ,124,505,629,2042,4741,6783
00126800,PORTERVILLE COLLEGE                     ,CA,93257-6059,Public       ,132,301,433,2169,2615,4784
00126900,RIO HONDO COLLEGE                       ,CA,90601-1699,Public       ,465,817,1282,10989,8691,19680
00127000,RIVERSIDE CITY COLLEGE                  ,CA,92506-1299,Public       ,944,2000,2944,20029,22821,42850
00127001,RIVERSIDE CITY COLLEGE - MORENO VALLEY C,CA,92551-2045,Public       ,0,0,0,1893,2247,4140
00127002,NORCO COLLEGE                           ,CA,91760-2600,Public       ,0,0,0,1561,1350,2911
00127200,SAN BERNARDINO VALLEY COLLEGE           ,CA,92410-2798,Public       ,565,1696,2261,8795,14191,22986
00127300,SAN DIEGO CITY COLLEGE                  ,CA,92101-4787,Public       ,678,2037,2715,10020,15742,25762
00127500,SAN DIEGO MESA COLLEGE                  ,CA,92111-4996,Public       ,696,1380,2076,9978,11960,21938
00127800,SAN FRANCISCO CONSERVATORY OF MUSIC     ,CA,94122-4498,Private      ,11,17,28,313,471,784
00127900,SAN FRANCISCO THEOLOGICAL SEMINARY      ,CA,94960-0000,Private      ,0,2,2,1,105,106
00128000,SAN JOAQUIN DELTA COLLEGE               ,CA,95207-6370,Public       ,709,1708,2417,10201,14402,24603
00128100,WILLIAM JESSUP UNIVERSITY               ,CA,95765-3707,Private      ,35,64,99,881,614,1495
00128200,SAN JOSE CITY COLLEGE                   ,CA,95128-2797,Public       ,290,776,1066,4304,6922,11226
00128400,SANTA ANA COLLEGE                       ,CA,92706-3398,Public       ,376,767,1143,7524,7906,15430
00128500,SANTA BARBARA CITY COLLEGE              ,CA,93109-2394,Public       ,385,731,1116,7571,6323,13894
00128600,SANTA MONICA COLLEGE                    ,CA,90405-1644,Public       ,790,1172,1962,18641,11974,30615
00128700,SANTA ROSA JUNIOR COLLEGE               ,CA,95401-4395,Public       ,421,1038,1459,6254,8308,14562
00128800,CLAREMONT SCHOOL OF THEOLOGY            ,CA,91711-0000,Private      ,0,7,7,4,220,224
00128900,SHASTA COLLEGE                          ,CA,96049-7692,Public       ,268,754,1022,4112,6310,10422
00129000,SIERRA COLLEGE                          ,CA,95677-3397,Public       ,628,1358,1986,7928,10429,18357
00129100,SIMPSON UNIVERSITY                      ,CA,96003-8606,Private      ,27,99,126,1160,1168,2328
00129200,SOLANO COMMUNITY COLLEGE                ,CA,94534-3197,Public       ,315,895,1210,3938,6706,10644
00129300,VANGUARD UNIVERSITY OF SOUTHERN CA      ,CA,92626-6597,Private      ,52,131,183,2258,1274,3532
00129400,SOUTHWESTERN COLLEGE                    ,CA,91910-7299,Public       ,602,1110,1712,9122,9102,18224
00129500,SOUTHWESTERN LAW SCHOOL                 ,CA,90010-1106,Private      ,2,41,43,36,2829,2865
00129600,DOMINICAN SCH PHILOSOPHY & THEOLOGY     ,CA,94709-0000,Private      ,0,2,2,8,60,68
00129900,ST JOHN'S SEMINARY COLLEGE              ,CA,93010-0000,Private      ,0,0,0,8,6,14
00130200,SAINT MARY'S COLLEGE OF CALIFORNIA      ,CA,94556-2744,Private      ,97,141,238,5699,1855,7554
00130500,STANFORD UNIVERSITY                     ,CA,94305-6106,Private      ,452,237,689,22927,3752,26679
00130501,STANFORD UNIVERSITY - GRADUATE SCHOOL OF,CA,94305-5301,Private      ,1,80,81,25,1727,1752
00130502,STANFORD UNIVERSITY - GRADUATE SCHOOL OF,CA,94305-5015,Private      ,0,53,53,32,1416,1448
00130503,STANFORD UNIVERSITY - STANFORD LAW SCHOO,CA,94305-3096,Private      ,6,25,31,61,2148,2209
00130700,FRESNO CITY COLLEGE                     ,CA,93741-0002,Public       ,879,2358,3237,16274,18628,34902
00130800,REEDLEY COLLEGE                         ,CA,93654-2099,Public       ,413,771,1184,7173,6124,13297
00130900,TAFT COLLEGE                            ,CA,93268-2317,Public       ,109,177,286,1708,1604,3312
00131200,UNIVERSITY OF CALIFORNIA-BERKELEY       ,CA,94720-1520,Public       ,698,744,1442,49680,21090,70770
00131300,UNIVERSITY OF CALIFORNIA-DAVIS          ,CA,95616-8558,Public       ,584,381,965,49555,16734,66289
00131400,UNIVERSITY OF CALIFORNIA-IRVINE         ,CA,92697-2825,Public       ,575,472,1047,51541,14386,65927
00131500,UNIVERSITY OF CALIFORNIA (UCLA)         ,CA,90095-9000,Public       ,1038,1273,2311,63371,30112,93483
00131502,UNIV OF CALIFORNIA LOS ANG SCH MED      ,CA,90095-0000,Public       ,15,29,44,161,1014,1175
00131503,UNIV OF CALIFORNIA LOS ANG DENTAL       ,CA,90095-0000,Public       ,8,11,19,64,182,246
00131600,UNIVERSITY OF CALIFORNIA-RIVERSIDE      ,CA,92521-0209,Public       ,429,377,806,35160,9176,44336
00131700,UNIVERSITY OF CALIFORNIA-SAN DIEGO      ,CA,92093-0013,Public       ,485,373,858,48115,11860,59975
00131900,UNIVERSITY OF CALIFORNIA-SFRANCISCO     ,CA,94143-0246,Public       ,100,156,256,1398,4444,5842
00132000,UNIVERSITY OF CALIFORNIA-SANTA BARB     ,CA,93106-3180,Public       ,589,231,820,47414,8520,55934
00132100,UNIVERSITY OF CALIFORNIA-SANTA CRUZ     ,CA,95064-0001,Public       ,369,221,590,30056,5541,35597
00132200,UNIVERSITY OF REDLANDS                  ,CA,92373-0999,Private      ,86,365,451,5027,3227,8254
00132500,UNIVERSITY OF SAN FRANCISCO             ,CA,94117-1080,Private      ,224,419,643,11176,8847,20023
00132600,SANTA CLARA UNIVERSITY                  ,CA,95053-4956,Private      ,149,160,309,10865,4598,15463
00132604,JESUIT SCHOOL OF THEOLOGY - BERKELEY    ,CA,94709-1193,Private      ,0,0,0,0,46,46
00132800,UNIVERSITY OF SOUTHERN CALIFORNIA       ,CA,90089-0914,Private      ,748,1383,2131,33586,29294,62880
00132900,UNIVERSITY OF THE PACIFIC               ,CA,95211-0197,Private      ,167,145,312,11793,3694,15487
00132901,UNIVERSITY OF THE PACIFIC - MCGEORGE SCH,CA,95817-2799,Private      ,3,34,37,134,2552,2686
00132902,UNIV OF THE PACIFIC SCH OF DENT         ,CA,94115-0000,Private      ,2,32,34,38,595,633
00133400,VENTURA COLLEGE                         ,CA,93003-3899,Public       ,429,843,1272,6003,6116,12119
00133500,VICTOR VALLEY COLLEGE                   ,CA,92395-5849,Public       ,441,1298,1739,6454,11804,18258
00133800,WEST VALLEY COLLEGE                     ,CA,95070-5697,Public       ,167,313,480,2723,3296,6019
00134100,WESTMONT COLLEGE                        ,CA,93108-1099,Private      ,40,9,49,2651,127,2778
00134200,WHITTIER COLLEGE                        ,CA,90601-4413,Private      ,69,24,93,3305,553,3858
00134201,WHITTIER COLLEGE - COLLEGE OF LAW       ,CA,92626-1501,Private      ,0,16,16,19,1582,1601
00134300,WOODBURY UNIVERSITY                     ,CA,91510-7846,Private      ,25,67,92,1006,956,1962
00134400,YUBA COLLEGE                            ,CA,95901-7699,Public       ,271,815,1086,3120,5441,8561
00177212,TRINITY INTERNATIONAL UNIV-CA           ,CA,92705-0000,Private      ,0,13,13,8,306,314
00274100,AMERICAN JEWISH UNIVERSITY              ,CA,90077-1599,Private      ,5,7,12,105,161,266
00301002,ANTIOCH UNIV/LOS ANGELES                ,CA,90230-7615,Private      ,3,83,86,49,1060,1109
00301003,ANTIOCH  UNIV/SANTA BARBARA             ,CA,93101-0000,Private      ,18,50,68,313,575,888
00369110,MIDDLEBURY COLLEGE - MONTEREY INSTITUTE ,CA,93940-2691,Private      ,2,41,43,43,917,960
00394700,UC-HASTINGS COLLEGE OF THE LAW          ,CA,94102-0000,Public       ,4,24,28,17,3658,3675
00394800,SAN FRANCISCO ART INSTITUTE             ,CA,94133-2299,Private      ,76,103,179,1542,1153,2695
00405402,HEBREW UNION COLLEGE JEWISH INSTITUTE OF,CA,90007-3717,Private      ,1,0,1,1,85,86
00408000,STARR KING SCHOOL FOR THE MINISTRY      ,CA,94709-1299,Private      ,0,4,4,0,80,80
00448000,DE ANZA COLLEGE                         ,CA,95014-5793,Public       ,489,760,1249,7546,7209,14755
00448100,OHLONE COLLEGE                          ,CA,94539-5847,Public       ,229,370,599,3191,3229,6420
00448400,JOHN F. KENNEDY UNIVERSITY              ,CA,94523-4817,Private      ,1,134,135,47,1728,1775
00449000,PATTEN UNIVERSITY                       ,CA,94601-2699,Private      ,9,28,37,241,432,673
00449400,EVEREST COLLEGE                         ,CA,92408-3752,Proprietary  ,52,167,219,490,997,1487
00450200,CITY COLLEGE OF SAN FRANCISCO           ,CA,94112-0000,Public       ,696,2017,2713,10104,16507,26611
00450302,EVEREST COLLEGE - SANTA ANA             ,CA,92701-4559,Proprietary  ,46,90,136,353,420,773
00563800,DOWNEY ADULT SCHOOL                     ,CA,90241-5610,Public       ,22,123,145,198,667,865
00565500,HACIENDA LA PUENTE ADULT EDUC CTR       ,CA,91746-0000,Public       ,12,69,81,134,512,646
00616500,LA CNTY CLG OF NURSING & ALLD HLTH      ,CA,90033-1018,Public       ,4,43,47,105,514,619
00672000,COLLEGE OF ALAMEDA                      ,CA,94501-2109,Public       ,112,351,463,2281,3316,5597
00673100,CASA LOMA COLLEGE                       ,CA,91405-4523,Private      ,18,63,81,223,693,916
00697300,CANADA COLLEGE                          ,CA,94061-1099,Public       ,108,323,431,1311,2187,3498
00697500,LINCOLN UNIVERSITY                      ,CA,94612-2801,Private      ,1,16,17,45,128,173
00701200,SAMUEL MERRITT COLLEGE                  ,CA,94609-3108,Private      ,13,157,170,345,2478,2823
00704700,LOS ANGELES SOUTHWEST COLLEGE           ,CA,90047-4810,Public       ,181,612,793,2896,7025,9921
00705000,BAY VISTA COLLEGE OF BEAUTY             ,CA,91950-3616,Proprietary  ,25,40,65,98,249,347
00711500,MOORPARK COLLEGE                        ,CA,93021-1695,Public       ,377,504,881,4986,4173,9159
00713000,NEWBERRY SCHOOLS OF BEAUTY              ,CA,91344-7404,Proprietary  ,10,8,18,66,93,159
00714200,LYLE'S COLLEGE OF BEAUTY                ,CA,93710-3948,Proprietary  ,9,37,46,135,191,326
00716400,BRYAN COLLEGE                           ,CA,90057-0000,Proprietary  ,34,282,316,237,1658,1895
00718700,NORTH ADRIAN'S COLLEGE OF BEAUTY        ,CA,95350-2381,Proprietary  ,14,26,40,152,211,363
00719000,WYOTECH                                 ,CA,94539-7663,Proprietary  ,112,322,434,836,1893,2729
00720300,SALON SUCCESS ACADEMY                   ,CA,91786-4060,Proprietary  ,15,20,35,120,120,240
00720400,MODERN BEAUTY ACADEMY                   ,CA,93030-7016,Proprietary  ,8,8,16,44,54,98
00722900,WESTERN BEAUTY INSTITUTE                ,CA,91402-3104,Proprietary  ,44,94,138,276,535,811
00723400,HEALD COLLEGE                           ,CA,94105-2206,Proprietary  ,89,247,336,697,2150,2847
00723600,ART INST OF CALIFORNIA-LOS ANGELES      ,CA,90405-3035,Proprietary  ,837,558,1395,7579,5908,13487
00725300,FEDERICO BEAUTY INSTITUTE               ,CA,95834-1905,Proprietary  ,34,57,91,270,385,655
00725800,MARINELLO SCH BTY                       ,CA,91606-3210,Proprietary  ,0,0,0,26,36,62
00729600,COLEMAN COLLEGE                         ,CA,92123-0000,Private      ,26,132,158,191,797,988
00732909,ITT TECHNICAL INSTITUTE                 ,CA,92868-3506,Proprietary  ,139,398,537,757,2248,3005
00732971,ITT TECHNICAL INSTITUTE                 ,CA,95670-6047,Proprietary  ,122,336,458,666,2037,2703
00732976,ITT TECHNICAL INSTITUTE                 ,CA,92408-3519,Proprietary  ,106,312,418,1155,2513,3668
00732981,ITT TECHNICAL INSTITUTE                 ,CA,92123-2662,Proprietary  ,116,453,569,896,2832,3728
00732985,ITT TECHNICAL INSTITUTE                 ,CA,91773-2933,Proprietary  ,147,314,461,776,1808,2584
00732989,ITT TECHNICAL INSTITUTE                 ,CA,90502-1356,Proprietary  ,127,394,521,725,2279,3004
00732994,ITT TECHNICAL INSTITUTE                 ,CA,91342-3664,Proprietary  ,110,283,393,654,1764,2418
00746501,AMERICAN ACADEMY OF DRAMATIC ARTS - HOLL,CA,90028-7504,Private      ,14,27,41,447,252,699
00747600,MARINELLO SCHOOLS OF BEAUTY             ,CA,90023-2666,Proprietary  ,189,389,578,1142,2035,3177
00747602,MARINELLO SCHOOLS OF BEAUTY - SPA ACADEM,CA,90048-5101,Proprietary  ,5,13,18,56,68,124
00747603,MARINELLO SCHOOLS OF BEAUTY - INGLEWOOD ,CA,90301-2306,Proprietary  ,1,3,4,21,25,46
00747604,MARINELLO SCHOOLS OF BEAUTY - RESEDA    ,CA,91335-4218,Proprietary  ,4,4,8,23,22,45
00747606,MARINELLO SCHOOLS OF BEAUTY - WEST COVIN,CA,91790-2805,Proprietary  ,0,6,6,37,42,79
00747607,MARINELLO SCHOOLS OF BEAUTY - SAN BERNAR,CA,92410-3261,Proprietary  ,8,8,16,128,120,248
00747608,MARINELLO SCHOOLS OF BEAUTY - ONTARIO   ,CA,91762-2113,Proprietary  ,4,12,16,88,119,207
00747609,MARINELLO SCHOOLS OF BEAUTY - WHITTIER  ,CA,90601-4107,Proprietary  ,4,13,17,45,60,105
00747611,MARINELLO SCHOOLS OF BEAUTY - SAN DIEGO ,CA,92126-4217,Proprietary  ,3,25,28,137,201,338
00747700,"HEALD COLLEGE,SCHOOLS OF BUS & TECH     ",CA,95670-6005,Proprietary  ,63,181,244,547,1985,2532
00753100,ACADEMY OF ART UNIVERSITY               ,CA,94105-3410,Proprietary  ,392,1023,1415,8463,13993,22456
00753600,COSUMNES RIVER COLLEGE                  ,CA,95823-5799,Public       ,486,1182,1668,7682,10061,17743
00754802,WESTWOOD COLLEGE OF TECHNOLOGY          ,CA,92801-0000,Proprietary  ,77,78,155,1066,772,1838
00754803,WESTWOOD COLLEGE OF TECHNOLOGY          ,CA,91786-0000,Proprietary  ,52,96,148,1106,969,2075
00760600,EVEREST COLLEGE                         ,CA,90010-2221,Proprietary  ,38,86,124,336,561,897
00760700,CONCORDE CAREER INSTITUTE               ,CA,91606-3134,Proprietary  ,56,113,169,308,704,1012
00770700,COLUMBIA COLLEGE                        ,CA,95370-8580,Public       ,83,219,302,1163,1605,2768
00771300,SKYLINE COLLEGE                         ,CA,94066-1698,Public       ,235,457,692,3185,3601,6786
00793000,CONCORDE CAREER INSTITUTE               ,CA,92108-0000,Proprietary  ,42,215,257,271,951,1222
00799300,CALIF STATE UNIV BAKERSFIELD            ,CA,93311-1022,Public       ,198,351,549,8181,6883,15064
00807100,CONCORDE CAREER INSTITUTE               ,CA,92840-9201,Proprietary  ,41,110,151,348,840,1188
00807300,BUTTE COMMUNITY COLLEGE                 ,CA,95965-0000,Public       ,450,1121,1571,7160,9368,16528
00809000,EVEREST COLLEGE                         ,CA,91803-1310,Proprietary  ,72,309,381,376,1222,1598
00809300,HEALD COLLEGE                           ,CA,93704-1706,Proprietary  ,104,302,406,1388,3020,4408
00853200,HEALD COLLEGE                           ,CA,94545-2352,Proprietary  ,84,258,342,903,2387,3290
00853202,HEALD COLLEGE - MODESTO                 ,CA,95368-9095,Proprietary  ,46,129,175,464,950,1414
00853700,CONCORDE CAREER INSTITUTE               ,CA,92401-0000,Proprietary  ,43,130,173,390,1157,1547
00859600,WEST LOS ANGELES COLLEGE                ,CA,90230-3500,Public       ,251,657,908,3721,6867,10588
00859700,FEATHER RIVER COLLEGE                   ,CA,95971-9124,Public       ,38,36,74,678,619,1297
00884400,CALIFORNIA CHRISTIAN COLLEGE            ,CA,93703-3599,Private      ,5,16,21,65,120,185
00884600,WRIGHT INSTITUTE                        ,CA,94704-0000,Private      ,0,16,16,1,504,505
00890300,COLLEGE OF THE CANYONS                  ,CA,91355-1899,Public       ,286,453,739,5990,5185,11175
00891800,SADDLEBACK COLLEGE                      ,CA,92692-3699,Public       ,408,893,1301,4974,6406,11380
00902200,ASSOCIATED TECHNICAL COLLEGE            ,CA,90017-0000,Proprietary  ,27,141,168,146,537,683
00903200,EMPIRE COLLEGE                          ,CA,95403-2122,Proprietary  ,26,92,118,159,576,735
00915706,WYOMING TECHNICAL INSTITUTE - WEST SACRA,CA,95605-1507,Proprietary  ,126,220,346,863,1332,2195
00927200,CRAFTON HILLS COLLEGE                   ,CA,92399-1799,Public       ,222,471,693,3507,3890,7397
00932500,ABRAM FRIEDMAN OCCUP CTR                ,CA,90015-3507,Public       ,10,43,53,85,256,341
00950900,SKILLS & BUSINESS EDUCATION CENTER      ,CA,95824-1529,Public       ,31,138,169,304,1254,1558
00974800,CARRINGTON COLLEGE CALIFORNIA           ,CA,95826-3203,Proprietary  ,74,273,347,799,2370,3169
00974801,CARRINGTON COLLEGE CALIFORNIA - SAN LEAN,CA,94578-3711,Proprietary  ,27,70,97,376,795,1171
00974802,CARRINGTON COLLEGE CALIFORNIA - PLEASANT,CA,94523-1984,Proprietary  ,22,56,78,240,516,756
00974803,CARRINGTON COLLEGE CALIFORNIA - STOCKTON,CA,95207-5509,Proprietary  ,23,72,95,326,620,946
00974804,CARRINGTON COLLEGE CALIFORNIA - CITRUS H,CA,95621-5577,Proprietary  ,49,81,130,278,739,1017
00974806,CARRINGTON COLLEGE CALIFORNIA -  ANTIOCH,CA,94531-1604,Proprietary  ,25,64,89,220,542,762
00974807,CARRINGTON COLLEGE CALIFORNIA - SAN JOSE,CA,95119-1325,Proprietary  ,41,119,160,433,990,1423
00974808,CARRINGTON COLLEGE CALIFORNIA - EMERYVIL,CA,94608-3006,Proprietary  ,7,31,38,129,303,432
00974809,WESTERN CAREER COLLEGE -  EMERYVILLE SHE,CA,94608-3006,Proprietary  ,1,3,4,18,61,79
00998900,SANTA BARBARA BUSINESS COLLEGE          ,CA,93111-0000,Proprietary  ,22,81,103,266,607,873
01011100,CERRO-COSO COMMUNITY COLLEGE            ,CA,93555-9571,Public       ,72,314,386,778,2324,3102
01014900,PEPPERDINE UNIVERSITY                   ,CA,90263-0000,Private      ,190,342,532,8563,7173,15736
01034000,LOS MEDANOS COLLEGE                     ,CA,94565-5197,Public       ,288,677,965,3359,5052,8411
01036500,CHARLES R DREW UNIV OF MED & SCI        ,CA,90059-0000,Private      ,4,52,56,95,729,824
01039500,UNIVERSITY OF SAN DIEGO                 ,CA,92110-2492,Private      ,506,370,876,16370,6029,22399
01039501,UNIVERSITY OF SAN DIEGO - SCHOOL OF LAW ,CA,92110-2492,Private      ,29,74,103,794,3382,4176
01044100,PARDEE RAND GRADUATE SCHOOL             ,CA,90407-2138,Private      ,0,5,5,0,30,30
01047400,MARYMOUNT COLLEGE OF PALOS VERDES       ,CA,90275-0000,Private      ,41,19,60,1467,192,1659
01083200,WESTERN STATE UNIV COLLEGE OF LAW       ,CA,92831-3014,Proprietary  ,0,29,29,20,1203,1223
01085400,THOMAS JEFFERSON SCHOOL OF LAW          ,CA,92110-0000,Private      ,2,97,99,25,2340,2365
01102400,EVEREST COLLEGE                         ,CA,94103-2091,Proprietary  ,23,98,121,188,506,694
01110700,EVEREST  COLLEGE                        ,CA,92801-5231,Proprietary  ,53,100,153,499,794,1293
01110900,EVEREST COLLEGE                         ,CA,91335-4631,Proprietary  ,63,265,328,549,1317,1866
01111200,FIDM-FASHION INSTITUTE OF DESIGN        ,CA,90015-1421,Proprietary  ,292,232,524,6589,2721,9310
01111700,ALLIANT INTERNATIONAL UNIVERSITY        ,CA,92131-1799,Private      ,13,128,141,136,2632,2768
01111705,ALLIANT INTERNATIONAL UNIVERSITY - LOS A,CA,91803-1360,Private      ,0,13,13,6,598,604
01111706,ALLIANT INTERNATIONAL UNIVERSITY - SAN F,CA,94133-1221,Private      ,6,27,33,40,857,897
01111707,ALLIANT INTERNATIONAL UNIVERSITY - FRESN,CA,93727-2014,Private      ,7,37,44,68,621,689
01112100,EVEREST COLLEGE                         ,CA,94541-4007,Proprietary  ,18,83,101,108,436,544
01112300,EVEREST COLLEGE                         ,CA,90247-4163,Proprietary  ,20,86,106,262,665,927
01146000,NATIONAL UNIVERSITY                     ,CA,92037-1011,Private      ,110,2367,2477,779,16854,17633
01162600,PRACTICAL SCHOOLS                       ,CA,92805-0000,Proprietary  ,24,48,72,418,796,1214
01164900,LOYOLA MARYMOUNT UNIVERSITY             ,CA,90045-0000,Private      ,184,170,354,12164,3777,15941
01164901,LMU  - LOYOLA LAW SCHOOL                ,CA,90015-0019,Private      ,14,46,60,263,3703,3966
01167200,MENDOCINO COLLEGE                       ,CA,95482-3000,Public       ,84,255,339,1255,2190,3445
01170700,NORTH-WEST COLLEGE                      ,CA,91790-2097,Proprietary  ,42,65,107,220,416,636
01179200,FRANCISCAN SCHOOL OF THEOLOGY           ,CA,94709-0000,Private      ,0,1,1,0,26,26
01182000,SAN DIEGO MIRAMAR COLLEGE               ,CA,92126-0000,Public       ,265,811,1076,3990,6064,10054
01186500,CALIFORNIA HAIR DESIGN ACADEMY          ,CA,92115-0000,Proprietary  ,16,49,65,142,257,399
01186600,LU ROSS ACADEMY                         ,CA,93001-2927,Proprietary  ,29,35,64,128,183,311
01202600,JE BOUTIQUE COLLEGE OF BEAUTY           ,CA,92021-6247,Proprietary  ,16,34,50,79,178,257
01202700,GALEN COLLEGE OF CALIFORNIA             ,CA,93728-2381,Proprietary  ,4,13,17,53,119,172
01203100,SAN DIEGO CHRISTIAN COLLEGE             ,CA,92019-1157,Private      ,68,424,492,950,1760,2710
01206100,EVEREST COLLEGE                         ,CA,95128-3908,Proprietary  ,29,112,141,258,574,832
01215400,CALIFORNIA INSTITUTE OF INTEGRAL STUDIES,CA,94103-2557,Private      ,5,78,83,30,1742,1772
01230002,PALMER COLLEGE OF CHIROPRACTIC - WEST CA,CA,95134-1617,Private      ,2,5,7,23,354,377
01231600,MANCHESTER BEAUTY COLLEGE               ,CA,93726-5306,Proprietary  ,7,34,41,137,259,396
01231700,TULARE BEAUTY COLLEGE                   ,CA,93274-3432,Proprietary  ,2,13,15,30,82,112
01244600,UNIVERSAL COLLEGE OF BEAUTY             ,CA,90044-0044,Proprietary  ,5,19,24,67,85,152
01245200,EVERGREEN VALLEY COLLEGE                ,CA,95135-1598,Public       ,284,615,899,4626,5481,10107
01255000,LOS ANGELES MISSION COLLEGE             ,CA,91342-3200,Public       ,257,487,744,4839,5201,10040
01265000,MARINELLO SCHOOL OF BEAUTY              ,CA,91502-2828,Proprietary  ,23,57,80,175,363,538
01265100,MARINELLO SCHOOL OF BEAUTY              ,CA,91748-1674,Proprietary  ,11,24,35,65,117,182
01284200,OXNARD COLLEGE                          ,CA,93030-0000,Public       ,244,547,791,3285,4243,7528
01287200,NORTH-WEST COLLEGE                      ,CA,91768-3199,Proprietary  ,37,98,135,194,490,684
01287300,WYOTECH                                 ,CA,90810-3800,Proprietary  ,111,322,433,1028,1611,2639
01287301,WYOTECH - EVEREST  COLLEGE              ,CA,90034-3158,Proprietary  ,20,96,116,224,615,839
01287302,WYOTECH - EVEREST  COLLEGE              ,CA,91746-3412,Proprietary  ,56,152,208,482,882,1364
01290700,LAKE TAHOE COMMUNITY COLLEGE            ,CA,96150-4524,Public       ,72,163,235,727,1113,1840
01291100,MARINELLO SCHOOL OF BEAUTY              ,CA,92646-2552,Proprietary  ,30,59,89,81,142,223
01291200,MTI COLLEGE                             ,CA,95841-0000,Proprietary  ,50,206,256,504,1594,2098
01294200,ROSEMEAD BEAUTY SCHOOL                  ,CA,91770-1639,Proprietary  ,6,46,52,41,264,305
01298400,PROFESSIONAL INSTITUTE OF BEAUTY        ,CA,91731-2613,Proprietary  ,7,30,37,29,103,132
01298500,HAIR CALIFORNIA BEAUTY ACADEMY          ,CA,92867-7127,Proprietary  ,0,11,11,24,62,86
01298900,OCEANSIDE COLLEGE OF BEAUTY             ,CA,92054-5393,Proprietary  ,6,30,36,91,159,250
01301000,LANCASTER BEAUTY SCHOOL                 ,CA,93534-3098,Proprietary  ,12,26,38,92,202,294
01307400,AMERICAN BEAUTY COLLEGE                 ,CA,91790-2906,Proprietary  ,11,17,28,71,82,153
01309500,SALON SUCCESS ACADEMY                   ,CA,92879-6561,Proprietary  ,13,26,39,155,231,386
01310300,CALIFORNIA WESTERN SCHOOL OF LAW        ,CA,92101-0000,Private      ,9,79,88,68,2060,2128
01324000,LYTLE'S REDWOOD EMPIRE BEAUTY CLG       ,CA,95403-0000,Proprietary  ,14,29,43,138,221,359
02054900,MARINELLO SCHOOL OF BEAUTY              ,CA,92630-0000,Proprietary  ,64,81,145,138,202,340
02059800,PARIS BEAUTY COLLEGE                    ,CA,94520-2611,Proprietary  ,6,24,30,52,153,205
02063500,COASTLINE COMMUNITY COLLEGE             ,CA,92708-0000,Public       ,100,728,828,1576,6313,7889
02064300,SIERRA COLLEGE OF BEAUTY                ,CA,95340-0000,Proprietary  ,5,22,27,92,184,276
02065700,CALIFORNIA BEAUTY COLLEGE               ,CA,95354-0000,Proprietary  ,14,32,46,159,192,351
02070500,CONCORDIA UNIVERSITY                    ,CA,92612-0000,Private      ,74,186,260,2283,2184,4467
02075800,SOUTHERN CA INST OF ARCHITECTURE        ,CA,90013-0000,Private      ,9,20,29,190,560,750
02086400,MARINELLO SCHOOL OF BEAUTY              ,CA,95050-0000,Proprietary  ,43,100,143,317,581,898
02091200,ELEGANCE INTERNATIONAL                  ,CA,90028-0000,Proprietary  ,10,24,34,125,178,303
02091700,KAPLAN COLLEGE                          ,CA,92123-1509,Proprietary  ,66,245,311,539,2068,2607
02091702,KAPLAN COLLEGE - CHULA VISTA            ,CA,91910-5342,Proprietary  ,24,76,100,196,384,580
02096100,FIELDING GRADUATE UNIVERSITY            ,CA,93105-0000,Private      ,1,199,200,3,1179,1182
02099200,AMERICAN CONSERVATORY THEATER           ,CA,94108-0000,Private      ,4,12,16,56,240,296
02110200,COLUMBIA COLLEGE                        ,CA,91356-0000,Private      ,14,12,26,339,174,513
02110800,CALIFORNIA COLLEGE SAN DIEGO            ,CA,92108-3821,Proprietary  ,82,259,341,1502,2661,4163
02111300,CUYAMACA COLLEGE                        ,CA,92019-0000,Public       ,299,680,979,3861,6230,10091
02113601,AMERICAN INTERCONTINENTAL UNIV - LOS ANG,CA,90066-7008,Proprietary  ,0,0,0,3,2,5
02119100,MISSION COLLEGE                         ,CA,95054-1897,Public       ,156,506,662,2999,5096,8095
02120600,SAYBROOK GRADUATE SCHOOL                ,CA,94111-1920,Private      ,0,40,40,2,680,682
02120700,SAN JOAQUIN VALLEY COLLEGE              ,CA,93291-0000,Proprietary  ,256,845,1101,2947,6499,9446
02125000,CAREER ACADEMY OF BEAUTY                ,CA,92845-0000,Proprietary  ,16,28,44,81,146,227
02128200,"VICTOR VALLEY BEAUTY COLLEGE, INC       ",CA,92392-0000,Proprietary  ,10,33,43,123,236,359
02128300,INSTITUTE FOR BUSINESS & TECHNOLOGY     ,CA,95050-0000,Proprietary  ,19,107,126,104,654,758
02128301,INSTITUTE FOR BUSINESS & TECHNOLOGY - NA,CA,95670-6351,Proprietary  ,5,86,91,56,412,468
02138300,PALO ALTO UNIVERSITY                    ,CA,94304-1337,Private      ,3,29,32,52,806,858
02147400,CLEVELAND CHIROPRACTIC COLLEGE          ,CA,90004-0000,Private      ,0,4,4,36,165,201
02161800,MUSICIANS INSTITUTE                     ,CA,90028-6157,Proprietary  ,105,145,250,1664,1317,2981
02167800,ESTES INSTITUTE OF COSMETOLOGY          ,CA,93291-0000,Proprietary  ,12,29,41,131,151,282
02174600,MARINELLO SCHOOL OF BEAUTY              ,CA,90201-0000,Proprietary  ,6,9,15,75,102,177
02180600,BRIDGES  ACADEMY OF BEAUTY              ,CA,92311-2327,Proprietary  ,1,2,3,8,30,38
02185800,MOLER BARBER COLLEGE                    ,CA,94611-0000,Proprietary  ,4,27,31,45,95,140
02187500,"HEALD COLLEGE, SCH OF BUS & TECH        ",CA,94520-0000,Proprietary  ,109,226,335,993,2309,3302
02188400,SIERRA VALLEY COLLEGE OF COURT REPORTING,CA,93726-0000,Proprietary  ,6,20,26,63,222,285
02208600,MADERA BEAUTY COLLEGE                   ,CA,93637-3519,Proprietary  ,6,23,29,64,104,168
02211000,SALON SUCCESS ACADEMY                   ,CA,92405-0000,Proprietary  ,4,9,13,77,76,153
02220000,COLLEEN O'HARA BEAUTY ACADEMY           ,CA,92701-0000,Proprietary  ,21,53,74,92,154,246
02220200,CALIFORNIA CULINARY ACADEMY             ,CA,94102-3336,Proprietary  ,47,110,157,647,957,1604
02221300,MARINELLO SCHOOL OF BEAUTY              ,CA,92553-0000,Proprietary  ,40,69,109,228,397,625
02222000,AMERICAN FILM INSTITUTE                 ,CA,90027-0000,Private      ,11,49,60,305,794,1099
02226000,EAST LOS ANGELES COLLEGE                ,CA,91754-0000,Public       ,689,1075,1764,14861,13203,28064
02228500,LIFE CHIROPRACTIC COLLEGE WEST          ,CA,94545-0000,Private      ,2,25,27,18,418,436
02230900,FREDRICK & CHARLES BEAUTY COLLEGE       ,CA,95501-0000,Proprietary  ,4,8,12,56,78,134
02231900,GEMOLOGICAL INSTITUTE OF AMERICA        ,CA,92008-4698,Private      ,1,21,22,56,232,288
02234300,FASHION CAREERS OF CALIFORNIA           ,CA,92110-0000,Proprietary  ,8,26,34,161,165,326
02236400,"THANH LE COLG, SCH OF COSMETOLOGY       ",CA,92840-0000,Proprietary  ,2,22,24,9,48,57
02237200,PHILLIPS GRADUATE INSTITUTE             ,CA,91316-0000,Private      ,1,43,44,3,268,271
02241600,SAN DIEGO CONTINUING EDUCATION          ,CA,92113-0000,Public       ,14,94,108,108,706,814
02241800,AMERICAN CAREER COLLEGE                 ,CA,90004-0000,Proprietary  ,184,489,673,1607,3184,4791
02242700,BERKELEY CITY COLLEGE                   ,CA,94704-0000,Public       ,190,453,643,2835,4287,7122
02250602,EVEREST COLLEGE                         ,CA,91761-8525,Proprietary  ,22,112,134,429,1342,1771
02255400,INTERNATIONAL SCHOOL OF COSMETOLOGY     ,CA,90250-0000,Proprietary  ,16,28,44,155,218,373
02255600,MARINELLO SCHOOL OF BEAUTY              ,CA,90723-0000,Proprietary  ,17,30,47,104,176,280
02258600,ALAMEDA BEAUTY COLLEGE                  ,CA,94501-0000,Proprietary  ,18,44,62,116,288,404
02262400,YESHIVA OHR ELCHONON CHABAD             ,CA,90046-0000,Private      ,13,0,13,46,1,47
02263101,ANTHEM COLLEGE - SACRAMENTO             ,CA,95827-3378,Proprietary  ,8,24,32,46,144,190
02267600,INSTITUTE OF TRANSPERSONAL PSYCHLGY     ,CA,94303-4624,Private      ,1,34,35,5,597,602
02270600,LIFE PACIFIC COLLEGE                    ,CA,91773-0000,Private      ,13,13,26,347,253,600
02276800,WESTMINSTER SEMINARY CALIFORNIA         ,CA,92027-0000,Private      ,0,7,7,0,155,155
02277400,SOUTH COAST COLLEGE                     ,CA,92868-2616,Proprietary  ,13,33,46,175,504,679
02282300,ALHAMBRA BEAUTY COLLEGE                 ,CA,91802-0000,Proprietary  ,6,15,21,56,116,172
02285100,HILLTOP BEAUTY SCHOOL                   ,CA,94014-0000,Proprietary  ,4,15,19,25,133,158
02298000,DESIGN INSTITUTE OF SAN DIEGO           ,CA,92121-0000,Proprietary  ,7,30,37,171,297,468
02304300,"PLATT COLLEGE, SAN DIEGO                ",CA,92115-0000,Proprietary  ,20,67,87,210,411,621
02306300,KAPLAN COLLEGE                          ,CA,95368-0000,Proprietary  ,43,101,144,401,760,1161
02306302,KAPLAN COLLEGE - FRESNO                 ,CA,93612-3802,Proprietary  ,26,71,97,277,565,842
02309500,CLOVIS ADULT EDUC                       ,CA,93611-0000,Public       ,6,43,49,54,361,415
02312400,LA COLLEGE INTERNATIONAL                ,CA,90010-0000,Proprietary  ,3,59,62,62,903,965
02327600,ART INSTITUTE OF CALIFORNIA - SAN DIEGO ,CA,92108-4401,Proprietary  ,467,466,933,4230,4195,8425
02330500,LAGUNA COLLEGE OF ART AND DESIGN        ,CA,92651-0000,Private      ,22,22,44,574,277,851
02332800,CENTER FOR EMPLOYMENT TRAINING          ,CA,95110-0000,Private      ,157,730,887,501,2333,2834
02338500,GLENDALE CAREER COLLEGE                 ,CA,91203-1207,Proprietary  ,38,131,169,225,552,777
02338700,MARINELLO SCHOOL OF BEAUTY              ,CA,94103-0000,Proprietary  ,29,86,115,250,463,713
02342400,ACADEMY OF RADIO BROADCASTING           ,CA,92647-3809,Proprietary  ,12,45,57,101,297,398
02343400,"BELLUS ACADEMY, THE ACADEMY OF BEAUTY AN",CA,92064-4633,Proprietary  ,41,92,133,283,557,840
02345800,MONTEBELLO BEAUTY COLLEGE               ,CA,90640-0000,Proprietary  ,4,6,10,47,78,125
02351900,KAPLAN COLLEGE                          ,CA,95660-5512,Proprietary  ,36,186,222,408,1333,1741
02351901,KAPLAN COLLEGE - BAKERSFIELD            ,CA,93304-0000,Proprietary  ,54,125,179,581,1113,1694
02358000,THOMAS AQUINAS COLLEGE                  ,CA,93060-9622,Private      ,4,2,6,377,24,401
02359300,SHASTA BIBLE COLLEGE                    ,CA,96002-0000,Private      ,2,8,10,45,67,112
02482700,WESTERN UNIVERSITY OF HEALTH S          ,CA,91766-1854,Private      ,8,55,63,125,5106,5231
02494800,LOLA BEAUTY COLLEGE                     ,CA,92641-0000,Proprietary  ,7,13,20,35,63,98
02497300,TRINITY COLLEGE                         ,CA,93277-8109,Proprietary  ,29,142,171,212,801,1013
02500000,SAN JOAQUIN COLLEGE OF LAW              ,CA,93612-0000,Private      ,2,7,9,19,351,370
02518400,THE NATIONAL HISPANIC UNIVERSITY        ,CA,95127-0000,Proprietary  ,21,68,89,332,625,957
02519800,AVANCE BEAUTY COLLEGE                   ,CA,92154-0000,Proprietary  ,6,25,31,80,156,236
02520200,CALIFORNIA CAREER SCHOOLS               ,CA,92805-0000,Proprietary  ,8,40,48,62,206,268
02520300,INTERIOR DESIGNERS INSTITUTE            ,CA,92660-0000,Proprietary  ,10,45,55,50,177,227
02520400,ADRIAN'S BEAUTY COLLEGE OF TURLOCK      ,CA,95382-0000,Proprietary  ,14,15,29,121,176,297
02537200,PALOMAR INSTITUTE OF COSMETOLOGY        ,CA,92069-0000,Proprietary  ,12,45,57,150,272,422
02539100,KAPLAN COLLEGE                          ,CA,91606-3231,Proprietary  ,55,137,192,549,1254,1803
02539102,KAPLAN COLLEGE -  RIVERSIDE             ,CA,92507-4223,Proprietary  ,24,131,155,353,828,1181
02539500,IRVINE VALLEY COLLEGE                   ,CA,92620-0000,Public       ,227,466,693,4757,4453,9210
02542300,NATIONAL HOLISTIC INSTITUTE             ,CA,94608-0000,Proprietary  ,32,162,194,222,879,1101
02543400,BROWNSON TECHNICAL SCHOOL               ,CA,92805-0000,Proprietary  ,4,44,48,49,239,288
02545900,HYPNOSIS MOTIVATION INSTITUTE           ,CA,91356-0000,Private      ,0,29,29,3,128,131
02546400,MTI BUSINESS COLLEGE INC                ,CA,95207-0000,Proprietary  ,3,50,53,50,204,254
02549000,KAPLAN COLLEGE                          ,CA,92083-7736,Proprietary  ,61,174,235,451,1248,1699
02549005,KAPLAN COLLEGE -  PALM SPRINGS          ,CA,92262-7011,Proprietary  ,27,87,114,291,617,908
02553500,ASSOCIATED TECHNICAL COLLEGE            ,CA,92101-0000,Proprietary  ,12,75,87,92,305,397
02553600,DIVERSIFIED LANGUAGE INSTITUTE          ,CA,90017-0000,Proprietary  ,22,275,297,75,889,964
02559300,UNITED EDUCATION INSTITUTE              ,CA,90020-0000,Proprietary  ,654,1422,2076,3560,7698,11258
02559400,INTERCOAST COLLEGES                     ,CA,92868-1656,Proprietary  ,47,477,524,259,2542,2801
02565400,KAPLAN COLLEGE                          ,CA,95207-6216,Proprietary  ,15,115,130,295,797,1092
02570300,LOS ANGELES ORT COLLEGE                 ,CA,90048-0000,Private      ,27,117,144,142,589,731
02577900,SANTA BARBARA BUSINESS COLLEGE          ,CA,93309-1664,Proprietary  ,41,92,133,542,1124,1666
02578000,SANTA BARBARA BUSINESS COLLEGE          ,CA,93454-6943,Proprietary  ,16,53,69,213,446,659
02584200,NEWBRIDGE COLLEGE                       ,CA,92701-0000,Proprietary  ,25,98,123,236,655,891
02591600,NORTH-WEST COLLEGE                      ,CA,91101-1744,Proprietary  ,10,31,41,73,212,285
02593100,HEALD COLLEGE                           ,CA,95678-5303,Proprietary  ,56,215,271,682,2196,2878
02593200,HEALD COLLEGE                           ,CA,95035-8008,Proprietary  ,134,293,427,851,2218,3069
02593300,HEALD COLLEGE                           ,CA,95210-5667,Proprietary  ,78,211,289,1105,2756,3861
02595600,ASIAN AMERICAN INTERNATIONAL BTY CG     ,CA,92683-4043,Proprietary  ,6,12,18,27,60,87
02597300,SOUTH BAYLO UNIVERSITY                  ,CA,92801-1701,Private      ,0,28,28,9,294,303
02602300,CENTRAL COAST COLLEGE                   ,CA,93901-3301,Proprietary  ,25,50,75,242,328,570
02608900,PINNACLE COLLEGE                        ,CA,91803-8842,Proprietary  ,13,18,31,71,102,173
02608901,PINNACLE COLLEGE - SACRAMENTO           ,CA,95670-6386,Proprietary  ,8,25,33,75,125,200
02609000,EMPERORS COLG OF TRAD ORIENTAL MED      ,CA,90403-5609,Proprietary  ,1,32,33,17,221,238
02612800,LOS ANGELES RECORDING SCHOOL            ,CA,90028-3112,Proprietary  ,33,52,85,430,419,849
03010611,VIRGINIA COLLEGE - GOLF ACADEMY OF AMERI,CA,92008-6512,Proprietary  ,11,40,51,94,328,422
03011300,"CALIF STATE UNIV, SAN MARCOS            ",CA,92096-0001,Public       ,250,353,603,12108,6879,18987
03019900,CAPSTONE COLLEGE                        ,CA,91402-4924,Proprietary  ,2,9,11,19,63,82
03025600,DELL'ARTE SCH OF PHYSICAL THEATRE       ,CA,95525-0816,Private      ,1,1,2,6,42,48
03027700,PACIFIC COLLEGE OF ORIENTAL MED         ,CA,92108-4408,Proprietary  ,4,94,98,57,673,730
03029600,POMONA ADULT SCHOOL                     ,CA,91766-0000,Public       ,12,21,33,84,224,308
03031409,INTERNATIONAL ACADEMY OF DESIGN AND TECH,CA,95834-9664,Proprietary  ,9,56,65,310,626,936
03034000,HEALD COLLEGE                           ,CA,93906-5100,Proprietary  ,60,162,222,895,1732,2627
03035700,LAS POSITAS COLLEGE                     ,CA,94551-6750,Public       ,193,374,567,2722,2697,5419
03039900,FREMONT COLLEGE                         ,CA,90703-5342,Proprietary  ,23,58,81,246,466,712
03043900,NEWSCHOOL OF ARCHITECTURE & DESIGN      ,CA,92101-6634,Proprietary  ,17,40,57,357,628,985
03044500,KAPLAN COLLEGE                          ,CA,91402-4222,Proprietary  ,4,19,23,103,229,332
03054100,ROYALE COLLEGE OF BEAUTY                ,CA,92590-2525,Proprietary  ,6,12,18,63,76,139
03062300,WESTECH COLLEGE                         ,CA,91764-4988,Proprietary  ,34,133,167,155,707,862
03062400,MT DIABLO ADULT EDUC LOMA VISTA CTR     ,CA,94518-1122,Public       ,3,28,31,76,223,299
03062700,PLATT COLLEGE                           ,CA,90041-0000,Proprietary  ,21,45,66,235,347,582
03062701,PLATT COLLEGE                           ,CA,91764-0000,Proprietary  ,39,48,87,357,546,903
03063400,MODERN TECHNOLOGY SCHOOL                ,CA,92708-9821,Proprietary  ,8,31,39,56,190,246
03067400,BALDWIN PARK ADULT SCHOOL               ,CA,91706-4897,Public       ,20,59,79,160,410,570
03067500,INSTITUTE OF TECHNOLOGY                 ,CA,93612-3217,Proprietary  ,153,540,693,1121,3517,4638
03067501,INSTITUTE OF TECHNOLOGY - MODESTO BRANCH,CA,95356-9000,Proprietary  ,0,0,0,0,1,1
03069500,SAGE COLLEGE                            ,CA,92557-6720,Proprietary  ,22,74,96,156,757,913
03072300,EVEREST COLLEGE                         ,CA,91761-3222,Proprietary  ,36,147,183,414,904,1318
03072700,WESTWOOD COLLEGE - LOS ANGELES          ,CA,90010-1577,Proprietary  ,75,567,642,1629,5088,6717
03074900,MARTINEZ ADULT CENTER                   ,CA,94553-3298,Public       ,0,9,9,5,74,79
03078200,AMERICAN CLG TRADITIONAL CHINESE MD     ,CA,94107-2813,Private      ,0,42,42,7,326,333
03084700,VENTURA ADULT\CONTINUING EDUCATION      ,CA,93003-7313,Public       ,12,49,61,68,202,270
03094400,ELITE PROGRESSIVE SCHOOL OF COSM        ,CA,95841-2909,Proprietary  ,33,94,127,234,457,691
03097700,CENTRAL CALIF SCH CONTINUING EDUC       ,CA,93401-6739,Proprietary  ,9,53,62,58,248,306
03098200,YO SAN UNIV TRADITIONAL CHINESE MED     ,CA,90066-1103,Private      ,0,43,43,6,210,216
03108100,SUMMIT CAREER COLLEGE                   ,CA,92324-3956,Proprietary  ,45,243,288,343,1348,1691
03109500,DONGGUK  UNIVERSITY LOS ANGELES         ,CA,90020-1765,Private      ,0,14,14,9,108,117
03113300,UEI COLLEGE                             ,CA,93727-1620,Proprietary  ,70,175,245,340,940,1280
03113600,SOUTHERN CALIFORNIA INST OF TECHNOL     ,CA,92805-3758,Proprietary  ,21,118,139,123,747,870
03116600,EAST SAN GABRIEL VLY REG OCCUP PROG     ,CA,91790-2105,Public       ,37,150,187,171,868,1039
03125300,JOHN WESLEY INTER. BARBER & BTY CLG     ,CA,90813-4321,Proprietary  ,14,28,42,66,149,215
03125400,ART INSTITUTE OF CALIFORNIA-HOLLYWOOD (T,CA,91601-3112,Proprietary  ,293,248,541,3180,2593,5773
03125800,PREMIERE CAREER COLLEGE                 ,CA,91706-3746,Proprietary  ,16,70,86,149,376,525
03126800,PACIFICA GRADUATE INSTITUTE             ,CA,93013-0000,Proprietary  ,0,66,66,2,1047,1049
03128700,MT SIERRA COLLEGE                       ,CA,91016-3414,Proprietary  ,27,49,76,437,504,941
03131300,FIVE BRANCHES UNIVERSITY                ,CA,95062-4669,Private      ,1,37,38,50,409,459
03144400,AMERICAN CLG OF HEALTH PROFESSIONS      ,CA,92505-3038,Proprietary  ,26,93,119,179,643,822
03150500,VIRGINIA SEWING MACHINES & SCH CTR      ,CA,90015-3535,Proprietary  ,0,13,13,3,52,55
03162300,FOUR-D SUCCESS ACADEMY                  ,CA,92324-4218,Proprietary  ,34,135,169,213,979,1192
03163300,PACIFIC STATES UNIVERSITY               ,CA,90006-0000,Private      ,1,4,5,31,46,77
03195400,EVEREST COLLEGE                         ,CA,90501-2867,Proprietary  ,13,42,55,106,230,336
03210300,LE CORDON BLEU COLLEGE OF CULINARY ARTS ,CA,91101-5221,Proprietary  ,375,1205,1580,3364,8435,11799
03225300,AMERICAN UNIVERSITY OF HEALTH SCIENCES  ,CA,90755-3612,Proprietary  ,6,21,27,105,243,348
03242300,CAREER NETWORK INSTITUTE                ,CA,92868-4710,Proprietary  ,49,153,202,135,546,681
03250300,COMMUNITY BASED EDUCATION AND DEVEL     ,CA,90036-1137,Private      ,16,43,59,67,196,263
03260300,CALIFORNIA STATE U-MONTEREY BAY         ,CA,93955-8001,Public       ,213,206,419,9398,3417,12815
03266300,BETHESDA UNIVERSITY OF CALIFORNIA       ,CA,92801-4132,Private      ,1,31,32,69,149,218
03278300,CLARITA CAREER COLLEGE                  ,CA,91351-5432,Proprietary  ,159,267,426,675,1430,2105
03288300,ACAD CHINESE CULTURE & HEALTH SCIS      ,CA,94512-0000,Private      ,3,25,28,19,164,183
03299300,PACIFIC COLLEGE                         ,CA,92626-3160,Proprietary  ,16,95,111,87,495,582
03308300,KENSINGTON COLLEGE                      ,CA,92705-8708,Proprietary  ,1,8,9,6,37,43
03327400,ACUPUNCTURE AND INTEGRATIVE MEDICINE COL,CA,94704-2724,Private      ,4,29,33,28,279,307
03332300,SOUTHERN CA BIBLE CLG & SEMINARY        ,CA,92019-1109,Private      ,1,21,22,8,196,204
03359300,ST. FRANCIS CAREER COLLEGE              ,CA,90262-2659,Private      ,5,20,25,73,200,273
03367300,PROFESSIONAL GOLFERS CAREER COLLEGE     ,CA,92591-6013,Proprietary  ,15,38,53,190,335,525
03395300,INTERNATIONAL CAREER DEVELOPMENT        ,CA,90027-5794,Proprietary  ,231,1687,1918,824,6541,7365
03399300,NORTHWESTERN TECHNICAL COLLEGE          ,CA,95670-4443,Proprietary  ,22,43,65,156,561,717
03403300,EPIC BIBLE COLLEGE                      ,CA,95841-3546,Private      ,3,50,53,83,476,559
03413400,ENGLISH CENTER  (THE)                   ,CA,94607-3734,Private      ,5,51,56,33,210,243
03427400,CAREER COLLEGES OF AMERICA              ,CA,90280-7420,Proprietary  ,35,205,240,403,1548,1951
03427500,ANTELOPE VALLEY MEDICAL COLLEGE         ,CA,93534-3324,Proprietary  ,59,136,195,559,1155,1714
03440400,MARIAN HEALTH CAREERS CENTER            ,CA,90010-1728,Proprietary  ,11,14,25,66,161,227
03441400,VALLEY CAREER COLLEGE                   ,CA,92020-3057,Proprietary  ,20,37,57,126,299,425
03458300,MY LE'S BEAUTY COLLEGE                  ,CA,95824-3039,Proprietary  ,6,45,51,73,223,296
03467300,MARINELLO SCHOOL OF BEAUTY              ,CA,92545-3661,Proprietary  ,103,174,277,272,529,801
03467301,CALIFORNIA BEAUTY COLLEGE - DESERT HOT S,CA,92240-1307,Proprietary  ,0,2,2,5,14,19
03479300,PROFESSIONAL CAREER INSTITUTE           ,CA,90703-2522,Proprietary  ,10,16,26,77,118,195
03485400,JAMES ALBERT SCHOOL OF COSMETOLOGY      ,CA,92627-3831,Proprietary  ,6,34,40,106,183,289
03516300,KING'S UNIVERSITY (THE)                 ,CA,91405-2233,Private      ,10,33,43,97,366,463
03532400,ADVANCED TRAINING ASSOCIATES            ,CA,92020-1236,Proprietary  ,3,17,20,30,108,138
03542400,COPPER MOUNTAIN COLLEGE                 ,CA,92252-6102,Public       ,89,324,413,757,2194,2951
03577300,COBA ACADEMY                            ,CA,92866-1407,Proprietary  ,2,9,11,38,57,95
03590400,NTMA TRAINING CENTERS OF SOUTHERN C     ,CA,90650-6099,Private      ,33,142,175,116,524,640
03592400,IRELL & MANELLA GRADUATE SCHOOL OF BIOLO,CA,91010-0000,Private      ,0,1,1,3,8,11
03598300,AVALON BEAUTY COLLEGE                   ,CA,93103-3137,Proprietary  ,23,21,44,116,121,237
03614300,DAVID'S ACADEMY OF BEAUTY               ,CA,91780-1089,Proprietary  ,0,51,51,10,175,185
03639300,WEST COAST ULTRASOUND INSTITUTE         ,CA,90211-3312,Proprietary  ,40,181,221,362,1310,1672
03646300,DESIGN'S SCHOOL OF COSMETOLOGY          ,CA,93446-1471,Proprietary  ,14,28,42,64,137,201
03681300,CALIFORNIA HEALING ARTS COLLEGE         ,CA,90025-2589,Proprietary  ,12,40,52,79,209,288
03695300,COMMUNITY ENHANCEMENT SERVICES          ,CA,91502-2750,Private      ,3,44,47,14,130,144
03695700,SANTIAGO CANYON COLLEGE                 ,CA,92869-4512,Public       ,162,231,393,2981,2369,5350
03696300,UNIVERSITY OF THE WEST                  ,CA,91770-3709,Private      ,2,2,4,14,65,79
03698300,WEST COAST UNIVERSITY                   ,CA,91606-3206,Proprietary  ,223,500,723,1708,3326,5034
03698400,CA COLLEGE OF VOCATIONAL CAREER         ,CA,93301-1800,Proprietary  ,8,42,50,120,379,499
03736300,ADVANCE BEAUTY COLLEGE                  ,CA,92843-4752,Proprietary  ,5,80,85,71,400,471
03740400,ATI COLLEGE                             ,CA,90650-0000,Proprietary  ,21,61,82,104,282,386
03759300,COMPUTER TUTOR BUSINESS & TECH INST     ,CA,95356-0000,Proprietary  ,8,37,45,76,197,273
03786300,ADVANCED COLLEGE                        ,CA,90280-5255,Proprietary  ,17,47,64,104,407,511
03797400,CAREER CARE INSTITUTE                   ,CA,93534-4766,Proprietary  ,26,79,105,264,753,1017
03797401,CAREER CARE INSTITUTE - VENTURA         ,CA,93003-0000,Proprietary  ,3,17,20,37,98,135
03797402,CAREER CARE INSTITUTE - MORENO VALLEY   ,CA,92553-7519,Proprietary  ,4,17,21,30,104,134
03814400,SOKA UNIVERSITY OF AMERICA              ,CA,92656-8081,Private      ,13,0,13,507,62,569
03852500,CIT COLLEGE OF INFOMEDICAL TECHNOLOGY   ,CA,92831-3703,Proprietary  ,0,4,4,97,408,505
03853300,KECK GRADUATE INSTITUTE OF APPLIED LIFE ,CA,91711-4817,Private      ,0,1,1,6,131,137
03853400,LADERA CAREER PATHS TRAINING CENTERS    ,CA,90045-1931,Proprietary  ,0,9,9,6,47,53
03868300,WORLD MISSION UNIVERSITY                ,CA,90020-1789,Private      ,1,8,9,7,89,96
03868400,LOS ANGELES MUSIC ACADEMY               ,CA,91105-2540,Proprietary  ,11,10,21,159,131,290
03871300,FOLSOM LAKE COLLEGE                     ,CA,95630-6798,Public       ,230,508,738,3026,4186,7212
03874300,CAMBRIDGE JUNIOR COLLEGE                ,CA,95993-0000,Proprietary  ,15,65,80,122,392,514
03874400,COMMMUNITY CHRISTIAN COLLEGE            ,CA,92373-4465,Private      ,8,18,26,166,160,326
03889300,STANBRIDGE COLLEGE                      ,CA,92612-0000,Proprietary  ,25,113,138,185,846,1031
03901300,PACIFIC COAST TRADE SCHOOL              ,CA,93033-2441,Proprietary  ,13,51,64,49,196,245
03910400,NATIONAL POLYTECHNIC COLLEGE            ,CA,90040-3066,Proprietary  ,26,56,82,76,184,260
03933300,MUELLER COLLEGE OF HOLISTIC STUDIES     ,CA,92116-2630,Proprietary  ,8,58,66,56,343,399
03935300,CALIFORNIA NURSES EDUCATIONAL INSTITUTE ,CA,92234-7248,Proprietary  ,7,32,39,66,195,261
03962300,AMERICAN INSTITUTE OF MASSAGE THERAPY   ,CA,92705-5463,Proprietary  ,8,18,26,44,92,136
03964400,INTERNATIONAL SCHOOL OF BEAUTY          ,CA,92260-2740,Proprietary  ,14,49,63,105,236,341
03969600,AMERICAN AUTO INSTITUTE                 ,CA,90703-2637,Proprietary  ,135,314,449,731,1554,2285
03971300,AMERICAN CAREER COLLEGE                 ,CA,91764-4906,Proprietary  ,101,249,350,892,1803,2695
03973300,EX'PRESSION COLLEGE FOR DIGTAL ARTS     ,CA,94608-1021,Proprietary  ,65,76,141,788,733,1521
03974500,CALIFORNIA CAREER COLLEGE               ,CA,91303-2006,Proprietary  ,3,15,18,36,149,185
03980300,CALIFORNIA STATE UNIVERSITY CHANNEL ISLA,CA,93012-8599,Public       ,150,174,324,5943,2701,8644
03995300,UNIVERSITY OF EAST-WEST MEDICINE        ,CA,94087-6106,Proprietary  ,1,13,14,11,70,81
03999300,BEAUMONT ADULT SCHOOL                   ,CA,92223-1927,Public       ,7,29,36,41,158,199
04001300,PALACE BEAUTY COLLEGE                   ,CA,90006-4233,Proprietary  ,14,33,47,80,155,235
04001400,MOJAVE BARBER COLLEGE                   ,CA,92395-3201,Proprietary  ,2,14,16,34,90,124
04003300,CSI CAREER COLLEGE                      ,CA,95687-3100,Proprietary  ,45,86,131,185,533,718
04004300,THUY PRINCESS BEAUTY COLLEGE            ,CA,91766-0000,Proprietary  ,4,16,20,23,78,101
04005300,INTERAMERICAN COLLEGE                   ,CA,91950-4437,Proprietary  ,0,60,60,18,330,348
04014400,PALLADIUM TECHNICAL ACADEMY             ,CA,91731-2429,Proprietary  ,4,13,17,20,86,106
04023400,PROTEUS                                 ,CA,93291-3014,Private      ,2,9,11,10,56,66
04037300,LOS ANGELES FILM SCHOOL (THE)           ,CA,90028-7300,Proprietary  ,209,334,543,1601,2137,3738
04049300,MAXINE WATERS EMPLOYMENT PREPARATION CEN,CA,90059-1023,Public       ,4,13,17,43,154,197
04056300,CAREER COLLEGE OF CALIFORNIA            ,CA,92705-5805,Proprietary  ,13,25,38,79,222,301
04057300,TECHSKILLS OF CALIFORNIA                ,CA,95815-4025,Proprietary  ,16,140,156,126,735,861
04076400,GNOMON SCHOOL OF VISUAL EFFECTS         ,CA,90038-2616,Proprietary  ,5,22,27,79,191,270
04088300,WESTMED COLLEGE                         ,CA,95128-2541,Private      ,0,6,6,0,6,6
04092300,COASTLINE BEAUTY COLLEGE                ,CA,92708-3847,Proprietary  ,2,21,23,34,162,196
04092400,MAKE-UP DESIGNORY                       ,CA,91502-1322,Proprietary  ,32,45,77,321,409,730
04100400,TAFT UNIVERSITY SYSTEM (THE)            ,CA,92704-6954,Proprietary  ,0,71,71,2,472,474
04109300,ACADEMY OF BARBERING ARTS (THE)         ,CA,91324-3406,Proprietary  ,32,48,80,124,197,321
04111300,WEST HILLS COLLEGE LEMOORE              ,CA,93245-9248,Public       ,108,361,469,1871,3023,4894
04114500,VALLEY COLLEGE OF MEDICAL CAREERS       ,CA,91304-2354,Proprietary  ,8,10,18,70,157,227
04115300,COACHELLA VALLEY BEAUTY COLLEGE         ,CA,92253-2051,Proprietary  ,1,9,10,43,76,119
04115600,MAYFIELD COLLEGE                        ,CA,92234-7014,Proprietary  ,22,61,83,119,370,489
04116000,VIDEO SYMPHONY ENTERTRAINING            ,CA,91502-3253,Proprietary  ,12,77,89,91,344,435
04118800,NEW YORK FILM ACADEMY                   ,CA,91608-1002,Proprietary  ,73,130,203,824,1095,1919
04119200,CAREER COLLEGE CONSULTANTS              ,CA,90041-2088,Proprietary  ,6,25,31,36,140,176
04126400,CHAMPION INSTITUTE OF COSMETOLOGY       ,CA,92264-7458,Proprietary  ,2,10,12,28,58,86
04126500,COAST CAREER INSTITUTE                  ,CA,90015-3040,Proprietary  ,35,167,202,158,714,872
04127100,"UNIVERSITY OF CALIFORNIA, MERCED        ",CA,95343-5001,Public       ,138,62,200,11568,1976,13544
04127800,HEALTHY HAIR ACADEMY                    ,CA,90303-3137,Proprietary  ,6,7,13,40,97,137
04127900,TUI UNIVERSITY                          ,CA,90630-5023,Proprietary  ,11,420,431,40,2838,2878
04129700,INTERNATIONAL POLYTECHNIC INSTITUTE     ,CA,92231-1737,Private      ,2,10,12,32,56,88
04129803,MEDIATECH INSTITUTE - OCEANSIDE         ,CA,92054-5116,Proprietary  ,4,12,16,4,12,16
04132300,INSTITUTE OF MEDICAL EDUCATION          ,CA,95113-2207,Proprietary  ,24,103,127,213,896,1109
04132400,ACADEMY OF ESTHETICS AND COSMETOLOGY    ,CA,91342-3373,Proprietary  ,6,15,21,45,95,140
04132700,INFOTECH CAREER COLLEGE                 ,CA,90706-5579,Proprietary  ,7,45,52,70,257,327
04133000,BIOHEALTH COLLEGE                       ,CA,95134-2033,Proprietary  ,2,31,33,41,209,250
04133100,CALIFORNIA UNIVERSITY OF MANAGEMENT AND ,CA,92801-1702,Private      ,3,14,17,3,14,17
04134500,CAREER COLLEGE OF SAN DIEGO             ,CA,92102-3348,Proprietary  ,25,82,107,110,364,474
04134700,INTERNATL PROFESSIONAL SCHL OF BODYWORK ,CA,92123-1520,Proprietary  ,4,26,30,45,270,315
04137200,BORNER'S BARBER COLLEGE                 ,CA,90047-3856,Proprietary  ,4,12,16,35,70,105
04138700,CAO INSTITUTE OF AESTHETICS (THE)       ,CA,91801-3903,Proprietary  ,6,25,31,77,144,221
04140500,HORIZON COLLEGE SAN DIEGO               ,CA,92131-9906,Private      ,6,11,17,38,91,129
04140600,MODERN INSTITUTE OF TECHNOLOGY          ,CA,93036-1387,Proprietary  ,1,7,8,18,38,56
04141300,SAN FRANCISCO INSTITUTE OF ESTHETICS    ,CA,94103-4083,Proprietary  ,16,37,53,131,259,390
04141400,LAURUS COLLEGE                          ,CA,93401-5405,Proprietary  ,28,110,138,102,487,589
04141700,HEALING HANDS SCHOOL OF HOLISTIC HEALTH ,CA,92025-1722,Proprietary  ,3,33,36,26,155,181
04142500,TOURO COLLEGE LOS ANGELES               ,CA,90046-4506,Private      ,4,21,25,69,67,136
04142600,TOURO UNIVERSITY                        ,CA,94592-1118,Private      ,0,56,56,28,2688,2716
04143800,WOODLAND COMMUNITY COLLEGE              ,CA,95776-5156,Public       ,102,239,341,1260,1671,2931
04144200,CAREER DEVELOPMENT INSTITUTE            ,CA,90035-4364,Proprietary  ,3,19,22,16,123,139
04145000,SAN DIEGO CULINARY INSTITUTE            ,CA,91941-6435,Proprietary  ,29,55,84,252,421,673
04145600,INTERNATIONAL COLLEGE OF COSMETOLOGY    ,CA,94601-3525,Proprietary  ,5,33,38,43,171,214
04146000,NATIONAL CAREER COLLEGE                 ,CA,91605-1400,Proprietary  ,4,16,20,15,67,82
04148200,BEYOND 21ST CENTURY BEAUTY ACADEMY      ,CA,90670-6316,Proprietary  ,1,8,9,30,56,86
04148900,N CALIF INSTITUTE OF COSMETOLOGY        ,CA,94577-2820,Proprietary  ,6,4,10,11,63,74
04149700,HOMESTEAD SCHOOLS                       ,CA,90505-5945,Private      ,9,30,39,59,203,262
04150000,CENTRAL NURSING COLLEGE                 ,CA,90010-2444,Proprietary  ,7,38,45,123,254,377
04150100,GOLDEN STATE COLLEGE OF COURT REPORTING ,CA,94568-2948,Proprietary  ,1,9,10,10,67,77
04150300,RWM FIBER OPTICS                        ,CA,90746-1051,Proprietary  ,4,19,23,10,62,72
04150500,"PREFERRED COLLEGE OF NURSING, LOS ANGELE",CA,90010-2202,Proprietary  ,13,39,52,108,250,358
04152800,CALIFORNIA ACADEMY (THE) - A PAUL MITCHE,CA,95825-2276,Proprietary  ,31,54,85,283,447,730
04153900,PROVIDENCE CHRISTIAN COLLEGE            ,CA,91104-2635,Private      ,3,4,7,72,30,102
04154300,AMERICANA COLLEGE                       ,CA,90029-3765,Proprietary  ,2,8,10,21,46,67
04154400,FRANKLIN CAREER COLLEGE                 ,CA,91761-1522,Proprietary  ,3,14,17,26,137,163
04155500,"ACADEMY FOR JEWISH RELIGION, CALIFORNIA ",CA,90024-3234,Private      ,2,8,10,13,64,77
04156100,DIOR SCHOOL OF COSMETOLOGY              ,CA,95355-9695,Proprietary  ,9,19,28,102,163,265
04158200,PAUL MITCHELL THE SCHOOL SHERMAN OAKS   ,CA,91403-5882,Proprietary  ,22,39,61,222,274,496
04158700,HOLLYWOOD BEAUTY COLLEGE                ,CA,95210-3514,Proprietary  ,12,34,46,106,222,328
04159600,GALAXY MEDICAL COLLEGE                  ,CA,91606-1593,Proprietary  ,3,10,13,14,35,49
04159700,AMERICAN MEDICAL SCIENCES CENTER        ,CA,91204-5108,Proprietary  ,18,34,52,76,122,198
04160100,TRINITY VOCATIONAL CENTER               ,CA,90248-4334,Proprietary  ,2,26,28,44,168,212
04160400,ANGELES COLLEGE OF NURSING              ,CA,90010-2100,Proprietary  ,25,62,87,290,451,741
04161300,PREFERRED COLLEGE OF NURSING            ,CA,91401-1442,Proprietary  ,11,56,67,11,56,67
04161700,SHASTA SCHOOL OF COSMETOLOGY            ,CA,96003-0000,Proprietary  ,8,26,34,70,137,207
04161800,BRANDMAN UNIVERSITY                     ,CA,92618-3801,Private      ,42,870,912,390,6851,7241
04162800,S.I.C.E PAUL MITCHELL PARTNER SCHOOL    ,CA,95350-1440,Proprietary  ,32,31,63,264,284,548
04163400,COSMO BEAUTY ACADEMY                    ,CA,95605-1904,Proprietary  ,10,36,46,141,260,401
04163900,L.A. BARBER COLLEGE                     ,CA,90013-1121,Proprietary  ,4,21,25,47,113,160
04164400,ANGELES INSTITUTE                       ,CA,90712-2903,Proprietary  ,13,24,37,78,143,221
04165900,PAUL MITCHELL THE SCHOOL FRESNO         ,CA,93710-7617,Proprietary  ,24,39,63,247,262,509
04167000,ESTHETIQUES COSMETOLOGY INSTITUTE       ,CA,92591-4663,Proprietary  ,29,43,72,203,233,436
04169200,TRAMY BEAUTY SCHOOL                     ,CA,92115-6347,Proprietary  ,5,39,44,46,187,233
04169700,UNITEK COLLEGE                          ,CA,94538-3185,Proprietary  ,35,176,211,205,922,1127
04169800,GURNICK ACADEMY OF MEDICAL ARTS         ,CA,94403-1849,Proprietary  ,18,93,111,216,1080,1296
04172000,SOUTHERN CALIFORNIA UNIVERSITY SOMA     ,CA,90017-2211,Proprietary  ,7,10,17,86,125,211
04173400,SANTA ANA BEAUTY ACADEMY                ,CA,92705-7820,Proprietary  ,1,6,7,25,41,66
04173500,MORENO VALLEY COLLEGE                   ,CA,92551-2204,Public       ,203,573,776,1117,2166,3283
04175200,PAUL MITCHELL THE SCHOOL EAST BAY       ,CA,94523-5515,Proprietary  ,20,29,49,190,202,392
04175400,ELITE COSMETOLOGY SCHOOL                ,CA,92284-2860,Proprietary  ,4,12,16,34,99,133
04176100,NORCO COLLEGE                           ,CA,92860-2600,Public       ,161,324,485,1011,1361,2372
04176200,TWIN RIVERS ADULT SCHOOL                ,CA,95660-5523,Public       ,13,104,117,44,521,565
04176300,BERGIN UNIVERSITY OF CANINE STUDIES     ,CA,95407-6834,Private      ,0,10,10,28,65,93
04177200,REAL BARBERS COLLEGE (THE)              ,CA,92805-2533,Proprietary  ,10,13,23,51,91,142
04178900,HANDS-ON MEDICAL MASSAGE SCHOOL         ,CA,92373-6271,Proprietary  ,2,5,7,23,63,86
04180000,CINTA AVEDA INSTITUTE                   ,CA,94108-3204,Proprietary  ,20,36,56,103,258,361
04181200,IPPT CAREER SCHOOL                      ,CA,91601-2028,Proprietary  ,15,73,88,43,254,297
04185200,SALINAS BEAUTY COLLEGE                  ,CA,93901-2405,Proprietary  ,6,17,23,27,49,76
04185500,ACADEMY OF COUTURE ART                  ,CA,90069-5701,Proprietary  ,7,8,15,14,27,41
04185600,MEDICAL ALLIED CAREER CENTER            ,CA,90670-4710,Proprietary  ,2,16,18,11,64,75
04185700,ACADEMY FOR SALON PROFESSIONALS (THE)   ,CA,95050-4057,Proprietary  ,15,38,53,54,136,190
04186900,"INTERNATIONAL COLLEGE OF BEAUTY, ARTS & ",CA,90039-1012,Proprietary  ,2,11,13,5,27,32
04187900,JOE BLASCO MAKEUP ARTIST TRAINING CENTER,CA,90027-5580,Proprietary  ,4,12,16,4,12,16
04189300,ALLIED AMERICAN UNIVERSITY              ,CA,92653-1337,Proprietary  ,3,107,110,3,112,115
04189800,ACADEMY FOR SALON PROFESSIONALS         ,CA,91304-2305,Proprietary  ,10,27,37,36,76,112
04191300,ANNENBERG SCHOOL OF NURSING             ,CA,91335-5426,Private      ,4,12,16,4,12,16
04193700,JOHN PAUL THE GREAT CATHOLIC UNIVERSITY ,CA,92131-1652,Private      ,9,4,13,45,18,63
00184600,BRIAR CLIFF UNIVERSITY                  ,IA,51104-2100,Private      ,16,45,61,1233,570,1803
00184700,BUENA VISTA UNIVERSITY                  ,IA,50588-9987,Private      ,18,109,127,1582,1996,3578
00184800,SOUTHEASTERN COMMUNITY COLLEGE          ,IA,52655-0000,Public       ,78,237,315,1220,2214,3434
00185000,CENTRAL COLLEGE                         ,IA,50219-1999,Private      ,20,11,31,2409,160,2569
00185200,CLARKE UNIVERSITY                       ,IA,52001-3198,Private      ,7,37,44,1050,578,1628
00185400,COE COLLEGE                             ,IA,52402-5092,Private      ,28,18,46,2131,262,2393
00185500,DES MOINES UNIV-OSTEOPATHIC MED CTR     ,IA,50312-0000,Private      ,1,36,37,15,1841,1856
00185600,CORNELL COLLEGE                         ,IA,52314-1098,Private      ,16,10,26,1984,117,2101
00185700,SOUTHWESTERN COMMUNITY COLLEGE          ,IA,50801-1098,Public       ,14,89,103,652,887,1539
00185800,DIVINE WORD COLLEGE                     ,IA,52045-0380,Private      ,10,4,14,27,25,52
00185900,DORDT COLLEGE                           ,IA,51250-1697,Private      ,12,5,17,1531,103,1634
00186000,DRAKE UNIVERSITY                        ,IA,50311-4505,Private      ,72,146,218,4789,2454,7243
00186200,ELLSWORTH COMMUNITY COLLEGE             ,IA,50126-1199,Public       ,33,52,85,754,421,1175
00186400,IOWA LAKES COMMUNITY COLLEGE            ,IA,51334-2234,Public       ,51,159,210,1270,1541,2811
00186500,IOWA CENTRAL COMMUNITY COLLEGE          ,IA,50501-0000,Public       ,106,369,475,2598,3397,5995
00186600,GRACELAND UNIVERSITY                    ,IA,50140-1699,Private      ,23,113,136,1168,1426,2594
00186700,GRAND VIEW UNIVERSITY                   ,IA,50316-1599,Private      ,37,112,149,2056,1510,3566
00186800,GRINNELL COLLEGE                        ,IA,50112-1690,Private      ,43,5,48,2223,67,2290
00186900,IOWA STATE UNIV SCIENCE & TECHNOLOG     ,IA,50011-2028,Public       ,237,310,547,22881,6279,29160
00187100,IOWA WESLEYAN COLLEGE                   ,IA,52641-1398,Private      ,9,27,36,823,423,1246
00187300,LORAS COLLEGE                           ,IA,52004-0178,Private      ,16,15,31,1926,185,2111
00187400,LUTHER COLLEGE                          ,IA,52101-1045,Private      ,18,9,27,3323,107,3430
00187500,MARSHALLTOWN COMMUNITY COLLEGE          ,IA,50158-4760,Public       ,56,152,208,753,1189,1942
00187700,NORTH IOWA AREA COMMUNITY COLLEGE       ,IA,50401-7299,Public       ,51,138,189,1454,1449,2903
00187900,MORNINGSIDE COLLEGE                     ,IA,51106-1751,Private      ,17,59,76,1905,629,2534
00188000,MOUNT MERCY UNIVERSITY                  ,IA,52402-4797,Private      ,12,67,79,1030,1052,2082
00188100,ASHFORD UNIVERSITY                      ,IA,52732-3910,Proprietary  ,514,15605,16119,3947,117356,121303
00188300,NORTHWESTERN COLLEGE                    ,IA,51041-1996,Private      ,17,8,25,1596,139,1735
00188700,SIMPSON COLLEGE                         ,IA,50125-1297,Private      ,17,44,61,2161,667,2828
00188900,ST AMBROSE UNIVERSITY                   ,IA,52803-2898,Private      ,43,73,116,2931,1387,4318
00189000,UNIVERSITY OF NORTHERN IOWA             ,IA,50614-0002,Public       ,137,163,300,10803,3236,14039
00189100,UNIVERSITY OF DUBUQUE                   ,IA,52001-5099,Private      ,28,33,61,1904,735,2639
00189200,UNIVERSITY OF IOWA                      ,IA,52242-1316,Public       ,303,412,715,20319,10631,30950
00189300,UPPER IOWA UNIVERSITY                   ,IA,52142-9206,Private      ,43,496,539,1494,5319,6813
00189500,WALDORF COLLEGE                         ,IA,50436-1700,Proprietary  ,13,51,64,825,414,1239
00189600,WARTBURG COLLEGE                        ,IA,50677-2200,Private      ,13,6,19,2454,114,2568
00189700,WARTBURG THEOLOGICAL SEMINARY           ,IA,52004-5004,Private      ,0,2,2,1,121,122
00190000,WILLIAM PENN UNIVERSITY                 ,IA,52577-1799,Private      ,15,101,116,1241,1318,2559
00396300,AIB COLLEGE OF BUSINESS                 ,IA,50321-1799,Private      ,9,78,87,557,825,1382
00407500,ESTRN IOWA COMMUNITY COLLEGE DIST       ,IA,52801-1221,Public       ,9,45,54,137,456,593
00407501,CLINTON COMMUNITY COLLEGE               ,IA,52732-0000,Public       ,22,128,150,471,1081,1552
00407502,MUSCATINE COMMUNITY COLLEGE             ,IA,52761-0000,Public       ,29,94,123,538,821,1359
00407503,SCOTT COMMUNITY COLLEGE                 ,IA,52722-0000,Public       ,120,386,506,1593,3675,5268
00407600,KIRKWOOD COMMUNITY COLLEGE              ,IA,52406-2068,Public       ,323,1046,1369,7475,9724,17199
00423300,MERCY/ST. LUKE'S SCH RAD TECH           ,IA,52402-0000,Private      ,2,1,3,20,26,46
00458600,KAPLAN UNIVERSITY                       ,IA,52807-2095,Proprietary  ,740,10792,11532,3998,81553,85551
00458604,KAPLAN UNIVERSITY - CEDAR RAPIDS        ,IA,52404-2998,Proprietary  ,30,253,283,196,2142,2338
00458605,KAPLAN UNIVERSITY - DES MOINES          ,IA,50323-5702,Proprietary  ,20,232,252,213,2011,2224
00458606,KAPLAN UNIVERSITY - MASON CITY          ,IA,50401-4665,Proprietary  ,7,73,80,61,682,743
00458607,KAPLAN UNIVERSITY - CEDAR FALLS         ,IA,50613-6309,Proprietary  ,11,126,137,155,1243,1398
00458610,KAPLAN UNIVERSITY - COUNCIL BLUFFS      ,IA,51503-5289,Proprietary  ,7,71,78,68,704,772
00458700,NORTHEAST IOWA COMMUNITY COLLEGE        ,IA,52132-0400,Public       ,28,102,130,705,924,1629
00458701,NORTHEAST IOWA COMMUNITY COLLEGE        ,IA,52068-0000,Public       ,76,211,287,1127,1609,2736
00459500,HAWKEYE COMMUNITY COLLEGE               ,IA,50701-0000,Public       ,141,376,517,3319,3409,6728
00459800,IOWA WESTERN CMTY CLG-COUNCIL BLUFF     ,IA,51502-0000,Public       ,171,418,589,3493,3802,7295
00460000,NORTHWEST IOWA COMMUNITY COLLEGE        ,IA,51201-1046,Public       ,10,51,61,580,572,1152
00626700,IOWA METHODIST MEDICAL CENTER SCHOOLS   ,IA,50309-1499,Private      ,1,9,10,28,84,112
00627300,MERCY COLLEGE OF HEALTH SCIENCES        ,IA,50309-1239,Private      ,19,88,107,504,1059,1563
00712000,DES MOINES AREA CMTY COLLEGE            ,IA,50021-0000,Public       ,473,1578,2051,7249,13432,20681
00712100,FAITH BAPTIST BIBLE CLG & THEOL SEM     ,IA,50021-0000,Private      ,6,2,8,336,63,399
00729100,ST LUKE'S COLLEGE                       ,IA,51104-0263,Private      ,2,16,18,111,158,269
00731600,WESTERN IOWA TECH COMMUNITY COLLEGE     ,IA,51106-0000,Public       ,104,462,566,2075,4014,6089
00758800,CAPRI COLLEGE                           ,IA,52004-0873,Proprietary  ,4,17,21,103,133,236
00761100,EQ SCHOOL OF HAIR DESIGN                ,IA,51503-0813,Proprietary  ,1,5,6,38,45,83
00765600,AMERICAN COLLEGE OF HARISTYLING -CR     ,IA,52402-0000,Proprietary  ,0,6,6,7,40,47
00765800,AMER COLL OF HAIRSTYLING-DES MOINES     ,IA,50309-5446,Proprietary  ,3,11,14,14,76,90
00765900,LA JAMES COLLEGE OF HAIRSTYLING         ,IA,50401-3308,Proprietary  ,15,16,31,91,76,167
00771700,CAPRI COLLEGE                           ,IA,52807-2622,Proprietary  ,12,20,32,114,206,320
00794100,COLLEGE OF HAIR DESIGN                  ,IA,50703-1834,Proprietary  ,4,7,11,21,49,70
00826000,IOWA SCHOOL OF BEAUTY INC               ,IA,50322-0000,Proprietary  ,12,30,42,120,312,432
00840300,INDIAN HILLS COMMUNITY COLLEGE          ,IA,52501-1398,Public       ,131,313,444,1794,2932,4726
00840301,INDIAN HILLS COMMUNITY COLLEGE          ,IA,52544-0000,Public       ,15,48,63,250,395,645
00842400,LA JAMES INTERNATIONAL COLLEGE          ,IA,50501-5577,Proprietary  ,8,17,25,84,121,205
00959300,LA'JAMES COLLEGE OF HAIRSTYLING         ,IA,52240-0000,Proprietary  ,2,9,11,68,78,146
01111300,MAHARISHI UNIV OF MANAGEMENT            ,IA,52557-0001,Private      ,20,40,60,214,483,697
01206400,HAMILTON TECHNICAL COLLEGE              ,IA,52807-2653,Proprietary  ,17,48,65,97,330,427
01230000,PALMER COLLEGE OF CHIROPRACTIC          ,IA,52803-5287,Private      ,3,67,70,84,2155,2239
01300600,LA' JAMES INTERNATIONAL COLLEGE-CF      ,IA,50613-5242,Proprietary  ,10,13,23,76,93,169
02090300,CAPRI COLLEGE                           ,IA,52404-0000,Proprietary  ,11,20,31,114,192,306
02134500,LA JAMES INTERNATIONAL COLLEGE - DAV    ,IA,52806-3952,Proprietary  ,7,19,26,33,123,156
02160900,"SALON PROFESSIONAL ACADEMY, THE         ",IA,50010-0000,Proprietary  ,14,13,27,121,91,212
02262500,FAUST INSTITUTE OF COSMETOLOGY          ,IA,50588-0000,Proprietary  ,3,9,12,28,50,78
02274100,LA' JAMES INTERNATIONAL COLLEGE - DM    ,IA,50131-0000,Proprietary  ,16,27,43,105,158,263
02289000,AMERICAN HAIR ACADEMY                   ,IA,52627-4530,Proprietary  ,2,1,3,22,47,69
02306900,IOWA SCHOOL OF BEAUTY                   ,IA,52501-0000,Proprietary  ,5,9,14,34,71,105
02328900,EMMAUS BIBLE COLLEGE                    ,IA,52001-0000,Private      ,1,6,7,250,58,308
02330900,IOWA SCHOOL OF BEAUTY                   ,IA,50158-0000,Proprietary  ,3,4,7,17,40,57
02609200,VATTEROTT COLLEGE                       ,IA,50321-4704,Proprietary  ,8,91,99,118,848,966
03069100,ALLEN COLLEGE                           ,IA,50703-1916,Private      ,4,32,36,317,460,777
03441300,IOWA SCHOOL OF BEAUTY                   ,IA,51106-5111,Proprietary  ,8,8,16,42,99,141
03607400,TOTAL LOOK SCHOOL OF COSMETOLOGY AND MAS,IA,52136-1053,Proprietary  ,3,5,8,12,15,27
03720300,CARLSON COLLEGE OF MASSAGE THERAPY      ,IA,52205-7519,Proprietary  ,1,5,6,15,35,50
04051313,ART INSTITUTE OF PHOENIX (THE) - BROWN M,IA,52722-3628,Proprietary  ,2,4,6,38,202,240
04089300,BIO-CHI INSTITUTE OF MASSAGE THERAPY    ,IA,51103-2138,Proprietary  ,1,4,5,14,35,49
04177800,SALON PROFESSIONAL ACADEMY (THE)        ,IA,52240-6083,Proprietary  ,9,11,20,38,39,77
04203300,AVEDA INSTITUTE DES MOINES              ,IA,50266-8137,Proprietary  ,28,32,60,76,82,158
00259600,ATLANTIC COMMUNITY COLLEGE              ,NJ,08330-2699,Public       ,282,736,1018,4084,5324,9408
00259700,BLOOMFIELD COLLEGE                      ,NJ,07003-3425,Private      ,65,144,209,3270,1905,5175
00259800,CALDWELL COLLEGE                        ,NJ,07006-6195,Private      ,36,77,113,1839,1271,3110
00259900,CENTENARY COLLEGE                       ,NJ,07840-2184,Private      ,40,134,174,1832,1033,2865
00260000,COLLEGE OF SAINT ELIZABETH              ,NJ,07960-6989,Private      ,10,47,57,837,788,1625
00260100,CUMBERLAND COUNTY COLLEGE               ,NJ,08362-0517,Public       ,158,405,563,2364,3551,5915
00260300,DREW UNIVERSITY                         ,NJ,07940-4063,Private      ,55,51,106,3839,835,4674
00260700,FAIRLEIGH DICKINSON UNIV-TEANECK        ,NJ,07666-1996,Private      ,106,277,383,4424,2888,7312
00260701,FAIRLEIGH DICKINSON UNIV-FLORHAM        ,NJ,07940-0000,Private      ,46,61,107,2952,708,3660
00260702,FAIRLEIGH DICKINSON UNIV-ED WMS CLG     ,NJ,07601-0000,Private      ,15,22,37,280,274,554
00260703,FAIRLEIGH DICKINSON UNIVERSITY          ,NJ,07940-0000,Private      ,59,76,135,2287,1044,3331
00260800,GEORGIAN COURT UNIVERSITY               ,NJ,08701-2697,Private      ,34,93,127,1584,1559,3143
00260900,ROWAN UNIVERSITY                        ,NJ,08028-1702,Public       ,259,302,561,13746,4677,18423
00261000,FELICIAN COLLEGE                        ,NJ,07644-2198,Private      ,49,161,210,2231,1656,3887
00261300,NEW JERSEY CITY UNIVERSITY              ,NJ,07305-1597,Public       ,158,512,670,5019,6469,11488
00261500,MIDDLESEX COUNTY COLLEGE                ,NJ,08818-3050,Public       ,414,633,1047,6700,5677,12377
00261600,MONMOUTH UNIVERSITY                     ,NJ,07764-1898,Private      ,143,178,321,7821,2683,10504
00261700,MONTCLAIR STATE UNIVERSITY              ,NJ,07043-9987,Public       ,405,628,1033,17970,8258,26228
00261900,NEW BRUNSWICK THEOLOGICAL SEMINARY      ,NJ,08901-0000,Private      ,1,12,13,24,166,190
00262100,NEW JERSEY INST OF TECHNOLOGY           ,NJ,07102-1982,Public       ,146,259,405,5921,3439,9360
00262200,KEAN UNIVERSITY                         ,NJ,07083-7131,Public       ,322,616,938,13223,9670,22893
00262400,OCEAN COUNTY COLLEGE                    ,NJ,08754-2001,Public       ,262,551,813,5188,4538,9726
00262500,WILLIAM PATERSON UNIVERSITY             ,NJ,07470-2152,Public       ,211,328,539,11242,5220,16462
00262600,PRINCETON THEOLOGICAL SEMINARY          ,NJ,08542-0000,Private      ,1,14,15,21,648,669
00262700,PRINCETON UNIVERSITY                    ,NJ,08544-0001,Private      ,293,98,391,17259,1887,19146
00262800,RIDER UNIVERSITY                        ,NJ,08648-3099,Private      ,97,124,221,7787,1853,9640
00262900,"RUTGERS, THE STATE UNIVERSITY OF NJ     ",NJ,08901-1281,Public       ,867,1260,2127,46385,24685,71070
00263200,SETON HALL UNIVERSITY                   ,NJ,07079-2697,Private      ,145,262,407,8145,4233,12378
00263201,SETON HALL UNIVERSITY - SCHOOL OF LAW   ,NJ,07079-5210,Private      ,13,47,60,196,2178,2374
00263800,ST PETER'S COLLEGE                      ,NJ,07306-5997,Private      ,49,142,191,2843,1419,4262
00263900,STEVENS INSTITUTE OF TECHNOLOGY         ,NJ,07030-5370,Private      ,52,71,123,3845,793,4638
00264200,COLLEGE OF NEW JERSEY (THE)             ,NJ,08628-0718,Public       ,144,128,272,11418,1510,12928
00264300,UNION COUNTY COLLEGE                    ,NJ,07016-1598,Public       ,391,841,1232,5213,8525,13738
00473600,BERGEN COMMUNITY COLLEGE                ,NJ,07652-1595,Public       ,471,651,1122,8467,6574,15041
00474000,MERCER COUNTY COMMUNITY COLLEGE         ,NJ,08690-0000,Public       ,236,605,841,3466,5123,8589
00539900,MONMOUTH COUNTY VOCATIONAL SCH DIST     ,NJ,07728-5033,Public       ,1,12,13,93,150,243
00545200,TETERBORO SCH OF AERONAUTICS            ,NJ,07608-1083,Proprietary  ,26,34,60,117,108,225
00546000,SOMERSET COUNTY TECHNICAL INSTITUTE     ,NJ,08807-0350,Public       ,0,0,0,12,24,36
00546100,SALEM COMMUNITY COLLEGE                 ,NJ,08069-2799,Public       ,24,78,102,684,873,1557
00641700,HOLY NAME HOSPITAL SCH OF NURSING       ,NJ,07666-4254,Private      ,3,13,16,91,224,315
00642000,MOUNTAINSIDE HOSP SCH NRSG              ,NJ,07042-4898,Proprietary  ,1,8,9,20,81,101
00642100,MUHLENBERG SNYDER SCHOOLS               ,NJ,07061-3399,Private      ,3,39,42,121,566,687
00642900,ST FRANCIS MEDICAL CTR SCH NURSING      ,NJ,08629-1986,Private      ,0,7,7,31,83,114
00642902,ST FRANCIS MED CTR RAD TECH             ,NJ,08629-0000,Private      ,0,6,6,7,34,41
00686500,CAMDEN COUNTY COLLEGE                   ,NJ,08012-3240,Public       ,396,1045,1441,6663,9762,16425
00690100,GLOUCESTER COUNTY COLLEGE               ,NJ,08080-4249,Public       ,133,357,490,3473,3358,6831
00710700,ESSEX COUNTY COLLEGE                    ,NJ,07102-1798,Public       ,425,1174,1599,5961,10078,16039
00750200,BERKELEY COLLEGE                        ,NJ,07424-3367,Proprietary  ,38,147,185,1408,1670,3078
00750201,BERKELEY COLLEGE                        ,NJ,07095-0000,Proprietary  ,22,99,121,823,995,1818
00750202,BERKELEY COLLEGE - PARAMUS              ,NJ,07652-2931,Proprietary  ,26,54,80,593,790,1383
00750600,LINCOLN TECHNICAL INSTITUTE             ,NJ,07083-5032,Proprietary  ,120,180,300,713,798,1511
00750601,LINCOLN TECHNICAL INSTITUTE             ,NJ,07430-0000,Proprietary  ,45,57,102,487,393,880
00759300,PARISIAN BEAUTY ACADEMY                 ,NJ,07601-5509,Proprietary  ,43,36,79,149,174,323
00772900,COUNTY COLLEGE OF MORRIS                ,NJ,07869-0000,Public       ,194,211,405,3810,2272,6082
00773000,BURLINGTON COUNTY COLLEGE               ,NJ,08068-1599,Public       ,290,658,948,4420,5700,10120
00773100,RARITAN VALLEY COMMUNITY COLLEGE        ,NJ,08876-1265,Public       ,128,244,372,2760,2408,5168
00780401,STAR CAREER ACADEMY - STAR LAKEWOOD     ,NJ,08701-5900,Proprietary  ,30,80,110,156,479,635
00780402,STAR CAREER ACADEMY - STAR EGG HARBOR   ,NJ,08234-4863,Proprietary  ,10,67,77,75,398,473
00794700,BETH MEDRASH GOVOHA OF AMERICA          ,NJ,08701-0000,Private      ,165,378,543,338,1593,1931
00840400,BROOKDALE COMMUNITY COLLEGE             ,NJ,07738-1597,Public       ,262,455,717,6360,4761,11121
00844101,ANTHEM INSTITUTE                        ,NJ,08002-0000,Proprietary  ,7,31,38,39,183,222
00849400,HO HO KUS SCHL OF TRADE & TECH SCIENCES ,NJ,07513-1402,Proprietary  ,14,42,56,106,180,286
00860900,RABBINICAL COLLEGE OF AMERICA           ,NJ,07960-3600,Private      ,18,2,20,72,7,79
00907800,CAPRI INSTITUTE OF HAIR DESIGN          ,NJ,07011-2111,Proprietary  ,32,74,106,121,272,393
00934400,RAMAPO COLLEGE OF NEW JERSEY            ,NJ,07430-1680,Public       ,139,99,238,6870,1312,8182
00934500,RICHARD STOCKTON COLLEGE OF NJ          ,NJ,08240-0195,Public       ,172,207,379,9148,3429,12577
00982804,EVEREST INSTITUTE - SOUTH PLAINFIELD    ,NJ,07080-1125,Proprietary  ,36,142,178,237,626,863
00999400,PASSAIC COUNTY COMMUNITY COLLEGE        ,NJ,07505-1179,Public       ,272,656,928,4162,6112,10274
01039400,UNIV OF MEDICINE & DENTISTRY OF NJ      ,NJ,07107-0000,Public       ,17,265,282,300,5409,5709
01062900,P B COSMETOLOGY EDUCATION CENTRE        ,NJ,08030-1750,Proprietary  ,31,28,59,123,146,269
01085100,ANTHEM INSTITUTE                        ,NJ,07054-3409,Proprietary  ,68,178,246,413,783,1196
01085101,ANTHEM INSTITUTE                        ,NJ,07306-0000,Proprietary  ,8,25,33,53,155,208
01085102,ANTHEM INSTITUTE                        ,NJ,08902-0000,Proprietary  ,5,19,24,32,113,145
01090300,RIZZIERI INSTITUTE                      ,NJ,08043-4600,Proprietary  ,21,39,60,136,172,308
01152300,MORRIS COUNTY SCHOOL OF TECHNOLOGY      ,NJ,07834-0000,Public       ,0,4,4,47,79,126
01170800,NATURAL MOTION INST OF HAIR DESIGN      ,NJ,07306-5496,Proprietary  ,10,24,34,55,113,168
01198900,TALMUDICAL ACADEMY                      ,NJ,07710-0000,Private      ,5,0,5,62,7,69
01209000,REIGNBOW BEAUTY ACADEMY                 ,NJ,08861-4118,Proprietary  ,6,15,21,62,126,188
01234600,DOVER BUSINESS COLLEGE                  ,NJ,07011-2161,Proprietary  ,29,95,124,400,957,1357
01234602,DOVER BUSINESS COLLEGE                  ,NJ,07801-4643,Proprietary  ,15,51,66,145,424,569
01246100,LINCOLN TECHNICAL INSTITUTE             ,NJ,08820-2896,Proprietary  ,60,140,200,419,1028,1447
01246102,LINCOLN TECHNICAL INSTITUTE             ,NJ,08057-3212,Proprietary  ,23,116,139,262,1002,1264
01246103,LINCOLN TECHNICAL INSTITUTE             ,NJ,07652-2106,Proprietary  ,58,134,192,413,1007,1420
01246200,HOHOKUS - HACKENSACK SCHOOL OF BUSINESS ,NJ,07601-7197,Proprietary  ,29,108,137,149,584,733
01295400,HUDSON COUNTY COMMUNITY COLLEGE         ,NJ,07306-4012,Public       ,330,898,1228,4948,7570,12518
02053700,EASTWICK COLLEGE                        ,NJ,07446-0000,Proprietary  ,29,122,151,319,1210,1529
02061800,ROMAN ACADEMY OF BEAUTY CULTURE         ,NJ,07506-0000,Proprietary  ,9,14,23,26,37,63
02092300,HOHOKUS SCHOOL - RETS/NUTLEY            ,NJ,07110-0000,Proprietary  ,36,100,136,183,517,700
02103700,CAPRI INSTITUTE OF HAIR DESIGN          ,NJ,07652-0000,Proprietary  ,12,28,40,65,108,173
02104000,HARRIS SCHOOL OF BUSINESS               ,NJ,08002-2983,Proprietary  ,62,267,329,342,1351,1693
02106601,AMERICAN INSTITUTE - CLIFTON            ,NJ,07011-2345,Proprietary  ,30,118,148,164,526,690
02131100,DU CRET SCHOOL OF THE ARTS              ,NJ,07060-0000,Private      ,2,5,7,27,29,56
02131600,PENNCO TECH                             ,NJ,08012-0000,Proprietary  ,58,170,228,399,756,1155
02132300,BERDAN INSTITUTE                        ,NJ,07512-0000,Proprietary  ,43,93,136,289,570,859
02146800,JOE KUBERT SCH OF CARTOON & GRAPHIC     ,NJ,07801-0000,Proprietary  ,3,2,5,50,65,115
02149800,EMPIRE BEAUTY SCHOOL                    ,NJ,08021-0000,Proprietary  ,12,40,52,93,314,407
02149801,EMPIRE BEAUTY SCHOOL - BORDENTOWN       ,NJ,08505-1513,Proprietary  ,3,8,11,19,61,80
02154000,DIVERS ACAD OF EASTERN SEABOARD         ,NJ,08081-1139,Proprietary  ,23,66,89,86,216,302
02183600,CAPRI INSTITUTE OF HAIR DESIGN          ,NJ,07033-0000,Proprietary  ,11,31,42,73,176,249
02192200,THOMAS EDISON STATE COLLEGE             ,NJ,08608-0000,Public       ,54,822,876,477,6659,7136
02219600,OMEGA INSTITUTE                         ,NJ,08109-0000,Proprietary  ,11,41,52,38,204,242
02223700,NEW HORIZON INST OF COSMETOLOGY         ,NJ,07093-0000,Proprietary  ,8,27,35,33,166,199
02223900,DRAKE COLLEGE OF BUSINESS               ,NJ,07201-0000,Proprietary  ,44,260,304,193,1248,1441
02223902,DRAKE COLLEGE OF BUSINESS - NEWARK CAMPU,NJ,07112-2760,Proprietary  ,67,356,423,316,1637,1953
02232500,UNION COUNTY VOCATIONAL TECH INST       ,NJ,07076-0000,Public       ,12,12,24,61,93,154
02234600,SHORE BEAUTY SCHOOL                     ,NJ,08232-0000,Proprietary  ,4,37,41,60,178,238
02246000,ROSS UNIVERSITY - MEDICAL SCHOOL        ,NJ,08837-0000,Proprietary  ,1,273,274,21,4252,4273
02248600,COOPER HEALTH SYS-CTR ALLIED HEALTH     ,NJ,08103-0000,Private      ,8,33,41,58,198,256
02252700,CONCORDE SCHOOL OF HAIR DESIGN          ,NJ,07712-0000,Proprietary  ,15,48,63,122,269,391
02252701,CONCORDE SCHOOL OF HAIR DESIGN - BLOOMFI,NJ,07003-2517,Proprietary  ,5,7,12,34,50,84
02261800,EUROPEAN ACADEMY OF COSMETOLOGY         ,NJ,07083-0000,Proprietary  ,9,22,31,62,152,214
02265500,CAPRI INSTITUTE OF HAIR DESIGN          ,NJ,08724-0000,Proprietary  ,30,43,73,70,156,226
02277900,ROSS UNIV - SCH OF VETERINARY MED       ,NJ,08837-0000,Proprietary  ,2,63,65,11,1408,1419
02291000,LINCOLN TECHNICAL INSTITUTE             ,NJ,07080-2424,Proprietary  ,15,31,46,182,251,433
02312000,BERGEN COUNTY TECHNICAL SCHOOLS         ,NJ,07601-6110,Public       ,12,34,46,82,184,266
02344200,EMPIRE BEAUTY SCHOOL                    ,NJ,08002-0000,Proprietary  ,14,44,58,137,342,479
02503900,WARREN COUNTY COMMUNITY COLLEGE         ,NJ,07882-0000,Public       ,44,106,150,794,799,1593
02523700,OCEAN COUNTY VOCATIONAL-TECH SCHOOL     ,NJ,08753-0000,Public       ,6,36,42,212,363,575
02525900,ARTISTIC ACADEMY OF HAIR DESIGN         ,NJ,07950-1409,Proprietary  ,7,17,24,112,132,244
02528200,REIGNBOW BEAUTY ACADEMY                 ,NJ,07060-0000,Proprietary  ,8,42,50,27,94,121
02558700,PRISM CAREER INSTITUTE                  ,NJ,08037-0000,Proprietary  ,24,139,163,128,663,791
02568800,SUSSEX COUNTY COMMUNITY COLLEGE         ,NJ,07860-1149,Public       ,56,97,153,1658,1188,2846
02586900,HARRIS SCHOOL OF BUSINESS               ,NJ,08043-2604,Proprietary  ,36,225,261,184,976,1160
02616402,SANFORD-BROWN INSTITUTE - ISELIN        ,NJ,08830-0000,Proprietary  ,68,192,260,425,1045,1470
03077500,RABBI JACOB JOSEPH SCHOOL               ,NJ,08817-4494,Private      ,1,0,1,19,2,21
03122600,EASTERN INTERNATIONAL COLLEGE           ,NJ,07306-3906,Proprietary  ,15,61,76,118,416,534
03187300,STENOTECH CAREER INSTITUTE              ,NJ,07004-3490,Proprietary  ,12,13,25,48,82,130
03197300,INSTITUTE FOR HEALTH EDUCATION(THE)     ,NJ,07306-2929,Proprietary  ,8,48,56,43,239,282
03324300,CENTRAL CAREER SCHOOL                   ,NJ,07080-2408,Proprietary  ,7,33,40,45,128,173
03380302,STAR CAREER ACADEMY - STAR NEWARK       ,NJ,07102-4510,Proprietary  ,42,176,218,147,598,745
03380303,STAR CAREER ACADEMY - STAR CLIFTON      ,NJ,07011-2248,Proprietary  ,22,78,100,104,405,509
03389300,ACADEMY OF MASSAGE THERAPY              ,NJ,07631-0000,Proprietary  ,5,21,26,40,121,161
03424500,NEW COMMUNITY WORKFORCE DEVELOPMENT     ,NJ,07103-2402,Private      ,3,29,32,43,447,490
03530300,"KEY SKILLS LEARNING, INC.               ",NJ,07013-1900,Proprietary  ,0,0,0,1,23,24
03536300,INSTITUTE FOR THERAPEUTIC MASSAGE       ,NJ,07420-1452,Proprietary  ,4,30,34,24,136,160
03625300,PERFORMANCE TRAINING INSTITUTE          ,NJ,08753-0000,Proprietary  ,11,280,291,68,1281,1349
03637300,METRO AUTO ELECTRONICS TRAINING INSTITUT,NJ,07033-1798,Proprietary  ,0,1,1,10,40,50
03650600,PC AGE                                  ,NJ,07306-3936,Proprietary  ,6,39,45,52,261,313
03650603,PC AGE                                  ,NJ,08817-2842,Proprietary  ,2,4,6,6,33,39
03666300,SOMERSET CHRISTIAN COLLEGE              ,NJ,08890-9035,Private      ,8,37,45,79,410,489
03803300,HEALTHCARE TRAINING INSTITUTE           ,NJ,07083-3504,Proprietary  ,12,52,64,94,357,451
03811300,EASTERN SCHOOL OF ACUPUNCTURE AND TRADIT,NJ,07042-3562,Proprietary  ,0,4,4,1,52,53
04081300,BAIS MEDRASH TORAS CHESED               ,NJ,08701-0000,Private      ,10,1,11,25,18,43
04123400,YESHIVAS BE'ER YITZCHOK                 ,NJ,07208-2380,Private      ,0,12,12,4,39,43
04125000,GENTLE HEALING SCHOOL OF MASSAGE        ,NJ,08512-3600,Proprietary  ,1,9,10,6,43,49
04131100,YESHIVA TORAS CHAIM                     ,NJ,08701-2120,Private      ,8,0,8,161,3,164
04131200,TOTAL IMAGE BEAUTY ACADEMY              ,NJ,07307-2943,Proprietary  ,2,18,20,12,71,83
04134100,CENTER FOR ALLIED HEALTH & NURSING EDUCA,NJ,07601-5801,Proprietary  ,17,174,191,130,1454,1584
04136400,AMERICAN INSTITUTE OF MEDICAL SCIENCES &,NJ,07080-1183,Proprietary  ,11,48,59,54,221,275
04154500,STARTING POINTS FOR CHILDREN            ,NJ,07306-0001,Private      ,2,13,15,8,117,125
04154900,NATIONAL CAREER INSTITUTE               ,NJ,07018-2011,Proprietary  ,11,66,77,49,226,275
04173100,LAB PAUL MITCHELL PARTNER SCHOOL (THE)  ,NJ,08628-2500,Proprietary  ,9,11,20,53,82,135
04180300,MESIVTA KESER TORAH                     ,NJ,07719-2409,Private      ,1,0,1,2,2,4
04181400,BEST CARE TRAINING INSTITUTE            ,NJ,07018-1703,Proprietary  ,2,40,42,23,192,215
04184500,CHRISTINE VALMY INTERNATIONAL SCHOOL OF ,NJ,07058-9589,Proprietary  ,1,4,5,1,4,5
04188700,ASI CAREER INSTITUTE                    ,NJ,08012-1043,Proprietary  ,1,14,15,1,14,15
04191400,SCHOOL OF COURT REPORTING (THE)         ,NJ,08053-1533,Proprietary  ,7,29,36,17,80,97
00266500,VAUGHN COLLEGE OF AERONAUTICS AND TECHNO,NY,11369-9997,Private      ,71,116,187,1200,1032,2232
00266600,ADELPHI UNIVERSITY                      ,NY,11530-4299,Private      ,170,341,511,8369,5019,13388
00266700,DOWLING COLLEGE                         ,NY,11769-1999,Private      ,77,131,208,2709,1880,4589
00266800,ALFRED UNIVERSITY                       ,NY,14802-1205,Private      ,56,54,110,3582,808,4390
00266900,BANK STREET COLLEGE OF EDUCATION        ,NY,10025-0000,Private      ,1,45,46,6,923,929
00267100,BARD COLLEGE                            ,NY,12504-5000,Private      ,41,18,59,2834,721,3555
00267400,NEW YORK THEOLOGICAL SEMINARY           ,NY,10115-0002,Private      ,0,21,21,2,228,230
00267700,BROOKLYN LAW SCHOOL                     ,NY,11201-0000,Private      ,9,39,48,68,3531,3599
00267800,BRYANT & STRATTON COLLEGE               ,NY,14203-1713,Proprietary  ,304,1727,2031,2872,15127,17999
00267803,BRYANT & STRATTON COLLEGE - GREECE      ,NY,14606-4227,Proprietary  ,40,126,166,326,1287,1613
00267805,BRYANT & STRATTON COLLEGE - SYRACUSE    ,NY,13203-2502,Proprietary  ,72,204,276,644,1777,2421
00267807,BRYANT & STRATTON COLLEGE - ALBANY      ,NY,12205-5230,Proprietary  ,23,127,150,280,1155,1435
00268100,CANISIUS COLLEGE                        ,NY,14208-1098,Private      ,57,122,179,4627,2059,6686
00268500,CAZENOVIA COLLEGE                       ,NY,13035-1085,Private      ,16,15,31,1887,265,2152
00268700,CUNY-BROOKLYN COLLEGE                   ,NY,11210-2814,Public       ,659,1079,1738,17621,12869,30490
00268800,CITY COLLEGE-CUNY                       ,NY,10031-9198,Public       ,662,1054,1716,20385,11742,32127
00268900,CUNY-HUNTER COLLEGE                     ,NY,10021-0000,Public       ,866,1494,2360,27538,17658,45196
00269000,QUEENS COLLEGE-CUNY                     ,NY,11367-1597,Public       ,576,792,1368,17274,9569,26843
00269100,CUNY- BOROUGH OF MANHATTAN CMTY CLG     ,NY,10007-1047,Public       ,1799,1800,3599,25742,16854,42596
00269200,CUNY BRONX COMMUNITY COLLEGE            ,NY,10453-3102,Public       ,942,1271,2213,12019,10770,22789
00269300,CUNY-JOHN JAY CLG CRIMINAL JUSTICE      ,NY,10019-1093,Public       ,573,798,1371,15774,8696,24470
00269400,KINGSBOROUGH COMMUNITY COLLEGE          ,NY,11235-2398,Public       ,824,839,1663,14144,8825,22969
00269600,NY CITY COLLEGE OF TECHNOLOGY-CUNY      ,NY,11201-2983,Public       ,759,942,1701,16300,9599,25899
00269700,QUEENSBOROUGH COMMUNITY COLLEGE         ,NY,11364-1497,Public       ,842,712,1554,13453,6981,20434
00269800,CUNY THE COLLEGE OF STATEN ISLAND       ,NY,10314-6600,Public       ,376,415,791,11102,5348,16450
00269900,CLARKSON UNIVERSITY                     ,NY,13699-5615,Private      ,29,35,64,4933,507,5440
00270000,COLGATE ROCHESTER CROZER DIVINITY S     ,NY,14620-0000,Private      ,0,7,7,15,92,107
00270100,COLGATE UNIVERSITY                      ,NY,13346-1386,Private      ,57,7,64,4226,117,4343
00270300,COLLEGE OF MOUNT SAINT VINCENT          ,NY,10471-1093,Private      ,49,43,92,2672,576,3248
00270400,COLLEGE OF NEW ROCHELLE                 ,NY,10805-2339,Private      ,41,367,408,1236,4647,5883
00270500,COLLEGE OF SAINT ROSE                   ,NY,12203-1490,Private      ,76,162,238,5012,2275,7287
00270700,COLUMBIA UNIVERSITY                     ,NY,10027-0000,Private      ,447,967,1414,23187,24672,47859
00270800,BARNARD COLLEGE-COLUMBIA UNIV           ,NY,10027-6598,Private      ,70,44,114,4116,367,4483
00270900,CONCORDIA COLLEGE                       ,NY,10708-1998,Private      ,20,45,65,870,464,1334
00271000,COOPER UNION                            ,NY,10003-7120,Private      ,39,23,62,1797,309,2106
00271100,CORNELL UNIVERSITY                      ,NY,14853-2801,Private      ,368,227,595,26963,7108,34071
00271101,WEILL CORNELL MEDICAL COLLEGE AND GRADUA,NY,10021-0000,Private      ,3,31,34,26,791,817
00271200,D'YOUVILLE COLLEGE                      ,NY,14201-1084,Private      ,37,119,156,1867,2225,4092
00271300,DOMINICAN COLLEGE                       ,NY,10962-1299,Private      ,58,90,148,1816,976,2792
00271800,ELMIRA COLLEGE                          ,NY,14901-2099,Private      ,33,48,81,2283,547,2830
00272200,FORDHAM UNIVERSITY                      ,NY,10458-5157,Private      ,373,550,923,23292,10078,33370
00272600,GENERAL THEOLOGICAL SEMINARY            ,NY,10011-0000,Private      ,1,2,3,1,100,101
00272800,HAMILTON COLLEGE                        ,NY,13323-1218,Private      ,50,4,54,3059,70,3129
00272900,HARTWICK COLLEGE                        ,NY,13820-4020,Private      ,36,6,42,3922,199,4121
00273100,HOBART & WILLIAM SMITH COLLEGES         ,NY,14456-3397,Private      ,37,6,43,3452,102,3554
00273200,HOFSTRA UNIVERSITY                      ,NY,11549-1010,Private      ,293,271,564,15261,6505,21766
00273400,HOUGHTON COLLEGE                        ,NY,14744-0128,Private      ,10,22,32,1497,230,1727
00273500,HILBERT COLLEGE                         ,NY,14075-1597,Private      ,24,19,43,1152,374,1526
00273700,IONA COLLEGE                            ,NY,10801-1890,Private      ,107,64,171,7064,1366,8430
00273900,ITHACA COLLEGE                          ,NY,14850-7130,Private      ,185,41,226,13550,1047,14597
00274000,JEWISH THEOLOGICAL SEMINARY OF AMER     ,NY,10027-4649,Private      ,0,2,2,139,180,319
00274200,THE JUILLIARD SCHOOL                    ,NY,10023-6588,Private      ,49,30,79,1372,730,2102
00274400,KEUKA COLLEGE                           ,NY,14478-0000,Private      ,17,99,116,1371,1295,2666
00274800,LEMOYNE COLLEGE                         ,NY,13214-1399,Private      ,52,56,108,4794,1102,5896
00274900,NEW YORK COLLEGE OF PODIATRIC MED       ,NY,10035-1940,Private      ,4,19,23,43,423,466
00275100,LONG ISLAND UNIVERSITY                  ,NY,11548-1326,Private      ,369,840,1209,12766,11128,23894
00275800,MANHATTAN COLLEGE                       ,NY,10471-4098,Private      ,117,45,162,6066,705,6771
00275900,MANHATTAN SCHOOL OF MUSIC               ,NY,10027-4689,Private      ,26,22,48,683,824,1507
00276000,MANHATTANVILLE COLLEGE                  ,NY,10577-2132,Private      ,39,88,127,3161,995,4156
00276300,MARIA COLLEGE                           ,NY,12208-1798,Private      ,9,81,90,244,1027,1271
00276500,MARIST COLLEGE                          ,NY,12601-1387,Private      ,171,126,297,10781,1464,12245
00276900,MARYMOUNT MANHATTAN COLLEGE             ,NY,10021-4597,Private      ,75,40,115,3797,413,4210
00277200,MERCY COLLEGE                           ,NY,10522-1189,Private      ,251,824,1075,5693,8349,14042
00277500,MOLLOY COLLEGE                          ,NY,11570-1100,Private      ,62,143,205,3375,2237,5612
00277700,MEDAILLE COLLEGE                        ,NY,14214-2695,Private      ,48,154,202,1727,1601,3328
00277800,MOUNT SAINT MARY COLLEGE                ,NY,12550-3494,Private      ,58,109,167,3750,1237,4987
00277900,NAZARETH COLLEGE OF ROCHESTER           ,NY,14618-3790,Private      ,50,83,133,3529,1657,5186
00278200,NEW YORK INSTITUTE OF TECHNOLOGY        ,NY,11568-8000,Private      ,120,169,289,5466,3011,8477
00278202,NY INSTITUTE OF TECHNOLOGY-OSTEOPATHIC M,NY,11568-0000,Private      ,3,10,13,83,1241,1324
00278300,NEW YORK LAW SCHOOL                     ,NY,10013-0000,Private      ,3,47,50,32,3392,3424
00278400,NEW YORK MEDICAL COLLEGE                ,NY,10595-0000,Private      ,4,52,56,41,2013,2054
00278500,NEW YORK UNIVERSITY                     ,NY,10012-1091,Private      ,850,1669,2519,38069,32605,70674
00278800,NIAGARA UNIVERSITY                      ,NY,14109-2010,Private      ,63,57,120,3891,1001,4892
00279000,NYACK COLLEGE                           ,NY,10960-3698,Private      ,36,224,260,1523,2151,3674
00279100,PACE UNIVERSITY - NEW YORK              ,NY,10038-1598,Private      ,188,276,464,9228,3685,12913
00279101,PACE UNIVERSITY-PLEASANTVILLE           ,NY,10570-0000,Private      ,67,107,174,3575,1286,4861
00279102,PACE UNIVERSITY - WHITE PLAINS          ,NY,10603-0000,Private      ,18,95,113,564,2092,2656
00279500,PAUL SMITHS CLG OF ARTS & SCIENCES      ,NY,12970-0000,Private      ,19,9,28,1321,222,1543
00279600,POLYTECHNIC INTSTITUTE OF NEW YORK UNIV ,NY,11201-3840,Private      ,40,61,101,2949,1114,4063
00279800,PRATT INSTITUTE                         ,NY,11205-3899,Private      ,139,144,283,5133,2866,7999
00280300,RENSSELAER POLYTECHNIC INSTITUTE        ,NY,12180-3590,Private      ,147,37,184,10842,869,11711
00280500,ROBERTS WESLEYAN COLLEGE                ,NY,14624-1997,Private      ,31,111,142,1568,1346,2914
00280600,ROCHESTER INSTITUTE OF TECHNOLOGY       ,NY,14623-5608,Private      ,251,206,457,16050,3499,19549
00280700,ROCKEFELLER UNIVERSITY                  ,NY,10021-0000,Private      ,3,7,10,18,41,59
00280800,DAEMEN COLLEGE                          ,NY,14226-3592,Private      ,40,65,105,2452,1176,3628
00281000,THE SAGE COLLEGES                       ,NY,12180-4199,Private      ,40,140,180,1808,2019,3827
00281200,TROCAIRE COLLEGE                        ,NY,14220-2094,Private      ,40,185,225,730,1727,2457
00281300,SARAH LAWRENCE COLLEGE                  ,NY,10708-5999,Private      ,34,19,53,1931,728,2659
00281400,SKIDMORE COLLEGE                        ,NY,12866-1632,Private      ,55,9,64,3804,137,3941
00281401,SKIDMORE COLLEGE - UNIV WITHOUT WALLS   ,NY,12866-1632,Private      ,0,0,0,113,16,129
00281500,ST BERNARDS SCH THEOLOGY & MINISTRY     ,NY,14618-3822,Private      ,0,2,2,0,36,36
00281600,SIENA COLLEGE                           ,NY,12211-1462,Private      ,72,19,91,6796,407,7203
00281700,ST BONAVENTURE UNIVERSITY               ,NY,14778-2284,Private      ,30,28,58,2842,607,3449
00282000,ST FRANCIS COLLEGE                      ,NY,11201-4398,Private      ,105,82,187,2676,776,3452
00282100,ST JOHN FISHER COLLEGE                  ,NY,14618-3597,Private      ,59,92,151,4569,1911,6480
00282200,CHRIST THE KING SEMINARY                ,NY,14052-0607,Private      ,0,0,0,0,8,8
00282300,ST JOHN'S UNIVERSITY                    ,NY,11439-1343,Private      ,300,304,604,24846,7791,32637
00282500,ST JOSEPH'S COLLEGE                     ,NY,11205-3688,Private      ,46,87,133,1260,848,2108
00282501,ST JOSEPH'S COLLEGE-SUFFOLK CAMPUS      ,NY,11772-0000,Private      ,102,143,245,3183,1594,4777
00282900,ST LAWRENCE UNIVERSITY                  ,NY,13617-1455,Private      ,24,10,34,2874,140,3014
00283200,ST THOMAS AQUINAS COLLEGE               ,NY,10976-1050,Private      ,42,26,68,1948,319,2267
00283300,ST VLADIMIR ORTHODOX THEOL SEM          ,NY,10707-0000,Private      ,0,0,0,0,42,42
00283400,EXCELSIOR COLLEGE                       ,NY,12203-5159,Private      ,44,1355,1399,228,8003,8231
00283500,SUNY AT ALBANY                          ,NY,12222-0001,Public       ,412,255,667,20576,5624,26200
00283600,BINGHAMTON UNIVERSITY (SUNY)            ,NY,13902-6000,Public       ,344,155,499,24633,3606,28239
00283700,SUNY AT BUFFALO                         ,NY,14260-0001,Public       ,382,377,759,23054,10443,33497
00283800,SUNY AT STONY BROOK                     ,NY,11794-0701,Public       ,515,457,972,26302,8946,35248
00283900,SUNY-DOWNSTATE MEDICAL CENTER           ,NY,11203-2098,Public       ,11,62,73,174,2314,2488
00284000,SUNY UPSTATE MEDICAL UNIVERSITY         ,NY,13210-2375,Public       ,17,53,70,258,1543,1801
00284100,SUNY BROCKPORT - FIN AID OFF            ,NY,14420-2914,Public       ,164,215,379,9950,3340,13290
00284200,BUFFALO STATE COLLEGE - SUNY            ,NY,14222-1095,Public       ,325,401,726,13003,5667,18670
00284300,SUNY COLLEGE-CORTLAND                   ,NY,13045-0900,Public       ,174,86,260,12157,1806,13963
00284400,SUNY AT FREDONIA                        ,NY,14063-1145,Public       ,124,65,189,7719,1139,8858
00284500,SUNY GENESEO                            ,NY,14454-1401,Public       ,119,36,155,9417,747,10164
00284600,SUNY COLLEGE-NEW PALTZ                  ,NY,12561-2499,Public       ,175,148,323,11906,2612,14518
00284700,SUNY COLLEGE-ONEONTA                    ,NY,13820-4015,Public       ,167,45,212,11360,970,12330
00284800,SUNY OSWEGO                             ,NY,13126-3599,Public       ,172,118,290,11125,2371,13496
00284900,SUNY COLLEGE AT PLATTSBURGH             ,NY,12901-2681,Public       ,139,74,213,7739,1694,9433
00285000,SUNY COLLEGE-POTSDAM                    ,NY,13676-2294,Public       ,89,67,156,5768,1137,6905
00285100,SUNY COLLEGE OF ENVIRONMENT SCIENCE AND ,NY,13210-2778,Public       ,35,33,68,2352,658,3010
00285300,SUNY MARITIME COLLEGE                   ,NY,10465-4198,Public       ,34,26,60,1683,373,2056
00285400,SUNY COLLEGE OF TECHNOLOGY-ALFRED       ,NY,14802-9951,Public       ,64,81,145,4286,1097,5383
00285500,SUNY CANTON COLG OF TECHNOLOGY          ,NY,13617-1098,Public       ,92,152,244,3451,1732,5183
00285600,SUNY AG & TECH COLLEGE-COBLESKILL       ,NY,12043-9986,Public       ,47,24,71,2889,585,3474
00285700,SUNY DELHI                              ,NY,13753-1190,Public       ,114,103,217,3879,1141,5020
00285800,SUNY FARMINGDALE                        ,NY,11735-1021,Public       ,199,244,443,6202,2580,8782
00285900,SUNY COLLEGE OF AG & TECH AT MORRISVILLE,NY,13408-0901,Public       ,65,78,143,3729,1214,4943
00286000,ADIRONDACK COMMUNITY COLLEGE            ,NY,12804-2004,Public       ,94,199,293,1859,1975,3834
00286100,CAYUGA COMMUNITY COLLEGE                ,NY,13021-3099,Public       ,117,365,482,1901,2649,4550
00286200,BROOME COMMUNITY COLLEGE                ,NY,13902-0000,Public       ,143,305,448,3439,2984,6423
00286300,CORNING COMMUNITY COLLEGE               ,NY,14830-3297,Public       ,105,266,371,1984,2343,4327
00286400,DUTCHESS COMMUNITY COLLEGE              ,NY,12601-1595,Public       ,227,302,529,3608,2743,6351
00286600,FASHION INSTITUTE OF TECHNOLOGY         ,NY,10001-5992,Public       ,299,314,613,8438,3720,12158
00286700,SUNY FULTON MONTGOMERY COMM CLG         ,NY,12095-3790,Public       ,72,119,191,1599,1381,2980
00286800,HUDSON VALLEY COMMUNITY COLLEGE         ,NY,12180-6096,Public       ,400,686,1086,7008,5599,12607
00286900,JAMESTOWN COMMUNITY COLLEGE             ,NY,14702-0020,Public       ,118,247,365,2713,2356,5069
00287000,JEFFERSON COMMUNITY COLLEGE             ,NY,13601-1897,Public       ,76,396,472,1507,2638,4145
00287100,"SUNY, MOHAWK VALLEY COMMUNITY CLG       ",NY,13501-5394,Public       ,233,528,761,4630,4039,8669
00287200,MONROE COMMUNITY COLLEGE                ,NY,14623-5780,Public       ,721,1458,2179,10398,10923,21321
00287300,NASSAU COMMUNITY COLLEGE                ,NY,11530-6793,Public       ,870,929,1799,12973,7932,20905
00287400,NIAGARA COUNTY COMMUNITY COLLEGE        ,NY,14132-9460,Public       ,240,386,626,4297,3346,7643
00287500,ONONDAGA COMMUNITY COLLEGE              ,NY,13215-4585,Public       ,425,662,1087,6930,5050,11980
00287600,ORANGE COUNTY COMMUNITY COLLEGE         ,NY,10940-6441,Public       ,217,400,617,3158,2912,6070
00287700,ROCKLAND COMMUNITY COLLEGE              ,NY,10901-3611,Public       ,170,247,417,2860,2267,5127
00287800,SUFFOLK COMMUNITY COLLEGE               ,NY,11784-2899,Public       ,482,596,1078,8245,4664,12909
00287801,SUFFOLK COMMUNITY CLG-W. CAMPUS         ,NY,11717-0000,Public       ,313,414,727,3914,3030,6944
00287803,SUFFOLK COMMUNITY CLG-EASTRN CAMPUS     ,NY,11901-0000,Public       ,108,178,286,1377,1087,2464
00287900,SULLIVAN COUNTY COMMUNITY COLLEGE       ,NY,12759-5151,Public       ,85,106,191,1487,966,2453
00288000,ULSTER COUNTY COMMUNITY COLLEGE         ,NY,12484-0557,Public       ,102,167,269,1373,1249,2622
00288100,SUNY WESTCHESTER COMMUNITY COLLEGE      ,NY,10595-1698,Public       ,480,674,1154,6377,5455,11832
00288200,SYRACUSE UNIVERSITY                     ,NY,13244-2130,Private      ,438,265,703,23920,7083,31003
00288300,UTICA COLLEGE- UTICA                    ,NY,13502-4892,Private      ,53,189,242,3732,2044,5776
00288500,ALBANY COLLEGE OF PHARMACY AND HEALTH SC,NY,12208-3492,Private      ,23,13,36,1726,866,2592
00288600,ALBANY LAW SCHOOL                       ,NY,12208-0000,Private      ,4,13,17,61,1420,1481
00288700,ALBANY MEDICAL COLLEGE                  ,NY,12208-0000,Private      ,9,22,31,100,1168,1268
00288900,UNION COLLEGE                           ,NY,12308-2311,Private      ,36,8,44,3556,170,3726
00289000,UNION THEOLOGICAL SEMINARY              ,NY,10027-0000,Private      ,1,3,4,2,373,375
00289200,UNITED STATES MERCHANT MARINE ACADEMY   ,NY,11024-1699,Public       ,10,2,12,405,25,430
00289400,UNIVERSITY OF ROCHESTER                 ,NY,14627-9000,Private      ,147,153,300,8828,2232,11060
00289401,EASTMAN SCH OF MUSIC/UNIV ROCHESTER     ,NY,14604-0000,Private      ,18,10,28,752,395,1147
00289402,UNIV OF ROCHESTER SCHL OF MEDICINE      ,NY,14642-0000,Private      ,3,10,13,50,708,758
00289500,VASSAR COLLEGE                          ,NY,12604-0008,Private      ,69,10,79,5167,185,5352
00289600,VILLA MARIA COLLEGE-BUFFALO             ,NY,14225-3999,Private      ,11,27,38,446,312,758
00289900,WAGNER COLLEGE                          ,NY,10301-4495,Private      ,77,44,121,2982,522,3504
00290000,WEBB INSTITUTE                          ,NY,11542-1398,Private      ,2,0,2,74,6,80
00290100,WELLS COLLEGE                           ,NY,13026-0500,Private      ,12,4,16,1273,112,1385
00290300,YESHIVA UNIVERSITY                      ,NY,10033-3201,Private      ,57,100,157,2256,3220,5476
00290302,YESHIVA UNIVERSITY - BRONX CAMPUS       ,NY,10461-1975,Private      ,2,19,21,31,1146,1177
00397400,MESIVTHA TIFERETH JERUSALEM OF AMER     ,NY,10002-6382,Private      ,20,0,20,29,1,30
00397600,RABBINICAL ACAD MESIVTA RABBI CHAIM     ,NY,11230-4715,Private      ,14,0,14,14,2,16
00397700,RABBINICAL COLLEGE CH'SAN SOFER         ,NY,11204-1252,Private      ,0,8,8,0,9,9
00397800,RABBINICAL SEMINARY OF AMERICA          ,NY,11375-0000,Private      ,3,25,28,30,47,77
00397900,COLUMBIA UNIV TEACHERS COLLEGE          ,NY,10027-0000,Private      ,5,205,210,56,5100,5156
00405400,HEBREW UNION COL-JEWISH INST OF REL     ,NY,10012-0000,Private      ,0,1,1,0,86,86
00475900,"CUNY, YORK COLLEGE                      ",NY,11451-0001,Public       ,399,620,1019,10677,6184,16861
00476500,CUNY GRADUATE SCH & UNIV CTR            ,NY,10016-4309,Public       ,21,270,291,178,3580,3758
00477600,CENTRAL YESHIVA TOMCHEI TMIMIM LUBA     ,NY,11230-2798,Private      ,117,36,153,151,43,194
00478800,HERKIMER COUNTY COMMUNITY COLLEGE       ,NY,13350-1598,Public       ,112,161,273,2775,1524,4299
00479800,MIRRER YESHIVA CENTRAL INST             ,NY,11223-2010,Private      ,31,15,46,87,48,135
00479900,MONROE COLLEGE                          ,NY,10468-4305,Proprietary  ,223,654,877,3644,5948,9592
00481100,EVEREST INSTITUTE                       ,NY,14621-3007,Proprietary  ,31,151,182,179,1331,1510
00506400,SAINT JAMES MERCY HOSPITAL SCHOOL OF RAD,NY,14843-2197,Private      ,0,0,0,18,15,33
00506600,FAXTON ST. LUKE'S SCHOOL OF RADIOGRAPHY ,NY,13502-4856,Private      ,1,5,6,28,31,59
00520800,THE COLLEGE OF WESTCHESTER              ,NY,10602-0000,Proprietary  ,44,124,168,792,850,1642
00587700,ROBERT J HOCHSTIM SCHOOL OF RADIOG      ,NY,11572-1151,Private      ,0,0,0,1,10,11
00643501,ARNOT OGDEN MEDICAL CENTER              ,NY,14905-1676,Private      ,0,6,6,49,66,115
00643800,PHILLIPS BETH ISRAEL SCH OF NURSING     ,NY,10001-6354,Private      ,2,28,30,115,403,518
00644300,COCHRAN SCH NSG-ST JOHN RVSDE HOSP      ,NY,10701-1399,Private      ,1,8,9,37,231,268
00644500,CROUSE HOSP SCH OF NURSING              ,NY,13210-1690,Private      ,13,48,61,184,347,531
00644800,ELLIS HOSPITAL SCHOOL OF NURSING        ,NY,12308-0000,Private      ,2,15,17,60,183,243
00646101,ST ELIZABETH COLLEGE OF NURSING         ,NY,13501-2998,Private      ,3,11,14,111,194,305
00646102,ST ELIZABETH SCH OF RADIOGRAPHY         ,NY,13501-0000,Private      ,1,2,3,20,28,48
00646700,SAINT JOSEPH'S COLLEGE OF NURSING       ,NY,13203-1806,Private      ,4,23,27,205,325,530
00678200,GENESEE COMMUNITY COLLEGE               ,NY,14020-9704,Public       ,140,360,500,3110,3033,6143
00678500,SCHENECTADY COUNTY COMMUNITY CLG        ,NY,12305-2294,Public       ,122,293,415,2150,2656,4806
00678700,CLINTON COMMUNITY COLLEGE               ,NY,12901-5690,Public       ,68,90,158,1312,936,2248
00678800,TOMPKINS CORTLAND COMMUNITY COLLEGE     ,NY,13053-8504,Public       ,151,208,359,3128,1838,4966
00678900,COLUMBIA-GREENE COMMUNITY COLLEGE       ,NY,12534-9543,Public       ,50,104,154,942,970,1912
00679100,SUNY AT PURCHASE                        ,NY,10577-1400,Public       ,148,78,226,7590,1193,8783
00702200,CUNY-LEHMAN COLLEGE                     ,NY,10468-1589,Public       ,484,1026,1510,13018,11837,24855
00702600,MOUNT SINAI SCHOOL OF MEDICINE          ,NY,10029-0000,Private      ,5,18,23,26,1050,1076
00710900,SUNY COLLEGE-OLD WESTBURY               ,NY,11568-0210,Public       ,137,150,287,5672,2415,8087
00711100,NORTH COUNTRY COMMUNITY COLLEGE         ,NY,12983-2046,Public       ,30,82,112,853,843,1696
00726400,MESIFTA TORAH VODAATH RABBINCAL SEM     ,NY,11218-5209,Private      ,10,9,19,19,25,44
00727300,CUNY-BERNARD BARUCH COLLEGE             ,NY,10010-5518,Public       ,517,901,1418,17817,10347,28164
00730400,CULINARY INSTITUTE OF AMERICA           ,NY,12538-1499,Private      ,261,231,492,3402,1772,5174
00732916,ITT TECHNICAL INSTITUTE                 ,NY,12205-1003,Proprietary  ,29,110,139,197,591,788
00737200,AUSTIN'S SCHOOL OF SPA TECHNOLOGY       ,NY,12206-1513,Proprietary  ,27,98,125,156,481,637
00737500,ISLAND DRAFTING & TECHNICAL INST        ,NY,11701-2704,Proprietary  ,7,8,15,64,74,138
00738700,LONG ISLAND BEAUTY SCHOOL               ,NY,11788-4346,Proprietary  ,35,58,93,164,340,504
00738800,LONG ISLAND BEAUTY SCHOOL               ,NY,11550-3704,Proprietary  ,8,38,46,43,168,211
00739100,BEAUTY SCHOOL OF MIDDLETOWN             ,NY,10940-6574,Proprietary  ,8,20,28,45,84,129
00739400,BERKELEY COLLEGE                        ,NY,10017-0000,Proprietary  ,197,467,664,3129,4320,7449
00739402,BERKELEY COLLEGE-WESTCHESTER CAMPUS     ,NY,10601-1533,Proprietary  ,35,46,81,870,571,1441
00740100,MANDL SCHOOL                            ,NY,10019-5516,Proprietary  ,35,148,183,247,1041,1288
00740500,WOOD TOBE-COBURN SCHOOL                 ,NY,10016-0102,Proprietary  ,6,3,9,690,176,866
00746500,AMERICAN ACADEMY OF DRAMATIC ARTS       ,NY,10016-7089,Private      ,42,48,90,638,318,956
00746600,LIM COLLEGE                             ,NY,10022-5268,Proprietary  ,59,36,95,2223,406,2629
00746800,SCHOOL OF VISUAL ARTS                   ,NY,10010-3994,Proprietary  ,94,91,185,4284,1765,6049
00750602,LINCOLN TECHNICAL INSTITUTE             ,NY,11357-6092,Proprietary  ,75,64,139,640,380,1020
00751800,APEX TECHNICAL SCHOOL                   ,NY,10011-2008,Proprietary  ,178,416,594,790,1932,2722
00752200,CONTINENTAL SCH OF BEAUTY CULTURE       ,NY,14623-3231,Proprietary  ,45,116,161,196,501,697
00752205,CONTINENTAL SCHOOL OF BEAUTY CULTURE - M,NY,13211-1003,Proprietary  ,2,1,3,14,15,29
00753200,FINGER LAKES COMMUNITY COLLEGE          ,NY,14424-8395,Public       ,144,301,445,3605,2881,6486
00757200,AMERICAN MUSICAL AND DRAMATIC ACAD      ,NY,10023-2106,Private      ,108,50,158,2538,512,3050
00757300,EMPIRE BEAUTY SCHOOL                    ,NY,11103-4028,Proprietary  ,25,34,59,170,349,519
00780400,STAR CAREER ACADEMY                     ,NY,10011-7307,Proprietary  ,38,185,223,229,850,1079
00818900,CONTINENTAL SCHOOL OF BEAUTY CULTURE - B,NY,14224-3402,Proprietary  ,14,57,71,85,213,298
00818903,CONTINENTAL SCHOOL OF BEAUTY CULTURE - B,NY,14223-2911,Proprietary  ,2,7,9,21,48,69
00843700,CHAMPLAIN VALLEY - TEC/PRN              ,NY,12901-0000,Public       ,0,2,2,16,47,63
00849500,JAMESTOWN BUSINESS COLLEGE              ,NY,14702-0429,Proprietary  ,9,32,41,180,331,511
00861100,"CUNY, HOSTOS CMTY COLLEGE               ",NY,10451-1499,Public       ,624,855,1479,7630,7285,14915
00861400,RABBINICAL CLG BOBOVER YESHIVA BNEI     ,NY,11219-3293,Private      ,62,19,81,87,20,107
00861700,RABBINICAL SEM MKOR CHAIM-YESHIVA       ,NY,11219-4300,Private      ,7,0,7,7,0,7
00878800,STATE UNIVERSITY OF NEW YORK STUDENT LOA,NY,12246-0000,Public       ,21,30,51,810,418,1228
00900300,OLEAN BUSINESS INSTITUTE INC            ,NY,14760-2691,Proprietary  ,3,11,14,12,88,100
00902900,NEIGHBORHOOD PLAYHOUSE                  ,NY,10022-5017,Private      ,2,4,6,28,46,74
00904300,ELMIRA BUSINESS INSTITUTE               ,NY,14901-2731,Proprietary  ,13,104,117,108,759,867
00907700,UTICA SCHOOL OF COMMERCE                ,NY,13501-2280,Proprietary  ,17,73,90,138,478,616
00924800,SAMARITAN HOSPITAL SCH NURSING          ,NY,12180-2475,Private      ,8,18,26,53,208,261
00928300,MIDWAY-PARIS BEAUTY SCHOOL              ,NY,11385-3453,Proprietary  ,12,31,43,34,81,115
00928400,LEARNING INST FOR BEAUTY SCIENCES       ,NY,11756-1345,Proprietary  ,19,68,87,92,269,361
00933500,MESIVTA EASTERN PKWY RABBINICAL CLG     ,NY,11218-5559,Private      ,13,3,16,25,3,28
00947900,SAINT VINCENTS CMC SI NURSING SCHOOL    ,NY,10304-3850,Proprietary  ,35,89,124,229,568,797
00976900,METROPOLITAN COLLEGE OF NEW YORK        ,NY,10013-1919,Private      ,15,190,205,287,1759,2046
00992900,SUNY COLLEGE OF OPTOMETRY               ,NY,10036-8003,Public       ,2,6,8,25,354,379
01005100,LA GUARDIA CMTY COLLEGE - CUNY          ,NY,11101-3083,Public       ,1035,1307,2342,15191,11445,26636
01005200,JEFFERSON-LEWIS BOCES PRAC NRSGPRG      ,NY,13601-9509,Public       ,4,29,33,29,166,195
01009700,CUNY-MEDGAR W EVERS COLLEGE             ,NY,11225-2010,Public       ,290,547,837,6178,6111,12289
01014200,TOURO COLLEGE                           ,NY,10010-4202,Private      ,316,757,1073,3576,10612,14188
01014700,WESTERN SUFFOLK BOCES                   ,NY,11768-3499,Public       ,11,34,45,123,402,525
01015300,HELENE FULD COL OF NRSNG/N GEN HOSP     ,NY,10035-0000,Private      ,6,84,90,31,615,646
01028600,EMPIRE STATE COLLEGE                    ,NY,12866-4391,Public       ,113,1255,1368,1016,12792,13808
01037800,RABBINICAL COLLEGE OF LONG ISLAND       ,NY,11561-3244,Private      ,27,0,27,35,3,38
01054900,KEHILATH YAKOV RABBINICAL SEMINARY      ,NY,10562-1001,Private      ,20,10,30,20,10,30
01055100,NEW YORK SCH MED & DENTAL ASSISTANT     ,NY,11101-2327,Proprietary  ,20,46,66,123,252,375
01064100,SOUTHERN WESTCHESTER BOCES              ,NY,10543-0000,Public       ,3,13,16,34,177,211
01068400,ERIE COMMUNITY COLLEGE-ALL CAMPUSES     ,NY,14203-2698,Public       ,551,1147,1698,8587,9093,17680
01081300,AMERICAN ACAD MCALLISTER INST           ,NY,10019-3604,Private      ,8,55,63,95,486,581
01083700,SIMMONS INST OF FUNERAL SERVICE         ,NY,13207-2098,Proprietary  ,3,6,9,24,47,71
01093000,SUBURBAN TECHNICAL SCHOOL               ,NY,11550-3771,Proprietary  ,0,2,2,22,132,154
01094300,RABBINICAL COLLEGE BETH SHRAGA          ,NY,10952-3033,Private      ,3,0,3,6,0,6
01095200,PNW BOCES LPN PROGRAM                   ,NY,10598-0000,Public       ,1,9,10,9,73,82
01103100,TECHNICAL CAREER INSTITUTE              ,NY,10001-2789,Proprietary  ,278,536,814,1889,4464,6353
01118900,UNITED TALMUDICAL SEMINARY              ,NY,11211-7984,Private      ,409,2,411,412,3,415
01119200,BETH HAMEDRASH SHAAREI YOSHER INST      ,NY,11204-1052,Private      ,2,5,7,4,7,11
01161400,CHAMPLAIN VALLEY HOSP SCH RAD TECH      ,NY,12901-1490,Private      ,0,1,1,23,11,34
01161700,NEW YORK METHODIST HOSPITAL             ,NY,11229-9023,Private      ,9,60,69,96,339,435
01164700,SBI CAMPUS - AN AFFILIATE OF SANFORD-BRO,NY,11747-3785,Proprietary  ,36,44,80,342,754,1096
01167000,YESHIVA OF NITRA RABBINICAL COLLEGE     ,NY,11211-7108,Private      ,26,1,27,26,1,27
01167700,MEMORIAL SLOAN KETTERING CANCER CTR     ,NY,10021-6094,Private      ,1,3,4,6,28,34
01167800,SUNY INST OF TECHNOLOGY UTICA ROME      ,NY,13504-3050,Public       ,25,89,114,1671,1238,2909
01182100,YESHIVATH ZICHRON MOSHE                 ,NY,12779-0580,Private      ,62,0,62,73,0,73
01183000,BERK TRADE AND BUSINESS SCHOOL          ,NY,11101-0000,Proprietary  ,12,38,50,60,180,240
01185900,WORD OF LIFE BIBLE INSTITUTE            ,NY,12860-0129,Private      ,17,3,20,582,102,684
01186000,MERCY MED CNTR SCHL OF RADIOGRAPHY      ,NY,11570-1098,Private      ,0,3,3,7,13,20
01192100,WESTCHESTER SCH OF BEAUTY CULTURE       ,NY,10550-2295,Proprietary  ,6,19,25,23,83,106
01192200,BETH HATALMUD RABBINICAL CLG            ,NY,11214-2594,Private      ,0,1,1,0,2,2
01198400,OHR HAMEIR THEOLOGICAL SEMINARY         ,NY,10566-0990,Private      ,44,0,44,48,1,49
01201100,TALMUDICAL SEM OHOLEI TORAH             ,NY,11213-3310,Private      ,104,0,104,158,4,162
01207200,PHILLIPS HAIRSTYLING INSTITUTE          ,NY,13210-1509,Proprietary  ,4,15,19,27,95,122
01210700,INSTITUTE OF DESIGN & CONSTRUCTION      ,NY,11201-5380,Private      ,6,13,19,45,130,175
01220300,MEMORIAL HOSPITAL SCH OF NURSING        ,NY,12204-1083,Private      ,8,20,28,53,169,222
01227700,NEW YORK CHIROPRACTIC COLLEGE           ,NY,13148-0800,Private      ,2,50,52,10,792,802
01229300,VEEB NASSAU CNTY SCHL OF PRACT NURS     ,NY,11553-3037,Public       ,3,7,10,58,214,272
01235800,PLAZA COLLEGE                           ,NY,11372-6300,Proprietary  ,62,92,154,356,896,1252
01236400,SAINT VINCENTS CATHOLIC MEDICAL CENTERS ,NY,11354-0000,Proprietary  ,18,100,118,106,594,700
01240700,SCHUYLER-CHEMUNG-TIOGA BOCES            ,NY,14903-1089,Public       ,1,9,10,35,157,192
01240701,STEUBEN SCHUYLER CHEMUNG TIOGA ALLEGANY ,NY,14870-9518,Public       ,0,1,1,0,6,6
01256100,FIVE TOWNS COLLEGE                      ,NY,11746-5871,Proprietary  ,66,30,96,1303,344,1647
01258900,ERIE 1 BOCES                            ,NY,14224-0000,Public       ,9,24,33,88,284,372
01265200,ONONDAGA CORTLAND MADISON BOCES         ,NY,13090-4500,Public       ,27,163,190,200,766,966
01278300,OSWEGO COUNTY BOCES ADULT CAREERS       ,NY,13114-4498,Public       ,0,7,7,40,80,120
01292700,CENTRAL TECH NURSING PROGRAM            ,NY,13202-3092,Public       ,1,26,27,26,122,148
01302600,MACHZIKEI HADATH RABBINICAL COLLEGE     ,NY,11204-1805,Private      ,0,1,1,0,1,1
01302700,YESHIVATH VIZNITZ                       ,NY,10952-3021,Private      ,0,18,18,0,18,18
01302900,BORICUA COLLEGE                         ,NY,10032-1599,Private      ,38,90,128,500,1241,1741
02056400,CAPRI COSMETOLOGY LEARNING CENTER       ,NY,10954-0000,Proprietary  ,19,60,79,126,270,396
02066200,THE NEW SCHOOL                          ,NY,10011-0000,Private      ,238,409,647,5644,6577,12221
02069000,NEW YORK SCHOOL OF INTERIOR DESIGN      ,NY,10021-0000,Private      ,11,39,50,201,431,632
02075700,BRIARCLIFFE COLLEGE                     ,NY,11714-0000,Proprietary  ,47,127,174,846,1130,1976
02075702,BRIARCLIFFE COLLEGE - PATCHOGUE         ,NY,11772-3019,Proprietary  ,29,83,112,639,829,1468
02092400,RIDLEY-LOWELL SCHOOL OF BUSINESS        ,NY,13905-0000,Proprietary  ,25,65,90,55,245,300
02093700,LONG ISLAND BUSINESS INSTITUTE          ,NY,11725-0000,Proprietary  ,6,13,19,267,688,955
02093701,LONG ISLAND BUSINESS INSTITUTE - FLUSHIN,NY,11354-4429,Proprietary  ,78,217,295,141,425,566
02098400,HERKIMER COUNTY BOCES                   ,NY,13350-0000,Public       ,3,7,10,95,149,244
02104300,OTSEGO AREA SCHOOL OF PRAC NURSING      ,NY,12167-0000,Public       ,0,0,0,7,39,46
02105900,HAIR DESIGN INSTITUTE AT FIFTH AVE      ,NY,11220-0000,Proprietary  ,20,78,98,124,336,460
02106800,BRAMSON ORT COLLEGE                     ,NY,11375-0000,Private      ,70,98,168,421,732,1153
02110900,CATTARAUGUS/ALLEGANY BOCES              ,NY,14760-0000,Public       ,0,2,2,24,141,165
02112301,RIDLEY - LOWELL BUSINESS & TECHNICAL INS,NY,12601-3328,Proprietary  ,25,101,126,131,538,669
02116011,SANFORD-BROWN INSTITUTE - NEW YORK      ,NY,10003-2103,Proprietary  ,122,283,405,754,2118,2872
02118700,LONG ISLAND COLLEGE HOSPITAL - SCHOOL OF,NY,11201-6001,Private      ,5,13,18,102,278,380
02118702,LONG ISLAND COLLEGE HOSPITAL - SCHOOL OF,NY,11201-6001,Private      ,7,22,29,114,234,348
02124000,ORANGE ULSTER BOCES SCH OF PRAC NRS     ,NY,10924-9401,Public       ,0,6,6,35,130,165
02125500,CIRCLE IN THE SQUARE THEATRE SCHOOL     ,NY,10019-0000,Private      ,1,11,12,53,74,127
02126300,MADISON-ONEIDA BOCES PRAC NRS           ,NY,13478-0000,Public       ,5,25,30,21,121,142
02138500,BOCES RENSSELAER SCHOOL OF PN           ,NY,12033-3221,Public       ,0,1,1,15,90,105
02145800,CAYUGA ONONDAGA BOCES                   ,NY,13021-9430,Public       ,0,8,8,23,72,95
02146000,WAYNE-FINGER LAKES BOCES                ,NY,14513-0000,Public       ,2,9,11,50,281,331
02152000,YESHIVA SHAAR HATORAH ITRI TORAH        ,NY,11418-0000,Private      ,0,0,0,3,1,4
02153600,BROOME-TIOGA BOCES PN PROG              ,NY,13905-0000,Public       ,1,7,8,34,122,156
02157900,ROCHESTER GENERAL HOSPITAL              ,NY,14621-3001,Private      ,3,16,19,33,120,153
02158200,WSHNGTN-SARTGA-WARN-HMLTN-ESX BOCES     ,NY,12839-1051,Public       ,0,6,6,32,100,132
02160100,GENEVA GENERAL HOSPITAL                 ,NY,14456-0000,Private      ,0,12,12,32,134,166
02163400,NEW YORK CAREER INSTITUTE               ,NY,10007-2801,Proprietary  ,19,90,109,268,789,1057
02169100,DAVIS COLLEGE                           ,NY,13790-0000,Private      ,6,8,14,158,101,259
02170000,SWEDISH INSTITUTE                       ,NY,10001-0000,Proprietary  ,17,111,128,115,696,811
02170200,ALBANY SCHOHARIE SCHENECTADY            ,NY,12205-0000,Public       ,6,40,46,64,201,265
02171900,AILEY SCHOOL (THE)                      ,NY,10019-4402,Private      ,8,9,17,137,84,221
02172100,HAMILTON-FULTON-MONTGOMERY BOCES        ,NY,12095-0665,Public       ,3,5,8,92,92,184
02172800,DUTCHESS COUNTY BOCES SCH PRAC NURS     ,NY,12601-0000,Public       ,8,44,52,52,216,268
02173200,EMPIRE BEAUTY SCHOOL                    ,NY,10001-0000,Proprietary  ,86,120,206,531,871,1402
02173900,ULSTER COUNTY BOCES PRACTICAL NRSG      ,NY,12466-0000,Public       ,14,38,52,58,208,266
02176000,CHERYL FELL'S SCHOOL OF BUSINESS        ,NY,14304-0000,Proprietary  ,2,11,13,11,75,86
02179400,EASTERN SUFFOLK BOCES                   ,NY,11713-0000,Public       ,4,23,27,141,393,534
02182200,NEW SCHOOL OF RADIO & TELEVISION        ,NY,12206-1106,Proprietary  ,8,17,25,51,85,136
02187300,DARKEI NOAM RABBINICAL COLLEGE          ,NY,11210-0000,Private      ,0,1,1,1,5,6
02191600,TORAH TEMIMAH TALMUDICAL SEMINARY       ,NY,11218-0000,Private      ,38,0,38,56,0,56
02192500,BELLEVUE HOSP CTR SCH RAD TECH          ,NY,10016-0000,Public       ,3,14,17,22,75,97
02199300,ORLEANS-NIAGARA BOCES                   ,NY,14132-0000,Public       ,1,13,14,17,72,89
02206000,HUNTER BUSINESS SCHOOL                  ,NY,11756-0000,Proprietary  ,47,119,166,213,628,841
02217800,D.HOPFER SCH NURSING AT MT.VRN HOSP     ,NY,10550-0000,Private      ,2,28,30,42,248,290
02219500,MILDRED ELLEY                           ,NY,12206-1513,Proprietary  ,70,364,434,406,2522,2928
02235600,ERIE 2-CHAUTAUQUA-CATTARAUGUS BOCES     ,NY,14006-0000,Public       ,5,10,15,25,91,116
02256700,KOL YAAKOV TORAH CENTER                 ,NY,10952-0000,Private      ,1,0,1,3,0,3
02265100,YESHIVA DERECH CHAIM                    ,NY,11218-0000,Private      ,6,3,9,28,10,38
02265200,GLOBAL BUSINESS INSTITUTE               ,NY,11691-0000,Private      ,36,143,179,145,693,838
02272900,ROCKLAND COUNTY BOCES PRAC NRSG SCH     ,NY,10994-0000,Public       ,1,4,5,25,116,141
02275900,"MODERN WELDING SCHOOL, INC.             ",NY,12304-0000,Proprietary  ,15,21,36,61,87,148
02287800,NATIONAL TRACTOR TRAILER SCHOOL         ,NY,13088-2505,Proprietary  ,12,161,173,45,540,585
02294900,INSTITUTE OF AUDIO RESEARCH             ,NY,10003-0000,Proprietary  ,63,82,145,332,440,772
02306500,PROFESSIONAL BUSINESS INSTITUTE         ,NY,10002-0000,Private      ,84,133,217,499,743,1242
02314200,NORTHERN WESTCHESTER SCH COSMETOL       ,NY,10566-0000,Proprietary  ,12,6,18,45,60,105
02320100,OHR SOMAYACH TANENBAUM EDUCATIONAL CENTE,NY,10952-0000,Private      ,0,0,0,0,1,1
02325600,NEW YORK INSTITUTE OF ENGLISH & BUS     ,NY,10001-0000,Private      ,16,63,79,104,281,385
02350600,YESHIVA AND KOLLEL HARBOTZAS TORAH      ,NY,11230-0000,Private      ,0,12,12,0,18,18
02491400,SPANISH AMERICAN INSTITUTE              ,NY,10036-0000,Private      ,0,13,13,5,26,31
02505800,YESHIVA KARLIN STOLIN RAB INSTITUTE     ,NY,11204-0000,Private      ,6,27,33,6,27,33
02505900,SH-OR YOSHUV RABBINICAL COLLEGE         ,NY,11691-0000,Private      ,4,1,5,39,16,55
02506000,ASSOCIATED BETH RIVKAH SCHOOLS          ,NY,11225-0000,Private      ,11,10,21,91,13,104
02506100,CITY UNIV OF NEW YORK-CENTRAL           ,NY,10021-0000,Public       ,36,71,107,865,684,1549
02506200,MERCE CUNNINGHAM STUDIO                 ,NY,10014-0000,Private      ,0,0,0,0,1,1
02506800,YESHIVAT MIKDASH MELECH                 ,NY,11230-0000,Private      ,9,1,10,34,3,37
02511500,JOFFREY BALLET SCHOOL                   ,NY,10011-0000,Proprietary  ,0,1,1,77,9,86
02513500,MAR JON SCHOOL OF BEAUTY CULTURE        ,NY,14150-0000,Proprietary  ,9,26,35,37,78,115
02525600,ART INSTITUTE OF NEW YORK CITY (THE)    ,NY,10013-2429,Proprietary  ,204,212,416,2491,1565,4056
02540800,"GLOBE INSTITUTE OF TECHNOLOGY, INC.     ",NY,10007-0000,Proprietary  ,75,93,168,430,453,883
02546000,TRI-STATE COLLEGE OF ACUPUNCTURE        ,NY,10011-0000,Proprietary  ,0,16,16,3,162,165
02546300,YESHIVA OF THE TELSHE ALUMNI            ,NY,10471-0000,Private      ,1,0,1,2,1,3
02550600,TALMUDICAL INST OF UPSTATE NY           ,NY,14607-0000,Private      ,2,0,2,5,2,7
02556700,SEMINAR L'MOROS BAIS YAAKOV             ,NY,11219-0000,Private      ,18,1,19,254,4,258
02572900,BUSINESS INFORMATICS CENTER             ,NY,11580-0000,Proprietary  ,5,13,18,27,84,111
02575400,FRENCH CULINARY INSTITUTE               ,NY,10013-2618,Proprietary  ,82,197,279,480,1041,1521
02587600,ORLO SCH HAIR DESIGN & COSMETOLOGY      ,NY,12206-1723,Proprietary  ,10,16,26,55,90,145
02599400,NEW YORK COLLEGE OF HEALTH PROFESSIONS  ,NY,11791-4413,Private      ,23,112,135,171,815,986
02600100,NEW YORK ACADEMY OF ART (THE)           ,NY,10013-2911,Private      ,14,18,32,131,246,377
02614900,SANFORD-BROWN INSTITUTE                 ,NY,10604-2910,Proprietary  ,38,87,125,236,624,860
02615001,SANFORD-BROWN COLLEGE - SANFORD-BROWN IN,NY,11530-4734,Proprietary  ,3,22,25,57,174,231
02616600,SHEAR EGO INTERNATIONAL SCHOOL OF HAIR D,NY,14617-3501,Proprietary  ,11,33,44,75,123,198
02617000,CONTINENTAL SCH OF BEAUTY CULTURE       ,NY,14020-0000,Proprietary  ,12,24,36,69,110,179
02617001,CONTINENTAL SCHOOL OF BEAUTY CULTURE - O,NY,14760-2618,Proprietary  ,0,0,0,7,1,8
02617002,CONTINENTAL SCHOOL OF BEAUTY CULTURE  - ,NY,14020-1908,Proprietary  ,1,1,2,3,1,4
02622900,BAIS MEDRASH ELYON                      ,NY,10952-3013,Private      ,0,1,1,1,1,2
03000100,YESHIVA GEDOLAH IMREI YOSEF DSPINKA     ,NY,11219-4696,Private      ,3,29,32,3,64,67
03007200,DANCE THEATRE OF HARLEM                 ,NY,10031-0000,Private      ,5,2,7,33,19,52
03027701,PACIFIC COLLEGE OF ORIENTAL MEDICINE - N,NY,10010-7108,Proprietary  ,11,65,76,41,597,638
03081600,DELAWARE CHENANGO MADISON OT. BOCES     ,NY,13815-9554,Public       ,0,5,5,15,94,109
03089700,COMPUTER CAREER CENTER                  ,NY,11530-3334,Proprietary  ,55,211,266,195,727,922
03095500,ASA INST BUSINESS & COMPUTER TECH       ,NY,11201-5208,Proprietary  ,450,704,1154,2318,4649,6967
03096200,CHARLES STUART SCHOOL                   ,NY,11229-2004,Proprietary  ,1,17,18,7,60,67
03103700,ADIRONDACK BEAUTY SCHOOL                ,NY,12801-3158,Proprietary  ,1,5,6,12,41,53
03104900,SULLIVAN COUNTY BOCES                   ,NY,12754-2116,Public       ,4,6,10,45,73,118
03115300,GENESEE VALLEY BOCES                    ,NY,14020-1099,Public       ,14,55,69,43,189,232
03120700,NEW YORK CONSERVATORY FOR DRAMATIC ARTS ,NY,10011-4225,Proprietary  ,22,16,38,490,176,666
03127100,YESHIVAS NOVOMINSK                      ,NY,11219-0000,Private      ,10,0,10,41,0,41
03129200,RABBINICAL CLG OHR SHIMAR YISROEL       ,NY,11211-8102,Private      ,8,40,48,8,40,48
03169300,STUDIO JEWELERS                         ,NY,10016-4112,Proprietary  ,0,4,4,7,42,49
03181400,MERKAZ BNOS                             ,NY,11214-4911,Private      ,7,70,77,11,153,164
03191300,CUNY SCHOOL OF LAW @ QUEENS COLLEGE     ,NY,11367-0000,Public       ,24,51,75,514,1598,2112
03193300,MANHATTAN SCHOOL OF COMPUTER TECH       ,NY,11230-1617,Private      ,28,117,145,136,546,682
03203300,NEW YORK INSTITUTE OF MASSAGE           ,NY,14221-6021,Proprietary  ,17,31,48,55,180,235
03216300,UNIFICATION THEOLOGICAL SEMINARY        ,NY,12507-5021,Private      ,0,2,2,0,32,32
03328300,FRANKLIN CAREER INSTITUTE               ,NY,11550-3003,Private      ,16,40,56,88,224,312
03328301,FRANKLIN CAREER INSTITUTE - BROOKLYN    ,NY,11220-3110,Private      ,22,55,77,120,377,497
03342400,AMERICAN BARBER INSTITUTE               ,NY,10001-5271,Proprietary  ,8,16,24,52,97,149
03358300,ALLEN SCHOOL                            ,NY,11432-4901,Proprietary  ,26,363,389,181,1568,1749
03358301,ALLEN SCHOOL - BROOKLYN                 ,NY,11201-0000,Proprietary  ,25,165,190,157,788,945
03380300,STAR CAREER ACADEMY                     ,NY,11791-5311,Proprietary  ,7,60,67,96,293,389
03419400,NORTHEASTERN SEMINARY                   ,NY,14624-1997,Private      ,1,14,15,15,134,149
03426400,ANTHEM INSTITUTE                        ,NY,10018-0000,Proprietary  ,48,88,136,274,594,868
03433500,LIA SCHORR INSTITUTE OF COSMETIC SK     ,NY,10022-2614,Proprietary  ,4,15,19,8,61,69
03443300,NEW YORK COLLEGE OF TRADITIONAL CHINESE ,NY,11501-0000,Private      ,0,6,6,4,86,90
03496300,YESHIVA SHAAREI TORAH OF ROCKLAND       ,NY,10901-4003,Private      ,17,21,38,17,21,38
03537300,NEW YORK AUTOMOTIVE & DIESEL INSTIT     ,NY,11101-0000,Proprietary  ,46,98,144,193,436,629
03568300,LEON STUDIO ONE SCHOOL OF HAIR DESI     ,NY,14221-5323,Proprietary  ,6,16,22,41,73,114
03651300,SAINT JOSEPH'S MEDICAL CENTER SCHOO     ,NY,10701-4080,Private      ,1,3,4,7,38,45
03652300,METROPOLITAN LEARNING INSTITUTE         ,NY,11374-2101,Private      ,16,205,221,78,1147,1225
03691300,USA BEAUTY SCHOOL INTERNATIONAL         ,NY,10013-3530,Proprietary  ,0,0,0,7,36,43
03713300,BEIS MEDRASH HEICHAL DOVID              ,NY,11691-4433,Private      ,16,1,17,17,1,18
03773300,CENTER FOR NATURAL WELLNESS SCHOOL OF MA,NY,12205-1601,Proprietary  ,1,30,31,31,207,238
03802300,UTA MESIVTA OF KIRYAS JOEL              ,NY,10950-2169,Private      ,290,188,478,290,204,494
03809400,MICROPOWER CAREER INSTITUTE             ,NY,10001-2812,Proprietary  ,4,93,97,46,433,479
03819400,HUDSON VALLEY SCHOOL OF ADVANCED AESTHET,NY,12493-0000,Proprietary  ,1,13,14,7,29,36
03839300,AVEDA INSTITUTE NEW YORK                ,NY,10013-1522,Proprietary  ,28,74,102,143,344,487
03881300,UNION GRADUATE COLLEGE                  ,NY,12308-3131,Private      ,0,9,9,5,217,222
03903400,AMERICAN BEAUTY SCHOOL                  ,NY,10462-8003,Proprietary  ,15,72,87,110,441,551
03941400,ELITE ACADEMY OF BEAUTY ARTS            ,NY,11223-1630,Proprietary  ,5,33,38,22,136,158
03983300,"SCHOOL OF PROFESSIONAL HORTICULTURE, AT ",NY,10458-5126,Private      ,1,9,10,4,22,26
03988300,"SAE INSTITUTE OF TECHNOLOGY, NEW YORK   ",NY,10001-2915,Proprietary  ,45,79,124,300,376,676
04043300,ACE COMPUTER TRAINING CENTER            ,NY,11375-5337,Proprietary  ,9,23,32,33,180,213
04092401,MAKE-UP DESIGNORY -                     ,NY,10012-0041,Proprietary  ,31,59,90,295,366,661
04095300,KING'S COLLEGE (THE)                    ,NY,10018-0110,Private      ,23,6,29,948,88,1036
04102300,NEW AGE TRAINING                        ,NY,10001-4006,Proprietary  ,4,51,55,14,171,185
04115500,TALMUDICAL SEMINARY OF BOBOV            ,NY,11219-3826,Private      ,30,34,64,30,35,65
04117100,EDP SCHOOL OF COMPUTER PROGRAMMING      ,NY,11235-0000,Private      ,3,90,93,10,198,208
04117700,"MONROE 2-ORLEANS BOCES, CENTER FOR WORK ",NY,14624-1119,Public       ,9,40,49,44,189,233
04123200,INSTITUTE OF ALLIED MEDICAL PROFESSIONS ,NY,11373-5541,Private      ,3,25,28,20,234,254
04123300,HUDSON VALLEY SCHOOL OF MASSAGE THERAPY ,NY,12493-0000,Proprietary  ,2,13,15,11,70,81
04125600,CAREER SCHOOL OF NY                     ,NY,10301-2416,Private      ,7,14,21,54,93,147
04131500,COLLECTIVE (THE)                        ,NY,10011-2026,Proprietary  ,2,3,5,6,15,21
04133700,NEW YORK MEDICAL CAREER TRAINING CENTER ,NY,11354-6504,Proprietary  ,14,53,67,57,218,275
04134000,"JOHN PAOLO'S XTREME BEAUTY INSTITUTE, GO",NY,12020-1245,Proprietary  ,7,38,45,38,165,203
04137700,ANN MARIE'S WORLD OF BEAUTY SCHOOL      ,NY,13901-2308,Proprietary  ,2,7,9,15,27,42
04138100,YESHIVA OF MACHZIKAI HADAS              ,NY,11219-1408,Private      ,67,44,111,68,95,163
04144300,INSTITUTE OF CULINARY EDUCATION         ,NY,10010-5205,Proprietary  ,58,204,262,457,1053,1510
04148000,NEW LIFE BUSINESS INSTITUTE             ,NY,11432-6149,Proprietary  ,8,69,77,18,133,151
04151200,SALON PROFESSIONAL ACADEMY (THE)        ,NY,14150-9200,Proprietary  ,4,21,25,37,86,123
04155300,ONONDAGA SCHOOL OF THERAPEUTIC MASSAGE  ,NY,13210-1533,Proprietary  ,9,38,47,61,229,290
04156000,ACADEMY OF COSMETOLOGY & ESTHETICS NYC (,NY,10306-3003,Proprietary  ,27,34,61,132,160,292
04165700,"JOHN PAOLO'S XTREME BEAUTY INSTITUTE, GO",NY,12110-3053,Proprietary  ,3,11,14,10,43,53
04166000,MANHATTAN INSTITUTE (THE)               ,NY,10016-6516,Proprietary  ,11,32,43,68,134,202
04167600,FINGER LAKES SCHOOL OF MASSAGE (THE)    ,NY,14850-1384,Proprietary  ,9,37,46,53,171,224
04167601,FINGER LAKES SCHOOL OF MASSAGE (THE) -  ,NY,10549-1103,Proprietary  ,5,30,35,25,108,133
04178700,ATELIER ESTHETIQUE INSTITUTE OF ESTHETIC,NY,10016-8804,Proprietary  ,7,46,53,29,253,282
04180200,LONG ISLAND NAIL & SKIN CARE INSTITUTE  ,NY,11756-1316,Proprietary  ,3,13,16,12,95,107
04189000,LONG ISLAND BARBER INSTITUTE (THE)      ,NY,11550-6317,Proprietary  ,3,14,17,3,14,17
04190500,NEW YORK SCHOOL OF ESTHETICS & DAY SPA  ,NY,10591-3232,Proprietary  ,2,11,13,5,28,33
04192800,BE'ER YAAKOV TALMUDIC SEMINARY          ,NY,10977-1912,Private      ,0,81,81,0,81,81
00267808,BRYANT & STRATTON COLLEGE - PARMA       ,OH,44130-0000,Proprietary  ,58,388,446,646,3866,4512
00301000,ANTIOCH UNIVERSITY                      ,OH,45387-1608,Private      ,1,32,33,73,960,1033
00301100,ART ACADEMY OF CINCINNATI               ,OH,45202-7106,Private      ,11,18,29,421,159,580
00301200,ASHLAND UNIVERSITY                      ,OH,44805-3799,Private      ,58,298,356,3969,3351,7320
00301300,ATHENAEUM OF OHIO                       ,OH,45230-2000,Private      ,0,3,3,5,9,14
00301400,BALDWIN-WALLACE COLLEGE                 ,OH,44017-2088,Private      ,63,114,177,4656,1673,6329
00301600,BLUFFTON UNIVERSITY                     ,OH,45817-2104,Private      ,19,29,48,1640,462,2102
00301800,BOWLING GREEN STATE UNIVERSITY          ,OH,43403-0001,Public       ,362,510,872,20334,7196,27530
00302300,CAPITAL UNIVERSITY                      ,OH,43209-2394,Private      ,81,195,276,4134,3081,7215
00302400,CASE WESTERN RESERVE UNIV               ,OH,44106-0000,Private      ,98,68,166,7914,1415,9329
00302401,CASE WESTERN RESERVE UNIV - MED         ,OH,44106-0000,Private      ,6,16,22,94,1196,1290
00302402,CASE WESTERN RESERVE UNIV - DENTAL      ,OH,44106-0000,Private      ,0,4,4,36,289,325
00302403,CASE WESTERN RESERVE UNIV - LAW         ,OH,44106-0000,Private      ,0,5,5,19,982,1001
00302404,CASE WESTERN RESERVE UNIV - UG          ,OH,44106-0000,Private      ,5,2,7,261,46,307
00302405,CASE WESTERN RESERVE UNIV - MSASS       ,OH,44106-0000,Private      ,0,7,7,43,545,588
00302406,CASE WESTERN RESERVE UNIV - NURS UG     ,OH,44106-0000,Private      ,8,19,27,223,204,427
00302407,CASE WESTERN RESERVE UNIV - WSOM        ,OH,44106-0000,Private      ,1,11,12,9,245,254
00302408,CASE WESTERN RESERVE UNIV -A&S GRAD     ,OH,44106-0000,Private      ,1,7,8,8,383,391
00302409,CASE WESTERN RESERVE UNIV -ENG GRAD     ,OH,44106-0000,Private      ,1,5,6,24,110,134
00302410,CASE WESTERN RESERVE UNIV -NURS GRD     ,OH,44106-0000,Private      ,3,23,26,17,455,472
00302500,CEDARVILLE UNIVERSITY                   ,OH,45314-8564,Private      ,59,26,85,4111,307,4418
00302600,CENTRAL STATE UNIVERSITY                ,OH,45384-1004,Public       ,86,102,188,3541,1809,5350
00302900,CINCINNATI CHRISTIAN UNIVERSITY         ,OH,45204-3200,Private      ,17,44,61,541,716,1257
00303000,OHIO CHRISTIAN UNIVERSITY               ,OH,43113-9487,Private      ,27,320,347,623,2591,3214
00303100,CLEVELAND INSTITUTE OF MUSIC            ,OH,44106-1776,Private      ,4,10,14,487,447,934
00303200,CLEVELAND STATE UNIVERSITY              ,OH,44115-2214,Public       ,251,972,1223,9315,15522,24837
00303300,COLLEGE OF MT ST JOSEPH                 ,OH,45233-1670,Private      ,14,73,87,1824,1411,3235
00303500,OHIO DOMINICAN UNIVERSITY               ,OH,43219-2099,Private      ,56,195,251,2225,2589,4814
00303600,FRANCISCAN UNIV OF STEUBENVILLE         ,OH,43952-1763,Private      ,46,52,98,2334,733,3067
00303700,COLLEGE OF WOOSTER                      ,OH,44691-2363,Private      ,23,18,41,3112,163,3275
00303900,COLUMBUS COLLEGE OF ART AND DESIGN      ,OH,43215-1758,Private      ,38,66,104,1810,667,2477
00304000,CUYAHOGA COMMUNITY COLLEGE              ,OH,44115-2878,Public       ,852,3172,4024,11507,28377,39884
00304100,"DEFIANCE COLLEGE, THE                   ",OH,43512-1695,Private      ,7,27,34,1496,547,2043
00304200,DENISON UNIVERSITY                      ,OH,43023-1329,Private      ,47,11,58,2939,123,3062
00304300,CHANCELLOR UNIVERSITY                   ,OH,44114-0000,Proprietary  ,5,64,69,35,702,737
00304400,TRINITY LUTHERAN SEMINARY               ,OH,43209-0000,Private      ,0,2,2,0,135,135
00304500,UNIVERSITY OF FINDLAY                   ,OH,45840-3695,Private      ,46,120,166,3324,1733,5057
00304600,FRANKLIN UNIVERSITY                     ,OH,43215-5399,Private      ,73,793,866,1045,11141,12186
00304800,HEIDELBERG UNIVERSITY                   ,OH,44883-2462,Private      ,24,26,50,1860,429,2289
00304900,HIRAM COLLEGE                           ,OH,44234-1808,Private      ,25,24,49,1775,437,2212
00305000,JOHN CARROLL UNIVERSITY                 ,OH,44118-4581,Private      ,61,61,122,4379,1100,5479
00305100,KENT STATE UNIV - KENT CAMPUS           ,OH,44242-0001,Public       ,414,753,1167,23610,12678,36288
00305101,KENT STATE UNIV - GEAUGA CAMPUS         ,OH,44021-0000,Public       ,21,59,80,563,872,1435
00305102,KENT STATE UNIV - STARK CAMPUS          ,OH,44720-0000,Public       ,85,253,338,2760,3397,6157
00305103,KENT STATE UNIV - TUSCARAWAS CAMPUS     ,OH,44663-0000,Public       ,34,134,168,1066,1896,2962
00305104,KENT STATE UNIV - TRUMBULL CAMPUS       ,OH,44483-0000,Public       ,72,219,291,1038,2484,3522
00305105,KENT STATE UNIV - ASHTABULA CAMPUS      ,OH,44004-0000,Public       ,59,186,245,968,2249,3217
00305106,KENT STATE UNIV -E.LIVERPOOL CAMPUS     ,OH,43920-0000,Public       ,16,65,81,446,953,1399
00305107,KENT STATE UNIV - SALEM CAMPUS          ,OH,44460-0000,Public       ,40,92,132,937,1381,2318
00306500,KENYON COLLEGE                          ,OH,43022-9623,Private      ,35,2,37,2752,48,2800
00306600,LAKE ERIE COLLEGE                       ,OH,44077-3389,Private      ,28,35,63,1488,497,1985
00306800,LORAIN COUNTY COMMUNITY COLLEGE         ,OH,44035-1691,Public       ,233,870,1103,4081,9294,13375
00306900,LOURDES COLLEGE                         ,OH,43560-2898,Private      ,40,173,213,1090,2460,3550
00307200,MALONE UNIVERSITY                       ,OH,44709-3897,Private      ,26,126,152,2149,1578,3727
00307300,MARIETTA COLLEGE                        ,OH,45750-4033,Private      ,17,19,36,2572,378,2950
00307500,METHODIST THEOLOGICAL SCH IN OHIO       ,OH,43015-0000,Private      ,0,4,4,1,211,212
00307600,MIAMI-JACOBS COLLEGE                    ,OH,45401-0000,Proprietary  ,10,100,110,122,826,948
00307602,MIAMI - JACOBS CAREER COLLEGE - SPRINGBO,OH,45066-1115,Proprietary  ,26,41,67,108,313,421
00307603,MIAMI - JACOBS CAREER COLLEGE - TROY    ,OH,45373-3837,Proprietary  ,16,51,67,170,542,712
00307700,MIAMI UNIVERSITY                        ,OH,45056-1831,Public       ,308,540,848,20480,6591,27071
00307800,WRIGHT STATE UNIVERSITY                 ,OH,45435-0002,Public       ,261,691,952,14612,12081,26693
00308300,UNIVERSITY OF MOUNT UNION               ,OH,44601-3993,Private      ,51,19,70,3459,374,3833
00308400,MUSKINGUM UNIVERSITY                    ,OH,43762-1199,Private      ,18,51,69,2342,777,3119
00308500,NOTRE DAME COLLEGE OF OHIO              ,OH,44121-4293,Private      ,41,84,125,2260,1401,3661
00308600,OBERLIN COLLEGE                         ,OH,44074-1090,Private      ,80,22,102,5125,237,5362
00308800,OHIO COLLEGE OF PODIATRIC MEDICINE      ,OH,44131-7304,Private      ,0,2,2,2,474,476
00308900,OHIO NORTHERN UNIVERSITY                ,OH,45810-1555,Private      ,34,25,59,3804,1142,4946
00309000,OHIO STATE UNIVERSITY-ALL CAMPUSES      ,OH,43210-1358,Public       ,835,1261,2096,50816,27322,78138
00310000,OHIO UNIVERSITY                         ,OH,45701-2979,Public       ,314,867,1181,20602,10569,31171
00310002,"OHIO UNIVERSITY, ZANESVILLE CAMPUS      ",OH,43701-0000,Public       ,31,127,158,1156,1674,2830
00310003,"OHIO UNIVERSITY, LANCASTER CAMPUS       ",OH,43130-0000,Public       ,55,172,227,1350,2087,3437
00310004,"OHIO UNIVERSITY, SOUTHERN CAMPUS        ",OH,45638-0000,Public       ,32,143,175,911,1993,2904
00310005,"OHIO UNIVERSITY, CHILLICOTHE CAMPUS     ",OH,45601-0000,Public       ,55,212,267,1130,2499,3629
00310006,"OHIO UNIVERSITY, EASTERN CAMPUS         ",OH,43950-0000,Public       ,5,26,31,506,355,861
00310008,OHIO UNIV COLL OF OSTEOPATHIC MED       ,OH,45701-0000,Public       ,0,3,3,15,517,532
00310900,OHIO WESLEYAN UNIVERSITY                ,OH,43015-2398,Private      ,30,17,47,2890,196,3086
00311000,OTTERBEIN UNIVERSITY                    ,OH,43081-2006,Private      ,68,70,138,3958,1108,5066
00311300,PONTIFICAL COLLEGE JOSEPHINUM           ,OH,43235-1498,Private      ,0,4,4,34,24,58
00311400,FIRELANDS REGIONAL MEDICAL CENTER - SOUT,OH,44870-4788,Private      ,6,10,16,69,170,239
00311500,RABBINICAL COLLEGE OF TELSHE            ,OH,44092-2584,Private      ,5,11,16,11,16,27
00311600,UNIV OF RIO GRANDE                      ,OH,45674-3131,Private      ,33,189,222,1583,2134,3717
00311900,SINCLAIR COMMUNITY COLLEGE              ,OH,45402-1460,Public       ,588,2499,3087,9133,22796,31929
00312100,TIFFIN UNIVERSITY                       ,OH,44883-2161,Private      ,144,990,1134,3155,7951,11106
00312200,UNITED THEOLOGICAL SEMINARY             ,OH,45406-0000,Private      ,0,38,38,1,483,484
00312300,UNIVERSITY OF AKRON                     ,OH,44325-6211,Public       ,522,1014,1536,21425,16314,37739
00312500,UNIVERSITY OF CINCINNATI                ,OH,45221-0125,Public       ,679,1593,2272,27223,24154,51377
00312504,UNIVERSITY OF CINCINNATI - MEDICINE     ,OH,45267-0553,Public       ,12,45,57,337,1447,1784
00312700,UNIVERSITY OF DAYTON                    ,OH,45469-0002,Private      ,129,208,337,11232,3757,14989
00313100,UNIVERSITY OF TOLEDO                    ,OH,43606-3390,Public       ,377,638,1015,18435,11957,30392
00313300,URBANA UNIVERSITY                       ,OH,43078-2091,Private      ,21,49,70,973,763,1736
00313400,URSULINE COLLEGE                        ,OH,44124-4398,Private      ,17,107,124,654,1470,2124
00313500,WALSH UNIVERSITY                        ,OH,44720-3396,Private      ,30,82,112,2591,1298,3889
00314100,WILBERFORCE UNIVERSITY                  ,OH,45384-1001,Private      ,15,34,49,892,540,1432
00314200,WILMINGTON COLLEGE                      ,OH,45177-2499,Private      ,27,37,64,1738,643,2381
00314300,WITTENBERG UNIVERSITY                   ,OH,45501-2199,Private      ,40,18,58,3575,366,3941
00314400,XAVIER UNIVERSITY                       ,OH,45207-1035,Private      ,92,207,299,7276,3481,10757
00314500,YOUNGSTOWN STATE UNIVERSITY             ,OH,44555-0001,Public       ,252,594,846,9845,8663,18508
00398200,CLEVELAND INSTITUTE OF ART              ,OH,44106-1700,Private      ,17,18,35,976,266,1242
00405401,HEBREW UNION COLLEGE JEWISH INSTITUTE OF,OH,45220-2488,Private      ,0,5,5,2,94,96
00406000,WINEBRENNER THEOLOGICAL SEMINARY        ,OH,45840-0000,Private      ,1,8,9,2,61,63
00485200,CLARK STATE COMMUNITY COLLEGE           ,OH,45505-4795,Public       ,141,832,973,1956,6536,8492
00485300,BRADFORD SCHOOL                         ,OH,43219-0000,Proprietary  ,32,49,81,729,640,1369
00485500,DAVIS COLLEGE                           ,OH,43623-4307,Proprietary  ,14,91,105,129,856,985
00486100,UNIVERSITY OF NORTHWESTERN OHIO         ,OH,45805-1498,Private      ,145,195,340,4406,2250,6656
00486600,STAUTZENBERGER COLLEGE                  ,OH,43537-4007,Proprietary  ,38,171,209,450,1761,2211
00510200,SCH OF DIAGNOSTIC IMAGING-CLEVELAND     ,OH,44119-0000,Private      ,1,5,6,7,61,68
00531300,NORTH CENTRAL STATE COLLEGE             ,OH,44901-0000,Public       ,81,318,399,1376,3387,4763
00575300,OWENS STATE COMMUNITY COLLEGE           ,OH,43699-0000,Public       ,378,1390,1768,6025,13916,19941
00648700,AULTMAN COLLEGE OF NURSING AND HEALTH SC,OH,44710-1799,Private      ,7,28,35,142,490,632
00648900,CHRIST COLLEGE OF NURSING AND HEALTH SCI,OH,45219-2906,Private      ,11,46,57,207,516,723
00649400,GOOD SAMARITAN COLG-NURSING/HEALTH      ,OH,45220-2489,Private      ,10,39,49,203,499,702
00649800,MERIDIA HURON SCHOOL OF NURSING         ,OH,44112-4308,Private      ,0,0,0,13,76,89
00650700,TRINIT HEALTH SYSTEM SCH OF NURSING     ,OH,43952-2667,Private      ,0,6,6,37,126,163
00680400,LAKELAND COMMUNITY COLLEGE              ,OH,44094-5198,Public       ,208,734,942,3245,7281,10526
00686700,COLUMBUS STATE COMMUNITY COLLEGE        ,OH,43215-1786,Public       ,1022,3683,4705,13986,32995,46981
00703500,KETTERING COLLEGE OF MEDICAL ARTS       ,OH,45429-1299,Private      ,21,73,94,596,1084,1680
00708500,MOUNT VERNON NAZARENE UNIVERSITY        ,OH,43050-9500,Private      ,7,63,70,1582,772,2354
00708501,MOUNT VERNON NAZARENE UNIV - AGS        ,OH,43050-0000,Private      ,1,121,122,157,896,1053
00727500,EASTERN GATEWAY COMMUNITY COLLEGE       ,OH,43952-3598,Public       ,42,216,258,900,2099,2999
00732920,ITT TECHNICAL INSTITUTE                 ,OH,45414-3456,Proprietary  ,56,249,305,435,1787,2222
00732992,ITT TECHNICAL INSTITUTE                 ,OH,44509-4098,Proprietary  ,64,191,255,533,1675,2208
00747300,CHOFFIN CAREER & TECHNICAL CENTER       ,OH,44503-1628,Public       ,0,20,20,74,333,407
00759800,HOCKING TECHNICAL COLLEGE               ,OH,45764-9582,Public       ,163,357,520,3853,4454,8307
00777700,REMINGTON COLLEGE - CLEVELAND CAMPUS    ,OH,44125-1957,Private      ,62,295,357,462,2134,2596
00777704,REMINGTON COLLEGE-CLEVELAND WEST CAMPUS ,OH,44070-3129,Private      ,13,64,77,107,447,554
00812900,ADULT AND COMMUNITY EDUCATION @ HUDSON  ,OH,43211-2017,Public       ,5,45,50,47,494,541
00813200,TOLEDO SCHOOL OF PRACTICAL NURSING      ,OH,43613-5110,Public       ,7,39,46,102,419,521
00813300,ZANE STATE COLLEGE                      ,OH,43701-2626,Public       ,91,307,398,1298,2977,4275
00819400,AKRON SCHOOL OF PRACTICAL NRSG          ,OH,44311-0000,Public       ,7,31,38,125,334,459
00827800,TERRA COMMUNITY COLLEGE                 ,OH,43420-9670,Public       ,70,339,409,1015,2914,3929
00867700,NORTHWEST STATE COMMUNITY COLLEGE       ,OH,43502-9542,Public       ,60,246,306,1051,2933,3984
00888600,PORTAGE LAKES CAREER CENTER             ,OH,44685-9554,Public       ,0,3,3,24,136,160
00908803,ITT TECHNICAL INSTITUTE                 ,OH,44136-1758,Proprietary  ,0,1,1,0,1,1
00915600,WAYNE COUNTY SCHOOLS CAREER CENTER      ,OH,44677-9672,Public       ,4,14,18,49,233,282
00917200,SPRINGFIELD REGIONAL SCHOOL OF NURSING  ,OH,45501-0000,Private      ,0,7,7,16,81,97
00941200,FORTIS COLLEGE                          ,OH,44221-2998,Proprietary  ,42,207,249,319,1509,1828
00953000,GERBER AKRON BEAUTY SCHOOL              ,OH,44313-6995,Proprietary  ,1,24,25,31,131,162
00953100,SPA SCHOOL (THE)                        ,OH,43214-1524,Proprietary  ,4,36,40,53,243,296
00966000,TIFFIN ACADEMY OF HAIR DESIGN           ,OH,44883-2833,Proprietary  ,1,12,13,50,99,149
00994100,BELMONT TECHNICAL COLLEGE               ,OH,43950-9766,Public       ,35,161,196,942,2055,2997
00994200,SHAWNEE STATE UNIVERSITY                ,OH,45662-4344,Public       ,115,276,391,4605,2933,7538
01001700,PAYNE THEOLOGICAL SEMINARY              ,OH,45384-0474,Private      ,0,9,9,0,152,152
01002700,JAMES A. RHODES STATE COLLEGE           ,OH,45804-3597,Public       ,90,273,363,1782,3784,5566
01016800,NATIONWIDE BEAUTY ACADEMY               ,OH,43228-1000,Proprietary  ,9,24,33,98,233,331
01028000,OHIO STATE BEAUTY ACADEMY               ,OH,45801-4950,Proprietary  ,13,28,41,92,192,284
01032300,HANNAH E MULLINS SCH-PRAC NRSG          ,OH,44460-2906,Public       ,4,17,21,31,144,175
01034500,CINCINNATI STATE TECH & COMM CLG        ,OH,45223-2690,Public       ,393,1287,1680,5489,13836,19325
01045300,WASHINGTON STATE CMTY COLLEGE           ,OH,45750-9225,Public       ,48,198,246,1026,1801,2827
01063000,NORTHERN INSTITUTE OF COSMETOLOGY       ,OH,44052-1803,Proprietary  ,1,13,14,7,58,65
01073600,MARION TECHNICAL COLLEGE                ,OH,43302-5694,Public       ,51,219,270,909,2474,3383
01088000,CHATFIELD COLLEGE                       ,OH,45118-9705,Private      ,5,40,45,81,443,524
01088100,STARK STATE COLLEGE OF TECHNOLOGY       ,OH,44720-7299,Public       ,295,1365,1660,4258,14273,18531
01090600,CINCINNATI CLG OF MORTUARY SCIENCE      ,OH,45224-1428,Private      ,2,18,20,104,224,328
01092300,UNION INSTITUTE & UNIVERSITY            ,OH,45206-1925,Private      ,3,283,286,38,1957,1995
01099300,HOBART INSTITUTE OF WELDING TECHNOLOGY  ,OH,45373-2400,Private      ,21,47,68,252,285,537
01100500,KAPLAN COLLEGE                          ,OH,43232-4827,Proprietary  ,22,186,208,171,1314,1485
01104600,CENTRAL OHIO TECHNICAL COLLEGE          ,OH,43055-1767,Public       ,89,470,559,1685,5362,7047
01170300,PENTA COUNTY JOINT VOCATIONAL SCH       ,OH,43551-0000,Public       ,2,6,8,18,134,152
01174400,NATIONAL BEAUTY COLLEGE                 ,OH,44720-0000,Proprietary  ,0,23,23,36,164,200
01174500,OHIO TECHNICAL COLLEGE                  ,OH,44103-1228,Proprietary  ,49,114,163,1540,987,2527
01182500,OHIO STATE SCHOOL OF COSMETOLOGY        ,OH,43224-1107,Proprietary  ,1,23,24,59,206,265
01212800,SOUTHWESTERN COLLEGE                    ,OH,45402-3003,Proprietary  ,7,86,93,109,984,1093
01212802,SOUTHWESTERN COLLEGE                    ,OH,45005-2267,Proprietary  ,6,23,29,49,342,391
01212803,SOUTHWESTERN COLLEGE                    ,OH,45202-4304,Proprietary  ,6,71,77,60,702,762
01212804,SOUTHWESTERN COLLEGE                    ,OH,45246-3121,Proprietary  ,16,88,104,153,983,1136
01212806,LINCOLN COLLEGE OF TECHNOLOGY - TOLEDO  ,OH,43615-6800,Proprietary  ,12,68,80,78,673,751
01212807,LINCOLN COLLEGE OF TECHNOLOGY - COLUMBUS,OH,43215-3602,Proprietary  ,1,23,24,15,84,99
01212808,LINCOLN COLLEGE OF TECHNOLOGY - CLEVELAN,OH,44114-3266,Proprietary  ,7,45,52,10,81,91
01216600,CAROUSEL BEAUTY COLLEGE                 ,OH,45402-8935,Proprietary  ,6,38,44,75,244,319
01224800,CENTRAL SCHOOL OF PRACTICAL NURSING     ,OH,44103-4371,Private      ,8,39,47,67,429,496
01267200,CAROUSEL BEAUTY COLLEGE                 ,OH,45044-5113,Proprietary  ,2,1,3,13,35,48
01267400,CAROUSEL OF MIAMI VALLEY BEAUTY CLG     ,OH,45424-2063,Proprietary  ,0,2,2,3,16,19
01275000,EDISON COMMUNITY COLLEGE                ,OH,45356-9239,Public       ,49,256,305,1140,2827,3967
01283800,LAURA AND ALVIN SIEGAL COLLEGE OF JUDAIC,OH,44122-7197,Private      ,0,0,0,2,5,7
01284800,MOLER-HOLLYWOOD BEAUTY COLLEGE          ,OH,45202-2577,Proprietary  ,1,19,20,21,108,129
01287000,SOUTHERN STATE COMMUNITY COLLEGE        ,OH,45133-9406,Public       ,63,255,318,1272,3244,4516
01289100,ANTONELLI COLLEGE                       ,OH,45202-2592,Proprietary  ,5,96,101,170,586,756
01289600,VIRGINIA MARTI COLLEGE OF ART AND DESIGN,OH,44107-0778,Proprietary  ,17,28,45,181,218,399
01313200,INTERNATIONAL CLG OF BROADCASTING       ,OH,45431-1898,Proprietary  ,4,10,14,48,120,168
02052000,KAPLAN COLLEGE                          ,OH,45439-1984,Proprietary  ,18,163,181,209,1149,1358
02054300,TRUMBULL BUSINESS COLLEGE               ,OH,44484-0000,Proprietary  ,6,42,48,39,484,523
02056800,DAYMAR COLLEGE                          ,OH,45601-1038,Proprietary  ,10,36,46,64,505,569
02056802,DAYMAR COLLEGE - LANCASTER              ,OH,43130-0000,Proprietary  ,1,30,31,30,272,302
02056803,DAYMAR COLLEGE - NEW BOSTON             ,OH,45662-4900,Proprietary  ,3,31,34,37,300,337
02056804,DAYMAR COLLEGE - JACKSON                ,OH,45640-1728,Proprietary  ,8,52,60,39,307,346
02066100,OHIO STATE COLLEGE/BARBER STYLING       ,OH,43213-0000,Proprietary  ,13,41,54,75,224,299
02073300,GALLIA-JACKSON-VINTON SCH ADULT ED      ,OH,45674-0000,Public       ,4,15,19,62,241,303
02110700,CLEVELAND INST OF DENTAL-MED ASST       ,OH,44115-2285,Proprietary  ,11,98,109,122,559,681
02116009,SANFORD-BROWN COLLEGE - MIDDLEBURG HEIGH,OH,44130-8362,Proprietary  ,13,112,125,237,1252,1489
02116900,UPPER VALLEY JVS                        ,OH,45356-0000,Public       ,2,13,15,23,220,243
02117300,GREAT OAKS INSTITUTE OF TECHNOLOGY      ,OH,45241-1581,Public       ,8,66,74,192,802,994
02128600,THE ART INSTITUTE OF CINCINNATI         ,OH,45246-0000,Proprietary  ,20,32,52,405,270,675
02140700,COMMUNITY EDUCATIONAL SERVICES          ,OH,44702-1710,Public       ,0,14,14,22,240,262
02152100,ACADEMY OF COURT REPORTING AND TECHNOLOG,OH,44115-0000,Proprietary  ,2,42,44,60,505,565
02152101,ACADEMY OF COURT REPORTING & TECHNOLOGY ,OH,43215-3902,Proprietary  ,6,44,50,96,540,636
02152106,ACADEMY OF COURT REPORTING AND TECHNOLOG,OH,45241-5428,Proprietary  ,4,21,25,40,204,244
02158500,OHIO BUSINESS COLLEGE                   ,OH,44035-0701,Proprietary  ,16,72,88,109,726,835
02158501,OHIO BUSINESS COLLEGE                   ,OH,44870-9953,Proprietary  ,5,70,75,75,635,710
02168100,TRI-COUNTY JOINT VOCATIONAL SCHOOL      ,OH,45764-0000,Public       ,6,33,39,38,174,212
02187900,ASHTABULA CO JOINT VOC SCH ADULT ED     ,OH,44047-0000,Public       ,2,22,24,38,225,263
02189000,ADULT CENTER FOR EDUCATION              ,OH,43701-0000,Public       ,4,36,40,82,429,511
02190700,FORTIS COLLEGE                          ,OH,45459-0000,Proprietary  ,71,488,559,473,3777,4250
02192100,BUTLER TECHNOLOGY AND CAREER DEVELOPMENT,OH,45011-0000,Public       ,24,96,120,209,758,967
02196300,COLLINS CAREER CENTER                   ,OH,45619-0000,Public       ,13,63,76,190,687,877
02210800,MEDINA COUNTY CAREER CENTER             ,OH,44256-0000,Public       ,4,14,18,42,148,190
02215400,OHIO STATE SCHOOL OF COSMETOLOGY        ,OH,43207-0000,Proprietary  ,7,19,26,86,207,293
02220500,GOD'S BIBLE SCHOOL & COLLEGE            ,OH,45210-0000,Private      ,4,9,13,187,85,272
02220800,CAREER & TECHNOLOGY EDUCATION CENTERS OF,OH,43055-0000,Public       ,10,51,61,58,337,395
02239800,PIONEER CAREER & TECHNOLOGY CENTER      ,OH,44875-0000,Public       ,1,11,12,8,94,102
02245600,WARREN COUNTY CAREER CENTER             ,OH,45036-0000,Public       ,13,57,70,79,372,451
02246300,INSTITUTE OF MEDICAL-DENTAL TECH        ,OH,45246-3317,Proprietary  ,15,28,43,43,188,231
02263700,MIAMI VALLEY CAREER TECHNOLOGY CTR      ,OH,45315-0000,Public       ,8,77,85,103,513,616
02269400,EASTERN HILLS ACAD OF HAIR DESIGN       ,OH,45255-0000,Proprietary  ,6,12,18,27,108,135
02269500,WESTERN HILLS SCHOOL OF BEAUTY & HAIR DE,OH,45211-0000,Proprietary  ,9,54,63,54,279,333
02270100,OHIO HI-POINT CAREER CENTER             ,OH,43311-0000,Public       ,5,24,29,47,286,333
02272700,COLUMBIANA COUNTY CAREER CENTER         ,OH,44432-0000,Public       ,4,29,33,41,279,320
02287900,RAPHAEL'S SCHOOL OF BEAUTY CULTURE      ,OH,44446-0000,Proprietary  ,6,39,45,60,190,250
02289802,KAPLAN COLLEGE                          ,OH,45203-0000,Proprietary  ,15,136,151,121,858,979
02301400,OHIO VALLEY COLLEGE OF TECHNOLOGY       ,OH,43920-9139,Proprietary  ,5,19,24,130,240,370
02303600,FORTIS COLLEGE - RAVENNA CAMPUS         ,OH,44266-0000,Proprietary  ,14,61,75,128,560,688
02304700,TRI-RIVERS CAREER CENTER                ,OH,43302-0000,Public       ,3,27,30,43,262,305
02311200,AMERICAN SCHOOL OF TECHNOLOGY           ,OH,43229-0000,Proprietary  ,15,91,106,71,621,692
02315500,TOLEDO ACADEMY OF BEAUTY CULTURE - EAST ,OH,43616-0000,Proprietary  ,6,18,24,32,148,180
02324400,ALLSTATE HAIRSTYLING & BARBER CLG       ,OH,44113-0000,Proprietary  ,7,48,55,72,343,415
02328500,MOLER-PICKENS BEAUTY COLLEGE            ,OH,45014-0000,Proprietary  ,1,19,20,14,87,101
02334300,INTERNATIONAL ACAD OF HAIR DESIGN       ,OH,45239-0000,Proprietary  ,8,25,33,95,197,292
02336300,KNOX COUNTY CAREER CENTER               ,OH,43050-4298,Public       ,8,23,31,63,340,403
02336700,CUYAHOGA VALLEY CAREER CENTER           ,OH,44141-1296,Public       ,2,14,16,54,279,333
02337700,PROFESSIONAL SKILLS INSTITUTE           ,OH,43607-0000,Proprietary  ,5,46,51,118,789,907
02351500,WILLOUGHBY EASTLAKE SCH OF PRAC NSG     ,OH,44094-0000,Public       ,5,15,20,17,108,125
02352800,POLARIS CAREER CENTER-ADULT ED DEPT     ,OH,44130-0000,Public       ,9,50,59,103,416,519
02354200,SCIOTO COUNTY JOINT VOCATIONAL SCH      ,OH,45648-0000,Public       ,7,35,42,81,326,407
02454400,NORTHEASTERN OHIO UNIVS COL OF MED      ,OH,44272-0000,Public       ,3,3,6,129,833,962
02497800,GREENE COUNTY CAREER CENTER             ,OH,45385-0000,Public       ,4,25,29,25,188,213
02512600,ADULT VOCATIONAL SERVICES               ,OH,44308-0000,Public       ,1,21,22,13,98,111
02519300,OHIO STATE SCH COSMETOLOGY              ,OH,43110-2754,Proprietary  ,7,26,33,83,209,292
02522700,EASTLAND-FAIRFIELD CAREER AND TECHNICAL ,OH,43125-0000,Public       ,2,30,32,38,288,326
02528300,TDDS TECHNICAL INSTITUTE                ,OH,44429-0000,Proprietary  ,23,179,202,99,696,795
02529500,HAMRICK SCHOOL                          ,OH,44256-0000,Proprietary  ,6,55,61,14,221,235
02541400,TOLEDO ACADEMY OF BEAUTY CULTURE-SO     ,OH,43614-0000,Proprietary  ,5,27,32,53,219,272
02545800,INNER STATE BEAUTY SCHOOLS              ,OH,44124-0000,Proprietary  ,7,31,38,59,232,291
02553000,SCHOOL OF ADVERTISING ART               ,OH,45440-0000,Proprietary  ,2,7,9,192,36,228
02560000,CASAL AVEDA INSTITUTE                   ,OH,44515-0000,Proprietary  ,10,18,28,89,149,238
02560700,PICKAWAY ROSS CO JOINT VOC TECH SCH     ,OH,45601-0000,Public       ,6,32,38,77,370,447
02560701,PICKAWAY ROSS COUNTY JOINT VOCATIONAL SC,OH,45601-9010,Public       ,1,19,20,27,116,143
02562300,APOLLO CAREER CENTER-ADULT EDUC         ,OH,45806-0000,Public       ,11,75,86,81,582,663
02563000,RAPHAELS SCHOOL OF BEAUTY CULTURE       ,OH,44601-2847,Proprietary  ,6,21,27,34,125,159
02568600,MAHONING COUNTY CAREER & TECH CENTR     ,OH,44406-0000,Public       ,0,14,14,14,81,95
02582900,KAPLAN CAREER INSTITUTE                 ,OH,44129-6810,Proprietary  ,15,87,102,87,602,689
02586400,TRUMBULL CAREER & TECH CENTER-ADULT     ,OH,44483-1997,Public       ,8,41,49,60,314,374
02588500,OHIO STATE SCHOOL OF COSMETOLOGY        ,OH,43081-0000,Proprietary  ,8,27,35,108,217,325
02599711,VATTEROTT COLLEGE - CLEVELAND           ,OH,44147-3502,Proprietary  ,4,67,71,50,478,528
02603800,LORAIN COUNTY JVS ADULT CAREER CTR      ,OH,44074-9799,Public       ,4,27,31,80,292,372
02611007,HERITAGE COLLEGE - COLUMBUS             ,OH,43213-4440,Proprietary  ,17,99,116,54,357,411
02620000,SANDUSKY CAREER CENTER                  ,OH,44870-4786,Public       ,5,28,33,29,172,201
03007900,GALLIPOLIS CAREER COLLEGE               ,OH,45631-2600,Proprietary  ,6,22,28,24,236,260
03009702,"HARRISON COLLEGE - MUNCIE - COLUMBUS, OH",OH,43123-0000,Proprietary  ,22,46,68,97,339,436
03015100,ALLIANCE HIGH SCH-CMTY SERVICES DIV     ,OH,44601-2899,Public       ,4,18,22,30,113,143
03015300,EHOVE CAREER CENTER                     ,OH,44846-9500,Public       ,5,47,52,82,478,560
03023700,MADISON ADULT CAREER CENTER             ,OH,44905-2718,Public       ,4,29,33,31,269,300
03024300,VALLEY BEAUTY SCHOOL                    ,OH,43725-2332,Proprietary  ,2,1,3,40,92,132
03027100,FAIRVIEW ACADEMY                        ,OH,44126-2214,Proprietary  ,0,9,9,7,64,71
03034200,WASHINGTON COUNTY CAREER CENTER ADULT TE,OH,45750-9290,Public       ,8,49,57,74,437,511
03051400,AUBURN CAREER CENTER                    ,OH,44077-9723,Public       ,1,29,30,31,148,179
03051500,US GRANT JOINT VOCATIONAL SCHOOL        ,OH,45106-9502,Public       ,0,1,1,2,27,29
03065900,BUCKEYE CAREER CENTER                   ,OH,44663-9437,Public       ,2,17,19,74,247,321
03067600,RAPHAEL'S SCHOOL OF BEAUTY CULTURE      ,OH,44512-2222,Proprietary  ,5,20,25,27,90,117
03068200,OHIO CENTER FOR BROADCASTING            ,OH,44125-6273,Proprietary  ,2,45,47,65,254,319
03068202,OHIO CENTER FOR BROADCASTING - COLUMBUS ,OH,43213-2571,Proprietary  ,4,33,37,74,229,303
03071900,MOUNT CARMEL COLLEGE OF NURSING         ,OH,43222-1598,Private      ,14,116,130,789,984,1773
03072303,EVEREST INSTITUTE - COLUMBUS            ,OH,43230-6653,Proprietary  ,21,136,157,131,828,959
03078000,OHIO CENTER FOR BROADCASTING            ,OH,45227-1509,Proprietary  ,6,20,26,31,114,145
03079000,ETI TECHNICAL COLLEGE                   ,OH,44446-4398,Proprietary  ,4,36,40,94,337,431
03084800,DELAWARE AREA CAREER CENTER             ,OH,43015-8969,Public       ,0,7,7,8,53,61
03084801,DELAWARE AREA CAREER CENTER -           ,OH,43015-9001,Public       ,0,4,4,2,29,31
03095600,VANTAGE CAREER CENTER                   ,OH,45891-1378,Public       ,2,11,13,28,135,163
03097000,MERCY COLLEGE OF NORTHWEST OHIO         ,OH,43604-1132,Private      ,14,96,110,548,1401,1949
03100100,PARAMOUNT BEAUTY ACADEMY                ,OH,45662-4136,Proprietary  ,6,24,30,46,141,187
03116200,DAYTON BARBER COLLEGE                   ,OH,45342-0000,Proprietary  ,2,19,21,23,115,138
03116300,OHIO COLLEGE OF MASSOTHERAPY            ,OH,44321-1363,Private      ,5,26,31,39,205,244
03116400,VANGUARD-SENTINELL VOC SCH DISTRICT     ,OH,43420-1197,Public       ,0,4,4,7,61,68
03117000,ASHLAND COUNTY-W HOLMES CAREER CTR      ,OH,44805-0000,Public       ,2,22,24,34,174,208
03319300,CREATIVE IMAGES-A CERTIFIED MATRIX      ,OH,45414-2557,Proprietary  ,9,43,52,75,238,313
03319301,CREATIVE IMAGES-A CERTIFIED MATRIX      ,OH,45459-0000,Proprietary  ,1,26,27,66,202,268
03416400,VALLEY BEAUTY SCHOOL                    ,OH,43701-3624,Proprietary  ,2,7,9,15,70,85
03425300,ROSEDALE BIBLE COLLEGE                  ,OH,43029-9517,Private      ,1,2,3,58,15,73
03457300,ALLEGHENY WESLEYAN COLLEGE              ,OH,44460-9598,Private      ,1,6,7,34,35,69
03468400,NATIONAL INSTITUTE OF MASSOTHERAPY      ,OH,44319-2100,Proprietary  ,1,17,18,15,107,122
03468500,ATS INSTITUTE OF TECHNOLOGY             ,OH,44143-2216,Proprietary  ,4,153,157,42,820,862
03475400,TRI-STATE BIBLE COLLEGE                 ,OH,45680-8402,Private      ,0,7,7,9,63,72
03534400,AMERICAN INST OF ALTERNATIVE MEDICI     ,OH,43229-1113,Proprietary  ,7,77,84,56,552,608
03626300,BROWN AVEDA INSTITUTE                   ,OH,44060-6212,Proprietary  ,23,53,76,198,311,509
03693300,CARNEGIE CAREER COLLEGE                 ,OH,44260-9608,Private      ,0,33,33,26,450,476
03700300,REGENCY BEAUTY INSTITUTE - CLEVELAND    ,OH,44094-0000,Proprietary  ,10,40,50,98,295,393
03726300,TEMPLE BAPTIST COLLEGE                  ,OH,45240-0000,Private      ,7,7,14,67,74,141
03747300,BEXLEY HALL SEMINARY                    ,OH,43209-2325,Private      ,0,2,2,0,30,30
03776400,HEALING ARTS INSTITUTE                  ,OH,43551-3138,Proprietary  ,0,6,6,14,62,76
03837300,AVEDA FREDRIC'S INSTITUTE               ,OH,45208-1304,Proprietary  ,17,38,55,174,304,478
03882300,OREGON CAREER CENTER                    ,OH,43616-2631,Public       ,2,16,18,11,67,78
04050400,DESIGNER'S BEAUTY ACADEMY               ,OH,43920-0000,Proprietary  ,0,0,0,5,7,12
04051307,ART INSTITUTE OF PHOENIX (THE) - BROWN M,OH,45215-1107,Proprietary  ,76,362,438,568,2759,3327
04051308,ART INSTITUTE OF PHOENIX (THE) - BROWN M,OH,44320-4420,Proprietary  ,21,122,143,63,315,378
04051317,ART INSTITUTE OF PHOENIX (THE) - BROWN M,OH,45840-6848,Proprietary  ,125,360,485,562,2463,3025
04051326,ART INSTITUTE OF PHOENIX (THE) - BROWN M,OH,44718-3674,Proprietary  ,16,137,153,76,438,514
04068300,FOUR COUNTY CAREER CENTER               ,OH,43512-9541,Public       ,1,3,4,12,72,84
04074300,HONDROS COLLEGE                         ,OH,43081-3855,Proprietary  ,37,305,342,310,2270,2580
04116700,NEWLIFE TECHNICAL INSTITUTE             ,OH,43920-2920,Private      ,0,3,3,6,19,25
04117300,DAYTON SCHOOL OF MEDICAL MASSAGE        ,OH,45429-1111,Proprietary  ,32,121,153,180,630,810
04118300,NORTHCOAST MEDICAL TRAINING ACADEMY     ,OH,44240-4174,Proprietary  ,13,36,49,79,250,329
04124500,TECHSKILLS                              ,OH,43231-0000,Proprietary  ,2,24,26,21,237,258
04125700,CUT BEAUTY SCHOOL (THE)                 ,OH,44118-2918,Proprietary  ,4,39,43,52,257,309
04126000,OHIO ACADEMY PAUL MITCHELL PARTNER SCHOO,OH,44087-3107,Proprietary  ,15,29,44,106,170,276
04137800,AVEDA INSTITUTE COLUMBUS                ,OH,43201-2333,Proprietary  ,25,47,72,185,312,497
04138000,INSTITUTE OF THERAPEUTIC MASSAGE        ,OH,45875-0350,Proprietary  ,2,13,15,21,67,88
04140100,CISORIA ACADEMY OF COSMETOLOGY          ,OH,44137-2915,Proprietary  ,0,0,0,23,78,101
04149100,CINCINNATI ACADEMY A PAUL MITCHELL PARTN,OH,45241-1702,Proprietary  ,26,38,64,150,235,385
04151400,VANITY SCHOOL OF COSMETOLOGY            ,OH,44035-0000,Proprietary  ,3,5,8,19,36,55
04152100,TOLEDO RESTAURANT TRAINING CENTER       ,OH,43604-6508,Private      ,0,14,14,5,62,67
04152600,PIKE COUNTY CAREER TECHNOLOGY CENTER    ,OH,45661-9114,Public       ,5,17,22,20,121,141
04153300,OHIO ACADEMY COLUMBUS (THE)             ,OH,43231-6038,Proprietary  ,18,28,46,104,165,269
04154000,TOLLES CAREER & TECHNICAL CENTER        ,OH,43064-8854,Public       ,0,2,2,11,41,52
04166800,SALON PROFESSIONAL ACADEMY (THE)        ,OH,45551-0000,Proprietary  ,4,10,14,58,108,166
04167700,ARTISAN COLLEGE OF COSMETOLOGY (THE)    ,OH,45840-6848,Proprietary  ,4,7,11,31,68,99
04185900,ELITE SCHOOL OF COSMETOLOGY             ,OH,44857-2714,Proprietary  ,0,8,8,8,37,45
04189100,TONI & GUY HAIRDRESSING ACADEMY         ,OH,43615-1731,Proprietary  ,10,18,28,38,51,89
04192200,ATHENA CAREER ACADEMY                   ,OH,43560-2796,Proprietary  ,4,23,27,11,44,55
        ,INVALID SCHOOL CODE                     ,  ,00000-0000,,321,1650,1971,3481,8411,11892
00134500,ADAMS STATE COLLEGE                     ,CO,81102-2373,Public       ,73,301,374,2741,2517,5258
00134600,ARAPAHOE COMMUNITY COLLEGE              ,CO,80160-9002,Public       ,269,1054,1323,2885,7714,10599
00134700,COLORADO COLLEGE                        ,CO,80903-3294,Private      ,91,117,208,3003,766,3769
00134800,COLORADO SCHOOL OF MINES                ,CO,80401-1887,Public       ,95,102,197,5743,1393,7136
00134900,UNIVERSITY OF NORTHERN COLORADO         ,CO,80639-0001,Public       ,244,306,550,10761,5288,16049
00135000,COLORADO STATE UNIVERSITY               ,CO,80523-0100,Public       ,602,920,1522,23885,12354,36239
00135200,DENVER  SEMINARY                        ,CO,80120-2192,Private      ,0,57,57,2,768,770
00135300,FORT LEWIS COLLEGE                      ,CO,81301-3999,Public       ,158,142,300,4075,1671,5746
00135400,ILIFF SCHOOL OF THEOLOGY                ,CO,80210-0000,Private      ,1,19,20,4,351,355
00135500,LAMAR COMMUNITY COLLEGE                 ,CO,81052-3999,Public       ,12,42,54,384,387,771
00135800,MESA STATE COLLEGE                      ,CO,81501-3122,Public       ,276,391,667,6615,4436,11051
00135900,COLORADO NORTHWESTERN COMMUNITY COLLEGE ,CO,81648-3598,Public       ,27,67,94,379,513,892
00136000,METROPOLITAN STATE CLG OF DENVER        ,CO,80204-0000,Public       ,673,1771,2444,11938,18689,30627
00136100,NORTHEASTERN JUNIOR COLLEGE             ,CO,80751-2399,Public       ,52,65,117,1389,671,2060
00136200,OTERO JUNIOR COLLEGE                    ,CO,81050-3346,Public       ,31,91,122,671,916,1587
00136300,REGIS UNIVERSITY                        ,CO,80221-1099,Private      ,66,839,905,3162,9908,13070
00136500,COLORADO STATE UNIVERSITY-PUEBLO        ,CO,81001-4901,Public       ,153,477,630,5140,5295,10435
00136800,TRINIDAD STATE JR COLLEGE               ,CO,81082-2396,Public       ,46,166,212,681,1299,1980
00137000,UNIVERSITY OF COLORADO-BOULDER          ,CO,80309-0077,Public       ,635,514,1149,23772,10355,34127
00137100,UNIVERSITY OF DENVER                    ,CO,80208-2000,Private      ,167,506,673,7663,9864,17527
00137200,WESTERN STATE COLLEGE                   ,CO,81231-0000,Public       ,63,37,100,2106,668,2774
00405702,NATIONAL AMERICAN UNIVERSITY - COLORADO ,CO,80920-4001,Proprietary  ,4,44,48,29,331,360
00405703,NATIONAL AMERICAN UNIVERSITY            ,CO,80222-0000,Proprietary  ,6,43,49,39,313,352
00450300,EVEREST COLLEGE                         ,CO,80916-3548,Proprietary  ,20,181,201,151,1075,1226
00450600,COLORADO MOUNTAIN COLLEGE               ,CO,81602-0000,Public       ,108,247,355,1569,1908,3477
00450700,EVEREST COLLEGE                         ,CO,80229-4339,Proprietary  ,16,112,128,128,685,813
00450701,"EVEREST COLLEGE- EVEREST COLLEGE, AURORA",CO,80012-5692,Proprietary  ,18,108,126,144,735,879
00450800,UNIVERSITY OF COLORADO DENVER           ,CO,80204-2029,Public       ,281,1065,1346,7340,15486,22826
00450900,UNIV OF COLORADO AT COLO SPRINGS        ,CO,80918-3735,Public       ,208,480,688,6452,5640,12092
00559600,EMILY GRIFFITH OPPORTUNITY SCH          ,CO,80204-2197,Public       ,59,447,506,537,2422,2959
00729700,REDSTONE COLLEGE                        ,CO,80020-9988,Proprietary  ,36,152,188,344,1148,1492
00732912,ITT TECHNICAL INSTITUTE                 ,CO,80229-5338,Proprietary  ,73,261,334,366,1602,1968
00754700,LINCOLN COLLEGE OF TECHNOLOGY           ,CO,80223-0000,Proprietary  ,121,192,313,958,1082,2040
00754800,WESTWOOD COLLEGE - DENVER NORTH         ,CO,80221-3653,Proprietary  ,50,171,221,391,1541,1932
00754801,WESTWOOD COLLEGE - DENVER SOUTH         ,CO,80227-3653,Proprietary  ,18,103,121,147,816,963
00758200,AIMS COMMUNITY COLLEGE                  ,CO,80632-0000,Public       ,182,574,756,2418,4358,6776
00764900,ROCKY MOUNTAIN COLG OF ART & DESIGN     ,CO,80214-0000,Proprietary  ,41,65,106,893,535,1428
00793300,FRONT RANGE COMMUNITY COLLEGE           ,CO,80031-2199,Public       ,697,1912,2609,7707,15389,23096
00863500,INTELLITEC MEDICAL INSTITUTE            ,CO,80909-1570,Proprietary  ,19,84,103,112,649,761
00887100,CONCORDE CAREER INSTITUTE               ,CO,80203-0000,Proprietary  ,44,231,275,261,1229,1490
00889600,PIKES PEAK COMMUNITY COLLEGE            ,CO,80906-5498,Public       ,451,1886,2337,4955,13906,18861
00940100,COLORADO CHRISTIAN UNIVERSITY           ,CO,80226-7449,Private      ,72,468,540,1806,3466,5272
00954200,COMMUNITY COLLEGE OF DENVER             ,CO,80217-2026,Public       ,476,1747,2223,5466,13576,19042
00954300,RED ROCKS COMMUNITY COLLEGE             ,CO,80228-1255,Public       ,258,897,1155,3073,7154,10227
00998100,MORGAN COMMUNITY COLLEGE                ,CO,80701-4399,Public       ,26,116,142,347,1024,1371
01014800,COLORADO TECHNICAL UNIVERSITY           ,CO,80907-3896,Proprietary  ,73,1146,1219,519,8882,9401
01014802,COLORADO TECHNICAL UNIV - DENVER        ,CO,80111-3201,Proprietary  ,14,142,156,88,1030,1118
01014805,COLORADO TECH UNIV - ON LINE            ,CO,80907-0000,Proprietary  ,301,5787,6088,1586,38888,40474
01014806,COLORADO TECH UNIV - FED EXPRESS        ,CO,80921-3800,Proprietary  ,6,26,32,15,122,137
01014808,COLORADO TECH UNIV - USAA               ,CO,80920-1005,Proprietary  ,1,22,23,11,114,125
01014811,COLORADO TECH UNIV-HEWLETT PACKARD      ,CO,80919-2303,Proprietary  ,1,8,9,4,35,39
01014812,COLORADO TECHNICAL UNIVERSITY - WESTMINS,CO,80021-3498,Proprietary  ,21,172,193,123,1352,1475
01014813,COLORADO TECH UNIV - ORACLE             ,CO,80921-3660,Proprietary  ,2,11,13,5,66,71
01014815,COLORADO TECHNCL UNIV PUEBLO            ,CO,81003-2315,Proprietary  ,7,45,52,60,527,587
01070900,EMPIRE BEAUTY SCHOOL-LAKEWOOD           ,CO,80215-0000,Proprietary  ,5,17,22,43,134,177
01073200,SAN JUAN BASIN TECHNICAL COLLEGE        ,CO,81328-9196,Public       ,0,0,0,2,8,10
01157200,COLORADO SCHOOL OF TRADES               ,CO,80215-2996,Proprietary  ,6,76,82,70,433,503
01267000,BEL-REA INST OF ANIMAL TECH             ,CO,80247-3048,Proprietary  ,43,79,122,506,913,1419
01285000,INTERNATIONAL SALON AND SPA ACADEMY     ,CO,80918-3684,Proprietary  ,13,63,76,92,284,376
01287500,PICKENS TECHNICAL COLLEGE               ,CO,80011-9307,Public       ,36,151,187,343,950,1293
01300700,NAZARENE BIBLE COLLEGE                  ,CO,80910-3717,Private      ,3,68,71,54,679,733
02072200,EMPIRE BEAUTY SCHOOL -ARVADA            ,CO,80212-0000,Proprietary  ,11,23,34,63,204,267
02078900,ART INSTITUTE OF COLORADO (THE)         ,CO,80203-2983,Proprietary  ,158,253,411,1669,2336,4005
02116300,PUEBLO COMMUNITY COLLEGE                ,CO,81004-0000,Public       ,191,971,1162,2129,6916,9045
02117500,NAROPA UNIVERSITY                       ,CO,80302-0000,Private      ,28,64,92,366,1407,1773
02133100,COLORADO CENTER FOR MEDICAL LABORATORY S,CO,80218-0000,Private      ,2,13,15,11,89,100
02141100,EMPIRE BEAUTY SCHOOL-LITTLETON          ,CO,80030-0000,Proprietary  ,14,37,51,102,253,355
02156200,DELTA - MONTROSE TECHNICAL COLLEGE      ,CO,81416-0000,Public       ,10,41,51,101,291,392
02160600,EMPIRE BEAUTY SCHOOL -THORNTON          ,CO,80241-1659,Proprietary  ,9,23,32,69,160,229
02165200,SALON PROFESSIONAL ACADEMY (THE)        ,CO,81504-5309,Proprietary  ,15,16,31,53,92,145
02167600,KAPLAN COLLEGE                          ,CO,80229-5309,Proprietary  ,8,71,79,106,633,739
02171300,TRINIDAD STATE JUNIOR COLLEGE           ,CO,81101-0000,Proprietary  ,0,0,0,0,4,4
02188700,DENVER ACAD OF COURT REPORTING          ,CO,80030-0000,Proprietary  ,2,18,20,27,216,243
02211901,CHEEKS INTERNATIONAL ACADEMY OF BEAUTY C,CO,80525-3053,Proprietary  ,3,13,16,25,56,81
02211902,CHEEKS INTERNATIONAL ACDMY BTY CULT     ,CO,80631-0000,Proprietary  ,0,7,7,14,48,62
02253700,INTELLITEC COLLEGE                      ,CO,80909-0000,Proprietary  ,44,231,275,129,675,804
02267500,GLENWOOD BEAUTY ACADEMY                 ,CO,81601-0000,Proprietary  ,1,9,10,14,42,56
02276900,COMMUNITY COLLEGE OF AURORA             ,CO,80011-9036,Public       ,259,1055,1314,2636,7711,10347
02518500,HAIR DYNAMICS EDUCATION CENTER          ,CO,80525-0000,Proprietary  ,21,24,45,115,172,287
02594300,COLLEGE AMERICA - DENVER                ,CO,80222-3380,Proprietary  ,55,507,562,476,3042,3518
02611000,HERITAGE COLLEGE                        ,CO,80212-7413,Proprietary  ,45,157,202,304,963,1267
03006300,INST OF BUSINESS & MEDICAL CAREERS      ,CO,80525-3044,Proprietary  ,30,173,203,328,1412,1740
03010622,VIRGINIA COLLEGE - ECOTECH INSTITUTE - A,CO,80014-1405,Proprietary  ,6,46,52,118,533,651
03012100,REMINGTON COLLEGE - COLORADO SPRINGS CAM,CO,80215-0000,Private      ,3,27,30,39,228,267
03013100,BOULDER COLLEGE OF MASSAGE THERAPY      ,CO,80301-3295,Private      ,7,42,49,86,252,338
03014900,PLATT COLLEGE                           ,CO,80014-3141,Proprietary  ,4,35,39,40,274,314
03027400,XENON INTERNATIONAL ACADEMY III         ,CO,80014-1193,Proprietary  ,15,15,30,64,143,207
03030606,UTAH COLLEGE OF MASSAGE THERAPY - DENVER,CO,80031-2921,Proprietary  ,25,46,71,110,230,340
03030607,UTAH COLLEGE OF MASSAGE THERAPY - DENVER,CO,80012-2523,Proprietary  ,22,41,63,107,249,356
03066900,INTELLITEC COLLEGE                      ,CO,81506-3994,Proprietary  ,31,163,194,179,813,992
03068201,OHIO CENTER FOR BROADCASTING - COLORADO ,CO,80214-4129,Proprietary  ,11,39,50,54,208,262
03076401,BRYMAN SCHOOL OF ARIZONA (THE) - ANTHEM ,CO,80014-2622,Proprietary  ,2,5,7,12,44,56
03289300,COLORADO HEIGHTS UNIVERSITY             ,CO,80236-2711,Private      ,14,74,88,64,278,342
03306300,MONTESSORI EDUC CRT OF THE ROCKIES      ,CO,80301-2587,Private      ,0,3,3,4,47,51
03534300,JONES INTERNATIONAL UNIVERSITY          ,CO,80112-3446,Proprietary  ,55,1428,1483,346,8403,8749
03545300,UNIVERSITY OF THE ROCKIES               ,CO,80903-3612,Proprietary  ,3,410,413,31,2518,2549
03584400,COLORADO SCHOOL OF HEALING ARTS         ,CO,80226-4332,Proprietary  ,12,41,53,80,273,353
03670300,TONI & GUY HAIRDRESSING ACADEMY         ,CO,80911-1713,Proprietary  ,13,32,45,103,200,303
03686300,COLORADO SCHOOL OF TRADITIONAL CHINESE M,CO,80206-2127,Proprietary  ,0,24,24,7,207,214
03776300,CULINARY SCHOOL OF THE ROCKIES          ,CO,80305-5961,Proprietary  ,15,66,81,135,315,450
03972300,CUTTIN' UP BEAUTY ACADEMY               ,CO,80220-0000,Proprietary  ,2,24,26,28,113,141
03976300,MASSAGE THERAPY INSTITUTE OF COLORADO   ,CO,80206-2127,Proprietary  ,3,30,33,50,153,203
04080300,ASPEN UNIVERSITY                        ,CO,80246-1930,Proprietary  ,6,77,83,49,366,415
04093300,ACADEMY OF NATURAL THERAPY              ,CO,80631-3425,Proprietary  ,6,20,26,42,108,150
04121200,INSTITUTE OF TAOIST EDUCATION AND ACUPUN,CO,80027-1028,Private      ,0,1,1,0,49,49
04125100,MONTESSORI CASA INTERNATIONAL           ,CO,80111-5263,Private      ,0,1,1,1,14,15
04127700,AMERICAN SENTINEL UNIVERSITY            ,CO,80014-6510,Proprietary  ,2,181,183,16,846,862
04139300,NATIONAL BEAUTY COLLEGE                 ,CO,80221-0000,Proprietary  ,3,16,19,44,130,174
04140400,ACADEMY OF MEDICAL & HEALTH SCIENCE     ,CO,81005-2195,Proprietary  ,0,0,0,28,77,105
04148300,DENVER SCHOOL OF NURSING                ,CO,80202-1213,Proprietary  ,24,124,148,215,1114,1329
04151100,SUMMIT SALON & BEAUTY SCHOOL            ,CO,80866-4569,Proprietary  ,0,4,4,3,24,27
04167100,AVEDA INSTITUTE DENVER                  ,CO,80202-0000,Proprietary  ,29,75,104,227,438,665
04170200,PAUL MITCHELL THE SCHOOL COLORADO SPRING,CO,80903-0000,Proprietary  ,33,47,80,176,327,503
04172500,ROLF INSTITUTE OF STRUCTURAL INTEGRATION,CO,80301-0000,Private      ,0,17,17,4,98,102
04173800,SALON PROFESSIONAL ACADEMY (THE)        ,CO,80918-2932,Proprietary  ,8,19,27,64,163,227
04177100,PIMA MEDICAL INSTITUTE-SOUTH DENVER     ,CO,80231-0000,Proprietary  ,5,58,63,112,463,575
04179700,UNITED BEAUTY COLLEGE                   ,CO,80223-2936,Proprietary  ,4,21,25,15,77,92
04183700,HEALING ARTS INSTITUTE                  ,CO,80525-3479,Proprietary  ,3,18,21,18,48,66
04184900,COLLEGE OF INTERNATIONAL ESTHETICS      ,CO,80002-3754,Proprietary  ,8,35,43,11,76,87
04185000,COLORADO ACADEMY OF VETERINARY TECHNOLOG,CO,80906-4944,Proprietary  ,2,23,25,38,107,145
04185400,NATIONAL PERSONAL TRAINING INSTITUTE OF ,CO,80401-3304,Proprietary  ,7,31,38,21,74,95
04202600,NEW DIMENSIONS BEAUTY ACADEMY           ,CO,80138-9801,Proprietary  ,5,11,16,5,11,16
00145902,STRAYER UNIVERSITY - ALEXANDRIA CAMPUS  ,VA,22314-4553,Proprietary  ,0,1,1,0,1,1
00267811,BRYANT & STRATTON COLLEGE - VIRGINIA BEA,VA,23462-4417,Proprietary  ,65,358,423,605,3269,3874
00370200,AVERETT UNIVERSITY                      ,VA,24541-3692,Private      ,22,250,272,1482,1884,3366
00370300,BLUEFIELD COLLEGE                       ,VA,24605-1799,Private      ,16,97,113,822,664,1486
00370400,BRIDGEWATER COLLEGE                     ,VA,22812-1599,Private      ,33,14,47,3552,247,3799
00370500,COLLEGE OF WILLIAM & MARY               ,VA,23187-8795,Public       ,178,130,308,10568,4585,15153
00370600,CHRISTOPHER NEWPORT UNIVERSITY          ,VA,23606-2998,Public       ,153,123,276,7646,1335,8981
00370700,RICHARD BLAND COLLEGE                   ,VA,23805-7100,Public       ,57,81,138,1382,726,2108
00370800,EASTERN MENNONITE UNIVERSITY            ,VA,22802-2462,Private      ,14,45,59,1142,573,1715
00370900,EMORY & HENRY COLLEGE                   ,VA,24327-0010,Private      ,25,4,29,1497,188,1685
00371100,FERRUM COLLEGE                          ,VA,24088-2612,Private      ,47,16,63,2967,354,3321
00371200,TIDEWATER COMMUNITY COLLEGE             ,VA,23510-1910,Public       ,1044,3726,4770,11918,27626,39544
00371300,HAMPDEN-SYDNEY COLLEGE                  ,VA,23943-0128,Private      ,9,3,12,1398,58,1456
00371400,HAMPTON UNIVERSITY                      ,VA,23668-0099,Private      ,210,242,452,9219,4090,13309
00371500,HOLLINS UNIVERSITY                      ,VA,24020-0000,Private      ,15,35,50,995,682,1677
00371900,LONGWOOD UNIVERSITY                     ,VA,23909-1899,Public       ,98,51,149,5698,884,6582
00372000,LYNCHBURG COLLEGE                       ,VA,24501-3199,Private      ,52,66,118,3650,1026,4676
00372100,JAMES MADISON UNIVERSITY                ,VA,22807-3780,Public       ,401,141,542,23589,2937,26526
00372300,MARY BALDWIN COLLEGE                    ,VA,24401-3610,Private      ,27,95,122,1605,1203,2808
00372400,MARYMOUNT UNIVERSITY                    ,VA,22207-4224,Private      ,83,201,284,2628,2552,5180
00372600,NATIONAL COLLEGE                        ,VA,24153-4524,Proprietary  ,63,570,633,652,6249,6901
00372700,NORTHERN VA CMTY CLG                    ,VA,22003-3743,Public       ,1232,2725,3957,14896,20740,35636
00372800,OLD DOMINION UNIVERSITY                 ,VA,23529-0052,Public       ,460,1040,1500,19204,14960,34164
00373200,RADFORD UNIVERSITY                      ,VA,24142-6905,Public       ,196,127,323,9946,2689,12635
00373300,RANDOLPH-MACON COLLEGE                  ,VA,23005-5505,Private      ,39,14,53,2679,191,2870
00373400,RANDOLPH COLLEGE                        ,VA,24503-1526,Private      ,17,9,26,880,145,1025
00373500,VIRGINIA COMMONWEALTH UNIVERSITY        ,VA,23284-9004,Public       ,588,757,1345,23256,14700,37956
00373600,ROANOKE COLLEGE                         ,VA,24153-3794,Private      ,33,20,53,3300,313,3613
00373700,SHENANDOAH UNIVERSITY                   ,VA,22601-5195,Private      ,54,133,187,2647,2274,4921
00373800,SOUTHERN VIRGINIA UNIVERSITY            ,VA,24416-3038,Private      ,53,9,62,1185,332,1517
00373900,ST PAULS COLLEGE                        ,VA,23868-1299,Private      ,13,25,38,583,387,970
00374200,SWEET BRIAR COLLEGE                     ,VA,24595-9998,Private      ,16,3,19,837,82,919
00374300,UNION PRESBYTERIAN SEMINARY             ,VA,23227-0000,Private      ,0,5,5,5,95,100
00374400,UNIVERSITY OF RICHMOND                  ,VA,23173-0001,Private      ,108,179,287,6374,2866,9240
00374500,UNIVERSITY OF VIRGINIA - SFS            ,VA,22903-0000,Public       ,384,262,646,20119,9130,29249
00374600,UNIVERSITY OF MARY WASHINGTON           ,VA,22401-5358,Public       ,92,135,227,5248,1358,6606
00374700,UNIV OF VIRGINIA'S COLLEGE AT WISE      ,VA,24293-4412,Public       ,34,26,60,1912,528,2440
00374800,EASTERN SHORE COMMUNITY COLLEGE         ,VA,23410-3000,Public       ,39,97,136,442,773,1215
00374900,GEORGE MASON UNIVERSITY                 ,VA,22030-4444,Public       ,484,1072,1556,19786,16792,36578
00375100,PATRICK HENRY COMMUNITY COLLEGE         ,VA,24112-5311,Public       ,81,342,423,1276,2870,4146
00375200,VIRGINIA INTERMONT COLLEGE              ,VA,24201-4298,Private      ,10,29,39,538,325,863
00375300,VIRGINIA MILITARY INSTITUTE             ,VA,24450-2138,Public       ,57,15,72,2115,109,2224
00375400,VIRGINIA POLYTECH INST & STATE UNIV     ,VA,24061-2000,Public       ,340,263,603,26047,5753,31800
00375800,DANVILLE COMMUNITY COLLEGE              ,VA,24541-4004,Public       ,152,433,585,1520,3125,4645
00375900,J. SARGEANT REYNOLDS COMMUNITY CLG      ,VA,23285-0000,Public       ,424,1342,1766,5363,11863,17226
00376000,VIRGINIA WESTERN CMTY COLLEGE           ,VA,24038-0000,Public       ,175,564,739,2750,4958,7708
00376100,WYTHEVILLE COMMUNITY COLLEGE            ,VA,24382-3308,Public       ,62,254,316,1387,2250,3637
00376200,VIRGINIA UNIVERSITY OF LYNCHBURG        ,VA,24501-6400,Private      ,24,100,124,385,820,1205
00376400,VIRGINIA STATE UNIVERSITY               ,VA,23806-0001,Public       ,204,232,436,9865,3604,13469
00376500,NORFOLK STATE UNIVERSITY                ,VA,23504-8000,Public       ,243,548,791,8862,7672,16534
00376600,VIRGINIA UNION UNIVERSITY               ,VA,23220-1711,Private      ,114,125,239,4600,1638,6238
00376700,VIRGINIA WESLEYAN COLLEGE               ,VA,23502-5599,Private      ,54,66,120,2720,787,3507
00376800,WASHINGTON & LEE UNIVERSITY             ,VA,24450-0303,Private      ,46,11,57,2445,1294,3739
00400400,JOHN TYLER COMMUNITY COLLEGE            ,VA,23831-5316,Public       ,316,785,1101,3913,6908,10821
00450301,"EVEREST COLLEGE- EVEREST COLLEGE, MCLEAN",VA,22102-3000,Proprietary  ,15,96,111,129,543,672
00450702,"EVEREST COLLEGE- EVEREST COLLEGE, ARLING",VA,22203-1905,Proprietary  ,19,88,107,170,732,902
00498800,CENTRAL VIRGINIA COMMUNITY COLLEGE      ,VA,24502-2498,Public       ,120,354,474,1778,2838,4616
00499200,MILLER-MOTTE TECHNICAL COLLEGE          ,VA,24505-0000,Proprietary  ,84,298,382,216,850,1066
00499600,DABNEY S LANCASTER COMMUNITY CLG        ,VA,24422-1000,Public       ,19,65,84,568,696,1264
00522300,NEW RIVER COMMUNITY COLLEGE             ,VA,24084-1127,Public       ,107,299,406,1684,2749,4433
00662200,COLLEGE OF HEALTH SCIENCES - CHRV       ,VA,24031-0000,Private      ,14,50,64,576,1045,1621
00681900,BLUE RIDGE COMMUNITY COLLEGE            ,VA,24486-0080,Public       ,136,305,441,2243,2755,4998
00687100,THOMAS NELSON COMMUNITY COLLEGE         ,VA,23670-0000,Public       ,384,1250,1634,4117,9617,13734
00709900,VIRGINIA HIGHLANDS COMMUNITY CLG        ,VA,24210-4210,Public       ,44,216,260,1125,1881,3006
00726000,SOUTHWEST VIRGINIA COMMUNITY CLG        ,VA,24641-1510,Public       ,49,178,227,1140,1833,2973
00859200,LOUISE OBICI SCHOOL OF NURSING          ,VA,23434-8038,Private      ,3,22,25,21,115,136
00865900,LORD FAIRFAX COMMUNITY COLLEGE          ,VA,22645-0047,Public       ,205,465,670,2310,3353,5663
00866000,GERMANNA COMMUNITY COLLEGE              ,VA,22508-0339,Public       ,221,455,676,2546,4046,6592
00866100,SOUTHSIDE VIRGINIA CMTY CLG             ,VA,23821-2930,Public       ,151,510,661,1764,3551,5315
00915900,PAUL D CAMP COMMUNITY COLLEGE           ,VA,23851-0737,Public       ,50,187,237,531,1470,2001
00916000,RAPPAHANNOCK COMMUNITY COLLEGE          ,VA,23149-2616,Public       ,83,202,285,945,1585,2530
00926700,EVEREST COLLEGE                         ,VA,23606-4203,Proprietary  ,12,120,132,120,758,878
00926701,EVEREST COLLEGE - CHESAPEAKE            ,VA,23320-2637,Proprietary  ,21,189,210,158,1004,1162
00942000,SANFORD-BROWN COLLEGE                   ,VA,22182-3913,Proprietary  ,44,176,220,215,1027,1242
00953500,STAUNTON SCHOOL OF COSMETOLOGY          ,VA,24401-4323,Proprietary  ,2,7,9,25,79,104
00953700,VIRGINIA SCH OF HAIR DESIGN             ,VA,23669-0000,Proprietary  ,8,15,23,64,172,236
00962900,MOUNTAIN EMPIRE COMMUNITY COLLEGE       ,VA,24219-0700,Public       ,68,225,293,1263,2019,3282
00992800,PIEDMONT VIRGINIA COMMUNITY COLLEGE     ,VA,22902-7589,Public       ,110,378,488,1642,2939,4581
01004300,BON SECOURS MEMORIAL COLLEGE OF NURSING ,VA,23227-4612,Private      ,23,57,80,270,661,931
01019800,ECPI COLLEGE OF TECHNOLOGY              ,VA,23462-6542,Proprietary  ,370,1574,1944,2825,11467,14292
01033800,EASTERN VIRGINIA MEDICAL SCHOOL         ,VA,23501-1980,Private      ,5,43,48,85,1558,1643
01159600,RALPH'S VIRGINIA SCH OF COSMETOLOGY     ,VA,24501-2652,Proprietary  ,2,14,16,32,65,97
01162601,WESTWOOD COLLEGE - SOUTH BAY - ARLINGTON,VA,22203-4167,Proprietary  ,34,75,109,330,580,910
01162602,WESTWOOD COLLEGE - SOUTH BAY - ANNANDALE,VA,22003-2602,Proprietary  ,18,62,80,210,544,754
01274400,SOUTHSIDE REGIONAL MED CTR PROF SCHOOLS ,VA,23803-5133,Proprietary  ,5,28,33,81,294,375
02053000,LIBERTY UNIVERSITY                      ,VA,24502-0000,Private      ,691,7995,8686,18807,61832,80639
02083602,TESST COLLEGE OF TECHNOLOGY - KAPLAN COL,VA,23320-4422,Proprietary  ,5,55,60,28,171,199
02108800,WARDS CORNER BEAUTY ACADEMY             ,VA,23505-0000,Proprietary  ,11,51,62,75,262,337
02111600,DANVILLE REGIONAL MEDICAL CENTER SCHOOL ,VA,24541-0000,Proprietary  ,4,10,14,49,131,180
02128700,CENTRAL SCHOOL OF PRACTICAL NURSING     ,VA,23502-2230,Public       ,6,30,36,77,258,335
02140000,RIVERSIDE SCHOOL OF HEALTH CAREERS      ,VA,23608-3802,Private      ,16,63,79,155,717,872
02175800,LYNCHBURG GENERAL HOSP SCH OF NURSG     ,VA,24501-0000,Private      ,4,16,20,74,234,308
02197600,WOODROW WILSON REHABILITATION CTR       ,VA,22939-0000,Public       ,15,10,25,46,33,79
02242400,HENRICO CTY ST MARYS HOSP PRAC NRSG     ,VA,23075-0000,Public       ,0,5,5,14,66,80
02247200,MEDSPA CAREERS INSTITUTE                ,VA,23606-0000,Proprietary  ,0,0,0,5,32,37
02247206,MEDICAL CAREERS COLLEGE - NEWPORT NEWS  ,VA,23606-4215,Proprietary  ,0,0,0,0,1,1
02304500,HERITAGE INSTITUTE                      ,VA,20111-0000,Proprietary  ,1,24,25,28,164,192
02320900,TIDEWATER TECH                          ,VA,23502-1747,Proprietary  ,28,146,174,134,776,910
02334400,CENTURA COLLEGE                         ,VA,23452-0000,Proprietary  ,91,587,678,612,5681,6293
02342700,FORTIS COLLEGE                          ,VA,23502-4101,Proprietary  ,19,113,132,109,668,777
02342701,FORTIS COLLEGE - RICHMOND CAMPUS        ,VA,23236-3472,Proprietary  ,36,132,168,258,859,1117
02358500,BON SECOURS SAINT MARY'S HOSPITAL SCHOOL,VA,23227-4612,Private      ,8,37,45,71,301,372
02535400,SKYLINE COLLEGE - RICHMOND              ,VA,23236-0000,Proprietary  ,0,0,0,9,24,33
02538800,SUFFOLK BEAUTY ACADEMY                  ,VA,23434-0000,Proprietary  ,1,20,21,35,110,145
02541200,STRATFORD UNIVERSITY                    ,VA,22043-0000,Proprietary  ,47,237,284,252,1402,1654
02541201,STRATFORD UNIVERSITY-WOODBRIDGE         ,VA,22192-0000,Proprietary  ,16,88,104,105,524,629
02610100,WASHINGTON COUNTY ADULT SKILL CTR       ,VA,24210-2346,Public       ,4,19,23,39,124,163
03002400,GRAHAM WEBB INTERNATIONAL ACAD HAIR     ,VA,22209-2129,Proprietary  ,9,45,54,52,150,202
03010700,BAR PALMA BEAUTY CAREERS  ACADEMY       ,VA,24014-2255,Proprietary  ,3,24,27,17,87,104
03042800,"VIRGINIA BEACH CITY SCHOOLS, SCH.-PR.NSG",VA,23456-0038,Public       ,3,13,16,42,136,178
03091100,ACT COLLEGE                             ,VA,22209-2297,Proprietary  ,23,90,113,107,480,587
03091300,REGENT UNIVERSITY                       ,VA,23464-9800,Private      ,66,540,606,1595,7193,8788
03092700,SKYLINE COLLEGE                         ,VA,24012-1603,Proprietary  ,11,58,69,113,428,541
03096500,SPRINGFIELD BEAUTY ACADEMY              ,VA,22003-3016,Proprietary  ,1,22,23,15,96,111
03106500,SENTARA NORFOLK GENERAL HOSPITAL        ,VA,23320-2843,Private      ,12,51,63,155,629,784
03116900,BAPTIST THEOLOGICAL SEM.-RICHMOND       ,VA,23227-0000,Private      ,3,13,16,11,131,142
03126300,AVIATION INSTITUTE OF MAINTENANCE       ,VA,23320-5987,Proprietary  ,27,117,144,172,763,935
03126400,CENTURA COLLEGE                         ,VA,23235-5230,Proprietary  ,24,161,185,169,1144,1313
03127500,ADVANCED TECHNOLOGY INSTITUTE           ,VA,23462-2409,Proprietary  ,54,153,207,544,758,1302
03280400,VIRGINIA SCHOOL OF MASSAGE              ,VA,22903-0000,Proprietary  ,9,31,40,72,148,220
03409500,RICHMOND SCHOOL OF HEALTH AND TECH      ,VA,23227-0000,Proprietary  ,13,89,102,140,771,911
03455300,CRESCENT COSMETOLOGY UNIVERSITY         ,VA,23666-3115,Proprietary  ,2,5,7,9,46,55
03559300,APPALACHIAN SCHOOL OF LAW               ,VA,24614-0000,Private      ,3,7,10,17,669,686
03645400,RUDY & KELLY ACADEMY OF HAIR AND NA     ,VA,23464-6857,Proprietary  ,10,46,56,115,355,470
03654300,CAREER TRAINING SOLUTIONS               ,VA,22406-1014,Proprietary  ,26,102,128,103,634,737
03709300,EDWARD VIA VIRGINIA CLG OSTEOPATHIC MED ,VA,24060-6360,Private      ,1,3,4,16,832,848
03872400,INSTITUTE FOR THE PSYCHOLOGICAL SCIENCES,VA,22202-3609,Private      ,2,11,13,10,135,145
03876300,CULPEPER COSMETOLOGY TRAINING CENTER    ,VA,22701-3155,Public       ,2,18,20,26,55,81
03883400,AVIATION INSTITUTE OF MAINTENANCE       ,VA,20110-4156,Proprietary  ,19,71,90,112,439,551
04038400,AVI CAREER INSTITUTE                    ,VA,22066-1839,Proprietary  ,0,24,24,7,84,91
04110300,UNIVERSITY OF MANAGEMENT AND TECHNOLOGY ,VA,22209-1609,Proprietary  ,0,31,31,7,143,150
04124000,DOMINION SCHOOL OF HAIR DESIGN          ,VA,23062-2221,Proprietary  ,1,6,7,13,49,62
04127300,COLUMBIA COLLEGE                        ,VA,22031-4413,Proprietary  ,12,115,127,54,464,518
04133400,CENTURA COLLEGE                         ,VA,22312-2670,Proprietary  ,5,31,36,32,220,252
04133800,SOUTHEAST CULINARY & HOSPITALITY COLLEGE,VA,24201-4159,Proprietary  ,4,17,21,74,137,211
04137300,CAYCE/REILLY SCHOOL OF MASSOTHERAPY     ,VA,23451-2061,Private      ,3,12,15,14,82,96
04140000,GLOBAL HEALTH NURSE TRAINING SERVICES   ,VA,22314-4585,Proprietary  ,4,47,51,29,404,433
04153800,BETHEL COLLEGE                          ,VA,23666-3122,Private      ,6,13,19,40,119,159
04156200,INSTITUTE OF ADVANCED MEDICAL ESTHETICS ,VA,23294-4701,Proprietary  ,1,25,26,21,133,154
04169400,NORTHERN VIRGINIA SCHOOL OF THERAPEUTIC ,VA,22046-4302,Proprietary  ,8,34,42,15,89,104
04171500,COSMOPOLITAN BEAUTY & TECH SCHOOL       ,VA,22003-3204,Proprietary  ,0,23,23,12,143,155
04180600,APPALACHIAN COLLEGE OF PHARMACY         ,VA,24631-9210,Private      ,1,117,118,1,120,121
00107000,THUNDERBIRD SCHOOL OF GLOBAL MANAGEMENT ,AZ,85306-6000,Private      ,0,54,54,10,786,796
00107100,ARIZONA WESTERN COLLEGE                 ,AZ,85366-0000,Public       ,291,624,915,4701,5573,10274
00107200,COCHISE COLLEGE                         ,AZ,85607-6190,Public       ,115,365,480,1669,3142,4811
00107300,EASTERN ARIZONA COLLEGE                 ,AZ,85552-0769,Public       ,136,227,363,1771,2072,3843
00107400,GRAND CANYON UNIVERSITY                 ,AZ,85017-3030,Proprietary  ,497,7830,8327,6464,51957,58421
00107600,GLENDALE COMMUNITY COLLEGE              ,AZ,85302-3090,Public       ,910,1898,2808,10958,15605,26563
00107700,MESA COMMUNITY COLLEGE                  ,AZ,85202-4866,Public       ,928,2153,3081,11763,19917,31680
00107800,PHOENIX COLLEGE                         ,AZ,85013-4234,Public       ,445,1716,2161,5952,14930,20882
00107900,YAVAPAI COLLEGE                         ,AZ,86301-3297,Public       ,198,624,822,2225,4621,6846
00108100,ARIZONA STATE UNIV (ALL CAMPUSES)       ,AZ,85287-0412,Public       ,1503,2657,4160,51517,39628,91145
00108200,NORTHERN ARIZONA UNIVERSITY             ,AZ,86011-0001,Public       ,685,959,1644,25209,14646,39855
00108300,UNIVERSITY OF ARIZONA                   ,AZ,85721-0066,Public       ,757,841,1598,30324,16524,46848
00165701,MIDWESTERN UNIVERSITY                   ,AZ,85308-0000,Private      ,4,67,71,135,3733,3868
00446700,TUCSON COLLEGE                          ,AZ,85711-3781,Proprietary  ,39,157,196,239,701,940
00711300,SOUTHWESTERN COLLEGE                    ,AZ,85032-7097,Private      ,23,22,45,588,310,898
00726600,PIMA COUNTY COMMUNITY COLLEGE           ,AZ,85709-1110,Public       ,810,2466,3276,11625,21378,33003
00728300,CENTRAL ARIZONA COLLEGE                 ,AZ,85228-9779,Public       ,234,696,930,2739,5426,8165
00732911,ITT TECHNICAL INSTITUTE                 ,AZ,85282-9272,Proprietary  ,103,505,608,647,2946,3593
00732990,ITT TECHNICAL INSTITUTE                 ,AZ,85704-5829,Proprietary  ,159,504,663,711,2247,2958
00822100,UNIVERSAL TECHNICAL INSTITUTE           ,AZ,85323-7946,Proprietary  ,701,985,1686,9565,8615,18180
00824600,DINè COLLEGE                            ,AZ,86556-0126,Public       ,75,183,258,907,1746,2653
00830300,GATEWAY COMMUNITY COLLEGE               ,AZ,85034-1795,Public       ,184,928,1112,2684,8355,11039
00830302,MARICOPA SKILL CENTER                   ,AZ,85034-0000,Public       ,43,209,252,441,1726,2167
00830400,SCOTTSDALE COMMUNITY COLLEGE            ,AZ,85250-0000,Public       ,266,620,886,4256,5727,9983
00886400,ARIZONA ACADEMY OF BEAUTY               ,AZ,85712-5021,Proprietary  ,12,28,40,54,154,208
00886500,ARTISTIC BEAUTY COLLEGES-TUCSON         ,AZ,85716-3999,Proprietary  ,11,43,54,128,312,440
01084700,ARIZONA AUTOMOTIVE INSTITUTE            ,AZ,85301-3503,Proprietary  ,51,181,232,545,1667,2212
01085800,AVALON SCHOOL OF COSMETOLOGY            ,AZ,85210-4010,Proprietary  ,63,110,173,351,656,1007
01168900,REFRIGERATION SCHOOL                    ,AZ,85034-0000,Proprietary  ,29,201,230,169,1154,1323
01180200,ARIZONA ACADEMY OF BEAUTY-NORTH         ,AZ,85705-2720,Proprietary  ,3,14,17,30,104,134
01180800,ARTISTIC BEAUTY COLLEGES-FLAGSTAFF      ,AZ,86004-5119,Proprietary  ,24,41,65,154,351,505
01186200,NORTHLAND PIONEER COLLEGE               ,AZ,86025-2996,Public       ,68,352,420,687,2200,2887
01186400,MOHAVE COMMUNITY COLLEGE                ,AZ,86409-1238,Public       ,206,750,956,1689,5796,7485
01218400,INTERNATIONAL ACAD OF HAIR DESIGN       ,AZ,85225-7198,Proprietary  ,14,54,68,102,277,379
01234300,ARTISTIC BEAUTY COLLEGES-PHOENIX        ,AZ,85304-0000,Proprietary  ,14,63,77,152,352,504
01293700,ARTISTIC BEAUTY COLLEGES - PARADISE VALL,AZ,85257-0000,Proprietary  ,23,40,63,61,180,241
02065300,PRESCOTT COLLEGE                        ,AZ,86301-0000,Private      ,37,113,150,633,1273,1906
02071200,KAPLAN COLLEGE                          ,AZ,85029-4349,Proprietary  ,38,237,275,320,1799,2119
02098800,UNIVERSITY OF PHOENIX                   ,AZ,85040-0000,Proprietary  ,3948,71747,75695,21879,429528,451407
02100500,UNIVERSAL TECHNICAL INSTITUTE           ,AZ,85027-0000,Proprietary  ,642,1259,1901,6908,10136,17044
02100600,CARRINGTON COLLEGE                      ,AZ,85015-4096,Proprietary  ,156,606,762,1424,4850,6274
02113800,ROBERTO-VENN SCH OF LUTHIERY            ,AZ,85040-0000,Proprietary  ,13,18,31,46,72,118
02146600,SOUTH MOUNTAIN COMMUNITY COLLEGE        ,AZ,85040-0000,Public       ,163,496,659,2311,4454,6765
02160305,COLLINS COLLEGE                         ,AZ,85040-4000,Proprietary  ,64,141,205,755,1119,1874
02160306,INTERNATIONAL ACADEMY OF DESIGN AND TECH,AZ,85281-6705,Proprietary  ,2,4,6,18,44,62
02171500,WESTERN INTERNATIONAL UNIVERSITY        ,AZ,85021-0000,Proprietary  ,8,508,516,44,2813,2857
02177500,RIO SALADO COMMUNITY COLLEGE            ,AZ,85281-6948,Public       ,371,5431,5802,2768,24335,27103
02192300,MARICOPA BEAUTY COLLEGE                 ,AZ,85323-0000,Proprietary  ,1,22,23,62,152,214
02199900,AMERICAN INDIAN CLG-ASSEMBLIES GOD      ,AZ,85021-0000,Private      ,7,14,21,52,134,186
02217100,PIMA MEDICAL INSTITUTE                  ,AZ,85716-0000,Proprietary  ,414,1201,1615,2766,8471,11237
02218800,BROOKLINE COLLEGE                       ,AZ,85021-5815,Proprietary  ,50,361,411,395,2556,2951
02218804,BROOKLINE COLLEGE - MESA                ,AZ,85204-4448,Proprietary  ,35,145,180,202,853,1055
02218805,BROOKLINE COLLEGE - TUCSON              ,AZ,85711-5444,Proprietary  ,39,217,256,283,1123,1406
02220300,ARTISTIC BEAUTY COLLEGES-GLENDALE       ,AZ,85051-0000,Proprietary  ,14,59,73,111,378,489
02263100,ANTHEM COLLEGE                          ,AZ,85014-0000,Proprietary  ,192,927,1119,949,4829,5778
02280500,CHARLES OF ITALY BEAUTY COLLEGE         ,AZ,86403-0000,Proprietary  ,4,14,18,46,99,145
02295000,EVEREST COLLEGE                         ,AZ,85021-1610,Proprietary  ,47,280,327,451,3518,3969
02295002,EVEREST COLLEGE - MESA                  ,AZ,85206-4704,Proprietary  ,16,94,110,149,741,890
02317800,AMERICAN INSTITUTE OF TECHNOLOGY        ,AZ,85043-0000,Proprietary  ,27,417,444,143,1566,1709
02491500,THE ART CENTER DESIGN COLLEGE           ,AZ,85716-0000,Proprietary  ,15,37,52,249,522,771
02521500,LAMSON COLLEGE                          ,AZ,85284-1141,Proprietary  ,7,22,29,64,344,408
02533200,FRANK LLOYD WRIGHT SCHOOL OF ARCHITECTUR,AZ,85261-4430,Private      ,0,3,3,18,53,71
02559000,UNIVERSITY OF ADVANCING TECHNOLOGY      ,AZ,85283-0000,Proprietary  ,68,113,181,1023,881,1904
02561900,BRILLARE HAIRDRESSING ACADEMY           ,AZ,85254-3301,Proprietary  ,10,17,27,82,144,226
02582700,CORTIVA INSTITUTE - TUCSON              ,AZ,85710-3503,Proprietary  ,11,55,66,87,341,428
02616700,LE CORDON BLEU COLLEGE OF CULINARY ARTS ,AZ,85251-2729,Proprietary  ,98,316,414,836,2418,3254
02623600,PARADISE VALLEY COMMUNITY COLLEGE       ,AZ,85032-1210,Public       ,281,692,973,3450,5493,8943
02623800,CORTIVA INSTITUTE - SCOTTSDALE          ,AZ,85257-4218,Proprietary  ,5,18,23,46,135,181
03005000,SAFFORD COLLEGE OF BEAUTY CULTURE       ,AZ,85546-3309,Proprietary  ,1,11,12,14,63,77
03010613,VIRGINIA COLLEGE - GOLF ACADEMY OF ARIZO,AZ,85225-6742,Proprietary  ,7,24,31,77,270,347
03030604,UTAH COLLEGE OF MASSAGE THERAPY - ARIZON,AZ,85282-0000,Proprietary  ,14,74,88,134,358,492
03030605,UTAH COLLEGE OF MASSAGE THERAPY - ARIZON,AZ,85051-3470,Proprietary  ,34,83,117,181,412,593
03034400,CONSERVATORY RECORDING ARTS & SCIS      ,AZ,85282-1707,Proprietary  ,78,115,193,699,849,1548
03072200,CHANDLER-GILBERT COMMUNITY COLLEGE      ,AZ,85225-2499,Public       ,414,708,1122,5351,6900,12251
03076400,BRYMAN SCHOOL OF ARIZONA                ,AZ,85029-4919,Proprietary  ,164,505,669,952,3071,4023
03097800,CARSTEN INSTITUTE OF HAIR & BEAUTY      ,AZ,85282-5404,Proprietary  ,12,50,62,106,243,349
03100400,COCONINO COUNTY COMMUNITY COLLEGE       ,AZ,86001-2701,Public       ,147,282,429,1577,2565,4142
03107000,SOUTHWEST CLG OF NATUROPATHIC MED       ,AZ,85282-0000,Private      ,1,38,39,19,585,604
03115000,ARIZONA COLLEGE OF ALLIED HEALTH        ,AZ,85302-3843,Proprietary  ,44,195,239,258,1150,1408
03120300,COLLEGE AMERICA                         ,AZ,86004-3936,Proprietary  ,34,155,189,240,1109,1349
03156300,ESTRELLA MOUNTAIN COMMUNITY COLLEGE     ,AZ,85392-1010,Public       ,329,799,1128,4346,7447,11793
03347300,INTERNATIONAL BAPTIST COLLEGE           ,AZ,85282-6799,Private      ,3,2,5,50,30,80
03445300,HDS TRUCK DRIVING INSTITUTE             ,AZ,85731-0000,Proprietary  ,0,25,25,9,155,164
03478400,PHOENIX SEMINARY                        ,AZ,85018-7611,Private      ,0,16,16,5,135,140
03572300,EAST VALLEY INSTITUTE OF TECHNOLOGY     ,AZ,85201-6910,Public       ,27,92,119,255,542,797
03593300,SOUTHWEST INSTITUTE OF HEALING ARTS     ,AZ,85281-3658,Proprietary  ,30,218,248,200,1455,1655
03617500,PHOENIX INSTITUTE OF HERBAL MEDICINE & A,AZ,85012-0000,Proprietary  ,5,29,34,33,255,288
03695500,ARIZONA SCHOOL OF ACUPUNCTURE AND ORIENT,AZ,85712-1100,Proprietary  ,1,13,14,11,130,141
03784400,TOHONO O'ODHAM COMMUNITY COLLEGE        ,AZ,85634-3129,Public       ,1,19,20,49,131,180
03813300,NORTHCENTRAL UNIVERSITY                 ,AZ,86314-2336,Proprietary  ,5,896,901,59,5064,5123
03814300,TURNING POINT BEAUTY COLLEGE            ,AZ,85222-4229,Proprietary  ,0,14,14,23,97,120
04051300,ART INSTITUTE OF PHOENIX (THE)          ,AZ,85021-2859,Proprietary  ,1051,3233,4284,8361,27788,36149
04051306,ART INSTITUTE OF PHOENIX (THE) - ART INS,AZ,85712-2732,Proprietary  ,37,68,105,445,574,1019
04051325,ART INSTITUTE OF PHOENIX (THE) - BROWN M,AZ,85712-5300,Proprietary  ,22,128,150,480,1726,2206
04051327,ART INSTITUTE OF PHOENIX (THE) - BROWN M,AZ,85029-1348,Proprietary  ,6,30,36,114,179,293
04059300,TUCSON COLLEGE OF BEAUTY                ,AZ,85705-2451,Proprietary  ,10,24,34,51,146,197
04120900,ARIZONA CULINARY INSTITUTE              ,AZ,85259-4939,Proprietary  ,18,71,89,295,473,768
04131400,PHOENIX SCHOOL OF LAW                   ,AZ,85012-3330,Proprietary  ,4,76,80,50,1644,1694
04139200,UNIVERSAL BARBER COLLEGE                ,AZ,85007-3914,Proprietary  ,7,59,66,63,265,328
04148700,AMERICAN INSTITUTE OF INTERIOR DESIGN   ,AZ,85268-3827,Proprietary  ,0,8,8,13,58,71
04152900,STUDIO ACADEMY OF BEAUTY (THE)          ,AZ,85224-3600,Proprietary  ,19,50,69,60,222,282
04157400,NATIONAL PARALEGAL COLLEGE              ,AZ,85014-1262,Proprietary  ,9,233,242,69,1273,1342
04172100,CCIC BEAUTY COLLEGE                     ,AZ,85345-2410,Proprietary  ,4,18,22,19,64,83
04174100,PAUL MITCHELL THE SCHOOL PHOENIX        ,AZ,85017-1919,Proprietary  ,18,47,65,168,283,451
04174200,ALL BEAUTY COLLEGE                      ,AZ,86426-8326,Proprietary  ,7,21,28,39,115,154
04175300,KOHLER ACADEMY                          ,AZ,85254-4065,Proprietary  ,9,28,37,95,170,265
04177500,PURE AESTHETICS                         ,AZ,85711-2328,Proprietary  ,1,22,23,9,89,98
04191200,CLASSIC COOKING ACADEMY                 ,AZ,85255-8699,Private      ,1,3,4,1,3,4
04194500,AVEDA INSTITUTE TUCSON                  ,AZ,85719-4876,Proprietary  ,0,2,2,0,2,2
00142800,DELAWARE STATE UNIVERSITY               ,DE,19901-2277,Public       ,213,191,404,8392,2708,11100
00142900,GOLDEY BEACOM COLLEGE                   ,DE,19808-1993,Private      ,28,68,96,638,571,1209
00143100,UNIVERSITY OF DELAWARE                  ,DE,19716-0099,Public       ,381,214,595,24503,3488,27991
00143300,WESLEY COLLEGE                          ,DE,19901-3875,Private      ,57,69,126,2434,732,3166
00143301,WESLEY COLLEGE-CTR FOR ADULT STUDIE     ,DE,19720-0000,Private      ,2,33,35,37,304,341
00145948,STRAYER UNIVERSITY - CHRISTIANA         ,DE,19713-4316,Proprietary  ,0,0,0,0,1,1
00331301,WIDENER UNIV SCHOOL OF LAW - DE         ,DE,19803-0000,Private      ,4,35,39,61,1619,1680
00705300,DELAWARE TECH & CMTY COLLEGE-OWENS      ,DE,19947-0000,Public       ,120,454,574,2283,3579,5862
00794800,WILMINGTON UNIVERSITY                   ,DE,19720-6491,Private      ,160,928,1088,2646,8726,11372
01172700,DELAWARE TECH & CMTY CLG-TERRY          ,DE,19901-8736,Public       ,100,323,423,1865,2827,4692
02125200,BEEBE SCHOOL OF NURSING                 ,DE,19958-1462,Private      ,4,14,18,62,140,202
02144900,DELAWARE TECH & CMTY CLG-STANTN/WLM     ,DE,19801-0000,Public       ,221,591,812,3679,4803,8482
02190400,SCHILLING DOUGLAS SCH OF HAIR DSGN      ,DE,19711-0000,Proprietary  ,4,22,26,51,146,197
02586902,STAR TECHNICAL INSTITUTE -              ,DE,19901-4615,Proprietary  ,1,8,9,11,64,75
03025800,DAWN TRAINING CENTRE                    ,DE,19805-1511,Proprietary  ,22,187,209,139,977,1116
03543300,HARRIS SCHOOL OF BUSINESS               ,DE,19803-5341,Proprietary  ,42,138,180,127,575,702
03702300,DELAWARE LEARNING INSTITUTE OF COSMETOLO,DE,19939-9759,Proprietary  ,9,24,33,49,173,222
04130700,ACADEMY OF MASSAGE AND BODYWORK         ,DE,19701-1321,Proprietary  ,2,17,19,13,84,97
04139800,DELAWARE COLLEGE OF ART & DESIGN        ,DE,19801-3007,Private      ,19,14,33,462,135,597
04171100,DELAWARE ACADEMY PAUL MITCHELL PARTNER S,DE,19702-5108,Proprietary  ,16,24,40,107,162,269
        ,OFFICIAL USE ONLY                       ,DC,20202-0000,,2,0,2,3,1,4
00143400,AMERICAN UNIVERSITY                     ,DC,20016-8020,Private      ,189,340,529,14214,10938,25152
00143700,CATHOLIC UNIVERSITY OF AMERICA          ,DC,20064-0002,Private      ,79,172,251,5833,2880,8713
00143711,"CATHOLIC UNIV AMERICA, LAW SCHOOL       ",DC,20064-0000,Private      ,3,17,20,107,1549,1656
00144100,UNIV OF THE DISTRICT OF COLUMBIA        ,DC,20008-0000,Public       ,137,633,770,2577,6387,8964
00144102,UNIV OF THE DIST OF COLU -SCHOOL OF LAW ,DC,20008-1173,Public       ,12,71,83,293,1581,1874
00144300,GALLAUDET UNIVERSITY                    ,DC,20002-3695,Private      ,36,57,93,946,1098,2044
00144400,GEORGE WASHINGTON UNIVERSITY            ,DC,20052-2353,Private      ,230,739,969,13671,12932,26603
00144402,GEORGE WASHINGTON UNIV LAW SCHL         ,DC,20052-0000,Private      ,5,64,69,48,3881,3929
00144403,GEORGE WASHINGTON UNIV SCH MED          ,DC,20052-0000,Private      ,6,28,34,75,1350,1425
00144500,GEORGETOWN UNIVERSITY                   ,DC,20057-1252,Private      ,227,466,693,12737,5626,18363
00144501,"GEORGETOWN UNIV, SCH OF MEDICINE        ",DC,20007-0000,Private      ,3,29,32,51,1293,1344
00144502,GEORGETOWN UNIVERSITY - GRADUATE SCHOOL ,DC,20057-0004,Private      ,1,194,195,37,3412,3449
00144503,GEORGETOWN UNIV LAW CENTER              ,DC,20001-0000,Private      ,7,49,56,48,5299,5347
00144800,HOWARD UNIVERSITY                       ,DC,20059-0001,Private      ,331,449,780,14579,10028,24607
00145900,STRAYER UNIVERSITY                      ,DC,20005-2603,Proprietary  ,260,6157,6417,1995,55087,57082
00146000,TRINITY UNIVERSITY                      ,DC,20017-1004,Private      ,40,230,270,1357,2795,4152
00146400,WESLEY THEOLOGICAL SEMINARY             ,DC,20016-0000,Private      ,1,20,21,2,318,320
00207701,JOHNS HOPKINS UNIV SCH ADV INTL STU     ,DC,20036-0000,Private      ,2,50,52,42,1496,1538
01006500,WASHINGTON THEOLOGICAL UNION            ,DC,20012-0000,Private      ,1,6,7,3,44,47
01195000,THE CORCORAN COLLEGE OF ART & DESIG     ,DC,20006-4804,Private      ,19,41,60,473,515,988
01280300,DOMINICAN HOUSE OF STUDIES              ,DC,20017-1584,Private      ,0,1,1,0,22,22
02132800,NAT'L CONSERVATORY DRAMATIC ARTS        ,DC,20007-2758,Private      ,4,9,13,27,58,85
02279200,DUDLEY BEAUTY COLG-WASHINGTON           ,DC,20018-0000,Proprietary  ,0,0,0,63,135,198
02588900,SANZ SCHOOL                             ,DC,20006-0000,Proprietary  ,75,347,422,340,1614,1954
03104300,CAREER BLAZERS LEARNING CENTER OF WASHIN,DC,20037-1881,Proprietary  ,20,192,212,70,638,708
03218300,POTOMAC COLLEGE                         ,DC,20016-1860,Proprietary  ,10,102,112,56,470,526
03409600,BENNETT CAREER INSTITUTE                ,DC,20017-1754,Proprietary  ,20,61,81,138,351,489
03750300,TECHNICAL LEARNING CENTERS              ,DC,20006-3749,Proprietary  ,27,170,197,86,653,739
04114400,INSTITUTE OF WORLD POLITICS (THE)       ,DC,20036-1464,Private      ,0,11,11,5,212,217
04142700,PONTIFICAL JOHN PAUL II INSTITUTE FOR ST,DC,20064-0001,Private      ,0,2,2,2,38,40
00145959,STRAYER UNIVERSITY - DOUGLASVILLE       ,GA,30135-1224,Proprietary  ,0,1,1,0,1,1
00154100,ABRAHAM BALDWIN AGRICULTURAL CLG        ,GA,31794-0000,Public       ,125,206,331,3094,2093,5187
00154200,AGNES SCOTT COLLEGE                     ,GA,30030-3770,Private      ,24,46,70,1459,517,1976
00154300,DARTON COLLEGE                          ,GA,31707-3098,Public       ,197,519,716,3673,6608,10281
00154400,ALBANY STATE UNIVERSITY                 ,GA,31705-2796,Public       ,262,396,658,7556,5542,13098
00154500,ANDREW COLLEGE                          ,GA,39840-1395,Private      ,13,13,26,458,116,574
00154600,ARMSTRONG ATLANTIC STATE UNIVERSITY     ,GA,31419-1997,Public       ,257,521,778,6299,6468,12767
00154700,ATLANTA CHRISTIAN COLLEGE               ,GA,30344-1999,Private      ,24,158,182,584,1442,2026
00155200,AUGUSTA STATE UNIVERSITY                ,GA,30904-2200,Public       ,216,420,636,5559,5672,11231
00155400,BERRY COLLEGE                           ,GA,30149-5007,Private      ,82,26,108,3292,388,3680
00155500,THOMAS UNIVERSITY                       ,GA,31792-7499,Private      ,24,151,175,354,1497,1851
00155600,BRENAU UNIVERSITY                       ,GA,30501-3668,Private      ,57,274,331,1425,3410,4835
00155700,BREWTON PARKER COLLEGE                  ,GA,30445-0000,Private      ,10,17,27,495,341,836
00155800,COASTAL GEORGIA COMMUNITY COLLEGE       ,GA,31520-3644,Public       ,161,338,499,2252,3478,5730
00155900,CLARK ATLANTA UNIVERSITY                ,GA,30314-4385,Private      ,439,442,881,12312,6185,18497
00156000,COLUMBIA THEOLOGICAL SEMINARY           ,GA,30031-0000,Private      ,0,18,18,5,257,262
00156100,COLUMBUS STATE UNIVERSITY               ,GA,31907-5645,Public       ,289,667,956,7068,6969,14037
00156200,GEORGIA PERIMETER COLLEGE               ,GA,30021-0000,Public       ,1267,2812,4079,17263,27004,44267
00156300,EMMANUEL COLLEGE                        ,GA,30639-0000,Private      ,11,18,29,854,274,1128
00156400,EMORY UNIVERSITY                        ,GA,30322-1960,Private      ,279,449,728,12766,10588,23354
00156600,FORT VALLEY STATE UNIVERSITY            ,GA,31030-3298,Public       ,180,227,407,6068,3203,9271
00156700,GAINESVILLE STATE COLLEGE               ,GA,30503-0000,Public       ,410,485,895,6594,4597,11191
00156800,INTERDENOMINATIONAL THEOLOGY CENTER     ,GA,30314-0000,Private      ,0,34,34,2,585,587
00156900,GEORGIA INSTITUTE OF TECHNOLOGY         ,GA,30332-0002,Public       ,335,375,710,16794,5997,22791
00157000,SOUTHERN POLYTECHNIC STATE UNIV         ,GA,30060-2896,Public       ,135,322,457,3848,3935,7783
00157100,GEORGIA MILITARY COLLEGE                ,GA,31061-3398,Public       ,384,651,1035,4424,6152,10576
00157200,GEORGIA SOUTHERN UNIVERSITY             ,GA,30460-8065,Public       ,639,608,1247,22605,8626,31231
00157300,GEORGIA SOUTHWESTERN STATE UNIV         ,GA,31709-4693,Public       ,59,163,222,2550,2493,5043
00157400,GEORGIA STATE UNIVERSITY                ,GA,30303-3010,Public       ,1041,2311,3352,29416,31236,60652
00157500,GORDON COLLEGE                          ,GA,30204-1762,Public       ,233,324,557,5341,3626,8967
00157700,KENNESAW STATE UNIVERSITY               ,GA,30144-5591,Public       ,727,1275,2002,19849,16959,36808
00157800,LAGRANGE COLLEGE                        ,GA,30240-2999,Private      ,40,50,90,1430,760,2190
00157900,MEDICAL COLLEGE OF GEORGIA              ,GA,30912-0004,Public       ,18,112,130,609,2989,3598
00158000,MERCER UNIVERSITY                       ,GA,31207-0003,Private      ,143,580,723,4277,9150,13427
00158100,MIDDLE GEORGIA COLLEGE                  ,GA,31014-1599,Public       ,131,218,349,3400,2638,6038
00158200,MOREHOUSE COLLEGE                       ,GA,30314-3773,Private      ,123,110,233,4426,1291,5717
00158500,NORTH GEORGIA COLLEGE & STATE UNIV      ,GA,30597-0001,Public       ,213,214,427,5718,2661,8379
00158600,OGLETHORPE UNIVERSITY                   ,GA,30319-2737,Private      ,49,62,111,1855,713,2568
00158700,PAINE COLLEGE                           ,GA,30901-3182,Private      ,32,68,100,1485,717,2202
00158800,PIEDMONT COLLEGE                        ,GA,30535-5644,Private      ,27,158,185,1033,2342,3375
00158900,REINHARDT UNIVERSITY                    ,GA,30183-2981,Private      ,30,58,88,981,591,1572
00159000,SAVANNAH STATE UNIVERSITY               ,GA,31404-5298,Public       ,271,315,586,6881,3721,10602
00159100,SHORTER UNIVERSITY                      ,GA,30165-4298,Private      ,53,280,333,2105,3548,5653
00159200,SOUTH GEORGIA COLLEGE                   ,GA,31533-8104,Public       ,91,150,241,1891,1465,3356
00159400,SPELMAN COLLEGE                         ,GA,30314-4399,Private      ,213,125,338,6512,1562,8074
00159600,TOCCOA FALLS COLLEGE                    ,GA,30598-0001,Private      ,22,24,46,826,296,1122
00159700,TRUETT MCCONNELL COLLEGE                ,GA,30528-1264,Private      ,14,15,29,605,171,776
00159800,UNIVERSITY OF GEORGIA                   ,GA,30602-6114,Public       ,700,682,1382,26850,12893,39743
00159900,VALDOSTA STATE UNIVERSITY               ,GA,31698-0001,Public       ,409,533,942,13674,7041,20715
00160000,WESLEYAN COLLEGE                        ,GA,31210-4407,Private      ,14,40,54,420,559,979
00160100,UNIV OF WEST GEORGIA                    ,GA,30118-0002,Public       ,343,537,880,11150,6544,17694
00160200,GEORGIA COLLEGE & STATE UNIVERSITY      ,GA,31061-0490,Public       ,185,202,387,6626,2729,9355
00160400,YOUNG HARRIS COLLEGE                    ,GA,30582-4137,Private      ,23,8,31,1173,142,1315
00348400,COVENANT COLLEGE                        ,GA,30750-4164,Private      ,46,17,63,1334,181,1515
00395600,DALTON STATE COLLEGE                    ,GA,30720-3797,Public       ,146,359,505,4325,4396,8721
00402400,GEORGIA NORTHWESTERN TECHNICAL COLLEGE  ,GA,30161-6757,Public       ,258,1033,1291,2622,8258,10880
00411700,GRADY HEALTH SYSTEM                     ,GA,30303-3050,Public       ,9,66,75,117,654,771
00489808,MCCANN SCHOOL OF BUSINESS & TECHNOLOGY -,GA,31210-0246,Proprietary  ,2,9,11,2,12,14
00525400,LANIER TECHNICAL COLLEGE                ,GA,30566-3499,Public       ,201,575,776,1404,4806,6210
00525500,MOULTRIE TECHNICAL COLLEGE              ,GA,31768-0000,Public       ,65,291,356,678,2465,3143
00525600,WIREGRASS GEORGIA TECHNICAL COLLEGE     ,GA,31602-0929,Public       ,197,746,943,2006,6714,8720
00551100,OKEFENOKEE TECHNICAL COLLEGE            ,GA,31501-4016,Public       ,77,224,301,551,1807,2358
00559900,AUGUSTA TECHNICAL COLLEGE               ,GA,30906-3399,Public       ,302,928,1230,2508,7095,9603
00560000,ATHENS TECHNICAL COLLEGE                ,GA,30601-1579,Public       ,231,744,975,2862,6720,9582
00560100,ALBANY TECHNICAL COLLEGE                ,GA,31701-2648,Public       ,183,675,858,1883,7679,9562
00561500,SOUTHWEST GEORGIA TECHNICAL COLLEGE     ,GA,31792-2622,Public       ,82,286,368,763,2551,3314
00561600,SWAINSBORO TECHNICAL COLLEGE (FORMERLY S,GA,30401-5700,Public       ,0,0,0,21,61,82
00561700,SOUTH GEORGIA TECHNICAL COLLEGE         ,GA,31709-8167,Public       ,66,214,280,985,2474,3459
00561800,SAVANNAH TECHNICAL COLLEGE              ,GA,31405-5594,Public       ,284,1182,1466,2459,9277,11736
00561900,NORTH GEORGIA TECHNICAL COLLEGE         ,GA,30523-0000,Public       ,182,349,531,1563,2985,4548
00562000,CHATTAHOOCHEE TECHNICAL COLLEGE         ,GA,30060-3398,Public       ,748,1800,2548,6518,15162,21680
00562100,SOUTHERN CRESCENT TECHNICAL COLLEGE     ,GA,30223-2097,Public       ,214,765,979,2076,6608,8684
00562101,FLINT RIVER TECHNICAL INSTITUTE         ,GA,30286-0014,Public       ,10,48,58,123,476,599
00562200,DEKALB TECHNICAL COLLEGE                ,GA,30021-0000,Public       ,208,1029,1237,2276,9420,11696
00562400,COLUMBUS TECHNICAL COLLEGE              ,GA,31904-6572,Public       ,206,673,879,2094,5745,7839
00576300,CENTRAL GEORGIA TECHNICAL COLLEGE       ,GA,31206-3628,Public       ,241,922,1163,2296,9465,11761
00772800,MACON STATE COLLEGE                     ,GA,31206-5145,Public       ,207,566,773,3802,6432,10234
00854300,ATLANTA TECHNICAL COLLEGE               ,GA,30310-4499,Public       ,381,1507,1888,2736,10577,13313
00897600,CLAYTON STATE UNIVERSITY                ,GA,30260-0285,Public       ,264,951,1215,5987,11395,17382
00927000,ART INSTITUTE OF ATLANTA (THE)          ,GA,30328-1649,Proprietary  ,662,937,1599,9365,8366,17731
00950700,GEORGIA HIGHLANDS COLLEGE               ,GA,30162-0000,Public       ,322,502,824,4147,4316,8463
00962106,HERZING UNIVERSITY - ATLANTA            ,GA,30326-1162,Proprietary  ,1,9,10,1,9,10
01031903,MEDIX SCHOOL                            ,GA,30080-7630,Proprietary  ,42,131,173,249,890,1139
01035601,EVEREST INSTITUTE - DEKALB              ,GA,30035-3420,Proprietary  ,34,237,271,209,1175,1384
01048700,WEST GEORGIA TECHNICAL COLLEGE          ,GA,30182-6476,Public       ,370,1037,1407,3423,8698,12121
01077100,GUPTON JONES COLLEGE                    ,GA,30035-4022,Private      ,10,47,57,140,444,584
01099700,EAST GEORGIA COLLEGE                    ,GA,30401-2699,Public       ,194,182,376,3484,1807,5291
01107400,BAINBRIDGE COLLEGE                      ,GA,39819-8400,Public       ,122,590,712,1446,5117,6563
01110901,EVEREST COLLEGE - EVEREST INSTITUTE     ,GA,30067-8340,Proprietary  ,20,116,136,130,646,776
01110902,EVEREST COLLEGE - ATLANTA               ,GA,30331-2620,Proprietary  ,21,113,134,187,738,925
01112301,EVEREST COLLEGE - EVEREST INSTITUTE- NOR,GA,30093-2813,Proprietary  ,22,139,161,165,856,1021
01157400,BAUDER COLLEGE                          ,GA,30313-2439,Proprietary  ,39,222,261,511,1474,1985
01205100,PRO WAY HAIR SCHOOL                     ,GA,30083-2884,Proprietary  ,11,25,36,75,279,354
01216500,ATLANTA METROPOLITAN COLLEGE            ,GA,30310-4498,Public       ,250,727,977,3223,6592,9815
01303900,SOUTH UNIVERSITY                        ,GA,31406-4881,Proprietary  ,767,6705,7472,4673,37751,42424
02055000,WAYCROSS COLLEGE                        ,GA,31503-0000,Public       ,51,101,152,677,975,1652
02060900,BROWN CLG OF COURT REPORTING & M.T.     ,GA,30318-2570,Proprietary  ,3,49,52,35,512,547
02074800,LIFE UNIVERSITY                         ,GA,30060-0000,Private      ,32,139,171,471,2971,3442
02113613,AMERICAN INTERCONTINENTAL UNIVERSITY    ,GA,30328-1649,Proprietary  ,94,459,553,1297,3886,5183
02116000,SANFORD-BROWN COLLEGE                   ,GA,30328-4803,Proprietary  ,49,247,296,380,1889,2269
02141500,SAVANNAH COLLEGE OF ART & DESIGN        ,GA,31402-3146,Private      ,315,376,691,10128,5133,15261
02202800,AUGUSTA AREA DIET INTERN UNIV HOSP      ,GA,30901-0000,Private      ,1,6,7,11,48,59
02217200,PORTFOLIO CENTER                        ,GA,30309-0000,Proprietary  ,13,47,60,40,175,215
02266200,AMERICAN PROFESSIONAL INSTITUTE         ,GA,31201-3185,Proprietary  ,43,235,278,252,1327,1579
02284300,INTERACTIVE COLLEGE OF TECHNOLOGY       ,GA,30341-0000,Proprietary  ,47,319,366,220,1638,1858
02284308,INTERACTIVE LEARNING SYSTEMS            ,GA,30260-0000,Proprietary  ,14,37,51,70,271,341
02284309,INTERACTIVE COLLEGE OF TECHNOLOGY       ,GA,30501-0000,Proprietary  ,10,70,80,61,384,445
02285500,"CREATIVE CIRCUS, THE                    ",GA,30324-0000,Proprietary  ,7,24,31,101,316,417
02288400,GWINNETT TECHNICAL COLLEGE              ,GA,30043-5702,Public       ,396,1206,1602,3739,10942,14681
02313902,WESTWOOD COLLEGE - O'HARE AIRPORT - ATLA,GA,30345-2807,Proprietary  ,20,72,92,253,715,968
02321400,ROFFLER-MOLER HAIRSTYLING COLLEGE       ,GA,30062-0000,Proprietary  ,12,22,34,58,95,153
02354500,SOUTHEASTERN BEAUTY SCHOOLS             ,GA,31906-0000,Proprietary  ,3,27,30,36,143,179
02482100,MOREHOUSE SCHOOL OF MEDICINE            ,GA,30310-0000,Private      ,11,19,30,95,662,757
02502700,ADVANCED CAREER TRAINING                ,GA,30329-0000,Proprietary  ,162,558,720,605,2066,2671
02502701,ADVANCED CAREER TRAINING-RIVERDALE      ,GA,30274-0000,Proprietary  ,53,219,272,235,1063,1298
02508600,MIDDLE GEORGIA TECHNICAL COLLEGE        ,GA,31088-2730,Public       ,114,458,572,1335,4172,5507
02520000,INTERNATIONAL SCH SKIN & NAILCARE       ,GA,30342-1119,Proprietary  ,14,66,80,64,417,481
02577000,ESANI INSTITUTE                         ,GA,30297-0000,Proprietary  ,20,42,62,100,239,339
02577700,BEAUTY COLLEGE OF AMERICA               ,GA,30297-0000,Proprietary  ,5,17,22,46,142,188
02578300,INTERNATIONAL CITY BEAUTY COLLEGE       ,GA,31093-3631,Proprietary  ,0,0,0,3,2,5
02580200,ATLANTA SCHOOL OF MASSAGE               ,GA,30338-0000,Proprietary  ,21,69,90,120,557,677
02583000,GWINNETT COLLEGE OF BUSINESS            ,GA,30047-3447,Proprietary  ,11,97,108,112,717,829
02607600,CAPELLI LEARNING CTR FOR COSM           ,GA,30324-0000,Proprietary  ,9,40,49,102,326,428
02614206,MILLER - MOTTE TECHNICAL COLLEGE - COLUM,GA,31907-3222,Proprietary  ,23,136,159,119,934,1053
02614207,MILLER - MOTTE TECHNICAL COLLEGE - AUGUS,GA,30907-0921,Proprietary  ,15,79,94,95,505,600
03005400,GEORGIA CAREER INSTITUTE                ,GA,30013-2076,Proprietary  ,49,115,164,279,645,924
03010619,VIRGINIA COLLEGE - AUGUSTA              ,GA,30909-5515,Proprietary  ,15,90,105,256,1540,1796
03010623,VIRGINIA COLLEGE - MACON                ,GA,31206-3180,Proprietary  ,12,89,101,111,788,899
03022601,WESTERN CULINARY INSTITUTE - LE CORDON B,GA,30084-5893,Proprietary  ,24,99,123,236,621,857
03030000,OGEECHEE TECHNICAL COLLEGE              ,GA,30458-8049,Public       ,151,399,550,1479,3343,4822
03032100,ALTAMAHA TECHNICAL COLLEGE              ,GA,31545-4465,Public       ,82,363,445,633,2342,2975
03042700,LAURUSTECHNICAL INSTITUTE               ,GA,30030-1506,Proprietary  ,17,82,99,80,444,524
03066500,SOUTHEASTERN TECHNICAL COLLEGE          ,GA,30474-8817,Public       ,51,275,326,633,2216,2849
03072304,EVEREST COLLEGE - EVEREST INSTITUTE     ,GA,30236-0000,Proprietary  ,23,142,165,126,824,950
03076300,BEULAH HEIGHTS BIBLE COLLEGE            ,GA,30316-1873,Private      ,0,62,62,64,891,955
03079202,WESTWOOD COLLEGE - ATLANTA MIDTOWN      ,GA,30309-2848,Proprietary  ,54,191,245,620,1480,2100
03081500,SOUTHEASTERN BEAUTY SCHOOL              ,GA,31917-0000,Proprietary  ,11,38,49,57,145,202
03089100,GEORGIA INSTITUTE OF COSMETOLOGY        ,GA,30606-3152,Proprietary  ,23,90,113,187,502,689
03090600,COBB BEAUTY COLLEGE                     ,GA,30144-2828,Proprietary  ,5,21,26,53,144,197
03100900,LUTHER RICE UNIVERSITY                  ,GA,30038-2454,Private      ,3,113,116,41,1112,1153
03102000,RIVERTOWN SCHOOL OF BEAUTY              ,GA,31904-4747,Proprietary  ,21,73,94,85,288,373
03104500,ATLANTA INSTITUTE OF MUSIC              ,GA,30096-4988,Proprietary  ,49,81,130,358,460,818
03116100,VOGUE BEAUTY AND BARBER SCHOOL          ,GA,30141-2226,Proprietary  ,5,24,29,52,187,239
03155500,OCONEE FALL LINE TECHNICAL COLLEGE      ,GA,31082-6179,Public       ,71,256,327,521,1774,2295
03155504,OCONEE FALL LINE TECHNICAL COLLEGE - SOU,GA,31021-0560,Public       ,37,135,172,508,1612,2120
03173300,ATLANTA'S JOHN MARSHALL LAW SCHOOL      ,GA,30309-0000,Proprietary  ,6,45,51,48,1579,1627
03232304,LINCOLN COLLEGE OF TECHNOLOGY           ,GA,30067-8638,Proprietary  ,18,83,101,124,598,722
03418300,GWINNETT COLLEGE-SANDY SPRINGS          ,GA,30328-3161,Proprietary  ,8,47,55,70,335,405
03445500,FAYETTE BEAUTY ACADEMY                  ,GA,30214-1191,Proprietary  ,4,24,28,27,120,147
03523300,AVIATION INSTITUTE OF MAINTENANCE       ,GA,30045-0000,Proprietary  ,44,161,205,328,1061,1389
03635300,CARVER BIBLE COLLEGE                    ,GA,30331-1300,Private      ,0,19,19,31,170,201
03748300,KEVOSNIK SCHOOL OF HAIR DESIGN          ,GA,31021-0000,Proprietary  ,1,8,9,11,51,62
03753400,MICHAEL'S SCHOOL OF BEAUTY              ,GA,30909-0000,Proprietary  ,3,10,13,20,121,141
03804400,JAVELIN TECHNICAL TRAINING CENTER       ,GA,30339-6040,Proprietary  ,31,143,174,187,1021,1208
03812300,OMNITECH INSTITUTE                      ,GA,30035-1206,Proprietary  ,10,75,85,88,410,498
04021300,AUGUSTA SCHOOL OF MASSAGE               ,GA,30809-0000,Proprietary  ,3,22,25,29,121,150
04051331,ART INSTITUTE OF PHOENIX (THE) - BROWN M,GA,30319-3054,Proprietary  ,8,56,64,103,407,510
04091300,SAVANNAH SCHOOL OF MASSAGE THERAPY      ,GA,31406-2711,Private      ,3,19,22,44,190,234
04126800,ACADEMY OF SOMATIC HEALING ARTS (ASHA)  ,GA,30071-1024,Proprietary  ,2,29,31,22,189,211
04142900,GEORGIA GWINNETT COLLEGE                ,GA,30043-7409,Public       ,545,646,1191,7753,5774,13527
04147000,PAUL MITCHELL THE SCHOOL ATLANTA        ,GA,30318-5241,Proprietary  ,20,62,82,208,460,668
04147700,LAKE LANIER SCHOOL OF MASSAGE           ,GA,30501-4546,Proprietary  ,11,56,67,47,247,294
04149900,PROFILE INSTITUTE OF BARBER-STYLING     ,GA,30315-8459,Proprietary  ,2,26,28,39,185,224
04150900,PROCESS INSTITUTE OF COSMETOLOGY (THE)  ,GA,30043-7344,Proprietary  ,11,28,39,87,112,199
04152300,GEORGIA BEAUTY ACADEMY                  ,GA,30721-3952,Proprietary  ,8,21,29,61,156,217
04156500,GEORGIA CHRISTIAN UNIVERSITY            ,GA,30047-3778,Private      ,3,8,11,8,33,41
04160200,ATLANTA BEAUTY ACADEMY                  ,GA,30340-1334,Proprietary  ,8,84,92,76,379,455
04204500,ELAINE STERLING INSTITUTE(THE)          ,GA,30342-2633,Proprietary  ,0,11,11,0,11,11
00162800,AMERICAN ACADEMY OF ART                 ,IL,60604-4302,Proprietary  ,31,26,57,929,297,1226
00163300,AUGUSTANA COLLEGE                       ,IL,61201-2296,Private      ,40,16,56,4384,280,4664
00163400,AURORA UNIVERSITY                       ,IL,60506-4892,Private      ,63,276,339,3269,3211,6480
00163600,SOUTHWESTERN ILLINOIS COLLEGE           ,IL,62221-5899,Public       ,335,1017,1352,4309,7730,12039
00163800,BLACK HAWK COLLEGE                      ,IL,61265-5899,Public       ,166,470,636,2498,3604,6102
00163900,BLACKBURN COLLEGE                       ,IL,62626-1498,Private      ,10,15,25,813,192,1005
00164000,PRAIRIE STATE COLLEGE                   ,IL,60411-8226,Public       ,181,588,769,3078,5694,8772
00164100,BRADLEY UNIVERSITY                      ,IL,61625-0002,Private      ,101,88,189,7442,1427,8869
00164300,SPOON RIVER COLLEGE                     ,IL,61520-8907,Public       ,35,109,144,822,998,1820
00164700,CITY COLLEGES OF CHICAGO                ,IL,60606-6998,Public       ,73,309,382,2188,3243,5431
00164800,TRUMAN COLLEGE                          ,IL,60640-5691,Public       ,197,755,952,4044,7187,11231
00164900,RICHARD J DALEY COLLEGE                 ,IL,60652-1299,Public       ,198,544,742,3442,5983,9425
00165000,CITY COLLEGES OF CHICAGO-MALCOLM X      ,IL,60612-3197,Public       ,178,864,1042,3812,8789,12601
00165200,HAROLD WASHINGTON COLLEGE               ,IL,60601-2403,Public       ,486,1117,1603,7632,9942,17574
00165400,KENNEDY KING COLLEGE                    ,IL,60621-3798,Public       ,226,1051,1277,3436,9784,13220
00165500,WRIGHT COLLEGE                          ,IL,60634-1591,Public       ,325,795,1120,5942,7476,13418
00165700,MIDWESTERN UNIVERSITY                   ,IL,60515-1200,Private      ,2,37,39,143,3220,3363
00165900,ROSALIND FRANKLIN UNIVERSITY OF MEDICINE,IL,60064-3095,Private      ,1,51,52,37,2589,2626
00166100,CHICAGO THEOLOGICAL SEMINARY            ,IL,60637-0000,Private      ,0,10,10,16,200,216
00166300,SPERTUS COLLEGE                         ,IL,60605-1995,Private      ,0,18,18,1,114,115
00166400,UNIVERSITY OF ST FRANCIS                ,IL,60435-6188,Private      ,56,231,287,1734,2220,3954
00166500,COLUMBIA COLLEGE                        ,IL,60605-1996,Private      ,456,461,917,14629,6338,20967
00166600,CONCORDIA UNIVERSITY                    ,IL,60305-1499,Private      ,34,510,544,2603,4009,6612
00166900,DANVILLE AREA COMMUNITY COLLEGE         ,IL,61832-5199,Public       ,65,228,293,1055,2073,3128
00167100,DEPAUL UNIVERSITY                       ,IL,60604-2287,Private      ,392,1025,1417,21721,18479,40200
00167400,EASTERN ILLINOIS UNIVERSITY             ,IL,61920-3099,Public       ,261,269,530,11568,4258,15826
00167500,ELGIN COMMUNITY COLLEGE                 ,IL,60123-7193,Public       ,351,633,984,4218,5502,9720
00167600,ELMHURST COLLEGE                        ,IL,60126-3296,Private      ,62,95,157,4274,1411,5685
00167800,EUREKA COLLEGE                          ,IL,61530-9976,Private      ,15,16,31,1141,249,1390
00168100,HIGHLAND COMMUNITY COLLEGE              ,IL,61032-9341,Public       ,72,164,236,1028,1468,2496
00168200,GARRETT-EVANGELICAL THEOLOGICAL SEM     ,IL,60201-0000,Private      ,0,11,11,0,269,269
00168400,GREENVILLE COLLEGE                      ,IL,62246-1199,Private      ,29,54,83,1653,857,2510
00168500,HEBREW THEOLOGICAL COLLEGE              ,IL,60077-3263,Private      ,19,5,24,470,32,502
00168800,ILLINOIS COLLEGE                        ,IL,62650-2299,Private      ,18,6,24,1560,182,1742
00168900,ILLINOIS COLLEGE OF OPTOMETRY           ,IL,60616-3878,Private      ,3,12,15,32,743,775
00169100,ILLINOIS INSTITUTE OF TECHNOLOGY        ,IL,60616-0000,Private      ,56,161,217,3190,2706,5896
00169103,CHICAGO KENT COLLEGE OF LAW             ,IL,60661-0000,Private      ,2,42,44,66,2116,2182
00169200,ILLINOIS STATE UNIVERSITY               ,IL,61790-1000,Public       ,374,268,642,22121,5578,27699
00169300,NORTHEASTERN ILLINOIS UNIV              ,IL,60625-4699,Public       ,165,573,738,7542,8587,16129
00169400,CHICAGO STATE UNIVERSITY                ,IL,60628-1598,Public       ,210,849,1059,7031,13652,20683
00169600,ILLINOIS WESLEYAN UNIVERSITY            ,IL,61701-0000,Private      ,30,17,47,3352,210,3562
00169800,JOHN MARSHALL LAW SCHOOL                ,IL,60604-0000,Private      ,3,108,111,39,2807,2846
00169900,JOLIET JUNIOR COLLEGE                   ,IL,60431-8938,Public       ,483,1022,1505,7722,8639,16361
00170000,JUDSON UNIVERSITY                       ,IL,60123-1498,Private      ,23,63,86,1052,841,1893
00170100,KASKASKIA COLLEGE                       ,IL,62801-7878,Public       ,95,347,442,1623,2686,4309
00170300,KENDALL COLLEGE                         ,IL,60622-4278,Proprietary  ,80,251,331,1286,2526,3812
00170400,KNOX COLLEGE                            ,IL,61401-4999,Private      ,23,16,39,2381,159,2540
00170500,ILLINOIS VALLEY COMMUNITY COLLEGE       ,IL,61348-9692,Public       ,96,254,350,1686,2303,3989
00170600,LAKE FOREST COLLEGE                     ,IL,60045-2399,Private      ,40,14,54,2276,228,2504
00170700,LEWIS UNIVERSITY                        ,IL,60446-2200,Private      ,107,333,440,5351,4020,9371
00170800,LINCOLN CHRISTIAN UNIVERSITY            ,IL,62656-2167,Private      ,8,53,61,476,708,1184
00170900,LINCOLN COLLEGE                         ,IL,62656-1699,Private      ,39,55,94,1300,735,2035
00171000,LOYOLA UNIVERSITY CHICAGO               ,IL,60626-0000,Private      ,292,586,878,16230,12996,29226
00171200,LUTHERAN SCHOOL OF THEOL AT CHICAGO     ,IL,60615-0000,Private      ,0,7,7,1,151,152
00171600,MACCORMAC COLLEGE                       ,IL,60602-4405,Private      ,2,9,11,64,198,262
00171700,MACMURRAY COLLEGE                       ,IL,62650-2590,Private      ,17,24,41,707,363,1070
00172100,MCCORMICK THEOLOGICAL SEMINARY          ,IL,60615-5108,Private      ,0,3,3,1,148,149
00172200,MCKENDREE UNIVERSITY                    ,IL,62254-1299,Private      ,22,133,155,1819,1716,3535
00172300,MEADVILLE LOMBARD THEOLOGICAL SCHOOL    ,IL,60637-1602,Private      ,0,2,2,3,83,86
00172400,MILLIKIN UNIVERSITY                     ,IL,62522-2084,Private      ,50,62,112,3029,1013,4042
00172500,MONMOUTH COLLEGE                        ,IL,61462-1963,Private      ,14,6,20,2190,171,2361
00172700,MOODY BIBLE INSTITUTE                   ,IL,60610-3214,Private      ,61,188,249,1907,1567,3474
00172800,MORTON COLLEGE                          ,IL,60804-4398,Public       ,150,238,388,2630,2540,5170
00173200,NATIONAL UNIV OF HEALTH SCIENCES        ,IL,60148-4583,Private      ,5,44,49,62,1034,1096
00173300,NATIONAL-LOUIS UNIVERSITY               ,IL,60603-3032,Private      ,16,575,591,363,6550,6913
00173400,NORTH CENTRAL COLLEGE                   ,IL,60540-4690,Private      ,49,79,128,3691,1057,4748
00173500,NORTH PARK UNIVERSITY                   ,IL,60625-4895,Private      ,66,159,225,3189,2045,5234
00173600,NORTHERN BAPTIST THEOL SEMINARY         ,IL,60148-0000,Private      ,0,12,12,2,118,120
00173700,NORTHERN ILLINOIS UNIVERSITY            ,IL,60115-2854,Public       ,479,584,1063,22761,11718,34479
00173900,NORTHWESTERN UNIV                       ,IL,60208-0001,Private      ,243,508,751,19514,11604,31118
00174100,OLIVET NAZARENE UNIVERSITY              ,IL,60914-2271,Private      ,42,300,342,3528,2388,5916
00174200,IL EASTERN COMM COLGS-OLNEY CENTRAL     ,IL,62450-1099,Public       ,19,80,99,631,840,1471
00174500,QUINCY UNIVERSITY                       ,IL,62301-2699,Private      ,20,53,73,1625,1067,2692
00174600,ROBERT MORRIS UNIVERSITY ILLINOIS       ,IL,60605-1225,Private      ,128,346,474,5410,5927,11337
00174700,ROCK VALLEY COLLEGE                     ,IL,61114-5699,Public       ,249,777,1026,3604,6525,10129
00174800,ROCKFORD COLLEGE                        ,IL,61108-2393,Private      ,42,117,159,1230,1477,2707
00174900,ROOSEVELT UNIVERSITY                    ,IL,60605-1394,Private      ,119,512,631,5627,7858,13485
00175000,DOMINICAN UNIVERSITY                    ,IL,60305-1066,Private      ,41,132,173,3015,2144,5159
00175200,SAUK VALLEY COMMUNITY COLLEGE           ,IL,61021-9112,Public       ,61,189,250,1117,1562,2679
00175300,SCHOOL OF ART INSTITUTE OF CHICAGO      ,IL,60603-3013,Private      ,118,144,262,4030,2784,6814
00175400,SEABURY-WESTERN THEO SEMINARY           ,IL,60201-0000,Private      ,0,0,0,0,4,4
00175600,SHIMER COLLEGE                          ,IL,60616-3893,Private      ,12,11,23,171,78,249
00175700,SOUTHEASTERN ILLINOIS COLLEGE           ,IL,62946-4925,Public       ,31,108,139,733,954,1687
00175800,SOUTHERN ILL UNIV-CARBONDALE            ,IL,62901-0000,Public       ,381,555,936,16967,10075,27042
00175900,SOUTHERN ILL UNIV-EDWARDSVILLE          ,IL,62026-1060,Public       ,281,353,634,12436,6758,19194
00175924,SO IL UNIV-SCHL OF DENTAL MEDICINE      ,IL,62002-0000,Public       ,0,3,3,15,199,214
00176100,SPRINGFIELD COLLEGE IN ILLINOIS         ,IL,62702-2694,Private      ,8,44,52,281,409,690
00176500,UNIVERSITY OF ST MARY OF THE LAKE       ,IL,60060-0000,Private      ,0,2,2,2,14,16
00176700,BENEDICTINE UNIVERSITY                  ,IL,60532-0900,Private      ,65,359,424,3094,4821,7915
00176800,ST XAVIER UNIVERSITY                    ,IL,60655-3199,Private      ,72,261,333,5084,3877,8961
00176900,SOUTH SUBURBAN COLLEGE                  ,IL,60473-9978,Public       ,209,823,1032,3421,8677,12098
00177100,TRINITY CHRISTIAN COLLEGE               ,IL,60463-0929,Private      ,19,47,66,1440,952,2392
00177200,TRINITY INTERNATIONAL UNIVERSITY        ,IL,60015-1283,Private      ,20,96,116,906,1256,2162
00177300,TRITON COLLEGE                          ,IL,60171-1995,Public       ,237,585,822,4401,6130,10531
00177400,UNIVERSITY OF CHICAGO                   ,IL,60637-1476,Private      ,406,222,628,15525,3705,19230
00177401,UNIV OF CHICAGO PRITZKER SCH OF MED     ,IL,60637-0000,Private      ,2,8,10,51,584,635
00177403,"UNIV OF CHICAGO, BOOTH SCH OF BUS       ",IL,60637-0000,Private      ,3,108,111,40,1448,1488
00177405,UNIVERSITY OF CHICAGO GRADUATE          ,IL,60637-0000,Private      ,6,197,203,95,5563,5658
00177500,UNIV OF ILLINOIS @ URBANA-CHAMPAIGN     ,IL,61820-5796,Public       ,378,371,749,30090,9904,39994
00177600,UNIV OF ILLINOIS AT CHICAGO             ,IL,60607-0000,Public       ,447,918,1365,23742,19236,42978
00177800,VANDERCOOK COLLEGE OF MUSIC             ,IL,60616-3731,Private      ,4,9,13,189,118,307
00177900,IL EASTERN COMM COLGS-WABASH VALLEY     ,IL,62863-2699,Public       ,15,54,69,438,511,949
00178000,WESTERN ILLINOIS UNIVERSITY             ,IL,61455-1390,Public       ,280,264,544,12530,4837,17367
00178100,WHEATON COLLEGE                         ,IL,60187-5535,Private      ,30,30,60,2892,658,3550
00178300,WORSHAM COLLEGE OF MORTUARY SCIENCE     ,IL,60090-2646,Proprietary  ,2,16,18,55,169,224
00396100,HARPER COLLEGE                          ,IL,60067-7398,Public       ,320,701,1021,5988,6717,12705
00418100,ADVOCATE TRINITY HOSPITAL SCHOOL OF RADI,IL,60617-3982,Private      ,0,0,0,35,102,137
00456000,GEM CITY COLLEGE                        ,IL,62301-4949,Proprietary  ,0,6,6,18,63,81
00456800,MIDSTATE COLLEGE                        ,IL,61614-3558,Proprietary  ,10,116,126,107,1022,1129
00621400,BLESSING RIEMAN COLLEGE OF NURSING      ,IL,62301-0000,Private      ,2,9,11,111,167,278
00621401,BLESSING HOSPITAL - SCHOOL OF MEDICAL LA,IL,62305-7005,Private      ,0,1,1,14,21,35
00621402,BLESSING HOSPITAL - SCHOOL OF RADIOLOGIC,IL,62305-7005,Private      ,0,5,5,18,19,37
00622500,TRINITY COLLEGE OF NURSING AND HEALTH SC,IL,61201-5317,Private      ,3,9,12,87,212,299
00622800,METHODIST MED CTR OF ILL SCH NRSNG      ,IL,61636-0000,Private      ,12,49,61,295,615,910
00624000,ST FRANCIS MED CLG OF NRSG              ,IL,61603-3783,Private      ,5,36,41,235,472,707
00638500,CHAMBERLAIN COLLEGE OF NURSING          ,IL,60101-0000,Proprietary  ,90,1534,1624,1650,13529,15179
00665600,COLLEGE OF DUPAGE                       ,IL,60137-6599,Public       ,559,1243,1802,9604,10855,20459
00675300,ILLINOIS CENTRAL COLLEGE                ,IL,61635-0001,Public       ,212,766,978,4458,6943,11401
00693100,WAUBONSEE COMMUNITY COLLEGE             ,IL,60554-0000,Public       ,232,553,785,3138,4686,7824
00711800,PARKLAND COLLEGE                        ,IL,61821-1899,Public       ,237,537,774,4750,4936,9686
00711900,REND LAKE COLLEGE                       ,IL,62846-9801,Public       ,63,243,306,1306,1863,3169
00717000,LINCOLN LAND COMMUNITY COLLEGE          ,IL,62794-9256,Public       ,190,599,789,2705,4799,7504
00726500,CARL SANDBURG COLLEGE                   ,IL,61401-9576,Public       ,69,223,292,1086,1927,3013
00754900,COYNE AMERICAN INSTITUTE                ,IL,60607-1300,Proprietary  ,50,213,263,373,1438,1811
00764400,LAKE LAND COLLEGE                       ,IL,61938-9366,Public       ,104,322,426,2325,2868,5193
00768400,KISHWAUKEE COLLEGE                      ,IL,60150-9699,Public       ,119,239,358,2330,2487,4817
00769000,KANKAKEE COMMUNITY COLLEGE              ,IL,60901-6505,Public       ,90,363,453,1713,3373,5086
00769100,MCHENRY COUNTY COLLEGE                  ,IL,60012-2761,Public       ,165,312,477,2396,2505,4901
00769200,MORAINE VALLEY COMMUNITY COLLEGE        ,IL,60465-0937,Public       ,356,653,1009,6866,6781,13647
00769300,SHAWNEE COMMUNITY COLLEGE               ,IL,62992-9725,Public       ,39,114,153,860,1289,2149
00769400,COLLEGE OF LAKE COUNTY                  ,IL,60030-1198,Public       ,342,817,1159,4724,6535,11259
00793700,MS ROBERTS ACADEMY OF BEAUTY CULT       ,IL,60181-2930,Proprietary  ,4,13,17,26,83,109
00807600,JOHN A LOGAN COLLEGE                    ,IL,62918-2500,Public       ,127,353,480,2281,3018,5299
00809003,EVEREST COLLEGE - BEDFORD PARK          ,IL,60629-5819,Proprietary  ,6,19,25,17,94,111
00814604,EVEREST UNIVERSITY - EVEREST  COLLEGE   ,IL,60803-4517,Proprietary  ,23,121,144,138,621,759
00825900,EDUCATORS OF BEAUTY                     ,IL,61081-3611,Proprietary  ,3,22,25,47,165,212
00825901,EDUCATORS OF BEAUTY                     ,IL,61104-0000,Proprietary  ,2,15,17,25,104,129
00832800,ALVAREITA'S COLLEGE OF COSMETOLOGY      ,IL,62025-2041,Proprietary  ,3,16,19,36,123,159
00854500,ROCKFORD BUSINESS COLLEGE               ,IL,61103-0000,Proprietary  ,19,108,127,215,1062,1277
00869402,RASMUSSEN COLLEGE - ROCKFORD            ,IL,61108-2513,Proprietary  ,22,166,188,318,1648,1966
00869403,RASMUSSEN COLLEGE - AURORA              ,IL,60506-6219,Proprietary  ,17,80,97,208,716,924
00869404,RASMUSSEN COLLEGE - ROMEOVILLE          ,IL,60446-0000,Proprietary  ,17,85,102,169,731,900
00869418,RASMUSSEN COLLEGE -  MOKENA             ,IL,60448-0000,Proprietary  ,2,50,52,58,295,353
00888000,MORRISON INSTITUTE OF TECHNOLOGY        ,IL,61270-2959,Private      ,1,4,5,95,42,137
00893800,GRAHAM HOSPITAL SCH OF NURSING          ,IL,61520-2497,Private      ,2,7,9,31,107,138
00893900,CANNELLA SCHOOL OF HAIR DESIGN          ,IL,60406-2130,Proprietary  ,6,9,15,40,121,161
00914500,GOVERNORS STATE UNIVERSITY              ,IL,60466-0975,Public       ,59,458,517,1195,7225,8420
00923200,CATHOLIC THEOLOGICAL UNION              ,IL,60615-0000,Private      ,0,6,6,4,74,78
00933300,UNIV OF ILLINOIS AT SPRINGFIELD         ,IL,62703-5407,Public       ,51,228,279,2331,3388,5719
00947500,EDUCATORS OF BEAUTY                     ,IL,61301-2404,Proprietary  ,5,15,20,21,61,82
00959500,CANNELLA SCHOOL OF HAIR DESIGN          ,IL,60617-4303,Proprietary  ,4,27,31,44,173,217
00976700,OLIVE-HARVEY COLLEGE                    ,IL,60628-1696,Public       ,115,457,572,1862,4917,6779
00978600,IL EASTERN COMM COLGS-LINCOLN TRAIL     ,IL,62454-5708,Public       ,13,49,62,354,473,827
00980000,RUSH UNIVERSITY                         ,IL,60612-3806,Private      ,8,105,113,257,3224,3481
00989600,OAKTON COMMUNITY COLLEGE                ,IL,60016-1268,Public       ,206,433,639,3665,3850,7515
00998700,SAINT ANTHONY COLLEGE OF NURSING        ,IL,61108-2468,Private      ,7,22,29,151,378,529
01002000,LEWIS AND CLARK COMMUNITY COLLEGE       ,IL,62035-2466,Public       ,144,388,532,2274,3377,5651
01031600,LINCOLN COLLEGE OF TECHNOLOGY           ,IL,60160-1605,Proprietary  ,47,127,174,844,895,1739
01050100,LAKEVIEW  COLLEGE OF NURSING            ,IL,61832-3781,Private      ,6,13,19,181,264,445
01069500,TRI-COUNTY BEAUTY ACADEMY               ,IL,62056-2036,Proprietary  ,2,5,7,15,42,57
01071000,CAPITAL AREA SCH OF PRAC NRSG           ,IL,62707-0000,Public       ,5,50,55,90,569,659
01072700,DEVRY UNIVERSITY                        ,IL,60618-5994,Proprietary  ,1341,8249,9590,20550,93088,113638
01083600,PIVOT POINT INTNL CSMTLGY RSRCH CTR     ,IL,60626-0000,Proprietary  ,33,65,98,394,570,964
01087900,RICHLAND COMMUNITY COLLEGE              ,IL,62521-8513,Public       ,75,324,399,1029,2504,3533
01102401,EVEREST COLLEGE - CHICAGO               ,IL,60604-2052,Proprietary  ,44,168,212,566,1521,2087
01151002,EVEREST INSTITUTE - EVEREST COLLEGE     ,IL,60542-1610,Proprietary  ,34,102,136,140,550,690
01181000,TAYLOR BUSINESS INSTITUTE               ,IL,60606-5111,Proprietary  ,9,51,60,39,216,255
01185204,ITT TECHNICAL INSTITUTE - ORLAND PARK CA,IL,60467-4900,Proprietary  ,0,0,0,1,0,1
01185800,EVEREST COLLEGE                         ,IL,60077-1074,Proprietary  ,63,251,314,372,1256,1628
01185802,EVEREST COLLEGE - BURR RIDGE            ,IL,60527-7826,Proprietary  ,25,73,98,134,369,503
01185803,EVEREST COLLEGE - MELROSE PARK          ,IL,60160-1526,Proprietary  ,7,24,31,30,97,127
01236200,NORTHWESTERN COLLEGE                    ,IL,60630-2298,Proprietary  ,85,260,345,1910,4176,6086
01238500,BLOOMINGTON-NORMAL SCH RADIOGRAPHY      ,IL,61761-4604,Private      ,1,7,8,14,54,68
01258400,ILLINOIS INSTITUTE OF ART (THE)         ,IL,60654-1593,Proprietary  ,527,462,989,6008,4820,10828
01281300,JOHN WOOD COMMUNITY COLLEGE             ,IL,62305-0401,Public       ,52,193,245,1189,1583,2772
01308700,CAPRI GARFIELD RIDGE SCH OF BTY CLR     ,IL,60629-1613,Proprietary  ,4,25,29,71,212,283
01308800,CAPRI OAK FOREST COLLEGE OF BEAUTY      ,IL,60452-2798,Proprietary  ,20,21,41,126,205,331
02055200,HARRINGTON COLLEGE OF DESIGN            ,IL,60606-3433,Proprietary  ,24,65,89,518,775,1293
02068100,ADLER SCH OF PROFESSIONAL PSYCHLGY      ,IL,60601-0000,Private      ,5,58,63,64,1411,1475
02069300,VATTEROTT COLLEGE                       ,IL,62305-5938,Proprietary  ,11,49,60,114,476,590
02073200,TELSHE YESHIVA-CHICAGO                  ,IL,60625-0000,Private      ,4,2,6,40,8,48
02074400,IL EASTERN COMM COLGS-FRONTIER          ,IL,62837-0000,Public       ,8,54,62,219,435,654
02075400,KELLER GRADUATE SCHOOL OF MGMT.         ,IL,60515-5683,Proprietary  ,7,1802,1809,79,20588,20667
02113600,AMERICAN INTERCONTINENTAL UNIVERSITY    ,IL,60192-3713,Proprietary  ,275,4392,4667,1852,31390,33242
02117400,BECK AREA CAREER CENTER                 ,IL,62278-0000,Public       ,1,32,33,29,202,231
02124400,UNIVERSITY OF SPA & COSMETOLOGY ART     ,IL,62704-0000,Proprietary  ,9,24,33,123,198,321
02150600,COSMETOLOGY AND SPA INSTITUTE (THE)     ,IL,60014-4003,Proprietary  ,10,27,37,76,215,291
02155300,THE CHICAGO SCHOOL OF PROF PSYCHOLOGY   ,IL,60610-4705,Private      ,1,294,295,48,5247,5295
02160300,INTERNATIONAL ACAD OF DESIGN & TECH     ,IL,60602-3319,Proprietary  ,30,78,108,632,902,1534
02160304,INTERNATIONAL ACADEMY OF DESIGN AND TECH,IL,60173-5160,Proprietary  ,9,10,19,142,168,310
02168600,EAST WEST UNIVERSITY                    ,IL,60605-0000,Private      ,23,88,111,966,1758,2724
02179900,ARGOSY UNIVERSITY                       ,IL,60601-7757,Proprietary  ,1561,6515,8076,10319,48512,58831
02185400,ST AUGUSTINE COLLEGE                    ,IL,60640-0000,Private      ,29,189,218,657,2267,2924
02192400,MR JOHNS SCHOOL OF COSMETOLOGY          ,IL,62521-0000,Proprietary  ,3,17,20,19,96,115
02202600,CANNELLA SCHOOL OF HAIR DESIGN          ,IL,60181-1321,Proprietary  ,1,15,16,18,102,120
02214100,RESURRECTION UNIVERSITY                 ,IL,60302-2519,Private      ,4,37,41,127,590,717
02228100,MAC DANIEL'S BEAUTY SCHOOL              ,IL,60640-0000,Proprietary  ,3,17,20,28,97,125
02261200,HAIR PROFESSIONALS ACAD COSMETOLOGY     ,IL,60118-0000,Proprietary  ,5,42,47,43,227,270
02261201,HAIR PROFESSIONALS ACADEMY OF COSMETOLOG,IL,60118-9333,Proprietary  ,0,1,1,9,15,24
02262100,HAIR PROFESSIONALS SCH COSMETOLOGY      ,IL,60543-0000,Proprietary  ,9,15,24,48,104,152
02291200,CANNELLA SCHOOL OF HAIR DESIGN          ,IL,60639-0000,Proprietary  ,10,37,47,85,240,325
02295500,CANNELLA SCHOOL OF HAIR DESIGN          ,IL,60120-0000,Proprietary  ,5,12,17,23,78,101
02297500,OEHRLEIN SCHOOL OF COSMETOLOGY          ,IL,61611-0000,Proprietary  ,7,21,28,46,113,159
02312300,LA' JAMES COLLEGE HAIRSTYLING           ,IL,61244-0000,Proprietary  ,6,14,20,25,61,86
02313900,WESTWOOD COLLEGE - O'HARE AIRPORT       ,IL,60631-2801,Proprietary  ,43,122,165,502,1106,1608
02317300,CONCEPT COLLEGE OF COSMETOLOGY          ,IL,61832-0000,Proprietary  ,12,18,30,55,95,150
02319200,LAKE FOREST GRAD SCHL OF MGMT           ,IL,60045-4824,Private      ,0,43,43,2,340,342
02323300,PROFESSIONAL'S CHOICE HAIR DSN ACAD     ,IL,60435-0000,Proprietary  ,3,14,17,28,78,106
02332200,HAIR PROFESSIONALS CAREER COLLEGE       ,IL,60178-0000,Proprietary  ,4,16,20,28,75,103
02337800,THE COLLEGE OF OFFICE TECHNOLOGY        ,IL,60622-0000,Proprietary  ,20,92,112,124,473,597
02349400,ALVAREITA'S COLLEGE OF COSMETOLOGY      ,IL,62035-0000,Proprietary  ,3,16,19,28,76,104
02349500,CANNELLA SCHOOL OF HAIR DESIGN          ,IL,60632-0000,Proprietary  ,5,44,49,69,189,258
02352200,LE CORDON BLEU COLLEGE OF CULINARY ARTS ,IL,60610-3050,Proprietary  ,75,244,319,1088,1763,2851
02498200,G SKIN & BEAUTY INSTITUTE               ,IL,60523-1805,Proprietary  ,20,45,65,78,260,338
02498201,HAIR PROFESSIONALS ACADEMY OF COSMETOLOG,IL,60563-0000,Proprietary  ,4,5,9,18,36,54
02522800,FOX COLLEGE                             ,IL,60453-0000,Proprietary  ,24,39,63,529,507,1036
02527600,LEXINGTON COLLEGE                       ,IL,60607-0000,Private      ,2,10,12,95,77,172
02536700,BELL MAR BEAUTY COLLEGE                 ,IL,60650-0000,Proprietary  ,4,24,28,28,102,130
02556100,ENVIRONMENTAL TECHNICAL INSTITUTE       ,IL,60143-0000,Proprietary  ,22,109,131,87,361,448
02556600,NILES SCHOOL OF COSMETOLOGY             ,IL,60714-0000,Proprietary  ,1,9,10,17,65,82
02573700,INSTITUTE FOR CLINICAL SOCIAL WORK      ,IL,60605-1229,Private      ,0,20,20,24,200,224
02579200,INGALLS MEMORIAL HOSPITAL               ,IL,60426-0000,Private      ,1,5,6,12,66,78
02584900,"FIRST INSTITUTE, INC.                   ",IL,60014-7489,Proprietary  ,17,42,59,86,299,385
02587700,HAIR PROFESSIONALS CAREER COLLEGE       ,IL,60465-1929,Proprietary  ,6,28,34,42,120,162
02599500,HANOVER PARK COLLEGE OF BEAUTY CULT     ,IL,60133-5421,Proprietary  ,7,9,16,65,105,170
02622700,KNOWLEDGE SYSTEMS INSTITUTE             ,IL,60076-0000,Private      ,0,0,0,0,10,10
03002000,HAIRMASTERS INST OF COSMETOLOGY         ,IL,61701-5547,Proprietary  ,5,10,15,34,99,133
03027702,PACIFIC COLLEGE OF ORIENTAL MEDICINE - C,IL,60613-4418,Proprietary  ,4,56,60,16,365,381
03065300,TREND SETTERS COLL OF COSMETOLOGY       ,IL,60915-2101,Proprietary  ,37,37,74,220,253,473
03072701,WESTWOOD COLLEGE OF TECHNOLOGY          ,IL,60409-0000,Proprietary  ,16,93,109,246,1004,1250
03072702,WESTWOOD COLLEGE OF TECHNOLOGY          ,IL,60602-0000,Proprietary  ,24,150,174,501,1438,1939
03078400,CAMEO BEAUTY ACADEMY                    ,IL,60453-3196,Proprietary  ,12,7,19,56,98,154
03079200,WESTWOOD COLLEGE - DUPAGE               ,IL,60517-2321,Proprietary  ,28,60,88,402,614,1016
03082900,ROSEL SCHOOL OF COSMETOLOGY             ,IL,60659-1913,Proprietary  ,1,31,32,39,142,181
03083800,HEARTLAND COMMUNITY COLLEGE             ,IL,61761-9446,Public       ,146,336,482,2512,3019,5531
03098000,ST JOHN'S COLLEGE OF NURSING            ,IL,62702-5321,Private      ,2,15,17,155,184,339
03098002,ST JOHN'S HOSP SCH MED TECH             ,IL,62769-5324,Private      ,0,9,9,8,49,57
03099700,CAIN'S BARBER COLLEGE                   ,IL,60615-3510,Proprietary  ,18,69,87,125,405,530
03099800,ILLINOIS SCHOOL OF HEALTH CAREERS       ,IL,60604-0000,Proprietary  ,42,191,233,356,1120,1476
03101800,ILLINOIS CENTER FOR BROADCASTING        ,IL,60148-7015,Proprietary  ,24,81,105,154,468,622
03128300,PYRAMID CAREER INSTITUTE                ,IL,60657-4207,Proprietary  ,0,0,0,0,7,7
03128500,NATIONAL LATINO EDUCATION INSTITUTE     ,IL,60609-2205,Private      ,4,17,21,31,113,144
03199300,CHRISTIAN LIFE COLLEGE                  ,IL,60056-2522,Private      ,0,8,8,21,41,62
03368300,MIDWEST TECHNICAL INSTITUTE             ,IL,62707-8805,Proprietary  ,119,571,690,600,2409,3009
03416300,COMPUTER SYSTEMS INSTITUTE              ,IL,60077-0000,Proprietary  ,61,301,362,281,1364,1645
03448300,BUSINESS INDUSTRIAL RESOURCES           ,IL,60659-1298,Proprietary  ,22,411,433,192,1869,2061
03455700,CORTIVA INSTITUTE - CHICAGO             ,IL,60602-3315,Proprietary  ,35,76,111,186,510,696
03455701,CORTIVA INSTITUTE - CHICAGO             ,IL,60014-6285,Proprietary  ,2,3,5,12,42,54
03510300,ERIKSON INSTITUTE                       ,IL,60654-4510,Private      ,0,27,27,5,352,357
03623300,VEE'S SCHOOL OF BEAUTY CULTURE          ,IL,62205-2326,Proprietary  ,0,0,0,1,6,7
03643300,"MR. JOHN'S SCHOOL OF JACKSONVILLE,  INC,",IL,62650-3488,Proprietary  ,1,18,19,8,44,52
03655300,ILLINOIS CAREERPATH INSTITUTE           ,IL,60610-4705,Private      ,1,26,27,9,93,102
03684300,NORTHSHORE UNIVERSITY HEALTHSYSTEM SCHOO,IL,60201-9872,Private      ,1,3,4,5,61,66
03721400,AMERICAN CAREER COLLEGE                 ,IL,60402-0000,Proprietary  ,0,0,0,29,67,96
03881400,EUROPEAN MASSAGE THERAPY SCHOOL         ,IL,60077-2269,Proprietary  ,4,32,36,28,160,188
03891300,SOMA INSTITUTE - THE NATIONAL SCHOOL OF ,IL,60604-4466,Proprietary  ,26,60,86,92,300,392
03914300,"CALC, INSTITUTE OF TECHNOLOGY           ",IL,62002-5931,Proprietary  ,5,23,28,48,244,292
04117500,SOLEX MEDICAL ACADEMY                   ,IL,60090-3104,Proprietary  ,0,10,10,11,45,56
04117600,LARRY'S BARBER COLLEGE                  ,IL,60628-2322,Proprietary  ,17,63,80,40,138,178
04118400,ZAREM /GOLDE ORT TECHNICAL INSTITUTE    ,IL,60077-3210,Private      ,11,73,84,40,401,441
04124700,AMERICARE INSTITUTE                     ,IL,60133-5456,Proprietary  ,9,74,83,122,799,921
04136900,UNIVERSITY OF AESTHETICS (THE)          ,IL,60622-2151,Proprietary  ,3,8,11,11,58,69
04137000,UNIVERSITY OF AESTHETICS (THE)          ,IL,60515-5602,Proprietary  ,1,4,5,2,26,28
04137500,TRICOCI UNIVERSITY OF BEAUTY CULTURE    ,IL,60656-1805,Proprietary  ,19,37,56,170,294,464
04139000,CITI COLLEGE OF ALLIED HEALTH           ,IL,60602-1032,Proprietary  ,6,89,95,78,548,626
04141000,AVEDA INSTITUTE CHICAGO                 ,IL,60647-0000,Proprietary  ,18,43,61,188,317,505
04147100,TRICOCI UNIVERSITY OF BEAUTY CULTURE    ,IL,60048-2906,Proprietary  ,14,23,37,106,164,270
04147200,TRICOCI UNIVERSITY OF BEAUTY CULTURE    ,IL,60455-1824,Proprietary  ,10,23,33,72,194,266
04147300,TRICOCI UNIVERSITY OF BEAUTY CULTURE    ,IL,60139-3119,Proprietary  ,11,15,26,75,124,199
04147400,TRICOCI UNIVERSITY OF BEAUTY CULTURE    ,IL,61614-4831,Proprietary  ,6,21,27,47,115,162
04147500,TRICOCI UNIVERSITY OF BEAUTY CULTURE    ,IL,61108-2337,Proprietary  ,6,32,38,78,250,328
04160600,PAUL MITCHELL THE SCHOOL NORMAL         ,IL,61761-0000,Proprietary  ,9,22,31,178,207,385
04167800,INNOVATIONS DESIGN ACADEMY              ,IL,61520-2625,Proprietary  ,1,9,10,22,43,65
04168500,SOLEX COLLEGE                           ,IL,60090-3192,Proprietary  ,1,22,23,4,103,107
04170800,UNITY COSMETOLOGY COLLEGE               ,IL,61764-9652,Proprietary  ,0,6,6,14,49,63
04171600,SALON PROFESSIONAL ACADEMY OF ELGIN (THE,IL,60123-2319,Proprietary  ,5,17,22,26,54,80
04172200,NORTHWESTERN INSTITUTE OF HEALTH AND TEC,IL,60640-4785,Private      ,13,72,85,31,234,265
04174900,SKIN CARE AND SPA INSTITUTE             ,IL,60077-2200,Proprietary  ,1,23,24,13,158,171
04175000,UNIVERSAL SPA TRAINING ACADEMY          ,IL,60515-0000,Proprietary  ,1,14,15,17,120,137
04175800,J RENEE CAREER FACILITATION             ,IL,60014-7986,Proprietary  ,4,16,20,8,69,77
04186000,CHICAGO SCHOOL FOR PIANO TECHNOLOGY (THE,IL,60612-1630,Private      ,0,5,5,1,10,11
04187400,COSMETOLOGY CONCEPTS                    ,IL,60452-2501,Proprietary  ,13,42,55,38,107,145
04189200,SALON PROFESSIONAL ACADEMY (THE)        ,IL,60404-8789,Proprietary  ,2,14,16,22,35,57
04189400,SHEAR LEARNING ACADEMY OF COSMETOLOGY   ,IL,62523-1208,Proprietary  ,2,11,13,2,11,13
04189600,STATE CAREER SCHOOL                     ,IL,60085-5129,Proprietary  ,2,14,16,4,38,42
00195100,ALICE LLOYD COLLEGE                     ,KY,41844-9703,Private      ,15,7,22,1007,206,1213
00195200,ASBURY COLLEGE                          ,KY,40390-1198,Private      ,30,58,88,1664,653,2317
00195300,ASBURY THEOLOGICAL SEMINARY             ,KY,40390-0000,Private      ,0,46,46,18,1373,1391
00195400,BELLARMINE UNIVERSITY                   ,KY,40205-1877,Private      ,82,168,250,4259,1959,6218
00195500,BEREA COLLEGE                           ,KY,40403-0000,Private      ,67,47,114,2950,889,3839
00195800,BRESCIA UNIVERSITY                      ,KY,42301-3023,Private      ,15,57,72,839,735,1574
00195900,CAMPBELLSVILLE UNIVERSITY               ,KY,42718-2799,Private      ,65,174,239,2604,2001,4605
00196000,SPALDING UNIVERSITY                     ,KY,40203-2188,Private      ,43,198,241,1030,3187,4217
00196100,CENTRE COLLEGE                          ,KY,40422-1394,Private      ,30,13,43,2457,194,2651
00196200,UNIVERSITY OF THE CUMBERLANDS           ,KY,40769-1372,Private      ,52,250,302,2445,2357,4802
00196300,EASTERN KENTUCKY UNIVERSITY             ,KY,40475-3102,Public       ,339,734,1073,13092,10387,23479
00196400,GEORGETOWN COLLEGE                      ,KY,40324-1628,Private      ,43,80,123,2433,949,3382
00196500,KENTUCKY CHRISTIAN UNIVERSITY           ,KY,41143-2205,Private      ,13,11,24,797,198,995
00196800,KENTUCKY STATE UNIVERSITY               ,KY,40601-2355,Public       ,94,138,232,3960,2322,6282
00196900,KENTUCKY WESLEYAN COLLEGE               ,KY,42301-6057,Private      ,26,28,54,1305,372,1677
00197000,LEES COLLEGE                            ,KY,41339-0000,Private      ,0,0,0,0,1,1
00197100,LEXINGTON THEOLOGICAL SEMINARY          ,KY,40508-0000,Private      ,0,9,9,5,68,73
00197200,LINDSEY WILSON COLLEGE                  ,KY,42728-1223,Private      ,55,126,181,2863,1938,4801
00197400,LOUISVILLE PRESBYTERIAN THEOL SEM       ,KY,40205-0000,Private      ,0,6,6,12,168,180
00197500,MIDWAY COLLEGE                          ,KY,40347-1120,Private      ,19,231,250,728,2574,3302
00197600,MOREHEAD STATE UNIVERSITY               ,KY,40351-1689,Public       ,180,420,600,6809,5859,12668
00197700,MURRAY STATE UNIVERSITY                 ,KY,42071-0009,Public       ,182,338,520,7259,4512,11771
00197900,WEST KENTUCKY CMNTY & TECHNICAL COLG    ,KY,42002-7380,Public       ,123,510,633,1980,4448,6428
00198000,PIKEVILLE COLLEGE                       ,KY,41501-1194,Private      ,32,52,84,1997,715,2712
00198001,PIKEVILLE CLG-SCH OSTEOPATHIC MEDIC     ,KY,41501-0000,Private      ,0,0,0,20,351,371
00198300,ST. CATHARINE COLLEGE                   ,KY,40061-9499,Private      ,22,35,57,840,564,1404
00198700,TRANSYLVANIA UNIVERSITY                 ,KY,40508-1797,Private      ,23,25,48,1823,292,2115
00198800,UNION COLLEGE                           ,KY,40906-1499,Private      ,25,98,123,1310,1119,2429
00198900,UNIVERSITY OF KENTUCKY                  ,KY,40506-0054,Public       ,507,562,1069,20691,10516,31207
00198901,UNIV OF KY-COLLEGE OF DENTISTRY         ,KY,40536-0000,Public       ,0,4,4,19,255,274
00198902,UNIV OF KY-COLLEGE OF MEDICINE          ,KY,40536-0000,Public       ,2,14,16,64,565,629
00199000,ASHLAND COMMUNITY AND TECHNICAL COLLEGE ,KY,41101-3683,Public       ,73,405,478,1620,3250,4870
00199100,ELIZABETHTOWN COMMUNITY  AND TECHNICAL C,KY,42701-3081,Public       ,146,697,843,2716,6517,9233
00199300,HENDERSON COMMUNITY COLLEGE             ,KY,42420-4699,Public       ,31,149,180,588,1674,2262
00199400,HOPKINSVILLE COMMUNITY COLLEGE          ,KY,42241-2621,Public       ,89,526,615,1257,4600,5857
00199600,BIG SANDY COMMUNITY AND TECHNICAL COLG  ,KY,41653-1815,Public       ,76,308,384,2011,3064,5075
00199700,SOMERSET COMMUNITY COLLEGE              ,KY,42501-2973,Public       ,188,988,1176,3395,8709,12104
00199800,SOUTHEAST KENTUCKY COMMUNITY AND TECHNIC,KY,40823-1099,Public       ,55,192,247,1335,2079,3414
00199900,UNIVERSITY OF LOUISVILLE                ,KY,40292-0000,Public       ,396,740,1136,14587,13492,28079
00200100,THOMAS MORE COLLEGE                     ,KY,41017-3495,Private      ,23,93,116,1523,934,2457
00200200,WESTERN KENTUCKY UNIVERSITY             ,KY,42101-3576,Public       ,435,744,1179,15669,11057,26726
00461800,SPENCERIAN COLLEGE                      ,KY,40216-2605,Proprietary  ,37,197,234,726,2333,3059
00461900,SULLIVAN UNIVERSITY                     ,KY,40205-3000,Proprietary  ,120,625,745,2422,6835,9257
00524400,BLUEGRASS COMMUNITY & TECHNICAL COLLEGE ,KY,40506-0235,Public       ,327,1237,1564,5939,12447,18386
00527100,BOWLING GREEN TECHNICAL COLLEGE         ,KY,42101-3601,Public       ,103,446,549,1390,4148,5538
00527300,GATEWAY COMMUNITY & TECHNOLOGY COLL     ,KY,41011-0000,Public       ,119,507,626,1507,4859,6366
00696000,MAYSVILLE CMNTY & TECHNCL COLG          ,KY,41056-8910,Public       ,78,340,418,1229,3446,4675
00696100,JEFFERSON COMMUNITY AND TECHNICAL COLLEG,KY,40202-2005,Public       ,500,1799,2299,6833,15313,22146
00696200,HAZARD COMMUNITY COLLEGE                ,KY,41701-2402,Public       ,65,262,327,1464,2595,4059
00696203,KY TECH-KNOTT CO. TECHNOLOGY CTR        ,KY,41822-0000,Public       ,0,0,0,7,6,13
00696204,KY TECH-LESLIE COUNTY AREA TECH CTR     ,KY,41749-0000,Public       ,0,1,1,1,5,6
00696205,KY TECH-LEE COUNTY AREA TECH CTR        ,KY,41311-0000,Public       ,0,0,0,1,6,7
00696206,KY TECH-LETCHER CNTY AREA TECH CTR      ,KY,41858-0000,Public       ,1,7,8,18,42,60
00696207,KY TECH-BREATHITT COUNTY VOC ED CTR     ,KY,41339-0000,Public       ,1,5,6,7,27,34
00736205,MEDTECH COLLEGE - LEXINGTON             ,KY,40511-1200,Proprietary  ,15,96,111,107,757,864
00842500,DAYMAR COLLEGE                          ,KY,42001-0000,Proprietary  ,10,43,53,61,528,589
00901000,MADISONVILLE COMMUNITY COLLEGE          ,KY,42431-9199,Public       ,57,293,350,1214,2811,4025
00927500,NORTHERN KENTUCKY UNIVERSITY            ,KY,41099-0001,Public       ,237,518,755,10290,8552,18842
00931300,DAYMAR COLLEGE                          ,KY,42301-5830,Proprietary  ,35,226,261,309,2937,3246
01042400,SALON PROFESSIONAL ACADEMY THE          ,KY,40502-1776,Proprietary  ,10,44,54,89,298,387
01048901,NATIONAL COLLEGE - FLORENCE CAMPUS      ,KY,41042-1812,Proprietary  ,3,24,27,34,281,315
01048902,NATIONAL COLLEGE - PIKEVILLE CAMPUS     ,KY,41501-1518,Proprietary  ,9,36,45,106,369,475
01048903,NATIONAL COLLEGE - DANVILLE CAMPUS      ,KY,40422-1517,Proprietary  ,2,34,36,40,424,464
01048904,NATIONAL COLLEGE - RICHMOND CAMPUS      ,KY,40475-2309,Proprietary  ,7,51,58,55,331,386
01048906,NATIONAL COLLEGE - LOUISVILLE CAMPUS    ,KY,40216-4147,Proprietary  ,10,68,78,147,1029,1176
01048907,NATIONAL COLLEGE - LEXINGTON CAMPUS     ,KY,40509-2256,Proprietary  ,7,63,70,103,865,968
01172500,COLLINS SCHOOL OF COSMETOLOGY           ,KY,40965-2809,Proprietary  ,2,11,13,21,78,99
01208800,SULLIVAN COLLEGE OF TECHNOLOGY AND DESIG,KY,40218-4528,Proprietary  ,32,127,159,585,1156,1741
01212801,SOUTHWESTERN COLLEGE                    ,KY,41042-1466,Proprietary  ,14,60,74,136,609,745
01272300,KY TECH-WAYNE COUNTY AREA TECH CTR      ,KY,42633-1088,Public       ,0,2,2,0,9,9
01291400,EMPIRE BEAUTY SCHOOL                    ,KY,40218-0000,Proprietary  ,5,44,49,113,420,533
01291500,EMPIRE BEAUTY SCHOOL                    ,KY,41042-5113,Proprietary  ,3,23,26,75,232,307
01291600,EMPIRE BEAUTY SCHOOL                    ,KY,40216-4212,Proprietary  ,7,26,33,39,227,266
01291700,EMPIRE BEAUTY SCHOOL                    ,KY,40160-0000,Proprietary  ,8,31,39,90,248,338
01296800,EMPIRE BEAUTY SCHOOL                    ,KY,40207-2695,Proprietary  ,4,10,14,54,151,205
02159100,"APPALACHIAN BEAUTY SCHOOL, INC.         ",KY,41503-0000,Proprietary  ,2,6,8,27,45,72
02177100,EMPIRE BEAUTY SCHOOL                    ,KY,40204-0000,Proprietary  ,7,35,42,85,307,392
02251500,TREND SETTERS ACAD OF BEAUTY CULT       ,KY,40258-0000,Proprietary  ,11,56,67,65,273,338
02275000,JENNY LEA ACADEMY OF COSMETOLOGY        ,KY,40831-0000,Proprietary  ,11,51,62,112,348,460
02284306,INTERACTIVE LEARNING SYSTEMS            ,KY,41042-0000,Proprietary  ,0,15,15,13,70,83
02323700,PAT WILSON'S BEAUTY COLLEGE             ,KY,42420-0000,Proprietary  ,0,6,6,7,68,75
02337200,PJ'S COLLEGE OF COSMETOLOGY             ,KY,42101-0000,Proprietary  ,9,62,71,128,575,703
02340800,PAUL MITCHELL THE SCHOOL LEXINGTON      ,KY,40514-1545,Proprietary  ,20,48,68,159,304,463
02351700,PAUL MITCHELL THE SCHOOL - LOUISVILLE   ,KY,40222-0000,Proprietary  ,13,26,39,176,313,489
02491100,BECKFIELD COLLEGE                       ,KY,41042-0000,Proprietary  ,30,207,237,311,2324,2635
02518900,BARRETT & COMPANY SCH HAIR DESIGN       ,KY,40356-0000,Proprietary  ,2,28,30,33,176,209
02526100,JENNY LEA ACADEMY OF COSMETOLOGY        ,KY,41858-0000,Proprietary  ,1,4,5,19,39,58
02535600,CLEAR CREEK BAPTIST BIBLE COLLEGE       ,KY,40977-0000,Private      ,5,10,15,42,165,207
02551100,PJ'S COLLEGE OF COSMETOLOGY             ,KY,42141-2434,Proprietary  ,1,13,14,35,128,163
02560800,SOUTHEAST SCHOOL OF COSMETOLOGY         ,KY,40962-0000,Proprietary  ,1,12,13,21,74,95
02576200,MID-CONTINENT UNIVERSITY                ,KY,42066-9007,Private      ,18,200,218,396,3667,4063
03002100,KENTUCKY MOUNTAIN BIBLE COLLEGE         ,KY,41385-0010,Private      ,4,1,5,47,35,82
03007000,FRONTIER SCH OF MIDWIFERY&FAMILY NU     ,KY,41749-0000,Private      ,0,172,172,4,1598,1602
03026200,HEAD'S WEST KENTUCKY BEAUTY COLLEGE     ,KY,42431-0000,Proprietary  ,1,9,10,20,58,78
03029200,NU-TEK ACADEMY OF BEAUTY                ,KY,40353-9767,Proprietary  ,1,8,9,14,59,73
03034500,OWENSBORO COMMUNITY & TECHNICAL COLLEGE ,KY,42303-1899,Public       ,83,359,442,1696,3409,5105
03083700,GALEN HEALTH INSTITUTES                 ,KY,40207-1047,Proprietary  ,74,491,565,821,4764,5585
03103500,MR JIM'S BEAUTY COLLEGE                 ,KY,42301-2646,Proprietary  ,3,9,12,19,66,85
03516500,EZELL'S COSMETOLOGY SCHOOL              ,KY,42071-2530,Proprietary  ,3,9,12,32,82,114
03611300,BRIGHTON CENTER'S CENTER FOR EMPLOY     ,KY,41071-1968,Private      ,5,40,45,10,98,108
03804300,BELLEFONTE ACADEMY OF BEAUTY            ,KY,41169-2015,Proprietary  ,6,46,52,31,169,200
03885300,EMPLOYMENT SOLUTIONS                    ,KY,40517-3260,Private      ,5,56,61,39,341,380
03886300,REGENCY SCHOOL OF HAIR DESIGN           ,KY,41653-1278,Proprietary  ,1,16,17,17,84,101
04038300,ATA CAREER EDUCATION                    ,KY,40223-3832,Proprietary  ,19,174,193,228,1233,1461
04051316,ART INSTITUTE OF PHOENIX (THE) - ATS - (,KY,41017-2136,Proprietary  ,30,109,139,150,651,801
04051319,ART INSTITUTE OF PHOENIX (THE) - BROWN M,KY,40219-1916,Proprietary  ,8,36,44,122,434,556
04051320,ART INSTITUTE OF PHOENIX (THE) - BROWN M,KY,42240-3579,Proprietary  ,1,11,12,31,152,183
04123900,LEXINGTON HEALING ARTS ACADEMY          ,KY,40503-1932,Proprietary  ,4,24,28,41,191,232
04177600,LINDSEY INSTITUTE OF COSMETOLOGY        ,KY,42103-8036,Proprietary  ,3,11,14,56,122,178
04177700,TRI-STATE INSTITUTE OF HAIR DESIGN      ,KY,40744-5234,Proprietary  ,6,22,28,10,36,46
04178000,SIMMONS COLLEGE OF KENTUCKY             ,KY,40203-3322,Private      ,2,13,15,18,141,159
00200300,CENTENARY COLLEGE OF LOUISIANA          ,LA,71104-3396,Private      ,30,43,73,1157,365,1522
00200400,DILLARD UNIVERSITY                      ,LA,70122-3097,Private      ,68,108,176,2597,1148,3745
00200500,NICHOLLS STATE UNIVERSITY               ,LA,70310-0001,Public       ,111,236,347,5551,3047,8598
00200600,GRAMBLING STATE UNIVERSITY              ,LA,71245-2215,Public       ,226,291,517,6349,4073,10422
00200700,LOUISIANA COLLEGE                       ,LA,71359-0000,Private      ,19,72,91,1293,892,2185
00200800,LOUISIANA TECH UNIVERSITY               ,LA,71272-0001,Public       ,153,272,425,7054,3486,10540
00201000,LOUISIANA STATE UNIV & A&M COLG         ,LA,70803-5710,Public       ,537,506,1043,23582,8920,32502
00201100,LOUISIANA STATE UNIV-ALEXANDRIA         ,LA,71302-9121,Public       ,67,200,267,1620,2339,3959
00201200,LOUISIANA STATE UNIV-EUNICE             ,LA,70535-6726,Public       ,109,203,312,2204,2088,4292
00201300,LOUISIANA STATE UNIV-SHREVEPORT         ,LA,71115-2399,Public       ,100,316,416,2558,3465,6023
00201400,LA STATE UNIV HEALTH SCIENCES CTR       ,LA,70112-2223,Public       ,19,96,115,531,2419,2950
00201500,(THE) UNIVERSITY OF NEW ORLEANS         ,LA,70148-0001,Public       ,256,720,976,6605,8055,14660
00201600,LOYOLA UNIVERSITY NEW ORLEANS           ,LA,70118-6195,Private      ,134,203,337,4742,3244,7986
00201700,MCNEESE STATE UNIVERSITY                ,LA,70609-4510,Public       ,209,403,612,5747,4509,10256
00201900,NEW ORLEANS BAPTIST THEOL SEMINARY      ,LA,70126-0000,Private      ,1,14,15,47,155,202
00202000,UNIVERSITY OF LOUISIANA AT MONROE       ,LA,71209-9001,Public       ,147,406,553,5885,5135,11020
00202100,NORTHWESTERN STATE UNIVERSITY           ,LA,71497-0001,Public       ,148,544,692,5822,6146,11968
00202200,NOTRE DAME SEMINARY                     ,LA,70118-0000,Private      ,0,4,4,7,23,30
00202300,OUR LADY OF HOLY CROSS COLLEGE          ,LA,70131-7399,Private      ,17,126,143,645,1444,2089
00202400,SOUTHEASTERN LOUISIANA UNIV             ,LA,70402-0001,Public       ,300,570,870,11368,6711,18079
00202500,SOUTHERN UNIVERSITY A & M COLLEGE       ,LA,70813-9374,Public       ,187,409,596,7098,7489,14587
00202600,SOUTHERN UNIV NEW ORLEANS               ,LA,70126-0002,Public       ,71,394,465,1819,4414,6233
00202700,ST JOSEPH SEMINARY COLLEGE              ,LA,70457-9990,Private      ,3,1,4,40,24,64
00202900,TULANE UNIVERSITY                       ,LA,70118-5698,Private      ,260,389,649,12664,8021,20685
00203100,UNIV OF LOUISIANA AT LAFAYETTE          ,LA,70504-0001,Public       ,327,433,760,13213,5982,19195
00203200,XAVIER UNIVERSITY OF LOUISIANA          ,LA,70125-1098,Private      ,115,103,218,5199,2079,7278
00462100,AYERS CAREER COLLEGE                    ,LA,71108-5845,Proprietary  ,5,67,72,72,464,536
00462500,DELGADO COMMUNITY COLLEGE               ,LA,70119-0000,Public       ,756,2524,3280,9266,19826,29092
00546700,SOWELA TECHNICAL COMMUNITY COLLEGE      ,LA,70616-6950,Public       ,141,277,418,1167,1773,2940
00547100,NORTHEAST LOUISIANA TECHNICAL COLLEGE   ,LA,71292-9064,Public       ,29,100,129,256,812,1068
00547101,NORTHEAST LOUISIANA TECHNICAL COLLEGE   ,LA,71241-0000,Public       ,1,6,7,19,95,114
00547102,NORTHEAST LOUISIANA TECHNICAL COLLEGE   ,LA,71270-0000,Public       ,7,40,47,355,424,779
00547103,NORTHEAST LOUISIANA TECHNICAL COLLEGE   ,LA,71295-0000,Public       ,6,27,33,85,260,345
00547104,NORTHEAST LOUISIANA TECHNICAL COLLEGE   ,LA,71220-0000,Public       ,17,42,59,85,197,282
00548800,LOUISIANA TECH COLG-BATON ROUGE         ,LA,70807-0000,Public       ,56,174,230,589,1544,2133
00548804,LOUISIANA TECHNICAL COLLEGE - ASCENSION ,LA,70778-3007,Public       ,0,0,0,17,29,46
00548812,LOUISIANA TECH COLG-FOLKES CAMPUS       ,LA,70748-0000,Public       ,6,10,16,41,100,141
00548817,LOUISIANA TEC CLG-JUMONVILLE MEM CP     ,LA,70760-0000,Public       ,4,18,22,67,173,240
00548823,LA. TECH COLG.-MORGAN SMITH CAMPUS      ,LA,70546-0000,Public       ,5,22,27,65,175,240
00548842,LOUISIANA TECHNICAL COLLEGE - WESTSIDE C,LA,70765-0733,Public       ,1,13,14,52,156,208
00548900,CENTRAL LOUISIANA TECHNICAL COLLEGE     ,LA,71302-3137,Public       ,47,120,167,279,772,1051
00548901,CENTRAL LOUISIANA TECHNICAL COLLEGE     ,LA,71327-3743,Public       ,12,33,45,101,198,299
00548902,CENTRAL LOUISIANA TECHNICAL COLLEGE     ,LA,71483-3563,Public       ,8,32,40,89,248,337
00548903,CENTRAL LOUISIANA TECHNICAL COLLEGE     ,LA,71302-6511,Public       ,9,49,58,103,362,465
00548904,CENTRAL LOUISIANA TECHNICAL COLLEGE     ,LA,71463-3536,Public       ,3,19,22,68,168,236
00548905,CENTRAL LOUISIANA TECHNICAL COLLEGE     ,LA,71334-2232,Public       ,6,23,29,67,238,305
00552600,SOUTH CENTRAL LOUISIANA TECHNICAL COLG  ,LA,70381-2148,Public       ,15,37,52,138,440,578
00552602,SOUTH CENTRAL LOUISIANA TECHNICAL COLG  ,LA,70302-4336,Public       ,10,33,43,137,325,462
00552603,SOUTH CENTRAL LOUISIANA TECHNICAL COLG  ,LA,70084-6632,Public       ,21,102,123,316,639,955
00576100,L. E. FLETCHER TECHNICAL COMMUNITY COLLE,LA,70360-2863,Public       ,69,188,257,953,1532,2485
00675600,NORTHSHORE TECHNICAL COLLEGE            ,LA,70427-5866,Public       ,28,97,125,272,908,1180
00675603,NORTHSHORE TECHNICAL COLLEGE - HAMMOND  ,LA,70401-0000,Public       ,50,124,174,371,864,1235
00675604,NORTHSHORE TECHNICAL COLLEGE - FLORIDA  ,LA,70441-0000,Public       ,14,53,67,133,395,528
00768600,SOUTHERN UNIV AT SHREVEPORT/BOSSIER     ,LA,71107-4795,Public       ,57,308,365,1375,3260,4635
00777707,REMINGTON COLLEGE - CLEVELAND CAMPUS - L,LA,70508-5760,Private      ,10,27,37,120,349,469
00777708,REMINGTON COLLEGE - CLEVELAND CAMPUS - B,LA,70816-4040,Private      ,25,88,113,188,540,728
00806700,LSU HEALTH SCIENCES CENTR-SHREVEPOR     ,LA,71130-3932,Public       ,31,60,91,354,1165,1519
00989800,DEMMON SCHOOL OF BEAUTY                 ,LA,70607-2128,Proprietary  ,1,14,15,18,81,99
00997500,NORTHWEST LOUISIANA TECHNICAL COLLEGE   ,LA,71055-2422,Public       ,19,78,97,215,573,788
00997503,NORTHWEST LOUISIANA TECHNICAL COLLEGE   ,LA,71137-8527,Public       ,30,147,177,310,1399,1709
00997504,NORTHWEST LOUISIANA TECHNICAL COLLEGE   ,LA,71052-1236,Public       ,3,14,17,50,178,228
00997505,NORTHWEST LOUISIANA TECHNICAL COLLEGE   ,LA,71449-0790,Public       ,3,18,21,49,154,203
00997506,NORTHWEST LOUISIANA TECHNICAL COLLEGE   ,LA,71458-0657,Public       ,12,61,73,155,355,510
01005701,AMERICAN COMMERCIAL COLLEGE             ,LA,71105-2502,Proprietary  ,3,30,33,31,238,269
01109700,CLOYD'S BEAUTY SCHOOL #1                ,LA,71291-3131,Proprietary  ,17,38,55,56,186,242
01163100,"D-JAY'S SCHL OF BEAUTY, ARTS & SCI      ",LA,70806-0000,Proprietary  ,7,32,39,58,157,215
01184100,JOHN JAY BEAUTY COLLEGE                 ,LA,70124-2592,Proprietary  ,5,17,22,74,152,226
01282300,PAT GOINS RUSTON BEAUTY SCHOOL          ,LA,71270-4301,Proprietary  ,3,6,9,26,47,73
01287900,PAT GOINS BENTON ROAD BEAUTY SCHOOL     ,LA,71111-4838,Proprietary  ,5,16,21,22,63,85
01288000,PAT GOINS BEAUTY SCHOOL                 ,LA,71201-5167,Proprietary  ,0,3,3,23,60,83
02055400,BOSSIER PARISH COMMUNITY COLLEGE        ,LA,71111-0000,Public       ,206,633,839,3234,5562,8796
02055500,DELTA SCH OF BUSINESS & TECHNOLOGY      ,LA,70601-0000,Proprietary  ,10,52,62,124,492,616
02117800,AVEDA INSTITUTE LAFAYETTE               ,LA,70503-3246,Proprietary  ,15,24,39,132,223,355
02166100,NUNEZ COMMUNITY COLLEGE                 ,LA,70043-0000,Public       ,57,236,293,646,1892,2538
02166200,ITI TECHNICAL COLLEGE                   ,LA,70817-0000,Proprietary  ,61,156,217,433,713,1146
02197500,BATON ROUGE SCHOOL OF COMPUTERS         ,LA,70809-8188,Proprietary  ,5,16,21,42,109,151
02214800,ACADIANA TECHNICAL COLLEGE              ,LA,70506-4109,Public       ,53,163,216,719,1479,2198
02214802,ACADIANA TECHNICAL COLLEGE - ACADIAN    ,LA,70526-4109,Public       ,16,47,63,140,327,467
02214803,ACADIANA TECHNICAL COLLEGE - C.B. COREIL,LA,70586-0000,Public       ,13,23,36,129,268,397
02214804,ACADIANA TECHNICAL COLLEGE - EVANGELINE ,LA,70582-0000,Public       ,6,37,43,69,260,329
02214805,ACADIANA TECHNICAL COLLEGE - GULF AREA  ,LA,70510-0000,Public       ,9,24,33,134,346,480
02214806,ACADIANA TECHNICAL COLLEGE - T.H. HARRIS,LA,70570-0000,Public       ,37,93,130,378,680,1058
02214807,ACADIANA TECHNICAL COLLEGE - TECHE AREA ,LA,70562-0000,Public       ,21,62,83,239,443,682
02234000,CAMERON COLLEGE                         ,LA,70119-0000,Proprietary  ,22,53,75,84,248,332
02258400,AVEDA INSTITUTE BATON ROUGE             ,LA,70816-2246,Proprietary  ,19,38,57,198,255,453
02260200,DIESEL DRIVING ACADEMY                  ,LA,71109-5617,Proprietary  ,16,137,153,66,528,594
02265600,JOHN JAY KENNER ACADEMY                 ,LA,70062-0000,Proprietary  ,4,15,19,40,100,140
02269300,STEVENSON'S ACADEMY OF HAIR DESIGN      ,LA,70116-0000,Proprietary  ,6,31,37,75,183,258
02327800,PINEVILLE BEAUTY SCHOOL                 ,LA,71360-0000,Proprietary  ,5,10,15,38,95,133
02335700,BATON ROUGE GENERAL MEDICAL CENTER      ,LA,70806-3889,Private      ,3,15,18,51,163,214
02335701,BATON ROUGE GEN MED CTR SCH NSG         ,LA,70821-0000,Private      ,7,23,30,71,224,295
02335702,BATON ROUGE GEN MED CTR-RAD TECH        ,LA,70806-0000,Private      ,8,15,23,40,89,129
02338000,"CLOYD'S BEAUTY SCHOOL #2, INC           ",LA,71202-3539,Proprietary  ,18,36,54,50,179,229
02352500,"CLOYD'S BEAUTY SCHOOL #3, INC           ",LA,71201-3211,Proprietary  ,16,35,51,46,171,217
02358600,"STAGE ONE THE HAIR SCHOOL, INC.         ",LA,70605-0000,Proprietary  ,12,26,38,76,142,218
02518300,SOUTH LOUISIANA BEAUTY COLLEGE          ,LA,70363-0000,Proprietary  ,5,14,19,42,73,115
02536400,LOUISIANA ACADEMY OF BEAUTY             ,LA,70535-0000,Proprietary  ,3,7,10,35,61,96
02538300,DELTA COLLEGE OF ARTS & TECH INC        ,LA,70806-1529,Proprietary  ,20,69,89,200,603,803
02538301,DELTA COLLEGE OF ARTS & TECHNOLOGY - LAF,LA,70508-6831,Proprietary  ,4,27,31,83,248,331
02548500,COSMETOLOGY TRAINING CENTER             ,LA,70503-0000,Proprietary  ,14,27,41,77,131,208
02554800,VANGUARD COLLEGE OF COSMETOLOGY         ,LA,70458-8823,Proprietary  ,19,31,50,162,254,416
02582200,"GUY'S ACADEMY HAIR, SKIN & NAILS        ",LA,71105-2404,Proprietary  ,6,29,35,40,186,226
02600900,AVEDA INSTITUTE                         ,LA,70433-2922,Proprietary  ,136,285,421,930,1775,2705
02601000,AMERICAN SCHOOL OF BUSINESS             ,LA,71105-5646,Proprietary  ,10,59,69,34,217,251
02601100,OPELOUSAS SCHOOL OF COSMETOLOGY         ,LA,70570-6156,Proprietary  ,3,5,8,14,42,56
02606800,CAREER TRAINING SPECIALISTS             ,LA,71201-6046,Proprietary  ,27,102,129,350,957,1307
02606801,CAREER TECHNICAL COLLEGE - SHREVEPORT   ,LA,71105-2405,Proprietary  ,21,103,124,213,673,886
02617100,BATON ROUGE COLLEGE                     ,LA,70806-1725,Proprietary  ,6,35,41,135,247,382
02619200,DENHAM SPRINGS BEAUTY COLLEGE           ,LA,70726-3829,Proprietary  ,5,16,21,55,124,179
03010400,CRESCENT CITY SCH GAMING & BARTENDG     ,LA,70119-5507,Proprietary  ,19,200,219,91,705,796
03010624,VIRGINIA COLLEGE - BATON ROUGE          ,LA,70815-8604,Proprietary  ,26,114,140,222,854,1076
03023500,CAMELOT CAREER COLLEGE                  ,LA,70805-7539,Proprietary  ,18,51,69,133,273,406
03030900,DIESEL DRIVING ACADEMY                  ,LA,70815-8109,Proprietary  ,9,110,119,52,471,523
03095100,GRETNA CAREER COLLEGE                   ,LA,70053-2436,Proprietary  ,5,48,53,79,306,385
03106200,OUR LADY OF THE LAKE COLLEGE            ,LA,70808-4345,Private      ,28,205,233,931,2104,3035
03253300,JONESVILLE BEAUTY SCHOOL                ,LA,71343-0000,Proprietary  ,17,24,41,96,149,245
03294300,BLUE CLIFF SCH THERAPEUTIC MASSAGE      ,LA,70002-3458,Proprietary  ,55,248,303,341,1414,1755
03332600,DELTA COLLEGE                           ,LA,70433-9042,Proprietary  ,11,41,52,118,401,519
03332601,DELTA COLLEGE - SLIDELL                 ,LA,70460-2624,Proprietary  ,8,72,80,100,359,459
03356300,MEDICAL TRAINING COLLEGE                ,LA,70816-5820,Proprietary  ,24,62,86,147,372,519
03422500,BLUE CLIFF COLLEGE                      ,LA,71107-6520,Proprietary  ,56,201,257,270,1235,1505
03422600,BLUE CLIFF COLLEGE                      ,LA,70508-3858,Proprietary  ,20,157,177,274,1099,1373
03480300,MEDVANCE INSTITUTE                      ,LA,70809-1908,Proprietary  ,24,118,142,230,758,988
03498400,OMEGA INSTITUTE OF COSMETOLOGY          ,LA,70360-0000,Proprietary  ,4,12,16,45,69,114
03727500,MOORE CAREER COLLEGE                    ,LA,70808-4191,Proprietary  ,3,7,10,17,62,79
03730300,BATON ROUGE COMMUNITY COLLEGE           ,LA,78806-4129,Public       ,411,853,1264,5950,7655,13605
03752400,SCHOOL OF URBAN MISSIONS                ,LA,70053-0000,Private      ,10,16,26,156,244,400
03789300,UNITECH TRAINING ACADEMY                ,LA,70503-5132,Proprietary  ,24,67,91,123,339,462
03789301,UNITECH TRAINING ACADEMY - WEST MONROE  ,LA,71291-2913,Proprietary  ,13,48,61,74,270,344
03789302,UNITECH TRAINING ACADEMY - HOUMA        ,LA,70363-5556,Proprietary  ,10,40,50,64,211,275
03789303,UNITECH TRAINING ACADEMY -  ALEXANDRIA  ,LA,71303-3625,Proprietary  ,14,61,75,45,289,334
03789304,UNITECH TRAINING ACADEMY - LAKE CHARLES ,LA,70601-7887,Proprietary  ,12,59,71,69,279,348
03789400,RIVER PARISHES COMMUNITY COLLEGE        ,LA,70778-0310,Public       ,54,133,187,768,1286,2054
03810500,COURT REPORTING INSTITUTE OF LOUISI     ,LA,70816-0000,Proprietary  ,1,8,9,14,89,103
03956300,SOUTH LOUISIANA COMMUNITY COLLEGE       ,LA,70506-0000,Public       ,158,318,476,2055,2315,4370
04040300,COMPASS CAREER COLLEGE                  ,LA,70403-0653,Proprietary  ,8,42,50,90,311,401
04112300,LOUISIANA CULINARY INSTITUTE            ,LA,70816-4109,Proprietary  ,21,59,80,183,293,476
04120700,ALDEN'S SCHOOL OF COSMETOLOGY           ,LA,70714-1502,Proprietary  ,9,33,42,30,109,139
04130100,LOUISIANA DELTA COMMUNITY COLLEGE       ,LA,71203-3618,Public       ,105,362,467,1624,2881,4505
04130101,LOUISIANA TECHNICAL COLG - TALLULAH     ,LA,71284-0000,Public       ,2,8,10,33,104,137
04149500,A & W HEALTHCARE EDUCATORS              ,LA,70122-3146,Proprietary  ,5,39,44,31,221,252
04151600,MY-LE'S BEAUTY COLLEGE                  ,LA,70056-3150,Proprietary  ,6,37,43,35,174,209
00143600,CAPITOL COLLEGE                         ,MD,20708-9759,Private      ,12,57,69,460,497,957
00146200,WASHINGTON BIBLE COLLEGE                ,MD,20706-3599,Private      ,4,31,35,84,426,510
00205700,ALLEGANY COLLEGE OF MARYLAND            ,MD,21502-2596,Public       ,76,197,273,2521,2223,4744
00205800,ANNE ARUNDEL COMMUNITY COLLEGE          ,MD,21012-1895,Public       ,280,988,1268,5026,9488,14514
00206100,BALTIMORE CITY COMMUNITY COLLEGE        ,MD,21215-7893,Public       ,198,947,1145,3509,10522,14031
00206200,BOWIE STATE UNIVERSITY                  ,MD,20715-9465,Public       ,188,413,601,7640,6117,13757
00206300,COMMUNITY COLLEGE OF BALTIMORE COUNTY   ,MD,21228-5381,Public       ,464,1676,2140,9518,18368,27886
00206400,COLLEGE OF SOUTHERN MARYLAND            ,MD,20646-0910,Public       ,223,631,854,3534,5385,8919
00206500,CLG NOTRE DAME OF MARYLAND              ,MD,21210-2476,Private      ,21,124,145,856,1805,2661
00206700,WASHINGTON ADVENTIST UNIVERSITY         ,MD,20912-7796,Private      ,23,93,116,954,1439,2393
00206800,COPPIN STATE UNIVERSITY                 ,MD,21216-3698,Public       ,115,350,465,3931,5375,9306
00207100,FREDERICK COMMUNITY COLLEGE             ,MD,21702-9745,Public       ,126,357,483,2085,3146,5231
00207200,FROSTBURG STATE UNIVERSITY              ,MD,21532-1099,Public       ,112,103,215,6772,1785,8557
00207300,GOUCHER COLLEGE                         ,MD,21204-2794,Private      ,59,72,131,3290,882,4172
00207400,HAGERSTOWN COMMUNITY COLLEGE            ,MD,21742-6590,Public       ,123,422,545,1859,3635,5494
00207500,HARFORD COMMUNITY COLLEGE               ,MD,21015-1696,Public       ,139,351,490,2287,3209,5496
00207600,HOOD COLLEGE                            ,MD,21701-8575,Private      ,49,64,113,2285,961,3246
00207700,JOHNS HOPKINS UNIVERSITY                ,MD,21218-2693,Private      ,143,184,327,9273,2969,12242
00207702,JOHNS HOPKINS UNIV SCH ARTS/SCI/ENG     ,MD,21218-0000,Private      ,28,193,221,3598,2225,5823
00207703,JOHNS HOPKINS UNIV SCH OF BUS/ED        ,MD,21046-0000,Private      ,7,121,128,69,1722,1791
00207705,JOHNS HOPKINS BLOOMBERG SCH OF PH       ,MD,21205-0000,Private      ,2,56,58,28,1550,1578
00207706,JOHNS HOPKINS UNIV SCH OF MEDICINE      ,MD,21205-0000,Private      ,23,33,56,192,1060,1252
00207707,JOHNS HOPKINS UNIV SCH OF NURSING       ,MD,21205-0000,Private      ,21,88,109,300,1161,1461
00207708,JOHNS HOPKINS UNIV PEABODY CONSERV      ,MD,21202-2397,Private      ,15,11,26,604,507,1111
00207800,LOYOLA UNIVERSITY MARYLAND              ,MD,21210-2699,Private      ,104,142,246,8718,2615,11333
00208000,MARYLAND INST COLLEGE OF ART            ,MD,21217-4191,Private      ,49,57,106,3014,1058,4072
00208300,MORGAN STATE UNIVERSITY                 ,MD,21251-0002,Public       ,299,405,704,11646,7335,18981
00208600,MOUNT SAINT MARY'S UNIVERSITY           ,MD,21727-7799,Private      ,37,39,76,3347,546,3893
00208700,NER ISRAEL RABBINICAL COLLEGE           ,MD,21208-1198,Private      ,5,8,13,110,45,155
00208900,PRINCE GEORGES COMMUNITY COLLEGE        ,MD,20774-2199,Public       ,396,1243,1639,6643,12121,18764
00209100,SALISBURY UNIVERSITY                    ,MD,21801-6862,Public       ,214,141,355,11420,2481,13901
00209200,ST JOHN'S COLLEGE                       ,MD,21404-0000,Private      ,10,27,37,657,212,869
00209500,ST. MARY'S COLLEGE OF MARYLAND          ,MD,20686-3001,Public       ,47,26,73,2762,321,3083
00209600,ST MARY'S SEMINARY & UNIV               ,MD,21210-1994,Private      ,1,3,4,26,50,76
00209900,TOWSON UNIVERSITY                       ,MD,21252-0002,Public       ,542,578,1120,23836,9249,33085
00210200,UNIVERSITY OF BALTIMORE                 ,MD,21201-5779,Public       ,79,370,449,1735,7258,8993
00210300,"UNIVERSITY OF MARYLAND, COLLEGE PARK    ",MD,20742-5145,Public       ,657,937,1594,32379,14888,47267
00210400,"UNIVERSITY OF MARYLAND, BALTIMORE       ",MD,21201-1691,Public       ,163,485,648,3811,11025,14836
00210500,UMBC                                    ,MD,21250-0002,Public       ,207,347,554,10059,5502,15561
00210600,UNIVERSITY MARYLAND EASTERN SHORE       ,MD,21853-4053,Public       ,143,117,260,5575,2353,7928
00210700,STEVENSON UNIVERSITY                    ,MD,21153-0641,Private      ,130,137,267,6367,2085,8452
00210800,WASHINGTON COLLEGE                      ,MD,21620-1197,Private      ,39,15,54,2822,138,2960
00210900,MCDANIEL COLLEGE                        ,MD,21157-4390,Private      ,52,61,113,2900,789,3689
00458612,KAPLAN COLLEGE                          ,MD,21742-2797,Proprietary  ,30,215,245,288,1476,1764
00458614,KAPLAN COLLEGE - FREDERICK              ,MD,21704-8307,Proprietary  ,1,24,25,20,168,188
00465000,CHESAPEAKE COLLEGE                      ,MD,21679-0008,Public       ,76,248,324,1355,1901,3256
00691100,MONTGOMERY COLLEGE                      ,MD,20850-1195,Public       ,579,1322,1901,10769,12375,23144
00734100,INTERNATIONAL BEAUTY SCHOOL             ,MD,21502-2370,Proprietary  ,21,132,153,68,466,534
00744700,DEL-MAR-VA BEAUTY ACADEMY               ,MD,21804-0000,Proprietary  ,7,17,24,53,123,176
00749100,TESST COLLEGE OF TECHNOLOGY             ,MD,21227-1063,Proprietary  ,36,223,259,317,1379,1696
00793600,LINCOLN TECHNICAL INSTITUTE             ,MD,21046-1544,Proprietary  ,108,157,265,680,980,1660
00817500,HOWARD COMMUNITY COLLEGE                ,MD,21044-3197,Public       ,183,456,639,3431,4624,8055
00826300,AWARD BEAUTY SCHOOL                     ,MD,21740-5624,Proprietary  ,20,77,97,73,258,331
00830800,CECIL COLLEGE                           ,MD,21901-1999,Public       ,70,192,262,1071,1552,2623
00907906,EVEREST COLLEGE- EVEREST INSTITUTE      ,MD,20910-3737,Proprietary  ,46,159,205,250,800,1050
01001400,GARRETT COMMUNITY COLLEGE               ,MD,21541-1265,Public       ,29,34,63,920,463,1383
01031900,MEDIX SCHOOL                            ,MD,21204-2538,Proprietary  ,101,399,500,680,2715,3395
01041000,TESST COLLEGE OF TECHNOLOGY             ,MD,21286-2201,Proprietary  ,30,103,133,151,592,743
01164400,UNIV OF MARYLAND UNIVERSITY COLLEGE     ,MD,20783-8078,Public       ,228,4225,4453,2951,34683,37634
01164402,U OF MD UNIVERSITY COLLEGE - EUROPE     ,MD,20832-0000,Public       ,18,153,171,446,1048,1494
01164404,U OF MD UNIVERSITY COLLEGE - ASIA       ,MD,31207-0000,Public       ,2,132,134,70,770,840
02073900,WOR-WIC COMMUNITY COLLEGE               ,MD,21804-0000,Public       ,123,380,503,1685,3335,5020
02083600,TESST COLLEGE OF TECHNOLOGY             ,MD,20705-2698,Proprietary  ,24,99,123,273,867,1140
02116005,SANFORD-BROWN INSTITUTE - LANDOVER      ,MD,20785-2287,Proprietary  ,30,143,173,210,985,1195
02127900,SOJOURNER DOUGLASS COLLEGE              ,MD,21205-0000,Private      ,15,292,307,217,2883,3100
02155100,MARYLAND COLLEGE OF ART AND DESIGN      ,MD,20902-0000,Private      ,10,24,34,152,145,297
02269700,INTERNATIONAL BEAUTY SCHOOL             ,MD,21014-0000,Proprietary  ,4,14,18,31,70,101
02314800,BALTIMORE INTERNATIONAL COLLEGE         ,MD,21202-0000,Private      ,11,50,61,520,658,1178
02331000,MARYLAND BEAUTY ACADEMY OF ESSEX        ,MD,21221-0000,Proprietary  ,10,31,41,59,179,238
02333000,HAIR ACADEMY                            ,MD,20784-0000,Proprietary  ,53,98,151,231,495,726
02343800,MONTGOMERY BEAUTY SCHOOL                ,MD,20901-0000,Proprietary  ,6,48,54,72,206,278
02494700,BALTIMORE STUDIO OF HAIR DESIGN         ,MD,21201-0000,Proprietary  ,19,38,57,112,254,366
02495000,ROBERT PAUL ACAD COSMTGY ARTS & SCI     ,MD,21093-0000,Proprietary  ,6,8,14,55,95,150
02495100,MARYLAND BEAUTY ACADEMY                 ,MD,21136-0000,Proprietary  ,4,8,12,36,71,107
02545400,NORTH AMERICAN TRADE SCHOOLS            ,MD,21244-0069,Proprietary  ,21,176,197,200,861,1061
02573800,"L' ACADEMIE DE CUISINE, INC.            ",MD,20877-0000,Proprietary  ,12,41,53,72,256,328
02578400,TAI SOPHIA INSTITUTE                    ,MD,20723-6010,Private      ,0,85,85,4,387,391
03027200,BLADES SCHOOL OF HAIR DESIGN            ,MD,20619-0226,Proprietary  ,9,23,32,40,120,160
03064900,AARON'S ACADEMY OF BEAUTY               ,MD,20602-2715,Proprietary  ,7,21,28,46,91,137
03097200,AESTHETICS INSTITUTE OF COSMETOLOGY     ,MD,20877-1305,Proprietary  ,7,29,36,26,102,128
03100700,CARROLL COMMUNITY COLLEGE               ,MD,21157-6913,Public       ,60,155,215,1171,1527,2698
03148300,AMERICAN BEAUTY ACADEMY                 ,MD,20902-1911,Proprietary  ,72,168,240,304,685,989
03296300,BALTIMORE SCHOOL OF MASSAGE             ,MD,21090-2261,Proprietary  ,46,144,190,199,688,887
03327300,NEW CREATIONS ACADEMY OF HAIR DSN       ,MD,20746-2960,Proprietary  ,6,29,35,40,141,181
03455500,NATIONAL LABOR COLLEGE                  ,MD,20903-1790,Private      ,1,73,74,12,290,302
03493300,ALL-STATE CAREER SCHOOL                 ,MD,21224-6658,Proprietary  ,73,523,596,515,2547,3062
03771300,AMERICAN CAREER INSTITUTE               ,MD,20902-4637,Proprietary  ,124,609,733,636,3156,3792
03822400,MAPLE SPRINGS BAPTIST BIBLE COLLEGE & SE,MD,20743-5711,Private      ,0,6,6,2,66,68
03937300,YESHIVA COLLEGE OF THE NATION'S CAPITAL ,MD,20902-1700,Private      ,0,3,3,11,9,20
03965500,HAIR EXPRESSIONS ACADEMY                ,MD,20852-1729,Proprietary  ,15,34,49,71,136,207
04121600,FILA ACADEMY (THE)                      ,MD,21061-1634,Proprietary  ,0,0,0,10,59,69
04139700,FREDERICK SCHOOL OF COSMETOLOGY         ,MD,21701-0000,Proprietary  ,4,8,12,28,56,84
04141600,OMEGA STUDIOS' SCHOOL OF APPLIED RECORDI,MD,20852-1731,Proprietary  ,7,11,18,52,108,160
04151800,TEMPLE (THE): A PAUL MITCHELL PARTNER SC,MD,21701-5409,Proprietary  ,14,22,36,73,93,166
04168900,HOLISTIC MASSAGE TRAINING INSTITUTE     ,MD,21218-2407,Proprietary  ,4,9,13,10,49,59
04204000,ASPEN BEAUTY ACADEMY - LAUREL           ,MD,20724-2013,Proprietary  ,8,21,29,8,21,29
00211400,AMERICAN INTERNATIONAL COLLEGE          ,MA,01109-3189,Private      ,35,364,399,2029,2880,4909
00211500,AMHERST COLLEGE                         ,MA,01002-5000,Private      ,87,21,108,5107,397,5504
00211600,ANDOVER NEWTON THEOLOGICAL SCHOOL       ,MA,02459-0000,Private      ,0,13,13,2,213,215
00211700,ANNA MARIA COLLEGE                      ,MA,01612-1198,Private      ,13,75,88,1834,688,2522
00211800,ASSUMPTION COLLEGE                      ,MA,01615-1294,Private      ,67,67,134,4570,797,5367
00211900,ATLANTIC UNION COLLEGE                  ,MA,01561-1000,Private      ,0,0,0,278,247,525
00212000,MERRIMACK COLLEGE                       ,MA,01845-5800,Private      ,67,35,102,3965,379,4344
00212100,BABSON COLLEGE                          ,MA,02457-0310,Private      ,53,65,118,2562,920,3482
00212200,BAY PATH COLLEGE                        ,MA,01106-2212,Private      ,17,170,187,1018,2228,3246
00212300,BECKER COLLEGE-WORCESTER                ,MA,01615-0071,Private      ,53,80,133,2717,1117,3834
00212400,BENTLEY UNIVERSITY                      ,MA,02452-4705,Private      ,90,59,149,5679,932,6611
00212600,BERKLEE COLLEGE OF MUSIC                ,MA,02215-3693,Private      ,132,137,269,4717,1504,6221
00212800,BOSTON COLLEGE                          ,MA,02467-3800,Private      ,278,200,478,20785,7085,27870
00212900,BOSTON CONSERVATORY OF MUSIC            ,MA,02215-9830,Private      ,19,10,29,1123,382,1505
00213000,BOSTON UNIVERSITY                       ,MA,02215-1789,Private      ,623,909,1532,33953,19506,53459
00213300,BRANDEIS UNIVERSITY                     ,MA,02453-2700,Private      ,70,52,122,5566,1634,7200
00213900,CLARK UNIVERSITY                        ,MA,01610-1473,Private      ,60,47,107,3728,833,4561
00214000,ELMS COLLEGE                            ,MA,01013-2839,Private      ,9,50,59,1153,845,1998
00214100,COLLEGE OF THE HOLY CROSS               ,MA,01610-2395,Private      ,71,13,84,5909,157,6066
00214300,CURRY COLLEGE                           ,MA,02186-2395,Private      ,80,131,211,4687,1425,6112
00214400,DEAN COLLEGE                            ,MA,02038-1994,Private      ,29,32,61,1977,316,2293
00214500,EASTERN NAZARENE COLLEGE                ,MA,02170-2999,Private      ,11,58,69,876,578,1454
00214507,EASTERN NAZARENE CLG - LEAD PROGRAM     ,MA,02170-0000,Private      ,6,53,59,51,154,205
00214600,EMERSON COLLEGE                         ,MA,02116-4624,Private      ,107,55,162,7165,1782,8947
00214700,EMMANUEL COLLEGE                        ,MA,02115-5798,Private      ,55,37,92,5046,574,5620
00214800,ENDICOTT COLLEGE                        ,MA,01915-2098,Private      ,63,83,146,4253,587,4840
00214900,EPISCOPAL DIVINITY SCHOOL               ,MA,02138-0000,Private      ,0,5,5,0,87,87
00215000,FISHER COLLEGE                          ,MA,02116-1500,Private      ,38,192,230,1498,1389,2887
00215100,BENJAMIN FRANKLIN INSTITUTE OF TECH     ,MA,02116-6296,Public       ,29,43,72,640,376,1016
00215300,GORDON COLLEGE                          ,MA,01984-1899,Private      ,23,18,41,2368,190,2558
00215400,HELLENIC COLLEGE                        ,MA,02445-7496,Private      ,1,6,7,95,148,243
00215500,HARVARD UNIVERSITY                      ,MA,02138-3800,Private      ,195,97,292,9566,1707,11273
00215501,AMRCN REPERTORY THTR INST ADV THTR      ,MA,02138-0000,Private      ,0,1,1,3,126,129
00215502,HARVARD BUSINESS SCHOOL                 ,MA,02163-0000,Private      ,16,47,63,251,1602,1853
00215503,HARVARD EXTENSION SCHOOL                ,MA,02138-0000,Private      ,17,144,161,156,1465,1621
00215504,HARVARD SCH OF DENTAL MEDICINE          ,MA,02115-0000,Private      ,4,5,9,25,195,220
00215505,HARVARD UNIV GRAD SCH DESIGN            ,MA,02138-0000,Private      ,2,12,14,16,1092,1108
00215506,HARVARD DIVINITY SCHOOL                 ,MA,02138-0000,Private      ,2,12,14,16,530,546
00215507,HARVARD UNIV GRAD SCH ED                ,MA,02138-0000,Private      ,0,26,26,8,1499,1507
00215508,HARVARD UNIV GRAD S OF ARTS & SCIEN     ,MA,02138-0000,Private      ,3,43,46,91,903,994
00215509,HARVARD KENNEDY SCHOOL                  ,MA,02138-0000,Private      ,0,24,24,8,1406,1414
00215510,HARVARD LAW SCHOOL                      ,MA,02138-0000,Private      ,14,38,52,142,3397,3539
00215511,HARVARD UNIV MEDICAL SCHOOL             ,MA,02115-0000,Private      ,16,11,27,182,982,1164
00215512,HARVARD UNIV SCH PUBLIC HEALTH          ,MA,02115-0000,Private      ,6,32,38,54,828,882
00215513,HARVARD UNIVERSITY-HARVARD COLLEGE      ,MA,02138-0000,Private      ,134,41,175,15052,787,15839
00215700,HEBREW COLLEGE                          ,MA,02459-2237,Private      ,0,5,5,0,103,103
00215800,LASELL COLLEGE                          ,MA,02466-2716,Private      ,35,25,60,2956,363,3319
00216000,LESLEY UNIVERSITY                       ,MA,02138-2790,Private      ,54,374,428,2966,4573,7539
00216100,UMASS LOWELL                            ,MA,01854-3089,Public       ,280,472,752,12483,6342,18825
00216400,NEW ENGLAND COLLEGE OF OPTOMETRY        ,MA,02115-1129,Private      ,1,11,12,10,424,434
00216500,MASS. COLLEGE OF PHARMACY  & HEALTH SCIE,MA,02115-5804,Private      ,66,121,187,5060,3532,8592
00216700,BERKSHIRE COMMUNITY COLLEGE             ,MA,01201-5786,Public       ,50,155,205,1039,1611,2650
00216800,CAPE COD COMMUNITY COLLEGE              ,MA,02668-1599,Public       ,117,326,443,1788,2622,4410
00216900,GREENFIELD COMMUNITY COLLEGE            ,MA,01301-9739,Public       ,67,153,220,972,1689,2661
00217000,HOLYOKE COMMUNITY COLLEGE               ,MA,01040-1099,Public       ,208,557,765,4018,5237,9255
00217100,MASSACHUSETTS BAY COMMUNITY COLLEGE     ,MA,02181-0000,Public       ,115,271,386,2345,2704,5049
00217200,MOUNT WACHUSETT COMMUNITY COLLEGE       ,MA,01440-1000,Public       ,109,383,492,1953,3423,5376
00217300,NORTH SHORE COMMUNITY COLLEGE           ,MA,01923-4093,Public       ,220,580,800,3518,4908,8426
00217400,NORTHERN ESSEX COMMUNITY COLLEGE        ,MA,01830-2399,Public       ,203,507,710,3054,4612,7666
00217500,QUINSIGAMOND COMMUNITY COLLEGE          ,MA,01606-2092,Public       ,253,613,866,4306,6119,10425
00217600,BRISTOL COMMUNITY COLLEGE               ,MA,02720-7399,Public       ,263,625,888,4437,5639,10076
00217700,MASSASOIT COMMUNITY COLLEGE             ,MA,02302-3996,Public       ,256,514,770,3620,4625,8245
00217800,MASSACHUSETTS INST OF TECHNOLOGY        ,MA,02139-4307,Private      ,168,192,360,11235,3094,14329
00218000,MASSACHUSETTS COLLEGE OF ART AND DESIGN ,MA,02115-5803,Public       ,43,49,92,2505,977,3482
00218100,MASSACHUSETTS MARITIME ACADEMY          ,MA,02532-3400,Public       ,15,11,26,1382,155,1537
00218300,BRIDGEWATER STATE COLLEGE               ,MA,02325-0001,Public       ,224,278,502,12083,3892,15975
00218400,FITCHBURG STATE COLLEGE                 ,MA,01420-2697,Public       ,87,108,195,5595,1713,7308
00218500,FRAMINGHAM STATE COLLEGE                ,MA,01702-2471,Public       ,113,145,258,6260,1623,7883
00218700,MASSACHUSETTS CLG OF LIBERAL ARTS       ,MA,01247-4100,Public       ,26,42,68,2223,637,2860
00218800,SALEM STATE UNIVERSITY                  ,MA,01970-5353,Public       ,205,293,498,8453,4283,12736
00218900,WESTFIELD STATE COLLEGE                 ,MA,01086-1630,Public       ,105,124,229,8176,1996,10172
00219000,WORCESTER STATE COLLEGE                 ,MA,01602-2597,Public       ,125,180,305,6309,2567,8876
00219200,MOUNT HOLYOKE COLLEGE                   ,MA,01075-1492,Private      ,34,12,46,2650,352,3002
00219300,MOUNT IDA COLLEGE                       ,MA,02459-3323,Private      ,42,28,70,2144,457,2601
00219400,NEW ENGLAND CONSERVATORY OF MUSIC       ,MA,02115-5018,Private      ,17,19,36,775,627,1402
00219700,NICHOLS COLLEGE                         ,MA,01571-6346,Private      ,28,39,67,1973,482,2455
00219900,NORTHEASTERN UNIVERSITY                 ,MA,02115-5000,Private      ,534,893,1427,34936,12990,47926
00220100,PINE MANOR COLLEGE                      ,MA,02167-0000,Private      ,7,10,17,459,173,632
00220200,BLESSED JOHN XXIII NATIONAL SEMINARY    ,MA,02493-0000,Private      ,0,0,0,0,7,7
00220500,QUINCY COLLEGE                          ,MA,02169-4501,Public       ,132,360,492,1695,3647,5342
00220600,REGIS COLLEGE                           ,MA,02193-0000,Private      ,26,41,67,2014,867,2881
00220800,SIMMONS COLLEGE                         ,MA,02115-5898,Private      ,39,183,222,3261,3908,7169
00220900,SMITH COLLEGE                           ,MA,01063-2936,Private      ,42,18,60,3436,533,3969
00220901,"SMITH COLLEGE, SCH FOR SOCIAL WORK      ",MA,01063-0000,Private      ,0,9,9,6,466,472
00221000,UNIV OF MASSACHUSETTS-DARTMOUTH         ,MA,02747-2300,Public       ,154,214,368,11842,3671,15513
00221100,SPRINGFIELD COLLEGE                     ,MA,01109-3797,Private      ,46,335,381,4157,4666,8823
00221400,ST JOHN'S SEMINARY                      ,MA,02135-8839,Private      ,3,11,14,12,58,70
00221700,STONEHILL COLLEGE                       ,MA,02357-6110,Private      ,71,15,86,6506,182,6688
00221800,SUFFOLK UNIVERSITY                      ,MA,02108-2770,Private      ,138,183,321,9517,5318,14835
00221900,TUFTS UNIVERSITY                        ,MA,02155-5808,Private      ,128,94,222,10613,2880,13493
00221901,TUFTS UNIV SCH OF DENTAL MEDICINE       ,MA,02111-0000,Private      ,2,11,13,18,892,910
00221902,TUFTS UNIVERSITY - CUMMINGS SCHOOL OF VE,MA,01536-0000,Private      ,0,7,7,23,482,505
00221904,TUFTS UNIV SCHOOL OF MEDICINE           ,MA,02111-0000,Private      ,4,15,19,54,1748,1802
00222100,UNIV OF MASSACHUSETTS-AMHERST           ,MA,01003-0000,Public       ,453,401,854,37043,8087,45130
00222200,UNIV OF MASSACHUSETTS-BOSTON            ,MA,02125-3393,Public       ,310,779,1089,11462,10996,22458
00222400,WELLESLEY COLLEGE                       ,MA,02481-8203,Private      ,40,20,60,3515,224,3739
00222500,WENTWORTH INSTITUTE OF TECHNOLOGY       ,MA,02115-5998,Private      ,87,95,182,4992,985,5977
00222600,WESTERN NEW ENGLAND UNIVERSITY          ,MA,01119-2654,Private      ,59,93,152,5902,1888,7790
00222700,WHEATON COLLEGE                         ,MA,02766-2322,Private      ,40,5,45,2666,94,2760
00222800,WHEELOCK COLLEGE                        ,MA,02215-4176,Private      ,20,37,57,1693,815,2508
00222900,WILLIAMS COLLEGE                        ,MA,01267-2600,Private      ,47,4,51,4148,166,4314
00223300,WORCESTER POLYTECHNIC INSTITUTE         ,MA,01609-2280,Private      ,57,27,84,6576,638,7214
00396500,BAY STATE COLLEGE                       ,MA,02116-2901,Proprietary  ,75,114,189,1586,1132,2718
00396600,BOSTON ARCHITECTURAL COLLEGE            ,MA,02115-2795,Private      ,14,66,80,439,1016,1455
00466100,HAMPSHIRE COLLEGE                       ,MA,01002-3359,Private      ,61,12,73,2513,224,2737
00466600,SALTER COLLEGE                          ,MA,01583-1700,Proprietary  ,93,503,596,487,2579,3066
00466700,SCHOOL OF MUSEUM OF FINE ARTS           ,MA,02115-5534,Private      ,12,16,28,784,358,1142
00466900,UPPER CAPE COD REGIONAL VOC TECH        ,MA,02532-3310,Public       ,2,4,6,20,119,139
00527900,GREATER LOWELL REGNL VOC TECH SCH       ,MA,01879-0000,Public       ,1,2,3,20,111,131
00551900,DIMAN REGIONAL VOC TECH INST            ,MA,02723-3519,Public       ,2,20,22,32,117,149
00552300,BLUE HILLS REGIONAL VOC TECH            ,MA,02021-1398,Public       ,1,13,14,24,140,164
00555700,MCCANN TECHNICAL SCHOOL                 ,MA,01247-0000,Public       ,2,12,14,21,77,98
00613600,NATIONAL AVIATION ACADEMY - NEW ENGLAND ,MA,01730-2620,Proprietary  ,14,40,54,133,251,384
00632200,BROCKTON HOSPITAL SCH OF NURSING        ,MA,02302-0000,Private      ,4,28,32,136,558,694
00632400,LABOURE COLLEGE                         ,MA,02124-5698,Private      ,16,86,102,221,876,1097
00633100,LAWRENCE MEM HOSPITAL SCH OF NRSNG      ,MA,02155-1643,Private      ,4,25,29,77,417,494
00635200,BAYSTATE MEDICAL CENTER                 ,MA,01199-0001,Private      ,2,13,15,16,77,93
00687300,MARIAN COURT COLLEGE                    ,MA,01907-2896,Private      ,6,9,15,180,90,270
00748100,GIBBS COLLEGE                           ,MA,02116-2904,Proprietary  ,10,48,58,132,490,622
00748400,NEWBURY COLLEGE                         ,MA,02445-5796,Private      ,27,18,45,2459,417,2876
00748600,THE NEW ENGLAND INSTITUTE OF ART        ,MA,02445-7295,Proprietary  ,135,67,202,1683,723,2406
00748800,KAPLAN CAREER INSTITUTE                 ,MA,02129-1644,Proprietary  ,21,93,114,110,491,601
00748801,KAPLAN CAREER INSTITUTE -               ,MA,02215-2606,Proprietary  ,6,56,62,86,351,437
00807800,SPRINGFIELD TECHNICAL COMMUNITY CLG     ,MA,01105-0000,Public       ,216,641,857,3388,6052,9440
00809002,EVEREST COLLEGE - EVEREST INSTITUTE     ,MA,02150-2333,Proprietary  ,23,85,108,119,378,497
00891600,NEW ENGLAND SCHOOL OF LAW               ,MA,02116-0000,Private      ,4,14,18,18,2128,2146
00964500,BARD COLLEGE AT SIMON'S ROCK            ,MA,01230-9702,Private      ,14,4,18,457,31,488
00974700,GORDON-CONWELL THEOLOGICAL SEMINARY     ,MA,01982-0000,Private      ,2,31,33,5,538,543
00975600,UNIVERSITY OF MASS MEDICAL CENTER       ,MA,01655-0000,Public       ,2,29,31,43,935,978
00987700,HENRI'S SCHOOL OF HAIR DESIGN           ,MA,01420-5675,Proprietary  ,3,7,10,28,40,68
00989900,LOWELL ACADEMY HAIRSTYLING INST         ,MA,01852-1909,Proprietary  ,11,19,30,41,69,110
00993600,MIDDLESEX COMMUNITY COLLEGE             ,MA,01730-1197,Public       ,85,154,239,1755,1687,3442
00993602,"MIDDLESEX COMMUNITY COLLEGE, LOWELL     ",MA,01852-0000,Public       ,125,264,389,2698,2912,5610
01121000,BUNKER HILL COMMUNITY COLLEGE           ,MA,02129-2991,Public       ,521,1263,1784,6344,10512,16856
01151000,EVEREST INSTITUTE                       ,MA,02135-7638,Proprietary  ,13,78,91,100,402,502
01193000,ROXBURY COMMUNITY COLLEGE               ,MA,02120-3400,Public       ,97,310,407,1284,3214,4498
01204200,MANSFIELD BEAUTY SCHOOLS                ,MA,02169-5061,Proprietary  ,6,15,21,27,96,123
01206800,MANSFIELD BEAUTY SCHOOL                 ,MA,01103-1410,Proprietary  ,6,7,13,14,35,49
01218700,BLACKSTONE VALLEY VOCATIONAL REGIONAL SC,MA,01568-1499,Public       ,0,8,8,3,36,39
01238600,SOUTHEASTERN TECHNICAL INSTITUTE        ,MA,02375-1780,Public       ,5,25,30,41,196,237
01288100,MONTACHUSETT REG VOC TECH SCH           ,MA,01420-4649,Public       ,1,2,3,11,75,86
01292100,EMPIRE BEAUTY SCHOOL                    ,MA,02215-0000,Proprietary  ,29,56,85,206,396,602
01294800,ROB ROY ACADEMY                         ,MA,02721-5330,Proprietary  ,15,28,43,46,108,154
02063000,MONTSERRAT COLLEGE OF ART               ,MA,01915-0000,Private      ,14,1,15,636,63,699
02076700,EMPIRE BEAUTY SCHOOL                    ,MA,02148-0000,Proprietary  ,11,23,34,94,163,257
02079400,EMPIRE BEAUTY SCHOOL                    ,MA,01702-5232,Proprietary  ,4,25,29,79,197,276
02092100,MASSACHUSETTS SCHOOL OF BARBERING       ,MA,02169-5058,Proprietary  ,6,30,36,34,104,138
02092200,EMPIRE BEAUTY SCHOOL                    ,MA,01852-0000,Proprietary  ,11,33,44,78,176,254
02122000,NEW ENGLAND HAIR ACADEMY                ,MA,02148-0000,Proprietary  ,17,35,52,71,132,203
02137000,ROB ROY ACADEMY                         ,MA,02780-0000,Proprietary  ,6,11,17,33,50,83
02137200,MASS GEN HOSP DIETETIC INTERNSHIP       ,MA,02114-0000,Private      ,0,2,2,1,19,20
02143000,LONGY SCHOOL OF MUSIC                   ,MA,02138-3599,Private      ,2,0,2,50,147,197
02163500,NEW ENGLAND SCHOOL OF PHOTOGRAPHY       ,MA,02215-0000,Proprietary  ,2,17,19,113,129,242
02163600,MASS SCH OF PROFESSIONAL PSYCHOLOGY     ,MA,02132-0000,Private      ,1,20,21,17,696,713
02169900,ASSABET VALLEY REGIONAL VOC SCHOOL      ,MA,01752-0000,Public       ,0,3,3,21,107,128
02181600,ROB ROY ACADEMY                         ,MA,01609-0000,Proprietary  ,19,48,67,100,196,296
02182900,CAMBRIDGE COLLEGE                       ,MA,02138-5304,Private      ,35,467,502,388,4207,4595
02197900,NORTH BENNET STREET SCHOOL              ,MA,02113-0000,Private      ,1,12,13,38,154,192
02215100,HALLMARK INSTITUTE OF PHOTOGRAPHY       ,MA,01376-0000,Proprietary  ,13,17,30,164,133,297
02219501,MILDRED ELLEY - PITTSFIELD              ,MA,01201-5300,Proprietary  ,1,1,2,13,36,49
02220400,CATHERINE HINDS INST OF ESTHETICS       ,MA,01801-0000,Proprietary  ,7,40,47,65,207,272
02231600,MGH INSTITUTE OF HEALTH PROFESSION      ,MA,02129-0000,Private      ,3,56,59,46,1448,1494
02274300,CONWAY SCHOOL OF LANDSCAPE DESIGN       ,MA,01341-0179,Private      ,0,1,1,0,22,22
02325700,LABARON HAIRDRESSING ACADEMY            ,MA,02740-0000,Proprietary  ,2,8,10,18,52,70
02325800,LABARON HAIRDRESSING ACAD-BROCKTON      ,MA,02301-0000,Proprietary  ,1,9,10,23,64,87
02337400,BANCROFT SCHOOL OF MASSAGE THERAPY      ,MA,01604-4614,Proprietary  ,3,11,14,14,79,93
02338200,BAY STATE SCHOOL OF TECHNOLOGY          ,MA,02021-0000,Proprietary  ,8,42,50,57,293,350
02339400,ROB ROY ACADEMY                         ,MA,02746-0000,Proprietary  ,2,13,15,14,36,50
02491700,CORTIVA INSTITUTE -  BOSTON             ,MA,02472-2577,Proprietary  ,7,46,53,43,219,262
02523900,ELIZABETH GRADY SCHOOL OF ESTHETICS     ,MA,02155-0000,Proprietary  ,8,13,21,43,154,197
02579800,NEW ENGLAND SCHOOL OF ACUPUNCTURE       ,MA,02458-0000,Private      ,0,4,4,0,158,158
03006802,PENNSYLVANIA CULINARY INSTITUTE - LE COR,MA,02142-1221,Proprietary  ,26,97,123,311,759,1070
03066700,AILANO SCHOOL OF COSMETOLOGY            ,MA,02303-4740,Proprietary  ,3,16,19,17,61,78
03104000,SHAWSHEEN ADULT TECHNICAL INSTITUTE     ,MA,01821-5499,Public       ,0,5,5,12,74,86
03115200,MOTORING TECHNICAL TRAINING INST        ,MA,02771-5933,Proprietary  ,25,39,64,98,240,338
03120800,KAY HARVEY HAIRDRESSING ACADEMY         ,MA,01089-2701,Proprietary  ,3,16,19,16,52,68
03130500,URBAN COLLEGE OF BOSTON                 ,MA,02111-1093,Private      ,6,51,57,64,653,717
03194300,BOSTON GRAD SCH OF PSYCHOANALYSIS       ,MA,02446-4602,Private      ,0,10,10,2,105,107
03196300,LINCOLN TECHNICAL INSTITUTE             ,MA,02145-1102,Proprietary  ,19,73,92,147,470,617
03196302,LINCOLN TECHNICAL INSTITUTE             ,MA,01852-5119,Proprietary  ,18,59,77,129,413,542
03205400,JOLIE HAIR & BEAUTY ACADEMY             ,MA,01056-2769,Proprietary  ,7,22,29,51,160,211
03232302,LINCOLN TECHNICAL INSTITUTE             ,MA,02401-1818,Proprietary  ,4,22,26,38,122,160
03235300,MASSACHUSETTS SCHOOL OF LAW             ,MA,01810-1094,Private      ,0,41,41,9,682,691
03240300,TONI & GUY HAIRDRESSING ACADEMY         ,MA,01605-2213,Proprietary  ,9,10,19,69,49,118
03248300,BOSTON BAPTIST COLLEGE                  ,MA,02136-4000,Private      ,5,3,8,108,59,167
03316400,FUNERAL INSTITUTE OF THE NORTHEAST      ,MA,02062-4766,Proprietary  ,1,13,14,20,118,138
03504300,NATL GRAD SCH OF QUALITY SYSTM MGMT     ,MA,02540-0000,Private      ,0,30,30,0,68,68
03570500,ZION BIBLE COLLEGE                      ,MA,01835-0000,Private      ,8,3,11,199,138,337
03763300,MEDICAL PROFESSIONAL INSTITUTE          ,MA,02148-8143,Proprietary  ,3,39,42,36,246,282
03859300,E.I.N.E.                                ,MA,01876-4709,Proprietary  ,0,11,11,0,50,50
03946300,FRANKLIN W. OLIN COLLEGE OF ENGINEERING ,MA,02492-1200,Private      ,7,0,7,539,12,551
03965300,NEW ENGLAND COLLEGE OF FINANCE          ,MA,02110-1605,Proprietary  ,3,114,117,61,905,966
04039300,SULLIVAN AND COGLIANO TRAINING CENTER   ,MA,02301-4921,Proprietary  ,17,367,384,73,1379,1452
04116900,DIGRIGOLI SCHOOL OF COSMETOLOGY         ,MA,01089-4623,Proprietary  ,11,8,19,48,76,124
04122000,TRI COUNTY REGIONAL VOCATIONAL TECHNICAL,MA,02038-0000,Public       ,1,8,9,12,74,86
04128000,MILLENNIUM TRAINING INSTITUTE           ,MA,01801-6386,Proprietary  ,2,47,49,11,194,205
04128900,CENTRAL MASS SCHOOL OF MASSAGE AND THERA,MA,01562-1712,Proprietary  ,3,7,10,6,28,34
04153200,SOUTHERN WORCESTER COUNTY REGIONAL VOC S,MA,01507-1331,Public       ,1,3,4,5,38,43
04193100,ALEXANDER ACADEMY                       ,MA,01420-0000,Proprietary  ,3,11,14,3,11,14
00324204,CARNEGIE MELLON UNIVERSITY - QATAR      ,FC,00000-0000,Private      ,0,0,0,3,5,8
00401000,INSTITUT INTERNAT'L D'ETUDES FRANCA     ,FC,00000-0000,Public       ,0,0,0,1,5,6
00401200,HEBREW UNIVERSITY OF JERUSALEM (THE)    ,FC,00000-0000,Public       ,6,8,14,36,108,144
00403000,UNIVERSITY OF CAMBRIDGE                 ,FC,00000-0000,Public       ,1,7,8,5,94,99
00503400,AMERICAN UNIVERSITY OF CAIRO            ,FC,00000-0000,Private      ,3,12,15,71,226,297
00667100,KATHOLIEKE UNIVERSITEIT LEUVEN          ,FC,00000-0000,Private      ,0,2,2,1,24,25
00669100,UNIVERSITY OF CAMBRIDGE - PEMBROKE      ,FC,00000-0000,Public       ,1,0,1,4,12,16
00669200,UNIVERSITY OF LEEDS                     ,FC,00000-0000,Public       ,0,4,4,16,120,136
00669300,UNIV OF LONDON-LONDON SCHOOL ECON       ,FC,00000-0000,Public       ,0,11,11,16,475,491
00669400,SCH OF ORIENTAL & AFRICAN STUDIES       ,FC,00000-0000,Public       ,0,3,3,8,169,177
00669500,UNIV OF LONDON-UNIVERSITY COLLEGE       ,FC,00000-0000,Public       ,0,6,6,56,428,484
00669600,UNIV OF LONDON-SCH ADVANCED STUDY       ,FC,00000-0000,Public       ,0,1,1,0,18,18
00669700,"QUEEN MARY, UNIVERSITY OF LONDON        ",FC,00000-0000,Public       ,1,4,5,32,150,182
00669900,UNIVERSITY OF SUSSEX                    ,FC,00000-0000,Public       ,0,3,3,19,110,129
00670000,"UNIVERSITY OF YORK, THE                 ",FC,00000-0000,Public       ,0,5,5,16,156,172
00670400,UNIVERSITY COLLEGE CORK                 ,FC,00000-0000,Public       ,0,1,1,12,65,77
00671300,UPPSALA UNIVERSITY                      ,FC,00000-0000,Public       ,0,1,1,4,42,46
00671500,UNIVERSITY OF GENEVA                    ,FC,00000-0000,Public       ,1,1,2,6,80,86
00683900,UNIVERSITY OF EDINBURGH                 ,FC,00000-0000,Public       ,5,15,20,155,703,858
00684200,UNIVERSITY OF DUBLIN TRINITY COLLEG     ,FC,00000-0000,Public       ,0,3,3,40,190,230
00685000,UNIVERSITY OF CAMBRIDGE - DOWNING C     ,FC,00000-0000,Public       ,0,0,0,0,6,6
00763200,UNIVERSITY OF BRISTOL                   ,FC,00000-0000,Public       ,0,4,4,17,102,119
00768100,COLLEGE OF EUROPE                       ,FC,00000-0000,Private      ,0,1,1,2,7,9
00770500,ROYAL COLLEGE OF SURGEONS IN IRELAN     ,FC,00000-0000,Private      ,0,0,0,11,64,75
00788100,AMERICAN UNIVERSITY OF PARIS            ,FC,00000-0000,Private      ,16,18,34,234,305,539
00837100,AMERICAN UNIVERSITY OF BEIRUT           ,FC,00000-0000,Private      ,2,6,8,92,114,206
00837300,TEL-AVIV UNIVERSITY                     ,FC,00000-0000,Public       ,2,7,9,13,141,154
00837600,VRIJE UNIVERSITEIT AMSTERDAM            ,FC,00000-0000,Public       ,0,1,1,2,36,38
00837700,UNIVERSITEIT VAN AMSTERDAM(UNIVERSI     ,FC,00000-0000,Public       ,1,4,5,20,130,150
00838000,UNIVERSITY OF WARWICK                   ,FC,00000-0000,Public       ,0,10,10,6,89,95
00838300,UNIVERSITY OF GLASGOW                   ,FC,00000-0000,Public       ,0,4,4,41,386,427
00839300,UNIVERSITY OF OSLO                      ,FC,00000-0000,Public       ,0,4,4,4,28,32
00839400,UNIVERSITY OF OXFORD                    ,FC,00000-0000,Public       ,1,17,18,22,429,451
00839800,UNIVERSITY OF SHEFFIELD (THE)           ,FC,00000-0000,Public       ,2,0,2,16,80,96
00839900,UNIVERSITY OF SOUTHAMPTON               ,FC,00000-0000,Public       ,0,2,2,8,56,64
00845200,ABERYSTWYTH UNIVERSITY                  ,FC,00000-0000,Public       ,1,1,2,16,51,67
00845800,LOUGHBOROUGH UNIVERSITY                 ,FC,00000-0000,Public       ,0,3,3,6,9,15
00846000,UNIVERSITY OF NEWCASTLE UPON TYNE       ,FC,00000-0000,Public       ,0,2,2,12,101,113
00846100,UNIVERSITY OF SAINT ANDREWS             ,FC,00000-0000,Public       ,2,9,11,239,223,462
00850500,UNIVERSITY OF MELBOURNE                 ,FC,00000-0000,Public       ,0,49,49,12,186,198
00858600,SWANSEA UNIVERSITY                      ,FC,00000-0000,Public       ,0,0,0,8,44,52
00858700,UNIVERSITY OF DURHAM                    ,FC,00000-0000,Public       ,1,9,10,29,212,241
00866500,UNIVERSITY OF KENT AT CANTERBURY (THE)  ,FC,00000-0000,Public       ,1,3,4,28,111,139
00867000,UNIVERSITY OF NEW SOUTH WALES           ,FC,00000-0000,Public       ,1,22,23,14,115,129
00868700,UNIVERSITY OF ESSEX                     ,FC,00000-0000,Public       ,0,5,5,16,102,118
00869300,CITY UNIVERSITY                         ,FC,00000-0000,Public       ,3,10,13,19,182,201
00890800,THE UNIVERSITY OF BIRMINGHAM            ,FC,00000-0000,Public       ,0,4,4,12,85,97
00891000,UNIVERSITY OF HULL                      ,FC,00000-0000,Public       ,1,0,1,9,11,20
00892000,UNIVERSITY OF NOTTINGHAM                ,FC,00000-0000,Public       ,0,3,3,10,99,109
00900600,UNIVERSITY OF SALFORD (THE)             ,FC,00000-0000,Public       ,0,2,2,1,15,16
00908400,"UNIV OF LONDON, BIRKBECK                ",FC,00000-0000,Public       ,0,5,5,3,122,125
00908500,UNIV OF LONDON KING'S COLLEGE           ,FC,00000-0000,Public       ,0,9,9,38,373,411
00908600,UNIVERSITY OF LONDON - ROYAL HOLLOWAY   ,FC,00000-0000,Public       ,1,5,6,22,87,109
00914300,BAR-ILAN UNIVERSITY                     ,FC,00000-0000,Private      ,3,1,4,13,22,35
00924900,UNIVERSITY OF LIVERPOOL                 ,FC,00000-0000,Public       ,1,7,8,16,88,104
00936800,UNIVERSITY OF ABERDEEN                  ,FC,00000-0000,Public       ,0,6,6,42,131,173
00942300,ROYAL COLLEGE OF ART                    ,FC,00000-0000,Public       ,0,1,1,3,48,51
00942800,TECHNION-ISRAEL INST OF TECHLGY         ,FC,00000-0000,Public       ,0,5,5,2,62,64
00944200,UNIVERSITY OF EXETER                    ,FC,00000-0000,Public       ,0,3,3,10,115,125
00944400,UNIVERSITY OF LANCASTER                 ,FC,00000-0000,Public       ,0,1,1,12,40,52
00963400,UNIVERSITY OF OXFORD ST CATHERINE'S     ,FC,00000-0000,Public       ,0,0,0,1,4,5
00980800,UNIVERSITY OF STRATHCLYDE               ,FC,00000-0000,Public       ,0,2,2,5,52,57
00986000,UNIVERSITY OF SURREY                    ,FC,00000-0000,Public       ,1,2,3,8,44,52
00990600,PONTIFICAL NORTH AMERICAN COLLEGE       ,FC,00000-0000,Private      ,0,0,0,1,8,9
00992700,UNIVERSITY OF CAMBRIDGE - FITZWILLI     ,FC,00000-0000,Public       ,0,1,1,0,13,13
01006700,LUND UNIVERSITY                         ,FC,00000-0000,Public       ,0,3,3,6,99,105
01008400,UNIVERSITY OF CAPE TOWN                 ,FC,00000-0000,Private      ,0,19,19,6,75,81
01008700,UNIVERSITY OF OXFORD ST PETER'S COL     ,FC,00000-0000,Public       ,0,0,0,0,2,2
01008800,UNIVERSITY OF OXFORD - CORPUS CHRIS     ,FC,00000-0000,Public       ,0,0,0,0,3,3
01008900,CENTRAL SCHOOL OF SPEECH AND DRAMA      ,FC,00000-0000,Private      ,0,3,3,16,56,72
01009000,UNIVERSITY OF OXFORD - BALLIOL COLL     ,FC,00000-0000,Public       ,0,0,0,0,5,5
01014300,UNIVERSITY OF READING                   ,FC,00000-0000,Public       ,0,1,1,7,37,44
01015700,CARDIFF UNIVERSITY                      ,FC,00000-0000,Public       ,1,1,2,12,75,87
01015900,PONTIFICIA UNIVERSITA GREGORIANA        ,FC,00000-0000,Private      ,0,0,0,1,2,3
01016000,CG JUNG INST                            ,FC,00000-0000,Private      ,0,0,0,0,5,5
01018800,UNIVERSITY COLLEGE DUBLIN               ,FC,00000-0000,Public       ,0,5,5,27,252,279
01019000,UNIVERSITY OF CAMBRIDGE CHURCHILL C     ,FC,00000-0000,Public       ,0,0,0,0,8,8
01022800,UNIVERSITY OF STIRLING                  ,FC,00000-0000,Public       ,0,2,2,11,55,66
01033200,UNIVERSITY OF CAMBRIDGE - CLARE COL     ,FC,00000-0000,Public       ,0,0,0,1,15,16
01045600,UNIVERSITY OF HAIFA                     ,FC,00000-0000,Public       ,0,3,3,6,32,38
01047200,INST EUROPEEN OPEEN D'ADMINISTRATIO     ,FC,00000-0000,Private      ,0,7,7,0,49,49
01049300,CRANFIELD UNIVERSITY                    ,FC,00000-0000,Public       ,0,3,3,0,22,22
01052000,TRINITY LABAN CONSERVATOIRE OF MUSIC AND,FC,00000-0000,Public       ,0,1,1,3,22,25
01052500,UNIVERSITY OF HERTFORDSHIRE             ,FC,00000-0000,Public       ,0,5,5,18,22,40
01057400,LONDON INTRNTL FILM SCHOOL              ,FC,00000-0000,Private      ,0,3,3,4,32,36
01058800,AUSTRALIAN NATIONAL UNIVERSITY          ,FC,00000-0000,Public       ,0,10,10,7,54,61
01058900,BANGOR UNIVERSITY                       ,FC,00000-0000,Public       ,0,1,1,2,25,27
01059400,"RICHMOND, THE AMERICAN INT UNI IN LONDON",FC,00000-0000,Private      ,6,3,9,323,109,432
01059900,INST D'ETUDES POLITIQUES DE PARIS       ,FC,00000-0000,Public       ,0,0,0,2,99,101
01068100,MACQUARIE UNIVERSITY                    ,FC,00000-0000,Public       ,1,11,12,9,64,73
01069200,UNIVERSITY OF QUEENSLAND (THE)          ,FC,00000-0000,Public       ,2,90,92,19,271,290
01078900,UNIVERSITY OF OXFORD - WORCESTER CO     ,FC,00000-0000,Public       ,0,0,0,0,5,5
01079200,CITY AND GUILDS OF LONDON INSTITUTE     ,FC,00000-0000,Private      ,0,2,2,1,3,4
01079700,"NATIONAL UNIVERSITY OF IRELAND, MAY     ",FC,00000-0000,Public       ,0,0,0,8,12,20
01080300,SEMMELWEIS UNIVERSITY OF BUDAPEST       ,FC,00000-0000,Public       ,0,0,0,3,5,8
01081600,KINGSTON UNIVERSITY                     ,FC,00000-0000,Public       ,0,10,10,57,182,239
01083800,UNIVERSITITY OF BERGEN (UOB)            ,FC,00000-0000,Public       ,0,1,1,3,4,7
01086400,UNIV OF DUNDEE                          ,FC,00000-0000,Public       ,0,0,0,6,32,38
01086600,UNIVERSITY OF OXFORD - MAGDALEN COLLEGE ,FC,00000-0000,Public       ,0,0,0,3,13,16
01086700,UNIVERSITY OF OXFORD ST JOHN'S COLL     ,FC,00000-0000,Public       ,0,0,0,1,7,8
01091400,MONASH UNIVERSITY                       ,FC,00000-0000,Public       ,1,7,8,8,36,44
01091500,UNIV OF EAST ANGLIA                     ,FC,00000-0000,Public       ,0,8,8,16,77,93
01094200,UNIVERSITY OF OXFORD - ST HUGH'S CO     ,FC,00000-0000,Public       ,0,0,0,1,7,8
01097700,UNIVERSIDAD CENTRAL DEL ESTE            ,FC,00000-0000,Private      ,27,104,131,141,916,1057
01098000,SOMERVILLE COLLEGE                      ,FC,00000-0000,Public       ,0,0,0,1,3,4
01099900,UNIV OF OXFORD - WADHAM COLLEGE         ,FC,00000-0000,Public       ,0,0,0,2,6,8
01104400,PONTIFICIA UNIVERSITA SAN TOMMASO       ,FC,00000-0000,Private      ,0,1,1,1,6,7
01105300,UNIVERSITY OF OXFORD - ST HILDA'S C     ,FC,00000-0000,Public       ,0,0,0,0,7,7
01105400,UNIVERSITY OF OXFORD - ST ANNE'S CO     ,FC,00000-0000,Public       ,0,0,0,1,3,4
01105500,UNIV OF OXFORD - LADY MARGARET HALL     ,FC,00000-0000,Public       ,0,0,0,0,7,7
01105600,UNIVERSITY OF OXFORD - UNIVERSITY C     ,FC,00000-0000,Public       ,0,0,0,1,9,10
01105700,UNIVERSITY OF OXFORD - TRINITY COLL     ,FC,00000-0000,Public       ,0,0,0,1,6,7
01105800,UNIVERSITY OF OXFORD-ST EDMUND HALL     ,FC,00000-0000,Public       ,0,0,0,0,11,11
01105900,UNIVERSITY OF OXFORD ST ANTONY'S CO     ,FC,00000-0000,Public       ,0,2,2,0,23,23
01106000,UNIVERSITY OF OXFORD - QUEEN'S COLL     ,FC,00000-0000,Public       ,0,0,0,1,11,12
01106100,UNIVERSITY OF OXFORD - PEMBROKE COL     ,FC,00000-0000,Public       ,0,0,0,1,6,7
01106200,UNIVERSITY OF OXFORD - ORIEL COLLEG     ,FC,00000-0000,Public       ,1,0,1,1,6,7
01106300,UNIVERSITY OF OXFORD - NUFFIELD COL     ,FC,00000-0000,Public       ,0,0,0,0,2,2
01106400,UNIVERSITY OF OXFORD - NEW COLLEGE      ,FC,00000-0000,Public       ,0,0,0,0,9,9
01106500,UNIVERSITY OF OXFORD MERTON COLLEGE     ,FC,00000-0000,Public       ,0,0,0,2,15,17
01106600,UNIVERSITY OF OXFORD - LINCOLN COLL     ,FC,00000-0000,Public       ,0,0,0,0,12,12
01106700,UNIVERSITY OF OXFORD - KEBLE COLLEG     ,FC,00000-0000,Public       ,0,2,2,0,8,8
01106800,UNIVERSITY OF OXFORD - JESUS COLLEG     ,FC,00000-0000,Public       ,0,1,1,1,3,4
01106900,UNIVERSITY OF OXFORD - HERTFORD COL     ,FC,00000-0000,Public       ,0,0,0,1,7,8
01107000,UNIVERSITY OF OXFORD EXETER COLLEGE     ,FC,00000-0000,Public       ,0,2,2,0,13,13
01107100,UNIV OF OXFORD - CHRIST CHURCH          ,FC,00000-0000,Public       ,0,0,0,1,12,13
01107200,UNIVERSITY OF OXFORD - BRASENOSE CO     ,FC,00000-0000,Public       ,0,0,0,0,4,4
01109100,FLINDERS UNIVERSITY OF S AUSTRALIA      ,FC,00000-0000,Public       ,0,5,5,3,31,34
01109400,UNIVERSITY OF WESTERN AUSTRALIA (THE)   ,FC,00000-0000,Public       ,0,5,5,6,27,33
01122600,AARHUS UNIVERSITY                       ,FC,00000-0000,Public       ,0,1,1,4,25,29
01156700,"IMPERIAL COLLEGE OF SCIENCE, TECHNOLOGY ",FC,00000-0000,Public       ,1,2,3,12,63,75
01167900,UNIVERSITY OF BATH                      ,FC,00000-0000,Public       ,0,0,0,5,28,33
01168300,FRANKLIN COLLEGE  SWITZERLAND           ,FC,00000-0000,Private      ,14,2,16,314,23,337
01175800,UNIV OF CAMBRIDGE - PETERHOUSE          ,FC,00000-0000,Public       ,0,0,0,1,9,10
01176400,ROYAL ACADEMY OF MUSIC                  ,FC,00000-0000,Public       ,0,0,0,10,30,40
01176500,GOLDSMITHS' COLLEGE-UNIV OF LONDON      ,FC,00000-0000,Public       ,3,5,8,25,152,177
01176600,UNIV OF LONDON - INST OF EDUC           ,FC,00000-0000,Public       ,0,2,2,0,28,28
01178000,BRUNEL UNIVERSITY                       ,FC,00000-0000,Public       ,0,1,1,3,38,41
01183800,UNIVERSITY OF OXFORD - MANSFIELD CO     ,FC,00000-0000,Public       ,0,0,0,0,1,1
01207500,UNIVERSITY CAMBRIDGE - TRINITY COLL     ,FC,00000-0000,Public       ,1,0,1,4,14,18
01207800,VICTORIA UNIV OF WELLINGTON             ,FC,00000-0000,Public       ,5,20,25,15,65,80
01209600,ECOLE HåTELIERE DE LAUSANNE             ,FC,00000-0000,Private      ,1,0,1,2,7,9
01210100,UNIVERSITY OF CAMBRIDGE - GIRTON CO     ,FC,00000-0000,Public       ,0,0,0,1,3,4
01213600,VICTORIA UNIV OF MANCHESTER (THE)       ,FC,00000-0000,Public       ,0,10,10,18,168,186
01219800,UNIVERSITY OF BRADFORD                  ,FC,00000-0000,Public       ,0,1,1,5,14,19
01220100,UNIVERSITY OF OXFORD - REGENT'S PAR     ,FC,00000-0000,Public       ,0,0,0,1,5,6
01220600,JAMES COOK UNIVERSITY                   ,FC,00000-0000,Public       ,4,22,26,30,102,132
01221500,BIRMINGHAM CITY UNIVERSITY              ,FC,00000-0000,Public       ,1,0,1,6,30,36
01222300,JAGIELLONIAN UNIVERSITY COLLEGIUM M     ,FC,00000-0000,Public       ,0,3,3,2,47,49
01222500,UNIVERSITY OF SZEGED FACULTY OF MEDICINE,FC,00000-0000,Public       ,0,0,0,2,2,4
01225800,ASTON UNIVERSITY                        ,FC,00000-0000,Public       ,0,2,2,2,17,19
01227500,UNIVERSITY OF OXFORD - WOLFSON COLL     ,FC,00000-0000,Public       ,0,1,1,0,17,17
01230200,GONVILLE & CAIUS COLLEGE                ,FC,00000-0000,Public       ,0,0,0,0,3,3
01233300,UNIV OF THE ARTS LONDON- CAMBERWELL COLL,FC,00000-0000,Public       ,0,3,3,15,21,36
01233500,ROYAL COLLEGE OF MUSIC                  ,FC,00000-0000,Public       ,0,0,0,5,20,25
01234100,UNIVERSITY OF WALES - ST DAVID'S UN     ,FC,00000-0000,Public       ,0,0,0,2,13,15
01236000,EDINBURGH COLLEGE OF ART                ,FC,00000-0000,Public       ,0,0,0,8,34,42
01242100,UNIV OF AUCKLAND                        ,FC,00000-0000,Public       ,0,18,18,21,97,118
01253900,UNIVERSITY OF THE ARTS LONDON IDO - CENT,FC,00000-0000,Public       ,2,4,6,63,60,123
01254000,UNIVERSIDAD DE NAVARRA                  ,FC,00000-0000,Private      ,1,1,2,8,21,29
01276500,UNIVERSITY OF OXFORD - LINACRE COLL     ,FC,00000-0000,Public       ,0,1,1,0,14,14
01276600,"NATIONAL UNIVERSITY IRELAND, GALWAY     ",FC,00000-0000,Public       ,0,3,3,34,107,141
01280200,PONTIFICIA UNIV CATOLICA MAD Y MAES     ,FC,00000-0000,Private      ,32,12,44,187,284,471
01281100,INST TECNOLOGICO DE SANTO DOMINGO       ,FC,00000-0000,Private      ,11,16,27,55,143,198
01283900,UNIVERSITY OF CAMBRIDGE - SAINT JOH     ,FC,00000-0000,Public       ,0,0,0,0,9,9
01286200,MOUNTVIEW ACADEMY OF THEATRE ARTS       ,FC,00000-0000,Private      ,0,0,0,0,4,4
01297800,UNIVERSITY OF HUDDERSFIELD (THE)        ,FC,00000-0000,Public       ,0,0,0,2,7,9
01315300,MASSEY UNIVERSITY                       ,FC,00000-0000,Public       ,2,44,46,11,100,111
01322500,COLLEGE OF LAW                          ,FC,00000-0000,Private      ,0,2,2,1,47,48
02052400,DARWIN COLLEGE                          ,FC,00000-0000,Public       ,0,0,0,0,17,17
02082400,UNIVERSITY OF CAMBRIDGE - QUEEN'S C     ,FC,00000-0000,Public       ,0,0,0,0,15,15
02083400,UNIVERSITY OF CAMBRIDGE - WOLFSON C     ,FC,00000-0000,Public       ,0,1,1,0,17,17
02087400,UNIVERSITY OF CAMBRIDGE - NEWNHAM C     ,FC,00000-0000,Public       ,0,0,0,2,8,10
02087900,OXFORD BROOKES UNIVERSITY               ,FC,00000-0000,Public       ,2,4,6,29,67,96
02094100,BEN-GURION UNIV                         ,FC,00000-0000,Public       ,3,4,7,6,148,154
02094400,UNIV OF CAMBRIDGE - ST EDMUND'S HOU     ,FC,00000-0000,Public       ,0,0,0,2,13,15
02095500,LONDON BUS SCHOOL                       ,FC,00000-0000,Private      ,0,7,7,2,117,119
02098700,FATIMA COLLEGE OF MEDICINE              ,FC,00000-0000,Private      ,0,0,0,1,24,25
02101900,ROEHAMPTON UNIVERSITY                   ,FC,00000-0000,Public       ,0,3,3,7,71,78
02108600,LONDON ACADEMY OF MUSIC & DRAMATIC      ,FC,00000-0000,Private      ,0,1,1,15,25,40
02115900,UNIVERSITY OF PORTSMOUTH                ,FC,00000-0000,Public       ,0,0,0,4,16,20
02116700,UNIVERSITY OF CAMBRIDGE - LUCY CAVE     ,FC,00000-0000,Public       ,0,0,0,0,8,8
02120000,UNIV OF LONDON - COURTALD INST OF A     ,FC,00000-0000,Public       ,0,0,0,1,39,40
02133400,UNIVERSITY OF CAMBRIDGE - SIDNEY SU     ,FC,00000-0000,Public       ,0,0,0,0,1,1
02142000,UNIVERSITY OF CAMBRIDGE - HOMERTON      ,FC,00000-0000,Public       ,0,0,0,0,7,7
02149700,UNIVERSITY OF WINCHESTER (THE)          ,FC,00000-0000,Public       ,0,1,1,3,11,14
02156800,UNIV OF OTAGO                           ,FC,00000-0000,Public       ,1,16,17,8,44,52
02162300,"IESE BUSINESS SCH, UNIV OF NAVARRA      ",FC,00000-0000,Private      ,1,4,5,4,69,73
02167400,UNIVERSITY OF CAMBRIDGE - CORPUS CH     ,FC,00000-0000,Public       ,0,2,2,0,11,11
02177700,KING'S COLLEGE- UNIV OF CAMBRIDGE       ,FC,00000-0000,Public       ,0,1,1,3,27,30
02180500,MIDDLESEX UNIVERSITY                    ,FC,00000-0000,Public       ,0,4,4,16,79,95
02181000,UNIVERSITY OF SOUTH AUSTRALIA           ,FC,00000-0000,Public       ,0,2,2,3,10,13
02183500,UNIV OF OXFORD - WYCLIFFE HALL          ,FC,00000-0000,Public       ,0,0,0,2,7,9
02186000,UNIVERSITY OF CAMBRIDGE - MAGDALENE     ,FC,00000-0000,Public       ,0,0,0,0,1,1
02186100,UNIVERSITY OF CAMBRIDGE - EMMANUEL      ,FC,00000-0000,Public       ,0,0,0,0,7,7
02189600,UNIVERSITY OF GRONINGEN                 ,FC,00000-0000,Public       ,0,0,0,13,26,39
02194800,UNIVERSITY OF THE WEST OF ENGLAND -     ,FC,00000-0000,Public       ,0,0,0,8,19,27
02195100,UNIV OF WESTMINSTER                     ,FC,00000-0000,Public       ,0,6,6,28,124,152
02196700,GUILDHALL SCHOOL OF MUSIC & DRAMA       ,FC,00000-0000,Public       ,1,0,1,8,14,22
02207300,UNIVERSITY OF CAMBRIDGE - CHRIST'S      ,FC,00000-0000,Public       ,0,0,0,0,10,10
02207400,CHINESE UNIVERSITY OF HONG KONG (THE)   ,FC,00000-0000,Public       ,0,2,2,14,39,53
02209500,UNIVERSITEIT UTRECHT                    ,FC,00000-0000,Public       ,0,3,3,9,68,77
02210000,UNIV OF LONDON - LONDON SCHOOL OF H     ,FC,00000-0000,Public       ,0,4,4,0,75,75
02212300,UNIVERSITY OF CAMBRIDGE - ROBINSON      ,FC,00000-0000,Public       ,0,0,0,0,2,2
02225300,UNIV OF CANTERBURY                      ,FC,00000-0000,Public       ,2,4,6,12,38,50
02229100,UNIVERSITY OF LEICESTER                 ,FC,00000-0000,Public       ,0,8,8,2,89,91
02229600,SACKLER SCHOOL OF MEDICINE              ,FC,00000-0000,Public       ,0,0,0,1,178,179
02232100,UNIVERSITY OF CAMBRIDGE                 ,FC,00000-0000,Public       ,0,2,2,4,50,54
02233300,"ST GEORGE'S UNIVERSITY, SCHOOL OF MEDICI",FC,00000-0000,Proprietary  ,2,267,269,17,3031,3048
02235300,LONDON METROPOLITAN UNIVERSITY          ,FC,00000-0000,Public       ,0,13,13,30,138,168
02240900,AISH HATORAH CLG OF JEWISH STUDIES      ,FC,00000-0000,Private      ,0,0,0,2,2,4
02244400,AMERICAN UNIV OF THE CARIBBEAN          ,FC,00000-0000,Proprietary  ,1,125,126,9,1444,1453
02266600,UNIVERSITY OF LONDON - SAINT GEORGE     ,FC,00000-0000,Public       ,0,2,2,1,25,26
02271700,UNIVERSITY OF CAMBRIDGE - CLARE HAL     ,FC,00000-0000,Public       ,0,1,1,0,9,9
02271900,UNIVERSITY OF OXFORD - BLACKFRIARS      ,FC,00000-0000,Public       ,0,0,0,0,3,3
02272100,UNIV OF OXFORD - GREYFRIARS             ,FC,00000-0000,Public       ,0,0,0,0,2,2
02272200,UNIV OF CAMBRIDGE - NEW HALL            ,FC,00000-0000,Public       ,0,0,0,0,2,2
02273600,QUEEN'S UNIV OF BELFAST (THE)           ,FC,00000-0000,Public       ,0,0,0,15,85,100
02273900,HERIOT WATT UNIVERSITY                  ,FC,00000-0000,Public       ,1,2,3,4,27,31
02276700,NYENRODE BUSINESS UNIVERSITEIT          ,FC,00000-0000,Private      ,0,0,0,0,2,2
02293400,ECOLE DES HAUTES ETUDES COMERCIALS      ,FC,00000-0000,Public       ,0,4,4,0,33,33
02296300,UNIVERSITY OF CAMBRIDGE - JESUS COL     ,FC,00000-0000,Public       ,0,0,0,0,6,6
02310500,DE MONTFORT UNIVERSITY                  ,FC,00000-0000,Public       ,0,0,0,0,15,15
02320500,ROYAL NORTHERN COLLEGE OF MUSIC         ,FC,00000-0000,Public       ,0,0,0,2,6,8
02335100,UNIV OF CAMBRIDGE - TRINITY HALL        ,FC,00000-0000,Public       ,0,0,0,0,10,10
02338900,UNIVERSITY  FOR THE CREATIVE ARTS       ,FC,00000-0000,Public       ,0,0,0,5,3,8
02351800,UNIVERSIDAD IBEROAMERICANA (UNIBE       ,FC,00000-0000,Private      ,18,77,95,135,917,1052
02355200,ECOLE SUPERIEURE DE CUISINE FRANCAISE-FE,FC,00000-0000,Public       ,0,3,3,3,23,26
02363000,GSA CONSERVATOIRE                       ,FC,00000-0000,Private      ,0,0,0,1,0,1
02493000,ESCUELA SUPERIOR ADMINISTRACION Y D     ,FC,00000-0000,Private      ,1,1,2,3,2,5
02496700,NATIONAL FILM & TV SCHOOL               ,FC,00000-0000,Public       ,0,1,1,0,7,7
02502600,PECSI ORVOSTUDOMANYI EGYETEM (PECS      ,FC,00000-0000,Public       ,0,0,0,1,26,27
02545700,GLASGOW SCHOOL OF ART                   ,FC,00000-0000,Public       ,0,1,1,8,33,41
02561600,SOUTHAMPTON SOLENT UNIVERSITY           ,FC,00000-0000,Public       ,0,0,0,3,7,10
02579600,MURDOCH UNIVERSITY                      ,FC,00000-0000,Public       ,0,5,5,2,51,53
02588000,UNIVERSITY OF ULSTER                    ,FC,00000-0000,Public       ,0,1,1,3,24,27
02591800,CURTIN UNIVERSITY OF TECHNOLOGY         ,FC,00000-0000,Public       ,0,2,2,4,15,19
02592300,MILLTOWN INST OF THEOLOGY & PHILOSO     ,FC,00000-0000,Private      ,0,0,0,1,0,1
02604300,AALBORG UNIVERSITY                      ,FC,00000-0000,Public       ,0,0,0,1,13,14
02611600,ECOL NATIONAL DES PONTS ET CHAUSSEE     ,FC,00000-0000,Public       ,0,1,1,3,4,7
02611700,DUBLIN CITY UNIVERSITY                  ,FC,00000-0000,Public       ,0,1,1,9,21,30
02622500,DENMARKS TEKNISKE UNIVERSITET           ,FC,00000-0000,Public       ,0,0,0,0,6,6
02623200,UNIVERSITY OF NEWCASTLE (THE)           ,FC,00000-0000,Public       ,1,2,3,8,25,33
03012700,UNIVERSITY OF BUCKINGHAM                ,FC,00000-0000,Private      ,1,1,2,7,14,21
03029400,KEELE UNIVERSITY                        ,FC,00000-0000,Public       ,0,0,0,7,9,16
03029500,NORTHUMBRIA UNIVERSITY                  ,FC,00000-0000,Public       ,1,1,2,11,19,30
03029800,NORGES HANDELSHOYSKOLE                  ,FC,00000-0000,Public       ,0,0,0,1,10,11
03033300,MANCHESTER METROPOLITAN UNIV            ,FC,00000-0000,Public       ,0,3,3,16,52,68
03045000,UNIVERSITY OF EAST LONDON               ,FC,00000-0000,Public       ,1,4,5,19,52,71
03050100,STUDIO ART CENTERS INTERNATIONAL        ,FC,00000-0000,Private      ,1,1,2,31,56,87
03061000,CHALMERS TEKNISKA HOGSKOLA AB           ,FC,00000-0000,Private      ,0,0,0,0,10,10
03066800,PONTIFICIO ATENEO DELLA SANTA CROCE     ,FC,00000-0000,Private      ,0,0,0,0,8,8
03067200,UNIVERSITY OF SYDNEY                    ,FC,00000-0000,Public       ,0,61,61,24,237,261
03073800,UNIV OF DEBRECEN MED & HEALTH SCI       ,FC,00000-0000,Public       ,0,0,0,4,28,32
03080300,SHEFFIELD HALLAM UNIVERSITY             ,FC,00000-0000,Public       ,0,0,0,3,15,18
03084300,UNIVERSITY OF LIMERICK                  ,FC,00000-0000,Public       ,1,1,2,12,41,53
03088700,ROYAL SCOTTISH ACAD MUSIC & DRAMA       ,FC,00000-0000,Public       ,0,1,1,10,26,36
03091400,UNIVERSITY OF WOLLONGONG                ,FC,00000-0000,Public       ,1,5,6,3,25,28
03091500,UNIVERSITY OF CANBERRA                  ,FC,00000-0000,Public       ,0,1,1,3,15,18
03091700,POZNAN UNIVERSITY OF MEDICAL SCIENCES   ,FC,00000-0000,Public       ,0,15,15,11,207,218
03092500,NOTTINGHAM TRENT UNIVERSITY             ,FC,00000-0000,Public       ,1,1,2,4,21,25
03095000,RMIT UNIVERSITY                         ,FC,00000-0000,Public       ,0,9,9,4,38,42
03095400,BOND UNIVERSITY                         ,FC,00000-0000,Private      ,3,10,13,24,78,102
03095900,ESSEC BUSINESS SCHOOL                   ,FC,00000-0000,Private      ,0,0,0,1,20,21
03096100,LA TROBE UNIVERSITY                     ,FC,00000-0000,Public       ,0,7,7,2,38,40
03096900,DEAKIN UNIVERSITY                       ,FC,00000-0000,Public       ,0,1,1,1,11,12
03097100,UNIVERSITY OF WESTERN SYDNEY            ,FC,00000-0000,Public       ,1,3,4,2,15,17
03097300,VICTORIA UNIVERSITY OF TECHNOLOGY       ,FC,00000-0000,Public       ,0,1,1,2,9,11
03097500,CENTRAL QUEENSLAND UNIVERSITY           ,FC,00000-0000,Public       ,0,1,1,1,7,8
03100000,UNIVERSITY OF ADELAIDE (THE)            ,FC,00000-0000,Public       ,0,1,1,5,22,27
03101600,ASIAN INSTITUTE OF MANAGEMENT           ,FC,00000-0000,Private      ,0,1,1,1,17,18
03102500,AMERICAN UNIVERSITY OF ROME             ,FC,00000-0000,Private      ,6,4,10,171,74,245
03102800,ROBERT GORDON UNIVERSITY (THE)          ,FC,00000-0000,Public       ,0,0,0,1,21,22
03104800,GRIFFITH UNIVERSITY                     ,FC,00000-0000,Public       ,1,14,15,10,74,84
03136300,AUSTRALIAN CATHOLIC UNIVERSITY          ,FC,00000-0000,Public       ,0,4,4,5,17,22
03140300,EDITH COWAN UNIVERSITY                  ,FC,00000-0000,Public       ,0,1,1,4,23,27
03140400,NORTHERN TERRITORY UNIVERSITY           ,FC,00000-0000,Public       ,0,0,0,1,3,4
03140500,QUEENSLAND UNIVERSITY OF TECHNOLOGY     ,FC,00000-0000,Public       ,2,8,10,6,26,32
03140600,SOUTHERN CROSS UNIVERSITY               ,FC,00000-0000,Public       ,0,1,1,3,6,9
03140700,SWINBURNE UNIVERSITY OF TECHNOLOGY      ,FC,00000-0000,Public       ,0,5,5,4,25,29
03140900,UNIVERSITY OF BALLARAT                  ,FC,00000-0000,Public       ,1,0,1,1,2,3
03150300,UNIVERSITY OF TASMANIA                  ,FC,00000-0000,Public       ,0,0,0,0,5,5
03150400,"UNIVERSITY OF TECHNOLOGY, SYDNEY        ",FC,00000-0000,Public       ,1,10,11,2,39,41
03274300,"KUNGLIGA TEKNISKA HOGSKOLAN, KTH        ",FC,00000-0000,Public       ,0,0,0,0,4,4
03287300,LIVERPOOL INSTITUTE FOR PERFORMING ARTS ,FC,00000-0000,Public       ,0,0,0,21,2,23
03300300,"2ND SCHOOL OF MEDICINE, CHARLES UNI     ",FC,00000-0000,Public       ,0,2,2,0,7,7
03300400,"FIRST FACULTY OF MEDICINE, CHARLES UNIV.",FC,00000-0000,Public       ,0,1,1,5,32,37
03329300,JOHN CABOT UNIVERSITY                   ,FC,00000-0000,Private      ,7,1,8,164,39,203
03332400,AGRICULTURE UNIVERSITY OF WROCLAW       ,FC,00000-0000,Public       ,0,0,0,0,3,3
03333300,MEDICAL UNIVERSITY SCHOOL OF LUBLIN     ,FC,00000-0000,Public       ,2,26,28,17,215,232
03334300,UNIVERSIDAD NORDESTANA                  ,FC,00000-0000,Private      ,1,16,17,21,200,221
03335300,MEDICAL UNIVERSITY OF SILESIA           ,FC,00000-0000,Public       ,0,6,6,7,90,97
03342300,GLASGOW CALEDONIAN UNIVERSITY           ,FC,00000-0000,Public       ,0,1,1,0,1,1
03349400,"QUEEN MARGARET UNIVERSITY COLLEGE, EDINB",FC,00000-0000,Public       ,0,2,2,2,18,20
03350300,BOURNEMOUTH UNIVERSITY                  ,FC,00000-0000,Public       ,0,1,1,4,24,28
03352300,LONDON SOUTH BANK UNIVERSITY            ,FC,00000-0000,Private      ,0,3,3,12,29,41
03363300,THE ARTS EDUCATIONAL SCHOOLS LONDON     ,FC,00000-0000,Private      ,0,0,0,1,1,2
03364300,"FACULTY OF MEDICINE, PALACKY UNIVER     ",FC,00000-0000,Public       ,0,0,0,2,7,9
03365400,AUCKLAND INSTITUTE OF TECHNOLOGY        ,FC,00000-0000,Public       ,1,4,5,9,21,30
03366300,TROPICAL AGRICULTURE RESEARCH AND H     ,FC,00000-0000,Private      ,0,0,0,0,2,2
03377300,"UNIVERSITY OF WALES INSTITUTE, CARD     ",FC,00000-0000,Public       ,0,3,3,6,13,19
03378300,"THE 3RD FACULTY OF MEDICINE, CHARLE     ",FC,00000-0000,Public       ,0,0,0,2,13,15
03406300,"THE SCHOOL OF PHARMACY, UNIVERSITY      ",FC,00000-0000,Public       ,1,0,1,3,3,6
03418400,NAPIER UNIVERSITY                       ,FC,00000-0000,Public       ,0,1,1,7,23,30
03435300,ANGLIA  RUSKIN UNIVERSITY               ,FC,00000-0000,Private      ,0,3,3,2,15,17
03460300,INTERNATIONALES THEOLOGISCHES INSTI     ,FC,00000-0000,Private      ,0,0,0,5,13,18
03462400,UNIV OF ARTS LONDON - LON COLL OF COMMUN,FC,00000-0000,Public       ,0,1,1,20,32,52
03466300,INSTITUTO CENTROAMERICANO DE ADMINI     ,FC,00000-0000,Private      ,0,1,1,2,10,12
03473300,UNIV OF ARTS LONDON - LON COLL FASHION  ,FC,00000-0000,Public       ,2,1,3,54,76,130
03475300,UNIV OF THE ARTS  LONDON - CHELSEA COLL ,FC,00000-0000,Public       ,0,3,3,12,21,33
03478300,ROYAL WELSH COLLEGE OF MUSIC AND DRAMA  ,FC,00000-0000,Public       ,0,1,1,6,12,18
03492300,UNIVERSITY OF OXFORD - GREEN TEMPLETON C,FC,00000-0000,Public       ,0,1,1,0,15,15
03492400,UNIV OF CAMBRIDGE-ST CATHERINE'S CG     ,FC,00000-0000,Public       ,0,0,0,1,4,5
03494400,UNIV OF CAMBRIDGE-SELWYN COLLEGE        ,FC,00000-0000,Public       ,0,1,1,0,7,7
03494600,UNIV OF OXFORD-HARRIS MANCHESTER        ,FC,00000-0000,Public       ,0,1,1,1,7,8
03500300,WIMBLEDON COLLEGE OF ART                ,FC,00000-0000,Public       ,1,2,3,11,7,18
03501400,LEEDS METROPOLITAN UNIVERSITY           ,FC,00000-0000,Public       ,1,3,4,8,26,34
03507300,UNIVERSITY OF SUNDERLAND                ,FC,00000-0000,Public       ,0,0,0,0,7,7
03515300,UNIVERSITY OF CENTRAL LANCASHIRE        ,FC,00000-0000,Public       ,1,1,2,11,22,33
03517300,UNIVERSITY OF BRIGHTON                  ,FC,00000-0000,Public       ,0,0,0,8,28,36
03518300,EUROPEAN GRADUATE SCHOOL                ,FC,00000-0000,Private      ,0,9,9,0,103,103
03526300,INST CENTROAMERICANO DE ADM DE EMP      ,FC,00000-0000,Private      ,0,0,0,0,9,9
03527300,SOFIA UNIVERSITY ST. KLIMENT OHRIDSKI   ,FC,00000-0000,Public       ,0,0,0,0,6,6
03533300,BATH SPA UNIVERSITY                     ,FC,00000-0000,Public       ,0,1,1,4,16,20
03547300,UNIVERSITY OF GLAMORGAN                 ,FC,00000-0000,Public       ,0,1,1,6,10,16
03580300,LIVERPOOL JOHN MOORES UNIVERSITY        ,FC,00000-0000,Public       ,0,1,1,8,13,21
03589400,ARTS INSTITUTE AT BOURNEMOUTH (THE)     ,FC,00000-0000,Public       ,0,2,2,10,6,16
03590300,AVONDALE COLLEGE LIMITED                ,FC,00000-0000,Private      ,0,2,2,9,6,15
03594300,GROUP ESC GRENOBLE GRAD SCH OF BUS.     ,FC,00000-0000,Private      ,0,2,2,4,32,36
03597300,JAGIELLONIAN UNIVERSITY                 ,FC,00000-0000,Public       ,0,2,2,5,30,35
03601300,UNIVERSITAT JAUME I DE CASTELLO/UJI     ,FC,00000-0000,Public       ,0,1,1,1,8,9
03619300,UNIVERSITY OF GREENWICH                 ,FC,00000-0000,Public       ,0,1,1,20,48,68
03653400,UNIVERSIDAD DE IBEROAMERICA - UNIBE     ,FC,00000-0000,Private      ,2,3,5,7,22,29
03674300,UNIVERSITY OF ABERTAY DUNDEE            ,FC,00000-0000,Public       ,0,0,0,2,3,5
03684400,UNIVERSITY OF LINCOLN                   ,FC,00000-0000,Public       ,0,0,0,0,19,19
03684500,MEDICAL UNIVERSITY OF GDANSK            ,FC,00000-0000,Public       ,0,8,8,1,29,30
03685300,UNIVERSITAT POMPEU FABRA                ,FC,00000-0000,Public       ,0,0,0,5,24,29
03694300,UNIVERSITY COLLEGE CHICHESTER           ,FC,00000-0000,Public       ,0,0,0,0,1,1
03716300,"UNIVERSITY OF WALES, NEWPORT            ",FC,00000-0000,Public       ,0,0,0,2,7,9
03721300,WRITTLE COLLEGE                         ,FC,00000-0000,Public       ,0,0,0,1,0,1
03727400,UNIVERSITY OF WAIKATO (THE)             ,FC,00000-0000,Public       ,0,1,1,3,11,14
03738300,LONDON SCHOOL OF THEOLOGY               ,FC,00000-0000,Private      ,0,2,2,0,8,8
03741300,ALRA (ACADEMY OF LIVE AND RECORDED ARTS),FC,00000-0000,Private      ,0,1,1,2,5,7
03770300,NAZARENE THEOLOGICAL COLLEGE            ,FC,00000-0000,Private      ,0,2,2,0,11,11
03794400,ANGLO EUROPEAN COLLEGE OF CHIROPRACTIC  ,FC,00000-0000,Private      ,0,0,0,1,2,3
03807300,ROSE BRUFORD COLLEGE                    ,FC,00000-0000,Public       ,0,0,0,2,2,4
03816400,AMERICAN GRAD SCH OF INTERNTL REL & DIPL,FC,00000-0000,Private      ,0,2,2,7,66,73
03818300,LEIPZIG GRADUATE SCHOOL OF MANAGEMENT   ,FC,00000-0000,Private      ,0,3,3,0,15,15
03824300,"ROYAL VETERINARY COLLEGE (THE), UNIVERSI",FC,00000-0000,Public       ,0,1,1,1,138,139
03850500,MEDICAL UNIVERSITY OF LODZ              ,FC,00000-0000,Public       ,0,1,1,5,50,55
03859400,UNIVERSITY COLLEGE FALMOUTH             ,FC,00000-0000,Public       ,0,0,0,4,7,11
03880300,UNIVERSITY OF GLOUCESTERSHIRE (THE)     ,FC,00000-0000,Public       ,0,0,0,6,8,14
03897400,INTERNATIONAL SPACE UNIVERSITY          ,FC,00000-0000,Private      ,0,0,0,0,4,4
03926400,NATIONAL COLLEGE OF ART AND DESIGN      ,FC,00000-0000,Public       ,0,0,0,1,3,4
03941301,AVE MARIA UNIVERSITY - LATIN AMERICA    ,FC,00000-0000,Private      ,20,7,27,183,42,225
03974300,"ST. GEORGE'S UNIVERSITY, SCHOOL OF VETER",FC,00000-0000,Proprietary  ,0,55,55,2,734,736
03978300,SPURGEON'S COLLEGE                      ,FC,00000-0000,Private      ,0,0,0,0,2,2
03993400,TRINITY UNIVERSITY COLLEGE CARMARTHEN   ,FC,00000-0000,Public       ,0,0,0,0,1,1
04021400,"AMERICAN COLLEGE, DUBLIN LIMITED (THE)  ",FC,00000-0000,Private      ,0,1,1,6,14,20
04021500,CENTRAL EUROPEAN UNIVERSITY             ,FC,00000-0000,Private      ,0,3,3,4,105,109
04032300,YORK ST JOHN UNIVERSITY                 ,FC,00000-0000,Public       ,0,0,0,5,6,11
04046300,HK UNIVERSITY OF SCI & TECH (HKUST)     ,FC,00000-0000,Public       ,0,0,0,0,20,20
04070300,"RAPHAEL RECANATI INTERNATIONAL SCHOOL, T",FC,00000-0000,Private      ,8,9,17,67,73,140
04085400,NEW ZEALAND COLLEGE OF CHIROPRACTIC     ,FC,00000-0000,Private      ,0,1,1,0,1,1
04113300,LEBANESE AMERICAN UNIVERSITY            ,FC,00000-0000,Private      ,3,1,4,34,22,56
04115900,LIVERPOOL HOPE UNIVERSITY               ,FC,00000-0000,Public       ,0,3,3,4,21,25
04116300,EDHEC BUSINESS SCHOOL                   ,FC,00000-0000,Private      ,0,1,1,0,24,24
04121400,ISAPZURICH (INTERNATIONAL SCHOOL OF ANAL,FC,00000-0000,Private      ,0,0,0,1,4,5
04128600,UNIVERSITY OF WORCESTER                 ,FC,00000-0000,Public       ,0,0,0,1,6,7
04134200,LONDON CONTEMPORARY DANCE SCHOOL        ,FC,00000-0000,Private      ,1,1,2,1,2,3
04139100,UNIVERSITA DEGLI STUDI DI SCIENZE GASTRO,FC,00000-0000,Private      ,0,4,4,4,27,31
04143700,ST MARY'S UNIVERSITY COLLEGE TWICKENHAM ,FC,00000-0000,Public       ,1,8,9,3,78,81
04168200,EUROPEAN UNIVERSITY AT ST. PETERSBURG   ,FC,00000-0000,Private      ,0,2,2,0,16,16
04171800,"INTERNATIONAL UNIVERSITY OF NURSING, ST.",FC,00000-0000,Proprietary  ,1,6,7,6,12,18
00380600,ALDERSON-BROADDUS COLLEGE               ,WV,26416-1051,Private      ,16,19,35,823,332,1155
00380700,MOUNTAIN STATE UNIVERSITY               ,WV,25801-5624,Private      ,56,686,742,1353,7339,8692
00380800,BETHANY COLLEGE                         ,WV,26032-0417,Private      ,18,7,25,1244,157,1401
00380900,BLUEFIELD STATE COLLEGE                 ,WV,24701-2198,Public       ,44,165,209,1294,1977,3271
00381000,CONCORD UNIVERSITY                      ,WV,24712-0000,Public       ,43,108,151,2878,1444,4322
00381100,DAVIS & ELKINS COLLEGE                  ,WV,26241-3996,Private      ,15,18,33,917,335,1252
00381200,FAIRMONT STATE UNIVERSITY               ,WV,26554-2470,Public       ,92,340,432,5066,4196,9262
00381300,GLENVILLE STATE COLLEGE                 ,WV,26351-1292,Public       ,28,52,80,1362,716,2078
00381500,MARSHALL UNIVERSITY                     ,WV,25755-3300,Public       ,178,441,619,9685,7709,17394
00381600,SOUTHERN WV COMMUNITY COLLEGE           ,WV,25637-2900,Public       ,55,152,207,1142,1413,2555
00381800,UNIVERSITY OF CHARLESTON                ,WV,25304-1099,Private      ,25,71,96,1456,996,2452
00381900,OHIO VALLEY COLLEGE                     ,WV,26105-8000,Private      ,16,18,34,536,222,758
00382000,SALEM INTERNATIONAL UNIVERSITY          ,WV,26426-0500,Proprietary  ,11,126,137,363,997,1360
00382200,SHEPHERD UNIVERSITY                     ,WV,25443-3210,Public       ,79,93,172,4019,1762,5781
00382300,WEST LIBERTY UNIVERSITY                 ,WV,26074-0295,Public       ,43,58,101,2897,968,3865
00382600,WEST VIRGINIA STATE UNIVERSITY          ,WV,25112-0000,Public       ,69,187,256,2514,2677,5191
00382700,WEST VIRGINIA UNIVERSITY                ,WV,26506-6201,Public       ,343,473,816,25515,10492,36007
00382711,WEST VIRGINIA UNIVERSITY - POTOMAC STATE,WV,26726-3000,Public       ,34,57,91,1693,641,2334
00382721,WEST VIRGINIA UNIV INST OF TECH         ,WV,25136-2436,Public       ,19,32,51,1124,514,1638
00382800,WEST VIRGINIA UNIV AT PARKERSBURG       ,WV,26101-9577,Public       ,70,359,429,1688,3641,5329
00383000,WEST VIRGINIA WESLEYAN COLLEGE          ,WV,26201-2600,Private      ,27,20,47,1943,321,2264
00383100,WHEELING JESUIT UNIVERSITY              ,WV,26003-6243,Private      ,12,56,68,1192,849,2041
00500700,WEST VIRGINIA JUNIOR COLLEGE            ,WV,26505-5596,Proprietary  ,11,26,37,183,266,449
00500800,MOUNTAIN STATE COLLEGE                  ,WV,26101-3993,Proprietary  ,7,42,49,71,402,473
00754400,APPALACHIAN BIBLE COLLEGE               ,WV,25818-1353,Private      ,1,8,9,267,75,342
00757800,HUNTINGTON SCHOOL OF BEAUTY CULTURE     ,WV,25705-2030,Proprietary  ,10,13,23,96,188,284
00760000,INTERNATIONAL BEAUTY SCHOOL             ,WV,25401-3231,Proprietary  ,8,41,49,49,167,216
00835500,JAMES RUMSEY TECHNICAL INSTITUTE        ,WV,25403-0259,Public       ,7,27,34,85,338,423
00895900,CLARKSBURG BEAUTY ACADEMY               ,WV,26301-2903,Proprietary  ,7,19,26,50,98,148
00904700,HUNTINGTON JUNIOR COLLEGE               ,WV,25701-2004,Proprietary  ,16,108,124,201,1356,1557
00905400,WEST VIRGINIA NORTHERN CMTY COLLEGE     ,WV,26003-0000,Public       ,47,246,293,1190,2628,3818
01014000,MINERAL COUNTY VOCATIONAL TECH CTR      ,WV,26726-0000,Public       ,4,7,11,18,45,63
01035600,EVEREST INSTITUTE                       ,WV,25313-1304,Proprietary  ,17,86,103,122,464,586
01057300,WEST VIRGINIA JUNIOR COLLEGE            ,WV,25322-0000,Proprietary  ,20,56,76,198,397,595
01057302,WEST VIRGINIA JUNIOR COLLEGE            ,WV,26330-0000,Proprietary  ,35,55,90,199,435,634
01086100,WEST VIRGINIA BUSINESS COLLEGE          ,WV,26301-0000,Proprietary  ,2,14,16,36,202,238
01124500,WEST VIRGINIA SCH OSTEOPATHIC MED       ,WV,24901-1128,Public       ,0,5,5,12,903,915
01174900,WOOD COUNTY SCH OF PRAC NURSING         ,WV,26101-6424,Public       ,1,6,7,27,90,117
01235900,B M SPURR SCHOOL OF PRAC NURSING        ,WV,26038-1660,Private      ,0,2,2,13,28,41
01257300,WEST VIRGINIA UNIV-HOSP-RAD TECH        ,WV,26506-8062,Private      ,0,4,4,74,73,147
01274300,BENJAMIN FRANKLIN CAREER&TECH           ,WV,25064-0000,Public       ,7,23,30,84,195,279
01290400,MONONGALIA CNTY TECH ED CTR             ,WV,26501-6841,Public       ,1,11,12,73,131,204
01290500,ACADEMY OF CAREERS AND TECHNOLOGY       ,WV,25801-0000,Public       ,6,22,28,95,353,448
02057400,ROANE-JACKSON TECHNICAL CENTER          ,WV,25252-0000,Public       ,0,13,13,22,72,94
02068000,UNITED TECHNICAL CENTER                 ,WV,26301-0000,Public       ,0,10,10,40,129,169
02070100,BECKLEY BEAUTY ACADEMY                  ,WV,25801-0000,Proprietary  ,0,7,7,34,80,114
02073400,CARVER CAREER TECH ED CTR               ,WV,25306-6397,Public       ,6,44,50,175,401,576
02145100,SCOTT COLLEGE OF COSMETOLOGY            ,WV,26003-0000,Proprietary  ,7,11,18,62,65,127
02178200,CHARLESTON SCHOOL OF BEAUTY CULTURE     ,WV,25301-0000,Proprietary  ,7,34,41,60,168,228
02218200,GARNET CAREER CENTER                    ,WV,25301-0000,Public       ,13,56,69,101,412,513
02275300,CABELL COUNTY CAREER TECHNOLOGY CTR     ,WV,25705-0000,Public       ,3,21,24,98,262,360
02524500,RALPH R WILLIS VOCATIONAL CENTER        ,WV,25601-0000,Public       ,1,4,5,26,64,90
02534800,FRED W EBERLE TECHNICAL CENTER          ,WV,26201-0000,Public       ,3,25,28,56,174,230
02535500,MERCER COUNTY TECH EDUC CNTR            ,WV,24740-0000,Public       ,3,40,43,72,243,315
02579900,NORTH CENTRAL OPPORTUNITIES INDUSTRIALIZ,WV,26554-2936,Private      ,7,19,26,28,121,149
02609400,VALLEY COLLEGE                          ,WV,25404-5711,Proprietary  ,0,23,23,16,169,185
03052000,MEREDITH MANOR EQUESTRIAN CENTRE        ,WV,26184-9707,Proprietary  ,17,30,47,225,142,367
03076500,FAYETTE INSTITUTE OF TECHNOLOGY         ,WV,25901-2174,Public       ,2,15,17,25,87,112
03084200,VALLEY COLLEGE                          ,WV,24740-3141,Proprietary  ,1,19,20,19,100,119
03084400,VALLEY COLLEGE                          ,WV,25801-2643,Proprietary  ,1,22,23,29,153,182
03098300,PUTNAM CAREER & TECHNICAL CENTER        ,WV,25070-0000,Public       ,2,11,13,71,118,189
03099200,"MOUNTAINEER BEAUTY COLLEGE, INC         ",WV,25177-2917,Proprietary  ,1,9,10,54,92,146
03102100,MORGANTOWN BEAUTY COLLEGE               ,WV,26505-5430,Proprietary  ,4,13,17,65,114,179
03123200,STANLEY TECHNICAL INSTITUTE             ,WV,26505-3751,Private      ,0,8,8,6,38,44
03327500,SOUTH BRANCH VOCATIONAL TECH CENTER     ,WV,26847-1698,Public       ,0,2,2,4,18,22
03734300,JOHN D. ROCKEFELLER IV CAREER CENTER    ,WV,26047-9424,Public       ,0,2,2,4,32,36
03819300,AMERICAN PUBLIC UNIVERSITY SYSTEM       ,WV,25414-1621,Proprietary  ,398,9618,10016,1713,45123,46836
03957300,BLUE RIDGE COMMUNITY AND TECHNICAL COLLE,WV,25401-3244,Public       ,61,292,353,768,2308,3076
03960300,NEW RIVER COMMUNITY AND TECHNICAL COLLEG,WV,25801-2636,Public       ,53,252,305,1056,2663,3719
04028300,MOUNTAIN STATE SCHOOL OF MASSAGE        ,WV,25304-2025,Proprietary  ,2,20,22,21,79,100
04038500,PIERPONT COMMUNITY & TECHNICAL COLLEGE  ,WV,26554-2451,Public       ,50,206,256,1484,1854,3338
04038600,KANAWHA VALLEY COMMUNITY & TECH COLLEGE ,WV,25112-1000,Public       ,33,164,197,648,1736,2384
04041400,MOUNTWEST COMMUNITY AND TECHNICAL COLLEG,WV,25755-3300,Public       ,50,195,245,860,2086,2946
04047300,BRIDGEMONT COMMUNITY & TECHNICAL COLLEGE,WV,25136-2435,Public       ,6,31,37,397,403,800
04119000,EASTERN WEST VIRGINIA COMMUNITY & TECHNI,WV,26836-0000,Public       ,12,76,88,184,603,787
00106100,ALASKA PACIFIC UNIVERSITY               ,AK,99508-4672,Private      ,25,92,117,489,879,1368
00106300,UNIVERSITY OF ALASKA FAIRBANKS          ,AK,99775-7500,Public       ,138,403,541,3053,4412,7465
00106500,UNIVERSITY OF ALASKA SOUTHEAST          ,AK,99801-8680,Public       ,41,176,217,792,1688,2480
00884300,ALASKA BIBLE COLLEGE                    ,AK,99588-0000,Private      ,4,2,6,25,27,52
01146200,UNIVERSITY OF ALASKA ANCHORAGE          ,AK,99514-1608,Public       ,372,970,1342,6228,10027,16255
02541000,CAREER ACADEMY                          ,AK,99507-0000,Proprietary  ,25,144,169,177,735,912
02576900,CHARTER COLLEGE                         ,AK,99508-0000,Proprietary  ,184,740,924,929,3891,4820
03160300,AVTEC                                   ,AK,99664-0889,Public       ,24,69,93,229,463,692
03461300,ILISAGVIK COLLEGE                       ,AK,99723-0749,Public       ,4,11,15,29,76,105
04138600,ALASKA CHRISTIAN COLLEGE                ,AK,99669-9755,Private      ,7,6,13,54,46,100
00108500,UNIV ARKANSAS MONTICELLO                ,AR,71656-0000,Public       ,101,290,391,2408,2680,5088
00108600,UNIV OF ARKANSAS AT PINE BLUFF          ,AR,71601-2790,Public       ,108,139,247,3903,2051,5954
00108700,ARKANSAS BAPTIST COLLEGE                ,AR,72202-6099,Private      ,63,123,186,1010,1454,2464
00108800,LYON COLLEGE                            ,AR,72501-3699,Private      ,21,15,36,813,183,996
00108900,ARKANSAS TECH UNIVERSITY                ,AR,72801-2222,Public       ,180,518,698,6640,5396,12036
00109000,ARKANSAS STATE UNIVERSITY               ,AR,72467-0000,Public       ,325,1123,1448,9139,12253,21392
00109006,DELTA TECHNICAL INSTITUTE               ,AR,72365-9558,Public       ,5,23,28,72,177,249
00109100,ARKANSAS STATE UNIVERSITY - BEEBE       ,AR,72012-1000,Public       ,121,365,486,2132,3500,5632
00109200,UNIVERSITY OF CENTRAL ARKANSAS          ,AR,72035-0001,Public       ,230,370,600,9242,5236,14478
00109300,CENTRAL BAPTIST COLLEGE                 ,AR,72034-6470,Private      ,14,40,54,644,510,1154
00109400,UNIVERSITY OF THE OZARKS                ,AR,72830-2880,Private      ,29,19,48,797,188,985
00109500,CROWLEYS RIDGE COLLEGE                  ,AR,72450-9775,Private      ,11,16,27,212,152,364
00109700,HARDING UNIVERSITY                      ,AR,72149-0001,Private      ,106,99,205,3889,1888,5777
00109800,HENDERSON STATE UNIVERSITY              ,AR,71999-0001,Public       ,103,139,242,3772,2182,5954
00109900,HENDRIX COLLEGE                         ,AR,72032-3080,Private      ,43,27,70,2156,257,2413
00110000,JOHN BROWN UNIVERSITY                   ,AR,72761-2747,Private      ,33,105,138,1573,1325,2898
00110100,UNIV ARKANSAS LITTLE ROCK               ,AR,72204-1099,Public       ,221,778,999,5349,11216,16565
00110200,OUACHITA BAPTIST UNIVERSITY             ,AR,71998-0001,Private      ,34,17,51,1847,203,2050
00110300,PHILANDER SMITH COLLEGE                 ,AR,72202-3718,Private      ,26,74,100,1051,923,1974
00110400,PHILLIPS COUNTY COMMUNITY COLLEGE       ,AR,72342-0000,Public       ,30,86,116,574,1020,1594
00110600,WILLIAMS BAPTIST COLLEGE                ,AR,72476-4661,Private      ,13,17,30,615,254,869
00110700,SOUTHERN ARKANSAS UNIVERSITY            ,AR,71754-0000,Public       ,77,154,231,2708,2001,4709
00110800,UNIV ARKANSAS FAYETTEVILLE              ,AR,72701-0000,Public       ,459,488,947,15750,7627,23377
00110900,UNIVERSITY OF ARKANSAS FOR MEDICAL SCIEN,AR,72205-7102,Public       ,35,156,191,697,2848,3545
00110901,UNIVERSITY OF ARKANSAS FOR MEDICAL SCIEN,AR,71603-7000,Public       ,0,0,0,77,264,341
00111000,UNIVERSITY OF ARKANSAS-FORT SMITH       ,AR,72904-7397,Public       ,172,488,660,4436,5309,9745
00524500,U OF A COMM COLLEGE AT MORRILTON        ,AR,72110-9601,Public       ,81,264,345,1305,2205,3510
00570700,SEARK COLLEGE                           ,AR,71603-0000,Public       ,61,287,348,799,2406,3205
00573200,UNIV AR COMMUNITY COLLEGE AT HOPE       ,AR,71801-0000,Public       ,35,138,173,526,1309,1835
00704400,CROWLEYS RIDGE TECHNICAL INSTITUTE      ,AR,72336-0000,Public       ,12,32,44,154,347,501
00732967,ITT TECHNICAL INSTITUTE                 ,AR,72204-7739,Proprietary  ,47,159,206,289,943,1232
00773800,SOUTHERN ARKANSAS UNIVERSITY TECH       ,AR,71701-1900,Public       ,27,122,149,543,1091,1634
00792100,PAUL MITCHELL THE SCHOOL ARKANSAS       ,AR,72701-0000,Proprietary  ,7,19,26,94,153,247
00997600,OUACHITA TECHNICAL COLLEGE              ,AR,72104-0816,Public       ,24,149,173,363,1208,1571
01074100,MELLIE'S BEAUTY COLLEGE                 ,AR,72901-3886,Proprietary  ,2,30,32,41,210,251
01210500,NATIONAL PARK COMMUNITY COLLEGE         ,AR,71913-9174,Public       ,103,476,579,1299,3614,4913
01226000,EAST ARKANSAS COMMUNITY COLLEGE         ,AR,72335-2204,Public       ,30,100,130,537,1031,1568
01226100,NORTH ARKANSAS COLLEGE                  ,AR,72601-5508,Public       ,69,300,369,1114,2215,3329
01286000,ARKANSAS NORTHEASTERN COLLEGE           ,AR,72316-1109,Public       ,41,162,203,896,1705,2601
02052200,BLACK RIVER TECHNICAL COLLEGE           ,AR,72455-0000,Public       ,69,336,405,900,2531,3431
02073500,UNIVERSITY OF ARKANSAS COMMUNITY COLLEGE,AR,72503-0000,Public       ,39,137,176,662,1516,2178
02073700,NORTHWEST TECHNICAL INSTITUTE           ,AR,72765-0000,Public       ,21,89,110,219,612,831
02074600,SOUTH ARKANSAS COMMUNITY COLLEGE        ,AR,71731-0000,Public       ,49,258,307,631,1934,2565
02075300,PULASKI TECHNICAL COLLEGE               ,AR,72118-0000,Public       ,380,1721,2101,4103,15019,19122
02087000,OZARKA COLLEGE                          ,AR,72556-0000,Public       ,49,173,222,450,1573,2023
02111100,RICH MOUNTAIN COMMUNITY COLLEGE         ,AR,71953-0000,Public       ,20,71,91,380,674,1054
02202400,PROFESSIONAL COSMETOLOGY EDUC CTR       ,AR,71730-5828,Proprietary  ,2,22,24,21,95,116
02220900,COSSATOT COMMUNITY COLLEGE              ,AR,71832-0000,Public       ,25,132,157,453,1132,1585
02260400,BEE JAY'S HAIRSTYLING ACADEMY           ,AR,72212-0000,Proprietary  ,0,13,13,17,69,86
02260401,BEE JAY'S HAIRSTYLING ACADEMY - BATESVIL,AR,72501-6709,Proprietary  ,1,2,3,10,36,46
02272400,EASTERN COLLEGE OF HEALTH VOCATIONS     ,AR,72205-3535,Proprietary  ,33,135,168,158,730,888
02284200,NEW TYLER BARBER COLLEGE INC            ,AR,72114-0000,Proprietary  ,4,20,24,57,170,227
02287400,MARSHA KAY BEAUTY COLLEGE               ,AR,72653-0000,Proprietary  ,1,6,7,11,23,34
02330800,JEFFERSON SCHOOL OF NURSING             ,AR,71603-0000,Private      ,5,14,19,65,176,241
02339800,SOUTHERN INSTITUTE OF COSMETOLOGY       ,AR,72301-0000,Proprietary  ,5,9,14,34,63,97
02341700,CAREER ACADEMY OF HAIR DESIGN           ,AR,72764-4304,Proprietary  ,9,29,38,38,149,187
02341701,CAREER ACADEMY OF HAIR DESIGN - ROGERS  ,AR,72756-2102,Proprietary  ,7,28,35,46,159,205
02341702,CAREER ACADEMY OF HAIR DESIGN - SILOAM  ,AR,72761-4217,Proprietary  ,2,15,17,16,54,70
02348200,MID-SOUTH COMMUNITY COLLEGE             ,AR,72301-0000,Public       ,49,176,225,785,2006,2791
02363500,ARTHUR'S BEAUTY COLLEGE                 ,AR,72901-0000,Proprietary  ,2,28,30,40,171,211
02525800,LEE'S SCHOOL OF COSMETOLOGY             ,AR,72114-0000,Proprietary  ,5,12,17,40,100,140
02538500,ARTHUR'S BEAUTY COLLEGE                 ,AR,72076-0000,Proprietary  ,11,30,41,90,241,331
02569600,SEARCY BEAUTY COLLEGE                   ,AR,72143-0000,Proprietary  ,2,17,19,20,88,108
03005100,ARKANSAS BEAUTY SCHOOL                  ,AR,72209-5116,Proprietary  ,7,23,30,54,174,228
03007100,HOT SPRINGS BEAUTY COLLEGE              ,AR,71901-5432,Proprietary  ,3,18,21,46,109,155
03007600,ARKANSAS BEAUTY SCHOOL-CONWAY           ,AR,72032-4354,Proprietary  ,8,22,30,53,119,172
03023400,ARKANSAS COLLEGE OF BARBERING           ,AR,72114-5615,Proprietary  ,10,31,41,59,155,214
03063300,NORTHWEST ARKANSAS COMMUNITY COLLEG     ,AR,72712-5190,Public       ,180,697,877,3258,6216,9474
03065100,ABC BEAUTY COLLEGE                      ,AR,71923-4206,Proprietary  ,5,13,18,29,78,107
03066302,BRYAN COLLEGE -                         ,AR,72756-1825,Proprietary  ,7,53,60,80,393,473
03105200,BAPTIST HEALTH SCHOOLS LITTLE ROCK      ,AR,72210-2820,Private      ,25,152,177,543,1672,2215
03115102,HERITAGE COLLEGE - LITTLE ROCK          ,AR,72227-5544,Proprietary  ,27,146,173,197,954,1151
03124900,IMAGINE -  PAUL MITCHELL PARTNER SCHOOL ,AR,72117-2516,Proprietary  ,14,40,54,159,343,502
03127200,ASKINS VO-TECH                          ,AR,72908-8028,Proprietary  ,1,12,13,12,60,72
03214300,VELVATEX COLLEGE OF BEAUTY CULTURE      ,AR,72202-5452,Proprietary  ,2,6,8,15,48,63
03254300,MARGARET'S HAIR ACADEMY                 ,AR,71655-4905,Proprietary  ,4,13,17,35,74,109
03519400,LYNNDALE FUNDAMENTALS OF BEAUTY SCH     ,AR,71730-4804,Proprietary  ,0,8,8,8,44,52
03855300,ECCLESIA COLLEGE                        ,AR,72762-8159,Private      ,6,13,19,112,94,206
03912300,CROSSETT SCHOOL OF COSMETOLOGY          ,AR,71635-0000,Proprietary  ,2,6,8,18,39,57
03997300,ARKANSAS BEAUTY COLLEGE                 ,AR,72801-3741,Proprietary  ,3,16,19,30,87,117
04183100,WASHINGTON BARBER COLLEGE               ,AR,72209-3820,Proprietary  ,7,11,18,17,61,78
04183400,SALON PROFESSIONAL ACADEMY (THE)        ,AR,72116-7310,Proprietary  ,2,24,26,36,104,140
00133900,CORBAN UNIVERSITY                       ,OR,97301-9392,Private      ,30,54,84,1911,819,2730
00318600,BLUE MOUNTAIN COMMUNITY COLLEGE         ,OR,97801-0000,Public       ,65,249,314,1192,2392,3584
00318800,CENTRAL OREGON COMMUNITY COLLEGE        ,OR,97701-5998,Public       ,231,843,1074,2957,7669,10626
00318900,CLATSOP COMMUNITY COLLEGE               ,OR,97103-3698,Public       ,42,172,214,578,1604,2182
00319100,CONCORDIA UNIVERSITY                    ,OR,97211-6099,Private      ,54,346,400,1822,3135,4957
00319300,EASTERN OREGON UNIVERSITY               ,OR,97850-2899,Public       ,94,203,297,2700,3530,6230
00319400,GEORGE FOX UNIVERSITY                   ,OR,97132-2697,Private      ,82,192,274,3466,2369,5835
00319600,LANE COMMUNITY COLLEGE                  ,OR,97405-0640,Public       ,473,1276,1749,7140,15796,22936
00319700,LEWIS & CLARK COLLEGE                   ,OR,97219-7899,Private      ,81,108,189,5196,3743,8939
00319800,LINFIELD COLLEGE                        ,OR,97128-6894,Private      ,77,77,154,3543,1287,4830
00319801,LINFIELD COLLEGE - PORTLAND CAMPUS      ,OR,97210-0000,Private      ,9,52,61,432,1020,1452
00319900,MARYLHURST UNIVERSITY                   ,OR,97036-7036,Private      ,11,202,213,167,2274,2441
00320300,MOUNT ANGEL SEMINARY                    ,OR,97373-0505,Private      ,0,0,0,18,37,55
00320400,MOUNT HOOD COMMUNITY COLLEGE            ,OR,97030-3300,Public       ,372,982,1354,5121,9703,14824
00320600,MULTNOMAH BIBLE COLLEGE/SEMINARY        ,OR,97220-5898,Private      ,12,80,92,619,863,1482
00320700,PACIFIC NORTHWEST COLLEGE OF ART        ,OR,97209-3023,Private      ,28,39,67,765,717,1482
00320800,NORTHWEST CHRISTIAN UNIVERSITY          ,OR,97401-3727,Private      ,11,42,53,602,711,1313
00320900,WESTERN OREGON UNIVERSITY               ,OR,97361-1394,Public       ,192,173,365,7198,3343,10541
00321000,OREGON STATE UNIVERSITY                 ,OR,97331-8507,Public       ,607,732,1339,22994,12878,35872
00321100,OREGON INSTITUTE OF TECHNOLOGY          ,OR,97601-8801,Public       ,69,139,208,2566,2604,5170
00321200,PACIFIC UNIVERSITY                      ,OR,97116-1797,Private      ,85,89,174,3571,3160,6731
00321300,PORTLAND COMMUNITY COLLEGE              ,OR,97219-7198,Public       ,1099,3683,4782,13801,35700,49501
00321312,PORTLAND COMMUNITY COLLEGE - COLUMBIA GO,OR,97058-3447,Public       ,4,12,16,343,797,1140
00321600,PORTLAND STATE UNIVERSITY               ,OR,97207-0000,Public       ,589,1509,2098,14895,24966,39861
00321700,REED COLLEGE                            ,OR,97202-8199,Private      ,45,55,100,2741,590,3331
00321800,CHEMEKETA COMMUNITY COLLEGE             ,OR,97309-1500,Public       ,435,1411,1846,6168,14617,20785
00321900,SOUTHERN OREGON UNIVERSITY              ,OR,97520-5010,Public       ,173,249,422,5481,4131,9612
00322000,SOUTHWESTERN OREGON COMMUNITY CLG       ,OR,97420-2956,Public       ,56,171,227,1659,2073,3732
00322100,TREASURE VALLEY COMMUNITY COLLEGE       ,OR,97914-3423,Public       ,119,368,487,1693,3126,4819
00322200,UMPQUA COMMUNITY COLLEGE                ,OR,97470-0226,Public       ,84,337,421,1481,4172,5653
00322300,UNIVERSITY OF OREGON                    ,OR,97403-1226,Public       ,731,972,1703,28511,14661,43172
00322400,UNIVERSITY OF PORTLAND                  ,OR,97203-5798,Private      ,186,186,372,9376,2778,12154
00322500,WARNER PACIFIC COLLEGE                  ,OR,97215-4099,Private      ,21,183,204,946,2083,3029
00322700,WILLAMETTE UNIVERSITY                   ,OR,97301-3930,Private      ,75,76,151,5145,1910,7055
00487800,CLACKAMAS COMMUNITY COLLEGE             ,OR,97045-7998,Public       ,280,683,963,3949,6967,10916
00488200,OREGON HEALTH & SCIENCE UNIVERSITY      ,OR,97239-0000,Public       ,30,139,169,652,3924,4576
00693800,LINN BENTON COMMUNITY COLLEGE           ,OR,97321-3774,Public       ,234,643,877,4106,6745,10851
00717800,WESTERN SEMINARY                        ,OR,97215-0000,Private      ,0,75,75,12,482,494
00723402,HEALD COLLEGE - PORTLAND                ,OR,97205-3432,Proprietary  ,47,196,243,400,1758,2158
00732969,ITT TECHNICAL INSTITUTE                 ,OR,97220-6819,Proprietary  ,64,288,352,578,2101,2679
00781900,ART INSTITUTE OF PORTLAND (THE)         ,OR,97209-2911,Proprietary  ,158,196,354,1998,2284,4282
00888700,CONCORDE CAREER INSTITUTE               ,OR,97232-2242,Proprietary  ,40,165,205,312,1161,1473
00907900,EVEREST COLLEGE                         ,OR,97204-2296,Proprietary  ,16,165,181,293,1208,1501
00958100,SPRINGFIELD COLLEGE OF BEAUTY           ,OR,97477-5474,Proprietary  ,9,22,31,86,195,281
01012200,PHAGANS' MEDFORD BEAUTY SCHOOL          ,OR,97504-5297,Proprietary  ,11,29,40,76,207,283
01018200,ROGUE COMMUNITY COLLEGE                 ,OR,97527-0000,Public       ,197,856,1053,2950,8124,11074
01050700,ACADEMY OF HAIR DESIGN                  ,OR,97301-3526,Proprietary  ,5,27,32,52,154,206
01230900,UNIVERSITY OF WESTERN STATES            ,OR,97230-3099,Private      ,1,33,34,62,636,698
01234700,PHAGANS CENTRAL OREGON BEAUTY CLG       ,OR,97701-5175,Proprietary  ,22,46,68,99,314,413
01234800,PHAGANS BEAUTY COLLEGE                  ,OR,97333-4716,Proprietary  ,5,20,25,68,126,194
01235000,PHAGANS SCHOOL OF HAIR DESIGN           ,OR,97267-0000,Proprietary  ,10,15,25,89,186,275
01235100,PHAGANS SCHOOL OF BEAUTY                ,OR,97301-4732,Proprietary  ,8,25,33,66,183,249
01300800,PHAGANS TIGARD BEAUTY SCHOOL            ,OR,97223-0000,Proprietary  ,5,9,14,39,88,127
02101000,NORTHWEST COLLEGE OF HAIR DESIGN        ,OR,97086-7702,Proprietary  ,29,77,106,251,570,821
02101002,NORTHWEST COLLEGE                       ,OR,97007-3954,Proprietary  ,3,8,11,45,88,133
02104900,COLLEGE OF LEGAL ARTS                   ,OR,97219-9998,Proprietary  ,9,59,68,95,449,544
02106100,COLLEGE OF COSMETOLOGY                  ,OR,97601-0000,Proprietary  ,4,21,25,40,113,153
02154400,BEAU MONDE CLG OF HAIR DESIGN           ,OR,97205-0000,Proprietary  ,14,51,65,127,320,447
02159700,NEW HOPE CHRISTIAN COLLEGE              ,OR,97405-1194,Private      ,12,15,27,173,173,346
02201900,PHAGANS' SCHOOL OF HAIR DESIGN          ,OR,97232-0000,Proprietary  ,16,56,72,137,444,581
02239203,ANTHEM COLLEGE - BEAVERTON              ,OR,97005-0000,Proprietary  ,4,36,40,62,226,288
02330100,PIONEER PACIFIC COLLEGE                 ,OR,97070-0000,Proprietary  ,50,174,224,415,1546,1961
02330102,PIONEER PACIFIC COLLEGE                 ,OR,97403-0000,Proprietary  ,27,114,141,254,1088,1342
02337900,COLLEGE OF HAIR DESIGN CAREERS          ,OR,97301-0000,Proprietary  ,8,15,23,81,157,238
02344100,ROSEBURG BEAUTY COLLEGE                 ,OR,97470-0000,Proprietary  ,3,15,18,46,114,160
02534000,NATIONAL COLLEGE OF NATURAL MEDICINE    ,OR,97201-0000,Private      ,3,35,38,39,842,881
02578800,NORTHWEST NANNIES INSTITUTE             ,OR,97035-0000,Proprietary  ,3,6,9,28,21,49
02603700,OREGON COL OF ORIENTAL MEDICINE         ,OR,97216-0000,Private      ,3,15,18,26,427,453
02617506,EVEREST COLLEGE - EVEREST INSTITUTE     ,OR,97223-6581,Proprietary  ,19,93,112,104,463,567
03007300,OREGON COLLEGE OF ART & CRAFT           ,OR,97225-6399,Private      ,11,33,44,205,384,589
03022600,LE CORDON BLEU COLLEGE OF CULINARY ARTS ,OR,97205-2793,Proprietary  ,96,362,458,1299,2744,4043
03042500,CARRINGTON COLLEGE                      ,OR,97232-1302,Proprietary  ,43,198,241,386,1349,1735
03074400,PHAGANS NEWPORT ACAD CSMTLGY CAREER     ,OR,97365-4963,Proprietary  ,4,15,19,17,71,88
03074500,EAST-WEST COLLEGE OF THE HEALING ARTS   ,OR,97232-2765,Proprietary  ,13,55,68,125,466,591
03185300,PHAGANS GRANTS PASS COLLEGE OF BTY      ,OR,97527-3039,Proprietary  ,3,22,25,37,120,157
03428300,KLAMATH COMMUNITY COLLEGE               ,OR,97603-7121,Public       ,66,220,286,701,2102,2803
03642300,VALLEY MEDICAL COLLEGE                  ,OR,97305-1373,Proprietary  ,19,79,98,195,736,931
03668300,BIRTHINGWAY COLLEGE OF MIDWIFERY        ,OR,97266-4042,Private      ,3,23,26,22,225,247
03783400,ABDILL CAREER COLLEGE                   ,OR,97504-7137,Proprietary  ,10,50,60,62,318,380
04146500,PORTLAND ACTORS CONSERVATORY            ,OR,97201-2557,Private      ,2,8,10,41,85,126
04151900,COLUMBIA GORGE COMMUNITY COLLEGE        ,OR,97058-3434,Public       ,26,114,140,109,333,442
04167400,SAGE SCHOOL OF MASSAGE & HEALING ARTS   ,OR,97701-4082,Proprietary  ,2,16,18,31,112,143
04171400,AVEDA INSTITUTE PORTLAND                ,OR,97209-3144,Proprietary  ,29,67,96,291,521,812
00137400,ALBERTUS MAGNUS COLLEGE                 ,CT,06511-1189,Private      ,24,113,137,964,1325,2289
00137403,ALBERTUS MAGNUS CLG-NEW DIMENSIONS      ,CT,06511-0000,Private      ,8,102,110,96,783,879
00137800,CENTRAL CONNECTICUT STATE UNIV          ,CT,06050-2490,Public       ,212,331,543,10331,5327,15658
00137900,CONNECTICUT COLLEGE                     ,CT,06320-4196,Private      ,49,16,65,3345,219,3564
00138000,WESTERN CONNECTICUT STATE UNIV          ,CT,06810-6826,Public       ,130,127,257,6156,1913,8069
00138500,FAIRFIELD UNIVERSITY                    ,CT,06430-0000,Private      ,84,106,190,6791,1313,8104
00138700,HARTFORD SEMINARY                       ,CT,06105-0000,Private      ,2,7,9,14,95,109
00138900,HOLY APOSTLES COLLEGE & SEMINARY        ,CT,06416-2005,Private      ,0,10,10,16,80,96
00139200,MANCHESTER COMMUNITY COLLEGE            ,CT,06045-1046,Public       ,218,460,678,3832,4183,8015
00139300,MITCHELL COLLEGE                        ,CT,06320-4498,Private      ,16,19,35,1108,311,1419
00139700,UNIVERSITY OF NEW HAVEN                 ,CT,06516-1999,Private      ,136,153,289,10068,2360,12428
00139800,NORTHWESTERN CT COMMUNITY COLLEGE       ,CT,06098-1747,Public       ,43,87,130,623,832,1455
00139900,NORWALK COMMUNITY TECHNICAL COLLEGE     ,CT,06854-1655,Public       ,167,343,510,2387,3053,5440
00140100,POST UNIVERSITY                         ,CT,06723-3240,Proprietary  ,151,1265,1416,1957,6801,8758
00140200,QUINNIPIAC UNIVERSITY                   ,CT,06518-1908,Private      ,156,149,305,14825,2426,17251
00140201,QUINNIPIAC UNIVERSITY SCHOOL OF LAW     ,CT,06518-0000,Private      ,2,6,8,73,1090,1163
00140300,SACRED HEART UNIVERSITY                 ,CT,06825-1000,Private      ,94,198,292,8239,2431,10670
00140600,SOUTHERN CONNECTICUT STATE UNIV         ,CT,06515-1355,Public       ,196,355,551,9568,5496,15064
00140900,SAINT JOSEPH COLLEGE                    ,CT,06117-2791,Private      ,18,156,174,1334,1916,3250
00141400,TRINITY COLLEGE                         ,CT,06106-3100,Private      ,57,34,91,3579,360,3939
00141600,UNIVERSITY OF BRIDGEPORT                ,CT,06601-5650,Private      ,74,241,315,3237,3322,6559
00141700,UNIVERSITY OF CONNECTICUT-STORRS        ,CT,06269-2151,Public       ,386,288,674,30185,6687,36872
00141702,UNIV CONN STAMFORD                      ,CT,06901-0000,Public       ,11,43,54,634,520,1154
00141703,UNIV OF CONNECTICUT - TORINGTON         ,CT,06790-0000,Public       ,3,10,13,165,92,257
00141706,UNIV OF CONNECTICUT SCH LAW             ,CT,06105-0000,Public       ,1,12,13,27,1244,1271
00141707,UNIV OF CT - SCH OF SOCIAL WORK         ,CT,06117-0000,Public       ,1,21,22,105,680,785
00141708,UNIVERSITY OF CONNECTICUT - SCHOOL OF ME,CT,06030-1920,Public       ,6,17,23,326,720,1046
00141709,UNIVERSITY OF CONNECTICUT - SCHOOL OF DE,CT,06030-1920,Public       ,18,15,33,580,602,1182
00142200,UNIVERSITY OF HARTFORD                  ,CT,06117-1599,Private      ,139,136,275,9671,2348,12019
00142400,WESLEYAN UNIVERSITY                     ,CT,06459-3208,Private      ,67,16,83,5601,346,5947
00142500,EASTERN CONNECTICUT STATE UNIV          ,CT,06226-2295,Public       ,151,125,276,5656,1497,7153
00142600,YALE UNIVERSITY                         ,CT,06520-8288,Private      ,317,214,531,17236,8822,26058
00280301,RENSSELAER POLYTECHNIC INSTITUTE-RENSSEL,CT,06120-2991,Private      ,1,12,13,9,64,73
00451300,HOUSATONIC COMMUNITY COLLEGE            ,CT,06604-4704,Public       ,246,612,858,3035,4755,7790
00618100,BRIDGEPORT HOSP SCHL OF NURSING         ,CT,06610-2896,Private      ,5,47,52,143,524,667
00619100,ST. VINCENT'S COLLEGE                   ,CT,06606-9966,Private      ,28,142,170,340,929,1269
00698200,NAUGATUCK VALLEY COMM-TECH COLG         ,CT,06708-3089,Public       ,211,422,633,3183,4058,7241
00730000,ELI WHITNEY TECHNICAL HIGH SCHOOL       ,CT,06514-0000,Public       ,3,12,15,15,96,111
00730300,LINCOLN TECHNICAL INSTITUTE             ,CT,06051-0000,Proprietary  ,102,261,363,738,1877,2615
00730500,PORTER AND CHESTER INSTITUTE OF BRANFORD,CT,06405-4022,Proprietary  ,28,77,105,244,571,815
00731100,WINDHAM TECHNICAL HIGH SCHOOL           ,CT,06226-2100,Public       ,0,1,1,6,21,27
00745900,PAIER COLLEGE OF ART                    ,CT,06514-3902,Proprietary  ,5,2,7,151,87,238
00763500,CAPITAL COMMUNITY COLLEGE               ,CT,06103-1207,Public       ,149,508,657,1862,4735,6597
00803700,GATEWAY COMMUNITY-TECHNICAL COLLEGE     ,CT,06511-0000,Public       ,235,673,908,3169,5375,8544
00803800,MIDDLESEX COMMUNITY CLG                 ,CT,06457-4889,Public       ,71,205,276,1189,1647,2836
00887300,PAUL MITCHELL THE SCHOOL                ,CT,06810-6716,Proprietary  ,16,22,38,100,130,230
00887400,BRIO ACADEMY OF COSMETOLOGY             ,CT,06450-4836,Proprietary  ,27,96,123,206,429,635
00906500,THE HARTFORD CONSERVATORY               ,CT,06105-2891,Private      ,0,0,0,30,9,39
00927700,E C GOODWIN TECHNICAL HIGH SCHOOL       ,CT,06053-0000,Public       ,2,10,12,34,60,94
00940700,LINCOLN COLLEGE OF NEW ENGLAND          ,CT,06489-1057,Proprietary  ,62,223,285,926,1519,2445
00940701,CLEMENS COLLEGE                         ,CT,06078-0000,Proprietary  ,0,2,2,21,15,36
00976400,TUNXIS COMMUNITY COLLEGE                ,CT,06032-3187,Public       ,139,283,422,1960,2538,4498
00976500,THREE RIVERS COMMUNITY COLLEGE          ,CT,06360-6598,Public       ,147,350,497,1927,3186,5113
00982200,ALBERT I PRINCE TECHNICAL HIGH SCHOOL   ,CT,06106-3799,Public       ,0,10,10,11,90,101
01041700,BRIO ACADEMY OF EAST HARTFORD           ,CT,06108-2220,Proprietary  ,25,48,73,81,176,257
01053000,QUINEBAUG VALLEY COMMUNITY COLLEGE      ,CT,06239-1440,Public       ,78,193,271,879,1507,2386
01077900,PORTER AND CHESTER INSTITUTE-ALLCAMPUSES,CT,06615-7158,Proprietary  ,193,622,815,1495,3823,5318
01115000,ASNUNTUCK COMMUNITY COLLEGE             ,CT,06082-3800,Public       ,33,104,137,581,892,1473
01149600,BULLARD HAVENS VOC TECH SCHOOL          ,CT,06610-3499,Public       ,3,13,16,16,89,105
01169700,VINAL REGIONAL VOC TECH SCHOOL          ,CT,06457-4918,Public       ,0,6,6,6,52,58
01184300,NORWICH TECHNICAL HIGH SCHOOL           ,CT,06360-7097,Public       ,0,1,1,10,41,51
01242500,STONE ACADEMY                           ,CT,06514-4125,Proprietary  ,40,191,231,221,1065,1286
01242503,STONE ACADEMY -WATERBURY                ,CT,06705-3823,Proprietary  ,3,20,23,24,125,149
01242504,STONE ACADEMY -  EAST HARTFORD          ,CT,06118-0000,Proprietary  ,1,12,13,21,160,181
01287700,SANFORD-BROWN COLLEGE                   ,CT,06855-1436,Proprietary  ,11,61,72,120,453,573
01291300,LEON INSTITUTE OF HAIR DESIGN           ,CT,06604-4226,Proprietary  ,0,11,11,11,51,62
01326400,HENRY ABBOTT TECHNICAL HIGH SCHOOL      ,CT,06811-4881,Public       ,0,0,0,5,8,13
02074000,BRANFORD HALL CAREER INSTITUTE          ,CT,06405-0000,Proprietary  ,216,759,975,903,3417,4320
02106600,AMERICAN INSTITUTE                      ,CT,06110-1922,Proprietary  ,19,65,84,74,432,506
02112300,RIDLEY LOWELL BUSINESS & TECH INST      ,CT,06320-0000,Proprietary  ,27,117,144,140,698,838
02112700,NORTH HAVEN ACADEMY                     ,CT,06473-3108,Proprietary  ,9,11,20,141,139,280
02115100,BUTLER BUSINESS SCHOOL                  ,CT,06604-0000,Proprietary  ,17,76,93,79,415,494
02148700,CONNECTICUT INST OF HAIR DESIGN         ,CT,06716-0000,Proprietary  ,0,8,8,26,58,84
02202500,NEW ENGLAND TRACTOR TRAILER SCH         ,CT,06071-2036,Proprietary  ,36,356,392,112,1184,1296
02228800,LINCOLN TECHNICAL INSTITUTE - EAST WINDS,CT,06088-9631,Proprietary  ,98,93,191,1054,726,1780
02244900,GOODWIN COLLEGE                         ,CT,06118-9980,Private      ,98,529,627,1086,4653,5739
02245300,HOWELL CHENEY TECHNICAL HIGH SCHOOL     ,CT,06040-0000,Public       ,2,1,3,10,15,25
02265900,WINDHAM COMMUNITY MEM HOSP-RAD TECH     ,CT,06226-0000,Private      ,0,2,2,14,34,48
02296100,YALE-NEW HAVEN HOSP DIETETIC INTERN     ,CT,06510-8900,Private      ,0,8,8,18,41,59
02300000,W F KAYNOR TECHNICAL HIGH SCHOOL        ,CT,06708-0000,Public       ,1,12,13,10,64,74
02316600,CONNECTICUT CTR FOR MASSAGE THERAPY     ,CT,06111-3975,Proprietary  ,8,55,63,63,340,403
02316601,CONNECTICUT CENTER FOR MASSAGE THERAPY -,CT,06880-4619,Proprietary  ,2,48,50,37,213,250
02316603,CONNECTICUT CENTER FOR MASSAGE THERAPY -,CT,06340-4619,Proprietary  ,2,25,27,34,159,193
02565000,PLATT TECHNICAL HIGH SCHOOL             ,CT,06460-2105,Public       ,4,6,10,11,30,41
03079400,LYME ACADEMY COLLEGE OF FINE ARTS       ,CT,06371-2333,Private      ,0,2,2,76,28,104
03094800,INDUSTRIAL MANAGEMENT & TRAINING        ,CT,06706-1211,Proprietary  ,1,23,24,29,167,196
03234300,CHARTER OAK STATE COLLEGE               ,CT,06053-2150,Public       ,7,141,148,103,1578,1681
03316300,LINCOLN TECHNICAL INSTITUTE - HARTFORD  ,CT,06105-3630,Proprietary  ,38,88,126,644,735,1379
03381300,CONNECTICUT TRAINING CENTER             ,CT,06108-2705,Private      ,0,2,2,6,33,39
03927300,ALBERT SCHOOL (THE)                     ,CT,06357-2447,Proprietary  ,28,53,81,125,219,344
04104300,ACADEMY DI CAPELLI - SCHOOL OF COSMETOLO,CT,06492-0000,Proprietary  ,9,27,36,31,60,91
04128800,BRANFORD ACADEMY OF HAIR & COSMETOLOGY  ,CT,06405-0000,Proprietary  ,4,14,18,29,67,96
04145400,OXFORD ACADEMY OF HAIR DESIGN           ,CT,06483-2911,Proprietary  ,5,13,18,48,58,106
04148400,EUROPEAN ACADEMY OF COSMETOLOGY AND HAIR,CT,06437-0000,Proprietary  ,0,3,3,16,25,41
04152400,INTERNATIONAL INSTITUTE OF COSMETOLOGY  ,CT,06109-0000,Proprietary  ,11,12,23,89,93,182
04162900,TONSORIAL ACADEMY OF COSMETOLOGY AND BAR,CT,06516-0000,Proprietary  ,1,7,8,3,23,26
00146600,BARRY UNIVERSITY                        ,FL,33161-6695,Private      ,234,697,931,5931,9202,15133
00146601,BARRY UNIVERSITY - ORLANDO              ,FL,32807-3673,Private      ,18,81,99,284,1880,2164
00146700,BETHUNE COOKMAN UNIVERSITY              ,FL,32114-3099,Private      ,282,166,448,7417,2139,9556
00146800,ST THOMAS UNIVERSITY                    ,FL,33054-0000,Private      ,51,200,251,1502,2943,4445
00146900,FLORIDA INSTITUTE OF TECHNOLOGY         ,FL,32901-6988,Private      ,134,865,999,4114,8811,12925
00147000,BREVARD COMMUNITY COLLEGE               ,FL,32922-6503,Public       ,508,1319,1827,6656,11110,17766
00147100,CENTRAL FLORIDA COMMUNITY COLLEGE       ,FL,34478-1388,Public       ,365,1030,1395,5126,9303,14429
00147200,CHIPOLA  COLLEGE                        ,FL,32446-2053,Public       ,71,188,259,1238,1692,2930
00147300,CLEARWATER CHRISTIAN COLLEGE            ,FL,33759-0000,Private      ,14,31,45,800,255,1055
00147500,DAYTONA STATE COLLEGE                   ,FL,32114-2800,Public       ,658,1691,2349,8664,16155,24819
00147700,EDISON STATE COLLEGE                    ,FL,33906-6210,Public       ,590,1152,1742,8753,12453,21206
00147800,EDWARD WATERS COLLEGE                   ,FL,32209-6199,Private      ,41,91,132,1287,1006,2293
00147900,EMBRY-RIDDLE AERONAUTICAL UNIV          ,FL,32114-3900,Private      ,190,1045,1235,7431,7736,15167
00148000,FLORIDA A & M UNIVERSITY                ,FL,32307-3100,Public       ,636,510,1146,19202,9540,28742
00148100,FLORIDA ATLANTIC UNIVERSITY             ,FL,33431-6498,Public       ,1295,1252,2547,25753,17471,43224
00148101,FLORIDA ATLANTIC UNIVERSITY/DAVIE       ,FL,33314-0000,Public       ,96,263,359,1648,3392,5040
00148103,FLORIDA ATLANTIC UNIV-JUPITER/PSL       ,FL,33458-0000,Public       ,45,84,129,737,758,1495
00148200,FLORIDA COLLEGE                         ,FL,33617-5578,Private      ,22,10,32,520,120,640
00148400,FLORIDA STATE COLLEGE AT JACKSONVILLE   ,FL,32202-4030,Public       ,1206,3649,4855,14596,31251,45847
00148500,FLORIDA KEYS COMMUNITY COLLEGE          ,FL,33040-4397,Public       ,49,134,183,560,993,1553
00148600,FLORIDA MEMORIAL UNIVERSITY             ,FL,33054-6199,Private      ,124,97,221,2819,1587,4406
00148700,ECKERD COLLEGE                          ,FL,33711-4744,Private      ,80,112,192,3192,1118,4310
00148800,FLORIDA SOUTHERN COLLEGE                ,FL,33801-5698,Private      ,123,139,262,3701,1181,4882
00148900,FLORIDA STATE UNIVERSITY                ,FL,32306-2430,Public       ,2276,1086,3362,49288,19773,69061
00149000,GULF COAST COMMUNITY COLLEGE            ,FL,32401-1058,Public       ,225,733,958,2826,5677,8503
00149300,INDIAN RIVER STATE COLLEGE              ,FL,34981-5596,Public       ,606,1416,2022,7206,12337,19543
00149500,JACKSONVILLE UNIVERSITY                 ,FL,32211-3394,Private      ,214,456,670,4646,4299,8945
00149700,JONES COLLEGE                           ,FL,32211-5588,Private      ,7,89,96,130,1122,1252
00149900,EVEREST UNIVERSITY                      ,FL,32810-5601,Proprietary  ,47,380,427,468,3041,3509
00149901,EVEREST UNIVERSITY - ORLANDO SOUTH      ,FL,32819-7666,Proprietary  ,596,6586,7182,3011,35502,38513
00149902,EVEREST UNIVERSITY - MELBOURNE          ,FL,32905-6609,Proprietary  ,12,176,188,126,1217,1343
00150000,BROWARD COLLEGE- DOWNTOWN CTR           ,FL,33301-2298,Public       ,675,1717,2392,7327,13895,21222
00150001,BROWARD COLLEGE - DAVIE CAMPUS          ,FL,33314-0000,Public       ,504,1063,1567,9400,10802,20202
00150002,BROWARD COLLEGE- NORTH CAMPUS           ,FL,33066-0000,Public       ,353,956,1309,6150,9387,15537
00150003,BROWARD COLLEGE- SOUTH CAMPUS           ,FL,33024-0000,Public       ,404,872,1276,6532,8828,15360
00150100,LAKE CITY COMMUNITY COLLEGE             ,FL,32025-2007,Public       ,129,427,556,1372,3263,4635
00150200,LAKE SUMTER COMMUNITY COLLEGE           ,FL,34788-8751,Public       ,234,435,669,2667,3598,6265
00150400,MANATEE COMMUNITY COLLEGE               ,FL,34207-3596,Public       ,409,929,1338,5520,8675,14195
00150500,LYNN UNIVERSITY                         ,FL,33431-5598,Private      ,89,83,172,2062,948,3010
00150600,MIAMI DADE COLLEGE ADMINISTRATION ONLY  ,FL,33176-3393,Public       ,94,192,286,1249,1668,2917
00150601,MIAMI DADE COLLEGE - NORTH CAMPUS       ,FL,33167-3495,Public       ,807,1836,2643,12517,17462,29979
00150602,MIAMI DADE COLLEGE - KENDALL CAMPUS     ,FL,33176-3393,Public       ,1291,2041,3332,18450,17315,35765
00150603,MIAMI DADE COLLEGE - WOLFSON CAMPUS     ,FL,33132-2297,Public       ,640,1355,1995,9519,11319,20838
00150604,MIAMI DADE COLLEGE - MEDICAL CAMPUS     ,FL,33127-4693,Public       ,195,724,919,2660,6580,9240
00150605,MIAMI DADE COLLEGE - HOMESTEAD CAMPUS   ,FL,33030-6009,Public       ,193,411,604,2317,3209,5526
00150606,MIAMI DADE COLLEGE -INTERAMERICAN CAMPUS,FL,33135-0000,Public       ,335,877,1212,3887,7594,11481
00150607,MIAMI DADE COLLEGE - HIALEAH CAMPUS     ,FL,33012-2918,Public       ,269,528,797,2996,3977,6973
00150800,NORTH FLORIDA COMMUNITY COLLEGE         ,FL,32340-1699,Public       ,35,140,175,635,1074,1709
00150900,NOVA SOUTHEASTERN UNIVERSITY            ,FL,33314-7796,Private      ,290,2136,2426,6527,34042,40569
00151000,NORTHWEST FLORIDA STATE COLLEGE         ,FL,32578-1295,Public       ,229,702,931,2546,5629,8175
00151200,PALM BEACH COMMUNITY COLLEGE            ,FL,33461-4796,Public       ,1068,2100,3168,14881,18428,33309
00151300,PENSACOLA STATE COLLEGE                 ,FL,32504-8998,Public       ,452,1325,1777,5146,10483,15629
00151400,POLK STATE COLLEGE                      ,FL,33881-4256,Public       ,348,944,1292,5382,8549,13931
00151500,ROLLINS COLLEGE                         ,FL,32789-4499,Private      ,142,131,273,3110,1598,4708
00151900,SANTA FE COLLEGE                        ,FL,32606-6200,Public       ,703,1100,1803,10146,10464,20610
00152000,SEMINOLE STATE COLLEGE OF FLORIDA       ,FL,32773-6199,Public       ,730,1920,2650,9925,16816,26741
00152100,SOUTHEASTERN UNIVERSITY                 ,FL,33801-6099,Private      ,86,130,216,2768,1385,4153
00152200,SOUTH FLORIDA COMMUNITY COLLEGE         ,FL,33825-9399,Public       ,126,334,460,1661,2353,4014
00152300,SAINT JOHNS RIVER STATE COLLEGE         ,FL,32177-3897,Public       ,216,548,764,2960,4984,7944
00152600,SAINT LEO UNIVERSITY                    ,FL,33574-6665,Private      ,150,1475,1625,3451,15030,18481
00152800,ST. PETERSBURG COLLEGE                  ,FL,33760-3768,Public       ,787,2543,3330,11174,25345,36519
00153100,STETSON UNIVERSITY                      ,FL,32723-3761,Private      ,131,108,239,3622,1167,4789
00153101,STETSON UNIVERSITY - COLLEGE OF LAW     ,FL,33707-3299,Private      ,12,38,50,85,1915,2000
00153300,TALLAHASSEE COMMUNITY COLLEGE           ,FL,32304-2895,Public       ,674,1057,1731,11561,11220,22781
00153400,EVEREST UNIVERSITY                      ,FL,33614-5801,Proprietary  ,63,436,499,666,4451,5117
00153408,EVEREST UNIVERSITY - TAMPA BRANDON CAMPU,FL,33619-1354,Proprietary  ,182,1992,2174,1249,18022,19271
00153409,EVEREST UNIVERSITY - ORANGE PARK        ,FL,32073-1111,Proprietary  ,21,207,228,176,1321,1497
00153500,UNIVERSITY OF FLORIDA                   ,FL,32611-3150,Public       ,2110,1126,3236,47436,21235,68671
00153600,UNIVERSITY OF MIAMI                     ,FL,33146-6531,Private      ,973,464,1437,21398,7700,29098
00153601,UNIV OF MIAMI SCHOOL OF LAW             ,FL,33124-0000,Private      ,7,23,30,115,2156,2271
00153602,UNIV OF MIAMI-SCH OF MEDICINE           ,FL,33136-0000,Private      ,66,69,135,874,1467,2341
00153700,UNIVERSITY OF SOUTH FLORIDA             ,FL,33620-6960,Public       ,1657,1866,3523,40840,27341,68181
00153701,UNIV OF SOUTH FLORIDA-ST PETERSBURG     ,FL,33701-0000,Public       ,81,139,220,1338,1326,2664
00153702,UNIV OF SOUTH FLORIDA-SARASOTA          ,FL,34243-2025,Public       ,32,105,137,516,1113,1629
00153705,UNIV OF SOUTH FLORIDA                   ,FL,33803-0000,Public       ,98,119,217,1439,1241,2680
00153706,UNIV OF SOUTH FLORIDA- MEDICINE         ,FL,33612-0000,Public       ,92,73,165,1257,1433,2690
00153800,UNIVERSITY OF TAMPA                     ,FL,33606-1490,Private      ,371,285,656,10929,3412,14341
00154000,WEBBER INTERNATIONAL UNIVERSITY         ,FL,33827-0096,Private      ,23,15,38,889,297,1186
00173308,NATIONAL-LOUIS UNIVERSITY               ,FL,33609-0000,Private      ,1,10,11,6,62,68
00177201,TRINITY INTERNATIONAL UNIVERSITY - SOUTH,FL,33324-4611,Private      ,4,38,42,52,504,556
00395400,UNIV OF CENTRAL FLORIDA                 ,FL,32816-0001,Public       ,2668,1950,4618,61795,30373,92168
00395500,UNIVERSITY OF WEST FLORIDA              ,FL,32514-5750,Public       ,450,631,1081,8744,7291,16035
00407215,NORTHWOOD UNIVERSITY                    ,FL,33409-0000,Private      ,17,37,54,551,394,945
00491004,KAPLAN CAREER INSTITUTE - KAPLAN COLLEGE,FL,33026-3978,Proprietary  ,21,204,225,117,1549,1666
00491005,KAPLAN COLLEGE JACKSONVILLE             ,FL,32216-3216,Proprietary  ,21,278,299,145,1985,2130
00558500,LIVELY TECHNICAL CENTER                 ,FL,32304-0000,Public       ,69,363,432,611,2376,2987
00558600,LINDSEY HOPKINS TECHNICAL ED CENTER     ,FL,33127-4692,Public       ,19,116,135,230,979,1209
00559400,D G ERWIN TECHNICAL CENTER              ,FL,33610-8255,Public       ,67,294,361,571,2351,2922
00560500,PINELLAS TECH ED CTR-CLEARWATER         ,FL,33760-2194,Public       ,33,231,264,349,1651,2000
00560700,SARASOTA COUNTY TECHNICAL INSTITUTE     ,FL,34233-0000,Public       ,29,132,161,335,1053,1388
00560800,TRAVISS TECHNICAL CENTER                ,FL,33803-0000,Public       ,49,154,203,387,1486,1873
00561200,MANATEE TECHNICAL INSTITUTE             ,FL,34210-0000,Public       ,70,197,267,498,1690,2188
00561201,MANATEE TECHNICAL INSTITUTE-EAST        ,FL,34211-0000,Public       ,35,89,124,247,876,1123
00675000,VALENCIA COMMUNITY COLLEGE              ,FL,32802-3028,Public       ,2194,3769,5963,29905,32630,62535
00732910,ITT TECHNICAL INSTITUTE                 ,FL,33634-7515,Proprietary  ,173,528,701,1059,3754,4813
00732947,ITT TECHNICAL INSTITUTE                 ,FL,32746-1607,Proprietary  ,159,555,714,855,2959,3814
00752500,SUWANNEE-HAMILTON AREA VOC TECH CTR     ,FL,32060-0000,Public       ,9,50,59,76,385,461
00752600,WASHINGTON HOLMES TECHNICAL CENTER      ,FL,32428-1699,Public       ,17,76,93,181,584,765
00755800,LEE COUNTY HIGH TECH CENTER CENTRAL     ,FL,33916-2299,Public       ,62,159,221,439,1266,1705
00758600,REMINGTON COLLEGE - TAMPA CAMPUS        ,FL,33612-8410,Private      ,24,123,147,192,848,1040
00787000,HILLSBOROUGH COMMUNITY COLLEGE          ,FL,33606-3572,Public       ,1347,2941,4288,16201,24435,40636
00789300,FLAGLER COLLEGE                         ,FL,32085-1027,Private      ,166,94,260,4238,948,5186
00789301,FLAGLER COLLEGE - TALLAHASSEE COMMUNITY ,FL,32304-2895,Private      ,19,58,77,372,795,1167
00807500,ST JOHN VIANNEY COLLEGE SEMINARY        ,FL,33165-3244,Private      ,6,2,8,36,15,51
00814600,EVEREST UNIVERSITY - POMPANO BEACH      ,FL,33062-2522,Proprietary  ,44,459,503,400,5530,5930
00822300,ST VINCENT DE PAUL REGIONL SEMINARY     ,FL,33436-0000,Private      ,0,1,1,3,9,12
00841700,STENOTYPE INST OF JACKSONVILLE          ,FL,32207-0000,Proprietary  ,8,118,126,31,396,427
00869410,RASMUSSEN COLLEGE - OCALA               ,FL,34471-7051,Proprietary  ,81,759,840,791,6279,7070
00869411,RASMUSSEN COLLEGE - NEW PORT RICHEY     ,FL,34690-4554,Proprietary  ,26,169,195,293,1488,1781
00869413,RASMUSSEN COLLEGE - FORT MYERS          ,FL,33905-7805,Proprietary  ,33,131,164,312,1317,1629
00869420,RASMUSSEN COLLEGE - TAMPA               ,FL,33610-9558,Proprietary  ,12,80,92,87,508,595
00869422,RASMUSSEN COLLEGE - PASCO               ,FL,33558-0000,Proprietary  ,7,37,44,17,92,109
00884800,WARNER UNIVERSITY                       ,FL,33859-8725,Private      ,24,61,85,700,817,1517
00884900,PALM BEACH ATLANTIC UNIVERSITY          ,FL,33401-6505,Private      ,102,228,330,3238,2823,6061
00887800,MIAMI INTERNATIONAL UNIV ART&DESIGN     ,FL,33132-1418,Proprietary  ,225,327,552,3474,3340,6814
00910400,RIVERSIDE HAIRSTYLING ACADEMY           ,FL,32207-3810,Proprietary  ,3,14,17,35,95,130
00963500,FLORIDA INTERNATIONAL UNIVERSITY        ,FL,33199-0001,Public       ,1467,2064,3531,35427,31556,66983
00984100,UNIVERSITY OF NORTH FLORIDA             ,FL,32224-2645,Public       ,844,718,1562,16146,10181,26327
00990200,SHERIDAN TECHNICAL CENTER               ,FL,33021-3399,Public       ,69,330,399,554,2402,2956
01016100,"LORAINE'S ACADEMY, INC                  ",FL,33710-0000,Proprietary  ,6,39,45,47,202,249
01019500,ART INSTITUTE OF FT LAUDERDALE          ,FL,33316-3000,Proprietary  ,127,235,362,2235,2626,4861
01065200,PASCO-HERNANDO COMMUNITY CLG            ,FL,34654-5199,Public       ,424,979,1403,5394,8696,14090
01072401,CARLOS ALBIZU UNIVERSITY                ,FL,33172-0000,Private      ,9,126,135,128,1329,1457
01082600,TOM P. HANEY TECHNICAL CENTER           ,FL,32405-5099,Public       ,37,201,238,261,1261,1522
01112700,GOODING INST OF NUR ANES BAY MED CT     ,FL,32401-0000,Public       ,1,8,9,21,111,132
01226300,ATLANTIC TECHNICAL CENTER               ,FL,33063-3902,Public       ,66,272,338,545,1908,2453
01254400,FIRST COAST TECHNICAL COLLEGE           ,FL,32084-1921,Public       ,42,159,201,331,1012,1343
01257400,RINGLING SCHOOL OF ART AND DESIGN       ,FL,34234-5895,Private      ,53,31,84,2162,501,2663
01303904,SOUTH UNIVERSITY - WEST PALM BEACH CAMPU,FL,33409-5149,Proprietary  ,42,209,251,475,1952,2427
01323400,LORENZO WALKER INST OF TECHNOLOGY       ,FL,34104-4405,Public       ,30,86,116,247,733,980
02089600,CONCORDE CAREER INSTITUTE               ,FL,32211-0000,Proprietary  ,26,196,222,219,1284,1503
02106602,AMERICAN INSTITUTE - AMERICAN INSTITUTE ,FL,34747-5161,Proprietary  ,4,72,76,11,186,197
02113609,AMERICAN INTERCONTINENTAL UNIV - WESTON ,FL,33326-3233,Proprietary  ,20,103,123,333,1135,1468
02115300,PINELLAS TECHNICAL EDUCATION CENTERS - S,FL,33711-0000,Public       ,39,213,252,372,1653,2025
02116006,SANFORD-BROWN INSTITUTE - FT. LAUDERDALE,FL,33309-1906,Proprietary  ,26,106,132,230,895,1125
02121800,EVEREST INSTITUTE                       ,FL,33169-4759,Proprietary  ,43,186,229,308,1292,1600
02121801,EVEREST INSTITUTE  - HIALEAH            ,FL,33012-7193,Proprietary  ,10,34,44,109,271,380
02148200,FASHION FOCUS HAIR ACADEMY              ,FL,34231-0000,Proprietary  ,4,17,21,34,96,130
02148300,MANHATTAN BEAUTY SCHOOL                 ,FL,33611-0000,Proprietary  ,27,135,162,138,620,758
02149900,PAUL MITCHELL THE SCHOOL-JACKSONVILLE   ,FL,32205-0000,Proprietary  ,30,77,107,278,565,843
02151900,KEISER  UNIVERSITY                      ,FL,33309-0000,Private      ,586,2555,3141,4484,19569,24053
02156300,MARGATE SCHOOL OF BEAUTY                ,FL,33063-0000,Proprietary  ,0,0,0,90,337,427
02156700,FLORIDA CHRISTIAN COLLEGE               ,FL,34744-0000,Private      ,18,28,46,414,306,720
02159600,BAPTIST COLLEGE OF FLORIDA (THE)        ,FL,32440-0000,Private      ,10,34,44,349,361,710
02172700,CONCORDE CAREER INSTITUTE               ,FL,33607-0000,Proprietary  ,16,126,142,184,814,998
02179909,ARGOSY UNIVERSITY - TAMPA               ,FL,33607-5325,Proprietary  ,0,0,0,0,1,1
02188900,HOBE SOUND BIBLE COLLEGE                ,FL,33475-0000,Private      ,5,2,7,82,93,175
02200100,BRADENTON BEAUTY & BARBER ACADEMY       ,FL,34209-0000,Proprietary  ,12,31,43,51,229,280
02215900,ATI CAREER TRAINING CENTER              ,FL,33309-1785,Proprietary  ,12,84,96,227,924,1151
02218700,FLORIDA TECHNICAL COLLEGE               ,FL,32826-2707,Proprietary  ,110,602,712,729,3267,3996
02218707,FLORIDA TECHNICAL COLLEGE - LAKELAND    ,FL,33813-2101,Proprietary  ,8,37,45,62,359,421
02218709,FLORIDA TECHNICAL COLLEGE - DELAND      ,FL,32720-7415,Proprietary  ,27,165,192,147,896,1043
02228300,LAKE TECHNICAL CENTER                   ,FL,32726-0000,Public       ,60,214,274,351,1210,1561
02245500,FORTIS COLLEGE                          ,FL,32789-4679,Proprietary  ,24,134,158,153,846,999
02257900,INTERNATIONAL ACADEMY                   ,FL,32119-3541,Proprietary  ,29,65,94,100,259,359
02275100,CONCORDE CAREER INSTITUTE               ,FL,33025-0000,Proprietary  ,17,108,125,138,633,771
02278800,SOUTHWEST FLORIDA COLLEGE               ,FL,33907-0000,Proprietary  ,79,357,436,467,2125,2592
02278801,SOUTHWEST FLORIDA COLLEGE - TAMPA       ,FL,33619-1344,Proprietary  ,38,125,163,308,787,1095
02278802,SOUTHWEST FLORIDA COLLEGE - INSTITUTUE O,FL,33928-9469,Proprietary  ,7,31,38,29,107,136
02278803,SOUTHWEST FLORIDA COLLEGE - PORT CHARLOT,FL,33953-3100,Proprietary  ,15,114,129,113,704,817
02279600,CORTIVA INSTITUTE - FLORIDA             ,FL,33781-0000,Proprietary  ,11,40,51,60,235,295
02280800,NEW ENGLAND INST TECH-PALM BEACH        ,FL,33407-0000,Proprietary  ,49,124,173,552,2070,2622
02283800,BEAUTY SCHOOLS OF AMERICA               ,FL,33012-3322,Proprietary  ,109,533,642,570,2622,3192
02286502,ITT TECHNICAL INSTITUTE                 ,FL,32244-6630,Proprietary  ,0,0,0,0,3,3
02287100,LA BELLE BEAUTY SCHOOL                  ,FL,33012-3224,Proprietary  ,6,84,90,22,216,238
02293200,ATI CAREER TRAINING CENTER              ,FL,33309-5916,Proprietary  ,102,288,390,756,2603,3359
02293201,ATI CAREER TRAINING CENTER - MIAMI      ,FL,33122-1707,Proprietary  ,4,42,46,66,311,377
02293202,ATI CAREER TAINING CENTER - ATI COLLEGE ,FL,87109-2016,Proprietary  ,18,97,115,231,1171,1402
02293600,ADVANCED TECHNICAL CENTERS              ,FL,33266-1597,Private      ,2,18,20,27,99,126
02297000,CHARLOTTE TECHNICAL CENTER              ,FL,33948-0000,Public       ,24,106,130,234,713,947
02300900,WITHLACOOCHEE TECHNICAL INSTITUTE       ,FL,34450-0000,Public       ,36,160,196,230,858,1088
02305700,FORTIS COLLEGE                          ,FL,33619-1283,Proprietary  ,8,103,111,73,721,794
02305800,FLORIDA CAREER COLLEGE                  ,FL,33012-7028,Proprietary  ,343,1141,1484,1803,6125,7928
02307400,GEORGE STONE AREA VOCATIONAL TECHNICAL  ,FL,32526-0000,Public       ,44,213,257,259,1181,1440
02314100,SCHILLER INTERNATIONAL UNIVERSITY       ,FL,33770-0000,Proprietary  ,6,45,51,69,235,304
02316200,MIAMI LAKES TECHNICAL EDUCATION CTR     ,FL,33014-0000,Public       ,44,171,215,363,1131,1494
02321200,ORANGE TECH EDUC CTR- WESTSIDE TECH     ,FL,34787-0000,Public       ,39,118,157,297,938,1235
02325100,KEY COLLEGE                             ,FL,33004-3046,Proprietary  ,1,4,5,22,82,104
02326303,MEDVANCE INSTITUTE - WEST PALM          ,FL,33461-2171,Proprietary  ,34,159,193,230,919,1149
02326306,MEDVANCE INSTITUTE - MIAMI              ,FL,33173-3431,Proprietary  ,11,38,49,73,290,363
02326800,MERIDIAN COLLEGE                        ,FL,34240-8478,Proprietary  ,9,46,55,68,337,405
02326801,MERIDIAN CAREER INSTITUTE -             ,FL,33619-1378,Proprietary  ,1,7,8,19,126,145
02326900,SUNSTATE ACADEMY OF HAIR DESIGN         ,FL,33907-1415,Proprietary  ,26,90,116,151,390,541
02329900,FLORIDA INSTITUTE OF ULTRASOUND         ,FL,32514-0000,Proprietary  ,3,39,42,74,298,372
02338400,FT PIERCE BEAUTY ACADEMY                ,FL,34982-0000,Proprietary  ,18,95,113,83,354,437
02346200,WYOTECH                                 ,FL,32174-1010,Proprietary  ,56,214,270,583,1127,1710
02362100,FULL SAIL UNIVERSITY                    ,FL,32792-0000,Proprietary  ,1458,4190,5648,13626,25526,39152
02499000,ACADEMY OF COSMETOLOGY                  ,FL,32953-3311,Proprietary  ,15,42,57,53,236,289
02501500,"O*TEC, MID-FLORIDA TECH                 ",FL,32809-0000,Public       ,52,237,289,469,1537,2006
02504600,WINTER PARK TECH                        ,FL,32789-0000,Public       ,17,99,116,141,773,914
02508900,TALMUDIC COLLEGE OF FLORIDA             ,FL,33139-0000,Private      ,6,5,11,39,18,57
02511700,RIDGE TECHNICAL CENTER                  ,FL,33881-0000,Public       ,35,141,176,307,1196,1503
02513200,ORLANDO TECHNICAL CENTER                ,FL,32801-0000,Public       ,37,238,275,404,1589,1993
02515400,CITY COLLEGE                            ,FL,33309-3073,Private      ,56,288,344,433,2389,2822
02517100,SARASOTA SCHOOL OF MASSAGE THERAPY      ,FL,34243-6130,Proprietary  ,6,33,39,38,186,224
02524000,SUNSTATE ACADEMY OF HAIR DESIGN         ,FL,34624-0000,Proprietary  ,19,69,88,90,242,332
02524200,ROBERT MORGAN EDUCATIONAL CENTER        ,FL,33177-0000,Public       ,63,195,258,467,1211,1678
02547600,FLORIDA NATIONAL COLLEGE                ,FL,33012-0000,Proprietary  ,115,406,521,841,3004,3845
02554200,RADFORD LOCKLIN TECH CENTER             ,FL,32570-0000,Public       ,13,45,58,71,276,347
02573200,LA BELLE BEAUTY ACADEMY                 ,FL,33135-0000,Proprietary  ,10,73,83,76,338,414
02586200,FLORIDA CAREER COLLEGE                  ,FL,33759-3924,Proprietary  ,25,91,116,132,578,710
02597100,HERITAGE INSTITUTE                      ,FL,33912-7132,Proprietary  ,51,199,250,318,1189,1507
02598200,SOUTHERN CAREER COLLEGE                 ,FL,32211-0000,Proprietary  ,9,67,76,48,368,416
02599800,EVEREST UNIVERSITY                      ,FL,33770-2556,Proprietary  ,13,133,146,126,1019,1145
02599801,EVEREST UNIVERSITY - TAMPA LAKELAND CAMP,FL,33801-3801,Proprietary  ,16,162,178,150,1192,1342
02599805,EVEREST UNIVERSITY - JACKSONVILLE       ,FL,32256-0000,Proprietary  ,35,204,239,260,1729,1989
02601600,HENRY W BREWSTER TECHNICAL CENTER       ,FL,33602-0000,Public       ,9,102,111,162,765,927
02612700,ACADEMY OF COSMETOLOGY-PALM BAY         ,FL,32905-2805,Proprietary  ,6,34,40,53,189,242
02616400,SANFORD-BROWN INSTITUTE                 ,FL,32256-3520,Proprietary  ,66,294,360,460,2549,3009
02616401,SANFORD-BROWN INSTITUTE - TAMPA         ,FL,33610-8304,Proprietary  ,32,146,178,264,1275,1539
03003200,EVEREST INSTITUTE                       ,FL,33186-1410,Proprietary  ,31,93,124,259,729,988
03003201,EVEREST INSTITUTE - FT. LAUDERDALE      ,FL,33304-2522,Proprietary  ,18,74,92,126,546,672
03003600,MCFATTER TECHNICAL CENTER               ,FL,33317-7499,Public       ,37,182,219,417,1423,1840
03006801,PENNSYLVANIA CULINARY INSTITUTE - LE COR,FL,33025-3929,Proprietary  ,44,180,224,349,1554,1903
03008600,FLORIDA COLLEGE OF NATURAL HEALTH       ,FL,33064-1342,Proprietary  ,49,178,227,309,1233,1542
03010608,VIRGINIA COLLEGE - PENSACOLA            ,FL,32501-5650,Proprietary  ,13,125,138,137,1170,1307
03010612,VIRGINIA COLLEGE - GOLF ACADEMY OF AMERI,FL,32701-0000,Proprietary  ,12,32,44,101,298,399
03010618,VIRGINIA COLLEGE - JACKSONVILLE         ,FL,32207-5167,Proprietary  ,14,94,108,145,854,999
03012300,ASM BEAUTY WORLD ACADEMY                ,FL,33021-0000,Proprietary  ,4,39,43,34,173,207
03018500,BENE'S INTERNATIONAL SCHOOL OF BEAUTY   ,FL,34652-1637,Proprietary  ,23,59,82,125,348,473
03028200,TRINITY COLLEGE OF FLORIDA              ,FL,34655-4401,Private      ,13,17,30,152,159,311
03031400,INTERNATIONAL ACADEMY OF DESIGN AND TECH,FL,33634-6313,Proprietary  ,168,707,875,1904,5721,7625
03031402,INTERNATIONAL ACADEMY OF DESIGN AND TECH,FL,32809-4613,Proprietary  ,44,87,131,670,965,1635
03031403,IADT - ORLANDO CULINARY ACADEMY         ,FL,32819-0000,Proprietary  ,31,84,115,295,632,927
03035800,HERITAGE INSTITUTE                      ,FL,32216-0948,Proprietary  ,14,111,125,96,588,684
03035900,NATIONAL AVIATION ACADEMY               ,FL,33760-3931,Proprietary  ,46,96,142,300,761,1061
03037500,HODGES UNIVERSITY                       ,FL,34119-7932,Private      ,66,384,450,639,4228,4867
03054200,FORTIS COLLEGE                          ,FL,33144-2373,Proprietary  ,22,57,79,298,389,687
03071600,COLLEGE OF BUSINESS & TECHNOLOGY        ,FL,33176-0000,Proprietary  ,42,298,340,261,1476,1737
03076402,BRYMAN SCHOOL OF ARIZONA (THE) - ANTHEM ,FL,32803-3509,Proprietary  ,2,16,18,20,90,110
03079800,GEORGE T BAKER AVIATION                 ,FL,33142-5687,Public       ,37,93,130,339,567,906
03079900,CITY COLLEGE                            ,FL,32707-0000,Private      ,10,89,99,98,495,593
03087601,ITT TECHNICAL INSTITUTE                 ,FL,33126-1823,Proprietary  ,0,0,0,0,1,1
03089200,NOUVELLE INSTITUTE                      ,FL,33125-4141,Proprietary  ,6,66,72,38,428,466
03096300,FORTIS INSTITUTE                        ,FL,33860-0000,Proprietary  ,3,25,28,38,193,231
03099600,MERCY HOSPITAL SCHOOL OF PRACTICAL NSG  ,FL,33133-4237,Private      ,0,0,0,53,222,275
03100800,TAYLOR TECHNICAL INSTITUTE              ,FL,32348-0894,Public       ,2,21,23,51,229,280
03101900,TRINITY BAPTIST COLLEGE                 ,FL,32221-1398,Private      ,11,23,34,224,185,409
03103900,MARION COUNTY COMMUNITY TECH & ADUL     ,FL,34474-3172,Public       ,44,166,210,422,1328,1750
03108500,EVERGLADES UNIVERSITY                   ,FL,33431-0000,Private      ,23,257,280,214,1874,2088
03108600,COM-PU-MED VOCATIONAL CAREERS           ,FL,33012-4861,Proprietary  ,20,122,142,62,390,452
03113400,ACADEMY OF HEALING ARTS                 ,FL,33463-2113,Proprietary  ,3,39,42,31,187,218
03114700,PRAXIS INSTITUTE                        ,FL,33135-2657,Proprietary  ,15,123,138,104,731,835
03115500,FLORIDA HOSPITAL COLG OF HEALTH SCI     ,FL,32803-1237,Private      ,95,388,483,1307,3461,4768
03123900,KEISER CAREER COLLEGE                   ,FL,33413-0000,Proprietary  ,68,234,302,386,1631,2017
03125600,MIAMI AD SCHOOL                         ,FL,33139-5203,Proprietary  ,3,46,49,59,384,443
03127900,TECHNICAL EDUCATION CTR OSCEOLA         ,FL,34744-4459,Public       ,50,177,227,365,1272,1637
03158300,LEE COUNTY HIGH TECH CENTER NORTH       ,FL,33993-2479,Public       ,21,99,120,186,650,836
03171300,UNIVERSITY OF ST. AUGUSTINE FOR HEALTH S,FL,32084-4215,Proprietary  ,2,220,222,62,1417,1479
03178400,CORAL RIDGE NURSES ASST TRAINING        ,FL,33306-0000,Proprietary  ,4,10,14,19,113,132
03224300,NEW PROFESSIONS TECHNICAL INSTITUTE     ,FL,33134-1640,Proprietary  ,11,116,127,54,540,594
03230300,CHOICE HIGH SCHOOL AND TECHNICAL CENTER ,FL,32547-1299,Public       ,15,120,135,101,656,757
03238300,FLORIDA COLLEGE OF INTEGRATIVE MED      ,FL,32809-5721,Proprietary  ,7,52,59,68,325,393
03255300,FLORIDA GULF COAST UNIVERSITY           ,FL,33965-6565,Public       ,661,403,1064,13703,5699,19402
03256300,YESHIVA GEDOLAH RABBINICAL COLLEGE      ,FL,33139-4708,Private      ,20,4,24,25,9,34
03264300,SOUTH FLORIDA BIBLE COLLEGE AND THEOLOGI,FL,33441-5768,Private      ,0,10,10,11,88,99
03346300,ACAD FOR PRAC NURSING & HEALTH OCCP     ,FL,33417-4574,Private      ,21,176,197,236,964,1200
03348400,PROFESSIONAL TRAINING CENTERS           ,FL,33184-0000,Proprietary  ,11,62,73,144,669,813
03373300,BEACON COLLEGE                          ,FL,34748-5224,Private      ,15,16,31,149,115,264
03374300,FLORIDA COASTAL SCHOOL OF LAW           ,FL,32256-0000,Proprietary  ,6,103,109,54,3149,3203
03382300,BRADFORD-UNION AREA CAREERTECHNICAL CENT,FL,32091-2434,Public       ,6,34,40,56,306,362
03390300,LINCOLN TECHNICAL INSTITUTE             ,FL,32730-2351,Proprietary  ,18,85,103,153,700,853
03411400,INTERNATIONAL TRAINING CAREERS          ,FL,33155-1462,Private      ,7,78,85,50,320,370
03414500,ACUPUNCTURE AND MASSAGE COLLEGE         ,FL,33176-1509,Proprietary  ,7,47,54,55,356,411
03425400,CENTRAL FLORIDA INSTITUTE               ,FL,34684-4436,Proprietary  ,31,107,138,237,724,961
03429600,ATLANTIC INST OF ORIENTAL MEDICINE      ,FL,33316-0000,Private      ,1,33,34,18,202,220
03429700,EAST WEST COLLG OF NATURAL MEDICINE     ,FL,34236-4959,Proprietary  ,0,23,23,32,231,263
03433400,NEW CONCEPT MASSAGE AND BEAUTY SCHO     ,FL,33135-0000,Proprietary  ,3,26,29,16,109,125
03434300,FORTIS COLLEGE                          ,FL,32073-2999,Proprietary  ,22,91,113,235,781,1016
03480301,MEDVANCE INSTITUTE - FORT LAUDERDALE    ,FL,33313-7261,Proprietary  ,12,43,55,79,384,463
03480302,MEDVANCE INSTITUTE - STUART             ,FL,34994-3000,Proprietary  ,29,99,128,101,659,760
03491400,AMERICAN ADVANCED TECHNICIANS INST      ,FL,33014-4430,Proprietary  ,6,62,68,30,161,191
03549300,ULTIMATE MEDICAL ACADEMY                ,FL,33756-5802,Proprietary  ,268,3371,3639,938,13469,14407
03553300,KEISER CAREER COLLEGE                   ,FL,32216-0000,Proprietary  ,14,136,150,193,1053,1246
03557300,NORTH FLORIDA COSMETOLOGY INSTITUTE     ,FL,32312-0000,Proprietary  ,4,56,60,108,414,522
03564300,"INTERNATIONAL SCHOOL OF HEALTH, BEAUTY &",FL,33311-1141,Proprietary  ,8,38,46,61,352,413
03570400,ENGLISH CENTER (THE)                    ,FL,33133-2703,Public       ,0,50,50,22,339,361
03595400,ANGLEY COLLEGE                          ,FL,32720-4257,Proprietary  ,5,45,50,37,361,398
03611400,FLORIDA BARBER ACADEMY                  ,FL,33441-0000,Proprietary  ,24,203,227,51,351,402
03618300,FLORIDA INSTITUTE OF ANIMAL ARTS        ,FL,32792-1740,Proprietary  ,15,43,58,120,273,393
03627400,JACKSONVILLE BEAUTY INSTITUTE           ,FL,32208-1885,Proprietary  ,9,63,72,78,283,361
03627600,FLORIDA EDUCATION INSTITUTE             ,FL,33144-5036,Proprietary  ,9,47,56,85,347,432
03661400,SOUTH FLORIDA INSTITUTE OF TECHNOLO     ,FL,33135-0000,Proprietary  ,18,190,208,111,885,996
03691400,AVE MARIA SCHOOL OF LAW                 ,FL,34119-1376,Private      ,4,19,23,61,969,1030
03696400,SABER                                   ,FL,33134-1604,Private      ,9,66,75,51,470,521
03706300,AMERICAN INSTITUTE                      ,FL,33319-5613,Proprietary  ,15,63,78,95,342,437
03757300,ADVANCE SCIENCE INSTITUTE               ,FL,33012-0000,Proprietary  ,1,23,24,17,104,121
03801400,BEAUTY INSTITUTE (THE)                  ,FL,33409-2972,Proprietary  ,8,41,49,58,210,268
03801401,BEAUTY INSTITUTE (THE) - MARGATE        ,FL,33068-5704,Proprietary  ,3,15,18,14,67,81
03816300,ARTISTIC NAILS & BEAUTY ACADEMY         ,FL,33605-5919,Proprietary  ,28,110,138,118,430,548
03823300,FLORIDA ACADEMY OF HEALTH & BEAUTY      ,FL,33311-0000,Proprietary  ,1,14,15,16,74,90
03832300,DADE MEDICAL COLLEGE                    ,FL,33126-5534,Proprietary  ,72,309,381,582,2312,2894
03842500,CAMBRIDGE INSTITUTE OF ALLIED HEALTH    ,FL,32750-0000,Proprietary  ,9,47,56,43,259,302
03856300,UNIVERSAL BEAUTY SCHOOL                 ,FL,33174-4406,Proprietary  ,5,34,39,30,127,157
03856500,FLORIDA SCHOOL OF TRADITIONAL MIDWIFERY ,FL,32601-5507,Private      ,1,12,13,9,102,111
03875300,MCI INSTITUTE OF TECHNOLOGY             ,FL,33409-4937,Proprietary  ,40,139,179,112,448,560
03888300,DRAGON RISES COLLEGE OF ORIENTAL MEDICIN,FL,32601-5089,Proprietary  ,0,5,5,5,82,87
03903500,SOUTHERN TECHNICAL COLLEGE              ,FL,32809-0000,Proprietary  ,29,251,280,257,1806,2063
03906300,CAREER INSTITUTE OF FLORIDA             ,FL,33773-3434,Proprietary  ,5,62,67,48,316,364
03911300,TOTAL INTERNATIONAL CAREER INSTITUTE    ,FL,33012-0000,Proprietary  ,4,111,115,15,373,388
03939300,WOLFORD COLLEGE                         ,FL,34108-1931,Proprietary  ,1,35,36,12,330,342
03939400,CENTURA INSTITUTE                       ,FL,32807-3566,Proprietary  ,5,92,97,61,633,694
03939600,DAYTONA COLLEGE                         ,FL,32174-8445,Proprietary  ,9,67,76,105,456,561
03941300,AVE MARIA UNIVERSITY                    ,FL,34142-9505,Private      ,30,11,41,1074,255,1329
03957400,NEW COLLEGE OF FLORIDA                  ,FL,34243-2109,Public       ,52,47,99,1718,446,2164
03985300,COMMERCIAL DIVING ACADEMY               ,FL,32208-0000,Proprietary  ,52,173,225,345,1047,1392
03986300,AVIATOR COLLEGE OF AERONAUTICAL SCIENCE ,FL,34946-9022,Proprietary  ,8,33,41,67,172,239
04016500,AMERICAN INSTITUTE OF BEAUTY            ,FL,33773-0000,Proprietary  ,20,50,70,89,238,327
04029300,TRENDSETTERS OF FLORIDA SCHOOL OF BEAUTY,FL,32205-4737,Proprietary  ,2,13,15,16,105,121
04058300,HEALTH OPPORTUNITY TECHNICAL CENTER     ,FL,33169-4517,Proprietary  ,0,0,0,2,19,21
04083400,INSTITUTE OF ALLIED MEDICAL PROFESSIONS ,FL,33484-6543,Proprietary  ,2,33,35,38,278,316
04105400,PENSACOLA SCHOOL OF MASSAGE THERAPY & HE,FL,32504-7337,Proprietary  ,8,43,51,44,214,258
04106300,PALM BEACH ACADEMY OF HEALTH & BEAUTY   ,FL,33403-2130,Proprietary  ,8,21,29,39,138,177
04116400,FUTURE-TECH INSTITUTE                   ,FL,33135-4142,Proprietary  ,2,14,16,14,62,76
04116600,TAYLOR COLLEGE                          ,FL,34420-8714,Proprietary  ,4,87,91,74,635,709
04119400,AVEDA INSTITUTE - SAINT PETERSBURG      ,FL,33701-4242,Proprietary  ,74,144,218,507,891,1398
04120400,HI-TECH SCHOOL OF COSMETOLOGY           ,FL,33174-0000,Proprietary  ,13,29,42,89,150,239
04126900,ACADEMY OF CAREER TRAINING              ,FL,34741-4644,Proprietary  ,27,55,82,110,416,526
04127400,DIGITAL MEDIA ARTS COLLEGE              ,FL,33431-5919,Proprietary  ,31,35,66,290,277,567
04128400,MANAGEMENT RESOURCES INSTITUTE          ,FL,33126-5473,Proprietary  ,12,190,202,37,854,891
04129300,INTERNATIONAL B NATURALE BEAUTY SCHOOL  ,FL,33311-1152,Proprietary  ,0,0,0,2,13,15
04129900,FLORIDA SCHOOL OF MASSAGE               ,FL,32608-5419,Proprietary  ,9,38,47,74,255,329
04130400,SHEAR EXCELLENCE INTERNATIONAL HAIR ACAD,FL,33614-2783,Proprietary  ,2,16,18,14,70,84
04131900,FASTTRAIN OF MIAMI                      ,FL,33134-1065,Proprietary  ,50,112,162,224,389,613
04132000,FASTTRAIN OF FORT LAUDERDALE            ,FL,33317-3127,Proprietary  ,37,186,223,93,508,601
04132100,FASTTRAIN OF TAMPA                      ,FL,33607-4153,Proprietary  ,30,178,208,87,454,541
04132200,FASTTRAIN OF JACKSONVILLE               ,FL,32256-4849,Proprietary  ,9,119,128,45,362,407
04133500,ACADEMY FOR FIVE ELEMENT ACUPUNCTURE    ,FL,32601-6811,Private      ,0,15,15,11,135,146
04133900,FUTURA CAREER INSTITUTE                 ,FL,33012-3325,Proprietary  ,1,25,26,1,25,26
04134800,AVEDA INSTITUTE - TALLAHASSEE           ,FL,32304-3186,Proprietary  ,33,66,99,261,460,721
04134900,ORANGE PARK BEAUTY ACADEMY              ,FL,32073-5524,Proprietary  ,4,17,21,21,88,109
04135000,COZMO THE SCHOOL                        ,FL,34135-4810,Proprietary  ,1,19,20,23,115,138
04135900,ALLIED HEALTH INSTITUTE                 ,FL,33068-0000,Proprietary  ,16,253,269,72,1177,1249
04140800,NORTH FLORIDA ACADEMY                   ,FL,32065-7758,Proprietary  ,2,5,7,22,58,80
04143000,VOCATIONAL INSTITUTE OF FLORIDA         ,FL,33135-1939,Proprietary  ,2,16,18,13,93,106
04143100,PROFESSIONAL HANDS INSTITUTE            ,FL,33135-1939,Proprietary  ,4,82,86,46,444,490
04145900,CELEBRITY SCHOOL OF BEAUTY              ,FL,33144-4153,Proprietary  ,15,77,92,67,255,322
04146200,WALTON CAREER DEVELOPMENT CENTER        ,FL,32433-1557,Public       ,7,34,41,38,206,244
04146300,MARCHMAN TECHNICAL EDUCATION CENTER     ,FL,34653-1211,Public       ,23,58,81,134,295,429
04147800,ROSE TRAINING INSTITUTE                 ,FL,33881-4094,Proprietary  ,2,11,13,13,147,160
04148500,MEDICAL INSTITUTE OF PALM BEACH         ,FL,33460-5042,Proprietary  ,17,80,97,78,288,366
04150800,IMMOKALEE TECHNICAL CENTER              ,FL,34142-3146,Public       ,12,31,43,101,206,307
04151500,AMERICAN ACADEMY OF COSMETOLOGY         ,FL,32065-8026,Proprietary  ,9,23,32,47,146,193
04156300,UNIVERSITY OF FORT LAUDERDALE           ,FL,33313-5809,Private      ,4,15,19,19,134,153
04156400,AVIATION INSTITUTE OF MAINTENANCE       ,FL,32803-6487,Proprietary  ,16,62,78,178,458,636
04157100,AEROSIM FLIGHT ACADEMY                  ,FL,32773-9683,Proprietary  ,11,37,48,67,218,285
04158300,FLAGLER TECHNICAL INSTITUTE             ,FL,32137-4714,Public       ,11,58,69,61,328,389
04162000,JOSE MARIA VARGAS UNIVERSITY            ,FL,33025-4534,Proprietary  ,1,15,16,4,49,53
04162500,HOLLYWOOD INSTITUTE OF BEAUTY CAREERS   ,FL,33020-4807,Proprietary  ,18,93,111,77,372,449
04163000,SALON PROFESSIONAL ACADEMY (THE)        ,FL,33624-6321,Proprietary  ,7,25,32,77,178,255
04163100,SALON PROFESSIONAL ACADEMY (THE)        ,FL,32607-1672,Proprietary  ,6,30,36,55,161,216
04163200,SALON PROFESSIONAL ACADEMY (THE)        ,FL,32162-9311,Proprietary  ,7,63,70,74,264,338
04164500,EUREKA INSTITUTE OF HEALTH AND BEAUTY   ,FL,33174-4205,Proprietary  ,0,19,19,4,68,72
04164600,D. A. DORSEY EDUCATIONAL CENTER         ,FL,33147-6304,Public       ,1,26,27,9,95,104
04167300,SALON PROFESSIONAL ACADEMY (THE)        ,FL,33904-4824,Proprietary  ,1,19,20,45,137,182
04170300,BEAUTY ACADEMY OF SOUTH FLORIDA         ,FL,33012-3221,Proprietary  ,5,24,29,33,143,176
04172300,ETERNITY COSMETOLOGY SCHOOL             ,FL,33415-5719,Proprietary  ,8,54,62,9,83,92
04173600,NOTTER SCHOOL OF PASTRY ARTS            ,FL,32809-7755,Proprietary  ,4,35,39,60,206,266
04176800,PROGRESSIVE TRAINING CENTERS            ,FL,33060-9238,Proprietary  ,1,30,31,4,82,86
04176900,AMERICAN HEALTH INSTITUTE               ,FL,34654-3743,Proprietary  ,3,39,42,29,192,221
04182500,MILLENNIA ATLANTIC UNIVERSITY           ,FL,33178-2369,Proprietary  ,0,5,5,4,36,40
04188300,FLORIDA ACADEMY                         ,FL,33966-1155,Proprietary  ,11,33,44,25,143,168
00160500,CHAMINADE UNIV OF HONOLULU              ,HI,96816-1578,Private      ,72,144,216,2038,2080,4118
00160600,BRIGHAM YOUNG UNIV-HAWAII CAMPUS        ,HI,96762-1294,Private      ,108,85,193,1741,1078,2819
00161000,UNIVERSITY OF HAWAII AT MANOA           ,HI,96822-2399,Public       ,386,497,883,13007,10048,23055
00161100,UNIVERSITY OF HAWAII AT HILO            ,HI,96720-4091,Public       ,98,183,281,3544,3019,6563
00161200,HONOLULU COMMUNITY COLLEGE              ,HI,96817-4598,Public       ,175,325,500,2148,2810,4958
00161300,KAPIOLANI COMMUNITY COLLEGE             ,HI,96816-4421,Public       ,216,433,649,3279,4103,7382
00161400,KAUAI COMMUNITY COLLEGE                 ,HI,96766-9591,Public       ,49,98,147,553,835,1388
00161500,UNIVERSITY OF HAWAII MAUI COLLEGE       ,HI,96732-1644,Public       ,132,412,544,1770,3584,5354
00454900,LEEWARD COMMUNITY COLLEGE               ,HI,96782-3393,Public       ,237,453,690,2667,3584,6251
00525800,HAWAII COMMUNITY COLLEGE                ,HI,96720-4075,Public       ,111,331,442,1824,3197,5021
00723401,HEALD COLLEGE - HONOLULU                ,HI,96814-0000,Proprietary  ,124,289,413,1042,2406,3448
00727900,HAWAII PACIFIC UNIVERSITY               ,HI,96813-2882,Private      ,141,338,479,4789,4149,8938
01122000,WINDWARD COMMUNITY COLLEGE              ,HI,96744-0000,Public       ,72,174,246,999,1699,2698
02100300,MED-ASSIST SCHOOL OF HAWAII             ,HI,96813-0000,Proprietary  ,15,43,58,78,247,325
02107800,UNIVERSITY OF HAWAII - WEST OAHU        ,HI,96782-0000,Public       ,60,127,187,1093,1733,2826
02139500,HAWAII INSTITUTE OF HAIR DESIGN         ,HI,96817-5195,Proprietary  ,5,24,29,68,177,245
02159701,NEW HOPE CHRISTIAN COLLEGE - HAWAII     ,HI,96819-2228,Private      ,10,16,26,73,113,186
03017800,TRAVEL INSTITUTE OF THE PACIFIC         ,HI,96814-1946,Proprietary  ,9,33,42,53,178,231
03072500,WORLD MEDICINE INSTITUTE                ,HI,96826-0000,Private      ,5,7,12,24,100,124
03649300,HAWAII TECHNOLOGY INSTITUTE             ,HI,96813-3036,Private      ,7,22,29,50,143,193
03735300,INST OF CLINICAL ACUPUNCTURE & ORIENT MD,HI,96813-2307,Proprietary  ,1,9,10,4,72,76
03999400,TRADITIONAL CHINESE MEDICAL COLLEGE OF H,HI,96743-8324,Private      ,0,2,2,2,45,47
04165200,MAUNA LOA HELICOPTERS                   ,HI,96740-2650,Proprietary  ,1,7,8,9,43,52
04169600,HEISEI INTERNATIONAL INSTITUTE OF MASSAG,HI,96814-2254,Proprietary  ,1,4,5,3,18,21
04175100,PAUL MITCHELL THE SCHOOL HONOLULU       ,HI,96816-2433,Proprietary  ,7,29,36,110,212,322
04182200,HAWAII MEDICAL INSTITUTE                ,HI,96814-3518,Proprietary  ,26,48,74,122,339,461
00161600,BOISE STATE UNIVERSITY                  ,ID,83725-1000,Public       ,455,1069,1524,13907,14259,28166
00161700,"COLLEGE OF IDAHO, THE                   ",ID,83605-4432,Private      ,48,47,95,1597,526,2123
00161900,COLLEGE OF SOUTHERN IDAHO               ,ID,83301-0000,Public       ,220,568,788,3621,5134,8755
00161908,COLLEGE OF WESTERN IDAHO                ,ID,83687-1515,Public       ,395,1121,1516,4187,8693,12880
00162000,IDAHO STATE UNIVERSITY                  ,ID,83209-5377,Public       ,340,914,1254,6088,10568,16656
00162100,LEWIS-CLARK STATE COLLEGE               ,ID,83501-2698,Public       ,61,217,278,2501,2872,5373
00162300,NORTH IDAHO COLLEGE                     ,ID,83814-2199,Public       ,221,678,899,3329,5727,9056
00162400,NORTHWEST NAZARENE UNIVERSITY           ,ID,83686-5897,Private      ,41,130,171,1523,1553,3076
00162500,BRIGHAM YOUNG UNIVERSITY-IDAHO          ,ID,83460-1650,Private      ,1177,1034,2211,11689,9282,20971
00162600,UNIVERSITY OF IDAHO                     ,ID,83844-4291,Public       ,202,282,484,10621,5395,16016
00732915,ITT TECHNICAL INSTITUTE                 ,ID,83713-1529,Proprietary  ,111,292,403,715,2392,3107
00987300,MR JUAN'S CLG OF HAIR DESIGN            ,ID,83301-4154,Proprietary  ,6,11,17,19,56,75
01113300,EASTERN IDAHO TECHNICAL COLLEGE         ,ID,83404-5788,Public       ,43,181,224,446,1485,1931
02218000,CARRINGTON COLLEGE                      ,ID,83704-0000,Proprietary  ,55,206,261,303,1469,1772
02234500,BOISE BIBLE COLLEGE                     ,ID,83714-1220,Private      ,11,14,25,242,134,376
02275800,MR LEONS SCHOOL OF HAIR DESIGN          ,ID,83843-8384,Proprietary  ,4,10,14,28,67,95
02275801,MR. LEON'S SCHOOL OF HAIR DESIGN        ,ID,83501-1910,Proprietary  ,0,1,1,9,14,23
02314000,SCHOOL OF HAIRSTYLING (THE)             ,ID,83202-0000,Proprietary  ,2,15,17,34,103,137
02319800,HEADMASTERS SCHOOL OF HAIR DESIGN       ,ID,83814-0000,Proprietary  ,28,40,68,151,249,400
02349200,HEADMASTERS SCHOOL OF HAIR DESIGN       ,ID,83501-0000,Proprietary  ,2,6,8,28,75,103
02559500,RAZZLE DAZZLE CLG OF HAIR DESIGN        ,ID,83686-5104,Proprietary  ,9,21,30,85,211,296
02607100,PAUL MITCHELL THE SCHOOL BOISE          ,ID,83709-1662,Proprietary  ,24,27,51,158,282,440
03098700,ACADEMY OF COURT REPORTING              ,ID,83704-8320,Proprietary  ,36,153,189,194,856,1050
03832400,COSMETOLOGY SCHOOL OF ARTS & SCIENCES   ,ID,83318-1327,Proprietary  ,3,13,16,19,82,101
04051323,ART INSTITUTE OF PHOENIX (THE) - BROWN M,ID,83709-2746,Proprietary  ,6,27,33,57,232,289
04134300,EVANS HAIRSTYLING COLLEGE               ,ID,83440-5277,Proprietary  ,7,7,14,64,47,111
04144500,HAIR ACDMY PAUL MITCHELL PARTNER SCHOOL ,ID,83440-2600,Proprietary  ,14,15,29,117,160,277
04150600,D & L ACADEMY OF HAIR DESIGN            ,ID,83301-6229,Proprietary  ,4,12,16,25,56,81
04155200,OLIVER FINLEY ACADEMY OF COSMETOLOGY    ,ID,83704-8011,Proprietary  ,13,38,51,117,224,341
04163800,MASTER EDUCATORS BEAUTY SCHOOL          ,ID,83301-4118,Proprietary  ,2,9,11,30,58,88
04168600,COLLEGE OF MASSAGE THERAPY              ,ID,83221-1758,Proprietary  ,3,13,16,27,60,87
04176700,D'SHAW INSTITUTE OF COSMETOLOGY         ,ID,83704-4406,Proprietary  ,4,15,19,59,93,152
04194800,VELVET TOUCH ACADEMY OF COSMETOLOGY     ,ID,83687-5020,Proprietary  ,10,14,24,22,31,53
04203200,BOISE BARBER COLLEGE                    ,ID,83704-5919,Proprietary  ,3,21,24,3,21,24
04203500,AUSTIN KADE ACADEMY                     ,ID,83404-5540,Proprietary  ,15,45,60,15,45,60
00163200,AQUINAS INSTITUTE OF THEOLOGY           ,MO,63108-3323,Private      ,2,9,11,5,104,109
00244900,AVILA COLLEGE                           ,MO,64145-1698,Private      ,27,137,164,1263,1752,3015
00245000,CALVARY BIBLE COLLEGE                   ,MO,64147-1341,Private      ,12,20,32,178,239,417
00245200,CENTRAL BIBLE COLLEGE                   ,MO,65803-1096,Private      ,11,37,48,573,419,992
00245300,CENTRAL METHODIST UNIVERSITY            ,MO,65248-1198,Private      ,37,121,158,1697,1712,3409
00245400,UNIVERSITY OF CENTRAL MISSOURI          ,MO,64093-5178,Public       ,253,363,616,8803,5225,14028
00245600,COLUMBIA COLLEGE                        ,MO,65216-4581,Private      ,210,1971,2181,3179,20998,24177
00245700,CONCORDIA SEMINARY                      ,MO,63105-3199,Private      ,0,5,5,4,449,453
00245800,COTTEY COLLEGE                          ,MO,64772-2790,Private      ,14,4,18,382,68,450
00245900,CROWDER COLLEGE                         ,MO,64850-9165,Public       ,139,389,528,2493,3638,6131
00246000,CULVER STOCKTON COLLEGE                 ,MO,63435-1299,Private      ,19,16,35,1079,217,1296
00246100,DRURY UNIVERSITY                        ,MO,65802-3791,Private      ,108,381,489,2710,4590,7300
00246200,EDEN THEOLOGICAL SEMINARY               ,MO,63119-0000,Private      ,1,4,5,4,123,127
00246300,EVANGEL UNIVERSITY                      ,MO,65802-2125,Private      ,49,82,131,2210,997,3207
00246400,FONTBONNE UNIVERSITY                    ,MO,63105-3098,Private      ,36,179,215,1229,2650,3879
00246600,HARRIS-STOWE STATE COLLEGE              ,MO,63103-2199,Public       ,56,167,223,1485,2137,3622
00246700,CONCEPTION SEMINARY COLLEGE             ,MO,64433-0502,Private      ,0,4,4,74,15,89
00246800,JEFFERSON COLLEGE                       ,MO,63050-2441,Public       ,171,468,639,3023,3884,6907
00247100,ST LOUIS COMMUNITY COLLEGE              ,MO,63102-0000,Public       ,838,2604,3442,11961,20863,32824
00247300,KANSAS CITY ART INSTITUTE               ,MO,64111-1874,Private      ,44,36,80,1419,449,1868
00247400,KANSAS CITY UNIV OF MED AND BIOSCIENCES ,MO,64106-0000,Private      ,2,24,26,55,1202,1257
00247600,KENRICK-GLENNON SEMINARY                ,MO,63119-4330,Private      ,0,0,0,12,12,24
00247700,A.T. STILL UNIV OF HEALTH SCIENCES      ,MO,63501-0000,Private      ,1,91,92,14,2868,2882
00247900,LINCOLN UNIVERSITY                      ,MO,65101-3500,Public       ,73,181,254,2736,2167,4903
00248000,LINDENWOOD UNIVERSITY                   ,MO,63301-1695,Private      ,209,597,806,6181,8161,14342
00248200,MARYVILLE UNIVERSITY                    ,MO,63141-7299,Private      ,54,227,281,2311,2933,5244
00248400,METROPOLITAN COMMUNITY COLLEGE          ,MO,64111-2408,Public       ,716,2374,3090,10633,18956,29589
00248500,MIDWESTERN BAPTIST THEOL SEMINARY       ,MO,64118-4697,Private      ,4,34,38,107,384,491
00248600,MINERAL AREA COLLEGE                    ,MO,63601-1000,Public       ,112,357,469,2153,3096,5249
00248800,MISSOURI SOUTHERN STATE UNIVERSITY      ,MO,64801-1595,Public       ,110,309,419,4044,4127,8171
00248900,MISSOURI VALLEY COLLEGE                 ,MO,65340-3197,Private      ,21,31,52,1697,511,2208
00249000,MISSOURI WESTERN STATE UNIVERSITY       ,MO,64507-2294,Public       ,128,240,368,4711,3187,7898
00249100,MOBERLY AREA COMMUNITY COLLEGE          ,MO,65270-1304,Public       ,147,395,542,3026,3973,6999
00249400,NAZARENE THEOLOGICAL SEMINARY           ,MO,64131-1246,Private      ,0,4,4,7,166,173
00249500,TRUMAN STATE UNIVERSITY                 ,MO,63501-4221,Public       ,108,22,130,5957,640,6597
00249600,NORTHWEST MISSOURI STATE UNIV           ,MO,64468-6001,Public       ,127,110,237,7061,1606,8667
00249800,PARK UNIVERSITY                         ,MO,64152-3795,Private      ,59,993,1052,1593,9003,10596
00249900,ROCKHURST UNIVERSITY                    ,MO,64110-2561,Private      ,27,95,122,1927,1403,3330
00250000,COLLEGE OF THE OZARKS                   ,MO,65726-2502,Private      ,89,29,118,3161,472,3633
00250100,SOUTHEAST MISSOURI STATE UNIV           ,MO,63701-4799,Public       ,228,393,621,8694,4740,13434
00250200,SOUTHWEST BAPTIST UNIVERSITY            ,MO,65613-2597,Private      ,63,143,206,2164,1803,3967
00250300,MISSOURI STATE UNIVERSITY               ,MO,65897-0094,Public       ,431,619,1050,15159,8510,23669
00250400,ST LOUIS COLLEGE OF PHARMACY            ,MO,63110-1088,Private      ,14,25,39,795,636,1431
00250600,SAINT LOUIS UNIVERSITY                  ,MO,63103-2097,Private      ,163,362,525,9578,8340,17918
00250900,SAINT PAUL SCHOOL OF THEOLOGY           ,MO,64127-2499,Private      ,0,10,10,2,152,154
00251200,STEPHENS COLLEGE                        ,MO,65215-0001,Private      ,20,49,69,997,669,1666
00251400,NORTH CENTRAL MISSOURI COLLEGE          ,MO,64683-1824,Public       ,31,132,163,935,1210,2145
00251600,UNIVERSITY OF MISSOURI-COLUMBIA         ,MO,65211-1600,Public       ,720,505,1225,26018,9668,35686
00251700,MISSOURI UNIVERSITY OF SCIENCE & TECHNOL,MO,65409-0250,Public       ,119,83,202,5474,1463,6937
00251800,UNIVERSITY OF MISSOURI-KANSAS CITY      ,MO,64110-2497,Public       ,255,611,866,7687,10411,18098
00251900,UNIVERSITY OF MISSOURI-ST LOUIS         ,MO,63121-4499,Public       ,204,707,911,6004,10530,16534
00252000,WASHINGTON UNIVERSITY                   ,MO,63130-4899,Private      ,224,178,402,14354,6081,20435
00252001,WASHINGTON UNIV-SCHOOL OF MEDICINE      ,MO,63110-0000,Private      ,8,12,20,76,1255,1331
00252100,WEBSTER UNIVERSITY                      ,MO,63119-3194,Private      ,84,1002,1086,3272,13541,16813
00252200,WENTWORTH MILITARY ACADEMY              ,MO,64067-1799,Private      ,11,29,40,269,261,530
00252300,WESTMINSTER COLLEGE                     ,MO,65251-1299,Private      ,41,9,50,1367,159,1526
00252400,WILLIAM JEWELL COLLEGE                  ,MO,64068-1896,Private      ,36,32,68,1585,365,1950
00252500,WILLIAM WOODS UNIVERSITY                ,MO,65251-2388,Private      ,26,236,262,1090,1596,2686
00405704,NATIONAL AMERICAN UNIVERSITY            ,MO,64057-1791,Proprietary  ,3,62,65,50,657,707
00441300,ST JOHNS HOSP SCH RAD TECH              ,MO,65802-0000,Private      ,7,19,26,68,145,213
00470300,LOGAN COLLEGE OF CHIROPRACTIC           ,MO,63006-1065,Private      ,2,49,51,67,1083,1150
00470700,COVENANT THEOLOGICAL SEMINARY           ,MO,63141-8697,Private      ,0,20,20,3,524,527
00471100,LINN STATE TECHNICAL COLLEGE            ,MO,65051-9607,Public       ,38,49,87,1373,546,1919
00471300,THREE RIVERS COMMUNITY COLLEGE          ,MO,63901-2393,Public       ,143,503,646,2072,3860,5932
00528800,KIRKSVILLE AREA TECHNICAL CENTER        ,MO,63501-0000,Public       ,3,4,7,52,82,134
00528900,WAYNESVILLE CAREER CENTER               ,MO,65583-2131,Public       ,1,18,19,46,155,201
00542400,SOUTH CENTRAL CAREER CENTER             ,MO,65775-3334,Public       ,3,15,18,55,167,222
00542600,SIKESTON CAREER AND TECHNOLOGY CTR      ,MO,63801-0000,Public       ,2,20,22,48,167,215
00542900,ROLLA TECHNICAL INSTITUTE               ,MO,65401-3601,Public       ,8,29,37,260,358,618
00543000,POPLAR BLUFF TECHNICAL CAREER CNTR      ,MO,63901-0000,Public       ,2,22,24,47,183,230
00543800,SALINE COUNTY CAREER CENTER             ,MO,65340-0000,Public       ,0,2,2,15,63,78
00544500,TRUMAN MEDICAL CENTER SCHOOL OF NURSE AN,MO,64108-2677,Private      ,4,12,16,48,160,208
00553100,GRAND RIVER TECHNICAL SCHOOL            ,MO,64601-1299,Public       ,1,15,16,92,94,186
00553200,CAPE GIRARDEAU CAREER & TECHNOLOGY CENTE,MO,63703-7511,Public       ,8,67,75,186,572,758
00638900,BARNES JEWISH COLLEGE OF NURSING AND ALL,MO,63110-1091,Private      ,23,121,144,420,1200,1620
00639200,RESEARCH COLLEGE OF NURSING             ,MO,64132-1199,Proprietary  ,4,37,41,108,395,503
00639201,RESEARCH MEDICAL CENTER - COLLEGE OF NUR,MO,64132-1199,Proprietary  ,1,7,8,12,51,63
00639202,RESEARCH MED CTR SCHL OF RAD TECH       ,MO,64132-0000,Proprietary  ,1,15,16,15,69,84
00666600,LUTHERAN  SCHOOL OF NURSING             ,MO,63118-3909,Proprietary  ,3,34,37,108,469,577
00732923,ITT TECHNICAL INSTITUTE                 ,MO,63045-1122,Proprietary  ,212,826,1038,1122,4025,5147
00754000,MISSOURI BAPTIST UNIVERSITY             ,MO,63141-8698,Private      ,52,237,289,1623,2634,4257
00808000,STATE FAIR COMMUNITY COLLEGE            ,MO,65301-0000,Public       ,157,439,596,2544,3769,6313
00826900,HILLYARD TECHNICAL CENTER               ,MO,64506-0000,Public       ,1,33,34,112,286,398
00855200,STEVENS INSTITUTE OF BUSINESS & ARTS    ,MO,63103-0000,Proprietary  ,8,28,36,79,215,294
00860600,TRI-COUNTY TECHNICAL SCHOOL             ,MO,65026-0000,Public       ,2,12,14,21,88,109
00886200,EAST CENTRAL COLLEGE                    ,MO,63084-0529,Public       ,114,324,438,2203,2743,4946
00908900,HANNIBAL-LAGRANGE COLLEGE               ,MO,63401-1999,Private      ,21,36,57,866,587,1453
00952000,NATIONAL ACADEMY OF BEAUTY ARTS         ,MO,63128-1307,Proprietary  ,23,60,83,134,328,462
00959000,INDEPENDENCE COLLEGE OF COSMETOLOGY     ,MO,64055-1105,Proprietary  ,9,28,37,43,137,180
00960700,HOUSE OF HEAVILIN BEAUTY COLLEGE        ,MO,64110-2826,Proprietary  ,3,18,21,38,150,188
00978200,SAINT LUKE'S COLLEGE OF HEALTH SCIENCES ,MO,64114-3237,Private      ,5,45,50,80,203,283
00979500,MISSOURI COLLEGE                        ,MO,63144-2901,Proprietary  ,58,159,217,366,1274,1640
01014814,COLORADO TECHNL UNIV NORTH KANSAS CITY  ,MO,64116-3614,Proprietary  ,8,34,42,185,1202,1387
01027900,HICKEY COLLEGE                          ,MO,63146-0000,Proprietary  ,28,40,68,532,384,916
01040500,PINNACLE CAREER INSTITUTE               ,MO,64131-3367,Proprietary  ,45,402,447,311,2698,3009
01040501,PINNACLE CAREER INSTITUTE - NORTH KANSAS,MO,64153-1151,Proprietary  ,8,80,88,78,427,505
01050303,WICHITA TECHNICAL INSTITUTE - WTI JOPLIN,MO,64801-2970,Proprietary  ,5,37,42,32,286,318
01102600,WARRENSBURG AREA VOC TECH SCH           ,MO,64093-0000,Public       ,0,8,8,31,88,119
01173500,PIKE/LINCOLN TECHNICAL CENTER           ,MO,63344-0000,Public       ,4,6,10,70,110,180
01212000,ASSEMBLIES OF GOD THEO. SEMINARY        ,MO,65802-0000,Private      ,2,17,19,9,275,284
01250000,RANKEN TECHNICAL COLLEGE                ,MO,63113-2811,Private      ,122,297,419,1642,2058,3700
01258000,ST LOUIS CHRISTIAN COLLEGE              ,MO,63033-6499,Private      ,15,11,26,174,244,418
01320800,BAPTIST BIBLE COLLEGE                   ,MO,65803-3498,Private      ,11,26,37,339,256,595
02056100,FOUR RIVERS CAREER CENTER               ,MO,63090-0000,Public       ,0,8,8,26,75,101
02066900,NICHOLS CAREER CENTER                   ,MO,65101-2814,Public       ,1,13,14,76,171,247
02068200,COX HEALTH - COX COLLEGE                ,MO,65802-0000,Private      ,10,119,129,306,1095,1401
02068202,COX HEALTH - RADIOLOGIC TECHNOLOGY      ,MO,65802-0000,Private      ,3,13,16,49,131,180
02068204,COX HEALTH - MEDICAL TECHNOLOGY         ,MO,65807-0000,Private      ,0,0,0,32,81,113
02073600,KENNETT CAREER & TECHNOLOGY CENTER      ,MO,63857-0000,Public       ,0,12,12,8,87,95
02090400,BOONSLICK TECHNICAL EDUCATION CTR       ,MO,65233-0000,Public       ,0,1,1,17,58,75
02121100,MIDWEST INSTITUTE                       ,MO,63122-0000,Proprietary  ,16,74,90,77,325,402
02124500,FRANKLIN TECHNOLOGY CENTER              ,MO,64801-0000,Public       ,1,32,33,108,450,558
02142200,LEX LA RAY TECHNICAL CENTER             ,MO,64067-0000,Public       ,0,3,3,19,107,126
02151000,HANNIBAL CAREER AND TECHNICAL CENTE     ,MO,63401-2285,Public       ,0,3,3,29,126,155
02154900,MISSOURI SCH OF BARB & HAIR             ,MO,63031-0000,Proprietary  ,6,15,21,27,106,133
02164200,FOREST INST PROFESSIONAL PSYCHOLOGY     ,MO,65807-0000,Private      ,1,15,16,14,417,431
02165900,CHILLICOTHE BEAUTY ACADEMY              ,MO,64601-0000,Proprietary  ,1,16,17,8,39,47
02180200,METRO BUSINESS COLLEGE                  ,MO,63701-0000,Proprietary  ,13,92,105,136,912,1048
02188000,NORTHWEST TECHNICAL SCHOOL              ,MO,64468-0000,Public       ,4,5,9,45,41,86
02188100,NORTHLAND CAREER CENTER                 ,MO,64079-8333,Public       ,1,4,5,24,96,120
02202700,OZARK CHRISTIAN COLLEGE                 ,MO,64801-0000,Private      ,23,16,39,608,206,814
02203400,NEVADA REGIONAL TECHNICAL CENTER        ,MO,64772-0000,Public       ,1,3,4,26,85,111
02205200,SANFORD-BROWN COLLEGE                   ,MO,63026-7305,Proprietary  ,33,133,166,309,1593,1902
02205203,SANFORD BROWN COLLEGE-ST. PETERS        ,MO,63376-5950,Proprietary  ,20,100,120,192,982,1174
02214500,SALEM COLLEGE OF HAIRSTYLING            ,MO,65401-0000,Proprietary  ,1,5,6,13,49,62
02239200,ANTHEM COLLEGE                          ,MO,63043-0000,Proprietary  ,75,195,270,414,1152,1566
02239202,ANTHEM COLLEGE - METRO SOUTH            ,MO,63026-0000,Proprietary  ,4,14,18,33,111,144
02250600,EVEREST COLLEGE                         ,MO,65807-2446,Proprietary  ,22,118,140,157,727,884
02263106,ANTHEM COLLEGE - ANTHEM COLLEGE - KANSAS,MO,64114-3232,Proprietary  ,4,25,29,40,149,189
02263400,LAKE CAREER AND TECHNICAL CENTER        ,MO,65020-0000,Public       ,0,8,8,13,53,66
02266400,CENTRAL CHRISTIAN CLG OF THE BIBLE      ,MO,65270-0000,Private      ,10,12,22,223,174,397
02277500,HOUSE OF HEAVILIN OF BLUE SPRINGS       ,MO,64014-3953,Proprietary  ,6,21,27,58,148,206
02289200,COLUMBIA AREA CAREER CENTER             ,MO,65203-0000,Public       ,4,45,49,97,350,447
02295700,MISSOURI BEAUTY ACADEMY                 ,MO,63640-1827,Proprietary  ,7,30,37,65,171,236
02300105,EVEREST COLLEGE - EARTH CITY            ,MO,63045-1100,Proprietary  ,26,135,161,179,856,1035
02304000,MISSOURI TECH                           ,MO,63303-3887,Proprietary  ,5,29,34,62,174,236
02309100,AMERICAN COLLEGE OF HAIR DESIGN         ,MO,65301-2144,Proprietary  ,2,19,21,37,87,124
02313000,CASS CAREER CENTER                      ,MO,64701-0000,Public       ,1,6,7,16,65,81
02340500,ST LOUIS COLLEGE OF HEALTH CAREERS      ,MO,63110-0000,Proprietary  ,30,173,203,245,1124,1369
02342100,CAREER & TECHNOLOGY CTR AT FT OSAGE     ,MO,64058-0000,Public       ,2,8,10,19,59,78
02361600,CONCORDE CAREER COLLEGE                 ,MO,64111-0000,Proprietary  ,53,240,293,313,1439,1752
02497500,CLINTON TECHNICAL SCHOOL                ,MO,64735-2966,Public       ,1,18,19,23,82,105
02520800,MERRELL UNIV OF BTY ARTS & SCIENCES     ,MO,65109-0000,Proprietary  ,9,22,31,84,171,255
02530600,SAINT CHARLES COMMUNITY COLLEGE         ,MO,63376-0975,Public       ,239,489,728,4202,3875,8077
02543800,PARIS II EDUCATIONAL CENTER (THE)       ,MO,64118-0000,Proprietary  ,4,32,36,52,218,270
02555300,PATSY AND ROB'S ACADEMY OF BEAUTY       ,MO,63074-0000,Proprietary  ,0,0,0,9,36,45
02564700,ELAINE STEVEN BEAUTY COLLEGE            ,MO,63136-0000,Proprietary  ,17,43,60,85,210,295
02564701,ELAINE STEVEN BEAUTY COLLEGE - ADVANCE B,MO,63383-2006,Proprietary  ,1,2,3,8,11,19
02564702,ELAINE STEVEN BEAUTY COLLEGE - ADVANCE B,MO,63401-2269,Proprietary  ,0,1,1,2,14,16
02568500,GRABBER SCHOOL OF HAIR DESIGN           ,MO,63011-0000,Proprietary  ,5,16,21,51,145,196
02599700,VATTEROTT COLLEGE                       ,MO,63134-2900,Proprietary  ,54,227,281,434,2088,2522
02599701,VATTEROTT COLLEGE - KANSAS CITY         ,MO,64129-1692,Proprietary  ,16,165,181,138,1311,1449
02599702,VATTEROTT COLLEGE - SPRINGFIELD LOCATION,MO,65807-5340,Proprietary  ,21,125,146,148,864,1012
02599703,VATTEROTT COLLEGE - JOPLIN              ,MO,64801-5033,Proprietary  ,8,48,56,98,625,723
02599705,VATTEROTT COLLEGE - SUNSET HILLS        ,MO,63127-1516,Proprietary  ,27,115,142,144,1024,1168
02599712,VATTEROTT COLLEGE - O'FALLON            ,MO,63366-2748,Proprietary  ,20,86,106,134,574,708
02608000,NEOSHO BEAUTY COLLEGE                   ,MO,64850-1525,Proprietary  ,3,9,12,18,55,73
02609202,VATTEROTT COLLEGE-ST JOSEPH             ,MO,64501-2911,Proprietary  ,12,56,68,105,497,602
02609203,VATTEROTT COLLEGE - L'ECOLE CULINAIRE   ,MO,63124-1103,Proprietary  ,19,92,111,208,740,948
02611004,HERITAGE COLLEGE-KANSAS CITY            ,MO,64131-4203,Proprietary  ,34,177,211,259,1133,1392
03042400,LEBANON TECHNOLOGY & CAREER CENTER      ,MO,65536-3296,Public       ,5,23,28,40,169,209
03066300,BRYAN CAREER COLLEGE                    ,MO,65806-2507,Proprietary  ,15,150,165,89,799,888
03066303,BRYAN COLLEGE - COLUMBIA                ,MO,65201-8248,Proprietary  ,4,47,51,33,240,273
03068600,SPECIAL SCHOOL DISTRICT OF ST. LOUIS CO.,MO,63127-0000,Public       ,6,77,83,61,544,605
03070200,CENTRAL COLLEGE OF COSMETOLOGY          ,MO,65583-0000,Proprietary  ,3,28,31,33,109,142
03070900,SE MO HOSP CLG NURSING & HEALTH SCI     ,MO,63703-4507,Private      ,4,30,34,145,359,504
03072800,DALLAS COUNTY CAREER CENTER             ,MO,65685-9152,Public       ,0,1,1,2,1,3
03077200,COSMETOLOGY CONCEPTS INSTITUTE          ,MO,65202-1972,Proprietary  ,7,12,19,47,103,150
03083000,OZARKS TECHNICAL COMMUNITY COLLEGE      ,MO,65802-3601,Public       ,584,1690,2274,7976,13312,21288
03092600,MESSENGER COLLEGE                       ,MO,64804-4909,Private      ,6,5,11,35,72,107
03097600,ST LOUIS HAIR ACADEMY                   ,MO,63107-1737,Proprietary  ,4,17,21,15,82,97
03101000,NEW DIMENSION SCHOOL OF HAIR DESIGN     ,MO,64801-5017,Proprietary  ,3,11,14,28,82,110
03106000,MISSOURI STATE UNIVERSITY - WEST PLAINS ,MO,65775-2715,Public       ,68,155,223,1134,1454,2588
03110900,HOUSE OF HEAVILIN BEAUTY COLLEGE        ,MO,64083-9195,Proprietary  ,1,14,15,36,74,110
03166300,MOBERLY AREA TECHNICAL CENTER           ,MO,65270-1904,Public       ,0,7,7,46,64,110
03174300,HERNDON CAREER CENTER                   ,MO,64138-2695,Public       ,1,5,6,18,36,54
03519300,MISSOURI COLLEGE OF COSMETOLOGY NORTH   ,MO,65803-1235,Proprietary  ,6,37,43,94,249,343
03579300,TEXAS COUNTY TECHNICAL INSTITUTE        ,MO,65483-2700,Private      ,2,22,24,35,253,288
03616300,AVIATION INSTITUTE OF MAINTENANCE       ,MO,64129-1811,Proprietary  ,6,55,61,79,394,473
03663400,UNIVERSITY OF COSMETOLOGY               ,MO,63080-1910,Proprietary  ,0,0,0,1,3,4
03878300,PROFESSIONAL MASSAGE TRAINING CENTER    ,MO,65803-2939,Proprietary  ,4,17,21,55,163,218
03916300,ECLIPS SCHOOL OF COSMETOLOGY AND BARBERI,MO,63703-5809,Proprietary  ,15,63,78,55,226,281
03924300,HAIR ACADEMY 110 (THE)                  ,MO,63501-2915,Proprietary  ,2,5,7,14,29,43
03970400,WELLSPRING SCHOOL OF ALLIED HEALTH      ,MO,64114-3313,Proprietary  ,7,29,36,43,157,200
04037500,ACADEMY OF HAIR DESIGN                  ,MO,65804-2303,Proprietary  ,14,43,57,84,239,323
04051329,ART INSTITUTE OF PHOENIX (THE) - BROWN M,MO,63026-2564,Proprietary  ,3,13,16,41,76,117
04118700,AMERICAN COLLEGE OF TECHNOLOGY          ,MO,64506-2006,Proprietary  ,6,46,52,36,233,269
04119100,CITY VISION COLLEGE                     ,MO,64141-3188,Private      ,0,8,8,6,99,105
04122300,GRANTHAM UNIVERSITY                     ,MO,64153-2262,Proprietary  ,7,437,444,47,1394,1441
04127000,PEMISCOT COUNTY SPECIAL SCHOOL DISTRICT ,MO,63851-1666,Public       ,0,0,0,11,38,49
04130300,VICTORY TRADE SCHOOL                    ,MO,65803-2754,Private      ,0,8,8,7,87,94
04130600,"CENTER FOR HEALING ARTS (THE), LLC      ",MO,63143-2103,Proprietary  ,3,14,17,28,154,182
04133300,TREND SETTERS SCHOOL OF COSMETOLOGY     ,MO,63702-7607,Proprietary  ,3,12,15,46,111,157
04145200,TRANSFORMED BARBER AND COSMETOLOGY ACADE,MO,64137-1207,Proprietary  ,3,33,36,46,250,296
04145700,THE SYSTEM A PAUL MITCHELL PARTNER SCHL ,MO,65807-5969,Proprietary  ,4,37,41,124,233,357
04146100,URSHAN GRADUATE SCHOOL OF THEOLOGY      ,MO,63031-7526,Private      ,0,3,3,1,46,47
04170600,SALON PROFESSIONAL ACADEMY (THE)        ,MO,63301-1021,Proprietary  ,6,10,16,51,103,154
04170700,PAUL MITCHELL THE SCHOOL ST LOUIS       ,MO,63108-1554,Proprietary  ,21,29,50,189,272,461
04173900,COSMETOLOGY COLLEGE OF FRANKLIN COUNTY  ,MO,63077-3448,Proprietary  ,1,10,11,17,36,53
04174000,SKIN INSTITUTE                          ,MO,63128-1307,Proprietary  ,3,13,16,21,102,123
04174800,AMERICAN TRADE SCHOOL                   ,MO,63074-1807,Proprietary  ,3,31,34,33,178,211
04184400,SEYMOUR BEAUTY ACADEMY                  ,MO,65746-8743,Proprietary  ,1,9,10,7,37,44
04187000,DONNA'S ACADEMY OF HAIR DESIGN          ,MO,64089-9042,Proprietary  ,1,5,6,1,5,6
00314600,WESTERN OKLAHOMA STATE COLLEGE          ,OK,73521-1397,Public       ,25,100,125,607,1179,1786
00314700,BACONE COLLEGE                          ,OK,74403-1597,Private      ,18,81,99,990,1074,2064
00314900,SOUTHERN NAZARENE UNIVERSITY            ,OK,73008-2694,Private      ,26,255,281,1198,1973,3171
00315000,CAMERON UNIVERSITY                      ,OK,73505-6377,Public       ,125,501,626,2338,4635,6973
00315100,OKLAHOMA WESLEYAN UNIVERSITY            ,OK,74006-6299,Private      ,14,94,108,741,1088,1829
00315200,UNIV OF CENTRAL OKLAHOMA                ,OK,73034-5209,Public       ,339,636,975,8693,8232,16925
00315300,CONNORS STATE COLLEGE                   ,OK,74469-9700,Public       ,56,187,243,1146,1962,3108
00315400,EAST CENTRAL UNIVERSITY                 ,OK,74820-6999,Public       ,88,247,335,2647,3238,5885
00315500,EASTERN OKLAHOMA STATE COLLEGE          ,OK,74578-4999,Public       ,43,149,192,830,1420,2250
00315600,REDLANDS COMMUNITY COLLEGE              ,OK,73036-5304,Public       ,30,174,204,767,1411,2178
00315700,LANGSTON UNIVERSITY                     ,OK,73050-0000,Public       ,62,138,200,2102,2331,4433
00315800,MURRAY STATE COLLEGE                    ,OK,73460-3137,Public       ,59,198,257,1216,2089,3305
00316000,NORTHEASTERN OKLAHOMA A & M COLLEGE     ,OK,74354-6497,Public       ,68,143,211,1709,1445,3154
00316100,NORTHEASTERN STATE UNIVERSITY           ,OK,74464-2399,Public       ,161,461,622,5256,7188,12444
00316200,NORTHERN OKLAHOMA COLLEGE               ,OK,74653-0310,Public       ,102,251,353,1973,2606,4579
00316300,NORTHWESTERN OKLAHOMA STATE UNIV        ,OK,73717-2799,Public       ,47,88,135,1406,1078,2484
00316400,OKLAHOMA BAPTIST UNIVERSITY             ,OK,74801-2590,Private      ,64,41,105,2233,507,2740
00316500,OKLAHOMA CHRISTIAN UNIVERSITY           ,OK,73131-0000,Private      ,35,76,111,2073,930,3003
00316600,OKLAHOMA CITY UNIVERSITY                ,OK,73106-1493,Private      ,113,218,331,2510,3016,5526
00316700,UNIV OF SCIENCE & ARTS OF OKLAHOMA      ,OK,73018-5322,Public       ,15,32,47,745,511,1256
00316800,ROGERS STATE UNIVERSITY                 ,OK,74017-3252,Public       ,101,263,364,2649,3410,6059
00317000,OKLAHOMA STATE UNIVERSITY               ,OK,74078-1026,Public       ,597,602,1199,16749,8745,25494
00317200,OKLAHOMA STATE UNIVERSITY-OKMULGEE      ,OK,74447-3901,Public       ,104,215,319,1835,2200,4035
00317400,OKLAHOMA PANHANDLE STATE UNIVERSITY     ,OK,73939-0000,Public       ,63,49,112,965,552,1517
00317600,CARL ALBERT STATE COLLEGE               ,OK,74953-5208,Public       ,61,230,291,1348,2320,3668
00317800,SEMINOLE STATE COLLEGE                  ,OK,74818-1902,Public       ,56,145,201,1075,1547,2622
00317900,SOUTHEASTERN OKLAHOMA STATE UNIV        ,OK,74701-0609,Public       ,99,256,355,2427,2696,5123
00318000,SOUTHWESTERN CHRISTIAN UNIVERSITY       ,OK,73008-2335,Private      ,27,218,245,420,749,1169
00318100,SOUTHWESTERN OKLAHOMA STATE UNIV        ,OK,73096-3098,Public       ,100,168,268,3120,2298,5418
00318101,SOUTHWESTERN OK STATE UNIV AT SAYRE     ,OK,73662-0000,Public       ,5,22,27,154,301,455
00318300,ST GREGORY'S UNIVERSITY                 ,OK,74804-2499,Private      ,5,44,49,336,446,782
00318308,SAINT GREGORY'S UNIVERSITY - IPD TULSA  ,OK,74135-2499,Private      ,2,23,25,56,210,266
00318400,UNIVERSITY OF OKLAHOMA                  ,OK,73019-4078,Public       ,496,722,1218,17567,11062,28629
00318401,UNIVERSITY OF OKLAHOMA-HLTH SCI CTR     ,OK,73190-0000,Public       ,21,140,161,538,3478,4016
00318500,UNIVERSITY OF TULSA                     ,OK,74104-3189,Private      ,91,124,215,3233,2105,5338
00398500,ORAL ROBERTS UNIVERSITY                 ,OK,74171-0001,Private      ,56,134,190,2984,1878,4862
00531100,TULSA COUNTY AREA VOC TECH SCHOOL       ,OK,74145-0000,Public       ,38,192,230,417,1661,2078
00531200,RED RIVER TECHNOLOGY CENTER             ,OK,73533-2700,Public       ,4,28,32,30,192,222
00533900,METRO TECHNOLOGY CENTERS SCH DIST22     ,OK,73111-0000,Public       ,22,200,222,245,1620,1865
00533903,METRO TECHNOLOGY CENTERS SCH DIST22     ,OK,73129-0000,Public       ,8,73,81,87,536,623
00694200,MID-AMERICA CHRISTIAN UNIVERSITY        ,OK,73170-4504,Private      ,23,338,361,478,2394,2872
00767800,SPARTAN COLLEGE OF AERONAUTICS AND TECHN,OK,74115-5800,Proprietary  ,66,116,182,1066,1082,2148
00791100,VIRGILS BEAUTY COLLEGE                  ,OK,74401-6802,Proprietary  ,3,8,11,22,62,84
00834300,AUTRY TECHNOLOGY CENTER                 ,OK,73703-2598,Public       ,2,26,28,99,321,420
00861900,TRI COUNTY TECHNOLOGY CENTER            ,OK,74006-6029,Public       ,8,36,44,76,259,335
00918500,ROSE STATE COLLEGE                      ,OK,73110-2799,Public       ,168,664,832,2767,6582,9349
00920400,KIAMICHI AREA VOC TECH SCHOOL           ,OK,74578-0548,Public       ,14,106,120,305,1121,1426
00920408,KIAMICHI AREA VOC TECH SCHOOL           ,OK,74953-0000,Public       ,2,24,26,59,190,249
00961800,TULSA WELDING SCHOOL                    ,OK,74104-0000,Proprietary  ,183,544,727,1326,2286,3612
00964700,"OKLAHOMA STATE UNIV, OKLA CITY          ",OK,73107-6159,Public       ,194,763,957,2519,6909,9428
00970800,EVES COLLEGE OF HAIRSTYLING             ,OK,73501-4359,Proprietary  ,9,23,32,41,128,169
00976300,TULSA COMMUNITY COLLEGE                 ,OK,74135-6198,Public       ,467,1557,2024,8116,15040,23156
00996300,CADDO KIOWA VOC TECH CENTER             ,OK,73038-0000,Public       ,11,46,57,78,377,455
00996400,CENTRAL OKLAHOMA AREA VOC TECH SCH      ,OK,74030-9613,Public       ,9,44,53,97,352,449
00996500,CANADIAN VALLEY TECHNOLOGY CENTER       ,OK,73036-9117,Public       ,11,76,87,110,447,557
00996800,GORDON COOPER TECHNOLOGY CENTER         ,OK,74804-9913,Public       ,9,72,81,118,500,618
01005300,INDIAN CAPITAL TECHNOLGY CENTER #4      ,OK,74403-9907,Public       ,17,84,101,196,785,981
01026600,HILLSDALE FREE WILL BAPTIST COLLEGE     ,OK,73153-0000,Private      ,17,5,22,200,89,289
01034200,SOUTHERN OKLAHOMA TECHNOLOGY CENTER     ,OK,73401-2100,Public       ,2,40,42,77,347,424
01039100,OKLAHOMA CITY COMMUNITY COLLEGE         ,OK,73159-4444,Public       ,321,1147,1468,4760,11034,15794
01050304,WTI TULSA CAMPUS                        ,OK,74112-3140,Proprietary  ,4,41,45,28,229,257
01071700,GREAT PLAINS TECHNOLOGY CENTER SCHOOL DI,OK,73505-8399,Public       ,9,92,101,125,692,817
01076200,WESTERN OK AREA VOC TECH SCH DIST12     ,OK,73624-1469,Public       ,1,9,10,45,142,187
01120600,PIONEER TECHNOLOGY CENTER               ,OK,74601-1106,Public       ,2,28,30,30,236,266
01128200,OKLAHOMA STATE UNV CLG OSTEOPTHC MD     ,OK,74107-0000,Public       ,3,20,23,73,618,691
01153700,MID-AMERICA TECHNOLOGY CENTER           ,OK,73095-0210,Public       ,7,9,16,53,143,196
01227200,MOORE-NORMAN TECHNOLOGY CENTER          ,OK,73069-8399,Public       ,19,129,148,211,950,1161
02052700,NORTHEAST TECHNOLOGY CENTER             ,OK,74361-0487,Public       ,23,72,95,178,647,825
02060800,MERIDIAN TECHNOLOGY CENTER              ,OK,74074-0000,Public       ,18,57,75,132,439,571
02126500,ENID BEAUTY COLLEGE                     ,OK,73701-0000,Proprietary  ,4,10,14,20,65,85
02184400,SAND SPRINGS BEAUTY COLLEGE             ,OK,74063-0000,Proprietary  ,4,22,26,37,189,226
02197300,HOLLYWOOD COSMETOLOGY CENTER            ,OK,73189-0000,Proprietary  ,0,9,9,13,69,82
02222700,FRANCIS TUTTLE TECHNOLOGY CENTER        ,OK,73142-0000,Public       ,39,243,282,338,1671,2009
02238500,CENTRAL STATE BEAUTY ACADEMY            ,OK,73162-6007,Proprietary  ,6,60,66,56,355,411
02250900,E OK COUNTY AREA VO-TECH                ,OK,73020-0000,Public       ,5,20,25,32,98,130
02256200,"BROKEN ARROW BEAUTY COLLEGE, INC        ",OK,74012-0000,Proprietary  ,15,33,48,91,284,375
02282100,HIGH PLAINS AREA VOC-TECH               ,OK,73801-0000,Public       ,1,7,8,27,108,135
02306800,PLATT COLLEGE                           ,OK,74145-0000,Proprietary  ,53,313,366,364,2080,2444
02510300,BEAUTY TECHNICAL COLLEGE                ,OK,74465-0000,Proprietary  ,4,11,15,20,54,74
02531200,WOODWARD BEAUTY COLLEGE                 ,OK,73801-0000,Proprietary  ,2,4,6,9,36,45
02554300,AMERICAN BEAUTY INSTITUTE               ,OK,74501-0000,Proprietary  ,2,9,11,13,72,85
02556500,YUKON BEAUTY COLLEGE                    ,OK,73099-4108,Proprietary  ,0,6,6,6,31,37
02560200,PHILLIPS THEOLOGICAL SEMINARY -         ,OK,74116-5612,Private      ,1,7,8,3,95,98
02581100,CLAREMORE BEAUTY COLLEGE                ,OK,74017-7034,Proprietary  ,1,3,4,12,36,48
02581200,CC'S COSMETOLOGY COLLEGE                ,OK,74129-0000,Proprietary  ,2,31,33,64,189,253
02591101,CAREER POINT INSTITUTE                  ,OK,74146-0000,Proprietary  ,2,35,37,44,245,289
02596501,ATI-CAREER TRAINING CENTER - OKLAHOMA CI,OK,73107-2442,Proprietary  ,8,53,61,94,454,548
02596502,ATI- CAREER TRAINING CENTER - OKLAHOMA C,OK,76101-2740,Proprietary  ,2,26,28,33,197,230
02597400,PONTOTOC TECHNOLOGY CENTER SCHOOL       ,OK,74820-8621,Public       ,6,31,37,80,230,310
02599706,VATTEROTT COLLEGE - TULSA               ,OK,74146-2205,Proprietary  ,5,57,62,60,499,559
02600000,NORTHWEST TECHNOLOG CTR SCH DIST 10     ,OK,73717-9600,Public       ,3,12,15,44,81,125
02600500,WES WATKINS TECHNOLOGY CENTER           ,OK,74883-9660,Public       ,5,23,28,36,196,232
02609205,VATTEROTT COLLEGE - OKLAHOMA CITY       ,OK,73127-2103,Proprietary  ,12,94,106,64,731,795
03008700,SOUTHWEST TECHNOLOGY CENTER             ,OK,73521-1527,Public       ,6,25,31,37,145,182
03024700,STILLWATER BEAUTY ACADEMY               ,OK,74075-3467,Proprietary  ,0,14,14,13,61,74
03030700,OKLAHOMA SCHOOL OF PHOTOGRAPHY          ,OK,73160-3320,Proprietary  ,2,27,29,30,131,161
03030800,AMERICAN BROADCASTING SCHOOL            ,OK,73115-3334,Proprietary  ,9,59,68,59,351,410
03051100,CHISHOLM TRAIL TECHNOLOGY CENTER        ,OK,73764-9720,Public       ,1,2,3,11,69,80
03078500,TECH INST OF COSMETOLOGY ARTS & SCI     ,OK,74120-3610,Proprietary  ,3,15,18,43,105,148
03103800,SOUTHERN SCHOOL OF BEAUTY               ,OK,74701-5008,Proprietary  ,1,6,7,14,50,64
03109800,PONCA CITY BEAUTY COLLEGE               ,OK,74601-4201,Proprietary  ,0,2,2,4,22,26
03109801,BARTLESVILLE BEAUTY COLLEGE             ,OK,74003-2835,Proprietary  ,2,4,6,2,31,33
03115100,HERITAGE COLLEGE                        ,OK,73119-0000,Proprietary  ,34,202,236,251,1178,1429
03124800,PLATT COLLEGE                           ,OK,73501-3808,Proprietary  ,12,68,80,71,417,488
03124901,IMAGINE -  PAUL MITCHELL PARTNER SCHOOL ,OK,73072-4831,Proprietary  ,13,27,40,107,233,340
03126200,GREEN COUNTRY AREA VOC TECH SCHOOL      ,OK,74447-1217,Public       ,2,17,19,54,123,177
03198400,MID-DEL AREA VOCATIONAL & TECH SCH      ,OK,73110-4825,Public       ,0,22,22,24,173,197
03329400,PRYOR BEAUTY COLLEGE                    ,OK,74361-0000,Proprietary  ,2,6,8,10,47,57
03329401,PRYOR BEAUTY COLLEGE - GROVE BEAUTY COLL,OK,74345-0009,Proprietary  ,0,7,7,7,32,39
03329402,PRYOR BEAUTY COLLEGE - NORTH EAST OKLAHO,OK,74338-0000,Proprietary  ,2,2,4,3,10,13
03367400,COMMUNITY CARE COLLEGE                  ,OK,74145-6420,Proprietary  ,65,266,331,486,1673,2159
03396300,OKLAHOMA HEALTH ACADEMY                 ,OK,74105-6220,Proprietary  ,10,45,55,73,310,383
03396400,OKLAHOMA HEALTH ACADEMY                 ,OK,73160-3667,Proprietary  ,3,13,16,40,182,222
03453400,SHAWNEE BEAUTY COLLEGE                  ,OK,74801-7014,Proprietary  ,4,12,16,11,49,60
03676300,FAMILY OF FAITH COLLEGE                 ,OK,74802-1805,Private      ,0,3,3,12,21,33
03831300,INSTITUTE OF HAIR DESIGN                ,OK,74804-0000,Proprietary  ,1,10,11,3,38,41
03928300,CENTRAL STATE MASSAGE ACADEMY           ,OK,73162-6007,Proprietary  ,1,23,24,26,100,126
04027300,4-STATES ACADEMY OF COSMETOLOGY         ,OK,74354-0000,Proprietary  ,0,0,0,5,6,11
04051324,ART INSTITUTE OF PHOENIX (THE) - BROWN M,OK,74146-5234,Proprietary  ,17,68,85,139,728,867
04060300,AMERICAN INSTITUTE OF MEDICAL TECHNOLOGY,OK,74146-5201,Proprietary  ,5,33,38,51,270,321
04062300,BROOKLINE COLLEGE                       ,OK,73114-6318,Proprietary  ,2,17,19,26,168,194
04121300,4-STATES OKMULGEE ACADEMY OF COSMETOLOGY,OK,74447-0000,Proprietary  ,0,5,5,9,35,44
04133600,CUTTER'S EDGE SCHOOL OF COSMETOLOGY     ,OK,74023-2905,Proprietary  ,1,7,8,6,32,38
04144400,ACADEMY OF HAIR DESIGN (THE)            ,OK,73120-6808,Proprietary  ,7,29,36,46,173,219
00163700,BETHANY THEOLOGICAL SEMINARY            ,IN,47374-0000,Private      ,0,4,4,1,69,70
00178400,ANCILLA COLLEGE-FINANCIAL AID OFFC      ,IN,46513-0001,Private      ,2,34,36,458,587,1045
00178500,ANDERSON UNIVERSITY                     ,IN,46012-3495,Private      ,34,105,139,2919,1365,4284
00178600,BALL STATE UNIVERSITY                   ,IN,47306-0880,Public       ,279,518,797,22001,11213,33214
00178700,BETHEL COLLEGE INC                      ,IN,46545-5591,Private      ,16,85,101,1758,1704,3462
00178800,BUTLER UNIVERSITY                       ,IN,46208-3487,Private      ,97,124,221,7922,2232,10154
00178900,CHRISTIAN THEOLOGICAL SEMINARY          ,IN,46208-0000,Private      ,0,28,28,7,311,318
00179200,DEPAUW UNIVERSITY                       ,IN,46135-0037,Private      ,23,15,38,3188,173,3361
00179300,EARLHAM COLLEGE                         ,IN,47374-4095,Private      ,21,12,33,1473,223,1696
00179301,EARLHAM SCHOOL OF RELIGION              ,IN,47374-0000,Private      ,0,1,1,7,69,76
00179500,UNIVERSITY OF EVANSVILLE                ,IN,47722-0002,Private      ,38,61,99,3926,956,4882
00179800,FRANKLIN COLLEGE OF INDIANA             ,IN,46131-2623,Private      ,16,19,35,1936,329,2265
00179900,GOSHEN COLLEGE                          ,IN,46526-4794,Private      ,9,50,59,1027,522,1549
00180000,GRACE COLLEGE & THEO SEMINARY           ,IN,46590-1224,Private      ,17,42,59,1667,1064,2731
00180100,HANOVER COLLEGE                         ,IN,47243-0108,Private      ,38,6,44,2338,125,2463
00180300,HUNTINGTON UNIVERSITY                   ,IN,46750-1299,Private      ,12,41,53,1431,478,1909
00180400,UNIVERSITY OF INDIANAPOLIS              ,IN,46227-3697,Private      ,89,277,366,5802,5117,10919
00180500,INDIANA INSTITUTE OF TECHNOLOGY         ,IN,46803-1297,Private      ,39,353,392,2153,4537,6690
00180700,INDIANA STATE UNIVERSITY                ,IN,47809-2501,Public       ,192,501,693,12356,8590,20946
00180800,UNIVERSITY OF SOUTHERN INDIANA          ,IN,47712-3596,Public       ,136,246,382,9327,4368,13695
00180900,INDIANA UNIVERSITY-BLOOMINGTON          ,IN,47405-1223,Public       ,430,436,866,33263,13178,46441
00181100,INDIANA UNIV-EAST                       ,IN,47374-1289,Public       ,29,173,202,1658,2606,4264
00181300,INDIANA UNIV-PURDUE UNIV INDPLS         ,IN,46202-5145,Public       ,336,1149,1485,18529,24363,42892
00181301,INDIANA UNIVERSITY - PURDUE UNIVERSITY I,IN,47203-1769,Public       ,40,145,185,1882,2261,4143
00181400,INDIANA UNIV KOKOMO                     ,IN,46902-3557,Public       ,32,166,198,1884,2670,4554
00181500,INDIANA UNIV-NORTHWEST                  ,IN,46408-1197,Public       ,126,422,548,3528,5715,9243
00181600,INDIANA UNIVERSITY - SOUTH BEND         ,IN,46615-0000,Public       ,118,392,510,5088,6664,11752
00181700,INDIANA UNIVERSITY-SOUTHEAST            ,IN,47150-6405,Public       ,89,311,400,4560,4769,9329
00182000,MANCHESTER COLLEGE                      ,IN,46962-1276,Private      ,24,12,36,2578,311,2889
00182100,MARIAN UNIVERSITY                       ,IN,46222-1997,Private      ,30,177,207,2107,2493,4600
00182200,INDIANA WESLEYAN UNIVERSITY             ,IN,46953-4974,Private      ,70,1615,1685,4544,16569,21113
00182300,ASSOCIATED MENNONITE BIBLICAL SEM       ,IN,46517-1999,Private      ,0,6,6,2,110,112
00182400,OAKLAND CITY UNIVERSITY                 ,IN,47660-1099,Private      ,5,45,50,568,1940,2508
00182500,PURDUE UNIVERSITY                       ,IN,47907-2050,Public       ,359,403,762,31958,9101,41059
00182600,PURDUE UNIV NORTH CENTRAL CAMPUS        ,IN,46391-9542,Public       ,58,147,205,2708,3112,5820
00182700,PURDUE UNIV CALUMET                     ,IN,46323-2094,Public       ,121,426,547,5350,6676,12026
00182800,INDIANA UNIV-PURDUE UNIV FORT WAYNE     ,IN,46805-1499,Public       ,158,562,720,9706,9584,19290
00183000,ROSE HULMAN INSTITUTE OF TECHNOLOGY     ,IN,47803-3999,Private      ,33,14,47,3248,149,3397
00183200,UNIVERSITY OF SAINT FRANCIS             ,IN,46808-3994,Private      ,28,101,129,2283,2170,4453
00183300,ST JOSEPH'S COLLEGE                     ,IN,47978-0000,Private      ,14,15,29,1329,230,1559
00183400,CALUMET COLLEGE OF SAINT JOSEPH         ,IN,46394-2195,Private      ,21,48,69,584,931,1515
00183500,SAINT MARY-OF-THE-WOODS COLLEGE         ,IN,47876-0067,Private      ,7,63,70,431,1236,1667
00183600,ST MARY'S COLLEGE                       ,IN,46556-5007,Private      ,13,5,18,1773,95,1868
00183800,TAYLOR UNIVERSITY                       ,IN,46989-1001,Private      ,22,19,41,2459,294,2753
00183900,TRINE UNIVERSITY                        ,IN,46703-1764,Private      ,18,65,83,2769,1089,3858
00184000,UNIVERSITY OF NOTRE DAME                ,IN,46556-5602,Private      ,156,154,310,12695,3580,16275
00184200,VALPARAISO UNIVERSITY                   ,IN,46383-6493,Private      ,78,78,156,4559,2135,6694
00184300,VINCENNES UNIVERSITY                    ,IN,47591-1523,Public       ,146,335,481,6791,5065,11856
00184400,WABASH COLLEGE                          ,IN,47933-0352,Private      ,9,4,13,1327,74,1401
00457900,INTERNATIONAL BUSINESS COLLEGE          ,IN,46804-0000,Proprietary  ,15,40,55,797,496,1293
00457901,INTERNATIONAL BUSINESS COLLEGE          ,IN,46256-0000,Proprietary  ,17,31,48,686,473,1159
00625700,SAINT ELIZABETH SCHOOL OF NURSING       ,IN,47904-2198,Private      ,5,22,27,157,383,540
00726300,HOLY CROSS COLLEGE                      ,IN,46556-0308,Private      ,13,3,16,670,142,812
00727600,SAINT MEINRAD SCHOOL OF THEOLOGY        ,IN,47577-1002,Private      ,0,4,4,1,128,129
00732900,ITT TECHNICAL INSTITUTE                 ,IN,46268-1119,Proprietary  ,451,3008,3459,2629,14743,17372
00732908,ITT TECHNICAL INSTITUTE                 ,IN,46143-1067,Proprietary  ,2,19,21,68,154,222
00732933,ITT TECHNICAL INSTITUTE                 ,IN,46635-1512,Proprietary  ,13,87,100,204,599,803
00732962,ITT TECHNICAL INSTITUTE                 ,IN,47630-7430,Proprietary  ,234,859,1093,1354,4760,6114
00732968,ITT TECHNICAL INSTITUTE                 ,IN,46410-0000,Proprietary  ,5,28,33,137,438,575
00732993,ITT TECHNICAL INSTITUTE                 ,IN,46825-2393,Proprietary  ,190,651,841,1320,4510,5830
00736200,MEDTECH COLLEGE                         ,IN,46250-3970,Proprietary  ,29,176,205,303,2051,2354
00736202,MEDTECH COLLEGE - GREENWOOD             ,IN,46143-6478,Proprietary  ,10,102,112,162,1055,1217
00736204,MEDTECH COLLEGE - FORT WAYNE            ,IN,46804-2209,Proprietary  ,15,90,105,175,1051,1226
00793800,LINCOLN COLLEGE OF TECHNOLOGY           ,IN,46202-0000,Proprietary  ,100,137,237,1835,1365,3200
00842300,IVY TECH COMMUNITY COLLEGE OF INDIANA - ,IN,46601-3892,Public       ,0,0,0,2693,9190,11883
00854600,NOT FOR STUDENT USE                     ,IN,46208-4700,Public       ,0,0,0,16,97,113
00854700,IVY TECH COMMUNITY COLLEGE OF INDIANA - ,IN,47802-4898,Public       ,0,0,0,2210,5388,7598
00931306,DAYMAR COLLEGE - ROCKPORT               ,IN,47635-1506,Proprietary  ,0,6,6,0,9,9
00951500,J MICHAEL HARROLD BEAUTY ACADEMY        ,IN,47807-3390,Proprietary  ,1,10,11,46,123,169
00961200,"APEX SCHOOL OF BEAUTY CULTURE, INC      ",IN,46016-0000,Proprietary  ,1,9,10,14,57,71
00961300,MERRILLVILLE BEAUTY COLLEGE             ,IN,46410-3401,Proprietary  ,2,28,30,28,129,157
00967300,RUDAE'S SCHOOL OF BEAUTY CULTURE        ,IN,46825-5444,Proprietary  ,9,35,44,151,245,396
00977700,KAPLAN COLLEGE                          ,IN,46278-1736,Proprietary  ,29,192,221,410,1819,2229
00977702,KAPLAN COLLEGE - TEMPORARY FACILITY EXPA,IN,46268-4111,Proprietary  ,1,10,11,14,105,119
00977703,KAPLAN COLLEGE -  SE INDY               ,IN,46227-0000,Proprietary  ,12,133,145,189,988,1177
00991700,IVY TECH COMMUNITY COLLEGE OF INDIANA   ,IN,46208-1763,Public       ,2475,11583,14058,16072,50153,66225
00991713,IVY TECH COMMUNITY COLLEGE OF INDIANA - ,IN,47302-9448,Public       ,0,0,0,3641,8372,12013
00991715,IVY TECH COMMUNITY COLLEGE OF INDIANA - ,IN,47903-6299,Public       ,0,0,0,3485,6592,10077
00991720,IVY TECH COMMUNITY COLLEGE OF INDIANA - ,IN,46805-1489,Public       ,0,0,0,5020,11950,16970
00991725,IVY TECH COMMUNITY COLLEGE OF INDIANA - ,IN,47374-1220,Public       ,0,0,0,1253,4195,5448
00991731,IVY TECH COMMUNITY COLLEGE OF INDIANA - ,IN,46409-1303,Public       ,0,0,0,3172,8865,12037
00991735,IVY TECH COMMUNITY COLLEGE OF INDIANA - ,IN,46903-1373,Public       ,0,0,0,1648,5428,7076
00991736,IVY TECH COMMUNITY COLLEGE OF INDIANA - ,IN,47203-1868,Public       ,0,0,0,1822,4469,6291
00991745,IVY TECH COMMUNITY COLLEGE OF INDIANA - ,IN,47172-1897,Public       ,0,0,0,1662,4304,5966
00991747,IVY TECH COMMUNITY COLLEGE OF INDIANA - ,IN,47710-3398,Public       ,0,0,0,2086,5276,7362
00991750,IVY TECH COMMUNITY COLLEGE OF INDIANA - ,IN,47404-9772,Public       ,0,0,0,3168,5078,8246
00991752,IVY TECH COMMUNITY COLLEGE OF INDIANA - ,IN,47250-1881,Public       ,0,0,0,976,2408,3384
01015100,VINCENNES BEAUTY COLLEGE                ,IN,47591-1297,Proprietary  ,7,9,16,32,73,105
01040900,LAFAYETTE BEAUTY ACADEMY                ,IN,47901-1149,Proprietary  ,8,32,40,85,192,277
01048900,NATIONAL COLLEGE                        ,IN,46250-1930,Proprietary  ,2,35,37,105,1176,1281
01048910,NATIONAL COLLEGE - SOUTH BEND           ,IN,46617-3123,Proprietary  ,7,43,50,37,256,293
01048911,NATIONAL COLLEGE - FORT WAYNE           ,IN,46826-4905,Proprietary  ,2,20,22,37,180,217
01061800,MID-AMERICA CLG FUNERAL SERVICE         ,IN,47130-9990,Private      ,2,11,13,64,149,213
01150500,CREATIVE HAIR STYLING ACADEMY           ,IN,46322-1554,Proprietary  ,15,35,50,95,174,269
02084800,RAVENSCROFT BEAUTY COLLEGE              ,IN,46815-0000,Proprietary  ,4,40,44,92,240,332
02087600,CONCORDIA THEOLOGICAL SEMINARY          ,IN,46825-0000,Private      ,0,9,9,5,231,236
02100402,EVEREST INSTITUTE - EVEREST COLLEGE     ,IN,46410-7064,Proprietary  ,18,190,208,265,1256,1521
02140800,MARTIN UNIVERSITY                       ,IN,46218-0000,Private      ,15,148,163,209,1740,1949
02158400,HARRISON COLLEGE                        ,IN,46204-2611,Proprietary  ,57,380,437,740,4629,5369
02158401,HARRISON COLLEGE - COLUMBUS             ,IN,47203-1843,Proprietary  ,7,58,65,111,557,668
02158402,HARRISON COLLEGE - LAFAYETTE            ,IN,47905-4859,Proprietary  ,12,71,83,159,581,740
02158404,HARRISON COLLEGE - MARION               ,IN,46952-0000,Proprietary  ,0,0,0,0,1,1
02158405,HARRISON COLLEGE - TERRE HAUTE          ,IN,47802-0000,Proprietary  ,11,64,75,98,648,746
02158407,HARRISON COLLEGE - ANDERSON             ,IN,46013-0000,Proprietary  ,16,64,80,132,682,814
02158409,HARRISON COLLEGE - EVANSVILLE           ,IN,47715-3901,Proprietary  ,13,74,87,163,623,786
02158410,HARRISON COLLEGE - EAST                 ,IN,46239-8903,Proprietary  ,12,89,101,227,1168,1395
02158412,HARRISON COLLEGE - FORT WAYNE           ,IN,46825-0000,Proprietary  ,22,98,120,259,1082,1341
02158413,HARRISON COLLEGE - NORTHWEST            ,IN,46278-0000,Proprietary  ,8,44,52,225,502,727
02158800,DON ROBERTS BEAUTY SCHOOLS              ,IN,46383-0000,Proprietary  ,0,11,11,26,104,130
02164300,DON ROBERTS SCHOOL OF HAIR DESIGN       ,IN,46375-9999,Proprietary  ,2,7,9,39,78,117
02180108,ROSS MEDICAL EDUCATION CENTER -         ,IN,46530-4479,Proprietary  ,1,15,16,21,74,95
02201800,KAPLAN COLLEGE                          ,IN,46324-3347,Proprietary  ,21,117,138,140,670,810
02201802,KAPLAN COLLEGE - HAMMOND                ,IN,46324-3347,Proprietary  ,1,7,8,150,762,912
02241700,PJ'S COLLEGE OF COSMETOLOGY             ,IN,47129-0000,Proprietary  ,9,38,47,69,240,309
02245505,FORTIS COLLEGE - INDIANAPOLIS CAMPUS    ,IN,46268-0000,Proprietary  ,5,40,45,64,392,456
02302700,J EVERETT LIGHT CAREER CENTER           ,IN,46240-0000,Public       ,3,29,32,62,352,414
02304800,PJ'S COLLEGE OF COSMETOLOGY             ,IN,47374-0000,Proprietary  ,4,17,21,28,137,165
02308900,MASTER'S OF COSMETOLOGY COLLEGE         ,IN,46809-0000,Proprietary  ,15,24,39,119,166,285
02339600,ROGER'S ACADEMY OF HAIR DESIGN          ,IN,47712-0000,Proprietary  ,8,19,27,60,177,237
02345200,EMPIRE BEAUTY SCHOOL                    ,IN,46237-0000,Proprietary  ,22,68,90,219,676,895
02351300,KNOX BEAUTY COLLEGE                     ,IN,46534-0000,Proprietary  ,1,6,7,20,36,56
02490500,HAIR FASHIONS BY KAYE BEAUTY CLG        ,IN,46250-0000,Proprietary  ,2,26,28,69,286,355
02490800,HAIR FASHIONS BY KAYE BEAUTY CLG        ,IN,46060-0000,Proprietary  ,1,11,12,41,104,145
02607000,HAIR ARTS ACADEMY                       ,IN,47404-3581,Proprietary  ,2,16,18,40,147,187
02615800,COLLEGE OF COURT REPORTING              ,IN,46342-5969,Proprietary  ,2,33,35,30,370,400
03009700,HARRISON COLLEGE                        ,IN,47303-6413,Proprietary  ,2,63,65,104,540,644
03009701,HARRISON COLLEGE - MUNCIE - ELKHART     ,IN,46516-9795,Proprietary  ,9,70,79,113,612,725
03100600,MARION COMM TUCKER AREA VOC SCHOOL      ,IN,46952-3831,Public       ,2,27,29,36,185,221
03176300,AVIATION INSTITUTE OF MAINTENANCE       ,IN,46241-1445,Proprietary  ,10,112,122,132,602,734
03262300,DAVID DEMUTH INSTITUTE OF COSM          ,IN,47374-4101,Proprietary  ,2,8,10,12,67,79
03456700,CROSSROADS BIBLE COLLEGE                ,IN,46219-4912,Private      ,1,28,29,80,357,437
03538300,ALEXANDRIA SCH OF SCIENTIFIC THERAP     ,IN,46001-0287,Proprietary  ,3,10,13,29,105,134
04038700,IDEAL BEAUTY ACADEMY                    ,IN,47130-4215,Proprietary  ,2,17,19,26,84,110
04051304,ART INSTITUTE OF PHOENIX (THE) - ART  IN,IN,46268-1170,Proprietary  ,85,118,203,1214,1214,2428
04051311,ART INSTITUTE OF PHOENIX (THE) - BROWN M,IN,46410-5608,Proprietary  ,20,115,135,181,956,1137
04051312,ART INSTITUTE OF PHOENIX (THE) - BROWN M,IN,46360-7362,Proprietary  ,8,65,73,111,600,711
04051318,ART INSTITUTE OF PHOENIX (THE) - BROWN M,IN,46204-1017,Proprietary  ,28,192,220,406,1857,2263
04051321,ART INSTITUTE OF PHOENIX (THE) - BROWN M,IN,46635-1176,Proprietary  ,22,88,110,327,1398,1725
04051322,ART INSTITUTE OF PHOENIX (THE) - BROWN M,IN,46805-0000,Proprietary  ,31,158,189,362,1915,2277
04100300,SUCCESS SCHOOLS                         ,IN,46410-5310,Proprietary  ,6,36,42,68,215,283
04121000,TECHSKILLS - INDIANAPOLIS               ,IN,46240-4302,Proprietary  ,1,28,29,23,221,244
04130900,HONORS BEAUTY COLLEGE                   ,IN,46256-3317,Proprietary  ,5,28,33,91,287,378
04155900,AVEDA FREDRIC'S INSTITUTE               ,IN,46250-4746,Proprietary  ,9,25,34,131,203,334
04166700,REM SPA INC                             ,IN,46013-3136,Proprietary  ,11,12,23,70,153,223
04171700,AVANT GARD THE SCHOOL                   ,IN,46214-6500,Proprietary  ,1,10,11,33,77,110
04172700,SALON PROFESSIONAL ACADEMY (THE)        ,IN,47715-7822,Proprietary  ,13,24,37,87,197,284
04184000,PAUL MITCHELL THE SCHOOL INDIANAPOLIS   ,IN,46227-6252,Proprietary  ,13,44,57,165,246,411
04186600,SALON PROFESSIONAL ACADEMY (THE)        ,IN,46901-6248,Proprietary  ,0,20,20,21,83,104
00190100,ALLEN COUNTY COMMUNITY COLLEGE          ,KS,66749-1607,Public       ,61,221,282,1055,1660,2715
00190200,COWLEY COUNTY COMMUNITY COLLEGE & AREA V,KS,67005-2662,Public       ,121,327,448,1691,2969,4660
00190300,BAKER UNIVERSITY                        ,KS,66006-0065,Private      ,36,302,338,1441,2344,3785
00190400,BETHANY COLLEGE                         ,KS,67456-1897,Private      ,11,6,17,831,132,963
00190500,BETHEL COLLEGE                          ,KS,67117-0531,Private      ,7,5,12,652,142,794
00190600,BUTLER COUNTY COMMUNITY COLLEGE         ,KS,67042-3280,Public       ,258,661,919,4404,6004,10408
00190700,CENTRAL BAPTIST THEOLOGY SEMINARY       ,KS,66226-3513,Private      ,0,5,5,0,61,61
00190800,CENTRAL CHRISTIAN COLLEGE OF KANSAS     ,KS,67460-5799,Private      ,15,102,117,503,285,788
00190900,CLOUD COUNTY COMMUNITY COLLEGE          ,KS,66901-1002,Public       ,39,132,171,854,1182,2036
00191000,COFFEYVILLE COMMUNITY COLLEGE           ,KS,67337-5064,Public       ,40,81,121,1069,694,1763
00191100,COLBY COMMUNITY COLLEGE                 ,KS,67701-4099,Public       ,24,38,62,623,442,1065
00191300,DODGE CITY COMMUNITY COLLEGE            ,KS,67801-2399,Public       ,33,90,123,821,794,1615
00191400,DONNELLY COLLEGE                        ,KS,66102-4298,Private      ,23,109,132,235,808,1043
00191500,FORT HAYS STATE UNIVERSITY              ,KS,67601-4099,Public       ,110,438,548,4019,5302,9321
00191600,FORT SCOTT COMMUNITY COLLEGE            ,KS,66701-3199,Public       ,45,140,185,1217,1209,2426
00191700,BARCLAY COLLEGE                         ,KS,67059-0288,Private      ,8,8,16,149,130,279
00191800,FRIENDS UNIVERSITY                      ,KS,67213-3397,Private      ,38,242,280,1360,2962,4322
00191900,GARDEN CITY COMMUNITY COLLEGE           ,KS,67846-6398,Public       ,46,75,121,903,717,1620
00192000,HESSTON COLLEGE                         ,KS,67062-2093,Private      ,8,13,21,477,200,677
00192100,HIGHLAND COMMUNITY COLLEGE              ,KS,66035-4062,Public       ,62,172,234,1262,1689,2951
00192300,HUTCHINSON COMMUNITY COLLEGE            ,KS,67501-5894,Public       ,123,328,451,2383,2962,5345
00192400,INDEPENDENCE COMMUNITY COLLEGE          ,KS,67301-0708,Public       ,43,65,108,563,577,1140
00192500,KANSAS CITY KANSAS COMMUNITY CLG        ,KS,66112-9978,Public       ,151,610,761,2060,5728,7788
00192502,KANSAS CITY KANSAS COMMUNITY COLLEGE - T,KS,66104-2821,Public       ,4,19,23,115,347,462
00192600,PITTSBURG STATE UNIVERSITY              ,KS,66762-7500,Public       ,139,204,343,5115,3089,8204
00192700,EMPORIA STATE UNIVERSITY                ,KS,66801-5087,Public       ,87,231,318,3271,3010,6281
00192800,KANSAS STATE UNIVERSITY                 ,KS,66506-1104,Public       ,421,483,904,15775,7245,23020
00192900,KANSAS WESLEYAN UNIVERSITY              ,KS,67401-6196,Private      ,22,27,49,1104,372,1476
00193000,LABETTE COMMUNITY COLLEGE               ,KS,67357-4299,Public       ,38,102,140,668,984,1652
00193100,MANHATTAN CHRISTIAN COLLEGE             ,KS,66502-4081,Private      ,15,10,25,386,148,534
00193300,MCPHERSON COLLEGE                       ,KS,67460-3899,Private      ,32,12,44,875,192,1067
00193600,NEOSHO COUNTY COMMUNITY COLLEGE         ,KS,66720-2699,Public       ,38,152,190,717,1391,2108
00193700,OTTAWA UNIVERSITY                       ,KS,66067-3399,Private      ,50,422,472,955,3120,4075
00193800,PRATT COMMUNITY COLLEGE                 ,KS,67124-8432,Public       ,17,84,101,628,830,1458
00193900,NEWMAN UNIVERSITY                       ,KS,67213-2084,Private      ,44,131,175,1315,1796,3111
00194000,SOUTHWESTERN COLLEGE                    ,KS,67156-2499,Private      ,17,134,151,844,1297,2141
00194300,UNIVERSITY OF ST MARY                   ,KS,66048-5023,Private      ,21,74,95,696,672,1368
00194500,STERLING COLLEGE                        ,KS,67579-1533,Private      ,17,8,25,817,179,996
00194600,TABOR COLLEGE                           ,KS,67063-1799,Private      ,21,19,40,776,272,1048
00194800,UNIVERSITY OF KANSAS                    ,KS,66045-7535,Public       ,408,457,865,16519,11047,27566
00194900,WASHBURN UNIVERSITY                     ,KS,66621-1110,Public       ,127,289,416,3415,4681,8096
00194901,WASHBURN UNIVERSITY -TOPEKA - WASHBURN I,KS,66604-2199,Public       ,29,126,155,622,1176,1798
00195000,WICHITA STATE UNIVERSITY                ,KS,67208-0001,Public       ,237,634,871,7127,9127,16254
00460800,BARTON COUNTY COMMUNITY COLLEGE         ,KS,67530-9283,Public       ,42,258,300,937,1988,2925
00526400,FLINT HILLS TECHNICAL COLLEGE           ,KS,66801-5999,Public       ,18,56,74,291,532,823
00526500,NORTH CENTRAL KANSAS TECH COLG          ,KS,67420-0000,Public       ,14,26,40,388,368,756
00526700,NORTHWEST KANSAS TECHNICAL SCHOOL       ,KS,67735-3441,Public       ,6,21,27,265,194,459
00549800,WICHITA AREA TECHNICAL COLLEGE          ,KS,67211-2099,Public       ,74,409,483,569,2918,3487
00549900,SALINA AREA TECHNICAL COLLEGE           ,KS,67401-8195,Public       ,12,32,44,203,301,504
00550000,MANHATTAN AREA TECHNICAL COLLEGE        ,KS,66503-2499,Public       ,26,105,131,415,796,1211
00675500,BROWN MACKIE COLLEGE (THE)              ,KS,67401-7307,Proprietary  ,55,214,269,505,1730,2235
00703200,MID AMERICA NAZARENE UNIVERSITY         ,KS,66062-1899,Private      ,14,132,146,1003,1245,2248
00822800,SEWARD CO COMM CO/AREA TECHNICAL SCHOOL ,KS,67905-0000,Public       ,25,64,89,529,622,1151
00824400,JOHNSON COUNTY COMMUNITY COLLEGE        ,KS,66210-1299,Public       ,422,1194,1616,6391,9792,16183
00833200,B-STREET DESIGN SCHOOL OF INTERNATIONAL ,KS,66502-6082,Proprietary  ,6,29,35,49,155,204
00868200,ACADEMY OF HAIR DESIGN                  ,KS,67401-2803,Proprietary  ,0,0,0,9,13,22
01025600,BENEDICTINE COLLEGE                     ,KS,66002-1499,Private      ,36,23,59,2240,218,2458
01043800,HASKELL INDIAN NATIONS UNIVERSITY       ,KS,66046-4800,Public       ,65,69,134,1005,800,1805
01050300,WICHITA TECHNICAL INSTITUTE             ,KS,67213-1927,Proprietary  ,34,174,208,228,1226,1454
01050302,WICHITA TECHNICAL INSTITUTE - WTI TOPEKA,KS,66609-1217,Proprietary  ,5,54,59,62,432,494
01050305,WICHITA TECHNICAL INSTITUTE - EAST CAMPU,KS,67208-4243,Proprietary  ,6,55,61,79,408,487
02090700,CLEVELAND CHIROPRACTIC COLLEGE          ,KS,66210-1613,Private      ,6,80,86,55,629,684
02134800,OLD TOWN BARBER AND BEAUTY COLLEGE      ,KS,67211-0000,Proprietary  ,3,19,22,44,98,142
02196400,CAPITOL CITY HAIR DESIGN COLLEGE        ,KS,66102-0000,Proprietary  ,0,0,0,6,14,20
02257700,HAYS ACADEMY OF HAIR DESIGN             ,KS,67601-0000,Proprietary  ,2,6,8,54,63,117
02303500,AMERICAN INSTITUTE OF BAKING            ,KS,66502-0000,Private      ,0,3,3,19,34,53
02340700,LABARON HAIRDRESSING ACADEMY            ,KS,66204-0000,Proprietary  ,3,13,16,15,59,74
02590900,WRIGHT CAREER COLLEGE                   ,KS,66212-0000,Private      ,93,561,654,456,2834,3290
02599709,VATTEROTT COLLEGE - WICHITA             ,KS,67226-1304,Proprietary  ,7,53,60,86,575,661
02603100,XENON INTERNATIONAL ACADEMY             ,KS,67203-5428,Proprietary  ,9,39,48,142,270,412
02606300,PAUL MITCHELL THE SCHOOL WICHITA        ,KS,67226-2803,Proprietary  ,18,40,58,132,197,329
02611005,HERITAGE COLLEGE - WICHITA              ,KS,67210-1879,Proprietary  ,32,141,173,217,979,1196
02613000,PINNACLE CAREER INSTITUTE               ,KS,66046-2703,Proprietary  ,6,53,59,78,410,488
03031300,XENON INTERNATIONAL ACADEMY IV          ,KS,66061-3765,Proprietary  ,7,13,20,67,120,187
03066200,BRYAN COLLEGE                           ,KS,66604-2496,Proprietary  ,4,50,54,37,360,397
03450300,B-STREET DESIGN SCHOOL OF INTERNATIONAL ,KS,66611-2373,Proprietary  ,6,29,35,55,206,261
03450301,B-STREET DESIGN SCHOOL OF INTERNATIONAL ,KS,67207-5148,Proprietary  ,6,18,24,43,124,167
03450302,B-STREET DESIGN SCHOOL OF INTERNATIONAL ,KS,66212-5451,Proprietary  ,9,25,34,96,193,289
03529300,SIDNEY'S HAIRDRESSING COLLEGE           ,KS,67501-7094,Proprietary  ,4,7,11,34,71,105
04132900,Z HAIR ACADEMY                          ,KS,66046-4040,Proprietary  ,5,9,14,53,73,126
04162700,ERIC FISHER ACADEMY                     ,KS,67212-3376,Proprietary  ,15,22,37,155,203,358
04175700,ACADEMY OF AESTHETIC ARTS               ,KS,66203-3502,Proprietary  ,1,12,13,18,68,86
04179600,ENTOURAGE INSTITUTE OF BEAUTY AND ESTHET,KS,66215-3803,Proprietary  ,4,2,6,15,45,60
00203300,UNIVERSITY OF MAINE-PRESQUE ISLE        ,ME,04769-2888,Public       ,9,46,55,787,616,1403
00203500,BANGOR THEOLOGICAL SEMINARY             ,ME,04402-0411,Private      ,0,4,4,2,67,69
00203600,BATES COLLEGE                           ,ME,04240-6028,Private      ,55,12,67,3025,145,3170
00203800,BOWDOIN COLLEGE                         ,ME,04011-8451,Private      ,58,11,69,3993,127,4120
00203900,COLBY COLLEGE                           ,ME,04901-8841,Private      ,44,7,51,3146,93,3239
00204000,UNIVERSITY OF MAINE-FARMINGTON          ,ME,04938-1990,Public       ,33,47,80,2744,602,3346
00204100,UNIVERSITY OF MAINE-FORT KENT           ,ME,04743-1292,Public       ,7,31,38,634,425,1059
00204300,HUSSON UNIVERSITY                       ,ME,04401-2999,Private      ,38,80,118,2808,1638,4446
00204400,MAINE MARITIME ACADEMY                  ,ME,04420-0001,Public       ,8,5,13,1089,180,1269
00205000,UNIVERSITY OF NEW ENGLAND               ,ME,04005-9599,Private      ,53,231,284,4396,4111,8507
00205100,SAINT JOSEPH'S COLLEGE                  ,ME,04084-5263,Private      ,29,182,211,1776,1372,3148
00205200,THOMAS COLLEGE                          ,ME,04901-5097,Private      ,14,25,39,1063,337,1400
00205300,UNIVERSITY OF MAINE                     ,ME,04469-0001,Public       ,151,156,307,11264,3514,14778
00205400,UNIVERSITY OF SOUTHERN MAINE            ,ME,04104-0000,Public       ,126,350,476,6799,6129,12928
00205500,UNIVERSITY OF MAINE-MACHIAS             ,ME,04654-1397,Public       ,7,32,39,538,406,944
00458615,KAPLAN UNIVERSITY - PORTLAND            ,ME,04106-2415,Proprietary  ,11,110,121,131,815,946
00458616,KAPLAN UNIVERSITY - LEWISTON            ,ME,04240-0000,Proprietary  ,12,130,142,102,929,1031
00520400,BEAL COLLEGE                            ,ME,04401-6896,Proprietary  ,12,71,83,249,729,978
00527600,CENTRAL MAINE COMMUNITY COLLEGE         ,ME,04210-6498,Public       ,66,263,329,1620,2314,3934
00527700,EASTERN MAINE COMMUNITY COLLEGE         ,ME,04401-4280,Public       ,67,206,273,1722,1989,3711
00552500,SOUTHERN MAINE COMMUNITY  COLLEGE       ,ME,04106-1698,Public       ,229,536,765,4035,4763,8798
00576000,NORTHERN MAINE COMMUNITY COLLEGE        ,ME,04769-2016,Public       ,21,75,96,482,796,1278
00630501,CENTRAL MAINE MEDICAL CENTER - COLLEGE O,ME,04240-4500,Private      ,4,23,27,107,369,476
00676000,UNIVERSITY OF MAINE-AUGUSTA             ,ME,04330-9410,Public       ,77,478,555,1758,5956,7714
00685800,UNITY COLLEGE                           ,ME,04988-9502,Private      ,18,12,30,926,136,1062
00903800,MR BERNARD'S SCH HAIR FASHION INC       ,ME,04243-1163,Proprietary  ,5,38,43,49,184,233
00923100,WASHINGTON COUNTY COMMUNITY COLLEGE     ,ME,04619-9704,Public       ,7,41,48,251,355,606
00945900,EMPIRE BEAUTY SCHOOL                    ,ME,04101-3348,Proprietary  ,12,74,86,197,451,648
00982600,KENNEBEC VALLEY  COMMUNITY  COLLEGE     ,ME,04937-1367,Public       ,46,236,282,875,2136,3011
01138500,COLLEGE OF THE ATLANTIC                 ,ME,04609-1105,Private      ,12,7,19,511,99,610
01167300,MAINE COLLEGE OF ART                    ,ME,04101-3987,Private      ,10,9,19,621,239,860
02104400,SPA TECH INSTITUTE                      ,ME,04093-0000,Proprietary  ,29,81,110,188,479,667
02347100,NEW ENGLAND SCHOOL OF COMMUNICATIONS    ,ME,04401-0000,Private      ,7,15,22,610,174,784
02361300,LANDING SCHOOL OF BOATBUILDING & DESIGN ,ME,04046-1490,Private      ,0,1,1,27,46,73
03122900,YORK COUNTY COMMUNITY COLLEGE           ,ME,04090-0529,Public       ,38,130,168,607,1106,1713
03429300,SEACOAST CAREER SCHOOLS                 ,ME,04073-0000,Proprietary  ,45,167,212,173,679,852
03612300,BIRTHWISE MIDWIFERY SCHOOL              ,ME,04009-1110,Proprietary  ,1,6,7,12,69,81
04177400,CAPILO SCHOOL OF HAIR DESIGN            ,ME,04330-0000,Proprietary  ,8,20,28,75,121,196
04185100,NORTHEAST TECHNICAL INSTITUTE           ,ME,04074-0000,Proprietary  ,10,125,135,39,400,439
04188800,INSTITUTE FOR DOCTORAL STUDIES IN THE VI,ME,04102-0000,Private      ,0,16,16,0,28,28
00209300,ST JOHN'S COLLEGE                       ,NM,87505-4599,Private      ,17,13,30,430,213,643
00264900,SANTA FE UNIVERSITY OF ART AND DESIGN   ,NM,87505-7634,Proprietary  ,29,25,54,730,256,986
00265000,UNIVERSITY OF THE SOUTHWEST             ,NM,88240-9129,Private      ,7,86,93,291,547,838
00265100,EASTERN NEW MEXICO UNIV PORTALES        ,NM,88130-6000,Public       ,77,234,311,2883,3127,6010
00265101,EASTERN NEW MEXICO UNIV-ROSWELL CAM     ,NM,88202-0000,Public       ,55,176,231,1161,1949,3110
00265102,EASTERN NEW MEXICO UNIVERSITY - RUIDOSO ,NM,88345-0001,Public       ,0,0,0,3,3,6
00265300,NEW MEXICO HIGHLANDS UNIVERSITY         ,NM,87701-4436,Public       ,49,170,219,1899,2560,4459
00265400,NEW MEXICO INST OF MINING & TECH        ,NM,87801-4796,Public       ,27,30,57,1190,486,1676
00265500,NEW MEXICO JUNIOR COLLEGE               ,NM,88240-9123,Public       ,36,110,146,755,1145,1900
00265600,NEW MEXICO MILITARY INSTITUTE           ,NM,88201-5173,Public       ,25,7,32,456,64,520
00265700,NEW MEXICO STATE UNIVERSITY             ,NM,88003-8001,Public       ,369,569,938,12558,9687,22245
00265701,NEW MEXICO STATE UNIV-ALAMOGORDO        ,NM,88311-0000,Public       ,44,173,217,496,1523,2019
00265702,NEW MEXICO STATE UNIV.-DONA ANA CLG     ,NM,88003-0000,Public       ,183,438,621,3113,4930,8043
00265703,NEW MEXICO STATE UNIV-CARLSBAD          ,NM,88220-0000,Public       ,16,80,96,338,718,1056
00265704,NEW MEXICO STATE UNIV-GRANTS            ,NM,87020-0000,Public       ,9,52,61,233,606,839
00266000,SAN JUAN COLLEGE                        ,NM,87402-4699,Public       ,199,685,884,2002,4967,6969
00266300,THE UNIVERSITY OF NEW MEXICO            ,NM,87131-0001,Public       ,569,1254,1823,16663,19228,35891
00266301,UNIV OF NEW MEXICO - GALLUP BRANCH      ,NM,87301-5697,Public       ,30,84,114,687,1106,1793
00266302,UNIV OF NEW MEXICO - VALENCIA BRANCH    ,NM,87031-0000,Public       ,17,49,66,429,686,1115
00266303,UNIV OF NEW MEXICO - LOS ALAMOS         ,NM,87544-0000,Public       ,7,15,22,145,153,298
00266304,UNIVERSITY OF NEW MEXICO                ,NM,87571-6401,Public       ,15,42,57,299,506,805
00266400,WESTERN NEW MEXICO UNIVERSITY           ,NM,88061-5417,Public       ,45,195,240,1209,2251,3460
00405701,NATIONAL AMERICAN UNIVERSITY            ,NM,87110-0000,Proprietary  ,2,70,72,57,529,586
00474200,CENTRAL NEW MEXICO COMMUNITY COLLEGE    ,NM,87106-4096,Public       ,747,2457,3204,8633,20642,29275
00474300,CLOVIS COMMUNITY COLLEGE                ,NM,88101-8381,Public       ,51,216,267,681,1980,2661
00996200,LUNA COMMUNITY COLLEGE                  ,NM,87701-0000,Public       ,26,83,109,518,776,1294
01063200,DEWOLFF CLG HAIRSTYLING/COSMETOLOGY     ,NM,87112-4113,Proprietary  ,8,32,40,62,185,247
01300500,OLYMPIAN UNIVERSITY OF COSMETOLOGY      ,NM,88310-5051,Proprietary  ,63,244,307,445,1505,1950
02083900,NORTHERN NEW MEXICO COLLEGE             ,NM,87530-0000,Public       ,38,126,164,716,1165,1881
02146400,INSTITUTE OF AMERICAN INDIAN ARTS       ,NM,87508-0000,Public       ,18,30,48,187,297,484
02218808,BROOKLINE COLLEGE - ALBUQUERQUE         ,NM,87105-1649,Proprietary  ,34,174,208,222,981,1203
02278100,SANTA FE COMMUNITY COLLEGE              ,NM,87507-0000,Public       ,67,331,398,1026,2763,3789
02293203,ATI CAREER TRAINING CENTER - ALBUQUERQUE,NM,87109-2016,Proprietary  ,4,29,33,67,243,310
02357600,NAVAJO TECHNICAL COLLEGE                ,NM,87313-0000,Public       ,61,108,169,490,1086,1576
02511000,SOUTHWESTERN INDIAN POLYTECH INST       ,NM,87184-0000,Public       ,45,72,117,320,503,823
02572003,COMPUTER CAREER CENTER - LAS CRUCES CAMP,NM,88011-8220,Proprietary  ,25,81,106,168,687,855
02622000,SOUTHWEST ACUPUNCTURE COLLEGE           ,NM,87505-0000,Proprietary  ,1,42,43,6,319,325
03076100,SOUTHWESTERN COLLEGE                    ,NM,87507-0000,Private      ,1,21,22,19,228,247
03206300,MESALANDS COMMUNITY COLLEGE             ,NM,88401-3352,Public       ,9,16,25,171,269,440
03430300,UNIVERSAL THERAPEUTIC MASSAGE INSTITUTE ,NM,87107-4403,Proprietary  ,3,29,32,34,154,188
03678300,PIMA MEDICAL INSTITUTE                  ,NM,87110-0000,Proprietary  ,7,43,50,128,311,439
03944300,MASSAGE THERAPY TRAINING INSTITUTE      ,NM,88007-0000,Proprietary  ,5,19,24,44,90,134
04162400,URBAN ACADEMY                           ,NM,87106-4404,Proprietary  ,8,22,30,78,167,245
04174500,AVEDA INSTITUTE OF NEW MEXICO (THE)     ,NM,87110-3640,Proprietary  ,9,42,51,70,220,290
00223400,ADRIAN COLLEGE                          ,MI,49221-2575,Private      ,29,40,69,2654,386,3040
00223500,ALBION COLLEGE                          ,MI,49224-1831,Private      ,35,16,51,2295,155,2450
00223600,ALMA COLLEGE                            ,MI,48801-1599,Private      ,29,20,49,2322,222,2544
00223700,ALPENA COMMUNITY COLLEGE                ,MI,49707-1495,Public       ,66,156,222,1093,1372,2465
00223800,ANDREWS UNIVERSITY                      ,MI,49104-0750,Private      ,40,91,131,2082,1497,3579
00223900,AQUINAS COLLEGE                         ,MI,49506-1799,Private      ,31,78,109,2550,920,3470
00224000,BAY DE NOC COMMUNITY COLLEGE            ,MI,49829-2524,Public       ,71,224,295,1386,1891,3277
00224100,CALVIN COLLEGE                          ,MI,49546-4388,Private      ,47,49,96,4303,529,4832
00224200,CALVIN THEOLOGICAL SEMINARY             ,MI,49546-4387,Private      ,0,5,5,13,181,194
00224300,CENTRAL MICHIGAN UNIVERSITY             ,MI,48859-0001,Public       ,412,838,1250,24541,11504,36045
00224600,CLEARY UNIVERSITY                       ,MI,48105-2659,Private      ,12,77,89,151,882,1033
00224700,CONCORDIA UNIVERSITY-ANN ARBOR          ,MI,48105-2797,Private      ,17,27,44,796,357,1153
00224800,CRANBROOK ACADEMY OF ART                ,MI,48303-0000,Private      ,3,17,20,31,345,376
00224900,DAVENPORT UNIVERSITY                    ,MI,49503-0000,Private      ,174,1327,1501,3479,14742,18221
00225100,DELTA COLLEGE                           ,MI,48710-0001,Public       ,438,1140,1578,6822,10023,16845
00225400,MICHIGAN STATE UNIVERSITY COLLEGE OF LAW,MI,48824-1300,Private      ,23,36,59,633,2281,2914
00225900,EASTERN MICHIGAN UNIVERSITY             ,MI,48197-2214,Public       ,449,1059,1508,17461,16170,33631
00226000,FERRIS STATE UNIVERSITY                 ,MI,49307-2251,Public       ,306,425,731,14325,8332,22657
00226100,CHARLES STEWART MOTT COMMUNITY CLG      ,MI,48503-2089,Public       ,508,1591,2099,6383,12866,19249
00226200,KETTERING UNIVERSITY                    ,MI,48504-4898,Private      ,46,46,92,2084,467,2551
00226300,GLEN OAKS COMMUNITY COLLEGE             ,MI,49032-9784,Public       ,26,178,204,712,1264,1976
00226400,GOGEBIC COMMUNITY COLLEGE               ,MI,49938-1365,Public       ,29,81,110,735,721,1456
00226500,GRACE BIBLE COLLEGE                     ,MI,49509-1998,Private      ,5,26,31,354,208,562
00226600,CORNERSTONE UNIVERSITY                  ,MI,49525-5897,Private      ,34,236,270,1978,2108,4086
00226700,GRAND RAPIDS COMMUNITY COLLEGE          ,MI,49503-3295,Public       ,685,1812,2497,11917,14683,26600
00226800,GRAND VALLEY STATE UNIVERSITY           ,MI,49401-9403,Public       ,351,567,918,24585,9365,33950
00226900,GREAT LAKES CHRISTIAN COLLEGE           ,MI,48917-1299,Private      ,11,18,29,228,179,407
00227000,HENRY FORD COMMUNITY COLLEGE            ,MI,48128-1495,Public       ,879,2433,3312,11233,19480,30713
00227300,HOPE COLLEGE                            ,MI,49423-3607,Private      ,48,22,70,4411,279,4690
00227400,JACKSON COMMUNITY COLLEGE               ,MI,49201-8399,Public       ,174,691,865,3960,6937,10897
00227500,KALAMAZOO COLLEGE                       ,MI,49006-3295,Private      ,22,18,40,2047,246,2293
00227600,KELLOGG COMMUNITY COLLEGE               ,MI,49017-3397,Public       ,182,814,996,2868,6542,9410
00227700,LAKE MICHIGAN COLLEGE                   ,MI,49022-1899,Public       ,90,480,570,1891,4042,5933
00227800,LANSING COMMUNITY COLLEGE               ,MI,48933-1293,Public       ,685,1876,2561,10531,16376,26907
00227900,LAWRENCE TECHNOLOGICAL UNIVERSITY       ,MI,48075-1058,Private      ,52,132,184,1813,1769,3582
00228200,MADONNA UNIVERSITY                      ,MI,48150-1173,Private      ,49,250,299,1830,3760,5590
00228400,MARYGROVE COLLEGE                       ,MI,48221-2599,Private      ,44,374,418,978,3523,4501
00228800,ROCHESTER COLLEGE                       ,MI,48307-2764,Private      ,27,76,103,774,915,1689
00229000,MICHIGAN STATE UNIVERSITY               ,MI,48824-1113,Public       ,665,697,1362,38367,15014,53381
00229200,MICHIGAN TECHNOLOGICAL UNIV             ,MI,49931-1295,Public       ,76,63,139,5970,1178,7148
00229300,LAKE SUPERIOR STATE UNIVERSITY          ,MI,49783-1691,Public       ,54,86,140,2750,1155,3905
00229400,MONROE COUNTY COMMUNITY CLG             ,MI,48161-9746,Public       ,163,389,552,1881,2926,4807
00229500,MONTCALM COMMUNITY COLLEGE              ,MI,48885-9723,Public       ,41,231,272,1056,1896,2952
00229700,MUSKEGON COMMUNITY COLLEGE              ,MI,49442-1432,Public       ,200,564,764,3190,4236,7426
00229900,NORTH CENTRAL MICHIGAN COLLEGE          ,MI,49770-8740,Public       ,76,248,324,1249,1965,3214
00230100,NORTHERN MICHIGAN UNIVERSITY            ,MI,49855-5316,Public       ,193,248,441,8279,3469,11748
00230200,NORTHWESTERN MICHIGAN COLLEGE           ,MI,49686-3061,Public       ,143,402,545,2793,3817,6610
00230301,OAKLAND COMMUNITY COLLEGE - ORCHARD RIDG,MI,48334-4579,Public       ,254,588,842,3492,5297,8789
00230302,OAKLAND COMMUNITY COLLEGE - ROYAL OAK CA,MI,48067-3898,Public       ,335,948,1283,4175,7573,11748
00230303,OAKLAND COMMUNITY COLLEGE - SOUTHFIELD C,MI,48075-4793,Public       ,290,939,1229,3202,7847,11049
00230304,OAKLAND COMMUNITY COLLEGE - AUBURN HILLS,MI,48323-2845,Public       ,287,813,1100,4346,6960,11306
00230305,OAKLAND COMMUNITY COLLEGE - HIGHLAND LAK,MI,48327-4187,Public       ,178,416,594,2507,4115,6622
00230700,OAKLAND UNIVERSITY                      ,MI,48309-4401,Public       ,396,798,1194,14834,10949,25783
00230800,OLIVET COLLEGE                          ,MI,49076-9902,Private      ,17,25,42,1515,338,1853
00231000,ST. CLAIR COUNTY COMMUNITY COLLEGE      ,MI,48061-0000,Public       ,150,366,516,2413,3497,5910
00231100,KUYPER COLLEGE                          ,MI,49525-9749,Private      ,5,12,17,387,178,565
00231300,SACRED HEART MAJOR SEMINARY             ,MI,48206-1799,Private      ,0,10,10,37,165,202
00231400,SAGINAW VALLEY STATE UNIV               ,MI,48710-0001,Public       ,176,323,499,10052,4734,14786
00231500,SCHOOLCRAFT COLLEGE                     ,MI,48152-2696,Public       ,432,1064,1496,6519,10009,16528
00231600,SIENA HEIGHTS UNIVERSITY                ,MI,49221-1796,Private      ,26,177,203,1675,2215,3890
00231700,SOUTHWESTERN MICHIGAN COLLEGE           ,MI,49047-9793,Public       ,92,329,421,1970,2802,4772
00231800,SPRING ARBOR UNIVERSITY                 ,MI,49283-9984,Private      ,46,271,317,2638,3638,6276
00232200,FINLANDIA UNIVERSITY                    ,MI,49930-1882,Private      ,14,25,39,664,341,1005
00232300,UNIVERSITY OF DETROIT MERCY             ,MI,48221-3038,Private      ,84,302,386,3423,4101,7524
00232303,UNIV OF DETROIT MERCY - LAW SCHOOL      ,MI,48226-0000,Private      ,2,24,26,22,767,789
00232330,UNIV OF DETROIT MERCY - DENTAL SCHOOL   ,MI,48208-2576,Private      ,4,19,23,85,436,521
00232500,UNIVERSITY OF MICHIGAN - ANN ARBOR      ,MI,48109-1316,Public       ,564,479,1043,32417,13675,46092
00232501,UNIVERSITY OF MICHIGAN-MEDICAL SCH      ,MI,48109-0000,Public       ,18,22,40,249,1119,1368
00232503,UNIVERSITY OF MICHIGAN LAW SCHOOL       ,MI,48109-0000,Public       ,5,33,38,94,2849,2943
00232600,UNIVERSITY OF MICHIGAN-DEARBORN         ,MI,48128-2406,Public       ,197,435,632,6454,5964,12418
00232700,UNIVERSITY OF MICHIGAN-FLINT            ,MI,48502-1950,Public       ,146,459,605,5014,6876,11890
00232800,WASHTENAW COMMUNITY COLLEGE             ,MI,48106-0000,Public       ,401,1114,1515,5557,9165,14722
00232900,WAYNE STATE UNIVERSITY                  ,MI,48202-0000,Public       ,584,1564,2148,19145,24042,43187
00232901,WAYNE STATE UNIV SCH OF MEDICINE        ,MI,48201-3359,Public       ,14,59,73,439,1653,2092
00232902,WAYNE STATE UNIVERSITY - LAW SCHOOL     ,MI,48202-3424,Public       ,7,42,49,164,1346,1510
00233000,WESTERN MICHIGAN UNIVERSITY             ,MI,49008-3899,Public       ,477,612,1089,21664,11150,32814
00233100,WESTERN THEOLOGICAL SEMINARY            ,MI,49423-0000,Private      ,1,6,7,9,164,173
00407100,WALSH COLLEGE OF ACCT & BUS ADMN        ,MI,48007-7006,Private      ,19,334,353,349,2832,3181
00407200,NORTHWOOD UNIVERSITY                    ,MI,48640-2398,Private      ,33,120,153,2064,2012,4076
00467300,BAKER COLLEGE - FLINT                   ,MI,48507-5508,Private      ,161,700,861,3059,8663,11722
00467301,BAKER COLLEGE OF CADILLAC               ,MI,49601-0000,Private      ,49,267,316,589,2245,2834
00467302,BAKER COLLEGE OF CLINTON TOWNSHIP       ,MI,48035-0000,Private      ,150,552,702,2233,6391,8624
00467303,BAKER COLLEGE OF MUSKEGON               ,MI,49442-0000,Private      ,115,511,626,2827,5333,8160
00467304,BAKER COLLEGE OF OWOSSO                 ,MI,48867-0000,Private      ,84,250,334,1848,2808,4656
00467305,BAKER COLLEGE OF AUBURN HILLS           ,MI,48326-0000,Private      ,87,414,501,1201,4440,5641
00467306,BAKER COLLEGE OF PORT HURON             ,MI,48060-0000,Private      ,42,133,175,629,1657,2286
00467309,BAKER COLLEGE OF JACKSON                ,MI,49202-0000,Private      ,66,301,367,991,3413,4404
00467311,BAKER COLLEGE-CASS CITY                 ,MI,48726-0000,Private      ,9,58,67,225,563,788
00467313,BAKER COLLEGE - GRADUATE ON-LINE        ,MI,48507-0000,Private      ,45,628,673,467,7049,7516
00467317,BAKER COLLEGE-ALLEN PARK                ,MI,48101-0000,Private      ,130,490,620,1323,4969,6292
00469200,DORSEY SCHOOL OF BUSINESS               ,MI,48195-2334,Proprietary  ,15,55,70,105,422,527
00469201,DORSEY SCHOOL OF BUSINESS               ,MI,48184-0000,Proprietary  ,15,80,95,73,389,462
00469202,DORSEY SCHOOL OF BUSINESS               ,MI,48071-0000,Proprietary  ,18,79,97,83,370,453
00469204,DORSEY SCHOOL OF BUSINESS               ,MI,48066-0000,Proprietary  ,22,82,104,146,588,734
00469205,DORSEY BUSINESS SCHOOL - FARMINGTON HILL,MI,48334-3385,Proprietary  ,12,39,51,46,256,302
00469206,DORSEY BUSINESS SCHOOL - ROSEVILLE CULIN,MI,48066-4555,Proprietary  ,14,75,89,106,477,583
00469207,DORSEY BUSINESS SCHOOL - WATERFORD/PONTI,MI,48341-1037,Proprietary  ,22,92,114,111,462,573
00469208,DORSEY BUSINESS SCHOOL - SAGINAW CAMPUS ,MI,48603-5201,Proprietary  ,24,98,122,108,442,550
00491003,KAPLAN CAREER INSTITUTE - DEARBORN      ,MI,48228-0000,Proprietary  ,17,133,150,126,802,928
00676800,MID MICHIGAN COMMUNITY COLLEGE          ,MI,48625-9447,Public       ,183,458,641,2778,3705,6483
00677100,COLLEGE FOR CREATIVE STUDIES            ,MI,48202-4034,Private      ,73,87,160,1691,863,2554
00694900,KALAMAZOO VALLEY COMMUNITY COLLEGE      ,MI,49003-4070,Public       ,412,1219,1631,6007,9214,15221
00717100,KIRTLAND COMMUNITY COLLEGE              ,MI,48653-0000,Public       ,65,239,304,1018,1893,2911
00732991,ITT TECHNICAL INSTITUTE                 ,MI,49519-1851,Proprietary  ,133,442,575,966,3338,4304
00761700,CARNEGIE INSTITUTE                      ,MI,48083-1159,Proprietary  ,7,40,47,104,442,546
00795000,WEST SHORE COMMUNITY COLLEGE            ,MI,49454-0000,Public       ,52,143,195,660,1109,1769
00817800,EMPIRE BEAUTY SCHOOL                    ,MI,49525-2440,Proprietary  ,18,56,74,220,534,754
00832903,ITT TECHNICAL INSTITUTE                 ,MI,48083-2008,Proprietary  ,0,1,1,0,2,2
00890600,MACOMB COMMUNITY COLLEGE                ,MI,48088-3896,Public       ,937,2129,3066,12829,17262,30091
00894600,PORT HURON COSMETOLOGY COLLEGE          ,MI,48329-1618,Proprietary  ,4,8,12,17,53,70
00923000,WAYNE COUNTY COMMUNITY CLG-DISTRICT     ,MI,48226-3010,Public       ,947,3396,4343,10163,31458,41621
00973200,VIRGINIA FARRELL BEAUTY SCHOOL          ,MI,48080-1448,Proprietary  ,0,0,0,29,63,92
00973400,VIRGINIA FARRELL BEAUTY SCHOOL          ,MI,48220-1739,Proprietary  ,0,0,0,11,55,66
00982800,EVEREST INSTITUTE                       ,MI,48033-4400,Proprietary  ,40,258,298,272,1522,1794
00982801,EVEREST INSTITUTE- DEARBORN             ,MI,48124-1927,Proprietary  ,23,183,206,211,1038,1249
00982803,EVEREST INSTITUTE - DETROIT             ,MI,48207-4291,Proprietary  ,46,206,252,236,1084,1320
01047000,KALAMAZOO BEAUTY ACADEMY                ,MI,49002-5220,Proprietary  ,4,12,16,25,62,87
01082700,DAVID PRESSLEY PROF SCH OF COSMTLGY     ,MI,48067-3219,Proprietary  ,24,38,62,151,254,405
01109800,FLINT INSTITUTE OF BARBERING            ,MI,48504-4395,Proprietary  ,9,16,25,39,141,180
01164600,VIRGINIA FARRELL BEAUTY SCHOOL          ,MI,48185-3091,Proprietary  ,0,0,0,31,104,135
01229100,WRIGHT BEAUTY ACADEMY                   ,MI,49015-2696,Proprietary  ,3,20,23,34,86,120
01262700,THOMAS M. COOLEY LAW SCHOOL             ,MI,48901-1586,Private      ,1,165,166,22,5016,5038
01321800,M J MURPHY BTY CLG MT PLEASANT          ,MI,48858-2502,Proprietary  ,10,19,29,75,95,170
02060300,MICHIGAN INSTITUTE OF AERONAUTICS       ,MI,48188-2533,Proprietary  ,39,105,144,449,793,1242
02068700,FISER'S COLLEGE OF COSMETOLOGY          ,MI,49221-0000,Proprietary  ,1,5,6,14,53,67
02099700,ROSS MEDICAL EDUCATION CENTER           ,MI,48532-0000,Proprietary  ,49,249,298,291,1327,1618
02099701,ROSS MEDICAL EDUCATION CENTER-SAGINAW   ,MI,48603-5227,Proprietary  ,2,21,23,29,130,159
02099702,ROSS MEDICAL EDUCATION CENTER-PORT HURON,MI,48060-1958,Proprietary  ,4,11,15,13,87,100
02099703,ROSS MEDICAL EDUCATION CENTER-ROOSEVELT ,MI,49441-4156,Proprietary  ,0,5,5,5,28,33
02100400,EVEREST INSTITUTE                       ,MI,49525-2301,Proprietary  ,29,166,195,230,1080,1310
02100401,EVEREST INSTITUTE - KALAMAZOO           ,MI,49009-3307,Proprietary  ,22,133,155,184,767,951
02125600,MICHIGAN COLLEGE OF BEAUTY              ,MI,48083-0000,Proprietary  ,22,67,89,142,373,515
02152103,ACADEMY OF COURT REPORTING & TECHNOLOGY ,MI,48017-1495,Proprietary  ,1,9,10,16,144,160
02158600,MR BELA'S SCHOOL OF COSMETOLOGY         ,MI,48092-4637,Proprietary  ,15,38,53,39,125,164
02160303,INTERNATIONAL ACADEMY OF DESIGN AND TECH,MI,48083-2160,Proprietary  ,32,60,92,638,895,1533
02180100,ROSS MEDICAL EDUCATION CENTER           ,MI,48092-0000,Proprietary  ,21,122,143,161,722,883
02180105,ROSS MEDICAL EDUCATION CENTER-REDFORD   ,MI,48239-1260,Proprietary  ,2,10,12,16,102,118
02198900,MICHIGAN SCHOOL OF PROFESSIONAL PSYCHOLO,MI,48334-4512,Private      ,0,10,10,6,212,218
02209200,TAYLORTOWN SCHOOL OF BEAUTY             ,MI,48180-0000,Proprietary  ,2,35,37,16,101,117
02237800,SPECS HOWARD SCHOOL OF MEDIA ARTS       ,MI,48075-0000,Proprietary  ,55,118,173,601,826,1427
02285700,BAYSHIRE BEAUTY ACADEMY                 ,MI,48708-5614,Proprietary  ,5,22,27,41,163,204
02289801,KAPLAN INSTITUTE - DETROIT CAMPUS       ,MI,48202-0000,Proprietary  ,11,138,149,165,849,1014
02324500,MICHIGAN COLLEGE OF BEAUTY              ,MI,48161-3901,Proprietary  ,9,40,49,83,215,298
02339700,ROSS MEDICAL EDUCATION CENTER           ,MI,48116-0000,Proprietary  ,30,221,251,191,843,1034
02339701,ROSS MEDICAL EDUCATION CENTER-ANN ARBOR ,MI,48108-1411,Proprietary  ,4,9,13,21,98,119
02339703,ROSS MEDICAL EDUCATION CENTER - DAVISON ,MI,48423-1751,Proprietary  ,0,4,4,17,43,60
02361500,MICHIGAN BARBER COLLEGE                 ,MI,48204-2244,Private      ,25,95,120,121,454,575
02363800,YESHIVA GEDOLAH OF GREATER DETROIT      ,MI,48237-0000,Private      ,13,0,13,21,3,24
02491000,WEST MI COLG OF BARBERING & BEAUTY      ,MI,49008-0000,Proprietary  ,1,19,20,25,105,130
02498300,VIRGINIA FARRELL BEAUTY SCHOOL          ,MI,48154-0000,Proprietary  ,0,0,0,33,94,127
02533600,ROSS MEDICAL EDUCATION CENTER           ,MI,48917-2108,Proprietary  ,24,132,156,156,846,1002
02533601,ROSS MEDICAL EDUCATION CENTER - GRAND RA,MI,49546-2430,Proprietary  ,4,31,35,44,189,233
02588200,DOUGLAS J AVEDA INSTITUTE               ,MI,48823-4351,Proprietary  ,80,145,225,629,816,1445
02588201,DOUGLAS J AVEDA INSTITUTE - ANN ARBOR   ,MI,48104-2211,Proprietary  ,9,17,26,101,159,260
02595700,HILLSDALE BEAUTY COLLEGE                ,MI,49242-0000,Proprietary  ,4,9,13,45,49,94
02618400,MICHIGAN CAREER & TECHNICAL INST        ,MI,49080-9254,Public       ,41,20,61,273,133,406
03005700,DETROIT BUSINESS INST. DOWNRIVER        ,MI,48193-6761,Proprietary  ,3,27,30,31,208,239
03028500,LAWTON SCHOOL                           ,MI,48075-0000,Proprietary  ,4,45,49,43,242,285
03066600,BAY MILLS COMMUNITY COLLEGE             ,MI,49715-9750,Public       ,18,55,73,192,544,736
03075200,TWIN CITY BEAUTY COLLEGE                ,MI,49085-3305,Proprietary  ,10,38,48,72,245,317
03075201,TWIN CITY BEAUTY COLLEGE - TRAVERSE CITY,MI,49686-5119,Proprietary  ,0,4,4,11,47,58
03090000,SHARP'S ACADEMY OF HAIRSTYLING INC.     ,MI,48433-0000,Proprietary  ,1,3,4,13,55,68
03109700,HOUGHTON LAKE INST OF COSMETOLOGY       ,MI,48629-0669,Proprietary  ,4,4,8,10,24,34
03110300,THE SCHOOL OF CREATIVE HAIR DESIGN      ,MI,49036-1139,Proprietary  ,5,11,16,20,51,71
03124000,NORTHWESTERN TECHNOLOGICAL INST         ,MI,48075-2412,Proprietary  ,10,94,104,90,455,545
03284300,MICHIGAN JEWISH INSTITUTE               ,MI,48237-0000,Private      ,461,312,773,1647,815,2462
03490300,PAUL MITCHELL THE SCHOOL ESCANABA       ,MI,49829-0000,Proprietary  ,23,39,62,296,391,687
03588300,IRENE'S MYOMASSOLOGY INSTITUTE          ,MI,48033-2404,Proprietary  ,8,58,66,82,409,491
03704300,BLUE WATER COLLEGE OF COSMETOLOGY       ,MI,48040-0000,Proprietary  ,5,11,16,36,85,121
03772300,SAGINAW CHIPPEWA TRIBAL COLLEGE         ,MI,48858-0000,Public       ,3,7,10,23,68,91
03815300,IN SESSION-ARTS OF COSMETOLOGY BEAU     ,MI,48609-0000,Proprietary  ,3,22,25,39,150,189
03907300,PAUL MITCHELL THE SCHOOL GREAT LAKES    ,MI,48060-0000,Proprietary  ,20,36,56,100,153,253
03915300,CAREER QUEST LEARNING CENTER            ,MI,48910-4732,Proprietary  ,27,240,267,172,1209,1381
03968300,LAKEWOOD SCHOOL OF THERAPEUTIC MASSAGE  ,MI,48060-0000,Proprietary  ,3,9,12,22,72,94
03976500,ANN ARBOR INSTITUTE OF MASSAGE THERAPY  ,MI,48103-0000,Proprietary  ,5,26,31,39,156,195
04002400,ECUMENICAL THEOLOGICAL SEMINARY         ,MI,48201-3035,Private      ,0,10,10,0,144,144
04006300,NUVO COLLEGE OF COSMETOLOGY             ,MI,49441-3822,Proprietary  ,6,20,26,38,104,142
04014300,P&A SCHOLARS BEAUTY SCHOOL              ,MI,48204-0000,Proprietary  ,21,71,92,148,431,579
04094300,ROBERT B. MILLER COLLEGE (THE)          ,MI,49017-3306,Private      ,3,35,38,85,454,539
04121100,GALLERY COLLEGE OF BEAUTY (THE)         ,MI,48036-3591,Proprietary  ,11,55,66,99,365,464
04136300,FOCUS:  HOPE INFORMATION TECHNOLOGIES CE,MI,48238-2949,Private      ,12,61,73,42,186,228
04138400,SCHOOL OF DESIGNING ARTS                ,MI,49015-2853,Proprietary  ,3,17,20,44,83,127
04140900,INTERNATIONAL COSMETOLOGY ACADEMY       ,MI,49508-1308,Proprietary  ,4,32,36,46,163,209
04141100,FRENCH ACADEMY OF COSMETOLOGY           ,MI,49456-3207,Proprietary  ,6,14,20,39,86,125
04158400,L'ESPRIT ACADEMY                        ,MI,48150-0000,Proprietary  ,10,16,26,67,133,200
04159300,MARKETTI ACADEMY OF COSMETOLOGY         ,MI,48329-3506,Proprietary  ,5,27,32,47,133,180
04163300,COMPASS FILM ACADEMY                    ,MI,49504-5296,Private      ,1,5,6,81,82,163
04164700,KEWEENAW BAY OJIBWA COMMUNITY COLLEGE   ,MI,49908-0000,Public       ,3,11,14,15,66,81
04169300,SCHOLARS COSMETOLOGY UNIVERSITY         ,MI,48108-0000,Proprietary  ,3,13,16,24,76,100
04183300,ABCOTT INSTITUTE                        ,MI,48075-5227,Proprietary  ,4,37,41,27,205,232
04184700,PROTEGE ACADEMY                         ,MI,48823-8660,Proprietary  ,6,17,23,36,93,129
00233200,ANOKA-RAMSEY CC-CAMBRIDGE/COONRAPID     ,MN,55433-3499,Public       ,303,625,928,3687,5298,8985
00233400,AUGSBURG COLLEGE                        ,MN,55454-1351,Private      ,51,178,229,3096,2376,5472
00233500,RIVERLAND COMMUNITY COLLEGE             ,MN,55912-1473,Public       ,76,279,355,1116,2076,3192
00233600,BEMIDJI STATE UNIVERSITY                ,MN,56601-2699,Public       ,74,169,243,3683,2250,5933
00233700,BETHANY LUTHERAN COLLEGE INC            ,MN,56001-6163,Private      ,11,8,19,701,85,786
00233900,CENTRAL LAKES COLG-BRAINERD/STAPLES     ,MN,56401-3900,Public       ,107,271,378,1554,2392,3946
00234000,CARLETON COLLEGE                        ,MN,55057-4001,Private      ,36,4,40,3094,64,3158
00234100,COLLEGE OF ST BENEDICT                  ,MN,56374-2099,Private      ,24,6,30,2173,85,2258
00234200,ST. CATHERINE UNIVERSITY                ,MN,55105-1789,Private      ,49,215,264,2695,3577,6272
00234300,COLLEGE OF ST SCHOLASTICA               ,MN,55811-4199,Private      ,46,207,253,2452,2091,4543
00234500,UNIVERSITY OF ST THOMAS                 ,MN,55105-1096,Private      ,100,252,352,6660,3966,10626
00234600,CONCORDIA COLLEGE-MOORHEAD              ,MN,56562-0001,Private      ,38,18,56,3263,240,3503
00234700,"CONCORDIA UNIVERSITY, ST PAUL, MN       ",MN,55104-5494,Private      ,29,313,342,1316,2322,3638
00235000,VERMILION COMMUNITY COLLEGE             ,MN,55731-1996,Public       ,13,9,22,551,206,757
00235300,GUSTAVUS ADOLPHUS COLLEGE               ,MN,56082-1498,Private      ,38,5,43,3629,128,3757
00235400,HAMLINE UNIVERSITY                      ,MN,55104-1284,Private      ,42,240,282,2899,3317,6216
00235500,HIBBING COMMUNITY COLLEGE               ,MN,55746-3300,Public       ,35,90,125,698,1048,1746
00235600,ITASCA COMMUNITY COLLEGE                ,MN,55744-3397,Public       ,19,70,89,782,696,1478
00235700,LUTHER SEMINARY                         ,MN,55108-0000,Private      ,0,12,12,2,444,446
00235800,MACALESTER COLLEGE                      ,MN,55105-1899,Private      ,39,14,53,3633,149,3782
00236000,"MINNESOTA STATE UNIVERSITY, MANKATO     ",MN,56002-0000,Public       ,215,369,584,11832,4797,16629
00236100,MARTIN LUTHER COLLEGE                   ,MN,56073-3965,Private      ,5,6,11,659,68,727
00236200,MINNEAPOLIS COMM AND TECH COLLEGE       ,MN,55403-1779,Public       ,453,1613,2066,4305,11450,15755
00236500,MINNEAPOLIS COLLEGE OF ART & DESIGN     ,MN,55404-4343,Private      ,31,42,73,903,489,1392
00236600,CROSSROADS COLLEGE                      ,MN,55902-2382,Private      ,1,13,14,92,104,196
00236700,MINNESOTA STATE UNIVERSITY MOORHEAD     ,MN,56563-0001,Public       ,114,194,308,5321,2681,8002
00236900,NORTH CENTRAL UNIVERSITY                ,MN,55404-1391,Private      ,33,45,78,1373,438,1811
00237000,NORTH HENNEPIN COMMUNITY COLLEGE        ,MN,55445-2299,Public       ,245,702,947,3055,5734,8789
00237100,NORTHWESTERN COLLEGE                    ,MN,55113-1598,Private      ,42,107,149,2206,926,3132
00237300,ROCHESTER COMMUNITY/TECH COLLEGE        ,MN,55904-4999,Public       ,155,501,656,2806,3859,6665
00237500,SOUTHWEST MINNESOTA STATE UNIVERSITY    ,MN,56258-1598,Public       ,32,72,104,2095,1108,3203
00237700,ST CLOUD STATE UNIVERSITY               ,MN,56301-4498,Public       ,244,453,697,10330,5521,15851
00237900,SAINT JOHNS UNIVERSITY                  ,MN,56321-0000,Private      ,21,8,29,2063,116,2179
00238000,SAINT MARY'S UNIVERSITY                 ,MN,55987-1399,Private      ,25,347,372,1801,3250,5051
00238200,ST OLAF COLLEGE                         ,MN,55057-1098,Private      ,49,5,54,3962,103,4065
00238300,CROWN COLLEGE                           ,MN,55375-9001,Private      ,17,69,86,799,705,1504
00238500,NORTHLAND COMMUNITY & TECHNICAL CLG     ,MN,56701-2598,Public       ,89,234,323,1490,2248,3738
00238600,UNITED THEOLGCL SEMINRY TWIN CITIES     ,MN,55112-0000,Private      ,0,6,6,6,132,138
00238800,"UNIVERSITY OF MINNESOTA, DULUTH         ",MN,55812-2496,Public       ,222,144,366,10605,2385,12990
00238900,"UNIVERSITY OF MINNESOTA, MORRIS         ",MN,56267-2113,Public       ,35,15,50,2173,317,2490
00239100,WILLIAM MITCHELL COLLEGE OF LAW         ,MN,55105-0000,Private      ,1,13,14,3,1303,1306
00239300,MINNESOTA STATE COLLEGE-SE TECH         ,MN,55987-0409,Public       ,50,218,268,973,1755,2728
00239400,WINONA STATE UNIVERSITY                 ,MN,55987-5838,Public       ,127,93,220,7488,1630,9118
00396900,UNIVERSITY OF MINNESOTA-TWIN CITIES     ,MN,55455-0422,Public       ,577,1020,1597,32386,19541,51927
00400900,MESABI RANGE CMNTY & TECH COLLEGE       ,MN,55792-0000,Public       ,27,68,95,574,713,1287
00405708,NATIONAL AMERICAN UNIVERSITY            ,MN,55113-0000,Proprietary  ,4,34,38,37,298,335
00405715,NATIONAL AMERICAN UNIVERSITY - BLOOMINGT,MN,55425-5550,Proprietary  ,3,35,38,35,343,378
00406900,UNIVERSITY OF MINNESOTA-CROOKSTON       ,MN,56716-5001,Public       ,14,84,98,1179,707,1886
00438600,VETERAN'S MEDICAL CTR- SCH RAD TECH     ,MN,55417-2399,Public       ,0,4,4,4,19,23
00464100,DUNWOODY COLLEGE OF TECHNOLOGY          ,MN,55403-1192,Private      ,52,186,238,720,1384,2104
00464200,GLOBE UNIVERSITY                        ,MN,55125-5408,Proprietary  ,134,525,659,1501,5268,6769
00464500,MINNEAPOLIS BUSINESS COLLEGE            ,MN,55113-4036,Proprietary  ,6,13,19,428,189,617
00464600,MINNESOTA SCHOOL OF BUSINESS            ,MN,55423-0000,Proprietary  ,109,420,529,1776,6246,8022
00525200,RIDGEWATER COLLEGE                      ,MN,56201-2098,Public       ,104,301,405,1994,2205,4199
00526300,MINNESOTA WEST CMNTY & TECH COLG        ,MN,56241-1096,Public       ,39,182,221,878,1712,2590
00553300,"SAINT PAUL COLLEGE, COMMUNITY/TECHNICAL ",MN,55102-1800,Public       ,295,1227,1522,2808,7771,10579
00553400,SAINT CLOUD TECHNICAL COLLEGE AND COMMUN,MN,56303-1240,Public       ,219,396,615,2811,3194,6005
00553500,PINE TECHNICAL COLLEGE                  ,MN,55063-2198,Public       ,25,120,145,263,896,1159
00553700,SOUTH CENTRAL COLLEGE                   ,MN,56003-0000,Public       ,117,298,415,1734,2353,4087
00554100,MINNESOTA STATE COMMUNITY AND TECHNICAL ,MN,56573-1405,Public       ,170,422,592,2540,4166,6706
00554400,ALEXANDRIA TECHNICAL COLLEGE            ,MN,56308-3799,Public       ,48,128,176,1305,1116,2421
00575700,LAKE SUPERIOR COLLEGE                   ,MN,55811-3399,Public       ,138,384,522,2039,3211,5250
00575900,NORTHWEST TECHNICAL COLLEGE - BEMIDJI   ,MN,56601-4907,Public       ,33,122,155,442,1114,1556
00677500,RAINY RIVER COMMUNITY COLLEGE           ,MN,56649-2187,Public       ,7,12,19,147,147,294
00735000,ANOKA-HENNEPIN TECHNICAL COLLEGE        ,MN,55303-1590,Public       ,82,344,426,854,2823,3677
00735100,BROWN COLLEGE                           ,MN,55120-1004,Proprietary  ,20,116,136,576,1204,1780
00746200,COLLEGE OF VISUAL ARTS                  ,MN,55102-2199,Private      ,10,14,24,255,90,345
00795400,NORMANDALE COMMUNITY COLLEGE            ,MN,55431-4399,Public       ,355,745,1100,4629,5928,10557
00826700,NORTHWEST TECHNICAL INSTITUTE           ,MN,55121-5001,Proprietary  ,2,9,11,80,66,146
00869400,RASMUSSEN COLLEGE - ST. CLOUD           ,MN,56301-3713,Proprietary  ,32,153,185,317,1592,1909
00869401,RASMUSSEN COLLEGE - BROOKLYN PARK       ,MN,55445-1512,Proprietary  ,23,150,173,281,1572,1853
00869406,RASMUSSEN COLLEGE - EAGAN               ,MN,55122-1346,Proprietary  ,30,145,175,265,1427,1692
00869407,RASMUSSEN COLLEGE - BLOOMINGTON         ,MN,55435-5444,Proprietary  ,46,445,491,441,4405,4846
00869409,RASMUSSEN COLLEGE - MANKATO             ,MN,56001-8658,Proprietary  ,25,136,161,304,1191,1495
00869412,RASMUSSEN COLLEGE - LAKE ELMO           ,MN,55042-8624,Proprietary  ,17,98,115,166,985,1151
00869416,RASMUSSEN COLLEGE - MOORHEAD            ,MN,56560-4513,Proprietary  ,22,95,117,225,987,1212
00869417,RASMUSSEN COLLEGE - BLAINE              ,MN,55014-0000,Proprietary  ,18,105,123,166,741,907
00905800,BETHEL UNIVERSITY                       ,MN,55112-6999,Private      ,45,221,266,3326,2439,5765
00960000,COSMETOLOGY CAREERS UNLTD-DULUTH        ,MN,55802-2031,Proprietary  ,4,18,22,24,57,81
00972200,EMPIRE BEAUTY SCHOOL                    ,MN,55119-7003,Proprietary  ,11,33,44,73,337,410
00974000,INVER HILLS COMMUNITY COLLEGE           ,MN,55076-3224,Public       ,201,503,704,2503,4041,6544
00983100,MODEL COLLEGE OF HAIR DESIGN            ,MN,56301-4280,Proprietary  ,7,23,30,129,126,255
00987000,EMPIRE BEAUTY SCHOOL                    ,MN,55420-2919,Proprietary  ,13,54,67,145,381,526
00989200,"DULUTH BUSINESS UNIV, INC.              ",MN,55807-0000,Proprietary  ,7,56,63,144,466,610
00999200,OAK HILLS CHRISTIAN COLLEGE             ,MN,56601-0000,Private      ,4,4,8,113,62,175
01024800,ART INSTITUTES INTL MINNESOTA           ,MN,55402-3137,Proprietary  ,153,202,355,1696,1566,3262
01035602,EVEREST INSTITUTE - EAGAN               ,MN,55121-1696,Proprietary  ,25,103,128,142,651,793
01037400,METROPOLITAN STATE UNIVERSITY           ,MN,55106-5000,Public       ,104,899,1003,1895,8432,10327
01040200,DAKOTA COUNTY TECHNICAL COLLEGE         ,MN,55068-2999,Public       ,89,368,457,1226,2550,3776
01049000,REGENCY BEAUTY INSTITUTE                ,MN,55428-0000,Proprietary  ,476,1243,1719,3659,8415,12074
01049100,HENNEPIN TECHNICAL COLLEGE              ,MN,55445-2399,Public       ,231,806,1037,2083,6166,8249
01054600,CENTURY COLLEGE                         ,MN,55110-1894,Public       ,447,1033,1480,5307,8203,13510
01173200,"MAYO CLINIC, COLLEGE OF MEDICINE        ",MN,55905-0000,Private      ,4,9,13,35,347,382
01173201,MAYO SCHOOL OF HEALTH-RELATED SCIEN     ,MN,55905-0000,Private      ,2,12,14,67,201,268
01173206,MAYO GRAD SCHOOL                        ,MN,55901-0000,Private      ,0,5,5,3,51,54
01173207,MAYO MEDICAL SCHOOL                     ,MN,55901-0000,Private      ,0,4,4,10,213,223
01232800,NORTHWESTERN HEALTH SCIENCES UNIV       ,MN,55431-1599,Private      ,4,53,57,77,893,970
02050300,ACADEMY COLLEGE                         ,MN,55420-1554,Proprietary  ,4,29,33,54,257,311
02097300,HASTINGS BEAUTY SCHOOL                  ,MN,55033-1205,Proprietary  ,3,8,11,36,40,76
02123200,AVEDA INSTITUTE                         ,MN,55414-0000,Proprietary  ,42,77,119,430,473,903
02159800,COSMETOLOGY CAREERS UNLTD - HIBBING     ,MN,55746-0000,Proprietary  ,2,4,6,14,38,52
02160901,"SALON PROFESSIONAL ACADEMY, THE - THE SA",MN,55428-4928,Proprietary  ,3,16,19,29,82,111
02238100,MINNESOTA SCHOOL OF COSMETOLOGY         ,MN,55125-0000,Proprietary  ,17,55,72,158,261,419
02260500,SUMMIT ACAD OPPORTUNITIES IND CTR       ,MN,55405-0000,Private      ,11,118,129,45,381,426
02263102,ANTHEM COLLEGE - ST. LOUIS PARK         ,MN,55416-2467,Proprietary  ,3,21,24,28,108,136
02504200,WALDEN UNIVERSITY                       ,MN,55401-2511,Proprietary  ,29,7861,7890,240,51343,51583
02514100,AMERICAN INDIAN OPPORTUNITIES CTR       ,MN,55404-0000,Private      ,5,34,39,17,208,225
03001200,MCNALLY SMITH COLLEGE OF MUSIC          ,MN,55101-2220,Proprietary  ,45,41,86,791,327,1118
03051900,ALFRED ADLER GRADUATE SCHOOL            ,MN,55305-0000,Private      ,0,62,62,2,323,325
03096400,LEECH LAKE TRIBAL COLLEGE               ,MN,56633-0000,Public       ,2,6,8,39,248,287
03129100,FOND DU LAC TRIBAL & COMMUNITY CLG      ,MN,55720-2984,Public       ,44,130,174,549,1079,1628
03267300,CAPELLA UNIVERSITY                      ,MN,55402-3389,Proprietary  ,34,4120,4154,196,50993,51189
03833300,AMERICAN ACADEMY OF ACUPUNCTURE AND ORIE,MN,55113-0000,Proprietary  ,0,16,16,4,107,111
03921400,WHITE EARTH TRIBAL AND COMMUNITY COLLEGE,MN,56557-0478,Private      ,3,24,27,23,148,171
04044300,HAZELDEN GRADUATE SCHOOL OF ADDICTION ST,MN,55012-0000,Private      ,0,25,25,4,165,169
04130200,INST. OF PRODUCTION AND RECORDING       ,MN,55401-1315,Proprietary  ,57,69,126,473,415,888
04148800,CENTERPOINT MASSAGE & SHIATSU THERAPY SC,MN,55414-4525,Proprietary  ,7,30,37,39,145,184
04157600,NOVA ACADEMY OF COSMETOLOGY             ,MN,55906-4103,Proprietary  ,5,19,24,38,113,151
04160000,ALLURE SCHOOL OF COSMETOLOGY            ,MN,55066-2086,Proprietary  ,3,4,7,21,41,62
04160500,AVALON SCHOOL OF COSMETOLOGY            ,MN,56187-1930,Proprietary  ,0,5,5,21,41,62
04174400,ROCHESTER SCHOOL OF HAIR DESIGN         ,MN,55901-4310,Proprietary  ,0,6,6,15,37,52
04175600,PARK AVENUE SCHOOL OF COSMETOLOGY       ,MN,56470-3361,Proprietary  ,2,3,5,6,27,33
00239600,ALCORN STATE UNIVERSITY                 ,MS,39096-7500,Public       ,91,267,358,4083,4238,8321
00239700,BELHAVEN UNIVERSITY                     ,MS,39202-1789,Private      ,40,413,453,1527,4216,5743
00239800,BLUE MOUNTAIN COLLEGE                   ,MS,38610-9370,Private      ,17,30,47,530,397,927
00240100,COAHOMA COMMUNITY COLLEGE               ,MS,38614-9799,Public       ,60,188,248,1783,3107,4890
00240200,COPIAH-LINCOLN COMMUNITY COLLEGE        ,MS,39191-0649,Public       ,105,291,396,2345,3049,5394
00240300,DELTA STATE UNIVERSITY                  ,MS,38733-0000,Public       ,61,250,311,3080,3443,6523
00240400,EAST CENTRAL COMMUNITY COLLEGE          ,MS,39327-0129,Public       ,90,282,372,1986,2611,4597
00240500,EAST MISSISSIPPI COMM COLLEGE           ,MS,39358-0000,Public       ,122,413,535,3009,4578,7587
00240700,HINDS COMMUNITY COLLEGE                 ,MS,39154-9799,Public       ,467,1420,1887,7951,13723,21674
00240800,HOLMES COMMUNITY COLLEGE                ,MS,39079-0000,Public       ,232,640,872,4132,6817,10949
00240900,ITAWAMBA COMMUNITY COLLEGE              ,MS,38843-1099,Public       ,153,559,712,4263,6529,10792
00241000,JACKSON STATE UNIVERSITY                ,MS,39217-0001,Public       ,233,745,978,8393,10787,19180
00241100,JONES COUNTY JUNIOR COLLEGE             ,MS,39437-3999,Public       ,167,325,492,3807,3374,7181
00241300,MERIDIAN COMMUNITY COLLEGE              ,MS,39307-5890,Public       ,94,382,476,2353,3428,5781
00241400,MILLSAPS COLLEGE                        ,MS,39201-0000,Private      ,32,65,97,1507,585,2092
00241500,MISSISSIPPI COLLEGE                     ,MS,39058-0001,Private      ,71,230,301,2805,3702,6507
00241501,MISSISSIPPI COLLEGE - SCHOOL OF LAW     ,MS,39201-1391,Private      ,4,21,25,75,982,1057
00241600,MISSISSIPPI DELTA CMTY COLLEGE          ,MS,38761-0000,Public       ,63,219,282,2221,2715,4936
00241700,MISSISSIPPI GULF CST CLG-PERKINSTON     ,MS,39573-0000,Public       ,101,186,287,2050,1382,3432
00241701,MISSISSIPPI GULF CST CLG-JEFF DAVIS     ,MS,39507-0000,Public       ,154,596,750,2073,4482,6555
00241702,MISSISSIPPI GULF CST CLG-JACKSON CN     ,MS,39553-0000,Public       ,143,411,554,1911,3113,5024
00242200,MISSISSIPPI UNIV FOR WOMEN              ,MS,39701-5818,Public       ,43,191,234,1712,2723,4435
00242300,MISSISSIPPI STATE UNIVERSITY            ,MS,39762-9698,Public       ,451,504,955,16254,8573,24827
00242400,MISSISSIPPI VALLEY STATE UNIVERSITY     ,MS,38941-1400,Public       ,68,208,276,2985,3342,6327
00242600,NORTHEAST MS CMNTY COLLEGE              ,MS,38829-1731,Public       ,109,296,405,2885,2837,5722
00242700,NORTHWEST MISSISSIPPI COMMUNITY CLG     ,MS,38668-1703,Public       ,246,620,866,5795,6135,11930
00243000,PEARL RIVER COMMUNITY COLLEGE           ,MS,39470-2201,Public       ,189,435,624,3382,4682,8064
00243300,RUST COLLEGE                            ,MS,38635-2328,Private      ,45,58,103,1141,710,1851
00243500,SOUTHEASTERN BAPTIST COLLEGE            ,MS,39440-0000,Private      ,4,4,8,27,85,112
00243600,SOUTHWEST MISSISSIPPI CMNTY CLG         ,MS,39666-8099,Public       ,98,225,323,1502,1799,3301
00243900,TOUGALOO COLLEGE                        ,MS,39174-9799,Private      ,31,57,88,1633,828,2461
00244000,UNIVERSITY OF MISSISSIPPI               ,MS,38677-1848,Public       ,382,392,774,14131,7872,22003
00244001,UNIVERSITY OF MISSISSIPPI - MED CTR     ,MS,39216-0000,Public       ,9,91,100,609,2212,2821
00244100,UNIVERSITY OF SOUTHERN MISSISSIPPI      ,MS,39406-0001,Public       ,355,704,1059,12036,10921,22957
00244700,WILLIAM CAREY UNIVERSITY                ,MS,39401-5499,Private      ,59,290,349,1524,4254,5778
00489809,MCCANN SCHOOL OF BUSINESS & TECHNOLOGY -,MS,39503-3167,Proprietary  ,1,13,14,1,17,18
01289101,ANTONELLI COLLEGE - JACKSON             ,MS,39232-9514,Proprietary  ,21,183,204,205,1371,1576
01289102,ANTONELLI COLLEGE - HATTIESBURG         ,MS,39401-3056,Proprietary  ,18,98,116,173,758,931
02074900,CHRIS' BEAUTY COLLEGE                   ,MS,39501-0000,Proprietary  ,8,22,30,50,142,192
02160500,NORTH MISSISSIPPI MED CTR MED TECH      ,MS,38801-0000,Private      ,1,22,23,37,152,189
02235900,ACADEMY OF HAIR DESIGN #4               ,MS,39208-0000,Proprietary  ,3,19,22,72,193,265
02244300,ACADEMY OF HAIR DESIGN #1               ,MS,38901-0000,Proprietary  ,17,31,48,96,294,390
02249900,DELTA BEAUTY COLLEGE                    ,MS,38701-0000,Proprietary  ,4,16,20,55,127,182
02251600,ACADEMY OF HAIR DESIGN #6               ,MS,39401-7581,Proprietary  ,14,32,46,115,282,397
02251700,FOSTER'S COSMETOLOGY COLLEGE            ,MS,38663-0000,Proprietary  ,1,7,8,11,27,38
02302800,MISSISSIPPI COLLEGE OF BEAUTY CULT      ,MS,39440-0000,Proprietary  ,6,23,29,36,113,149
02320800,MAGNOLIA COLLEGE OF COSMETOLOGY         ,MS,39206-0000,Proprietary  ,8,40,48,86,276,362
02502100,CREATIONS COLLEGE OF COSMETOLOGY        ,MS,38803-0000,Proprietary  ,0,18,18,55,145,200
02516200,WESLEY BIBLICAL SEMINARY                ,MS,39206-0000,Private      ,1,7,8,6,119,125
02586000,J & J HAIR DESIGN COLLEGE               ,MS,39051-3716,Proprietary  ,2,36,38,47,197,244
03004000,FINAL TOUCH BEAUTY SCHOOL               ,MS,39307-2934,Proprietary  ,5,23,28,24,97,121
03010603,VIRGINIA COLLEGE - JACKSON              ,MS,39206-5602,Proprietary  ,21,133,154,230,1205,1435
03010610,VIRGINIA COLLEGE - BILOXI               ,MS,39532-2124,Proprietary  ,21,83,104,132,1055,1187
03263300,TRAXLER'S SCHOOL OF HAIR                ,MS,39212-2529,Proprietary  ,3,10,13,22,92,114
03464300,ACADEMY OF HAIR DESIGN                  ,MS,39562-0000,Proprietary  ,3,12,15,22,106,128
03525300,BLUE CLIFF COLLEGE                      ,MS,39507-0000,Proprietary  ,22,95,117,163,759,922
03848300,DAY SPA CAREER COLLEGE                  ,MS,39564-0000,Proprietary  ,2,18,20,30,141,171
03963300,HEALING TOUCH SCHOOL OF MASSAGE THERAPY ,MS,39402-1300,Proprietary  ,1,25,26,19,131,150
04131300,CORINTH ACADEMY OF COSMETOLOGY          ,MS,38834-4813,Proprietary  ,1,24,25,26,134,160
04137400,MISSISSIPPI SCHOOL OF THERAPEUTIC MASSAG,MS,39216-5023,Proprietary  ,2,7,9,17,86,103
04140200,"MISSISSIPPI INSTITUTE OF AESTHETICS, NAI",MS,39056-5628,Proprietary  ,6,13,19,39,100,139
00252600,CARROLL COLLEGE                         ,MT,59625-0002,Private      ,40,26,66,1835,349,2184
00252700,UNIVERSITY OF GREAT FALLS               ,MT,59405-4996,Private      ,17,68,85,714,778,1492
00252800,MILES COMMUNITY COLLEGE                 ,MT,59301-4799,Public       ,11,16,27,297,283,580
00252900,DAWSON COMMUNITY COLLEGE                ,MT,59330-1405,Public       ,11,23,34,277,189,466
00253000,MONTANA STATE UNIVERSITY - BILLINGS     ,MT,59101-0298,Public       ,137,403,540,2905,4189,7094
00253100,MONTANA TECH OF THE UNIV OF MONTANA     ,MT,59701-8997,Public       ,71,159,230,1604,1557,3161
00253200,MONTANA STATE UNIVERSITY - BOZEMAN      ,MT,59717-0001,Public       ,282,383,665,10807,5473,16280
00253300,MONTANA STATE UNIVERSITY-NORTHERN       ,MT,59501-3148,Public       ,26,67,93,827,924,1751
00253400,ROCKY MOUNTAIN COLLEGE                  ,MT,59102-1796,Private      ,29,36,65,1223,473,1696
00253600,UNIVERSITY OF MONTANA (THE)             ,MT,59812-0001,Public       ,275,633,908,9237,9122,18359
00253700,UNIVERSITY OF MONTANA WESTERN (THE)     ,MT,59725-3598,Public       ,32,53,85,1265,703,1968
00677700,FLATHEAD VALLEY COMMUNITY COLLEGE       ,MT,59901-2699,Public       ,88,271,359,955,2052,3007
00757000,HELENA COLLEGE OF TECHNOLOGY            ,MT,59601-3098,Public       ,39,129,168,507,1371,1878
00790000,BUTTE ACADEMY OF BEAUTY CULTURE         ,MT,59701-9197,Proprietary  ,1,7,8,24,51,75
00894700,"DAHL'S COLLEGE OF BEAUTY,INC            ",MT,59401-3731,Proprietary  ,1,11,12,25,70,95
00931400,MSU COLLEGE OF TECH-GREAT FALLS         ,MT,59405-4907,Public       ,48,212,260,691,1813,2504
02143400,SALISH KOOTENAI COLLEGE                 ,MT,59855-0000,Public       ,28,115,143,358,1198,1556
02286600,LITTLE BIG HORN COLLEGE                 ,MT,59022-0000,Public       ,11,22,33,124,246,370
02343000,FT PECK COMMUNITY COLLEGE               ,MT,59255-0000,Public       ,9,45,54,93,244,337
02510600,BLACKFEET COMMUNITY COLLEGE             ,MT,59417-0000,Private      ,10,25,35,155,411,566
02517500,FORT BELKNAP COLLEGE                    ,MT,59526-0000,Public       ,2,10,12,49,161,210
02545200,CHIEF DULL KNIFE COLLEGE                ,MT,59043-0098,Public       ,2,14,16,73,166,239
02610900,STONE CHILD COLLEGE                     ,MT,59521-9796,Public       ,2,10,12,73,255,328
02621300,ACADEMY OF COSMETOLOGY                  ,MT,59715-3544,Proprietary  ,1,11,12,53,69,122
03205300,MODERN BEAUTY SCHOOL                    ,MT,59801-8386,Proprietary  ,3,7,10,55,91,146
03763400,"ACADEMY OF NAIL, SKIN & HAIR            ",MT,59101-0000,Proprietary  ,7,29,36,87,168,255
03778300,HEALTH WORKS INSTITUTE                  ,MT,59715-0000,Proprietary  ,4,12,16,26,68,94
04163700,BITTERROOT SCHOOL OF COSMETOLOGY        ,MT,59840-3118,Proprietary  ,4,9,13,15,43,58
04164100,SALON PROFESSIONAL ACADEMY (THE)        ,MT,59405-0000,Proprietary  ,3,8,11,63,122,185
04187700,CREVIER'S SCHOOL OF COSMETOLOGY         ,MT,59901-4402,Proprietary  ,7,18,25,39,104,143
00253900,CHADRON STATE COLLEGE                   ,NE,69337-2690,Public       ,39,116,155,1776,1253,3029
00254000,COLLEGE OF ST MARY                      ,NE,68106-2606,Private      ,11,95,106,514,1221,1735
00254100,CONCORDIA UNIVERSITY                    ,NE,68434-1594,Private      ,15,65,80,1401,587,1988
00254200,CREIGHTON UNIVERSITY                    ,NE,68178-0001,Private      ,85,221,306,5252,5285,10537
00254400,DOANE COLLEGE                           ,NE,68333-2421,Private      ,19,112,131,1635,1216,2851
00254700,GRACE UNIVERSITY                        ,NE,68108-3629,Private      ,10,20,30,341,338,679
00254800,HASTINGS COLLEGE                        ,NE,68901-7621,Private      ,24,17,41,1561,199,1760
00255100,UNIVERSITY OF NEBRASKA AT KEARNEY       ,NE,68849-0001,Public       ,75,171,246,4505,2174,6679
00255300,MIDLAND UNIVERSITY                      ,NE,68025-4254,Private      ,20,17,37,1196,342,1538
00255400,UNIVERSITY OF NEBRASKA-OMAHA            ,NE,68182-0001,Public       ,224,497,721,8916,7241,16157
00255500,NEBRASKA WESLEYAN UNIVERSITY            ,NE,68504-2796,Private      ,30,57,87,1865,606,2471
00255700,MID-PLAINS COMM COLLEGE - NORTH PLATTE  ,NE,69101-9420,Public       ,24,101,125,529,764,1293
00255701,MID-PLAINS COMMUNITY COLLEGE - MCCOOK   ,NE,69001-2631,Public       ,10,38,48,267,232,499
00255900,PERU STATE COLLEGE                      ,NE,68421-0010,Public       ,28,82,110,981,1060,2041
00256000,WESTERN NEBRASKA COMMUNITY COLLEGE      ,NE,69361-1815,Public       ,40,131,171,748,1219,1967
00256300,UNION COLLEGE                           ,NE,68506-4387,Private      ,11,16,27,841,385,1226
00256500,UNIVERSITY OF NEBRASKA-LINCOLN          ,NE,68588-0419,Public       ,293,328,621,15885,5951,21836
00256596,UNIVERSITY OF NEBRASKA - CURTIS         ,NE,69025-9522,Public       ,10,7,17,253,59,312
00256600,WAYNE STATE COLLEGE                     ,NE,68787-1172,Public       ,42,64,106,2978,1008,3986
00256700,YORK COLLEGE                            ,NE,68467-2699,Private      ,6,15,21,576,178,754
00443600,REGNL WST MEDCL CTR SCHL RAD            ,NE,69361-0000,Private      ,2,2,4,17,15,32
00458608,KAPLAN UNIVERSITY - OMAHA               ,NE,68134-1002,Proprietary  ,19,187,206,158,1556,1714
00458609,KAPLAN UNIVERSITY - LINCOLN             ,NE,68508-2668,Proprietary  ,15,119,134,127,914,1041
00639900,BRYANLGH COLLEGE OF HEALTH SCIENCES     ,NE,68506-1398,Private      ,9,21,30,410,348,758
00640400,NEBR METHODIST CLG OF NURS ALLD HLTH    ,NE,68114-2852,Private      ,17,83,100,456,875,1331
00689500,UNIVERSITY OF NEBRASKA-MED CTR          ,NE,68198-4265,Public       ,11,73,84,634,2576,3210
00750100,VATTEROTT COLLEGE                       ,NE,68137-1237,Proprietary  ,36,209,245,265,1237,1502
00849200,ALEGENT HEALTH SCHOOLS                  ,NE,68114-2767,Private      ,3,15,18,38,176,214
00952300,BAHNER COLLEGE OF HAIRSTYLING           ,NE,68025-3297,Proprietary  ,3,6,9,22,42,64
00961700,CAPITOL BEAUTY SCHOOL                   ,NE,68144-0000,Proprietary  ,9,32,41,140,196,336
00974300,BELLEVUE UNIVERSITY                     ,NE,68005-0000,Private      ,54,822,876,834,8434,9268
00986200,CLARKSON COLLEGE                        ,NE,68131-2739,Private      ,11,91,102,504,1248,1752
01151900,JOSEPH'S COLLEGE OF BEAUTY/ALL CAMPUSES ,NE,68510-2226,Proprietary  ,9,79,88,151,377,528
01166700,NORTHEAST COMMUNITY COLLEGE             ,NE,68702-0000,Public       ,60,209,269,1832,1564,3396
01258600,METROPOLITAN COMMUNITY COLLEGE          ,NE,68103-0000,Public       ,430,1535,1965,5444,14462,19906
01297600,NEBRASKA CHRISTIAN COLLEGE              ,NE,68046-4256,Private      ,5,5,10,131,65,196
02079700,COLLEGE OF HAIR DESIGN                  ,NE,68508-0000,Proprietary  ,30,38,68,193,261,454
02099500,CENTRAL COMMUNITY COLLEGE- GI           ,NE,68801-0000,Public       ,38,229,267,739,1670,2409
02099501,CENTRAL COMMUNITY COLLEGE - HASTINGS    ,NE,68902-0000,Public       ,34,131,165,1047,975,2022
02099502,CENTRAL COMMUNITY COLLEGE - COLUMBUS    ,NE,68602-0000,Public       ,24,70,94,530,619,1149
02508300,SOUTHEAST COMM. COLLEGE-ALL CAMPUSES    ,NE,68520-0000,Public       ,311,724,1035,5265,7480,12745
02550800,NEBRASKA INDIAN COMMUNITY COLLEGE       ,NE,68039-0000,Public       ,2,14,16,21,145,166
02610500,XENON INTERNATIONAL ACADEMY II          ,NE,68127-3522,Proprietary  ,18,43,61,207,273,480
03164300,THE CREATIVE CENTER                     ,NE,68164-2911,Proprietary  ,3,4,7,164,60,224
03279300,MYOTHERAPY INSTITUTE                    ,NE,68516-3641,Proprietary  ,1,13,14,27,56,83
03323300,LITTLE PRIEST TRIBAL COLLEGE            ,NE,68071-0000,Private      ,2,8,10,38,135,173
03821400,UNIVERSAL COLLEGE OF HEALING ARTS       ,NE,68112-1810,Proprietary  ,1,3,4,18,81,99
00256800,UNIVERSITY OF NEVADA RENO               ,NV,89557-0002,Public       ,431,480,911,11766,6865,18631
00256900,UNIVERSITY OF NEVADA-LAS VEGAS          ,NV,89154-1001,Public       ,626,1268,1894,15941,17336,33277
00697700,GREAT BASIN COLLEGE                     ,NV,89801-3348,Public       ,35,177,212,640,1518,2158
00732954,ITT TECHNICAL INSTITUTE                 ,NV,89014-6712,Proprietary  ,78,211,289,336,1056,1392
00736700,MARINELLO SCHOOLS OF BEAUTY             ,NV,89110-3563,Proprietary  ,36,92,128,216,544,760
00737100,MARINELLO SCHOOL OF BEAUTY              ,NV,89502-6530,Proprietary  ,24,82,106,138,362,500
00844103,ANTHEM INSTITUTE - MORRISON UNIVERSITY  ,NV,89521-4826,Proprietary  ,2,34,36,35,262,297
00919200,SIERRA NEVADA COLLEGE                   ,NV,89451-0000,Private      ,21,59,80,540,600,1140
01036200,COLLEGE OF SOUTHERN NEVADA              ,NV,89146-1139,Public       ,1387,3707,5094,14179,27881,42060
01036300,WESTERN NEVADA COLLEGE                  ,NV,89703-0000,Public       ,106,421,527,1231,3248,4479
01323200,ACADEMY OF HAIR DESIGN                  ,NV,89146-1617,Proprietary  ,23,70,93,148,333,481
02107700,TRUCKEE MEADOWS COMMUNITY CLG           ,NV,89512-0000,Public       ,397,1272,1669,4353,9051,13404
02237500,EVEREST COLLEGE                         ,NV,89103-0000,Proprietary  ,85,293,378,622,1750,2372
02338512,GLENDALE CAREER COLLEGE - NEVADA CAREER ,NV,89131-3268,Proprietary  ,5,29,34,35,153,188
02616703,SCOTTSDALE CULINARY INSTITUTE - LE CORDO,NV,89144-7047,Proprietary  ,20,50,70,164,497,661
02621500,CAREER COLLEGE OF NORTHERN NEVADA       ,NV,89434-7905,Proprietary  ,26,123,149,170,878,1048
03030603,UTAH CLG OF MASSAGE THERAPY-NSMT        ,NV,89123-0000,Proprietary  ,52,82,134,184,382,566
03031405,INTERNATIONAL ACADEMY OF DESIGN AND TECH,NV,89074-7750,Proprietary  ,29,69,98,432,792,1224
03043200,KAPLAN COLLEGE                          ,NV,89102-8618,Proprietary  ,80,335,415,451,2076,2527
03076404,BRYMAN SCHOOL OF ARIZONA (THE) - ANTHEM ,NV,89102-4514,Proprietary  ,10,24,34,40,127,167
03088200,CARSON CITY BEAUTY ACADEMY              ,NV,89706-0000,Proprietary  ,2,20,22,35,137,172
03110000,ACADEMY OF HEALING ARTS                 ,NV,89106-4031,Proprietary  ,0,0,0,126,330,456
03232306,EUPHORIA INSTITUTE - SUMMERLIN          ,NV,89117-8803,Proprietary  ,19,41,60,147,322,469
03232307,EUPHORIA INSTITUTE - GREEN VALLEY       ,NV,89052-4964,Proprietary  ,9,45,54,111,262,373
03232308,EUPHORIA INSTITUTE - ALIANTE            ,NV,89131-1036,Proprietary  ,12,26,38,138,329,467
03787300,EXPERTISE SCHOOL OF BEAUTY              ,NV,89106-2516,Private      ,13,35,48,76,271,347
03838500,NORTHWEST HEALTH CAREERS                ,NV,89128-0255,Proprietary  ,19,98,117,136,474,610
03975300,INSTITUTE OF PROFESSIONAL CAREERS       ,NV,89119-7825,Proprietary  ,12,56,68,75,308,383
04051303,ART INSTITUTE OF PHOENIX (THE) - ART INS,NV,89074-7737,Proprietary  ,23,31,54,1012,1083,2095
04065300,UNIVERSITY OF SOUTHERN NEVADA           ,NV,89014-2333,Private      ,28,134,162,432,2058,2490
04114300,NEVADA STATE COLLEGE                    ,NV,89002-9455,Public       ,112,275,387,1601,3093,4694
04142601,TOURO UNIVERSITY - NEVADA               ,NV,89014-8800,Private      ,7,42,49,64,795,859
04144800,INTERNATIONAL ACADEMY OF STYLE          ,NV,89509-3450,Proprietary  ,4,22,26,66,173,239
04147600,AVEDA INSTITUTE LAS VEGAS               ,NV,89119-6103,Proprietary  ,9,45,54,117,277,394
04171000,ADVANCED TRAINING INSTITUTE             ,NV,89115-7504,Proprietary  ,13,76,89,77,420,497
04186300,PAUL MITCHELL THE SCHOOL LAS VEGAS      ,NV,89123-8014,Proprietary  ,61,81,142,166,238,404
04190300,AMERICAN INSTITUTE OF MEDICAL SONOGRAPHY,NV,89146-6597,Proprietary  ,1,16,17,1,16,17
04191100,DESTINATION ACADEMY FOR SPA AND SALON PR,NV,89147-8397,Proprietary  ,2,7,9,2,7,9
04203100,PAUL MITCHELL THE SCHOOL RENO           ,NV,89501-3356,Proprietary  ,14,13,27,14,13,27
00257200,COLBY-SAWYER COLLEGE                    ,NH,03257-4648,Private      ,24,7,31,2800,123,2923
00257300,DARTMOUTH COLLEGE                       ,NH,03755-3529,Private      ,132,53,185,12071,1917,13988
00257500,FRANKLIN PIERCE UNIVERSITY              ,NH,03461-0060,Private      ,43,80,123,2656,1342,3998
00257900,NEW ENGLAND COLLEGE                     ,NH,03242-3293,Private      ,26,106,132,1519,1078,2597
00258000,SOUTHERN NEW HAMPSHIRE UNIVERSITY       ,NH,03106-1045,Private      ,159,1233,1392,5356,8355,13711
00258100,NHTI  - CONCORD'S COMMUNITY COLLEGE     ,NH,03301-7412,Public       ,100,206,306,2830,2231,5061
00258200,MANCHESTER COMMUNITY COLLEGE            ,NH,03102-8518,Public       ,68,203,271,1403,1831,3234
00258300,GREAT BAY COMMUNITY COLLEGE             ,NH,03801-0000,Public       ,53,132,185,918,1299,2217
00258600,RIVIER COLLEGE                          ,NH,03060-5086,Private      ,15,68,83,1341,1137,2478
00258700,SAINT ANSELM COLLEGE                    ,NH,03102-1310,Private      ,47,20,67,4248,156,4404
00258900,UNIVERSITY OF NEW HAMPSHIRE             ,NH,03824-2511,Public       ,205,171,376,20759,4028,24787
00259000,KEENE STATE COLLEGE                     ,NH,03431-0000,Public       ,85,50,135,8515,774,9289
00259100,PLYMOUTH STATE UNIVERSITY               ,NH,03264-1595,Public       ,74,104,178,7092,1671,8763
00301004,ANTIOCH UNIVERSITY                      ,NH,03431-0000,Private      ,0,33,33,7,914,921
00472900,HESSER COLLEGE                          ,NH,03103-7230,Proprietary  ,50,136,186,559,1226,1785
00472901,HESSER COLLEGE - NASHUA CAMPUS          ,NH,03063-1286,Proprietary  ,19,53,72,181,579,760
00472904,HESSER COLLEGE - PORTSMOUTH CAMPUS      ,NH,03801-3245,Proprietary  ,20,109,129,175,686,861
00472905,HESSER COLLEGE - SALEM CAMPUS           ,NH,03079-2842,Proprietary  ,32,96,128,249,708,957
00472906,HESSER COLLEGE - CONCORD CAMPUS         ,NH,03301-3415,Proprietary  ,11,64,75,110,552,662
00473100,DANIEL WEBSTER COLLEGE                  ,NH,03063-1300,Proprietary  ,20,28,48,798,228,1026
00473300,CHESTER COLLEGE OF NEW ENGLAND          ,NH,03036-4331,Private      ,3,2,5,197,38,235
00529100,WHITE MOUNTAINS COMMUNITY COLLEGE       ,NH,03570-3799,Public       ,18,65,83,418,722,1140
00702500,LEBANON COLLEGE                         ,NH,03766-0000,Private      ,1,10,11,30,101,131
00755500,LAKES REGION COMMUNITY COLLEGE          ,NH,03246-1326,Public       ,41,80,121,647,730,1377
00756000,RIVER VALLEY COMMUNITY COLLEGE          ,NH,03743-9707,Public       ,25,74,99,369,912,1281
00849300,CONTINENTAL ACADEMIE OF HAIR DESIGN     ,NH,03103-4901,Proprietary  ,0,4,4,18,24,42
00864500,EMPIRE BEAUTY SCHOOL                    ,NH,03220-0000,Proprietary  ,25,30,55,103,144,247
00923600,NASHUA COMMUNITY COLLEGE                ,NH,03063-2052,Public       ,59,130,189,1158,1233,2391
01318900,CONTINENTAL ACADEMIE OF HAIR DESIGN     ,NH,03051-3754,Proprietary  ,10,7,17,50,44,94
02097900,UNIVERSITY NEW HAMPSHIRE SCHOOL OF LAW  ,NH,03301-0000,Private      ,5,12,17,71,755,826
02140400,ST JOSEPH SCH OF PRAC NRSG              ,NH,03060-0000,Private      ,1,9,10,55,186,241
02174800,MICHAEL'S SCHOOL OF HAIR DESIGN & ESTHET,NH,03110-0000,Proprietary  ,23,19,42,99,83,182
02179600,EMPIRE BEAUTY SCHOOL                    ,NH,03878-0000,Proprietary  ,22,22,44,101,130,231
02211600,PORTSMOUTH BTY SCH OF HAIR DESIGN       ,NH,03801-4084,Proprietary  ,4,5,9,21,20,41
02223300,MAGDALEN COLLEGE                        ,NH,03278-4012,Private      ,0,0,0,57,5,62
02245400,KEENE BEAUTY ACADEMY                    ,NH,03431-0000,Proprietary  ,1,4,5,27,44,71
02247000,NEW ENGLAND SCHOOL OF HAIR DESIGN       ,NH,03784-0000,Proprietary  ,2,3,5,36,55,91
03043100,THOMAS MORE COLLEGE OF LIBERAL ARTS     ,NH,03054-4818,Private      ,0,3,3,85,18,103
03101300,GRANITE STATE COLLEGE                   ,NH,03301-6400,Public       ,25,204,229,353,1893,2246
03182300,NEW HAMPSHIRE INSTITUTE OF ART          ,NH,03104-4858,Private      ,15,8,23,730,123,853
03437300,UPPER VALLEY TEACHER TRANING PROGRAM    ,NH,03766-1358,Private      ,1,4,5,1,47,48
03729300,NH INSTITUTE FOR THERAPEUTIC ARTS       ,NH,03051-4906,Proprietary  ,1,10,11,13,45,58
04162200,LAIRD INSTITUTE OF SPA THERAPY          ,NH,03102-5263,Proprietary  ,1,14,15,14,62,76
00267000,BAPTIST BIBLE COLG OF PENNSYLVANIA      ,PA,18411-1297,Private      ,14,52,66,657,336,993
00322800,BRYN ATHYN COLLEGE OF THE NEW CHURCH    ,PA,19009-0717,Private      ,1,1,2,284,35,319
00322900,ALBRIGHT COLLEGE                        ,PA,19612-5234,Private      ,73,82,155,3998,1297,5295
00323000,ALLEGHENY COLLEGE                       ,PA,16335-3902,Private      ,38,13,51,3690,140,3830
00323100,COMM CLG OF ALLEGHENY-ALLEGHENY CMP     ,PA,15212-0000,Public       ,252,733,985,3384,6424,9808
00323101,"COMM CLG OF ALLEGHENY, BOYCE CAMPUS     ",PA,15146-0000,Public       ,108,313,421,1615,2780,4395
00323102,"COMM CLG OF ALLEGHENY, NORTH CAMPUS     ",PA,15237-0000,Public       ,83,254,337,1417,1939,3356
00323103,"COMM CLG OF ALLEGHENY, SOUTH CAMPUS     ",PA,15122-0000,Public       ,137,337,474,2003,2692,4695
00323300,ALVERNIA UNIVERSITY                     ,PA,19607-1799,Private      ,30,99,129,2400,1665,4065
00323500,ARCADIA UNIVERSITY                      ,PA,19038-3295,Private      ,91,123,214,5377,2342,7719
00323700,BRYN MAWR COLLEGE                       ,PA,19010-2899,Private      ,27,17,44,1840,662,2502
00323800,BUCKNELL UNIVERSITY                     ,PA,17837-2122,Private      ,62,6,68,5389,207,5596
00323900,BUCKS COUNTY COMMUNITY COLLEGE          ,PA,18940-1320,Public       ,214,436,650,4094,4120,8214
00324000,BUTLER COUNTY COMMUNITY COLLEGE         ,PA,16001-0000,Public       ,105,263,368,2140,2394,4534
00324100,CABRINI COLLEGE                         ,PA,19087-3698,Private      ,32,227,259,2093,1635,3728
00324200,CARNEGIE MELLON UNIVERSITY              ,PA,15213-3890,Private      ,150,85,235,12067,1920,13987
00324201,CARNEGIE MELLON UNIV- THE HEINZ COLLEGE ,PA,15213-0000,Private      ,4,20,24,95,586,681
00324202,CARNEGIE MELLON- TEPPER SCHOOL OF BUSINE,PA,15213-0000,Private      ,6,16,22,214,490,704
00324300,CEDAR CREST COLLEGE                     ,PA,18104-6196,Private      ,23,86,109,1052,1332,2384
00324400,CHATHAM UNIVERSITY                      ,PA,15232-2826,Private      ,13,131,144,782,1944,2726
00324500,CHESTNUT HILL COLLEGE                   ,PA,19118-2693,Private      ,46,164,210,1858,2242,4100
00324700,MISERICORDIA  UNIVERSITY                ,PA,18612-1008,Private      ,28,57,85,2275,1298,3573
00324900,COMMUNITY COLLEGE OF PHILADELPHIA       ,PA,19130-3991,Public       ,969,2749,3718,12817,22889,35706
00325100,CURTIS INSTITUTE OF MUSIC               ,PA,19103-6187,Private      ,9,8,17,296,140,436
00325200,DELAWARE VALLEY COLLEGE                 ,PA,18901-2697,Private      ,20,59,79,2265,555,2820
00325300,DICKINSON COLLEGE                       ,PA,17013-2896,Private      ,63,4,67,3841,185,4026
00325600,DREXEL UNIVERSITY                       ,PA,19104-2875,Private      ,482,1164,1646,29446,18501,47947
00325800,DUQUESNE UNIVERSITY                     ,PA,15282-0001,Private      ,80,183,263,7573,4459,12032
00325900,EASTERN UNIVERSITY                      ,PA,19087-3696,Private      ,42,193,235,2399,3043,5442
00326200,ELIZABETHTOWN COLLEGE                   ,PA,17022-2298,Private      ,21,53,74,3210,661,3871
00326300,EVANGELICAL SCHOOL OF THEOLOGY          ,PA,17067-0000,Private      ,0,1,1,1,84,85
00326500,FRANKLIN & MARSHALL COLLEGE             ,PA,17604-0000,Private      ,62,17,79,3285,173,3458
00326600,GANNON UNIVERSITY                       ,PA,16541-0001,Private      ,44,66,110,3773,1554,5327
00326700,GENEVA COLLEGE                          ,PA,15010-3599,Private      ,22,77,99,1950,1014,2964
00326800,GETTYSBURG COLLEGE                      ,PA,17325-1486,Private      ,56,10,66,4407,153,4560
00326900,GROVE CITY COLLEGE                      ,PA,16127-2104,Private      ,15,3,18,32,7,39
00327000,GWYNEDD-MERCY COLLEGE                   ,PA,19437-0901,Private      ,20,116,136,1843,1636,3479
00327200,HARCUM COLLEGE                          ,PA,19010-3476,Private      ,48,129,177,884,1614,2498
00327300,HARRISBURG AREA COMMUNITY COLLEGE       ,PA,17110-2999,Public       ,610,1795,2405,9537,17226,26763
00327400,HAVERFORD COLLEGE                       ,PA,19041-1392,Private      ,25,2,27,2225,62,2287
00327500,HOLY FAMILY UNIVERSITY                  ,PA,19114-2094,Private      ,43,161,204,2174,2062,4236
00327600,IMMACULATA UNIVERSITY                   ,PA,19345-0647,Private      ,33,177,210,1670,2021,3691
00327700,INDIANA UNIVERSITY OF PENNSYLVANIA      ,PA,15705-1097,Public       ,212,223,435,15329,4311,19640
00327900,JUNIATA COLLEGE                         ,PA,16652-2196,Private      ,20,4,24,2301,91,2392
00328000,KEYSTONE COLLEGE                        ,PA,18440-0200,Private      ,30,40,70,1655,937,2592
00328200,KINGS COLLEGE                           ,PA,18711-0801,Private      ,26,45,71,3109,666,3775
00328300,LACKAWANNA COLLEGE                      ,PA,18509-9961,Private      ,63,110,173,1746,1219,2965
00328400,LAFAYETTE COLLEGE                       ,PA,18042-1768,Private      ,72,11,83,3999,158,4157
00328500,LANCASTER BIBLE COLLEGE                 ,PA,17601-5036,Private      ,23,190,213,759,831,1590
00328600,LANCASTER THEOLOGICAL SEMINARY          ,PA,17603-0000,Private      ,0,6,6,1,116,117
00328700,LASALLE UNIVERSITY                      ,PA,19141-1199,Private      ,88,266,354,5906,4082,9988
00328800,LEBANON VALLEY COLLEGE                  ,PA,17003-1400,Private      ,21,13,34,2969,315,3284
00328900,LEHIGH UNIVERSITY                       ,PA,18015-1588,Private      ,75,55,130,8619,1038,9657
00329000,LINCOLN UNIVERSITY                      ,PA,19352-0999,Public       ,92,89,181,3693,1381,5074
00329100,LUTHERAN THEOLOG SEMINARY-GETTYSBRG     ,PA,17325-0000,Private      ,0,2,2,0,124,124
00329200,LUTHERAN THEOLOGICAL SEMINARY           ,PA,19119-0000,Private      ,0,6,6,0,190,190
00329300,LYCOMING COLLEGE                        ,PA,17701-5192,Private      ,17,10,27,1995,181,2176
00329400,MANOR COLLEGE                           ,PA,19046-3399,Private      ,26,63,89,728,712,1440
00329600,MARYWOOD UNIVERSITY                     ,PA,18509-1598,Private      ,36,90,126,3010,1650,4660
00329700,MERCYHURST COLLEGE                      ,PA,16546-0001,Private      ,75,137,212,4209,1985,6194
00329800,MESSIAH COLLEGE                         ,PA,17027-0800,Private      ,42,35,77,3524,363,3887
00330000,MOORE COLLEGE OF ART & DESIGN           ,PA,19103-1179,Private      ,14,24,38,701,310,1011
00330100,MORAVIAN COLLEGE                        ,PA,18018-6650,Private      ,33,31,64,2373,351,2724
00330101,MORAVIAN THEOLOGICAL SEMINARY           ,PA,18018-0000,Private      ,0,6,6,6,80,86
00330200,MOUNT ALOYSIUS COLLEGE                  ,PA,16630-1999,Private      ,18,57,75,1345,912,2257
00330300,CARLOW UNIVERSITY                       ,PA,15213-3165,Private      ,18,143,161,1222,2104,3326
00330400,MUHLENBERG COLLEGE                      ,PA,18104-5586,Private      ,61,32,93,3836,359,4195
00330600,VALLEY FORGE CHRISTIAN COLLEGE          ,PA,19460-2399,Private      ,10,19,29,935,287,1222
00330900,PEIRCE COLLEGE                          ,PA,19102-4699,Private      ,27,209,236,340,2590,2930
00331100,SALUS UNIVERSITY                        ,PA,19027-1598,Private      ,1,11,12,11,989,1000
00331300,WIDENER UNIVERSITY                      ,PA,19013-5792,Private      ,65,123,188,4673,2689,7362
00331302,WIDENER UNIV SCH OF LAW- HARRISBURG     ,PA,17106-9381,Private      ,0,7,7,33,728,761
00331500,BLOOMSBURG UNIVERSITY OF PA             ,PA,17815-1301,Public       ,205,135,340,12708,2393,15101
00331600,CALIFORNIA UNIV OF PENNSYLVANIA         ,PA,15419-1394,Public       ,107,368,475,7259,4787,12046
00331700,CHEYNEY UNIVERSITY OF PENNSYLVANIA      ,PA,19319-0200,Public       ,52,50,102,2284,1081,3365
00331800,CLARION UNIVERSITY OF PENNSYLVANIA      ,PA,16214-1232,Public       ,62,165,227,5660,2746,8406
00332000,EAST STROUDSBURG UNIVERSITY             ,PA,18301-2999,Public       ,137,100,237,8148,2060,10208
00332100,EDINBORO UNIVERSITY OF PENNSYLVANIA     ,PA,16444-0001,Public       ,92,159,251,6854,3619,10473
00332200,KUTZTOWN UNIVERSITY OF PENNSYLVANIA     ,PA,19530-9339,Public       ,153,108,261,12001,2453,14454
00332300,LOCK HAVEN UNIV OF PENNSYLVANIA         ,PA,17745-2439,Public       ,63,62,125,6111,1532,7643
00332400,MANSFIELD UNIVERSITY                    ,PA,16933-1123,Public       ,44,57,101,3106,1090,4196
00332500,MILLERSVILLE UNIVERSITY OF PA           ,PA,17551-1800,Public       ,121,152,273,9145,2660,11805
00332600,SHIPPENSBURG UNIVERSITY                 ,PA,17257-2299,Public       ,109,111,220,8762,1817,10579
00332700,SLIPPERY ROCK UNIVERSITY                ,PA,16057-1326,Public       ,121,150,271,9107,2302,11409
00332800,WEST CHESTER UNIVERSITY                 ,PA,19383-0001,Public       ,253,277,530,17242,4900,22142
00332900,PENN STATE UNIVERSITY                   ,PA,16802-1503,Public       ,1035,1911,2946,74270,28463,102733
00335000,UNIVERSITY OF THE ARTS (THE)            ,PA,19102-9493,Private      ,47,49,96,3136,782,3918
00335100,PHILADELPHIA BIBLICAL UNIVERSITY        ,PA,19047-2942,Private      ,14,46,60,882,583,1465
00335200,PHILADELPHIA CLG OSTEOPATHIC MED        ,PA,19131-0000,Private      ,1,38,39,37,3042,3079
00335300,UNIVERSITY OF THE SCIENCES IN PHILADELPH,PA,19104-4495,Private      ,45,47,92,3456,1196,4652
00335400,PHILADELPHIA UNIVERSITY                 ,PA,19144-5497,Private      ,58,128,186,4571,1744,6315
00335600,PITTSBURGH THEOLOGICAL SEMINARY         ,PA,15206-0000,Private      ,0,7,7,4,230,234
00335700,POINT PARK UNIVERSITY                   ,PA,15222-1912,Private      ,48,182,230,3457,2378,5835
00335800,REFORMED PRESBYTERIAN THEOL SEMINAR     ,PA,15208-0000,Private      ,0,0,0,1,31,32
00335900,ROBERT MORRIS UNIVERSITY                ,PA,15108-1189,Private      ,61,174,235,4885,2226,7111
00336000,ROSEMONT COLLEGE                        ,PA,19010-1699,Private      ,8,58,66,750,598,1348
00336200,SETON HILL UNIVERSITY                   ,PA,15601-1599,Private      ,16,63,79,2085,1055,3140
00336400,ST. CHARLES BORROMEO SEMINARY           ,PA,19096-0000,Private      ,2,4,6,38,49,87
00336600,SAINT FRANCIS UNIVERSITY                ,PA,15940-0600,Private      ,30,42,72,2132,778,2910
00336700,SAINT JOSEPH'S UNIVERSITY               ,PA,19131-1395,Private      ,106,376,482,7141,3499,10640
00336800,ST VINCENT COLLEGE                      ,PA,15650-2690,Private      ,13,16,29,2031,332,2363
00336900,SUSQUEHANNA UNIVERSITY                  ,PA,17870-1001,Private      ,30,13,43,3368,151,3519
00337000,SWARTHMORE COLLEGE                      ,PA,19081-1397,Private      ,54,4,58,4022,126,4148
00337100,TEMPLE UNIVERSITY                       ,PA,19122-6003,Private      ,559,873,1432,34248,20991,55239
00337600,THIEL COLLEGE                           ,PA,16125-2181,Private      ,21,11,32,1878,221,2099
00337800,UNIVERSITY OF PENNSYLVANIA              ,PA,19104-6216,Private      ,345,475,820,21211,13277,34488
00337900,UNIVERSITY OF PITTSBURGH                ,PA,15260-0000,Public       ,383,545,928,28563,11727,40290
00337906,UNIVERSITY OF PITTSBURGH - SCHOOL OF MED,PA,15261-0001,Public       ,7,17,24,223,1143,1366
00337907,UNIVERSITY OF PITTSBURGH - SCHOOL OF DEN,PA,15261-2523,Public       ,11,16,27,279,722,1001
00338400,UNIVERSITY OF SCRANTON                  ,PA,18510-4622,Private      ,82,155,237,7733,1949,9682
00338500,URSINUS COLLEGE                         ,PA,19426-2562,Private      ,30,3,33,3205,126,3331
00338600,VALLEY FORGE MILITARY COLLEGE           ,PA,19087-3695,Private      ,18,4,22,415,49,464
00338800,VILLANOVA UNIVERSITY                    ,PA,19085-1699,Private      ,136,203,339,12416,2987,15403
00338801,VILLANOVA UNIV SCH OF LAW               ,PA,19085-0000,Private      ,3,21,24,116,1671,1787
00338900,WASHINGTON & JEFFERSON COLLEGE          ,PA,15301-4801,Private      ,26,0,26,2708,93,2801
00339100,WAYNESBURG UNIVERSITY                   ,PA,15370-1222,Private      ,21,83,104,2144,936,3080
00339200,WESTMINSTER COLLEGE                     ,PA,16172-0002,Private      ,22,6,28,2504,138,2642
00339300,WESTMINSTER THEOLOGICAL SEMINARY        ,PA,19038-0000,Private      ,0,13,13,7,306,313
00339400,WILKES UNIVERSITY                       ,PA,18766-0998,Private      ,45,109,154,3186,1315,4501
00339500,PENNSYLVANIA COLLEGE OF TECHNOLOGY      ,PA,17701-5779,Public       ,124,169,293,5266,2563,7829
00339600,WILSON COLLEGE                          ,PA,17201-1285,Private      ,8,42,50,457,512,969
00339900,YORK COLLEGE OF PENNSYLVANIA            ,PA,17405-7199,Private      ,115,111,226,8947,1521,10468
00398600,DESALES UNIVERSITY                      ,PA,18034-9568,Private      ,37,107,144,2513,1534,4047
00398700,LA ROCHE COLLEGE                        ,PA,15237-5898,Private      ,16,37,53,1141,559,1700
00398800,NEUMANN UNIVERSITY                      ,PA,19014-1298,Private      ,48,73,121,3305,1288,4593
00405800,GRATZ COLLEGE                           ,PA,19027-3097,Private      ,0,17,17,3,144,147
00445200,MONTGOMERY COUNTY COMMUNITY COLLEGE     ,PA,19422-6300,Public       ,283,719,1002,4957,6432,11389
00488900,CAMBRIA-ROWE BUSINESS COLLEGE           ,PA,15902-2494,Proprietary  ,4,30,34,142,313,455
00489000,CENTRAL PENNSYLVANIA COLLEGE            ,PA,17093-0309,Proprietary  ,40,115,155,1011,1603,2614
00489300,DU BOIS BUSINESS COLLEGE                ,PA,15801-2401,Proprietary  ,8,17,25,175,333,508
00489400,ERIE BUSINESS CENTER                    ,PA,16501-1305,Proprietary  ,10,52,62,83,375,458
00489401,ERIE BUSINESS CENTER - NEW CASTLE CAMPUS,PA,16101-3950,Proprietary  ,1,14,15,20,104,124
00489800,MCCANN SCHOOL OF BUSINESS & TECHNOL     ,PA,17901-1335,Proprietary  ,129,517,646,1436,4117,5553
00489807,MCCANN SCHOOL OF BUSINESS & TECHNOLOGY -,PA,17013-3180,Proprietary  ,2,6,8,27,88,115
00489900,MERCY HOSP SCH OF NURSING               ,PA,15219-5166,Private      ,1,13,14,90,188,278
00490100,NEWPORT BUSINESS INSTITUTE              ,PA,15068-3929,Proprietary  ,2,4,6,25,82,107
00490200,PENN COMMERCIAL BUSINESS/TECHNICAL SCHL ,PA,15301-2871,Proprietary  ,22,51,73,219,428,647
00491000,KAPLAN CAREER INSTITUTE                 ,PA,17111-3571,Proprietary  ,12,119,131,241,867,1108
00491001,THOMPSON INSTITUTE-PHILADEPHIA CAMPUS   ,PA,19104-3386,Proprietary  ,49,144,193,305,986,1291
00491400,NEWPORT BUSINESS INSTITUTE              ,PA,17701-5855,Proprietary  ,2,10,12,23,118,141
00500701,WEST VIRGINIA CAREER INSTITUTE          ,PA,15456-0000,Proprietary  ,4,23,27,71,169,240
00531000,PITTSBURGH INST OF AERONAUTICS          ,PA,15236-0000,Private      ,12,35,47,279,252,531
00533000,FAYETTE CNTY AREA VOC TECH PRC NRSG     ,PA,15401-0000,Public       ,2,12,14,32,103,135
00533500,CENTRAL PENN INST OF SCI & TECH PNP     ,PA,16823-0000,Public       ,11,36,47,100,228,328
00536500,YORK CO AREA VOC-TECH SCH-PRAC NSG      ,PA,17402-0000,Public       ,7,72,79,41,292,333
00594600,SCHOOL OF RADIOLOGIC TECHNOLOGY AT ST. C,PA,19134-1995,Proprietary  ,0,0,0,7,23,30
00653400,CITIZENS SCHOOL OF NURSING              ,PA,15068-6591,Private      ,0,11,11,89,177,266
00653700,CONEMAUGH VLY MEM HOSP SCH NRSNG        ,PA,15905-4398,Private      ,3,4,7,73,113,186
00653702,CONEMAUGH HOSP- SCH HISTOTECHNOLOGY     ,PA,15905-0000,Private      ,1,2,3,6,7,13
00653704,CONEMAUGH VLY MEM HOSP SCH RAD TECH     ,PA,15905-0000,Private      ,0,2,2,21,22,43
00653706,CONEMAUGH VLY MEM HOSP SCH  MED TECH    ,PA,15905-4398,Private      ,0,2,2,5,6,11
00655100,ST MARGARET SCHL OF NURSING             ,PA,15238-3205,Private      ,5,22,27,71,233,304
00656000,OHIO VALLEY HOSP SCH OF NURSING         ,PA,15136-1694,Private      ,1,1,2,27,53,80
00656500,READING HOSPITAL SCHOOL OF HEALTH SCIENC,PA,19611-1744,Private      ,9,17,26,221,359,580
00657400,"ST LUKE'S HOSPITAL OF BETHLEHEM, PA     ",PA,18015-1065,Private      ,2,15,17,68,226,294
00657600,SEWICKLEY VALLEY HOSP SCH NRSNG         ,PA,15143-1498,Private      ,0,2,2,41,73,114
00657700,UPMC SHADYSIDE SCHOOL OF NURSING        ,PA,15232-1381,Private      ,4,29,33,126,386,512
00657800,SHARON REGIONAL SCHOOL OF NURSING       ,PA,16146-3395,Private      ,2,1,3,21,74,95
00658200,WASHINGTON HOSP SCH OF NURSING          ,PA,15301-3398,Private      ,1,5,6,71,146,217
00658202,WASHINGTON HOSP SCH OF RAD TECH         ,PA,15301-3398,Private      ,0,1,1,21,19,40
00658300,WESTERN PENN HOSP-SCH OF NURSING        ,PA,15224-1790,Private      ,0,7,7,77,126,203
00680700,COMMUNITY COLLEGE OF BEAVER COUNTY      ,PA,15061-2588,Public       ,93,195,288,1383,1801,3184
00681000,LEHIGH CARBON COMMUNITY COLLEGE         ,PA,18078-2598,Public       ,176,432,608,3224,4408,7632
00681100,LUZERNE COUNTY COMMUNITY COLLEGE        ,PA,18634-3899,Public       ,166,361,527,3613,4010,7623
00708700,ABINGTON MEM HOSP SCHL OF NURSING       ,PA,19090-1284,Private      ,5,20,25,122,378,500
00709100,EVEREST INSTITUTE                       ,PA,15222-1320,Proprietary  ,31,152,183,198,838,1036
00711000,DELAWARE COUNTY COMMUNITY COLLEGE       ,PA,19063-1094,Public       ,489,1128,1617,5895,8336,14231
00719100,NORTHAMPTON COMMUNITY COLLEGE           ,PA,18020-7599,Public       ,325,673,998,6690,7015,13705
00732955,ITT TECHNICAL INSTITUTE                 ,PA,19406-1212,Proprietary  ,42,99,141,302,604,906
00743000,ANTONELLI INST OF ART & PHOTOGRAPHY     ,PA,19038-8242,Proprietary  ,5,6,11,236,42,278
00743600,KAPLAN CAREER INSTITUTE - ICM CAMPUS    ,PA,15222-1977,Proprietary  ,39,129,168,284,1051,1335
00743700,PITTSBURGH TECHNICAL INSTITUTE          ,PA,15071-3205,Proprietary  ,54,83,137,2155,1181,3336
00746900,"HUSSIAN SCHOOL OF ART, INC.             ",PA,19106-0000,Proprietary  ,2,3,5,147,37,184
00747000,"ART INSTITUTE OF PITTSBURGH, THE        ",PA,15219-1328,Proprietary  ,798,3779,4577,5895,24982,30877
00752900,CTR ART TCH BRDYWN CMPS PRC NRS PRG     ,PA,19320-2459,Public       ,6,20,26,32,165,197
00775900,LINCOLN TECHNICAL INSTITUTE             ,PA,18104-3298,Proprietary  ,43,139,182,305,655,960
00777900,LANSDALE SCHOOL OF BUSINESS             ,PA,19454-4114,Proprietary  ,16,74,90,121,558,679
00778000,NEW CASTLE SCHOOL OF TRADES             ,PA,16143-0000,Proprietary  ,40,137,177,249,624,873
00778100,CHI INSTITUTE/RETS CAMPUS               ,PA,19008-3516,Proprietary  ,33,107,140,241,649,890
00783200,LINCOLN TECH INSTITUTE                  ,PA,19136-1595,Proprietary  ,42,74,116,504,530,1034
00783900,TRIANGLE TECH                           ,PA,15214-3897,Proprietary  ,17,39,56,223,323,546
00791200,THADDEUS STEVENS CLG OF TECHNOLOGY      ,PA,17602-0000,Public       ,24,38,62,1121,555,1676
00791600,FRANKLIN CNTY CAREER & TECH CTR-PNP     ,PA,17201-0000,Public       ,7,12,19,21,66,87
00820000,JAMESON MEMORIAL HOSP SCH NURSING       ,PA,16105-2595,Private      ,2,1,3,30,95,125
00835000,ART INSTITUTE OF PHILADELPHIA           ,PA,19103-5198,Proprietary  ,198,269,467,3824,3023,6847
00844100,ANTHEM INSTITUTE                        ,PA,19064-1243,Proprietary  ,50,159,209,234,792,1026
00856800,VET TECH INSTITUTE                      ,PA,15222-3400,Proprietary  ,16,18,34,356,193,549
00865300,JEFFERSON CO DUBOIS VOC TECH-PR NSG     ,PA,15851-0000,Public       ,0,4,4,18,54,72
00895500,PRUONTOS HAIR DESIGN INSTITUTE          ,PA,16602-0000,Proprietary  ,1,2,3,20,25,45
00915705,WYOMING TECHNICAL INSTITUTE - BLAIRSVILL,PA,15717-8060,Proprietary  ,131,151,282,1539,1200,2739
00918600,DEAN INSTITUTE OF TECHNOLOGY            ,PA,15226-1197,Proprietary  ,6,17,23,54,143,197
00944900,PENNCO TECH                             ,PA,19007-0000,Proprietary  ,52,127,179,325,577,902
00966400,EMPIRE BEAUTY SCHOOL                    ,PA,18052-5730,Proprietary  ,11,38,49,141,338,479
00966500,EMPIRE BEAUTY SCHOOL                    ,PA,17109-2210,Proprietary  ,12,37,49,99,209,308
00966600,EMPIRE BEAUTY SCHOOL                    ,PA,19605-2803,Proprietary  ,13,43,56,109,317,426
00972100,BRADFORD SCHOOL                         ,PA,15219-2602,Proprietary  ,10,13,23,633,184,817
00972300,ARIA HEALTH SCHOOL OF NURSING           ,PA,19124-2696,Private      ,9,40,49,215,464,679
00978300,GORDON PHILLIPS SCH OF BEAUTY CULT      ,PA,19135-0000,Proprietary  ,30,74,104,240,509,749
00986300,LANCASTER GENERAL COLLEGE OF NURSING AND,PA,17602-4955,Private      ,13,65,78,536,942,1478
01000600,GREATER JOHNSTOWN AREA VOC TECH SCH     ,PA,15904-0000,Public       ,3,24,27,87,322,409
01005500,CRAWFORD CNTY AREA VO-TECH PRAC NUR     ,PA,16335-0000,Public       ,1,4,5,11,41,52
01017600,WESTMORELAND COUNTY COMMUNITY CLG       ,PA,15697-1895,Public       ,131,379,510,3015,4007,7022
01038800,READING AREA COMMUNITY COLLEGE          ,PA,19603-1706,Public       ,151,577,728,2335,4742,7077
01054100,EMPIRE BEAUTY SCHOOL                    ,PA,15146-2229,Proprietary  ,20,37,57,131,279,410
01054200,EMPIRE BEAUTY SCHOOL                    ,PA,18701-0000,Proprietary  ,18,40,58,173,291,464
01054300,EMPIRE BEAUTY SCHOOL                    ,PA,17701-3914,Proprietary  ,13,22,35,94,215,309
01081400,PITTSBURGH INST MORTUARY SCIENCE        ,PA,15206-3706,Private      ,5,36,41,109,285,394
01086000,GREATER ALTOONA CAREER/TECH CENTER      ,PA,16602-0000,Public       ,0,17,17,78,246,324
01096300,GREENE COUNTY VOC-TECH SCHOOL           ,PA,15370-0000,Public       ,0,2,2,8,38,46
01097000,EMPIRE BEAUTY SCHOOL                    ,PA,17042-5209,Proprietary  ,0,12,12,29,64,93
01099800,PENNSYLVANIA INSTITUTE OF TECH          ,PA,19063-4098,Private      ,35,165,200,448,1003,1451
01102000,EMPIRE BEAUTY SCHOOL                    ,PA,17604-4335,Proprietary  ,26,59,85,163,352,515
01102100,EMPIRE BEAUTY SCHOOL                    ,PA,17402-2862,Proprietary  ,19,52,71,141,383,524
01162100,AUTOMOTIVE TRAINING CENTER              ,PA,19341-1310,Proprietary  ,74,63,137,675,386,1061
01162200,WELDER TRAINING & TESTING INST          ,PA,18109-3253,Proprietary  ,9,24,33,34,104,138
01163800,EMPIRE BEAUTY SCHOOL                    ,PA,17876-0000,Proprietary  ,6,11,17,30,69,99
01171500,SCHUYLKILL HEALTH SCHOOL OF NURSING     ,PA,17901-3692,Private      ,0,2,2,47,70,117
01191900,BEAVER FALLS BEAUTY ACADEMY             ,PA,15010-4208,Proprietary  ,2,10,12,29,54,83
01205000,ROSEDALE TECHNICAL INSTITUTE            ,PA,15205-9791,Private      ,11,37,48,217,287,504
01239300,THOMAS JEFF UNIV-CLG ALLIED HEALTH      ,PA,19107-0000,Private      ,3,40,43,260,1147,1407
01239301,THOMAS JEFFERSON UNIVERSITY - JEFFERSON ,PA,19107-5001,Private      ,10,71,81,290,2274,2564
01239303,THOMAS JEFFERSON UNIVERSITY - COLLEGE OF,PA,19107-6731,Private      ,13,64,77,279,1371,1650
01246104,LINCOLN TECHNICAL INSTITUTE             ,PA,19104-0202,Proprietary  ,60,154,214,283,735,1018
01246105,LINCOLN TECHNICAL INSTITUTE             ,PA,19116-4202,Proprietary  ,22,58,80,219,393,612
01252300,TALMUDICAL YESHIVA OF PHILA             ,PA,19131-1296,Private      ,7,0,7,39,1,40
01260500,EMPIRE BEAUTY SCHOOL                    ,PA,17331-2405,Proprietary  ,18,43,61,110,304,414
01260600,EMPIRE BEAUTY SCHOOL                    ,PA,17901-2505,Proprietary  ,28,66,94,162,435,597
01260700,EMPIRE BEAUTY SCHOOL                    ,PA,16801-5218,Proprietary  ,4,6,10,37,47,84
01292900,SOUTH HILLS BEAUTY ACADEMY              ,PA,15216-2335,Proprietary  ,10,20,30,53,92,145
01301500,GORDON PHILLIPS SCH BEAUTY CULTURE      ,PA,19102-2701,Proprietary  ,32,77,109,270,583,853
01313400,YESHIVATH BETH MOSHE                    ,PA,18505-2196,Private      ,35,0,35,38,4,42
01321400,ROXBOROUGH MEM HOSP SCH OF NURSING      ,PA,19128-0000,Proprietary  ,1,14,15,66,246,312
01326300,SOUTH HILLS SCHOOL OF BUSINESS & TECHNOL,PA,16801-4516,Proprietary  ,9,37,46,555,675,1230
02061000,VENUS BEAUTY ACADEMY                    ,PA,19079-0000,Proprietary  ,5,20,25,39,88,127
02068300,DOUGLAS SCHOOL OF BUSINESS              ,PA,15062-0000,Proprietary  ,12,21,33,269,288,557
02090200,TRIANGLE TECH                           ,PA,16502-0000,Proprietary  ,8,17,25,76,157,233
02092500,LAUREL TECHNICAL INSTITUTE              ,PA,16146-0000,Proprietary  ,11,27,38,142,362,504
02092502,BUSINESS INSTITUTE OF PENNSYLVANIA      ,PA,16335-0000,Proprietary  ,1,8,9,7,26,33
02104003,HARRIS SCHOOL OF BUSINESS - UPPER DARBY ,PA,19082-2528,Proprietary  ,0,3,3,3,8,11
02107300,PENNSYLVANIA ACADEMY OF FINE ARTS       ,PA,19102-1424,Private      ,10,14,24,255,316,571
02112200,GREAT LAKES INSTITUTE OF TECHNOLOGY     ,PA,16509-0000,Proprietary  ,24,62,86,284,476,760
02114200,JOHNSON COLLEGE                         ,PA,18508-0000,Private      ,9,17,26,456,311,767
02116001,SANFORD-BROWN INSTITUTE - TREVOSE       ,PA,19053-4700,Proprietary  ,31,115,146,367,1287,1654
02118000,LEVITTOWN BEAUTY ACADEMY LLC            ,PA,19054-1713,Proprietary  ,5,14,19,23,47,70
02119300,PA ACAD OF COSMETOLOGY ARTS & SCI       ,PA,15904-0000,Proprietary  ,9,11,20,54,70,124
02120800,"YORKTOWNE BUSINESS INSTITUTE, INC.      ",PA,17404-0000,Proprietary  ,8,25,33,103,318,421
02127400,YORK TECHNICAL INSTITUTE                ,PA,17402-0000,Proprietary  ,90,246,336,1220,2046,3266
02129000,TRIANGLE TECH                           ,PA,15601-0000,Proprietary  ,38,35,73,282,263,545
02129001,TRIANGLE TECH - BUSINESS CAREERS INSTITU,PA,15601-3304,Proprietary  ,0,1,1,3,7,10
02144000,"VISION ACADEMY, THE                     ",PA,18103-0000,Proprietary  ,9,24,33,35,99,134
02149000,EMPIRE BEAUTY SCHOOL                    ,PA,19341-2804,Proprietary  ,24,47,71,193,384,577
02151500,CENTRAL SUSQUEHANNA LPN CENTER          ,PA,17837-8818,Public       ,3,12,15,41,166,207
02152105,ACADEMY OF COURT REPORTING AND TECHNOLOG,PA,15222-1710,Proprietary  ,0,1,1,11,47,58
02153500,OAKBRIDGE ACADEMY OF ARTS               ,PA,15068-0000,Proprietary  ,2,1,3,81,24,105
02158300,JUNIATA-MIFFLIN CO AREA VOC TECH        ,PA,17044-0000,Public       ,0,3,3,19,78,97
02161400,NORTHEASTERN HOSP SCH OF NRSG           ,PA,19134-0000,Private      ,1,19,20,54,179,233
02169600,CLEARFIELD CTY CAREER AND TECH CNTR     ,PA,16830-0000,Public       ,1,4,5,39,82,121
02174400,TRIANGLE TECH                           ,PA,15801-0000,Proprietary  ,37,27,64,278,273,551
02178900,ACADEMY OF HAIR DESIGN                  ,PA,18202-1465,Proprietary  ,22,54,76,51,114,165
02183000,ORLEANS TECHNICAL INSTITUTE             ,PA,19111-0000,Private      ,39,90,129,214,572,786
02192800,WALNUT HILL COLLEGE                     ,PA,19104-0000,Proprietary  ,21,54,75,485,382,867
02202300,SANFORD-BROWN INSTITUTE                 ,PA,15219-1907,Proprietary  ,30,145,175,323,1148,1471
02202301,SANFORD-BROWN INSTITUTE                 ,PA,15146-2141,Proprietary  ,21,63,84,149,552,701
02203900,ERIE INSTITUTE OF TECHNOLOGY            ,PA,16565-1002,Proprietary  ,11,44,55,117,300,417
02206200,"VISION ACADEMY, THE                     ",PA,19002-0000,Proprietary  ,5,18,23,52,88,140
02206300,STROUDSBURG SCHOOL OF COSMETOLOGY       ,PA,18360-0000,Proprietary  ,9,13,22,32,42,74
02212700,LANCASTER SCHOOL OF COSMETOLOGY         ,PA,17602-0000,Proprietary  ,4,21,25,65,160,225
02234200,ACADEMY OF MEDICAL ARTS & BUSINESS      ,PA,17112-0000,Proprietary  ,20,57,77,221,428,649
02251200,SCHUYLKILL COUNTY AREA VOC TECH SCH     ,PA,17931-0000,Public       ,5,22,27,33,99,132
02251202,SCHUYLKILL COUNTY AREA VOC TECH SCH     ,PA,17931-0000,Public       ,1,3,4,3,20,23
02253900,BERKS TECHNICAL INSTITUTE               ,PA,19610-0000,Proprietary  ,44,91,135,762,981,1743
02255200,PENNSYLVANIA SCHOOL OF BUSINESS         ,PA,18101-1604,Proprietary  ,16,69,85,114,581,695
02269900,PENNSYLVANIA COLLEGE OF ART & DESIGN    ,PA,17603-3528,Private      ,8,6,14,437,98,535
02270500,BUCKS COUNTY SCHOOL OF BEAUTY CULT      ,PA,19053-0000,Proprietary  ,8,10,18,40,54,94
02273400,RECONSTRUCTIONIST RABBINICAL COLLEG     ,PA,19095-0000,Private      ,0,3,3,0,32,32
02276600,HANOVER PUBLIC SCH DIST PRAC NURSG      ,PA,17331-0000,Public       ,1,8,9,9,55,64
02282500,LENAPE SCHOOL OF PRACTICAL NURSING      ,PA,16226-0000,Public       ,8,25,33,38,170,208
02288800,EMPIRE BEAUTY SCHOOL                    ,PA,18974-4508,Proprietary  ,15,52,67,148,376,524
02289500,PACE INSTITUTE                          ,PA,19601-0000,Proprietary  ,5,28,33,65,286,351
02289600,CONSOLIDATED SCHOOL OF BUSINESS         ,PA,17404-0000,Proprietary  ,4,36,40,33,207,240
02289700,ACADEMY OF CREATIVE HAIR DESIGN         ,PA,18702-0000,Proprietary  ,7,37,44,62,170,232
02289800,CHI INSTITUTE - FRANKLIN MILLS          ,PA,19154-0000,Proprietary  ,51,171,222,399,1030,1429
02290400,"ALTOONA BEAUTY SCHOOL, INC              ",PA,16602-0000,Proprietary  ,3,10,13,42,81,123
02292700,LANSDALE SCHOOL OF COSMETOLOGY          ,PA,19446-0000,Proprietary  ,2,4,6,32,40,72
02299300,TRINITY EPISCOPAL SCHOOL MINISTRY       ,PA,15003-0000,Private      ,0,7,7,1,117,118
02301300,PRISM CAREER INSTITUTE                  ,PA,19082-2448,Proprietary  ,28,94,122,205,942,1147
02304400,YTI CAREER INSTITUTE - MECHANICSBURG    ,PA,17055-0000,Proprietary  ,11,40,51,142,323,465
02306200,VENANGO COUNTY AREA VOC TECH SCHOOL     ,PA,16301-0000,Public       ,0,3,3,18,71,89
02310800,LANCASTER COUNTY CAREER & TECH CTR      ,PA,17584-0000,Public       ,16,61,77,151,486,637
02323000,BIBLICAL THEOLOGICAL SEMINARY           ,PA,19440-2421,Private      ,0,8,8,2,116,118
02330300,LEBANON CO CAREER & TECHNOLOGY CTR      ,PA,17042-0000,Public       ,0,9,9,39,195,234
02330600,PENNSYLVANIA GUNSMITH SCHOOL            ,PA,15202-0000,Proprietary  ,2,13,15,72,88,160
02350100,WESTERN AREA CAREER & TECHNOLOGY CT     ,PA,15317-0000,Public       ,2,9,11,27,125,152
02350200,INDIANA COUNTY TECH CTR SCH PR NSG      ,PA,15701-1465,Public       ,3,8,11,74,129,203
02353100,NORTHERN TIER CAREER CENTER             ,PA,18848-0000,Public       ,0,1,1,16,50,66
02362300,MERCER COUNTY AREA VOC TECH SCHOOL      ,PA,16137-0000,Public       ,1,5,6,8,88,96
02492500,DELAWARE VLY ACAD MED DNTL ASSTS        ,PA,19114-0000,Proprietary  ,0,0,0,9,34,43
02492600,EASTERN CTR ARTS AND TECH PR NSG        ,PA,19090-0000,Public       ,2,27,29,25,160,185
02495500,ALL-STATE CAREER SCHOOL                 ,PA,19029-0000,Proprietary  ,52,220,272,224,938,1162
02529800,WILKES BARRE AREA CAREER AND TECHNICAL C,PA,18705-0000,Public       ,4,14,18,79,199,278
02536600,COMMONWEALTH TECH INSTIT @ HIRAM G      ,PA,15905-0000,Public       ,63,17,80,248,121,369
02544300,BUTLER BEAUTY SCHOOL                    ,PA,16001-0000,Proprietary  ,7,21,28,50,115,165
02545000,LAWRENCE COUNTY CAREER AND TECHNICAL CEN,PA,16101-0000,Public       ,2,8,10,16,82,98
02546200,LAUREL BUSINESS INSTITUTE               ,PA,15401-0877,Proprietary  ,6,13,19,161,271,432
02550000,CLARION CO AREA VOC-TECH PRAC NRSG      ,PA,16254-4637,Public       ,7,13,20,35,92,127
02554500,HAZLETON AREA CAREER CENTER PRACTICAL NU,PA,18201-0000,Public       ,1,4,5,17,51,68
02557800,ART INSTITUTE OF YORK (THE) - PENNSYLVAN,PA,17402-9012,Proprietary  ,31,33,64,727,303,1030
02566400,ALBERT EINSTEIN MED CTR DEPT DNTL       ,PA,19141-3098,Private      ,2,13,15,24,83,107
02574800,PENNSYLVANIA INSTITUTE OF TAXIDERMY     ,PA,15931-0000,Proprietary  ,0,2,2,14,28,42
02609500,CAREER TRAINING ACADEMY                 ,PA,15068-6308,Proprietary  ,8,36,44,60,225,285
02609501,CAREER TRAINING ACADEMY                 ,PA,15146-0000,Proprietary  ,0,4,4,3,13,16
02616100,JEAN MADELINE ED CTR FOR COSM           ,PA,19147-1542,Proprietary  ,28,64,92,329,438,767
03006800,LE CORDON BLEU INSTITUTE OF CULINARY ART,PA,15222-3511,Proprietary  ,8,25,33,314,364,678
03010800,TRI-STATE BUSINESS INSTITUTE            ,PA,16506-1013,Proprietary  ,81,348,429,805,2799,3604
03011500,FORTIS INSTITUTE                        ,PA,18702-0000,Proprietary  ,16,48,64,123,253,376
03011600,FORTIS INSTITUTE                        ,PA,18509-2903,Proprietary  ,19,72,91,163,405,568
03029900,CONSOLIDATED SCHOOL OF BUSINESS         ,PA,17603-2389,Proprietary  ,4,20,24,57,165,222
03031600,DPT BUSINESS SCHOOL                     ,PA,19116-3961,Proprietary  ,13,124,137,69,430,499
03031601,DPT BUSINESS SCHOOL                     ,PA,19106-0000,Proprietary  ,5,35,40,55,194,249
03067000,ANTONELLI MEDICAL & PROF INST           ,PA,19464-9244,Proprietary  ,3,7,10,25,77,102
03072400,ALL-STATE CAREER SCHOOL                 ,PA,15122-0000,Proprietary  ,20,74,94,64,317,381
03072600,DCI CAREER INSTITUTE                    ,PA,15061-2307,Proprietary  ,6,30,36,30,134,164
03081900,YTI CAREER INSTITUTE - ALTOONA          ,PA,16602-4457,Proprietary  ,18,53,71,196,388,584
03090800,LAKE ERIE COLL OF OSTEOPATHIC MED       ,PA,16509-0000,Private      ,1,16,17,70,3491,3561
03098600,CAREER TECH CTR OF LACKAWANNA CNTY      ,PA,18508-0000,Public       ,3,16,19,63,179,242
03101400,FORBES ROAD CAREER & TECHNOLOGY CTR     ,PA,15146-1550,Public       ,1,6,7,14,26,40
03101500,BIDWELL TRAINING CENTER                 ,PA,15233-2233,Private      ,4,43,47,21,91,112
03103300,JNA INSTITUTE OF CULINARY ARTS          ,PA,19146-3119,Proprietary  ,11,26,37,67,151,218
03109100,METROPOLITAN CAREER CENTER              ,PA,19144-0000,Private      ,7,29,36,37,174,211
03110700,AVIATION INSTITUTE OF MAINTENANCE       ,PA,19114-1017,Proprietary  ,17,105,122,153,596,749
03120400,REGIONAL CAREER & TECHNICAL CENTER      ,PA,16509-4699,Public       ,0,2,2,2,17,19
03128400,DELAWARE COUNTY TECHNICAL SCHOOL        ,PA,19008-1928,Public       ,4,19,23,47,150,197
03180400,PENNSYLVANIA HIGHLANDS COMMUNITY COLLEGE,PA,15904-2927,Public       ,49,115,164,890,876,1766
03236400,LT INTERNATIONAL BEAUTY SCHOOL          ,PA,19130-2235,Proprietary  ,6,40,46,15,101,116
03353300,ACADEMY OF VOCAL ARTS                   ,PA,19103-6685,Private      ,2,3,5,19,68,87
03380301,STAR CAREER ACADEMY - STAR PHILADELPHIA ,PA,19114-2204,Proprietary  ,61,223,284,231,877,1108
03380304,STAR CAREER ACADEMY - STAR NORRISTOWN   ,PA,19403-2422,Proprietary  ,9,38,47,50,177,227
03439400,NAWCC SCHOOL OF HOROLOGY                ,PA,17512-2130,Private      ,0,1,1,4,13,17
03535300,HUNTINGDON COUNTY CAREER AND TECHNO     ,PA,17060-0905,Public       ,0,1,1,10,42,52
03561400,SUSQUEHANNA COUNTY CAREER & TECHNOL     ,PA,18816-0100,Public       ,0,0,0,5,22,27
03766300,PENNSYLVANIA SCHOOL OF MUSCLE THERAPY   ,PA,19406-3101,Proprietary  ,5,42,47,44,189,233
03781300,PRINCETON INFORMATION TECHNOLOGY CENTER ,PA,19038-4535,Proprietary  ,6,47,53,42,270,312
03899300,CALVARY BAPTIST THEOLOGICAL SEMINARY    ,PA,19446-4718,Private      ,0,2,2,0,56,56
03923300,PRECISION MANUFACTURING INSTITUTE       ,PA,16335-8380,Private      ,1,9,10,11,38,49
03948300,HARRISBURG UNIVERSITY OF SCIENCE AND TEC,PA,17101-2116,Private      ,5,16,21,433,255,688
03949300,WON INSTITUTE OF GRADUATE STUDIES       ,PA,19038-4535,Private      ,0,4,4,0,49,49
03950500,NORTHWEST REGIONAL TECHNOLOGY INSTITUTE ,PA,16508-2820,Proprietary  ,1,16,17,6,68,74
03952300,NATIONAL MASSAGE THERAPY INSTITUTE      ,PA,19116-3965,Proprietary  ,42,144,186,191,626,817
04024300,EDUCATION AND TECHNOLOGY INSTITUTE      ,PA,15601-9214,Private      ,0,12,12,5,39,44
04118000,BYZANTINE CATHOLIC SEMINARY OF SAINTS CY,PA,15214-2229,Private      ,0,0,0,0,7,7
04127500,CAREER DEVELOPMENT & EMPLOYMENT         ,PA,18702-5253,Proprietary  ,2,11,13,10,58,68
04137100,KIMBERLY'S BEAUTY SCHOOL                ,PA,19134-0000,Proprietary  ,0,0,0,8,19,27
04138300,INTERNATIONAL BEAUTY ACADEMY            ,PA,19149-2710,Proprietary  ,4,10,14,18,59,77
04145800,PULSE BEAUTY ACADEMY A PAUL MITCHELL PAR,PA,19335-0000,Proprietary  ,6,10,16,73,77,150
04149800,SOMERSET COUNTY TECHNOLOGY CENTER       ,PA,15501-1444,Public       ,0,8,8,13,50,63
04151700,BELLA CAPELLI ACADEMY                   ,PA,15146-2388,Proprietary  ,12,8,20,76,60,136
04155100,INSTITUTE OF MEDICAL CAREERS            ,PA,15235-3718,Proprietary  ,2,12,14,18,62,80
04158000,METRO BEAUTY ACADEMY                    ,PA,18106-9693,Proprietary  ,16,29,45,104,128,232
04164900,BARONE BEAUTY ACADEMY                   ,PA,17701-5316,Proprietary  ,4,6,10,25,42,67
04167200,COMMONWEALTH MEDICAL COLLEGE (THE)      ,PA,18503-3251,Private      ,0,9,9,8,493,501
04175900,LEWISTOWN HOSPITAL SCHOOL OF NURSING    ,PA,17044-1167,Private      ,2,1,3,4,8,12
00153410,EVEREST UNIVERSITY - EVEREST COLLEGE - M,WI,53212-4006,Proprietary  ,45,258,303,106,502,608
00267813,BRYANT & STRATTON COLLEGE - MIL DOWNTOWN,WI,53203-2608,Proprietary  ,58,313,371,805,3259,4064
00383200,ALVERNO COLLEGE                         ,WI,53234-3922,Private      ,43,167,210,1464,2497,3961
00383500,BELOIT COLLEGE                          ,WI,53511-5595,Private      ,18,15,33,1998,155,2153
00383700,CARDINAL STRITCH UNIVERSITY             ,WI,53217-9884,Private      ,33,508,541,1136,5001,6137
00383800,CARROLL UNIVERSITY                      ,WI,53186-5593,Private      ,43,59,102,3715,976,4691
00383900,CARTHAGE COLLEGE                        ,WI,53141-0000,Private      ,90,76,166,4864,948,5812
00384000,WESTERN TECHNICAL COLLEGE               ,WI,54601-0908,Public       ,148,350,498,2215,2943,5158
00384200,CONCORDIA UNIVERSITY WISCONSIN          ,WI,53097-2402,Private      ,37,468,505,2875,4514,7389
00384800,EDGEWOOD COLLEGE                        ,WI,53711-1958,Private      ,36,116,152,1737,1334,3071
00385000,SILVER LAKE COLLEGE                     ,WI,54220-9319,Private      ,7,42,49,195,440,635
00385400,LAKELAND COLLEGE                        ,WI,53082-0000,Private      ,24,181,205,1126,2246,3372
00385600,LAWRENCE UNIVERSITY                     ,WI,54912-0599,Private      ,36,16,52,2447,158,2605
00386100,MARIAN UNIVERSITY                       ,WI,54935-4699,Private      ,25,107,132,1448,1320,2768
00386300,MARQUETTE UNIVERSITY                    ,WI,53201-1881,Private      ,202,177,379,15019,4715,19734
00386600,MILWAUKEE AREA TECH COLLEGE             ,WI,53233-1443,Public       ,740,2637,3377,7205,19743,26948
00386800,MILWAUKEE SCHOOL OF ENGINEERING         ,WI,53202-3109,Private      ,28,64,92,2786,874,3660
00386900,MOUNT MARY COLLEGE                      ,WI,53222-4597,Private      ,12,92,104,865,1597,2462
00387400,NASHOTAH HOUSE                          ,WI,53058-0000,Private      ,0,4,4,0,51,51
00387500,NORTHLAND COLLEGE                       ,WI,54806-3999,Private      ,18,9,27,676,134,810
00388400,RIPON COLLEGE                           ,WI,54971-0248,Private      ,13,6,19,1415,76,1491
00389200,ST. NORBERT COLLEGE                     ,WI,54115-2099,Private      ,32,5,37,2655,145,2800
00389500,UNIVERSITY OF WISCONSIN-MADISON         ,WI,53715-1382,Public       ,404,372,776,24982,11886,36868
00389600,UNIVERSITY OF WISCONSIN-MILWAUKEE       ,WI,53201-3165,Public       ,534,820,1354,18988,13652,32640
00389700,UNIVERSITY OF WISCONSIN COLLEGES        ,WI,53708-8680,Public       ,151,231,382,4044,2616,6660
00389701,UNIVERSITY OF WISCONSIN-BARABOO         ,WI,53913-1098,Public       ,14,31,45,378,237,615
00389702,UNIVERSITY OF WISCONSIN-BARRON          ,WI,54868-2497,Public       ,11,25,36,369,212,581
00389703,UNIVERSITY OF WISCONSIN-FOND DU LAC     ,WI,54935-2998,Public       ,20,26,46,498,306,804
00389704,UNIVERSITY OF WISCONSIN-FOX VALLEY      ,WI,54952-1297,Public       ,34,38,72,895,530,1425
00389705,UNIVERSITY OF WISCONSIN-MANITOWOC       ,WI,54220-6699,Public       ,12,23,35,353,159,512
00389706,UNIVERSITY OF WISCONSIN-MARATHON        ,WI,54401-5396,Public       ,17,40,57,834,417,1251
00389707,UNIVERSITY OF WISCONSIN-MARINETTE       ,WI,54143-4299,Public       ,6,22,28,238,153,391
00389708,UNIVERSITY OF WISCONSIN-MARSHFIELD      ,WI,54449-3310,Public       ,10,20,30,321,182,503
00389709,UNIVERSITY OF WISCONSIN-RICHLAND        ,WI,53581-1399,Public       ,10,9,19,299,136,435
00389710,UNIVERSITY OF WISCONSIN COLLEGES - ROCK ,WI,53546-5699,Public       ,28,42,70,688,553,1241
00389711,UNIVERSITY OF WISCONSIN-SHEBOYGAN       ,WI,53081-4789,Public       ,18,33,51,552,322,874
00389712,UNIVERSITY OF WISCONSIN-WASHINGTON      ,WI,53095-3699,Public       ,22,24,46,499,293,792
00389713,UNIVERSITY OF WISCONSIN-WAUKESHA        ,WI,53188-2799,Public       ,50,55,105,1222,591,1813
00389900,UNIVERSITY OF WISCONSIN-GREEN BAY       ,WI,54311-7001,Public       ,75,171,246,4757,2639,7396
00391100,VITERBO UNIVERSITY                      ,WI,54601-4777,Private      ,27,100,127,1815,1368,3183
00391500,UNIVERSITY OF WISCONSIN-STOUT           ,WI,54751-0790,Public       ,139,178,317,6340,2468,8808
00391700,UNIVERSITY OF WISCONSIN-EAU CLAIRE      ,WI,54702-4004,Public       ,138,118,256,9079,2071,11150
00391900,UNIVERSITY OF WISCONSIN-LA CROSSE       ,WI,54601-3742,Public       ,154,99,253,8463,1908,10371
00392000,UNIVERSITY OF WISCONSIN-OSHKOSH         ,WI,54901-8604,Public       ,182,220,402,8791,3676,12467
00392100,UNIVERSITY OF WISCONSIN-PLATTEVILLE     ,WI,53818-3099,Public       ,99,150,249,6582,1885,8467
00392300,UNIVERSITY OF WISCONSIN-RIVER FALLS     ,WI,54022-5013,Public       ,91,80,171,5375,1630,7005
00392400,UNIVERSITY OF WISCONSIN-STEVENS POINT   ,WI,54481-3871,Public       ,152,109,261,8184,2140,10324
00392500,UNIVERSITY OF WISCONSIN-SUPERIOR        ,WI,54880-2898,Public       ,35,115,150,1747,1480,3227
00392600,UNIVERSITY OF WISCONSIN-WHITEWATER      ,WI,53190-1792,Public       ,183,179,362,9494,2941,12435
00400700,MADISON AREA TECHNICAL COLLEGE          ,WI,53704-2599,Public       ,336,941,1277,5039,8916,13955
00501500,UNIVERSITY OF WISCONSIN-PARKSIDE        ,WI,53141-2000,Public       ,124,180,304,3764,2578,6342
00529400,WAUKESHA COUNTY TECHNICAL COLLEGE       ,WI,53072-4696,Public       ,132,370,502,1775,3607,5382
00530100,NORTHEAST WISCONSIN TECHNICAL COLLEGE   ,WI,54307-9042,Public       ,192,705,897,2917,6105,9022
00530400,CHIPPEWA VALLEY TECHNICAL COLLEGE       ,WI,54701-6162,Public       ,165,390,555,2656,4037,6693
00538000,MID-STATE TECHNICAL COLLEGE             ,WI,54494-5512,Public       ,76,226,302,984,2228,3212
00538400,NICOLET AREA TECHNICAL COLLEGE          ,WI,54501-0000,Public       ,30,137,167,584,1074,1658
00538700,NORTHCENTRAL TECHNICAL COLLEGE          ,WI,54401-1899,Public       ,96,357,453,1224,3290,4514
00538900,GATEWAY TECHNICAL COLLEGE               ,WI,53144-1690,Public       ,295,1089,1384,2635,9272,11907
00539000,BLACKHAWK TECHNICAL COLLEGE             ,WI,53547-5009,Public       ,88,417,505,1110,3487,4597
00612601,ST LUKE'S MEDCL CTR SCHL RAD TECH       ,WI,53215-4330,Private      ,1,1,2,22,74,96
00663900,BELLIN COLLEGE                          ,WI,54305-0000,Private      ,5,26,31,275,224,499
00732934,ITT TECHNICAL INSTITUTE                 ,WI,53220-4612,Proprietary  ,123,498,621,861,2917,3778
00766900,SOUTHWEST WISCONSIN TECH COLLEGE        ,WI,53809-0000,Public       ,22,78,100,676,917,1593
00821700,WISCONSIN COLLEGE OF COSMETOLOGY        ,WI,54324-0257,Proprietary  ,6,11,17,96,121,217
00869405,RASMUSSEN COLLEGE - WAUSAU              ,WI,54401-7804,Proprietary  ,15,100,115,133,855,988
00869414,RASMUSSEN COLLEGE - GREEN BAY           ,WI,54303-2349,Proprietary  ,21,93,114,196,1056,1252
00869419,RASMUSSEN COLLEGE - APPLETON            ,WI,54915-7305,Proprietary  ,9,72,81,59,459,518
00919400,LAKESHORE TECHNICAL COLLEGE             ,WI,53015-1412,Public       ,56,248,304,740,2166,2906
00925600,MORAINE PARK TECHNICAL COLLEGE          ,WI,54936-0000,Public       ,81,331,412,1115,3240,4355
00941900,STATE CLG OF BEAUTY CULT-WAUSAU         ,WI,54403-4667,Proprietary  ,4,13,17,50,78,128
00962100,HERZING UNIVERSITY                      ,WI,53718-4236,Proprietary  ,185,1262,1447,1670,11670,13340
00974400,FOX VALLEY TECHNICAL COLLEGE            ,WI,54913-0000,Public       ,249,786,1035,3253,6382,9635
01091300,MADISON MEDIA INSTITUTE                 ,WI,53718-6787,Proprietary  ,48,73,121,638,541,1179
01148400,ADVANCED INSTITUTE OF HAIR DESIGN       ,WI,53225-0000,Proprietary  ,26,46,72,209,243,452
01182400,WISCONSIN INDIANHEAD TECH CLG WITC      ,WI,54871-9300,Public       ,80,354,434,1078,2758,3836
02077100,MILWAUKEE INST OF ART & DESIGN          ,WI,53202-0000,Private      ,25,30,55,1007,298,1305
02078000,SACRED HEART SCHOOL OF THEOLOGY         ,WI,53130-0000,Private      ,0,0,0,1,6,7
02136600,WISCONSIN LUTHERAN COLLEGE              ,WI,53226-0000,Private      ,18,15,33,1051,242,1293
02201803,KAPLAN COLLEGE - MILWAUKEE              ,WI,53212-3939,Proprietary  ,22,122,144,172,897,1069
02239204,ANTHEM COLLEGE - BROOKFIELD             ,WI,53005-4207,Proprietary  ,2,6,8,19,59,78
02271300,WI SCH OF PROFESSIONAL PSYCHOLOGY       ,WI,53225-0000,Private      ,1,10,11,14,122,136
02317200,MARANATHA BAPTIST BIBLE COLLEGE         ,WI,53094-0000,Private      ,49,15,64,881,160,1041
02324700,EMPIRE BEAUTY SCHOOL                    ,WI,53717-0000,Proprietary  ,9,29,38,59,188,247
02332100,EMPIRE BEAUTY SCHOOL                    ,WI,54220-0000,Proprietary  ,13,37,50,108,335,443
02332101,EMPIRE BEAUTY SCHOOL - APPLETON         ,WI,54914-4644,Proprietary  ,3,2,5,15,39,54
02453500,MEDICAL COLLEGE OF WISCONSIN            ,WI,53226-0000,Private      ,6,23,29,63,1241,1304
02494300,GILL-TECH ACADEMY OF HAIR DESIGN        ,WI,54911-0000,Proprietary  ,12,6,18,88,82,170
02532200,LAC COURTE OREILLES OJIBWA CMTY CLG     ,WI,54843-0000,Public       ,6,39,45,64,394,458
03007400,LAKESIDE SCHOOL OF MASSAGE THERAPY      ,WI,53212-3969,Private      ,0,9,9,24,86,110
03061200,MIDWEST COLLEGE OF ORIENTAL MEDICINE    ,WI,53403-9747,Proprietary  ,2,33,35,10,215,225
03077600,EMPIRE BEAUTY SCHOOL                    ,WI,54304-4838,Proprietary  ,20,71,91,191,456,647
03125100,COLLEGE OF MENOMINEE NATION             ,WI,54135-0000,Private      ,19,76,95,150,652,802
03125102,COLLEGE OF  THE MENOMINEE NATION - GREEN,WI,54304-4964,Private      ,3,15,18,29,110,139
03220300,"SALON PROFESSIONAL ACADEMY, THE         ",WI,54701-7633,Proprietary  ,6,11,17,79,116,195
03309300,MONTESSORI INSTITUTE OF MILWAUKEE       ,WI,53207-0000,Private      ,1,1,2,7,29,36
03808300,INSTITUTE OF BEAUTY AND WELLNESS (THE)  ,WI,53202-5715,Proprietary  ,16,36,52,123,225,348
03822300,FOUR SEASONS SALON AND COSMETOLOGY SCHOO,WI,53566-0000,Proprietary  ,1,11,12,24,66,90
03872500,NORTHLAND INTERNATIONAL UNIVERSITY      ,WI,54119-9285,Private      ,23,5,28,486,71,557
03925300,BLUE SKY SCHOOL OF PROFESSIONAL MASSAGE ,WI,53024-9699,Private      ,0,20,20,28,155,183
04117400,MILWAUKEE CAREER COLLEGE                ,WI,53222-4305,Proprietary  ,24,83,107,163,552,715
04118600,ACADEMY OF COSMETOLOGY                  ,WI,53548-3307,Proprietary  ,6,25,31,31,97,128
04124800,VISIONS IN HAIR DESIGN INSTITUTE OF COSM,WI,53210-1120,Proprietary  ,1,7,8,23,56,79
04132600,WISCONSIN ACADEMY (THE)                 ,WI,54157-1726,Proprietary  ,1,4,5,12,40,52
04137900,PC PROSCHOOLS                           ,WI,53005-6003,Proprietary  ,18,151,169,63,484,547
04138200,SALON PROFESSIONAL ACADEMY (THE)        ,WI,54914-3921,Proprietary  ,3,6,9,53,58,111
04157700,SALON PROFESSIONAL ACADEMY (THE)        ,WI,54650-8699,Proprietary  ,1,19,20,75,84,159
04159400,COLUMBIA COLLEGE OF NURSING             ,WI,53211-2952,Private      ,6,21,27,11,40,51
04165300,ACADEMY WAUKESHA (THE)                  ,WI,53072-5524,Proprietary  ,11,26,37,110,175,285
04179200,ADVANCED COLLEGE OF COSMETOLOGY         ,WI,53963-0000,Proprietary  ,2,4,6,31,40,71
04182100,FIRST CLASS COSMETOLOGY SCHOOL          ,WI,52511-0000,Proprietary  ,4,11,15,15,55,70
04183600,SALON PROFESSIONAL ACADEMY OF KENOSHA (T,WI,53142-4950,Proprietary  ,11,28,39,85,173,258
04202800,PANACHE ACADEMY OF BEAUTY               ,WI,53913-2596,Proprietary  ,7,16,23,7,16,23
00145964,STRAYER UNIVERSITY -GARNER              ,NC,27603-0000,Proprietary  ,0,0,0,0,1,1
00290500,NORTH CAROLINA A&T STATE UNIV           ,NC,27411-0001,Public       ,342,532,874,14028,7243,21271
00290600,APPALACHIAN STATE UNIVERSITY            ,NC,28608-2059,Public       ,432,300,732,17107,4917,22024
00290700,UNIVERSITY OF NC AT ASHEVILLE           ,NC,28804-3299,Public       ,123,165,288,4137,1975,6112
00290800,BARTON COLLEGE                          ,NC,27893-3104,Private      ,35,82,117,1622,1013,2635
00291000,BELMONT ABBEY COLLEGE                   ,NC,28012-1802,Private      ,22,115,137,1311,1431,2742
00291100,BENNETT COLLEGE                         ,NC,27401-3239,Private      ,31,67,98,1167,609,1776
00291200,BREVARD COLLEGE                         ,NC,28712-3306,Private      ,24,22,46,1016,200,1216
00291300,CAMPBELL UNIVERSITY                     ,NC,27506-0036,Private      ,149,281,430,5197,3893,9090
00291400,CATAWBA COLLEGE                         ,NC,28144-2488,Private      ,45,70,115,1688,755,2443
00291500,CENTRAL PIEDMONT COMMUNITY COLLEGE      ,NC,28204-2297,Public       ,932,2793,3725,9340,20291,29631
00291600,CHOWAN UNIVERSITY                       ,NC,27855-1850,Private      ,45,41,86,2243,523,2766
00291700,COLLEGE OF THE ALBEMARLE                ,NC,27909-2327,Public       ,92,250,342,995,2070,3065
00291800,DAVIDSON COLLEGE                        ,NC,28035-7157,Private      ,72,24,96,3328,229,3557
00291900,DAVIDSON COUNTY COMMUNITY COLLEGE       ,NC,27293-0000,Public       ,172,612,784,1789,4794,6583
00292000,DUKE UNIVERSITY                         ,NC,27708-0397,Private      ,363,137,500,18263,2634,20897
00292001,DUKE UNIV - SCHOOL OF MEDICINE          ,NC,27710-0000,Private      ,18,32,50,178,1389,1567
00292002,DUKE UNIV - SCHOOL OF LAW               ,NC,27708-0000,Private      ,9,15,24,56,2630,2686
00292003,DUKE UNIV - GRAD SCH ARTS & SCIENCE     ,NC,27708-0000,Private      ,8,37,45,80,731,811
00292004,DUKE UNIV - FUQUA SCH OF BUSINESS       ,NC,27708-0000,Private      ,5,38,43,64,1319,1383
00292005,DUKE UNIV/NICHOLAS SCH OF ENVIRON.      ,NC,27708-0000,Private      ,2,8,10,33,338,371
00292006,DUKE UNIV - DIVINITY SCHOOL             ,NC,27708-0000,Private      ,7,16,23,119,716,835
00292007,DUKE UNIV - SCHOOL OF NURSING           ,NC,27710-0000,Private      ,11,70,81,146,1150,1296
00292010,DUKE UNIVERSITY - SCHOOL OF PUBLIC POLIC,NC,27708-0239,Private      ,7,11,18,61,361,422
00292300,EAST CAROLINA UNIVERSITY                ,NC,27858-1818,Public       ,572,883,1455,23244,13472,36716
00292600,ELIZABETH CITY STATE UNIVERSITY         ,NC,27909-7806,Public       ,82,118,200,3833,1837,5670
00292700,ELON UNIVERSITY                         ,NC,27244-2010,Private      ,120,61,181,6875,1389,8264
00292800,FAYETTEVILLE STATE UNIVERSITY           ,NC,28301-4298,Public       ,175,552,727,4980,7337,12317
00292900,GARDNER-WEBB UNIVERSITY                 ,NC,28017-0000,Private      ,78,507,585,3055,3787,6842
00293000,GREENSBORO COLLEGE                      ,NC,27401-1875,Private      ,71,131,202,1815,1366,3181
00293100,GUILFORD COLLEGE                        ,NC,27410-4171,Private      ,92,310,402,2978,3308,6286
00293300,HIGH POINT UNIVERSITY                   ,NC,27262-4221,Private      ,126,88,214,5326,1252,6578
00293400,ISOTHERMAL COMMUNITY COLLEGE            ,NC,28160-0804,Public       ,111,309,420,1008,2135,3143
00293500,JOHN WESLEY COLLEGE                     ,NC,27265-0000,Private      ,6,36,42,49,247,296
00293600,JOHNSON C SMITH UNIVERSITY              ,NC,28216-5398,Private      ,107,178,285,3020,1730,4750
00293700,KING'S COLLEGE-CHARLOTTE                ,NC,28204-2435,Proprietary  ,37,70,107,776,754,1530
00293900,LEES MCRAE COLLEGE                      ,NC,28604-0000,Private      ,19,10,29,1077,338,1415
00294000,LENOIR COMMUNITY COLLEGE                ,NC,28502-0188,Public       ,77,326,403,1093,2793,3886
00294100,LENOIR-RHYNE UNIVERSITY                 ,NC,28603-0000,Private      ,62,80,142,2834,969,3803
00294200,LIVINGSTONE COLLEGE                     ,NC,28144-5298,Private      ,36,37,73,1707,584,2291
00294300,LOUISBURG COLLEGE                       ,NC,27549-2398,Private      ,54,22,76,1250,255,1505
00294400,MARS HILL COLLEGE                       ,NC,28754-0000,Private      ,45,52,97,1906,602,2508
00294500,MEREDITH COLLEGE                        ,NC,27607-5298,Private      ,49,84,133,1981,1075,3056
00294600,METHODIST UNIVERSITY                    ,NC,28311-1420,Private      ,50,160,210,2748,1981,4729
00294700,MITCHELL COMMUNITY COLLEGE              ,NC,28677-5264,Public       ,145,395,540,1370,3160,4530
00294800,MONTREAT COLLEGE                        ,NC,28757-1267,Private      ,12,57,69,542,640,1182
00294900,MOUNT OLIVE COLLEGE                     ,NC,28365-1299,Private      ,43,352,395,1297,4080,5377
00295000,NORTH CAROLINA CENTRAL UNIVERSITY       ,NC,27707-3198,Public       ,264,446,710,10235,8009,18244
00295100,NORTH CAROLINA WESLEYAN COLLEGE         ,NC,27804-8699,Private      ,36,128,164,1030,1279,2309
00295300,PEACE COLLEGE                           ,NC,27604-1194,Private      ,21,50,71,876,515,1391
00295400,UNIV OF NORTH CAROLINA AT PEMBROKE      ,NC,28372-1510,Public       ,133,273,406,5877,4415,10292
00295500,PFEIFFER UNIVERSITY                     ,NC,28109-0000,Private      ,22,142,164,960,1569,2529
00295600,PIEDMONT BAPTIST COLLEGE AND GRADUATE SC,NC,27101-5025,Private      ,8,33,41,201,265,466
00295700,QUEENS UNIVERSITY OF CHARLOTTE          ,NC,28274-0001,Private      ,80,252,332,2427,2440,4867
00295800,ROCKINGHAM COMMUNITY COLLEGE            ,NC,27375-0000,Public       ,81,274,355,949,2036,2985
00296000,SALEM COLLEGE                           ,NC,27108-0000,Private      ,19,55,74,760,882,1642
00296100,SANDHILLS COMMUNITY COLLEGE             ,NC,28374-8283,Public       ,142,424,566,1738,3790,5528
00296200,SHAW UNIVERSITY                         ,NC,27601-2393,Private      ,96,197,293,2943,2483,5426
00296400,SOUTHEASTERN COMMUNITY COLLEGE          ,NC,28472-5422,Public       ,48,179,227,773,1782,2555
00296700,ST ANDREWS PRESBYTERIAN COLLEGE         ,NC,28352-9979,Private      ,0,0,0,534,113,647
00296800,ST AUGUSTINES COLLEGE                   ,NC,27610-2298,Private      ,48,76,124,2222,982,3204
00297000,SURRY COMMUNITY COLLEGE                 ,NC,27017-0304,Public       ,80,263,343,1329,2175,3504
00297200,NORTH CAROLINA STATE UNIV-RALEIGH       ,NC,27695-7001,Public       ,559,726,1285,25893,11215,37108
00297300,GASTON COLLEGE                          ,NC,28034-1499,Public       ,229,753,982,2407,5932,8339
00297400,UNIVERSITY OF N C-CHAPEL HILL           ,NC,27514-0000,Public       ,477,546,1023,21495,13371,34866
00297500,UNIVERSITY OF NC AT CHARLOTTE           ,NC,28223-0001,Public       ,493,992,1485,20204,14102,34306
00297600,UNIVERSITY OF N C - GREENSBORO          ,NC,27412-0001,Public       ,366,653,1019,15927,10933,26860
00297800,WAKE FOREST UNIV - UNDERGRADUATE        ,NC,27109-7246,Private      ,154,36,190,6818,492,7310
00297801,WAKE FOREST UNIV - SCH OF MEDICINE      ,NC,27157-1090,Private      ,9,15,24,76,1028,1104
00297803,WAKE FOREST GRAD SCHOOLS OF BUSINESS    ,NC,27109-7659,Private      ,7,57,64,53,748,801
00297805,WAKE FOREST UNIV - SCH OF LAW           ,NC,27109-7206,Private      ,2,22,24,46,1438,1484
00297806,WAKE FOREST UNIV - GRAD A&S/DIVINITY    ,NC,27109-7246,Private      ,1,10,11,20,430,450
00297900,WARREN WILSON COLLEGE                   ,NC,28815-0000,Private      ,27,47,74,1232,486,1718
00298000,WAYNE COMMUNITY COLLEGE                 ,NC,27533-0000,Public       ,119,481,600,1455,3496,4951
00298100,WESTERN CAROLINA UNIVERSITY             ,NC,28723-9731,Public       ,225,289,514,8908,4169,13077
00298200,WESTERN PIEDMONT COMMUNITY COLLEGE      ,NC,28655-4504,Public       ,81,309,390,1192,2610,3802
00298300,WILKES COMMUNITY COLLEGE                ,NC,28697-2100,Public       ,84,246,330,1102,1891,2993
00298400,UNIVERSITY OF N C-WILMINGTON            ,NC,28403-3297,Public       ,327,367,694,13142,5348,18490
00298500,WINGATE UNIVERSITY                      ,NC,28174-0159,Private      ,68,54,122,3071,1089,4160
00298600,WINSTON-SALEM STATE UNIVERSITY          ,NC,27102-0000,Public       ,163,382,545,6633,5178,11811
00398100,UNC SCHOOL OF THE ARTS                  ,NC,27127-2188,Public       ,25,29,54,1260,425,1685
00403300,ASHEVILLE BUNCOMBE TECH CMTY CLG        ,NC,28801-4897,Public       ,241,859,1100,2424,6211,8635
00406200,PITT COMMUNITY COLLEGE                  ,NC,28590-0000,Public       ,321,773,1094,4387,7220,11607
00483500,CALDWELL COMMUNITY CLG & TECH INST      ,NC,28638-2626,Public       ,130,424,554,1707,3576,5283
00483800,GUILFORD TECHNICAL COMMUNITY CLG        ,NC,27282-0309,Public       ,524,1759,2283,7135,16470,23605
00484400,WAKE TECHNICAL COMMUNITY COLLEGE        ,NC,27603-5696,Public       ,708,1937,2645,7625,15996,23621
00484500,WILSON COMMUNITY COLLEGE                ,NC,27893-3310,Public       ,72,250,322,672,2165,2837
00499201,MILLER-MOTTE TECHNICAL COLLEGE - MILLER-,NC,27511-9209,Proprietary  ,25,108,133,142,835,977
00499202,MILLER-MOTTE TECHNICAL COLLEGE - MILLER-,NC,27604-6072,Proprietary  ,34,194,228,268,1267,1535
00499203,MILLER-MOTTE TECHNICAL COLLEGE - FAYETTE,NC,28311-7651,Proprietary  ,46,273,319,288,1673,1961
00499205,MILLER-MOTTE TECHNICAL COLLEGE - MILLER-,NC,28540-5901,Proprietary  ,15,158,173,104,955,1059
00531600,COASTAL CAROLINA COMMUNITY COLLEGE      ,NC,28546-6816,Public       ,141,683,824,1481,4829,6310
00531700,FORSYTH TECHNICAL COMMUNITY COLLEGE     ,NC,27103-5197,Public       ,386,1231,1617,3901,10325,14226
00531800,CATAWBA VALLEY COMMUNITY COLLEGE        ,NC,28602-8302,Public       ,158,482,640,2445,4536,6981
00532000,CAPE FEAR COMMUNITY COLLEGE             ,NC,28401-3910,Public       ,464,1089,1553,4450,7762,12212
00544700,RANDOLPH COMMUNITY COLLEGE              ,NC,27204-1009,Public       ,90,278,368,1037,2711,3748
00544800,DURHAM TECHNICAL CMNTY COLLEGE          ,NC,27703-5023,Public       ,191,774,965,1988,6745,8733
00544900,CENTRAL CAROLINA COMMUNITY COLLEGE      ,NC,27330-9000,Public       ,150,584,734,1510,4558,6068
00546300,ALAMANCE COMMUNITY COLLEGE              ,NC,27253-0000,Public       ,180,575,755,1816,4468,6284
00546400,RICHMOND COMMUNITY COLLEGE              ,NC,28345-4522,Public       ,64,280,344,787,2468,3255
00575400,ROWAN-CABARRUS COMMUNITY COLLEGE        ,NC,28146-8357,Public       ,214,824,1038,2329,5974,8303
00647700,CABARRUS COLLEGE OF HEALTH SCIENCES     ,NC,28025-0000,Private      ,12,80,92,268,922,1190
00647800,MERCY HOSP SCH OF NURSING               ,NC,28207-0000,Public       ,20,109,129,214,922,1136
00648300,WATTS SCHOOL OF NURSING                 ,NC,27704-0000,Private      ,2,34,36,52,316,368
00679900,CRAVEN COMMUNITY COLLEGE                ,NC,28562-0000,Public       ,82,481,563,913,3647,4560
00703100,PAMLICO COMMUNITY COLLEGE               ,NC,28529-0000,Public       ,3,48,51,94,378,472
00764000,FAYETTEVILLE TECHNICAL CMTY COLLEGE     ,NC,28303-0236,Public       ,399,1936,2335,3732,14981,18713
00768700,JAMES SPRUNT COMMUNITY COLLEGE          ,NC,28349-0398,Public       ,28,141,169,410,1507,1917
00781400,BROOKSTONE COLLEGE OF BUSINESS          ,NC,28262-1294,Proprietary  ,8,102,110,93,563,656
00781401,BROOKSTONE COLLEGE OF BUSINESS          ,NC,27409-0000,Proprietary  ,13,78,91,88,490,578
00789200,SAMPSON COMMUNITY COLLEGE               ,NC,28328-0000,Public       ,43,152,195,550,1499,2049
00798500,SOUTH PIEDMONT COMMUNITY COLLEGE        ,NC,28135-9703,Public       ,92,338,430,890,2491,3381
00798600,HALIFAX COMMUNITY COLLEGE               ,NC,27890-0089,Public       ,56,194,250,652,1646,2298
00798700,BLADEN COMMUNITY COLLEGE                ,NC,28332-0266,Public       ,64,186,250,614,1924,2538
00798800,MARTIN COMMUNITY COLLEGE                ,NC,27892-8307,Public       ,26,102,128,294,863,1157
00808100,CARTERET COMMUNITY COLLEGE              ,NC,28557-2989,Public       ,60,238,298,641,1826,2467
00808200,CLEVELAND COMMUNITY COLLEGE             ,NC,28150-0000,Public       ,103,362,465,1155,2957,4112
00808300,HAYWOOD COMMUNITY COLLEGE               ,NC,28721-0000,Public       ,55,202,257,749,1757,2506
00808500,MCDOWELL TECHNICAL COMMUNITY CLG        ,NC,28752-8728,Public       ,44,153,197,357,1060,1417
00808700,MONTGOMERY COMMUNITY COLLEGE            ,NC,27371-0787,Public       ,35,103,138,344,895,1239
00846600,SOUTHWESTERN COMMUNITY COLLEGE          ,NC,28779-8581,Public       ,57,191,248,860,1878,2738
00855700,NASH COMMUNITY COLLEGE                  ,NC,27804-0488,Public       ,121,385,506,1161,2910,4071
00855800,BEAUFORT COUNTY COMMUNITY COLLEGE       ,NC,27889-7889,Public       ,62,234,296,696,1848,2544
00861200,ROBESON COMMUNITY COLLEGE               ,NC,28359-2151,Public       ,101,387,488,1209,3512,4721
00861300,ROANOKE-CHOWAN COMMUNITY COLLEGE        ,NC,27910-9522,Public       ,25,97,122,326,862,1188
00885500,EDGECOMBE COMMUNITY COLLEGE             ,NC,27886-9399,Public       ,63,463,526,868,3630,4498
00902500,EMPIRE BEAUTY SCHOOL                    ,NC,28105-2508,Proprietary  ,20,75,95,208,634,842
00933600,JOHNSTON COMMUNITY COLLEGE              ,NC,27577-0000,Public       ,145,502,647,1573,3981,5554
00943000,TRI-COUNTY COMMUNITY COLLEGE            ,NC,28906-7919,Public       ,44,114,158,418,998,1416
00964600,PIEDMONT COMMUNITY COLLEGE              ,NC,27573-1197,Public       ,54,181,235,539,1560,2099
00968400,BLUE RIDGE COMMUNITY COLLEGE            ,NC,28731-9624,Public       ,68,241,309,787,1843,2630
00974701,GORDON-CONWELL THEO SEM - CHARLOTTE     ,NC,28273-0000,Private      ,1,27,28,3,259,262
00990300,VANCE-GRANVILLE CMTY COLLEGE            ,NC,27536-0917,Public       ,146,505,651,1378,3549,4927
01026400,SOUTH COLLEGE                           ,NC,28803-3152,Proprietary  ,13,81,94,102,625,727
01119400,STANLY COMMUNITY COLLEGE                ,NC,28001-7458,Public       ,75,332,407,989,2713,3702
01119700,MAYLAND COMMUNITY COLLEGE               ,NC,28777-2777,Public       ,34,105,139,408,741,1149
01179900,PAUL MITCHELL THE SCHOOL FAYETTEVILLE   ,NC,28303-5364,Proprietary  ,30,89,119,236,663,899
01192600,LEON'S BEAUTY SCHOOL                    ,NC,27403-2812,Proprietary  ,12,57,69,149,410,559
02056500,MITCHELL'S HAIR STYLING ACADEMY         ,NC,27893-0000,Proprietary  ,12,18,30,56,116,172
02056501,MITCHELL'S HAIR STYLING ACADEMY - MITCHE,NC,27606-3326,Proprietary  ,7,28,35,38,146,184
02110500,ART INSTITUTE OF CHARLOTTE (THE)        ,NC,28217-0000,Proprietary  ,292,306,598,2872,2813,5685
02158414,HARRISON COLLEGE - THE CHEF'S ACADEMY - ,NC,27560-0000,Proprietary  ,8,31,39,27,94,121
02170700,BRUNSWICK COMMUNITY COLLEGE             ,NC,28422-0000,Public       ,68,205,273,680,1326,2006
02205000,COLLEGE OF WILMINGTON                   ,NC,28403-0000,Proprietary  ,14,57,71,248,347,595
02210400,FAYETTEVILLE BEAUTY COLLEGE             ,NC,28303-0000,Proprietary  ,11,40,51,84,325,409
02227800,MITCHELL'S HAIR STYLING ACADEMY         ,NC,27534-0000,Proprietary  ,2,5,7,9,33,42
02227900,MITCHELL'S HAIR STYLING ACADEMY         ,NC,27858-0000,Proprietary  ,2,6,8,21,58,79
02238700,HAIRSTYLING INSTITUTE OF CHARLOTTE      ,NC,28204-0000,Proprietary  ,0,0,0,58,258,316
02280900,MID-ATLANTIC CHRISTIAN UNIVERSITY       ,NC,27909-0000,Private      ,5,19,24,112,131,243
02326203,KAPLAN CAREER INSTITUTE - KAPLAN COLLEGE,NC,28212-6830,Proprietary  ,50,268,318,321,1844,2165
02560600,PINNACLE INSTITUTE OF COSMETOLOGY       ,NC,28115-8020,Proprietary  ,8,18,26,43,105,148
02614201,MILLER-MOTTE BUSINESS COLLEGE           ,NC,28403-0000,Proprietary  ,82,485,567,377,2633,3010
02614205,MILLER - MOTTE TECHNICAL COLLEGE - MILLE,NC,27834-5052,Proprietary  ,24,129,153,206,1059,1265
03009500,WINSTON-SALEM BARBER SCHOOL             ,NC,27107-0000,Proprietary  ,2,15,17,62,165,227
03064400,REGENCY BEAUTY INSTITUTE                ,NC,27127-0000,Proprietary  ,17,36,53,127,265,392
03089300,HERITAGE BIBLE COLLEGE                  ,NC,28335-0000,Private      ,2,7,9,22,100,122
03104200,CAROLINAS COLLEGE OF HEALTH SCIENCE     ,NC,28232-2861,Public       ,28,141,169,364,1390,1754
03109000,LIVING ARTS COLLEGE                     ,NC,27614-7076,Proprietary  ,53,88,141,557,719,1276
03361300,MEDICAL ARTS MASSAGE SCHOOL             ,NC,27616-6453,Proprietary  ,8,65,73,52,343,395
03513400,APEX SCHOOL OF THEOLOGY                 ,NC,27703-8024,Private      ,5,78,83,32,1117,1149
03555300,SOUTHEASTERN INSTITUTE                  ,NC,28217-0000,Proprietary  ,28,139,167,125,700,825
03555400,SOUTHEASTERN SCHOOL OF NEUROMUSCULAR  MA,NC,29406-0000,Proprietary  ,13,45,58,47,231,278
03570300,CAROLINA CHRISTIAN COLLEGE              ,NC,27105-3241,Private      ,1,20,21,23,138,161
03663300,HOOD THEOLOGICAL SEMINARY               ,NC,28144-5768,Private      ,0,11,11,0,252,252
03748500,LA SHE'S BEAUTY ACADEMY                 ,NC,27707-3569,Proprietary  ,4,32,36,34,162,196
03777300,CAROLINA ACAD OF COSMETIC ART & SCI     ,NC,28054-0460,Proprietary  ,21,64,85,155,394,549
03827300,NEW LIFE THEOLOGICAL SEMINARY           ,NC,28205-1648,Private      ,0,35,35,7,221,228
04073300,JUNG TAO SCHOOL OF CLASSICAL CHINESE MED,NC,28679-9657,Private      ,0,0,0,1,32,33
04098300,TECHSKILLS - CHARLOTTE                  ,NC,28217-0000,Proprietary  ,4,47,51,46,304,350
04101300,CAROLINA SCHOOL OF BROADCASTING         ,NC,28214-8085,Proprietary  ,10,48,58,90,302,392
04115700,REGINA'S COLLEGE OF BEAUTY              ,NC,28110-2831,Proprietary  ,8,52,60,55,268,323
04120300,"FILA ACADEMY, THE                       ",NC,27265-3114,Proprietary  ,2,11,13,26,94,120
04129400,CENTER FOR MASSAGE & NATURAL HEALTH     ,NC,28787-8331,Proprietary  ,3,13,16,24,98,122
04140700,AVEDA INSTITUTE CHAPEL HILL             ,NC,27516-2559,Proprietary  ,21,53,74,206,354,560
04143500,CHARLOTTE SCHOOL OF LAW                 ,NC,28208-2816,Proprietary  ,10,111,121,62,2362,2424
04146400,DAOIST TRADITIONS COLLEGE OF CHINESE MED,NC,28801-1060,Proprietary  ,0,5,5,6,96,102
04149300,PARK WEST BARBER SCHOOL                 ,NC,27701-4022,Proprietary  ,21,84,105,57,337,394
04154200,CAROLINA BIBLE COLLEGE                  ,NC,29303-5157,Private      ,2,25,27,22,226,248
04172800,BODY THERAPY INSTITUTE                  ,NC,27344-6728,Proprietary  ,3,24,27,23,130,153
04173000,SHEPHERDS THEOLOGICAL SEMINARY          ,NC,27518-9316,Private      ,0,2,2,0,21,21
04173700,GRACE COLLEGE OF DIVINITY               ,NC,28314-2343,Private      ,1,7,8,22,65,87
04178100,CAROLINA COLLEGE OF HAIR DESIGN         ,NC,28802-1232,Proprietary  ,4,14,18,48,128,176
00298800,BISMARCK STATE COLLEGE                  ,ND,58501-1299,Public       ,59,195,254,2080,1807,3887
00298900,DICKINSON STATE UNIVERSITY              ,ND,58601-4896,Public       ,22,55,77,1136,772,1908
00299000,JAMESTOWN COLLEGE                       ,ND,58405-3401,Private      ,16,9,25,875,154,1029
00299100,LAKE REGION STATE COLLEGE               ,ND,58301-1598,Public       ,18,48,66,405,477,882
00299200,UNIVERSITY OF MARY                      ,ND,58504-9652,Private      ,19,152,171,1624,1659,3283
00299300,MAYVILLE STATE UNIVERSITY               ,ND,58257-1299,Public       ,13,18,31,579,332,911
00299400,MINOT STATE UNIVERSITY                  ,ND,58707-0002,Public       ,27,95,122,1691,1515,3206
00299500,DAKOTA COLLEGE AT BOTTINEAU             ,ND,58318-1159,Public       ,6,27,33,332,329,661
00299600,NORTH DAKOTA STATE CLG OF SCIENCE       ,ND,58076-0002,Public       ,45,73,118,1580,903,2483
00299700,NORTH DAKOTA STATE UNIVERSITY           ,ND,58108-6050,Public       ,208,198,406,9903,3168,13071
00300500,UNIVERSITY OF NORTH DAKOTA              ,ND,58202-8193,Public       ,139,383,522,8417,5584,14001
00300700,WILLISTON STATE COLLEGE                 ,ND,58802-1326,Public       ,13,41,54,306,401,707
00300800,VALLEY CITY STATE UNIVERSITY            ,ND,58072-0000,Public       ,17,27,44,766,410,1176
00775600,JOSEF'S SCHOOL OF HAIR DESIGN INC       ,ND,58102-4977,Proprietary  ,7,21,28,70,98,168
00869408,RASMUSSEN COLLEGE - FARGO               ,ND,58103-7196,Proprietary  ,13,104,117,212,1012,1224
00869415,RASMUSSEN COLLEGE - BISMARCK            ,ND,58503-0000,Proprietary  ,8,28,36,92,478,570
00935400,MEDCENTER ONE COLLEGE OF NURSING        ,ND,58501-4494,Private      ,3,4,7,72,92,164
01040600,JOSEF'S SCHOOL OF HAIR DESIGN           ,ND,58201-6394,Proprietary  ,5,19,24,58,97,155
01205900,TRINITY BIBLE COLLEGE                   ,ND,58436-7150,Private      ,4,9,13,217,135,352
01229500,JZ TREND ACADEMY PAUL MITCHELL PARTNER S,ND,58501-0000,Proprietary  ,9,9,18,92,54,146
02188200,SITTING BULL COLLEGE                    ,ND,58538-9701,Public       ,7,51,58,73,380,453
02236500,LITTLE HOOP COMMUNITY COLLEGE           ,ND,58335-0000,Public       ,3,17,20,35,192,227
02242900,UNITED TRIBES TECHNICAL COLLEGE         ,ND,58504-0000,Private      ,14,87,101,274,879,1153
02298200,HEADQUARTERS ACADEMY OF HAIR DESIGN     ,ND,58701-0000,Proprietary  ,3,10,13,23,56,79
02301100,TURTLE MTN CMNTY COLG-FIN AID OFC       ,ND,58316-0000,Private      ,5,44,49,246,599,845
02553700,FORT BERTHOLD COMMUNITY COLLEGE         ,ND,58763-0000,Public       ,2,11,13,59,144,203
03087200,MOLER BARBER CLG OF HAIRSTYLING         ,ND,58103-0000,Proprietary  ,0,5,5,4,13,17
04031300,SALON PROFESSIONAL ACADEMY (THE)        ,ND,58103-3337,Proprietary  ,5,11,16,83,81,164
04139400,HAIR ACADEMY (THE)                      ,ND,58501-4929,Proprietary  ,2,6,8,56,48,104
00133901,CORBAN UNIVERSITY - SCHOOL OF MINISTRY  ,WA,98402-6699,Private      ,0,0,0,5,25,30
00301005,ANTIOCH UNIV/SEATTLE                    ,WA,98121-0000,Private      ,7,81,88,81,1287,1368
00376900,BELLEVUE COLLEGE                        ,WA,98007-6484,Public       ,352,908,1260,5051,8349,13400
00377000,BIG BEND COMMUNITY COLLEGE              ,WA,98837-3299,Public       ,88,236,324,1153,1948,3101
00377100,"CENTRAL WASHINGTON UNIV., FIN AID       ",WA,98926-7495,Public       ,351,322,673,11094,5882,16976
00377200,CENTRALIA COLLEGE                       ,WA,98531-4099,Public       ,80,320,400,1345,2453,3798
00377300,CLARK COLLEGE                           ,WA,98663-3598,Public       ,472,1304,1776,5680,12025,17705
00377400,COLUMBIA BASIN COLLEGE                  ,WA,99301-3379,Public       ,195,621,816,3168,5002,8170
00377500,EASTERN WASHINGTON UNIVERSITY           ,WA,99004-2447,Public       ,323,389,712,10988,7670,18658
00377600,EVERETT COMMUNITY COLLEGE               ,WA,98201-1352,Public       ,270,906,1176,3160,7407,10567
00377700,HERITAGE UNIVERSITY                     ,WA,98948-9562,Private      ,35,110,145,569,1789,2358
00377800,GONZAGA UNIVERSITY                      ,WA,99258-0083,Private      ,159,266,425,8225,4475,12700
00377900,GRAYS HARBOR COLLEGE                    ,WA,98520-7599,Public       ,68,254,322,812,2087,2899
00378000,GREEN RIVER COMMUNITY COLLEGE           ,WA,98092-3622,Public       ,307,782,1089,3436,6364,9800
00378100,HIGHLINE COMMUNITY COLLEGE              ,WA,98198-9800,Public       ,326,793,1119,3459,6879,10338
00378200,LOWER COLUMBIA COLLEGE                  ,WA,98632-0310,Public       ,120,510,630,1389,3993,5382
00378300,NORTHWEST UNIVERSITY                    ,WA,98083-0000,Private      ,52,112,164,1363,1123,2486
00378400,OLYMPIC COLLEGE                         ,WA,98337-1600,Public       ,188,794,982,2321,6460,8781
00378500,PACIFIC LUTHERAN UNIVERSITY             ,WA,98447-0003,Private      ,115,155,270,4803,2077,6880
00378600,PENINSULA COLLEGE                       ,WA,98362-6660,Public       ,63,298,361,719,2104,2823
00378700,SEATTLE CENTRAL COMMUNITY COLLEGE       ,WA,98122-2413,Public       ,281,938,1219,3366,8248,11614
00378703,SEATTLE VOCATIONAL INSTITUTE            ,WA,98144-0000,Public       ,32,158,190,160,791,951
00378800,SEATTLE PACIFIC UNIVERSITY              ,WA,98119-1997,Private      ,144,193,337,6889,2827,9716
00379000,SEATTLE UNIVERSITY                      ,WA,98122-1090,Private      ,240,319,559,9144,7276,16420
00379100,SHORELINE COMMUNITY COLLEGE             ,WA,98133-5696,Public       ,185,509,694,2319,5228,7547
00379200,SKAGIT VALLEY COLLEGE                   ,WA,98273-5899,Public       ,137,435,572,1853,4010,5863
00379300,SPOKANE COMMUNITY COLLEGE               ,WA,99207-5399,Public       ,379,1326,1705,4444,12005,16449
00379400,ST MARTIN'S UNIVERSITY                  ,WA,98503-7500,Private      ,32,97,129,1421,1361,2782
00379600,TACOMA COMMUNITY COLLEGE                ,WA,98466-6100,Public       ,321,1254,1575,3980,10932,14912
00379700,UNIVERSITY OF PUGET SOUND               ,WA,98416-1039,Private      ,98,133,231,5390,1529,6919
00379800,UNIVERSITY OF WASHINGTON                ,WA,98195-5880,Public       ,884,1381,2265,33414,30289,63703
00379900,WALLA WALLA UNIVERSITY                  ,WA,99324-1198,Private      ,38,43,81,1664,814,2478
00380000,WASHINGTON STATE UNIVERSITY             ,WA,99164-1035,Public       ,625,806,1431,23305,13703,37008
00380100,WENATCHEE VALLEY COLLEGE                ,WA,98801-1799,Public       ,115,389,504,1810,3403,5213
00380200,WESTERN WASHINGTON UNIVERSITY           ,WA,98225-5946,Public       ,427,278,705,16449,5139,21588
00380300,WHITMAN COLLEGE                         ,WA,99362-2067,Private      ,45,9,54,2927,154,3081
00380400,WHITWORTH UNIVERSITY                    ,WA,99251-0001,Private      ,73,101,174,4464,1481,5945
00380500,YAKIMA VALLEY COMMUNITY COLLEGE         ,WA,98907-2520,Public       ,172,478,650,3184,5189,8373
00499900,BELLINGHAM TECHNICAL COLLEGE            ,WA,98225-0000,Public       ,82,350,432,999,3313,4312
00500000,PIERCE COLLEGE                          ,WA,98498-1919,Public       ,311,1124,1435,3658,8854,12512
00500100,EDMONDS COMMUNITY COLLEGE               ,WA,98036-5999,Public       ,212,650,862,2672,6146,8818
00500600,WALLA WALLA COMMUNITY COLLEGE           ,WA,99362-9267,Public       ,83,296,379,1788,3069,4857
00530600,BATES TECHNICAL COLLEGE                 ,WA,98405-0000,Public       ,124,634,758,984,3993,4977
00537200,SOUTH PUGET SOUND COMMUNITY COLLEGE     ,WA,98512-6292,Public       ,210,720,930,2510,6093,8603
00537300,LAKE WASHINGTON TECHNICAL COLLEGE       ,WA,98034-8505,Public       ,80,370,450,829,3354,4183
00575200,CLOVER PARK TECHNICAL COLLEGE           ,WA,98499-0000,Public       ,183,845,1028,1588,6660,8248
00815500,EVERGREEN STATE COLLEGE (THE)           ,WA,98505-0002,Public       ,162,282,444,4010,4572,8582
00907901,EVEREST COLLEGE                         ,WA,98684-6950,Proprietary  ,16,96,112,165,664,829
00938700,PERRY TECHNICAL INSTITUTE               ,WA,98903-1239,Private      ,37,114,151,566,1059,1625
00954400,SPOKANE FALLS COMMUNITY COLLEGE         ,WA,99224-5204,Public       ,320,858,1178,4645,7898,12543
00970400,NORTH SEATTLE COMMUNITY COLLEGE         ,WA,98103-3599,Public       ,148,633,781,1733,5744,7477
00970600,SOUTH SEATTLE COMMUNITY COLLEGE         ,WA,98106-1499,Public       ,164,601,765,2025,4893,6918
00973900,GLEN DOW ACAD OF HAIR DESIGN            ,WA,99201-0209,Proprietary  ,10,42,52,121,285,406
01036400,WHATCOM COMMUNITY COLLEGE               ,WA,98226-8003,Public       ,160,397,557,2393,3831,6224
01043400,RENTON TECHNICAL COLLEGE                ,WA,98056-0000,Public       ,120,464,584,986,3595,4581
01148100,DIVERS INSTITUTE OF TECHNOLOGY          ,WA,98107-0000,Proprietary  ,15,94,109,145,557,702
01231500,CORNISH COLLEGE OF THE ARTS             ,WA,98121-4604,Private      ,51,45,96,1651,543,2194
01249600,"BEAUTIWORKS SEATTLE, LLC                ",WA,98133-5615,Proprietary  ,10,13,23,40,84,124
01302200,CITY UNIVERSITY OF SEATTLE              ,WA,98005-3030,Private      ,9,211,220,214,2478,2692
01309400,BELLINGHAM BEAUTY SCHOOL                ,WA,98225-0000,Proprietary  ,3,14,17,32,123,155
02105300,EVERGREEN BEAUTY AND BARBER COLLEGE     ,WA,98007-3722,Proprietary  ,4,39,43,70,193,263
02106700,TRINITY LUTHERAN COLLEGE                ,WA,98201-3569,Private      ,10,15,25,187,128,315
02180000,NORTHWEST INDIAN COLLEGE                ,WA,98226-9278,Public       ,21,98,119,174,854,1028
02184200,PAROBA COLLEGE OF COSMETOLOGY           ,WA,98208-0000,Proprietary  ,15,32,47,73,180,253
02202200,STYLEMASTERS COLLEGE OF HAIR DESIGN     ,WA,98632-0000,Proprietary  ,12,19,31,46,129,175
02203300,GENE JUAREZ ACADEMY OF BEAUTY           ,WA,98125-0000,Proprietary  ,45,92,137,419,756,1175
02222900,INTERNATIONAL AIR & HOSPITALITY ACADEMY ,WA,98661-4835,Proprietary  ,55,158,213,320,661,981
02236800,PROFESSIONAL BEAUTY SCHOOL              ,WA,98902-0000,Proprietary  ,5,15,20,48,98,146
02242500,BASTYR UNIVERSITY                       ,WA,98028-0000,Private      ,10,93,103,160,1519,1679
02242504,SEATTLE MIDWIFERY SCHOOL                ,WA,98144-0000,Private      ,0,0,0,2,2,4
02291300,ART INSTITUTE OF SEATTLE                ,WA,98121-1622,Proprietary  ,138,292,430,2405,2643,5048
02300100,EVEREST COLLEGE                         ,WA,98367-1835,Proprietary  ,20,88,108,120,541,661
02300103,EVEREST COLLEGE - EVERETT               ,WA,98208-2610,Proprietary  ,38,130,168,234,862,1096
02300104,EVEREST COLLEGE - TACOMA                ,WA,98402-3004,Proprietary  ,62,354,416,436,1872,2308
02326500,INTERFACE COLLEGE                       ,WA,99201-4326,Proprietary  ,2,48,50,24,255,279
02331400,NORTHWEST HAIR ACADEMY                  ,WA,98273-0000,Proprietary  ,19,28,47,84,162,246
02331402,NORTHWEST HAIR ACADEMY - EVERETT        ,WA,98204-0000,Proprietary  ,2,11,13,38,68,106
02504900,ACADEMY OF HAIR DESIGN (THE)            ,WA,98801-0000,Proprietary  ,4,18,22,43,128,171
02541900,BJ'S BEAUTY AND BARBER COLLEGE          ,WA,98409-0000,Proprietary  ,13,66,79,50,302,352
02602100,NORTHWEST COLLEGE OF ART                ,WA,98370-8625,Proprietary  ,7,5,12,186,91,277
02606200,EVEREST COLLEGE                         ,WA,98055-2990,Proprietary  ,46,170,216,211,834,1045
02617500,EVEREST COLLEGE                         ,WA,98133-9018,Proprietary  ,43,177,220,245,739,984
02617501,EVEREST COLLEGE - FIFE                  ,WA,98424-2649,Proprietary  ,0,0,0,12,42,54
02617503,EVEREST COLLEGE - VANCOUVER             ,WA,98684-6951,Proprietary  ,8,48,56,103,383,486
03031406,INTERNATIONAL ACADEMY OF DESIGN & TECH  ,WA,98188-3319,Proprietary  ,24,64,88,141,336,477
03065000,CLARE'S BEAUTY COLLEGE                  ,WA,99301-0000,Proprietary  ,15,36,51,79,185,264
03071800,ITT TECHNICAL INSTITUTE                 ,WA,99216-1589,Proprietary  ,77,368,445,597,2497,3094
03071805,ITT TECHNICAL INSTITUTE - SEATTLE       ,WA,98168-3346,Proprietary  ,83,452,535,517,2181,2698
03099000,CORTIVA INSTITUTE - SEATTLE             ,WA,98109-5474,Proprietary  ,16,50,66,125,417,542
03110800,BAKKE GRADUATE UNIVERSITY               ,WA,98104-1222,Private      ,0,10,10,11,60,71
03139500,MONTESSORI SCHOOLS OF WASHINGTON        ,WA,98203-6600,Private      ,0,2,2,3,15,18
03280300,SEATTLE INST OF ORIENTAL MEDICINE       ,WA,98115-0000,Proprietary  ,0,9,9,15,92,107
03283300,NORTHWEST HVAC/R ASSOCIATION & TRAINING ,WA,99202-0000,Private      ,1,12,13,13,121,134
03466400,MARS HILL GRADUATE SCHOOL               ,WA,98121-0000,Private      ,0,5,5,2,322,324
03483500,CASCADIA COMMUNITY COLLEGE              ,WA,98011-9510,Public       ,110,182,292,1216,1677,2893
03490400,EMIL FRIES PIANO HOSPITAL & TRAININ     ,WA,98661-4323,Private      ,0,2,2,3,18,21
03689400,FAITH EVANGELICAL COLLEGE & SEMINARY    ,WA,98407-2607,Private      ,2,34,36,18,362,380
03724300,DIGIPEN INSTITUTE OF TECHNOLOGY         ,WA,98052-5170,Proprietary  ,31,25,56,831,511,1342
03917300,EVERGREEN BEAUTY AND BARBER COLLEGE     ,WA,98208-3759,Proprietary  ,18,59,77,118,352,470
03932500,TOTAL COSMETOLOGY TRAINING CENTER       ,WA,99217-6231,Proprietary  ,4,51,55,54,270,324
03953300,YAKIMA BEAUTY SCHOOL                    ,WA,98901-2202,Proprietary  ,1,13,14,44,110,154
04043400,ALPINE COLLEGE                          ,WA,99206-5097,Proprietary  ,0,0,0,51,306,357
04120000,SUNNYSIDE BEAUTY ACADEMY                ,WA,98944-8711,Proprietary  ,3,8,11,19,56,75
04127200,VICTORIA'S ACADEMY OF COSMETOLOGY       ,WA,99336-3826,Proprietary  ,4,33,37,64,188,252
04130500,PACIFIC NORTHWEST UNIV OF HEALTH SCIENCE,WA,98901-1471,Private      ,3,17,20,33,453,486
04130800,CASCADE BEAUTY COLLEGE                  ,WA,98002-5504,Proprietary  ,4,14,18,31,75,106
04132800,INLAND MASSAGE INSTITUTE                ,WA,99218-5016,Proprietary  ,3,10,13,36,129,165
04135200,NORTHWEST AVIATION COLLEGE              ,WA,98002-1609,Proprietary  ,3,15,18,33,109,142
04149400,GARY MANUEL AVEDA INSTITUTE             ,WA,98122-3807,Proprietary  ,23,66,89,185,414,599
04149600,GP INSTITUTE OF COSMETOLOGY             ,WA,98118-2353,Proprietary  ,3,14,17,14,99,113
04155000,NORTHWEST SCHOOL OF WOODEN BOAT BUILDING,WA,98339-8706,Private      ,0,7,7,16,85,101
04161200,BAINBRIDGE GRADUATE INSTITUTE           ,WA,98110-2870,Private      ,0,12,12,2,163,165
04170100,SALON PROFESSIONAL ACADEMY (THE)        ,WA,98409-7360,Proprietary  ,20,56,76,111,322,433
04172900,ACADEMY OF COSMETOLOGY                  ,WA,99354-2651,Proprietary  ,6,10,16,37,96,133
04188900,NORTHWEST INSTITUTE OF LITERARY ARTS    ,WA,98249-0000,Private      ,0,3,3,0,18,18
04191900,PAUL MITCHELL THE SCHOOL SPOKANE        ,WA,99037-5041,Proprietary  ,19,64,83,80,180,260
00340100,BROWN UNIVERSITY                        ,RI,02912-9127,Private      ,240,54,294,20445,1078,21523
00340101,BROWN UNIVERSITY - GRADUATE SCHOOL      ,RI,02912-1827,Private      ,7,115,122,47,1483,1530
00340102,BROWN MEDICAL SCHOOL                    ,RI,02912-0000,Private      ,1,9,10,41,507,548
00340200,BRYANT UNIVERSITY                       ,RI,02917-1284,Private      ,79,38,117,4997,608,5605
00340400,JOHNSON & WALES UNIVERSITY              ,RI,02903-3703,Private      ,451,410,861,20550,5788,26338
00340600,PROVIDENCE COLLEGE                      ,RI,02918-0001,Private      ,116,71,187,8456,873,9329
00340700,RHODE ISLAND COLLEGE                    ,RI,02908-1991,Public       ,134,246,380,7552,4462,12014
00340800,COMMUNITY COLLEGE OF RI - WARWICK       ,RI,02906-0000,Public       ,561,1126,1687,6609,9205,15814
00340801,COMMUNITY COLLEGE OF RHODE ISLAND - FLAN,RI,02865-4585,Public       ,33,82,115,2364,2844,5208
00340802,COMMUNITY COLLEGE OF RHODE ISLAND - PROV,RI,02905-2313,Public       ,39,88,127,1790,2644,4434
00340900,RHODE ISLAND SCHOOL OF DESIGN           ,RI,02903-2784,Private      ,67,50,117,2728,1582,4310
00341000,ROGER WILLIAMS UNIVERSITY               ,RI,02809-2921,Private      ,123,73,196,8320,1803,10123
00341100,SALVE REGINA UNIVERSITY                 ,RI,02840-4192,Private      ,73,41,114,4292,534,4826
00341400,UNIVERSITY OF RHODE ISLAND              ,RI,02881-0000,Public       ,350,257,607,22449,4744,27193
00659100,ST. JOSEPH HOSP SCH OF NURSING          ,RI,02904-5199,Private      ,4,14,18,75,233,308
00784500,NEW ENGLAND INSTITUTE OF TECHNOLOGY     ,RI,02886-2266,Private      ,155,306,461,2591,2916,5507
01115900,"SAWYER SCHOOL,THE                       ",RI,02860-4117,Proprietary  ,44,282,326,246,1449,1695
01164702,SBI CAMPUS - AN AFFILIATE OF SANFORD-BRO,RI,02920-7807,Proprietary  ,37,134,171,297,948,1245
02071900,ARTHUR ANGELO SCH COSMET&HAIR DSGN      ,RI,02903-0000,Proprietary  ,9,31,40,84,205,289
02176900,WARWICK ACADEMY OF BEAUTY CULTURE       ,RI,02886-1534,Proprietary  ,4,14,18,65,147,212
02584400,NEW ENGLAND TRACTOR TRAILER TRAINING SCH,RI,02860-1752,Proprietary  ,33,327,360,103,961,1064
03080000,NEWPORT SCHOOL OF HAIRDRESSING          ,RI,02860-4038,Proprietary  ,0,15,15,14,88,102
03232300,LINCOLN TECHNICAL INSTITUTE             ,RI,02865-4211,Proprietary  ,61,175,236,506,1190,1696
03732300,INTERNATIONAL YACHT RESTORATION SCH     ,RI,02840-6720,Private      ,0,3,3,23,38,61
04141200,TONI & GUY HAIRDRESSING ACADEMY         ,RI,02920-0000,Proprietary  ,9,15,24,109,121,230
00341700,ALLEN UNIVERSITY                        ,SC,29204-1085,Private      ,47,58,105,1040,639,1679
00341800,ANDERSON UNIVERSITY                     ,SC,29621-4035,Private      ,49,105,154,2516,1303,3819
00341900,CHARLESTON SOUTHERN UNIVERSITY          ,SC,29406-2160,Private      ,100,212,312,4240,2561,6801
00342000,BENEDICT COLLEGE                        ,SC,29204-1086,Private      ,134,142,276,4489,1935,6424
00342100,BOB JONES UNIVERSITY                    ,SC,29614-1000,Proprietary  ,52,51,103,2830,516,3346
00342200,SOUTHERN WESLEYAN UNIVERSITY            ,SC,29630-1020,Private      ,18,144,162,871,1813,2684
00342300,THE CITADEL                             ,SC,29409-0002,Public       ,106,112,218,2855,1272,4127
00342400,CLAFLIN UNIVERSITY                      ,SC,29115-4498,Private      ,40,77,117,2703,1133,3836
00342500,CLEMSON UNIVERSITY                      ,SC,29634-0001,Public       ,341,324,665,18266,4396,22662
00342600,UNIV OF SC AT SUMTER                    ,SC,29150-2498,Public       ,24,54,78,777,684,1461
00342700,COKER COLLEGE                           ,SC,29550-3797,Private      ,30,84,114,1120,1028,2148
00342800,COLLEGE OF CHARLESTON                   ,SC,29424-0100,Public       ,265,244,509,11499,3410,14909
00342900,COLUMBIA INTERNATIONAL UNIVERSITY       ,SC,29203-1599,Private      ,12,60,72,580,855,1435
00343000,COLUMBIA COLLEGE                        ,SC,29203-5998,Private      ,26,121,147,1336,1486,2822
00343100,CONVERSE COLLEGE                        ,SC,29302-0006,Private      ,18,57,75,946,761,1707
00343200,ERSKINE COLLEGE                         ,SC,29639-0000,Private      ,9,5,14,722,63,785
00343201,ERSKINE THEOLOGICAL SEMINARY            ,SC,29639-0000,Private      ,0,10,10,3,123,126
00343400,FURMAN UNIVERSITY                       ,SC,29613-5253,Private      ,82,47,129,3606,576,4182
00343500,LANDER UNIVERSITY                       ,SC,29649-2099,Public       ,79,84,163,4194,1151,5345
00343600,LIMESTONE COLLEGE                       ,SC,29340-3799,Private      ,28,187,215,1423,3215,4638
00343700,LUTHERAN THEOLOGICAL SOUTHERN SEM       ,SC,29203-5898,Private      ,0,12,12,6,141,147
00343800,MEDICAL UNIV OF SOUTH CAROLINA - FA     ,SC,29425-1760,Public       ,21,113,134,264,3225,3489
00343900,MORRIS COLLEGE                          ,SC,29150-3599,Private      ,34,43,77,1453,658,2111
00344000,NEWBERRY COLLEGE                        ,SC,29108-2197,Private      ,28,24,52,1745,331,2076
00344100,NORTH GREENVILLE COLLEGE                ,SC,29688-1892,Private      ,33,25,58,2404,466,2870
00344500,PRESBYTERIAN COLLEGE                    ,SC,29325-2503,Private      ,26,11,37,1651,287,1938
00344600,SOUTH CAROLINA STATE UNIVERSITY         ,SC,29117-4427,Public       ,138,183,321,6478,3221,9699
00344700,SPARTANBURG METHODIST COLLEGE           ,SC,29301-5899,Private      ,29,23,52,1307,261,1568
00344800,UNIVERSITY OF SOUTH CAROLINA            ,SC,29208-3999,Public       ,535,655,1190,25495,12898,38393
00344900,UNIVERSITY OF SOUTH CAROLINA AIKEN      ,SC,29801-6399,Public       ,88,121,209,3449,1567,5016
00345000,UNIV OF SC AT BEAUFORT                  ,SC,29902-0000,Public       ,53,95,148,1684,1185,2869
00345100,COASTAL CAROLINA UNIVERSITY             ,SC,29528-0000,Public       ,307,261,568,13092,3340,16432
00345300,UNIV OF SC AT LANCASTER                 ,SC,29721-0889,Public       ,45,96,141,1038,831,1869
00345400,UNIV OF SC SYSTEM SALKEHATCHIE          ,SC,29810-0617,Public       ,44,187,231,680,1103,1783
00345500,VOORHEES COLLEGE                        ,SC,29042-0000,Private      ,16,28,44,985,469,1454
00345600,WINTHROP UNIVERSITY                     ,SC,29733-0001,Public       ,125,155,280,5981,2489,8470
00345700,WOFFORD COLLEGE                         ,SC,29303-3663,Private      ,38,33,71,2346,240,2586
00399000,FLORENCE-DARLINGTON TECH COLLEGE        ,SC,29501-0548,Public       ,232,776,1008,3202,6916,10118
00399100,GREENVILLE TECHNICAL COLLEGE            ,SC,29607-2439,Public       ,524,1625,2149,7822,14390,22212
00399200,PIEDMONT TECHNICAL COLLEGE              ,SC,29648-1467,Public       ,179,658,837,2434,6173,8607
00399300,MIDLANDS TECHNICAL COLLEGE              ,SC,29202-0000,Public       ,504,1327,1831,7443,13229,20672
00399400,SPARTANBURG COMMUNITY COLLEGE           ,SC,29305-4386,Public       ,229,684,913,3447,6042,9489
00399500,CENTRAL CAROLINA TECHNICAL COLLEGE      ,SC,29150-2499,Public       ,147,547,694,1825,4936,6761
00399600,YORK TECHNICAL COLLEGE                  ,SC,29730-3395,Public       ,233,739,972,3036,6212,9248
00492000,TRIDENT TECHNICAL COLLEGE               ,SC,29423-8067,Public       ,635,2055,2690,7435,16240,23675
00492300,CLINTON JR COLLEGE                      ,SC,29730-5152,Private      ,3,6,9,199,123,322
00492400,FORREST JUNIOR COLLEGE                  ,SC,29624-2405,Proprietary  ,1,38,39,32,278,310
00492500,HORRY-GEORGETOWN TECH COLLEGE           ,SC,29526-9521,Public       ,402,975,1377,4032,8336,12368
00492600,TRI-COUNTY TECHNICAL COLLEGE            ,SC,29670-9133,Public       ,215,548,763,4292,5356,9648
00492700,UNIV OF SC AT UNION                     ,SC,29379-0729,Public       ,14,23,37,289,322,611
00499204,MILLER-MOTTE TECHNICAL COLLEGE - CONWAY ,SC,29526-9508,Proprietary  ,47,227,274,304,1247,1551
00536300,DENMARK TECHNICAL COLLEGE               ,SC,29042-0000,Public       ,90,162,252,989,1481,2470
00681500,ORANGEBURG-CALHOUN TECHNICAL COLG       ,SC,29118-8299,Public       ,83,246,329,1643,2783,4426
00695100,UNIVERSITY OF SOUTH CAROLINA UPSTATE    ,SC,29303-9972,Public       ,113,258,371,5888,3451,9339
00760200,NORTHEASTERN TECHNICAL COLLEGE          ,SC,29520-7015,Public       ,55,171,226,649,1399,2048
00922600,FRANCIS MARION UNIVERSITY               ,SC,29501-0000,Public       ,108,154,262,4744,2334,7078
00932200,WILLIAMSBURG TECHNICAL COLLEGE          ,SC,29556-4197,Public       ,17,76,93,316,884,1200
00991000,TECHNICAL COLLEGE OF THE LOWCOUNTRY     ,SC,29902-5441,Public       ,106,428,534,1110,3515,4625
00991100,UNIV OF SC-REGIONAL CAMPUSES ADMIN      ,SC,29208-0001,Public       ,2,8,10,88,81,169
01005600,AIKEN TECHNICAL COLLEGE                 ,SC,29802-0696,Public       ,149,447,596,2013,3798,5811
01209200,KENNETH SHULER SCHOOL OF COSMETOLOGY    ,SC,29732-2169,Proprietary  ,20,71,91,160,424,584
01303907,SOUTH UNIVERSITY                        ,SC,29203-6400,Proprietary  ,31,332,363,483,2966,3449
02063700,SHERMAN CLG STRAIGHT CHIROPRACTIC       ,SC,29316-0000,Private      ,0,12,12,14,247,261
02338600,CHARZANNE BEAUTY COLLEGE                ,SC,29649-0000,Proprietary  ,0,15,15,17,81,98
02341100,KENNETH SHULER SCHOOL OF COSMETOLOGY & N,SC,29210-0000,Proprietary  ,12,92,104,199,731,930
02356600,CHARLESTON COSMETOLOGY INSTITUTE        ,SC,29420-0000,Proprietary  ,9,43,52,55,171,226
02552400,ACADEMY OF HAIR TECHNOLOGY              ,SC,29615-2363,Proprietary  ,4,24,28,60,162,222
02567600,SUMTER BEAUTY COLLEGE                   ,SC,29150-0000,Proprietary  ,5,14,19,39,112,151
02614202,MILLER - MOTTE TECHNICAL COLLEGE - NORTH,SC,29406-9239,Proprietary  ,41,170,211,261,1187,1448
03010614,VIRGINIA COLLEGE - GOLF ACADEMY OF AMERI,SC,29579-0000,Proprietary  ,20,48,68,200,367,567
03010617,VIRGINIA COLLEGE - GREENVILLE           ,SC,29607-7200,Proprietary  ,17,80,97,252,1231,1483
03010620,VIRGINIA COLLEGE - CHARLESTON           ,SC,29406-4999,Proprietary  ,15,117,132,214,1169,1383
03010621,VIRGINIA COLLEGE - COLUMBIA             ,SC,29223-7527,Proprietary  ,12,86,98,271,1202,1473
03052300,KENNETH SHULER SCH COSM & HAIR DESG     ,SC,29841-2013,Proprietary  ,14,43,57,135,409,544
03088300,ACADEMY OF COSMETOLOGY                  ,SC,29418-5667,Proprietary  ,11,31,42,64,176,240
03293300,STRAND COLLEGE OF HAIR DESIGN           ,SC,29572-4310,Proprietary  ,4,20,24,30,120,150
03304300,CENTURA COLLEGE                         ,SC,29406-9235,Proprietary  ,40,252,292,175,1225,1400
03513300,LACY COSMETOLOGY SCHOOL                 ,SC,29803-9084,Proprietary  ,7,14,21,28,77,105
03513301,LACY COSMETOLOGY SCHOOL -               ,SC,29072-0000,Proprietary  ,0,7,7,9,46,55
03513302,LACY COSMETOLOGY SCHOOL -               ,SC,29445-0000,Proprietary  ,4,20,24,26,89,115
03595300,CHARLESTON SCHOOL OF MASSAGE            ,SC,29412-8270,Proprietary  ,6,19,25,30,84,114
03709301,EDWARD VIA VIRGINIA COLLEGE OF OSTEOPATH,SC,29303-3639,Private      ,1,21,22,30,374,404
03746300,LEGRAND INSTITUTE OF COSMETOLOGY        ,SC,29020-0000,Proprietary  ,0,11,11,24,61,85
03746400,SOUTHEASTERN INSTITUTE                  ,SC,29210-0000,Proprietary  ,10,50,60,64,327,391
03768400,STYLETRENDS BARBER AND HAIRSTYLING ACADE,SC,29730-4511,Proprietary  ,2,12,14,13,84,97
03856400,W. L. BONNER COLLEGE                    ,SC,29203-0000,Private      ,2,8,10,8,73,81
03892300,HARLEY'S BEAUTY & BARBER CAREER INST.   ,SC,29204-1919,Proprietary  ,5,17,22,28,112,140
04083300,MARION COUNTY TECHNICAL EDUCATION CENTER,SC,29571-0000,Public       ,1,11,12,22,121,143
04096300,CHARLESTON SCHOOL OF LAW                ,SC,29402-0535,Proprietary  ,3,31,34,33,1300,1333
04158100,AIKEN SCHOOL OF COSMETOLOGY             ,SC,29801-4026,Proprietary  ,5,14,19,31,88,119
04166900,COSMETIC ARTS INSTITUTE                 ,SC,29488-2753,Proprietary  ,3,21,24,9,73,82
04172600,SALON 496 BARBER ACADEMY                ,SC,29607-2548,Proprietary  ,3,23,26,29,148,177
04192600,PALMETTO BEAUTY SCHOOL                  ,SC,29307-1424,Proprietary  ,4,19,23,4,19,23
00345800,AUGUSTANA COLLEGE                       ,SD,57197-0001,Private      ,20,19,39,1905,271,2176
00345900,BLACK HILLS STATE UNIVERSITY            ,SD,57799-9670,Public       ,53,159,212,2541,2040,4581
00346100,DAKOTA WESLEYAN UNIVERSITY              ,SD,57301-4398,Private      ,17,11,28,684,306,990
00346300,DAKOTA STATE UNIVERSITY                 ,SD,57042-1799,Public       ,21,63,84,1315,911,2226
00346500,MOUNT MARTY COLLEGE                     ,SD,57078-3724,Private      ,13,34,47,565,507,1072
00346600,NORTHERN STATE UNIVERSITY               ,SD,57401-7198,Public       ,29,58,87,1681,814,2495
00346700,PRESENTATION COLLEGE                    ,SD,57401-1299,Private      ,8,37,45,451,508,959
00346900,UNIVERSITY OF SIOUX FALLS               ,SD,57105-1699,Private      ,23,45,68,1221,616,1837
00347000,SOUTH DAKOTA SCH OF MINES & TECH        ,SD,57701-3995,Public       ,25,45,70,1565,694,2259
00347100,SOUTH DAKOTA STATE UNIVERSITY           ,SD,57007-2298,Public       ,111,198,309,8634,3405,12039
00347400,UNIVERSITY OF SOUTH DAKOTA              ,SD,57069-2390,Public       ,93,302,395,5127,4994,10121
00405600,SIOUX FALLS SEMINARY                    ,SD,57105-2729,Private      ,0,7,7,1,98,99
00405700,NATIONAL AMERICAN UNIVERSITY            ,SD,57701-3692,Proprietary  ,162,2104,2266,944,12342,13286
00405707,NATIONAL AMERICAN UNIVERSITY            ,SD,57105-0000,Proprietary  ,6,61,67,84,789,873
00492900,MCKENNAN HOSP-RADOLOGICAL TECH          ,SD,57101-0000,Private      ,0,0,0,24,38,62
00530900,LAKE AREA TECHNICAL INSTITUTE           ,SD,57201-2869,Public       ,37,52,89,954,683,1637
00598700,AVERA SACRED HEART HOSPITAL SCHOOL OF RA,SD,57078-3899,Private      ,0,0,0,10,9,19
00776400,SOUTHEAST TECHNICAL INST                ,SD,57107-0000,Public       ,73,258,331,1431,1860,3291
00828400,MITCHELL TECHNICAL INSTITUTE            ,SD,57301-2002,Public       ,22,27,49,707,478,1185
01013800,STEWART SCHOOL                          ,SD,57104-0000,Proprietary  ,6,20,26,114,127,241
01014804,COLORADO TECHNICAL UNIVERSITY           ,SD,57108-2272,Proprietary  ,9,84,93,251,1251,1502
01017000,WESTERN DAKOTA TECHNICAL INSTITUTE      ,SD,57701-4018,Public       ,41,156,197,546,1157,1703
01147701,SIOUX VALLEY HOSP-MEDICAL TECH          ,SD,57117-5039,Private      ,0,1,1,18,34,52
01465900,OGLALA LAKOTA COLLEGE                   ,SD,57752-0490,Public       ,25,138,163,341,1475,1816
02137100,BLACK HILLS BEAUTY COLLEGE              ,SD,57701-0000,Proprietary  ,7,11,18,89,113,202
02143700,SINTE GLESKA UNIVERSITY                 ,SD,57570-0000,Public       ,3,46,49,127,615,742
02144600,KILIAN COMMUNITY COLLEGE                ,SD,57103-7020,Private      ,13,56,69,103,493,596
02277300,SISSETON WAHPETON COLLEGE               ,SD,57262-0000,Public       ,3,13,16,35,193,228
02297800,HEADLINES ACADEMY                       ,SD,57701-0000,Proprietary  ,7,21,28,57,129,186
00347700,AQUINAS COLLEGE                         ,TN,37205-2086,Private      ,9,75,84,278,936,1214
00347701,AQUINAS COLLEGE -  PRIMETIME PROGRAM    ,TN,37214-3644,Private      ,0,0,0,7,60,67
00347800,AUSTIN PEAY STATE UNIVERSITY            ,TN,37044-0002,Public       ,249,751,1000,8188,9104,17292
00347900,BELMONT UNIVERSITY                      ,TN,37212-3757,Private      ,168,219,387,7007,3966,10973
00348000,BETHEL UNIVERSITY                       ,TN,38201-1705,Private      ,67,778,845,1903,5717,7620
00348100,CARSON-NEWMAN COLLEGE                   ,TN,37760-2204,Private      ,63,59,122,3212,897,4109
00348200,CHRISTIAN BROTHERS UNIVERSITY           ,TN,38104-5581,Private      ,54,168,222,2332,1890,4222
00348300,COLUMBIA STATE COMMUNITY COLLEGE        ,TN,38401-5653,Public       ,157,461,618,3262,4184,7446
00348500,CUMBERLAND UNIVERSITY                   ,TN,37087-3554,Private      ,32,112,144,1517,1208,2725
00348600,LIPSCOMB UNIVERSITY                     ,TN,37204-3951,Private      ,75,187,262,3608,2583,6191
00348700,EAST TENNESSEE STATE UNIV - MAIN CAMPUS ,TN,37614-2857,Public       ,238,539,777,12117,8736,20853
00348701,EAST TENNESSEE STATE UNIV - MEDICINE    ,TN,37614-1708,Public       ,18,37,55,379,665,1044
00348709,EAST TENNESSEE STATE UNIV - PHARMACY    ,TN,37614-1704,Public       ,7,10,17,149,455,604
00349000,FISK UNIVERSITY                         ,TN,37208-3045,Private      ,31,48,79,1409,700,2109
00349200,FREED-HARDEMAN UNIVERSITY               ,TN,38340-2399,Private      ,20,47,67,1889,951,2840
00349400,HIWASSEE COLLEGE                        ,TN,37354-4001,Private      ,13,10,23,317,153,470
00349500,JOHNSON BIBLE COLLEGE                   ,TN,37998-9775,Private      ,14,31,45,713,447,1160
00349600,KING COLLEGE                            ,TN,37620-2699,Private      ,36,198,234,1383,1813,3196
00349800,LAMBUTH UNIVERSITY                      ,TN,38301-5296,Private      ,0,0,0,530,214,744
00349900,LANE COLLEGE                            ,TN,38301-4598,Private      ,68,101,169,3211,1437,4648
00350000,LEE UNIVERSITY                          ,TN,37320-0000,Private      ,71,125,196,3989,1701,5690
00350100,LEMOYNE-OWEN COLLEGE                    ,TN,38126-6510,Private      ,53,144,197,1478,2281,3759
00350200,LINCOLN MEMORIAL UNIVERSITY             ,TN,37752-7920,Private      ,38,130,168,2135,4395,6530
00350400,MARTIN METHODIST COLLEGE                ,TN,38478-2799,Private      ,21,44,65,980,564,1544
00350500,MARYVILLE COLLEGE                       ,TN,37804-5907,Private      ,37,35,72,1926,368,2294
00350600,MEHARRY MEDICAL COLLEGE                 ,TN,37208-0000,Private      ,4,39,43,96,1395,1491
00350700,MEMPHIS COLLEGE OF ART                  ,TN,38104-2764,Private      ,17,36,53,753,369,1122
00350900,UNIVERSITY OF MEMPHIS (THE)             ,TN,38152-4611,Public       ,410,1187,1597,17011,19636,36647
00351000,MIDDLE TENNESSEE STATE UNIV             ,TN,37130-0000,Public       ,576,1075,1651,24306,15516,39822
00351100,MILLIGAN COLLEGE                        ,TN,37682-4001,Private      ,22,51,73,1186,745,1931
00351700,SOUTHERN COLLEGE OF OPTOMETRY           ,TN,38104-2222,Private      ,1,13,14,32,655,687
00351800,SOUTHERN ADVENTIST UNIVERSITY           ,TN,37315-0370,Private      ,57,68,125,2773,1053,3826
00351900,RHODES COLLEGE                          ,TN,38112-1690,Private      ,80,59,139,3209,597,3806
00352200,TENNESSEE STATE UNIVERSITY              ,TN,37209-1561,Public       ,305,848,1153,10436,10419,20855
00352300,TENNESSEE TECHNOLOGICAL UNIV            ,TN,38505-0001,Public       ,207,251,458,10276,4486,14762
00352400,TENNESSEE TEMPLE UNIVERSITY             ,TN,37404-3587,Private      ,10,86,96,410,966,1376
00352500,TENNESSEE WESLEYAN COLLEGE              ,TN,37371-0040,Private      ,16,46,62,1167,578,1745
00352600,TREVECCA NAZARENE UNIVERSITY            ,TN,37210-2877,Private      ,24,175,199,1481,2169,3650
00352700,TUSCULUM COLLEGE                        ,TN,37743-0001,Private      ,50,128,178,2290,1940,4230
00352800,UNION UNIVERSITY                        ,TN,38305-3697,Private      ,41,221,262,2909,2924,5833
00352900,UNIVERSITY OF TENNESSEE-CHATTANOOGA     ,TN,37403-2598,Public       ,324,408,732,13170,5642,18812
00353000,UNIVERSITY OF TENNESSEE-KNOXVILLE       ,TN,37996-0150,Public       ,490,646,1136,26984,11365,38349
00353006,UNIVERSITY OF TENNESSEE-HEALTH SCI CTR  ,TN,38103-0000,Public       ,15,114,129,423,3486,3909
00353100,UNIVERSITY OF TENNESSEE-MARTIN          ,TN,38238-0002,Public       ,152,270,422,7519,4098,11617
00353400,UNIVERSITY OF THE SOUTH                 ,TN,37383-1000,Private      ,45,14,59,2003,139,2142
00353500,VANDERBILT UNIVERSITY                   ,TN,37240-0001,Private      ,331,217,548,15857,6828,22685
00353501,VANDERBILT UNIV MED CTR ALLIEDHEAL      ,TN,37232-5510,Private      ,3,16,19,54,219,273
00353502,VANDERBILT UNIV - SCH OF MED            ,TN,37232-0000,Private      ,17,21,38,274,1004,1278
00353600,BRYAN COLLEGE                           ,TN,37321-7000,Private      ,18,93,111,1249,801,2050
00399800,CHATTANOOGA STATE COMMUNITY COLLEGE     ,TN,37406-1097,Public       ,372,1126,1498,5765,10837,16602
00399900,CLEVELAND STATE COMMUNITY COLLEGE       ,TN,37312-2858,Public       ,85,302,387,2011,3230,5241
00402500,TN TECHNOLOGY CTR AT KNOXVILLE          ,TN,37919-2327,Public       ,45,219,264,631,1802,2433
00402600,TENNESSEE TECH. CNTR AT CROSSVILLE      ,TN,38555-4142,Public       ,25,54,79,302,560,862
00461700,NATIONAL COLLEGE OF BUSINESS & TECH     ,TN,37211-6605,Proprietary  ,22,168,190,341,2510,2851
00493400,DAYMAR INSTITUTE                        ,TN,37217-1056,Proprietary  ,55,324,379,551,2983,3534
00493700,JACKSON STATE COMMUNITY COLLEGE         ,TN,38301-3797,Public       ,134,522,656,3282,5248,8530
00493800,SOUTH COLLEGE                           ,TN,37909-3323,Proprietary  ,42,283,325,485,2216,2701
00494700,WEST TENNESSEE BUSINESS COLLEGE         ,TN,38301-3256,Proprietary  ,14,67,81,144,528,672
00528000,TN TECHNOLOGY CTR AT COVINGTON          ,TN,38019-0249,Public       ,10,36,46,117,381,498
00528100,TN TECHNOLOGY CTR AT ELIZABETHTON       ,TN,37643-0789,Public       ,40,126,166,334,982,1316
00528200,TN TECHNOLOGY CTR AT HARTSVILLE         ,TN,37074-0000,Public       ,16,56,72,204,429,633
00528300,TN TECHNOLOGY CTR AT NEWBERN            ,TN,38059-1198,Public       ,10,76,86,130,618,748
00530700,TN TECHNOLOGY CTR AT MCMINNVILLE        ,TN,37110-1322,Public       ,21,52,73,194,402,596
00535100,TENNESSEE TECHNOLOGY CENTER AT MORRISTOW,TN,37813-2094,Public       ,27,102,129,476,1184,1660
00535200,TN TECHNOLOGY CENTER AT MCKENZIE        ,TN,38201-1620,Public       ,9,55,64,141,383,524
00535300,TN TECHNOLOGY CENTER AT LIVINGSTON      ,TN,38570-0219,Public       ,16,44,60,253,439,692
00535400,TN TECHNOLOGY CTR AT JACKSON            ,TN,38301-0000,Public       ,28,128,156,475,1167,1642
00535600,TENNESSEE TECHNOLOGY CENTER AT HOHENWALD,TN,38462-0000,Public       ,11,51,62,259,600,859
00535700,TENNESSEE TECHNOLOGY CENTER AT CRUMP    ,TN,38327-3402,Public       ,15,53,68,196,467,663
00535800,TN TECHNOLOGY CENTER AT ATHENS          ,TN,37371-0848,Public       ,20,44,64,218,479,697
00535900,TENNESSEE TECHNOLOGY CENTER AT NASHVILLE,TN,37209-0000,Public       ,59,311,370,575,2070,2645
00536000,TENNESSEE TECHNOLOGY CENTER AT MEMPHIS  ,TN,38105-3604,Public       ,60,282,342,817,2318,3135
00537800,NORTHEAST STATE COMMUNITY COLLEGE       ,TN,37617-0246,Public       ,193,549,742,3562,6021,9583
00537900,TN TECHNOLOGY CTR AT SHELBYVILLE        ,TN,37160-3697,Public       ,22,86,108,335,876,1211
00683500,DYERSBURG STATE COMMUNITY COLLEGE       ,TN,38024-0000,Public       ,101,356,457,1891,3758,5649
00683600,MOTLOW STATE COMMUNITY COLLEGE          ,TN,37388-7972,Public       ,186,460,646,3220,4057,7277
00732941,ITT TECHNICAL INSTITUTE                 ,TN,37932-3343,Proprietary  ,204,601,805,1126,3529,4655
00732958,ITT TECHNICAL INSTITUTE                 ,TN,37214-3717,Proprietary  ,148,539,687,977,2861,3838
00743900,FOUNTAINHEAD COLLEGE OF TECHNOLOGY      ,TN,37918-2583,Proprietary  ,17,101,118,151,649,800
00778200,TENNESSEE TECHNOLOGY CENTER AT DICKSON  ,TN,37055-0000,Public       ,27,106,133,327,979,1306
00778300,MIDDLE TENNESSEE SCH OF ANESTHESIA      ,TN,37116-0000,Private      ,1,7,8,54,253,307
00793803,NASHVILLE AUTO DIESEL COLLEGE - NASHVILL,TN,37206-3210,Proprietary  ,209,164,373,2552,1351,3903
00814500,NASHVILLE STATE TECH CMNTY COLLEGE      ,TN,37209-0000,Public       ,308,1205,1513,4315,10568,14883
00865500,GENESIS CAREER COLLEGE OF COOKEVILLE    ,TN,38501-1959,Proprietary  ,32,84,116,180,520,700
00885900,JOHN A GUPTON COLLEGE                   ,TN,37203-2934,Private      ,3,18,21,116,212,328
00886300,WALTERS STATE COMMUNITY COLLEGE         ,TN,37813-6899,Public       ,250,549,799,4441,5426,9867
00946400,TN TECHNOLOGY CTR AT PULASKI            ,TN,38478-4541,Public       ,8,54,62,121,323,444
00956700,TENNESSEE SCHOOL OF BEAUTY              ,TN,37921-3303,Proprietary  ,26,83,109,229,585,814
00971000,TENNESSEE TECHNOLOGY CENTER AT ONEIDA/HU,TN,37756-4149,Public       ,20,28,48,135,258,393
00991200,VOLUNTEER STATE COMMUNITY COLLEGE       ,TN,37066-3188,Public       ,236,646,882,4266,6449,10715
00991400,ROANE STATE COMMUNITY COLLEGE           ,TN,37748-8664,Public       ,162,509,671,3916,5643,9559
00998200,CRICHTON COLLEGE                        ,TN,38111-4745,Proprietary  ,22,254,276,271,1673,1944
01032600,TN TECHNOLOGY CTR AT HARRIMAN           ,TN,37748-1109,Public       ,26,36,62,201,393,594
01043900,SOUTHWEST TENNESSEE COMMUNITY COLLG     ,TN,38104-3322,Public       ,492,1740,2232,8577,17645,26222
01044700,"PLAZA BEAUTY SCHOOL, INC.               ",TN,38117-4822,Proprietary  ,6,39,45,120,334,454
01046000,AMERICAN BAPTIST THEOLOGICAL SEMINA     ,TN,37207-4994,Private      ,2,15,17,36,197,233
01052900,MEMPHIS THEOLOGICAL SEMINARY            ,TN,38104-0000,Private      ,0,28,28,10,301,311
01070000,TN TECHNOLOGY CENTER AT JACKSBORO       ,TN,37757-2461,Public       ,7,32,39,161,324,485
01155300,WM R MOORE COLLEGE OF TECHNOLOGY        ,TN,38104-0000,Private      ,9,50,59,108,311,419
01216400,TENNESSEE TECHNICAL CNTR AT RIPLEY      ,TN,38063-7359,Public       ,1,30,31,51,320,371
01254700,EMMANUEL SCHOOL OF RELIGION             ,TN,37601-0000,Private      ,1,3,4,5,79,84
01269300,PELLISSIPPI STATE COMMUNITY COLLEGE     ,TN,37933-0990,Public       ,338,838,1176,6324,7989,14313
02069303,VATTEROTT COLLEGE -                     ,TN,38016-5877,Proprietary  ,19,89,108,170,668,838
02092800,TENNESSEE TECHNOLOGY CENTER AT WHITEVILL,TN,38075-0000,Public       ,12,30,42,139,311,450
02103500,TN TECHNOLOGY CTR AT MURFREESBORO       ,TN,37129-0000,Public       ,24,93,117,323,816,1139
02106400,O'MORE COLLEGE OF DESIGN                ,TN,37064-0000,Private      ,8,8,16,197,100,297
02125300,NASHVILLE CLG OF MEDICAL CAREERS        ,TN,37115-0000,Proprietary  ,5,41,46,53,281,334
02153100,JON NAVE UNIVERSITY OF COSMETOLOGY      ,TN,37013-3347,Proprietary  ,22,59,81,271,453,724
02157100,CONCORDE CAREER COLLEGE                 ,TN,38137-0000,Proprietary  ,43,234,277,513,1908,2421
02160307,INTERNATIONAL ACADEMY OF DESIGN & TECH  ,TN,37212-0000,Proprietary  ,28,62,90,442,731,1173
02188300,PENTECOSTAL THEOLOGICAL SEMINARY        ,TN,37320-0000,Private      ,0,17,17,2,198,200
02204200,"CHATTANOOGA COLLEGE - MEDICAL, DENTAL AN",TN,37411-0000,Proprietary  ,19,102,121,179,776,955
02237900,TN TECHNOLOGY CENTER AT PARIS           ,TN,38242-0000,Public       ,20,90,110,176,618,794
02255000,KNOXVILLE INSTITUTE OF HAIR DESIGN      ,TN,37917-0000,Proprietary  ,9,51,60,80,302,382
02257400,ARNOLD'S BEAUTY SCHOOL                  ,TN,38358-0000,Proprietary  ,11,17,28,41,77,118
02263104,ANTHEM COLLEGE - ANTHEM CAREER COLLEGE -,TN,37214-2531,Proprietary  ,8,37,45,68,211,279
02275500,REUBEN-ALLEN COLLEGE                    ,TN,37922-0000,Proprietary  ,14,38,52,88,186,274
02278700,MR WAYNES SCH OF UNISEX HAIR DESIGN     ,TN,38501-0000,Proprietary  ,0,18,18,27,85,112
02293900,VOLUNTEER BEAUTY ACADEMY-NASHVILLE      ,TN,37115-2112,Proprietary  ,1,18,19,16,85,101
02294000,VOLUNTEER BEAUTY ACADEMY-DYERSBURG      ,TN,38024-1622,Proprietary  ,5,12,17,33,121,154
02326200,KAPLAN CAREER INSTITUTE                 ,TN,37212-5318,Proprietary  ,17,181,198,283,1367,1650
02326300,MEDVANCE INSTITUTE                      ,TN,38501-4305,Proprietary  ,11,56,67,110,447,557
02335900,VOLUNTEER BEAUTY ACADEMY-NASHVILLE      ,TN,37209-3033,Proprietary  ,5,23,28,39,132,171
02539800,QUEEN CITY COLLEGE                      ,TN,37042-0000,Proprietary  ,5,40,45,69,295,364
02540000,TENNESSEE ACADEMY OF COSMETOLOGY        ,TN,38133-0000,Proprietary  ,8,40,48,87,277,364
02578200,NOSSI COLLEGE OF ART                    ,TN,37115-5138,Proprietary  ,24,28,52,298,343,641
02595000,FAYETTEVILLE BEAUTY SCHOOL              ,TN,37334-2909,Proprietary  ,2,19,21,34,91,125
02599710,VATTEROTT COLLEGE - MEMPHIS             ,TN,38132-1714,Proprietary  ,25,208,233,273,1514,1787
02605501,REMINGTON COLLEGE - MEMPHIS CAMPUS      ,TN,38132-0000,Private      ,41,285,326,508,1937,2445
02609204,VATTEROTT COLLEGE - VATTEROTT CAREER COL,TN,38133-4727,Proprietary  ,21,99,120,151,732,883
02614200,MILLER MOTTE BUSINESS COLLEGE           ,TN,37040-6023,Proprietary  ,27,144,171,282,1109,1391
02614203,MILLER - MOTTE TECHNICAL COLLEGE - CHATT,TN,37421-7220,Proprietary  ,25,112,137,245,898,1143
02614204,MILLER - MOTTE TECHNICAL COLLEGE - MADIS,TN,37072-1870,Proprietary  ,22,95,117,164,764,928
03001800,FREE WILL BAPTIST BIBLE COLLEGE         ,TN,37205-2498,Private      ,6,16,22,211,180,391
03008800,FRANKLIN ACADEMY                        ,TN,37312-3939,Private      ,10,19,29,37,109,146
03010606,VIRGINIA COLLEGE - SCH OF BUSNSS & HLTH ,TN,37411-5600,Proprietary  ,9,74,83,89,608,697
03024900,TENNESSEE ACADEMY OF COSMETOLOGY        ,TN,38125-3442,Proprietary  ,8,46,54,102,290,392
03061100,GENESIS CAREER COLLEGE OF LEBANON       ,TN,37087-2718,Proprietary  ,12,51,63,125,303,428
03076405,BRYMAN SCHOOL OF ARIZONA (THE) - ANTHEM ,TN,38134-7345,Proprietary  ,0,9,9,22,104,126
03079100,NORTH CENTRAL INSTITUTE                 ,TN,37042-3116,Proprietary  ,3,32,35,28,159,187
03088800,"WATKINS COLLEGE OF ART, DESIGN & FILM   ",TN,37228-1306,Private      ,17,32,49,545,337,882
03126900,STYLES & PROFILES BEAUTY COLLEGE        ,TN,38375-2109,Proprietary  ,4,7,11,16,32,48
03355400,RICHMONT GRADUATE UNIVERSITY            ,TN,37404-0000,Private      ,2,23,25,5,257,262
03440300,BAPTIST MEMORIAL COLLEGE OF HEALTH      ,TN,38104-3104,Private      ,15,146,161,829,2112,2941
03480303,MEDVANCE INSTITUTE - NASHVILLE          ,TN,37203-1536,Proprietary  ,18,131,149,193,963,1156
03513500,WILLIAMSON CHRISTIAN COLLEGE            ,TN,37067-8237,Private      ,1,10,11,24,99,123
03647300,NEW CONCEPTS SCHOOL OF COSMETOLOGY      ,TN,37311-7373,Proprietary  ,3,9,12,24,81,105
03683300,INTERNATIONAL BARBER & STYLE COLLEGE    ,TN,37209-0000,Proprietary  ,11,49,60,53,195,248
03701300,MEMPHIS INSTITUTE OF BARBERING          ,TN,38107-4334,Proprietary  ,16,56,72,124,366,490
03774400,SHEAR ACADEMY                           ,TN,38555-4177,Proprietary  ,4,9,13,16,71,87
03830300,SAE INSTITUTE OF TECHNOLOGY             ,TN,37203-4310,Proprietary  ,20,46,66,202,302,504
03840300,OXFORD GRADUATE SCHOOL                  ,TN,37321-6736,Private      ,0,2,2,3,35,38
03841300,CAREER BEAUTY COLLEGE                   ,TN,38464-3634,Proprietary  ,2,18,20,18,65,83
03920300,INSTITUTE OF HAIR DESIGN                ,TN,38310-1801,Proprietary  ,0,7,7,20,40,60
03930300,BUCHANAN BEAUTY COLLEGE                 ,TN,37160-2741,Proprietary  ,10,14,24,34,96,130
03982300,VISIBLE SCHOOL - MUSIC AND WORSHIPS ARTS,TN,38104-5814,Private      ,2,8,10,125,74,199
04035300,NAVE COSMETOLOGY ACADEMY                ,TN,38401-6335,Proprietary  ,5,29,34,55,153,208
04124100,ELITE COLLEGE OF COSMETOLOGY            ,TN,38351-1431,Proprietary  ,1,8,9,33,99,132
04157200,LOVE BEAUTY SCHOOL                      ,TN,37355-2950,Proprietary  ,5,19,24,29,95,124
04165000,MERIDIAN INSTITUTE OF SURGICAL ASSISTING,TN,37080-0758,Proprietary  ,0,40,40,3,222,225
04174600,NASHVILLE BARBER AND STYLE ACADEMY      ,TN,37208-2826,Proprietary  ,6,29,35,25,108,133
00353700,ABILENE CHRISTIAN UNIVERSITY            ,TX,79699-3701,Private      ,146,119,265,4707,1689,6396
00353900,ALVIN COMMUNITY COLLEGE                 ,TX,77511-4807,Public       ,124,370,494,1466,3278,4744
00354000,AMARILLO COLLEGE                        ,TX,79109-2446,Public       ,289,979,1268,3476,7730,11206
00354100,ANGELO STATE UNIVERSITY                 ,TX,76909-5069,Public       ,192,213,405,6931,3525,10456
00354300,AUSTIN COLLEGE                          ,TX,75090-4440,Private      ,56,27,83,2400,295,2695
00354400,AUSTIN PRESBYTERIAN THEOLOGICAL SEM     ,TX,78705-5797,Private      ,0,7,7,1,149,150
00354500,BAYLOR UNIVERSITY                       ,TX,76798-1458,Private      ,741,332,1073,22608,5652,28260
00354600,COASTAL BEND COLLEGE                    ,TX,78102-2197,Public       ,104,234,338,1560,2431,3991
00354900,BLINN COLLEGE                           ,TX,77833-4098,Public       ,621,618,1239,12070,5897,17967
00355300,CISCO JUNIOR COLLEGE                    ,TX,76437-9803,Public       ,129,352,481,2216,3145,5361
00355400,CLARENDON COLLEGE                       ,TX,79226-0000,Public       ,33,69,102,548,704,1252
00355600,COMMONWEALTH INST OF FUNERAL SVC        ,TX,77090-5918,Private      ,3,43,46,81,383,464
00355700,CONCORDIA UNIVERSITY TEXAS              ,TX,78726-4141,Private      ,45,355,400,1628,2682,4310
00355800,NORTH CENTRAL TEXAS COLLEGE             ,TX,76240-4699,Public       ,283,611,894,3377,5406,8783
00356000,DALLAS BAPTIST UNIVERSITY               ,TX,75211-9299,Private      ,144,407,551,3103,4557,7660
00356100,CEDAR VALLEY COLLEGE                    ,TX,75134-0000,Public       ,146,562,708,2303,5016,7319
00356200,DALLAS THEOLOGICAL SEM                  ,TX,75204-0000,Private      ,1,67,68,25,713,738
00356300,DEL MAR COLLEGE                         ,TX,78404-3897,Public       ,374,987,1361,5335,9385,14720
00356400,EAST TEXAS BAPTIST UNIVERSITY           ,TX,75670-1423,Private      ,49,34,83,1647,485,2132
00356500,TEXAS A&M UNIVERSITY - COMMERCE         ,TX,75429-3011,Public       ,147,568,715,5261,7922,13183
00356800,FRANK PHILLIPS COLLEGE                  ,TX,79008-0000,Public       ,17,64,81,371,571,942
00357000,GRAYSON COUNTY COLLEGE                  ,TX,75020-8299,Public       ,141,544,685,1878,4641,6519
00357100,HARDIN-SIMMONS UNIVERSITY               ,TX,79698-6050,Private      ,46,60,106,2222,969,3191
00357200,TRINITY VALLEY COMMUNITY COLLEGE        ,TX,75751-2734,Public       ,159,554,713,2412,5033,7445
00357300,HILL COLLEGE                            ,TX,76645-2711,Public       ,55,145,200,922,1383,2305
00357301,HILL COLLEGE                            ,TX,76031-0000,Public       ,69,244,313,835,2101,2936
00357400,HOWARD COLLEGE                          ,TX,79720-0213,Public       ,111,263,374,1577,2890,4467
00357500,HOWARD PAYNE UNIVERSITY                 ,TX,76801-2715,Private      ,38,25,63,1452,395,1847
00357600,HOUSTON BAPTIST UNIVERSITY              ,TX,77074-3298,Private      ,170,265,435,4414,2630,7044
00357700,HUSTON - TILLOTSON UNIVERSITY           ,TX,78702-2795,Private      ,30,77,107,1095,825,1920
00357800,UNIVERSITY OF THE INCARNATE WORD        ,TX,78209-6398,Private      ,193,544,737,6294,6094,12388
00357900,JACKSONVILLE COLLEGE                    ,TX,75766-4759,Private      ,3,12,15,221,226,447
00358000,KILGORE COLLEGE                         ,TX,75662-3299,Public       ,214,571,785,3137,5251,8388
00358100,LAMAR UNIVERSITY-BEAUMONT               ,TX,77710-0042,Public       ,343,1011,1354,8246,9474,17720
00358200,LAREDO COMMUNITY COLLEGE                ,TX,78040-4395,Public       ,354,406,760,6276,4622,10898
00358300,LEE COLLEGE                             ,TX,77520-4796,Public       ,148,551,699,1885,4719,6604
00358400,LETOURNEAU UNIVERSITY                   ,TX,75607-0000,Private      ,29,203,232,1657,2922,4579
00358500,LON MORRIS COLLEGE                      ,TX,75766-2900,Private      ,14,12,26,838,275,1113
00358600,LUBBOCK CHRISTIAN UNIVERSITY            ,TX,79407-2099,Private      ,71,150,221,1598,1569,3167
00358800,UNIVERSITY OF MARY HARDIN-BAYLOR        ,TX,76513-2599,Private      ,105,103,208,3863,1594,5457
00359000,MCLENNAN COMMUNITY COLLEGE              ,TX,76708-1498,Public       ,296,897,1193,4479,8724,13203
00359100,MCMURRY UNIVERSITY                      ,TX,79697-0001,Private      ,52,49,101,1651,765,2416
00359200,MIDWESTERN STATE UNIVERSITY             ,TX,76308-2099,Public       ,144,215,359,4339,3389,7728
00359300,NAVARRO COLLEGE                         ,TX,75110-4818,Public       ,281,757,1038,4959,7312,12271
00359400,UNIVERSITY OF NORTH TEXAS               ,TX,76203-5017,Public       ,1030,1367,2397,29133,21537,50670
00359500,OBLATE SCHOOL OF THEOLOGY               ,TX,78216-0000,Private      ,1,5,6,8,34,42
00359600,ODESSA COLLEGE                          ,TX,79764-7127,Public       ,122,316,438,1762,2974,4736
00359800,OUR LADY OF THE LAKE UNIVERSITY         ,TX,78207-4689,Private      ,41,211,252,2340,3156,5496
00359900,UNIVERSITY OF TEXAS - PAN AMERICAN      ,TX,78541-2999,Public       ,483,613,1096,17038,10680,27718
00360000,PANOLA COLLEGE                          ,TX,75633-2397,Public       ,63,217,280,987,2040,3027
00360100,PARIS JR COLLEGE                        ,TX,75460-6298,Public       ,131,508,639,2004,4035,6039
00360200,PAUL QUINN COLLEGE                      ,TX,75241-4398,Private      ,15,66,81,335,599,934
00360300,RANGER COLLEGE                          ,TX,76470-3298,Public       ,38,93,131,595,773,1368
00360305,RANGER COLLEGE-STEPHENVILE BEAUTY COLLEG,TX,76401-5136,Public       ,7,10,17,53,73,126
00360400,RICE UNIVERSITY                         ,TX,77251-1892,Private      ,257,229,486,9905,2970,12875
00360600,SAM HOUSTON STATE UNIVERSITY            ,TX,77340-0000,Public       ,614,673,1287,17087,9034,26121
00360700,ALAMO CMTY CLG DISTRICT PROGRAM         ,TX,78207-0000,Public       ,95,318,413,1387,2632,4019
00360800,ST PHILLIPS COLLEGE                     ,TX,78203-2098,Public       ,392,1348,1740,5205,11930,17135
00360900,SAN JACINTO CLG-CENTRAL-NORTH-SOUTH     ,TX,77501-0000,Public       ,785,1910,2695,9937,16098,26035
00361000,SCHREINER UNIVERSITY                    ,TX,78028-5697,Private      ,38,67,105,1356,601,1957
00361100,SOUTH PLAINS COLLEGE                    ,TX,79336-6504,Public       ,314,691,1005,5121,6022,11143
00361200,UNIV OF HOUSTON-DOWNTOWN                ,TX,77002-1001,Public       ,284,924,1208,6914,12091,19005
00361300,SOUTHERN METHODIST UNIVERSITY           ,TX,75275-0181,Private      ,265,383,648,7904,5921,13825
00361400,SOUTHWEST TEXAS JR COLLEGE              ,TX,78801-6221,Public       ,169,320,489,2772,3265,6037
00361500,TEXAS STATE UNIVERSITY--SAN MARCOS      ,TX,78666-4602,Public       ,1149,960,2109,31979,16737,48716
00361600,SOUTHWESTERN ASSEMBLIES OF GOD UNIV     ,TX,75165-2397,Private      ,49,127,176,1588,1298,2886
00361800,SOUTHWESTERN CHRISTIAN COLLEGE          ,TX,75160-3400,Private      ,3,14,17,217,142,359
00361900,SOUTHWESTERN ADVENTIST UNIVERSITY       ,TX,76059-1922,Private      ,14,25,39,691,454,1145
00362000,SOUTHWESTERN UNIVERSITY                 ,TX,78626-6111,Private      ,59,24,83,2390,305,2695
00362100,ST EDWARDS UNIVERSITY                   ,TX,78704-0000,Private      ,137,263,400,5274,3120,8394
00362300,ST MARY'S UNIV OF SAN ANTONIO           ,TX,78228-8500,Private      ,122,169,291,4525,3346,7871
00362400,STEPHEN F AUSTIN STATE UNIVERSITY       ,TX,75962-0001,Public       ,482,404,886,15160,5546,20706
00362500,SUL ROSS STATE UNIVERSITY               ,TX,79832-0113,Public       ,67,129,196,1825,2116,3941
00362600,TARRANT COUNTY COLLEGE                  ,TX,76102-6599,Public       ,1298,4173,5471,17960,33578,51538
00362700,TEMPLE COLLEGE                          ,TX,76504-7435,Public       ,174,715,889,2200,5940,8140
00362800,TEXARKANA COLLEGE                       ,TX,75599-0001,Public       ,105,413,518,1864,3211,5075
00363000,PRAIRIE VIEW A&M UNIVERSITY             ,TX,77446-2967,Public       ,304,439,743,11168,6579,17747
00363100,TARLETON STATE UNIVERSITY               ,TX,76402-0000,Public       ,323,484,807,7745,6927,14672
00363200,TEXAS A&M UNIVERSITY                    ,TX,77842-0000,Public       ,1404,704,2108,41915,10950,52865
00363400,TEXAS STATE TECHNICAL CLG AT WACO       ,TX,76705-1695,Public       ,207,569,776,2964,4809,7773
00363500,TEXAS CHIROPRACTIC COLLEGE              ,TX,77505-1699,Private      ,1,14,15,22,374,396
00363600,TEXAS CHRISTIAN UNIVERSITY              ,TX,76129-0001,Private      ,462,389,851,13964,4547,18511
00363700,JARVIS CHRISTIAN COLLEGE                ,TX,75765-1470,Private      ,22,16,38,605,237,842
00363800,TEXAS COLLEGE                           ,TX,75702-4500,Private      ,28,91,119,1105,902,2007
00363900,TEXAS A&M UNIVERSITY-KINGSVILLE         ,TX,78363-8203,Public       ,246,400,646,8015,6900,14915
00364100,TEXAS LUTHERAN UNIVERSITY               ,TX,78155-5999,Private      ,34,29,63,2025,375,2400
00364200,TEXAS SOUTHERN UNIVERSITY               ,TX,77004-4598,Public       ,380,1022,1402,10378,14050,24428
00364400,TEXAS TECH UNIVERSITY                   ,TX,79409-0000,Public       ,932,713,1645,25772,12003,37775
00364500,TEXAS WESLEYAN UNIVERSITY               ,TX,76105-1536,Private      ,56,235,291,1417,4078,5495
00364600,TEXAS WOMAN'S UNIVERSITY                ,TX,76204-5587,Public       ,206,833,1039,7089,12765,19854
00364700,TRINITY UNIVERSITY                      ,TX,78212-7200,Private      ,101,46,147,3676,791,4467
00364800,TYLER JUNIOR COLLEGE                    ,TX,75701-3436,Public       ,428,907,1335,8021,8670,16691
00365100,UNIVERSITY OF DALLAS                    ,TX,75062-4799,Private      ,60,150,210,2075,1590,3665
00365200,UNIVERSITY OF HOUSTON                   ,TX,77204-2010,Public       ,1324,2178,3502,34359,30703,65062
00365400,UNIVERSITY OF ST THOMAS                 ,TX,77006-4626,Private      ,51,296,347,1557,2626,4183
00365600,UNIVERSITY OF TEXAS-ARLINGTON           ,TX,76019-0000,Public       ,697,2153,2850,21622,27979,49601
00365800,UNIVERSITY OF TEXAS-AUSTIN              ,TX,78713-7758,Public       ,1312,1148,2460,43287,22434,65721
00365900,UT HEALTH CENTER-SAN ANTONIO            ,TX,78229-3900,Public       ,60,235,295,1053,3936,4989
00366100,UNIVERSITY OF TEXAS-EL PASO             ,TX,79968-0629,Public       ,452,915,1367,15308,13532,28840
00366200,VICTORIA COLLEGE                        ,TX,77901-4494,Public       ,136,379,515,1766,3411,5177
00366300,WAYLAND BAPTIST UNIVERSITY              ,TX,79072-6998,Private      ,59,430,489,1475,4180,5655
00366400,WEATHERFORD COLLEGE                     ,TX,76086-5699,Public       ,163,495,658,2388,3946,6334
00366500,WEST TEXAS A&M UNIVERSITY               ,TX,79016-0000,Public       ,206,306,512,5733,4039,9772
00366800,WHARTON COUNTY JR COLLEGE               ,TX,77488-3298,Public       ,238,427,665,2950,3723,6673
00366900,WILEY COLLEGE                           ,TX,75670-5199,Private      ,48,65,113,1079,951,2030
00400300,CENTRAL TEXAS COLLEGE                   ,TX,76540-4199,Public       ,298,2789,3087,3085,17627,20712
00407221,NORTHWOOD UNIVERSITY                    ,TX,75104-0000,Private      ,11,72,83,576,885,1461
00445300,EL CENTRO COLLEGE                       ,TX,75202-0000,Public       ,343,1631,1974,4529,12629,17158
00450303,EVEREST COLLEGE - FORT WORTH SOUTH      ,TX,76115-1407,Proprietary  ,30,196,226,187,965,1152
00481102,EVEREST INSTITUTE - EVEREST COLLEGE     ,TX,76011-6630,Proprietary  ,22,192,214,180,864,1044
00494800,TEXAS A&M UNIV SYSTEM HEALTH SCI CT     ,TX,77840-7896,Public       ,95,83,178,1556,2271,3827
00494900,BAYLOR COLLEGE OF MEDICINE              ,TX,77030-0000,Private      ,57,104,161,604,1806,2410
00495100,UNIV OF TEXAS HEALTH SCIENCE CENTER     ,TX,77225-0000,Public       ,29,177,206,591,3903,4494
00495200,UNIV OF TEXAS MEDICAL BRANCH            ,TX,77550-0000,Public       ,42,127,169,505,2744,3249
00497200,GALVESTON COLLEGE                       ,TX,77550-7447,Public       ,83,247,330,1168,2082,3250
00497700,SOUTH TEXAS COLLEGE OF LAW              ,TX,77002-0000,Private      ,4,69,73,54,2126,2180
00660600,BAPTIST HS SCHOOL OF HEALTH PROFESSIONS ,TX,78229-3234,Proprietary  ,16,126,142,192,1263,1455
00661200,COVENANT SCH OF NSG & ALLIED HEALTH     ,TX,79410-0000,Private      ,17,37,54,145,427,572
00666100,ANGELINA COLLEGE                        ,TX,75902-0000,Public       ,196,546,742,2481,4327,6808
00694100,DALLAS CHRISTIAN COLLEGE                ,TX,75234-7229,Private      ,15,64,79,337,527,864
00709600,COLLEGE OF THE MAINLAND                 ,TX,77591-2499,Public       ,112,479,591,1295,3536,4831
00728700,BRAZOSPORT COLLEGE                      ,TX,77566-3199,Public       ,150,316,466,1483,2242,3725
00732907,ITT TECHNICAL INSTITUTE                 ,TX,77063-3751,Proprietary  ,26,114,140,252,709,961
00732913,ITT TECHNICAL INSTITUTE                 ,TX,76011-3919,Proprietary  ,91,343,434,409,1446,1855
00732975,ITT TECHNICAL INSTITUTE                 ,TX,78249-3303,Proprietary  ,57,227,284,346,1205,1551
00754805,WESTWOOD COLLEGE OF TECHNOLOGY          ,TX,77074-0000,Proprietary  ,4,41,45,174,450,624
00793804,LINCOLN COLLEGE OF TECHNOLOGY - GRAND PR,TX,75052-7605,Proprietary  ,64,127,191,738,859,1597
00849800,MIMS CLASSIC BEAUTY COLLEGE             ,TX,78216-0000,Proprietary  ,7,13,20,47,106,153
00850300,MOUNTAIN VIEW COLLEGE                   ,TX,75211-6599,Public       ,231,787,1018,3970,6849,10819
00850400,RICHLAND COLLEGE                        ,TX,75243-2199,Public       ,363,1069,1432,5234,9488,14722
00851000,EASTFIELD COLLEGE                       ,TX,75150-2099,Public       ,334,1138,1472,4318,9161,13479
00907905,EVEREST COLLEGE                         ,TX,75206-5209,Proprietary  ,46,256,302,469,1860,2329
00908200,INTERNATIONAL BUSINESS COLLEGE          ,TX,79903-0000,Proprietary  ,25,95,120,165,569,734
00916300,SAN ANTONIO COLLEGE                     ,TX,78212-4299,Public       ,899,2363,3262,13016,22257,35273
00922500,TEXAS STATE TECHNICAL COLLEGE  HARLINGEN,TX,78550-3697,Public       ,227,436,663,3564,4380,7944
00946600,KAPLAN COLLEGE                          ,TX,78216-1899,Proprietary  ,34,190,224,271,1298,1569
00946607,KAPLAN COLLEGE - MCALLEN                ,TX,78503-1622,Proprietary  ,52,130,182,449,849,1298
00946609,KAPLAN COLLEGE - CAREER CENTERS OF TEXAS,TX,78416-9900,Proprietary  ,25,132,157,221,861,1082
00946610,KAPLAN COLLEGE - CAREER CENTERS OF TEXAS,TX,76103-2310,Proprietary  ,22,144,166,176,797,973
00954900,WESTERN TEXAS COLLEGE                   ,TX,79549-9501,Public       ,19,42,61,674,566,1240
00965100,TEXAS A&M INTERNATIONAL UNIVERSITY      ,TX,78041-1900,Public       ,197,204,401,5374,3553,8927
00974100,UNIVERSITY OF TEXAS AT DALLAS           ,TX,75083-0000,Public       ,343,649,992,9256,10345,19601
00976800,UNIVERSITY OF NORTH TEXAS HEALTH SCIENCE,TX,76107-2699,Public       ,15,99,114,332,2292,2624
00979700,MIDLAND COLLEGE                         ,TX,79705-6397,Public       ,110,307,417,1833,3111,4944
00982802,EVEREST INSTITUTE- AUSTIN               ,TX,78754-0000,Proprietary  ,59,286,345,326,1279,1605
00993000,UNIVERSITY OF TEXAS-PERMIAN BASIN       ,TX,79762-0001,Public       ,76,183,259,1938,2479,4417
00993200,TEXAS STATE TECH CLG-WEST TEXAS         ,TX,79556-4108,Public       ,20,78,98,330,797,1127
00993201,TEXAS STATE TECH COLLEGE-ABILENE        ,TX,79601-0000,Public       ,18,72,90,220,572,792
00993204,TEXAS STATE TECH CLG-BRECKENRIDGE       ,TX,76424-0000,Public       ,4,12,16,39,146,185
00993205,TEXAS STATE TECH COLLEGE-BROWNWOOD      ,TX,76801-0000,Public       ,10,33,43,92,326,418
01001900,UNIV OF TEXAS SOUTHWESTERN MED CTR      ,TX,75390-9096,Public       ,15,92,107,310,2168,2478
01005700,AMERICAN COMMERCIAL COLLEGE             ,TX,79602-1399,Proprietary  ,2,14,16,48,300,348
01005900,AMERICAN COMMERCIAL COLLEGE             ,TX,79761-0000,Proprietary  ,4,15,19,40,184,224
01005901,AMERICAN COMMERCIAL COLLEGE - AMERICAN C,TX,76310-2303,Proprietary  ,2,38,40,33,391,424
01006000,VERNON COLLEGE                          ,TX,76384-4092,Public       ,82,308,390,1226,2888,4114
01011500,UNIVERSITY OF TEXAS-SAN ANTONIO         ,TX,78249-0600,Public       ,1037,1227,2264,32623,19524,52147
01013000,WADE COLLEGE                            ,TX,75207-3199,Proprietary  ,21,31,52,220,344,564
01038700,EL PASO COMMUNITY COLLEGE               ,TX,79998-0000,Public       ,922,1936,2858,15271,18514,33785
01050900,HALLMARK COLLEGE OF AERONAUTICS         ,TX,78214-0000,Proprietary  ,48,181,229,243,1191,1434
01063300,HOUSTON COMMUNITY COLLEGE               ,TX,77002-0000,Public       ,1639,6099,7738,24209,55427,79636
01067400,TEXAS TECH U HEALTH SCIENCES CENTER     ,TX,79430-0000,Public       ,74,276,350,1176,4440,5616
01076100,DALLAS INSTITUTE OF FUNERAL SERVICE     ,TX,75227-4314,Private      ,4,65,69,66,410,476
01114500,LONE STAR COLLEGE SYSTEM                ,TX,77073-3499,Public       ,1507,4497,6004,19626,37516,57142
01116100,TEXAS A&M UNIV CORPUS CHRISTI           ,TX,78412-5599,Public       ,332,418,750,9584,6130,15714
01116300,UNIVERSITY OF TEXAS AT TYLER            ,TX,75799-6699,Public       ,177,373,550,4649,5025,9674
01171100,UNIVERSITY OF HOUSTON-CLEAR LAKE        ,TX,77058-1002,Public       ,114,618,732,2056,7992,10048
01201500,AUSTIN COMMUNITY COLLEGE                ,TX,78752-4390,Public       ,1234,3502,4736,16524,30145,46669
01202000,VICTORIA BEAUTY COLLEGE                 ,TX,77901-6233,Proprietary  ,3,17,20,46,123,169
01226800,BALDWIN BEAUTY SCHOOL #5                ,TX,78704-4785,Proprietary  ,17,70,87,131,374,505
01229700,LAREDO BEAUTY COLLEGE                   ,TX,78040-1051,Proprietary  ,8,25,33,105,245,350
01248200,ATI TECHNICAL TRAINING CENTER           ,TX,75235-4622,Proprietary  ,44,175,219,485,1991,2476
01248209,ATI CAREER TRAINING CENTER - GARLAND    ,TX,75041-2497,Proprietary  ,5,26,31,56,211,267
01248210,ATI CAREER TRAINING CENTER - WACO       ,TX,76711-1682,Proprietary  ,1,37,38,74,335,409
01248300,COSMETOLOGY CAREER CENTER-A PAUL MITCHEL,TX,75006-2567,Proprietary  ,98,126,224,372,570,942
01248800,INTERNATIONAL BEAUTY COLLEGE NO 3       ,TX,75040-0000,Proprietary  ,1,5,6,15,81,96
01276400,METROPLEX BEAUTY SCHOOL                 ,TX,75149-0000,Proprietary  ,3,20,23,21,129,150
01293000,CHARLES & SUE'S SCH OF HAIR DESIGN      ,TX,77801-0000,Proprietary  ,8,20,28,51,111,162
01293200,TINT SCHOOL OF MAKEUP & COSMETOLOGY     ,TX,75061-4235,Proprietary  ,7,12,19,34,104,138
01300300,NEILSON BEAUTY COLLEGE                  ,TX,75208-4637,Proprietary  ,5,20,25,20,104,124
01301600,OGLE SCHOOL HAIR SKIN NAILS             ,TX,76013-7400,Proprietary  ,39,122,161,214,579,793
01303912,SOUTH UNIVERSITY - THE ART INSTITUTE OF ,TX,75231-5993,Proprietary  ,85,136,221,1558,1649,3207
01323100,UNIVERSITY OF HOUSTON-VICTORIA          ,TX,77901-5731,Public       ,60,347,407,1527,3776,5303
02058600,CONLEE'S COLLEGE OF COSMETOLOGY         ,TX,78028-0000,Proprietary  ,6,12,18,27,43,70
02069302,VATTEROTT COLLEGE - VATTEROTT EDUCATION ,TX,75220-5441,Proprietary  ,0,14,14,39,275,314
02074100,CAPITOL CITY TRADE & TECHNICAL SCH      ,TX,78704-0000,Proprietary  ,31,98,129,214,511,725
02077400,NORTH LAKE COLLEGE                      ,TX,75038-0000,Public       ,202,659,861,2884,5728,8612
02081400,ARLINGTON BAPTIST COLLEGE               ,TX,76012-0000,Private      ,14,40,54,203,324,527
02093600,SOUTHWEST SCHOOL OF ELECTRONIC          ,TX,78735-0000,Proprietary  ,1,14,15,33,94,127
02098300,WESTERN TECHNICAL COLLEGE               ,TX,79927-2105,Proprietary  ,71,229,300,743,1673,2416
02100200,BROOKHAVEN COLLEGE                      ,TX,75244-0000,Public       ,196,798,994,2833,7197,10030
02113610,AMERICAN INTERCONTINENTAL UNIV - HOUSTON,TX,77042-4516,Proprietary  ,19,145,164,211,1071,1282
02116008,SANFORD-BROWN COLLEGE - HOUSTON         ,TX,77042-8900,Proprietary  ,67,243,310,412,1703,2115
02116012,SANFORD-BROWN COLLEGE - HOUSTON NORTH LO,TX,77008-1058,Proprietary  ,29,87,116,137,648,785
02117100,ART INSTITUTE OF HOUSTON                ,TX,77056-0000,Proprietary  ,505,619,1124,4898,4825,9723
02119200,COURT REPORTING INSTITUTE OF DALLAS     ,TX,75247-6913,Proprietary  ,10,107,117,73,853,926
02119202,COURT REPORTING INSTIUTE OF DALLAS - COU,TX,77040-6315,Proprietary  ,2,13,15,24,192,216
02128302,INSTITUTE FOR BUSINESS & TECHNOLOGY - LA,TX,78230-2520,Proprietary  ,22,97,119,135,514,649
02136800,AMERICAN COMMERCIAL COLLEGE             ,TX,76904-0000,Proprietary  ,4,44,48,43,264,307
02144800,VET TECH INSTITUTE OF HOUSTON           ,TX,77027-9881,Proprietary  ,28,41,69,296,310,606
02176100,PIPO ACADEMY OF HAIR DESIGN             ,TX,79903-0000,Proprietary  ,3,11,14,36,111,147
02200800,AMERICAN COMMERCIAL COLLEGE             ,TX,79411-0000,Proprietary  ,2,25,27,27,225,252
02218300,SOUTHWEST SCHOOL OF BUSINESS & TECHNICAL,TX,78221-0000,Proprietary  ,32,94,126,154,509,663
02218305,SOUTHWEST SCHOOL OF BUSINESS AND TECHNIC,TX,78501-6053,Proprietary  ,11,30,41,62,138,200
02218306,SOUTHWEST SCHOOL OF BUSINESS AND TECHNIC,TX,78413-2045,Proprietary  ,1,21,22,36,148,184
02224600,TRI-STATE BEAUTY SCHOOL #1              ,TX,79915-0000,Proprietary  ,7,51,58,111,391,502
02230500,OGLE SCHOOL HAIR SKIN NAILS             ,TX,76132-3638,Proprietary  ,46,128,174,344,906,1250
02230600,OGLE SCHOOL HAIR SKIN NAILS             ,TX,76053-4650,Proprietary  ,11,37,48,101,225,326
02239100,CENTRAL TEXAS BEAUTY COLLEGE #2         ,TX,78664-4204,Proprietary  ,20,49,69,84,279,363
02248200,MILAN INSTITUTE OF COSMETOLOGY          ,TX,79103-0000,Proprietary  ,140,481,621,877,2591,3468
02254800,TEXAS VOCATIONAL SCHOOLS                ,TX,77901-0000,Proprietary  ,7,23,30,59,159,218
02259400,AMBERTON UNIVERSITY                     ,TX,75041-0000,Private      ,2,60,62,38,393,431
02261300,EVEREST INSTITUTE                       ,TX,78213-3841,Proprietary  ,35,194,229,175,875,1050
02261302,EVEREST INSTITUTE - HOUSTON GREENSPOINT ,TX,77060-3249,Proprietary  ,36,157,193,186,778,964
02261303,EVEREST INSTITUTE - HOUSTON HOBBY       ,TX,77087-2737,Proprietary  ,34,191,225,181,772,953
02267100,EXPOSITO SCHOOL OF HAIR DESIGN          ,TX,79109-0000,Proprietary  ,6,19,25,37,83,120
02276000,FRANKLIN BEAUTY SCHOOL #2               ,TX,77021-0000,Proprietary  ,9,51,60,69,248,317
02285900,UNIVERSITY OF COSMETOLOGY ARTS&SCI      ,TX,78504-0000,Proprietary  ,39,83,122,193,442,635
02294800,CAPITOL CITY CAREERS                    ,TX,78745-0000,Proprietary  ,6,43,49,47,259,306
02298501,EVEREST COLLEGE- FORT WORTH             ,TX,76137-2472,Proprietary  ,32,155,187,158,813,971
02305300,PARKER COLLEGE OF CHIROPRACTIC          ,TX,75229-0000,Private      ,7,71,78,71,1160,1231
02306700,FORT WORTH BEAUTY SCHOOL                ,TX,76116-3299,Proprietary  ,15,70,85,71,300,371
02312200,TEXAS SCHOOL OF BUSINESS                ,TX,77073-6032,Proprietary  ,33,160,193,258,970,1228
02312201,TEXAS SCHOOL OF BUSINESS - SOUTHWEST CAM,TX,77057-5914,Proprietary  ,22,88,110,132,513,645
02312202,TEXAS SCHOOL OF BUSINESS - FRIENDSWOOD C,TX,77546-8938,Proprietary  ,12,71,83,76,406,482
02312203,TEXAS SCHOOL OF BUSINESS - EAST CAMPUS  ,TX,77029-1916,Proprietary  ,17,73,90,88,366,454
02313901,WESTWOOD COLLEGE - DALLAS               ,TX,75243-0000,Proprietary  ,19,55,74,299,827,1126
02315400,NORTHEAST TEXAS COMMUNITY COLLEGE       ,TX,75456-0000,Public       ,75,298,373,1546,2452,3998
02318200,"KD STUDIO, ACTOR'S CONSERVATORY         ",TX,75207-2111,Proprietary  ,13,35,48,174,261,435
02320200,HOUSTON GRADUATE SCHOOL OF THEOLOGY     ,TX,77092-0000,Private      ,1,28,29,6,217,223
02326000,SAN ANTONIO BEAUTY COLLEGE NO 3         ,TX,78217-0000,Proprietary  ,4,15,19,47,120,167
02331200,BAPTIST MISSIONARY ASSN THEOL SEM       ,TX,75766-0000,Private      ,1,13,14,16,75,91
02331300,INTERACTIVE LEARNING SYSTEMS            ,TX,77502-1201,Proprietary  ,3,52,55,25,217,242
02331301,INTERACTIVE LEARNING SYSTEMS            ,TX,77081-0000,Proprietary  ,23,129,152,94,525,619
02331304,INTERACTIVE LEARNING SYSTEMS            ,TX,77060-0000,Proprietary  ,5,52,57,26,325,351
02341300,PALO ALTO COLLEGE                       ,TX,78224-0000,Public       ,254,784,1038,4983,7489,12472
02348500,LAMAR STATE COLLEGE-PORT ARTHUR         ,TX,77640-0000,Public       ,87,293,380,1115,2345,3460
02357700,ACADEMY OF HAIR DESIGN                  ,TX,77043-3412,Proprietary  ,38,81,119,208,520,728
02358200,LAMAR STATE COLLEGE-ORANGE              ,TX,77630-0000,Public       ,49,239,288,949,2326,3275
02361400,COLLIN COUNTY COMMUNITY COLLEGE         ,TX,75071-0000,Public       ,617,1565,2182,7398,12762,20160
02362000,UNIVERSAL TECHNICAL INSTITUTE           ,TX,77073-0000,Proprietary  ,419,503,922,5397,3711,9108
02362800,AUSTIN GRADUATE SCHOOL OF THEOLOGY      ,TX,78752-1333,Private      ,1,12,13,11,103,114
02521200,ARLINGTON CAREER INSTITUTE              ,TX,75050-0000,Proprietary  ,8,46,54,50,401,451
02521800,SEGUIN BEAUTY SCHOOL                    ,TX,78155-0000,Proprietary  ,12,21,33,66,102,168
02527500,HOUSTON TRAINING SCHOOLS                ,TX,77029-0000,Proprietary  ,21,214,235,164,1044,1208
02530700,SEBRING CAREER SCHOOLS                  ,TX,77083-1510,Proprietary  ,6,23,29,15,97,112
02548800,SOUTH TEXAS VO-TECH INSTITUTE           ,TX,78596-0000,Proprietary  ,27,61,88,273,617,890
02548802,SOUTH TEXAS VOCATIONAL TECHNICAL INSTITU,TX,78520-8710,Proprietary  ,31,56,87,287,468,755
02549400,SOUTH TEXAS VO-TECH INSTITUTE           ,TX,78501-0000,Proprietary  ,74,168,242,709,1516,2225
02549402,SOUTH TEXAS VOCATIONAL TECHNICAL INSTITU,TX,78416-1141,Proprietary  ,2,16,18,80,296,376
02555400,UNIV OF TX MD ANDERSON CANCER CTR       ,TX,77030-0000,Public       ,2,30,32,126,516,642
02568100,TEXAS BARBER COLLEGES & HAIRSTYLING     ,TX,75208-0000,Proprietary  ,66,262,328,409,1476,1885
02569300,LE CORDON BLEU COLLEGE OF CULINARY ARTS ,TX,78758-3647,Proprietary  ,225,854,1079,1884,6028,7912
02572000,COMPUTER CAREER CENTER                  ,TX,79925-2021,Proprietary  ,55,329,384,400,1642,2042
02572004,COMPUTER CAREER CENTER - AMARILLO CAMPUS,TX,79101-2404,Proprietary  ,14,92,106,74,401,475
02572005,COMPUTER CAREER CENTER - LUBBOCK CAMPUS ,TX,79414-3517,Proprietary  ,19,82,101,100,485,585
02580100,IVERSON BUSINESS SCH & COURT REPORT     ,TX,76011-1344,Proprietary  ,13,48,61,56,310,366
02591100,CAREER POINT COLLEGE                    ,TX,78201-2027,Proprietary  ,75,485,560,354,2445,2799
02591900,KAPLAN COLLEGE                          ,TX,79907-1525,Proprietary  ,49,184,233,403,1251,1654
02591905,KAPLAN COLLEGE - BROWNSVILLE            ,TX,78521-9905,Proprietary  ,23,82,105,197,487,684
02596400,REDSTONE COLLEGE - LOS ANGELES          ,TX,77061-0000,Proprietary  ,27,44,71,187,351,538
02596500,ATI CAREER TRAINING CENTER              ,TX,76180-1599,Proprietary  ,58,241,299,489,2065,2554
02596503,ATI- CAREER TRAINING CENTER - HOUSTON (#,TX,77029-1978,Proprietary  ,19,82,101,151,631,782
02596600,ATI-CAREER TRAINING CENTER              ,TX,75220-4443,Proprietary  ,27,100,127,306,1067,1373
02596601,ATI CAREER TRAINING CENTER - RICHARDSON ,TX,75081-1948,Proprietary  ,1,21,22,38,169,207
02596602,ATI CAREER TRAINING CENTER - DALLAS (STE,TX,75247-6103,Proprietary  ,29,107,136,190,813,1003
02600200,OCEAN CORPORATION (THE)                 ,TX,77099-3479,Proprietary  ,30,190,220,174,842,1016
02600907,AVEDA INSTITUTE COVINGTON - DALLAS      ,TX,75231-0000,Proprietary  ,0,0,0,0,1,1
02604700,CENTER FOR ADVANCED LEGAL STUDIES       ,TX,77098-4151,Proprietary  ,3,60,63,30,472,502
02606202,EVEREST COLLEGE - EVEREST INSTITUTE - BI,TX,77036-8014,Proprietary  ,43,320,363,304,1397,1701
02615000,SANFORD-BROWN COLLEGE                   ,TX,75247-6931,Proprietary  ,76,269,345,666,2554,3220
03009400,SW SCH BUS & TECH CAREERS               ,TX,78212-2840,Proprietary  ,8,22,30,41,183,224
03010604,VIRGINIA COLLEGE - VIRGINIA COLLEGE AT A,TX,78723-0000,Proprietary  ,21,161,182,230,1322,1552
03011800,UNIVERSITY OF COSMETOLOGY ARTS & SCIENCE,TX,78226-1160,Proprietary  ,3,15,18,62,146,208
03019800,PCI HEALTH TRAINING CENTER              ,TX,75247-4720,Proprietary  ,60,146,206,337,831,1168
03021500,SW SCH BUS & TECH CAREERS               ,TX,78852-4859,Proprietary  ,9,28,37,113,197,310
03025000,TEXAS COLLEGE OF COSMETOLOGY            ,TX,79605-2001,Proprietary  ,7,40,47,68,258,326
03025001,TEXAS COLLEGE OF COSMETOLOGY - SAN ANGEL,TX,76903-4708,Proprietary  ,4,14,18,42,147,189
03026500,REMINGTON COLLEGE - HOUSTON CAMPUS      ,TX,77082-1849,Private      ,145,509,654,941,2890,3831
03026501,REMINGTON COLLEGE - NORTH HOUSTON CAMPUS,TX,77067-1849,Private      ,10,71,81,110,406,516
03026505,REMINGTON COLLEGE - HOUSTON CAMPUS - DAL,TX,75041-9935,Private      ,5,46,51,92,326,418
03026506,REMINGTON COLLEGE - FT. WORTH CAMPUS    ,TX,76112-1280,Private      ,38,137,175,238,735,973
03028800,CIRCLE J BEAUTY SCHOOL                  ,TX,77587-3714,Proprietary  ,5,34,39,43,195,238
03031408,INTERNATIONAL ACADEMY OF DESIGN & TECHNO,TX,78229-2263,Proprietary  ,35,61,96,327,745,1072
03032300,SCHOOL OF AUTOMOTIVE MACHINISTS         ,TX,77055-1803,Proprietary  ,13,50,63,136,238,374
03035200,TINT SCHOOL OF MAKEUP & COSMETOLOGY     ,TX,75229-3734,Proprietary  ,11,56,67,97,316,413
03035300,SOUTHERN CAREERS INSTITUTE              ,TX,78704-5252,Proprietary  ,248,959,1207,697,3249,3946
03035301,SOUTHERN CAREERS INSTITUTE-PHARR        ,TX,78577-2118,Proprietary  ,21,126,147,82,373,455
03035302,SOUTHERN CAREERS INSTITUTE - CORPUS CHRI,TX,78414-2904,Proprietary  ,17,93,110,97,476,573
03035303,SOUTHERN CAREERS INSTITUTE - SAN ANTONIO,TX,78221-4351,Proprietary  ,4,23,27,41,222,263
03035305,SOUTHERN CAREERS INSTITUTE - BROWNSVILLE,TX,78520-8680,Proprietary  ,1,13,14,19,54,73
03035306,SOUTHERN CAREERS INSTITUTE - HARLINGEN  ,TX,78550-7911,Proprietary  ,1,8,9,37,57,94
03035307,SOUTHERN CAREERS INSTITUTE - CORPUS CHRI,TX,78410-1609,Proprietary  ,1,9,10,29,76,105
03061800,STAR COLLEGE OF COSMETOLOGY             ,TX,75702-8214,Proprietary  ,5,30,35,88,208,296
03064600,UNIVERSITY OF TEXAS AT BROWNSVILLE      ,TX,78520-4993,Public       ,333,737,1070,9268,9451,18719
03073402,ITT TECHNICAL INSTITUTE                 ,TX,75080-2208,Proprietary  ,0,1,1,0,4,4
03075400,ICC TECHNICAL INSTITUTE                 ,TX,77004-2930,Private      ,12,31,43,44,174,218
03076403,BRYMAN SCHOOL OF ARIZONA (THE) - ANTHEM ,TX,75038-4201,Proprietary  ,3,15,18,17,81,98
03079201,WESTWOOD COLLEGE OF TECHNOLOGY          ,TX,76180-0000,Proprietary  ,0,10,10,78,286,364
03103400,SOUTH TEXAS COLLEGE                     ,TX,78501-6699,Public       ,819,1299,2118,14506,14802,29308
03108700,ROYAL BEAUTY CAREERS                    ,TX,77069-4611,Proprietary  ,21,74,95,122,410,532
03111000,MID-CITIES BARBER COLLEGE               ,TX,75051-4810,Proprietary  ,12,28,40,70,205,275
03115800,KAPLAN COLLEGE                          ,TX,78238-4203,Proprietary  ,27,183,210,259,1246,1505
03115802,KAPLAN COLLEGE - LAREDO                 ,TX,78041-6181,Proprietary  ,20,49,69,143,359,502
03115803,KAPLAN COLLEGE-BEAUMONT                 ,TX,77701-3706,Proprietary  ,16,95,111,146,691,837
03115804,KAPLAN COLLEGE - LUBBOCK                ,TX,79401-2601,Proprietary  ,21,116,137,177,711,888
03128100,ACADEMY OF HEALTH CARE PROFESSIONS      ,TX,77092-8108,Proprietary  ,69,252,321,416,1416,1832
03144300,NATIONAL BEAUTY COLLEGE                 ,TX,75043-4046,Proprietary  ,7,20,27,17,62,79
03153300,AMER COLL OF ACUPUNCTURE & O.M.         ,TX,77063-4104,Proprietary  ,0,13,13,6,140,146
03156400,ACADEMY OF ORIENTAL MEDICINE AT AUSTIN  ,TX,78757-1132,Proprietary  ,3,31,34,28,321,349
03159300,ARLINGTON MEDICAL INSTITUTE             ,TX,76011-0000,Proprietary  ,15,50,65,109,364,473
03170300,TEXAS A&M UNIVERSITY-TEXARKANA          ,TX,75501-0000,Public       ,76,189,265,1092,2132,3224
03179500,TEXAS COLG TRADITIONAL CHINESE MED      ,TX,78704-6748,Proprietary  ,0,10,10,4,132,136
03189400,COLLEGE OF SAINT THOMAS MORE            ,TX,76109-2323,Private      ,4,9,13,44,82,126
03237400,FARIS COMPUTER SCHOOL                   ,TX,77627-3829,Proprietary  ,0,5,5,4,14,18
03272300,KAPLAN COLLEGE                          ,TX,75234-7288,Proprietary  ,28,165,193,218,1158,1376
03272301,KAPLAN COLLEGE - MIDLAND                ,TX,79703-5531,Proprietary  ,17,79,96,103,466,569
03272303,KAPLAN COLLEGE - ARLINGTON              ,TX,76010-8121,Proprietary  ,30,178,208,225,1020,1245
03275300,TOUCH OF CLASS SCHOOL OF COSM           ,TX,75402-6314,Proprietary  ,4,26,30,40,121,161
03276300,ACADEMY OF HAIR DESIGN                  ,TX,75901-4900,Proprietary  ,13,39,52,67,200,267
03277300,ACADEMY OF HAIR DESIGN                  ,TX,77701-4650,Proprietary  ,7,35,42,46,179,225
03303300,NORTHWEST EDUCATIONAL CENTER            ,TX,77092-7055,Proprietary  ,6,63,69,58,310,368
03371300,TONI&GUY HAIRDRESSING ACADEMY           ,TX,75006-2351,Proprietary  ,26,32,58,157,257,414
03372300,NORTHWEST VISTA COLLEGE                 ,TX,78251-4217,Public       ,588,1166,1754,8992,10908,19900
03396500,TEXAS STATE TECHNICAL COLG/MARSHALL     ,TX,75672-7402,Public       ,29,81,110,436,650,1086
03400300,CAREER QUEST                            ,TX,78229-3539,Proprietary  ,13,106,119,46,489,535
03412300,ADVANCED BARBER COLLEGE & HAIR DESI     ,TX,78596-0000,Proprietary  ,12,54,66,63,247,310
03416500,DALLAS NURSING INSTITUTE                ,TX,75243-5502,Proprietary  ,45,191,236,374,2278,2652
03422300,MILAN INSTITUTE                         ,TX,78238-4103,Proprietary  ,131,424,555,848,2133,2981
03422400,COLLEGE OF BIBLICAL STUDIES-HOUSTON     ,TX,77036-3211,Private      ,4,131,135,70,877,947
03424400,MEDVANCE INSTITUTE                      ,TX,77057-7386,Proprietary  ,57,211,268,402,1377,1779
03426300,CAREER ADVANCEMENT CENTER               ,TX,78752-1470,Proprietary  ,14,55,69,67,281,348
03480304,MEDVANCE INSTITUTE OF BATON ROUGE - GRAN,TX,75050-2342,Proprietary  ,13,53,66,119,421,540
03509400,CORYELL COSMETOLOGY COLLEGE             ,TX,76528-2036,Proprietary  ,0,1,1,10,21,31
03520300,LUBBOCK HAIR ACADEMY                    ,TX,79410-3524,Proprietary  ,3,12,15,28,120,148
03542300,CONCORDE CAREER INSTITUTE               ,TX,76011-4016,Proprietary  ,40,183,223,230,1200,1430
03551400,STATE BEAUTY ACADEMY                    ,TX,75116-3501,Proprietary  ,1,9,10,13,55,68
03556400,KUSSAD INSTITUTE OF COURT REPORTING     ,TX,78704-5712,Proprietary  ,0,6,6,6,44,50
03573300,AVIATION INSTITUTE OF MAINTENANCE       ,TX,75209-3017,Proprietary  ,19,150,169,221,957,1178
03610300,MJ'S BEAUTY ACADEMY INC                 ,TX,75224-4425,Proprietary  ,5,23,28,24,100,124
03612400,VALLEY GRANDE INSTITUTE FOR ACADEMI     ,TX,78596-0000,Private      ,14,55,69,110,421,531
03627300,LAMAR INSTITUTE OF TECHNOLOGY           ,TX,77705-4142,Public       ,164,453,617,1935,3365,5300
03676400,HEALTHY HAIR ACADEMY                    ,TX,75227-0000,Proprietary  ,13,88,101,46,300,346
03680300,JAY'S TECHNICAL INSTITUTE               ,TX,77031-3509,Proprietary  ,7,48,55,38,192,230
03682400,DALLAS BARBER & STYLIST COLLEGE         ,TX,75231-0000,Proprietary  ,19,87,106,127,516,643
03714300,TREND BARBER COLLEGE                    ,TX,77071-2104,Proprietary  ,21,85,106,112,453,565
03723300,CULINARY INST ALAIN & MARIE LENOTRE     ,TX,77022-4322,Proprietary  ,20,65,85,184,579,763
03727600,CULINARY ACADEMY OF AUSTIN              ,TX,78752-0000,Proprietary  ,28,76,104,274,437,711
03731300,INTERNATIONAL RENOWNED BEAUTY ACADE     ,TX,76103-2504,Proprietary  ,2,14,16,13,91,104
03733300,BAPTIST UNIVERSITY OF THE AMERICAS      ,TX,78224-1336,Private      ,7,30,37,77,267,344
03756300,ANAMARC COLLEGE                         ,TX,79930-6230,Proprietary  ,32,170,202,215,1145,1360
03922300,SOUTH TEXAS BARBER COLLEGE              ,TX,78415-3463,Proprietary  ,2,8,10,31,74,105
03944400,PROFESSIONAL CAREERS INSTITUTE          ,TX,77036-2252,Proprietary  ,16,55,71,64,297,361
03970300,HANDS ON THERAPY                        ,TX,75149-2294,Proprietary  ,6,31,37,33,134,167
03987300,TEXAS HEALTH SCHOOL                     ,TX,77079-2106,Proprietary  ,22,70,92,137,442,579
04036300,SOUTHEAST TEXAS CAREER INSTITUTE        ,TX,77656-8601,Proprietary  ,2,14,16,36,116,152
04045300,NORTHWEST BEAUTY SCHOOL                 ,TX,77091-1208,Proprietary  ,3,19,22,36,126,162
04045400,MAI-TRIX BEAUTY COLLEGE                 ,TX,77040-0000,Proprietary  ,4,19,23,37,152,189
04082300,PROFESSIONAL CAREER TRAINING INSTITUTE  ,TX,77090-0000,Proprietary  ,8,31,39,28,158,186
04089400,CCI TRAINING CENTER                     ,TX,76011-4857,Proprietary  ,9,85,94,35,342,377
04117900,CHAMPION BEAUTY COLLEGE                 ,TX,77069-4611,Proprietary  ,6,54,60,55,275,330
04125400,ACADEMY AT AUSTIN (THE)                 ,TX,78660-3287,Proprietary  ,15,37,52,107,266,373
04125500,MANUEL AND THERESA'S SCHOOL OF HAIR DESI,TX,77803-3236,Proprietary  ,2,11,13,14,58,72
04129800,MEDIATECH INSTITUTE DALLAS              ,TX,75039-3105,Proprietary  ,20,61,81,162,362,524
04129801,MEDIATECH INSTITUTE - AUSTIN            ,TX,78704-8933,Proprietary  ,8,28,36,100,175,275
04129802,MEDIATECH INSTITUTE HOUSTON             ,TX,77042-4712,Proprietary  ,18,43,61,114,210,324
04131700,SOUTHWEST CAREER COLLEGE                ,TX,79925-6230,Proprietary  ,55,208,263,420,1299,1719
04135600,CANNON INSTITUTE OF HIGHER LEARNING     ,TX,75247-9998,Proprietary  ,2,14,16,5,55,60
04136500,PCCENTER                                ,TX,75115-4214,Proprietary  ,1,9,10,11,92,103
04138500,CARDIOTECH ULTRASOUND SCHOOL            ,TX,77099-1440,Proprietary  ,6,62,68,69,438,507
04142300,AVEDA INSTITUTE SAN ANTONIO             ,TX,78215-1260,Proprietary  ,22,80,102,207,468,675
04146600,360 DEGREES BEAUTY ACADEMY              ,TX,77084-2714,Proprietary  ,0,0,0,7,27,34
04146700,AVIATION INSTITUTE OF MAINTENANCE       ,TX,77061-4004,Proprietary  ,25,108,133,159,483,642
04146800,SOUTH TEXAS TRAINING CENTER             ,TX,78586-7721,Proprietary  ,1,14,15,23,89,112
04152700,ASTRODOME CAREER CENTERS                ,TX,77054-2678,Proprietary  ,7,16,23,24,112,136
04154800,DUVALL'S SCHOOL OF COSMETOLOGY          ,TX,76021-4159,Proprietary  ,11,16,27,48,98,146
04155800,ADVANCED BEAUTY COLLEGE                 ,TX,75061-1918,Proprietary  ,0,3,3,11,77,88
04158500,TEXAS BEAUTY COLLEGE                    ,TX,76117-3201,Proprietary  ,8,28,36,17,73,90
04160700,AVENUE FIVE INSTITUTE                   ,TX,78757-7000,Proprietary  ,10,65,75,110,349,459
04161100,CORPUS CHRISTI BEAUTY ACADEMY           ,TX,78412-3900,Proprietary  ,7,11,18,55,90,145
04165800,SALON PROFESSIONAL ACADEMY (THE)        ,TX,75067-5390,Proprietary  ,8,20,28,49,135,184
04168700,LAWYER'S ASSISTANT SCHOOL OF DALLAS     ,TX,75201-2829,Proprietary  ,6,48,54,33,266,299
04168800,ABC BEAUTY ACADEMY                      ,TX,75042-8682,Proprietary  ,3,30,33,28,134,162
04169000,SALON & SPA INSTITUTE                   ,TX,78521-1727,Proprietary  ,7,22,29,36,135,171
04169100,DIAMONDS COSMETOLOGY COLLEGE            ,TX,75090-2657,Proprietary  ,2,12,14,15,74,89
04177900,BUCKNER BARBER SCHOOL                   ,TX,75217-1775,Proprietary  ,5,25,30,35,138,173
04179500,NORTH AMERICAN COLLEGE                  ,TX,77038-0000,Private      ,8,24,32,98,85,183
00367000,BRIGHAM YOUNG UNIVERSITY                ,UT,84602-8406,Private      ,1057,1024,2081,13127,13566,26693
00367100,DIXIE STATE COLLEGE OF UTAH             ,UT,84770-3876,Public       ,404,545,949,4513,5573,10086
00367200,LDS BUSINESS COLLEGE                    ,UT,84101-3500,Private      ,141,147,288,1091,1113,2204
00367400,STEVENS HENAGER COLLEGE                 ,UT,84401-1420,Proprietary  ,349,2692,3041,1731,14003,15734
00367500,UNIVERSITY OF UTAH                      ,UT,84112-9055,Public       ,825,1448,2273,12867,19146,32013
00367600,COLLEGE OF EASTERN UTAH                 ,UT,84501-2699,Public       ,41,82,123,736,741,1477
00367700,UTAH STATE UNIVERSITY                   ,UT,84322-1400,Public       ,868,1214,2082,10820,13280,24100
00367800,SOUTHERN UTAH UNIVERSITY                ,UT,84720-2470,Public       ,397,404,801,5060,3835,8895
00367900,SNOW COLLEGE                            ,UT,84627-1299,Public       ,230,143,373,2800,1301,4101
00368000,WEBER STATE UNIVERSITY                  ,UT,84408-1136,Public       ,675,1537,2212,7524,14245,21769
00368100,WESTMINSTER COLLEGE                     ,UT,84105-3697,Private      ,116,195,311,2816,2158,4974
00402700,UTAH VALLEY UNIVERSITY                  ,UT,84058-5999,Public       ,1117,1985,3102,10405,19438,29843
00522000,SALT LAKE COMMUNITY COLLEGE             ,UT,84123-0000,Public       ,1222,3102,4324,9734,22161,31895
00732953,ITT TECHNICAL INSTITUTE                 ,UT,84123-2500,Proprietary  ,85,267,352,491,2026,2517
00943300,SHERMAN KENDALL'S ACADEMY OF BEAUTY     ,UT,84106-1836,Proprietary  ,7,18,25,31,80,111
01009800,NEUMONT UNIVERSITY                      ,UT,84095-0000,Proprietary  ,24,14,38,609,153,762
01116500,UINTAH BASIN APPLIED TECHNOLOGY CLG     ,UT,84066-0000,Public       ,4,29,33,27,168,195
01116600,BROADVIEW UNIVERSITY                    ,UT,84088-4021,Proprietary  ,64,187,251,505,1728,2233
02078800,SHERMAN KENDALL'S ACADEMY OF BEAUTY     ,UT,84047-0000,Proprietary  ,2,7,9,15,47,62
02115400,BRIDGERLAND APPLIED TECHNOLOGY COLLEGE  ,UT,84321-0000,Public       ,44,142,186,362,1103,1465
02156600,DAVIS APPLIED TECHNOLOGY COLLEGE        ,UT,84037-0000,Public       ,73,288,361,509,1974,2483
02178500,EAGLE GATE COLLEGE                      ,UT,84123-0000,Proprietary  ,61,249,310,288,1769,2057
02270800,AMERITECH COLLEGE                       ,UT,84604-6927,Proprietary  ,24,213,237,96,870,966
02270802,AMERITECH COLLEGE - DRAPER              ,UT,84020-6545,Proprietary  ,3,35,38,29,252,281
02298500,EVEREST COLLEGE                         ,UT,84119-2668,Proprietary  ,26,114,140,151,809,960
02346500,OGDEN-WEBER APPLIED TECHNOLOGY COLG     ,UT,84404-0000,Public       ,66,347,413,465,2123,2588
02360800,PROVO COLLEGE                           ,UT,84601-0000,Proprietary  ,34,111,145,289,926,1215
02504000,MARINELLO SCHOOL OF BEAUTY              ,UT,84041-0000,Proprietary  ,8,38,46,53,173,226
02504001,MARINELLO SCHOOL OF BEAUTY - MAIN STREET,UT,84041-3002,Proprietary  ,0,3,3,11,31,42
02516100,MARINELLO SCHOOL OF BEAUTY              ,UT,84405-1501,Proprietary  ,5,29,34,52,187,239
02531800,VON CURTIS ACADEMY OF HAIR DESIGN       ,UT,84606-0000,Proprietary  ,147,222,369,926,1145,2071
02556800,PAUL MITCHELL THE SCHOOL                ,UT,84117-7204,Proprietary  ,37,64,101,208,372,580
02556801,PAUL MITCHELL THE SCHOOL                ,UT,84780-0000,Proprietary  ,6,8,14,31,49,80
02557700,PREMIER HAIR ACADEMY                    ,UT,84120-3603,Proprietary  ,2,10,12,15,50,65
02572700,EVANS HAIRSTYLING COLLEGE               ,UT,84770-0000,Proprietary  ,4,8,12,45,60,105
02572800,VISTA COLLEGE                           ,UT,84015-0000,Proprietary  ,3,50,53,19,190,209
02573100,EVANS HAIRSTYLING COLLEGE               ,UT,84720-0000,Proprietary  ,5,10,15,47,64,111
02612200,MARINELLO SCHOOL OF BEAUTY              ,UT,84604-1585,Proprietary  ,13,32,45,75,136,211
03030600,UTAH COLLEGE OF MASSAGE THERAPY         ,UT,84111-1606,Proprietary  ,39,74,113,283,542,825
03030601,UTAH CLG OF MASSAGE THER-PROVO CMPS     ,UT,84042-0000,Proprietary  ,13,21,34,90,135,225
03082100,MYOTHERAPY COLLEGE OF UTAH              ,UT,84115-2522,Proprietary  ,5,15,20,29,116,145
03108200,ECHELON EDGE ACADEMY OF HAIR SKIN & NAIL,UT,84070-2004,Proprietary  ,6,21,27,28,86,114
03110400,HAIRITAGE HAIR ACADEMY                  ,UT,84770-5233,Proprietary  ,5,9,14,40,47,87
03339400,WESTERN GOVERNORS UNIVERSITY            ,UT,84107-2533,Private      ,174,6195,6369,1037,36344,37381
03413300,MOUNTAINLAND APPLIED TECHNOLOGY COLLEGE ,UT,84058-5857,Public       ,20,109,129,234,640,874
03463300,CAREERS UNLIMITED                       ,UT,84058-0000,Proprietary  ,12,15,27,51,150,201
03617300,HEALING MOUNTAIN MASSAGE SCHOOL         ,UT,84111-0000,Proprietary  ,11,16,27,46,105,151
03829500,SKINWORKS SCHOOL OF ADVANCED SKINCARE   ,UT,84115-0000,Proprietary  ,5,20,25,22,90,112
03838300,NIGHTINGALE COLL. SCH. OF NURSING SCH. O,UT,84403-0000,Proprietary  ,1,24,25,20,93,113
03902300,RENAISSANCE SCHOOL OF THERAPEUTIC MASSAG,UT,84010-2835,Proprietary  ,0,3,3,6,28,34
03909300,MAXIMUM STYLE TEC SCHOOL OF COSMETOLOGY ,UT,84323-4679,Proprietary  ,5,12,17,38,82,120
03921300,CAMEO COLLEGE OF ESSENTIAL BEAUTY       ,UT,84115-0000,Proprietary  ,17,49,66,125,375,500
04054300,SOUTHWEST APPLIED TECHNOLOGY COLLEGE    ,UT,84720-6608,Public       ,12,38,50,66,254,320
04072300,AVEDA INSTITUTE PROVO                   ,UT,84604-1008,Proprietary  ,14,26,40,100,174,274
04118100,IMAGEWORKS ACADEMY OF HAIR DESIGN       ,UT,84660-1210,Proprietary  ,5,7,12,26,69,95
04121700,DIXIE APPLIED TECHNOLOGY COLLEGE        ,UT,84770-3025,Public       ,33,72,105,363,537,900
04142100,SKIN INSTITUTE (THE)                    ,UT,84770-6452,Proprietary  ,3,6,9,13,35,48
04145500,SKIN SCIENCE INSTITUTE (THE)            ,UT,84115-0000,Proprietary  ,9,32,41,45,172,217
04153000,RENAISSANCE ACADEMIE                    ,UT,84604-0000,Proprietary  ,3,11,14,44,58,102
04161900,MANDALYN ACADEMY                        ,UT,84003-2161,Proprietary  ,6,17,23,17,65,82
04165500,ACAYDIA SCHOOL OF AESTHETICS            ,UT,84601-0000,Proprietary  ,3,16,19,25,81,106
04169900,AMERICAN BEAUTY ACADEMY                 ,UT,84651-0000,Proprietary  ,7,8,15,32,47,79
04173200,TAYLOR ANDREWS ACADEMY OF HAIR DESIGN   ,UT,84088-6577,Proprietary  ,25,33,58,94,166,260
04184200,TAYLOR ANDREWS ACADEMY-ST. GEORGE       ,UT,84790-2139,Proprietary  ,15,16,31,49,64,113
04192700,BARBER SCHOOL (THE)                     ,UT,84047-3723,Proprietary  ,5,18,23,12,63,75
00368200,BENNINGTON COLLEGE                      ,VT,05201-6001,Private      ,14,7,21,1136,261,1397
00368300,CASTLETON STATE COLLEGE                 ,VT,05735-0000,Public       ,63,33,96,3051,467,3518
00368400,CHAMPLAIN COLLEGE                       ,VT,05401-3950,Private      ,198,121,319,3354,1234,4588
00368402,WOODBURY COLLEGE                        ,VT,05602-0000,Private      ,0,0,0,2,16,18
00368500,COLLEGE OF ST JOSEPH                    ,VT,05701-3899,Private      ,3,21,24,154,297,451
00368600,GODDARD COLLEGE                         ,VT,05667-0000,Private      ,7,79,86,85,1065,1150
00368700,GREEN MOUNTAIN COLLEGE                  ,VT,05764-1199,Private      ,22,21,43,1060,225,1285
00368800,JOHNSON STATE COLLEGE                   ,VT,05656-9898,Public       ,24,72,96,1506,1052,2558
00368900,LYNDON STATE COLLEGE                    ,VT,05851-0919,Public       ,33,25,58,1847,380,2227
00369000,MARLBORO COLLEGE                        ,VT,05344-0300,Private      ,8,17,25,396,149,545
00369100,MIDDLEBURY COLLEGE                      ,VT,05753-0000,Private      ,57,17,74,4403,539,4942
00369200,NORWICH UNIVERSITY                      ,VT,05663-1035,Private      ,53,180,233,3140,1532,4672
00369300,SOUTHERN VERMONT COLLEGE                ,VT,05201-6002,Private      ,8,8,16,630,221,851
00369400,ST MICHAELS COLLEGE                     ,VT,05439-0001,Private      ,31,20,51,3877,272,4149
00369600,UNIVERSITY OF VERMONT                   ,VT,05405-0160,Public       ,189,122,311,19227,3506,22733
00369700,VERMONT COLLEGE OF FINE ARTS            ,VT,05602-3128,Private      ,0,31,31,11,440,451
00369800,VERMONT TECHNICAL COLLEGE               ,VT,05061-0000,Public       ,37,50,87,1222,939,2161
00857500,SALON PROFESSIONAL ACADEMY (THE)        ,VT,05495-4001,Proprietary  ,8,16,24,54,84,138
00865800,O'BRIENS AVEDA INSTITUTE                ,VT,05403-7747,Proprietary  ,3,11,14,35,78,113
00886000,SIT                                     ,VT,05301-4801,Private      ,1,39,40,12,585,597
01116700,COMMUNITY COLLEGE OF VERMONT            ,VT,05676-0000,Public       ,140,520,660,1977,4858,6835
01193400,VERMONT LAW SCHOOL                      ,VT,05068-0000,Private      ,1,24,25,2,1080,1082
01218300,BURLINGTON COLLEGE                      ,VT,05401-8477,Private      ,7,21,28,239,168,407
02143500,STERLING COLLEGE                        ,VT,05827-0000,Private      ,7,5,12,146,44,190
02254000,NEW ENGLAND CULINARY INSTITUTE          ,VT,05602-0000,Proprietary  ,25,34,59,475,292,767
02532600,LANDMARK COLLEGE                        ,VT,05346-0000,Private      ,14,7,21,475,89,564
03708300,BURLINGTON TECHNICAL CENTER             ,VT,05401-2721,Public       ,1,5,6,11,28,39
04146900,ADVANCED WELDING INSTITUTE              ,VT,05403-0000,Proprietary  ,5,7,12,25,25,50
00392800,CASPER COLLEGE                          ,WY,82601-4612,Public       ,67,210,277,1332,2065,3397
00392900,EASTERN WYOMING COLLEGE                 ,WY,82240-1603,Public       ,22,58,80,511,498,1009
00393000,SHERIDAN COLLEGE                        ,WY,82801-9133,Public       ,56,171,227,972,1308,2280
00393100,NORTHWEST COLLEGE                       ,WY,82435-1895,Public       ,49,103,152,974,801,1775
00393200,UNIVERSITY OF WYOMING                   ,WY,82071-3663,Public       ,211,309,520,6955,5153,12108
00393300,WESTERN WYOMING COMMUNITY COLLEGE       ,WY,82902-0000,Public       ,49,175,224,984,1395,2379
00728900,CENTRAL WYOMING COLLEGE                 ,WY,82501-0000,Public       ,40,146,186,600,1072,1672
00915700,WYOMING TECHNICAL INSTITUTE             ,WY,82072-9519,Proprietary  ,236,159,395,1982,1155,3137
00925900,LARAMIE COUNTY COMMUNITY CLG            ,WY,82007-3299,Public       ,88,302,390,1556,2497,4053
02211900,CHEEKS INTERNATIONAL ACDMY              ,WY,82001-0000,Proprietary  ,6,36,42,75,211,286
00393500,UNIV OF GUAM                            ,GU,96923-0000,Public       ,139,142,281,2333,1709,4042
01536100,GUAM COMMUNITY COLLEGE                  ,GU,96921-0000,Public       ,122,194,316,1498,1641,3139
03438300,PACIFIC ISLANDS UNIVERSITY              ,GU,96913-2619,Private      ,6,10,16,76,70,146
00393600,PONTIFICAL CATHOLIC UNIV OF PR          ,PR,00717-0777,Private      ,85,282,367,6727,5553,12280
00393700,UNIVERSITY OF THE SACRED HEART          ,PR,00914-0383,Private      ,92,162,254,4179,2664,6843
00393800,INTER-AMER UNIV PR-CNTRL ADMN           ,PR,00936-0000,Private      ,147,494,641,4033,6606,10639
00393801,INTER-AMER UNIV PR SCHL LAW             ,PR,00936-8351,Private      ,3,3,6,23,310,333
00393802,INTER AMERICAN UNIVERSITY OF PUERTO RICO,PR,00926-0000,Private      ,24,97,121,1202,1471,2673
00393803,INTER AMERICAN UNIVERSITY OF PR         ,PR,00683-0000,Private      ,95,128,223,3883,2117,6000
00393804,INTER-AMER UNIV PR-RECINTO AGUADILA     ,PR,00605-2000,Private      ,109,159,268,3255,2497,5752
00393805,INTER-AMER UNIV PR-ARECIBO CAMPUS       ,PR,00614-4050,Private      ,84,177,261,3470,2907,6377
00393806,INTER-AMER UNIV PR-BARRANQUITAS REG     ,PR,00794-0517,Private      ,38,64,102,1704,1005,2709
00393807,INTER-AMER UNIV PR-FAJARDO REGIONAL     ,PR,00738-0000,Private      ,43,86,129,1396,1232,2628
00393808,INTER-AMER UNIV PR - GUAYAMA CAMPUS     ,PR,00785-4004,Private      ,37,126,163,1252,1548,2800
00393809,INTER-AMER UNIV PR-PONCE REGIONAL       ,PR,00715-0000,Private      ,73,222,295,3741,3710,7451
00393811,INTER-AMER UNIV PR-BAYAMON REG CLG      ,PR,00959-0000,Private      ,94,134,228,4313,2028,6341
00394100,COLEGIO UNIVERSITARIO DEL ESTE          ,PR,00983-0000,Private      ,221,625,846,7397,8410,15807
00394200,UNIVERSITY OF PR-CENTRAL ADMINISTRATION ,PR,00936-4984,Public       ,10,11,21,353,164,517
00394300,UNIVERSITY OF PUERTO RICO - HUMACAO UNIV,PR,00791-4300,Public       ,31,27,58,3325,643,3968
00394400,UNIVERSITY OF PUERTO RICO - MAYAGUEZ    ,PR,00680-0000,Public       ,132,100,232,9352,2291,11643
00501900,UNIV ADVENTISTA DE LAS ANTILLAS         ,PR,00681-0118,Private      ,20,36,56,850,459,1309
00502200,BAYAMON CENTRAL UNIVERSITY              ,PR,00960-0000,Private      ,16,88,104,1110,1234,2344
00710800,UNIVERSITY OF PUERTO RICO - RIO PIEDRAS ,PR,00931-3300,Public       ,123,157,280,8076,3461,11537
00720600,UNIVERSITY OF PUERTO RICO - CAYEY UNIVER,PR,00736-5534,Public       ,20,15,35,3154,576,3730
00722800,UNIVERSITY OF PUERTO RICO - ARECIBO     ,PR,00614-4010,Public       ,27,28,55,3327,655,3982
00890200,COLUMBIA CENTRO UNIVERSITARIO           ,PR,00726-0000,Proprietary  ,145,224,369,1074,1381,2455
00965200,"UNIVERSITY OF PUERTO RICO, PONCE TECH UN",PR,00716-0000,Public       ,28,28,56,3038,494,3532
01056700,COLEGIO TECNOLOGICO DE SAN JUAN         ,PR,00918-2973,Public       ,21,51,72,808,985,1793
01072400,CARLOS ALBIZU UNIVERSITY                ,PR,00902-3711,Private      ,2,27,29,107,861,968
01081900,CONSERVATORIO DE MUSICA DE PUERTO RICO  ,PR,00907-3373,Public       ,3,7,10,310,128,438
01092200,UNIVERSITY OF PUERTO RICO - UTUADO      ,PR,00641-2500,Public       ,8,6,14,1158,267,1425
01097500,UNIVERSITY OF PUERTO RICO BAYAMON TECHNI,PR,00959-1911,Public       ,45,37,82,4166,836,5002
01120300,RYDER MEMORIAL HOSP SCH OF NURSING      ,PR,00792-0000,Private      ,0,4,4,15,32,47
01171900,UNIVERSIDAD DEL TURABO                  ,PR,00778-0000,Private      ,198,690,888,7978,10442,18420
01194000,ICPR JUNIOR COLLEGE                     ,PR,00919-0000,Proprietary  ,103,184,287,955,1265,2220
01194100,AMERICAN UNIVERSITY OF PUERTO RICO      ,PR,00960-2037,Private      ,59,57,116,848,673,1521
01194101,AMERICAN UNIVERSITY OF PUERTO RICO      ,PR,00674-0000,Private      ,51,63,114,695,575,1270
01212300,"UNIVERSITY OF PUERTO RICO, AGUADILLA REG",PR,00604-0160,Public       ,33,24,57,2462,632,3094
01252500,CARIBBEAN UNIVERSITY                    ,PR,00960-0493,Private      ,106,255,361,2711,3838,6549
02063100,MBTI BUSINESS TRNG INSTITUTE            ,PR,00907-3917,Proprietary  ,192,622,814,604,2034,2638
02100000,POLYTECHNIC UNIVERSITY OF PR            ,PR,00917-0000,Private      ,86,197,283,2829,2343,5172
02163300,UNIVERSIDAD CENTRAL DEL CARIBE          ,PR,00960-0000,Private      ,4,26,30,165,433,598
02165100,EDP COLLEGE OF PUERTO RICO              ,PR,00919-0000,Private      ,60,156,216,868,1647,2515
02166000,CENTER FOR ADVANCED STUDIES OF PUER     ,PR,00902-0000,Private      ,0,50,50,6,233,239
02166400,INSTITUTO DE BANCA Y COMERCIO           ,PR,00925-0000,Proprietary  ,1413,2046,3459,9440,12007,21447
02170300,INST EDUC TECNIA OCUP LA REINA          ,PR,00674-0000,Proprietary  ,30,61,91,281,396,677
02189100,CENTRO DE ESTUDIOS MULTIDISCIPLIN       ,PR,00926-0000,Private      ,105,169,274,1754,2252,4006
02189300,EMMA'S BEAUTY ACADEMY                   ,PR,00680-0000,Proprietary  ,10,23,33,257,202,459
02195400,MODERN HAIRSTYLING INSTITUTE            ,PR,00961-0000,Proprietary  ,227,172,399,738,516,1254
02195500,MODERN HAIRSTYLING INSTITUTE            ,PR,00612-0000,Proprietary  ,0,0,0,2,2,4
02195800,LICEO E ARTE Y TECNOLGIA                ,PR,00919-0000,Proprietary  ,39,70,109,518,588,1106
02195900,MODERN HAIRSTYLING INSTITUTE            ,PR,00980-0000,Proprietary  ,1,1,2,16,7,23
02234900,ANTILLES SCHOOL OF TECH CAREERS         ,PR,00909-3006,Proprietary  ,33,48,81,166,185,351
02241901,COMMONWEALTH OF PR DEPT OF EDUC - CARLOS,PR,00986-0000,Public       ,5,8,13,41,71,112
02241902,COMMONWEALTH OF PR DEPT OF EDUC - TOMAS ,PR,00613-0000,Public       ,1,0,1,23,27,50
02241904,COMMONWEALTH OF PR DEPT OF EDUC - ITPR R,PR,00655-0000,Public       ,26,33,59,527,310,837
02241905,COMMONWEALTH OF PR DEPT OF EDUC - JOSE A,PR,00674-0000,Public       ,0,1,1,84,33,117
02241907,COMMONWEALTH OF PR DEPT OF EDUC - ITPR R,PR,00928-0000,Public       ,11,17,28,447,315,762
02241908,COMMONWEALTH OF PR DEPT OF EDUC - ITPR R,PR,00732-0000,Public       ,22,25,47,446,321,767
02241909,COMMONWEALTH OF PR DEPT OF EDUC - TROQUE,PR,00959-0000,Public       ,3,0,3,62,16,78
02241910,COMMONWEALTH OF PR DEPT OF EDUC - ITPR R,PR,00701-1091,Public       ,15,17,32,659,271,930
02260600,NATIONAL COLLEGE OF BUSINESS & TECH     ,PR,00960-2036,Proprietary  ,365,1036,1401,3541,6237,9778
02260800,HUERTAS JUNIOR COLLEGE                  ,PR,00726-0000,Proprietary  ,57,106,163,845,1153,1998
02297700,AUTOMECA TECHNICAL COLLEGE              ,PR,00957-0000,Proprietary  ,63,80,143,1090,750,1840
02303800,AMERICAN EDUCATIONAL COLLEGE            ,PR,00961-0000,Proprietary  ,59,81,140,408,634,1042
02335500,COLEGIO BIBLICO PENTECOSTAL DE PR       ,PR,00978-0000,Private      ,1,11,12,17,179,196
02340600,HUMACAO COMMUNITY COLLEGE               ,PR,00792-0000,Private      ,28,35,63,360,422,782
02343600,INSTITUTE OF BEAUTY CAREERS             ,PR,00613-0000,Proprietary  ,39,43,82,370,427,797
02460000,UNIVERSITY OF PUERTO RICO - MEDICAL SCIE,PR,00936-0000,Public       ,12,35,47,686,1597,2283
02482400,PONCE SCHOOL OF MEDICINE AND HEALTH SCIE,PR,00716-2347,Private      ,1,9,10,46,663,709
02502400,SERBIA'S SCHOOL OF BEAUTY CULTURE       ,PR,00785-0000,Proprietary  ,25,44,69,119,201,320
02504500,INSTITUCION CHAVIANO DE MAYAGUEZ        ,PR,00708-0000,Proprietary  ,8,29,37,33,88,121
02505400,ATLANTIC COLLEGE                        ,PR,00970-0000,Private      ,59,39,98,1137,463,1600
02534900,PONCE PARAMEDICAL COLLEGE (POPAC)       ,PR,00731-0000,Proprietary  ,148,184,332,1934,1702,3636
02552300,COLEGIO MAYOR DE TECHNOLOGIA            ,PR,00714-0000,Proprietary  ,21,43,64,170,237,407
02562500,INTERNATIONAL TECHNICAL COLLEGE         ,PR,00918-0000,Proprietary  ,13,35,48,43,123,166
02563500,ROGIES SCHOOL OF BEAUTY CULTURE         ,PR,00910-0000,Proprietary  ,5,17,22,61,116,177
02569400,ESCUELA DE ARTES PLASTICAS              ,PR,00902-1112,Public       ,15,6,21,444,173,617
02570400,EDUCATIONAL TECHNICAL COLLEGE           ,PR,00925-3404,Proprietary  ,47,128,175,425,844,1269
02576100,ESCUELA TECNICA DE ELECTRICIDAD         ,PR,00731-0000,Proprietary  ,16,44,60,168,277,445
02587500,UNIVERSIDAD METROPOLITANA               ,PR,00928-0000,Private      ,232,701,933,6378,8993,15371
02588600,SEMINARIO EVANGELICO DE PUERTO RICO     ,PR,00925-0000,Private      ,0,9,9,3,40,43
02593700,HISPANIC AMERICAN COLLEGE               ,PR,00725-0000,Proprietary  ,37,45,82,167,209,376
03016000,UNIVERSITY OF PUERTO RICO CAROLINA REGIO,PR,00985-0000,Public       ,47,51,98,3076,740,3816
03021900,EDIC COLLEGE                            ,PR,00726-0000,Proprietary  ,34,44,78,970,1092,2062
03025500,MECH TECH COLLEGE                       ,PR,00725-6118,Proprietary  ,168,180,348,2933,1842,4775
03025900,"LICEO DE ARTE, DISENOS Y COMERCIO       ",PR,00726-0000,Proprietary  ,30,65,95,239,396,635
03029700,"UNIVERSAL TECHNOLOGY CLG OF PR, INC     ",PR,00605-1955,Private      ,49,99,148,548,1066,1614
03061900,COLEGIO TECHNOLOGICO Y COMERCIAL        ,PR,00602-0960,Proprietary  ,5,12,17,32,57,89
03068400,STAR BEAUTY ACADEMY                     ,PR,00961-6312,Proprietary  ,12,15,27,44,63,107
03070500,D'MART INSTITUTE                        ,PR,00794-3517,Proprietary  ,80,163,243,590,1002,1592
03075600,EMMA'S BEAUTY ACADEMY                   ,PR,00795-0000,Proprietary  ,19,33,52,324,259,583
03085700,PROFESSIONAL TECHNICAL INSTITUTION      ,PR,00960-7061,Proprietary  ,33,45,78,144,177,321
03104400,PROFESSIONAL ELECTRIC SCHOOL            ,PR,00674-1797,Proprietary  ,4,10,14,34,38,72
03106900,ESCUELA DE PERITOS ELECTRICITAS         ,PR,00662-0457,Proprietary  ,5,6,11,38,49,87
03112100,JOHN DEWEY COLLEGE                      ,PR,00915-9538,Private      ,379,822,1201,2086,4108,6194
03112101,JOHN DEWEY COLLEGE                      ,PR,00986-0000,Private      ,88,133,221,568,790,1358
03112102,JOHN DEWEY COLLEGE-BAYAMON CAMPUS       ,PR,00959-0000,Private      ,76,169,245,252,469,721
03112104,JOHN DEWEY COLLEGE - YABUCOA LRNING SITE,PR,00767-0767,Private      ,18,62,80,175,339,514
03112105,JOHN DEWEY COLLEGE - FAJARDO BRANCH     ,PR,00738-0738,Private      ,13,18,31,161,231,392
03112106,JOHN DEWEY COLLEGE - ARROYO BRANCH      ,PR,00714-0714,Private      ,0,4,4,90,142,232
03112107,JOHN DEWEY COLLEGE - JUANA DIAZ BRANCH  ,PR,00795-0000,Private      ,37,38,75,186,233,419
03112108,JOHN DEWEY COLLEGE - HATILLO CAMPUS     ,PR,00659-0000,Private      ,23,31,54,121,238,359
03112109,JOHN DEWEY COLLEGE - MANATI             ,PR,00674-0000,Private      ,76,141,217,227,418,645
03115900,TRINITY COLLEGE OF PUERTO RICO          ,PR,00734-0000,Private      ,21,35,56,98,159,257
03122500,ACADEMIA SERRANT INC.                   ,PR,00717-1568,Proprietary  ,28,70,98,120,191,311
03123100,GLOBELLE TECHNICAL INSTITUTE            ,PR,00693-4218,Proprietary  ,46,12,58,138,49,187
03124200,NOVA COLLEGE DE PUERTO RICO             ,PR,00960-4016,Proprietary  ,17,49,66,135,355,490
03157600,"COLEGIO DE CINEMATOGRAFIA, ARTES Y TELEV",PR,00961-6345,Proprietary  ,39,44,83,570,325,895
03177300,SAN JUAN BAUTISTA SCH OF MEDICINE       ,PR,00726-0000,Private      ,2,5,7,13,329,342
03326300,UNIVERSAL CAREER COMMUNITY COLLEGE      ,PR,00907-0000,Proprietary  ,59,113,172,412,737,1149
03336300,CENTURY COLLEGE                         ,PR,00603-0000,Proprietary  ,25,29,54,123,136,259
03414300,MONTECLARO                              ,PR,00745-9612,Private      ,0,0,0,14,6,20
03452300,INSTITUTO PRE-VOCACIONAL E INDUSTRI     ,PR,00613-1800,Private      ,7,26,33,73,175,248
03469300,IVAEM COLLEGE                           ,PR,00725-0000,Proprietary  ,3,3,6,134,68,202
03531300,UNIVERSIDAD PENTECOSTAL MIZPA           ,PR,00928-0966,Private      ,1,12,13,18,327,345
03544300,ATENAS COLLEGE                          ,PR,00674-0000,Private      ,64,89,153,1010,1268,2278
03552300,LESTON COLLEGE                          ,PR,00961-6309,Proprietary  ,14,31,45,71,156,227
03585300,CENTRO DE CAPACITACION Y ASESORAMIE     ,PR,00612-0000,Private      ,2,12,14,9,45,54
03608300,CARIBBEAN FORENSIC & TECHNICAL COLL     ,PR,00926-0000,Proprietary  ,13,18,31,43,75,118
03638300,ROSSLYN TRAINING ACADEMY OF COSMETOLOGY ,PR,00602-3225,Proprietary  ,2,12,14,11,56,67
03735400,"CHARLIES GUARD,DETECTIVE BUREAU&ACA     ",PR,00605-0000,Proprietary  ,8,19,27,68,100,168
03751300,ESCUELA HOTELERA DE SAN JUAN            ,PR,00917-0091,Proprietary  ,45,51,96,645,386,1031
03758300,BAYAMON COMMUNITY COLLEGE               ,PR,00960-0000,Proprietary  ,16,36,52,75,207,282
03781400,INDUSTRIAL TECHNICAL COLLEGE            ,PR,00792-0000,Proprietary  ,14,38,52,148,245,393
03785300,J.G. GUAYNABO TECHNICAL COLLEGE         ,PR,00960-0000,Proprietary  ,6,9,15,45,65,110
03800300,COLEGIO TECNICO DE ELECTRICIDAD GALLOSA ,PR,00602-0000,Proprietary  ,0,5,5,16,55,71
03800400,INSTITUTE OF BEAUTY OCCUPATIONS AND TECH,PR,00676-5071,Proprietary  ,27,67,94,66,126,192
03843300,ADVANCED TECH COLLEGE                   ,PR,00961-6321,Proprietary  ,18,42,60,96,179,275
03849300,AGUADILLA TECHNICAL COLLEGE             ,PR,00603-0000,Proprietary  ,3,4,7,21,39,60
03965400,MYRANGEL BEAUTY INSTITUTE               ,PR,00754-3917,Proprietary  ,19,61,80,90,204,294
04030300,"ASPIRA DE PUERTO RICO, ACADEMIA DE TECNO",PR,00987-0000,Private      ,0,1,1,6,3,9
04107300,CARIB TECHNOLOGICAL INSTITUTE           ,PR,00960-0000,Proprietary  ,15,40,55,75,112,187
04117200,INSTITUTO EDUCATIVO PREMIER             ,PR,00731-0000,Proprietary  ,41,105,146,102,268,370
04131600,LIBERTY TECHNICAL COLLEGE               ,PR,00737-1298,Proprietary  ,11,40,51,89,205,294
04158600,SCOTLAND EDUCATIONAL INSTITUTE          ,PR,00961-6312,Proprietary  ,0,0,0,3,8,11
04164300,GLOBAL INSTITUTE                        ,PR,00725-6485,Proprietary  ,2,1,3,2,1,3
04176000,AMERICAN TECHNICAL INSTITUTE            ,PR,00957-0000,Proprietary  ,12,12,24,33,26,59
00394600,UNIVERSITY OF THE VIRGIN ISLANDS        ,VI,00802-6000,Public       ,50,70,120,1149,983,2132
00394601,UNIV OF THE VIRGIN ISLANDS-ST CROIX     ,VI,00850-0000,Public       ,36,67,103,607,689,1296
00667700,MCGILL UNIVERSITY                       ,CN,00000-0000,Public       ,28,23,51,1620,456,2076
00667900,QUEEN'S UNIVERSITY AT KINGSTON          ,CN,00000-0000,Public       ,1,1,2,95,49,144
00668100,ST FRANCIS XAVIER UNIVERSITY            ,CN,00000-0000,Public       ,1,1,2,29,10,39
00668200,ST THOMAS UNIVERSITY                    ,CN,00000-0000,Public       ,1,0,1,45,7,52
00668300,UNIVERSITY OF GUELPH                    ,CN,00000-0000,Public       ,2,2,4,35,75,110
00668400,UNIVERSITY OF MANITOBA                  ,CN,00000-0000,Public       ,2,1,3,33,41,74
00668500,UNIVERSITY OF NEW BRUNSWICK (THE)       ,CN,00000-0000,Public       ,1,2,3,20,24,44
00668600,UNIVERSITY OF OTTAWA                    ,CN,00000-0000,Public       ,2,2,4,48,49,97
00668800,UNIVERSITY OF TORONTO                   ,CN,00000-0000,Public       ,13,21,34,325,411,736
00668900,UNIVERSITY OF WINDSOR                   ,CN,00000-0000,Public       ,3,1,4,26,50,76
00683700,UNIVERSITE LAVAL                        ,CN,00000-0000,Public       ,0,2,2,8,19,27
00683800,DALHOUSIE UNIVERSITY                    ,CN,00000-0000,Public       ,2,5,7,111,78,189
00685200,BISHOP'S UNIVERSITY                     ,CN,00000-0000,Private      ,2,0,2,52,8,60
00685300,MCMASTER UNIVERSITY                     ,CN,00000-0000,Public       ,0,2,2,26,40,66
00767900,YORK UNIVERSITY                         ,CN,00000-0000,Public       ,0,8,8,99,137,236
00787400,UNIVERSITY AT CALGARY (THE)             ,CN,00000-0000,Public       ,2,5,7,46,56,102
00814800,UNIVERSITY OF WINNIPEG                  ,CN,00000-0000,Public       ,1,0,1,15,10,25
00836200,UNIVERSITY OF ALBERTA (THE)             ,CN,00000-0000,Public       ,2,6,8,39,79,118
00836300,MOUNT SAINT VINCENT UNIVERSITY          ,CN,00000-0000,Private      ,0,1,1,8,11,19
00836400,SAINT MARY'S UNIVERSITY                 ,CN,00000-0000,Public       ,1,4,5,33,16,49
00836500,CONCORDIA UNIVERSITY - SIR GEORGE W     ,CN,00000-0000,Public       ,10,9,19,250,152,402
00836600,UNIVERSITE DE MONTREAL                  ,CN,00000-0000,Public       ,2,4,6,18,38,56
00836800,CARLETON UNIVERSITY                     ,CN,00000-0000,Public       ,2,1,3,49,31,80
00836900,UNIVERSITY OF BRITISH COLUMBIA          ,CN,00000-0000,Public       ,21,33,54,795,566,1361
00837000,"SAFA, UNIVERSITY OF VICTORIA            ",CN,00000-0000,Public       ,3,4,7,106,74,180
00844400,SIMON FRASER UNIVERSITY                 ,CN,00000-0000,Public       ,2,11,13,111,117,228
00844600,UNIVERSITY OF WESTERN ONTARIO (THE)     ,CN,00000-0000,Public       ,0,8,8,57,72,129
00844800,UNIVERSITY OF REGINA                    ,CN,00000-0000,Public       ,0,0,0,9,8,17
00844900,ACADIA UNIVERSITY                       ,CN,00000-0000,Public       ,0,1,1,45,15,60
00852600,UNIVERSITY OF WATERLOO                  ,CN,00000-0000,Public       ,0,0,0,33,12,45
00858200,WILFRID LAURIER UNIVERSITY              ,CN,00000-0000,Public       ,0,2,2,10,5,15
00891300,LAKEHEAD UNIVERSITY                     ,CN,00000-0000,Public       ,0,0,0,7,8,15
00911900,UNIVERSITE DE MONCTON                   ,CN,00000-0000,Public       ,0,0,0,0,3,3
00925200,BROCK UNIVERSITY                        ,CN,00000-0000,Public       ,1,1,2,9,8,17
00936700,UNIVERSITY OF PRINCE EDWARD ISLAND      ,CN,00000-0000,Public       ,0,3,3,15,106,121
00942100,BRANDON UNIVERSITY                      ,CN,00000-0000,Public       ,0,0,0,12,6,18
00948600,TRINITY WESTERN UNIVERSITY              ,CN,00000-0000,Private      ,2,4,6,173,66,239
00950000,MEMORIAL UNIVERSITY OF NEWFOUNDLAND     ,CN,00000-0000,Public       ,1,1,2,15,25,40
00950100,UNIVERSITY OF KING'S COLLEGE            ,CN,00000-0000,Public       ,0,1,1,27,4,31
00950300,MOUNT ALLISON UNIVERSITY                ,CN,00000-0000,Public       ,1,0,1,37,3,40
00950400,NOVA SCOTIA AGRICULTURAL COLLEGE        ,CN,00000-0000,Public       ,0,0,0,4,0,4
00950500,TRENT UNIVERSITY                        ,CN,00000-0000,Public       ,0,1,1,6,7,13
00969700,LETHBRIDGE COLLEGE                      ,CN,00000-0000,Public       ,0,0,0,3,2,5
00969800,MEDICINE HAT COLLEGE                    ,CN,00000-0000,Public       ,0,2,2,1,4,5
00970100,SENECA COLG OF APPLIED ARTS & TECH      ,CN,00000-0000,Public       ,0,0,0,9,11,20
01012300,NOVA SCOTIA COLLEGE OF ART & DESIGN     ,CN,00000-0000,Public       ,0,1,1,13,17,30
01022100,SAINT PAUL UNIVERSITY                   ,CN,00000-0000,Public       ,0,1,1,1,6,7
01045800,SHERIDAN COLLEGE OF APPLIED ARTS AN     ,CN,00000-0000,Public       ,0,1,1,27,13,40
01067500,REGENT COLLEGE                          ,CN,00000-0000,Private      ,0,5,5,1,93,94
01070300,UNIVERSITY OF LETHBRIDGE                ,CN,00000-0000,Public       ,0,2,2,5,8,13
01072000,RYERSON UNIVERSITY                      ,CN,00000-0000,Public       ,1,5,6,47,73,120
01172200,BRIERCREST BIBLE COLLEGE                ,CN,00000-0000,Private      ,0,0,0,11,3,14
01221100,ALGONQUIN COLLEGE OF APPLIED ARTS & TECH,CN,00000-0000,Public       ,0,0,0,6,5,11
01222800,HUMBER COLLEGE                          ,CN,00000-0000,Public       ,3,6,9,29,42,71
01227400,PROVIDENCE COLLEGE                      ,CN,00000-0000,Private      ,0,0,0,46,6,52
02102100,BETHANY BIBLE COLLEGE                   ,CN,00000-0000,Private      ,0,0,0,63,10,73
02116600,CANADIAN MEMORIAL CHIROPRACTIC COLL     ,CN,00000-0000,Private      ,0,0,0,0,1,1
02167000,PRAIRIE BIBLE INST                      ,CN,00000-0000,Private      ,0,0,0,25,3,28
02184600,INSTITUTE FOR CHRISTIAN STUDIES         ,CN,00000-0000,Private      ,0,2,2,2,10,12
02195600,LASALLE COLLEGE                         ,CN,00000-0000,Private      ,0,0,0,12,13,25
02195700,TAYLOR UNIVERSITY COLLEGE AND SEMINARY  ,CN,00000-0000,Private      ,0,1,1,0,3,3
02201100,COLUMBIA BIBLE COLLEGE                  ,CN,00000-0000,Private      ,0,1,1,20,11,31
02216400,TYNDALE COLLEGE & SEMINARY              ,CN,00000-0000,Private      ,0,2,2,9,7,16
02219200,UNIVERSITY OF SASKATCHEWAN              ,CN,00000-0000,Public       ,2,1,3,10,18,28
02324900,EMMANUEL BIBLE COLLEGE                  ,CN,00000-0000,Private      ,0,0,0,1,1,2
02338800,EMILY CARR UNIVERSITY OF ART AND DESIGN ,CN,00000-0000,Public       ,3,3,6,68,43,111
02577200,SALVATION ARMY WM & CATHERINE BOOTH     ,CN,00000-0000,Private      ,0,0,0,0,1,1
02593800,CONCORDIA UNIVERSITY COLLEGE            ,CN,00000-0000,Private      ,0,0,0,5,10,15
02611900,THE KING'S UNIVERSITY COLLEGE           ,CN,00000-0000,Private      ,0,0,0,1,3,4
03018300,ROCKY MOUNTAIN COLLEGE: CENTRE FOR BIBLI,CN,00000-0000,Private      ,1,0,1,1,1,2
03033800,UNIVERSITY COLLEGE OF CAPE BRETON       ,CN,00000-0000,Public       ,0,0,0,6,4,10
03078300,VANCOUVER SCHOOL OF THEOLOGY            ,CN,00000-0000,Private      ,0,1,1,3,5,8
03273300,CANADIAN COLLEGE OF NATUROPATHIC ME     ,CN,00000-0000,Private      ,0,2,2,2,29,31
03298300,ALBERTA COLLEGE OF ART & DESIGN         ,CN,00000-0000,Public       ,0,0,0,18,9,27
03332500,KWANTLEN UNIVERSITY COLLEGE             ,CN,00000-0000,Public       ,0,2,2,5,13,18
03335400,CANADIAN UNIVERSITY COLLEGE             ,CN,00000-0000,Private      ,1,3,4,36,13,49
03339300,ST. STEPHENS UNIVERSITY                 ,CN,00000-0000,Private      ,0,0,0,7,4,11
03348500,REDEEMER UNIVERSITY COLLEGE             ,CN,00000-0000,Private      ,0,0,0,14,6,20
03408300,CANDIAN NAZARENE UNIVERSITY COLLEGE     ,CN,00000-0000,Private      ,0,0,0,1,1,2
03420300,HOLLAND COLLEGE                         ,CN,00000-0000,Public       ,0,1,1,14,5,19
03421300,LOYALIST COLLEGE OF APPLIED ARTS &      ,CN,00000-0000,Public       ,0,0,0,1,0,1
03511300,CN CLG ACUPUNCTURE & ORIENTAL MED       ,CN,00000-0000,Private      ,0,0,0,1,4,5
03560400,NIAGARA COLLEGE-WELLAND CAMPUS          ,CN,00000-0000,Public       ,0,1,1,5,9,14
03613300,UNIV OF NORTHERN BRITISH COLUMBIA       ,CN,00000-0000,Public       ,0,1,1,7,12,19
03644400,CANADIAN MENNONITE UNIVERSITY           ,CN,00000-0000,Private      ,1,0,1,11,3,14
03674400,CANADIAN SOUTHERN BAPTIST SEMINARY      ,CN,00000-0000,Private      ,0,0,0,0,1,1
03711300,CAPILANO UNIVERSITY                     ,CN,00000-0000,Public       ,2,1,3,24,18,42
03745300,BRITISH COLUMBIA INSTITUTE OF TECHNOLOGY,CN,00000-0000,Public       ,0,0,0,6,12,18
03846300,PACIFIC LIFE BIBLE COLLEGE              ,CN,00000-0000,Private      ,1,0,1,11,2,13
03847300,CRANDALL UNIVERSITY                     ,CN,00000-0000,Private      ,0,0,0,5,2,7
04075300,QUEST UNIVERSITY CANADA                 ,CN,00000-0000,Private      ,1,0,1,1,0,1
04123100,ATLANTIC SCHOOL OF THEOLOGY             ,CN,00000-0000,Public       ,0,1,1,1,2,3
04156700,AMBROSE UNIVERSITY COLLEGE              ,CN,00000-0000,Private      ,3,2,5,6,10,16
00814700,UNIVERSIDAD AUTONOMA DE GUADALAJARA     ,MX,00000-0000,Private      ,6,244,250,76,1158,1234
01041800,INST TEC Y DE ESTSUPER DE MONTERRE      ,MX,00000-0000,Private      ,9,5,14,71,67,138
01067600,UNIVERSIDAD DE MONTERREY                ,MX,00000-0000,Private      ,0,3,3,22,44,66
01093800,UNIVERSIDAD DE GUANAJUATO               ,MX,00000-0000,Public       ,1,3,4,15,31,46
01097600,INSTITUTO ALLENDE                       ,MX,00000-0000,Private      ,0,0,0,6,15,21
02053300,CENTRO DE ESTUDIOS UNIVERSITARIOS D     ,MX,00000-0000,Private      ,20,34,54,146,243,389
01001000,AMERICAN SAMOA CMNTY COLLEGE            ,AS,96799-2609,Public       ,41,34,75,1542,466,2008
01034300,COLLEGE OF MICRONESIA - FSM             ,FM,96941-0159,Public       ,398,161,559,2370,1057,3427
01100900,PALAU COMMUNITY COLLEGE                 ,PW,96940-0009,Public       ,23,49,72,934,407,1341
03022400,COLLEGE OF THE MARSHALL ISLANDS         ,MH,96960-1258,Public       ,56,31,87,794,363,1157
03033000,NORTHERN MARIANAS COLLEGE               ,MP,96950-0000,Public       ,102,63,165,721,459,1180
