OPE ID,School,State,Zip Code,School Type,20122013Qtr6_Dependent Students,20122013Qtr6_Independent Students,Quarterly Total,YTD_20122013Qtr6_Dependent Students,YTD_20122013Qtr6_Independent Students,Award Year To Date Total
00100200,ALABAMA AGRCLTL & MECHL UNIV            ,AL,35762-1357,Public       ,43,66,109,7192,3840,11032
00100300,FAULKNER UNIVERSITY                     ,AL,36109-3398,Private      ,19,111,130,2177,4949,7126
00100400,UNIVERSITY OF MONTEVALLO                ,AL,35115-6000,Public       ,20,35,55,2619,1752,4371
00100500,ALABAMA STATE UNIVERSITY                ,AL,36101-0000,Public       ,221,162,383,10685,6742,17427
00100700,CENTRAL ALABAMA COMMUNITY COLLEGE       ,AL,35011-0000,Public       ,39,99,138,1691,2456,4147
00100800,ATHENS STATE UNIVERSITY                 ,AL,35611-1999,Public       ,12,76,88,976,3883,4859
00100900,AUBURN UNIVERSITY                       ,AL,36849-5113,Public       ,98,134,232,20446,7201,27647
00101200,BIRMINGHAM SOUTHERN COLLEGE             ,AL,35254-0002,Private      ,11,25,36,2308,1035,3343
00101300,CALHOUN COMMUNITY COLLEGE               ,AL,35609-2216,Public       ,104,297,401,5687,9680,15367
00101500,ENTERPRISE STATE COMMUNITY COLLEGE      ,AL,36331-1300,Public       ,40,77,117,1369,2243,3612
00101600,UNIVERSITY OF NORTH ALABAMA             ,AL,35632-0001,Public       ,55,78,133,5855,3538,9393
00101700,GADSDEN STATE COMMUNITY COLLEGE         ,AL,35903-2269,Public       ,79,288,367,3808,7290,11098
00101800,GEORGE C WALLACE COMMUNITY COLLEGE      ,AL,36303-0943,Public       ,80,187,267,2600,5092,7692
00101900,HUNTINGDON COLLEGE                      ,AL,36106-2148,Private      ,6,19,25,1726,926,2652
00102000,JACKSONVILLE STATE UNIVERSITY           ,AL,36265-1602,Public       ,59,143,202,7891,6576,14467
00102100,JEFFERSON DAVIS COMMUNITY COLLEGE       ,AL,36427-2790,Public       ,39,35,74,674,1002,1676
00102200,JEFFERSON STATE COMMUNITY COLLEGE       ,AL,35215-3098,Public       ,77,321,398,5363,10573,15936
00102300,JUDSON COLLEGE                          ,AL,36756-2504,Private      ,2,5,7,385,170,555
00102400,UNIVERSITY OF WEST ALABAMA              ,AL,35470-0000,Public       ,35,147,182,2720,6079,8799
00102600,MARION MILITARY INSTITUTE               ,AL,36756-3214,Public       ,7,2,9,565,86,651
00102800,MILES COLLEGE                           ,AL,35064-2697,Private      ,34,27,61,2597,1610,4207
00102900,UNIVERSITY OF MOBILE                    ,AL,36613-0000,Private      ,16,64,80,2105,2788,4893
00103000,BISHOP STATE COMMUNITY COLLEGE          ,AL,36603-5898,Public       ,68,266,334,2843,6236,9079
00103100,NORTHEAST ALABAMA STATE CMNTY COLG      ,AL,35986-0159,Public       ,77,113,190,1758,2551,4309
00103300,OAKWOOD COLLEGE                         ,AL,35896-0001,Private      ,9,17,26,2084,1427,3511
00103400,ALABAMA SOUTHERN COMMUNITY COLLEGE      ,AL,36460-5698,Public       ,59,62,121,1282,1375,2657
00103600,SAMFORD UNIVERSITY                      ,AL,35229-7000,Private      ,18,73,91,4019,3603,7622
00103800,SNEAD STATE COMMUNITY COLLEGE           ,AL,35957-0734,Public       ,24,58,82,1667,2361,4028
00104000,SOUTHERN UNION STATE COMMUNITY CLG      ,AL,36276-0000,Public       ,59,91,150,4000,3924,7924
00104100,SPRING HILL COLLEGE                     ,AL,36608-1791,Private      ,4,34,38,2017,1185,3202
00104400,STILLMAN COLLEGE                        ,AL,35403-1430,Private      ,23,16,39,2113,837,2950
00104600,TALLADEGA COLLEGE                       ,AL,35160-2354,Private      ,15,9,24,1067,638,1705
00104700,TROY UNIVERSITY                         ,AL,36082-0001,Public       ,104,690,794,9814,25627,35441
00105000,TUSKEGEE UNIVERSITY                     ,AL,36088-1645,Private      ,33,13,46,6235,1692,7927
00105100,UNIVERSITY OF ALABAMA (THE)             ,AL,35487-0120,Public       ,141,227,368,28313,12694,41007
00105200,UNIVERSITY OF ALABAMA AT BIRMINGHAM     ,AL,35294-1150,Public       ,70,257,327,12705,14924,27629
00105500,UNIVERSITY OF ALABAMA IN HUNTSVILLE     ,AL,35899-0001,Public       ,51,93,144,5684,5543,11227
00105700,UNIVERSITY OF SOUTH ALABAMA             ,AL,36688-0002,Public       ,81,268,349,11269,11793,23062
00105900,LAWSON STATE COMMUNITY COLLEGE          ,AL,35221-1798,Public       ,50,179,229,2598,4819,7417
00105901,LAWSON STATE COMMUNITY COLLEGE - BESSEME,AL,35021-0308,Public       ,30,62,92,986,1816,2802
00106000,FAULKNER STATE COMMUNITY COLLEGE        ,AL,36507-2698,Public       ,65,152,217,3812,4343,8155
00526000,J.F. DRAKE STATE TECH COLLEGE           ,AL,35811-1584,Public       ,29,113,142,744,2611,3355
00569100,SHELTON STATE COMMUNITY CLG             ,AL,35405-4017,Public       ,97,151,248,5116,4948,10064
00569200,REID STATE TECHNICAL COLLEGE            ,AL,36401-0000,Public       ,8,42,50,336,823,1159
00569700,NORTHWEST- SHOALS COMMUNITY COLLEGE     ,AL,35661-0000,Public       ,184,164,348,2519,3121,5640
00569900,GEORGE C WALLACE STATE CMTY COLLEGE     ,AL,36703-0000,Public       ,106,108,214,1368,2351,3719
00573300,BEVILL STATE CMTY COLLEGE-WALKER        ,AL,35148-0000,Public       ,50,142,192,2488,4203,6691
00573400,H. COUNCILL TRENHOLM STATE TECH COLLEGE ,AL,36108-0020,Public       ,20,128,148,1127,2901,4028
00573401,H. C. TRENHOLM ST TECH COL-PATTERSON CAM,AL,36116-2612,Public       ,9,49,58,674,1632,2306
00787100,GEORGE C WALLACE STATE CMTY CLG         ,AL,35077-2000,Public       ,87,109,196,3973,5482,9455
00831000,AUBURN UNIVERSITY-MONTGOMERY            ,AL,36124-0000,Public       ,53,113,166,4960,5787,10747
00898800,LURLEEN B WALLACE COMMUNITY COLLEGE     ,AL,36420-0418,Public       ,35,68,103,1213,1637,2850
01055400,CONCORDIA COLLEGE                       ,AL,36701-3323,Private      ,59,8,67,915,636,1551
01218200,CHATTAHOOCHEE VALLEY CMTY CLG           ,AL,36869-7917,Public       ,32,91,123,1237,2366,3603
01303906,SOUTH UNIVERSITY - MONTGOMERY           ,AL,36116-1120,Proprietary  ,20,92,112,594,2143,2737
02170600,UNITED STATES SPORTS ACADEMY            ,AL,36526-7055,Private      ,0,23,23,50,892,942
02199700,HERITAGE CHRISTIAN UNIVERSITY           ,AL,35630-0000,Private      ,0,3,3,36,103,139
02270400,SOUTHEASTERN BIBLE COLLEGE              ,AL,35244-2083,Private      ,0,6,6,145,393,538
02285000,PAUL MITCHELL THE SCHOOL HUNTSVILLE     ,AL,35758-0000,Proprietary  ,3,7,10,116,193,309
02296000,PRINCE INSTITUTE OF PROFESSIONAL STUDIES,AL,36117-0000,Proprietary  ,0,2,2,72,407,479
02341000,FORTIS COLLEGE                          ,AL,36609-0000,Proprietary  ,72,191,263,910,3042,3952
02503400,AMRIDGE UNIVERSITY                      ,AL,36124-0000,Private      ,3,69,72,122,1450,1572
02605500,REMINGTON COLLEGE - MOBILE CAMPUS       ,AL,36609-5593,Private      ,62,196,258,1153,3281,4434
03010600,VIRGINIA COLLEGE                        ,AL,35209-5154,Proprietary  ,379,2392,2771,4247,29791,34038
03010602,VIRGINIA COLLEGE - HUNTSVILLE           ,AL,35805-0000,Proprietary  ,7,25,32,322,1500,1822
03010607,VIRGINIA COLLEGE - MOBILE               ,AL,36608-1626,Proprietary  ,20,83,103,522,1924,2446
03010616,VIRGINIA COLLEGE - MONTGOMERY           ,AL,36117-2802,Proprietary  ,31,111,142,604,2375,2979
03032500,ALABAMA STATE CLG BARBER STYLING        ,AL,35215-0000,Proprietary  ,0,11,11,100,232,332
03361400,FORTIS COLLEGE                          ,AL,36535-0000,Proprietary  ,14,54,68,209,901,1110
03459300,SOUTHEASTERN SCHOOL OF COSMETOLOGY      ,AL,35228-0000,Private      ,3,9,12,67,240,307
03783300,BLUE CLIFF CAREER COLLEGE               ,AL,63306-4749,Proprietary  ,3,12,15,123,514,637
03894300,HUNTSVILLE BIBLE COLLEGE                ,AL,35811-0000,Private      ,1,9,10,31,260,291
04066300,CARDIAC AND VASCULAR INSTITUTE OF ULTRAS,AL,36604-1411,Proprietary  ,2,8,10,77,400,477
04067300,SELMA UNIVERSITY                        ,AL,36701-0000,Private      ,7,18,25,246,619,865
04121500,COLUMBIA SOUTHERN UNIVERSITY            ,AL,36561-3815,Proprietary  ,17,469,486,508,15280,15788
04149200,XCELL ACADEMY-A PAUL MITCHELL PARTNER SC,AL,35216-4990,Proprietary  ,4,11,15,116,306,422
04187200,NEW BEGINNING COLLEGE OF COSMETOLOGY    ,AL,35950-2415,Proprietary  ,4,10,14,68,206,274
04187300,HAIR ACADEMY (THE)                      ,AL,36111-2201,Proprietary  ,2,1,3,74,225,299
04197500,UNIVERSITY ACADEMY OF HAIR DESIGN       ,AL,35476-3100,Proprietary  ,1,10,11,29,80,109
04211000,SALON PROFESSIONAL ACADEMY (THE)        ,AL,35816-1849,Proprietary  ,1,5,6,14,33,47
00111100,ALLAN HANCOCK COLLEGE                   ,CA,93454-6399,Public       ,30,101,131,5222,6326,11548
00111300,ANTELOPE VALLEY COLLEGE                 ,CA,93536-5426,Public       ,135,368,503,7885,13343,21228
00111600,ART CENTER COLLEGE OF DESIGN            ,CA,91103-1999,Private      ,6,18,24,2117,1767,3884
00111700,AZUSA PACIFIC UNIVERSITY                ,CA,91702-7000,Private      ,17,270,287,10936,9892,20828
00111800,BAKERSFIELD COLLEGE                     ,CA,93305-1299,Public       ,219,370,589,11668,13876,25544
00111900,BARSTOW COMMUNITY COLLEGE               ,CA,92311-6608,Public       ,62,233,295,1592,5238,6830
00112000,AMER BAPT SEM OF THE WEST-BERKELEY      ,CA,94704-0000,Private      ,0,1,1,13,67,80
00112100,BETHANY UNIVERSITY /  ASSEMBLIES OF GOD ,CA,95066-2896,Private      ,0,0,0,4,13,17
00112200,BIOLA UNIVERSITY                        ,CA,90639-0001,Private      ,13,12,25,7215,2506,9721
00112300,BROOKS INSTITUTE                        ,CA,93103-1809,Proprietary  ,2,8,10,822,610,1432
00112400,CABRILLO COLLEGE                        ,CA,95003-3194,Public       ,84,119,203,5797,6816,12613
00112500,CALIFORNIA BAPTIST UNIVERSITY           ,CA,92504-3297,Private      ,27,178,205,6909,5529,12438
00112700,CALIFORNIA COLLEGE OF THE ARTS          ,CA,94107-2206,Private      ,14,19,33,2587,2270,4857
00113100,CALIFORNIA INSTITUTE OF TECHNOLOGY      ,CA,91125-0001,Private      ,4,8,12,3956,885,4841
00113200,CALIFORNIA INSTITUTE OF THE ARTS        ,CA,91355-2397,Private      ,5,6,11,2583,1756,4339
00113300,CALIFORNIA LUTHERAN UNIVERSITY          ,CA,91360-2787,Private      ,4,75,79,5261,2084,7345
00113400,CALIFORNIA MARITIME ACADEMY             ,CA,94590-8181,Public       ,1,3,4,1065,508,1573
00113700,CALIF STATE UNIV-FULLERTON              ,CA,92831-3599,Public       ,59,125,184,51463,25389,76852
00113800,"CALIFORNIA STATE UNIVERSITY, EAST BAY   ",CA,94542-3000,Public       ,52,138,190,16175,15207,31382
00113900,CALIF STATE UNIV-LONG BEACH             ,CA,90840-0006,Public       ,80,118,198,62670,27062,89732
00114000,CALIF STATE UNIV-LOS ANGELES            ,CA,90032-4226,Public       ,71,144,215,35540,24972,60512
00114100,"CALIF STATE UNIV, DOMINGUEZ HILLS       ",CA,90747-0001,Public       ,47,133,180,18508,17158,35666
00114200,CALIF STATE UNIV SAN BERNARDINO         ,CA,92407-2397,Public       ,65,136,201,22228,16103,38331
00114300,CAL POLY STATE UNIVERSITY               ,CA,93407-0001,Public       ,132,29,161,38022,5168,43190
00114400,CALIF STATE POLYTECHNIC UNIV POMONA     ,CA,91768-2500,Public       ,179,67,246,34114,12533,46647
00114600,CALIF STATE UNIV - CHICO                ,CA,95929-0001,Public       ,42,50,92,21248,7653,28901
00114700,CALIF STATE UNIV - FRESNO               ,CA,93740-8026,Public       ,29,77,106,26089,14036,40125
00114900,HUMBOLDT STATE UNIVERSITY               ,CA,95521-8299,Public       ,12,18,30,12517,4424,16941
00115000,CALIF STATE UNIV-SACRAMENTO             ,CA,95819-6044,Public       ,73,140,213,32782,22360,55142
00115100,SAN DIEGO STATE UNIVERSITY              ,CA,92182-1690,Public       ,118,191,309,59074,24125,83199
00115300,CALIF STATE UNIV-NORTHRIDGE             ,CA,91330-8307,Public       ,78,113,191,44172,24424,68596
00115400,SAN FRANCISCO STATE UNIVERSITY          ,CA,94132-1740,Public       ,201,179,380,39358,22330,61688
00115500,SAN JOSE STATE UNIVERSITY               ,CA,95192-0036,Public       ,57,108,165,32570,19101,51671
00115600,SONOMA STATE UNIVERSITY                 ,CA,94928-3609,Public       ,18,27,45,12928,4233,17161
00115700,CALIF STATE UNIV-STANISLAUS             ,CA,95382-0299,Public       ,11,41,52,10467,7073,17540
00116100,CERRITOS COLLEGE                        ,CA,90650-6296,Public       ,158,301,459,19211,16142,35353
00116200,CHABOT COLLEGE                          ,CA,94545-2400,Public       ,67,184,251,7229,9397,16626
00116300,CHAFFEY COLLEGE                         ,CA,91737-9400,Public       ,134,294,428,16327,16994,33321
00116400,CHAPMAN UNIVERSITY                      ,CA,92866-1099,Private      ,17,32,49,11442,4021,15463
00116453,CHAPMAN UNIVERSITY SCHOOL OF LAW        ,CA,92866-0000,Private      ,0,3,3,95,1865,1960
00116500,CHURCH DIV SCH OF THE PACIFIC           ,CA,94709-0000,Private      ,0,1,1,2,64,66
00116600,CITRUS COLLEGE                          ,CA,91741-1899,Public       ,172,218,390,11294,8732,20026
00116900,CLAREMONT GRADUATE UNIVERSITY           ,CA,91711-0000,Private      ,1,32,33,27,2152,2179
00117000,CLAREMONT MCKENNA COLLEGE               ,CA,91711-6400,Private      ,3,0,3,3832,228,4060
00117100,HARVEY MUDD COLLEGE                     ,CA,91711-5990,Private      ,1,0,1,2734,111,2845
00117200,PITZER COLLEGE                          ,CA,91711-6101,Private      ,1,0,1,3282,234,3516
00117300,POMONA COLLEGE                          ,CA,91711-6301,Private      ,2,1,3,5314,290,5604
00117400,SCRIPPS COLLEGE                         ,CA,91711-3948,Private      ,0,1,1,1966,179,2145
00117600,WEST HILLS COMMUNITY COLLEGE            ,CA,93210-1399,Public       ,13,32,45,1591,1566,3157
00117700,COGSWELL POLYTECHNICAL COLLEGE          ,CA,94089-1210,Proprietary  ,11,3,14,372,217,589
00117800,COLLEGE OF MARIN                        ,CA,94904-2590,Public       ,10,36,46,1349,2986,4335
00117801,COLG OF MARIN-INDIAN VALLEY CMPS        ,CA,94949-0000,Public       ,2,20,22,296,870,1166
00117900,NOTRE DAME DE NAMUR UNIVERSITY          ,CA,94002-1997,Private      ,2,17,19,1880,1629,3509
00118100,COLLEGE OF SAN MATEO                    ,CA,94402-3784,Public       ,69,146,215,3778,3942,7720
00118200,COLLEGE OF THE DESERT                   ,CA,92260-9305,Public       ,49,111,160,6399,7117,13516
00118300,HOLY NAMES UNIVERSITY                   ,CA,94619-1699,Private      ,2,10,12,1161,1384,2545
00118500,COLLEGE OF THE REDWOODS                 ,CA,95501-9300,Public       ,12,63,75,2930,4786,7716
00118600,COLLEGE OF THE SEQUOIAS                 ,CA,93277-2234,Public       ,47,115,162,7732,8528,16260
00118700,COLLEGE OF THE SISKIYOUS                ,CA,96094-2899,Public       ,7,38,45,1210,1528,2738
00118701,COLLEGE OF THE SISKIYOUS - YREKA CENTER ,CA,96097-9538,Public       ,3,18,21,169,487,656
00119000,CONTRA COSTA COLLEGE                    ,CA,94806-3195,Public       ,43,111,154,2810,5099,7909
00119100,DIABLO VALLEY COLLEGE                   ,CA,94523-1544,Public       ,75,176,251,6865,7336,14201
00119200,CUESTA COLLEGE                          ,CA,93403-8106,Public       ,44,124,168,5350,4938,10288
00119300,CYPRESS COLLEGE                         ,CA,90630-5897,Public       ,99,175,274,12157,10901,23058
00119600,DOMINICAN UNIVERSITY OF CALIFORNIA      ,CA,94901-2298,Private      ,1,8,9,3251,1616,4867
00119700,EL CAMINO COLLEGE                       ,CA,90506-0002,Public       ,149,317,466,15884,15609,31493
00119701,COMPTON COMMUNITY COLLEGE               ,CA,90221-5393,Public       ,52,217,269,3884,6943,10827
00119900,FOOTHILL COLLEGE                        ,CA,94022-4597,Public       ,73,164,237,4040,5476,9516
00120000,FULLER THEOLOGICAL SEMINARY             ,CA,91182-0000,Private      ,1,24,25,21,2448,2469
00120100,FULLERTON COLLEGE                       ,CA,92832-2095,Public       ,142,296,438,15112,10900,26012
00120200,GAVILAN COLLEGE                         ,CA,95020-9599,Public       ,59,81,140,2238,2843,5081
00120300,GLENDALE COMMUNITY COLLEGE              ,CA,91208-2894,Public       ,118,145,263,11321,10904,22225
00120500,GOLDEN GATE UNIVERSITY                  ,CA,94105-2967,Private      ,4,59,63,248,4224,4472
00120600,GOLDEN WEST COLLEGE                     ,CA,92647-2748,Public       ,40,130,170,10089,9440,19529
00120700,GRADUATE THEOLOGICAL UNION              ,CA,94709-0000,Private      ,0,1,1,1,344,345
00120800,GROSSMONT COLLEGE                       ,CA,92020-1799,Public       ,114,237,351,11125,13156,24281
00120900,HARTNELL COMMUNITY COLLEGE              ,CA,93901-1697,Public       ,92,100,192,4459,4085,8544
00121200,HUMPHREYS COLLEGE                       ,CA,95207-3896,Private      ,4,9,13,457,1598,2055
00121400,IMPERIAL VALLEY COLLEGE                 ,CA,92251-9787,Public       ,83,88,171,4929,4508,9437
00121500,LA SIERRA UNIVERSITY                    ,CA,92515-3332,Private      ,12,25,37,3679,1776,5455
00121600,UNIVERSITY OF LA VERNE                  ,CA,91750-4443,Private      ,9,155,164,6092,7817,13909
00121700,LASSEN COLLEGE                          ,CA,96130-3000,Public       ,7,9,16,602,926,1528
00121800,LOMA LINDA UNIVERSITY                   ,CA,92350-0001,Private      ,7,23,30,1459,6611,8070
00121900,LONG BEACH CITY COLLEGE                 ,CA,90808-1780,Public       ,132,311,443,20396,20456,40852
00122000,MASTER'S COLLEGE & SEMINARY (THE)       ,CA,91321-1200,Private      ,2,6,8,1625,622,2247
00122300,LOS ANGELES CITY COLLEGE                ,CA,90029-3588,Public       ,123,410,533,11933,18904,30837
00122400,LOS ANGELES HARBOR COLLEGE              ,CA,90744-2397,Public       ,65,138,203,5342,6311,11653
00122600,LOS ANGELES PIERCE COLLEGE              ,CA,91371-0001,Public       ,334,291,625,14961,13174,28135
00122700,LOS ANGELES TRADE TECH COLLEGE          ,CA,90015-4181,Public       ,102,417,519,7993,15977,23970
00122800,LOS ANGELES VALLEY COLLEGE              ,CA,91401-4096,Public       ,151,270,421,11035,13090,24125
00122900,SO CA UNIV  HEALTH SCIENCES             ,CA,90604-4051,Private      ,4,16,20,64,838,902
00123000,SOUTHERN CA COLLEGE OF OPTOMETRY        ,CA,92831-1699,Private      ,0,0,0,28,569,597
00123200,AMERICAN RIVER COLLEGE                  ,CA,95841-4286,Public       ,167,570,737,16005,27933,43938
00123300,SACRAMENTO CITY COLLEGE                 ,CA,95822-1386,Public       ,175,481,656,16354,22174,38528
00123600,MENLO COLLEGE                           ,CA,94027-4301,Private      ,7,1,8,1818,236,2054
00123700,MERCED COMMUNITY COLLEGE                ,CA,95348-2898,Public       ,118,188,306,7430,7450,14880
00123800,MILLS COLLEGE                           ,CA,94613-1301,Private      ,5,15,20,1974,2212,4186
00123900,MIRACOSTA COLLEGE                       ,CA,92056-3899,Public       ,36,158,194,5525,7984,13509
00124000,MODESTO JUNIOR COLLEGE                  ,CA,95350-5800,Public       ,130,383,513,11640,14690,26330
00124200,MONTEREY PENINSULA COLLEGE              ,CA,93940-4799,Public       ,41,81,122,3179,3390,6569
00124300,MOUNT ST MARYS COLLEGE                  ,CA,90049-1599,Private      ,10,35,45,3665,3140,6805
00124500,MT. SAN ANTONIO COLLEGE                 ,CA,91789-1399,Public       ,135,218,353,21586,18465,40051
00124600,MT SAN JACINTO COLLEGE                  ,CA,92583-2399,Public       ,51,145,196,10185,14229,24414
00124700,NAPA VALLEY COLLEGE                     ,CA,94558-6236,Public       ,22,70,92,3416,3741,7157
00124900,OCCIDENTAL COLLEGE                      ,CA,90041-3314,Private      ,5,3,8,5722,522,6244
00125000,ORANGE COAST COLLEGE - FIN AID OFF      ,CA,92628-5005,Public       ,73,152,225,16077,12702,28779
00125100,OTIS COLLEGE OF ART AND DESIGN          ,CA,90045-3505,Private      ,6,10,16,1895,1045,2940
00125200,HOPE INTERNATIONAL UNIVERSITY           ,CA,92631-0000,Private      ,4,16,20,940,1268,2208
00125300,FRESNO PACIFIC UNIVERSITY               ,CA,93702-4798,Private      ,6,95,101,2853,4730,7583
00125400,PACIFIC LUTHERAN THEOLOGICAL SEM        ,CA,94708-0000,Private      ,1,2,3,5,82,87
00125500,PACIFIC OAKS COLLEGE                    ,CA,91103-3606,Private      ,0,33,33,78,1343,1421
00125600,PACIFIC SCHOOL OF RELIGION              ,CA,94709-0000,Private      ,0,1,1,2,195,197
00125800,PACIFIC UNION COLLEGE                   ,CA,94508-9797,Private      ,2,8,10,2101,637,2738
00125900,PALO VERDE COLLEGE                      ,CA,92225-0000,Public       ,3,14,17,328,573,901
00126000,PALOMAR COLLEGE                         ,CA,92069-1486,Public       ,69,239,308,11336,11484,22820
00126100,PASADENA CITY COLLEGE                   ,CA,91106-2003,Public       ,144,287,431,21244,15679,36923
00126200,POINT LOMA NAZARENE UNIVERSITY          ,CA,92106-2899,Private      ,8,40,48,5190,1946,7136
00126600,LANEY COLLEGE                           ,CA,94607-4893,Public       ,74,272,346,4820,10494,15314
00126700,MERRITT COLLEGE                         ,CA,94619-3196,Public       ,43,183,226,2915,6677,9592
00126800,PORTERVILLE COLLEGE                     ,CA,93257-6059,Public       ,50,63,113,2636,2880,5516
00126900,RIO HONDO COLLEGE                       ,CA,90601-1699,Public       ,80,157,237,13944,10977,24921
00127000,RIVERSIDE CITY COLLEGE                  ,CA,92506-1299,Public       ,207,409,616,22645,23504,46149
00127200,SAN BERNARDINO VALLEY COLLEGE           ,CA,92410-2798,Public       ,96,325,421,11122,16074,27196
00127300,SAN DIEGO CITY COLLEGE                  ,CA,92101-4787,Public       ,119,240,359,12555,18936,31491
00127500,SAN DIEGO MESA COLLEGE                  ,CA,92111-4996,Public       ,75,176,251,13374,15934,29308
00127800,SAN FRANCISCO CONSERVATORY OF MUSIC     ,CA,94122-4498,Private      ,1,1,2,407,490,897
00127900,SAN FRANCISCO THEOLOGICAL SEMINARY      ,CA,94960-0000,Private      ,0,1,1,4,80,84
00128000,SAN JOAQUIN DELTA COLLEGE               ,CA,95207-6370,Public       ,173,369,542,11548,14715,26263
00128100,WILLIAM JESSUP UNIVERSITY               ,CA,95765-3707,Private      ,5,20,25,1128,843,1971
00128200,SAN JOSE CITY COLLEGE                   ,CA,95128-2797,Public       ,51,157,208,5633,8485,14118
00128400,SANTA ANA COLLEGE                       ,CA,92706-3398,Public       ,54,192,246,9891,9582,19473
00128500,SANTA BARBARA CITY COLLEGE              ,CA,93109-2394,Public       ,130,218,348,10342,7392,17734
00128600,SANTA MONICA COLLEGE                    ,CA,90405-1644,Public       ,177,302,479,23541,14683,38224
00128700,SANTA ROSA JUNIOR COLLEGE               ,CA,95401-4395,Public       ,44,133,177,7542,9419,16961
00128800,CLAREMONT SCHOOL OF THEOLOGY            ,CA,91711-0000,Private      ,0,3,3,7,313,320
00128900,SHASTA COLLEGE                          ,CA,96049-7692,Public       ,20,110,130,4599,6930,11529
00129000,SIERRA COLLEGE                          ,CA,95677-3397,Public       ,87,214,301,9726,11993,21719
00129100,SIMPSON UNIVERSITY                      ,CA,96003-8606,Private      ,2,12,14,1374,1377,2751
00129200,SOLANO COMMUNITY COLLEGE                ,CA,94534-3197,Public       ,68,192,260,4711,7360,12071
00129300,VANGUARD UNIVERSITY OF SOUTHERN CA      ,CA,92626-6597,Private      ,13,54,67,2819,1593,4412
00129400,SOUTHWESTERN COLLEGE                    ,CA,91910-7299,Public       ,90,212,302,11265,11023,22288
00129500,SOUTHWESTERN LAW SCHOOL                 ,CA,90010-1106,Private      ,2,8,10,109,2749,2858
00129600,DOMINICAN SCH PHILOSOPHY & THEOLOGY     ,CA,94709-0000,Private      ,0,0,0,7,78,85
00129900,ST JOHN'S SEMINARY COLLEGE              ,CA,93010-0000,Private      ,0,0,0,8,19,27
00130200,SAINT MARY'S COLLEGE OF CALIFORNIA      ,CA,94556-2744,Private      ,1,35,36,6349,2131,8480
00130500,STANFORD UNIVERSITY                     ,CA,94305-6106,Private      ,32,36,68,26947,4441,31388
00130501,STANFORD UNIVERSITY - GRADUATE SCHOOL OF,CA,94305-5301,Private      ,0,12,12,86,1722,1808
00130502,STANFORD UNIVERSITY - GRADUATE SCHOOL OF,CA,94305-5015,Private      ,3,19,22,108,2202,2310
00130503,STANFORD UNIVERSITY - STANFORD LAW SCHOO,CA,94305-3096,Private      ,6,5,11,254,2507,2761
00130700,FRESNO CITY COLLEGE                     ,CA,93741-0002,Public       ,133,354,487,18445,20383,38828
00130800,REEDLEY COLLEGE                         ,CA,93654-2099,Public       ,42,91,133,8203,6538,14741
00130900,TAFT COLLEGE                            ,CA,93268-2317,Public       ,27,62,89,1998,1832,3830
00131200,UNIVERSITY OF CALIFORNIA-BERKELEY       ,CA,94720-1520,Public       ,468,159,627,59144,22978,82122
00131300,UNIVERSITY OF CALIFORNIA-DAVIS          ,CA,95616-8558,Public       ,86,65,151,54175,17252,71427
00131400,UNIVERSITY OF CALIFORNIA-IRVINE         ,CA,92697-2825,Public       ,473,191,664,60969,15850,76819
00131500,UNIVERSITY OF CALIFORNIA (UCLA)         ,CA,90095-9000,Public       ,133,188,321,75496,32149,107645
00131502,UNIV OF CALIFORNIA LOS ANG SCH MED      ,CA,90095-0000,Public       ,3,3,6,432,1310,1742
00131503,UNIV OF CALIFORNIA LOS ANG DENTAL       ,CA,90095-0000,Public       ,0,2,2,143,301,444
00131600,UNIVERSITY OF CALIFORNIA-RIVERSIDE      ,CA,92521-0209,Public       ,52,98,150,41090,10736,51826
00131700,UNIVERSITY OF CALIFORNIA-SAN DIEGO      ,CA,92093-0013,Public       ,70,76,146,55408,12902,68310
00131900,UNIVERSITY OF CALIFORNIA-SFRANCISCO     ,CA,94143-0246,Public       ,10,24,34,1937,5239,7176
00132000,UNIVERSITY OF CALIFORNIA-SANTA BARB     ,CA,93106-3180,Public       ,380,64,444,53440,8649,62089
00132100,UNIVERSITY OF CALIFORNIA-SANTA CRUZ     ,CA,95064-0001,Public       ,54,53,107,35631,5886,41517
00132200,UNIVERSITY OF REDLANDS                  ,CA,92373-0999,Private      ,11,139,150,6111,4029,10140
00132500,UNIVERSITY OF SAN FRANCISCO             ,CA,94117-1080,Private      ,21,111,132,12891,9763,22654
00132600,SANTA CLARA UNIVERSITY                  ,CA,95053-4956,Private      ,13,58,71,12355,4233,16588
00132604,JESUIT SCHOOL OF THEOLOGY - BERKELEY    ,CA,94709-1193,Private      ,0,1,1,6,73,79
00132800,UNIVERSITY OF SOUTHERN CALIFORNIA       ,CA,90089-0914,Private      ,70,252,322,46262,33795,80057
00132900,UNIVERSITY OF THE PACIFIC               ,CA,95211-0197,Private      ,14,26,40,13468,4181,17649
00132901,UNIVERSITY OF THE PACIFIC - MCGEORGE SCH,CA,95817-2799,Private      ,0,8,8,223,2050,2273
00132902,UNIV OF THE PACIFIC SCH OF DENT         ,CA,94115-0000,Private      ,0,1,1,112,698,810
00133400,VENTURA COLLEGE                         ,CA,93003-3899,Public       ,123,217,340,7072,7355,14427
00133500,VICTOR VALLEY COLLEGE                   ,CA,92395-5849,Public       ,172,350,522,7843,12730,20573
00133800,WEST VALLEY COLLEGE                     ,CA,95070-5697,Public       ,39,72,111,3426,3750,7176
00134100,WESTMONT COLLEGE                        ,CA,93108-1099,Private      ,5,0,5,2795,180,2975
00134200,WHITTIER COLLEGE                        ,CA,90601-4413,Private      ,7,9,16,4295,831,5126
00134201,WHITTIER COLLEGE - COLLEGE OF LAW       ,CA,92626-1501,Private      ,0,1,1,45,1596,1641
00134300,WOODBURY UNIVERSITY                     ,CA,91510-7846,Private      ,7,15,22,1304,1139,2443
00134400,YUBA COLLEGE                            ,CA,95901-7699,Public       ,109,160,269,3977,6395,10372
00177212,TRINITY INTERNATIONAL UNIV-CA           ,CA,92705-0000,Private      ,1,5,6,12,404,416
00274100,AMERICAN JEWISH UNIVERSITY              ,CA,90077-1599,Private      ,0,0,0,120,149,269
00301002,ANTIOCH UNIV/LOS ANGELES                ,CA,90230-7615,Private      ,0,13,13,61,1257,1318
00301003,ANTIOCH  UNIV/SANTA BARBARA             ,CA,93101-0000,Private      ,4,5,9,736,706,1442
00369110,MIDDLEBURY COLLEGE - MONTEREY INSTITUTE ,CA,93940-2691,Private      ,1,5,6,42,953,995
00394700,UC-HASTINGS COLLEGE OF THE LAW          ,CA,94102-0000,Public       ,0,0,0,36,3573,3609
00394800,SAN FRANCISCO ART INSTITUTE             ,CA,94133-2299,Private      ,12,12,24,2336,1694,4030
00405402,HEBREW UNION COLLEGE JEWISH INSTITUTE OF,CA,90007-3717,Private      ,0,0,0,0,3,3
00408000,STARR KING SCHOOL FOR THE MINISTRY      ,CA,94709-1299,Private      ,0,1,1,3,117,120
00448000,DE ANZA COLLEGE                         ,CA,95014-5793,Public       ,116,221,337,9709,8738,18447
00448100,OHLONE COLLEGE                          ,CA,94539-5847,Public       ,51,78,129,3969,4181,8150
00448400,JOHN F. KENNEDY UNIVERSITY              ,CA,94523-4817,Private      ,5,19,24,67,1783,1850
00449000,PATTEN UNIVERSITY                       ,CA,94601-2699,Private      ,1,5,6,171,324,495
00449400,EVEREST COLLEGE                         ,CA,92408-3752,Proprietary  ,30,108,138,649,1560,2209
00450200,CITY COLLEGE OF SAN FRANCISCO           ,CA,94112-0000,Public       ,162,528,690,12492,19058,31550
00450302,EVEREST COLLEGE - SANTA ANA             ,CA,92701-4559,Proprietary  ,41,65,106,479,810,1289
00563800,DOWNEY ADULT SCHOOL                     ,CA,90241-5610,Public       ,9,24,33,326,1049,1375
00565500,HACIENDA LA PUENTE ADULT EDUC CTR       ,CA,91746-0000,Public       ,3,10,13,259,717,976
00616500,LA CNTY CLG OF NURSING & ALLD HLTH      ,CA,90033-1018,Public       ,2,8,10,282,803,1085
00672000,COLLEGE OF ALAMEDA                      ,CA,94501-2109,Public       ,58,148,206,3118,4540,7658
00673100,CASA LOMA COLLEGE                       ,CA,91405-4523,Private      ,28,47,75,323,809,1132
00697300,CANADA COLLEGE                          ,CA,94061-1099,Public       ,37,88,125,1689,2624,4313
00697500,LINCOLN UNIVERSITY                      ,CA,94612-2801,Private      ,1,4,5,62,223,285
00701200,SAMUEL MERRITT COLLEGE                  ,CA,94609-3108,Private      ,8,69,77,460,2990,3450
00704700,LOS ANGELES SOUTHWEST COLLEGE           ,CA,90047-4810,Public       ,72,272,344,3863,9053,12916
00705000,BAY VISTA COLLEGE OF BEAUTY             ,CA,91950-3616,Proprietary  ,5,15,20,113,262,375
00711500,MOORPARK COLLEGE                        ,CA,93021-1695,Public       ,82,107,189,6597,5195,11792
00713000,NEWBERRY SCHOOLS OF BEAUTY              ,CA,91344-7404,Proprietary  ,10,14,24,106,167,273
00714200,LYLE'S COLLEGE OF BEAUTY                ,CA,93710-3948,Proprietary  ,2,8,10,178,271,449
00716400,BRYAN COLLEGE                           ,CA,90057-0000,Proprietary  ,11,111,122,322,2208,2530
00718700,NORTH ADRIAN'S COLLEGE OF BEAUTY        ,CA,95350-2381,Proprietary  ,11,43,54,187,406,593
00719000,WYOTECH                                 ,CA,94539-7663,Proprietary  ,52,109,161,924,1931,2855
00720300,SALON SUCCESS ACADEMY                   ,CA,91786-4060,Proprietary  ,14,12,26,173,222,395
00720400,MODERN BEAUTY ACADEMY                   ,CA,93030-7016,Proprietary  ,3,4,7,65,95,160
00722900,WESTERN BEAUTY INSTITUTE                ,CA,91402-3104,Proprietary  ,22,42,64,299,540,839
00723400,HEALD COLLEGE                           ,CA,94105-2206,Proprietary  ,39,121,160,753,2268,3021
00723404,HEALD COLLEGE - CONCORD                 ,CA,94520-0000,Proprietary  ,26,145,171,1136,2630,3766
00723405,HEALD COLLEGE - MILPITAS                ,CA,95035-8008,Proprietary  ,42,159,201,1021,2761,3782
00723406,HEALD COLLEGE - HAYWARD                 ,CA,94545-2352,Proprietary  ,24,134,158,939,2407,3346
00723407,HEALD COLLEGE - MODESTO                 ,CA,95368-9095,Proprietary  ,32,72,104,758,1521,2279
00723408,HEALD COLLEGE - ROSEVILLE               ,CA,95678-5303,Proprietary  ,26,113,139,829,2479,3308
00723409,HEALD COLLEGE - SALINAS                 ,CA,93906-5100,Proprietary  ,27,95,122,1041,2037,3078
00723410,HEALD COLLEGE - STOCKTON                ,CA,95210-5667,Proprietary  ,39,143,182,1190,3017,4207
00723411,HEALD COLLEGE - RANCHO CORDOVA          ,CA,95670-6005,Proprietary  ,26,116,142,629,2196,2825
00723412,HEALD COLLEGE - FRESNO                  ,CA,93704-1706,Proprietary  ,44,178,222,1601,3505,5106
00725300,FEDERICO BEAUTY INSTITUTE               ,CA,95834-1905,Proprietary  ,8,29,37,361,550,911
00729600,COLEMAN COLLEGE                         ,CA,92123-0000,Private      ,13,59,72,347,1248,1595
00732909,ITT TECHNICAL INSTITUTE                 ,CA,92868-3506,Proprietary  ,75,295,370,901,2822,3723
00732971,ITT TECHNICAL INSTITUTE                 ,CA,95670-6047,Proprietary  ,57,196,253,706,2350,3056
00732976,ITT TECHNICAL INSTITUTE                 ,CA,92408-3519,Proprietary  ,94,350,444,1346,3077,4423
00732981,ITT TECHNICAL INSTITUTE                 ,CA,92123-2662,Proprietary  ,46,273,319,1071,3575,4646
00732985,ITT TECHNICAL INSTITUTE                 ,CA,91773-2933,Proprietary  ,51,187,238,711,1965,2676
00732989,ITT TECHNICAL INSTITUTE                 ,CA,90502-1356,Proprietary  ,40,234,274,737,2438,3175
00732994,ITT TECHNICAL INSTITUTE                 ,CA,91342-3664,Proprietary  ,46,195,241,656,2003,2659
00746501,AMERICAN ACADEMY OF DRAMATIC ARTS - LOS ,CA,90028-7504,Private      ,0,0,0,571,183,754
00747600,MARINELLO SCHOOLS OF BEAUTY             ,CA,90023-2666,Proprietary  ,34,59,93,705,1278,1983
00747602,MARINELLO SCHOOLS OF BEAUTY - SPA ACADEM,CA,90048-5101,Proprietary  ,8,15,23,123,218,341
00747603,MARINELLO SCHOOLS OF BEAUTY - INGLEWOOD ,CA,90301-2306,Proprietary  ,4,19,23,62,107,169
00747604,MARINELLO SCHOOLS OF BEAUTY - RESEDA    ,CA,91335-4218,Proprietary  ,1,0,1,41,57,98
00747606,MARINELLO SCHOOLS OF BEAUTY - WEST COVIN,CA,91790-2805,Proprietary  ,0,3,3,61,84,145
00747607,MARINELLO SCHOOLS OF BEAUTY - SAN BERNAR,CA,92410-3261,Proprietary  ,8,15,23,266,417,683
00747608,MARINELLO SCHOOLS OF BEAUTY - ONTARIO   ,CA,91762-2113,Proprietary  ,22,37,59,226,316,542
00747609,MARINELLO SCHOOLS OF BEAUTY - WHITTIER  ,CA,90601-4107,Proprietary  ,12,13,25,156,221,377
00747610,MARINELLO SCHOOLS OF BEAUTY - LOMITA    ,CA,90717-1460,Proprietary  ,2,8,10,76,133,209
00747611,MARINELLO SCHOOLS OF BEAUTY - SAN DIEGO ,CA,92126-4217,Proprietary  ,5,26,31,286,427,713
00747612,MARINELLO SCHOOLS OF BEAUTY - EL CAJON  ,CA,92020-2503,Proprietary  ,9,13,22,93,179,272
00747613,MARINELLO SCHOOLS OF BEAUTY - VICTORVILL,CA,92392-5496,Proprietary  ,12,30,42,195,436,631
00747614,MARINELLO SCHOOLS OF BEAUTY - ANAHEIM   ,CA,92801-4622,Proprietary  ,14,15,29,178,266,444
00747615,MARINELLO SCHOOLS OF BEAUTY - SIMI VALLE,CA,93065-2801,Proprietary  ,12,12,24,101,202,303
00753100,ACADEMY OF ART UNIVERSITY               ,CA,94105-3410,Proprietary  ,150,340,490,9361,15399,24760
00753600,COSUMNES RIVER COLLEGE                  ,CA,95823-5799,Public       ,89,242,331,10257,12974,23231
00754802,WESTWOOD COLLEGE OF TECHNOLOGY          ,CA,92801-0000,Proprietary  ,13,27,40,1003,912,1915
00754803,WESTWOOD COLLEGE OF TECHNOLOGY          ,CA,91786-0000,Proprietary  ,37,42,79,1032,1111,2143
00760600,EVEREST COLLEGE                         ,CA,90010-2221,Proprietary  ,9,58,67,469,989,1458
00760700,CONCORDE CAREER INSTITUTE               ,CA,91606-3134,Proprietary  ,16,36,52,416,889,1305
00770700,COLUMBIA COLLEGE                        ,CA,95370-8580,Public       ,19,55,74,1379,1868,3247
00771300,SKYLINE COLLEGE                         ,CA,94066-1698,Public       ,72,170,242,3892,4666,8558
00793000,CONCORDE CAREER INSTITUTE               ,CA,92108-0000,Proprietary  ,26,88,114,441,1759,2200
00799300,CALIF STATE UNIV BAKERSFIELD            ,CA,93311-1022,Public       ,41,66,107,10539,8002,18541
00807100,CONCORDE CAREER INSTITUTE               ,CA,92840-9201,Proprietary  ,21,53,74,530,1110,1640
00807300,BUTTE COMMUNITY COLLEGE                 ,CA,95965-0000,Public       ,56,106,162,8340,10286,18626
00809000,EVEREST COLLEGE                         ,CA,91803-1310,Proprietary  ,27,87,114,558,1611,2169
00853700,CONCORDE CAREER INSTITUTE               ,CA,92401-0000,Proprietary  ,27,75,102,561,1502,2063
00859600,WEST LOS ANGELES COLLEGE                ,CA,90230-3500,Public       ,64,209,273,4801,8573,13374
00859700,FEATHER RIVER COLLEGE                   ,CA,95971-9124,Public       ,6,10,16,878,654,1532
00884400,CALIFORNIA CHRISTIAN COLLEGE            ,CA,93703-3599,Private      ,1,0,1,119,205,324
00884600,WRIGHT INSTITUTE                        ,CA,94704-0000,Private      ,0,7,7,3,542,545
00890300,COLLEGE OF THE CANYONS                  ,CA,91355-1899,Public       ,186,216,402,8396,7137,15533
00891800,SADDLEBACK COLLEGE                      ,CA,92692-3699,Public       ,96,207,303,6833,8125,14958
00902200,ASSOCIATED TECHNICAL COLLEGE            ,CA,90017-0000,Proprietary  ,12,57,69,248,785,1033
00903200,EMPIRE COLLEGE                          ,CA,95403-2122,Proprietary  ,7,32,39,220,796,1016
00915706,WYOMING TECHNICAL INSTITUTE - WEST SACRA,CA,95605-1507,Proprietary  ,2,14,16,977,1670,2647
00927200,CRAFTON HILLS COLLEGE                   ,CA,92399-1799,Public       ,40,101,141,4410,4489,8899
00932500,ABRAM FRIEDMAN OCCUP CTR                ,CA,90015-3507,Public       ,0,0,0,87,186,273
00950900,SKILLS & BUSINESS EDUCATION CENTER      ,CA,95824-1529,Public       ,13,36,49,358,1406,1764
00974800,CARRINGTON COLLEGE CALIFORNIA           ,CA,95826-3203,Proprietary  ,46,105,151,1203,3302,4505
00974801,CARRINGTON COLLEGE CALIFORNIA - SAN LEAN,CA,94578-3711,Proprietary  ,13,48,61,358,765,1123
00974802,CARRINGTON COLLEGE CALIFORNIA - PLEASANT,CA,94523-1984,Proprietary  ,11,24,35,244,617,861
00974803,CARRINGTON COLLEGE CALIFORNIA - STOCKTON,CA,95207-5509,Proprietary  ,9,36,45,483,853,1336
00974804,CARRINGTON COLLEGE CALIFORNIA - CITRUS H,CA,95621-5577,Proprietary  ,4,46,50,309,792,1101
00974806,CARRINGTON COLLEGE CALIFORNIA -  ANTIOCH,CA,94531-1604,Proprietary  ,11,42,53,300,657,957
00974807,CARRINGTON COLLEGE CALIFORNIA - SAN JOSE,CA,95119-1325,Proprietary  ,22,46,68,565,1322,1887
00974808,CARRINGTON COLLEGE CALIFORNIA - EMERYVIL,CA,94608-3006,Proprietary  ,1,3,4,124,277,401
00974809,WESTERN CAREER COLLEGE -  EMERYVILLE SHE,CA,94608-3006,Proprietary  ,0,2,2,18,67,85
00998900,SANTA BARBARA BUSINESS COLLEGE          ,CA,93111-0000,Proprietary  ,9,47,56,372,735,1107
01011100,CERRO-COSO COMMUNITY COLLEGE            ,CA,93555-9571,Public       ,23,139,162,1176,3044,4220
01014900,PEPPERDINE UNIVERSITY                   ,CA,90263-0000,Private      ,6,84,90,8981,7218,16199
01034000,LOS MEDANOS COLLEGE                     ,CA,94565-5197,Public       ,59,161,220,4063,5851,9914
01036500,CHARLES R DREW UNIV OF MED & SCI        ,CA,90059-0000,Private      ,1,34,35,175,1148,1323
01039500,UNIVERSITY OF SAN DIEGO                 ,CA,92110-2492,Private      ,32,89,121,20700,7288,27988
01039501,UNIVERSITY OF SAN DIEGO - SCHOOL OF LAW ,CA,92110-2492,Private      ,2,12,14,270,3071,3341
01044100,PARDEE RAND GRADUATE SCHOOL             ,CA,90407-2138,Private      ,0,0,0,6,42,48
01047400,MARYMOUNT COLLEGE OF PALOS VERDES       ,CA,90275-0000,Private      ,0,5,5,1649,218,1867
01085400,THOMAS JEFFERSON SCHOOL OF LAW          ,CA,92110-0000,Private      ,0,16,16,51,2432,2483
01102400,EVEREST COLLEGE                         ,CA,94103-2091,Proprietary  ,14,37,51,228,725,953
01110700,EVEREST  COLLEGE                        ,CA,92801-5231,Proprietary  ,25,67,92,643,1090,1733
01110900,EVEREST COLLEGE                         ,CA,91335-4631,Proprietary  ,31,68,99,517,1388,1905
01111200,FIDM-FASHION INSTITUTE OF DESIGN        ,CA,90015-1421,Proprietary  ,28,24,52,7255,2942,10197
01111700,ALLIANT INTERNATIONAL UNIVERSITY        ,CA,92131-1799,Private      ,4,28,32,175,2558,2733
01111705,ALLIANT INTERNATIONAL UNIVERSITY - LOS A,CA,91803-1360,Private      ,0,4,4,14,793,807
01111706,ALLIANT INTERNATIONAL UNIVERSITY - SAN F,CA,94133-1221,Private      ,1,11,12,55,950,1005
01111707,ALLIANT INTERNATIONAL UNIVERSITY - FRESN,CA,93727-2014,Private      ,0,5,5,86,673,759
01112100,EVEREST COLLEGE                         ,CA,94541-4007,Proprietary  ,6,33,39,187,649,836
01112300,EVEREST COLLEGE                         ,CA,90247-4163,Proprietary  ,21,85,106,294,931,1225
01146000,NATIONAL UNIVERSITY                     ,CA,92037-1011,Private      ,49,1188,1237,1149,23101,24250
01162600,PRACTICAL SCHOOLS                       ,CA,92805-0000,Proprietary  ,15,40,55,411,835,1246
01164900,LOYOLA MARYMOUNT UNIVERSITY             ,CA,90045-0000,Private      ,24,76,100,13910,4418,18328
01164901,LMU  - LOYOLA LAW SCHOOL                ,CA,90015-0019,Private      ,1,12,13,247,3547,3794
01167200,MENDOCINO COLLEGE                       ,CA,95482-3000,Public       ,41,59,100,1562,2440,4002
01170700,NORTH-WEST COLLEGE                      ,CA,91790-2097,Proprietary  ,14,48,62,318,679,997
01179200,FRANCISCAN SCHOOL OF THEOLOGY           ,CA,94709-0000,Private      ,0,0,0,3,44,47
01182000,SAN DIEGO MIRAMAR COLLEGE               ,CA,92126-0000,Public       ,41,117,158,5959,9141,15100
01186500,CALIFORNIA HAIR DESIGN ACADEMY          ,CA,92115-0000,Proprietary  ,9,19,28,232,412,644
01186600,LU ROSS ACADEMY                         ,CA,93001-2927,Proprietary  ,12,23,35,204,364,568
01202600,JE BOUTIQUE COLLEGE OF BEAUTY           ,CA,92021-6247,Proprietary  ,4,16,20,138,277,415
01202700,GALEN COLLEGE OF CALIFORNIA             ,CA,93728-2381,Proprietary  ,0,5,5,73,219,292
01203100,SAN DIEGO CHRISTIAN COLLEGE             ,CA,92019-1157,Private      ,1,15,16,1023,1425,2448
01206100,EVEREST COLLEGE                         ,CA,95128-3908,Proprietary  ,9,27,36,357,821,1178
01215400,CALIFORNIA INSTITUTE OF INTEGRAL STUDIES,CA,94103-2557,Private      ,0,7,7,68,1769,1837
01230002,PALMER COLLEGE OF CHIROPRACTIC - WEST CA,CA,95134-1617,Private      ,2,0,2,33,434,467
01231600,MANCHESTER BEAUTY COLLEGE               ,CA,93726-5306,Proprietary  ,1,6,7,200,321,521
01231700,TULARE BEAUTY COLLEGE                   ,CA,93274-3432,Proprietary  ,1,1,2,48,77,125
01244600,UNIVERSAL COLLEGE OF BEAUTY             ,CA,90044-0044,Proprietary  ,4,9,13,113,175,288
01245200,EVERGREEN VALLEY COLLEGE                ,CA,95135-1598,Public       ,64,120,184,5764,6691,12455
01255000,LOS ANGELES MISSION COLLEGE             ,CA,91342-3200,Public       ,91,120,211,6682,6468,13150
01265000,MARINELLO SCHOOL OF BEAUTY              ,CA,91502-2828,Proprietary  ,10,32,42,203,412,615
01265001,MARINELLO SCHOOL OF BEAUTY - PALMDALE   ,CA,93550-4686,Proprietary  ,10,19,29,99,158,257
01284200,OXNARD COLLEGE                          ,CA,93030-0000,Public       ,66,145,211,3867,4931,8798
01287200,NORTH-WEST COLLEGE                      ,CA,91768-3199,Proprietary  ,9,26,35,348,723,1071
01287300,WYOTECH                                 ,CA,90810-3800,Proprietary  ,60,256,316,1367,2576,3943
01287301,WYOTECH - EVEREST  COLLEGE              ,CA,90034-3158,Proprietary  ,21,75,96,349,862,1211
01287302,WYOTECH - EVEREST  COLLEGE              ,CA,91746-3412,Proprietary  ,58,115,173,581,1236,1817
01290700,LAKE TAHOE COMMUNITY COLLEGE            ,CA,96150-4524,Public       ,19,51,70,890,1428,2318
01291200,MTI COLLEGE                             ,CA,95841-0000,Proprietary  ,22,74,96,696,2167,2863
01294200,ROSEMEAD BEAUTY SCHOOL                  ,CA,91770-1639,Proprietary  ,8,54,62,51,382,433
01298400,PROFESSIONAL INSTITUTE OF BEAUTY        ,CA,91731-2613,Proprietary  ,3,7,10,50,151,201
01298500,HAIR CALIFORNIA BEAUTY ACADEMY          ,CA,92867-7127,Proprietary  ,2,2,4,37,83,120
01298900,OCEANSIDE COLLEGE OF BEAUTY             ,CA,92054-5393,Proprietary  ,8,8,16,138,273,411
01301000,LANCASTER BEAUTY SCHOOL                 ,CA,93534-3098,Proprietary  ,8,22,30,121,308,429
01307400,AMERICAN BEAUTY COLLEGE                 ,CA,91790-2906,Proprietary  ,8,17,25,82,164,246
01309500,SALON SUCCESS ACADEMY                   ,CA,92879-6561,Proprietary  ,15,19,34,224,325,549
01310300,CALIFORNIA WESTERN SCHOOL OF LAW        ,CA,92101-0000,Private      ,3,9,12,145,2210,2355
01324000,LYTLE'S REDWOOD EMPIRE BEAUTY CLG       ,CA,95403-0000,Proprietary  ,6,20,26,181,298,479
02054900,MARINELLO SCHOOL OF BEAUTY              ,CA,92630-0000,Proprietary  ,23,46,69,185,381,566
02054902,MARINELLO SCHOOL OF BEAUTY - BAKERSFIELD,CA,93309-5001,Proprietary  ,14,34,48,351,514,865
02054903,MARINELLO SCHOOL OF BEAUTY - VISALIA    ,CA,93277-6228,Proprietary  ,5,5,10,22,51,73
02059800,PARIS BEAUTY COLLEGE                    ,CA,94520-2611,Proprietary  ,3,10,13,87,231,318
02061600,WAYNES COLLEGE OF BEAUTY                ,CA,93906-2830,Proprietary  ,4,9,13,26,58,84
02063500,COASTLINE COMMUNITY COLLEGE             ,CA,92708-0000,Public       ,24,279,303,2238,8282,10520
02064300,SIERRA COLLEGE OF BEAUTY                ,CA,95340-0000,Proprietary  ,7,16,23,140,248,388
02065700,CALIFORNIA BEAUTY COLLEGE               ,CA,95354-0000,Proprietary  ,4,13,17,214,306,520
02070500,CONCORDIA UNIVERSITY                    ,CA,92612-0000,Private      ,9,78,87,2974,3138,6112
02075800,SOUTHERN CA INST OF ARCHITECTURE        ,CA,90013-0000,Private      ,1,4,5,284,636,920
02086400,MARINELLO SCHOOL OF BEAUTY              ,CA,95050-0000,Proprietary  ,11,26,37,171,372,543
02086401,MARINELLO SCHOOL OF BEAUTY - SEASIDE    ,CA,93955-3615,Proprietary  ,14,29,43,162,246,408
02086402,MARINELLO SCHOOL OF BEAUTY - SAN MATEO  ,CA,94401-3801,Proprietary  ,6,13,19,54,100,154
02086403,MARINELLO SCHOOL OF BEAUTY - HAYWARD    ,CA,94541-5111,Proprietary  ,11,20,31,129,283,412
02086404,MARINELLO SCHOOL OF BEAUTY - CASTRO VALL,CA,94546-5506,Proprietary  ,0,2,2,30,38,68
02091200,ELEGANCE INTERNATIONAL                  ,CA,90028-0000,Proprietary  ,6,10,16,122,174,296
02091700,KAPLAN COLLEGE                          ,CA,92123-1509,Proprietary  ,31,139,170,888,3158,4046
02091702,KAPLAN COLLEGE - CHULA VISTA            ,CA,91910-5342,Proprietary  ,14,38,52,320,670,990
02096100,FIELDING GRADUATE UNIVERSITY            ,CA,93105-0000,Private      ,0,24,24,8,1220,1228
02099200,AMERICAN CONSERVATORY THEATER           ,CA,94108-0000,Private      ,1,5,6,80,266,346
02110200,COLUMBIA COLLEGE                        ,CA,91356-0000,Private      ,6,2,8,403,224,627
02110800,CALIFORNIA COLLEGE SAN DIEGO            ,CA,92108-3821,Proprietary  ,55,188,243,2467,3892,6359
02111300,CUYAMACA COLLEGE                        ,CA,92019-0000,Public       ,58,143,201,5258,7614,12872
02119100,MISSION COLLEGE                         ,CA,95054-1897,Public       ,37,115,152,3803,6036,9839
02120600,SAYBROOK GRADUATE SCHOOL                ,CA,94111-1920,Private      ,0,5,5,1,727,728
02120700,SAN JOAQUIN VALLEY COLLEGE              ,CA,93291-0000,Proprietary  ,211,421,632,3600,7292,10892
02125000,CAREER ACADEMY OF BEAUTY                ,CA,92845-0000,Proprietary  ,5,23,28,115,252,367
02128200,"VICTOR VALLEY BEAUTY COLLEGE, INC       ",CA,92392-0000,Proprietary  ,7,12,19,177,325,502
02128300,INSTITUTE FOR BUSINESS & TECHNOLOGY     ,CA,95050-0000,Proprietary  ,5,39,44,149,649,798
02128301,INSTITUTE FOR BUSINESS & TECHNOLOGY - NA,CA,95670-6351,Proprietary  ,0,6,6,44,246,290
02138300,PALO ALTO UNIVERSITY                    ,CA,94304-1337,Private      ,0,6,6,83,1026,1109
02147400,CLEVELAND CHIROPRACTIC COLLEGE          ,CA,90004-0000,Private      ,0,0,0,4,18,22
02161800,MUSICIANS INSTITUTE                     ,CA,90028-6157,Proprietary  ,10,13,23,1803,1325,3128
02167800,ESTES INSTITUTE OF COSMETOLOGY          ,CA,93291-0000,Proprietary  ,0,4,4,178,229,407
02178700,CITRUS HEIGHTS BEAUTY COLLEGE           ,CA,95610-1410,Proprietary  ,4,6,10,46,79,125
02179937,WESTERN STATE COLLEGE OF LAW            ,CA,92831-3014,Proprietary  ,0,3,3,36,1257,1293
02179938,"ART INSTITUTE OF CALIFORNIA, HOLLYWOOD  ",CA,91601-3112,Proprietary  ,16,23,39,3673,2829,6502
02179941,"ART INSTITUTE OF CALIFORNIA, LOS ANGELES",CA,90405-3035,Proprietary  ,25,37,62,7960,6068,14028
02179947,"ART INSTITUTE OF CALIFORNIA, SAN DIEGO  ",CA,92108-4423,Proprietary  ,28,64,92,4794,4355,9149
02180600,BRIDGES  ACADEMY OF BEAUTY              ,CA,92311-2327,Proprietary  ,0,0,0,5,40,45
02185800,MOLER BARBER COLLEGE                    ,CA,94611-0000,Proprietary  ,3,10,13,88,247,335
02188400,SIERRA VALLEY COLLEGE OF COURT REPORTING,CA,93726-0000,Proprietary  ,2,4,6,90,246,336
02208600,MADERA BEAUTY COLLEGE                   ,CA,93637-3519,Proprietary  ,1,1,2,80,93,173
02211000,SALON SUCCESS ACADEMY                   ,CA,92405-0000,Proprietary  ,5,4,9,125,172,297
02220000,COLLEEN O'HARA BEAUTY ACADEMY           ,CA,92701-0000,Proprietary  ,9,23,32,108,179,287
02220200,CALIFORNIA CULINARY ACADEMY             ,CA,94102-3336,Proprietary  ,10,27,37,698,1082,1780
02221300,MARINELLO SCHOOL OF BEAUTY              ,CA,92553-0000,Proprietary  ,14,17,31,221,373,594
02221303,MARINELLO SCHOOL OF BEAUTY - SAN RAFAEL ,CA,94901-3224,Proprietary  ,1,7,8,42,92,134
02222000,AMERICAN FILM INSTITUTE                 ,CA,90027-0000,Private      ,7,12,19,527,1197,1724
02226000,EAST LOS ANGELES COLLEGE                ,CA,91754-0000,Public       ,199,302,501,18361,16233,34594
02228500,LIFE CHIROPRACTIC COLLEGE WEST          ,CA,94545-0000,Private      ,0,1,1,24,491,515
02230900,FREDRICK & CHARLES BEAUTY COLLEGE       ,CA,95501-0000,Proprietary  ,1,4,5,78,162,240
02231900,GEMOLOGICAL INSTITUTE OF AMERICA        ,CA,92008-4698,Private      ,0,10,10,71,311,382
02234300,FASHION CAREERS OF CALIFORNIA           ,CA,92110-0000,Proprietary  ,0,0,0,208,213,421
02236400,"THANH LE COLG, SCH OF COSMETOLOGY       ",CA,92840-0000,Proprietary  ,1,12,13,14,79,93
02237200,PHILLIPS GRADUATE INSTITUTE             ,CA,91316-0000,Private      ,0,0,0,6,266,272
02241600,SAN DIEGO CONTINUING EDUCATION          ,CA,92113-0000,Public       ,0,0,0,203,834,1037
02241800,AMERICAN CAREER COLLEGE                 ,CA,90004-0000,Proprietary  ,125,280,405,2049,4123,6172
02242700,BERKELEY CITY COLLEGE                   ,CA,94704-0000,Public       ,63,161,224,4120,5831,9951
02250602,EVEREST COLLEGE                         ,CA,91761-8525,Proprietary  ,20,45,65,610,1502,2112
02255400,INTERNATIONAL SCHOOL OF COSMETOLOGY     ,CA,90250-0000,Proprietary  ,11,19,30,245,322,567
02258600,ALAMEDA BEAUTY COLLEGE                  ,CA,94501-0000,Proprietary  ,11,23,34,208,374,582
02262400,YESHIVA OHR ELCHONON CHABAD             ,CA,90046-0000,Private      ,24,3,27,109,13,122
02263101,ANTHEM COLLEGE - SACRAMENTO             ,CA,95827-3378,Proprietary  ,16,44,60,123,304,427
02267600,INSTITUTE OF TRANSPERSONAL PSYCHLGY     ,CA,94303-4624,Private      ,0,5,5,11,672,683
02270600,LIFE PACIFIC COLLEGE                    ,CA,91773-0000,Private      ,0,2,2,444,322,766
02276800,WESTMINSTER SEMINARY CALIFORNIA         ,CA,92027-0000,Private      ,0,0,0,12,186,198
02277400,SOUTH COAST COLLEGE                     ,CA,92868-2616,Proprietary  ,5,14,19,302,670,972
02282300,ALHAMBRA BEAUTY COLLEGE                 ,CA,91802-0000,Proprietary  ,4,23,27,60,171,231
02285100,HILLTOP BEAUTY SCHOOL                   ,CA,94014-0000,Proprietary  ,1,12,13,33,151,184
02298000,DESIGN INSTITUTE OF SAN DIEGO           ,CA,92121-0000,Proprietary  ,3,7,10,271,400,671
02304300,"PLATT COLLEGE, SAN DIEGO                ",CA,92115-0000,Proprietary  ,5,28,33,318,572,890
02306300,KAPLAN COLLEGE                          ,CA,95368-0000,Proprietary  ,16,34,50,466,998,1464
02306302,KAPLAN COLLEGE - FRESNO                 ,CA,93612-3802,Proprietary  ,5,19,24,385,614,999
02309500,CLOVIS ADULT EDUC                       ,CA,93611-0000,Public       ,0,10,10,115,477,592
02312400,LA COLLEGE INTERNATIONAL                ,CA,90010-0000,Proprietary  ,0,0,0,62,294,356
02321801,ITT TECHNICAL INSTITUTE                 ,CA,93030-2649,Proprietary  ,0,0,0,0,1,1
02330500,LAGUNA COLLEGE OF ART AND DESIGN        ,CA,92651-0000,Private      ,0,3,3,729,303,1032
02332800,CENTER FOR EMPLOYMENT TRAINING          ,CA,95110-0000,Private      ,93,376,469,778,3346,4124
02338500,GLENDALE CAREER COLLEGE                 ,CA,91203-1207,Proprietary  ,5,39,44,321,744,1065
02338700,MARINELLO SCHOOL OF BEAUTY              ,CA,94103-0000,Proprietary  ,10,13,23,219,371,590
02338701,MARINELLO SCHOOL OF BEAUTY - CHICO      ,CA,95928-7184,Proprietary  ,3,17,20,138,259,397
02338702,MARINELLO SCHOOL OF BEAUTY - REDDING    ,CA,96001-1023,Proprietary  ,5,18,23,117,275,392
02338703,MARINELLO SCHOOL OF BEAUTY - FRESNO     ,CA,93711-3246,Proprietary  ,10,23,33,250,368,618
02342400,ACADEMY OF RADIO BROADCASTING           ,CA,92647-3809,Proprietary  ,1,17,18,110,340,450
02343400,"BELLUS ACADEMY, THE ACADEMY OF BEAUTY AN",CA,92064-4633,Proprietary  ,10,39,49,351,687,1038
02345800,MONTEBELLO BEAUTY COLLEGE               ,CA,90640-0000,Proprietary  ,0,0,0,69,76,145
02351900,KAPLAN COLLEGE                          ,CA,95660-5512,Proprietary  ,13,62,75,654,2092,2746
02351901,KAPLAN COLLEGE - BAKERSFIELD            ,CA,93304-0000,Proprietary  ,21,58,79,664,1241,1905
02358000,THOMAS AQUINAS COLLEGE                  ,CA,93060-9622,Private      ,0,1,1,423,39,462
02359300,SHASTA BIBLE COLLEGE                    ,CA,96002-0000,Private      ,0,0,0,75,120,195
02482700,WESTERN UNIVERSITY OF HEALTH S          ,CA,91766-1854,Private      ,2,12,14,221,5867,6088
02494800,LOLA BEAUTY COLLEGE                     ,CA,92641-0000,Proprietary  ,1,3,4,52,125,177
02497300,TRINITY COLLEGE                         ,CA,93277-8109,Proprietary  ,12,54,66,294,909,1203
02500000,SAN JOAQUIN COLLEGE OF LAW              ,CA,93612-0000,Private      ,0,4,4,31,359,390
02518400,THE NATIONAL HISPANIC UNIVERSITY        ,CA,95127-0000,Proprietary  ,10,53,63,517,1077,1594
02519800,AVANCE BEAUTY COLLEGE                   ,CA,92154-0000,Proprietary  ,6,14,20,176,294,470
02520200,CALIFORNIA CAREER SCHOOLS               ,CA,92805-0000,Proprietary  ,4,15,19,119,343,462
02520300,INTERIOR DESIGNERS INSTITUTE            ,CA,92660-0000,Proprietary  ,1,1,2,63,220,283
02520400,ADRIAN'S BEAUTY COLLEGE OF TURLOCK      ,CA,95382-0000,Proprietary  ,6,13,19,175,210,385
02531801,PAUL MITCHELL THE SCHOOL-COSTA MESA     ,CA,92626-3804,Proprietary  ,6,9,15,7,10,17
02531804,PAUL MITCHELL THE SCHOOL - SAN DIEGO    ,CA,92101-0000,Proprietary  ,2,11,13,3,12,15
02537200,PALOMAR INSTITUTE OF COSMETOLOGY        ,CA,92069-0000,Proprietary  ,13,13,26,254,425,679
02539100,KAPLAN COLLEGE                          ,CA,91606-3231,Proprietary  ,23,56,79,554,1263,1817
02539102,KAPLAN COLLEGE -  RIVERSIDE             ,CA,92507-4223,Proprietary  ,15,49,64,603,1429,2032
02539500,IRVINE VALLEY COLLEGE                   ,CA,92620-0000,Public       ,57,121,178,6679,5702,12381
02542300,NATIONAL HOLISTIC INSTITUTE             ,CA,94608-0000,Proprietary  ,11,59,70,275,1146,1421
02543400,BROWNSON TECHNICAL SCHOOL               ,CA,92805-0000,Proprietary  ,4,17,21,64,246,310
02545900,HYPNOSIS MOTIVATION INSTITUTE           ,CA,91356-0000,Private      ,1,21,22,9,167,176
02546400,MTI BUSINESS COLLEGE INC                ,CA,95207-0000,Proprietary  ,4,26,30,100,357,457
02549000,KAPLAN COLLEGE                          ,CA,92083-7736,Proprietary  ,25,73,98,445,1491,1936
02549005,KAPLAN COLLEGE -  PALM SPRINGS          ,CA,92262-7011,Proprietary  ,16,27,43,404,705,1109
02553500,ASSOCIATED TECHNICAL COLLEGE            ,CA,92101-0000,Proprietary  ,10,36,46,190,545,735
02553600,DIVERSIFIED LANGUAGE INSTITUTE          ,CA,90017-0000,Proprietary  ,7,120,127,104,1321,1425
02559300,UNITED EDUCATION INSTITUTE              ,CA,90020-0000,Proprietary  ,102,288,390,966,1965,2931
02559400,INTERCOAST COLLEGES                     ,CA,92868-1656,Proprietary  ,61,326,387,442,3167,3609
02565400,KAPLAN COLLEGE                          ,CA,95207-6216,Proprietary  ,2,11,13,375,851,1226
02570300,LOS ANGELES ORT COLLEGE                 ,CA,90048-0000,Private      ,25,140,165,207,961,1168
02577900,SANTA BARBARA BUSINESS COLLEGE          ,CA,93309-1664,Proprietary  ,31,72,103,639,1220,1859
02578000,SANTA BARBARA BUSINESS COLLEGE          ,CA,93454-6943,Proprietary  ,4,32,36,312,508,820
02584200,NEWBRIDGE COLLEGE                       ,CA,92701-0000,Proprietary  ,10,40,50,264,787,1051
02591600,NORTH-WEST COLLEGE                      ,CA,91101-1744,Proprietary  ,7,20,27,126,340,466
02595600,ASIAN AMERICAN INTERNATIONAL BTY CG     ,CA,92683-4043,Proprietary  ,1,5,6,23,81,104
02597300,SOUTH BAYLO UNIVERSITY                  ,CA,92801-1701,Private      ,0,6,6,9,345,354
02602300,CENTRAL COAST COLLEGE                   ,CA,93901-3301,Proprietary  ,11,23,34,326,448,774
02608900,PINNACLE COLLEGE                        ,CA,91803-8842,Proprietary  ,2,14,16,95,135,230
02608901,PINNACLE COLLEGE - SACRAMENTO           ,CA,95670-6386,Proprietary  ,6,21,27,104,189,293
02609000,EMPERORS COLG OF TRAD ORIENTAL MED      ,CA,90403-5609,Proprietary  ,0,3,3,15,270,285
02612800,LOS ANGELES RECORDING SCHOOL            ,CA,90028-3112,Proprietary  ,0,0,0,428,461,889
03010611,VIRGINIA COLLEGE - GOLF ACADEMY OF AMERI,CA,92008-6512,Proprietary  ,1,5,6,94,226,320
03011300,"CALIF STATE UNIV, SAN MARCOS            ",CA,92096-0001,Public       ,105,90,195,14169,8339,22508
03019900,CAPSTONE COLLEGE                        ,CA,91402-4924,Proprietary  ,1,4,5,31,99,130
03025600,DELL'ARTE SCH OF PHYSICAL THEATRE       ,CA,95525-0816,Private      ,0,1,1,7,45,52
03027700,PACIFIC COLLEGE OF ORIENTAL MED         ,CA,92108-4408,Proprietary  ,4,28,32,90,809,899
03029600,POMONA ADULT SCHOOL                     ,CA,91766-0000,Public       ,1,9,10,153,429,582
03031409,INTERNATIONAL ACADEMY OF DESIGN AND TECH,CA,95834-9664,Proprietary  ,6,21,27,377,774,1151
03035700,LAS POSITAS COLLEGE                     ,CA,94551-6750,Public       ,41,84,125,3429,3422,6851
03039900,FREMONT COLLEGE                         ,CA,90703-5342,Proprietary  ,17,25,42,454,616,1070
03043900,NEWSCHOOL OF ARCHITECTURE & DESIGN      ,CA,92101-6634,Proprietary  ,0,5,5,451,754,1205
03044500,KAPLAN COLLEGE                          ,CA,91402-4222,Proprietary  ,0,0,0,32,63,95
03054100,ROYALE COLLEGE OF BEAUTY                ,CA,92590-2525,Proprietary  ,3,2,5,97,126,223
03062300,WESTECH COLLEGE                         ,CA,91764-4988,Proprietary  ,21,87,108,289,894,1183
03062400,MT DIABLO ADULT EDUC LOMA VISTA CTR     ,CA,94518-1122,Public       ,0,4,4,138,387,525
03062700,PLATT COLLEGE                           ,CA,90041-0000,Proprietary  ,37,59,96,409,602,1011
03062701,PLATT COLLEGE                           ,CA,91764-0000,Proprietary  ,24,39,63,649,907,1556
03062702,PLATT COLLEGE - RIVERSIDE               ,CA,92507-0730,Proprietary  ,20,36,56,120,235,355
03063400,MODERN TECHNOLOGY SCHOOL                ,CA,92708-9821,Proprietary  ,2,8,10,100,240,340
03067400,BALDWIN PARK ADULT SCHOOL               ,CA,91706-4897,Public       ,6,20,26,206,489,695
03067500,INSTITUTE OF TECHNOLOGY                 ,CA,93612-3217,Proprietary  ,55,200,255,1110,3183,4293
03069500,SAGE COLLEGE                            ,CA,92557-6720,Proprietary  ,6,20,26,199,873,1072
03072300,EVEREST COLLEGE                         ,CA,91761-3222,Proprietary  ,53,120,173,626,1280,1906
03072700,WESTWOOD COLLEGE - LOS ANGELES          ,CA,90010-1577,Proprietary  ,41,243,284,1799,5933,7732
03074900,MARTINEZ ADULT CENTER                   ,CA,94553-3298,Public       ,0,0,0,5,25,30
03078200,AMERICAN CLG TRADITIONAL CHINESE MD     ,CA,94107-2813,Private      ,0,3,3,17,355,372
03084700,VENTURA ADULT\CONTINUING EDUCATION      ,CA,93003-7313,Public       ,3,16,19,60,395,455
03094400,ELITE PROGRESSIVE SCHOOL OF COSM        ,CA,95841-2909,Proprietary  ,11,22,33,177,389,566
03094401,MARINELLO SCHOOL OF BEAUTY - CONCORD    ,CA,94520-2581,Proprietary  ,9,16,25,121,277,398
03094402,MARINELLO SCHOOL OF BEAUTY- STOCKTON    ,CA,95203-3149,Proprietary  ,8,19,27,211,335,546
03097700,CENTRAL CALIF SCH CONTINUING EDUC       ,CA,93401-6739,Proprietary  ,0,5,5,95,320,415
03098200,YO SAN UNIV TRADITIONAL CHINESE MED     ,CA,90066-1103,Private      ,0,7,7,10,245,255
03108100,SUMMIT CAREER COLLEGE                   ,CA,92324-3956,Proprietary  ,20,75,95,460,1509,1969
03109500,DONGGUK  UNIVERSITY LOS ANGELES         ,CA,90020-1765,Private      ,1,6,7,32,128,160
03113300,UEI COLLEGE                             ,CA,93727-1620,Proprietary  ,64,149,213,854,2012,2866
03113600,SOUTHERN CALIFORNIA INST OF TECHNOL     ,CA,92805-3758,Proprietary  ,16,40,56,234,730,964
03116600,EAST SAN GABRIEL VLY REG OCCUP PROG     ,CA,91790-2105,Public       ,33,158,191,306,1221,1527
03125300,JOHN WESLEY INTER. BARBER & BTY CLG     ,CA,90813-4321,Proprietary  ,2,11,13,114,269,383
03125800,PREMIERE CAREER COLLEGE                 ,CA,91706-3746,Proprietary  ,19,74,93,247,707,954
03126800,PACIFICA GRADUATE INSTITUTE             ,CA,93013-0000,Proprietary  ,0,19,19,0,1082,1082
03128700,MT SIERRA COLLEGE                       ,CA,91016-3414,Proprietary  ,2,12,14,464,515,979
03131300,FIVE BRANCHES UNIVERSITY                ,CA,95062-4669,Proprietary  ,0,9,9,58,507,565
03144400,AMERICAN CLG OF HEALTH PROFESSIONS      ,CA,92505-3038,Proprietary  ,28,65,93,341,852,1193
03150500,VIRGINIA SEWING MACHINES & SCH CTR      ,CA,90015-3535,Proprietary  ,4,12,16,16,66,82
03162300,FOUR-D SUCCESS ACADEMY                  ,CA,92324-4218,Proprietary  ,8,40,48,221,857,1078
03163300,PACIFIC STATES UNIVERSITY               ,CA,90006-0000,Private      ,1,1,2,90,132,222
03195400,EVEREST COLLEGE                         ,CA,90501-2867,Proprietary  ,16,21,37,196,433,629
03210300,LE CORDON BLEU COLLEGE OF CULINARY ARTS ,CA,91101-5221,Proprietary  ,53,150,203,3460,7259,10719
03225300,AMERICAN UNIVERSITY OF HEALTH SCIENCES  ,CA,90755-3612,Proprietary  ,1,6,7,163,367,530
03242300,CAREER NETWORK INSTITUTE                ,CA,92868-4710,Proprietary  ,13,50,63,191,674,865
03250300,COMMUNITY BASED EDUCATION AND DEVEL     ,CA,90036-0000,Private      ,8,19,27,95,318,413
03260300,CALIFORNIA STATE U-MONTEREY BAY         ,CA,93955-8001,Public       ,24,56,80,12374,4296,16670
03266300,BETHESDA UNIVERSITY OF CALIFORNIA       ,CA,92801-4132,Private      ,0,1,1,129,201,330
03278300,CLARITA CAREER COLLEGE                  ,CA,91351-5432,Proprietary  ,26,50,76,716,1500,2216
03288300,ACAD CHINESE CULTURE & HEALTH SCIS      ,CA,94512-0000,Private      ,0,3,3,22,189,211
03299300,PACIFIC COLLEGE                         ,CA,92626-3160,Proprietary  ,1,25,26,160,549,709
03308300,BRISTOL UNIVERSITY                      ,CA,92806-6198,Proprietary  ,1,7,8,16,83,99
03327400,ACUPUNCTURE AND INTEGRATIVE MEDICINE COL,CA,94704-2724,Private      ,0,5,5,44,290,334
03332300,SOUTHERN CA BIBLE CLG & SEMINARY        ,CA,92019-1109,Private      ,4,8,12,24,196,220
03359300,ST. FRANCIS CAREER COLLEGE              ,CA,90262-2659,Private      ,0,3,3,65,138,203
03367300,PROFESSIONAL GOLFERS CAREER COLLEGE     ,CA,92591-6013,Proprietary  ,1,6,7,163,296,459
03395300,INTERNATIONAL CAREER DEVELOPMENT        ,CA,90027-5794,Proprietary  ,71,340,411,1231,7449,8680
03399300,NORTHWESTERN TECHNICAL COLLEGE          ,CA,95670-4443,Proprietary  ,7,19,26,165,576,741
03403300,EPIC BIBLE COLLEGE                      ,CA,95841-3546,Private      ,0,11,11,162,648,810
03413400,ENGLISH CENTER  (THE)                   ,CA,94607-3734,Private      ,8,22,30,46,260,306
03427400,CAREER COLLEGES OF AMERICA              ,CA,90280-7420,Proprietary  ,46,141,187,479,1592,2071
03427500,UNIVERSITY OF ANTELOPE VALLEY           ,CA,93534-3324,Proprietary  ,30,77,107,708,1319,2027
03440400,MARIAN HEALTH CAREERS CENTER            ,CA,90010-1728,Proprietary  ,7,13,20,117,244,361
03441400,VALLEY CAREER COLLEGE                   ,CA,92020-3057,Proprietary  ,5,23,28,128,414,542
03458300,MY LE'S BEAUTY COLLEGE                  ,CA,95824-3039,Proprietary  ,3,7,10,120,326,446
03467300,MARINELLO SCHOOL OF BEAUTY              ,CA,92545-3661,Proprietary  ,22,37,59,220,444,664
03467301,MARINELLO SCHOOL OF BEAUTY - CATHEDRAL C,CA,92234-6656,Proprietary  ,0,3,3,26,43,69
03467302,MARINELLO SCHOOL OF BEAUTY - MURRIETA   ,CA,92563-5039,Proprietary  ,21,27,48,173,332,505
03467303,MARINELLO SCHOOL OF BEAUTY - NAPA       ,CA,94559-1237,Proprietary  ,8,9,17,101,165,266
03467304,MARINELLO SCHOOL OF BEAUTY - CITY OF IND,CA,91748-1674,Proprietary  ,6,19,25,80,174,254
03467305,MARINELLO SCHOOL OF BEAUTY - BELL       ,CA,90201-1193,Proprietary  ,6,12,18,120,138,258
03467306,MARINELLO SCHOOL OF BEAUTY - PARAMOUNT  ,CA,90723-5256,Proprietary  ,8,19,27,135,206,341
03467307,MARINELLO SCHOOL OF BEAUTY - HUNTINGTON ,CA,92646-2552,Proprietary  ,4,13,17,121,232,353
03479300,PROFESSIONAL CAREER INSTITUTE           ,CA,90703-2522,Proprietary  ,2,11,13,125,191,316
03485400,JAMES ALBERT SCHOOL OF COSMETOLOGY      ,CA,92627-3831,Proprietary  ,0,0,0,17,20,37
03516300,KING'S UNIVERSITY (THE)                 ,CA,91405-2233,Private      ,1,9,10,128,532,660
03532400,ADVANCED TRAINING ASSOCIATES            ,CA,92020-1236,Proprietary  ,3,8,11,32,166,198
03542400,COPPER MOUNTAIN COLLEGE                 ,CA,92252-6102,Public       ,8,30,38,865,2367,3232
03577300,COBA ACADEMY                            ,CA,92866-1407,Proprietary  ,2,5,7,58,85,143
03590400,NTMA TRAINING CENTERS OF SOUTHERN C     ,CA,90650-6099,Private      ,32,86,118,234,815,1049
03592400,IRELL & MANELLA GRADUATE SCHOOL OF BIOLO,CA,91010-0000,Private      ,0,0,0,1,9,10
03598300,AVALON BEAUTY COLLEGE                   ,CA,93103-3137,Proprietary  ,9,4,13,191,170,361
03614300,DAVID'S ACADEMY OF BEAUTY               ,CA,91780-1089,Proprietary  ,1,17,18,16,437,453
03639300,WEST COAST ULTRASOUND INSTITUTE         ,CA,90211-3312,Proprietary  ,3,11,14,471,1475,1946
03646300,DESIGN'S SCHOOL OF COSMETOLOGY          ,CA,93446-9530,Proprietary  ,6,17,23,118,280,398
03681300,CALIFORNIA HEALING ARTS COLLEGE         ,CA,90025-2589,Proprietary  ,1,14,15,106,380,486
03695300,COMMUNITY ENHANCEMENT SERVICES          ,CA,91502-2750,Private      ,1,13,14,30,172,202
03695700,SANTIAGO CANYON COLLEGE                 ,CA,92869-4512,Public       ,41,63,104,4421,2991,7412
03696300,UNIVERSITY OF THE WEST                  ,CA,91770-3709,Private      ,1,1,2,34,99,133
03698300,WEST COAST UNIVERSITY                   ,CA,91606-3206,Proprietary  ,52,87,139,2531,5363,7894
03698400,CA COLLEGE OF VOCATIONAL CAREER         ,CA,93301-1800,Proprietary  ,2,26,28,220,627,847
03736300,ADVANCE BEAUTY COLLEGE                  ,CA,92843-4752,Proprietary  ,8,57,65,92,482,574
03740400,ATI COLLEGE                             ,CA,90650-0000,Proprietary  ,5,19,24,113,277,390
03759300,COMPUTER TUTOR BUSINESS & TECH INST     ,CA,95356-0000,Proprietary  ,4,16,20,107,354,461
03786300,ADVANCED COLLEGE                        ,CA,90280-5255,Proprietary  ,3,47,50,95,339,434
03797400,CAREER CARE INSTITUTE                   ,CA,93534-4766,Proprietary  ,28,71,99,376,1113,1489
03797401,CAREER CARE INSTITUTE - VENTURA         ,CA,93003-0000,Proprietary  ,4,6,10,77,240,317
03797402,CAREER CARE INSTITUTE - MORENO VALLEY   ,CA,92553-7519,Proprietary  ,1,6,7,61,209,270
03814400,SOKA UNIVERSITY OF AMERICA              ,CA,92656-8081,Private      ,1,0,1,566,62,628
03853300,KECK GRADUATE INSTITUTE OF APPLIED LIFE ,CA,91711-4817,Private      ,0,0,0,5,168,173
03853400,LADERA CAREER PATHS TRAINING CENTERS    ,CA,90045-1931,Proprietary  ,0,0,0,16,63,79
03868300,WORLD MISSION UNIVERSITY                ,CA,90020-1789,Private      ,0,0,0,18,142,160
03868400,LOS ANGELES MUSIC ACADEMY               ,CA,91105-2540,Proprietary  ,4,0,4,264,209,473
03871300,FOLSOM LAKE COLLEGE                     ,CA,95630-6798,Public       ,47,115,162,3750,4989,8739
03874300,CAMBRIDGE JUNIOR COLLEGE                ,CA,95993-0000,Proprietary  ,2,25,27,226,556,782
03874400,COMMMUNITY CHRISTIAN COLLEGE            ,CA,92373-4465,Private      ,1,0,1,233,184,417
03889300,STANBRIDGE COLLEGE                      ,CA,92612-0000,Proprietary  ,18,91,109,335,1345,1680
03901300,PACIFIC COAST TRADE SCHOOL              ,CA,93033-2441,Proprietary  ,9,49,58,123,396,519
03910400,NATIONAL POLYTECHNIC COLLEGE            ,CA,90040-3066,Proprietary  ,6,8,14,137,268,405
03933300,MUELLER COLLEGE OF HOLISTIC STUDIES     ,CA,92116-2630,Proprietary  ,4,16,20,58,440,498
03935300,CALIFORNIA NURSES EDUCATIONAL INSTITUTE ,CA,92234-7248,Proprietary  ,4,14,18,99,316,415
03962300,AMERICAN INSTITUTE OF MASSAGE THERAPY   ,CA,92705-5463,Proprietary  ,0,6,6,76,152,228
03964400,INTERNATIONAL SCHOOL OF BEAUTY          ,CA,92260-2740,Proprietary  ,12,38,50,145,374,519
03969600,AMERICAN AUTO INSTITUTE                 ,CA,90703-2637,Proprietary  ,64,162,226,810,1768,2578
03971300,AMERICAN CAREER COLLEGE                 ,CA,91764-4906,Proprietary  ,62,106,168,1164,2172,3336
03973300,EX'PRESSION COLLEGE FOR DIGTAL ARTS     ,CA,94608-1021,Proprietary  ,15,16,31,742,715,1457
03974500,CALIFORNIA CAREER COLLEGE               ,CA,91303-2006,Proprietary  ,1,3,4,50,146,196
03980300,CALIFORNIA STATE UNIVERSITY CHANNEL ISLA,CA,93012-8599,Public       ,18,22,40,7472,3302,10774
03995300,UNIVERSITY OF EAST-WEST MEDICINE        ,CA,94087-6106,Proprietary  ,0,7,7,14,101,115
03999300,BEAUMONT ADULT SCHOOL                   ,CA,92223-1927,Public       ,0,1,1,55,199,254
04001300,PALACE BEAUTY COLLEGE                   ,CA,90006-4233,Proprietary  ,2,12,14,132,280,412
04001400,MOJAVE BARBER COLLEGE                   ,CA,92395-3201,Proprietary  ,0,0,0,67,142,209
04003300,BLAKE AUSTIN COLLEGE                    ,CA,95687-3100,Proprietary  ,2,30,32,258,747,1005
04004300,THUY PRINCESS BEAUTY COLLEGE            ,CA,91766-0000,Proprietary  ,1,8,9,46,116,162
04005300,INTERAMERICAN COLLEGE                   ,CA,91950-4437,Proprietary  ,0,41,41,34,401,435
04014400,PALLADIUM TECHNICAL ACADEMY             ,CA,91731-2429,Proprietary  ,6,24,30,46,112,158
04023400,PROTEUS                                 ,CA,93291-3014,Private      ,0,3,3,34,130,164
04037300,LOS ANGELES FILM SCHOOL (THE)           ,CA,90028-7300,Proprietary  ,35,77,112,2034,2659,4693
04049300,MAXINE WATERS EMPLOYMENT PREPARATION CEN,CA,90059-1023,Public       ,0,0,0,39,126,165
04056300,CAREER COLLEGE OF CALIFORNIA            ,CA,92705-5805,Proprietary  ,6,22,28,145,308,453
04057300,TECHSKILLS OF CALIFORNIA                ,CA,95815-4025,Proprietary  ,8,110,118,228,1262,1490
04076400,GNOMON SCHOOL OF VISUAL EFFECTS         ,CA,90038-2616,Proprietary  ,0,2,2,108,279,387
04088300,WESTMED COLLEGE                         ,CA,95128-2541,Private      ,7,22,29,144,460,604
04088301,WESTMED COLLEGE - MERCED                ,CA,95340-9165,Private      ,0,12,12,121,342,463
04092300,COASTLINE BEAUTY COLLEGE                ,CA,92708-3847,Proprietary  ,2,30,32,49,272,321
04092400,MAKE-UP DESIGNORY                       ,CA,91502-1322,Proprietary  ,7,10,17,355,428,783
04100400,TAFT UNIVERSITY SYSTEM (THE)            ,CA,92704-6954,Proprietary  ,0,26,26,14,660,674
04109300,ACADEMY OF BARBERING ARTS (THE)         ,CA,91324-3406,Proprietary  ,0,0,0,122,208,330
04111300,WEST HILLS COLLEGE LEMOORE              ,CA,93245-9248,Public       ,28,70,98,2389,3390,5779
04114500,VALLEY COLLEGE OF MEDICAL CAREERS       ,CA,91304-2354,Proprietary  ,4,9,13,90,224,314
04115300,COACHELLA VALLEY BEAUTY COLLEGE         ,CA,92253-2051,Proprietary  ,15,19,34,103,129,232
04115600,MAYFIELD COLLEGE                        ,CA,92234-7014,Proprietary  ,44,68,112,199,514,713
04116000,VIDEO SYMPHONY ENTERTRAINING            ,CA,91502-3253,Proprietary  ,3,21,24,63,466,529
04118800,NEW YORK FILM ACADEMY                   ,CA,91608-1002,Proprietary  ,6,17,23,836,1119,1955
04119200,CAREER COLLEGE CONSULTANTS              ,CA,90041-2088,Proprietary  ,5,23,28,61,234,295
04126400,CHAMPION INSTITUTE OF COSMETOLOGY       ,CA,92264-7458,Proprietary  ,3,3,6,44,75,119
04126500,COAST CAREER INSTITUTE                  ,CA,90015-3040,Proprietary  ,10,33,43,251,865,1116
04127100,"UNIVERSITY OF CALIFORNIA, MERCED        ",CA,95343-5001,Public       ,87,8,95,14278,2227,16505
04127800,HEALTHY HAIR ACADEMY                    ,CA,90303-3137,Proprietary  ,0,0,0,9,13,22
04127900,TUI UNIVERSITY                          ,CA,90630-5023,Proprietary  ,2,271,273,57,3642,3699
04129700,INTERNATIONAL POLYTECHNIC INSTITUTE     ,CA,92231-1737,Private      ,0,0,0,35,66,101
04129803,MEDIATECH INSTITUTE - OCEANSIDE         ,CA,92054-5116,Proprietary  ,1,4,5,60,145,205
04132300,INSTITUTE OF MEDICAL EDUCATION          ,CA,95113-2207,Proprietary  ,0,0,0,64,110,174
04132400,ACADEMY OF ESTHETICS AND COSMETOLOGY    ,CA,91342-3373,Proprietary  ,3,4,7,69,109,178
04132700,INFOTECH CAREER COLLEGE                 ,CA,90706-5579,Proprietary  ,3,21,24,67,218,285
04133000,BIOHEALTH COLLEGE                       ,CA,95134-2033,Proprietary  ,3,31,34,97,461,558
04133100,CALIFORNIA UNIVERSITY OF MANAGEMENT AND ,CA,92801-1702,Private      ,0,4,4,28,99,127
04134500,CAREER COLLEGE OF SAN DIEGO             ,CA,92102-3348,Proprietary  ,11,68,79,277,909,1186
04134700,INTERNATL PROFESSIONAL SCHL OF BODYWORK ,CA,92123-1520,Proprietary  ,0,5,5,61,334,395
04137200,BORNER'S BARBER COLLEGE                 ,CA,90047-3856,Proprietary  ,1,5,6,71,159,230
04138700,CAO INSTITUTE OF AESTHETICS (THE)       ,CA,91801-3903,Proprietary  ,8,14,22,102,179,281
04140500,HORIZON UNIVERSITY                      ,CA,92111-2622,Private      ,0,6,6,72,185,257
04140600,MODERN INSTITUTE OF TECHNOLOGY          ,CA,93036-1387,Proprietary  ,0,0,0,22,49,71
04141300,SAN FRANCISCO INSTITUTE OF ESTHETICS    ,CA,94103-4083,Proprietary  ,4,7,11,195,301,496
04141400,LAURUS COLLEGE                          ,CA,93401-5405,Proprietary  ,5,79,84,160,977,1137
04141700,HEALING HANDS SCHOOL OF HOLISTIC HEALTH ,CA,92025-1722,Proprietary  ,2,8,10,48,245,293
04142500,TOURO COLLEGE LOS ANGELES               ,CA,90046-4506,Private      ,1,3,4,120,152,272
04142600,TOURO UNIVERSITY                        ,CA,94592-1118,Private      ,0,11,11,46,2884,2930
04143800,WOODLAND COMMUNITY COLLEGE              ,CA,95776-5156,Public       ,16,45,61,1666,1999,3665
04144200,CAREER DEVELOPMENT INSTITUTE            ,CA,90035-4364,Proprietary  ,0,12,12,39,195,234
04145000,SAN DIEGO CULINARY INSTITUTE            ,CA,91941-6435,Proprietary  ,9,22,31,477,793,1270
04145600,INTERNATIONAL COLLEGE OF COSMETOLOGY    ,CA,94601-3525,Proprietary  ,9,10,19,89,275,364
04146000,NATIONAL CAREER COLLEGE                 ,CA,91605-1400,Proprietary  ,2,10,12,38,135,173
04148200,BEYOND 21ST CENTURY BEAUTY ACADEMY      ,CA,90670-6316,Proprietary  ,2,1,3,42,61,103
04148900,N CALIF INSTITUTE OF COSMETOLOGY        ,CA,94577-2820,Proprietary  ,0,5,5,25,88,113
04149700,HOMESTEAD SCHOOLS                       ,CA,90505-5945,Private      ,9,16,25,85,312,397
04150000,CENTRAL NURSING COLLEGE                 ,CA,90010-2444,Proprietary  ,1,10,11,220,400,620
04150100,GOLDEN STATE COLLEGE OF COURT REPORTING ,CA,94568-2948,Proprietary  ,0,0,0,12,75,87
04150300,RWM FIBER OPTICS                        ,CA,90746-1051,Proprietary  ,0,15,15,11,126,137
04150500,"PREFERRED COLLEGE OF NURSING, LOS ANGELE",CA,90010-2202,Proprietary  ,6,12,18,137,420,557
04152800,CALIFORNIA ACADEMY (THE) - A PAUL MITCHE,CA,95825-2276,Proprietary  ,13,22,35,444,716,1160
04153900,PROVIDENCE CHRISTIAN COLLEGE            ,CA,91104-2635,Private      ,0,1,1,111,41,152
04154300,AMERICANA COLLEGE                       ,CA,90029-3765,Proprietary  ,0,0,0,5,9,14
04154400,FRANKLIN CAREER COLLEGE                 ,CA,91761-1522,Proprietary  ,0,11,11,45,207,252
04155500,"ACADEMY FOR JEWISH RELIGION, CALIFORNIA ",CA,90024-3234,Private      ,0,1,1,23,95,118
04156100,DIOR SCHOOL OF COSMETOLOGY              ,CA,95355-9695,Proprietary  ,3,5,8,150,236,386
04157800,GRACE MISSION UNIVERSITY                ,CA,92833-3860,Private      ,0,4,4,2,38,40
04158200,PAUL MITCHELL THE SCHOOL SHERMAN OAKS   ,CA,91403-5882,Proprietary  ,13,18,31,299,342,641
04158700,HOLLYWOOD BEAUTY COLLEGE                ,CA,95210-3514,Proprietary  ,9,18,27,153,280,433
04158900,FLAIR BEAUTY COLLEGE                    ,CA,91351-3381,Proprietary  ,2,6,8,51,74,125
04159600,GALAXY MEDICAL COLLEGE                  ,CA,91606-1593,Proprietary  ,1,2,3,46,73,119
04159700,AMERICAN MEDICAL SCIENCES CENTER        ,CA,91204-5108,Proprietary  ,3,13,16,107,185,292
04160100,TRINITY VOCATIONAL CENTER               ,CA,90248-4334,Proprietary  ,0,16,16,42,182,224
04160400,ANGELES COLLEGE OF NURSING              ,CA,90010-2100,Proprietary  ,0,12,12,543,839,1382
04161300,PREFERRED COLLEGE OF NURSING            ,CA,91401-1442,Proprietary  ,1,8,9,63,220,283
04161700,SHASTA SCHOOL OF COSMETOLOGY            ,CA,96003-0000,Proprietary  ,4,10,14,124,204,328
04161800,BRANDMAN UNIVERSITY                     ,CA,92618-3801,Private      ,19,423,442,505,9515,10020
04162800,S.I.C.E PAUL MITCHELL PARTNER SCHOOL    ,CA,95350-1440,Proprietary  ,15,24,39,357,483,840
04163400,COSMO BEAUTY ACADEMY                    ,CA,95605-1904,Proprietary  ,2,17,19,229,408,637
04163900,L.A. BARBER COLLEGE                     ,CA,90013-1121,Proprietary  ,0,0,0,111,237,348
04164400,ANGELES INSTITUTE                       ,CA,90712-2903,Proprietary  ,3,8,11,119,230,349
04165900,PAUL MITCHELL THE SCHOOL FRESNO         ,CA,93710-7617,Proprietary  ,17,15,32,412,414,826
04167000,PAUL MITCHELL THE SCHOOL TEMECULA       ,CA,92591-4663,Proprietary  ,8,13,21,242,298,540
04169200,TRAMY BEAUTY SCHOOL                     ,CA,92115-6347,Proprietary  ,5,49,54,122,437,559
04169700,UNITEK COLLEGE                          ,CA,94538-3185,Proprietary  ,32,126,158,448,1749,2197
04169800,GURNICK ACADEMY OF MEDICAL ARTS         ,CA,94403-1849,Proprietary  ,4,27,31,303,1447,1750
04172000,SOUTHERN CALIFORNIA UNIVERSITY SOMA     ,CA,90017-2211,Proprietary  ,3,6,9,205,417,622
04173400,SANTA ANA BEAUTY ACADEMY                ,CA,92705-7820,Proprietary  ,0,3,3,76,104,180
04173500,MORENO VALLEY COLLEGE                   ,CA,92551-2204,Public       ,86,170,256,5502,7606,13108
04175200,PAUL MITCHELL THE SCHOOL EAST BAY       ,CA,94523-5515,Proprietary  ,10,19,29,293,357,650
04175400,ELITE COSMETOLOGY SCHOOL                ,CA,92284-2860,Proprietary  ,3,7,10,50,130,180
04176100,NORCO COLLEGE                           ,CA,92860-2600,Public       ,50,83,133,4870,5062,9932
04176200,TWIN RIVERS ADULT SCHOOL                ,CA,95660-5523,Public       ,0,3,3,36,611,647
04176300,BERGIN UNIVERSITY OF CANINE STUDIES     ,CA,95407-6834,Private      ,0,3,3,23,111,134
04177200,REAL BARBERS COLLEGE (THE)              ,CA,92805-2533,Proprietary  ,4,9,13,81,147,228
04178900,HANDS-ON MEDICAL MASSAGE SCHOOL         ,CA,92373-6271,Proprietary  ,0,1,1,39,104,143
04180000,CINTA AVEDA INSTITUTE                   ,CA,94108-3204,Proprietary  ,11,21,32,183,426,609
04181200,IPPT CAREER SCHOOL                      ,CA,91601-2028,Proprietary  ,12,44,56,88,349,437
04185200,SALINAS BEAUTY COLLEGE                  ,CA,93901-2405,Proprietary  ,5,6,11,66,112,178
04185500,ACADEMY OF COUTURE ART                  ,CA,90069-5701,Proprietary  ,0,1,1,114,151,265
04185600,MEDICAL ALLIED CAREER CENTER            ,CA,90670-4710,Proprietary  ,0,3,3,28,127,155
04185700,ACADEMY FOR SALON PROFESSIONALS (THE)   ,CA,95050-4057,Proprietary  ,5,6,11,148,246,394
04186900,"INTERNATIONAL COLLEGE OF BEAUTY, ARTS & ",CA,90039-1012,Proprietary  ,1,8,9,179,228,407
04187900,JOE BLASCO MAKEUP ARTIST TRAINING CENTER,CA,90027-5580,Proprietary  ,1,6,7,172,356,528
04189300,ALLIED AMERICAN UNIVERSITY              ,CA,92653-1337,Proprietary  ,7,238,245,95,1835,1930
04189700,CALIFORNIA MIRAMAR UNIVERSITY           ,CA,92126-7501,Proprietary  ,4,23,27,43,168,211
04189800,ACADEMY FOR SALON PROFESSIONALS         ,CA,91304-2305,Proprietary  ,2,6,8,84,154,238
04190800,SANTA ANA BEAUTY COLLEGE                ,CA,92706-2321,Proprietary  ,10,25,35,10,29,39
04191300,ANNENBERG SCHOOL OF NURSING             ,CA,91335-5426,Private      ,1,0,1,48,74,122
04193500,LEMELANGE ACADEMY OF HAIR               ,CA,94558-2935,Proprietary  ,0,1,1,46,65,111
04193700,JOHN PAUL THE GREAT CATHOLIC UNIVERSITY ,CA,92131-1652,Private      ,1,2,3,181,110,291
04194300,COLTON-REDLANDS-YUCAIPA REGIONAL OCCUPAT,CA,92374-2896,Public       ,1,3,4,15,68,83
04194600,BRAND COLLEGE                           ,CA,91203-3646,Proprietary  ,0,2,2,9,32,41
04195200,DIAMOND BEAUTY COLLEGE                  ,CA,91733-2180,Proprietary  ,0,8,8,3,46,49
04195400,NCP COLLEGE OF NURSING                  ,CA,94080-1005,Proprietary  ,3,13,16,87,287,374
04195401,NCP COLLEGE OF NURSING - HAYWARD CAMPUS ,CA,94541-7026,Proprietary  ,3,12,15,81,328,409
04205800,"SAE INSTITUTE OF TECHNOLOGY, LOS ANGELES",CA,90028-7219,Proprietary  ,10,18,28,152,256,408
04206800,ADVANCE BEAUTY TECHS ACADEMY            ,CA,92583-6572,Proprietary  ,0,8,8,30,71,101
04208100,UKIAH ADULT SCHOOL                      ,CA,95482-3865,Public       ,1,3,4,7,43,50
04208400,RIVERSIDE COUNTY OFFICE OF EDUCATION    ,CA,92503-3504,Public       ,3,17,20,3,21,24
04208900,ADVANCED CAREER INSTITUTE               ,CA,93291-9254,Proprietary  ,6,50,56,28,255,283
04209800,HINTON BARBER COLLEGE                   ,CA,94590-4547,Proprietary  ,4,6,10,27,84,111
04210600,ADVANCED COMPUTING INSTITUTE            ,CA,90010-3911,Proprietary  ,3,45,48,8,72,80
04211900,XAVIER COLLEGE SCHOOL OF NURSING        ,CA,95202-1332,Proprietary  ,10,10,20,20,33,53
04212000,LAWRENCE & COMPANY COLLEGE OF COSMETOLOG,CA,93230-4102,Proprietary  ,7,4,11,15,10,25
04215100,CALIFORNIA CAREER INSTITUTE             ,CA,92840-2816,Proprietary  ,8,37,45,8,37,45
04215300,COSMO FACTORY COSMETOLOGY ACADEMY (THE) ,CA,95060-4401,Proprietary  ,0,7,7,13,27,40
04216300,UEI COLLEGE                             ,CA,95065-1520,Proprietary  ,3,8,11,6,25,31
04217500,W INSTITUTE OF COSMETOLOGY              ,CA,94521-5385,Proprietary  ,0,8,8,2,16,18
04221800,TONI&GUY HAIRDRESSING ACADEMY           ,CA,95337-5703,Proprietary  ,4,8,12,4,8,12
00184600,BRIAR CLIFF UNIVERSITY                  ,IA,51104-2100,Private      ,1,11,12,1371,692,2063
00184700,BUENA VISTA UNIVERSITY                  ,IA,50588-9987,Private      ,2,60,62,1769,2213,3982
00184800,SOUTHEASTERN COMMUNITY COLLEGE          ,IA,52655-0000,Public       ,33,70,103,1332,2362,3694
00185000,CENTRAL COLLEGE                         ,IA,50219-1999,Private      ,0,2,2,2337,175,2512
00185200,CLARKE UNIVERSITY                       ,IA,52001-3198,Private      ,3,6,9,1198,638,1836
00185400,COE COLLEGE                             ,IA,52402-5092,Private      ,3,4,7,2403,295,2698
00185500,DES MOINES UNIV-OSTEOPATHIC MED CTR     ,IA,50312-0000,Private      ,0,4,4,31,1889,1920
00185600,CORNELL COLLEGE                         ,IA,52314-1098,Private      ,2,0,2,2015,115,2130
00185700,SOUTHWESTERN COMMUNITY COLLEGE          ,IA,50801-1098,Public       ,5,14,19,686,840,1526
00185800,DIVINE WORD COLLEGE                     ,IA,52045-0380,Private      ,0,0,0,34,20,54
00185900,DORDT COLLEGE                           ,IA,51250-1697,Private      ,1,2,3,1481,117,1598
00186000,DRAKE UNIVERSITY                        ,IA,50311-4505,Private      ,5,23,28,5188,2529,7717
00186200,ELLSWORTH COMMUNITY COLLEGE             ,IA,50126-1199,Public       ,7,12,19,808,518,1326
00186400,IOWA LAKES COMMUNITY COLLEGE            ,IA,51334-2234,Public       ,11,27,38,1344,1383,2727
00186500,IOWA CENTRAL COMMUNITY COLLEGE          ,IA,50501-0000,Public       ,14,108,122,2950,3636,6586
00186600,GRACELAND UNIVERSITY                    ,IA,50140-1699,Private      ,1,48,49,1239,1605,2844
00186700,GRAND VIEW UNIVERSITY                   ,IA,50316-1599,Private      ,3,33,36,2195,1756,3951
00186800,GRINNELL COLLEGE                        ,IA,50112-1690,Private      ,0,0,0,2875,110,2985
00186900,IOWA STATE UNIV SCIENCE & TECHNOLOG     ,IA,50011-2028,Public       ,69,86,155,26027,6833,32860
00187100,IOWA WESLEYAN COLLEGE                   ,IA,52641-1398,Private      ,1,9,10,831,445,1276
00187300,LORAS COLLEGE                           ,IA,52004-0178,Private      ,4,4,8,2105,252,2357
00187400,LUTHER COLLEGE                          ,IA,52101-1045,Private      ,2,4,6,3383,102,3485
00187500,MARSHALLTOWN COMMUNITY COLLEGE          ,IA,50158-4760,Public       ,15,25,40,814,1203,2017
00187700,NORTH IOWA AREA COMMUNITY COLLEGE       ,IA,50401-7299,Public       ,15,41,56,1581,1387,2968
00187900,MORNINGSIDE COLLEGE                     ,IA,51106-1751,Private      ,2,54,56,1958,904,2862
00188000,MOUNT MERCY UNIVERSITY                  ,IA,52402-4797,Private      ,3,17,20,1090,1240,2330
00188100,ASHFORD UNIVERSITY                      ,IA,52732-3910,Proprietary  ,112,5819,5931,4184,133409,137593
00188300,NORTHWESTERN COLLEGE                    ,IA,51041-1996,Private      ,1,6,7,1540,159,1699
00188700,SIMPSON COLLEGE                         ,IA,50125-1297,Private      ,3,13,16,2263,667,2930
00188900,ST AMBROSE UNIVERSITY                   ,IA,52803-2898,Private      ,6,28,34,3473,1658,5131
00189000,UNIVERSITY OF NORTHERN IOWA             ,IA,50614-0002,Public       ,8,57,65,10919,3361,14280
00189100,UNIVERSITY OF DUBUQUE                   ,IA,52001-5099,Private      ,9,19,28,2300,797,3097
00189200,UNIVERSITY OF IOWA                      ,IA,52242-1316,Public       ,40,89,129,22344,10834,33178
00189300,UPPER IOWA UNIVERSITY                   ,IA,52142-9206,Private      ,9,148,157,1590,6142,7732
00189500,WALDORF COLLEGE                         ,IA,50436-1700,Proprietary  ,0,16,16,800,669,1469
00189600,WARTBURG COLLEGE                        ,IA,50677-2200,Private      ,1,0,1,2417,111,2528
00189700,WARTBURG THEOLOGICAL SEMINARY           ,IA,52004-5004,Private      ,0,0,0,7,135,142
00190000,WILLIAM PENN UNIVERSITY                 ,IA,52577-1799,Private      ,3,35,38,1265,1339,2604
00396300,AIB COLLEGE OF BUSINESS                 ,IA,50321-1799,Private      ,9,36,45,689,983,1672
00407500,ESTRN IOWA COMMUNITY COLLEGE DIST       ,IA,52801-1221,Public       ,1,11,12,233,736,969
00407501,CLINTON COMMUNITY COLLEGE               ,IA,52732-0000,Public       ,5,31,36,538,1190,1728
00407502,MUSCATINE COMMUNITY COLLEGE             ,IA,52761-0000,Public       ,17,26,43,658,884,1542
00407503,SCOTT COMMUNITY COLLEGE                 ,IA,52722-0000,Public       ,26,92,118,1672,3759,5431
00407600,KIRKWOOD COMMUNITY COLLEGE              ,IA,52406-2068,Public       ,79,305,384,7728,9762,17490
00422009,HAMILTON COLLEGE -  COUNCIL BLUFFS      ,IA,51503-5289,Proprietary  ,0,9,9,88,922,1010
00423300,MERCY/ST. LUKE'S SCH RAD TECH           ,IA,52402-0000,Private      ,0,2,2,39,64,103
00458600,KAPLAN UNIVERSITY                       ,IA,52807-2095,Proprietary  ,388,5768,6156,5401,93308,98709
00458604,KAPLAN UNIVERSITY - CEDAR RAPIDS        ,IA,52404-2998,Proprietary  ,6,89,95,242,2798,3040
00458605,KAPLAN UNIVERSITY - DES MOINES          ,IA,50323-5702,Proprietary  ,9,117,126,226,2446,2672
00458606,KAPLAN UNIVERSITY - MASON CITY          ,IA,50401-4665,Proprietary  ,4,38,42,65,971,1036
00458607,KAPLAN UNIVERSITY - CEDAR FALLS         ,IA,50613-6309,Proprietary  ,5,92,97,187,1666,1853
00458700,NORTHEAST IOWA COMMUNITY COLLEGE        ,IA,52132-0400,Public       ,12,21,33,781,904,1685
00458701,NORTHEAST IOWA COMMUNITY COLLEGE        ,IA,52068-0000,Public       ,17,40,57,1183,1677,2860
00459500,HAWKEYE COMMUNITY COLLEGE               ,IA,50701-0000,Public       ,27,87,114,3222,3548,6770
00459800,IOWA WESTERN CMTY CLG-COUNCIL BLUFF     ,IA,51502-0000,Public       ,66,107,173,4127,4263,8390
00460000,NORTHWEST IOWA COMMUNITY COLLEGE        ,IA,51201-1046,Public       ,8,12,20,616,588,1204
00626700,IOWA METHODIST MEDICAL CENTER SCHOOLS   ,IA,50309-1499,Private      ,0,2,2,56,165,221
00627300,MERCY COLLEGE OF HEALTH SCIENCES        ,IA,50309-1239,Private      ,3,32,35,572,1264,1836
00712000,DES MOINES AREA CMTY COLLEGE            ,IA,50021-0000,Public       ,130,489,619,8241,13690,21931
00712100,FAITH BAPTIST BIBLE CLG & THEOL SEM     ,IA,50021-0000,Private      ,1,0,1,346,66,412
00729100,ST LUKE'S COLLEGE                       ,IA,51104-0263,Private      ,2,1,3,127,197,324
00731600,WESTERN IOWA TECH COMMUNITY COLLEGE     ,IA,51106-0000,Public       ,44,116,160,2252,4062,6314
00758800,CAPRI COLLEGE                           ,IA,52004-0873,Proprietary  ,2,6,8,96,142,238
00761100,EQ SCHOOL OF HAIR DESIGN                ,IA,51503-0813,Proprietary  ,4,4,8,49,78,127
00765600,AMERICAN COLLEGE OF HARISTYLING -CR     ,IA,52402-0000,Proprietary  ,1,1,2,16,56,72
00765800,AMER COLL OF HAIRSTYLING-DES MOINES     ,IA,50309-5446,Proprietary  ,1,5,6,18,103,121
00765900,LA JAMES COLLEGE OF HAIRSTYLING         ,IA,50401-3308,Proprietary  ,4,8,12,87,108,195
00771700,CAPRI COLLEGE                           ,IA,52807-2622,Proprietary  ,5,11,16,176,312,488
00794100,COLLEGE OF HAIR DESIGN                  ,IA,50703-1834,Proprietary  ,2,8,10,35,81,116
00826000,IOWA SCHOOL OF BEAUTY INC               ,IA,50322-0000,Proprietary  ,3,8,11,95,299,394
00840300,INDIAN HILLS COMMUNITY COLLEGE          ,IA,52501-1398,Public       ,36,107,143,2111,3028,5139
00840301,INDIAN HILLS COMMUNITY COLLEGE          ,IA,52544-1223,Public       ,10,28,38,278,453,731
00842400,LA JAMES INTERNATIONAL COLLEGE          ,IA,50501-5577,Proprietary  ,2,5,7,64,114,178
00959300,LA'JAMES COLLEGE OF HAIRSTYLING         ,IA,52240-0000,Proprietary  ,0,2,2,90,100,190
01111300,MAHARISHI UNIV OF MANAGEMENT            ,IA,52557-0001,Private      ,0,1,1,218,586,804
01206400,HAMILTON TECHNICAL COLLEGE              ,IA,52807-2653,Proprietary  ,5,21,26,130,421,551
01230000,PALMER COLLEGE OF CHIROPRACTIC          ,IA,52803-5287,Private      ,2,4,6,100,2167,2267
01300600,LA' JAMES INTERNATIONAL COLLEGE-CF      ,IA,50613-5242,Proprietary  ,0,4,4,81,129,210
02090300,CAPRI COLLEGE                           ,IA,52404-0000,Proprietary  ,5,8,13,157,225,382
02132000,LA JAMES COLLEGE OF HAIRSTYLING         ,IA,50703-0000,Proprietary  ,0,0,0,0,1,1
02134500,LA JAMES INTERNATIONAL COLLEGE - DAV    ,IA,52806-3952,Proprietary  ,3,4,7,67,104,171
02160900,"SALON PROFESSIONAL ACADEMY, THE         ",IA,50010-0000,Proprietary  ,0,5,5,103,121,224
02262500,FAUST INSTITUTE OF COSMETOLOGY          ,IA,50588-0000,Proprietary  ,5,5,10,26,54,80
02274100,LA' JAMES INTERNATIONAL COLLEGE - DM    ,IA,50131-0000,Proprietary  ,3,8,11,85,198,283
02289000,AMERICAN HAIR ACADEMY                   ,IA,52627-4530,Proprietary  ,0,0,0,22,48,70
02306900,IOWA SCHOOL OF BEAUTY                   ,IA,52501-0000,Proprietary  ,2,6,8,59,97,156
02328900,EMMAUS BIBLE COLLEGE                    ,IA,52001-0000,Private      ,1,0,1,240,64,304
02330900,IOWA SCHOOL OF BEAUTY                   ,IA,50158-0000,Proprietary  ,3,3,6,31,52,83
02609200,VATTEROTT COLLEGE                       ,IA,50321-4704,Proprietary  ,3,50,53,132,839,971
03069100,ALLEN COLLEGE                           ,IA,50703-1916,Private      ,0,6,6,365,609,974
03441300,IOWA SCHOOL OF BEAUTY                   ,IA,51106-5111,Proprietary  ,1,0,1,39,112,151
03607400,TOTAL LOOK SCHOOL OF COSMETOLOGY AND MAS,IA,52136-1053,Proprietary  ,0,1,1,14,12,26
03720300,CARLSON COLLEGE OF MASSAGE THERAPY      ,IA,52205-7519,Proprietary  ,0,0,0,19,48,67
04051313,ART INSTITUTE OF PHOENIX (THE) - BROWN M,IA,52722-3628,Proprietary  ,1,4,5,25,81,106
04089300,BIO-CHI INSTITUTE OF MASSAGE THERAPY    ,IA,51103-2138,Proprietary  ,2,2,4,17,65,82
04177800,SALON PROFESSIONAL ACADEMY (THE)        ,IA,52240-6083,Proprietary  ,0,3,3,56,68,124
04203300,AVEDA INSTITUTE DES MOINES              ,IA,50266-8137,Proprietary  ,1,3,4,180,201,381
00259600,ATLANTIC COMMUNITY COLLEGE              ,NJ,08330-2699,Public       ,42,123,165,4418,5718,10136
00259700,BLOOMFIELD COLLEGE                      ,NJ,07003-3425,Private      ,15,15,30,3439,1987,5426
00259800,CALDWELL COLLEGE                        ,NJ,07006-6195,Private      ,5,28,33,2436,1499,3935
00259900,CENTENARY COLLEGE                       ,NJ,07840-2184,Private      ,3,23,26,1901,1059,2960
00260000,COLLEGE OF SAINT ELIZABETH              ,NJ,07960-6989,Private      ,3,7,10,927,859,1786
00260100,CUMBERLAND COUNTY COLLEGE               ,NJ,08362-9912,Public       ,17,34,51,2528,3626,6154
00260300,DREW UNIVERSITY                         ,NJ,07940-4063,Private      ,2,9,11,3854,864,4718
00260700,FAIRLEIGH DICKINSON UNIV-TEANECK        ,NJ,07666-1996,Private      ,17,66,83,5228,3589,8817
00260701,FAIRLEIGH DICKINSON UNIV-FLORHAM        ,NJ,07940-0000,Private      ,7,16,23,4013,1143,5156
00260702,FAIRLEIGH DICKINSON UNIV-ED WMS CLG     ,NJ,07601-0000,Private      ,4,8,12,563,499,1062
00260703,FAIRLEIGH DICKINSON UNIVERSITY          ,NJ,07940-0000,Private      ,5,12,17,1903,953,2856
00260800,GEORGIAN COURT UNIVERSITY               ,NJ,08701-2697,Private      ,3,30,33,1551,1559,3110
00260900,ROWAN UNIVERSITY                        ,NJ,08028-1702,Public       ,21,65,86,15339,5596,20935
00261000,FELICIAN COLLEGE                        ,NJ,07644-2198,Private      ,8,14,22,2518,1762,4280
00261300,NEW JERSEY CITY UNIVERSITY              ,NJ,07305-1597,Public       ,27,106,133,5923,7593,13516
00261500,MIDDLESEX COUNTY COLLEGE                ,NJ,08818-3050,Public       ,43,81,124,7668,6313,13981
00261600,MONMOUTH UNIVERSITY                     ,NJ,07764-1898,Private      ,16,50,66,8567,2780,11347
00261700,MONTCLAIR STATE UNIVERSITY              ,NJ,07043-9987,Public       ,38,93,131,19620,9186,28806
00261900,NEW BRUNSWICK THEOLOGICAL SEMINARY      ,NJ,08901-0000,Private      ,0,3,3,80,212,292
00262100,NEW JERSEY INST OF TECHNOLOGY           ,NJ,07102-1982,Public       ,23,41,64,7110,4131,11241
00262200,KEAN UNIVERSITY                         ,NJ,07083-7131,Public       ,24,83,107,14375,10399,24774
00262400,OCEAN COUNTY COLLEGE                    ,NJ,08754-2001,Public       ,28,111,139,5713,5115,10828
00262500,WILLIAM PATERSON UNIVERSITY             ,NJ,07470-2152,Public       ,28,40,68,12814,5801,18615
00262600,PRINCETON THEOLOGICAL SEMINARY          ,NJ,08542-0000,Private      ,0,1,1,10,659,669
00262700,PRINCETON UNIVERSITY                    ,NJ,08544-0001,Private      ,10,10,20,17328,2002,19330
00262800,RIDER UNIVERSITY                        ,NJ,08648-3099,Private      ,12,23,35,8568,1975,10543
00262900,"RUTGERS, THE STATE UNIVERSITY OF NJ     ",NJ,08901-1281,Public       ,105,261,366,51136,27722,78858
00263200,SETON HALL UNIVERSITY                   ,NJ,07079-2697,Private      ,17,37,54,11434,4840,16274
00263201,SETON HALL UNIVERSITY - SCHOOL OF LAW   ,NJ,07079-5210,Private      ,0,12,12,318,2141,2459
00263800,SAINT PETER'S UNIVERSITY                ,NJ,07306-5997,Private      ,10,42,52,3156,2047,5203
00263900,STEVENS INSTITUTE OF TECHNOLOGY         ,NJ,07030-5370,Private      ,3,10,13,4512,755,5267
00264200,COLLEGE OF NEW JERSEY (THE)             ,NJ,08628-0718,Public       ,7,32,39,12321,1645,13966
00264300,UNION COUNTY COLLEGE                    ,NJ,07016-1598,Public       ,39,152,191,6247,9604,15851
00473600,BERGEN COMMUNITY COLLEGE                ,NJ,07652-1595,Public       ,55,87,142,9741,7075,16816
00474000,MERCER COUNTY COMMUNITY COLLEGE         ,NJ,08690-0000,Public       ,26,119,145,3953,5490,9443
00539900,MONMOUTH COUNTY VOCATIONAL SCH DIST     ,NJ,07728-5033,Public       ,0,1,1,72,172,244
00545200,TETERBORO SCH OF AERONAUTICS            ,NJ,07608-1083,Proprietary  ,9,7,16,152,227,379
00546100,SALEM COMMUNITY COLLEGE                 ,NJ,08069-2799,Public       ,9,27,36,721,971,1692
00641700,HOLY NAME HOSPITAL SCH OF NURSING       ,NJ,07666-4254,Private      ,1,9,10,107,307,414
00642000,MOUNTAINSIDE HOSP SCH NRSG              ,NJ,07042-4898,Proprietary  ,0,3,3,57,193,250
00642100,MUHLENBERG SNYDER SCHOOLS               ,NJ,07061-3399,Private      ,1,2,3,120,598,718
00642900,ST FRANCIS MEDICAL CTR SCH NURSING      ,NJ,08629-1986,Private      ,1,4,5,35,192,227
00642902,ST FRANCIS MED CTR RAD TECH             ,NJ,08629-0000,Private      ,0,3,3,17,85,102
00686500,CAMDEN COUNTY COLLEGE                   ,NJ,08012-3240,Public       ,68,214,282,7153,10428,17581
00690100,GLOUCESTER COUNTY COLLEGE               ,NJ,08080-4249,Public       ,57,95,152,4087,3904,7991
00710700,ESSEX COUNTY COLLEGE                    ,NJ,07102-1798,Public       ,50,151,201,6685,10888,17573
00750200,BERKELEY COLLEGE                        ,NJ,07424-3367,Proprietary  ,11,23,34,2545,3198,5743
00750201,BERKELEY COLLEGE - WOODBRIDGE           ,NJ,07095-3305,Proprietary  ,0,0,0,58,74,132
00750202,BERKELEY COLLEGE - PARAMUS              ,NJ,07652-2931,Proprietary  ,0,0,0,57,52,109
00750205,BERKELEY COLLEGE - CLIFTON              ,NJ,07011-2161,Proprietary  ,1,8,9,422,1082,1504
00750600,LINCOLN TECHNICAL INSTITUTE             ,NJ,07083-5032,Proprietary  ,55,79,134,944,1128,2072
00750601,LINCOLN TECHNICAL INSTITUTE             ,NJ,07430-0000,Proprietary  ,36,26,62,556,378,934
00759300,PARISIAN BEAUTY ACADEMY                 ,NJ,07601-5509,Proprietary  ,5,18,23,225,311,536
00772900,COUNTY COLLEGE OF MORRIS                ,NJ,07869-0000,Public       ,20,45,65,4272,2476,6748
00773000,BURLINGTON COUNTY COLLEGE               ,NJ,08068-1599,Public       ,37,139,176,4901,6189,11090
00773100,RARITAN VALLEY COMMUNITY COLLEGE        ,NJ,08876-1265,Public       ,39,50,89,3201,2768,5969
00780401,STAR CAREER ACADEMY - STAR LAKEWOOD     ,NJ,08701-5900,Proprietary  ,12,27,39,200,610,810
00780402,STAR CAREER ACADEMY - STAR EGG HARBOR   ,NJ,08234-4863,Proprietary  ,8,28,36,114,463,577
00794700,BETH MEDRASH GOVOHA OF AMERICA          ,NJ,08701-0000,Private      ,113,160,273,495,1986,2481
00840400,BROOKDALE COMMUNITY COLLEGE             ,NJ,07738-1597,Public       ,59,105,164,6772,5371,12143
00844101,ANTHEM INSTITUTE                        ,NJ,08002-0000,Proprietary  ,12,36,48,70,282,352
00849400,HO HO KUS SCHL OF TRADE & TECH SCIENCES ,NJ,07513-1402,Proprietary  ,16,17,33,158,335,493
00860900,RABBINICAL COLLEGE OF AMERICA           ,NJ,07960-3600,Private      ,33,2,35,108,14,122
00907800,CAPRI INSTITUTE OF HAIR DESIGN          ,NJ,07011-2111,Proprietary  ,2,15,17,136,335,471
00934400,RAMAPO COLLEGE OF NEW JERSEY            ,NJ,07430-1680,Public       ,14,23,37,8145,1692,9837
00934500,RICHARD STOCKTON COLLEGE OF NJ          ,NJ,08240-0000,Public       ,15,24,39,10471,3995,14466
00982804,EVEREST INSTITUTE - SOUTH PLAINFIELD    ,NJ,07080-1125,Proprietary  ,25,49,74,360,911,1271
00999400,PASSAIC COUNTY COMMUNITY COLLEGE        ,NJ,07505-1179,Public       ,38,130,168,4929,6901,11830
01039400,UNIV OF MEDICINE & DENTISTRY OF NJ      ,NJ,07107-0000,Public       ,5,71,76,484,6573,7057
01062900,P B COSMETOLOGY EDUCATION CENTRE        ,NJ,08030-1750,Proprietary  ,3,4,7,125,170,295
01085100,ANTHEM INSTITUTE                        ,NJ,07054-3409,Proprietary  ,50,102,152,456,1031,1487
01085101,ANTHEM INSTITUTE                        ,NJ,07306-0000,Proprietary  ,0,4,4,81,240,321
01085102,ANTHEM INSTITUTE                        ,NJ,08902-0000,Proprietary  ,1,4,5,87,209,296
01090300,RIZZIERI INSTITUTE                      ,NJ,08043-4600,Proprietary  ,4,9,13,169,249,418
01152300,MORRIS COUNTY SCHOOL OF TECHNOLOGY      ,NJ,07834-0000,Public       ,0,1,1,48,101,149
01170800,NATURAL MOTION INST OF HAIR DESIGN      ,NJ,07306-5496,Proprietary  ,4,15,19,72,150,222
01198900,TALMUDICAL ACADEMY                      ,NJ,07710-0000,Private      ,2,0,2,61,3,64
01209000,REIGNBOW BEAUTY ACADEMY                 ,NJ,08861-4118,Proprietary  ,1,16,17,98,196,294
01234602,DOVER BUSINESS COLLEGE                  ,NJ,07801-4643,Proprietary  ,1,4,5,168,477,645
01246100,LINCOLN TECHNICAL INSTITUTE             ,NJ,08820-2896,Proprietary  ,14,42,56,416,1035,1451
01246102,LINCOLN TECHNICAL INSTITUTE             ,NJ,08057-3212,Proprietary  ,21,50,71,332,1025,1357
01246103,LINCOLN TECHNICAL INSTITUTE             ,NJ,07652-2106,Proprietary  ,15,44,59,447,1013,1460
01246200,HOHOKUS - HACKENSACK SCHOOL OF BUSINESS ,NJ,07601-7197,Proprietary  ,0,31,31,157,727,884
01295400,HUDSON COUNTY COMMUNITY COLLEGE         ,NJ,07306-4012,Public       ,44,107,151,6211,8117,14328
02053700,EASTWICK COLLEGE                        ,NJ,07446-0000,Proprietary  ,11,37,48,432,1569,2001
02061800,ROMAN ACADEMY OF BEAUTY CULTURE         ,NJ,07506-0000,Proprietary  ,2,2,4,37,59,96
02092300,HOHOKUS SCHOOL - RETS/NUTLEY            ,NJ,07110-0000,Proprietary  ,14,38,52,259,703,962
02103700,CAPRI INSTITUTE OF HAIR DESIGN          ,NJ,07652-0000,Proprietary  ,0,13,13,94,157,251
02104000,HARRIS SCHOOL OF BUSINESS               ,NJ,08002-2983,Proprietary  ,47,197,244,505,2006,2511
02106601,AMERICAN INSTITUTE - CLIFTON            ,NJ,07011-2345,Proprietary  ,17,53,70,275,741,1016
02106605,AMERICAN INSTITUTE - TOMS RIVER         ,NJ,08755-1524,Proprietary  ,11,28,39,14,39,53
02131100,DU CRET SCHOOL OF THE ARTS              ,NJ,07060-0000,Private      ,1,0,1,45,28,73
02131600,PENNCO TECH                             ,NJ,08012-0000,Proprietary  ,25,66,91,515,1030,1545
02132300,BERDAN INSTITUTE                        ,NJ,07512-0000,Proprietary  ,20,60,80,356,811,1167
02146800,JOE KUBERT SCH OF CARTOON & GRAPHIC     ,NJ,07801-0000,Proprietary  ,0,1,1,85,93,178
02149800,EMPIRE BEAUTY SCHOOL                    ,NJ,08021-0000,Proprietary  ,8,16,24,126,356,482
02149801,EMPIRE BEAUTY SCHOOL - BORDENTOWN       ,NJ,08505-1513,Proprietary  ,1,2,3,29,79,108
02154000,DIVERS ACAD OF EASTERN SEABOARD         ,NJ,08081-1139,Proprietary  ,5,18,23,128,324,452
02183600,CAPRI INSTITUTE OF HAIR DESIGN          ,NJ,07033-0000,Proprietary  ,4,13,17,80,208,288
02192200,THOMAS EDISON STATE COLLEGE             ,NJ,08608-0000,Public       ,13,291,304,621,9368,9989
02219600,OMEGA INSTITUTE                         ,NJ,08109-0000,Proprietary  ,7,35,42,60,262,322
02223700,ROBERT FIANCE BEAUTY SCHOOLS            ,NJ,07093-4623,Proprietary  ,6,20,26,56,220,276
02223900,DRAKE COLLEGE OF BUSINESS               ,NJ,07201-0000,Proprietary  ,20,135,155,204,1325,1529
02223902,DRAKE COLLEGE OF BUSINESS - NEWARK CAMPU,NJ,07112-2760,Proprietary  ,41,257,298,452,2356,2808
02232500,UNION COUNTY VOCATIONAL TECH INST       ,NJ,07076-0000,Public       ,2,2,4,99,151,250
02234600,SHORE BEAUTY SCHOOL                     ,NJ,08232-0000,Proprietary  ,5,10,15,79,208,287
02246000,ROSS UNIVERSITY - MEDICAL SCHOOL        ,NJ,08837-0000,Proprietary  ,1,62,63,42,4388,4430
02248600,COOPER HEALTH SYS-CTR ALLIED HEALTH     ,NJ,08103-0000,Private      ,0,10,10,136,489,625
02252700,CONCORDE SCHOOL OF HAIR DESIGN          ,NJ,07712-0000,Proprietary  ,7,16,23,144,304,448
02252701,CONCORDE SCHOOL OF HAIR DESIGN - BLOOMFI,NJ,07003-2517,Proprietary  ,2,4,6,35,95,130
02261800,EUROPEAN ACADEMY OF COSMETOLOGY         ,NJ,07083-0000,Proprietary  ,6,14,20,90,202,292
02265500,CAPRI INSTITUTE OF HAIR DESIGN          ,NJ,08724-0000,Proprietary  ,5,13,18,91,214,305
02277900,ROSS UNIV - SCH OF VETERINARY MED       ,NJ,08837-0000,Proprietary  ,0,25,25,19,1598,1617
02291000,LINCOLN TECHNICAL INSTITUTE             ,NJ,07080-2424,Proprietary  ,19,15,34,235,305,540
02312000,BERGEN COUNTY TECHNICAL SCHOOLS         ,NJ,07601-6110,Public       ,1,4,5,97,228,325
02344200,EMPIRE BEAUTY SCHOOL                    ,NJ,08002-0000,Proprietary  ,5,21,26,132,366,498
02503900,WARREN COUNTY COMMUNITY COLLEGE         ,NJ,07882-0000,Public       ,10,22,32,851,855,1706
02523700,OCEAN COUNTY VOCATIONAL-TECH SCHOOL     ,NJ,08753-0000,Public       ,0,9,9,276,538,814
02525900,ARTISTIC ACADEMY OF HAIR DESIGN         ,NJ,07950-1409,Proprietary  ,2,4,6,133,159,292
02528200,REIGNBOW BEAUTY ACADEMY                 ,NJ,07060-0000,Proprietary  ,1,15,16,43,154,197
02558700,PRISM CAREER INSTITUTE                  ,NJ,08037-0000,Proprietary  ,3,16,19,168,751,919
02568800,SUSSEX COUNTY COMMUNITY COLLEGE         ,NJ,07860-1149,Public       ,13,31,44,1730,1334,3064
02586900,HARRIS SCHOOL OF BUSINESS               ,NJ,08043-2604,Proprietary  ,22,108,130,248,1236,1484
02616402,SANFORD-BROWN INSTITUTE - ISELIN        ,NJ,08830-0000,Proprietary  ,4,24,28,383,878,1261
03077500,RABBI JACOB JOSEPH SCHOOL               ,NJ,08817-4494,Private      ,1,1,2,35,7,42
03122600,EASTERN INTERNATIONAL COLLEGE           ,NJ,07306-3906,Proprietary  ,7,15,22,176,518,694
03187300,STENOTECH CAREER INSTITUTE              ,NJ,07004-3490,Proprietary  ,1,2,3,38,75,113
03197300,INSTITUTE FOR HEALTH EDUCATION(THE)     ,NJ,07306-2929,Proprietary  ,0,20,20,60,284,344
03324300,CENTRAL CAREER SCHOOL                   ,NJ,07080-2408,Proprietary  ,4,30,34,69,252,321
03380302,STAR CAREER ACADEMY - STAR NEWARK       ,NJ,07102-4510,Proprietary  ,22,96,118,283,1179,1462
03380303,STAR CAREER ACADEMY - STAR CLIFTON      ,NJ,07011-2248,Proprietary  ,5,17,22,114,467,581
03389300,ACADEMY OF MASSAGE THERAPY              ,NJ,07631-0000,Proprietary  ,2,9,11,61,157,218
03424500,NEW COMMUNITY WORKFORCE DEVELOPMENT     ,NJ,07103-2402,Private      ,2,98,100,67,719,786
03536300,INSTITUTE FOR THERAPEUTIC MASSAGE       ,NJ,07420-1452,Proprietary  ,2,4,6,34,149,183
03625300,PERFORMANCE TRAINING INSTITUTE          ,NJ,08753-0000,Proprietary  ,0,1,1,68,1016,1084
03650600,PC AGE                                  ,NJ,07306-3936,Proprietary  ,2,41,43,63,434,497
03650603,PC AGE                                  ,NJ,08817-2842,Proprietary  ,0,3,3,16,64,80
03666300,SOMERSET CHRISTIAN COLLEGE              ,NJ,08890-9035,Private      ,0,14,14,85,622,707
03803300,HEALTHCARE TRAINING INSTITUTE           ,NJ,07083-3504,Proprietary  ,1,9,10,111,494,605
03811300,EASTERN SCHOOL OF ACUPUNCTURE AND TRADIT,NJ,07042-3562,Proprietary  ,0,3,3,7,103,110
04081300,BAIS MEDRASH TORAS CHESED               ,NJ,08701-0000,Private      ,3,5,8,39,27,66
04123400,YESHIVAS BE'ER YITZCHOK                 ,NJ,07208-2380,Private      ,2,1,3,17,73,90
04125000,GENTLE HEALING SCHOOL OF MASSAGE        ,NJ,08512-3600,Proprietary  ,0,3,3,10,54,64
04131100,YESHIVA TORAS CHAIM                     ,NJ,08701-2120,Private      ,7,0,7,192,8,200
04131200,TOTAL IMAGE BEAUTY ACADEMY              ,NJ,07307-2943,Proprietary  ,1,9,10,29,139,168
04134100,CENTER FOR ALLIED HEALTH & NURSING EDUCA,NJ,07601-5801,Proprietary  ,3,176,179,181,2395,2576
04136400,AMERICAN INSTITUTE OF MEDICAL SCIENCES &,NJ,07080-1183,Proprietary  ,0,6,6,106,288,394
04154500,STARTING POINTS FOR CHILDREN            ,NJ,07306-0001,Private      ,0,13,13,16,161,177
04154900,NATIONAL CAREER INSTITUTE               ,NJ,07018-2011,Proprietary  ,2,26,28,30,291,321
04173100,LAB PAUL MITCHELL PARTNER SCHOOL (THE)  ,NJ,08628-2500,Proprietary  ,2,7,9,64,119,183
04180300,MESIVTA KESER TORAH                     ,NJ,07719-2409,Private      ,27,1,28,39,2,41
04181400,BEST CARE TRAINING INSTITUTE            ,NJ,07018-1703,Proprietary  ,0,8,8,30,275,305
04184500,CHRISTINE VALMY INTERNATIONAL SCHOOL OF ,NJ,07058-9589,Proprietary  ,5,11,16,41,91,132
04188700,ASI CAREER INSTITUTE                    ,NJ,08012-1043,Proprietary  ,1,11,12,25,247,272
04191400,SCHOOL OF COURT REPORTING (THE)         ,NJ,08053-1533,Proprietary  ,0,2,2,19,80,99
04192400,YESHIVA GEDOLAH ZICHRON LEYMA           ,NJ,07036-3905,Private      ,4,2,6,13,9,22
04207500,MEDICAL CAREER INSTITUTE                ,NJ,07712-7202,Proprietary  ,3,10,13,17,107,124
04216000,UNIVERSAL TRAINING INSTITUTE            ,NJ,08861-4106,Proprietary  ,5,34,39,5,34,39
04216100,YESHIVA YESODEI HATORAH                 ,NJ,08701-4946,Private      ,28,1,29,28,1,29
04216500,RIZZIERI INSTITUTE                      ,NJ,08043-1911,Proprietary  ,1,2,3,1,2,3
04218200,PAUL MITCHELL THE SCHOOL - JERSEY SHORE ,NJ,08723-3413,Proprietary  ,8,6,14,8,6,14
00266500,VAUGHN COLLEGE OF AERONAUTICS AND TECHNO,NY,11369-9997,Private      ,8,15,23,1478,1172,2650
00266600,ADELPHI UNIVERSITY                      ,NY,11530-4299,Private      ,27,32,59,9550,5266,14816
00266700,DOWLING COLLEGE                         ,NY,11769-1999,Private      ,3,18,21,2765,1715,4480
00266800,ALFRED UNIVERSITY                       ,NY,14802-1205,Private      ,5,10,15,3977,787,4764
00266900,BANK STREET COLLEGE OF EDUCATION        ,NY,10025-0000,Private      ,0,14,14,23,906,929
00267100,BARD COLLEGE                            ,NY,12504-5000,Private      ,1,0,1,2986,803,3789
00267400,NEW YORK THEOLOGICAL SEMINARY           ,NY,10115-0002,Private      ,0,6,6,4,325,329
00267700,BROOKLYN LAW SCHOOL                     ,NY,11201-0000,Private      ,1,29,30,128,3058,3186
00267800,BRYANT & STRATTON COLLEGE               ,NY,14203-1713,Proprietary  ,156,1119,1275,3350,18132,21482
00267803,BRYANT & STRATTON COLLEGE - GREECE      ,NY,14606-4227,Proprietary  ,13,105,118,417,1655,2072
00267805,BRYANT & STRATTON COLLEGE - SYRACUSE    ,NY,13203-2502,Proprietary  ,9,96,105,697,2024,2721
00267807,BRYANT & STRATTON COLLEGE - ALBANY      ,NY,12205-5230,Proprietary  ,7,52,59,315,1365,1680
00268100,CANISIUS COLLEGE                        ,NY,14208-1098,Private      ,4,24,28,5055,2276,7331
00268500,CAZENOVIA COLLEGE                       ,NY,13035-1085,Private      ,5,0,5,2093,244,2337
00268700,CUNY-BROOKLYN COLLEGE                   ,NY,11210-2814,Public       ,56,80,136,21167,14015,35182
00268800,CITY COLLEGE-CUNY                       ,NY,10031-9198,Public       ,62,97,159,23905,13444,37349
00268900,CUNY-HUNTER COLLEGE                     ,NY,10021-0000,Public       ,77,135,212,32603,19475,52078
00269000,QUEENS COLLEGE-CUNY                     ,NY,11367-1597,Public       ,63,68,131,20361,10638,30999
00269100,CUNY- BOROUGH OF MANHATTAN CMTY CLG     ,NY,10007-1047,Public       ,101,153,254,31647,19587,51234
00269200,CUNY BRONX COMMUNITY COLLEGE            ,NY,10453-3102,Public       ,36,71,107,13723,12107,25830
00269300,CUNY-JOHN JAY CLG CRIMINAL JUSTICE      ,NY,10019-1093,Public       ,47,76,123,18826,9844,28670
00269400,KINGSBOROUGH COMMUNITY COLLEGE          ,NY,11235-2398,Public       ,74,77,151,16590,10439,27029
00269600,NY CITY COLLEGE OF TECHNOLOGY-CUNY      ,NY,11201-2983,Public       ,73,82,155,19536,11447,30983
00269700,QUEENSBOROUGH COMMUNITY COLLEGE         ,NY,11364-1497,Public       ,78,63,141,16504,7969,24473
00269800,CUNY THE COLLEGE OF STATEN ISLAND       ,NY,10314-6600,Public       ,55,40,95,12904,5644,18548
00269900,CLARKSON UNIVERSITY                     ,NY,13699-5615,Private      ,1,2,3,5000,540,5540
00270000,COLGATE ROCHESTER CROZER DIVINITY S     ,NY,14620-0000,Private      ,0,2,2,6,106,112
00270100,COLGATE UNIVERSITY                      ,NY,13346-1386,Private      ,0,0,0,4358,102,4460
00270300,COLLEGE OF MOUNT SAINT VINCENT          ,NY,10471-1093,Private      ,3,5,8,2973,653,3626
00270400,COLLEGE OF NEW ROCHELLE                 ,NY,10805-2339,Private      ,15,98,113,1368,5251,6619
00270500,COLLEGE OF SAINT ROSE                   ,NY,12203-1490,Private      ,5,23,28,5523,2263,7786
00270700,COLUMBIA UNIVERSITY                     ,NY,10027-0000,Private      ,17,107,124,23415,24699,48114
00270800,BARNARD COLLEGE-COLUMBIA UNIV           ,NY,10027-6598,Private      ,2,9,11,4580,558,5138
00270900,CONCORDIA COLLEGE                       ,NY,10708-1998,Private      ,3,2,5,1005,633,1638
00271000,COOPER UNION                            ,NY,10003-7120,Private      ,1,2,3,2060,423,2483
00271100,CORNELL UNIVERSITY                      ,NY,14853-2801,Private      ,22,35,57,29504,7206,36710
00271101,WEILL CORNELL MEDICAL COLLEGE AND GRADUA,NY,10021-0000,Private      ,1,2,3,58,905,963
00271200,D'YOUVILLE COLLEGE                      ,NY,14201-1084,Private      ,2,11,13,2090,2479,4569
00271300,DOMINICAN COLLEGE                       ,NY,10962-1299,Private      ,7,28,35,2027,1132,3159
00271800,ELMIRA COLLEGE                          ,NY,14901-2099,Private      ,3,5,8,2409,484,2893
00272200,FORDHAM UNIVERSITY                      ,NY,10458-5157,Private      ,20,88,108,25835,10599,36434
00272600,GENERAL THEOLOGICAL SEMINARY            ,NY,10011-0000,Private      ,0,0,0,1,105,106
00272800,HAMILTON COLLEGE                        ,NY,13323-1218,Private      ,3,0,3,3162,77,3239
00272900,HARTWICK COLLEGE                        ,NY,13820-4020,Private      ,2,2,4,4251,202,4453
00273100,HOBART & WILLIAM SMITH COLLEGES         ,NY,14456-3397,Private      ,3,3,6,3688,112,3800
00273200,HOFSTRA UNIVERSITY                      ,NY,11549-1010,Private      ,23,33,56,17215,6455,23670
00273400,HOUGHTON COLLEGE                        ,NY,14744-0128,Private      ,0,1,1,1318,222,1540
00273500,HILBERT COLLEGE                         ,NY,14075-1597,Private      ,1,2,3,1229,415,1644
00273700,IONA COLLEGE                            ,NY,10801-1890,Private      ,10,11,21,8824,1415,10239
00273900,ITHACA COLLEGE                          ,NY,14850-7130,Private      ,9,4,13,14374,1078,15452
00274000,JEWISH THEOLOGICAL SEMINARY OF AMER     ,NY,10027-4649,Private      ,0,0,0,136,195,331
00274200,THE JUILLIARD SCHOOL                    ,NY,10023-6588,Private      ,3,3,6,1794,973,2767
00274400,KEUKA COLLEGE                           ,NY,14478-0000,Private      ,0,23,23,1464,1572,3036
00274800,LEMOYNE COLLEGE                         ,NY,13214-1399,Private      ,1,8,9,4666,1112,5778
00274900,NEW YORK COLLEGE OF PODIATRIC MED       ,NY,10035-1940,Private      ,0,1,1,37,438,475
00275100,LONG ISLAND UNIVERSITY                  ,NY,11548-1326,Private      ,29,82,111,14120,11935,26055
00275800,MANHATTAN COLLEGE                       ,NY,10471-4098,Private      ,7,10,17,6540,739,7279
00275900,MANHATTAN SCHOOL OF MUSIC               ,NY,10027-4689,Private      ,2,3,5,748,900,1648
00276000,MANHATTANVILLE COLLEGE                  ,NY,10577-2132,Private      ,5,16,21,3248,976,4224
00276300,MARIA COLLEGE                           ,NY,12208-1798,Private      ,0,9,9,304,1080,1384
00276500,MARIST COLLEGE                          ,NY,12601-1387,Private      ,6,13,19,11260,1699,12959
00276900,MARYMOUNT MANHATTAN COLLEGE             ,NY,10021-4597,Private      ,6,1,7,4078,422,4500
00277200,MERCY COLLEGE                           ,NY,10522-1189,Private      ,22,220,242,6558,9071,15629
00277500,MOLLOY COLLEGE                          ,NY,11570-1100,Private      ,8,22,30,3775,2482,6257
00277700,MEDAILLE COLLEGE                        ,NY,14214-2695,Private      ,5,36,41,1898,1935,3833
00277800,MOUNT SAINT MARY COLLEGE                ,NY,12550-3494,Private      ,1,17,18,4046,1351,5397
00277900,NAZARETH COLLEGE OF ROCHESTER           ,NY,14618-3790,Private      ,2,10,12,3749,1697,5446
00278200,NEW YORK INSTITUTE OF TECHNOLOGY        ,NY,11568-8000,Private      ,7,18,25,6463,3233,9696
00278202,NY INSTITUTE OF TECHNOLOGY-OSTEOPATHIC M,NY,11568-0000,Private      ,0,1,1,80,1217,1297
00278300,NEW YORK LAW SCHOOL                     ,NY,10013-0000,Private      ,2,3,5,86,3367,3453
00278400,NEW YORK MEDICAL COLLEGE                ,NY,10595-0000,Private      ,1,6,7,43,2171,2214
00278500,NEW YORK UNIVERSITY                     ,NY,10012-1091,Private      ,52,220,272,42717,33514,76231
00278800,NIAGARA UNIVERSITY                      ,NY,14109-2010,Private      ,5,9,14,4088,1044,5132
00279000,NYACK COLLEGE                           ,NY,10960-3698,Private      ,4,24,28,1625,2162,3787
00279100,PACE UNIVERSITY - NEW YORK              ,NY,10038-1598,Private      ,23,74,97,11568,4848,16416
00279101,PACE UNIVERSITY-PLEASANTVILLE           ,NY,10570-0000,Private      ,13,19,32,4406,1466,5872
00279102,PACE UNIVERSITY - WHITE PLAINS          ,NY,10603-0000,Private      ,0,17,17,738,2178,2916
00279500,PAUL SMITHS CLG OF ARTS & SCIENCES      ,NY,12970-0000,Private      ,2,1,3,1508,250,1758
00279600,POLYTECHNIC INTSTITUTE OF NEW YORK UNIV ,NY,11201-3840,Private      ,6,14,20,3808,1331,5139
00279800,PRATT INSTITUTE                         ,NY,11205-3899,Private      ,16,12,28,5673,2779,8452
00280300,RENSSELAER POLYTECHNIC INSTITUTE        ,NY,12180-3590,Private      ,4,5,9,11864,870,12734
00280500,ROBERTS WESLEYAN COLLEGE                ,NY,14624-1997,Private      ,2,27,29,1665,1539,3204
00280600,ROCHESTER INSTITUTE OF TECHNOLOGY       ,NY,14623-5608,Private      ,15,26,41,17414,3616,21030
00280700,ROCKEFELLER UNIVERSITY                  ,NY,10021-0000,Private      ,0,1,1,45,92,137
00280800,DAEMEN COLLEGE                          ,NY,14226-3592,Private      ,3,11,14,2898,1328,4226
00281000,THE SAGE COLLEGES                       ,NY,12180-4199,Private      ,6,10,16,2137,2190,4327
00281200,TROCAIRE COLLEGE                        ,NY,14220-2094,Private      ,3,9,12,856,1978,2834
00281300,SARAH LAWRENCE COLLEGE                  ,NY,10708-5999,Private      ,2,2,4,2161,753,2914
00281400,SKIDMORE COLLEGE                        ,NY,12866-1632,Private      ,2,1,3,4060,137,4197
00281500,ST BERNARDS SCH THEOLOGY & MINISTRY     ,NY,14618-3822,Private      ,0,0,0,2,48,50
00281600,SIENA COLLEGE                           ,NY,12211-1462,Private      ,1,1,2,7011,376,7387
00281700,ST BONAVENTURE UNIVERSITY               ,NY,14778-2284,Private      ,4,6,10,2898,574,3472
00282000,ST FRANCIS COLLEGE                      ,NY,11201-4398,Private      ,10,7,17,3300,923,4223
00282100,ST JOHN FISHER COLLEGE                  ,NY,14618-3597,Private      ,3,20,23,5154,2128,7282
00282200,CHRIST THE KING SEMINARY                ,NY,14052-0607,Private      ,0,0,0,1,14,15
00282300,ST JOHN'S UNIVERSITY                    ,NY,11439-1343,Private      ,45,52,97,29030,7861,36891
00282500,ST JOSEPH'S COLLEGE                     ,NY,11205-3688,Private      ,4,14,18,1865,1034,2899
00282501,ST JOSEPH'S COLLEGE-SUFFOLK CAMPUS      ,NY,11772-0000,Private      ,5,22,27,3459,1878,5337
00282900,ST LAWRENCE UNIVERSITY                  ,NY,13617-1455,Private      ,3,1,4,2922,171,3093
00283200,ST THOMAS AQUINAS COLLEGE               ,NY,10976-1050,Private      ,4,3,7,2107,329,2436
00283300,ST VLADIMIR ORTHODOX THEOL SEM          ,NY,10707-0000,Private      ,0,2,2,0,54,54
00283400,EXCELSIOR COLLEGE                       ,NY,12203-5159,Private      ,16,803,819,382,11986,12368
00283500,SUNY AT ALBANY                          ,NY,12222-0001,Public       ,28,41,69,22988,6030,29018
00283600,BINGHAMTON UNIVERSITY (SUNY)            ,NY,13902-6000,Public       ,26,17,43,26733,3508,30241
00283700,SUNY AT BUFFALO                         ,NY,14260-0001,Public       ,38,35,73,25442,10845,36287
00283800,SUNY AT STONY BROOK                     ,NY,11794-0701,Public       ,39,99,138,28953,9255,38208
00283900,SUNY-DOWNSTATE MEDICAL CENTER           ,NY,11203-2098,Public       ,2,15,17,289,2790,3079
00284000,SUNY UPSTATE MEDICAL UNIVERSITY         ,NY,13210-2375,Public       ,0,6,6,338,1696,2034
00284100,SUNY BROCKPORT - FIN AID OFF            ,NY,14420-2914,Public       ,16,22,38,10717,3441,14158
00284200,BUFFALO STATE COLLEGE - SUNY            ,NY,14222-1095,Public       ,39,68,107,15274,6149,21423
00284300,SUNY COLLEGE-CORTLAND                   ,NY,13045-0900,Public       ,17,8,25,12767,1647,14414
00284400,SUNY AT FREDONIA                        ,NY,14063-1145,Public       ,14,6,20,8051,1095,9146
00284500,SUNY GENESEO                            ,NY,14454-1401,Public       ,7,3,10,9599,695,10294
00284600,SUNY COLLEGE-NEW PALTZ                  ,NY,12561-2499,Public       ,13,11,24,12501,2499,15000
00284700,SUNY COLLEGE-ONEONTA                    ,NY,13820-4015,Public       ,14,9,23,12319,946,13265
00284800,SUNY OSWEGO                             ,NY,13126-3599,Public       ,12,20,32,11746,2277,14023
00284900,SUNY COLLEGE AT PLATTSBURGH             ,NY,12901-2681,Public       ,14,14,28,8804,1746,10550
00285000,SUNY COLLEGE-POTSDAM                    ,NY,13676-2294,Public       ,4,3,7,6152,1122,7274
00285100,SUNY COLLEGE OF ENVIRONMENT SCIENCE AND ,NY,13210-2778,Public       ,2,3,5,2473,674,3147
00285300,SUNY MARITIME COLLEGE                   ,NY,10465-4198,Public       ,3,2,5,1860,378,2238
00285400,SUNY COLLEGE OF TECHNOLOGY-ALFRED       ,NY,14802-9951,Public       ,11,11,22,4878,1180,6058
00285500,SUNY CANTON COLG OF TECHNOLOGY          ,NY,13617-1098,Public       ,7,7,14,4628,1958,6586
00285600,SUNY AG & TECH COLLEGE-COBLESKILL       ,NY,12043-9986,Public       ,8,4,12,3319,670,3989
00285700,SUNY DELHI                              ,NY,13753-1190,Public       ,11,14,25,4370,1294,5664
00285800,SUNY FARMINGDALE                        ,NY,11735-1021,Public       ,32,30,62,7814,3236,11050
00285900,SUNY COLLEGE OF AG & TECH AT MORRISVILLE,NY,13408-0901,Public       ,13,5,18,4172,1154,5326
00286000,ADIRONDACK COMMUNITY COLLEGE            ,NY,12804-2004,Public       ,4,16,20,2216,2112,4328
00286100,CAYUGA COMMUNITY COLLEGE                ,NY,13021-3099,Public       ,27,63,90,2161,2756,4917
00286200,BROOME COMMUNITY COLLEGE                ,NY,13902-0000,Public       ,21,39,60,3722,3298,7020
00286300,CORNING COMMUNITY COLLEGE               ,NY,14830-3297,Public       ,12,36,48,1980,2360,4340
00286400,DUTCHESS COMMUNITY COLLEGE              ,NY,12601-1595,Public       ,36,59,95,4338,2990,7328
00286600,FASHION INSTITUTE OF TECHNOLOGY         ,NY,10001-5992,Public       ,14,42,56,9981,4256,14237
00286700,SUNY FULTON MONTGOMERY COMM CLG         ,NY,12095-3790,Public       ,5,10,15,1989,1397,3386
00286800,HUDSON VALLEY COMMUNITY COLLEGE         ,NY,12180-6096,Public       ,21,44,65,7495,5630,13125
00286900,JAMESTOWN COMMUNITY COLLEGE             ,NY,14702-0020,Public       ,5,15,20,2786,2278,5064
00287000,JEFFERSON COMMUNITY COLLEGE             ,NY,13601-1897,Public       ,16,139,155,1768,3334,5102
00287100,"SUNY, MOHAWK VALLEY COMMUNITY CLG       ",NY,13501-5394,Public       ,5,35,40,4949,4483,9432
00287200,MONROE COMMUNITY COLLEGE                ,NY,14623-5780,Public       ,34,81,115,11558,11906,23464
00287300,NASSAU COMMUNITY COLLEGE                ,NY,11530-6793,Public       ,80,131,211,14430,8697,23127
00287400,NIAGARA COUNTY COMMUNITY COLLEGE        ,NY,14132-9460,Public       ,18,18,36,4428,3332,7760
00287500,ONONDAGA COMMUNITY COLLEGE              ,NY,13215-4585,Public       ,31,86,117,7957,5721,13678
00287600,ORANGE COUNTY COMMUNITY COLLEGE         ,NY,10940-6441,Public       ,19,44,63,3579,3104,6683
00287700,ROCKLAND COMMUNITY COLLEGE              ,NY,10901-3611,Public       ,19,24,43,3163,2506,5669
00287800,SUFFOLK COMMUNITY COLLEGE               ,NY,11784-2899,Public       ,33,59,92,8089,4571,12660
00287801,SUFFOLK COMMUNITY CLG-W. CAMPUS         ,NY,11717-0000,Public       ,33,43,76,5733,4209,9942
00287803,SUFFOLK COMMUNITY CLG-EASTRN CAMPUS     ,NY,11901-0000,Public       ,8,19,27,2113,1552,3665
00287900,SULLIVAN COUNTY COMMUNITY COLLEGE       ,NY,12759-5151,Public       ,6,8,14,1721,958,2679
00288000,ULSTER COUNTY COMMUNITY COLLEGE         ,NY,12484-0557,Public       ,5,23,28,1493,1341,2834
00288100,SUNY WESTCHESTER COMMUNITY COLLEGE      ,NY,10595-1698,Public       ,49,110,159,7237,6247,13484
00288200,SYRACUSE UNIVERSITY                     ,NY,13244-2130,Private      ,25,124,149,25888,7605,33493
00288300,UTICA COLLEGE- UTICA                    ,NY,13502-4892,Private      ,4,28,32,3905,2335,6240
00288500,ALBANY COLLEGE OF PHARMACY AND HEALTH SC,NY,12208-3492,Private      ,2,3,5,2012,1047,3059
00288600,ALBANY LAW SCHOOL                       ,NY,12208-0000,Private      ,0,1,1,89,1348,1437
00288700,ALBANY MEDICAL COLLEGE                  ,NY,12208-0000,Private      ,0,6,6,148,1260,1408
00288900,UNION COLLEGE                           ,NY,12308-2311,Private      ,3,0,3,4007,183,4190
00289000,UNION THEOLOGICAL SEMINARY              ,NY,10027-0000,Private      ,0,1,1,2,368,370
00289200,UNITED STATES MERCHANT MARINE ACADEMY   ,NY,11024-1699,Public       ,0,1,1,477,29,506
00289400,UNIVERSITY OF ROCHESTER                 ,NY,14627-9000,Private      ,5,55,60,9744,2344,12088
00289401,EASTMAN SCH OF MUSIC/UNIV ROCHESTER     ,NY,14604-0000,Private      ,0,5,5,948,470,1418
00289402,UNIV OF ROCHESTER SCHL OF MEDICINE      ,NY,14642-0000,Private      ,1,5,6,99,847,946
00289500,VASSAR COLLEGE                          ,NY,12604-0008,Private      ,3,2,5,5422,223,5645
00289600,VILLA MARIA COLLEGE-BUFFALO             ,NY,14225-3999,Private      ,1,1,2,467,394,861
00289900,WAGNER COLLEGE                          ,NY,10301-4495,Private      ,7,9,16,3109,715,3824
00290000,WEBB INSTITUTE                          ,NY,11542-1398,Private      ,2,0,2,76,14,90
00290100,WELLS COLLEGE                           ,NY,13026-0500,Private      ,1,0,1,1418,113,1531
00290300,YESHIVA UNIVERSITY                      ,NY,10033-3201,Private      ,3,9,12,2512,3344,5856
00290302,YESHIVA UNIVERSITY - BRONX CAMPUS       ,NY,10461-1975,Private      ,0,4,4,106,1426,1532
00397400,MESIVTHA TIFERETH JERUSALEM OF AMER     ,NY,10002-6382,Private      ,0,0,0,35,2,37
00397600,RABBINICAL ACAD MESIVTA RABBI CHAIM     ,NY,11230-4715,Private      ,3,1,4,38,4,42
00397700,RABBINICAL COLLEGE CH'SAN SOFER         ,NY,11204-1252,Private      ,0,0,0,1,24,25
00397800,RABBINICAL SEMINARY OF AMERICA          ,NY,11375-0000,Private      ,21,8,29,69,40,109
00397900,COLUMBIA UNIV TEACHERS COLLEGE          ,NY,10027-0000,Private      ,0,163,163,153,6157,6310
00405400,HEBREW UNION COL-JEWISH INST OF REL     ,NY,10012-0000,Private      ,0,1,1,0,243,243
00475900,"CUNY, YORK COLLEGE                      ",NY,11451-0001,Public       ,42,44,86,12917,7324,20241
00476500,CUNY GRADUATE SCH & UNIV CTR            ,NY,10016-4309,Public       ,1,42,43,177,3686,3863
00477600,CENTRAL YESHIVA TOMCHEI TMIMIM LUBA     ,NY,11230-2798,Private      ,139,9,148,508,49,557
00478800,HERKIMER COUNTY COMMUNITY COLLEGE       ,NY,13350-1598,Public       ,7,9,16,2805,1682,4487
00479800,MIRRER YESHIVA CENTRAL INST             ,NY,11223-2010,Private      ,6,2,8,81,34,115
00479900,MONROE COLLEGE                          ,NY,10468-4305,Proprietary  ,78,229,307,5027,7216,12243
00481100,EVEREST INSTITUTE                       ,NY,14621-3007,Proprietary  ,12,59,71,261,1390,1651
00506400,SAINT JAMES MERCY HOSPITAL SCHOOL OF RAD,NY,14843-2197,Private      ,0,0,0,19,27,46
00506600,FAXTON ST. LUKE'S SCHOOL OF RADIOGRAPHY ,NY,13502-4856,Private      ,0,0,0,28,62,90
00520800,THE COLLEGE OF WESTCHESTER              ,NY,10602-0000,Proprietary  ,15,32,47,1064,1072,2136
00587700,ROBERT J HOCHSTIM SCHOOL OF RADIOG      ,NY,11572-1151,Private      ,0,0,0,2,18,20
00643501,ARNOT OGDEN MEDICAL CENTER              ,NY,14905-1676,Private      ,1,0,1,61,78,139
00643800,PHILLIPS BETH ISRAEL SCH OF NURSING     ,NY,10001-6354,Private      ,0,10,10,104,479,583
00644300,COCHRAN SCH NSG-ST JOHN RVSDE HOSP      ,NY,10701-1399,Private      ,0,2,2,45,230,275
00644500,CROUSE HOSP SCH OF NURSING              ,NY,13210-1690,Private      ,0,5,5,241,490,731
00644800,ELLIS HOSPITAL SCHOOL OF NURSING        ,NY,12308-0000,Private      ,0,1,1,80,245,325
00646101,ST ELIZABETH COLLEGE OF NURSING         ,NY,13501-2998,Private      ,0,1,1,147,244,391
00646102,ST ELIZABETH SCH OF RADIOGRAPHY         ,NY,13501-0000,Private      ,0,0,0,33,56,89
00646700,SAINT JOSEPH'S COLLEGE OF NURSING       ,NY,13203-1806,Private      ,0,2,2,253,435,688
00678200,GENESEE COMMUNITY COLLEGE               ,NY,14020-9704,Public       ,14,61,75,3399,3159,6558
00678500,SCHENECTADY COUNTY COMMUNITY CLG        ,NY,12305-2294,Public       ,6,33,39,2544,3067,5611
00678700,CLINTON COMMUNITY COLLEGE               ,NY,12901-5690,Public       ,7,5,12,1445,899,2344
00678800,TOMPKINS CORTLAND COMMUNITY COLLEGE     ,NY,13053-8504,Public       ,14,19,33,3274,1937,5211
00678900,COLUMBIA-GREENE COMMUNITY COLLEGE       ,NY,12534-9543,Public       ,16,32,48,1122,1080,2202
00679100,SUNY AT PURCHASE                        ,NY,10577-1400,Public       ,19,8,27,8577,1317,9894
00702200,CUNY-LEHMAN COLLEGE                     ,NY,10468-1589,Public       ,37,86,123,15736,13787,29523
00702600,MOUNT SINAI SCHOOL OF MEDICINE          ,NY,10029-0000,Private      ,1,2,3,63,1125,1188
00710900,SUNY COLLEGE-OLD WESTBURY               ,NY,11568-0210,Public       ,15,20,35,6725,2679,9404
00711100,NORTH COUNTRY COMMUNITY COLLEGE         ,NY,12983-2046,Public       ,2,2,4,839,770,1609
00726400,MESIFTA TORAH VODAATH RABBINCAL SEM     ,NY,11218-5209,Private      ,5,3,8,22,57,79
00727300,CUNY-BERNARD BARUCH COLLEGE             ,NY,10010-5518,Public       ,46,103,149,21148,11656,32804
00730400,CULINARY INSTITUTE OF AMERICA           ,NY,12538-1499,Private      ,55,44,99,4034,1921,5955
00732916,ITT TECHNICAL INSTITUTE                 ,NY,12205-1003,Proprietary  ,9,66,75,200,706,906
00737200,AUSTIN'S SCHOOL OF SPA TECHNOLOGY       ,NY,12206-1513,Proprietary  ,4,40,44,187,523,710
00737500,ISLAND DRAFTING & TECHNICAL INST        ,NY,11701-2704,Proprietary  ,1,2,3,69,91,160
00738700,LONG ISLAND BEAUTY SCHOOL               ,NY,11788-4346,Proprietary  ,10,22,32,202,415,617
00738800,LONG ISLAND BEAUTY SCHOOL               ,NY,11550-3704,Proprietary  ,3,11,14,78,197,275
00739100,BEAUTY SCHOOL OF MIDDLETOWN             ,NY,10940-6574,Proprietary  ,2,5,7,53,110,163
00739400,BERKELEY COLLEGE                        ,NY,10017-0000,Proprietary  ,19,37,56,3895,5047,8942
00739402,BERKELEY COLLEGE  -  WESTCHESTER CAMPUS ,NY,10601-9963,Proprietary  ,0,0,0,91,50,141
00740100,MANDL SCHOOL                            ,NY,10019-5516,Proprietary  ,11,61,72,339,1229,1568
00740500,WOOD TOBE-COBURN SCHOOL                 ,NY,10016-0102,Proprietary  ,1,1,2,674,170,844
00746500,AMERICAN ACADEMY OF DRAMATIC ARTS       ,NY,10016-7089,Private      ,5,2,7,1002,467,1469
00746600,LIM COLLEGE                             ,NY,10022-5268,Proprietary  ,6,1,7,2474,581,3055
00746800,SCHOOL OF VISUAL ARTS                   ,NY,10010-3994,Proprietary  ,8,20,28,4577,2011,6588
00750602,LINCOLN TECHNICAL INSTITUTE             ,NY,11357-6092,Proprietary  ,24,33,57,804,533,1337
00751800,APEX TECHNICAL SCHOOL                   ,NY,10011-0000,Proprietary  ,47,168,215,700,2195,2895
00752200,CONTINENTAL SCH OF BEAUTY CULTURE       ,NY,14623-3231,Proprietary  ,18,49,67,283,691,974
00752205,CONTINENTAL SCHOOL OF BEAUTY CULTURE - M,NY,13211-1003,Proprietary  ,3,5,8,30,62,92
00753200,FINGER LAKES COMMUNITY COLLEGE          ,NY,14424-8395,Public       ,16,45,61,3835,3165,7000
00757200,AMERICAN MUSICAL AND DRAMATIC ACAD      ,NY,10023-2106,Private      ,9,6,15,2801,643,3444
00757300,EMPIRE BEAUTY SCHOOL                    ,NY,11103-4028,Proprietary  ,6,24,30,210,405,615
00780400,STAR CAREER ACADEMY                     ,NY,10011-7307,Proprietary  ,24,150,174,259,1223,1482
00818900,CONTINENTAL SCHOOL OF BEAUTY CULTURE - B,NY,14224-3402,Proprietary  ,3,5,8,61,110,171
00818903,CONTINENTAL SCHOOL OF BEAUTY CULTURE - B,NY,14223-2911,Proprietary  ,5,7,12,87,228,315
00843700,CHAMPLAIN VALLEY - TEC/PRN              ,NY,12901-0000,Public       ,2,2,4,38,84,122
00849500,JAMESTOWN BUSINESS COLLEGE              ,NY,14702-0429,Proprietary  ,2,14,16,198,338,536
00861100,"CUNY, HOSTOS CMTY COLLEGE               ",NY,10451-1499,Public       ,29,50,79,9403,8796,18199
00861400,RABBINICAL CLG BOBOVER YESHIVA BNEI     ,NY,11219-3293,Private      ,29,13,42,161,64,225
00861700,RABBINICAL SEM MKOR CHAIM-YESHIVA       ,NY,11219-4300,Private      ,9,2,11,11,5,16
00878800,STATE UNIVERSITY OF NEW YORK STUDENT LOA,NY,12246-0000,Public       ,2,5,7,622,442,1064
00900300,OLEAN BUSINESS INSTITUTE INC            ,NY,14760-2691,Proprietary  ,0,0,0,22,91,113
00902900,NEIGHBORHOOD PLAYHOUSE                  ,NY,10022-5017,Private      ,0,0,0,26,53,79
00904300,ELMIRA BUSINESS INSTITUTE               ,NY,14901-2731,Proprietary  ,13,93,106,134,1008,1142
00907700,UTICA SCHOOL OF COMMERCE                ,NY,13501-2280,Proprietary  ,1,39,40,137,549,686
00924800,SAMARITAN HOSPITAL SCH NURSING          ,NY,12180-2475,Private      ,0,2,2,91,300,391
00928300,MIDWAY-PARIS BEAUTY SCHOOL              ,NY,11385-3453,Proprietary  ,3,9,12,32,124,156
00928400,BRITTANY BEAUTY SCHOOL                  ,NY,11756-1345,Proprietary  ,6,37,43,112,361,473
00933500,MESIVTA EASTERN PKWY RABBINICAL CLG     ,NY,11218-5559,Private      ,3,0,3,29,9,38
00947900,SAINT VINCENTS CMC SI NURSING SCHOOL    ,NY,10304-3850,Proprietary  ,8,21,29,377,822,1199
00976900,METROPOLITAN COLLEGE OF NEW YORK        ,NY,10013-1919,Private      ,1,23,24,365,2148,2513
00992900,SUNY COLLEGE OF OPTOMETRY               ,NY,10036-8003,Public       ,0,0,0,30,379,409
01005100,LA GUARDIA CMTY COLLEGE - CUNY          ,NY,11101-3083,Public       ,66,86,152,18678,12987,31665
01005200,JEFFERSON-LEWIS BOCES PRAC NRSGPRG      ,NY,13601-9509,Public       ,0,3,3,34,217,251
01009700,CUNY-MEDGAR W EVERS COLLEGE             ,NY,11225-2010,Public       ,29,38,67,8038,7466,15504
01014200,TOURO COLLEGE                           ,NY,10010-4202,Private      ,41,96,137,3980,11122,15102
01014700,WESTERN SUFFOLK BOCES                   ,NY,11768-3499,Public       ,2,6,8,196,504,700
01015300,HELENE FULD COL OF NRSNG/N GEN HOSP     ,NY,10035-0000,Private      ,1,37,38,36,796,832
01028600,EMPIRE STATE COLLEGE                    ,NY,12866-4391,Public       ,8,126,134,1169,14285,15454
01037800,RABBINICAL COLLEGE OF LONG ISLAND       ,NY,11561-3244,Private      ,9,0,9,58,0,58
01054900,KEHILATH YAKOV RABBINICAL SEMINARY      ,NY,10562-1001,Private      ,12,7,19,65,31,96
01055100,NEW YORK SCH MED & DENTAL ASSISTANT     ,NY,11101-2327,Proprietary  ,8,40,48,188,394,582
01064100,SOUTHERN WESTCHESTER BOCES              ,NY,10543-0000,Public       ,0,1,1,27,238,265
01068400,ERIE COMMUNITY COLLEGE-ALL CAMPUSES     ,NY,14203-2698,Public       ,32,55,87,9152,9397,18549
01081300,AMERICAN ACAD MCALLISTER INST           ,NY,10019-3604,Private      ,0,10,10,132,605,737
01083700,SIMMONS INST OF FUNERAL SERVICE         ,NY,13207-2098,Proprietary  ,0,0,0,21,68,89
01093000,SUBURBAN TECHNICAL SCHOOL               ,NY,11550-3771,Proprietary  ,0,0,0,2,13,15
01094300,RABBINICAL COLLEGE BETH SHRAGA          ,NY,10952-3033,Private      ,1,0,1,15,0,15
01095200,PNW BOCES LPN PROGRAM                   ,NY,10598-0000,Public       ,0,2,2,16,68,84
01103100,TECHNICAL CAREER INSTITUTE              ,NY,10001-2789,Proprietary  ,88,221,309,1849,4571,6420
01118900,UNITED TALMUDICAL SEMINARY              ,NY,11211-7984,Private      ,102,32,134,958,524,1482
01119200,BETH HAMEDRASH SHAAREI YOSHER INST      ,NY,11204-1052,Private      ,4,0,4,13,21,34
01161400,CHAMPLAIN VALLEY HOSP SCH RAD TECH      ,NY,12901-1490,Private      ,1,0,1,30,35,65
01161700,NEW YORK METHODIST HOSPITAL             ,NY,11229-9023,Private      ,2,7,9,173,596,769
01164700,SBI CAMPUS - AN AFFILIATE OF SANFORD-BRO,NY,11747-3785,Proprietary  ,9,18,27,244,585,829
01167000,YESHIVA OF NITRA RABBINICAL COLLEGE -   ,NY,10549-4112,Private      ,46,13,59,159,26,185
01167700,MEMORIAL SLOAN KETTERING CANCER CTR     ,NY,10021-6094,Private      ,0,1,1,9,45,54
01167800,SUNY INST OF TECHNOLOGY UTICA ROME      ,NY,13504-3050,Public       ,4,5,9,2112,1368,3480
01182100,YESHIVATH ZICHRON MOSHE                 ,NY,12779-0580,Private      ,16,0,16,119,3,122
01183000,BERK TRADE AND BUSINESS SCHOOL          ,NY,11101-0000,Proprietary  ,4,19,23,105,250,355
01185900,WORD OF LIFE BIBLE INSTITUTE            ,NY,12860-0129,Private      ,1,0,1,541,83,624
01186000,MERCY MED CNTR SCHL OF RADIOGRAPHY      ,NY,11570-1098,Private      ,0,0,0,17,34,51
01192100,WESTCHESTER SCH OF BEAUTY CULTURE       ,NY,10550-2295,Proprietary  ,2,9,11,54,169,223
01192200,BETH HATALMUD RABBINICAL CLG            ,NY,11214-2594,Private      ,3,1,4,28,14,42
01198400,OHR HAMEIR THEOLOGICAL SEMINARY         ,NY,10566-0990,Private      ,8,0,8,73,2,75
01201100,TALMUDICAL SEM OHOLEI TORAH             ,NY,11213-3310,Private      ,46,0,46,286,1,287
01207200,PHILLIPS HAIRSTYLING INSTITUTE          ,NY,13210-1509,Proprietary  ,0,0,0,13,54,67
01210700,INSTITUTE OF DESIGN & CONSTRUCTION      ,NY,11201-5380,Private      ,2,4,6,79,197,276
01220300,MEMORIAL HOSPITAL SCH OF NURSING        ,NY,12204-1083,Private      ,1,5,6,76,247,323
01227700,NEW YORK CHIROPRACTIC COLLEGE           ,NY,13148-0800,Private      ,0,4,4,9,901,910
01229300,VEEB NASSAU CNTY SCHL OF PRACT NURS     ,NY,11553-3037,Public       ,0,3,3,84,312,396
01235800,PLAZA COLLEGE                           ,NY,11372-6300,Proprietary  ,19,62,81,411,1088,1499
01236400,SAINT VINCENTS CATHOLIC MEDICAL CENTERS ,NY,11354-0000,Proprietary  ,5,9,14,139,719,858
01240700,SCHUYLER-CHEMUNG-TIOGA BOCES            ,NY,14903-1089,Public       ,0,2,2,31,180,211
01240701,STEUBEN SCHUYLER CHEMUNG TIOGA ALLEGANY ,NY,14870-9518,Public       ,0,1,1,2,13,15
01256100,FIVE TOWNS COLLEGE                      ,NY,11746-5871,Proprietary  ,7,6,13,1230,333,1563
01258900,ERIE 1 BOCES                            ,NY,14224-0000,Public       ,1,1,2,126,375,501
01265200,ONONDAGA CORTLAND MADISON BOCES         ,NY,13090-4500,Public       ,2,7,9,235,928,1163
01278300,OSWEGO COUNTY BOCES ADULT CAREERS       ,NY,13114-4498,Public       ,0,0,0,31,77,108
01292700,CENTRAL TECH NURSING PROGRAM            ,NY,13202-3092,Public       ,0,2,2,43,173,216
01302600,MACHZIKEI HADATH RABBINICAL COLLEGE     ,NY,11204-1805,Private      ,54,37,91,65,58,123
01302700,YESHIVATH VIZNITZ                       ,NY,10952-3021,Private      ,164,175,339,194,179,373
01302900,BORICUA COLLEGE                         ,NY,10032-1599,Private      ,2,8,10,642,1450,2092
02056400,CAPRI COSMETOLOGY LEARNING CENTER       ,NY,10954-0000,Proprietary  ,5,15,20,139,275,414
02066200,THE NEW SCHOOL                          ,NY,10011-0000,Private      ,21,40,61,6200,6517,12717
02069000,NEW YORK SCHOOL OF INTERIOR DESIGN      ,NY,10021-0000,Private      ,1,9,10,285,494,779
02075700,BRIARCLIFFE COLLEGE                     ,NY,11714-0000,Proprietary  ,12,51,63,766,1488,2254
02075702,BRIARCLIFFE COLLEGE - PATCHOGUE         ,NY,11772-3019,Proprietary  ,5,23,28,653,919,1572
02092400,RIDLEY-LOWELL SCHOOL OF BUSINESS        ,NY,13905-0000,Proprietary  ,4,40,44,78,369,447
02093700,LONG ISLAND BUSINESS INSTITUTE          ,NY,11725-0000,Proprietary  ,52,152,204,346,972,1318
02093701,LONG ISLAND BUSINESS INSTITUTE - FLUSHIN,NY,11354-4429,Proprietary  ,1,2,3,135,436,571
02098400,HERKIMER COUNTY BOCES                   ,NY,13350-0000,Public       ,0,2,2,36,154,190
02104300,OTSEGO AREA SCHOOL OF PRAC NURSING      ,NY,12167-0000,Public       ,0,0,0,16,33,49
02105900,HAIR DESIGN INSTITUTE AT FIFTH AVE      ,NY,11220-0000,Proprietary  ,21,45,66,190,439,629
02106800,BRAMSON ORT COLLEGE                     ,NY,11375-0000,Private      ,23,68,91,432,883,1315
02110900,CATTARAUGUS/ALLEGANY BOCES              ,NY,14760-0000,Public       ,0,0,0,37,154,191
02112301,RIDLEY - LOWELL BUSINESS & TECHNICAL INS,NY,12601-3328,Proprietary  ,7,28,35,194,774,968
02116011,SANFORD-BROWN INSTITUTE - NEW YORK      ,NY,10003-2103,Proprietary  ,9,37,46,664,1927,2591
02118700,LONG ISLAND COLLEGE HOSPITAL - SCHOOL OF,NY,11201-6001,Private      ,3,4,7,190,376,566
02118702,LONG ISLAND COLLEGE HOSPITAL - SCHOOL OF,NY,11201-6001,Private      ,1,4,5,201,405,606
02124000,ORANGE ULSTER BOCES SCH OF PRAC NRS     ,NY,10924-9401,Public       ,0,2,2,47,192,239
02125500,CIRCLE IN THE SQUARE THEATRE SCHOOL     ,NY,10019-0000,Private      ,0,1,1,88,94,182
02126300,MADISON-ONEIDA BOCES PRAC NRS           ,NY,13478-0000,Public       ,0,1,1,13,96,109
02138500,BOCES RENSSELAER SCHOOL OF PN           ,NY,12033-3221,Public       ,0,0,0,33,84,117
02145800,CAYUGA ONONDAGA BOCES                   ,NY,13021-9430,Public       ,0,0,0,35,124,159
02146000,WAYNE-FINGER LAKES BOCES                ,NY,14513-0000,Public       ,0,3,3,39,310,349
02152000,YESHIVA SHAAR HATORAH ITRI TORAH        ,NY,11418-0000,Private      ,2,0,2,15,1,16
02153600,BROOME-TIOGA BOCES PN PROG              ,NY,13905-0000,Public       ,0,4,4,48,187,235
02157900,ROCHESTER GENERAL HOSPITAL              ,NY,14621-3001,Private      ,0,5,5,46,167,213
02158200,WSHNGTN-SARTGA-WARN-HMLTN-ESX BOCES     ,NY,12839-1051,Public       ,0,4,4,25,114,139
02160100,GENEVA GENERAL HOSPITAL                 ,NY,14456-0000,Private      ,2,3,5,50,185,235
02163400,NEW YORK CAREER INSTITUTE               ,NY,10007-2801,Proprietary  ,2,4,6,280,887,1167
02169100,DAVIS COLLEGE                           ,NY,13790-0000,Private      ,1,7,8,185,144,329
02170000,SWEDISH INSTITUTE                       ,NY,10001-0000,Proprietary  ,10,46,56,217,995,1212
02170200,ALBANY SCHOHARIE SCHENECTADY            ,NY,12205-0000,Public       ,1,2,3,69,186,255
02171900,AILEY SCHOOL (THE)                      ,NY,10019-4402,Private      ,2,3,5,172,129,301
02172100,HAMILTON-FULTON-MONTGOMERY BOCES        ,NY,12095-0665,Public       ,1,2,3,54,109,163
02172800,DUTCHESS COUNTY BOCES SCH PRAC NURS     ,NY,12601-0000,Public       ,0,2,2,97,271,368
02173200,EMPIRE BEAUTY SCHOOL                    ,NY,10001-0000,Proprietary  ,34,73,107,673,1062,1735
02173900,ULSTER COUNTY BOCES PRACTICAL NRSG      ,NY,12466-0000,Public       ,0,1,1,53,206,259
02176000,CHERYL FELL'S SCHOOL OF BUSINESS        ,NY,14304-0000,Proprietary  ,1,6,7,17,89,106
02179400,EASTERN SUFFOLK BOCES                   ,NY,11713-0000,Public       ,2,2,4,216,407,623
02182200,NEW SCHOOL OF RADIO & TELEVISION        ,NY,12206-1106,Proprietary  ,1,1,2,88,134,222
02187300,DARKEI NOAM RABBINICAL COLLEGE          ,NY,11210-0000,Private      ,0,0,0,2,6,8
02191600,TORAH TEMIMAH TALMUDICAL SEMINARY       ,NY,11218-0000,Private      ,13,1,14,71,5,76
02192500,BELLEVUE HOSP CTR SCH RAD TECH          ,NY,10016-0000,Public       ,1,3,4,25,152,177
02199300,ORLEANS-NIAGARA BOCES                   ,NY,14132-0000,Public       ,1,9,10,26,107,133
02206000,HUNTER BUSINESS SCHOOL                  ,NY,11756-0000,Proprietary  ,19,43,62,295,850,1145
02217800,D.HOPFER SCH NURSING AT MT.VRN HOSP     ,NY,10550-0000,Private      ,0,1,1,50,302,352
02219500,MILDRED ELLEY                           ,NY,12206-1513,Proprietary  ,27,163,190,495,2702,3197
02235600,ERIE 2-CHAUTAUQUA-CATTARAUGUS BOCES     ,NY,14006-0000,Public       ,0,1,1,35,120,155
02265100,YESHIVA DERECH CHAIM                    ,NY,11218-0000,Private      ,4,1,5,55,20,75
02265200,GLOBAL BUSINESS INSTITUTE               ,NY,11691-0000,Private      ,0,5,5,99,636,735
02272900,ROCKLAND COUNTY BOCES PRAC NRSG SCH     ,NY,10994-0000,Public       ,0,1,1,48,137,185
02275900,"MODERN WELDING SCHOOL, INC.             ",NY,12304-0000,Proprietary  ,3,11,14,62,158,220
02287800,NATIONAL TRACTOR TRAILER SCHOOL         ,NY,13088-2505,Proprietary  ,2,22,24,80,642,722
02294900,INSTITUTE OF AUDIO RESEARCH             ,NY,10003-0000,Proprietary  ,13,12,25,392,559,951
02306500,PROFESSIONAL BUSINESS INSTITUTE         ,NY,10002-0000,Private      ,75,154,229,709,1459,2168
02314200,NORTHERN WESTCHESTER SCH COSMETOL       ,NY,10566-0000,Proprietary  ,3,4,7,42,67,109
02320100,OHR SOMAYACH TANENBAUM EDUCATIONAL CENTE,NY,10952-0000,Private      ,0,0,0,2,2,4
02325600,NEW YORK INSTITUTE OF ENGLISH & BUS     ,NY,10001-0000,Private      ,0,0,0,15,25,40
02350600,YESHIVA AND KOLLEL HARBOTZAS TORAH      ,NY,11230-0000,Private      ,0,2,2,2,34,36
02491400,SPANISH AMERICAN INSTITUTE              ,NY,10036-0000,Private      ,0,1,1,7,30,37
02505800,YESHIVA KARLIN STOLIN RAB INSTITUTE     ,NY,11204-0000,Private      ,3,6,9,45,65,110
02505900,SH-OR YOSHUV RABBINICAL COLLEGE         ,NY,11691-0000,Private      ,16,4,20,46,15,61
02506000,ASSOCIATED BETH RIVKAH SCHOOLS          ,NY,11225-0000,Private      ,1,0,1,118,22,140
02506100,CITY UNIV OF NEW YORK-CENTRAL           ,NY,10021-0000,Public       ,9,21,30,2371,1724,4095
02506800,YESHIVAT MIKDASH MELECH                 ,NY,11230-0000,Private      ,6,0,6,56,13,69
02511500,JOFFREY BALLET SCHOOL                   ,NY,10011-0000,Proprietary  ,0,0,0,89,17,106
02513500,MAR JON SCHOOL OF BEAUTY CULTURE        ,NY,14150-0000,Proprietary  ,1,5,6,51,112,163
02525600,ART INSTITUTE OF NEW YORK CITY (THE)    ,NY,10013-2429,Proprietary  ,39,36,75,3150,2047,5197
02540800,"GLOBE INSTITUTE OF TECHNOLOGY, INC.     ",NY,10007-0000,Proprietary  ,18,35,53,546,536,1082
02546000,TRI-STATE COLLEGE OF ACUPUNCTURE        ,NY,10011-0000,Proprietary  ,0,2,2,3,151,154
02546300,YESHIVA OF THE TELSHE ALUMNI            ,NY,10471-0000,Private      ,4,0,4,49,0,49
02550600,TALMUDICAL INST OF UPSTATE NY           ,NY,14607-0000,Private      ,1,0,1,7,11,18
02556700,SEMINAR L'MOROS BAIS YAAKOV             ,NY,11219-0000,Private      ,1,0,1,249,3,252
02572900,BUSINESS INFORMATICS CENTER             ,NY,11580-0000,Proprietary  ,1,0,1,27,74,101
02575400,FRENCH CULINARY INSTITUTE               ,NY,10013-2618,Proprietary  ,7,28,35,616,1308,1924
02587600,ORLO SCH HAIR DESIGN & COSMETOLOGY      ,NY,12206-1723,Proprietary  ,3,6,9,65,131,196
02599400,NEW YORK COLLEGE OF HEALTH PROFESSIONS  ,NY,11791-4413,Private      ,3,49,52,221,1162,1383
02600100,NEW YORK ACADEMY OF ART (THE)           ,NY,10013-2911,Private      ,2,2,4,306,403,709
02614900,SANFORD-BROWN INSTITUTE                 ,NY,10604-2910,Proprietary  ,3,13,16,209,586,795
02615001,SANFORD-BROWN COLLEGE - SANFORD-BROWN IN,NY,11530-4734,Proprietary  ,4,15,19,274,566,840
02616600,SHEAR EGO INTERNATIONAL SCHOOL OF HAIR D,NY,14617-3501,Proprietary  ,0,8,8,95,235,330
02617000,CONTINENTAL SCH OF BEAUTY CULTURE       ,NY,14020-0000,Proprietary  ,6,13,19,71,120,191
02617002,CONTINENTAL SCHOOL OF BEAUTY CULTURE  - ,NY,14020-1908,Proprietary  ,0,0,0,6,10,16
02622900,BAIS MEDRASH ELYON                      ,NY,10952-3013,Private      ,1,0,1,3,9,12
03000100,YESHIVA GEDOLAH IMREI YOSEF DSPINKA     ,NY,11219-4696,Private      ,0,20,20,7,122,129
03007200,DANCE THEATRE OF HARLEM                 ,NY,10031-0000,Private      ,0,0,0,51,59,110
03027701,PACIFIC COLLEGE OF ORIENTAL MEDICINE - N,NY,10010-7108,Proprietary  ,0,12,12,57,616,673
03081600,DELAWARE CHENANGO MADISON OT. BOCES     ,NY,13815-9554,Public       ,1,1,2,24,107,131
03089700,COMPUTER CAREER CENTER                  ,NY,11530-3334,Proprietary  ,11,63,74,192,725,917
03095500,ASA INST BUSINESS & COMPUTER TECH       ,NY,11201-5208,Proprietary  ,206,488,694,2749,5205,7954
03096200,CHARLES STUART SCHOOL                   ,NY,11229-2004,Proprietary  ,1,4,5,16,76,92
03103700,ADIRONDACK BEAUTY SCHOOL                ,NY,12801-3158,Proprietary  ,4,5,9,29,67,96
03104900,SULLIVAN COUNTY BOCES                   ,NY,12754-2116,Public       ,0,1,1,20,79,99
03115300,GENESEE VALLEY BOCES                    ,NY,14020-1099,Public       ,0,2,2,53,231,284
03120700,NEW YORK CONSERVATORY FOR DRAMATIC ARTS ,NY,10011-4225,Proprietary  ,1,2,3,598,247,845
03127100,YESHIVAS NOVOMINSK                      ,NY,11219-0000,Private      ,7,0,7,42,0,42
03129200,RABBINICAL CLG OHR SHIMAR YISROEL       ,NY,11211-8102,Private      ,5,21,26,22,114,136
03147300,YESHIVA D'MONSEY                        ,NY,10952-3106,Private      ,0,9,9,2,50,52
03169300,STUDIO JEWELERS                         ,NY,10016-4112,Proprietary  ,0,1,1,7,63,70
03181400,MERKAZ BNOS                             ,NY,11214-4911,Private      ,2,27,29,13,202,215
03191300,CUNY SCHOOL OF LAW @ QUEENS COLLEGE     ,NY,11367-0000,Public       ,3,4,7,482,1515,1997
03193300,MANHATTAN SCHOOL OF COMPUTER TECH       ,NY,11230-1617,Private      ,16,101,117,227,745,972
03203300,NEW YORK INSTITUTE OF MASSAGE           ,NY,14221-6021,Proprietary  ,5,2,7,63,201,264
03216300,UNIFICATION THEOLOGICAL SEMINARY        ,NY,12507-5021,Private      ,0,2,2,8,28,36
03328300,FRANKLIN CAREER INSTITUTE               ,NY,11550-3003,Private      ,4,17,21,72,236,308
03328301,FRANKLIN CAREER INSTITUTE - BROOKLYN    ,NY,11220-3110,Private      ,16,41,57,153,467,620
03342400,AMERICAN BARBER INSTITUTE               ,NY,10001-5271,Proprietary  ,0,12,12,73,226,299
03358300,ALLEN SCHOOL                            ,NY,11432-4901,Proprietary  ,23,231,254,224,1981,2205
03358301,ALLEN SCHOOL - BROOKLYN                 ,NY,11201-0000,Proprietary  ,13,65,78,219,926,1145
03380300,STAR CAREER ACADEMY                     ,NY,11791-5311,Proprietary  ,7,22,29,108,427,535
03419400,NORTHEASTERN SEMINARY                   ,NY,14624-1997,Private      ,0,7,7,26,188,214
03426400,ANTHEM INSTITUTE                        ,NY,10018-0000,Proprietary  ,0,0,0,48,118,166
03433500,LIA SCHORR INSTITUTE OF COSMETIC SK     ,NY,10022-2614,Proprietary  ,0,6,6,20,94,114
03443300,NEW YORK COLLEGE OF TRADITIONAL CHINESE ,NY,11501-0000,Private      ,0,4,4,1,108,109
03496300,YESHIVA SHAAREI TORAH OF ROCKLAND       ,NY,10901-4003,Private      ,8,8,16,32,44,76
03537300,NEW YORK AUTOMOTIVE & DIESEL INSTIT     ,NY,11101-0000,Proprietary  ,24,49,73,253,571,824
03568300,LEON STUDIO ONE SCHOOL OF HAIR DESI     ,NY,14221-5323,Proprietary  ,0,3,3,43,69,112
03651300,SAINT JOSEPH'S MEDICAL CENTER SCHOO     ,NY,10701-4080,Private      ,0,2,2,25,76,101
03652300,METROPOLITAN LEARNING INSTITUTE         ,NY,11374-2101,Private      ,10,178,188,129,1465,1594
03665400,CHRISTIE'S EDUCATION                    ,NY,10036-8002,Proprietary  ,0,3,3,4,29,33
03713300,BEIS MEDRASH HEICHAL DOVID              ,NY,11691-4433,Private      ,3,0,3,35,6,41
03773300,CENTER FOR NATURAL WELLNESS SCHOOL OF MA,NY,12205-1601,Proprietary  ,0,6,6,60,248,308
03802300,UTA MESIVTA OF KIRYAS JOEL              ,NY,10950-2169,Private      ,175,211,386,673,706,1379
03809400,MICROPOWER CAREER INSTITUTE             ,NY,10001-2812,Proprietary  ,15,120,135,111,721,832
03819400,HUDSON VALLEY SCHOOL OF ADVANCED AESTHET,NY,12493-0000,Proprietary  ,0,0,0,2,5,7
03839300,AVEDA INSTITUTE NEW YORK                ,NY,10013-1522,Proprietary  ,8,30,38,230,537,767
03881300,UNION GRADUATE COLLEGE                  ,NY,12308-3131,Private      ,0,2,2,22,221,243
03903400,AMERICAN BEAUTY SCHOOL                  ,NY,10462-8003,Proprietary  ,9,36,45,166,504,670
03941400,ELITE ACADEMY OF BEAUTY ARTS            ,NY,11223-1630,Proprietary  ,1,6,7,48,152,200
03983300,"SCHOOL OF PROFESSIONAL HORTICULTURE, AT ",NY,10458-5126,Private      ,0,1,1,19,78,97
03988300,"SAE INSTITUTE OF TECHNOLOGY, NEW YORK   ",NY,10001-2915,Proprietary  ,12,11,23,486,586,1072
04043300,ACE COMPUTER TRAINING CENTER            ,NY,11375-5337,Proprietary  ,1,14,15,59,291,350
04092401,MAKE-UP DESIGNORY -                     ,NY,10012-0041,Proprietary  ,9,16,25,331,451,782
04095300,KING'S COLLEGE (THE)                    ,NY,10018-0110,Private      ,3,4,7,1254,164,1418
04102300,NEW AGE TRAINING                        ,NY,10001-4006,Proprietary  ,6,18,24,38,272,310
04115500,TALMUDICAL SEMINARY OF BOBOV            ,NY,11219-3826,Private      ,24,45,69,120,132,252
04117100,EDP SCHOOL OF COMPUTER PROGRAMMING      ,NY,11235-0000,Private      ,0,0,0,12,155,167
04117700,"MONROE 2-ORLEANS BOCES, CENTER FOR WORK ",NY,14624-1119,Public       ,0,6,6,100,388,488
04123200,INSTITUTE OF ALLIED MEDICAL PROFESSIONS ,NY,11373-5541,Private      ,0,4,4,28,225,253
04123300,HUDSON VALLEY SCHOOL OF MASSAGE THERAPY ,NY,12493-0000,Proprietary  ,0,0,0,8,30,38
04125600,CAREER SCHOOL OF NY                     ,NY,10301-2416,Private      ,1,5,6,77,146,223
04131500,COLLECTIVE (THE)                        ,NY,10011-2026,Proprietary  ,0,0,0,11,40,51
04133700,NEW YORK MEDICAL CAREER TRAINING CENTER ,NY,11354-6504,Proprietary  ,0,7,7,69,285,354
04134000,"JOHN PAOLO'S XTREME BEAUTY INSTITUTE, GO",NY,12020-1245,Proprietary  ,2,8,10,31,204,235
04134001,"JOHN PAOLO'S XTREME BEAUTY INSTITUTE, GO",NY,13417-1319,Proprietary  ,3,15,18,22,71,93
04137700,ANN MARIE'S WORLD OF BEAUTY SCHOOL      ,NY,13901-2308,Proprietary  ,0,2,2,16,48,64
04138100,YESHIVA OF MACHZIKAI HADAS              ,NY,11219-1408,Private      ,32,33,65,121,154,275
04144300,INSTITUTE OF CULINARY EDUCATION         ,NY,10010-5205,Proprietary  ,7,16,23,592,1114,1706
04148000,NEW LIFE BUSINESS INSTITUTE             ,NY,11432-6149,Proprietary  ,13,67,80,50,323,373
04151200,SALON PROFESSIONAL ACADEMY (THE)        ,NY,14150-9200,Proprietary  ,3,2,5,84,138,222
04155300,ONONDAGA SCHOOL OF THERAPEUTIC MASSAGE  ,NY,13210-1533,Proprietary  ,0,2,2,95,289,384
04156000,ACADEMY OF COSMETOLOGY & ESTHETICS NYC (,NY,10306-3003,Proprietary  ,8,10,18,175,221,396
04157500,ACCESS CAREERS                          ,NY,11201-5826,Proprietary  ,4,8,12,57,244,301
04165700,"JOHN PAOLO'S XTREME BEAUTY INSTITUTE, GO",NY,12110-3053,Proprietary  ,0,5,5,11,74,85
04166000,MANHATTAN INSTITUTE (THE)               ,NY,10016-6516,Proprietary  ,4,10,14,151,307,458
04167600,FINGER LAKES SCHOOL OF MASSAGE (THE)    ,NY,14850-1384,Proprietary  ,2,12,14,75,205,280
04167601,FINGER LAKES SCHOOL OF MASSAGE (THE) -  ,NY,10549-1103,Proprietary  ,0,7,7,21,136,157
04178700,ATELIER ESTHETIQUE INSTITUTE OF ESTHETIC,NY,10016-8804,Proprietary  ,1,26,27,50,320,370
04179800,SOTHEBY'S INSTITUTE OF ART - NY         ,NY,10022-6717,Proprietary  ,0,1,1,0,9,9
04180200,LONG ISLAND NAIL & SKIN CARE INSTITUTE  ,NY,11756-1316,Proprietary  ,1,9,10,23,112,135
04189000,LONG ISLAND BARBER INSTITUTE (THE)      ,NY,11550-6317,Proprietary  ,4,8,12,22,119,141
04190500,NEW YORK SCHOOL OF ESTHETICS & DAY SPA  ,NY,10591-3232,Proprietary  ,1,9,10,25,93,118
04192800,BE'ER YAAKOV TALMUDIC SEMINARY          ,NY,10977-1912,Private      ,23,50,73,66,206,272
04204300,AESTHETIC SCIENCE INSTITUTE (THE)       ,NY,12110-1095,Proprietary  ,3,0,3,36,81,117
04206200,DIGITAL FILM ACADEMY                    ,NY,10036-3708,Proprietary  ,1,5,6,53,115,168
04207600,AMERICAN ACADEMY OF PERSONAL TRAINING   ,NY,10011-7301,Proprietary  ,4,10,14,4,10,14
04208600,RELAY SCHOOL OF EDUCATION               ,NY,10011-4233,Private      ,0,0,0,2,483,485
04210100,NEW COMMUNITY COLLEGE AT CUNY (THE)     ,NY,10018-2602,Public       ,7,10,17,7,10,17
04210700,NEW YORK INSTITUTE OF BEAUTY            ,NY,11749-1479,Proprietary  ,2,7,9,3,24,27
04212500,CACTUS ACADEMY (THE)                    ,NY,11530-3402,Proprietary  ,2,12,14,16,36,52
04213500,SHARP EDGEZ BARBER INSTITUTE            ,NY,14620-0000,Proprietary  ,1,22,23,1,22,23
04215900,YESHIVA GEDOLAH KESSER TORAH            ,NY,10952-2127,Private      ,29,0,29,29,0,29
00267808,BRYANT & STRATTON COLLEGE - PARMA       ,OH,44130-0000,Proprietary  ,27,138,165,723,4263,4986
00301000,ANTIOCH UNIVERSITY                      ,OH,45387-1608,Private      ,2,17,19,655,979,1634
00301100,ART ACADEMY OF CINCINNATI               ,OH,45202-7106,Private      ,3,3,6,463,320,783
00301200,ASHLAND UNIVERSITY                      ,OH,44805-3799,Private      ,5,103,108,4060,3553,7613
00301300,ATHENAEUM OF OHIO                       ,OH,45230-2000,Private      ,0,0,0,4,29,33
00301400,BALDWIN-WALLACE COLLEGE                 ,OH,44017-2088,Private      ,5,28,33,4912,1981,6893
00301600,BLUFFTON UNIVERSITY                     ,OH,45817-2104,Private      ,4,2,6,1662,491,2153
00301800,BOWLING GREEN STATE UNIVERSITY          ,OH,43403-0001,Public       ,23,81,104,22066,7412,29478
00302300,CAPITAL UNIVERSITY                      ,OH,43209-2394,Private      ,13,48,61,4579,3705,8284
00302400,CASE WESTERN RESERVE UNIV               ,OH,44106-0000,Private      ,3,19,22,9306,2314,11620
00302401,CASE WESTERN RESERVE UNIV - MED         ,OH,44106-0000,Private      ,1,3,4,111,1265,1376
00302402,CASE WESTERN RESERVE UNIV - DENTAL      ,OH,44106-0000,Private      ,1,0,1,51,371,422
00302403,CASE WESTERN RESERVE UNIV - LAW         ,OH,44106-0000,Private      ,0,0,0,34,984,1018
00302404,CASE WESTERN RESERVE UNIV - UG          ,OH,44106-0000,Private      ,1,1,2,217,60,277
00302405,CASE WESTERN RESERVE UNIV - MSASS       ,OH,44106-0000,Private      ,0,4,4,32,535,567
00302406,CASE WESTERN RESERVE UNIV - NURS UG     ,OH,44106-0000,Private      ,1,4,5,248,297,545
00302407,CASE WESTERN RESERVE UNIV - WSOM        ,OH,44106-0000,Private      ,0,3,3,23,233,256
00302408,CASE WESTERN RESERVE UNIV -A&S GRAD     ,OH,44106-0000,Private      ,0,3,3,8,331,339
00302409,CASE WESTERN RESERVE UNIV -ENG GRAD     ,OH,44106-0000,Private      ,0,0,0,39,132,171
00302410,CASE WESTERN RESERVE UNIV -NURS GRD     ,OH,44106-0000,Private      ,0,7,7,24,453,477
00302500,CEDARVILLE UNIVERSITY                   ,OH,45314-8564,Private      ,4,8,12,4432,428,4860
00302600,CENTRAL STATE UNIVERSITY                ,OH,45384-1004,Public       ,13,27,40,3764,2038,5802
00302900,CINCINNATI CHRISTIAN UNIVERSITY         ,OH,45204-3200,Private      ,2,12,14,652,899,1551
00303000,OHIO CHRISTIAN UNIVERSITY               ,OH,43113-9487,Private      ,13,238,251,865,4246,5111
00303100,CLEVELAND INSTITUTE OF MUSIC            ,OH,44106-1776,Private      ,2,4,6,542,515,1057
00303200,CLEVELAND STATE UNIVERSITY              ,OH,44115-2214,Public       ,47,231,278,11508,16889,28397
00303300,COLLEGE OF MT ST JOSEPH                 ,OH,45233-1670,Private      ,3,28,31,1965,1678,3643
00303500,OHIO DOMINICAN UNIVERSITY               ,OH,43219-2099,Private      ,5,52,57,2439,2984,5423
00303600,FRANCISCAN UNIV OF STEUBENVILLE         ,OH,43952-1763,Private      ,2,13,15,2655,784,3439
00303700,COLLEGE OF WOOSTER                      ,OH,44691-2363,Private      ,0,1,1,3490,172,3662
00303900,COLUMBUS COLLEGE OF ART AND DESIGN      ,OH,43215-1758,Private      ,8,17,25,2031,932,2963
00304000,CUYAHOGA COMMUNITY COLLEGE              ,OH,44115-2878,Public       ,159,784,943,12910,29697,42607
00304100,"DEFIANCE COLLEGE, THE                   ",OH,43512-1695,Private      ,0,9,9,1487,551,2038
00304200,DENISON UNIVERSITY                      ,OH,43023-1329,Private      ,0,1,1,3144,120,3264
00304300,CHANCELLOR UNIVERSITY                   ,OH,44114-0000,Proprietary  ,0,16,16,23,518,541
00304400,TRINITY LUTHERAN SEMINARY               ,OH,43209-0000,Private      ,0,1,1,3,154,157
00304500,UNIVERSITY OF FINDLAY                   ,OH,45840-3695,Private      ,3,29,32,3685,1798,5483
00304600,FRANKLIN UNIVERSITY                     ,OH,43215-5399,Private      ,16,147,163,1309,12483,13792
00304700,HEBREW UNION COLLEGE MAIN CAMPUS        ,OH,45220-0000,Private      ,0,0,0,1,1,2
00304800,HEIDELBERG UNIVERSITY                   ,OH,44883-2462,Private      ,3,12,15,1931,465,2396
00304900,HIRAM COLLEGE                           ,OH,44234-1808,Private      ,0,13,13,1827,460,2287
00305000,JOHN CARROLL UNIVERSITY                 ,OH,44118-4581,Private      ,2,19,21,4626,1113,5739
00305100,KENT STATE UNIVERSITY                   ,OH,44242-0001,Public       ,52,125,177,26986,14109,41095
00305101,KENT STATE UNIVERSITY - GEAUGA CAMPUS   ,OH,44021-9500,Public       ,1,12,13,856,1192,2048
00305102,KENT STATE UNIVERSITY - STARK CAMPUS    ,OH,44720-7599,Public       ,10,30,40,3542,4605,8147
00305103,KENT STATE UNIVERSITY - TUSCARAWAS CAMPU,OH,44663-9403,Public       ,3,11,14,1175,1937,3112
00305104,KENT STATE UNIVERSITY - TRUMBULL CAMPUS ,OH,44483-1998,Public       ,6,22,28,1321,2757,4078
00305105,KENT STATE UNIVERSITY - ASHTABULA CAMPUS,OH,44004-2299,Public       ,3,26,29,1051,2439,3490
00305106,KENT STATE UNIVERSITY - EAST LIVERPOOL C,OH,43920-3497,Public       ,5,11,16,500,1052,1552
00305107,KENT STATE UNIVERSITY - SALEM CAMPUS    ,OH,44460-9412,Public       ,5,15,20,1070,1542,2612
00305143,KENT STATE UNIVERSITY - COLLEGE OF PODIA,OH,44131-2330,Public       ,1,1,2,5,494,499
00306500,KENYON COLLEGE                          ,OH,43022-9623,Private      ,0,0,0,2740,50,2790
00306600,LAKE ERIE COLLEGE                       ,OH,44077-3389,Private      ,1,6,7,1563,518,2081
00306800,LORAIN COUNTY COMMUNITY COLLEGE         ,OH,44035-1691,Public       ,27,128,155,4594,9821,14415
00306900,LOURDES COLLEGE                         ,OH,43560-2898,Private      ,5,27,32,1486,2408,3894
00307200,MALONE UNIVERSITY                       ,OH,44709-3897,Private      ,2,16,18,2263,1760,4023
00307300,MARIETTA COLLEGE                        ,OH,45750-4033,Private      ,7,11,18,2682,452,3134
00307500,METHODIST THEOLOGICAL SCH IN OHIO       ,OH,43015-0000,Private      ,0,0,0,3,206,209
00307602,MIAMI - JACOBS CAREER COLLEGE - SPRINGBO,OH,45066-1115,Proprietary  ,0,0,0,74,237,311
00307603,MIAMI - JACOBS CAREER COLLEGE - TROY    ,OH,45373-3837,Proprietary  ,0,0,0,113,319,432
00307700,MIAMI UNIVERSITY                        ,OH,45056-1831,Public       ,35,123,158,22351,6548,28899
00307800,WRIGHT STATE UNIVERSITY                 ,OH,45435-0002,Public       ,32,105,137,14938,12791,27729
00308300,UNIVERSITY OF MOUNT UNION               ,OH,44601-3993,Private      ,3,0,3,3818,365,4183
00308400,MUSKINGUM UNIVERSITY                    ,OH,43762-1199,Private      ,5,21,26,2457,878,3335
00308500,NOTRE DAME COLLEGE OF OHIO              ,OH,44121-4293,Private      ,4,33,37,2662,1796,4458
00308600,OBERLIN COLLEGE                         ,OH,44074-1090,Private      ,2,4,6,5056,222,5278
00308900,OHIO NORTHERN UNIVERSITY                ,OH,45810-1555,Private      ,3,6,9,3941,1168,5109
00309000,OHIO STATE UNIVERSITY-ALL CAMPUSES      ,OH,43210-1358,Public       ,70,205,275,54062,28155,82217
00310000,OHIO UNIVERSITY                         ,OH,45701-2979,Public       ,29,187,216,23624,13166,36790
00310002,"OHIO UNIVERSITY, ZANESVILLE CAMPUS      ",OH,43701-0000,Public       ,3,21,24,1463,2028,3491
00310003,"OHIO UNIVERSITY, LANCASTER CAMPUS       ",OH,43130-0000,Public       ,8,31,39,1590,2329,3919
00310004,"OHIO UNIVERSITY, SOUTHERN CAMPUS        ",OH,45638-0000,Public       ,2,24,26,968,2225,3193
00310005,"OHIO UNIVERSITY, CHILLICOTHE CAMPUS     ",OH,45601-0000,Public       ,2,30,32,1282,2766,4048
00310006,"OHIO UNIVERSITY, EASTERN CAMPUS         ",OH,43950-0000,Public       ,2,3,5,635,490,1125
00310008,OHIO UNIV COLL OF OSTEOPATHIC MED       ,OH,45701-0000,Public       ,0,1,1,25,611,636
00310900,OHIO WESLEYAN UNIVERSITY                ,OH,43015-2398,Private      ,4,4,8,3039,225,3264
00311000,OTTERBEIN UNIVERSITY                    ,OH,43081-2006,Private      ,4,23,27,4095,1266,5361
00311300,PONTIFICAL COLLEGE JOSEPHINUM           ,OH,43235-1498,Private      ,0,0,0,53,31,84
00311400,FIRELANDS REGIONAL MEDICAL CENTER - SOUT,OH,44870-4788,Private      ,0,2,2,85,208,293
00311500,RABBINICAL COLLEGE OF TELSHE            ,OH,44092-2584,Private      ,3,1,4,26,25,51
00311600,UNIV OF RIO GRANDE                      ,OH,45674-3131,Private      ,17,108,125,1704,2505,4209
00311900,SINCLAIR COMMUNITY COLLEGE              ,OH,45402-1460,Public       ,136,606,742,9954,22487,32441
00312100,TIFFIN UNIVERSITY                       ,OH,44883-2161,Private      ,8,86,94,3186,8039,11225
00312200,UNITED THEOLOGICAL SEMINARY             ,OH,45406-0000,Private      ,0,3,3,3,683,686
00312300,UNIVERSITY OF AKRON                     ,OH,44325-6211,Public       ,48,141,189,22258,16460,38718
00312500,UNIVERSITY OF CINCINNATI                ,OH,45221-0125,Public       ,94,426,520,30213,26301,56514
00312504,UNIVERSITY OF CINCINNATI - MEDICINE     ,OH,45267-0553,Public       ,2,8,10,452,1769,2221
00312700,UNIVERSITY OF DAYTON                    ,OH,45469-0002,Private      ,15,98,113,12424,4349,16773
00313100,UNIVERSITY OF TOLEDO                    ,OH,43606-3390,Public       ,37,117,154,19199,12282,31481
00313300,URBANA UNIVERSITY                       ,OH,43078-2091,Private      ,2,18,20,1171,1114,2285
00313400,URSULINE COLLEGE                        ,OH,44124-4398,Private      ,1,29,30,691,1601,2292
00313500,WALSH UNIVERSITY                        ,OH,44720-3396,Private      ,1,16,17,2795,1584,4379
00314100,WILBERFORCE UNIVERSITY                  ,OH,45384-1001,Private      ,3,10,13,1024,590,1614
00314200,WILMINGTON COLLEGE                      ,OH,45177-2499,Private      ,0,9,9,2270,695,2965
00314300,WITTENBERG UNIVERSITY                   ,OH,45501-2199,Private      ,5,12,17,4121,474,4595
00314400,XAVIER UNIVERSITY                       ,OH,45207-1035,Private      ,6,53,59,8573,3819,12392
00314500,YOUNGSTOWN STATE UNIVERSITY             ,OH,44555-0001,Public       ,17,57,74,10020,8475,18495
00398200,CLEVELAND INSTITUTE OF ART              ,OH,44106-1700,Private      ,0,7,7,1083,383,1466
00406000,WINEBRENNER THEOLOGICAL SEMINARY        ,OH,45840-0000,Private      ,0,2,2,2,67,69
00485200,CLARK STATE COMMUNITY COLLEGE           ,OH,45505-4795,Public       ,34,237,271,2154,7288,9442
00485300,BRADFORD SCHOOL                         ,OH,43219-0000,Proprietary  ,6,10,16,913,922,1835
00485500,DAVIS COLLEGE                           ,OH,43623-4307,Proprietary  ,4,26,30,184,949,1133
00486100,UNIVERSITY OF NORTHWESTERN OHIO         ,OH,45805-1498,Private      ,22,24,46,5147,2377,7524
00486600,STAUTZENBERGER COLLEGE                  ,OH,43537-4007,Proprietary  ,9,48,57,503,1890,2393
00489811,MCCANN SCHOOL OF BUSINESS & TECHNOLOGY -,OH,45402-1724,Proprietary  ,1,0,1,121,686,807
00489814,MCCANN SCHOOL OF BUSINESS & TECHNOLOGY -,OH,44131-2309,Proprietary  ,0,1,1,33,317,350
00489815,MCCANN SCHOOL OF BUSINESS & TECHNOLOGY -,OH,43215-3902,Proprietary  ,0,0,0,46,246,292
00489817,MCCANN SCHOOL OF BUSINESS & TECHNOLOGY -,OH,45241-5428,Proprietary  ,0,2,2,15,74,89
00510200,SCH OF DIAGNOSTIC IMAGING-CLEVELAND     ,OH,44119-0000,Private      ,0,1,1,16,76,92
00531300,NORTH CENTRAL STATE COLLEGE             ,OH,44901-0000,Public       ,10,25,35,1386,3056,4442
00575300,OWENS STATE COMMUNITY COLLEGE           ,OH,43699-0000,Public       ,32,175,207,6558,13380,19938
00648700,AULTMAN COLLEGE OF NURSING AND HEALTH SC,OH,44710-1799,Private      ,1,2,3,209,565,774
00648900,CHRIST COLLEGE OF NURSING AND HEALTH SCI,OH,45219-2906,Private      ,2,9,11,313,804,1117
00649400,GOOD SAMARITAN COLG-NURSING/HEALTH      ,OH,45220-2489,Private      ,1,7,8,305,799,1104
00650700,TRINIT HEALTH SYSTEM SCH OF NURSING     ,OH,43952-2667,Private      ,0,1,1,67,179,246
00680400,LAKELAND COMMUNITY COLLEGE              ,OH,44094-5198,Public       ,21,84,105,3640,7613,11253
00686700,COLUMBUS STATE COMMUNITY COLLEGE        ,OH,43215-1786,Public       ,154,738,892,15410,32991,48401
00703500,KETTERING COLLEGE OF MEDICAL ARTS       ,OH,45429-1299,Private      ,5,24,29,690,1164,1854
00708500,MOUNT VERNON NAZARENE UNIVERSITY        ,OH,43050-9500,Private      ,1,12,13,1675,929,2604
00708501,MOUNT VERNON NAZARENE UNIV - AGS        ,OH,43050-0000,Private      ,1,22,23,87,968,1055
00727500,EASTERN GATEWAY COMMUNITY COLLEGE       ,OH,43952-3598,Public       ,4,25,29,1066,2571,3637
00732920,ITT TECHNICAL INSTITUTE                 ,OH,45414-3456,Proprietary  ,23,183,206,622,2370,2992
00732992,ITT TECHNICAL INSTITUTE                 ,OH,44509-4098,Proprietary  ,36,175,211,625,1983,2608
00747300,CHOFFIN CAREER & TECHNICAL CENTER       ,OH,44503-1628,Public       ,1,3,4,131,481,612
00759800,HOCKING TECHNICAL COLLEGE               ,OH,45764-9582,Public       ,12,58,70,3755,4089,7844
00777700,REMINGTON COLLEGE - CLEVELAND CAMPUS    ,OH,44125-1957,Private      ,42,148,190,602,2489,3091
00777704,REMINGTON COLLEGE-CLEVELAND WEST CAMPUS ,OH,44070-3129,Private      ,0,2,2,129,477,606
00812900,ADULT AND COMMUNITY EDUCATION @ HUDSON  ,OH,43211-2017,Public       ,3,22,25,75,684,759
00813200,TOLEDO SCHOOL OF PRACTICAL NURSING      ,OH,43613-5110,Public       ,0,5,5,142,657,799
00813300,ZANE STATE COLLEGE                      ,OH,43701-2626,Public       ,28,88,116,1559,3150,4709
00819400,AKRON SCHOOL OF PRACTICAL NRSG          ,OH,44311-0000,Public       ,1,8,9,153,391,544
00827800,TERRA COMMUNITY COLLEGE                 ,OH,43420-9670,Public       ,12,82,94,1132,2939,4071
00867700,NORTHWEST STATE COMMUNITY COLLEGE       ,OH,43502-9542,Public       ,5,34,39,1076,2618,3694
00888600,PORTAGE LAKES CAREER CENTER             ,OH,44685-9554,Public       ,2,0,2,33,141,174
00908803,ITT TECHNICAL INSTITUTE                 ,OH,44136-1758,Proprietary  ,0,0,0,0,1,1
00915600,WAYNE COUNTY SCHOOLS CAREER CENTER      ,OH,44677-9672,Public       ,1,2,3,53,241,294
00917200,SPRINGFIELD REGIONAL SCHOOL OF NURSING  ,OH,45501-0000,Private      ,0,0,0,39,118,157
00941200,FORTIS COLLEGE                          ,OH,44221-2998,Proprietary  ,18,74,92,317,1651,1968
00953000,GERBER AKRON BEAUTY SCHOOL              ,OH,44313-6995,Proprietary  ,0,10,10,44,212,256
00953100,SPA SCHOOL (THE)                        ,OH,43214-1524,Proprietary  ,3,15,18,94,393,487
00966000,TIFFIN ACADEMY OF HAIR DESIGN           ,OH,44883-2833,Proprietary  ,2,6,8,50,89,139
00994100,BELMONT TECHNICAL COLLEGE               ,OH,43950-9766,Public       ,3,16,19,913,1827,2740
00994200,SHAWNEE STATE UNIVERSITY                ,OH,45662-4344,Public       ,14,37,51,4840,3040,7880
01001700,PAYNE THEOLOGICAL SEMINARY              ,OH,45384-0474,Private      ,0,2,2,1,173,174
01002700,JAMES A. RHODES STATE COLLEGE           ,OH,45804-3597,Public       ,11,37,48,1804,3410,5214
01016800,NATIONWIDE BEAUTY ACADEMY               ,OH,43228-1000,Proprietary  ,3,7,10,128,283,411
01028000,OHIO STATE BEAUTY ACADEMY               ,OH,45801-0000,Proprietary  ,1,9,10,126,267,393
01032300,HANNAH E MULLINS SCH-PRAC NRSG          ,OH,44460-2906,Public       ,0,1,1,28,112,140
01034500,CINCINNATI STATE TECH & COMM CLG        ,OH,45223-2690,Public       ,94,354,448,5927,14641,20568
01045300,WASHINGTON STATE CMTY COLLEGE           ,OH,45750-9225,Public       ,7,29,36,1048,1650,2698
01063000,NORTHERN INSTITUTE OF COSMETOLOGY       ,OH,44052-1803,Proprietary  ,0,5,5,25,119,144
01073600,MARION TECHNICAL COLLEGE                ,OH,43302-5694,Public       ,2,22,24,1000,2495,3495
01088000,CHATFIELD COLLEGE                       ,OH,45118-9705,Private      ,12,29,41,115,540,655
01088100,STARK STATE COLLEGE OF TECHNOLOGY       ,OH,44720-7299,Public       ,32,130,162,4808,14986,19794
01090600,CINCINNATI CLG OF MORTUARY SCIENCE      ,OH,45224-1428,Private      ,1,3,4,120,278,398
01092300,UNION INSTITUTE & UNIVERSITY            ,OH,45206-1925,Private      ,1,140,141,54,2400,2454
01099300,HOBART INSTITUTE OF WELDING TECHNOLOGY  ,OH,45373-2400,Private      ,8,10,18,309,395,704
01100500,KAPLAN COLLEGE                          ,OH,43232-4827,Proprietary  ,7,33,40,249,1656,1905
01104600,CENTRAL OHIO TECHNICAL COLLEGE          ,OH,43055-1767,Public       ,6,67,73,1884,5358,7242
01170300,PENTA COUNTY JOINT VOCATIONAL SCH       ,OH,43551-0000,Public       ,0,2,2,34,154,188
01174400,NATIONAL BEAUTY COLLEGE                 ,OH,44720-0000,Proprietary  ,3,13,16,57,227,284
01174500,OHIO TECHNICAL COLLEGE                  ,OH,44103-1228,Proprietary  ,14,41,55,1572,1348,2920
01182500,OHIO STATE SCHOOL OF COSMETOLOGY        ,OH,43224-1107,Proprietary  ,2,6,8,161,483,644
01212800,SOUTHWESTERN COLLEGE                    ,OH,45402-3003,Proprietary  ,2,35,37,94,721,815
01212802,SOUTHWESTERN COLLEGE                    ,OH,45005-2267,Proprietary  ,0,0,0,31,183,214
01212803,SOUTHWESTERN COLLEGE                    ,OH,45202-4304,Proprietary  ,0,0,0,68,407,475
01212804,SOUTHWESTERN COLLEGE                    ,OH,45246-3121,Proprietary  ,4,29,33,125,710,835
01212806,LINCOLN COLLEGE OF TECHNOLOGY - TOLEDO  ,OH,43615-6800,Proprietary  ,5,21,26,126,616,742
01212807,LINCOLN COLLEGE OF TECHNOLOGY - COLUMBUS,OH,43215-3602,Proprietary  ,0,0,0,72,313,385
01212808,LINCOLN COLLEGE OF TECHNOLOGY - CLEVELAN,OH,44114-3266,Proprietary  ,1,30,31,110,589,699
01216600,CAROUSEL BEAUTY COLLEGE                 ,OH,45402-8935,Proprietary  ,8,20,28,140,383,523
01224800,CENTRAL SCHOOL OF PRACTICAL NURSING     ,OH,44103-0000,Private      ,1,7,8,129,606,735
01267200,CAROUSEL BEAUTY COLLEGE                 ,OH,45044-5113,Proprietary  ,0,6,6,23,83,106
01267400,CAROUSEL OF MIAMI VALLEY BEAUTY CLG     ,OH,45424-2063,Proprietary  ,0,2,2,12,34,46
01275000,EDISON COMMUNITY COLLEGE                ,OH,45356-9239,Public       ,3,26,29,1220,2864,4084
01283800,LAURA AND ALVIN SIEGAL COLLEGE OF JUDAIC,OH,44122-7197,Private      ,0,0,0,6,9,15
01284800,MOLER-HOLLYWOOD BEAUTY COLLEGE          ,OH,45202-2577,Proprietary  ,4,19,23,45,172,217
01287000,SOUTHERN STATE COMMUNITY COLLEGE        ,OH,45133-9406,Public       ,18,91,109,1247,2965,4212
01289100,ANTONELLI COLLEGE                       ,OH,45202-2592,Proprietary  ,5,27,32,179,869,1048
01289600,VIRGINIA MARTI COLLEGE OF ART AND DESIGN,OH,44107-0778,Proprietary  ,3,6,9,202,232,434
01303922,SOUTH UNIVERSITY - CLEVELAND            ,OH,44128-5919,Proprietary  ,5,35,40,27,240,267
01313200,INTERNATIONAL CLG OF BROADCASTING       ,OH,45431-1898,Proprietary  ,1,2,3,87,248,335
02052000,KAPLAN COLLEGE                          ,OH,45439-1984,Proprietary  ,13,67,80,313,1783,2096
02054300,TRUMBULL BUSINESS COLLEGE               ,OH,44484-0000,Proprietary  ,0,8,8,57,496,553
02056800,DAYMAR COLLEGE                          ,OH,45601-1038,Proprietary  ,3,24,27,51,431,482
02056802,DAYMAR COLLEGE - LANCASTER              ,OH,43130-0000,Proprietary  ,4,17,21,44,258,302
02056803,DAYMAR COLLEGE - NEW BOSTON             ,OH,45662-4900,Proprietary  ,2,19,21,41,293,334
02056804,DAYMAR COLLEGE - JACKSON                ,OH,45640-1728,Proprietary  ,1,12,13,34,292,326
02066100,OHIO STATE COLLEGE/BARBER STYLING       ,OH,43213-0000,Proprietary  ,5,25,30,135,502,637
02073300,GALLIA-JACKSON-VINTON SCH ADULT ED      ,OH,45674-0000,Public       ,0,3,3,93,224,317
02110700,CLEVELAND INST OF DENTAL-MED ASST       ,OH,44115-2285,Proprietary  ,6,44,50,183,831,1014
02116009,SANFORD-BROWN COLLEGE - MIDDLEBURG HEIGH,OH,44130-8362,Proprietary  ,4,31,35,172,919,1091
02116900,UPPER VALLEY JVS                        ,OH,45356-0000,Public       ,3,3,6,40,301,341
02117300,GREAT OAKS INSTITUTE OF TECHNOLOGY      ,OH,45241-1581,Public       ,2,22,24,269,1103,1372
02128600,THE ART INSTITUTE OF CINCINNATI         ,OH,45246-0000,Proprietary  ,3,6,9,573,457,1030
02140700,COMMUNITY EDUCATIONAL SERVICES          ,OH,44702-1710,Public       ,0,5,5,37,226,263
02158417,"HARRISON COLLEGE - COLUMBUS, OH         ",OH,43123-0000,Proprietary  ,4,23,27,105,412,517
02158500,OHIO BUSINESS COLLEGE                   ,OH,44035-0701,Proprietary  ,10,42,52,92,656,748
02158501,OHIO BUSINESS COLLEGE                   ,OH,44870-9953,Proprietary  ,0,16,16,79,626,705
02158503,OHIO BUSINESS COLLEGE - COLUMBUS        ,OH,43229-3523,Proprietary  ,5,24,29,100,516,616
02158504,OHIO BUSINESS COLLEGE - DAYTON          ,OH,45417-4094,Proprietary  ,0,9,9,5,112,117
02168100,TRI-COUNTY JOINT VOCATIONAL SCHOOL      ,OH,45764-0000,Public       ,0,3,3,56,284,340
02187900,ASHTABULA CO JOINT VOC SCH ADULT ED     ,OH,44047-0000,Public       ,0,0,0,48,280,328
02189000,ADULT CENTER FOR EDUCATION              ,OH,43701-0000,Public       ,0,9,9,129,512,641
02190700,FORTIS COLLEGE                          ,OH,45459-0000,Proprietary  ,26,245,271,600,4651,5251
02192100,BUTLER TECHNOLOGY AND CAREER DEVELOPMENT,OH,45011-0000,Public       ,5,15,20,273,877,1150
02196300,COLLINS CAREER CENTER                   ,OH,45619-0000,Public       ,0,7,7,224,684,908
02210800,MEDINA COUNTY CAREER CENTER             ,OH,44256-0000,Public       ,0,0,0,35,200,235
02215400,OHIO STATE SCHOOL OF COSMETOLOGY        ,OH,43207-0000,Proprietary  ,0,0,0,26,41,67
02220500,GOD'S BIBLE SCHOOL & COLLEGE            ,OH,45210-0000,Private      ,0,0,0,186,136,322
02220800,CAREER & TECHNOLOGY EDUCATION CENTERS OF,OH,43055-0000,Public       ,1,7,8,129,485,614
02239800,PIONEER CAREER & TECHNOLOGY CENTER      ,OH,44875-0000,Public       ,0,0,0,13,99,112
02245600,WARREN COUNTY CAREER CENTER             ,OH,45036-0000,Public       ,10,15,25,120,503,623
02246300,INSTITUTE OF MEDICAL-DENTAL TECH        ,OH,45246-3317,Proprietary  ,8,46,54,97,441,538
02263700,MIAMI VALLEY CAREER TECHNOLOGY CTR      ,OH,45315-0000,Public       ,4,11,15,126,648,774
02269400,EASTERN HILLS ACAD OF HAIR DESIGN       ,OH,45255-0000,Proprietary  ,1,6,7,19,129,148
02269500,WESTERN HILLS SCHOOL OF BEAUTY & HAIR DE,OH,45211-0000,Proprietary  ,5,24,29,75,381,456
02270100,OHIO HI-POINT CAREER CENTER             ,OH,43311-0000,Public       ,2,7,9,57,255,312
02272700,COLUMBIANA COUNTY CAREER CENTER         ,OH,44432-0000,Public       ,0,7,7,72,423,495
02287900,RAPHAEL'S SCHOOL OF BEAUTY CULTURE      ,OH,44446-0000,Proprietary  ,3,19,22,73,282,355
02289802,KAPLAN COLLEGE                          ,OH,45203-0000,Proprietary  ,2,17,19,174,1124,1298
02301400,OHIO VALLEY COLLEGE OF TECHNOLOGY       ,OH,43920-9139,Proprietary  ,4,16,20,130,280,410
02304700,TRI-RIVERS CAREER CENTER                ,OH,43302-0000,Public       ,0,2,2,76,368,444
02311200,AMERICAN SCHOOL OF TECHNOLOGY           ,OH,43229-0000,Proprietary  ,4,71,75,118,829,947
02315500,TOLEDO ACADEMY OF BEAUTY CULTURE - EAST ,OH,43616-0000,Proprietary  ,2,11,13,53,210,263
02324400,ALLSTATE HAIRSTYLING & BARBER CLG       ,OH,44113-0000,Proprietary  ,1,8,9,77,473,550
02328500,MOLER-PICKENS BEAUTY COLLEGE            ,OH,45014-0000,Proprietary  ,0,9,9,15,98,113
02334300,INTERNATIONAL ACAD OF HAIR DESIGN       ,OH,45239-0000,Proprietary  ,8,22,30,129,323,452
02336300,KNOX COUNTY CAREER CENTER               ,OH,43050-4298,Public       ,0,5,5,70,370,440
02336700,CUYAHOGA VALLEY CAREER CENTER           ,OH,44141-1296,Public       ,0,4,4,66,330,396
02337700,PROFESSIONAL SKILLS INSTITUTE           ,OH,43607-0000,Proprietary  ,2,12,14,155,844,999
02342705,FORTIS COLLEGE -  RAVENNA CAMPUS        ,OH,44266-0000,Proprietary  ,7,15,22,170,628,798
02351500,WILLOUGHBY EASTLAKE SCH OF PRAC NSG     ,OH,44094-0000,Public       ,0,2,2,30,159,189
02352800,POLARIS CAREER CENTER-ADULT ED DEPT     ,OH,44130-0000,Public       ,1,6,7,152,517,669
02354200,SCIOTO COUNTY JOINT VOCATIONAL SCH      ,OH,45648-0000,Public       ,2,16,18,116,464,580
02454400,NORTHEAST OHIO MEDICAL UNIVERSITY       ,OH,44272-9621,Public       ,1,2,3,165,866,1031
02497800,GREENE COUNTY CAREER CENTER             ,OH,45385-0000,Public       ,1,5,6,44,245,289
02512600,ADULT VOCATIONAL SERVICES               ,OH,44308-0000,Public       ,0,0,0,30,160,190
02519300,OHIO STATE SCH COSMETOLOGY              ,OH,43110-2754,Proprietary  ,4,14,18,131,266,397
02522700,EASTLAND-FAIRFIELD CAREER AND TECHNICAL ,OH,43125-0000,Public       ,1,7,8,68,358,426
02528300,TDDS TECHNICAL INSTITUTE                ,OH,44429-0000,Proprietary  ,8,74,82,107,836,943
02529500,HAMRICK SCHOOL                          ,OH,44256-0000,Proprietary  ,3,28,31,36,364,400
02541400,TOLEDO ACADEMY OF BEAUTY CULTURE-SO     ,OH,43614-0000,Proprietary  ,0,0,0,62,214,276
02545800,INNER STATE BEAUTY SCHOOLS              ,OH,44124-0000,Proprietary  ,1,8,9,72,321,393
02553000,SCHOOL OF ADVERTISING ART               ,OH,45440-0000,Proprietary  ,1,0,1,237,45,282
02560000,CASAL AVEDA INSTITUTE                   ,OH,44515-0000,Proprietary  ,9,6,15,142,210,352
02560700,PICKAWAY ROSS CO JOINT VOC TECH SCH     ,OH,45601-0000,Public       ,2,2,4,95,433,528
02560701,PICKAWAY ROSS COUNTY JOINT VOCATIONAL SC,OH,45601-9010,Public       ,0,0,0,29,153,182
02562300,APOLLO CAREER CENTER-ADULT EDUC         ,OH,45806-0000,Public       ,2,10,12,139,668,807
02563000,RAPHAELS SCHOOL OF BEAUTY CULTURE       ,OH,44601-2847,Proprietary  ,4,7,11,53,150,203
02568600,MAHONING COUNTY CAREER & TECH CENTR     ,OH,44406-0000,Public       ,0,3,3,30,178,208
02582900,KAPLAN CAREER INSTITUTE                 ,OH,44129-6810,Proprietary  ,3,33,36,95,742,837
02586400,TRUMBULL CAREER & TECH CENTER-ADULT     ,OH,44483-1997,Public       ,3,13,16,75,445,520
02588500,OHIO STATE SCHOOL OF COSMETOLOGY        ,OH,43081-0000,Proprietary  ,6,10,16,123,281,404
02599711,VATTEROTT COLLEGE - CLEVELAND           ,OH,44147-3502,Proprietary  ,3,25,28,67,560,627
02603800,LORAIN COUNTY JVS ADULT CAREER CTR      ,OH,44074-9799,Public       ,0,1,1,89,311,400
02611007,HERITAGE COLLEGE - COLUMBUS             ,OH,43213-4440,Proprietary  ,30,110,140,278,1129,1407
02620000,SANDUSKY CAREER CENTER                  ,OH,44870-4786,Public       ,0,2,2,38,228,266
03007900,GALLIPOLIS CAREER COLLEGE               ,OH,45631-2600,Proprietary  ,1,4,5,25,241,266
03015100,ALLIANCE HIGH SCH-CMTY SERVICES DIV     ,OH,44601-2899,Public       ,0,2,2,32,144,176
03015300,EHOVE CAREER CENTER                     ,OH,44846-9500,Public       ,2,6,8,118,559,677
03023700,MADISON ADULT CAREER CENTER             ,OH,44905-2718,Public       ,2,9,11,52,451,503
03024300,VALLEY BEAUTY SCHOOL                    ,OH,43725-2332,Proprietary  ,3,1,4,19,39,58
03027100,FAIRVIEW ACADEMY                        ,OH,44126-2214,Proprietary  ,0,0,0,14,73,87
03034200,WASHINGTON COUNTY CAREER CENTER ADULT TE,OH,45750-9290,Public       ,1,6,7,102,386,488
03051400,AUBURN CAREER CENTER                    ,OH,44077-9723,Public       ,0,8,8,59,262,321
03051500,US GRANT JOINT VOCATIONAL SCHOOL        ,OH,45106-9502,Public       ,0,1,1,7,39,46
03065900,BUCKEYE CAREER CENTER                   ,OH,44663-9437,Public       ,0,3,3,79,275,354
03067600,RAPHAEL'S SCHOOL OF BEAUTY CULTURE      ,OH,44512-2222,Proprietary  ,3,14,17,50,168,218
03068200,OHIO CENTER FOR BROADCASTING            ,OH,44125-6273,Proprietary  ,1,4,5,89,289,378
03068202,OHIO CENTER FOR BROADCASTING - COLUMBUS ,OH,43213-2571,Proprietary  ,1,4,5,81,339,420
03071900,MOUNT CARMEL COLLEGE OF NURSING         ,OH,43222-1598,Private      ,6,14,20,961,1423,2384
03072303,EVEREST INSTITUTE - COLUMBUS            ,OH,43230-6653,Proprietary  ,11,120,131,179,1209,1388
03078000,OHIO CENTER FOR BROADCASTING            ,OH,45227-1509,Proprietary  ,5,31,36,70,256,326
03079000,ETI TECHNICAL COLLEGE                   ,OH,44446-4398,Proprietary  ,1,15,16,86,417,503
03084800,DELAWARE AREA CAREER CENTER             ,OH,43015-8969,Public       ,1,2,3,21,107,128
03084801,DELAWARE AREA CAREER CENTER -           ,OH,43015-9001,Public       ,0,1,1,9,58,67
03095600,VANTAGE CAREER CENTER                   ,OH,45891-1378,Public       ,0,1,1,22,132,154
03097000,MERCY COLLEGE OF NORTHWEST OHIO         ,OH,43604-1132,Private      ,6,12,18,671,1641,2312
03100100,PARAMOUNT BEAUTY ACADEMY                ,OH,45662-4136,Proprietary  ,0,13,13,47,165,212
03116200,DAYTON BARBER COLLEGE                   ,OH,45342-0000,Proprietary  ,2,10,12,26,139,165
03116300,OHIO COLLEGE OF MASSOTHERAPY            ,OH,44321-1363,Private      ,2,12,14,46,256,302
03116400,VANGUARD-SENTINELL VOC SCH DISTRICT     ,OH,43420-1197,Public       ,0,2,2,17,90,107
03117000,ASHLAND COUNTY-W HOLMES CAREER CTR      ,OH,44805-0000,Public       ,0,2,2,31,205,236
03319300,CREATIVE IMAGES-A CERTIFIED MATRIX      ,OH,45414-2557,Proprietary  ,3,15,18,107,372,479
03319301,CREATIVE IMAGES-A CERTIFIED MATRIX      ,OH,45459-0000,Proprietary  ,3,8,11,84,299,383
03416400,VALLEY BEAUTY SCHOOL                    ,OH,43701-3624,Proprietary  ,1,3,4,16,72,88
03425300,ROSEDALE BIBLE COLLEGE                  ,OH,43029-9517,Private      ,0,0,0,63,14,77
03457300,ALLEGHENY WESLEYAN COLLEGE              ,OH,44460-9598,Private      ,0,0,0,41,31,72
03468400,NATIONAL INSTITUTE OF MASSOTHERAPY      ,OH,44319-2100,Proprietary  ,0,2,2,25,166,191
03468500,ATS INSTITUTE OF TECHNOLOGY             ,OH,44143-2216,Proprietary  ,4,38,42,75,1034,1109
03475400,TRI-STATE BIBLE COLLEGE                 ,OH,45680-8402,Private      ,0,1,1,11,85,96
03534400,AMERICAN INST OF ALTERNATIVE MEDICI     ,OH,43229-1113,Proprietary  ,1,28,29,62,751,813
03626300,BROWN AVEDA INSTITUTE                   ,OH,44060-6212,Proprietary  ,4,3,7,242,333,575
03693300,CARNEGIE CAREER COLLEGE                 ,OH,44260-9608,Private      ,0,0,0,3,52,55
03700300,REGENCY BEAUTY INSTITUTE - CLEVELAND    ,OH,44094-0000,Proprietary  ,12,23,35,188,489,677
03726300,TEMPLE BAPTIST COLLEGE                  ,OH,45240-0000,Private      ,2,0,2,137,117,254
03747300,BEXLEY HALL SEMINARY                    ,OH,43209-2325,Private      ,0,1,1,7,54,61
03776400,HEALING ARTS INSTITUTE                  ,OH,43551-3138,Proprietary  ,0,1,1,14,79,93
03837300,AVEDA FREDRIC'S INSTITUTE               ,OH,45208-1304,Proprietary  ,0,5,5,159,261,420
03882300,OREGON CAREER CENTER                    ,OH,43616-2631,Public       ,0,2,2,7,31,38
04051307,ART INSTITUTE OF PHOENIX (THE) - BROWN M,OH,45215-1107,Proprietary  ,18,104,122,530,2309,2839
04051308,ART INSTITUTE OF PHOENIX (THE) - BROWN M,OH,44320-4420,Proprietary  ,5,41,46,296,1310,1606
04051317,ART INSTITUTE OF PHOENIX (THE) - BROWN M,OH,45840-6848,Proprietary  ,25,142,167,775,3401,4176
04051326,ART INSTITUTE OF PHOENIX (THE) - BROWN M,OH,44718-3674,Proprietary  ,14,55,69,200,1100,1300
04068300,FOUR COUNTY CAREER CENTER               ,OH,43512-9541,Public       ,0,1,1,9,71,80
04074300,HONDROS COLLEGE                         ,OH,43081-3855,Proprietary  ,5,59,64,488,3480,3968
04116700,NEWLIFE TECHNICAL INSTITUTE             ,OH,43920-2920,Private      ,0,0,0,3,8,11
04117300,DAYTON SCHOOL OF MEDICAL MASSAGE        ,OH,45429-1111,Proprietary  ,7,48,55,205,746,951
04118300,NORTHCOAST MEDICAL TRAINING ACADEMY     ,OH,44240-4174,Proprietary  ,4,13,17,81,300,381
04124500,TECHSKILLS                              ,OH,43231-0000,Proprietary  ,6,56,62,69,562,631
04125700,CUT BEAUTY SCHOOL (THE)                 ,OH,44118-2918,Proprietary  ,0,13,13,83,411,494
04126000,OHIO ACADEMY PAUL MITCHELL PARTNER SCHOO,OH,44087-3107,Proprietary  ,2,5,7,139,240,379
04137800,AVEDA INSTITUTE COLUMBUS                ,OH,43201-2333,Proprietary  ,20,18,38,361,616,977
04138000,INSTITUTE OF THERAPEUTIC MASSAGE        ,OH,45875-0350,Proprietary  ,2,1,3,19,73,92
04149100,CINCINNATI ACADEMY A PAUL MITCHELL PARTN,OH,45241-1702,Proprietary  ,8,19,27,196,335,531
04151400,VANITY SCHOOL OF COSMETOLOGY            ,OH,44035-0000,Proprietary  ,0,7,7,32,59,91
04152100,TOLEDO RESTAURANT TRAINING CENTER       ,OH,43604-6508,Private      ,3,7,10,25,124,149
04152600,PIKE COUNTY CAREER TECHNOLOGY CENTER    ,OH,45661-9114,Public       ,0,0,0,25,134,159
04153300,OHIO ACADEMY COLUMBUS (THE)             ,OH,43231-6038,Proprietary  ,5,5,10,150,260,410
04154000,TOLLES CAREER & TECHNICAL CENTER        ,OH,43064-8854,Public       ,0,0,0,8,36,44
04166800,SALON PROFESSIONAL ACADEMY (THE)        ,OH,45551-0000,Proprietary  ,0,4,4,68,102,170
04167700,ARTISAN COLLEGE OF COSMETOLOGY (THE)    ,OH,45840-6848,Proprietary  ,1,1,2,18,74,92
04185900,ELITE SCHOOL OF COSMETOLOGY             ,OH,44857-2714,Proprietary  ,1,6,7,18,74,92
04189100,TONI & GUY HAIRDRESSING ACADEMY         ,OH,43615-1731,Proprietary  ,5,14,19,121,178,299
04192200,ATHENA CAREER ACADEMY                   ,OH,43560-2796,Proprietary  ,0,1,1,33,326,359
04220900,NATIONAL PERSONAL TRAINING INSTITUTE OF ,OH,43235-5739,Proprietary  ,0,6,6,0,6,6
        ,INVALID SCHOOL CODE                     ,  ,00000-0000,,79,359,438,2108,7578,9686
00134500,ADAMS STATE COLLEGE                     ,CO,81102-2373,Public       ,6,104,110,3038,2734,5772
00134600,ARAPAHOE COMMUNITY COLLEGE              ,CO,80160-9002,Public       ,65,257,322,3727,8963,12690
00134700,COLORADO COLLEGE                        ,CO,80903-3294,Private      ,9,38,47,3557,1186,4743
00134800,COLORADO SCHOOL OF MINES                ,CO,80401-1887,Public       ,7,10,17,6887,1537,8424
00134900,UNIVERSITY OF NORTHERN COLORADO         ,CO,80639-0001,Public       ,31,125,156,12174,6070,18244
00135000,COLORADO STATE UNIVERSITY               ,CO,80523-0100,Public       ,96,156,252,27261,13056,40317
00135200,DENVER  SEMINARY                        ,CO,80120-2192,Private      ,0,8,8,10,854,864
00135300,FORT LEWIS COLLEGE                      ,CO,81301-3999,Public       ,14,14,28,5058,1964,7022
00135400,ILIFF SCHOOL OF THEOLOGY                ,CO,80210-0000,Private      ,0,6,6,9,436,445
00135500,LAMAR COMMUNITY COLLEGE                 ,CO,81052-3999,Public       ,10,14,24,481,380,861
00135800,COLORADO MESA UNIVERSITY                ,CO,81501-3122,Public       ,28,72,100,7724,4858,12582
00135900,COLORADO NORTHWESTERN COMMUNITY COLLEGE ,CO,81648-3598,Public       ,4,17,21,516,571,1087
00136000,METROPOLITAN STATE CLG OF DENVER        ,CO,80204-3362,Public       ,121,321,442,14028,21077,35105
00136100,NORTHEASTERN JUNIOR COLLEGE             ,CO,80751-2399,Public       ,13,23,36,1311,724,2035
00136200,OTERO JUNIOR COLLEGE                    ,CO,81050-3346,Public       ,13,35,48,756,898,1654
00136300,REGIS UNIVERSITY                        ,CO,80221-1099,Private      ,7,139,146,3716,10856,14572
00136500,COLORADO STATE UNIVERSITY-PUEBLO        ,CO,81001-4901,Public       ,21,58,79,5996,5163,11159
00136800,TRINIDAD STATE JR COLLEGE               ,CO,81082-2396,Public       ,9,42,51,833,1458,2291
00137000,UNIVERSITY OF COLORADO-BOULDER          ,CO,80309-0077,Public       ,84,140,224,27624,11411,39035
00137100,UNIVERSITY OF DENVER                    ,CO,80208-2000,Private      ,20,234,254,9273,11829,21102
00137200,WESTERN STATE COLLEGE                   ,CO,81231-0000,Public       ,7,13,20,2475,729,3204
00405702,NATIONAL AMERICAN UNIVERSITY - COLORADO ,CO,80920-4001,Proprietary  ,1,18,19,59,566,625
00405703,NATIONAL AMERICAN UNIVERSITY            ,CO,80222-0000,Proprietary  ,1,6,7,55,422,477
00450300,EVEREST COLLEGE                         ,CO,80916-3548,Proprietary  ,5,76,81,240,1730,1970
00450600,COLORADO MOUNTAIN COLLEGE               ,CO,81602-0000,Public       ,16,91,107,1821,2385,4206
00450700,EVEREST COLLEGE                         ,CO,80229-4339,Proprietary  ,11,60,71,189,913,1102
00450701,"EVEREST COLLEGE- EVEREST COLLEGE, AURORA",CO,80012-5692,Proprietary  ,8,52,60,224,963,1187
00450800,UNIVERSITY OF COLORADO DENVER           ,CO,80204-2029,Public       ,52,290,342,9758,18128,27886
00450900,UNIV OF COLORADO AT COLO SPRINGS        ,CO,80918-3735,Public       ,50,157,207,9263,7446,16709
00559600,EMILY GRIFFITH OPPORTUNITY SCH          ,CO,80204-2197,Public       ,11,88,99,809,3103,3912
00729700,REDSTONE COLLEGE                        ,CO,80020-9988,Proprietary  ,15,46,61,413,1231,1644
00732912,ITT TECHNICAL INSTITUTE                 ,CO,80229-5338,Proprietary  ,33,171,204,380,1809,2189
00754700,LINCOLN COLLEGE OF TECHNOLOGY           ,CO,80223-0000,Proprietary  ,59,97,156,1557,1611,3168
00754800,WESTWOOD COLLEGE - DENVER NORTH         ,CO,80221-3653,Proprietary  ,14,61,75,381,1759,2140
00754801,WESTWOOD COLLEGE - DENVER SOUTH         ,CO,80227-3653,Proprietary  ,6,52,58,219,1154,1373
00758200,AIMS COMMUNITY COLLEGE                  ,CO,80632-0000,Public       ,31,118,149,2658,4941,7599
00764900,ROCKY MOUNTAIN COLG OF ART & DESIGN     ,CO,80214-0000,Proprietary  ,7,22,29,941,799,1740
00793300,FRONT RANGE COMMUNITY COLLEGE           ,CO,80031-2199,Public       ,122,396,518,8766,16916,25682
00863500,INTELLITEC MEDICAL INSTITUTE            ,CO,80909-0000,Proprietary  ,7,27,34,134,751,885
00887100,CONCORDE CAREER INSTITUTE               ,CO,80203-0000,Proprietary  ,20,106,126,476,1949,2425
00889600,PIKES PEAK COMMUNITY COLLEGE            ,CO,80906-5498,Public       ,128,724,852,5852,16782,22634
00940100,COLORADO CHRISTIAN UNIVERSITY           ,CO,80226-7449,Private      ,6,138,144,2145,4381,6526
00954200,COMMUNITY COLLEGE OF DENVER             ,CO,80217-2026,Public       ,85,385,470,6791,15136,21927
00954300,RED ROCKS COMMUNITY COLLEGE             ,CO,80228-1255,Public       ,59,235,294,3658,8185,11843
00998100,MORGAN COMMUNITY COLLEGE                ,CO,80701-4399,Public       ,20,34,54,427,1183,1610
01014800,COLORADO TECHNICAL UNIVERSITY           ,CO,80907-3896,Proprietary  ,18,199,217,523,6441,6964
01014802,COLORADO TECHNICAL UNIV - DENVER        ,CO,80111-3201,Proprietary  ,1,46,47,146,1428,1574
01014805,COLORADO TECH UNIV - ON LINE            ,CO,80907-0000,Proprietary  ,143,2302,2445,2405,47882,50287
01014806,COLORADO TECH UNIV - FED EXPRESS        ,CO,80921-3800,Proprietary  ,0,0,0,14,92,106
01014808,COLORADO TECH UNIV - USAA               ,CO,80920-1005,Proprietary  ,0,0,0,12,80,92
01014811,COLORADO TECH UNIV-HEWLETT PACKARD      ,CO,80919-2303,Proprietary  ,0,0,0,7,43,50
01014812,COLORADO TECHNICAL UNIVERSITY - WESTMINS,CO,80021-3498,Proprietary  ,4,30,34,137,1137,1274
01014813,COLORADO TECH UNIV - ORACLE             ,CO,80921-3660,Proprietary  ,0,0,0,6,62,68
01014815,COLORADO TECHNCL UNIV PUEBLO            ,CO,81003-2315,Proprietary  ,1,4,5,114,710,824
01070900,EMPIRE BEAUTY SCHOOL-LAKEWOOD           ,CO,80215-0000,Proprietary  ,1,6,7,53,140,193
01157200,COLORADO SCHOOL OF TRADES               ,CO,80215-2996,Proprietary  ,0,10,10,96,601,697
01267000,BEL-REA INST OF ANIMAL TECH             ,CO,80247-3048,Proprietary  ,4,4,8,562,895,1457
01285000,INTERNATIONAL SALON AND SPA ACADEMY     ,CO,80918-3684,Proprietary  ,5,14,19,117,448,565
01287500,PICKENS TECHNICAL COLLEGE               ,CO,80011-9307,Public       ,10,22,32,481,1210,1691
01300700,NAZARENE BIBLE COLLEGE                  ,CO,80910-3717,Private      ,0,18,18,72,717,789
02072200,EMPIRE BEAUTY SCHOOL -ARVADA            ,CO,80212-0000,Proprietary  ,1,10,11,85,203,288
02078900,ART INSTITUTE OF COLORADO (THE)         ,CO,80203-2983,Proprietary  ,35,114,149,2204,2949,5153
02116300,PUEBLO COMMUNITY COLLEGE                ,CO,81004-0000,Public       ,44,251,295,2472,7472,9944
02117500,NAROPA UNIVERSITY                       ,CO,80302-0000,Private      ,1,7,8,382,1417,1799
02133100,COLORADO CENTER FOR MEDICAL LABORATORY S,CO,80218-0000,Private      ,0,0,0,72,225,297
02141100,EMPIRE BEAUTY SCHOOL-LITTLETON          ,CO,80030-0000,Proprietary  ,12,15,27,120,316,436
02156200,DELTA - MONTROSE TECHNICAL COLLEGE      ,CO,81416-0000,Public       ,1,8,9,109,360,469
02160600,EMPIRE BEAUTY SCHOOL -THORNTON          ,CO,80241-1659,Proprietary  ,6,11,17,92,244,336
02165200,SALON PROFESSIONAL ACADEMY (THE)        ,CO,81504-5309,Proprietary  ,1,1,2,82,148,230
02167600,KAPLAN COLLEGE                          ,CO,80229-5309,Proprietary  ,0,0,0,42,410,452
02171300,TRINIDAD STATE JUNIOR COLLEGE           ,CO,81101-0000,Proprietary  ,0,0,0,0,3,3
02211901,CHEEKS INTERNATIONAL ACADEMY OF BEAUTY C,CO,80525-3053,Proprietary  ,0,0,0,32,101,133
02211902,CHEEKS INTERNATIONAL ACDMY BTY CULT     ,CO,80631-0000,Proprietary  ,0,1,1,20,80,100
02253700,INTELLITEC COLLEGE                      ,CO,80909-0000,Proprietary  ,7,68,75,217,1126,1343
02267500,GLENWOOD BEAUTY ACADEMY                 ,CO,81601-0000,Proprietary  ,3,6,9,25,65,90
02276900,COMMUNITY COLLEGE OF AURORA             ,CO,80011-9036,Public       ,55,292,347,3242,9050,12292
02296004,PRINCE INSTITUTE - SOUTHEAST - PRINCE IN,CO,80031-2943,Proprietary  ,0,0,0,19,224,243
02518500,HAIR DYNAMICS EDUCATION CENTER          ,CO,80525-0000,Proprietary  ,4,8,12,130,259,389
02594300,COLLEGE AMERICA - DENVER                ,CO,80222-3380,Proprietary  ,39,209,248,563,3445,4008
02611000,HERITAGE COLLEGE                        ,CO,80212-7413,Proprietary  ,22,70,92,349,1056,1405
03006300,INST OF BUSINESS & MEDICAL CAREERS      ,CO,80525-3044,Proprietary  ,12,92,104,415,1771,2186
03010622,VIRGINIA COLLEGE - ECOTECH INSTITUTE - A,CO,80014-1405,Proprietary  ,2,17,19,113,399,512
03012100,REMINGTON COLLEGE - COLORADO SPRINGS CAM,CO,80215-0000,Private      ,0,0,0,28,153,181
03013100,BOULDER COLLEGE OF MASSAGE THERAPY      ,CO,80301-3295,Private      ,0,3,3,114,316,430
03014900,PLATT COLLEGE                           ,CO,80014-3141,Proprietary  ,1,7,8,75,379,454
03027400,XENON INTERNATIONAL ACADEMY III         ,CO,80014-1193,Proprietary  ,6,10,16,91,173,264
03030606,UTAH COLLEGE OF MASSAGE THERAPY - DENVER,CO,80031-2921,Proprietary  ,8,12,20,112,257,369
03030607,UTAH COLLEGE OF MASSAGE THERAPY - DENVER,CO,80012-2523,Proprietary  ,8,8,16,112,245,357
03066900,INTELLITEC COLLEGE                      ,CO,81506-3994,Proprietary  ,11,54,65,257,944,1201
03068201,OHIO CENTER FOR BROADCASTING - COLORADO ,CO,80214-4129,Proprietary  ,3,5,8,83,224,307
03076401,BRYMAN SCHOOL OF ARIZONA (THE) - ANTHEM ,CO,80014-2622,Proprietary  ,7,14,21,41,122,163
03289300,COLORADO HEIGHTS UNIVERSITY             ,CO,80236-2711,Private      ,5,29,34,154,618,772
03306300,MONTESSORI EDUC CRT OF THE ROCKIES      ,CO,80301-2587,Private      ,0,2,2,2,95,97
03534300,JONES INTERNATIONAL UNIVERSITY          ,CO,80112-3446,Proprietary  ,24,476,500,280,8239,8519
03545300,UNIVERSITY OF THE ROCKIES               ,CO,80903-3612,Proprietary  ,2,194,196,126,3417,3543
03584400,COLORADO SCHOOL OF HEALING ARTS         ,CO,80226-4332,Proprietary  ,0,10,10,93,318,411
03670300,TONI & GUY HAIRDRESSING ACADEMY         ,CO,80911-0000,Proprietary  ,13,20,33,119,275,394
03686300,COLORADO SCHOOL OF TRADITIONAL CHINESE M,CO,80206-2127,Proprietary  ,1,5,6,21,310,331
03776300,CULINARY SCHOOL OF THE ROCKIES          ,CO,80305-5961,Proprietary  ,14,27,41,292,512,804
03972300,CUTTIN' UP BEAUTY ACADEMY               ,CO,80220-0000,Proprietary  ,0,0,0,29,79,108
03976300,MASSAGE THERAPY INSTITUTE OF COLORADO   ,CO,80206-2127,Proprietary  ,1,6,7,98,260,358
04080300,ASPEN UNIVERSITY                        ,CO,80246-1930,Proprietary  ,2,34,36,126,844,970
04093300,ACADEMY OF NATURAL THERAPY              ,CO,80631-3425,Proprietary  ,2,3,5,58,172,230
04121200,INSTITUTE OF TAOIST EDUCATION AND ACUPUN,CO,80027-1028,Private      ,0,0,0,2,75,77
04125100,MONTESSORI CASA INTERNATIONAL           ,CO,80111-5263,Private      ,0,0,0,0,13,13
04127700,AMERICAN SENTINEL UNIVERSITY            ,CO,80014-6510,Proprietary  ,3,95,98,38,1710,1748
04139300,NATIONAL BEAUTY COLLEGE                 ,CO,80221-0000,Proprietary  ,2,13,15,48,229,277
04148300,DENVER SCHOOL OF NURSING                ,CO,80202-1213,Proprietary  ,2,17,19,358,1447,1805
04151100,SUMMIT SALON & BEAUTY SCHOOL            ,CO,80866-4569,Proprietary  ,0,0,0,0,32,32
04167100,AVEDA INSTITUTE DENVER                  ,CO,80202-0000,Proprietary  ,5,12,17,363,649,1012
04170200,PAUL MITCHELL THE SCHOOL COLORADO SPRING,CO,80903-0000,Proprietary  ,6,25,31,196,499,695
04172500,ROLF INSTITUTE OF STRUCTURAL INTEGRATION,CO,80301-0000,Private      ,0,8,8,12,144,156
04173800,SALON PROFESSIONAL ACADEMY (THE)        ,CO,80918-2932,Proprietary  ,3,6,9,88,219,307
04177100,PIMA MEDICAL INSTITUTE-SOUTH DENVER     ,CO,80231-0000,Proprietary  ,13,30,43,242,751,993
04179700,UNITED BEAUTY COLLEGE                   ,CO,80223-2936,Proprietary  ,3,14,17,45,155,200
04183700,HEALING ARTS INSTITUTE                  ,CO,80525-3479,Proprietary  ,2,3,5,52,170,222
04184900,COLLEGE OF INTERNATIONAL ESTHETICS      ,CO,80002-3754,Proprietary  ,2,8,10,42,243,285
04185000,COLORADO ACADEMY OF VETERINARY TECHNOLOG,CO,80906-4944,Proprietary  ,4,6,10,134,251,385
04185400,NATIONAL PERSONAL TRAINING INSTITUTE OF ,CO,80401-3304,Proprietary  ,1,2,3,43,170,213
04195300,LONGS PEAK ACADEMY                      ,CO,80501-6458,Proprietary  ,2,3,5,38,85,123
04202600,NEW DIMENSIONS BEAUTY ACADEMY           ,CO,80138-9801,Proprietary  ,1,3,4,23,73,96
04208700,COLORADO STATE UNIVERSITY - GLOBAL CAMPU,CO,80111-0000,Public       ,7,327,334,150,3700,3850
04218900,ROCKY VISTA UNIVERSITY COLLEGE OF OSTEOP,CO,80134-9498,Proprietary  ,0,1,1,0,343,343
00267811,BRYANT & STRATTON COLLEGE - VIRGINIA BEA,VA,23462-4417,Proprietary  ,25,192,217,857,4412,5269
00370200,AVERETT UNIVERSITY                      ,VA,24541-3692,Private      ,15,133,148,1746,1993,3739
00370300,BLUEFIELD COLLEGE                       ,VA,24605-1799,Private      ,5,13,18,977,790,1767
00370400,BRIDGEWATER COLLEGE                     ,VA,22812-1599,Private      ,1,2,3,3662,243,3905
00370500,COLLEGE OF WILLIAM & MARY               ,VA,23187-8795,Public       ,4,29,33,11782,5003,16785
00370600,CHRISTOPHER NEWPORT UNIVERSITY          ,VA,23606-3072,Public       ,11,21,32,8701,1798,10499
00370700,RICHARD BLAND COLLEGE                   ,VA,23805-7100,Public       ,7,7,14,1699,943,2642
00370800,EASTERN MENNONITE UNIVERSITY            ,VA,22802-2462,Private      ,2,6,8,1338,647,1985
00370900,EMORY & HENRY COLLEGE                   ,VA,24327-0010,Private      ,0,1,1,1589,184,1773
00371100,FERRUM COLLEGE                          ,VA,24088-2612,Private      ,8,3,11,3394,390,3784
00371200,TIDEWATER COMMUNITY COLLEGE             ,VA,23510-1910,Public       ,148,1001,1149,13649,32395,46044
00371300,HAMPDEN-SYDNEY COLLEGE                  ,VA,23943-0128,Private      ,1,0,1,1669,63,1732
00371400,HAMPTON UNIVERSITY                      ,VA,23668-0099,Private      ,34,54,88,9582,4387,13969
00371500,HOLLINS UNIVERSITY                      ,VA,24020-0000,Private      ,1,8,9,891,714,1605
00371900,LONGWOOD UNIVERSITY                     ,VA,23909-1899,Public       ,7,15,22,6069,1022,7091
00372000,LYNCHBURG COLLEGE                       ,VA,24501-3199,Private      ,7,30,37,3818,1247,5065
00372100,JAMES MADISON UNIVERSITY                ,VA,22807-3780,Public       ,31,26,57,25983,3331,29314
00372300,MARY BALDWIN COLLEGE                    ,VA,24401-3610,Private      ,8,46,54,1839,1370,3209
00372400,MARYMOUNT UNIVERSITY                    ,VA,22207-4224,Private      ,15,38,53,3099,2906,6005
00372600,NATIONAL COLLEGE                        ,VA,24153-4524,Proprietary  ,24,233,257,680,6049,6729
00372700,NORTHERN VA CMTY CLG                    ,VA,22003-3743,Public       ,275,881,1156,18029,25118,43147
00372800,OLD DOMINION UNIVERSITY                 ,VA,23529-0052,Public       ,69,266,335,20799,17575,38374
00373200,RADFORD UNIVERSITY                      ,VA,24142-6905,Public       ,18,23,41,11438,3033,14471
00373300,RANDOLPH-MACON COLLEGE                  ,VA,23005-5505,Private      ,5,2,7,3098,205,3303
00373400,RANDOLPH COLLEGE                        ,VA,24503-1526,Private      ,2,9,11,968,216,1184
00373500,VIRGINIA COMMONWEALTH UNIVERSITY        ,VA,23284-9004,Public       ,84,164,248,28019,17037,45056
00373600,ROANOKE COLLEGE                         ,VA,24153-3794,Private      ,3,6,9,3517,341,3858
00373700,SHENANDOAH UNIVERSITY                   ,VA,22601-5195,Private      ,6,26,32,3258,2408,5666
00373800,SOUTHERN VIRGINIA UNIVERSITY            ,VA,24416-3038,Private      ,2,7,9,1329,398,1727
00373900,ST PAULS COLLEGE                        ,VA,23868-1299,Private      ,2,5,7,471,350,821
00374200,SWEET BRIAR COLLEGE                     ,VA,24595-9998,Private      ,1,1,2,1039,109,1148
00374300,UNION PRESBYTERIAN SEMINARY             ,VA,23227-0000,Private      ,0,3,3,6,135,141
00374400,UNIVERSITY OF RICHMOND                  ,VA,23173-0001,Private      ,3,30,33,7518,3707,11225
00374500,UNIVERSITY OF VIRGINIA - SFS            ,VA,22903-0000,Public       ,38,56,94,22422,9425,31847
00374600,UNIVERSITY OF MARY WASHINGTON           ,VA,22401-5358,Public       ,14,29,43,5901,1828,7729
00374700,UNIV OF VIRGINIA'S COLLEGE AT WISE      ,VA,24293-4412,Public       ,5,7,12,2190,668,2858
00374800,EASTERN SHORE COMMUNITY COLLEGE         ,VA,23410-3001,Public       ,1,12,13,452,800,1252
00374900,GEORGE MASON UNIVERSITY                 ,VA,22030-4444,Public       ,57,192,249,22528,18613,41141
00375100,PATRICK HENRY COMMUNITY COLLEGE         ,VA,24112-5311,Public       ,11,74,85,1357,3034,4391
00375200,VIRGINIA INTERMONT COLLEGE              ,VA,24201-4298,Private      ,1,5,6,585,379,964
00375300,VIRGINIA MILITARY INSTITUTE             ,VA,24450-2138,Public       ,3,1,4,2400,145,2545
00375400,VIRGINIA POLYTECH INST & STATE UNIV     ,VA,24061-2000,Public       ,104,70,174,27701,6548,34249
00375800,DANVILLE COMMUNITY COLLEGE              ,VA,24541-4004,Public       ,30,130,160,1808,3537,5345
00375900,J. SARGEANT REYNOLDS COMMUNITY CLG      ,VA,23285-0000,Public       ,75,269,344,6481,14263,20744
00376000,VIRGINIA WESTERN CMTY COLLEGE           ,VA,24038-0000,Public       ,30,144,174,3325,5466,8791
00376100,WYTHEVILLE COMMUNITY COLLEGE            ,VA,24382-3308,Public       ,29,64,93,1481,2358,3839
00376200,VIRGINIA UNIVERSITY OF LYNCHBURG        ,VA,24501-6400,Private      ,5,18,23,493,958,1451
00376400,VIRGINIA STATE UNIVERSITY               ,VA,23806-0001,Public       ,32,42,74,11467,4358,15825
00376500,NORFOLK STATE UNIVERSITY                ,VA,23504-8000,Public       ,47,116,163,10207,9146,19353
00376600,VIRGINIA UNION UNIVERSITY               ,VA,23220-1711,Private      ,15,30,45,5208,2032,7240
00376700,VIRGINIA WESLEYAN COLLEGE               ,VA,23502-5599,Private      ,5,20,25,3544,1193,4737
00376800,WASHINGTON & LEE UNIVERSITY             ,VA,24450-0303,Private      ,0,0,0,3071,1535,4606
00400400,JOHN TYLER COMMUNITY COLLEGE            ,VA,23831-5316,Public       ,65,211,276,4487,7405,11892
00450301,"EVEREST COLLEGE- EVEREST COLLEGE, MCLEAN",VA,22102-3000,Proprietary  ,6,40,46,131,610,741
00450702,"EVEREST COLLEGE- EVEREST COLLEGE, ARLING",VA,22203-1905,Proprietary  ,1,4,5,110,542,652
00498800,CENTRAL VIRGINIA COMMUNITY COLLEGE      ,VA,24502-2498,Public       ,23,78,101,2001,3116,5117
00499200,MILLER-MOTTE TECHNICAL COLLEGE          ,VA,24505-0000,Proprietary  ,15,68,83,343,1523,1866
00499600,DABNEY S LANCASTER COMMUNITY CLG        ,VA,24422-1000,Public       ,12,22,34,629,782,1411
00522300,NEW RIVER COMMUNITY COLLEGE             ,VA,24084-1127,Public       ,11,43,54,1813,2825,4638
00662200,COLLEGE OF HEALTH SCIENCES - CHRV       ,VA,24031-0000,Private      ,6,15,21,699,1309,2008
00681900,BLUE RIDGE COMMUNITY COLLEGE            ,VA,24486-0080,Public       ,25,76,101,2444,3008,5452
00687100,THOMAS NELSON COMMUNITY COLLEGE         ,VA,23670-0000,Public       ,69,347,416,4804,11779,16583
00709900,VIRGINIA HIGHLANDS COMMUNITY CLG        ,VA,24210-4210,Public       ,1,32,33,1132,2015,3147
00726000,SOUTHWEST VIRGINIA COMMUNITY CLG        ,VA,24641-0000,Public       ,16,30,46,1226,2045,3271
00859200,LOUISE OBICI SCHOOL OF NURSING          ,VA,23434-8038,Private      ,0,0,0,25,112,137
00865900,LORD FAIRFAX COMMUNITY COLLEGE          ,VA,22645-0047,Public       ,44,114,158,2622,3780,6402
00866000,GERMANNA COMMUNITY COLLEGE              ,VA,22508-0339,Public       ,41,123,164,3201,4831,8032
00866100,SOUTHSIDE VIRGINIA CMTY CLG             ,VA,23821-2930,Public       ,71,188,259,1979,3839,5818
00915900,PAUL D CAMP COMMUNITY COLLEGE           ,VA,23851-0737,Public       ,10,70,80,613,1647,2260
00916000,RAPPAHANNOCK COMMUNITY COLLEGE          ,VA,23149-2616,Public       ,11,68,79,1099,1846,2945
00926700,EVEREST COLLEGE                         ,VA,23606-4203,Proprietary  ,12,71,83,180,1150,1330
00926701,EVEREST COLLEGE - CHESAPEAKE            ,VA,23320-2637,Proprietary  ,16,122,138,281,1489,1770
00942000,SANFORD-BROWN COLLEGE                   ,VA,22182-3913,Proprietary  ,1,11,12,172,836,1008
00953500,STAUNTON SCHOOL OF COSMETOLOGY          ,VA,24401-4323,Proprietary  ,2,0,2,35,69,104
00953700,VIRGINIA SCH OF HAIR DESIGN             ,VA,23669-0000,Proprietary  ,1,8,9,85,294,379
00962900,MOUNTAIN EMPIRE COMMUNITY COLLEGE       ,VA,24219-0700,Public       ,4,31,35,1262,2174,3436
00992800,PIEDMONT VIRGINIA COMMUNITY COLLEGE     ,VA,22902-7589,Public       ,30,90,120,1918,3544,5462
01004300,BON SECOURS MEMORIAL COLLEGE OF NURSING ,VA,23227-4612,Private      ,1,7,8,355,963,1318
01019800,ECPI COLLEGE OF TECHNOLOGY              ,VA,23462-6542,Proprietary  ,108,702,810,3013,13424,16437
01033800,EASTERN VIRGINIA MEDICAL SCHOOL         ,VA,23501-1980,Public       ,4,16,20,157,1864,2021
01159600,RALPH'S VIRGINIA SCH OF COSMETOLOGY     ,VA,24501-2652,Proprietary  ,1,8,9,40,142,182
01162601,WESTWOOD COLLEGE - SOUTH BAY - ARLINGTON,VA,22203-4167,Proprietary  ,10,28,38,334,868,1202
01162602,WESTWOOD COLLEGE - SOUTH BAY - ANNANDALE,VA,22003-2602,Proprietary  ,5,33,38,200,744,944
01274400,SOUTHSIDE REGIONAL MED CTR PROF SCHOOLS ,VA,23803-5133,Proprietary  ,0,4,4,104,406,510
02053000,LIBERTY UNIVERSITY                      ,VA,24502-0000,Private      ,223,4072,4295,21798,92643,114441
02083602,TESST COLLEGE OF TECHNOLOGY - KAPLAN COL,VA,23320-4422,Proprietary  ,1,6,7,73,452,525
02108800,WARDS CORNER BEAUTY ACADEMY             ,VA,23505-0000,Proprietary  ,5,44,49,97,552,649
02111600,DANVILLE REGIONAL MEDICAL CENTER SCHOOL ,VA,24541-0000,Proprietary  ,2,6,8,60,156,216
02119203,COURT REPORTING INSTITUTE OF DALLAS - CO,VA,22203-4179,Proprietary  ,0,1,1,4,48,52
02128700,CENTRAL SCHOOL OF PRACTICAL NURSING     ,VA,23502-2230,Public       ,2,15,17,147,470,617
02140000,RIVERSIDE SCHOOL OF HEALTH CAREERS      ,VA,23608-3802,Private      ,2,12,14,248,976,1224
02149901,PAUL MITCHELL THE SCHOOL-JACKSONVILLE - ,VA,22102-0000,Proprietary  ,1,6,7,1,8,9
02149902,PAUL MITCHELL THE SCHOOL-JACKSONVILLE - ,VA,22192-0000,Proprietary  ,3,5,8,3,5,8
02175800,LYNCHBURG GENERAL HOSP SCH OF NURSG     ,VA,24501-0000,Private      ,2,9,11,132,318,450
02197600,WOODROW WILSON REHABILITATION CTR       ,VA,22939-0000,Public       ,2,0,2,66,54,120
02242400,HENRICO CTY ST MARYS HOSP PRAC NRSG     ,VA,23075-0000,Public       ,0,0,0,25,97,122
02304500,HERITAGE INSTITUTE                      ,VA,20111-0000,Proprietary  ,0,0,0,3,20,23
02320900,TIDEWATER TECH                          ,VA,23502-1747,Proprietary  ,17,74,91,323,1466,1789
02334400,CENTURA COLLEGE                         ,VA,23452-0000,Proprietary  ,31,319,350,566,5206,5772
02342700,FORTIS COLLEGE                          ,VA,23502-4101,Proprietary  ,5,40,45,159,953,1112
02342701,FORTIS COLLEGE - RICHMOND CAMPUS        ,VA,23236-3472,Proprietary  ,25,62,87,320,1210,1530
02358500,BON SECOURS SAINT MARY'S HOSPITAL SCHOOL,VA,23227-4612,Private      ,2,7,9,137,509,646
02538800,SUFFOLK BEAUTY ACADEMY                  ,VA,23434-0000,Proprietary  ,2,11,13,39,152,191
02541200,STRATFORD UNIVERSITY                    ,VA,22043-0000,Proprietary  ,18,107,125,525,2525,3050
02541201,STRATFORD UNIVERSITY-WOODBRIDGE         ,VA,22192-0000,Proprietary  ,5,39,44,272,1273,1545
02588900,MEDTECH INSTITUTE                       ,VA,22042-3013,Proprietary  ,49,228,277,452,1912,2364
02610100,WASHINGTON COUNTY ADULT SKILL CTR       ,VA,24210-2346,Public       ,1,2,3,53,213,266
03002400,GRAHAM WEBB INTERNATIONAL ACAD HAIR     ,VA,22209-2129,Proprietary  ,3,9,12,64,164,228
03010700,BAR PALMA BEAUTY CAREERS  ACADEMY       ,VA,24014-2255,Proprietary  ,1,13,14,46,178,224
03042800,"VIRGINIA BEACH CITY SCHOOLS, SCH.-PR.NSG",VA,23456-0038,Public       ,1,6,7,80,276,356
03091100,ACT COLLEGE                             ,VA,22209-2297,Proprietary  ,0,0,0,35,87,122
03091300,REGENT UNIVERSITY                       ,VA,23464-9800,Private      ,6,159,165,1874,7836,9710
03092700,SKYLINE COLLEGE                         ,VA,24012-1603,Proprietary  ,5,26,31,148,580,728
03096500,SPRINGFIELD BEAUTY ACADEMY              ,VA,22003-3016,Proprietary  ,1,15,16,19,166,185
03106500,SENTARA NORFOLK GENERAL HOSPITAL        ,VA,23320-2843,Private      ,1,18,19,227,915,1142
03116900,BAPTIST THEOLOGICAL SEM.-RICHMOND       ,VA,23227-0000,Private      ,0,1,1,9,204,213
03126300,AVIATION INSTITUTE OF MAINTENANCE       ,VA,23320-5987,Proprietary  ,7,36,43,165,691,856
03126400,CENTURA COLLEGE                         ,VA,23235-5230,Proprietary  ,22,88,110,295,1581,1876
03127500,ADVANCED TECHNOLOGY INSTITUTE           ,VA,23462-2409,Proprietary  ,9,62,71,624,1205,1829
03280400,VIRGINIA SCHOOL OF MASSAGE              ,VA,22903-0000,Proprietary  ,1,3,4,83,207,290
03409500,RICHMOND SCHOOL OF HEALTH AND TECH      ,VA,23227-0000,Proprietary  ,3,39,42,140,799,939
03455300,CRESCENT COSMETOLOGY UNIVERSITY         ,VA,23666-3115,Proprietary  ,0,2,2,25,101,126
03559300,APPALACHIAN SCHOOL OF LAW               ,VA,24614-0000,Private      ,1,1,2,18,580,598
03645400,RUDY & KELLY ACADEMY OF HAIR AND NA     ,VA,23464-6857,Proprietary  ,8,17,25,195,485,680
03654300,CAREER TRAINING SOLUTIONS               ,VA,22406-1014,Proprietary  ,4,23,27,200,1021,1221
03709300,EDWARD VIA VIRGINIA CLG OSTEOPATHIC MED ,VA,24060-6360,Private      ,0,2,2,12,869,881
03872400,INSTITUTE FOR THE PSYCHOLOGICAL SCIENCES,VA,22202-3609,Private      ,0,0,0,20,178,198
03876300,CULPEPER COSMETOLOGY TRAINING CENTER    ,VA,22701-3155,Public       ,1,1,2,34,89,123
03883400,AVIATION INSTITUTE OF MAINTENANCE       ,VA,20110-4156,Proprietary  ,6,36,42,125,581,706
04038400,AVI CAREER INSTITUTE                    ,VA,22066-1839,Proprietary  ,1,16,17,13,158,171
04110300,UNIVERSITY OF MANAGEMENT AND TECHNOLOGY ,VA,22209-1609,Proprietary  ,1,46,47,32,548,580
04124000,DOMINION SCHOOL OF HAIR DESIGN          ,VA,23062-2221,Proprietary  ,2,6,8,18,68,86
04127300,COLUMBIA COLLEGE                        ,VA,22031-4413,Proprietary  ,5,59,64,78,775,853
04133400,CENTURA COLLEGE                         ,VA,22312-2670,Proprietary  ,7,45,52,100,442,542
04133800,SOUTHEAST CULINARY & HOSPITALITY COLLEGE,VA,24201-4159,Proprietary  ,0,1,1,63,151,214
04137300,CAYCE/REILLY SCHOOL OF MASSOTHERAPY     ,VA,23451-2061,Private      ,0,3,3,19,139,158
04140000,GLOBAL HEALTH NURSE TRAINING SERVICES   ,VA,22314-4585,Proprietary  ,0,19,19,55,618,673
04153800,BETHEL COLLEGE                          ,VA,23666-3122,Private      ,1,3,4,59,180,239
04156200,INSTITUTE OF ADVANCED MEDICAL ESTHETICS ,VA,23294-4701,Proprietary  ,0,3,3,27,186,213
04169400,NORTHERN VIRGINIA SCHOOL OF THERAPEUTIC ,VA,22046-4302,Proprietary  ,0,4,4,34,162,196
04171500,COSMOPOLITAN BEAUTY & TECH SCHOOL       ,VA,22003-3204,Proprietary  ,1,21,22,19,262,281
04179900,TOMORROW'S IMAGE BARBER ACADEMY OF VIRGI,VA,23602-5532,Proprietary  ,0,12,12,8,89,97
04180600,APPALACHIAN COLLEGE OF PHARMACY         ,VA,24631-9210,Private      ,0,1,1,33,347,380
04220400,CHRYSM INSTITUTE OF ESTHETICS (THE)     ,VA,23462-3650,Proprietary  ,3,10,13,6,27,33
00107000,THUNDERBIRD SCHOOL OF GLOBAL MANAGEMENT ,AZ,85306-6000,Private      ,1,18,19,35,827,862
00107100,ARIZONA WESTERN COLLEGE                 ,AZ,85366-0000,Public       ,105,145,250,5397,5790,11187
00107200,COCHISE COLLEGE                         ,AZ,85607-6190,Public       ,34,113,147,1761,3437,5198
00107300,EASTERN ARIZONA COLLEGE                 ,AZ,85552-0769,Public       ,8,36,44,1807,2008,3815
00107400,GRAND CANYON UNIVERSITY                 ,AZ,85017-3030,Proprietary  ,237,5098,5335,11962,70313,82275
00107600,GLENDALE COMMUNITY COLLEGE              ,AZ,85302-3090,Public       ,143,382,525,12708,18259,30967
00107700,MESA COMMUNITY COLLEGE                  ,AZ,85202-4866,Public       ,160,534,694,13500,23241,36741
00107800,PHOENIX COLLEGE                         ,AZ,85013-4234,Public       ,76,450,526,7436,18250,25686
00107900,YAVAPAI COLLEGE                         ,AZ,86301-3297,Public       ,27,129,156,2518,5231,7749
00108100,ARIZONA STATE UNIV (ALL CAMPUSES)       ,AZ,85287-0412,Public       ,238,829,1067,60908,48474,109382
00108200,NORTHERN ARIZONA UNIVERSITY             ,AZ,86011-0001,Public       ,131,289,420,31509,16791,48300
00108300,UNIVERSITY OF ARIZONA                   ,AZ,85721-0066,Public       ,258,278,536,35625,18236,53861
00165701,MIDWESTERN UNIVERSITY                   ,AZ,85308-0000,Private      ,1,26,27,218,4278,4496
00446700,TUCSON COLLEGE                          ,AZ,85711-3781,Proprietary  ,6,42,48,357,1102,1459
00711300,ARIZONA CHRISTIAN UNIVERSITY            ,AZ,85032-7097,Private      ,9,14,23,867,657,1524
00726600,PIMA COUNTY COMMUNITY COLLEGE           ,AZ,85709-1110,Public       ,119,371,490,12697,21348,34045
00728300,CENTRAL ARIZONA COLLEGE                 ,AZ,85228-9779,Public       ,49,165,214,3339,6103,9442
00732911,ITT TECHNICAL INSTITUTE                 ,AZ,85282-9272,Proprietary  ,49,299,348,735,3432,4167
00732990,ITT TECHNICAL INSTITUTE                 ,AZ,85704-5829,Proprietary  ,82,385,467,876,3029,3905
00822100,UNIVERSAL TECHNICAL INSTITUTE           ,AZ,85323-7946,Proprietary  ,191,310,501,8957,8684,17641
00824600,DINÉ COLLEGE                            ,AZ,86556-0126,Public       ,12,44,56,1075,1891,2966
00830300,GATEWAY COMMUNITY COLLEGE               ,AZ,85034-1795,Public       ,79,265,344,3892,10933,14825
00830302,MARICOPA SKILL CENTER                   ,AZ,85034-0000,Public       ,9,85,94,486,1986,2472
00830400,SCOTTSDALE COMMUNITY COLLEGE            ,AZ,85250-0000,Public       ,50,125,175,5171,6758,11929
00886400,ARIZONA ACADEMY OF BEAUTY               ,AZ,85712-5021,Proprietary  ,3,9,12,115,246,361
00886500,ARTISTIC BEAUTY COLLEGES-TUCSON         ,AZ,85716-3999,Proprietary  ,7,27,34,155,385,540
01084700,ARIZONA AUTOMOTIVE INSTITUTE            ,AZ,85301-3503,Proprietary  ,21,59,80,432,1231,1663
01085800,AVALON SCHOOL OF COSMETOLOGY            ,AZ,85210-4010,Proprietary  ,61,64,125,594,1024,1618
01168900,REFRIGERATION SCHOOL                    ,AZ,85034-0000,Proprietary  ,18,77,95,197,1295,1492
01180200,ARIZONA ACADEMY OF BEAUTY-NORTH         ,AZ,85705-2720,Proprietary  ,2,7,9,55,168,223
01180800,ARTISTIC BEAUTY COLLEGES-FLAGSTAFF      ,AZ,86004-5119,Proprietary  ,13,18,31,206,363,569
01186200,NORTHLAND PIONEER COLLEGE               ,AZ,86025-0610,Public       ,9,45,54,842,2321,3163
01186400,MOHAVE COMMUNITY COLLEGE                ,AZ,86409-1238,Public       ,41,140,181,1807,5722,7529
01218400,INTERNATIONAL ACAD OF HAIR DESIGN       ,AZ,85225-7198,Proprietary  ,7,27,34,112,336,448
01234300,ARTISTIC BEAUTY COLLEGES-PHOENIX        ,AZ,85304-0000,Proprietary  ,16,25,41,208,431,639
01293700,ARTISTIC BEAUTY COLLEGES - PARADISE VALL,AZ,85257-0000,Proprietary  ,5,20,25,149,389,538
02065300,PRESCOTT COLLEGE                        ,AZ,86301-0000,Private      ,1,19,20,839,1411,2250
02071200,KAPLAN COLLEGE                          ,AZ,85029-4349,Proprietary  ,4,39,43,437,2397,2834
02098800,UNIVERSITY OF PHOENIX                   ,AZ,85040-0000,Proprietary  ,985,22137,23122,23796,448428,472224
02100500,UNIVERSAL TECHNICAL INSTITUTE           ,AZ,85027-0000,Proprietary  ,133,267,400,6855,10307,17162
02100600,CARRINGTON COLLEGE                      ,AZ,85015-4096,Proprietary  ,106,287,393,1958,5973,7931
02113800,ROBERTO-VENN SCH OF LUTHIERY            ,AZ,85040-0000,Proprietary  ,1,2,3,37,94,131
02146600,SOUTH MOUNTAIN COMMUNITY COLLEGE        ,AZ,85040-0000,Public       ,33,164,197,3188,6157,9345
02160305,COLLINS COLLEGE                         ,AZ,85040-4000,Proprietary  ,2,12,14,677,1292,1969
02160306,INTERNATIONAL ACADEMY OF DESIGN AND TECH,AZ,85281-6705,Proprietary  ,0,3,3,64,114,178
02171500,WESTERN INTERNATIONAL UNIVERSITY        ,AZ,85021-0000,Proprietary  ,2,81,83,101,2928,3029
02177500,RIO SALADO COMMUNITY COLLEGE            ,AZ,85281-6948,Public       ,73,852,925,3623,27077,30700
02192300,MARICOPA BEAUTY COLLEGE                 ,AZ,85323-0000,Proprietary  ,0,0,0,36,74,110
02199900,AMERICAN INDIAN CLG-ASSEMBLIES GOD      ,AZ,85021-0000,Private      ,0,1,1,66,179,245
02217100,PIMA MEDICAL INSTITUTE                  ,AZ,85716-0000,Proprietary  ,220,611,831,3641,10575,14216
02218800,BROOKLINE COLLEGE                       ,AZ,85021-5815,Proprietary  ,23,119,142,500,2447,2947
02218804,BROOKLINE COLLEGE - MESA                ,AZ,85204-4448,Proprietary  ,10,36,46,258,1040,1298
02218805,BROOKLINE COLLEGE - TUCSON              ,AZ,85711-5444,Proprietary  ,18,101,119,348,1222,1570
02220300,ARTISTIC BEAUTY COLLEGES-GLENDALE       ,AZ,85051-0000,Proprietary  ,2,20,22,191,588,779
02221302,MARINELLO SCHOOL OF BEAUTY - SPA ACADEMY,AZ,85201-5205,Proprietary  ,0,0,0,37,116,153
02263100,ANTHEM COLLEGE                          ,AZ,85014-0000,Proprietary  ,59,350,409,1073,5503,6576
02280500,CHARLES OF ITALY BEAUTY COLLEGE         ,AZ,86403-0000,Proprietary  ,5,8,13,59,144,203
02295000,EVEREST COLLEGE                         ,AZ,85021-1610,Proprietary  ,74,579,653,887,6042,6929
02295002,EVEREST COLLEGE - MESA                  ,AZ,85206-4704,Proprietary  ,8,65,73,255,1463,1718
02317800,AMERICAN INSTITUTE OF TECHNOLOGY        ,AZ,85043-0000,Proprietary  ,11,117,128,261,1992,2253
02491500,THE ART CENTER DESIGN COLLEGE           ,AZ,85716-0000,Proprietary  ,4,8,12,295,601,896
02521500,LAMSON COLLEGE                          ,AZ,85284-1141,Proprietary  ,0,0,0,25,118,143
02533200,FRANK LLOYD WRIGHT SCHOOL OF ARCHITECTUR,AZ,85261-4430,Private      ,0,2,2,34,82,116
02559000,UNIVERSITY OF ADVANCING TECHNOLOGY      ,AZ,85283-0000,Proprietary  ,6,45,51,1301,1092,2393
02561900,BRILLARE HAIRDRESSING ACADEMY           ,AZ,85254-3301,Proprietary  ,7,6,13,113,194,307
02582700,CORTIVA INSTITUTE - TUCSON              ,AZ,85710-3503,Proprietary  ,3,8,11,117,377,494
02616700,LE CORDON BLEU COLLEGE OF CULINARY ARTS ,AZ,85251-2729,Proprietary  ,44,226,270,1052,3299,4351
02623600,PARADISE VALLEY COMMUNITY COLLEGE       ,AZ,85032-1210,Public       ,42,137,179,4311,6762,11073
02623800,CORTIVA INSTITUTE - SCOTTSDALE          ,AZ,85257-4218,Proprietary  ,1,3,4,43,145,188
03005000,SAFFORD COLLEGE OF BEAUTY CULTURE       ,AZ,85546-3309,Proprietary  ,4,5,9,15,78,93
03010613,VIRGINIA COLLEGE - GOLF ACADEMY OF ARIZO,AZ,85225-6742,Proprietary  ,0,3,3,63,199,262
03030604,UTAH COLLEGE OF MASSAGE THERAPY - ARIZON,AZ,85282-0000,Proprietary  ,7,26,33,158,411,569
03030605,UTAH COLLEGE OF MASSAGE THERAPY - ARIZON,AZ,85051-3470,Proprietary  ,8,24,32,192,560,752
03034400,CONSERVATORY RECORDING ARTS & SCIS      ,AZ,85282-1707,Proprietary  ,17,29,46,855,1018,1873
03072200,CHANDLER-GILBERT COMMUNITY COLLEGE      ,AZ,85225-2499,Public       ,51,205,256,6491,8787,15278
03076400,BRYMAN SCHOOL OF ARIZONA                ,AZ,85029-4919,Proprietary  ,37,110,147,1061,3441,4502
03097800,CARSTEN INSTITUTE OF HAIR & BEAUTY      ,AZ,85282-5404,Proprietary  ,8,13,21,127,271,398
03100400,COCONINO COUNTY COMMUNITY COLLEGE       ,AZ,86001-2701,Public       ,20,61,81,2113,3039,5152
03107000,SOUTHWEST CLG OF NATUROPATHIC MED       ,AZ,85282-0000,Private      ,0,9,9,28,707,735
03115000,ARIZONA COLLEGE OF ALLIED HEALTH        ,AZ,85302-3843,Proprietary  ,25,73,98,438,1526,1964
03120300,COLLEGE AMERICA                         ,AZ,86004-3936,Proprietary  ,40,193,233,388,1873,2261
03156300,ESTRELLA MOUNTAIN COMMUNITY COLLEGE     ,AZ,85392-1010,Public       ,57,211,268,5394,9012,14406
03347300,INTERNATIONAL BAPTIST COLLEGE           ,AZ,85282-6799,Private      ,0,0,0,49,50,99
03445300,HDS TRUCK DRIVING INSTITUTE             ,AZ,85731-0000,Proprietary  ,2,11,13,30,287,317
03478400,PHOENIX SEMINARY                        ,AZ,85018-7611,Private      ,0,3,3,5,249,254
03572300,EAST VALLEY INSTITUTE OF TECHNOLOGY     ,AZ,85201-6910,Public       ,29,31,60,505,1020,1525
03593300,SOUTHWEST INSTITUTE OF HEALING ARTS     ,AZ,85281-3658,Proprietary  ,5,66,71,248,2145,2393
03617500,PHOENIX INSTITUTE OF HERBAL MEDICINE & A,AZ,85012-0000,Proprietary  ,0,9,9,78,518,596
03695500,ARIZONA SCHOOL OF ACUPUNCTURE AND ORIENT,AZ,85712-1100,Proprietary  ,2,2,4,26,164,190
03784400,TOHONO O'ODHAM COMMUNITY COLLEGE        ,AZ,85634-3129,Public       ,2,7,9,87,164,251
03813300,NORTHCENTRAL UNIVERSITY                 ,AZ,86314-2336,Proprietary  ,0,638,638,129,8521,8650
03814300,TURNING POINT BEAUTY COLLEGE            ,AZ,85222-4229,Proprietary  ,2,10,12,38,108,146
04051300,ART INSTITUTE OF PHOENIX (THE)          ,AZ,85021-2859,Proprietary  ,308,1426,1734,8999,29099,38098
04051306,ART INSTITUTE OF PHOENIX (THE) - ART INS,AZ,85712-2732,Proprietary  ,8,23,31,639,816,1455
04051325,ART INSTITUTE OF PHOENIX (THE) - BROWN M,AZ,85712-5300,Proprietary  ,12,65,77,330,1235,1565
04051327,ART INSTITUTE OF PHOENIX (THE) - BROWN M,AZ,85029-1348,Proprietary  ,5,17,22,215,459,674
04059300,TUCSON COLLEGE OF BEAUTY                ,AZ,85705-2451,Proprietary  ,2,14,16,87,232,319
04120900,ARIZONA CULINARY INSTITUTE              ,AZ,85259-4939,Proprietary  ,5,7,12,340,520,860
04131400,PHOENIX SCHOOL OF LAW                   ,AZ,85012-3330,Proprietary  ,0,29,29,122,2198,2320
04139200,UNIVERSAL BARBER COLLEGE                ,AZ,85007-3914,Proprietary  ,2,19,21,127,407,534
04148700,AMERICAN INSTITUTE OF INTERIOR DESIGN   ,AZ,85268-3827,Proprietary  ,1,3,4,26,86,112
04152900,STUDIO ACADEMY OF BEAUTY (THE)          ,AZ,85224-3600,Proprietary  ,9,29,38,119,353,472
04157400,NATIONAL PARALEGAL COLLEGE              ,AZ,85014-1262,Proprietary  ,0,82,82,107,1929,2036
04172100,CCIC BEAUTY COLLEGE                     ,AZ,85345-2410,Proprietary  ,0,0,0,28,95,123
04174100,PAUL MITCHELL THE SCHOOL PHOENIX        ,AZ,85017-1919,Proprietary  ,13,16,29,221,516,737
04174200,ALL BEAUTY COLLEGE                      ,AZ,86426-8326,Proprietary  ,0,5,5,41,139,180
04175300,PENROSE ACADEMY                         ,AZ,85254-4065,Proprietary  ,6,12,18,100,214,314
04177500,PURE AESTHETICS                         ,AZ,85711-2328,Proprietary  ,0,6,6,25,140,165
04191200,CLASSIC COOKING ACADEMY                 ,AZ,85255-8699,Private      ,0,0,0,55,79,134
04194500,AVEDA INSTITUTE TUCSON                  ,AZ,85719-4876,Proprietary  ,11,13,24,126,245,371
04217600,SESSIONS COLLEGE FOR PROFESSIONAL DESIGN,AZ,85281-2840,Proprietary  ,0,4,4,2,29,31
00142800,DELAWARE STATE UNIVERSITY               ,DE,19901-2277,Public       ,40,24,64,9694,3153,12847
00142900,GOLDEY BEACOM COLLEGE                   ,DE,19808-1993,Private      ,0,12,12,712,719,1431
00143100,UNIVERSITY OF DELAWARE                  ,DE,19716-0099,Public       ,47,45,92,27640,3788,31428
00143300,WESLEY COLLEGE                          ,DE,19901-3875,Private      ,9,14,23,2799,931,3730
00143301,WESLEY COLLEGE-CTR FOR ADULT STUDIE     ,DE,19720-0000,Private      ,1,4,5,50,364,414
00331301,WIDENER UNIV SCHOOL OF LAW - DE         ,DE,19803-0000,Private      ,0,8,8,95,1630,1725
00705300,DELAWARE TECH & CMTY COLLEGE-OWENS      ,DE,19947-0000,Public       ,27,120,147,2634,3995,6629
00794800,WILMINGTON UNIVERSITY                   ,DE,19720-6491,Private      ,30,276,306,3015,10792,13807
01172700,DELAWARE TECH & CMTY CLG-TERRY          ,DE,19901-8736,Public       ,30,86,116,2256,3482,5738
02125200,BEEBE SCHOOL OF NURSING                 ,DE,19958-1462,Private      ,1,2,3,77,156,233
02144900,DELAWARE TECH & CMTY CLG-STANTN/WLM     ,DE,19801-0000,Public       ,42,144,186,4374,5918,10292
02190400,SCHILLING DOUGLAS SCH OF HAIR DSGN      ,DE,19711-0000,Proprietary  ,2,18,20,82,193,275
02586902,STAR TECHNICAL INSTITUTE -              ,DE,19901-4615,Proprietary  ,0,2,2,47,158,205
03025800,DAWN TRAINING CENTRE                    ,DE,19805-1511,Proprietary  ,8,62,70,183,1260,1443
03543300,HARRIS SCHOOL OF BUSINESS               ,DE,19803-5341,Proprietary  ,11,60,71,181,717,898
03702300,DELAWARE LEARNING INSTITUTE OF COSMETOLO,DE,19939-9759,Proprietary  ,0,2,2,61,157,218
04130700,ACADEMY OF MASSAGE AND BODYWORK         ,DE,19701-1321,Proprietary  ,4,8,12,40,101,141
04139800,DELAWARE COLLEGE OF ART & DESIGN        ,DE,19801-3007,Private      ,4,2,6,531,199,730
04171100,DELAWARE ACADEMY PAUL MITCHELL PARTNER S,DE,19702-5108,Proprietary  ,3,8,11,120,187,307
        ,FEDERAL STUDENT AID USE ONLY            ,DC,20202-0000,,0,0,0,1,2,3
        ,OFFICIAL USE ONLY                       ,DC,20202-0000,,0,0,0,0,1,1
00143400,AMERICAN UNIVERSITY                     ,DC,20016-8020,Private      ,14,57,71,14575,10908,25483
00143700,CATHOLIC UNIVERSITY OF AMERICA          ,DC,20064-0002,Private      ,8,36,44,6083,2887,8970
00143711,"CATHOLIC UNIV AMERICA, LAW SCHOOL       ",DC,20064-0000,Private      ,1,7,8,82,1635,1717
00144100,UNIV OF THE DISTRICT OF COLUMBIA        ,DC,20008-0000,Public       ,27,139,166,3226,8049,11275
00144102,UNIV OF THE DIST OF COLU -SCHOOL OF LAW ,DC,20008-1173,Public       ,1,3,4,62,1082,1144
00144300,GALLAUDET UNIVERSITY                    ,DC,20002-3695,Private      ,4,15,19,1074,1284,2358
00144400,GEORGE WASHINGTON UNIVERSITY            ,DC,20052-2353,Private      ,15,229,244,14972,13625,28597
00144402,GEORGE WASHINGTON UNIV LAW SCHL         ,DC,20052-0000,Private      ,0,7,7,74,3909,3983
00144403,GEORGE WASHINGTON UNIV SCH MED          ,DC,20052-0000,Private      ,0,8,8,123,1819,1942
00144500,GEORGETOWN UNIVERSITY                   ,DC,20057-1252,Private      ,17,98,115,14038,5827,19865
00144501,"GEORGETOWN UNIV, SCH OF MEDICINE        ",DC,20007-0000,Private      ,1,7,8,138,1654,1792
00144502,GEORGETOWN UNIVERSITY - GRADUATE SCHOOL ,DC,20057-0004,Private      ,1,58,59,80,5476,5556
00144503,GEORGETOWN UNIV LAW CENTER              ,DC,20001-0000,Private      ,1,6,7,83,5299,5382
00144800,HOWARD UNIVERSITY                       ,DC,20059-0001,Private      ,33,58,91,17580,10966,28546
00145900,STRAYER UNIVERSITY                      ,DC,20005-2603,Proprietary  ,40,919,959,2333,59776,62109
00146000,TRINITY UNIVERSITY                      ,DC,20017-1004,Private      ,3,37,40,1638,3472,5110
00146400,WESLEY THEOLOGICAL SEMINARY             ,DC,20016-0000,Private      ,1,6,7,5,382,387
00207701,JOHNS HOPKINS UNIV SCH ADV INTL STU     ,DC,20036-0000,Private      ,1,5,6,74,1675,1749
01006500,WASHINGTON THEOLOGICAL UNION            ,DC,20012-0000,Private      ,0,1,1,3,58,61
01195000,THE CORCORAN COLLEGE OF ART & DESIG     ,DC,20006-4804,Private      ,2,6,8,516,562,1078
01280300,DOMINICAN HOUSE OF STUDIES              ,DC,20017-1584,Private      ,0,4,4,3,32,35
02132800,NAT'L CONSERVATORY DRAMATIC ARTS        ,DC,20007-2758,Private      ,2,1,3,22,78,100
03104300,CAREER BLAZERS LEARNING CENTER OF WASHIN,DC,20037-1881,Proprietary  ,12,83,95,113,1068,1181
03218300,POTOMAC COLLEGE                         ,DC,20016-1860,Proprietary  ,4,34,38,86,720,806
03409600,BENNETT CAREER INSTITUTE                ,DC,20017-1754,Proprietary  ,7,36,43,166,526,692
03750300,TECHNICAL LEARNING CENTERS              ,DC,20006-3749,Proprietary  ,13,70,83,125,894,1019
04114400,INSTITUTE OF WORLD POLITICS (THE)       ,DC,20036-1464,Private      ,1,4,5,13,270,283
04142700,PONTIFICAL JOHN PAUL II INSTITUTE FOR ST,DC,20064-0001,Private      ,0,1,1,2,42,44
04190000,RADIANS COLLEGE                         ,DC,20005-3542,Proprietary  ,6,55,61,14,149,163
00154100,ABRAHAM BALDWIN AGRICULTURAL CLG        ,GA,31794-0000,Public       ,37,64,101,3479,2551,6030
00154200,AGNES SCOTT COLLEGE                     ,GA,30030-3770,Private      ,5,11,16,1580,642,2222
00154300,DARTON COLLEGE                          ,GA,31707-3098,Public       ,93,234,327,4703,8278,12981
00154400,ALBANY STATE UNIVERSITY                 ,GA,31705-2796,Public       ,74,128,202,8620,6500,15120
00154500,ANDREW COLLEGE                          ,GA,39840-1395,Private      ,4,5,9,491,133,624
00154600,ARMSTRONG ATLANTIC STATE UNIVERSITY     ,GA,31419-1997,Public       ,133,165,298,7702,7351,15053
00154700,POINT UNIVERSITY                        ,GA,30344-1999,Private      ,8,24,32,1023,1675,2698
00155400,BERRY COLLEGE                           ,GA,30149-5007,Private      ,11,10,21,3973,452,4425
00155500,THOMAS UNIVERSITY                       ,GA,31792-7499,Private      ,8,48,56,569,1677,2246
00155600,BRENAU UNIVERSITY                       ,GA,30501-3668,Private      ,15,133,148,1819,4593,6412
00155700,BREWTON PARKER COLLEGE                  ,GA,30445-0000,Private      ,26,11,37,675,319,994
00155800,COASTAL GEORGIA COMMUNITY COLLEGE       ,GA,31520-3644,Public       ,39,86,125,2546,3551,6097
00155900,CLARK ATLANTA UNIVERSITY                ,GA,30314-4385,Private      ,48,72,120,14315,7617,21932
00156000,COLUMBIA THEOLOGICAL SEMINARY           ,GA,30031-0000,Private      ,1,3,4,14,295,309
00156100,COLUMBUS STATE UNIVERSITY               ,GA,31907-5645,Public       ,67,185,252,8101,7849,15950
00156200,GEORGIA PERIMETER COLLEGE               ,GA,30021-0000,Public       ,286,599,885,19384,29461,48845
00156300,EMMANUEL COLLEGE                        ,GA,30639-0000,Private      ,2,4,6,928,271,1199
00156400,EMORY UNIVERSITY                        ,GA,30322-1960,Private      ,45,109,154,14319,12404,26723
00156600,FORT VALLEY STATE UNIVERSITY            ,GA,31030-3298,Public       ,39,53,92,6159,3466,9625
00156700,GAINESVILLE STATE COLLEGE               ,GA,30503-0000,Public       ,84,84,168,7719,5306,13025
00156800,INTERDENOMINATIONAL THEOLOGY CENTER     ,GA,30314-0000,Private      ,1,3,4,13,777,790
00156900,GEORGIA INSTITUTE OF TECHNOLOGY         ,GA,30332-0325,Public       ,242,101,343,20251,7608,27859
00157000,SOUTHERN POLYTECHNIC STATE UNIV         ,GA,30060-2896,Public       ,48,65,113,5122,5429,10551
00157100,GEORGIA MILITARY COLLEGE                ,GA,31061-3398,Public       ,141,256,397,5987,8082,14069
00157200,GEORGIA SOUTHERN UNIVERSITY             ,GA,30460-8065,Public       ,521,228,749,26641,9806,36447
00157300,GEORGIA SOUTHWESTERN STATE UNIV         ,GA,31709-4693,Public       ,45,80,125,3304,2956,6260
00157400,GEORGIA STATE UNIVERSITY                ,GA,30303-3010,Public       ,309,481,790,35110,35448,70558
00157500,GORDON COLLEGE                          ,GA,30204-1762,Public       ,33,67,100,5192,3915,9107
00157700,KENNESAW STATE UNIVERSITY               ,GA,30144-5591,Public       ,218,368,586,23957,19236,43193
00157800,LAGRANGE COLLEGE                        ,GA,30240-2999,Private      ,21,73,94,1525,802,2327
00157900,MEDICAL COLLEGE OF GEORGIA              ,GA,30912-0004,Public       ,13,32,45,869,3721,4590
00157913,GEORGIA REGENTS UNIVERSITY - AUGUSTA STA,GA,30904-2200,Public       ,49,117,166,6278,6421,12699
00158000,MERCER UNIVERSITY                       ,GA,31207-0003,Private      ,30,164,194,5592,10532,16124
00158100,MIDDLE GEORGIA COLLEGE                  ,GA,31014-1599,Public       ,61,107,168,3503,2755,6258
00158200,MOREHOUSE COLLEGE                       ,GA,30314-3773,Private      ,29,25,54,5479,1915,7394
00158500,NORTH GEORGIA COLLEGE & STATE UNIV      ,GA,30597-0001,Public       ,153,92,245,7626,3384,11010
00158600,OGLETHORPE UNIVERSITY                   ,GA,30319-2737,Private      ,10,16,26,2305,1014,3319
00158700,PAINE COLLEGE                           ,GA,30901-3182,Private      ,22,22,44,1593,1053,2646
00158800,PIEDMONT COLLEGE                        ,GA,30535-5644,Private      ,13,200,213,1299,2565,3864
00158900,REINHARDT UNIVERSITY                    ,GA,30183-2981,Private      ,20,9,29,1652,704,2356
00159000,SAVANNAH STATE UNIVERSITY               ,GA,31404-5298,Public       ,94,80,174,8927,4763,13690
00159100,SHORTER UNIVERSITY                      ,GA,30165-4298,Private      ,15,72,87,2277,3620,5897
00159200,SOUTH GEORGIA COLLEGE                   ,GA,31533-8104,Public       ,38,53,91,2314,1757,4071
00159400,SPELMAN COLLEGE                         ,GA,30314-4399,Private      ,29,18,47,7479,2280,9759
00159600,TOCCOA FALLS COLLEGE                    ,GA,30598-0001,Private      ,1,2,3,985,347,1332
00159700,TRUETT MCCONNELL COLLEGE                ,GA,30528-1264,Private      ,5,2,7,780,246,1026
00159800,UNIVERSITY OF GEORGIA                   ,GA,30602-6114,Public       ,359,210,569,32388,14194,46582
00159900,VALDOSTA STATE UNIVERSITY               ,GA,31698-0001,Public       ,144,170,314,15572,8219,23791
00160000,WESLEYAN COLLEGE                        ,GA,31210-4407,Private      ,5,15,20,633,949,1582
00160100,UNIV OF WEST GEORGIA                    ,GA,30118-0002,Public       ,218,206,424,13953,8214,22167
00160200,GEORGIA COLLEGE & STATE UNIVERSITY      ,GA,31061-0490,Public       ,126,86,212,8132,3131,11263
00160400,YOUNG HARRIS COLLEGE                    ,GA,30582-4137,Private      ,16,3,19,1468,188,1656
00348400,COVENANT COLLEGE                        ,GA,30750-4164,Private      ,1,2,3,1431,182,1613
00395600,DALTON STATE COLLEGE                    ,GA,30720-3797,Public       ,26,83,109,4480,4392,8872
00402400,GEORGIA NORTHWESTERN TECHNICAL COLLEGE  ,GA,30161-6757,Public       ,80,314,394,3296,9242,12538
00411700,GRADY HEALTH SYSTEM                     ,GA,30303-3050,Public       ,7,17,24,219,1213,1432
00489808,MCCANN SCHOOL OF BUSINESS & TECHNOLOGY -,GA,31210-0246,Proprietary  ,0,6,6,39,203,242
00525400,LANIER TECHNICAL COLLEGE                ,GA,30566-3499,Public       ,48,150,198,1782,5089,6871
00525500,MOULTRIE TECHNICAL COLLEGE              ,GA,31768-0000,Public       ,44,236,280,768,2854,3622
00525600,WIREGRASS GEORGIA TECHNICAL COLLEGE     ,GA,31602-0929,Public       ,89,327,416,2293,6922,9215
00551100,OKEFENOKEE TECHNICAL COLLEGE            ,GA,31501-4016,Public       ,47,120,167,697,2141,2838
00559900,AUGUSTA TECHNICAL COLLEGE               ,GA,30906-3399,Public       ,57,225,282,2931,8340,11271
00560000,ATHENS TECHNICAL COLLEGE                ,GA,30601-1579,Public       ,56,213,269,3163,6746,9909
00560100,ALBANY TECHNICAL COLLEGE                ,GA,31701-2648,Public       ,85,362,447,1996,7694,9690
00561300,FLINT RIVER TECHNICAL COLLEGE - THOMASTO,GA,30286-0014,Public       ,0,0,0,234,818,1052
00561500,SOUTHWEST GEORGIA TECHNICAL COLLEGE     ,GA,31792-2622,Public       ,28,108,136,988,2818,3806
00561700,SOUTH GEORGIA TECHNICAL COLLEGE         ,GA,31709-8167,Public       ,64,183,247,1098,2389,3487
00561800,SAVANNAH TECHNICAL COLLEGE              ,GA,31405-5594,Public       ,130,539,669,3164,10503,13667
00561900,NORTH GEORGIA TECHNICAL COLLEGE         ,GA,30523-0000,Public       ,61,159,220,1723,3247,4970
00562000,CHATTAHOOCHEE TECHNICAL COLLEGE         ,GA,30060-3398,Public       ,212,663,875,7612,16475,24087
00562100,SOUTHERN CRESCENT TECHNICAL COLLEGE     ,GA,30223-2097,Public       ,109,472,581,2678,7990,10668
00562200,DEKALB TECHNICAL COLLEGE                ,GA,30021-0000,Public       ,66,345,411,2232,9552,11784
00562400,COLUMBUS TECHNICAL COLLEGE              ,GA,31904-6572,Public       ,55,306,361,2634,7417,10051
00576300,CENTRAL GEORGIA TECHNICAL COLLEGE       ,GA,31206-3628,Public       ,80,529,609,2339,8492,10831
00772800,MACON STATE COLLEGE                     ,GA,31206-5145,Public       ,50,147,197,4946,7484,12430
00854300,ATLANTA TECHNICAL COLLEGE               ,GA,30310-4499,Public       ,75,597,672,3750,15013,18763
00897600,CLAYTON STATE UNIVERSITY                ,GA,30260-0285,Public       ,71,219,290,7098,12841,19939
00927000,ART INSTITUTE OF ATLANTA (THE)          ,GA,30328-1649,Proprietary  ,102,182,284,10208,9424,19632
00950700,GEORGIA HIGHLANDS COLLEGE               ,GA,30162-0000,Public       ,56,99,155,5188,5271,10459
01031903,MEDIX SCHOOL                            ,GA,30080-7630,Proprietary  ,27,84,111,286,1096,1382
01035601,EVEREST INSTITUTE - DEKALB              ,GA,30035-3420,Proprietary  ,2,22,24,155,810,965
01048700,WEST GEORGIA TECHNICAL COLLEGE          ,GA,30182-6476,Public       ,120,336,456,4145,9489,13634
01077100,GUPTON JONES COLLEGE                    ,GA,30035-4022,Private      ,0,2,2,213,573,786
01099700,EAST GEORGIA COLLEGE                    ,GA,30401-2699,Public       ,69,56,125,3920,1992,5912
01107400,BAINBRIDGE COLLEGE                      ,GA,39819-8400,Public       ,89,131,220,1471,4752,6223
01110901,EVEREST COLLEGE - EVEREST INSTITUTE     ,GA,30067-8340,Proprietary  ,10,70,80,233,1278,1511
01110902,EVEREST COLLEGE - ATLANTA               ,GA,30331-2620,Proprietary  ,20,163,183,509,2150,2659
01112301,EVEREST COLLEGE - EVEREST INSTITUTE- NOR,GA,30093-2813,Proprietary  ,18,114,132,279,1490,1769
01157400,BAUDER COLLEGE                          ,GA,30313-2439,Proprietary  ,6,65,71,610,2579,3189
01205100,PRO WAY HAIR SCHOOL                     ,GA,30083-2884,Proprietary  ,5,26,31,108,456,564
01216500,ATLANTA METROPOLITAN COLLEGE            ,GA,30310-4498,Public       ,57,247,304,4281,9178,13459
01303900,SOUTH UNIVERSITY                        ,GA,31406-4881,Proprietary  ,208,2513,2721,4416,34911,39327
02055000,WAYCROSS COLLEGE                        ,GA,31503-0000,Public       ,14,26,40,771,1040,1811
02060900,BROWN CLG OF COURT REPORTING & M.T.     ,GA,30318-2570,Proprietary  ,2,11,13,48,635,683
02074800,LIFE UNIVERSITY                         ,GA,30060-0000,Private      ,12,23,35,651,3346,3997
02113613,AMERICAN INTERCONTINENTAL UNIVERSITY    ,GA,30328-1649,Proprietary  ,17,114,131,1410,4930,6340
02116000,SANFORD-BROWN COLLEGE                   ,GA,30328-4803,Proprietary  ,6,44,50,414,1918,2332
02141500,SAVANNAH COLLEGE OF ART & DESIGN        ,GA,31402-3146,Private      ,56,46,102,12296,6043,18339
02202800,AUGUSTA AREA DIET INTERN UNIV HOSP      ,GA,30901-0000,Private      ,0,1,1,18,107,125
02217200,PORTFOLIO CENTER                        ,GA,30309-0000,Proprietary  ,3,10,13,103,402,505
02266200,AMERICAN PROFESSIONAL INSTITUTE         ,GA,31201-3185,Proprietary  ,16,75,91,255,1358,1613
02284300,INTERACTIVE COLLEGE OF TECHNOLOGY       ,GA,30341-0000,Proprietary  ,42,195,237,351,2231,2582
02284308,INTERACTIVE LEARNING SYSTEMS            ,GA,30260-0000,Proprietary  ,3,22,25,65,377,442
02284309,INTERACTIVE COLLEGE OF TECHNOLOGY       ,GA,30501-0000,Proprietary  ,9,42,51,97,510,607
02285500,"CREATIVE CIRCUS, THE                    ",GA,30324-0000,Proprietary  ,1,3,4,113,366,479
02288400,GWINNETT TECHNICAL COLLEGE              ,GA,30043-5702,Public       ,108,315,423,4685,12359,17044
02313902,WESTWOOD COLLEGE - O'HARE AIRPORT - ATLA,GA,30345-2807,Proprietary  ,6,54,60,293,1132,1425
02321400,ROFFLER-MOLER HAIRSTYLING COLLEGE       ,GA,30062-0000,Proprietary  ,9,7,16,99,197,296
02354500,SOUTHEASTERN BEAUTY SCHOOLS             ,GA,31906-0000,Proprietary  ,1,7,8,46,221,267
02482100,MOREHOUSE SCHOOL OF MEDICINE            ,GA,30310-0000,Private      ,2,10,12,268,1008,1276
02502700,ADVANCED CAREER TRAINING                ,GA,30329-0000,Proprietary  ,3,39,42,410,1546,1956
02502701,ADVANCED CAREER TRAINING-RIVERDALE      ,GA,30274-0000,Proprietary  ,1,23,24,77,453,530
02508600,MIDDLE GEORGIA TECHNICAL COLLEGE        ,GA,31088-2730,Public       ,80,280,360,1775,5345,7120
02520000,INTERNATIONAL SCH SKIN & NAILCARE       ,GA,30342-1119,Proprietary  ,4,27,31,102,582,684
02577000,ESANI INSTITUTE                         ,GA,30297-0000,Proprietary  ,5,15,20,119,269,388
02577700,BEAUTY COLLEGE OF AMERICA               ,GA,30297-0000,Proprietary  ,1,13,14,72,220,292
02580100,IVERSON INSTITUTE                       ,GA,30341-3662,Proprietary  ,11,32,43,41,297,338
02580200,ATLANTA SCHOOL OF MASSAGE               ,GA,30338-0000,Proprietary  ,3,27,30,219,861,1080
02583000,GWINNETT COLLEGE OF BUSINESS            ,GA,30047-3447,Proprietary  ,4,33,37,153,896,1049
02607600,CAPELLI LEARNING CTR FOR COSM           ,GA,30324-0000,Proprietary  ,6,19,25,141,403,544
02614206,MILLER - MOTTE TECHNICAL COLLEGE - COLUM,GA,31907-3222,Proprietary  ,4,69,73,287,1701,1988
02614207,MILLER - MOTTE TECHNICAL COLLEGE - AUGUS,GA,30907-0921,Proprietary  ,4,47,51,274,1379,1653
03005400,GEORGIA CAREER INSTITUTE                ,GA,30013-2076,Proprietary  ,26,65,91,332,1048,1380
03010619,VIRGINIA COLLEGE - AUGUSTA              ,GA,30909-5515,Proprietary  ,2,46,48,311,1499,1810
03010623,VIRGINIA COLLEGE - MACON                ,GA,31206-3180,Proprietary  ,1,26,27,182,1030,1212
03022601,WESTERN CULINARY INSTITUTE - LE CORDON B,GA,30084-5893,Proprietary  ,9,43,52,476,1281,1757
03030000,OGEECHEE TECHNICAL COLLEGE              ,GA,30458-8049,Public       ,38,173,211,1777,3777,5554
03032100,ALTAMAHA TECHNICAL COLLEGE              ,GA,31545-4465,Public       ,40,134,174,911,2506,3417
03042700,LAURUSTECHNICAL INSTITUTE               ,GA,30030-1506,Proprietary  ,8,69,77,121,778,899
03066500,SOUTHEASTERN TECHNICAL COLLEGE          ,GA,30474-8817,Public       ,36,128,164,693,2422,3115
03072304,EVEREST COLLEGE - EVEREST INSTITUTE     ,GA,30236-0000,Proprietary  ,7,57,64,192,1213,1405
03076300,BEULAH HEIGHTS BIBLE COLLEGE            ,GA,30316-1873,Private      ,1,32,33,46,1048,1094
03079202,WESTWOOD COLLEGE - ATLANTA MIDTOWN      ,GA,30309-2848,Proprietary  ,18,69,87,751,2405,3156
03081500,SOUTHEASTERN BEAUTY SCHOOL              ,GA,31917-0000,Proprietary  ,4,13,17,78,286,364
03089100,GEORGIA INSTITUTE OF COSMETOLOGY        ,GA,30606-3152,Proprietary  ,8,45,53,228,696,924
03090600,COBB BEAUTY COLLEGE                     ,GA,30144-2828,Proprietary  ,3,8,11,83,251,334
03100900,LUTHER RICE UNIVERSITY                  ,GA,30038-2454,Private      ,3,16,19,77,1400,1477
03102000,RIVERTOWN SCHOOL OF BEAUTY              ,GA,31904-4747,Proprietary  ,4,37,41,123,463,586
03104500,ATLANTA INSTITUTE OF MUSIC              ,GA,30096-4988,Proprietary  ,4,8,12,500,667,1167
03116100,VOGUE BEAUTY AND BARBER SCHOOL          ,GA,30141-2226,Proprietary  ,1,17,18,101,341,442
03155500,OCONEE FALL LINE TECHNICAL COLLEGE      ,GA,31082-6179,Public       ,34,180,214,474,1845,2319
03155504,OCONEE FALL LINE TECHNICAL COLLEGE - SOU,GA,31021-0560,Public       ,11,33,44,352,1086,1438
03173300,ATLANTA'S JOHN MARSHALL LAW SCHOOL      ,GA,30309-0000,Proprietary  ,0,22,22,88,1813,1901
03232304,LINCOLN COLLEGE OF TECHNOLOGY           ,GA,30067-8638,Proprietary  ,8,39,47,121,671,792
03418300,GWINNETT COLLEGE-SANDY SPRINGS          ,GA,30328-3161,Proprietary  ,0,10,10,114,468,582
03445500,FAYETTE BEAUTY ACADEMY                  ,GA,30214-1191,Proprietary  ,1,15,16,43,145,188
03523300,AVIATION INSTITUTE OF MAINTENANCE       ,GA,30045-0000,Proprietary  ,18,74,92,340,1157,1497
03635300,CARVER BIBLE COLLEGE                    ,GA,30331-1300,Private      ,0,8,8,46,338,384
03748300,KEVOSNIK SCHOOL OF HAIR DESIGN          ,GA,31021-0000,Proprietary  ,1,8,9,11,78,89
03753400,MICHAEL'S SCHOOL OF BEAUTY              ,GA,30909-0000,Proprietary  ,1,8,9,52,228,280
03804400,MEDTECH INSTITUTE                       ,GA,30339-6040,Proprietary  ,11,70,81,175,1007,1182
03812300,OMNITECH INSTITUTE                      ,GA,30035-1206,Proprietary  ,2,34,36,94,494,588
04021300,AUGUSTA SCHOOL OF MASSAGE               ,GA,30809-0000,Proprietary  ,0,4,4,31,128,159
04051331,ART INSTITUTE OF PHOENIX (THE) - BROWN M,GA,30319-3054,Proprietary  ,3,20,23,237,791,1028
04091300,SAVANNAH SCHOOL OF MASSAGE THERAPY      ,GA,31406-2711,Private      ,0,0,0,89,385,474
04126800,ACADEMY OF SOMATIC HEALING ARTS (ASHA)  ,GA,30071-1024,Proprietary  ,0,0,0,44,267,311
04142900,GEORGIA GWINNETT COLLEGE                ,GA,30043-7409,Public       ,125,110,235,11000,7468,18468
04147000,PAUL MITCHELL THE SCHOOL ATLANTA        ,GA,30318-5241,Proprietary  ,6,29,35,400,810,1210
04147700,LAKE LANIER SCHOOL OF MASSAGE           ,GA,30501-4546,Proprietary  ,2,20,22,73,302,375
04149900,PROFILE INSTITUTE OF BARBER-STYLING     ,GA,30315-8459,Proprietary  ,1,18,19,84,375,459
04150900,PROCESS INSTITUTE OF COSMETOLOGY (THE)  ,GA,30043-7344,Proprietary  ,4,6,10,118,234,352
04152300,GEORGIA BEAUTY ACADEMY                  ,GA,30721-3952,Proprietary  ,2,12,14,99,259,358
04156500,GEORGIA CHRISTIAN UNIVERSITY            ,GA,30047-3778,Private      ,1,1,2,62,142,204
04160200,ATLANTA BEAUTY ACADEMY                  ,GA,30340-1334,Proprietary  ,12,71,83,105,664,769
04203800,WOODRUFF MEDICAL TRAINING AND TESTING   ,GA,30033-6103,Proprietary  ,3,21,24,4,31,35
04204500,ELAINE STERLING INSTITUTE(THE)          ,GA,30342-2633,Proprietary  ,1,10,11,18,212,230
04206400,HELMS COLLEGE                           ,GA,31206-5309,Private      ,4,14,18,18,99,117
04206600,SAE INSTITUTE OF TECHNOLOGY - ATLANTA   ,GA,30303-1736,Proprietary  ,4,17,21,150,389,539
04208000,TECHNOLOGY CENTER                       ,GA,30071-3519,Proprietary  ,0,12,12,1,27,28
04218000,UNITED MEDICAL AND BUSINESS INSTITUTE   ,GA,30344-6977,Proprietary  ,2,13,15,2,15,17
00162800,AMERICAN ACADEMY OF ART                 ,IL,60604-4302,Proprietary  ,2,5,7,1151,520,1671
00163300,AUGUSTANA COLLEGE                       ,IL,61201-2296,Private      ,2,5,7,4695,279,4974
00163400,AURORA UNIVERSITY                       ,IL,60506-4892,Private      ,11,143,154,4052,3767,7819
00163600,SOUTHWESTERN ILLINOIS COLLEGE           ,IL,62221-5899,Public       ,102,350,452,5011,8420,13431
00163800,BLACK HAWK COLLEGE                      ,IL,61265-5899,Public       ,29,76,105,2893,3787,6680
00163900,BLACKBURN COLLEGE                       ,IL,62626-1498,Private      ,1,2,3,815,170,985
00164000,PRAIRIE STATE COLLEGE                   ,IL,60411-8226,Public       ,34,133,167,3819,6916,10735
00164100,BRADLEY UNIVERSITY                      ,IL,61625-0002,Private      ,10,12,22,8378,1516,9894
00164300,SPOON RIVER COLLEGE                     ,IL,61520-8907,Public       ,4,23,27,935,1187,2122
00164700,CITY COLLEGES OF CHICAGO                ,IL,60606-6998,Public       ,28,127,155,2483,4892,7375
00164800,TRUMAN COLLEGE                          ,IL,60640-5691,Public       ,47,196,243,4619,8591,13210
00164900,RICHARD J DALEY COLLEGE                 ,IL,60652-1299,Public       ,20,136,156,4517,7620,12137
00165000,CITY COLLEGES OF CHICAGO-MALCOLM X      ,IL,60612-3197,Public       ,61,306,367,5197,11830,17027
00165200,HAROLD WASHINGTON COLLEGE               ,IL,60601-2403,Public       ,94,282,376,10359,12964,23323
00165400,KENNEDY KING COLLEGE                    ,IL,60621-3798,Public       ,53,373,426,4361,11973,16334
00165500,WRIGHT COLLEGE                          ,IL,60634-1591,Public       ,57,175,232,7450,9303,16753
00165700,MIDWESTERN UNIVERSITY                   ,IL,60515-1200,Private      ,1,9,10,143,3507,3650
00165900,ROSALIND FRANKLIN UNIVERSITY OF MEDICINE,IL,60064-3095,Private      ,0,9,9,71,2861,2932
00166100,CHICAGO THEOLOGICAL SEMINARY            ,IL,60637-0000,Private      ,0,1,1,18,276,294
00166300,SPERTUS COLLEGE                         ,IL,60605-1995,Private      ,0,7,7,5,140,145
00166400,UNIVERSITY OF ST FRANCIS                ,IL,60435-6188,Private      ,5,62,67,2380,2866,5246
00166500,COLUMBIA COLLEGE                        ,IL,60605-1996,Private      ,43,84,127,16346,7204,23550
00166600,CONCORDIA UNIVERSITY                    ,IL,60305-1499,Private      ,0,89,89,2918,4850,7768
00166900,DANVILLE AREA COMMUNITY COLLEGE         ,IL,61832-5199,Public       ,19,73,92,1227,2151,3378
00167100,DEPAUL UNIVERSITY                       ,IL,60604-2287,Private      ,41,230,271,25130,19951,45081
00167400,EASTERN ILLINOIS UNIVERSITY             ,IL,61920-3099,Public       ,37,65,102,12571,4534,17105
00167500,ELGIN COMMUNITY COLLEGE                 ,IL,60123-7193,Public       ,24,63,87,4863,5669,10532
00167600,ELMHURST COLLEGE                        ,IL,60126-3296,Private      ,4,11,15,4727,1537,6264
00167800,EUREKA COLLEGE                          ,IL,61530-9976,Private      ,3,3,6,1222,299,1521
00168100,HIGHLAND COMMUNITY COLLEGE              ,IL,61032-9341,Public       ,18,53,71,1066,1527,2593
00168200,GARRETT-EVANGELICAL THEOLOGICAL SEM     ,IL,60201-0000,Private      ,0,1,1,3,326,329
00168400,GREENVILLE COLLEGE                      ,IL,62246-1199,Private      ,3,32,35,1868,885,2753
00168500,HEBREW THEOLOGICAL COLLEGE              ,IL,60077-3263,Private      ,2,1,3,566,38,604
00168800,ILLINOIS COLLEGE                        ,IL,62650-2299,Private      ,2,2,4,1929,258,2187
00168900,ILLINOIS COLLEGE OF OPTOMETRY           ,IL,60616-3878,Private      ,0,4,4,40,792,832
00169100,ILLINOIS INSTITUTE OF TECHNOLOGY        ,IL,60616-0000,Private      ,8,36,44,3758,3243,7001
00169103,CHICAGO KENT COLLEGE OF LAW             ,IL,60661-0000,Private      ,0,23,23,96,2358,2454
00169200,ILLINOIS STATE UNIVERSITY               ,IL,61790-1000,Public       ,40,62,102,24580,5892,30472
00169300,NORTHEASTERN ILLINOIS UNIV              ,IL,60625-4699,Public       ,33,112,145,9064,10292,19356
00169400,CHICAGO STATE UNIVERSITY                ,IL,60628-1598,Public       ,18,134,152,7772,15202,22974
00169600,ILLINOIS WESLEYAN UNIVERSITY            ,IL,61701-0000,Private      ,2,1,3,3658,315,3973
00169800,JOHN MARSHALL LAW SCHOOL                ,IL,60604-0000,Private      ,0,15,15,99,2934,3033
00169900,JOLIET JUNIOR COLLEGE                   ,IL,60431-8938,Public       ,58,159,217,8700,9288,17988
00170000,JUDSON UNIVERSITY                       ,IL,60123-1498,Private      ,1,23,24,1155,992,2147
00170100,KASKASKIA COLLEGE                       ,IL,62801-7878,Public       ,39,92,131,1939,3105,5044
00170300,KENDALL COLLEGE                         ,IL,60622-4278,Proprietary  ,6,27,33,1478,2772,4250
00170400,KNOX COLLEGE                            ,IL,61401-4999,Private      ,0,2,2,2390,187,2577
00170500,ILLINOIS VALLEY COMMUNITY COLLEGE       ,IL,61348-9692,Public       ,25,39,64,1748,2224,3972
00170600,LAKE FOREST COLLEGE                     ,IL,60045-2399,Private      ,3,3,6,2642,279,2921
00170700,LEWIS UNIVERSITY                        ,IL,60446-2200,Private      ,11,79,90,6226,4664,10890
00170800,LINCOLN CHRISTIAN UNIVERSITY            ,IL,62656-2167,Private      ,0,9,9,537,814,1351
00170900,LINCOLN COLLEGE                         ,IL,62656-1699,Private      ,6,15,21,1339,841,2180
00171000,LOYOLA UNIVERSITY CHICAGO               ,IL,60626-0000,Private      ,23,143,166,19170,14531,33701
00171200,LUTHERAN SCHOOL OF THEOL AT CHICAGO     ,IL,60615-0000,Private      ,0,3,3,5,164,169
00171600,MACCORMAC COLLEGE                       ,IL,60602-4405,Private      ,3,3,6,80,290,370
00171700,MACMURRAY COLLEGE                       ,IL,62650-2590,Private      ,2,3,5,999,409,1408
00172100,MCCORMICK THEOLOGICAL SEMINARY          ,IL,60615-5108,Private      ,0,0,0,5,180,185
00172200,MCKENDREE UNIVERSITY                    ,IL,62254-1299,Private      ,5,39,44,1945,1814,3759
00172300,MEADVILLE LOMBARD THEOLOGICAL SCHOOL    ,IL,60637-1602,Private      ,0,0,0,2,86,88
00172400,MILLIKIN UNIVERSITY                     ,IL,62522-2084,Private      ,3,8,11,3669,1138,4807
00172500,MONMOUTH COLLEGE                        ,IL,61462-1963,Private      ,4,1,5,2108,174,2282
00172700,MOODY BIBLE INSTITUTE                   ,IL,60610-3214,Private      ,11,35,46,2073,2037,4110
00172800,MORTON COLLEGE                          ,IL,60804-4398,Public       ,43,67,110,3195,2900,6095
00173200,NATIONAL UNIV OF HEALTH SCIENCES        ,IL,60148-4583,Private      ,5,9,14,74,1116,1190
00173300,NATIONAL-LOUIS UNIVERSITY               ,IL,60603-3032,Private      ,4,170,174,512,7393,7905
00173400,NORTH CENTRAL COLLEGE                   ,IL,60540-4690,Private      ,6,12,18,4390,1250,5640
00173500,NORTH PARK UNIVERSITY                   ,IL,60625-4895,Private      ,6,34,40,3809,2496,6305
00173600,NORTHERN BAPTIST THEOL SEMINARY         ,IL,60148-0000,Private      ,0,1,1,2,97,99
00173700,NORTHERN ILLINOIS UNIVERSITY            ,IL,60115-2854,Public       ,66,138,204,25259,12351,37610
00173900,NORTHWESTERN UNIV                       ,IL,60208-0001,Private      ,9,146,155,21930,12209,34139
00174100,OLIVET NAZARENE UNIVERSITY              ,IL,60914-2271,Private      ,10,56,66,3825,2901,6726
00174200,IL EASTERN COMM COLGS-OLNEY CENTRAL     ,IL,62450-1099,Public       ,18,33,51,738,876,1614
00174500,QUINCY UNIVERSITY                       ,IL,62301-2699,Private      ,3,10,13,1766,985,2751
00174600,ROBERT MORRIS UNIVERSITY ILLINOIS       ,IL,60605-1225,Private      ,10,79,89,6572,7185,13757
00174700,ROCK VALLEY COLLEGE                     ,IL,61114-5699,Public       ,54,119,173,4127,6515,10642
00174800,ROCKFORD COLLEGE                        ,IL,61108-2393,Private      ,5,31,36,1585,1707,3292
00174900,ROOSEVELT UNIVERSITY                    ,IL,60605-1394,Private      ,18,136,154,6366,8949,15315
00175000,DOMINICAN UNIVERSITY                    ,IL,60305-1066,Private      ,7,26,33,3433,2217,5650
00175200,SAUK VALLEY COMMUNITY COLLEGE           ,IL,61021-9112,Public       ,19,53,72,1195,1531,2726
00175300,SCHOOL OF ART INSTITUTE OF CHICAGO      ,IL,60603-3013,Private      ,13,16,29,5001,3115,8116
00175600,SHIMER COLLEGE                          ,IL,60616-3893,Private      ,1,2,3,143,77,220
00175700,SOUTHEASTERN ILLINOIS COLLEGE           ,IL,62946-4925,Public       ,11,29,40,793,1053,1846
00175800,SOUTHERN ILL UNIV-CARBONDALE            ,IL,62901-0000,Public       ,51,172,223,19866,11139,31005
00175900,SOUTHERN ILL UNIV-EDWARDSVILLE          ,IL,62026-1060,Public       ,48,94,142,14828,7391,22219
00175924,SO IL UNIV-SCHL OF DENTAL MEDICINE      ,IL,62002-0000,Public       ,0,0,0,12,203,215
00176100,SPRINGFIELD COLLEGE IN ILLINOIS         ,IL,62702-2694,Private      ,0,0,0,328,480,808
00176500,UNIVERSITY OF ST MARY OF THE LAKE       ,IL,60060-0000,Private      ,0,0,0,1,26,27
00176700,BENEDICTINE UNIVERSITY                  ,IL,60532-0900,Private      ,8,100,108,3745,5112,8857
00176800,ST XAVIER UNIVERSITY                    ,IL,60655-3199,Private      ,12,65,77,6581,4675,11256
00176900,SOUTH SUBURBAN COLLEGE                  ,IL,60473-9978,Public       ,43,177,220,3824,8839,12663
00177100,TRINITY CHRISTIAN COLLEGE               ,IL,60463-0929,Private      ,1,8,9,1432,1097,2529
00177200,TRINITY INTERNATIONAL UNIVERSITY        ,IL,60015-1283,Private      ,1,9,10,1015,1300,2315
00177300,TRITON COLLEGE                          ,IL,60171-1995,Public       ,64,154,218,5200,6824,12024
00177400,UNIVERSITY OF CHICAGO                   ,IL,60637-1476,Private      ,17,32,49,20048,5173,25221
00177401,UNIV OF CHICAGO PRITZKER SCH OF MED     ,IL,60637-0000,Private      ,0,0,0,85,696,781
00177403,"UNIV OF CHICAGO, BOOTH SCH OF BUS       ",IL,60637-0000,Private      ,0,27,27,162,1913,2075
00177405,UNIVERSITY OF CHICAGO GRADUATE          ,IL,60637-0000,Private      ,1,22,23,150,5394,5544
00177500,UNIV OF ILLINOIS @ URBANA-CHAMPAIGN     ,IL,61820-5796,Public       ,69,128,197,34683,10762,45445
00177600,UNIV OF ILLINOIS AT CHICAGO             ,IL,60607-0000,Public       ,58,187,245,29463,23397,52860
00177800,VANDERCOOK COLLEGE OF MUSIC             ,IL,60616-3731,Private      ,0,3,3,218,151,369
00177900,IL EASTERN COMM COLGS-WABASH VALLEY     ,IL,62863-2699,Public       ,8,12,20,509,554,1063
00178000,WESTERN ILLINOIS UNIVERSITY             ,IL,61455-1390,Public       ,35,59,94,14782,5471,20253
00178100,WHEATON COLLEGE                         ,IL,60187-5535,Private      ,2,7,9,3208,742,3950
00178300,WORSHAM COLLEGE OF MORTUARY SCIENCE     ,IL,60090-2646,Proprietary  ,0,1,1,82,175,257
00396100,HARPER COLLEGE                          ,IL,60067-7398,Public       ,71,168,239,6483,6466,12949
00456000,GEM CITY COLLEGE                        ,IL,62301-4949,Proprietary  ,0,4,4,34,84,118
00456800,MIDSTATE COLLEGE                        ,IL,61614-3558,Proprietary  ,6,35,41,171,1175,1346
00621400,BLESSING RIEMAN COLLEGE OF NURSING      ,IL,62301-0000,Private      ,0,5,5,177,269,446
00621401,BLESSING HOSPITAL - SCHOOL OF MEDICAL LA,IL,62305-7005,Private      ,0,2,2,20,55,75
00621402,BLESSING HOSPITAL - SCHOOL OF RADIOLOGIC,IL,62305-7005,Private      ,0,0,0,42,60,102
00622500,TRINITY COLLEGE OF NURSING AND HEALTH SC,IL,61201-5317,Private      ,3,2,5,141,249,390
00622800,METHODIST MED CTR OF ILL SCH NRSNG      ,IL,61636-0000,Private      ,1,5,6,362,726,1088
00624000,ST FRANCIS MED CLG OF NRSG              ,IL,61603-3783,Private      ,0,3,3,390,698,1088
00638500,CHAMBERLAIN COLLEGE OF NURSING          ,IL,60101-0000,Proprietary  ,10,343,353,2278,18045,20323
00665600,COLLEGE OF DUPAGE                       ,IL,60137-6599,Public       ,140,308,448,12159,13023,25182
00675300,ILLINOIS CENTRAL COLLEGE                ,IL,61635-0001,Public       ,62,184,246,4915,6794,11709
00693100,WAUBONSEE COMMUNITY COLLEGE             ,IL,60554-0000,Public       ,40,113,153,4044,5369,9413
00711800,PARKLAND COLLEGE                        ,IL,61821-1899,Public       ,33,91,124,5550,5295,10845
00711900,REND LAKE COLLEGE                       ,IL,62846-9801,Public       ,29,59,88,1468,2073,3541
00717000,LINCOLN LAND COMMUNITY COLLEGE          ,IL,62794-9256,Public       ,18,71,89,3189,5360,8549
00726500,CARL SANDBURG COLLEGE                   ,IL,61401-9576,Public       ,8,36,44,1262,1985,3247
00730307,LINCOLN COLLEGE OF TECHNOLOGY - MELROSE ,IL,60160-1605,Proprietary  ,54,63,117,988,948,1936
00750103,VATTEROTT COLLEGE - FAIRVIEW HEIGHTS    ,IL,62208-2029,Proprietary  ,22,79,101,170,659,829
00754900,COYNE AMERICAN INSTITUTE                ,IL,60607-1300,Proprietary  ,12,59,71,546,1891,2437
00764400,LAKE LAND COLLEGE                       ,IL,61938-9366,Public       ,36,78,114,2719,2949,5668
00768400,KISHWAUKEE COLLEGE                      ,IL,60150-9699,Public       ,20,39,59,2787,2794,5581
00769000,KANKAKEE COMMUNITY COLLEGE              ,IL,60901-6505,Public       ,25,73,98,1887,3630,5517
00769100,MCHENRY COUNTY COLLEGE                  ,IL,60012-2761,Public       ,35,82,117,2833,2982,5815
00769200,MORAINE VALLEY COMMUNITY COLLEGE        ,IL,60465-0937,Public       ,82,180,262,8171,7767,15938
00769300,SHAWNEE COMMUNITY COLLEGE               ,IL,62992-9725,Public       ,40,68,108,909,1458,2367
00769400,COLLEGE OF LAKE COUNTY                  ,IL,60030-1198,Public       ,94,280,374,5780,7337,13117
00793700,MS ROBERTS ACADEMY OF BEAUTY CULT       ,IL,60181-2930,Proprietary  ,3,8,11,40,101,141
00807600,JOHN A LOGAN COLLEGE                    ,IL,62918-2500,Public       ,38,99,137,2450,3294,5744
00809003,EVEREST COLLEGE - BEDFORD PARK          ,IL,60629-5819,Proprietary  ,15,139,154,204,836,1040
00814604,EVEREST UNIVERSITY - EVEREST  COLLEGE   ,IL,60803-4517,Proprietary  ,8,49,57,146,954,1100
00825900,EDUCATORS OF BEAUTY                     ,IL,61081-3611,Proprietary  ,1,11,12,67,141,208
00825901,EDUCATORS OF BEAUTY                     ,IL,61104-0000,Proprietary  ,1,1,2,64,154,218
00832800,ALVAREITA'S COLLEGE OF COSMETOLOGY      ,IL,62025-2041,Proprietary  ,3,5,8,65,158,223
00854500,ROCKFORD CAREER  COLLEGE                ,IL,61108-3900,Proprietary  ,7,20,27,321,1299,1620
00869402,RASMUSSEN COLLEGE - ROCKFORD            ,IL,61108-2513,Proprietary  ,8,35,43,365,1815,2180
00869403,RASMUSSEN COLLEGE - AURORA              ,IL,60506-6219,Proprietary  ,4,21,25,222,972,1194
00869404,RASMUSSEN COLLEGE - ROMEOVILLE          ,IL,60446-0000,Proprietary  ,5,24,29,256,1010,1266
00869418,RASMUSSEN COLLEGE -  MOKENA             ,IL,60448-0000,Proprietary  ,2,18,20,100,559,659
00888000,MORRISON INSTITUTE OF TECHNOLOGY        ,IL,61270-2959,Private      ,0,1,1,133,41,174
00893800,GRAHAM HOSPITAL SCH OF NURSING          ,IL,61520-2497,Private      ,0,0,0,44,109,153
00893900,CANNELLA SCHOOL OF HAIR DESIGN          ,IL,60406-2130,Proprietary  ,3,2,5,44,141,185
00914500,GOVERNORS STATE UNIVERSITY              ,IL,60466-0975,Public       ,9,128,137,1593,8476,10069
00923200,CATHOLIC THEOLOGICAL UNION              ,IL,60615-0000,Private      ,0,1,1,8,88,96
00933300,UNIV OF ILLINOIS AT SPRINGFIELD         ,IL,62703-5407,Public       ,3,66,69,2960,4147,7107
00947500,EDUCATORS OF BEAUTY                     ,IL,61301-2404,Proprietary  ,0,0,0,38,41,79
00959500,CANNELLA SCHOOL OF HAIR DESIGN          ,IL,60617-4303,Proprietary  ,0,10,10,136,333,469
00976700,OLIVE-HARVEY COLLEGE                    ,IL,60628-1696,Public       ,20,130,150,2792,7069,9861
00978600,IL EASTERN COMM COLGS-LINCOLN TRAIL     ,IL,62454-5708,Public       ,8,27,35,401,530,931
00980000,RUSH UNIVERSITY                         ,IL,60612-3806,Private      ,2,35,37,492,3854,4346
00989600,OAKTON COMMUNITY COLLEGE                ,IL,60016-1268,Public       ,29,96,125,4561,4522,9083
00998700,SAINT ANTHONY COLLEGE OF NURSING        ,IL,61108-2468,Private      ,1,4,5,229,541,770
01002000,LEWIS AND CLARK COMMUNITY COLLEGE       ,IL,62035-2466,Public       ,38,99,137,2650,3614,6264
01050100,LAKEVIEW  COLLEGE OF NURSING            ,IL,61832-3781,Private      ,2,2,4,210,335,545
01069500,TRI-COUNTY BEAUTY ACADEMY               ,IL,62056-2036,Proprietary  ,1,1,2,12,41,53
01071000,CAPITAL AREA SCH OF PRAC NRSG           ,IL,62707-0000,Public       ,1,6,7,106,740,846
01072700,DEVRY UNIVERSITY                        ,IL,60618-5994,Proprietary  ,91,1241,1332,17541,92013,109554
01083600,PIVOT POINT INTNL CSMTLGY RSRCH CTR     ,IL,60626-0000,Proprietary  ,12,9,21,511,778,1289
01087900,RICHLAND COMMUNITY COLLEGE              ,IL,62521-8513,Public       ,18,117,135,1244,2874,4118
01102401,EVEREST COLLEGE - CHICAGO               ,IL,60604-2052,Proprietary  ,0,0,0,645,1368,2013
01151002,EVEREST INSTITUTE - EVEREST COLLEGE     ,IL,60542-1610,Proprietary  ,13,52,65,249,760,1009
01181000,TAYLOR BUSINESS INSTITUTE               ,IL,60606-5111,Proprietary  ,0,22,22,58,298,356
01185204,ITT TECHNICAL INSTITUTE - ORLAND PARK CA,IL,60467-4900,Proprietary  ,0,0,0,0,1,1
01185800,EVEREST COLLEGE                         ,IL,60077-1074,Proprietary  ,15,50,65,326,953,1279
01185802,EVEREST COLLEGE - BURR RIDGE            ,IL,60527-7826,Proprietary  ,2,45,47,168,575,743
01185803,EVEREST COLLEGE - MELROSE PARK          ,IL,60160-1526,Proprietary  ,13,91,104,230,877,1107
01236200,NORTHWESTERN COLLEGE                    ,IL,60630-2298,Proprietary  ,31,119,150,2428,4523,6951
01238500,BLOOMINGTON-NORMAL SCH RADIOGRAPHY      ,IL,61761-4604,Private      ,1,0,1,31,102,133
01258400,ILLINOIS INSTITUTE OF ART (THE)         ,IL,60654-1593,Proprietary  ,39,111,150,6783,5473,12256
01281300,JOHN WOOD COMMUNITY COLLEGE             ,IL,62305-0401,Public       ,21,52,73,1375,1707,3082
01308700,CAPRI GARFIELD RIDGE SCH OF BTY CLR     ,IL,60629-1613,Proprietary  ,0,7,7,105,320,425
01308800,CAPRI OAK FOREST COLLEGE OF BEAUTY      ,IL,60452-2798,Proprietary  ,6,3,9,149,243,392
02055200,HARRINGTON COLLEGE OF DESIGN            ,IL,60606-3433,Proprietary  ,4,5,9,486,806,1292
02068100,ADLER SCH OF PROFESSIONAL PSYCHLGY      ,IL,60601-0000,Private      ,4,6,10,137,1824,1961
02069300,VATTEROTT COLLEGE                       ,IL,62305-5938,Proprietary  ,9,39,48,161,580,741
02073200,TELSHE YESHIVA-CHICAGO                  ,IL,60625-0000,Private      ,6,0,6,39,14,53
02074400,IL EASTERN COMM COLGS-FRONTIER          ,IL,62837-0000,Public       ,16,28,44,247,468,715
02075400,KELLER GRADUATE SCHOOL OF MGMT.         ,IL,60515-5683,Proprietary  ,0,197,197,83,21622,21705
02113600,AMERICAN INTERCONTINENTAL UNIVERSITY    ,IL,60192-3713,Proprietary  ,120,2273,2393,2010,31562,33572
02117400,BECK AREA CAREER CENTER                 ,IL,62278-0000,Public       ,0,2,2,35,184,219
02124400,UNIVERSITY OF SPA & COSMETOLOGY ART     ,IL,62704-0000,Proprietary  ,11,9,20,165,293,458
02150600,COSMETOLOGY AND SPA INSTITUTE (THE)     ,IL,60014-4003,Proprietary  ,9,10,19,134,275,409
02155300,THE CHICAGO SCHOOL OF PROF PSYCHOLOGY   ,IL,60610-4705,Private      ,0,37,37,115,6126,6241
02160300,INTERNATIONAL ACAD OF DESIGN & TECH     ,IL,60602-3319,Proprietary  ,11,11,22,552,891,1443
02160304,INTERNATIONAL ACADEMY OF DESIGN AND TECH,IL,60173-5160,Proprietary  ,0,14,14,163,358,521
02168600,EAST WEST UNIVERSITY                    ,IL,60605-0000,Private      ,34,52,86,912,1693,2605
02179900,ARGOSY UNIVERSITY                       ,IL,60601-7757,Proprietary  ,364,3881,4245,10773,51129,61902
02185400,ST AUGUSTINE COLLEGE                    ,IL,60640-0000,Private      ,6,22,28,785,2667,3452
02192400,MR JOHNS SCHOOL OF COSMETOLOGY          ,IL,62521-0000,Proprietary  ,4,12,16,51,150,201
02202600,CANNELLA SCHOOL OF HAIR DESIGN          ,IL,60181-1321,Proprietary  ,0,10,10,17,115,132
02214100,RESURRECTION UNIVERSITY                 ,IL,60302-2519,Private      ,0,4,4,202,899,1101
02228100,MAC DANIEL'S BEAUTY SCHOOL              ,IL,60640-0000,Proprietary  ,0,10,10,65,163,228
02261200,HAIR PROFESSIONALS ACAD COSMETOLOGY     ,IL,60118-0000,Proprietary  ,9,37,46,88,307,395
02261201,HAIR PROFESSIONALS ACADEMY OF COSMETOLOG,IL,60118-9333,Proprietary  ,0,0,0,10,16,26
02262100,HAIR PROFESSIONALS SCH COSMETOLOGY      ,IL,60543-0000,Proprietary  ,4,3,7,50,94,144
02291200,CANNELLA SCHOOL OF HAIR DESIGN          ,IL,60639-0000,Proprietary  ,1,11,12,97,261,358
02295500,CANNELLA SCHOOL OF HAIR DESIGN          ,IL,60120-0000,Proprietary  ,1,9,10,32,125,157
02297500,OEHRLEIN SCHOOL OF COSMETOLOGY          ,IL,61611-0000,Proprietary  ,0,5,5,74,161,235
02312300,LA' JAMES COLLEGE HAIRSTYLING           ,IL,61244-0000,Proprietary  ,0,0,0,21,84,105
02313900,WESTWOOD COLLEGE - O'HARE AIRPORT       ,IL,60631-2801,Proprietary  ,10,40,50,464,1149,1613
02317300,CONCEPT COLLEGE OF COSMETOLOGY          ,IL,61832-0000,Proprietary  ,1,7,8,71,180,251
02319200,LAKE FOREST GRAD SCHL OF MGMT           ,IL,60045-4824,Private      ,0,10,10,6,388,394
02323300,PROFESSIONAL'S CHOICE HAIR DSN ACAD     ,IL,60435-0000,Proprietary  ,1,4,5,57,174,231
02332200,HAIR PROFESSIONALS CAREER COLLEGE       ,IL,60178-0000,Proprietary  ,3,5,8,35,103,138
02337800,THE COLLEGE OF OFFICE TECHNOLOGY        ,IL,60622-0000,Proprietary  ,0,0,0,55,244,299
02349400,ALVAREITA'S COLLEGE OF COSMETOLOGY      ,IL,62035-0000,Proprietary  ,4,6,10,46,117,163
02349500,CANNELLA SCHOOL OF HAIR DESIGN          ,IL,60632-0000,Proprietary  ,6,17,23,106,347,453
02352200,LE CORDON BLEU COLLEGE OF CULINARY ARTS ,IL,60610-3050,Proprietary  ,21,72,93,1240,2384,3624
02498200,G SKIN & BEAUTY INSTITUTE               ,IL,60523-1805,Proprietary  ,8,25,33,124,372,496
02498201,HAIR PROFESSIONALS ACADEMY OF COSMETOLOG,IL,60563-0000,Proprietary  ,0,0,0,23,60,83
02522800,FOX COLLEGE                             ,IL,60453-0000,Proprietary  ,1,0,1,547,610,1157
02527600,LEXINGTON COLLEGE                       ,IL,60607-0000,Private      ,0,2,2,115,139,254
02536700,BELL MAR BEAUTY COLLEGE                 ,IL,60650-0000,Proprietary  ,0,4,4,49,110,159
02556100,ENVIRONMENTAL TECHNICAL INSTITUTE       ,IL,60143-0000,Proprietary  ,9,39,48,137,547,684
02556600,NILES SCHOOL OF COSMETOLOGY             ,IL,60714-0000,Proprietary  ,4,2,6,28,78,106
02573700,INSTITUTE FOR CLINICAL SOCIAL WORK      ,IL,60605-1229,Private      ,0,4,4,37,370,407
02579200,INGALLS MEMORIAL HOSPITAL               ,IL,60426-0000,Private      ,0,0,0,7,70,77
02584900,"FIRST INSTITUTE, INC.                   ",IL,60014-7489,Proprietary  ,4,7,11,113,366,479
02587700,HAIR PROFESSIONALS CAREER COLLEGE       ,IL,60465-1929,Proprietary  ,1,5,6,46,152,198
02599500,HANOVER PARK COLLEGE OF BEAUTY CULT     ,IL,60133-5421,Proprietary  ,5,7,12,51,113,164
02622700,KNOWLEDGE SYSTEMS INSTITUTE             ,IL,60076-0000,Private      ,0,0,0,2,14,16
03002000,HAIRMASTERS INST OF COSMETOLOGY         ,IL,61701-5547,Proprietary  ,5,5,10,61,128,189
03027702,PACIFIC COLLEGE OF ORIENTAL MEDICINE - C,IL,60613-4418,Proprietary  ,0,10,10,43,436,479
03065300,TREND SETTERS COLL OF COSMETOLOGY       ,IL,60915-0000,Proprietary  ,15,8,23,280,326,606
03072701,WESTWOOD COLLEGE OF TECHNOLOGY          ,IL,60409-0000,Proprietary  ,10,34,44,258,1034,1292
03072702,WESTWOOD COLLEGE OF TECHNOLOGY          ,IL,60602-0000,Proprietary  ,8,56,64,513,1769,2282
03078400,CAMEO BEAUTY ACADEMY                    ,IL,60453-3196,Proprietary  ,3,9,12,58,124,182
03079200,WESTWOOD COLLEGE - DUPAGE               ,IL,60517-2321,Proprietary  ,2,27,29,390,833,1223
03082900,ROSEL SCHOOL OF COSMETOLOGY             ,IL,60659-1913,Proprietary  ,1,12,13,55,208,263
03083800,HEARTLAND COMMUNITY COLLEGE             ,IL,61761-9446,Public       ,27,70,97,2896,3128,6024
03098000,ST JOHN'S COLLEGE OF NURSING            ,IL,62702-5321,Private      ,0,2,2,191,313,504
03098002,ST JOHN'S HOSP SCH MED TECH             ,IL,62769-5324,Private      ,1,5,6,46,140,186
03099700,CAIN'S BARBER COLLEGE                   ,IL,60615-3510,Proprietary  ,6,23,29,188,665,853
03099800,ILLINOIS SCHOOL OF HEALTH CAREERS       ,IL,60604-0000,Proprietary  ,12,66,78,579,1853,2432
03101800,ILLINOIS CENTER FOR BROADCASTING        ,IL,60148-7015,Proprietary  ,4,7,11,178,470,648
03128300,PYRAMID CAREER INSTITUTE                ,IL,60657-4207,Proprietary  ,0,0,0,0,2,2
03128500,NATIONAL LATINO EDUCATION INSTITUTE     ,IL,60609-2205,Private      ,1,4,5,67,157,224
03199300,CHRISTIAN LIFE COLLEGE                  ,IL,60056-2522,Private      ,0,1,1,19,43,62
03368300,MIDWEST TECHNICAL INSTITUTE             ,IL,62707-8805,Proprietary  ,50,188,238,1134,4015,5149
03416300,COMPUTER SYSTEMS INSTITUTE              ,IL,60077-0000,Proprietary  ,41,181,222,483,2023,2506
03448300,BUSINESS INDUSTRIAL RESOURCES           ,IL,60659-1298,Proprietary  ,24,197,221,385,3677,4062
03455700,CORTIVA INSTITUTE - CHICAGO             ,IL,60602-3315,Proprietary  ,9,20,29,217,586,803
03455701,CORTIVA INSTITUTE - CHICAGO             ,IL,60014-6285,Proprietary  ,1,0,1,18,62,80
03490301,PAUL MITCHELL THE SCHOOL CHICAGO        ,IL,60607-0000,Proprietary  ,7,18,25,7,22,29
03510300,ERIKSON INSTITUTE                       ,IL,60654-4510,Private      ,1,3,4,9,432,441
03643300,"MR. JOHN'S SCHOOL OF JACKSONVILLE,  INC,",IL,62650-3488,Proprietary  ,1,4,5,18,51,69
03655300,ILLINOIS CAREERPATH INSTITUTE           ,IL,60610-4705,Private      ,0,10,10,39,239,278
03684300,NORTHSHORE UNIVERSITY HEALTHSYSTEM SCHOO,IL,60201-9872,Private      ,0,1,1,19,98,117
03881400,EUROPEAN MASSAGE THERAPY SCHOOL         ,IL,60077-2269,Proprietary  ,2,32,34,31,234,265
03891300,SOMA INSTITUTE - THE NATIONAL SCHOOL OF ,IL,60604-4466,Proprietary  ,3,22,25,98,267,365
03914300,"CALC, INSTITUTE OF TECHNOLOGY           ",IL,62002-5931,Proprietary  ,5,17,22,55,308,363
04117500,SOLEX MEDICAL ACADEMY                   ,IL,60090-3104,Proprietary  ,1,2,3,7,50,57
04117600,LARRY'S BARBER COLLEGE                  ,IL,60628-2322,Proprietary  ,4,19,23,247,777,1024
04118400,ZAREM /GOLDE ORT TECHNICAL INSTITUTE    ,IL,60077-3210,Private      ,8,41,49,69,352,421
04124700,AMERICARE INSTITUTE                     ,IL,60133-5456,Proprietary  ,7,13,20,112,685,797
04136900,UNIVERSITY OF AESTHETICS (THE)          ,IL,60622-2151,Proprietary  ,0,8,8,22,106,128
04137000,UNIVERSITY OF AESTHETICS (THE)          ,IL,60515-5602,Proprietary  ,1,0,1,13,44,57
04137500,TRICOCI UNIVERSITY OF BEAUTY CULTURE    ,IL,60656-1805,Proprietary  ,4,20,24,279,521,800
04139000,MIDWESTERN CAREER COLLEGE               ,IL,60606-3103,Proprietary  ,11,76,87,179,1017,1196
04141000,AVEDA INSTITUTE CHICAGO                 ,IL,60647-0000,Proprietary  ,6,11,17,295,544,839
04147100,TRICOCI UNIVERSITY OF BEAUTY CULTURE    ,IL,60048-2906,Proprietary  ,7,7,14,114,161,275
04147200,TRICOCI UNIVERSITY OF BEAUTY CULTURE    ,IL,60455-1824,Proprietary  ,4,13,17,126,249,375
04147300,TRICOCI UNIVERSITY OF BEAUTY CULTURE    ,IL,60139-3119,Proprietary  ,9,8,17,140,168,308
04147400,TRICOCI UNIVERSITY OF BEAUTY CULTURE    ,IL,61614-4831,Proprietary  ,10,13,23,88,187,275
04147500,TRICOCI UNIVERSITY OF BEAUTY CULTURE    ,IL,61108-2337,Proprietary  ,5,3,8,127,281,408
04160600,PAUL MITCHELL THE SCHOOL NORMAL         ,IL,61761-0000,Proprietary  ,8,4,12,232,257,489
04167800,INNOVATIONS DESIGN ACADEMY              ,IL,61520-2625,Proprietary  ,1,6,7,22,66,88
04168500,SOLEX COLLEGE                           ,IL,60090-3192,Proprietary  ,1,55,56,18,280,298
04170800,UNITY COSMETOLOGY COLLEGE               ,IL,61764-9652,Proprietary  ,5,5,10,29,80,109
04171600,SALON PROFESSIONAL ACADEMY OF ELGIN (THE,IL,60123-2319,Proprietary  ,2,6,8,29,83,112
04172200,NORTHWESTERN INSTITUTE OF HEALTH AND TEC,IL,60640-4785,Private      ,5,7,12,285,1014,1299
04174900,SKIN CARE AND SPA INSTITUTE             ,IL,60077-2200,Proprietary  ,0,0,0,18,182,200
04175000,UNIVERSAL SPA TRAINING ACADEMY          ,IL,60515-0000,Proprietary  ,0,6,6,17,122,139
04175800,J RENEE CAREER FACILITATION             ,IL,60014-7986,Proprietary  ,1,7,8,22,167,189
04179100,PCCTI  IT & HEALTHCARE                  ,IL,60523-0000,Proprietary  ,4,12,16,14,201,215
04179101,PCCTI  IT & HEALTHCARE -                ,IL,60606-0000,Proprietary  ,0,3,3,3,12,15
04186000,CHICAGO SCHOOL FOR PIANO TECHNOLOGY (THE,IL,60612-1630,Private      ,0,3,3,30,83,113
04187400,COSMETOLOGY CONCEPTS                    ,IL,60452-2501,Proprietary  ,12,17,29,126,303,429
04189200,SALON PROFESSIONAL ACADEMY (THE)        ,IL,60404-8789,Proprietary  ,1,1,2,47,91,138
04189400,SHEAR LEARNING ACADEMY OF COSMETOLOGY   ,IL,62523-1208,Proprietary  ,1,2,3,25,84,109
04189600,STATE CAREER SCHOOL                     ,IL,60085-5129,Proprietary  ,3,14,17,46,210,256
04192000,CURVE METRIC SCHOOL OF HAIR DESIGN      ,IL,60707-1118,Proprietary  ,0,1,1,10,26,36
04195600,TRIBECA FLASHPOINT MEDIA ARTS ACADEMY   ,IL,60602-2716,Proprietary  ,69,38,107,69,38,107
00195100,ALICE LLOYD COLLEGE                     ,KY,41844-9703,Private      ,2,2,4,1224,263,1487
00195200,ASBURY COLLEGE                          ,KY,40390-1198,Private      ,5,10,15,1781,806,2587
00195300,ASBURY THEOLOGICAL SEMINARY             ,KY,40390-0000,Private      ,0,10,10,29,1502,1531
00195400,BELLARMINE UNIVERSITY                   ,KY,40205-1877,Private      ,9,72,81,5250,2715,7965
00195500,BEREA COLLEGE                           ,KY,40403-0000,Private      ,10,6,16,3594,1052,4646
00195800,BRESCIA UNIVERSITY                      ,KY,42301-3023,Private      ,1,12,13,1091,944,2035
00195900,CAMPBELLSVILLE UNIVERSITY               ,KY,42718-2799,Private      ,8,26,34,2988,2259,5247
00196000,SPALDING UNIVERSITY                     ,KY,40203-2188,Private      ,9,37,46,1425,3816,5241
00196100,CENTRE COLLEGE                          ,KY,40422-1394,Private      ,2,0,2,2696,194,2890
00196200,UNIVERSITY OF THE CUMBERLANDS           ,KY,40769-1372,Private      ,3,78,81,3066,3247,6313
00196300,EASTERN KENTUCKY UNIVERSITY             ,KY,40475-3102,Public       ,57,200,257,14907,12425,27332
00196400,GEORGETOWN COLLEGE                      ,KY,40324-1628,Private      ,5,27,32,2516,943,3459
00196500,KENTUCKY CHRISTIAN UNIVERSITY           ,KY,41143-2205,Private      ,2,3,5,981,282,1263
00196800,KENTUCKY STATE UNIVERSITY               ,KY,40601-2355,Public       ,9,28,37,3590,2503,6093
00196900,KENTUCKY WESLEYAN COLLEGE               ,KY,42301-6057,Private      ,4,4,8,1238,477,1715
00197100,LEXINGTON THEOLOGICAL SEMINARY          ,KY,40508-0000,Private      ,0,4,4,10,124,134
00197200,LINDSEY WILSON COLLEGE                  ,KY,42728-1223,Private      ,5,5,10,3390,2136,5526
00197400,LOUISVILLE PRESBYTERIAN THEOL SEM       ,KY,40205-0000,Private      ,0,5,5,17,220,237
00197500,MIDWAY COLLEGE                          ,KY,40347-1120,Private      ,2,32,34,776,2629,3405
00197600,MOREHEAD STATE UNIVERSITY               ,KY,40351-1689,Public       ,66,116,182,8721,6561,15282
00197700,MURRAY STATE UNIVERSITY                 ,KY,42071-0009,Public       ,27,73,100,8581,5275,13856
00197900,WEST KENTUCKY CMNTY & TECHNICAL COLG    ,KY,42002-7380,Public       ,46,139,185,2377,5340,7717
00198000,UNIVERSITY OF PIKEVILLE                 ,KY,41501-1194,Private      ,9,8,17,2464,1461,3925
00198300,ST. CATHARINE COLLEGE                   ,KY,40061-9499,Private      ,2,4,6,965,568,1533
00198700,TRANSYLVANIA UNIVERSITY                 ,KY,40508-1797,Private      ,2,4,6,2244,420,2664
00198800,UNION COLLEGE                           ,KY,40906-1499,Private      ,4,43,47,1442,1235,2677
00198900,UNIVERSITY OF KENTUCKY                  ,KY,40506-0054,Public       ,71,114,185,25885,12235,38120
00198901,UNIV OF KY-COLLEGE OF DENTISTRY         ,KY,40536-0000,Public       ,0,0,0,64,317,381
00198902,UNIV OF KY-COLLEGE OF MEDICINE          ,KY,40536-0000,Public       ,0,6,6,148,751,899
00199000,ASHLAND COMMUNITY AND TECHNICAL COLLEGE ,KY,41101-3683,Public       ,19,89,108,1756,3646,5402
00199100,ELIZABETHTOWN COMMUNITY  AND TECHNICAL C,KY,42701-3081,Public       ,37,202,239,2999,7144,10143
00199300,HENDERSON COMMUNITY COLLEGE             ,KY,42420-4699,Public       ,7,27,34,661,1756,2417
00199400,HOPKINSVILLE COMMUNITY COLLEGE          ,KY,42241-2621,Public       ,15,130,145,1424,5267,6691
00199600,BIG SANDY COMMUNITY AND TECHNICAL COLG  ,KY,41653-1815,Public       ,22,91,113,2387,3723,6110
00199700,SOMERSET COMMUNITY COLLEGE              ,KY,42501-2973,Public       ,43,164,207,3663,9096,12759
00199800,SOUTHEAST KENTUCKY COMMUNITY AND TECHNIC,KY,40823-1099,Public       ,19,73,92,1493,2648,4141
00199900,UNIVERSITY OF LOUISVILLE                ,KY,40292-0000,Public       ,65,183,248,17234,15517,32751
00200100,THOMAS MORE COLLEGE                     ,KY,41017-3495,Private      ,2,29,31,1575,1035,2610
00200200,WESTERN KENTUCKY UNIVERSITY             ,KY,42101-3576,Public       ,67,153,220,18488,12072,30560
00461800,SPENCERIAN COLLEGE                      ,KY,40216-2605,Proprietary  ,22,69,91,871,2528,3399
00461900,SULLIVAN UNIVERSITY                     ,KY,40205-3000,Proprietary  ,92,317,409,2670,8114,10784
00493402,DAYMAR COLLEGE - BOWLING GREEN          ,KY,42101-4063,Proprietary  ,3,23,26,55,320,375
00493403,DAYMAR COLLEGE - CLINTON                ,KY,42031-9998,Proprietary  ,0,0,0,1,19,20
00493406,DAYMAR COLLEGE - RUSSELLVILLE           ,KY,42276-1622,Proprietary  ,1,4,5,8,71,79
00524400,BLUEGRASS COMMUNITY & TECHNICAL COLLEGE ,KY,40506-0235,Public       ,65,263,328,6904,13676,20580
00527100,BOWLING GREEN TECHNICAL COLLEGE         ,KY,42101-3601,Public       ,25,73,98,2024,4773,6797
00527300,GATEWAY COMMUNITY & TECHNOLOGY COLL     ,KY,41011-0000,Public       ,28,143,171,1771,5487,7258
00696000,MAYSVILLE CMNTY & TECHNCL COLG          ,KY,41056-8910,Public       ,50,111,161,1434,3727,5161
00696100,JEFFERSON COMMUNITY AND TECHNICAL COLLEG,KY,40202-2005,Public       ,59,287,346,8016,17661,25677
00696200,HAZARD COMMUNITY COLLEGE                ,KY,41701-2402,Public       ,12,48,60,1635,3098,4733
00696203,KY TECH-KNOTT CO. TECHNOLOGY CTR        ,KY,41822-0000,Public       ,1,0,1,19,26,45
00696204,KY TECH-LESLIE COUNTY AREA TECH CTR     ,KY,41749-0000,Public       ,0,0,0,8,19,27
00696205,KY TECH-LEE COUNTY AREA TECH CTR        ,KY,41311-0000,Public       ,0,1,1,5,21,26
00696206,KY TECH-LETCHER CNTY AREA TECH CTR      ,KY,41858-0000,Public       ,0,1,1,38,79,117
00696207,KY TECH-BREATHITT COUNTY VOC ED CTR     ,KY,41339-0000,Public       ,0,2,2,38,102,140
00736205,MEDTECH COLLEGE - LEXINGTON             ,KY,40511-1200,Proprietary  ,4,62,66,148,1104,1252
00842500,DAYMAR COLLEGE                          ,KY,42001-0000,Proprietary  ,0,11,11,77,575,652
00901000,MADISONVILLE COMMUNITY COLLEGE          ,KY,42431-9199,Public       ,10,51,61,1313,2990,4303
00927500,NORTHERN KENTUCKY UNIVERSITY            ,KY,41099-0001,Public       ,30,124,154,11328,9022,20350
00931300,DAYMAR COLLEGE                          ,KY,42301-5830,Proprietary  ,13,121,134,268,2377,2645
00931302,DAYMAR COLLEGE - LOUISVILLE             ,KY,40219-1973,Proprietary  ,2,15,17,19,209,228
00931304,DAYMAR COLLEGE - ALBANY                 ,KY,42602-1235,Proprietary  ,0,0,0,1,13,14
00931305,DAYMAR COLLEGE - BELLEVUE               ,KY,41073-2416,Proprietary  ,1,3,4,9,64,73
00931308,DAYMAR COLLEGE -  SCOTTSVILLE           ,KY,42164-1505,Proprietary  ,2,5,7,8,44,52
00931309,DAYMAR COLLEGE - LOUISVILLE EAST        ,KY,40245-1629,Proprietary  ,0,8,8,35,299,334
00931310,DAYMAR COLLEGE -  MADISONVILLE          ,KY,42431-0000,Proprietary  ,0,9,9,13,100,113
01042400,SALON PROFESSIONAL ACADEMY THE          ,KY,40502-0000,Proprietary  ,6,9,15,121,354,475
01048901,NATIONAL COLLEGE - FLORENCE CAMPUS      ,KY,41042-1812,Proprietary  ,4,11,15,52,374,426
01048902,NATIONAL COLLEGE - PIKEVILLE CAMPUS     ,KY,41501-1518,Proprietary  ,1,20,21,188,585,773
01048903,NATIONAL COLLEGE - DANVILLE CAMPUS      ,KY,40422-1517,Proprietary  ,2,13,15,70,524,594
01048904,NATIONAL COLLEGE - RICHMOND CAMPUS      ,KY,40475-2309,Proprietary  ,0,18,18,102,663,765
01048906,NATIONAL COLLEGE - LOUISVILLE CAMPUS    ,KY,40216-4147,Proprietary  ,5,37,42,172,1215,1387
01048907,NATIONAL COLLEGE - LEXINGTON CAMPUS     ,KY,40509-2256,Proprietary  ,2,27,29,142,1122,1264
01172500,COLLINS SCHOOL OF COSMETOLOGY           ,KY,40965-2809,Proprietary  ,1,13,14,39,147,186
01208800,SULLIVAN COLLEGE OF TECHNOLOGY AND DESIG,KY,40218-4528,Proprietary  ,18,29,47,669,1210,1879
01212801,SOUTHWESTERN COLLEGE                    ,KY,41042-1466,Proprietary  ,7,26,33,106,551,657
01272300,KY TECH-WAYNE COUNTY AREA TECH CTR      ,KY,42633-1088,Public       ,0,0,0,2,15,17
01291400,EMPIRE BEAUTY SCHOOL                    ,KY,40218-0000,Proprietary  ,3,33,36,159,510,669
01291500,EMPIRE BEAUTY SCHOOL                    ,KY,41042-5113,Proprietary  ,7,16,23,104,324,428
01291600,EMPIRE BEAUTY SCHOOL                    ,KY,40216-4212,Proprietary  ,3,13,16,80,301,381
01291700,EMPIRE BEAUTY SCHOOL                    ,KY,40160-0000,Proprietary  ,2,17,19,115,272,387
01296800,EMPIRE BEAUTY SCHOOL                    ,KY,40207-2695,Proprietary  ,4,7,11,95,235,330
02159100,"APPALACHIAN BEAUTY SCHOOL, INC.         ",KY,41503-0000,Proprietary  ,0,1,1,33,55,88
02177100,EMPIRE BEAUTY SCHOOL                    ,KY,40204-0000,Proprietary  ,0,6,6,103,315,418
02251500,TREND SETTERS ACAD OF BEAUTY CULT       ,KY,40258-0000,Proprietary  ,4,23,27,83,374,457
02275000,JENNY LEA ACADEMY OF COSMETOLOGY        ,KY,40831-0000,Proprietary  ,1,28,29,93,320,413
02284306,INTERACTIVE LEARNING SYSTEMS            ,KY,41042-0000,Proprietary  ,2,10,12,25,153,178
02323700,PAT WILSON'S BEAUTY COLLEGE             ,KY,42420-0000,Proprietary  ,0,5,5,11,90,101
02337200,PJ'S COLLEGE OF COSMETOLOGY             ,KY,42101-0000,Proprietary  ,6,42,48,172,680,852
02340800,PAUL MITCHELL THE SCHOOL LEXINGTON      ,KY,40514-1545,Proprietary  ,9,14,23,244,457,701
02351700,PAUL MITCHELL THE SCHOOL - LOUISVILLE   ,KY,40222-0000,Proprietary  ,7,10,17,248,424,672
02491100,BECKFIELD COLLEGE                       ,KY,41042-0000,Proprietary  ,20,197,217,373,2818,3191
02518900,BARRETT & COMPANY SCH HAIR DESIGN       ,KY,40356-0000,Proprietary  ,1,9,10,57,208,265
02526100,JENNY LEA ACADEMY OF COSMETOLOGY        ,KY,41858-0000,Proprietary  ,0,3,3,26,79,105
02535600,CLEAR CREEK BAPTIST BIBLE COLLEGE       ,KY,40977-0000,Private      ,1,1,2,56,172,228
02551100,PJ'S COLLEGE OF COSMETOLOGY             ,KY,42141-2434,Proprietary  ,1,10,11,46,146,192
02560800,SOUTHEAST SCHOOL OF COSMETOLOGY         ,KY,40962-0000,Proprietary  ,1,6,7,29,107,136
02576200,MID-CONTINENT UNIVERSITY                ,KY,42066-9007,Private      ,2,32,34,508,4274,4782
03002100,KENTUCKY MOUNTAIN BIBLE COLLEGE         ,KY,41385-0010,Private      ,1,0,1,72,45,117
03007000,FRONTIER SCH OF MIDWIFERY&FAMILY NU     ,KY,41749-0000,Private      ,0,27,27,9,2158,2167
03026200,HEAD'S WEST KENTUCKY BEAUTY COLLEGE     ,KY,42431-0000,Proprietary  ,2,5,7,20,96,116
03029200,NU-TEK ACADEMY OF BEAUTY                ,KY,40353-9767,Proprietary  ,1,2,3,39,73,112
03034500,OWENSBORO COMMUNITY & TECHNICAL COLLEGE ,KY,42303-1899,Public       ,22,96,118,1850,3771,5621
03083700,GALEN HEALTH INSTITUTES                 ,KY,40207-1047,Proprietary  ,7,51,58,965,5902,6867
03103500,MR JIM'S BEAUTY COLLEGE                 ,KY,42301-2646,Proprietary  ,0,1,1,21,81,102
03516500,EZELL'S COSMETOLOGY SCHOOL              ,KY,42071-2530,Proprietary  ,3,2,5,53,89,142
03611300,BRIGHTON CENTER'S CENTER FOR EMPLOY     ,KY,41071-1968,Private      ,0,24,24,14,182,196
03804300,BELLEFONTE ACADEMY OF BEAUTY            ,KY,41169-2015,Proprietary  ,3,13,16,39,232,271
03885300,EMPLOYMENT SOLUTIONS                    ,KY,40517-3260,Private      ,7,35,42,84,607,691
03886300,REGENCY SCHOOL OF HAIR DESIGN           ,KY,41653-1278,Proprietary  ,0,6,6,33,117,150
04038300,ATA CAREER EDUCATION                    ,KY,40223-3832,Proprietary  ,16,45,61,305,1572,1877
04051316,ART INSTITUTE OF PHOENIX (THE) - ATS - (,KY,41017-2136,Proprietary  ,11,27,38,209,918,1127
04051319,ART INSTITUTE OF PHOENIX (THE) - BROWN M,KY,40219-1916,Proprietary  ,3,16,19,244,752,996
04051320,ART INSTITUTE OF PHOENIX (THE) - BROWN M,KY,42240-3579,Proprietary  ,2,4,6,51,309,360
04123900,LEXINGTON HEALING ARTS ACADEMY          ,KY,40503-1932,Proprietary  ,0,10,10,70,295,365
04177600,LINDSEY INSTITUTE OF COSMETOLOGY        ,KY,42103-8036,Proprietary  ,0,6,6,105,200,305
04177700,TRI-STATE INSTITUTE OF HAIR DESIGN      ,KY,40744-5234,Proprietary  ,2,10,12,35,155,190
04178000,SIMMONS COLLEGE OF KENTUCKY             ,KY,40203-3322,Private      ,2,2,4,46,205,251
00200300,CENTENARY COLLEGE OF LOUISIANA          ,LA,71104-3396,Private      ,10,10,20,1277,501,1778
00200400,DILLARD UNIVERSITY                      ,LA,70122-3097,Private      ,44,36,80,3376,1816,5192
00200500,NICHOLLS STATE UNIVERSITY               ,LA,70310-0001,Public       ,50,62,112,6345,3312,9657
00200600,GRAMBLING STATE UNIVERSITY              ,LA,71245-2215,Public       ,95,95,190,7389,4767,12156
00200700,LOUISIANA COLLEGE                       ,LA,71359-0000,Private      ,9,106,115,1496,1058,2554
00200800,LOUISIANA TECH UNIVERSITY               ,LA,71272-0001,Public       ,76,61,137,8085,3989,12074
00201000,LOUISIANA STATE UNIV & A&M COLG         ,LA,70803-5710,Public       ,116,118,234,28828,10433,39261
00201100,LOUISIANA STATE UNIV-ALEXANDRIA         ,LA,71302-9121,Public       ,24,48,72,2067,2578,4645
00201200,LOUISIANA STATE UNIV-EUNICE             ,LA,70535-6726,Public       ,37,38,75,2619,2376,4995
00201300,LOUISIANA STATE UNIV-SHREVEPORT         ,LA,71115-2399,Public       ,24,79,103,3595,4420,8015
00201400,LA STATE UNIV HEALTH SCIENCES CTR       ,LA,70112-2223,Public       ,5,38,43,694,3033,3727
00201500,(THE) UNIVERSITY OF NEW ORLEANS         ,LA,70148-0001,Public       ,57,141,198,8049,9270,17319
00201600,LOYOLA UNIVERSITY NEW ORLEANS           ,LA,70118-6195,Private      ,21,65,86,5734,3915,9649
00201700,MCNEESE STATE UNIVERSITY                ,LA,70609-4510,Public       ,54,92,146,6399,4765,11164
00201900,NEW ORLEANS BAPTIST THEOL SEMINARY      ,LA,70126-0000,Private      ,0,3,3,59,354,413
00202000,UNIVERSITY OF LOUISIANA AT MONROE       ,LA,71209-9001,Public       ,54,117,171,7270,5849,13119
00202100,NORTHWESTERN STATE UNIVERSITY           ,LA,71497-0001,Public       ,54,182,236,6912,7249,14161
00202200,NOTRE DAME SEMINARY                     ,LA,70118-0000,Private      ,0,3,3,13,66,79
00202300,OUR LADY OF HOLY CROSS COLLEGE          ,LA,70131-7399,Private      ,9,32,41,757,1785,2542
00202400,SOUTHEASTERN LOUISIANA UNIV             ,LA,70402-0001,Public       ,116,121,237,12821,7192,20013
00202500,SOUTHERN UNIVERSITY A & M COLLEGE       ,LA,70813-9374,Public       ,92,125,217,7798,8272,16070
00202600,SOUTHERN UNIV NEW ORLEANS               ,LA,70126-0002,Public       ,36,82,118,2793,5942,8735
00202700,ST JOSEPH SEMINARY COLLEGE              ,LA,70457-9990,Private      ,0,0,0,51,16,67
00202900,TULANE UNIVERSITY                       ,LA,70118-5698,Private      ,43,94,137,13032,8897,21929
00203100,UNIV OF LOUISIANA AT LAFAYETTE          ,LA,70504-0001,Public       ,104,114,218,15714,6987,22701
00203200,XAVIER UNIVERSITY OF LOUISIANA          ,LA,70125-1098,Private      ,29,33,62,5997,2522,8519
00462100,AYERS CAREER COLLEGE                    ,LA,71108-5845,Proprietary  ,5,23,28,99,594,693
00462500,DELGADO COMMUNITY COLLEGE               ,LA,70119-0000,Public       ,142,455,597,10402,21745,32147
00546700,SOWELA TECHNICAL COMMUNITY COLLEGE      ,LA,70616-6950,Public       ,40,104,144,1441,2367,3808
00546702,SOWELA TECHNICAL COMMUNITY COLLEGE - MOR,LA,70546-1327,Public       ,3,9,12,75,159,234
00547100,NORTHEAST LOUISIANA TECHNICAL COLLEGE   ,LA,71292-9064,Public       ,16,57,73,376,1072,1448
00547101,NORTHEAST LOUISIANA TECHNICAL COLLEGE   ,LA,71241-0000,Public       ,0,1,1,15,69,84
00547102,NORTHEAST LOUISIANA TECHNICAL COLLEGE   ,LA,71270-0000,Public       ,7,17,24,204,422,626
00547103,NORTHEAST LOUISIANA TECHNICAL COLLEGE   ,LA,71295-0000,Public       ,6,10,16,104,281,385
00547104,NORTHEAST LOUISIANA TECHNICAL COLLEGE   ,LA,71220-0000,Public       ,13,17,30,97,268,365
00548800,LOUISIANA TECH COLG-BATON ROUGE         ,LA,70807-0000,Public       ,24,81,105,740,1722,2462
00548812,LOUISIANA TECH COLG-FOLKES CAMPUS       ,LA,70748-0000,Public       ,2,8,10,60,83,143
00548817,LOUISIANA TEC CLG-JUMONVILLE MEM CP     ,LA,70760-0000,Public       ,5,3,8,44,118,162
00548842,LOUISIANA TECHNICAL COLLEGE - WESTSIDE C,LA,70765-0733,Public       ,6,12,18,32,101,133
00548900,CENTRAL LOUISIANA TECHNICAL COLLEGE     ,LA,71302-3137,Public       ,6,16,22,261,867,1128
00548901,CENTRAL LOUISIANA TECHNICAL COLLEGE     ,LA,71327-3743,Public       ,7,9,16,88,176,264
00548902,CENTRAL LOUISIANA TECHNICAL COLLEGE     ,LA,71483-3563,Public       ,10,13,23,109,280,389
00548903,CENTRAL LOUISIANA TECHNICAL COLLEGE     ,LA,71302-6511,Public       ,6,15,21,92,435,527
00548904,CENTRAL LOUISIANA TECHNICAL COLLEGE     ,LA,71463-3536,Public       ,1,1,2,77,179,256
00548905,CENTRAL LOUISIANA TECHNICAL COLLEGE     ,LA,71334-2232,Public       ,5,18,23,108,305,413
00552600,SOUTH CENTRAL LOUISIANA TECHNICAL COLG  ,LA,70381-2148,Public       ,4,16,20,187,466,653
00552602,SOUTH CENTRAL LOUISIANA TECHNICAL COLG  ,LA,70302-4336,Public       ,3,8,11,170,330,500
00552603,SOUTH CENTRAL LOUISIANA TECHNICAL COLG  ,LA,70084-6632,Public       ,8,30,38,382,741,1123
00576100,L. E. FLETCHER TECHNICAL COMMUNITY COLLE,LA,70360-2863,Public       ,26,44,70,1166,1735,2901
00675600,NORTHSHORE TECHNICAL COLLEGE            ,LA,70427-5866,Public       ,16,42,58,310,919,1229
00675603,NORTHSHORE TECHNICAL COLLEGE - HAMMOND  ,LA,70401-0000,Public       ,16,32,48,543,1078,1621
00675604,NORTHSHORE TECHNICAL COLLEGE - FLORIDA  ,LA,70441-0000,Public       ,6,9,15,225,426,651
00768600,SOUTHERN UNIV AT SHREVEPORT/BOSSIER     ,LA,71107-4795,Public       ,45,71,116,1806,4127,5933
00777707,REMINGTON COLLEGE - CLEVELAND CAMPUS - L,LA,70508-5760,Private      ,2,10,12,180,319,499
00777708,REMINGTON COLLEGE - CLEVELAND CAMPUS - B,LA,70816-4040,Private      ,10,40,50,338,789,1127
00806700,LSU HEALTH SCIENCES CENTR-SHREVEPOR     ,LA,71130-3932,Public       ,5,27,32,378,1333,1711
00989800,DEMMON SCHOOL OF BEAUTY                 ,LA,70607-2128,Proprietary  ,2,5,7,44,142,186
00997500,NORTHWEST LOUISIANA TECHNICAL COLLEGE   ,LA,71055-2422,Public       ,13,28,41,247,627,874
00997503,NORTHWEST LOUISIANA TECHNICAL COLLEGE   ,LA,71137-8527,Public       ,13,49,62,410,1541,1951
00997504,NORTHWEST LOUISIANA TECHNICAL COLLEGE   ,LA,71052-1236,Public       ,4,8,12,66,203,269
00997505,NORTHWEST LOUISIANA TECHNICAL COLLEGE   ,LA,71449-0790,Public       ,3,8,11,46,181,227
00997506,NORTHWEST LOUISIANA TECHNICAL COLLEGE   ,LA,71458-0657,Public       ,9,20,29,248,464,712
01005701,AMERICAN COMMERCIAL COLLEGE             ,LA,71105-2502,Proprietary  ,0,0,0,34,242,276
01109700,CLOYD'S BEAUTY SCHOOL #1                ,LA,71291-3131,Proprietary  ,2,5,7,71,230,301
01163100,"D-JAY'S SCHL OF BEAUTY, ARTS & SCI      ",LA,70806-0000,Proprietary  ,3,15,18,70,243,313
01184100,JOHN JAY BEAUTY COLLEGE                 ,LA,70124-2592,Proprietary  ,2,6,8,128,323,451
01282300,PAT GOINS RUSTON BEAUTY SCHOOL          ,LA,71270-4301,Proprietary  ,0,2,2,43,73,116
01287900,PAT GOINS BENTON ROAD BEAUTY SCHOOL     ,LA,71111-4838,Proprietary  ,1,7,8,44,101,145
01288000,PAT GOINS BEAUTY SCHOOL                 ,LA,71201-5167,Proprietary  ,2,7,9,30,101,131
02055400,BOSSIER PARISH COMMUNITY COLLEGE        ,LA,71111-0000,Public       ,95,222,317,4023,7005,11028
02055500,DELTA SCH OF BUSINESS & TECHNOLOGY      ,LA,70601-0000,Proprietary  ,4,7,11,144,552,696
02117800,AVEDA INSTITUTE LAFAYETTE               ,LA,70503-3246,Proprietary  ,5,10,15,169,258,427
02166100,NUNEZ COMMUNITY COLLEGE                 ,LA,70043-0000,Public       ,21,76,97,890,2238,3128
02166200,ITI TECHNICAL COLLEGE                   ,LA,70817-0000,Proprietary  ,19,62,81,641,1158,1799
02197500,BATON ROUGE SCHOOL OF COMPUTERS         ,LA,70809-8188,Proprietary  ,5,10,15,93,193,286
02214800,ACADIANA TECHNICAL COLLEGE              ,LA,70506-4109,Public       ,17,35,52,815,1510,2325
02214802,ACADIANA TECHNICAL COLLEGE - ACADIAN    ,LA,70526-4109,Public       ,2,10,12,140,303,443
02214803,ACADIANA TECHNICAL COLLEGE - C.B. COREIL,LA,70586-0000,Public       ,2,7,9,141,227,368
02214804,ACADIANA TECHNICAL COLLEGE - EVANGELINE ,LA,70582-0000,Public       ,1,2,3,95,255,350
02214805,ACADIANA TECHNICAL COLLEGE - GULF AREA  ,LA,70510-0000,Public       ,15,18,33,202,391,593
02214806,ACADIANA TECHNICAL COLLEGE - T.H. HARRIS,LA,70570-0000,Public       ,3,24,27,404,725,1129
02214807,ACADIANA TECHNICAL COLLEGE - TECHE AREA ,LA,70562-0000,Public       ,5,12,17,265,503,768
02234000,CAMERON COLLEGE                         ,LA,70119-0000,Proprietary  ,4,21,25,142,540,682
02258400,AVEDA INSTITUTE BATON ROUGE             ,LA,70816-2246,Proprietary  ,13,14,27,271,459,730
02260200,DIESEL DRIVING ACADEMY                  ,LA,71109-5617,Proprietary  ,10,44,54,89,633,722
02265600,JOHN JAY KENNER ACADEMY                 ,LA,70062-0000,Proprietary  ,1,5,6,48,140,188
02269300,STEVENSON'S ACADEMY OF HAIR DESIGN      ,LA,70116-0000,Proprietary  ,4,8,12,120,324,444
02327800,PINEVILLE BEAUTY SCHOOL                 ,LA,71360-0000,Proprietary  ,2,9,11,77,121,198
02335700,BATON ROUGE GENERAL MEDICAL CENTER      ,LA,70806-3889,Private      ,1,3,4,122,277,399
02335701,BATON ROUGE GEN MED CTR SCH NSG         ,LA,70821-0000,Private      ,1,5,6,105,382,487
02335702,BATON ROUGE GEN MED CTR-RAD TECH        ,LA,70806-0000,Private      ,2,4,6,83,202,285
02338000,"CLOYD'S BEAUTY SCHOOL #2, INC           ",LA,71202-3539,Proprietary  ,1,7,8,75,205,280
02352500,"CLOYD'S BEAUTY SCHOOL #3, INC           ",LA,71201-3211,Proprietary  ,2,6,8,70,215,285
02358600,"STAGE ONE THE HAIR SCHOOL, INC.         ",LA,70605-0000,Proprietary  ,4,14,18,99,227,326
02518300,SOUTH LOUISIANA BEAUTY COLLEGE          ,LA,70363-0000,Proprietary  ,0,4,4,28,120,148
02536400,LOUISIANA ACADEMY OF BEAUTY             ,LA,70535-0000,Proprietary  ,1,7,8,44,92,136
02538300,DELTA COLLEGE OF ARTS & TECH INC        ,LA,70806-1529,Proprietary  ,9,40,49,289,1047,1336
02538301,DELTA COLLEGE OF ARTS & TECHNOLOGY - LAF,LA,70508-6831,Proprietary  ,3,16,19,145,472,617
02548500,COSMETOLOGY TRAINING CENTER             ,LA,70503-0000,Proprietary  ,6,11,17,123,152,275
02554800,VANGUARD COLLEGE OF COSMETOLOGY         ,LA,70458-8823,Proprietary  ,12,21,33,238,313,551
02582200,"GUY'S ACADEMY HAIR, SKIN & NAILS        ",LA,71105-2404,Proprietary  ,2,10,12,78,282,360
02600900,AVEDA INSTITUTE                         ,LA,70433-2922,Proprietary  ,41,106,147,1305,2352,3657
02601000,AMERICAN SCHOOL OF BUSINESS             ,LA,71105-5646,Proprietary  ,1,15,16,53,241,294
02601100,OPELOUSAS SCHOOL OF COSMETOLOGY         ,LA,70570-6156,Proprietary  ,2,2,4,40,80,120
02606800,CAREER TRAINING SPECIALISTS             ,LA,71201-6046,Proprietary  ,17,46,63,377,1213,1590
02606801,CAREER TECHNICAL COLLEGE - SHREVEPORT   ,LA,71105-2405,Proprietary  ,5,24,29,271,998,1269
02617100,BATON ROUGE COLLEGE                     ,LA,70806-1725,Proprietary  ,6,11,17,213,396,609
02619200,DENHAM SPRINGS BEAUTY COLLEGE           ,LA,70726-3829,Proprietary  ,4,8,12,60,132,192
03010400,CRESCENT CITY SCH GAMING & BARTENDG     ,LA,70119-5507,Proprietary  ,9,132,141,154,1081,1235
03010624,VIRGINIA COLLEGE - BATON ROUGE          ,LA,70815-8604,Proprietary  ,4,17,21,179,672,851
03023500,CAMELOT CAREER COLLEGE                  ,LA,70805-7539,Proprietary  ,13,31,44,166,488,654
03030900,DIESEL DRIVING ACADEMY                  ,LA,70815-8109,Proprietary  ,5,60,65,105,770,875
03095100,GRETNA CAREER COLLEGE                   ,LA,70053-2436,Proprietary  ,0,0,0,70,256,326
03106200,OUR LADY OF THE LAKE COLLEGE            ,LA,70808-4345,Private      ,12,52,64,1218,2440,3658
03253300,JONESVILLE BEAUTY SCHOOL                ,LA,71343-0000,Proprietary  ,2,1,3,94,156,250
03294300,BLUE CLIFF SCH THERAPEUTIC MASSAGE      ,LA,70002-3458,Proprietary  ,23,93,116,455,1676,2131
03294303,BLUE CLIFF COLLEGE - LAFAYETTE          ,LA,70508-3256,Proprietary  ,22,70,92,389,1375,1764
03294306,BLUE CLIFF COLLEGE - SHREVEPORT         ,LA,71105-6520,Proprietary  ,11,75,86,336,1477,1813
03332600,DELTA COLLEGE                           ,LA,70433-9042,Proprietary  ,16,21,37,237,620,857
03332601,DELTA COLLEGE - SLIDELL                 ,LA,70460-2624,Proprietary  ,6,22,28,184,667,851
03356300,MEDICAL TRAINING COLLEGE                ,LA,70816-5820,Proprietary  ,7,18,25,218,583,801
03480300,MEDVANCE INSTITUTE                      ,LA,70809-1908,Proprietary  ,19,53,72,256,813,1069
03498400,OMEGA INSTITUTE OF COSMETOLOGY          ,LA,70360-0000,Proprietary  ,2,6,8,63,110,173
03727500,MOORE CAREER COLLEGE                    ,LA,70808-4191,Proprietary  ,0,8,8,26,94,120
03730300,BATON ROUGE COMMUNITY COLLEGE           ,LA,78806-4129,Public       ,104,194,298,6696,8193,14889
03752400,SCHOOL OF URBAN MISSIONS                ,LA,70053-0000,Private      ,0,1,1,185,334,519
03789300,UNITECH TRAINING ACADEMY                ,LA,70503-5132,Proprietary  ,28,88,116,214,669,883
03789301,UNITECH TRAINING ACADEMY - WEST MONROE  ,LA,71291-2913,Proprietary  ,8,50,58,103,540,643
03789302,UNITECH TRAINING ACADEMY - HOUMA        ,LA,70363-5556,Proprietary  ,17,40,57,85,290,375
03789303,UNITECH TRAINING ACADEMY -  ALEXANDRIA  ,LA,71303-3625,Proprietary  ,11,44,55,122,427,549
03789304,UNITECH TRAINING ACADEMY - LAKE CHARLES ,LA,70601-7887,Proprietary  ,15,40,55,156,465,621
03789400,RIVER PARISHES COMMUNITY COLLEGE        ,LA,70778-0310,Public       ,9,39,48,1108,1564,2672
03810500,COURT REPORTING INSTITUTE OF LOUISI     ,LA,70816-0000,Proprietary  ,0,2,2,15,144,159
03956300,SOUTH LOUISIANA COMMUNITY COLLEGE       ,LA,70506-0000,Public       ,66,110,176,2788,3028,5816
04040300,COMPASS CAREER COLLEGE                  ,LA,70403-0653,Proprietary  ,5,15,20,133,419,552
04112300,LOUISIANA CULINARY INSTITUTE            ,LA,70816-4109,Proprietary  ,5,16,21,326,447,773
04120700,ALDEN'S SCHOOL OF COSMETOLOGY           ,LA,70714-1502,Proprietary  ,0,0,0,17,51,68
04130100,LOUISIANA DELTA COMMUNITY COLLEGE       ,LA,71203-3618,Public       ,66,126,192,2023,3365,5388
04130101,LOUISIANA TECHNICAL COLG - TALLULAH     ,LA,71284-0000,Public       ,3,6,9,61,128,189
04149500,A & W HEALTHCARE EDUCATORS              ,LA,70122-3146,Proprietary  ,0,12,12,67,443,510
04151600,MY-LE'S BEAUTY COLLEGE                  ,LA,70056-3150,Proprietary  ,1,14,15,42,160,202
04217000,HEALTHCARE TRAINING INSTITUTE           ,LA,70062-7630,Proprietary  ,1,16,17,1,39,40
00143600,CAPITOL COLLEGE                         ,MD,20708-9759,Private      ,1,14,15,504,689,1193
00146200,WASHINGTON BIBLE COLLEGE                ,MD,20706-3599,Private      ,0,0,0,83,467,550
00205700,ALLEGANY COLLEGE OF MARYLAND            ,MD,21502-2596,Public       ,16,38,54,2834,2487,5321
00205800,ANNE ARUNDEL COMMUNITY COLLEGE          ,MD,21012-1895,Public       ,67,266,333,5958,11053,17011
00206100,BALTIMORE CITY COMMUNITY COLLEGE        ,MD,21215-7893,Public       ,44,228,272,4678,12474,17152
00206200,BOWIE STATE UNIVERSITY                  ,MD,20715-9465,Public       ,26,54,80,8313,6927,15240
00206300,COMMUNITY COLLEGE OF BALTIMORE COUNTY   ,MD,21228-5381,Public       ,109,435,544,11130,20996,32126
00206400,COLLEGE OF SOUTHERN MARYLAND            ,MD,20646-0910,Public       ,36,123,159,4133,6197,10330
00206500,NOTRE DAME OF MARYLAND UNIVERSITY       ,MD,21210-2476,Private      ,5,34,39,1237,2532,3769
00206700,WASHINGTON ADVENTIST UNIVERSITY         ,MD,20912-7796,Private      ,3,13,16,1093,1539,2632
00206800,COPPIN STATE UNIVERSITY                 ,MD,21216-3698,Public       ,15,73,88,5196,6743,11939
00207100,FREDERICK COMMUNITY COLLEGE             ,MD,21702-9745,Public       ,21,100,121,2501,3676,6177
00207200,FROSTBURG STATE UNIVERSITY              ,MD,21532-1099,Public       ,18,13,31,7128,2082,9210
00207300,GOUCHER COLLEGE                         ,MD,21204-2794,Private      ,4,13,17,3522,1257,4779
00207400,HAGERSTOWN COMMUNITY COLLEGE            ,MD,21742-6514,Public       ,22,122,144,2237,4099,6336
00207500,HARFORD COMMUNITY COLLEGE               ,MD,21015-1696,Public       ,20,88,108,2642,3780,6422
00207600,HOOD COLLEGE                            ,MD,21701-8575,Private      ,3,21,24,2672,1181,3853
00207700,JOHNS HOPKINS UNIVERSITY                ,MD,21218-2693,Private      ,7,35,42,10208,2840,13048
00207702,JOHNS HOPKINS UNIV SCH ARTS/SCI/ENG     ,MD,21218-0000,Private      ,3,69,72,4191,2624,6815
00207703,JOHNS HOPKINS UNIV SCH OF BUS/ED        ,MD,21046-0000,Private      ,1,16,17,122,1825,1947
00207705,JOHNS HOPKINS BLOOMBERG SCH OF PH       ,MD,21205-0000,Private      ,1,9,10,78,1834,1912
00207706,JOHNS HOPKINS UNIV SCH OF MEDICINE      ,MD,21205-0000,Private      ,2,10,12,403,1421,1824
00207707,JOHNS HOPKINS UNIV SCH OF NURSING       ,MD,21205-0000,Private      ,2,19,21,480,1821,2301
00207708,JOHNS HOPKINS UNIV PEABODY CONSERV      ,MD,21202-2397,Private      ,3,1,4,682,552,1234
00207800,LOYOLA UNIVERSITY MARYLAND              ,MD,21210-2699,Private      ,7,27,34,9797,3337,13134
00208000,MARYLAND INST COLLEGE OF ART            ,MD,21217-4191,Private      ,6,12,18,3331,1263,4594
00208300,MORGAN STATE UNIVERSITY                 ,MD,21251-0002,Public       ,33,51,84,12887,8855,21742
00208600,MOUNT SAINT MARY'S UNIVERSITY           ,MD,21727-7799,Private      ,3,14,17,3734,612,4346
00208700,NER ISRAEL RABBINICAL COLLEGE           ,MD,21208-1198,Private      ,9,10,19,111,68,179
00208900,PRINCE GEORGES COMMUNITY COLLEGE        ,MD,20774-2199,Public       ,72,293,365,8096,14774,22870
00209100,SALISBURY UNIVERSITY                    ,MD,21801-6862,Public       ,12,20,32,13072,2924,15996
00209200,ST JOHN'S COLLEGE                       ,MD,21404-0000,Private      ,0,10,10,670,244,914
00209500,ST. MARY'S COLLEGE OF MARYLAND          ,MD,20686-3001,Public       ,5,4,9,2782,380,3162
00209600,ST MARY'S SEMINARY & UNIV               ,MD,21210-1994,Private      ,2,1,3,36,115,151
00209900,TOWSON UNIVERSITY                       ,MD,21252-0002,Public       ,37,95,132,28000,10528,38528
00210200,UNIVERSITY OF BALTIMORE                 ,MD,21201-5779,Public       ,12,78,90,2390,8695,11085
00210300,"UNIVERSITY OF MARYLAND, COLLEGE PARK    ",MD,20742-5145,Public       ,63,172,235,35985,17112,53097
00210400,"UNIVERSITY OF MARYLAND, BALTIMORE       ",MD,21201-1691,Public       ,17,87,104,5043,13238,18281
00210500,UMBC                                    ,MD,21250-0002,Public       ,28,68,96,11952,7300,19252
00210600,UNIVERSITY MARYLAND EASTERN SHORE       ,MD,21853-4053,Public       ,16,29,45,6821,2908,9729
00210700,STEVENSON UNIVERSITY                    ,MD,21153-0641,Private      ,7,25,32,7214,2557,9771
00210800,WASHINGTON COLLEGE                      ,MD,21620-1197,Private      ,2,0,2,2978,160,3138
00210900,MCDANIEL COLLEGE                        ,MD,21157-4390,Private      ,2,17,19,3498,887,4385
00458612,KAPLAN COLLEGE                          ,MD,21742-2797,Proprietary  ,8,93,101,350,1913,2263
00458614,KAPLAN COLLEGE - FREDERICK              ,MD,21704-8307,Proprietary  ,1,14,15,75,500,575
00465000,CHESAPEAKE COLLEGE                      ,MD,21679-0008,Public       ,11,42,53,1497,2054,3551
00691100,MONTGOMERY COLLEGE                      ,MD,20850-1195,Public       ,96,247,343,12812,14331,27143
00734100,INTERNATIONAL BEAUTY SCHOOL             ,MD,21502-2370,Proprietary  ,7,41,48,88,566,654
00744700,DEL-MAR-VA BEAUTY ACADEMY               ,MD,21804-0000,Proprietary  ,1,2,3,84,219,303
00749100,TESST COLLEGE OF TECHNOLOGY             ,MD,21227-1063,Proprietary  ,28,128,156,517,1923,2440
00793600,LINCOLN TECHNICAL INSTITUTE             ,MD,21046-1544,Proprietary  ,118,88,206,811,1266,2077
00817500,HOWARD COMMUNITY COLLEGE                ,MD,21044-3197,Public       ,38,134,172,4289,5648,9937
00826300,AWARD BEAUTY SCHOOL                     ,MD,21740-5624,Proprietary  ,6,36,42,83,370,453
00830800,CECIL COLLEGE                           ,MD,21901-1999,Public       ,7,33,40,1365,1881,3246
00907906,EVEREST COLLEGE- EVEREST INSTITUTE      ,MD,20910-3737,Proprietary  ,17,56,73,350,1169,1519
01001400,GARRETT COMMUNITY COLLEGE               ,MD,21541-1265,Public       ,4,7,11,1110,511,1621
01031900,MEDIX SCHOOL                            ,MD,21204-2538,Proprietary  ,70,192,262,849,3502,4351
01041000,TESST COLLEGE OF TECHNOLOGY             ,MD,21286-2201,Proprietary  ,13,57,70,259,868,1127
01164400,UNIV OF MARYLAND UNIVERSITY COLLEGE     ,MD,20783-8078,Public       ,55,2655,2710,3611,49102,52713
01164402,U OF MD UNIVERSITY COLLEGE - EUROPE     ,MD,20832-0000,Public       ,2,38,40,403,1109,1512
01164404,U OF MD UNIVERSITY COLLEGE - ASIA       ,MD,31207-0000,Public       ,1,68,69,96,1230,1326
02073900,WOR-WIC COMMUNITY COLLEGE               ,MD,21804-0000,Public       ,17,88,105,1965,3716,5681
02083600,TESST COLLEGE OF TECHNOLOGY             ,MD,20705-2698,Proprietary  ,16,52,68,281,919,1200
02116005,SANFORD-BROWN INSTITUTE - LANDOVER      ,MD,20785-2287,Proprietary  ,0,3,3,146,753,899
02127900,SOJOURNER DOUGLASS COLLEGE              ,MD,21205-0000,Private      ,0,38,38,344,3873,4217
02155100,MARYLAND COLLEGE OF ART AND DESIGN      ,MD,20902-0000,Private      ,1,3,4,193,228,421
02269700,"COLORLAB ACADEMY OF HAIR, THE           ",MD,21014-3639,Proprietary  ,2,3,5,53,110,163
02314800,BALTIMORE INTERNATIONAL COLLEGE         ,MD,21202-0000,Private      ,0,0,0,73,126,199
02331000,MARYLAND BEAUTY ACADEMY OF ESSEX        ,MD,21221-0000,Proprietary  ,2,14,16,109,298,407
02333000,HAIR ACADEMY                            ,MD,20784-0000,Proprietary  ,14,49,63,239,628,867
02343800,MONTGOMERY BEAUTY SCHOOL                ,MD,20901-0000,Proprietary  ,5,20,25,113,349,462
02494700,BALTIMORE STUDIO OF HAIR DESIGN         ,MD,21201-0000,Proprietary  ,7,22,29,151,427,578
02495000,ROBERT PAUL ACAD COSMTGY ARTS & SCI     ,MD,21093-0000,Proprietary  ,1,4,5,80,107,187
02495100,MARYLAND BEAUTY ACADEMY                 ,MD,21136-0000,Proprietary  ,1,9,10,30,94,124
02545400,NORTH AMERICAN TRADE SCHOOLS            ,MD,21244-0069,Proprietary  ,23,99,122,292,1391,1683
02573800,"L' ACADEMIE DE CUISINE, INC.            ",MD,20877-0000,Proprietary  ,0,1,1,92,312,404
02578400,TAI SOPHIA INSTITUTE                    ,MD,20723-6010,Private      ,0,7,7,5,538,543
03027200,BLADES SCHOOL OF HAIR DESIGN            ,MD,20619-0226,Proprietary  ,3,21,24,40,172,212
03064900,AARON'S ACADEMY OF BEAUTY               ,MD,20602-2715,Proprietary  ,3,2,5,69,166,235
03097200,AESTHETICS INSTITUTE OF COSMETOLOGY     ,MD,20877-1305,Proprietary  ,1,5,6,35,164,199
03100700,CARROLL COMMUNITY COLLEGE               ,MD,21157-6913,Public       ,7,45,52,1487,1761,3248
03148300,AMERICAN BEAUTY ACADEMY                 ,MD,20902-1911,Proprietary  ,50,117,167,402,1075,1477
03296300,BALTIMORE SCHOOL OF MASSAGE             ,MD,21090-2261,Proprietary  ,16,72,88,189,767,956
03327300,NEW CREATIONS ACADEMY OF HAIR DSN       ,MD,20746-0000,Proprietary  ,4,15,19,56,227,283
03455500,NATIONAL LABOR COLLEGE                  ,MD,20903-1790,Private      ,1,23,24,18,510,528
03493300,ALL-STATE CAREER SCHOOL                 ,MD,21224-6658,Proprietary  ,55,242,297,690,3202,3892
03667300,FAITH THEOLOGICAL SEMINARY              ,MD,21212-2624,Private      ,1,6,7,2,32,34
03771300,AMERICAN CAREER INSTITUTE               ,MD,20902-4637,Proprietary  ,0,0,0,613,2654,3267
03822400,MAPLE SPRINGS BAPTIST BIBLE COLLEGE & SE,MD,20743-5711,Private      ,0,1,1,2,63,65
03937300,YESHIVA COLLEGE OF THE NATION'S CAPITAL ,MD,20902-1700,Private      ,1,0,1,16,37,53
03965500,HAIR EXPRESSIONS ACADEMY                ,MD,20852-1729,Proprietary  ,12,23,35,92,270,362
04139700,FREDERICK SCHOOL OF COSMETOLOGY         ,MD,21701-0000,Proprietary  ,0,5,5,58,78,136
04141600,OMEGA STUDIOS' SCHOOL OF APPLIED RECORDI,MD,20852-1731,Proprietary  ,3,4,7,85,190,275
04151800,TEMPLE (THE): A PAUL MITCHELL PARTNER SC,MD,21701-5409,Proprietary  ,3,10,13,156,196,352
04167602,FINGER LAKES SCHOOL OF MASSAGE (THE)    ,MD,21701-3030,Proprietary  ,1,5,6,1,5,6
04168900,HOLISTIC MASSAGE TRAINING INSTITUTE     ,MD,21218-2407,Proprietary  ,2,7,9,29,204,233
04188400,BAIS HAMEDRASH AND MESIVTA OF BALTIMORE ,MD,21209-1613,Private      ,3,2,5,45,25,70
04204000,ASPEN BEAUTY ACADEMY - LAUREL           ,MD,20724-2013,Proprietary  ,0,9,9,57,202,259
04209600,INSTITUTE OF HEALTH SCIENCES            ,MD,21031-1408,Proprietary  ,2,10,12,3,40,43
04211700,HARMON'S BEAUTY SCHOOL                  ,MD,20785-2135,Proprietary  ,1,6,7,4,20,24
00211400,AMERICAN INTERNATIONAL COLLEGE          ,MA,01109-3189,Private      ,1,30,31,2121,3530,5651
00211500,AMHERST COLLEGE                         ,MA,01002-5000,Private      ,4,0,4,5134,420,5554
00211600,ANDOVER NEWTON THEOLOGICAL SCHOOL       ,MA,02459-0000,Private      ,1,0,1,2,202,204
00211700,ANNA MARIA COLLEGE                      ,MA,01612-1198,Private      ,3,31,34,1787,796,2583
00211800,ASSUMPTION COLLEGE                      ,MA,01615-1294,Private      ,1,11,12,4937,955,5892
00212000,MERRIMACK COLLEGE                       ,MA,01845-5800,Private      ,4,6,10,5607,604,6211
00212100,BABSON COLLEGE                          ,MA,02457-0310,Private      ,1,11,12,2901,916,3817
00212200,BAY PATH COLLEGE                        ,MA,01106-2212,Private      ,2,23,25,1031,2615,3646
00212300,BECKER COLLEGE-WORCESTER                ,MA,01615-0071,Private      ,3,21,24,3173,1380,4553
00212400,BENTLEY UNIVERSITY                      ,MA,02452-4705,Private      ,3,12,15,6019,969,6988
00212600,BERKLEE COLLEGE OF MUSIC                ,MA,02215-3693,Private      ,13,18,31,5424,1683,7107
00212800,BOSTON COLLEGE                          ,MA,02467-3800,Private      ,17,22,39,21668,6971,28639
00212900,BOSTON CONSERVATORY OF MUSIC            ,MA,02215-9830,Private      ,0,2,2,1269,398,1667
00213000,BOSTON UNIVERSITY                       ,MA,02215-1789,Private      ,20,95,115,36654,20565,57219
00213300,BRANDEIS UNIVERSITY                     ,MA,02453-2700,Private      ,3,12,15,5691,1557,7248
00213900,CLARK UNIVERSITY                        ,MA,01610-1473,Private      ,0,10,10,3931,1006,4937
00214000,ELMS COLLEGE                            ,MA,01013-2839,Private      ,1,8,9,1279,1107,2386
00214100,COLLEGE OF THE HOLY CROSS               ,MA,01610-2395,Private      ,1,2,3,6144,199,6343
00214300,CURRY COLLEGE                           ,MA,02186-2395,Private      ,5,31,36,5453,1666,7119
00214400,DEAN COLLEGE                            ,MA,02038-1994,Private      ,5,0,5,1994,391,2385
00214500,EASTERN NAZARENE COLLEGE                ,MA,02170-2999,Private      ,4,12,16,1020,770,1790
00214507,EASTERN NAZARENE CLG - LEAD PROGRAM     ,MA,02170-0000,Private      ,0,5,5,67,1001,1068
00214600,EMERSON COLLEGE                         ,MA,02116-4624,Private      ,3,3,6,7617,1818,9435
00214700,EMMANUEL COLLEGE                        ,MA,02115-5798,Private      ,4,6,10,5916,693,6609
00214800,ENDICOTT COLLEGE                        ,MA,01915-2098,Private      ,1,17,18,4873,909,5782
00214900,EPISCOPAL DIVINITY SCHOOL               ,MA,02138-0000,Private      ,0,6,6,0,92,92
00215000,FISHER COLLEGE                          ,MA,02116-1500,Private      ,4,41,45,1715,1939,3654
00215100,BENJAMIN FRANKLIN INSTITUTE OF TECH     ,MA,02116-6296,Public       ,3,3,6,655,467,1122
00215300,GORDON COLLEGE                          ,MA,01984-1899,Private      ,1,5,6,2473,271,2744
00215400,HELLENIC COLLEGE                        ,MA,02445-7496,Private      ,0,1,1,92,136,228
00215500,HARVARD UNIVERSITY                      ,MA,02138-3800,Private      ,3,13,16,4776,1141,5917
00215501,AMRCN REPERTORY THTR INST ADV THTR      ,MA,02138-0000,Private      ,0,0,0,4,128,132
00215502,HARVARD BUSINESS SCHOOL                 ,MA,02163-0000,Private      ,3,9,12,259,1878,2137
00215503,HARVARD EXTENSION SCHOOL                ,MA,02138-0000,Private      ,1,31,32,185,1801,1986
00215504,HARVARD SCH OF DENTAL MEDICINE          ,MA,02115-0000,Private      ,0,0,0,32,219,251
00215505,HARVARD UNIV GRAD SCH DESIGN            ,MA,02138-0000,Private      ,0,2,2,8,1047,1055
00215506,HARVARD DIVINITY SCHOOL                 ,MA,02138-0000,Private      ,0,2,2,17,563,580
00215507,HARVARD UNIV GRAD SCH ED                ,MA,02138-0000,Private      ,0,4,4,16,1618,1634
00215508,HARVARD UNIV GRAD S OF ARTS & SCIEN     ,MA,02138-0000,Private      ,0,8,8,68,1074,1142
00215509,HARVARD KENNEDY SCHOOL                  ,MA,02138-0000,Private      ,0,3,3,9,1457,1466
00215510,HARVARD LAW SCHOOL                      ,MA,02138-0000,Private      ,0,4,4,155,3407,3562
00215511,HARVARD UNIV MEDICAL SCHOOL             ,MA,02115-0000,Private      ,1,1,2,238,1189,1427
00215512,HARVARD UNIV SCH PUBLIC HEALTH          ,MA,02115-0000,Private      ,0,3,3,49,994,1043
00215513,HARVARD UNIVERSITY-HARVARD COLLEGE      ,MA,02138-0000,Private      ,12,15,27,20199,1451,21650
00215700,HEBREW COLLEGE                          ,MA,02459-2237,Private      ,0,0,0,2,103,105
00215800,LASELL COLLEGE                          ,MA,02466-2716,Private      ,2,11,13,3487,568,4055
00216000,LESLEY UNIVERSITY                       ,MA,02138-2790,Private      ,8,139,147,3177,4608,7785
00216100,UMASS LOWELL                            ,MA,01854-3089,Public       ,23,116,139,14015,7475,21490
00216400,NEW ENGLAND COLLEGE OF OPTOMETRY        ,MA,02115-1129,Private      ,0,2,2,16,444,460
00216500,MASS. COLLEGE OF PHARMACY  & HEALTH SCIE,MA,02115-5804,Private      ,4,15,19,6087,4262,10349
00216700,BERKSHIRE COMMUNITY COLLEGE             ,MA,01201-5786,Public       ,3,5,8,1154,1802,2956
00216800,CAPE COD COMMUNITY COLLEGE              ,MA,02668-1599,Public       ,11,34,45,1934,2872,4806
00216900,GREENFIELD COMMUNITY COLLEGE            ,MA,01301-9739,Public       ,7,20,27,1059,1884,2943
00217000,HOLYOKE COMMUNITY COLLEGE               ,MA,01040-1099,Public       ,33,80,113,4347,5795,10142
00217100,MASSACHUSETTS BAY COMMUNITY COLLEGE     ,MA,02181-0000,Public       ,19,57,76,2656,3241,5897
00217200,MOUNT WACHUSETT COMMUNITY COLLEGE       ,MA,01440-1000,Public       ,18,86,104,2277,4089,6366
00217300,NORTH SHORE COMMUNITY COLLEGE           ,MA,01923-4093,Public       ,22,92,114,3927,5791,9718
00217400,NORTHERN ESSEX COMMUNITY COLLEGE        ,MA,01830-2399,Public       ,46,109,155,3650,5382,9032
00217500,QUINSIGAMOND COMMUNITY COLLEGE          ,MA,01606-2092,Public       ,36,126,162,4893,7050,11943
00217600,BRISTOL COMMUNITY COLLEGE               ,MA,02720-7399,Public       ,28,110,138,4860,6643,11503
00217700,MASSASOIT COMMUNITY COLLEGE             ,MA,02302-3996,Public       ,21,62,83,4108,5418,9526
00217800,MASSACHUSETTS INST OF TECHNOLOGY        ,MA,02139-4307,Private      ,15,36,51,12664,3893,16557
00218000,MASSACHUSETTS COLLEGE OF ART AND DESIGN ,MA,02115-5803,Public       ,2,5,7,2739,1116,3855
00218100,MASSACHUSETTS MARITIME ACADEMY          ,MA,02532-3400,Public       ,2,1,3,1519,187,1706
00218300,BRIDGEWATER STATE COLLEGE               ,MA,02325-0001,Public       ,19,31,50,12687,4476,17163
00218400,FITCHBURG STATE UNIVERSITY              ,MA,01420-2697,Public       ,5,26,31,6027,1978,8005
00218500,FRAMINGHAM STATE COLLEGE                ,MA,01702-2471,Public       ,10,18,28,7629,1980,9609
00218700,MASSACHUSETTS CLG OF LIBERAL ARTS       ,MA,01247-4100,Public       ,3,5,8,2425,683,3108
00218800,SALEM STATE UNIVERSITY                  ,MA,01970-5353,Public       ,113,77,190,9800,4860,14660
00218900,WESTFIELD STATE COLLEGE                 ,MA,01086-1630,Public       ,9,18,27,8437,2231,10668
00219000,WORCESTER STATE COLLEGE                 ,MA,01602-2597,Public       ,9,32,41,6903,3017,9920
00219200,MOUNT HOLYOKE COLLEGE                   ,MA,01075-1492,Private      ,3,1,4,2991,376,3367
00219300,MOUNT IDA COLLEGE                       ,MA,02459-3323,Private      ,8,3,11,2184,482,2666
00219400,NEW ENGLAND CONSERVATORY OF MUSIC       ,MA,02115-5018,Private      ,0,1,1,803,642,1445
00219700,NICHOLS COLLEGE                         ,MA,01571-6346,Private      ,1,4,5,2124,485,2609
00219900,NORTHEASTERN UNIVERSITY                 ,MA,02115-5000,Private      ,36,169,205,35945,14315,50260
00220100,PINE MANOR COLLEGE                      ,MA,02167-0000,Private      ,1,2,3,379,163,542
00220200,BLESSED JOHN XXIII NATIONAL SEMINARY    ,MA,02493-0000,Private      ,0,0,0,0,6,6
00220500,QUINCY COLLEGE                          ,MA,02169-4501,Public       ,11,75,86,1913,4413,6326
00220600,REGIS COLLEGE                           ,MA,02193-0000,Private      ,2,9,11,2181,1089,3270
00220800,SIMMONS COLLEGE                         ,MA,02115-5898,Private      ,3,14,17,3730,4173,7903
00220900,SMITH COLLEGE                           ,MA,01063-2936,Private      ,0,0,0,3719,517,4236
00220901,"SMITH COLLEGE, SCH FOR SOCIAL WORK      ",MA,01063-0000,Private      ,0,2,2,17,593,610
00221000,UNIV OF MASSACHUSETTS-DARTMOUTH         ,MA,02747-2300,Public       ,11,23,34,13440,4341,17781
00221100,SPRINGFIELD COLLEGE                     ,MA,01109-3797,Private      ,2,119,121,4279,5066,9345
00221400,ST JOHN'S SEMINARY                      ,MA,02135-8839,Private      ,1,5,6,17,68,85
00221700,STONEHILL COLLEGE                       ,MA,02357-6110,Private      ,1,0,1,6224,203,6427
00221800,SUFFOLK UNIVERSITY                      ,MA,02108-2770,Private      ,12,16,28,10011,5710,15721
00221900,TUFTS UNIVERSITY                        ,MA,02155-5808,Private      ,2,12,14,10767,2803,13570
00221901,TUFTS UNIV SCH OF DENTAL MEDICINE       ,MA,02111-0000,Private      ,0,0,0,43,1012,1055
00221902,TUFTS UNIVERSITY - CUMMINGS SCHOOL OF VE,MA,01536-0000,Private      ,0,0,0,34,540,574
00221904,TUFTS UNIV SCHOOL OF MEDICINE           ,MA,02111-0000,Private      ,0,2,2,113,2069,2182
00222100,UNIV OF MASSACHUSETTS-AMHERST           ,MA,01003-0000,Public       ,24,51,75,41394,9163,50557
00222200,UNIV OF MASSACHUSETTS-BOSTON            ,MA,02125-3393,Public       ,31,150,181,14071,13675,27746
00222400,WELLESLEY COLLEGE                       ,MA,02481-8203,Private      ,1,1,2,3714,282,3996
00222500,WENTWORTH INSTITUTE OF TECHNOLOGY       ,MA,02115-5998,Private      ,4,10,14,5942,1110,7052
00222600,WESTERN NEW ENGLAND UNIVERSITY          ,MA,01119-2654,Private      ,1,12,13,6450,2103,8553
00222700,WHEATON COLLEGE                         ,MA,02766-2322,Private      ,2,1,3,2940,144,3084
00222800,WHEELOCK COLLEGE                        ,MA,02215-4176,Private      ,0,8,8,1796,986,2782
00222900,WILLIAMS COLLEGE                        ,MA,01267-2600,Private      ,2,1,3,4482,161,4643
00223300,WORCESTER POLYTECHNIC INSTITUTE         ,MA,01609-2280,Private      ,3,9,12,7403,770,8173
00267104,BARD COLLEGE - LONGY SCHOOL OF MUSIC    ,MA,02138-3599,Private      ,0,0,0,44,173,217
00396500,BAY STATE COLLEGE                       ,MA,02116-2901,Proprietary  ,6,25,31,1657,1572,3229
00396600,BOSTON ARCHITECTURAL COLLEGE            ,MA,02115-2795,Private      ,3,1,4,431,1032,1463
00466100,HAMPSHIRE COLLEGE                       ,MA,01002-3359,Private      ,2,0,2,2926,253,3179
00466600,SALTER COLLEGE                          ,MA,01583-1700,Proprietary  ,39,235,274,584,3029,3613
00466700,SCHOOL OF MUSEUM OF FINE ARTS           ,MA,02115-5534,Private      ,1,0,1,800,374,1174
00466900,UPPER CAPE COD REGIONAL VOC TECH        ,MA,02532-3310,Public       ,1,4,5,29,168,197
00527900,GREATER LOWELL REGNL VOC TECH SCH       ,MA,01879-0000,Public       ,1,2,3,33,125,158
00551900,DIMAN REGIONAL VOC TECH INST            ,MA,02723-3519,Public       ,0,0,0,40,194,234
00552300,BLUE HILLS REGIONAL VOC TECH            ,MA,02021-1398,Public       ,0,0,0,42,174,216
00555700,MCCANN TECHNICAL SCHOOL                 ,MA,01247-0000,Public       ,0,0,0,23,100,123
00613600,NATIONAL AVIATION ACADEMY - NEW ENGLAND ,MA,01730-2620,Proprietary  ,5,10,15,168,372,540
00632200,BROCKTON HOSPITAL SCH OF NURSING        ,MA,02302-0000,Private      ,0,3,3,157,691,848
00632400,LABOURE COLLEGE                         ,MA,02124-5698,Private      ,0,17,17,194,1051,1245
00633100,LAWRENCE MEM HOSPITAL SCH OF NRSNG      ,MA,02155-1643,Private      ,0,3,3,75,480,555
00635200,BAYSTATE MEDICAL CENTER                 ,MA,01199-0001,Private      ,0,1,1,39,150,189
00687300,MARIAN COURT COLLEGE                    ,MA,01907-2896,Private      ,0,4,4,138,114,252
00748100,GIBBS COLLEGE                           ,MA,02116-2904,Proprietary  ,0,0,0,100,337,437
00748400,NEWBURY COLLEGE                         ,MA,02445-5796,Private      ,4,0,4,2796,431,3227
00748600,THE NEW ENGLAND INSTITUTE OF ART        ,MA,02445-7295,Proprietary  ,11,13,24,1561,720,2281
00748800,KAPLAN CAREER INSTITUTE                 ,MA,02129-1644,Proprietary  ,2,3,5,110,442,552
00748801,KAPLAN CAREER INSTITUTE -               ,MA,02215-2606,Proprietary  ,0,1,1,77,315,392
00807800,SPRINGFIELD TECHNICAL COMMUNITY CLG     ,MA,01105-0000,Public       ,8,43,51,3946,6793,10739
00809002,EVEREST COLLEGE - EVEREST INSTITUTE     ,MA,02150-2333,Proprietary  ,14,35,49,198,611,809
00891600,NEW ENGLAND SCHOOL OF LAW               ,MA,02116-0000,Private      ,0,4,4,29,2287,2316
00964500,BARD COLLEGE AT SIMON'S ROCK            ,MA,01230-9702,Private      ,3,1,4,437,34,471
00974700,GORDON-CONWELL THEOLOGICAL SEMINARY     ,MA,01982-0000,Private      ,0,5,5,11,574,585
00975600,UNIVERSITY OF MASS MEDICAL CENTER       ,MA,01655-0000,Public       ,0,4,4,65,1021,1086
00987700,HENRI'S SCHOOL OF HAIR DESIGN           ,MA,01420-5675,Proprietary  ,0,4,4,27,60,87
00989900,LOWELL ACADEMY HAIRSTYLING INST         ,MA,01852-1909,Proprietary  ,0,13,13,49,113,162
00993600,MIDDLESEX COMMUNITY COLLEGE             ,MA,01730-1197,Public       ,24,50,74,2129,2212,4341
00993602,"MIDDLESEX COMMUNITY COLLEGE, LOWELL     ",MA,01852-0000,Public       ,37,84,121,3296,3841,7137
01121000,BUNKER HILL COMMUNITY COLLEGE           ,MA,02129-2991,Public       ,24,91,115,7127,12463,19590
01151000,EVEREST INSTITUTE                       ,MA,02135-7638,Proprietary  ,12,29,41,154,544,698
01193000,ROXBURY COMMUNITY COLLEGE               ,MA,02120-3400,Public       ,8,57,65,1330,3883,5213
01204200,MANSFIELD BEAUTY SCHOOLS                ,MA,02169-5061,Proprietary  ,3,7,10,48,103,151
01206800,MANSFIELD BEAUTY SCHOOL                 ,MA,01103-1410,Proprietary  ,1,7,8,25,76,101
01218700,BLACKSTONE VALLEY VOCATIONAL REGIONAL SC,MA,01568-1499,Public       ,0,0,0,4,29,33
01238600,SOUTHEASTERN TECHNICAL INSTITUTE        ,MA,02375-1780,Public       ,0,3,3,64,221,285
01288100,MONTACHUSETT REG VOC TECH SCH           ,MA,01420-4649,Public       ,1,1,2,23,125,148
01292100,EMPIRE BEAUTY SCHOOL                    ,MA,02215-0000,Proprietary  ,8,25,33,269,523,792
01294800,ROB ROY ACADEMY                         ,MA,02721-5330,Proprietary  ,2,9,11,55,140,195
02063000,MONTSERRAT COLLEGE OF ART               ,MA,01915-0000,Private      ,0,0,0,697,89,786
02076700,EMPIRE BEAUTY SCHOOL                    ,MA,02148-0000,Proprietary  ,4,11,15,96,210,306
02079400,EMPIRE BEAUTY SCHOOL                    ,MA,01702-5232,Proprietary  ,14,48,62,192,460,652
02092100,MASSACHUSETTS SCHOOL OF BARBERING       ,MA,02169-5058,Proprietary  ,2,12,14,41,197,238
02092200,EMPIRE BEAUTY SCHOOL                    ,MA,01852-0000,Proprietary  ,9,16,25,135,299,434
02122000,NEW ENGLAND HAIR ACADEMY                ,MA,02148-0000,Proprietary  ,6,15,21,97,195,292
02137000,ROB ROY ACADEMY                         ,MA,02780-0000,Proprietary  ,1,2,3,18,57,75
02137200,MASS GEN HOSP DIETETIC INTERNSHIP       ,MA,02114-0000,Private      ,0,2,2,6,44,50
02163500,NEW ENGLAND SCHOOL OF PHOTOGRAPHY       ,MA,02215-0000,Proprietary  ,0,4,4,133,164,297
02163600,MASS SCH OF PROFESSIONAL PSYCHOLOGY     ,MA,02132-0000,Private      ,1,3,4,33,921,954
02169900,ASSABET VALLEY REGIONAL VOC SCHOOL      ,MA,01752-0000,Public       ,0,1,1,24,128,152
02181600,ROB ROY ACADEMY                         ,MA,01609-0000,Proprietary  ,10,9,19,120,228,348
02182900,CAMBRIDGE COLLEGE                       ,MA,02138-5304,Private      ,3,175,178,433,4282,4715
02197900,NORTH BENNET STREET SCHOOL              ,MA,02113-0000,Private      ,0,0,0,53,210,263
02215100,HALLMARK INSTITUTE OF PHOTOGRAPHY       ,MA,01376-0000,Proprietary  ,7,7,14,186,198,384
02219501,MILDRED ELLEY - PITTSFIELD              ,MA,01201-5300,Proprietary  ,0,1,1,18,84,102
02220400,CATHERINE HINDS INST OF ESTHETICS       ,MA,01801-0000,Proprietary  ,1,7,8,78,282,360
02231600,MGH INSTITUTE OF HEALTH PROFESSION      ,MA,02129-0000,Private      ,3,16,19,109,1726,1835
02274300,CONWAY SCHOOL OF LANDSCAPE DESIGN       ,MA,01341-0179,Private      ,0,0,0,2,20,22
02325700,LABARON HAIRDRESSING ACADEMY            ,MA,02740-0000,Proprietary  ,0,4,4,20,80,100
02325800,LABARON HAIRDRESSING ACAD-BROCKTON      ,MA,02301-0000,Proprietary  ,1,4,5,26,81,107
02337400,BANCROFT SCHOOL OF MASSAGE THERAPY      ,MA,01604-4614,Proprietary  ,0,0,0,24,101,125
02338200,BAY STATE SCHOOL OF TECHNOLOGY          ,MA,02021-0000,Proprietary  ,2,21,23,64,345,409
02339400,ROB ROY ACADEMY                         ,MA,02746-0000,Proprietary  ,1,2,3,12,50,62
02491700,CORTIVA INSTITUTE -  BOSTON             ,MA,02472-2577,Proprietary  ,4,4,8,32,132,164
02523900,ELIZABETH GRADY SCHOOL OF ESTHETICS     ,MA,02155-0000,Proprietary  ,3,14,17,49,197,246
02579800,NEW ENGLAND SCHOOL OF ACUPUNCTURE       ,MA,02458-0000,Private      ,0,2,2,0,172,172
02616704,LE CORDON BLEU COLLEGE OF CULINARY ARTS ,MA,02142-1221,Proprietary  ,2,7,9,253,541,794
03066700,AILANO SCHOOL OF COSMETOLOGY            ,MA,02303-4740,Proprietary  ,0,5,5,38,79,117
03104000,SHAWSHEEN ADULT TECHNICAL INSTITUTE     ,MA,01821-5499,Public       ,1,1,2,15,100,115
03115200,MOTORING TECHNICAL TRAINING INST        ,MA,02771-5933,Proprietary  ,1,1,2,174,341,515
03120800,KAY HARVEY HAIRDRESSING ACADEMY         ,MA,01089-2701,Proprietary  ,1,4,5,28,70,98
03130500,URBAN COLLEGE OF BOSTON                 ,MA,02111-1093,Private      ,2,67,69,95,920,1015
03194300,BOSTON GRAD SCH OF PSYCHOANALYSIS       ,MA,02446-4602,Private      ,0,2,2,2,100,102
03205400,JOLIE HAIR & BEAUTY ACADEMY             ,MA,01056-2769,Proprietary  ,3,6,9,47,198,245
03232302,LINCOLN TECHNICAL INSTITUTE - BROCKTON C,MA,02401-1818,Proprietary  ,6,30,36,133,383,516
03232310,LINCOLN TECHNICAL INSTITUTE - LOWELL    ,MA,01852-5119,Proprietary  ,19,51,70,200,522,722
03232311,LINCOLN TECHNICAL INSTITUTE - SOMERVILLE,MA,02145-1102,Proprietary  ,21,35,56,167,427,594
03235300,MASSACHUSETTS SCHOOL OF LAW             ,MA,01810-1094,Private      ,0,2,2,10,679,689
03240300,TONI & GUY HAIRDRESSING ACADEMY         ,MA,01605-2213,Proprietary  ,3,6,9,90,96,186
03248300,BOSTON BAPTIST COLLEGE                  ,MA,02136-4000,Private      ,1,2,3,116,82,198
03316400,FUNERAL INSTITUTE OF THE NORTHEAST      ,MA,02062-4766,Proprietary  ,1,1,2,52,118,170
03504300,NATL GRAD SCH OF QUALITY SYSTM MGMT     ,MA,02540-0000,Private      ,0,5,5,2,83,85
03570500,NORTHPOINT BIBLE COLLEGE                ,MA,01835-0000,Private      ,0,3,3,210,168,378
03763300,MEDICAL PROFESSIONAL INSTITUTE          ,MA,02148-8143,Proprietary  ,4,13,17,69,392,461
03859300,E.I.N.E.                                ,MA,01876-4709,Proprietary  ,0,2,2,11,68,79
03927303,BRIO ACADEMY OF COSMETOLOGY - NORTHHAMPT,MA,01060-3947,Proprietary  ,11,5,16,55,79,134
03946300,FRANKLIN W. OLIN COLLEGE OF ENGINEERING ,MA,02492-1200,Private      ,1,1,2,581,27,608
03965300,NEW ENGLAND COLLEGE OF FINANCE          ,MA,02110-1605,Proprietary  ,0,22,22,81,989,1070
04039300,SULLIVAN AND COGLIANO TRAINING CENTER   ,MA,02301-4921,Proprietary  ,14,240,254,96,1731,1827
04116900,DIGRIGOLI SCHOOL OF COSMETOLOGY         ,MA,01089-4623,Proprietary  ,1,2,3,61,99,160
04122000,TRI COUNTY REGIONAL VOCATIONAL TECHNICAL,MA,02038-0000,Public       ,0,0,0,15,89,104
04128000,MILLENNIUM TRAINING INSTITUTE           ,MA,01801-6386,Proprietary  ,0,23,23,8,218,226
04128900,CENTRAL MASS SCHOOL OF MASSAGE AND THERA,MA,01562-1712,Proprietary  ,0,1,1,11,27,38
04143200,HULT INTERNATIONAL BUSINESS SCHOOL      ,MA,02141-1805,Private      ,0,3,3,18,330,348
04153200,SOUTHERN WORCESTER COUNTY REGIONAL VOC S,MA,01507-1331,Public       ,0,0,0,13,47,60
04193100,ALEXANDER ACADEMY                       ,MA,01420-0000,Proprietary  ,1,4,5,30,94,124
00324204,CARNEGIE MELLON UNIVERSITY - QATAR      ,FC,00000-0000,Private      ,0,0,0,13,6,19
00401200,HEBREW UNIVERSITY OF JERUSALEM (THE)    ,FC,00000-0000,Public       ,0,1,1,37,119,156
00403000,UNIVERSITY OF CAMBRIDGE                 ,FC,00000-0000,Public       ,0,0,0,10,111,121
00503400,AMERICAN UNIVERSITY OF CAIRO            ,FC,00000-0000,Private      ,0,0,0,81,199,280
00667100,KATHOLIEKE UNIVERSITEIT LEUVEN          ,FC,00000-0000,Private      ,0,1,1,3,43,46
00669100,UNIVERSITY OF CAMBRIDGE - PEMBROKE      ,FC,00000-0000,Public       ,0,0,0,3,10,13
00669200,UNIVERSITY OF LEEDS                     ,FC,00000-0000,Public       ,0,0,0,20,91,111
00669300,UNIV OF LONDON-LONDON SCHOOL ECON       ,FC,00000-0000,Public       ,0,0,0,21,428,449
00669400,UNIVERSITY OF LONDON - SCHOOL OF ORIENTA,FC,00000-0000,Public       ,0,0,0,15,186,201
00669500,UNIV OF LONDON-UNIVERSITY COLLEGE       ,FC,00000-0000,Public       ,0,1,1,57,435,492
00669600,UNIV OF LONDON-SCH ADVANCED STUDY       ,FC,00000-0000,Public       ,0,0,0,1,21,22
00669700,"QUEEN MARY, UNIVERSITY OF LONDON        ",FC,00000-0000,Public       ,0,0,0,31,160,191
00669900,UNIVERSITY OF SUSSEX                    ,FC,00000-0000,Public       ,1,2,3,33,99,132
00670000,"UNIVERSITY OF YORK, THE                 ",FC,00000-0000,Public       ,0,1,1,23,147,170
00670400,UNIVERSITY COLLEGE CORK                 ,FC,00000-0000,Public       ,0,0,0,18,74,92
00671300,UPPSALA UNIVERSITY                      ,FC,00000-0000,Public       ,0,0,0,5,39,44
00671500,UNIVERSITY OF GENEVA                    ,FC,00000-0000,Public       ,0,2,2,3,109,112
00683900,UNIVERSITY OF EDINBURGH                 ,FC,00000-0000,Public       ,3,4,7,232,753,985
00683903,UNIVERSITY OF EDINBURGH - EDINBURGH COLL,FC,00000-0000,Public       ,0,0,0,4,27,31
00684200,UNIVERSITY OF DUBLIN TRINITY COLLEG     ,FC,00000-0000,Public       ,0,3,3,61,205,266
00685000,UNIVERSITY OF CAMBRIDGE - DOWNING C     ,FC,00000-0000,Public       ,0,0,0,0,5,5
00763200,UNIVERSITY OF BRISTOL                   ,FC,00000-0000,Public       ,0,0,0,14,105,119
00768100,COLLEGE OF EUROPE                       ,FC,00000-0000,Private      ,0,0,0,1,10,11
00770500,ROYAL COLLEGE OF SURGEONS IN IRELAN     ,FC,00000-0000,Private      ,0,1,1,9,70,79
00788100,AMERICAN UNIVERSITY OF PARIS            ,FC,00000-0000,Private      ,0,3,3,535,312,847
00837100,AMERICAN UNIVERSITY OF BEIRUT           ,FC,00000-0000,Private      ,2,1,3,93,127,220
00837300,TEL-AVIV UNIVERSITY                     ,FC,00000-0000,Public       ,0,1,1,33,165,198
00837600,VRIJE UNIVERSITEIT AMSTERDAM            ,FC,00000-0000,Public       ,0,0,0,5,44,49
00837700,UNIVERSITEIT VAN AMSTERDAM(UNIVERSI     ,FC,00000-0000,Public       ,0,0,0,20,125,145
00838000,UNIVERSITY OF WARWICK                   ,FC,00000-0000,Public       ,0,0,0,9,74,83
00838300,UNIVERSITY OF GLASGOW                   ,FC,00000-0000,Public       ,0,0,0,59,372,431
00839300,UNIVERSITY OF OSLO                      ,FC,00000-0000,Public       ,0,0,0,6,34,40
00839400,UNIVERSITY OF OXFORD                    ,FC,00000-0000,Public       ,0,2,2,30,412,442
00839800,UNIVERSITY OF SHEFFIELD (THE)           ,FC,00000-0000,Public       ,0,0,0,8,114,122
00839900,UNIVERSITY OF SOUTHAMPTON               ,FC,00000-0000,Public       ,0,0,0,14,80,94
00845200,ABERYSTWYTH UNIVERSITY                  ,FC,00000-0000,Public       ,0,0,0,24,53,77
00845800,LOUGHBOROUGH UNIVERSITY                 ,FC,00000-0000,Public       ,0,0,0,3,9,12
00846000,UNIVERSITY OF NEWCASTLE UPON TYNE       ,FC,00000-0000,Public       ,0,0,0,20,141,161
00846100,UNIVERSITY OF SAINT ANDREWS             ,FC,00000-0000,Private      ,1,0,1,341,221,562
00850500,UNIVERSITY OF MELBOURNE                 ,FC,00000-0000,Public       ,1,2,3,21,226,247
00858600,SWANSEA UNIVERSITY                      ,FC,00000-0000,Public       ,0,0,0,7,42,49
00858700,UNIVERSITY OF DURHAM                    ,FC,00000-0000,Public       ,0,2,2,42,239,281
00866500,UNIVERSITY OF KENT AT CANTERBURY (THE)  ,FC,00000-0000,Public       ,0,0,0,22,132,154
00867000,UNIVERSITY OF NEW SOUTH WALES           ,FC,00000-0000,Public       ,0,1,1,20,118,138
00868700,UNIVERSITY OF ESSEX                     ,FC,00000-0000,Public       ,0,1,1,21,132,153
00869300,CITY UNIVERSITY                         ,FC,00000-0000,Public       ,0,1,1,35,199,234
00890800,THE UNIVERSITY OF BIRMINGHAM            ,FC,00000-0000,Public       ,0,2,2,17,114,131
00891000,UNIVERSITY OF HULL                      ,FC,00000-0000,Public       ,0,0,0,7,14,21
00892000,UNIVERSITY OF NOTTINGHAM                ,FC,00000-0000,Public       ,0,2,2,24,102,126
00900600,UNIVERSITY OF SALFORD (THE)             ,FC,00000-0000,Public       ,0,0,0,2,25,27
00908400,"UNIV OF LONDON, BIRKBECK                ",FC,00000-0000,Public       ,0,0,0,7,119,126
00908500,UNIV OF LONDON KING'S COLLEGE           ,FC,00000-0000,Public       ,0,1,1,53,427,480
00908600,UNIVERSITY OF LONDON - ROYAL HOLLOWAY   ,FC,00000-0000,Public       ,0,0,0,32,87,119
00914300,BAR-ILAN UNIVERSITY                     ,FC,00000-0000,Private      ,0,1,1,23,23,46
00924900,UNIVERSITY OF LIVERPOOL                 ,FC,00000-0000,Public       ,0,2,2,26,128,154
00936800,UNIVERSITY OF ABERDEEN                  ,FC,00000-0000,Public       ,0,0,0,44,143,187
00942300,ROYAL COLLEGE OF ART                    ,FC,00000-0000,Public       ,0,0,0,12,56,68
00942800,TECHNION-ISRAEL INST OF TECHLGY         ,FC,00000-0000,Public       ,0,1,1,6,61,67
00944200,UNIVERSITY OF EXETER                    ,FC,00000-0000,Public       ,0,0,0,13,116,129
00944400,UNIVERSITY OF LANCASTER                 ,FC,00000-0000,Public       ,0,2,2,10,64,74
00963400,UNIVERSITY OF OXFORD ST CATHERINE'S     ,FC,00000-0000,Public       ,0,0,0,3,9,12
00980800,UNIVERSITY OF STRATHCLYDE               ,FC,00000-0000,Public       ,0,1,1,8,56,64
00986000,UNIVERSITY OF SURREY                    ,FC,00000-0000,Public       ,0,0,0,10,29,39
00990600,PONTIFICAL NORTH AMERICAN COLLEGE       ,FC,00000-0000,Private      ,0,0,0,2,7,9
00992700,UNIVERSITY OF CAMBRIDGE - FITZWILLI     ,FC,00000-0000,Public       ,0,1,1,0,11,11
01006700,LUND UNIVERSITY                         ,FC,00000-0000,Public       ,0,1,1,5,91,96
01008400,UNIVERSITY OF CAPE TOWN                 ,FC,00000-0000,Public       ,0,0,0,16,88,104
01008700,UNIVERSITY OF OXFORD ST PETER'S COL     ,FC,00000-0000,Public       ,0,0,0,2,8,10
01008800,UNIVERSITY OF OXFORD - CORPUS CHRIS     ,FC,00000-0000,Public       ,0,0,0,0,4,4
01008900,CENTRAL SCHOOL OF SPEECH AND DRAMA      ,FC,00000-0000,Private      ,0,0,0,17,50,67
01009000,UNIVERSITY OF OXFORD - BALLIOL COLL     ,FC,00000-0000,Public       ,0,0,0,2,12,14
01014300,UNIVERSITY OF READING                   ,FC,00000-0000,Public       ,0,0,0,10,49,59
01015700,CARDIFF UNIVERSITY                      ,FC,00000-0000,Public       ,0,1,1,12,77,89
01015900,PONTIFICIA UNIVERSITA GREGORIANA        ,FC,00000-0000,Private      ,0,0,0,1,6,7
01016000,CG JUNG INST                            ,FC,00000-0000,Private      ,0,0,0,0,6,6
01018800,UNIVERSITY COLLEGE DUBLIN               ,FC,00000-0000,Public       ,0,3,3,44,245,289
01019000,UNIVERSITY OF CAMBRIDGE CHURCHILL C     ,FC,00000-0000,Public       ,0,0,0,2,14,16
01022800,UNIVERSITY OF STIRLING                  ,FC,00000-0000,Public       ,0,0,0,20,72,92
01033200,UNIVERSITY OF CAMBRIDGE - CLARE COL     ,FC,00000-0000,Public       ,0,0,0,1,9,10
01045600,UNIVERSITY OF HAIFA                     ,FC,00000-0000,Public       ,1,0,1,10,30,40
01047200,INST EUROPEEN OPEEN D'ADMINISTRATIO     ,FC,00000-0000,Private      ,0,0,0,1,68,69
01049300,CRANFIELD UNIVERSITY                    ,FC,00000-0000,Public       ,0,0,0,1,17,18
01052000,TRINITY LABAN CONSERVATOIRE OF MUSIC AND,FC,00000-0000,Public       ,0,0,0,8,13,21
01052500,UNIVERSITY OF HERTFORDSHIRE             ,FC,00000-0000,Public       ,0,1,1,14,29,43
01057400,LONDON INTRNTL FILM SCHOOL              ,FC,00000-0000,Private      ,0,1,1,2,38,40
01058800,AUSTRALIAN NATIONAL UNIVERSITY          ,FC,00000-0000,Public       ,0,0,0,16,58,74
01058900,BANGOR UNIVERSITY                       ,FC,00000-0000,Public       ,0,0,0,11,23,34
01059400,"RICHMOND, THE AMERICAN INT UNI IN LONDON",FC,00000-0000,Private      ,1,0,1,313,86,399
01059900,INST D'ETUDES POLITIQUES DE PARIS       ,FC,00000-0000,Public       ,0,0,0,11,129,140
01068100,MACQUARIE UNIVERSITY                    ,FC,00000-0000,Public       ,0,0,0,10,60,70
01069200,UNIVERSITY OF QUEENSLAND (THE)          ,FC,00000-0000,Public       ,0,2,2,18,369,387
01078900,UNIVERSITY OF OXFORD - WORCESTER CO     ,FC,00000-0000,Public       ,0,0,0,1,4,5
01079200,CITY AND GUILDS OF LONDON INSTITUTE     ,FC,00000-0000,Private      ,0,0,0,4,7,11
01079700,"NATIONAL UNIVERSITY OF IRELAND, MAY     ",FC,00000-0000,Public       ,0,0,0,14,16,30
01081600,KINGSTON UNIVERSITY                     ,FC,00000-0000,Public       ,1,0,1,52,221,273
01083800,UNIVERSITITY OF BERGEN (UOB)            ,FC,00000-0000,Public       ,0,0,0,2,12,14
01086400,UNIV OF DUNDEE                          ,FC,00000-0000,Public       ,0,0,0,8,37,45
01086600,UNIVERSITY OF OXFORD - MAGDALEN COLLEGE ,FC,00000-0000,Public       ,0,0,0,1,13,14
01086700,UNIVERSITY OF OXFORD ST JOHN'S COLL     ,FC,00000-0000,Public       ,0,0,0,3,6,9
01091400,MONASH UNIVERSITY                       ,FC,00000-0000,Public       ,0,1,1,10,52,62
01091500,UNIV OF EAST ANGLIA                     ,FC,00000-0000,Public       ,0,0,0,29,98,127
01094200,UNIVERSITY OF OXFORD - ST HUGH'S CO     ,FC,00000-0000,Public       ,0,0,0,1,9,10
01097700,UNIVERSIDAD CENTRAL DEL ESTE            ,FC,00000-0000,Private      ,4,11,15,124,942,1066
01098000,SOMERVILLE COLLEGE                      ,FC,00000-0000,Public       ,0,0,0,2,5,7
01099900,UNIV OF OXFORD - WADHAM COLLEGE         ,FC,00000-0000,Public       ,0,0,0,3,4,7
01104400,PONTIFICIA UNIVERSITA SAN TOMMASO       ,FC,00000-0000,Private      ,0,0,0,1,11,12
01105300,UNIVERSITY OF OXFORD - ST HILDA'S C     ,FC,00000-0000,Public       ,0,0,0,2,9,11
01105400,UNIVERSITY OF OXFORD - ST ANNE'S CO     ,FC,00000-0000,Public       ,0,0,0,1,6,7
01105500,UNIV OF OXFORD - LADY MARGARET HALL     ,FC,00000-0000,Public       ,0,0,0,2,5,7
01105600,UNIVERSITY OF OXFORD - UNIVERSITY C     ,FC,00000-0000,Public       ,0,0,0,4,47,51
01105700,UNIVERSITY OF OXFORD - TRINITY COLL     ,FC,00000-0000,Public       ,0,0,0,1,10,11
01105800,UNIVERSITY OF OXFORD-ST EDMUND HALL     ,FC,00000-0000,Public       ,0,0,0,2,11,13
01105900,UNIVERSITY OF OXFORD ST ANTONY'S CO     ,FC,00000-0000,Public       ,0,1,1,0,32,32
01106000,UNIVERSITY OF OXFORD - QUEEN'S COLL     ,FC,00000-0000,Public       ,0,0,0,2,7,9
01106100,UNIVERSITY OF OXFORD - PEMBROKE COL     ,FC,00000-0000,Public       ,1,0,1,2,9,11
01106200,UNIVERSITY OF OXFORD - ORIEL COLLEG     ,FC,00000-0000,Public       ,0,0,0,0,10,10
01106300,UNIVERSITY OF OXFORD - NUFFIELD COL     ,FC,00000-0000,Public       ,0,0,0,0,4,4
01106400,UNIVERSITY OF OXFORD - NEW COLLEGE      ,FC,00000-0000,Public       ,0,0,0,2,11,13
01106500,UNIVERSITY OF OXFORD MERTON COLLEGE     ,FC,00000-0000,Public       ,0,0,0,1,11,12
01106600,UNIVERSITY OF OXFORD - LINCOLN COLL     ,FC,00000-0000,Public       ,0,0,0,2,12,14
01106700,UNIVERSITY OF OXFORD - KEBLE COLLEG     ,FC,00000-0000,Public       ,0,0,0,1,4,5
01106800,UNIVERSITY OF OXFORD - JESUS COLLEG     ,FC,00000-0000,Public       ,0,0,0,1,5,6
01106900,UNIVERSITY OF OXFORD - HERTFORD COL     ,FC,00000-0000,Public       ,0,0,0,0,7,7
01107000,UNIVERSITY OF OXFORD EXETER COLLEGE     ,FC,00000-0000,Public       ,0,0,0,0,10,10
01107100,UNIV OF OXFORD - CHRIST CHURCH          ,FC,00000-0000,Public       ,0,0,0,4,20,24
01107200,UNIVERSITY OF OXFORD - BRASENOSE CO     ,FC,00000-0000,Public       ,0,0,0,0,10,10
01109100,FLINDERS UNIVERSITY OF S AUSTRALIA      ,FC,00000-0000,Public       ,0,0,0,7,27,34
01109400,UNIVERSITY OF WESTERN AUSTRALIA (THE)   ,FC,00000-0000,Public       ,0,0,0,4,37,41
01121400,UNIVERSITY OF THE WITWATERSRAND         ,FC,00000-0000,Public       ,0,0,0,2,3,5
01122600,AARHUS UNIVERSITY                       ,FC,00000-0000,Public       ,0,1,1,4,28,32
01156700,"IMPERIAL COLLEGE OF SCIENCE, TECHNOLOGY ",FC,00000-0000,Public       ,0,0,0,19,87,106
01167900,UNIVERSITY OF BATH                      ,FC,00000-0000,Public       ,0,1,1,10,43,53
01168300,FRANKLIN COLLEGE  SWITZERLAND           ,FC,00000-0000,Private      ,0,0,0,382,24,406
01175800,UNIV OF CAMBRIDGE - PETERHOUSE          ,FC,00000-0000,Public       ,0,0,0,2,5,7
01176400,ROYAL ACADEMY OF MUSIC                  ,FC,00000-0000,Public       ,0,0,0,6,25,31
01176500,GOLDSMITHS' COLLEGE-UNIV OF LONDON      ,FC,00000-0000,Public       ,1,1,2,31,187,218
01176600,UNIV OF LONDON - INST OF EDUC           ,FC,00000-0000,Public       ,0,0,0,2,38,40
01178000,BRUNEL UNIVERSITY                       ,FC,00000-0000,Public       ,0,0,0,12,38,50
01183800,UNIVERSITY OF OXFORD - MANSFIELD CO     ,FC,00000-0000,Public       ,0,0,0,0,6,6
01207500,UNIVERSITY CAMBRIDGE - TRINITY COLL     ,FC,00000-0000,Public       ,0,0,0,1,13,14
01207800,VICTORIA UNIV OF WELLINGTON             ,FC,00000-0000,Public       ,0,2,2,15,56,71
01209600,ECOLE HÔTELIERE DE LAUSANNE             ,FC,00000-0000,Private      ,0,0,0,2,16,18
01210100,UNIVERSITY OF CAMBRIDGE - GIRTON CO     ,FC,00000-0000,Public       ,0,0,0,1,3,4
01213600,VICTORIA UNIV OF MANCHESTER (THE)       ,FC,00000-0000,Public       ,0,1,1,24,177,201
01219800,UNIVERSITY OF BRADFORD                  ,FC,00000-0000,Public       ,0,1,1,2,34,36
01220100,UNIVERSITY OF OXFORD - REGENT'S PAR     ,FC,00000-0000,Public       ,0,0,0,0,7,7
01220600,JAMES COOK UNIVERSITY                   ,FC,00000-0000,Public       ,0,0,0,26,84,110
01221500,BIRMINGHAM CITY UNIVERSITY              ,FC,00000-0000,Public       ,0,0,0,6,28,34
01222300,JAGIELLONIAN UNIVERSITY COLLEGIUM M     ,FC,00000-0000,Public       ,0,0,0,3,44,47
01222500,UNIVERSITY OF SZEGED FACULTY OF MEDICINE,FC,00000-0000,Public       ,0,0,0,2,10,12
01225800,ASTON UNIVERSITY                        ,FC,00000-0000,Public       ,0,1,1,5,22,27
01227500,UNIVERSITY OF OXFORD - WOLFSON COLL     ,FC,00000-0000,Public       ,0,0,0,0,21,21
01230200,GONVILLE & CAIUS COLLEGE                ,FC,00000-0000,Public       ,0,0,0,1,6,7
01233300,UNIVERSITY OF THE ARTS LONDON IDO - CAMB,FC,00000-0000,Public       ,0,0,0,18,15,33
01233500,ROYAL COLLEGE OF MUSIC                  ,FC,00000-0000,Public       ,0,0,0,8,15,23
01234100,UNIVERSITY OF WALES - ST DAVID'S UN     ,FC,00000-0000,Public       ,0,0,0,5,11,16
01242100,UNIV OF AUCKLAND                        ,FC,00000-0000,Public       ,0,0,0,28,103,131
01253900,UNIVERSITY OF THE ARTS LONDON IDO - CENT,FC,00000-0000,Public       ,0,0,0,53,55,108
01254000,UNIVERSIDAD DE NAVARRA                  ,FC,00000-0000,Private      ,0,1,1,14,25,39
01276500,UNIVERSITY OF OXFORD - LINACRE COLL     ,FC,00000-0000,Public       ,0,0,0,0,14,14
01276600,"NATIONAL UNIVERSITY IRELAND, GALWAY     ",FC,00000-0000,Public       ,0,0,0,32,97,129
01280200,PONTIFICIA UNIV CATOLICA MAD Y MAES     ,FC,00000-0000,Private      ,11,3,14,221,189,410
01281100,INST TECNOLOGICO DE SANTO DOMINGO       ,FC,00000-0000,Private      ,0,1,1,58,103,161
01283900,UNIVERSITY OF CAMBRIDGE - SAINT JOH     ,FC,00000-0000,Public       ,0,0,0,1,12,13
01297800,UNIVERSITY OF HUDDERSFIELD (THE)        ,FC,00000-0000,Public       ,0,0,0,4,19,23
01315300,MASSEY UNIVERSITY                       ,FC,00000-0000,Public       ,0,0,0,15,97,112
01322500,COLLEGE OF LAW                          ,FC,00000-0000,Private      ,0,0,0,0,26,26
02052400,DARWIN COLLEGE                          ,FC,00000-0000,Public       ,0,0,0,0,10,10
02082400,UNIVERSITY OF CAMBRIDGE - QUEEN'S C     ,FC,00000-0000,Public       ,0,0,0,3,19,22
02083400,UNIVERSITY OF CAMBRIDGE - WOLFSON C     ,FC,00000-0000,Public       ,0,0,0,0,18,18
02087400,UNIVERSITY OF CAMBRIDGE - NEWNHAM C     ,FC,00000-0000,Public       ,0,0,0,1,6,7
02087900,OXFORD BROOKES UNIVERSITY               ,FC,00000-0000,Public       ,0,0,0,19,83,102
02094100,BEN-GURION UNIV                         ,FC,00000-0000,Public       ,0,2,2,6,145,151
02094400,UNIV OF CAMBRIDGE - ST EDMUND'S HOU     ,FC,00000-0000,Public       ,0,0,0,1,15,16
02095500,LONDON BUS SCHOOL                       ,FC,00000-0000,Private      ,0,0,0,4,154,158
02101900,ROEHAMPTON UNIVERSITY                   ,FC,00000-0000,Public       ,0,1,1,14,101,115
02108600,LONDON ACADEMY OF MUSIC & DRAMATIC      ,FC,00000-0000,Private      ,0,1,1,22,24,46
02115900,UNIVERSITY OF PORTSMOUTH                ,FC,00000-0000,Public       ,0,0,0,10,22,32
02116700,UNIVERSITY OF CAMBRIDGE - LUCY CAVE     ,FC,00000-0000,Public       ,0,0,0,1,7,8
02120000,UNIV OF LONDON - COURTALD INST OF A     ,FC,00000-0000,Public       ,0,0,0,2,34,36
02133400,UNIVERSITY OF CAMBRIDGE - SIDNEY SU     ,FC,00000-0000,Public       ,0,0,0,0,10,10
02142000,UNIVERSITY OF CAMBRIDGE - HOMERTON      ,FC,00000-0000,Public       ,0,0,0,1,5,6
02149700,UNIVERSITY OF WINCHESTER (THE)          ,FC,00000-0000,Public       ,1,0,1,12,12,24
02156800,UNIV OF OTAGO                           ,FC,00000-0000,Public       ,0,0,0,10,38,48
02162300,"IESE BUSINESS SCH, UNIV OF NAVARRA      ",FC,00000-0000,Private      ,0,1,1,3,90,93
02167400,UNIVERSITY OF CAMBRIDGE - CORPUS CH     ,FC,00000-0000,Public       ,0,0,0,0,7,7
02177700,KING'S COLLEGE- UNIV OF CAMBRIDGE       ,FC,00000-0000,Public       ,0,0,0,5,29,34
02180500,MIDDLESEX UNIVERSITY                    ,FC,00000-0000,Public       ,0,0,0,33,113,146
02181000,UNIVERSITY OF SOUTH AUSTRALIA           ,FC,00000-0000,Public       ,0,0,0,1,5,6
02183500,UNIV OF OXFORD - WYCLIFFE HALL          ,FC,00000-0000,Public       ,0,0,0,1,13,14
02186000,UNIVERSITY OF CAMBRIDGE - MAGDALENE     ,FC,00000-0000,Public       ,0,0,0,0,6,6
02186100,UNIVERSITY OF CAMBRIDGE - EMMANUEL      ,FC,00000-0000,Public       ,0,0,0,1,7,8
02189600,UNIVERSITY OF GRONINGEN                 ,FC,00000-0000,Public       ,0,0,0,8,32,40
02194800,UNIVERSITY OF THE WEST OF ENGLAND -     ,FC,00000-0000,Public       ,0,0,0,11,22,33
02195100,UNIV OF WESTMINSTER                     ,FC,00000-0000,Public       ,0,0,0,39,131,170
02196700,GUILDHALL SCHOOL OF MUSIC & DRAMA       ,FC,00000-0000,Public       ,0,0,0,8,12,20
02207300,UNIVERSITY OF CAMBRIDGE - CHRIST'S      ,FC,00000-0000,Public       ,0,0,0,0,6,6
02207400,CHINESE UNIVERSITY OF HONG KONG (THE)   ,FC,00000-0000,Public       ,0,0,0,21,55,76
02209500,UNIVERSITEIT UTRECHT                    ,FC,00000-0000,Public       ,0,1,1,11,61,72
02210000,UNIV OF LONDON - LONDON SCHOOL OF H     ,FC,00000-0000,Public       ,0,0,0,1,91,92
02212300,UNIVERSITY OF CAMBRIDGE - ROBINSON      ,FC,00000-0000,Public       ,0,0,0,0,3,3
02225300,UNIV OF CANTERBURY                      ,FC,00000-0000,Public       ,0,0,0,6,29,35
02229100,UNIVERSITY OF LEICESTER                 ,FC,00000-0000,Public       ,0,0,0,8,107,115
02229600,SACKLER SCHOOL OF MEDICINE              ,FC,00000-0000,Public       ,0,1,1,0,175,175
02232100,UNIVERSITY OF CAMBRIDGE                 ,FC,00000-0000,Public       ,0,0,0,8,50,58
02233300,"ST GEORGE'S UNIVERSITY, SCHOOL OF MEDICI",FC,00000-0000,Proprietary  ,0,12,12,27,3681,3708
02235300,LONDON METROPOLITAN UNIVERSITY          ,FC,00000-0000,Public       ,0,0,0,32,137,169
02244400,AMERICAN UNIV OF THE CARIBBEAN          ,FC,00000-0000,Proprietary  ,0,30,30,15,1666,1681
02266600,UNIVERSITY OF LONDON - SAINT GEORGE     ,FC,00000-0000,Public       ,0,0,0,4,20,24
02271700,UNIVERSITY OF CAMBRIDGE - CLARE HAL     ,FC,00000-0000,Public       ,0,0,0,0,6,6
02271900,UNIVERSITY OF OXFORD - BLACKFRIARS      ,FC,00000-0000,Public       ,0,0,0,0,10,10
02272200,UNIV OF CAMBRIDGE - NEW HALL            ,FC,00000-0000,Public       ,0,0,0,1,4,5
02273600,QUEEN'S UNIV OF BELFAST (THE)           ,FC,00000-0000,Public       ,0,0,0,16,87,103
02273900,HERIOT WATT UNIVERSITY                  ,FC,00000-0000,Public       ,1,0,1,4,45,49
02276700,NYENRODE BUSINESS UNIVERSITEIT          ,FC,00000-0000,Private      ,0,0,0,0,5,5
02293400,ECOLE DES HAUTES ETUDES COMERCIALS      ,FC,00000-0000,Public       ,0,0,0,1,33,34
02296300,UNIVERSITY OF CAMBRIDGE - JESUS COL     ,FC,00000-0000,Public       ,0,0,0,1,3,4
02310500,DE MONTFORT UNIVERSITY                  ,FC,00000-0000,Public       ,0,1,1,1,15,16
02320500,ROYAL NORTHERN COLLEGE OF MUSIC         ,FC,00000-0000,Public       ,0,0,0,3,8,11
02335100,UNIV OF CAMBRIDGE - TRINITY HALL        ,FC,00000-0000,Public       ,1,0,1,1,16,17
02338900,UNIVERSITY  FOR THE CREATIVE ARTS       ,FC,00000-0000,Public       ,0,0,0,5,13,18
02351800,UNIVERSIDAD IBEROAMERICANA (UNIBE       ,FC,00000-0000,Private      ,2,5,7,117,712,829
02352100,UNIVERSITY OF PLYMOUTH                  ,FC,00000-0000,Public       ,0,0,0,9,23,32
02355200,ECOLE SUPERIEURE DE CUISINE FRANCAISE-FE,FC,00000-0000,Public       ,0,1,1,6,22,28
02493000,ESCUELA SUPERIOR ADMINISTRACION Y D     ,FC,00000-0000,Private      ,0,1,1,3,49,52
02496700,NATIONAL FILM & TV SCHOOL               ,FC,00000-0000,Public       ,0,0,0,1,5,6
02502600,PECSI ORVOSTUDOMANYI EGYETEM (PECS      ,FC,00000-0000,Public       ,0,0,0,0,19,19
02545700,GLASGOW SCHOOL OF ART                   ,FC,00000-0000,Public       ,0,0,0,13,31,44
02561600,SOUTHAMPTON SOLENT UNIVERSITY           ,FC,00000-0000,Public       ,0,0,0,6,10,16
02579600,MURDOCH UNIVERSITY                      ,FC,00000-0000,Public       ,0,0,0,10,47,57
02588000,UNIVERSITY OF ULSTER                    ,FC,00000-0000,Public       ,0,1,1,7,23,30
02591800,CURTIN UNIVERSITY OF TECHNOLOGY         ,FC,00000-0000,Public       ,0,0,0,4,19,23
02611600,ECOL NATIONAL DES PONTS ET CHAUSSEE     ,FC,00000-0000,Public       ,0,0,0,0,11,11
02611700,DUBLIN CITY UNIVERSITY                  ,FC,00000-0000,Public       ,0,1,1,12,28,40
02623200,UNIVERSITY OF NEWCASTLE (THE)           ,FC,00000-0000,Public       ,0,1,1,8,28,36
03012700,UNIVERSITY OF BUCKINGHAM                ,FC,00000-0000,Private      ,0,0,0,7,17,24
03029400,KEELE UNIVERSITY                        ,FC,00000-0000,Public       ,0,1,1,10,8,18
03029500,NORTHUMBRIA UNIVERSITY                  ,FC,00000-0000,Public       ,0,0,0,11,29,40
03029800,NORGES HANDELSHOYSKOLE                  ,FC,00000-0000,Public       ,0,0,0,1,5,6
03033300,MANCHESTER METROPOLITAN UNIV            ,FC,00000-0000,Public       ,0,0,0,21,53,74
03045000,UNIVERSITY OF EAST LONDON               ,FC,00000-0000,Public       ,0,0,0,25,70,95
03050100,STUDIO ART CENTERS INTERNATIONAL        ,FC,00000-0000,Private      ,0,0,0,25,61,86
03061000,CHALMERS TEKNISKA HOGSKOLA AB           ,FC,00000-0000,Private      ,0,0,0,0,7,7
03066800,PONTIFICIO ATENEO DELLA SANTA CROCE     ,FC,00000-0000,Private      ,0,0,0,0,10,10
03067200,UNIVERSITY OF SYDNEY                    ,FC,00000-0000,Public       ,0,4,4,49,302,351
03073800,UNIV OF DEBRECEN MED & HEALTH SCI       ,FC,00000-0000,Public       ,0,0,0,3,27,30
03080300,SHEFFIELD HALLAM UNIVERSITY             ,FC,00000-0000,Public       ,0,0,0,4,14,18
03084300,UNIVERSITY OF LIMERICK                  ,FC,00000-0000,Public       ,0,0,0,24,37,61
03088700,ROYAL SCOTTISH ACAD MUSIC & DRAMA       ,FC,00000-0000,Public       ,0,0,0,22,25,47
03091400,UNIVERSITY OF WOLLONGONG                ,FC,00000-0000,Public       ,0,0,0,7,18,25
03091500,UNIVERSITY OF CANBERRA                  ,FC,00000-0000,Public       ,0,0,0,4,15,19
03091700,POZNAN UNIVERSITY OF MEDICAL SCIENCES   ,FC,00000-0000,Public       ,0,2,2,5,103,108
03092500,NOTTINGHAM TRENT UNIVERSITY             ,FC,00000-0000,Public       ,0,0,0,2,19,21
03095000,RMIT UNIVERSITY                         ,FC,00000-0000,Public       ,1,0,1,15,44,59
03095400,BOND UNIVERSITY                         ,FC,00000-0000,Private      ,0,1,1,26,83,109
03095900,ESSEC BUSINESS SCHOOL                   ,FC,00000-0000,Private      ,0,0,0,0,19,19
03096100,LA TROBE UNIVERSITY                     ,FC,00000-0000,Public       ,0,0,0,5,34,39
03096900,DEAKIN UNIVERSITY                       ,FC,00000-0000,Public       ,0,1,1,3,15,18
03097100,UNIVERSITY OF WESTERN SYDNEY            ,FC,00000-0000,Public       ,0,0,0,3,9,12
03097300,VICTORIA UNIVERSITY OF TECHNOLOGY       ,FC,00000-0000,Public       ,0,1,1,4,13,17
03097500,CENTRAL QUEENSLAND UNIVERSITY           ,FC,00000-0000,Public       ,0,0,0,3,14,17
03100000,UNIVERSITY OF ADELAIDE (THE)            ,FC,00000-0000,Public       ,0,0,0,7,19,26
03101600,ASIAN INSTITUTE OF MANAGEMENT           ,FC,00000-0000,Private      ,1,0,1,4,10,14
03102500,AMERICAN UNIVERSITY OF ROME             ,FC,00000-0000,Private      ,1,1,2,178,75,253
03102800,ROBERT GORDON UNIVERSITY (THE)          ,FC,00000-0000,Public       ,0,0,0,0,27,27
03104800,GRIFFITH UNIVERSITY                     ,FC,00000-0000,Public       ,0,0,0,15,56,71
03136300,AUSTRALIAN CATHOLIC UNIVERSITY          ,FC,00000-0000,Public       ,0,0,0,4,18,22
03140300,EDITH COWAN UNIVERSITY                  ,FC,00000-0000,Public       ,0,1,1,2,20,22
03140400,NORTHERN TERRITORY UNIVERSITY           ,FC,00000-0000,Public       ,0,0,0,1,3,4
03140500,QUEENSLAND UNIVERSITY OF TECHNOLOGY     ,FC,00000-0000,Public       ,0,0,0,6,28,34
03140600,SOUTHERN CROSS UNIVERSITY               ,FC,00000-0000,Public       ,0,0,0,1,15,16
03140700,SWINBURNE UNIVERSITY OF TECHNOLOGY      ,FC,00000-0000,Public       ,1,1,2,5,12,17
03140900,UNIVERSITY OF BALLARAT                  ,FC,00000-0000,Public       ,0,0,0,0,1,1
03150400,"UNIVERSITY OF TECHNOLOGY, SYDNEY        ",FC,00000-0000,Public       ,0,1,1,11,51,62
03287300,LIVERPOOL INSTITUTE FOR PERFORMING ARTS ,FC,00000-0000,Public       ,0,0,0,21,1,22
03300300,"2ND SCHOOL OF MEDICINE, CHARLES UNI     ",FC,00000-0000,Public       ,0,0,0,3,22,25
03300400,"FIRST FACULTY OF MEDICINE, CHARLES UNIV.",FC,00000-0000,Public       ,0,0,0,4,37,41
03329300,JOHN CABOT UNIVERSITY                   ,FC,00000-0000,Private      ,0,0,0,181,57,238
03333300,MEDICAL UNIVERSITY SCHOOL OF LUBLIN     ,FC,00000-0000,Public       ,0,7,7,22,227,249
03334300,UNIVERSIDAD NORDESTANA                  ,FC,00000-0000,Private      ,0,0,0,30,365,395
03335300,MEDICAL UNIVERSITY OF SILESIA           ,FC,00000-0000,Public       ,0,0,0,5,49,54
03342300,GLASGOW CALEDONIAN UNIVERSITY           ,FC,00000-0000,Public       ,0,0,0,6,21,27
03349400,"QUEEN MARGARET UNIVERSITY, EDINBURGH    ",FC,00000-0000,Public       ,0,0,0,7,35,42
03350300,BOURNEMOUTH UNIVERSITY                  ,FC,00000-0000,Public       ,0,0,0,7,17,24
03352300,LONDON SOUTH BANK UNIVERSITY            ,FC,00000-0000,Private      ,0,0,0,13,30,43
03363300,THE ARTS EDUCATIONAL SCHOOLS LONDON     ,FC,00000-0000,Private      ,0,0,0,2,4,6
03364300,"FACULTY OF MEDICINE, PALACKY UNIVER     ",FC,00000-0000,Public       ,0,0,0,0,6,6
03365400,AUCKLAND INSTITUTE OF TECHNOLOGY        ,FC,00000-0000,Public       ,0,0,0,7,22,29
03366300,TROPICAL AGRICULTURE RESEARCH AND H     ,FC,00000-0000,Private      ,0,0,0,0,2,2
03378300,"THE 3RD FACULTY OF MEDICINE, CHARLE     ",FC,00000-0000,Public       ,0,0,0,1,11,12
03406300,"THE SCHOOL OF PHARMACY, UNIVERSITY      ",FC,00000-0000,Public       ,0,0,0,0,2,2
03418400,NAPIER UNIVERSITY                       ,FC,00000-0000,Public       ,0,0,0,9,57,66
03435300,ANGLIA  RUSKIN UNIVERSITY               ,FC,00000-0000,Private      ,0,1,1,11,26,37
03460300,INTERNATIONALES THEOLOGISCHES INSTI     ,FC,00000-0000,Private      ,0,0,0,1,15,16
03462400,UNIV OF ARTS LONDON - LON COLL OF COMMUN,FC,00000-0000,Public       ,0,0,0,23,28,51
03466300,INSTITUTO CENTROAMERICANO DE ADMINI     ,FC,00000-0000,Private      ,0,0,0,2,5,7
03473300,UNIV OF ARTS LONDON - LON COLL FASHION  ,FC,00000-0000,Public       ,1,0,1,94,114,208
03473305,UNIVERSITY OF THE ARTS LONDON - CHELSEA ,FC,00000-0000,Public       ,0,0,0,26,24,50
03473311,UNIVERSITY OF THE ARTS LONDON - WIMBLEDO,FC,00000-0000,Public       ,0,0,0,16,12,28
03478300,ROYAL WELSH COLLEGE OF MUSIC AND DRAMA  ,FC,00000-0000,Public       ,0,0,0,11,18,29
03492300,UNIVERSITY OF OXFORD - GREEN TEMPLETON C,FC,00000-0000,Public       ,0,0,0,0,20,20
03492400,UNIV OF CAMBRIDGE-ST CATHERINE'S CG     ,FC,00000-0000,Public       ,0,0,0,0,6,6
03494400,UNIV OF CAMBRIDGE-SELWYN COLLEGE        ,FC,00000-0000,Public       ,0,0,0,0,3,3
03494600,UNIV OF OXFORD-HARRIS MANCHESTER        ,FC,00000-0000,Public       ,0,0,0,4,12,16
03501400,LEEDS METROPOLITAN UNIVERSITY           ,FC,00000-0000,Public       ,0,0,0,7,35,42
03507300,UNIVERSITY OF SUNDERLAND                ,FC,00000-0000,Public       ,0,1,1,4,14,18
03515300,UNIVERSITY OF CENTRAL LANCASHIRE        ,FC,00000-0000,Public       ,0,1,1,9,17,26
03517300,UNIVERSITY OF BRIGHTON                  ,FC,00000-0000,Public       ,0,1,1,15,21,36
03518300,EUROPEAN GRADUATE SCHOOL                ,FC,00000-0000,Private      ,0,22,22,0,148,148
03526300,INST CENTROAMERICANO DE ADM DE EMP      ,FC,00000-0000,Private      ,0,0,0,1,1,2
03527300,SOFIA UNIVERSITY ST. KLIMENT OHRIDSKI   ,FC,00000-0000,Public       ,0,0,0,2,8,10
03533300,BATH SPA UNIVERSITY                     ,FC,00000-0000,Public       ,0,0,0,11,13,24
03547300,UNIVERSITY OF GLAMORGAN                 ,FC,00000-0000,Public       ,0,0,0,5,16,21
03580300,LIVERPOOL JOHN MOORES UNIVERSITY        ,FC,00000-0000,Public       ,0,0,0,2,15,17
03589400,ARTS INSTITUTE AT BOURNEMOUTH (THE)     ,FC,00000-0000,Public       ,0,0,0,14,14,28
03590300,AVONDALE COLLEGE LIMITED                ,FC,00000-0000,Private      ,0,0,0,10,2,12
03594300,GROUP ESC GRENOBLE GRAD SCH OF BUS.     ,FC,00000-0000,Private      ,0,0,0,2,42,44
03597300,JAGIELLONIAN UNIVERSITY                 ,FC,00000-0000,Public       ,0,1,1,3,36,39
03601300,UNIVERSITAT JAUME I DE CASTELLO/UJI     ,FC,00000-0000,Public       ,0,0,0,1,17,18
03619300,UNIVERSITY OF GREENWICH                 ,FC,00000-0000,Public       ,0,1,1,16,63,79
03653400,UNIVERSIDAD DE IBEROAMERICA - UNIBE     ,FC,00000-0000,Private      ,0,0,0,9,34,43
03674300,UNIVERSITY OF ABERTAY DUNDEE            ,FC,00000-0000,Public       ,0,0,0,1,10,11
03684400,UNIVERSITY OF LINCOLN                   ,FC,00000-0000,Public       ,0,0,0,6,29,35
03684500,MEDICAL UNIVERSITY OF GDANSK            ,FC,00000-0000,Public       ,0,0,0,8,27,35
03694300,UNIVERSITY OF CHICHESTER                ,FC,00000-0000,Public       ,0,0,0,1,0,1
03716300,"UNIVERSITY OF WALES, NEWPORT            ",FC,00000-0000,Public       ,0,0,0,1,10,11
03727400,UNIVERSITY OF WAIKATO (THE)             ,FC,00000-0000,Public       ,0,0,0,6,7,13
03738300,LONDON SCHOOL OF THEOLOGY               ,FC,00000-0000,Private      ,0,0,0,1,8,9
03741300,ALRA (ACADEMY OF LIVE AND RECORDED ARTS),FC,00000-0000,Private      ,0,0,0,6,18,24
03770300,NAZARENE THEOLOGICAL COLLEGE            ,FC,00000-0000,Private      ,0,0,0,1,4,5
03794400,ANGLO EUROPEAN COLLEGE OF CHIROPRACTIC  ,FC,00000-0000,Private      ,0,1,1,0,5,5
03807300,ROSE BRUFORD COLLEGE                    ,FC,00000-0000,Public       ,0,0,0,1,6,7
03816400,AMERICAN GRAD SCH OF INTERNTL REL & DIPL,FC,00000-0000,Private      ,0,0,0,10,94,104
03818300,LEIPZIG GRADUATE SCHOOL OF MANAGEMENT   ,FC,00000-0000,Private      ,0,0,0,0,20,20
03824300,"ROYAL VETERINARY COLLEGE (THE), UNIVERSI",FC,00000-0000,Public       ,0,0,0,3,147,150
03850500,MEDICAL UNIVERSITY OF LODZ              ,FC,00000-0000,Public       ,0,0,0,4,45,49
03859400,UNIVERSITY COLLEGE FALMOUTH             ,FC,00000-0000,Public       ,0,0,0,5,5,10
03873300,COPENHAGEN BUSINESS SCHOOL              ,FC,00000-0000,Public       ,0,2,2,0,2,2
03880300,UNIVERSITY OF GLOUCESTERSHIRE (THE)     ,FC,00000-0000,Public       ,0,0,0,2,13,15
03897400,INTERNATIONAL SPACE UNIVERSITY          ,FC,00000-0000,Private      ,0,0,0,2,7,9
03941301,AVE MARIA UNIVERSITY - LATIN AMERICA    ,FC,00000-0000,Private      ,0,0,0,185,56,241
03974300,"ST. GEORGE'S UNIVERSITY, SCHOOL OF VETER",FC,00000-0000,Proprietary  ,0,2,2,4,531,535
04021400,"AMERICAN COLLEGE, DUBLIN LIMITED (THE)  ",FC,00000-0000,Private      ,0,0,0,20,29,49
04021500,CENTRAL EUROPEAN UNIVERSITY             ,FC,00000-0000,Private      ,0,0,0,4,95,99
04032300,YORK ST JOHN UNIVERSITY                 ,FC,00000-0000,Public       ,0,0,0,12,8,20
04046300,HK UNIVERSITY OF SCI & TECH (HKUST)     ,FC,00000-0000,Public       ,0,0,0,4,21,25
04070300,"RAPHAEL RECANATI INTERNATIONAL SCHOOL, T",FC,00000-0000,Private      ,0,0,0,98,66,164
04085400,NEW ZEALAND COLLEGE OF CHIROPRACTIC     ,FC,00000-0000,Private      ,0,0,0,1,6,7
04113300,LEBANESE AMERICAN UNIVERSITY            ,FC,00000-0000,Private      ,2,1,3,62,22,84
04115900,LIVERPOOL HOPE UNIVERSITY               ,FC,00000-0000,Public       ,0,0,0,1,14,15
04116300,EDHEC BUSINESS SCHOOL                   ,FC,00000-0000,Private      ,0,0,0,0,46,46
04121400,ISAPZURICH (INTERNATIONAL SCHOOL OF ANAL,FC,00000-0000,Private      ,0,0,0,0,2,2
04128600,UNIVERSITY OF WORCESTER                 ,FC,00000-0000,Public       ,0,0,0,8,2,10
04128700,HERTIE SCHOOL OF GOVERNANCE             ,FC,00000-0000,Private      ,0,0,0,0,5,5
04134200,LONDON CONTEMPORARY DANCE SCHOOL        ,FC,00000-0000,Private      ,0,0,0,3,4,7
04139100,UNIVERSITA DEGLI STUDI DI SCIENZE GASTRO,FC,00000-0000,Private      ,0,1,1,4,27,31
04143700,ST MARY'S UNIVERSITY COLLEGE TWICKENHAM ,FC,00000-0000,Public       ,0,1,1,11,82,93
04168200,EUROPEAN UNIVERSITY AT ST. PETERSBURG   ,FC,00000-0000,Private      ,0,0,0,0,36,36
04171800,"INTERNATIONAL UNIVERSITY OF NURSING, ST.",FC,00000-0000,Proprietary  ,0,0,0,24,62,86
04176500,ESMT EUROPEAN SCHOOL OF MANAGEMENT AND T,FC,00000-0000,Private      ,0,0,0,2,9,11
00380600,ALDERSON-BROADDUS COLLEGE               ,WV,26416-1051,Private      ,3,7,10,1693,386,2079
00380700,MOUNTAIN STATE UNIVERSITY               ,WV,25801-5624,Private      ,0,2,2,857,4206,5063
00380800,BETHANY COLLEGE                         ,WV,26032-0417,Private      ,1,1,2,1367,145,1512
00380900,BLUEFIELD STATE COLLEGE                 ,WV,24701-2198,Public       ,6,37,43,1439,2160,3599
00381000,CONCORD UNIVERSITY                      ,WV,24712-0000,Public       ,6,26,32,3009,1719,4728
00381100,DAVIS & ELKINS COLLEGE                  ,WV,26241-3996,Private      ,3,3,6,1093,392,1485
00381200,FAIRMONT STATE UNIVERSITY               ,WV,26554-2470,Public       ,18,52,70,5280,4251,9531
00381300,GLENVILLE STATE COLLEGE                 ,WV,26351-1292,Public       ,5,5,10,1569,748,2317
00381500,MARSHALL UNIVERSITY                     ,WV,25755-3300,Public       ,28,122,150,10892,8416,19308
00381600,SOUTHERN WV COMMUNITY COLLEGE           ,WV,25637-2900,Public       ,5,20,25,1291,1838,3129
00381800,UNIVERSITY OF CHARLESTON                ,WV,25304-1099,Private      ,4,30,34,1721,1439,3160
00381900,OHIO VALLEY COLLEGE                     ,WV,26105-8000,Private      ,1,5,6,574,227,801
00382000,SALEM INTERNATIONAL UNIVERSITY          ,WV,26426-0500,Proprietary  ,4,57,61,450,1237,1687
00382200,SHEPHERD UNIVERSITY                     ,WV,25443-3210,Public       ,2,11,13,4314,1854,6168
00382300,WEST LIBERTY UNIVERSITY                 ,WV,26074-0295,Public       ,3,19,22,3113,1086,4199
00382600,WEST VIRGINIA STATE UNIVERSITY          ,WV,25112-0000,Public       ,9,17,26,2556,2633,5189
00382700,WEST VIRGINIA UNIVERSITY                ,WV,26506-6201,Public       ,55,132,187,27611,11335,38946
00382711,WEST VIRGINIA UNIVERSITY - POTOMAC STATE,WV,26726-3000,Public       ,10,12,22,2016,798,2814
00382721,WEST VIRGINIA UNIV INST OF TECH         ,WV,25136-2436,Public       ,3,10,13,1300,715,2015
00382800,WEST VIRGINIA UNIV AT PARKERSBURG       ,WV,26101-9577,Public       ,18,81,99,2042,3608,5650
00383000,WEST VIRGINIA WESLEYAN COLLEGE          ,WV,26201-2600,Private      ,1,3,4,2214,354,2568
00383100,WHEELING JESUIT UNIVERSITY              ,WV,26003-6243,Private      ,0,36,36,1330,1108,2438
00500700,WEST VIRGINIA JUNIOR COLLEGE            ,WV,26505-5596,Proprietary  ,5,13,18,280,426,706
00500800,MOUNTAIN STATE COLLEGE                  ,WV,26101-3993,Proprietary  ,2,16,18,90,461,551
00754400,APPALACHIAN BIBLE COLLEGE               ,WV,25818-1353,Private      ,1,2,3,316,92,408
00757800,HUNTINGTON SCHOOL OF BEAUTY CULTURE     ,WV,25705-2030,Proprietary  ,2,13,15,99,225,324
00760000,INTERNATIONAL BEAUTY SCHOOL             ,WV,25401-3231,Proprietary  ,1,30,31,37,180,217
00835500,JAMES RUMSEY TECHNICAL INSTITUTE        ,WV,25403-0259,Public       ,2,10,12,138,437,575
00895900,CLARKSBURG BEAUTY ACADEMY               ,WV,26301-2903,Proprietary  ,14,8,22,71,142,213
00904700,HUNTINGTON JUNIOR COLLEGE               ,WV,25701-2004,Proprietary  ,10,82,92,291,1510,1801
00905400,WEST VIRGINIA NORTHERN CMTY COLLEGE     ,WV,26003-0000,Public       ,9,59,68,1263,2578,3841
01014000,MINERAL COUNTY VOCATIONAL TECH CTR      ,WV,26726-0000,Public       ,0,1,1,22,92,114
01035600,EVEREST INSTITUTE                       ,WV,25313-1304,Proprietary  ,3,36,39,123,576,699
01057300,WEST VIRGINIA JUNIOR COLLEGE            ,WV,25322-0000,Proprietary  ,10,21,31,236,490,726
01057302,WEST VIRGINIA JUNIOR COLLEGE            ,WV,26330-0000,Proprietary  ,11,19,30,198,395,593
01086100,WEST VIRGINIA BUSINESS COLLEGE          ,WV,26301-0000,Proprietary  ,0,11,11,34,202,236
01124500,WEST VIRGINIA SCH OSTEOPATHIC MED       ,WV,24901-1128,Public       ,0,1,1,12,941,953
01174900,WOOD COUNTY SCH OF PRAC NURSING         ,WV,26101-6424,Public       ,0,5,5,46,130,176
01235900,B M SPURR SCHOOL OF PRAC NURSING        ,WV,26038-1660,Private      ,1,0,1,23,35,58
01257300,WEST VIRGINIA UNIV-HOSP-RAD TECH        ,WV,26506-8062,Private      ,0,2,2,217,182,399
01274300,BENJAMIN FRANKLIN CAREER&TECH           ,WV,25064-0000,Public       ,1,2,3,91,252,343
01290400,MONONGALIA CNTY TECH ED CTR             ,WV,26501-6841,Public       ,2,2,4,88,200,288
01290500,ACADEMY OF CAREERS AND TECHNOLOGY       ,WV,25801-0000,Public       ,0,7,7,132,422,554
02057400,ROANE-JACKSON TECHNICAL CENTER          ,WV,25252-0000,Public       ,0,1,1,31,102,133
02068000,UNITED TECHNICAL CENTER                 ,WV,26301-0000,Public       ,0,3,3,50,156,206
02070100,BECKLEY BEAUTY ACADEMY                  ,WV,25801-0000,Proprietary  ,0,0,0,14,39,53
02073400,CARVER CAREER TECH ED CTR               ,WV,25306-6397,Public       ,1,2,3,252,499,751
02145100,SCOTT COLLEGE OF COSMETOLOGY            ,WV,26003-0000,Proprietary  ,6,7,13,91,93,184
02178200,CHARLESTON SCHOOL OF BEAUTY CULTURE     ,WV,25301-0000,Proprietary  ,6,12,18,89,267,356
02218200,GARNET CAREER CENTER                    ,WV,25301-0000,Public       ,2,15,17,119,516,635
02275300,CABELL COUNTY CAREER TECHNOLOGY CTR     ,WV,25705-0000,Public       ,0,8,8,153,408,561
02524500,RALPH R WILLIS VOCATIONAL CENTER        ,WV,25601-0000,Public       ,1,4,5,36,108,144
02534800,FRED W EBERLE TECHNICAL CENTER          ,WV,26201-0000,Public       ,1,1,2,81,210,291
02535500,MERCER COUNTY TECH EDUC CNTR            ,WV,24740-0000,Public       ,1,2,3,118,360,478
02579900,NORTH CENTRAL OPPORTUNITIES INDUSTRIALIZ,WV,26554-2936,Private      ,0,3,3,55,152,207
02609400,VALLEY COLLEGE                          ,WV,25404-5711,Proprietary  ,1,13,14,35,337,372
03052000,MEREDITH MANOR EQUESTRIAN CENTRE        ,WV,26184-9707,Proprietary  ,4,1,5,312,134,446
03076500,FAYETTE INSTITUTE OF TECHNOLOGY         ,WV,25901-2174,Public       ,0,0,0,36,110,146
03084200,VALLEY COLLEGE                          ,WV,24740-3141,Proprietary  ,2,13,15,53,222,275
03084400,VALLEY COLLEGE                          ,WV,25801-2643,Proprietary  ,6,31,37,60,355,415
03098300,PUTNAM CAREER & TECHNICAL CENTER        ,WV,25070-0000,Public       ,0,2,2,91,137,228
03099200,"MOUNTAINEER BEAUTY COLLEGE, INC         ",WV,25177-2917,Proprietary  ,0,0,0,53,105,158
03102100,MORGANTOWN BEAUTY COLLEGE               ,WV,26505-5430,Proprietary  ,1,8,9,100,167,267
03123200,STANLEY TECHNICAL INSTITUTE             ,WV,26505-3751,Private      ,0,0,0,21,51,72
03327500,SOUTH BRANCH VOCATIONAL TECH CENTER     ,WV,26847-1698,Public       ,0,2,2,8,46,54
03734300,JOHN D. ROCKEFELLER IV CAREER CENTER    ,WV,26047-9424,Public       ,0,2,2,10,36,46
03819300,AMERICAN PUBLIC UNIVERSITY SYSTEM       ,WV,25414-1621,Proprietary  ,150,4494,4644,2596,65903,68499
03957300,BLUE RIDGE COMMUNITY AND TECHNICAL COLLE,WV,25401-3244,Public       ,17,59,76,944,2740,3684
03960300,NEW RIVER COMMUNITY AND TECHNICAL COLLEG,WV,25801-2636,Public       ,17,82,99,1179,3106,4285
04028300,MOUNTAIN STATE SCHOOL OF MASSAGE        ,WV,25304-2025,Proprietary  ,0,3,3,27,102,129
04038500,PIERPONT COMMUNITY & TECHNICAL COLLEGE  ,WV,26554-2451,Public       ,17,35,52,2001,2596,4597
04038600,KANAWHA VALLEY COMMUNITY & TECH COLLEGE ,WV,25112-1000,Public       ,5,47,52,765,2205,2970
04041400,MOUNTWEST COMMUNITY AND TECHNICAL COLLEG,WV,25755-3300,Public       ,7,54,61,1102,2519,3621
04047300,BRIDGEMONT COMMUNITY & TECHNICAL COLLEGE,WV,25136-2435,Public       ,2,5,7,447,477,924
04119000,EASTERN WEST VIRGINIA COMMUNITY & TECHNI,WV,26836-0000,Public       ,4,27,31,262,790,1052
00106100,ALASKA PACIFIC UNIVERSITY               ,AK,99508-4672,Private      ,4,12,16,628,1192,1820
00106300,UNIVERSITY OF ALASKA FAIRBANKS          ,AK,99775-7500,Public       ,20,98,118,3626,5103,8729
00106500,UNIVERSITY OF ALASKA SOUTHEAST          ,AK,99801-8680,Public       ,8,54,62,1020,1798,2818
00884300,ALASKA BIBLE COLLEGE                    ,AK,99588-0000,Private      ,0,2,2,38,47,85
01146200,UNIVERSITY OF ALASKA ANCHORAGE          ,AK,99514-1608,Public       ,47,182,229,7339,10629,17968
02541000,ALASKA CAREER COLLEGE                   ,AK,99507-1033,Proprietary  ,9,53,62,304,1114,1418
02576900,CHARTER COLLEGE                         ,AK,99508-0000,Proprietary  ,92,349,441,1260,4549,5809
03160300,AVTEC                                   ,AK,99664-0889,Public       ,3,8,11,300,520,820
03461300,ILISAGVIK COLLEGE                       ,AK,99723-0749,Public       ,0,1,1,33,99,132
04138600,ALASKA CHRISTIAN COLLEGE                ,AK,99669-9755,Private      ,0,0,0,55,79,134
00108500,UNIV ARKANSAS MONTICELLO                ,AR,71656-0000,Public       ,25,94,119,2811,2895,5706
00108600,UNIV OF ARKANSAS AT PINE BLUFF          ,AR,71601-2790,Public       ,49,28,77,4183,2287,6470
00108700,ARKANSAS BAPTIST COLLEGE                ,AR,72202-6099,Private      ,133,54,187,1499,1956,3455
00108800,LYON COLLEGE                            ,AR,72501-3699,Private      ,3,2,5,950,214,1164
00108900,ARKANSAS TECH UNIVERSITY                ,AR,72801-2222,Public       ,49,141,190,7571,6519,14090
00109000,ARKANSAS STATE UNIVERSITY               ,AR,72467-0000,Public       ,85,437,522,10876,14339,25215
00109002,ARKANSAS STATE UNIVERSITY - NEWPORT     ,AR,72112-1120,Public       ,11,35,46,22,78,100
00109006,DELTA TECHNICAL INSTITUTE               ,AR,72365-9558,Public       ,3,2,5,103,347,450
00109100,ARKANSAS STATE UNIVERSITY - BEEBE       ,AR,72012-1000,Public       ,22,66,88,2619,3903,6522
00109200,UNIVERSITY OF CENTRAL ARKANSAS          ,AR,72035-0001,Public       ,57,132,189,10673,5760,16433
00109300,CENTRAL BAPTIST COLLEGE                 ,AR,72034-6470,Private      ,5,9,14,719,678,1397
00109400,UNIVERSITY OF THE OZARKS                ,AR,72830-2880,Private      ,2,1,3,862,207,1069
00109500,CROWLEYS RIDGE COLLEGE                  ,AR,72450-9775,Private      ,0,8,8,261,251,512
00109700,HARDING UNIVERSITY                      ,AR,72149-0001,Private      ,11,55,66,4243,2183,6426
00109800,HENDERSON STATE UNIVERSITY              ,AR,71999-0001,Public       ,28,45,73,4265,2392,6657
00109900,HENDRIX COLLEGE                         ,AR,72032-3080,Private      ,1,6,7,2328,359,2687
00110000,JOHN BROWN UNIVERSITY                   ,AR,72761-2747,Private      ,1,22,23,1722,1485,3207
00110100,UNIV ARKANSAS LITTLE ROCK               ,AR,72204-1099,Public       ,55,209,264,6436,12628,19064
00110200,OUACHITA BAPTIST UNIVERSITY             ,AR,71998-0001,Private      ,9,3,12,2084,221,2305
00110300,PHILANDER SMITH COLLEGE                 ,AR,72202-3718,Private      ,15,17,32,1224,1112,2336
00110400,PHILLIPS COUNTY COMMUNITY COLLEGE       ,AR,72342-0000,Public       ,58,34,92,674,1034,1708
00110500,SHORTER COLLEGE                         ,AR,72114-4885,Private      ,5,21,26,22,185,207
00110600,WILLIAMS BAPTIST COLLEGE                ,AR,72476-4661,Private      ,0,2,2,652,216,868
00110700,SOUTHERN ARKANSAS UNIVERSITY            ,AR,71754-0000,Public       ,38,44,82,3183,2264,5447
00110800,UNIV ARKANSAS FAYETTEVILLE              ,AR,72701-0000,Public       ,65,142,207,19256,8746,28002
00110900,UNIVERSITY OF ARKANSAS FOR MEDICAL SCIEN,AR,72205-7102,Public       ,4,40,44,804,3468,4272
00111000,UNIVERSITY OF ARKANSAS-FORT SMITH       ,AR,72904-7397,Public       ,35,99,134,4821,5483,10304
00524500,U OF A COMM COLLEGE AT MORRILTON        ,AR,72110-9601,Public       ,17,37,54,1515,2407,3922
00570700,SEARK COLLEGE                           ,AR,71603-0000,Public       ,35,98,133,897,2647,3544
00573200,UNIV AR COMMUNITY COLLEGE AT HOPE       ,AR,71801-0000,Public       ,23,42,65,714,1556,2270
00704400,CROWLEYS RIDGE TECHNICAL INSTITUTE      ,AR,72336-0000,Public       ,6,6,12,219,492,711
00732967,ITT TECHNICAL INSTITUTE                 ,AR,72204-7739,Proprietary  ,24,81,105,374,1266,1640
00773800,SOUTHERN ARKANSAS UNIVERSITY TECH       ,AR,71701-1900,Public       ,10,27,37,692,1209,1901
00792100,PAUL MITCHELL THE SCHOOL ARKANSAS       ,AR,72701-0000,Proprietary  ,1,3,4,130,222,352
00997600,OUACHITA TECHNICAL COLLEGE              ,AR,72104-0816,Public       ,8,27,35,390,1387,1777
01074100,MELLIE'S BEAUTY COLLEGE                 ,AR,72901-3886,Proprietary  ,1,10,11,77,250,327
01210500,NATIONAL PARK COMMUNITY COLLEGE         ,AR,71913-9174,Public       ,8,79,87,1340,3576,4916
01226000,EAST ARKANSAS COMMUNITY COLLEGE         ,AR,72335-2204,Public       ,13,22,35,653,1157,1810
01226100,NORTH ARKANSAS COLLEGE                  ,AR,72601-5508,Public       ,12,34,46,1190,2329,3519
01286000,ARKANSAS NORTHEASTERN COLLEGE           ,AR,72316-1109,Public       ,41,55,96,925,1777,2702
02052200,BLACK RIVER TECHNICAL COLLEGE           ,AR,72455-0000,Public       ,12,69,81,985,2690,3675
02073500,UNIVERSITY OF ARKANSAS COMMUNITY COLLEGE,AR,72503-0000,Public       ,11,27,38,722,1444,2166
02073700,NORTHWEST TECHNICAL INSTITUTE           ,AR,72765-0000,Public       ,0,9,9,303,772,1075
02074600,SOUTH ARKANSAS COMMUNITY COLLEGE        ,AR,71731-0000,Public       ,13,43,56,759,2170,2929
02075300,PULASKI TECHNICAL COLLEGE               ,AR,72118-0000,Public       ,57,277,334,4762,16618,21380
02087000,OZARKA COLLEGE                          ,AR,72556-0000,Public       ,13,40,53,544,1644,2188
02111100,RICH MOUNTAIN COMMUNITY COLLEGE         ,AR,71953-0000,Public       ,5,22,27,440,730,1170
02202400,PROFESSIONAL COSMETOLOGY EDUC CTR       ,AR,71730-5828,Proprietary  ,2,4,6,33,103,136
02220900,COSSATOT COMMUNITY COLLEGE              ,AR,71832-0000,Public       ,7,22,29,564,1208,1772
02260400,BEE JAY'S HAIRSTYLING ACADEMY           ,AR,72212-0000,Proprietary  ,0,0,0,12,23,35
02260401,BEE JAY'S HAIRSTYLING ACADEMY - BATESVIL,AR,72501-6709,Proprietary  ,0,0,0,4,11,15
02272400,EASTERN COLLEGE OF HEALTH VOCATIONS     ,AR,72205-3535,Proprietary  ,11,43,54,217,920,1137
02284200,NEW TYLER BARBER COLLEGE INC            ,AR,72114-0000,Proprietary  ,2,6,8,89,268,357
02287400,MARSHA KAY BEAUTY COLLEGE               ,AR,72653-0000,Proprietary  ,1,1,2,21,59,80
02330800,JEFFERSON SCHOOL OF NURSING             ,AR,71603-0000,Private      ,1,6,7,100,287,387
02339800,SOUTHERN INSTITUTE OF COSMETOLOGY       ,AR,72301-0000,Proprietary  ,2,8,10,38,102,140
02341700,CAREER ACADEMY OF HAIR DESIGN           ,AR,72764-4304,Proprietary  ,2,10,12,56,206,262
02341701,CAREER ACADEMY OF HAIR DESIGN - ROGERS  ,AR,72756-2102,Proprietary  ,6,14,20,61,196,257
02341702,CAREER ACADEMY OF HAIR DESIGN - SILOAM  ,AR,72761-4217,Proprietary  ,3,6,9,31,64,95
02348200,MID-SOUTH COMMUNITY COLLEGE             ,AR,72301-0000,Public       ,38,86,124,923,2283,3206
02363500,ARTHUR'S BEAUTY COLLEGE                 ,AR,72901-0000,Proprietary  ,1,11,12,58,214,272
02525800,LEE'S SCHOOL OF COSMETOLOGY             ,AR,72114-0000,Proprietary  ,0,7,7,63,165,228
02538500,ARTHUR'S BEAUTY COLLEGE                 ,AR,72076-0000,Proprietary  ,3,10,13,100,273,373
02569600,SEARCY BEAUTY COLLEGE                   ,AR,72143-0000,Proprietary  ,3,12,15,45,127,172
03005100,ARKANSAS BEAUTY SCHOOL                  ,AR,72209-5116,Proprietary  ,2,3,5,81,282,363
03007100,HOT SPRINGS BEAUTY COLLEGE              ,AR,71901-5432,Proprietary  ,3,4,7,46,160,206
03007600,ARKANSAS BEAUTY SCHOOL-CONWAY           ,AR,72032-4354,Proprietary  ,0,0,0,63,178,241
03023400,ARKANSAS COLLEGE OF BARBERING           ,AR,72114-5615,Proprietary  ,11,10,21,98,318,416
03063300,NORTHWEST ARKANSAS COMMUNITY COLLEG     ,AR,72712-5190,Public       ,31,157,188,3840,6905,10745
03065100,ABC BEAUTY COLLEGE                      ,AR,71923-4206,Proprietary  ,3,6,9,41,114,155
03066302,BRYAN COLLEGE -                         ,AR,72756-1825,Proprietary  ,3,17,20,94,465,559
03105200,BAPTIST HEALTH SCHOOLS LITTLE ROCK      ,AR,72210-2820,Private      ,4,23,27,587,2130,2717
03115102,HERITAGE COLLEGE - LITTLE ROCK          ,AR,72227-5544,Proprietary  ,15,70,85,253,1208,1461
03124900,IMAGINE -  PAUL MITCHELL PARTNER SCHOOL ,AR,72117-2516,Proprietary  ,14,21,35,243,516,759
03127200,ASKINS VO-TECH                          ,AR,72908-8028,Proprietary  ,0,0,0,0,10,10
03214300,VELVATEX COLLEGE OF BEAUTY CULTURE      ,AR,72202-5452,Proprietary  ,0,0,0,25,94,119
03254300,MARGARET'S HAIR ACADEMY                 ,AR,71655-4905,Proprietary  ,1,3,4,44,132,176
03519400,LYNNDALE FUNDAMENTALS OF BEAUTY SCH     ,AR,71730-4804,Proprietary  ,0,0,0,7,39,46
03855300,ECCLESIA COLLEGE                        ,AR,72762-8159,Private      ,0,2,2,143,140,283
03912300,CROSSETT SCHOOL OF COSMETOLOGY          ,AR,71635-0000,Proprietary  ,3,6,9,13,43,56
03997300,ARKANSAS BEAUTY COLLEGE                 ,AR,72801-3741,Proprietary  ,3,5,8,50,125,175
04183100,WASHINGTON BARBER COLLEGE               ,AR,72209-3820,Proprietary  ,3,11,14,60,194,254
04183400,SALON PROFESSIONAL ACADEMY (THE)        ,AR,72116-7310,Proprietary  ,1,2,3,70,191,261
04220000,DESIGNER BARBER & STYLIST SCHOOL        ,AR,72903-3753,Proprietary  ,0,7,7,0,7,7
00133900,CORBAN UNIVERSITY                       ,OR,97301-9392,Private      ,4,7,11,2083,919,3002
00318600,BLUE MOUNTAIN COMMUNITY COLLEGE         ,OR,97801-0000,Public       ,6,31,37,1391,2624,4015
00318800,CENTRAL OREGON COMMUNITY COLLEGE        ,OR,97701-5998,Public       ,21,80,101,3673,8351,12024
00318900,CLATSOP COMMUNITY COLLEGE               ,OR,97103-3698,Public       ,8,18,26,668,1763,2431
00319100,CONCORDIA UNIVERSITY                    ,OR,97211-6099,Private      ,6,357,363,2386,5976,8362
00319300,EASTERN OREGON UNIVERSITY               ,OR,97850-2899,Public       ,9,29,38,3375,3993,7368
00319400,GEORGE FOX UNIVERSITY                   ,OR,97132-2697,Private      ,3,44,47,3753,2552,6305
00319600,LANE COMMUNITY COLLEGE                  ,OR,97405-0640,Public       ,39,140,179,8283,16379,24662
00319700,LEWIS & CLARK COLLEGE                   ,OR,97219-7899,Private      ,3,26,29,6100,4203,10303
00319800,LINFIELD COLLEGE                        ,OR,97128-6894,Private      ,6,15,21,3735,1537,5272
00319801,LINFIELD COLLEGE - PORTLAND CAMPUS      ,OR,97210-0000,Private      ,1,7,8,778,1582,2360
00319900,MARYLHURST UNIVERSITY                   ,OR,97036-7036,Private      ,4,47,51,182,2268,2450
00320300,MOUNT ANGEL SEMINARY                    ,OR,97373-0505,Private      ,0,0,0,21,30,51
00320400,MOUNT HOOD COMMUNITY COLLEGE            ,OR,97030-3300,Public       ,38,108,146,6032,11385,17417
00320600,MULTNOMAH BIBLE COLLEGE/SEMINARY        ,OR,97220-5898,Private      ,1,8,9,576,1058,1634
00320700,PACIFIC NORTHWEST COLLEGE OF ART        ,OR,97209-3023,Private      ,3,9,12,908,1087,1995
00320800,NORTHWEST CHRISTIAN UNIVERSITY          ,OR,97401-3727,Private      ,1,8,9,714,974,1688
00320900,WESTERN OREGON UNIVERSITY               ,OR,97361-1394,Public       ,13,39,52,8445,3892,12337
00321000,OREGON STATE UNIVERSITY                 ,OR,97331-8507,Public       ,57,149,206,26812,15793,42605
00321100,OREGON INSTITUTE OF TECHNOLOGY          ,OR,97601-8801,Public       ,4,21,25,3228,3169,6397
00321200,PACIFIC UNIVERSITY                      ,OR,97116-1797,Private      ,3,9,12,4263,3553,7816
00321300,PORTLAND COMMUNITY COLLEGE              ,OR,97219-7198,Public       ,94,449,543,17014,42875,59889
00321311,PORTLAND COMMUNITY COLLEGE - TILLAMOOK B,OR,97141-2599,Public       ,0,9,9,169,447,616
00321600,PORTLAND STATE UNIVERSITY               ,OR,97207-0000,Public       ,68,339,407,17699,29007,46706
00321700,REED COLLEGE                            ,OR,97202-8199,Private      ,2,7,9,3131,1040,4171
00321800,CHEMEKETA COMMUNITY COLLEGE             ,OR,97309-1500,Public       ,37,155,192,7749,16175,23924
00321900,SOUTHERN OREGON UNIVERSITY              ,OR,97520-5010,Public       ,15,67,82,6344,4633,10977
00322000,SOUTHWESTERN OREGON COMMUNITY CLG       ,OR,97420-2956,Public       ,5,14,19,1879,2252,4131
00322100,TREASURE VALLEY COMMUNITY COLLEGE       ,OR,97914-3423,Public       ,19,118,137,1834,3397,5231
00322200,UMPQUA COMMUNITY COLLEGE                ,OR,97470-0226,Public       ,4,31,35,1478,3779,5257
00322300,UNIVERSITY OF OREGON                    ,OR,97403-1226,Public       ,82,123,205,29986,13135,43121
00322400,UNIVERSITY OF PORTLAND                  ,OR,97203-5798,Private      ,14,41,55,11313,4052,15365
00322500,WARNER PACIFIC COLLEGE                  ,OR,97215-4099,Private      ,4,31,35,1360,2544,3904
00322700,WILLAMETTE UNIVERSITY                   ,OR,97301-3930,Private      ,2,6,8,6207,2071,8278
00487800,CLACKAMAS COMMUNITY COLLEGE             ,OR,97045-7998,Public       ,27,96,123,4784,7884,12668
00488200,OREGON HEALTH & SCIENCE UNIVERSITY      ,OR,97239-0000,Public       ,4,19,23,1298,5135,6433
00693800,LINN BENTON COMMUNITY COLLEGE           ,OR,97321-3774,Public       ,10,35,45,4642,7007,11649
00717800,WESTERN SEMINARY                        ,OR,97215-0000,Private      ,0,4,4,31,650,681
00723402,HEALD COLLEGE - PORTLAND                ,OR,97205-3432,Proprietary  ,11,89,100,418,1980,2398
00732969,ITT TECHNICAL INSTITUTE                 ,OR,97220-6819,Proprietary  ,20,142,162,689,2831,3520
00737101,MARINELLO SCHOOL OF BEAUTY - PORTLAND   ,OR,97212-3732,Proprietary  ,7,15,22,124,351,475
00781900,ART INSTITUTE OF PORTLAND (THE)         ,OR,97209-2911,Proprietary  ,14,31,45,2426,2871,5297
00888700,CONCORDE CAREER INSTITUTE               ,OR,97232-2242,Proprietary  ,5,40,45,462,1709,2171
00907900,EVEREST COLLEGE                         ,OR,97204-2296,Proprietary  ,12,34,46,407,1510,1917
00958100,SPRINGFIELD COLLEGE OF BEAUTY           ,OR,97477-5474,Proprietary  ,2,4,6,98,223,321
01012200,PHAGANS' MEDFORD BEAUTY SCHOOL          ,OR,97504-5297,Proprietary  ,1,5,6,110,333,443
01018200,ROGUE COMMUNITY COLLEGE                 ,OR,97527-0000,Public       ,23,80,103,3303,8681,11984
01050700,ACADEMY OF HAIR DESIGN                  ,OR,97301-3526,Proprietary  ,3,19,22,117,313,430
01230900,UNIVERSITY OF WESTERN STATES            ,OR,97230-3099,Private      ,1,7,8,143,853,996
01234700,PHAGANS CENTRAL OREGON BEAUTY CLG       ,OR,97701-5175,Proprietary  ,4,8,12,128,388,516
01234800,PHAGANS BEAUTY COLLEGE                  ,OR,97333-4716,Proprietary  ,3,2,5,96,178,274
01235000,PHAGANS SCHOOL OF HAIR DESIGN           ,OR,97267-0000,Proprietary  ,8,17,25,109,212,321
01235100,PHAGANS SCHOOL OF BEAUTY                ,OR,97301-4732,Proprietary  ,4,7,11,113,318,431
01300800,PHAGANS TIGARD BEAUTY SCHOOL            ,OR,97223-0000,Proprietary  ,0,3,3,47,115,162
02101000,NORTHWEST COLLEGE OF HAIR DESIGN        ,OR,97086-7702,Proprietary  ,15,36,51,326,803,1129
02101002,NORTHWEST COLLEGE                       ,OR,97007-3954,Proprietary  ,3,6,9,45,140,185
02104900,COLLEGE OF LEGAL ARTS                   ,OR,97219-9998,Proprietary  ,3,18,21,108,582,690
02106100,COLLEGE OF COSMETOLOGY                  ,OR,97601-0000,Proprietary  ,0,1,1,69,180,249
02154400,BEAU MONDE CLG OF HAIR DESIGN           ,OR,97205-0000,Proprietary  ,9,13,22,210,496,706
02159700,NEW HOPE CHRISTIAN COLLEGE              ,OR,97405-1194,Private      ,1,3,4,323,332,655
02201900,PHAGANS' SCHOOL OF HAIR DESIGN          ,OR,97232-0000,Proprietary  ,7,21,28,225,558,783
02239203,ANTHEM COLLEGE - BEAVERTON              ,OR,97005-0000,Proprietary  ,11,32,43,129,338,467
02330100,PIONEER PACIFIC COLLEGE                 ,OR,97070-0000,Proprietary  ,6,35,41,442,1510,1952
02330102,PIONEER PACIFIC COLLEGE                 ,OR,97403-0000,Proprietary  ,6,30,36,331,1504,1835
02337900,COLLEGE OF HAIR DESIGN CAREERS          ,OR,97301-0000,Proprietary  ,2,5,7,110,280,390
02344100,ROSEBURG BEAUTY COLLEGE                 ,OR,97470-0000,Proprietary  ,0,8,8,56,174,230
02534000,NATIONAL COLLEGE OF NATURAL MEDICINE    ,OR,97201-0000,Private      ,2,4,6,91,1118,1209
02578800,NORTHWEST NANNIES INSTITUTE             ,OR,97035-0000,Proprietary  ,1,0,1,25,24,49
02603700,OREGON COL OF ORIENTAL MEDICINE         ,OR,97216-0000,Private      ,0,1,1,41,519,560
02617506,EVEREST COLLEGE - EVEREST INSTITUTE     ,OR,97223-6581,Proprietary  ,6,44,50,171,685,856
03007300,OREGON COLLEGE OF ART & CRAFT           ,OR,97225-6399,Private      ,1,6,7,382,678,1060
03022600,LE CORDON BLEU COLLEGE OF CULINARY ARTS ,OR,97205-2793,Proprietary  ,29,81,110,1210,2658,3868
03042500,CARRINGTON COLLEGE                      ,OR,97232-1302,Proprietary  ,11,71,82,487,1790,2277
03074400,PHAGANS NEWPORT ACAD CSMTLGY CAREER     ,OR,97365-4963,Proprietary  ,0,4,4,26,107,133
03074500,EAST-WEST COLLEGE OF THE HEALING ARTS   ,OR,97232-2765,Proprietary  ,1,7,8,135,722,857
03185300,PHAGANS GRANTS PASS COLLEGE OF BTY      ,OR,97527-3039,Proprietary  ,1,6,7,54,172,226
03428300,KLAMATH COMMUNITY COLLEGE               ,OR,97603-7121,Public       ,2,22,24,804,2048,2852
03642300,VALLEY MEDICAL COLLEGE                  ,OR,97305-1373,Proprietary  ,4,28,32,224,853,1077
03668300,BIRTHINGWAY COLLEGE OF MIDWIFERY        ,OR,97266-4042,Private      ,2,4,6,61,354,415
03783400,ABDILL CAREER COLLEGE                   ,OR,97504-7137,Proprietary  ,4,13,17,101,545,646
04146500,PORTLAND ACTORS CONSERVATORY            ,OR,97201-2557,Private      ,0,5,5,77,196,273
04151900,COLUMBIA GORGE COMMUNITY COLLEGE        ,OR,97058-3434,Public       ,3,15,18,560,1391,1951
04167400,SAGE SCHOOL OF MASSAGE & HEALING ARTS   ,OR,97701-4082,Proprietary  ,0,1,1,67,201,268
04171400,AVEDA INSTITUTE PORTLAND                ,OR,97209-3144,Proprietary  ,10,15,25,441,738,1179
04194400,AMERICAN COLLEGE OF HEALTHCARE SCIENCES ,OR,97239-3719,Proprietary  ,4,28,32,35,455,490
04194900,TILLAMOOK BAY COMMUNITY COLLEGE         ,OR,97141-2807,Public       ,1,2,3,1,2,3
00137400,ALBERTUS MAGNUS COLLEGE                 ,CT,06511-1189,Private      ,1,22,23,1151,1499,2650
00137403,ALBERTUS MAGNUS CLG-NEW DIMENSIONS      ,CT,06511-0000,Private      ,0,22,22,111,1060,1171
00137800,CENTRAL CONNECTICUT STATE UNIV          ,CT,06050-2490,Public       ,7,67,74,10933,5907,16840
00137900,CONNECTICUT COLLEGE                     ,CT,06320-4196,Private      ,1,2,3,3306,248,3554
00138000,WESTERN CONNECTICUT STATE UNIV          ,CT,06810-6826,Public       ,9,8,17,6557,2178,8735
00138500,FAIRFIELD UNIVERSITY                    ,CT,06430-0000,Private      ,4,20,24,7720,1380,9100
00138700,HARTFORD SEMINARY                       ,CT,06105-0000,Private      ,0,2,2,8,124,132
00138900,HOLY APOSTLES COLLEGE & SEMINARY        ,CT,06416-2027,Private      ,0,0,0,17,78,95
00139200,MANCHESTER COMMUNITY COLLEGE            ,CT,06045-1046,Public       ,24,59,83,4578,5056,9634
00139300,MITCHELL COLLEGE                        ,CT,06320-4498,Private      ,3,1,4,1119,350,1469
00139700,UNIVERSITY OF NEW HAVEN                 ,CT,06516-1999,Private      ,7,16,23,10365,2541,12906
00139800,NORTHWESTERN CT COMMUNITY COLLEGE       ,CT,06098-1747,Public       ,1,10,11,699,1017,1716
00139900,NORWALK COMMUNITY TECHNICAL COLLEGE     ,CT,06854-1655,Public       ,11,31,42,2788,3621,6409
00140100,POST UNIVERSITY                         ,CT,06723-3240,Proprietary  ,53,620,673,2391,11821,14212
00140200,QUINNIPIAC UNIVERSITY                   ,CT,06518-1908,Private      ,8,14,22,15994,2503,18497
00140201,QUINNIPIAC UNIVERSITY SCHOOL OF LAW     ,CT,06518-0000,Private      ,0,3,3,88,953,1041
00140300,SACRED HEART UNIVERSITY                 ,CT,06825-1000,Private      ,12,97,109,8490,2990,11480
00140600,SOUTHERN CONNECTICUT STATE UNIV         ,CT,06515-1355,Public       ,13,56,69,10634,6367,17001
00140900,SAINT JOSEPH COLLEGE                    ,CT,06117-2791,Private      ,3,29,32,1253,2253,3506
00141400,TRINITY COLLEGE                         ,CT,06106-3100,Private      ,1,4,5,4048,433,4481
00141600,UNIVERSITY OF BRIDGEPORT                ,CT,06601-5650,Private      ,8,36,44,4039,3968,8007
00141700,UNIVERSITY OF CONNECTICUT-STORRS        ,CT,06269-2151,Public       ,24,72,96,32484,6942,39426
00141702,UNIV CONN STAMFORD                      ,CT,06901-0000,Public       ,4,9,13,1121,812,1933
00141703,UNIV OF CONNECTICUT - TORINGTON         ,CT,06790-0000,Public       ,1,2,3,333,200,533
00141706,UNIV OF CONNECTICUT SCH LAW             ,CT,06105-0000,Public       ,0,1,1,104,1369,1473
00141707,UNIV OF CT - SCH OF SOCIAL WORK         ,CT,06117-0000,Public       ,1,8,9,180,808,988
00141708,UNIVERSITY OF CONNECTICUT - SCHOOL OF ME,CT,06030-1920,Public       ,1,4,5,217,655,872
00141709,UNIVERSITY OF CONNECTICUT - SCHOOL OF DE,CT,06030-1920,Public       ,1,1,2,319,391,710
00142200,UNIVERSITY OF HARTFORD                  ,CT,06117-1599,Private      ,11,26,37,11858,2814,14672
00142400,WESLEYAN UNIVERSITY                     ,CT,06459-3208,Private      ,2,2,4,6055,352,6407
00142500,EASTERN CONNECTICUT STATE UNIV          ,CT,06226-2295,Public       ,8,15,23,6973,1724,8697
00142600,YALE UNIVERSITY                         ,CT,06520-8288,Private      ,5,17,22,19828,9185,29013
00280301,RENSSELAER POLYTECHNIC INSTITUTE-RENSSEL,CT,06120-2991,Private      ,0,4,4,25,83,108
00451300,HOUSATONIC COMMUNITY COLLEGE            ,CT,06604-4704,Public       ,17,42,59,3320,5432,8752
00618100,BRIDGEPORT HOSP SCHL OF NURSING         ,CT,06610-2896,Private      ,1,8,9,237,814,1051
00619100,ST. VINCENT'S COLLEGE                   ,CT,06606-9966,Private      ,2,11,13,448,1265,1713
00698200,NAUGATUCK VALLEY COMM-TECH COLG         ,CT,06708-3089,Public       ,16,42,58,3742,4871,8613
00730000,ELI WHITNEY TECHNICAL HIGH SCHOOL       ,CT,06514-0000,Public       ,2,0,2,20,112,132
00730300,LINCOLN TECHNICAL INSTITUTE             ,CT,06051-0000,Proprietary  ,28,85,113,779,1773,2552
00730306,LINCOLN TECHNICAL INSTITUTE - EAST WINDS,CT,06088-9631,Proprietary  ,15,15,30,1191,681,1872
00730500,PORTER AND CHESTER INSTITUTE OF BRANFORD,CT,06405-4022,Proprietary  ,11,20,31,282,668,950
00731100,WINDHAM TECHNICAL HIGH SCHOOL           ,CT,06226-2100,Public       ,0,0,0,9,15,24
00745900,PAIER COLLEGE OF ART                    ,CT,06514-3902,Proprietary  ,1,2,3,162,93,255
00763500,CAPITAL COMMUNITY COLLEGE               ,CT,06103-1207,Public       ,8,62,70,2204,5440,7644
00803700,GATEWAY COMMUNITY-TECHNICAL COLLEGE     ,CT,06511-0000,Public       ,20,75,95,3876,6990,10866
00803800,MIDDLESEX COMMUNITY CLG                 ,CT,06457-4889,Public       ,9,28,37,1461,2023,3484
00887300,PAUL MITCHELL THE SCHOOL                ,CT,06810-6716,Proprietary  ,4,4,8,109,119,228
00887400,BRIO ACADEMY OF COSMETOLOGY             ,CT,06450-4836,Proprietary  ,2,15,17,66,182,248
00887401,BRIO ACADEMY OF COSMETOLOGY - HAMDEN    ,CT,06514-4132,Proprietary  ,3,16,19,36,157,193
00887402,BRIO ACADEMY OF COSMETOLOGY - FAIRFIELD ,CT,06824-6690,Proprietary  ,5,17,22,111,265,376
00887403,BRIO ACADEMY OF COSMETOLOGY - WILLIMANTI,CT,06226-1940,Proprietary  ,6,9,15,52,146,198
00887404,BRIO ACADEMY OF COSMETOLOGY -           ,CT,06605-4114,Proprietary  ,0,0,0,22,65,87
00927700,E C GOODWIN TECHNICAL HIGH SCHOOL       ,CT,06053-0000,Public       ,1,1,2,31,74,105
00940700,LINCOLN COLLEGE OF NEW ENGLAND          ,CT,06489-1057,Proprietary  ,8,22,30,799,1264,2063
00940701,CLEMENS COLLEGE                         ,CT,06078-0000,Proprietary  ,0,0,0,21,11,32
00976400,TUNXIS COMMUNITY COLLEGE                ,CT,06032-3187,Public       ,7,53,60,2362,3027,5389
00976500,THREE RIVERS COMMUNITY COLLEGE          ,CT,06360-6598,Public       ,17,56,73,2221,3766,5987
00982200,ALBERT I PRINCE TECHNICAL HIGH SCHOOL   ,CT,06106-3799,Public       ,0,2,2,22,131,153
01041700,BRIO ACADEMY OF EAST HARTFORD           ,CT,06108-2220,Proprietary  ,6,25,31,106,284,390
01053000,QUINEBAUG VALLEY COMMUNITY COLLEGE      ,CT,06239-1440,Public       ,4,26,30,964,1709,2673
01077900,PORTER AND CHESTER INSTITUTE-ALLCAMPUSES,CT,06615-7158,Proprietary  ,62,138,200,1821,4539,6360
01115000,ASNUNTUCK COMMUNITY COLLEGE             ,CT,06082-3800,Public       ,7,44,51,715,1104,1819
01149600,BULLARD HAVENS VOC TECH SCHOOL          ,CT,06610-3499,Public       ,0,1,1,25,160,185
01169700,VINAL REGIONAL VOC TECH SCHOOL          ,CT,06457-4918,Public       ,0,0,0,12,54,66
01184300,NORWICH TECHNICAL HIGH SCHOOL           ,CT,06360-7097,Public       ,0,0,0,14,96,110
01242500,STONE ACADEMY                           ,CT,06516-4049,Proprietary  ,11,49,60,265,1171,1436
01242503,STONE ACADEMY -WATERBURY                ,CT,06705-3823,Proprietary  ,0,4,4,49,182,231
01242504,STONE ACADEMY -  EAST HARTFORD          ,CT,06118-0000,Proprietary  ,2,5,7,63,261,324
01287700,SANFORD-BROWN COLLEGE                   ,CT,06855-1436,Proprietary  ,0,2,2,108,383,491
01291300,LEON INSTITUTE OF HAIR DESIGN           ,CT,06604-4226,Proprietary  ,0,0,0,8,69,77
02074000,BRANFORD HALL CAREER INSTITUTE          ,CT,06405-0000,Proprietary  ,91,423,514,1150,4757,5907
02106600,AMERICAN INSTITUTE                      ,CT,06110-1922,Proprietary  ,3,56,59,80,478,558
02112300,RIDLEY LOWELL BUSINESS & TECH INST      ,CT,06320-0000,Proprietary  ,13,79,92,202,1010,1212
02112700,NORTH HAVEN ACADEMY                     ,CT,06473-3108,Proprietary  ,3,2,5,119,136,255
02115100,BUTLER BUSINESS SCHOOL                  ,CT,06604-0000,Proprietary  ,0,0,0,78,375,453
02148700,CONNECTICUT INST OF HAIR DESIGN         ,CT,06716-0000,Proprietary  ,1,3,4,33,62,95
02202500,NEW ENGLAND TRACTOR TRAILER SCH         ,CT,06071-2036,Proprietary  ,14,143,157,165,1679,1844
02244900,GOODWIN COLLEGE                         ,CT,06118-9980,Private      ,26,234,260,1324,5710,7034
02245300,HOWELL CHENEY TECHNICAL HIGH SCHOOL     ,CT,06040-0000,Public       ,0,0,0,17,30,47
02265900,WINDHAM COMMUNITY MEM HOSP-RAD TECH     ,CT,06226-0000,Private      ,0,0,0,16,46,62
02296100,YALE-NEW HAVEN HOSP DIETETIC INTERN     ,CT,06510-8900,Private      ,0,0,0,32,53,85
02300000,W F KAYNOR TECHNICAL HIGH SCHOOL        ,CT,06708-0000,Public       ,0,3,3,23,110,133
02316600,CONNECTICUT CTR FOR MASSAGE THERAPY     ,CT,06111-3975,Proprietary  ,1,7,8,82,282,364
02316601,CONNECTICUT CENTER FOR MASSAGE THERAPY -,CT,06880-4619,Proprietary  ,3,14,17,46,228,274
02316603,CONNECTICUT CENTER FOR MASSAGE THERAPY -,CT,06340-4619,Proprietary  ,1,5,6,52,152,204
02565000,PLATT TECHNICAL HIGH SCHOOL             ,CT,06460-2105,Public       ,1,2,3,18,37,55
03079400,LYME ACADEMY COLLEGE OF FINE ARTS       ,CT,06371-2333,Private      ,0,0,0,107,39,146
03094800,INDUSTRIAL MANAGEMENT & TRAINING        ,CT,06706-1211,Proprietary  ,4,7,11,60,211,271
03234300,CHARTER OAK STATE COLLEGE               ,CT,06053-2150,Public       ,2,66,68,145,2116,2261
03316300,LINCOLN TECHNICAL INSTITUTE - HARTFORD  ,CT,06105-3630,Proprietary  ,6,42,48,746,892,1638
03381300,CONNECTICUT TRAINING CENTER             ,CT,06108-2705,Private      ,0,5,5,12,92,104
03927300,ALBERT SCHOOL (THE)                     ,CT,06357-2447,Proprietary  ,2,1,3,39,95,134
03927301,BRIO ACADEMY OF COSMETOLOGY - TORRINGTON,CT,06790-5425,Proprietary  ,2,7,9,23,61,84
03927302,BRIO ACADEMY OF COSMETOLOGY  -  ENFIELD ,CT,06082-2946,Proprietary  ,2,4,6,48,89,137
04104300,ACADEMY DI CAPELLI - SCHOOL OF COSMETOLO,CT,06492-0000,Proprietary  ,0,7,7,54,110,164
04128800,BRANFORD ACADEMY OF HAIR & COSMETOLOGY  ,CT,06405-0000,Proprietary  ,1,5,6,36,86,122
04145400,OXFORD ACADEMY OF HAIR DESIGN           ,CT,06483-2911,Proprietary  ,0,9,9,61,101,162
04148400,EUROPEAN ACADEMY OF COSMETOLOGY AND HAIR,CT,06437-0000,Proprietary  ,0,2,2,16,26,42
04152400,INTERNATIONAL INSTITUTE OF COSMETOLOGY  ,CT,06109-0000,Proprietary  ,2,2,4,123,105,228
04162900,TONSORIAL ACADEMY OF COSMETOLOGY AND BAR,CT,06516-0000,Proprietary  ,0,0,0,4,19,23
04219200,ACE COSMETOLOGY & BARBERING TRAINING CEN,CT,06716-0000,Proprietary  ,0,5,5,1,9,10
04224200,BELLE ACADEMY OF COSMETOLOGY            ,CT,06704-0135,Proprietary  ,1,3,4,1,3,4
00146600,BARRY UNIVERSITY                        ,FL,33161-6695,Private      ,59,137,196,6919,11076,17995
00146601,BARRY UNIVERSITY - ORLANDO              ,FL,32807-3673,Private      ,6,21,27,521,2564,3085
00146700,BETHUNE COOKMAN UNIVERSITY              ,FL,32114-3099,Private      ,113,32,145,8220,2426,10646
00146800,ST THOMAS UNIVERSITY                    ,FL,33054-0000,Private      ,24,67,91,1969,3557,5526
00146900,FLORIDA INSTITUTE OF TECHNOLOGY         ,FL,32901-6988,Private      ,30,275,305,5216,9687,14903
00147000,BREVARD COMMUNITY COLLEGE               ,FL,32922-6503,Public       ,186,453,639,7585,12715,20300
00147100,COLLEGE OF CENTRAL FLORIDA              ,FL,34474-4415,Public       ,86,258,344,5612,10086,15698
00147200,CHIPOLA  COLLEGE                        ,FL,32446-2053,Public       ,27,36,63,1415,1866,3281
00147300,CLEARWATER CHRISTIAN COLLEGE            ,FL,33759-0000,Private      ,3,3,6,867,269,1136
00147500,DAYTONA STATE COLLEGE                   ,FL,32114-2800,Public       ,182,451,633,9744,16717,26461
00147700,EDISON STATE COLLEGE                    ,FL,33906-6210,Public       ,181,279,460,9304,12798,22102
00147800,EDWARD WATERS COLLEGE                   ,FL,32209-6199,Private      ,8,27,35,1488,1255,2743
00147900,EMBRY-RIDDLE AERONAUTICAL UNIV          ,FL,32114-3900,Private      ,50,491,541,8381,10785,19166
00148000,FLORIDA A & M UNIVERSITY                ,FL,32307-3100,Public       ,321,135,456,20106,10426,30532
00148100,FLORIDA ATLANTIC UNIVERSITY             ,FL,33431-6498,Public       ,538,338,876,31533,20333,51866
00148101,FLORIDA ATLANTIC UNIVERSITY/DAVIE       ,FL,33314-0000,Public       ,46,111,157,3231,6009,9240
00148103,FLORIDA ATLANTIC UNIV-JUPITER/PSL       ,FL,33458-0000,Public       ,18,33,51,1685,1865,3550
00148200,FLORIDA COLLEGE                         ,FL,33617-5578,Private      ,0,4,4,575,124,699
00148400,FLORIDA STATE COLLEGE AT JACKSONVILLE   ,FL,32202-4030,Public       ,253,936,1189,17032,34816,51848
00148500,FLORIDA KEYS COMMUNITY COLLEGE          ,FL,33040-4397,Public       ,16,35,51,803,1116,1919
00148600,FLORIDA MEMORIAL UNIVERSITY             ,FL,33054-6199,Private      ,46,37,83,3327,2179,5506
00148700,ECKERD COLLEGE                          ,FL,33711-4744,Private      ,9,32,41,3685,1516,5201
00148800,FLORIDA SOUTHERN COLLEGE                ,FL,33801-5698,Private      ,13,57,70,4650,1819,6469
00148900,FLORIDA STATE UNIVERSITY                ,FL,32306-2430,Public       ,656,318,974,61748,22371,84119
00149000,GULF COAST COMMUNITY COLLEGE            ,FL,32401-1058,Public       ,34,150,184,3335,6532,9867
00149300,INDIAN RIVER STATE COLLEGE              ,FL,34981-5596,Public       ,193,467,660,8334,13416,21750
00149500,JACKSONVILLE UNIVERSITY                 ,FL,32211-3394,Private      ,38,183,221,4601,5528,10129
00149700,JONES COLLEGE                           ,FL,32211-5588,Private      ,6,21,27,178,1274,1452
00149900,EVEREST UNIVERSITY                      ,FL,32810-5601,Proprietary  ,19,147,166,844,5361,6205
00149901,EVEREST UNIVERSITY - ORLANDO SOUTH      ,FL,32819-7666,Proprietary  ,404,3981,4385,5282,55845,61127
00149902,EVEREST UNIVERSITY - MELBOURNE          ,FL,32905-6609,Proprietary  ,12,94,106,220,1747,1967
00150000,BROWARD COLLEGE- DOWNTOWN CTR           ,FL,33301-2298,Public       ,251,618,869,8358,16258,24616
00150001,BROWARD COLLEGE - DAVIE CAMPUS          ,FL,33314-0000,Public       ,236,396,632,12642,15356,27998
00150002,BROWARD COLLEGE- NORTH CAMPUS           ,FL,33066-0000,Public       ,139,329,468,8364,13320,21684
00150003,BROWARD COLLEGE- SOUTH CAMPUS           ,FL,33024-0000,Public       ,171,359,530,9257,13088,22345
00150100,FLORIDA GATEWAY COLLEGE                 ,FL,32025-2007,Public       ,41,97,138,1546,3420,4966
00150200,LAKE SUMTER COMMUNITY COLLEGE           ,FL,34788-8751,Public       ,41,80,121,3002,3941,6943
00150400,"STATE COLLEGE OF FLORIDA, MANATEE-SARASO",FL,34207-3596,Public       ,96,214,310,5961,8966,14927
00150500,LYNN UNIVERSITY                         ,FL,33431-5598,Private      ,15,21,36,2703,1303,4006
00150600,MIAMI DADE COLLEGE ADMINISTRATION ONLY  ,FL,33176-3393,Public       ,23,30,53,857,1211,2068
00150601,MIAMI DADE COLLEGE - NORTH CAMPUS       ,FL,33167-3495,Public       ,332,550,882,15463,20346,35809
00150602,MIAMI DADE COLLEGE - KENDALL CAMPUS     ,FL,33176-3393,Public       ,476,556,1032,21913,20122,42035
00150603,MIAMI DADE COLLEGE - WOLFSON CAMPUS     ,FL,33132-2297,Public       ,324,410,734,12333,14550,26883
00150604,MIAMI DADE COLLEGE - MEDICAL CAMPUS     ,FL,33127-4693,Public       ,98,221,319,3873,8752,12625
00150605,MIAMI DADE COLLEGE - HOMESTEAD CAMPUS   ,FL,33030-6009,Public       ,93,137,230,3362,4786,8148
00150606,MIAMI DADE COLLEGE -INTERAMERICAN CAMPUS,FL,33135-0000,Public       ,146,267,413,4804,9381,14185
00150607,MIAMI DADE COLLEGE - HIALEAH CAMPUS     ,FL,33012-2918,Public       ,97,166,263,4683,6180,10863
00150800,NORTH FLORIDA COMMUNITY COLLEGE         ,FL,32340-1699,Public       ,11,30,41,705,1181,1886
00150900,NOVA SOUTHEASTERN UNIVERSITY            ,FL,33314-7796,Private      ,73,584,657,7937,36780,44717
00151000,NORTHWEST FLORIDA STATE COLLEGE         ,FL,32578-1295,Public       ,42,188,230,2785,6176,8961
00151200,PALM BEACH COMMUNITY COLLEGE            ,FL,33461-4796,Public       ,281,519,800,17141,20408,37549
00151300,PENSACOLA STATE COLLEGE                 ,FL,32504-8998,Public       ,115,358,473,6121,12180,18301
00151400,POLK STATE COLLEGE                      ,FL,33881-4256,Public       ,110,274,384,6133,10171,16304
00151500,ROLLINS COLLEGE                         ,FL,32789-4499,Private      ,13,31,44,3927,1748,5675
00151900,SANTA FE COLLEGE                        ,FL,32606-6200,Public       ,170,290,460,11935,11900,23835
00152000,SEMINOLE STATE COLLEGE OF FLORIDA       ,FL,32773-6199,Public       ,173,445,618,11899,19061,30960
00152100,SOUTHEASTERN UNIVERSITY                 ,FL,33801-6099,Private      ,15,29,44,3197,1818,5015
00152200,SOUTH FLORIDA COMMUNITY COLLEGE         ,FL,33825-9399,Public       ,32,82,114,1782,2665,4447
00152300,SAINT JOHNS RIVER STATE COLLEGE         ,FL,32177-3897,Public       ,56,117,173,3547,5636,9183
00152600,SAINT LEO UNIVERSITY                    ,FL,33574-6665,Private      ,32,475,507,4392,18276,22668
00152800,ST. PETERSBURG COLLEGE                  ,FL,33760-3768,Public       ,196,675,871,12592,29086,41678
00153100,STETSON UNIVERSITY                      ,FL,32723-3761,Private      ,25,26,51,5366,1296,6662
00153101,STETSON UNIVERSITY - COLLEGE OF LAW     ,FL,33707-3299,Private      ,3,11,14,165,2097,2262
00153300,TALLAHASSEE COMMUNITY COLLEGE           ,FL,32304-2895,Public       ,241,333,574,13342,12162,25504
00153400,EVEREST UNIVERSITY                      ,FL,33614-5801,Proprietary  ,22,170,192,769,5884,6653
00153408,EVEREST UNIVERSITY - TAMPA BRANDON CAMPU,FL,33619-1354,Proprietary  ,24,291,315,1166,14477,15643
00153409,EVEREST UNIVERSITY - ORANGE PARK        ,FL,32073-1111,Proprietary  ,17,109,126,203,1697,1900
00153500,UNIVERSITY OF FLORIDA                   ,FL,32611-3150,Public       ,601,288,889,58092,23828,81920
00153600,UNIVERSITY OF MIAMI                     ,FL,33146-6531,Private      ,102,107,209,25827,7917,33744
00153601,UNIV OF MIAMI SCHOOL OF LAW             ,FL,33124-0000,Private      ,4,4,8,242,2855,3097
00153602,UNIV OF MIAMI-SCH OF MEDICINE           ,FL,33136-0000,Private      ,18,26,44,1335,2294,3629
00153700,UNIVERSITY OF SOUTH FLORIDA             ,FL,33620-6960,Public       ,531,362,893,50034,30162,80196
00153701,UNIV OF SOUTH FLORIDA-ST PETERSBURG     ,FL,33701-0000,Public       ,106,86,192,5354,4895,10249
00153702,UNIV OF SOUTH FLORIDA-SARASOTA          ,FL,34243-2025,Public       ,15,38,53,1311,2590,3901
00153705,UNIV OF SOUTH FLORIDA                   ,FL,33803-0000,Public       ,17,30,47,1783,2381,4164
00153706,UNIV OF SOUTH FLORIDA- MEDICINE         ,FL,33612-0000,Public       ,29,31,60,2078,2666,4744
00153800,UNIVERSITY OF TAMPA                     ,FL,33606-1490,Private      ,58,69,127,13775,4656,18431
00154000,WEBBER INTERNATIONAL UNIVERSITY         ,FL,33827-0096,Private      ,7,3,10,1415,436,1851
00173308,NATIONAL-LOUIS UNIVERSITY               ,FL,33609-0000,Private      ,2,6,8,17,150,167
00177201,TRINITY INTERNATIONAL UNIVERSITY - SOUTH,FL,33324-4611,Private      ,1,8,9,79,640,719
00395400,UNIV OF CENTRAL FLORIDA                 ,FL,32816-0001,Public       ,1102,465,1567,80220,38356,118576
00395500,UNIVERSITY OF WEST FLORIDA              ,FL,32514-5750,Public       ,95,211,306,13481,9554,23035
00407215,NORTHWOOD UNIVERSITY                    ,FL,33409-0000,Private      ,6,22,28,701,692,1393
00491004,KAPLAN CAREER INSTITUTE - KAPLAN COLLEGE,FL,33026-3978,Proprietary  ,1,19,20,186,2027,2213
00491005,KAPLAN COLLEGE JACKSONVILLE             ,FL,32216-3216,Proprietary  ,13,169,182,312,3362,3674
00558500,LIVELY TECHNICAL CENTER                 ,FL,32304-0000,Public       ,17,38,55,864,2890,3754
00558600,LINDSEY HOPKINS TECHNICAL ED CENTER     ,FL,33127-4692,Public       ,25,85,110,361,1476,1837
00559400,D G ERWIN TECHNICAL CENTER              ,FL,33610-8255,Public       ,27,107,134,866,3087,3953
00560500,PINELLAS TECH ED CTR-CLEARWATER         ,FL,33760-2194,Public       ,12,59,71,464,2168,2632
00560700,SARASOTA COUNTY TECHNICAL INSTITUTE     ,FL,34233-0000,Public       ,1,22,23,367,1239,1606
00560800,MAYNARD A. TRAVISS CAREER CENTER        ,FL,33803-9709,Public       ,6,32,38,567,1848,2415
00561200,MANATEE TECHNICAL INSTITUTE             ,FL,34210-0000,Public       ,4,20,24,610,1955,2565
00561201,MANATEE TECHNICAL INSTITUTE-EAST        ,FL,34211-0000,Public       ,5,16,21,371,1212,1583
00675000,VALENCIA COMMUNITY COLLEGE              ,FL,32802-3028,Public       ,508,765,1273,35913,37323,73236
00732910,ITT TECHNICAL INSTITUTE                 ,FL,33634-7515,Proprietary  ,79,396,475,1241,4911,6152
00732947,ITT TECHNICAL INSTITUTE                 ,FL,32746-1607,Proprietary  ,49,307,356,793,3310,4103
00736206,MEDTECH COLLEGE - MEDTECH INSTITUTE - OR,FL,32826-4906,Proprietary  ,8,61,69,16,100,116
00752500,SUWANNEE-HAMILTON AREA VOC TECH CTR     ,FL,32060-0000,Public       ,0,2,2,99,405,504
00752600,WASHINGTON HOLMES TECHNICAL CENTER      ,FL,32428-1699,Public       ,5,16,21,180,694,874
00755800,LEE COUNTY HIGH TECH CENTER CENTRAL     ,FL,33916-2299,Public       ,9,20,29,620,1575,2195
00758600,REMINGTON COLLEGE - TAMPA CAMPUS        ,FL,33612-8410,Private      ,8,55,63,293,1394,1687
00787000,HILLSBOROUGH COMMUNITY COLLEGE          ,FL,33606-3572,Public       ,226,575,801,19198,28329,47527
00789300,FLAGLER COLLEGE                         ,FL,32085-1027,Private      ,15,10,25,5290,1199,6489
00789301,FLAGLER COLLEGE - TALLAHASSEE COMMUNITY ,FL,32304-2895,Private      ,7,26,33,603,1173,1776
00807500,ST JOHN VIANNEY COLLEGE SEMINARY        ,FL,33165-3244,Private      ,1,2,3,53,38,91
00814600,EVEREST UNIVERSITY - POMPANO BEACH      ,FL,33062-2522,Proprietary  ,28,290,318,626,5694,6320
00822300,ST VINCENT DE PAUL REGIONL SEMINARY     ,FL,33436-0000,Private      ,0,0,0,9,40,49
00841700,STENOTYPE INST OF JACKSONVILLE          ,FL,32207-0000,Proprietary  ,4,16,20,78,645,723
00869410,RASMUSSEN COLLEGE - OCALA               ,FL,34471-7051,Proprietary  ,29,275,304,959,7624,8583
00869411,RASMUSSEN COLLEGE - NEW PORT RICHEY     ,FL,34690-4554,Proprietary  ,3,40,43,312,1676,1988
00869413,RASMUSSEN COLLEGE - FORT MYERS          ,FL,33905-7805,Proprietary  ,6,46,52,485,2004,2489
00869420,RASMUSSEN COLLEGE - TAMPA               ,FL,33610-9558,Proprietary  ,6,38,44,248,1097,1345
00869422,RASMUSSEN COLLEGE - PASCO               ,FL,33558-0000,Proprietary  ,3,17,20,80,490,570
00884800,WARNER UNIVERSITY                       ,FL,33859-8725,Private      ,7,39,46,808,1026,1834
00884900,PALM BEACH ATLANTIC UNIVERSITY          ,FL,33401-6505,Private      ,37,62,99,4003,3437,7440
00887800,MIAMI INTERNATIONAL UNIV ART&DESIGN     ,FL,33132-1418,Proprietary  ,25,50,75,3743,3643,7386
00910400,RIVERSIDE HAIRSTYLING ACADEMY           ,FL,32207-3810,Proprietary  ,3,7,10,35,157,192
00963500,FLORIDA INTERNATIONAL UNIVERSITY        ,FL,33199-0001,Public       ,1087,575,1662,45249,36781,82030
00984100,UNIVERSITY OF NORTH FLORIDA             ,FL,32224-2645,Public       ,319,205,524,20376,12716,33092
00990200,SHERIDAN TECHNICAL CENTER               ,FL,33021-3399,Public       ,31,108,139,807,3086,3893
01016100,"LORAINE'S ACADEMY, INC                  ",FL,33710-0000,Proprietary  ,8,26,34,72,384,456
01019500,ART INSTITUTE OF FT LAUDERDALE          ,FL,33316-3000,Proprietary  ,23,32,55,2479,2833,5312
01065200,PASCO-HERNANDO COMMUNITY CLG            ,FL,34654-5199,Public       ,116,267,383,5961,9637,15598
01072401,CARLOS ALBIZU UNIVERSITY                ,FL,33172-0000,Private      ,4,29,33,158,1508,1666
01082600,TOM P. HANEY TECHNICAL CENTER           ,FL,32405-5099,Public       ,2,17,19,370,1636,2006
01112700,GOODING INST OF NUR ANES BAY MED CT     ,FL,32401-0000,Proprietary  ,0,5,5,22,202,224
01226300,ATLANTIC TECHNICAL CENTER               ,FL,33063-3902,Public       ,12,53,65,630,2209,2839
01254400,FIRST COAST TECHNICAL COLLEGE           ,FL,32084-1921,Public       ,16,30,46,499,1421,1920
01257400,RINGLING SCHOOL OF ART AND DESIGN       ,FL,34234-5895,Private      ,5,3,8,2356,553,2909
01303904,SOUTH UNIVERSITY - WEST PALM BEACH CAMPU,FL,33409-5149,Proprietary  ,29,144,173,657,2603,3260
01323400,LORENZO WALKER INST OF TECHNOLOGY       ,FL,34104-4405,Public       ,10,23,33,357,928,1285
02089600,CONCORDE CAREER INSTITUTE               ,FL,32211-0000,Proprietary  ,24,100,124,412,2105,2517
02106602,AMERICAN INSTITUTE - AMERICAN INSTITUTE ,FL,34747-5161,Proprietary  ,0,0,0,19,369,388
02113609,AMERICAN INTERCONTINENTAL UNIV - WESTON ,FL,33326-3233,Proprietary  ,1,17,18,255,1096,1351
02115300,PINELLAS TECHNICAL EDUCATION CENTERS - S,FL,33711-0000,Public       ,9,75,84,553,2766,3319
02116006,SANFORD-BROWN INSTITUTE - FT. LAUDERDALE,FL,33309-1906,Proprietary  ,6,26,32,231,1029,1260
02121800,EVEREST INSTITUTE                       ,FL,33169-4759,Proprietary  ,26,142,168,433,1827,2260
02121801,EVEREST INSTITUTE  - HIALEAH            ,FL,33012-7193,Proprietary  ,4,6,10,100,309,409
02148200,FASHION FOCUS HAIR ACADEMY              ,FL,34231-0000,Proprietary  ,2,7,9,49,180,229
02148300,MANHATTAN BEAUTY SCHOOL                 ,FL,33611-0000,Proprietary  ,17,93,110,220,926,1146
02149900,PAUL MITCHELL THE SCHOOL-JACKSONVILLE   ,FL,32205-0000,Proprietary  ,17,29,46,360,794,1154
02151100,ATI COLLEGE OF HEALTH                   ,FL,33169-0000,Proprietary  ,0,0,0,234,946,1180
02151900,KEISER  UNIVERSITY                      ,FL,33309-0000,Private      ,201,1171,1372,5567,24959,30526
02156700,FLORIDA CHRISTIAN COLLEGE               ,FL,34744-0000,Private      ,3,7,10,536,432,968
02159600,BAPTIST COLLEGE OF FLORIDA (THE)        ,FL,32440-0000,Private      ,4,8,12,399,390,789
02172700,CONCORDE CAREER INSTITUTE               ,FL,33607-0000,Proprietary  ,12,73,85,306,1296,1602
02188900,HOBE SOUND BIBLE COLLEGE                ,FL,33475-0000,Private      ,1,3,4,78,107,185
02200100,BRADENTON BEAUTY & BARBER ACADEMY       ,FL,34209-0000,Proprietary  ,3,22,25,93,271,364
02215900,ATI CAREER TRAINING CENTER              ,FL,33309-1785,Proprietary  ,0,0,0,124,606,730
02218700,FLORIDA TECHNICAL COLLEGE               ,FL,32826-2707,Proprietary  ,105,348,453,1394,5070,6464
02218707,FLORIDA TECHNICAL COLLEGE - LAKELAND    ,FL,33813-2101,Proprietary  ,1,19,20,153,765,918
02218709,FLORIDA TECHNICAL COLLEGE - DELAND      ,FL,32720-7415,Proprietary  ,32,104,136,273,1348,1621
02228300,LAKE TECHNICAL CENTER                   ,FL,32726-0000,Public       ,10,25,35,524,1740,2264
02245500,FORTIS COLLEGE                          ,FL,32789-4679,Proprietary  ,5,30,35,166,1142,1308
02257900,INTERNATIONAL ACADEMY                   ,FL,32119-3541,Proprietary  ,10,41,51,122,449,571
02275100,CONCORDE CAREER INSTITUTE               ,FL,33025-0000,Proprietary  ,14,40,54,209,807,1016
02278800,SOUTHWEST FLORIDA COLLEGE               ,FL,33907-0000,Proprietary  ,29,118,147,673,2504,3177
02278801,SOUTHWEST FLORIDA COLLEGE - TAMPA       ,FL,33619-1344,Proprietary  ,9,33,42,529,1310,1839
02278802,SOUTHWEST FLORIDA COLLEGE - INSTITUTUE O,FL,33928-9469,Proprietary  ,3,7,10,45,140,185
02278803,SOUTHWEST FLORIDA COLLEGE - PORT CHARLOT,FL,33953-3100,Proprietary  ,16,36,52,215,955,1170
02279600,CORTIVA INSTITUTE - FLORIDA             ,FL,33781-0000,Proprietary  ,0,4,4,64,213,277
02280800,NEW ENGLAND INST TECH-PALM BEACH        ,FL,33407-0000,Proprietary  ,16,41,57,466,1260,1726
02283800,BEAUTY SCHOOLS OF AMERICA               ,FL,33012-3322,Proprietary  ,84,489,573,712,3967,4679
02286502,ITT TECHNICAL INSTITUTE                 ,FL,32244-6630,Proprietary  ,0,0,0,0,2,2
02287100,LA BELLE BEAUTY SCHOOL                  ,FL,33012-3224,Proprietary  ,11,51,62,68,302,370
02293200,ATI CAREER TRAINING CENTER              ,FL,33309-5916,Proprietary  ,0,0,0,177,787,964
02293201,ATI CAREER TRAINING CENTER - MIAMI      ,FL,33122-1707,Proprietary  ,0,0,0,188,618,806
02293600,ADVANCED TECHNICAL CENTERS              ,FL,33266-1597,Private      ,0,6,6,52,153,205
02297000,CHARLOTTE TECHNICAL CENTER              ,FL,33948-0000,Public       ,3,8,11,258,833,1091
02300900,WITHLACOOCHEE TECHNICAL INSTITUTE       ,FL,34450-0000,Public       ,5,15,20,283,916,1199
02305700,FORTIS COLLEGE                          ,FL,33619-1283,Proprietary  ,2,9,11,151,797,948
02305800,FLORIDA CAREER COLLEGE                  ,FL,33012-7028,Proprietary  ,233,829,1062,2220,8124,10344
02305810,FLORIDA CAREER COLLEGE - CLEARWATER     ,FL,33759-3924,Proprietary  ,2,9,11,139,603,742
02307400,GEORGE STONE AREA VOCATIONAL TECHNICAL  ,FL,32526-0000,Public       ,12,37,49,458,1905,2363
02314100,SCHILLER INTERNATIONAL UNIVERSITY       ,FL,33770-0000,Proprietary  ,1,11,12,71,380,451
02316200,MIAMI LAKES TECHNICAL EDUCATION CTR     ,FL,33014-0000,Public       ,42,123,165,522,1815,2337
02321200,ORANGE TECH EDUC CTR- WESTSIDE TECH     ,FL,34787-0000,Public       ,8,12,20,320,1049,1369
02325100,KEY COLLEGE                             ,FL,33004-3046,Proprietary  ,0,5,5,20,113,133
02326303,MEDVANCE INSTITUTE - WEST PALM          ,FL,33461-2171,Proprietary  ,10,37,47,244,787,1031
02326306,MEDVANCE INSTITUTE - MIAMI              ,FL,33173-3431,Proprietary  ,1,22,23,107,400,507
02326800,MERIDIAN COLLEGE                        ,FL,34240-8478,Proprietary  ,2,26,28,67,397,464
02326801,MERIDIAN CAREER INSTITUTE -             ,FL,33619-1378,Proprietary  ,0,0,0,14,38,52
02326900,SUNSTATE ACADEMY OF HAIR DESIGN         ,FL,33907-1415,Proprietary  ,23,48,71,242,664,906
02329900,FLORIDA INSTITUTE OF ULTRASOUND         ,FL,32514-0000,Proprietary  ,2,11,13,162,622,784
02338400,FT PIERCE BEAUTY ACADEMY                ,FL,34982-0000,Proprietary  ,9,38,47,111,466,577
02346200,WYOTECH                                 ,FL,32174-1010,Proprietary  ,4,9,13,645,1397,2042
02362100,FULL SAIL UNIVERSITY                    ,FL,32792-0000,Proprietary  ,378,1289,1667,18321,34646,52967
02499000,ACADEMY OF COSMETOLOGY                  ,FL,32953-3311,Proprietary  ,4,9,13,82,305,387
02501500,"O*TEC, MID-FLORIDA TECH                 ",FL,32809-0000,Public       ,11,65,76,726,2302,3028
02502702,ADVANCED CAREER TRAINING-JACKSONVIL     ,FL,32256-0000,Proprietary  ,4,13,17,109,460,569
02504600,WINTER PARK TECH                        ,FL,32789-0000,Public       ,7,14,21,194,966,1160
02508900,TALMUDIC COLLEGE OF FLORIDA             ,FL,33139-0000,Private      ,5,1,6,58,37,95
02511700,RIDGE TECHNICAL CENTER                  ,FL,33881-0000,Public       ,6,23,29,443,1505,1948
02513200,ORLANDO TECHNICAL CENTER                ,FL,32801-0000,Public       ,11,42,53,703,2284,2987
02515400,CITY COLLEGE                            ,FL,33309-3073,Private      ,33,137,170,573,2963,3536
02517100,SARASOTA SCHOOL OF MASSAGE THERAPY      ,FL,34243-6130,Proprietary  ,1,10,11,49,215,264
02524000,SUNSTATE ACADEMY OF HAIR DESIGN         ,FL,34624-0000,Proprietary  ,11,27,38,124,355,479
02524200,ROBERT MORGAN EDUCATIONAL CENTER        ,FL,33177-0000,Public       ,40,64,104,565,1418,1983
02531803,PAUL MITCHELL THE SCHOOL - ORLANDO      ,FL,32765-6444,Proprietary  ,7,5,12,7,5,12
02531805,PAUL MITCHELL THE SCHOOL -TAMPA         ,FL,33613-0000,Proprietary  ,7,9,16,7,12,19
02547600,FLORIDA NATIONAL COLLEGE                ,FL,33012-0000,Proprietary  ,72,266,338,995,3614,4609
02554200,RADFORD LOCKLIN TECH CENTER             ,FL,32570-0000,Public       ,1,3,4,116,418,534
02573200,LA BELLE BEAUTY ACADEMY                 ,FL,33135-0000,Proprietary  ,10,48,58,126,528,654
02597100,HERITAGE INSTITUTE                      ,FL,33912-7132,Proprietary  ,36,95,131,455,1368,1823
02598200,SOUTHERN CAREER COLLEGE                 ,FL,32211-0000,Proprietary  ,3,17,20,79,476,555
02599800,EVEREST UNIVERSITY                      ,FL,33770-2556,Proprietary  ,4,56,60,156,1230,1386
02599801,EVEREST UNIVERSITY - TAMPA LAKELAND CAMP,FL,33801-3801,Proprietary  ,8,97,105,225,1672,1897
02599805,EVEREST UNIVERSITY - JACKSONVILLE       ,FL,32256-0000,Proprietary  ,23,86,109,427,2639,3066
02601600,HENRY W BREWSTER TECHNICAL CENTER       ,FL,33602-0000,Public       ,7,35,42,242,1033,1275
02612700,"SALON PROFESSIONAL ACADEMY - MELBOURNE, ",FL,32904-3919,Proprietary  ,4,8,12,108,274,382
02616400,SANFORD-BROWN INSTITUTE                 ,FL,32256-3520,Proprietary  ,8,23,31,282,1540,1822
02616401,SANFORD-BROWN INSTITUTE - TAMPA         ,FL,33610-8304,Proprietary  ,3,17,20,244,1027,1271
02616705,LE CORDON BLEU COLLEGE OF CULINARY ARTS ,FL,33025-3929,Proprietary  ,5,20,25,320,1292,1612
03003200,EVEREST INSTITUTE                       ,FL,33186-1410,Proprietary  ,12,75,87,357,1257,1614
03003201,EVEREST INSTITUTE - FT. LAUDERDALE      ,FL,33304-2522,Proprietary  ,0,0,0,56,258,314
03003600,MCFATTER TECHNICAL CENTER               ,FL,33317-7499,Public       ,13,46,59,601,1836,2437
03008600,FLORIDA COLLEGE OF NATURAL HEALTH       ,FL,33064-1342,Proprietary  ,17,53,70,339,1256,1595
03010608,VIRGINIA COLLEGE - PENSACOLA            ,FL,32501-5650,Proprietary  ,15,62,77,239,1665,1904
03010612,VIRGINIA COLLEGE - GOLF ACADEMY OF AMERI,FL,32701-0000,Proprietary  ,1,4,5,118,261,379
03010618,VIRGINIA COLLEGE - JACKSONVILLE         ,FL,32207-5167,Proprietary  ,7,29,36,210,1141,1351
03012300,ASM BEAUTY WORLD ACADEMY                ,FL,33021-0000,Proprietary  ,4,28,32,51,271,322
03018500,BENE'S INTERNATIONAL SCHOOL OF BEAUTY   ,FL,34652-1637,Proprietary  ,7,21,28,125,457,582
03028200,TRINITY COLLEGE OF FLORIDA              ,FL,34655-4401,Private      ,2,4,6,177,220,397
03031400,INTERNATIONAL ACADEMY OF DESIGN AND TECH,FL,33634-6313,Proprietary  ,43,220,263,1543,5424,6967
03031402,INTERNATIONAL ACADEMY OF DESIGN AND TECH,FL,32809-4613,Proprietary  ,15,27,42,657,1162,1819
03031403,IADT - ORLANDO CULINARY ACADEMY         ,FL,32819-0000,Proprietary  ,2,12,14,383,790,1173
03035800,HERITAGE INSTITUTE                      ,FL,32216-0948,Proprietary  ,15,57,72,152,847,999
03035900,NATIONAL AVIATION ACADEMY               ,FL,33760-3931,Proprietary  ,42,43,85,466,1113,1579
03037500,HODGES UNIVERSITY                       ,FL,34119-7932,Private      ,46,258,304,850,4765,5615
03054200,FORTIS COLLEGE                          ,FL,33144-2373,Proprietary  ,1,6,7,218,425,643
03071600,COLLEGE OF BUSINESS & TECHNOLOGY        ,FL,33176-0000,Proprietary  ,13,107,120,403,1923,2326
03076402,BRYMAN SCHOOL OF ARIZONA (THE) - ANTHEM ,FL,32803-3509,Proprietary  ,17,72,89,87,317,404
03079800,GEORGE T BAKER AVIATION                 ,FL,33142-5687,Public       ,11,14,25,445,675,1120
03079900,CITY COLLEGE                            ,FL,32707-0000,Private      ,9,47,56,110,655,765
03089200,NOUVELLE INSTITUTE                      ,FL,33125-4141,Proprietary  ,6,49,55,60,526,586
03096300,FORTIS INSTITUTE                        ,FL,33860-0000,Proprietary  ,5,26,31,51,229,280
03100800,TAYLOR TECHNICAL INSTITUTE              ,FL,32348-0894,Public       ,1,9,10,65,285,350
03101900,TRINITY BAPTIST COLLEGE                 ,FL,32221-1398,Private      ,3,7,10,303,321,624
03103900,MARION COUNTY COMMUNITY TECH & ADUL     ,FL,34474-3172,Public       ,11,26,37,428,1811,2239
03108500,EVERGLADES UNIVERSITY                   ,FL,33431-0000,Private      ,12,108,120,274,2160,2434
03108600,COM-PU-MED VOCATIONAL CAREERS           ,FL,33012-4861,Proprietary  ,12,98,110,75,520,595
03113400,ACADEMY OF HEALING ARTS                 ,FL,33463-2113,Proprietary  ,4,9,13,52,221,273
03114700,PRAXIS INSTITUTE                        ,FL,33135-2657,Proprietary  ,2,50,52,35,378,413
03115500,ADVENTIST UNIVERSITY OF HEALTH SCIENCES ,FL,32803-1237,Private      ,13,51,64,1953,4338,6291
03123900,KEISER CAREER COLLEGE                   ,FL,33413-0000,Proprietary  ,25,91,116,458,1922,2380
03125600,MIAMI AD SCHOOL                         ,FL,33139-5203,Proprietary  ,1,8,9,109,478,587
03127900,TECHNICAL EDUCATION CTR OSCEOLA         ,FL,34744-4459,Public       ,9,13,22,464,1492,1956
03158300,LEE COUNTY HIGH TECH CENTER NORTH       ,FL,33993-2479,Public       ,1,10,11,238,746,984
03171300,UNIVERSITY OF ST. AUGUSTINE FOR HEALTH S,FL,32084-4215,Proprietary  ,1,46,47,132,1904,2036
03178400,CORAL RIDGE NURSES ASST TRAINING        ,FL,33306-0000,Proprietary  ,0,6,6,33,151,184
03224300,NEW PROFESSIONS TECHNICAL INSTITUTE     ,FL,33134-1640,Proprietary  ,19,126,145,133,960,1093
03230300,CHOICE HIGH SCHOOL AND TECHNICAL CENTER ,FL,32547-1299,Public       ,1,12,13,137,811,948
03238300,FLORIDA COLLEGE OF INTEGRATIVE MED      ,FL,32809-5721,Proprietary  ,0,9,9,158,588,746
03255300,FLORIDA GULF COAST UNIVERSITY           ,FL,33965-6565,Public       ,183,99,282,18435,7000,25435
03256300,YESHIVA GEDOLAH RABBINICAL COLLEGE      ,FL,33139-4708,Private      ,3,1,4,41,18,59
03264300,SOUTH FLORIDA BIBLE COLLEGE AND THEOLOGI,FL,33441-5768,Private      ,1,3,4,21,121,142
03346300,ACAD FOR PRAC NURSING & HEALTH OCCP     ,FL,33417-4574,Private      ,10,53,63,330,1452,1782
03348400,PROFESSIONAL TRAINING CENTERS           ,FL,33184-0000,Proprietary  ,22,83,105,160,749,909
03373300,BEACON COLLEGE                          ,FL,34748-5224,Private      ,1,4,5,213,143,356
03374300,FLORIDA COASTAL SCHOOL OF LAW           ,FL,32256-0000,Proprietary  ,2,11,13,98,3428,3526
03382300,BRADFORD-UNION AREA CAREERTECHNICAL CENT,FL,32091-2434,Public       ,1,6,7,71,385,456
03390300,LINCOLN TECHNICAL INSTITUTE             ,FL,32730-2351,Proprietary  ,11,23,34,161,684,845
03411400,INTERNATIONAL TRAINING CAREERS          ,FL,33155-1462,Private      ,10,28,38,82,479,561
03414500,ACUPUNCTURE AND MASSAGE COLLEGE         ,FL,33176-1509,Proprietary  ,3,14,17,102,466,568
03425400,CENTRAL FLORIDA INSTITUTE               ,FL,34684-4436,Proprietary  ,6,19,25,211,834,1045
03429600,ATLANTIC INST OF ORIENTAL MEDICINE      ,FL,33316-0000,Private      ,1,5,6,31,284,315
03429700,EAST WEST COLLG OF NATURAL MEDICINE     ,FL,34236-4959,Proprietary  ,2,5,7,34,254,288
03433400,NEW CONCEPT MASSAGE AND BEAUTY SCHO     ,FL,33135-0000,Proprietary  ,2,12,14,27,164,191
03434300,FORTIS COLLEGE                          ,FL,32073-2999,Proprietary  ,13,61,74,205,909,1114
03480301,MEDVANCE INSTITUTE - FORT LAUDERDALE    ,FL,33313-7261,Proprietary  ,6,18,24,97,403,500
03480302,MEDVANCE INSTITUTE - STUART             ,FL,34994-3000,Proprietary  ,9,35,44,185,841,1026
03491400,AMERICAN ADVANCED TECHNICIANS INST      ,FL,33014-4430,Proprietary  ,4,27,31,61,260,321
03549300,ULTIMATE MEDICAL ACADEMY                ,FL,33756-4917,Proprietary  ,203,2065,2268,1844,21198,23042
03553300,KEISER CAREER COLLEGE                   ,FL,32216-0000,Proprietary  ,12,62,74,447,1797,2244
03557300,NORTH FLORIDA COSMETOLOGY INSTITUTE     ,FL,32312-0000,Proprietary  ,4,19,23,166,593,759
03564300,"INTERNATIONAL SCHOOL OF HEALTH, BEAUTY &",FL,33311-1141,Proprietary  ,8,23,31,67,421,488
03570400,ENGLISH CENTER (THE)                    ,FL,33133-2703,Public       ,0,5,5,42,425,467
03595400,ANGLEY COLLEGE                          ,FL,32720-4257,Proprietary  ,0,0,0,1,4,5
03611400,FLORIDA BARBER ACADEMY                  ,FL,33441-0000,Proprietary  ,5,57,62,61,525,586
03618300,FLORIDA INSTITUTE OF ANIMAL ARTS        ,FL,32792-1740,Proprietary  ,13,18,31,205,375,580
03627400,JACKSONVILLE BEAUTY INSTITUTE           ,FL,32208-1885,Proprietary  ,6,41,47,114,484,598
03627600,FLORIDA EDUCATION INSTITUTE             ,FL,33144-5036,Proprietary  ,2,48,50,91,488,579
03661400,SOUTH FLORIDA INSTITUTE OF TECHNOLO     ,FL,33135-0000,Proprietary  ,25,198,223,225,1422,1647
03691400,AVE MARIA SCHOOL OF LAW                 ,FL,34119-1376,Private      ,0,5,5,78,817,895
03696400,SABER                                   ,FL,33134-1604,Private      ,7,57,64,75,677,752
03706300,AMERICAN INSTITUTE                      ,FL,33319-0000,Proprietary  ,16,39,55,106,369,475
03757300,ADVANCE SCIENCE INSTITUTE               ,FL,33012-0000,Proprietary  ,2,9,11,36,105,141
03801400,BEAUTY INSTITUTE (THE)                  ,FL,33409-2972,Proprietary  ,2,16,18,87,278,365
03801401,BEAUTY INSTITUTE (THE) - MARGATE        ,FL,33068-5704,Proprietary  ,1,1,2,36,111,147
03816300,ARTISTIC NAILS & BEAUTY ACADEMY         ,FL,33605-5919,Proprietary  ,12,56,68,206,744,950
03823300,FLORIDA ACADEMY OF HEALTH & BEAUTY      ,FL,33311-0000,Proprietary  ,0,9,9,20,71,91
03832300,DADE MEDICAL COLLEGE                    ,FL,33126-5534,Proprietary  ,30,279,309,945,4084,5029
03842500,CAMBRIDGE INSTITUTE OF ALLIED HEALTH    ,FL,32750-0000,Proprietary  ,2,42,44,75,384,459
03856300,UNIVERSAL BEAUTY SCHOOL                 ,FL,33174-4406,Proprietary  ,2,24,26,36,229,265
03856500,FLORIDA SCHOOL OF TRADITIONAL MIDWIFERY ,FL,32601-5507,Private      ,1,4,5,23,188,211
03875300,MCI INSTITUTE OF TECHNOLOGY             ,FL,33409-4937,Proprietary  ,15,70,85,173,666,839
03888300,DRAGON RISES COLLEGE OF ORIENTAL MEDICIN,FL,32601-5089,Proprietary  ,1,2,3,7,119,126
03903500,SOUTHERN TECHNICAL COLLEGE              ,FL,32809-0000,Proprietary  ,17,195,212,416,2433,2849
03906300,CAREER INSTITUTE OF FLORIDA             ,FL,33773-3434,Proprietary  ,0,1,1,24,129,153
03907301,PAUL MITCHELL THE SCHOOL FT MYERS       ,FL,33907-0000,Proprietary  ,5,7,12,5,10,15
03911300,TOTAL INTERNATIONAL CAREER INSTITUTE    ,FL,33012-0000,Proprietary  ,4,51,55,21,335,356
03939300,WOLFORD COLLEGE                         ,FL,34108-1931,Proprietary  ,2,6,8,44,370,414
03939400,CENTURA INSTITUTE                       ,FL,32807-3566,Proprietary  ,3,50,53,141,815,956
03939600,DAYTONA COLLEGE                         ,FL,32174-8445,Proprietary  ,3,30,33,153,610,763
03941300,AVE MARIA UNIVERSITY                    ,FL,34142-9505,Private      ,2,0,2,1205,251,1456
03957400,NEW COLLEGE OF FLORIDA                  ,FL,34243-2109,Public       ,4,9,13,2067,614,2681
03985300,COMMERCIAL DIVING ACADEMY               ,FL,32208-0000,Proprietary  ,6,15,21,437,1202,1639
03986300,AVIATOR COLLEGE OF AERONAUTICAL SCIENCE ,FL,34946-9022,Proprietary  ,1,4,5,102,256,358
04016500,AMERICAN INSTITUTE OF BEAUTY            ,FL,33773-0000,Proprietary  ,15,33,48,126,488,614
04029300,TRENDSETTERS OF FLORIDA SCHOOL OF BEAUTY,FL,32205-4737,Proprietary  ,5,7,12,42,199,241
04038302,ATA COLLEGE-ATA CAREER EDUCATION        ,FL,34606-4300,Proprietary  ,9,38,47,96,384,480
04083400,CAMBRIDGE INSTITUTE OF ALLIED HEALTH & T,FL,33484-6543,Proprietary  ,2,13,15,82,392,474
04105400,PENSACOLA SCHOOL OF MASSAGE THERAPY & HE,FL,32504-7337,Proprietary  ,2,12,14,85,452,537
04106300,PALM BEACH ACADEMY OF HEALTH & BEAUTY   ,FL,33403-2130,Proprietary  ,3,15,18,42,182,224
04116400,FUTURE-TECH INSTITUTE                   ,FL,33135-4142,Proprietary  ,1,53,54,40,226,266
04116600,TAYLOR COLLEGE                          ,FL,34420-8714,Proprietary  ,1,7,8,110,848,958
04119400,AVEDA INSTITUTE - SAINT PETERSBURG      ,FL,33701-4242,Proprietary  ,20,38,58,648,1196,1844
04120400,HI-TECH SCHOOL OF COSMETOLOGY           ,FL,33174-0000,Proprietary  ,7,9,16,115,196,311
04126900,ACADEMY OF CAREER TRAINING              ,FL,34741-4644,Proprietary  ,5,33,38,196,635,831
04127400,DIGITAL MEDIA ARTS COLLEGE              ,FL,33431-5919,Proprietary  ,3,6,9,407,342,749
04128400,MANAGEMENT RESOURCES INSTITUTE          ,FL,33126-5473,Proprietary  ,4,91,95,85,1327,1412
04129900,FLORIDA SCHOOL OF MASSAGE               ,FL,32608-5419,Proprietary  ,4,22,26,106,394,500
04130400,SHEAR EXCELLENCE INTERNATIONAL HAIR ACAD,FL,33614-2783,Proprietary  ,3,12,15,64,229,293
04131900,FASTTRAIN OF MIAMI                      ,FL,33134-1065,Proprietary  ,0,0,0,58,174,232
04132000,FASTTRAIN OF FORT LAUDERDALE            ,FL,33317-3127,Proprietary  ,0,0,0,21,121,142
04132100,FASTTRAIN OF TAMPA                      ,FL,33607-4153,Proprietary  ,0,0,0,21,150,171
04132200,FASTTRAIN OF JACKSONVILLE               ,FL,32256-4849,Proprietary  ,0,0,0,15,130,145
04133500,ACADEMY FOR FIVE ELEMENT ACUPUNCTURE    ,FL,32601-6811,Private      ,2,5,7,29,171,200
04133900,FUTURA CAREER INSTITUTE                 ,FL,33012-3325,Proprietary  ,8,34,42,31,188,219
04134800,AVEDA INSTITUTE - TALLAHASSEE           ,FL,32304-3186,Proprietary  ,39,48,87,461,783,1244
04134900,ORANGE PARK BEAUTY ACADEMY              ,FL,32073-5524,Proprietary  ,0,0,0,20,107,127
04135000,COZMO THE SCHOOL                        ,FL,34135-4810,Proprietary  ,1,14,15,26,107,133
04135900,ALLIED HEALTH INSTITUTE                 ,FL,33068-0000,Proprietary  ,6,99,105,115,1455,1570
04140800,NORTH FLORIDA ACADEMY                   ,FL,32065-7758,Proprietary  ,0,3,3,36,87,123
04143000,VOCATIONAL INSTITUTE OF FLORIDA         ,FL,33135-1939,Proprietary  ,0,2,2,42,214,256
04143100,PROFESSIONAL HANDS INSTITUTE            ,FL,33135-1939,Proprietary  ,0,5,5,16,97,113
04145900,CELEBRITY SCHOOL OF BEAUTY              ,FL,33144-4153,Proprietary  ,2,31,33,116,381,497
04146200,WALTON CAREER DEVELOPMENT CENTER        ,FL,32433-1557,Public       ,3,3,6,69,340,409
04146300,MARCHMAN TECHNICAL EDUCATION CENTER     ,FL,34653-1211,Public       ,5,13,18,206,479,685
04147800,ROSE TRAINING INSTITUTE                 ,FL,33881-4094,Proprietary  ,0,0,0,13,62,75
04148500,MEDICAL INSTITUTE OF PALM BEACH         ,FL,33460-5042,Proprietary  ,0,9,9,121,363,484
04150800,IMMOKALEE TECHNICAL CENTER              ,FL,34142-3146,Public       ,4,4,8,143,250,393
04151500,AMERICAN ACADEMY OF COSMETOLOGY         ,FL,32065-8026,Proprietary  ,5,17,22,60,189,249
04156300,UNIVERSITY OF FORT LAUDERDALE           ,FL,33313-5809,Private      ,1,3,4,70,190,260
04156400,AVIATION INSTITUTE OF MAINTENANCE       ,FL,32803-6487,Proprietary  ,21,63,84,312,821,1133
04157100,AEROSIM FLIGHT ACADEMY                  ,FL,32773-9683,Proprietary  ,2,10,12,113,284,397
04158300,FLAGLER TECHNICAL INSTITUTE             ,FL,32137-4714,Public       ,0,12,12,108,504,612
04162000,JOSE MARIA VARGAS UNIVERSITY            ,FL,33025-4534,Proprietary  ,0,8,8,32,176,208
04162500,HOLLYWOOD INSTITUTE OF BEAUTY CAREERS   ,FL,33020-4807,Proprietary  ,18,119,137,122,834,956
04163000,SALON PROFESSIONAL ACADEMY (THE)        ,FL,33624-6321,Proprietary  ,7,10,17,111,313,424
04163100,SALON PROFESSIONAL ACADEMY (THE)        ,FL,32607-1672,Proprietary  ,5,16,21,117,282,399
04163200,SALON PROFESSIONAL ACADEMY (THE)        ,FL,32162-9311,Proprietary  ,23,15,38,104,246,350
04164500,EUREKA INSTITUTE OF HEALTH AND BEAUTY   ,FL,33174-4205,Proprietary  ,0,11,11,30,150,180
04164600,D. A. DORSEY EDUCATIONAL CENTER         ,FL,33147-6304,Public       ,2,17,19,50,307,357
04167300,SALON PROFESSIONAL ACADEMY (THE)        ,FL,33904-4824,Proprietary  ,0,5,5,68,168,236
04170300,BEAUTY ACADEMY OF SOUTH FLORIDA         ,FL,33012-3221,Proprietary  ,8,44,52,53,244,297
04172300,ETERNITY COSMETOLOGY SCHOOL             ,FL,33415-5719,Proprietary  ,3,22,25,54,338,392
04173600,NOTTER SCHOOL OF PASTRY ARTS            ,FL,32809-7755,Proprietary  ,0,0,0,108,254,362
04176800,PROGRESSIVE TRAINING CENTERS            ,FL,33060-9238,Proprietary  ,0,0,0,9,96,105
04176900,AMERICAN HEALTH INSTITUTE               ,FL,34654-3743,Proprietary  ,3,11,14,54,228,282
04182500,MILLENNIA ATLANTIC UNIVERSITY           ,FL,33178-2369,Proprietary  ,2,2,4,34,83,117
04188300,FLORIDA ACADEMY                         ,FL,33966-1155,Proprietary  ,2,16,18,118,406,524
04192100,AMERICAN MEDICAL ACADEMY                ,FL,33186-4830,Proprietary  ,8,8,16,160,312,472
04195100,AMBIANCE BEAUTY & BARBER ACADEMY        ,FL,32935-8771,Proprietary  ,5,14,19,32,159,191
04197600,"FLORIDA INSTITUTE OF RECORDING, SOUND AN",FL,32804-3309,Proprietary  ,4,9,13,208,411,619
04206300,FLORIDA VOCATIONAL INSTITUTE            ,FL,33155-3762,Proprietary  ,1,24,25,25,203,228
04207900,SAE INSTITUTE OF TECHNOLOGY - MIAMI     ,FL,33160-4307,Proprietary  ,10,11,21,121,223,344
04209500,SHEAR FINESSE HAIRSTYLING ACADEMY       ,FL,32208-5005,Proprietary  ,0,11,11,2,33,35
04210800,ULTRASOUND MEDICAL INSTITUTE            ,FL,33462-4221,Proprietary  ,1,4,5,2,15,17
04213200,KAIZEN BEAUTY ACADEMY                   ,FL,33024-6609,Proprietary  ,1,1,2,5,10,15
04217800,BOCA BEAUTY ACADEMY                     ,FL,33434-4178,Proprietary  ,5,37,42,8,53,61
04221200,BLY'S SCHOOL OF COSMETOLOGY             ,FL,32601-4021,Proprietary  ,1,0,1,1,0,1
00160500,CHAMINADE UNIV OF HONOLULU              ,HI,96816-1578,Private      ,13,51,64,2569,2564,5133
00160600,BRIGHAM YOUNG UNIV-HAWAII CAMPUS        ,HI,96762-1294,Private      ,11,24,35,2482,1233,3715
00161000,UNIVERSITY OF HAWAII AT MANOA           ,HI,96822-2399,Public       ,30,61,91,15702,11001,26703
00161100,UNIVERSITY OF HAWAII AT HILO            ,HI,96720-4091,Public       ,16,23,39,4230,3453,7683
00161200,HONOLULU COMMUNITY COLLEGE              ,HI,96817-4598,Public       ,13,46,59,2978,3759,6737
00161300,KAPIOLANI COMMUNITY COLLEGE             ,HI,96816-4421,Public       ,21,62,83,4137,4686,8823
00161400,KAUAI COMMUNITY COLLEGE                 ,HI,96766-9591,Public       ,8,10,18,686,946,1632
00161500,UNIVERSITY OF HAWAII MAUI COLLEGE       ,HI,96732-1644,Public       ,12,38,50,1925,3763,5688
00454900,LEEWARD COMMUNITY COLLEGE               ,HI,96782-3393,Public       ,17,68,85,3305,4236,7541
00525800,HAWAII COMMUNITY COLLEGE                ,HI,96720-4075,Public       ,8,20,28,2091,3328,5419
00723401,HEALD COLLEGE - HONOLULU                ,HI,96814-0000,Proprietary  ,48,163,211,1208,2839,4047
00727900,HAWAII PACIFIC UNIVERSITY               ,HI,96813-2882,Private      ,13,108,121,6005,5053,11058
01122000,WINDWARD COMMUNITY COLLEGE              ,HI,96744-0000,Public       ,3,29,32,1174,1844,3018
02100300,MED-ASSIST SCHOOL OF HAWAII             ,HI,96813-0000,Proprietary  ,2,5,7,159,366,525
02107800,UNIVERSITY OF HAWAII - WEST OAHU        ,HI,96782-0000,Public       ,10,30,40,2167,2520,4687
02139500,HAWAII INSTITUTE OF HAIR DESIGN         ,HI,96817-5195,Proprietary  ,7,17,24,142,314,456
02159701,NEW HOPE CHRISTIAN COLLEGE - HAWAII     ,HI,96819-2228,Private      ,0,1,1,152,247,399
03017800,TRAVEL INSTITUTE OF THE PACIFIC         ,HI,96814-1946,Proprietary  ,4,12,16,95,284,379
03072500,WORLD MEDICINE INSTITUTE                ,HI,96826-0000,Private      ,1,4,5,65,179,244
03649300,HAWAII TECHNOLOGY INSTITUTE             ,HI,96813-3036,Private      ,0,0,0,115,196,311
03735300,INST OF CLINICAL ACUPUNCTURE & ORIENT MD,HI,96813-2307,Proprietary  ,0,0,0,13,122,135
03999400,TRADITIONAL CHINESE MEDICAL COLLEGE OF H,HI,96743-8324,Private      ,0,3,3,4,71,75
04165200,MAUNA LOA HELICOPTERS                   ,HI,96740-2650,Proprietary  ,0,2,2,22,85,107
04169600,HEISEI INTERNATIONAL INSTITUTE OF MASSAG,HI,96814-2254,Proprietary  ,0,0,0,5,16,21
04175100,PAUL MITCHELL THE SCHOOL HONOLULU       ,HI,96816-2433,Proprietary  ,9,10,19,197,301,498
04182200,HAWAII MEDICAL INSTITUTE                ,HI,96814-3518,Proprietary  ,16,30,46,331,700,1031
00161600,BOISE STATE UNIVERSITY                  ,ID,83725-1000,Public       ,27,164,191,15250,14888,30138
00161700,"COLLEGE OF IDAHO, THE                   ",ID,83605-4432,Private      ,0,5,5,1814,713,2527
00161900,COLLEGE OF SOUTHERN IDAHO               ,ID,83301-0000,Public       ,24,108,132,3996,5091,9087
00161908,COLLEGE OF WESTERN IDAHO                ,ID,83687-1515,Public       ,0,0,0,4079,7382,11461
00162000,IDAHO STATE UNIVERSITY                  ,ID,83209-5377,Public       ,29,106,135,6883,10472,17355
00162100,LEWIS-CLARK STATE COLLEGE               ,ID,83501-2698,Public       ,4,26,30,2692,3103,5795
00162300,NORTH IDAHO COLLEGE                     ,ID,83814-2199,Public       ,15,107,122,3633,5808,9441
00162400,NORTHWEST NAZARENE UNIVERSITY           ,ID,83686-5897,Private      ,1,39,40,1708,1833,3541
00162500,BRIGHAM YOUNG UNIVERSITY-IDAHO          ,ID,83460-1650,Private      ,191,291,482,14623,11128,25751
00162600,UNIVERSITY OF IDAHO                     ,ID,83844-4291,Public       ,13,68,81,10864,5460,16324
00732915,ITT TECHNICAL INSTITUTE                 ,ID,83713-1529,Proprietary  ,36,179,215,638,2320,2958
00987300,MR JUAN'S CLG OF HAIR DESIGN            ,ID,83301-4154,Proprietary  ,2,10,12,41,112,153
01113300,EASTERN IDAHO TECHNICAL COLLEGE         ,ID,83404-5788,Public       ,2,24,26,516,1466,1982
02218000,CARRINGTON COLLEGE                      ,ID,83704-0000,Proprietary  ,40,83,123,545,2108,2653
02234500,BOISE BIBLE COLLEGE                     ,ID,83714-1220,Private      ,1,4,5,263,199,462
02275800,MR LEONS SCHOOL OF HAIR DESIGN          ,ID,83843-8384,Proprietary  ,2,5,7,34,83,117
02275801,MR. LEON'S SCHOOL OF HAIR DESIGN        ,ID,83501-1910,Proprietary  ,1,2,3,19,35,54
02314000,SCHOOL OF HAIRSTYLING (THE)             ,ID,83202-0000,Proprietary  ,1,2,3,31,77,108
02319800,TONI&GUY HAIRDRESSING ACADEMY           ,ID,83814-2822,Proprietary  ,7,11,18,136,276,412
02319801,TONI&GUY HAIRDRESSING ACADEMY - BOISE   ,ID,83705-2636,Proprietary  ,1,2,3,1,2,3
02349200,HEADMASTERS SCHOOL OF HAIR DESIGN       ,ID,83501-0000,Proprietary  ,2,4,6,38,97,135
02559500,RAZZLE DAZZLE CLG OF HAIR DESIGN        ,ID,83686-5104,Proprietary  ,5,5,10,96,259,355
02607100,PAUL MITCHELL THE SCHOOL BOISE          ,ID,83709-1662,Proprietary  ,6,7,13,242,401,643
03098700,ACADEMY OF COURT REPORTING              ,ID,83704-8320,Proprietary  ,13,56,69,188,703,891
03832400,COSMETOLOGY SCHOOL OF ARTS & SCIENCES   ,ID,83318-1327,Proprietary  ,0,7,7,30,89,119
04051323,ART INSTITUTE OF PHOENIX (THE) - BROWN M,ID,83709-2746,Proprietary  ,0,5,5,105,279,384
04134300,EVANS HAIRSTYLING COLLEGE               ,ID,83440-5277,Proprietary  ,5,1,6,73,65,138
04144500,HAIR ACDMY PAUL MITCHELL PARTNER SCHOOL ,ID,83440-2600,Proprietary  ,2,4,6,126,160,286
04150600,D & L ACADEMY OF HAIR DESIGN            ,ID,83301-6229,Proprietary  ,1,1,2,33,88,121
04155200,OLIVER FINLEY ACADEMY OF COSMETOLOGY    ,ID,83704-8011,Proprietary  ,7,14,21,148,425,573
04163800,MASTER EDUCATORS BEAUTY SCHOOL          ,ID,83301-4118,Proprietary  ,0,0,0,61,97,158
04168600,COLLEGE OF MASSAGE THERAPY              ,ID,83221-1758,Proprietary  ,1,1,2,43,82,125
04176700,D'SHAW INSTITUTE OF COSMETOLOGY         ,ID,83704-4406,Proprietary  ,0,2,2,58,165,223
04194800,VELVET TOUCH ACADEMY OF COSMETOLOGY     ,ID,83687-5020,Proprietary  ,1,7,8,56,169,225
04203200,BOISE BARBER COLLEGE                    ,ID,83704-5919,Proprietary  ,3,7,10,43,161,204
04203500,AUSTIN KADE ACADEMY                     ,ID,83404-5540,Proprietary  ,6,16,22,107,290,397
04207200,ACADEMY DI FIRENZE                      ,ID,83338-2329,Proprietary  ,0,3,3,10,25,35
04211800,COLLEGE OF WESTERN IDAHO                ,ID,83687-5505,Public       ,39,220,259,1456,4441,5897
00163200,AQUINAS INSTITUTE OF THEOLOGY           ,MO,63108-3323,Private      ,0,1,1,10,111,121
00244900,AVILA COLLEGE                           ,MO,64145-1698,Private      ,7,34,41,1572,2208,3780
00245000,CALVARY BIBLE COLLEGE                   ,MO,64147-1341,Private      ,0,8,8,203,286,489
00245200,CENTRAL BIBLE COLLEGE                   ,MO,65803-1096,Private      ,0,5,5,448,407,855
00245300,CENTRAL METHODIST UNIVERSITY            ,MO,65248-1198,Private      ,4,54,58,1863,2321,4184
00245400,UNIVERSITY OF CENTRAL MISSOURI          ,MO,64093-5178,Public       ,24,158,182,10037,5823,15860
00245600,COLUMBIA COLLEGE                        ,MO,65216-4581,Private      ,54,820,874,3726,25942,29668
00245700,CONCORDIA SEMINARY                      ,MO,63105-3199,Private      ,1,7,8,9,490,499
00245800,COTTEY COLLEGE                          ,MO,64772-2790,Private      ,0,2,2,399,82,481
00245900,CROWDER COLLEGE                         ,MO,64850-9165,Public       ,72,131,203,2824,3989,6813
00246000,CULVER STOCKTON COLLEGE                 ,MO,63435-1299,Private      ,1,4,5,1123,227,1350
00246100,DRURY UNIVERSITY                        ,MO,65802-3791,Private      ,29,110,139,2878,4997,7875
00246200,EDEN THEOLOGICAL SEMINARY               ,MO,63119-0000,Private      ,1,1,2,5,143,148
00246300,EVANGEL UNIVERSITY                      ,MO,65802-2125,Private      ,4,27,31,2516,1145,3661
00246400,FONTBONNE UNIVERSITY                    ,MO,63105-3098,Private      ,3,34,37,1480,3101,4581
00246600,HARRIS-STOWE STATE COLLEGE              ,MO,63103-2199,Public       ,25,27,52,1885,2533,4418
00246700,CONCEPTION SEMINARY COLLEGE             ,MO,64433-0502,Private      ,0,2,2,69,16,85
00246800,JEFFERSON COLLEGE                       ,MO,63050-2441,Public       ,62,118,180,3192,4016,7208
00247100,ST LOUIS COMMUNITY COLLEGE              ,MO,63102-0000,Public       ,189,550,739,13846,22814,36660
00247300,KANSAS CITY ART INSTITUTE               ,MO,64111-1874,Private      ,4,8,12,1517,617,2134
00247400,KANSAS CITY UNIV OF MED AND BIOSCIENCES ,MO,64106-0000,Private      ,2,4,6,114,1256,1370
00247600,KENRICK-GLENNON SEMINARY                ,MO,63119-4330,Private      ,0,0,0,18,19,37
00247700,A.T. STILL UNIV OF HEALTH SCIENCES      ,MO,63501-0000,Private      ,0,21,21,25,3052,3077
00247900,LINCOLN UNIVERSITY                      ,MO,65101-3500,Public       ,5,24,29,2787,2327,5114
00248000,LINDENWOOD UNIVERSITY                   ,MO,63301-1695,Private      ,23,203,226,7335,8890,16225
00248200,MARYVILLE UNIVERSITY                    ,MO,63141-7299,Private      ,6,146,152,2724,4376,7100
00248400,METROPOLITAN COMMUNITY COLLEGE          ,MO,64111-2408,Public       ,226,553,779,11602,20086,31688
00248500,MIDWESTERN BAPTIST THEOL SEMINARY       ,MO,64118-4697,Private      ,1,4,5,121,446,567
00248600,MINERAL AREA COLLEGE                    ,MO,63601-1000,Public       ,48,81,129,2360,3207,5567
00248800,MISSOURI SOUTHERN STATE UNIVERSITY      ,MO,64801-1595,Public       ,34,79,113,4550,4479,9029
00248900,MISSOURI VALLEY COLLEGE                 ,MO,65340-3197,Private      ,4,10,14,1802,604,2406
00249000,MISSOURI WESTERN STATE UNIVERSITY       ,MO,64507-2294,Public       ,14,56,70,5100,3380,8480
00249100,MOBERLY AREA COMMUNITY COLLEGE          ,MO,65270-1304,Public       ,81,143,224,3510,4382,7892
00249400,NAZARENE THEOLOGICAL SEMINARY           ,MO,64131-1246,Private      ,0,1,1,11,205,216
00249500,TRUMAN STATE UNIVERSITY                 ,MO,63501-4221,Public       ,10,6,16,6385,654,7039
00249600,NORTHWEST MISSOURI STATE UNIV           ,MO,64468-6001,Public       ,13,43,56,7451,1742,9193
00249800,PARK UNIVERSITY                         ,MO,64152-3795,Private      ,14,411,425,1796,10948,12744
00249900,ROCKHURST UNIVERSITY                    ,MO,64110-2561,Private      ,7,44,51,2304,1788,4092
00250000,COLLEGE OF THE OZARKS                   ,MO,65726-2502,Private      ,5,4,9,3583,470,4053
00250100,SOUTHEAST MISSOURI STATE UNIV           ,MO,63701-4799,Public       ,38,81,119,9533,5199,14732
00250200,SOUTHWEST BAPTIST UNIVERSITY            ,MO,65613-2597,Private      ,4,38,42,2403,1992,4395
00250300,MISSOURI STATE UNIVERSITY               ,MO,65897-0094,Public       ,77,170,247,17160,9727,26887
00250400,ST LOUIS COLLEGE OF PHARMACY            ,MO,63110-1088,Private      ,1,4,5,918,877,1795
00250600,SAINT LOUIS UNIVERSITY                  ,MO,63103-2097,Private      ,23,116,139,11308,9665,20973
00250900,SAINT PAUL SCHOOL OF THEOLOGY           ,MO,64127-2499,Private      ,0,1,1,6,175,181
00251200,STEPHENS COLLEGE                        ,MO,65215-0001,Private      ,6,20,26,1040,837,1877
00251400,NORTH CENTRAL MISSOURI COLLEGE          ,MO,64683-1824,Public       ,12,24,36,1037,1251,2288
00251600,UNIVERSITY OF MISSOURI-COLUMBIA         ,MO,65211-1600,Public       ,91,181,272,29849,10688,40537
00251700,MISSOURI UNIVERSITY OF SCIENCE & TECHNOL,MO,65409-0250,Public       ,17,20,37,6160,1637,7797
00251800,UNIVERSITY OF MISSOURI-KANSAS CITY      ,MO,64110-2497,Public       ,33,158,191,9355,11951,21306
00251900,UNIVERSITY OF MISSOURI-ST LOUIS         ,MO,63121-4499,Public       ,33,172,205,8191,13039,21230
00252000,WASHINGTON UNIVERSITY                   ,MO,63130-4899,Private      ,16,34,50,15025,6669,21694
00252001,WASHINGTON UNIV-SCHOOL OF MEDICINE      ,MO,63110-0000,Private      ,4,3,7,251,1686,1937
00252100,WEBSTER UNIVERSITY                      ,MO,63119-3194,Private      ,11,206,217,3805,15118,18923
00252200,WENTWORTH MILITARY ACADEMY              ,MO,64067-1799,Private      ,5,5,10,353,329,682
00252300,WESTMINSTER COLLEGE                     ,MO,65251-1299,Private      ,2,0,2,1386,212,1598
00252400,WILLIAM JEWELL COLLEGE                  ,MO,64068-1896,Private      ,1,4,5,1637,428,2065
00252500,WILLIAM WOODS UNIVERSITY                ,MO,65251-2388,Private      ,6,119,125,1223,1710,2933
00405704,NATIONAL AMERICAN UNIVERSITY            ,MO,64057-1791,Proprietary  ,0,8,8,68,913,981
00439800,COX HEALTH SYSTEM SCHOOL OF RADIOLOGIC T,MO,65802-0000,Private      ,0,0,0,134,268,402
00441300,MERCY HOSPITAL SPRINGFIELD SCHOOL OF RAD,MO,65804-2263,Private      ,1,6,7,142,297,439
00470300,LOGAN COLLEGE OF CHIROPRACTIC           ,MO,63006-1065,Private      ,0,14,14,73,1145,1218
00470700,COVENANT THEOLOGICAL SEMINARY           ,MO,63141-8697,Private      ,1,2,3,5,549,554
00471100,LINN STATE TECHNICAL COLLEGE            ,MO,65051-9607,Public       ,28,8,36,1574,662,2236
00471300,THREE RIVERS COMMUNITY COLLEGE          ,MO,63901-2393,Public       ,57,98,155,2383,4690,7073
00528800,KIRKSVILLE AREA TECHNICAL CENTER        ,MO,63501-0000,Public       ,1,5,6,42,126,168
00528900,WAYNESVILLE CAREER CENTER               ,MO,65583-2131,Public       ,1,2,3,68,224,292
00542400,SOUTH CENTRAL CAREER CENTER             ,MO,65775-3334,Public       ,0,1,1,72,211,283
00542600,SIKESTON CAREER AND TECHNOLOGY CTR      ,MO,63801-0000,Public       ,3,2,5,95,345,440
00542900,ROLLA TECHNICAL INSTITUTE               ,MO,65401-3601,Public       ,4,7,11,289,469,758
00543000,POPLAR BLUFF TECHNICAL CAREER CNTR      ,MO,63901-0000,Public       ,1,4,5,65,319,384
00543800,SALINE COUNTY CAREER CENTER             ,MO,65340-0000,Public       ,0,1,1,16,95,111
00544500,TRUMAN MEDICAL CENTER SCHOOL OF NURSE AN,MO,64108-2677,Private      ,1,6,7,101,326,427
00553100,GRAND RIVER TECHNICAL SCHOOL            ,MO,64601-1299,Public       ,0,1,1,77,89,166
00553200,CAPE GIRARDEAU CAREER & TECHNOLOGY CENTE,MO,63703-7511,Public       ,4,12,16,289,806,1095
00638900,BARNES JEWISH COLLEGE OF NURSING AND ALL,MO,63110-1091,Private      ,4,11,15,649,1612,2261
00639200,RESEARCH COLLEGE OF NURSING             ,MO,64132-1199,Proprietary  ,2,7,9,176,554,730
00639201,RESEARCH MEDICAL CENTER - COLLEGE OF NUR,MO,64132-1199,Proprietary  ,0,5,5,98,289,387
00639202,RESEARCH MED CTR SCHL OF RAD TECH       ,MO,64132-0000,Proprietary  ,0,3,3,35,162,197
00666600,LUTHERAN  SCHOOL OF NURSING             ,MO,63118-3909,Proprietary  ,1,5,6,167,671,838
00732923,ITT TECHNICAL INSTITUTE                 ,MO,63045-1122,Proprietary  ,80,440,520,1028,4293,5321
00754000,MISSOURI BAPTIST UNIVERSITY             ,MO,63141-8698,Private      ,9,100,109,1940,3301,5241
00808000,STATE FAIR COMMUNITY COLLEGE            ,MO,65301-0000,Public       ,55,140,195,2814,4317,7131
00826900,HILLYARD TECHNICAL CENTER               ,MO,64506-0000,Public       ,1,4,5,196,391,587
00855200,STEVENS INSTITUTE OF BUSINESS & ARTS    ,MO,63103-0000,Proprietary  ,0,4,4,125,332,457
00860600,TRI-COUNTY TECHNICAL SCHOOL             ,MO,65026-0000,Public       ,0,0,0,19,82,101
00886200,EAST CENTRAL COLLEGE                    ,MO,63084-0529,Public       ,18,72,90,2368,3097,5465
00908900,HANNIBAL-LAGRANGE COLLEGE               ,MO,63401-1999,Private      ,1,19,20,936,720,1656
00952000,NATIONAL ACADEMY OF BEAUTY ARTS         ,MO,63128-1307,Proprietary  ,9,19,28,182,469,651
00959000,INDEPENDENCE COLLEGE OF COSMETOLOGY     ,MO,64055-1105,Proprietary  ,3,8,11,77,198,275
00960700,HOUSE OF HEAVILIN BEAUTY COLLEGE        ,MO,64110-2826,Proprietary  ,1,10,11,62,187,249
00978200,SAINT LUKE'S COLLEGE OF HEALTH SCIENCES ,MO,64114-3237,Private      ,2,6,8,264,679,943
00979500,MISSOURI COLLEGE                        ,MO,63144-2901,Proprietary  ,9,22,31,320,1004,1324
01014814,COLORADO TECHNL UNIV NORTH KANSAS CITY  ,MO,64116-3614,Proprietary  ,0,12,12,99,717,816
01027900,HICKEY COLLEGE                          ,MO,63146-0000,Proprietary  ,5,3,8,609,582,1191
01040500,PINNACLE CAREER INSTITUTE               ,MO,64131-3367,Proprietary  ,33,180,213,328,2656,2984
01040501,PINNACLE CAREER INSTITUTE - NORTH KANSAS,MO,64153-1151,Proprietary  ,4,43,47,111,575,686
01050303,WICHITA TECHNICAL INSTITUTE - WTI JOPLIN,MO,64801-2970,Proprietary  ,2,34,36,61,491,552
01102600,WARRENSBURG AREA VOC TECH SCH           ,MO,64093-0000,Public       ,1,3,4,49,150,199
01173500,PIKE/LINCOLN TECHNICAL CENTER           ,MO,63344-0000,Public       ,1,0,1,48,113,161
01212000,ASSEMBLIES OF GOD THEO. SEMINARY        ,MO,65802-0000,Private      ,0,5,5,21,320,341
01250000,RANKEN TECHNICAL COLLEGE                ,MO,63113-2811,Private      ,40,86,126,2040,2861,4901
01258000,ST LOUIS CHRISTIAN COLLEGE              ,MO,63033-6499,Private      ,0,3,3,205,244,449
01320800,BAPTIST BIBLE COLLEGE                   ,MO,65803-3498,Private      ,0,4,4,313,293,606
02056100,FOUR RIVERS CAREER CENTER               ,MO,63090-0000,Public       ,0,1,1,34,90,124
02066900,NICHOLS CAREER CENTER                   ,MO,65101-2814,Public       ,1,5,6,107,272,379
02068200,COX HEALTH - COX COLLEGE                ,MO,65802-0000,Private      ,1,25,26,408,1405,1813
02073600,KENNETT CAREER & TECHNOLOGY CENTER      ,MO,63857-0000,Public       ,0,0,0,32,111,143
02090400,BOONSLICK TECHNICAL EDUCATION CTR       ,MO,65233-0000,Public       ,0,1,1,17,63,80
02119204,COURT REPORTING INSTITUTE OF DALLAS - CO,MO,63105-3329,Proprietary  ,0,5,5,4,68,72
02121100,MIDWEST INSTITUTE                       ,MO,63122-0000,Proprietary  ,1,6,7,92,269,361
02124500,FRANKLIN TECHNOLOGY CENTER              ,MO,64801-0000,Public       ,3,8,11,116,517,633
02142200,LEX LA RAY TECHNICAL CENTER             ,MO,64067-0000,Public       ,0,1,1,42,107,149
02151000,HANNIBAL CAREER AND TECHNICAL CENTE     ,MO,63401-2285,Public       ,0,0,0,20,104,124
02154900,MISSOURI SCH OF BARB & HAIR             ,MO,63031-0000,Proprietary  ,1,3,4,31,127,158
02164200,FOREST INST PROFESSIONAL PSYCHOLOGY     ,MO,65807-0000,Private      ,0,3,3,25,417,442
02165900,CHILLICOTHE BEAUTY ACADEMY              ,MO,64601-0000,Proprietary  ,0,1,1,14,38,52
02180200,METRO BUSINESS COLLEGE                  ,MO,63701-0000,Proprietary  ,10,43,53,162,930,1092
02188000,NORTHWEST TECHNICAL SCHOOL              ,MO,64468-0000,Public       ,0,0,0,75,64,139
02188100,NORTHLAND CAREER CENTER                 ,MO,64079-8333,Public       ,0,0,0,38,105,143
02202700,OZARK CHRISTIAN COLLEGE                 ,MO,64801-0000,Private      ,1,1,2,754,254,1008
02203400,NEVADA REGIONAL TECHNICAL CENTER        ,MO,64772-0000,Public       ,0,3,3,51,100,151
02205200,SANFORD-BROWN COLLEGE                   ,MO,63026-7305,Proprietary  ,0,4,4,223,1138,1361
02205203,SANFORD BROWN COLLEGE-ST. PETERS        ,MO,63376-5950,Proprietary  ,0,6,6,171,730,901
02214500,SALEM COLLEGE OF HAIRSTYLING            ,MO,65401-0000,Proprietary  ,2,7,9,26,69,95
02239200,ANTHEM COLLEGE                          ,MO,63043-0000,Proprietary  ,17,44,61,437,1252,1689
02239202,ANTHEM COLLEGE - METRO SOUTH            ,MO,63026-0000,Proprietary  ,9,25,34,35,165,200
02250600,EVEREST COLLEGE                         ,MO,65807-2446,Proprietary  ,13,58,71,194,980,1174
02263106,ANTHEM COLLEGE - ANTHEM COLLEGE - KANSAS,MO,64114-3232,Proprietary  ,1,4,5,72,305,377
02263400,LAKE CAREER AND TECHNICAL CENTER        ,MO,65020-0000,Public       ,0,0,0,21,67,88
02266400,CENTRAL CHRISTIAN CLG OF THE BIBLE      ,MO,65270-0000,Private      ,0,5,5,225,221,446
02277500,HOUSE OF HEAVILIN OF BLUE SPRINGS       ,MO,64014-3953,Proprietary  ,0,9,9,59,154,213
02289200,COLUMBIA AREA CAREER CENTER             ,MO,65203-0000,Public       ,4,15,19,193,630,823
02295700,MISSOURI BEAUTY ACADEMY                 ,MO,63640-1827,Proprietary  ,3,15,18,78,201,279
02300105,EVEREST COLLEGE - EARTH CITY            ,MO,63045-1100,Proprietary  ,18,104,122,269,1187,1456
02304000,MISSOURI TECH                           ,MO,63303-3887,Proprietary  ,1,8,9,126,287,413
02309100,AMERICAN COLLEGE OF HAIR DESIGN         ,MO,65301-2144,Proprietary  ,1,1,2,35,95,130
02313000,CASS CAREER CENTER                      ,MO,64701-0000,Public       ,0,0,0,22,90,112
02340500,ST LOUIS COLLEGE OF HEALTH CAREERS      ,MO,63110-0000,Proprietary  ,13,68,81,405,1644,2049
02342100,CAREER & TECHNOLOGY CTR AT FT OSAGE     ,MO,64058-0000,Public       ,0,1,1,23,102,125
02361600,CONCORDE CAREER COLLEGE                 ,MO,64111-0000,Proprietary  ,30,130,160,466,2257,2723
02497500,CLINTON TECHNICAL SCHOOL                ,MO,64735-2966,Public       ,0,2,2,32,119,151
02520800,MERRELL UNIV OF BTY ARTS & SCIENCES     ,MO,65109-0000,Proprietary  ,1,6,7,130,256,386
02530600,SAINT CHARLES COMMUNITY COLLEGE         ,MO,63376-0975,Public       ,73,86,159,4840,4275,9115
02543800,PARIS II EDUCATIONAL CENTER (THE)       ,MO,64118-0000,Proprietary  ,1,10,11,74,252,326
02564700,ELAINE STEVEN BEAUTY COLLEGE            ,MO,63136-0000,Proprietary  ,3,17,20,146,348,494
02564701,ELAINE STEVEN BEAUTY COLLEGE - ADVANCE B,MO,63383-2006,Proprietary  ,0,0,0,5,19,24
02564702,ELAINE STEVEN BEAUTY COLLEGE - ADVANCE B,MO,63401-2269,Proprietary  ,1,0,1,15,23,38
02568500,GRABBER SCHOOL OF HAIR DESIGN           ,MO,63011-0000,Proprietary  ,2,3,5,67,170,237
02599700,VATTEROTT COLLEGE                       ,MO,63134-2900,Proprietary  ,47,207,254,610,2522,3132
02599701,VATTEROTT COLLEGE - KANSAS CITY         ,MO,64117-0000,Proprietary  ,8,51,59,224,1523,1747
02599702,VATTEROTT COLLEGE - SPRINGFIELD LOCATION,MO,65807-5340,Proprietary  ,9,57,66,188,1031,1219
02599703,VATTEROTT COLLEGE - JOPLIN              ,MO,64801-5033,Proprietary  ,8,63,71,102,672,774
02599705,VATTEROTT COLLEGE - SUNSET HILLS        ,MO,63127-1516,Proprietary  ,13,68,81,207,1250,1457
02599712,VATTEROTT COLLEGE - O'FALLON            ,MO,63366-2748,Proprietary  ,4,23,27,167,579,746
02599714,VATTEROTT COLLEGE - EX'TREME INSTITUTE B,MO,63102-2115,Proprietary  ,19,31,50,51,110,161
02599715,VATTEROTT COLLEGE - PERSONAL FITNESS AND,MO,63132-3251,Proprietary  ,0,1,1,2,2,4
02608000,NEOSHO BEAUTY COLLEGE                   ,MO,64850-1525,Proprietary  ,3,0,3,28,76,104
02609202,VATTEROTT COLLEGE-ST JOSEPH             ,MO,64501-2911,Proprietary  ,6,18,24,146,611,757
02609203,VATTEROTT COLLEGE - L'ECOLE CULINAIRE   ,MO,63124-1103,Proprietary  ,5,22,27,316,968,1284
02609206,VATTEROTT COLLEGE - L'ECOLE CULINAIRE   ,MO,64112-2110,Proprietary  ,0,1,1,0,1,1
02611004,HERITAGE COLLEGE-KANSAS CITY            ,MO,64131-4203,Proprietary  ,17,77,94,346,1281,1627
03042400,LEBANON TECHNOLOGY & CAREER CENTER      ,MO,65536-3296,Public       ,2,3,5,104,272,376
03066300,BRYAN CAREER COLLEGE                    ,MO,65806-2507,Proprietary  ,7,65,72,126,1060,1186
03066303,BRYAN COLLEGE - COLUMBIA                ,MO,65201-8248,Proprietary  ,4,18,22,112,596,708
03068600,SPECIAL SCHOOL DISTRICT OF ST. LOUIS CO.,MO,63127-0000,Public       ,0,6,6,75,680,755
03070200,CENTRAL COLLEGE OF COSMETOLOGY          ,MO,65583-0000,Proprietary  ,4,8,12,43,141,184
03070900,SE MO HOSP CLG NURSING & HEALTH SCI     ,MO,63703-4507,Private      ,0,4,4,188,508,696
03072800,DALLAS COUNTY CAREER CENTER             ,MO,65685-9152,Public       ,0,0,0,1,13,14
03077200,COSMETOLOGY CONCEPTS INSTITUTE          ,MO,65202-1972,Proprietary  ,2,8,10,79,153,232
03083000,OZARKS TECHNICAL COMMUNITY COLLEGE      ,MO,65802-3601,Public       ,132,354,486,9076,14828,23904
03092600,MESSENGER COLLEGE                       ,MO,64804-4909,Private      ,0,1,1,41,67,108
03097600,ST LOUIS HAIR ACADEMY                   ,MO,63107-1737,Proprietary  ,0,4,4,79,174,253
03101000,NEW DIMENSION SCHOOL OF HAIR DESIGN     ,MO,64801-5017,Proprietary  ,1,5,6,35,100,135
03106000,MISSOURI STATE UNIVERSITY - WEST PLAINS ,MO,65775-2715,Public       ,27,50,77,1367,1760,3127
03110900,HOUSE OF HEAVILIN BEAUTY COLLEGE        ,MO,64083-9195,Proprietary  ,1,3,4,39,85,124
03166300,MOBERLY AREA TECHNICAL CENTER           ,MO,65270-1904,Public       ,0,0,0,72,88,160
03174300,HERNDON CAREER CENTER                   ,MO,64138-2695,Public       ,0,1,1,19,45,64
03519300,MISSOURI COLLEGE OF COSMETOLOGY NORTH   ,MO,65803-0000,Proprietary  ,2,10,12,111,280,391
03579300,TEXAS COUNTY TECHNICAL INSTITUTE        ,MO,65483-2700,Private      ,0,7,7,50,293,343
03616300,AVIATION INSTITUTE OF MAINTENANCE       ,MO,64129-1811,Proprietary  ,6,21,27,72,480,552
03878300,PROFESSIONAL MASSAGE TRAINING CENTER    ,MO,65803-2939,Proprietary  ,1,11,12,62,196,258
03916300,ECLIPS SCHOOL OF COSMETOLOGY AND BARBERI,MO,63703-5809,Proprietary  ,2,17,19,75,350,425
03924300,HAIR ACADEMY 110 (THE)                  ,MO,63501-2915,Proprietary  ,1,0,1,12,33,45
03970400,WELLSPRING SCHOOL OF ALLIED HEALTH      ,MO,64114-3313,Proprietary  ,4,14,18,73,270,343
04037500,ACADEMY OF HAIR DESIGN                  ,MO,65804-2303,Proprietary  ,2,14,16,131,386,517
04051329,ART INSTITUTE OF PHOENIX (THE) - BROWN M,MO,63026-2564,Proprietary  ,1,5,6,73,152,225
04118700,AMERICAN COLLEGE OF TECHNOLOGY          ,MO,64506-2006,Proprietary  ,1,56,57,34,585,619
04119100,CITY VISION COLLEGE                     ,MO,64141-3188,Private      ,0,4,4,10,132,142
04122300,GRANTHAM UNIVERSITY                     ,MO,64153-2262,Proprietary  ,30,677,707,269,5938,6207
04127000,PEMISCOT COUNTY SPECIAL SCHOOL DISTRICT ,MO,63851-1666,Public       ,0,0,0,4,18,22
04130300,VICTORY TRADE SCHOOL                    ,MO,65803-2754,Private      ,1,8,9,20,105,125
04130600,"CENTER FOR HEALING ARTS (THE), LLC      ",MO,63143-2103,Proprietary  ,0,5,5,44,219,263
04133300,TREND SETTERS SCHOOL OF COSMETOLOGY     ,MO,63702-7607,Proprietary  ,2,7,9,69,165,234
04145200,TRANSFORMED BARBER AND COSMETOLOGY ACADE,MO,64137-1207,Proprietary  ,6,15,21,95,320,415
04145700,THE SYSTEM A PAUL MITCHELL PARTNER SCHL ,MO,65807-5969,Proprietary  ,5,15,20,179,276,455
04146100,URSHAN GRADUATE SCHOOL OF THEOLOGY      ,MO,63031-7526,Private      ,0,0,0,40,64,104
04152200,CARTHAGE R-9 SCHOOL DISTRICT/CARTHAGE TE,MO,64836-1332,Public       ,0,1,1,0,1,1
04170600,SALON PROFESSIONAL ACADEMY (THE)        ,MO,63301-1021,Proprietary  ,1,8,9,80,142,222
04170700,PAUL MITCHELL THE SCHOOL ST LOUIS       ,MO,63108-1554,Proprietary  ,5,12,17,224,346,570
04173900,COSMETOLOGY COLLEGE OF FRANKLIN COUNTY  ,MO,63077-3448,Proprietary  ,1,0,1,23,44,67
04174000,SKIN INSTITUTE                          ,MO,63128-1307,Proprietary  ,1,1,2,32,134,166
04174800,AMERICAN TRADE SCHOOL                   ,MO,63074-1807,Proprietary  ,2,11,13,38,217,255
04184400,SEYMOUR BEAUTY ACADEMY                  ,MO,65746-8743,Proprietary  ,2,6,8,15,57,72
04187000,DONNA'S ACADEMY OF HAIR DESIGN          ,MO,64089-9042,Proprietary  ,0,1,1,32,49,81
04212100,ACADEMY OF SALON PROFESSIONALS          ,MO,65301-6910,Proprietary  ,1,4,5,3,23,26
04218400,CITY POINTE BEAUTY ACADEMY              ,MO,64870-2502,Proprietary  ,10,9,19,10,11,21
00314600,WESTERN OKLAHOMA STATE COLLEGE          ,OK,73521-1397,Public       ,8,30,38,814,1348,2162
00314700,BACONE COLLEGE                          ,OK,74403-1597,Private      ,21,18,39,1367,1026,2393
00314900,SOUTHERN NAZARENE UNIVERSITY            ,OK,73008-2694,Private      ,3,36,39,1333,2293,3626
00315000,CAMERON UNIVERSITY                      ,OK,73505-6377,Public       ,30,136,166,2631,5195,7826
00315100,OKLAHOMA WESLEYAN UNIVERSITY            ,OK,74006-6299,Private      ,3,25,28,943,1322,2265
00315200,UNIV OF CENTRAL OKLAHOMA                ,OK,73034-5209,Public       ,52,158,210,10984,9497,20481
00315300,CONNORS STATE COLLEGE                   ,OK,74469-9700,Public       ,24,64,88,1416,2098,3514
00315400,EAST CENTRAL UNIVERSITY                 ,OK,74820-6999,Public       ,18,70,88,2977,3420,6397
00315500,EASTERN OKLAHOMA STATE COLLEGE          ,OK,74578-4999,Public       ,23,36,59,985,1594,2579
00315600,REDLANDS COMMUNITY COLLEGE              ,OK,73036-5304,Public       ,13,50,63,971,1576,2547
00315700,LANGSTON UNIVERSITY                     ,OK,73050-0000,Public       ,19,29,48,2429,2392,4821
00315800,MURRAY STATE COLLEGE                    ,OK,73460-3137,Public       ,15,72,87,1314,2178,3492
00316000,NORTHEASTERN OKLAHOMA A & M COLLEGE     ,OK,74354-6497,Public       ,58,47,105,2095,1732,3827
00316100,NORTHEASTERN STATE UNIVERSITY           ,OK,74464-2399,Public       ,22,102,124,5884,7390,13274
00316200,NORTHERN OKLAHOMA COLLEGE               ,OK,74653-0310,Public       ,27,57,84,2297,2726,5023
00316300,NORTHWESTERN OKLAHOMA STATE UNIV        ,OK,73717-2799,Public       ,15,17,32,1792,1230,3022
00316400,OKLAHOMA BAPTIST UNIVERSITY             ,OK,74801-2590,Private      ,8,12,20,2836,686,3522
00316500,OKLAHOMA CHRISTIAN UNIVERSITY           ,OK,73131-0000,Private      ,3,16,19,2462,1246,3708
00316600,OKLAHOMA CITY UNIVERSITY                ,OK,73106-1493,Private      ,12,37,49,3227,3728,6955
00316700,UNIV OF SCIENCE & ARTS OF OKLAHOMA      ,OK,73018-5322,Public       ,5,12,17,890,649,1539
00316800,ROGERS STATE UNIVERSITY                 ,OK,74017-3252,Public       ,19,83,102,3242,3677,6919
00317000,OKLAHOMA STATE UNIVERSITY               ,OK,74078-1026,Public       ,81,111,192,20897,9843,30740
00317200,OKLAHOMA STATE UNIVERSITY-OKMULGEE      ,OK,74447-3901,Public       ,31,65,96,2409,2550,4959
00317400,OKLAHOMA PANHANDLE STATE UNIVERSITY     ,OK,73939-0000,Public       ,8,12,20,1171,577,1748
00317600,CARL ALBERT STATE COLLEGE               ,OK,74953-5208,Public       ,32,59,91,1562,2484,4046
00317800,SEMINOLE STATE COLLEGE                  ,OK,74818-0351,Public       ,19,46,65,1074,1556,2630
00317900,SOUTHEASTERN OKLAHOMA STATE UNIV        ,OK,74701-0609,Public       ,25,53,78,2746,3068,5814
00318000,SOUTHWESTERN CHRISTIAN UNIVERSITY       ,OK,73008-2335,Private      ,1,24,25,569,1334,1903
00318100,SOUTHWESTERN OKLAHOMA STATE UNIV        ,OK,73096-3098,Public       ,17,47,64,3564,2444,6008
00318101,SOUTHWESTERN OK STATE UNIV AT SAYRE     ,OK,73662-0000,Public       ,4,5,9,184,289,473
00318300,ST GREGORY'S UNIVERSITY                 ,OK,74804-2499,Private      ,4,5,9,464,514,978
00318308,SAINT GREGORY'S UNIVERSITY - IPD TULSA  ,OK,74135-2499,Private      ,1,4,5,63,358,421
00318400,UNIVERSITY OF OKLAHOMA                  ,OK,73019-4078,Public       ,67,177,244,20592,12570,33162
00318401,UNIVERSITY OF OKLAHOMA-HLTH SCI CTR     ,OK,73190-0000,Public       ,3,40,43,901,4159,5060
00318500,UNIVERSITY OF TULSA                     ,OK,74104-3189,Private      ,16,31,47,3995,2820,6815
00398500,ORAL ROBERTS UNIVERSITY                 ,OK,74171-0001,Private      ,8,30,38,3558,2186,5744
00531100,TULSA COUNTY AREA VOC TECH SCHOOL       ,OK,74145-0000,Public       ,8,39,47,644,2261,2905
00531200,RED RIVER TECHNOLOGY CENTER             ,OK,73533-2700,Public       ,1,5,6,58,214,272
00533900,METRO TECHNOLOGY CENTERS SCH DIST22     ,OK,73111-0000,Public       ,8,30,38,308,1699,2007
00533903,METRO TECHNOLOGY CENTERS SCH DIST22     ,OK,73129-0000,Public       ,4,15,19,198,1001,1199
00694200,MID-AMERICA CHRISTIAN UNIVERSITY        ,OK,73170-4504,Private      ,5,157,162,554,3583,4137
00767800,SPARTAN COLLEGE OF AERONAUTICS AND TECHN,OK,74115-5800,Proprietary  ,14,22,36,1021,1119,2140
00791100,VIRGILS BEAUTY COLLEGE                  ,OK,74401-6802,Proprietary  ,1,5,6,33,107,140
00834300,AUTRY TECHNOLOGY CENTER                 ,OK,73703-2598,Public       ,0,10,10,148,430,578
00861900,TRI COUNTY TECHNOLOGY CENTER            ,OK,74006-6029,Public       ,0,5,5,89,306,395
00918500,ROSE STATE COLLEGE                      ,OK,73110-2799,Public       ,36,215,251,3389,7175,10564
00920400,KIAMICHI TECHNOLOGY CENTER              ,OK,74578-0548,Public       ,2,9,11,284,1028,1312
00920408,KIAMICHI TECHNOLOGY CENTER - POTEAU CAMP,OK,74953-0825,Public       ,0,0,0,115,344,459
00961800,TULSA WELDING SCHOOL                    ,OK,74104-0000,Proprietary  ,139,234,373,1801,2991,4792
00964700,"OKLAHOMA STATE UNIV, OKLA CITY          ",OK,73107-6159,Public       ,47,209,256,3618,8740,12358
00970800,EVES COLLEGE OF HAIRSTYLING             ,OK,73501-4359,Proprietary  ,4,16,20,50,193,243
00976300,TULSA COMMUNITY COLLEGE                 ,OK,74135-6198,Public       ,131,430,561,9110,16458,25568
00996300,CADDO KIOWA VOC TECH CENTER             ,OK,73038-0000,Public       ,0,5,5,64,328,392
00996400,CENTRAL OKLAHOMA AREA VOC TECH SCH      ,OK,74030-9613,Public       ,1,11,12,125,455,580
00996500,CANADIAN VALLEY TECHNOLOGY CENTER       ,OK,73036-9117,Public       ,3,16,19,146,618,764
00996800,GORDON COOPER TECHNOLOGY CENTER         ,OK,74804-9913,Public       ,1,6,7,149,587,736
01005300,INDIAN CAPITAL TECHNOLGY CENTER #4      ,OK,74403-9907,Public       ,1,10,11,236,860,1096
01026600,HILLSDALE FREE WILL BAPTIST COLLEGE     ,OK,73153-0000,Private      ,0,1,1,207,131,338
01034200,SOUTHERN OKLAHOMA TECHNOLOGY CENTER     ,OK,73401-2100,Public       ,1,8,9,121,395,516
01039100,OKLAHOMA CITY COMMUNITY COLLEGE         ,OK,73159-4444,Public       ,101,311,412,5777,12139,17916
01050304,WTI TULSA CAMPUS                        ,OK,74112-3140,Proprietary  ,1,36,37,41,416,457
01071700,GREAT PLAINS TECHNOLOGY CENTER SCHOOL DI,OK,73505-8399,Public       ,5,20,25,242,1018,1260
01076200,WESTERN OK AREA VOC TECH SCH DIST12     ,OK,73624-1469,Public       ,0,0,0,59,136,195
01120600,PIONEER TECHNOLOGY CENTER               ,OK,74601-1106,Public       ,2,5,7,54,246,300
01128200,OKLAHOMA STATE UNV CLG OSTEOPTHC MD     ,OK,74107-0000,Public       ,1,8,9,178,821,999
01153700,MID-AMERICA TECHNOLOGY CENTER           ,OK,73095-0210,Public       ,0,1,1,62,160,222
01227200,MOORE-NORMAN TECHNOLOGY CENTER          ,OK,73069-8399,Public       ,2,12,14,276,1256,1532
02052700,NORTHEAST TECHNOLOGY CENTER             ,OK,74361-0487,Public       ,2,6,8,206,716,922
02060800,MERIDIAN TECHNOLOGY CENTER              ,OK,74074-0000,Public       ,2,2,4,207,513,720
02126500,ENID BEAUTY COLLEGE                     ,OK,73701-0000,Proprietary  ,1,5,6,37,84,121
02184400,SAND SPRINGS BEAUTY COLLEGE             ,OK,74063-0000,Proprietary  ,3,12,15,42,197,239
02197300,HOLLYWOOD COSMETOLOGY CENTER            ,OK,73189-0000,Proprietary  ,0,4,4,20,115,135
02222700,FRANCIS TUTTLE TECHNOLOGY CENTER        ,OK,73142-0000,Public       ,5,28,33,426,2052,2478
02238500,CENTRAL STATE BEAUTY ACADEMY            ,OK,73162-6007,Proprietary  ,6,34,40,91,444,535
02250900,E OK COUNTY AREA VO-TECH                ,OK,73020-0000,Public       ,1,2,3,49,117,166
02256200,"BROKEN ARROW BEAUTY COLLEGE, INC        ",OK,74012-0000,Proprietary  ,2,13,15,122,341,463
02282100,HIGH PLAINS AREA VOC-TECH               ,OK,73801-0000,Public       ,0,4,4,39,97,136
02306800,PLATT COLLEGE                           ,OK,74145-0000,Proprietary  ,11,77,88,436,2326,2762
02510300,BEAUTY TECHNICAL COLLEGE                ,OK,74465-0000,Proprietary  ,0,7,7,32,113,145
02531200,WOODWARD BEAUTY COLLEGE                 ,OK,73801-0000,Proprietary  ,2,1,3,14,58,72
02554300,AMERICAN BEAUTY INSTITUTE               ,OK,74501-0000,Proprietary  ,0,5,5,25,79,104
02556500,YUKON BEAUTY COLLEGE                    ,OK,73099-4108,Proprietary  ,0,6,6,7,39,46
02560200,PHILLIPS THEOLOGICAL SEMINARY -         ,OK,74116-5612,Private      ,0,0,0,9,130,139
02581100,CLAREMORE BEAUTY COLLEGE                ,OK,74017-7034,Proprietary  ,1,2,3,18,47,65
02581200,CC'S COSMETOLOGY COLLEGE                ,OK,74129-0000,Proprietary  ,2,11,13,78,262,340
02591101,CAREER POINT INSTITUTE                  ,OK,74146-0000,Proprietary  ,1,9,10,116,539,655
02596501,ATI-CAREER TRAINING CENTER - OKLAHOMA CI,OK,73107-2442,Proprietary  ,0,0,0,41,226,267
02596502,ATI- CAREER TRAINING CENTER - OKLAHOMA C,OK,76101-2740,Proprietary  ,0,0,0,113,549,662
02597400,PONTOTOC TECHNOLOGY CENTER SCHOOL       ,OK,74820-8621,Public       ,0,2,2,76,305,381
02599706,VATTEROTT COLLEGE - TULSA               ,OK,74146-2205,Proprietary  ,3,21,24,93,621,714
02600000,NORTHWEST TECHNOLOG CTR SCH DIST 10     ,OK,73717-9600,Public       ,0,0,0,33,71,104
02600500,WES WATKINS TECHNOLOGY CENTER           ,OK,74883-9660,Public       ,0,1,1,43,198,241
02609205,VATTEROTT COLLEGE - OKLAHOMA CITY       ,OK,73127-2103,Proprietary  ,4,82,86,120,984,1104
03008700,SOUTHWEST TECHNOLOGY CENTER             ,OK,73521-1527,Public       ,1,5,6,53,210,263
03024700,STILLWATER BEAUTY ACADEMY               ,OK,74075-3467,Proprietary  ,3,6,9,38,94,132
03030700,OKLAHOMA SCHOOL OF PHOTOGRAPHY          ,OK,73160-3320,Proprietary  ,0,3,3,45,136,181
03030800,AMERICAN BROADCASTING SCHOOL            ,OK,73115-3334,Proprietary  ,4,21,25,73,460,533
03051100,CHISHOLM TRAIL TECHNOLOGY CENTER        ,OK,73764-6335,Public       ,0,3,3,17,93,110
03078500,TECH INST OF COSMETOLOGY ARTS & SCI     ,OK,74120-3610,Proprietary  ,1,5,6,61,186,247
03103800,SOUTHERN SCHOOL OF BEAUTY               ,OK,74701-5008,Proprietary  ,2,11,13,38,83,121
03109800,PONCA CITY BEAUTY COLLEGE               ,OK,74601-4201,Proprietary  ,1,3,4,5,47,52
03109801,BARTLESVILLE BEAUTY COLLEGE             ,OK,74003-2835,Proprietary  ,0,3,3,5,51,56
03115100,HERITAGE COLLEGE                        ,OK,73119-0000,Proprietary  ,17,88,105,356,1486,1842
03124800,PLATT COLLEGE                           ,OK,73501-3808,Proprietary  ,6,31,37,109,573,682
03124901,IMAGINE -  PAUL MITCHELL PARTNER SCHOOL ,OK,73072-4831,Proprietary  ,7,18,25,138,304,442
03126200,GREEN COUNTRY AREA VOC TECH SCHOOL      ,OK,74447-1217,Public       ,2,3,5,78,188,266
03198400,MID-DEL AREA VOCATIONAL & TECH SCH      ,OK,73110-4825,Public       ,0,4,4,40,229,269
03329400,PRYOR BEAUTY COLLEGE                    ,OK,74361-0000,Proprietary  ,3,7,10,14,54,68
03329401,PRYOR BEAUTY COLLEGE - GROVE BEAUTY COLL,OK,74345-0009,Proprietary  ,0,1,1,5,33,38
03329402,PRYOR BEAUTY COLLEGE - NORTH EAST OKLAHO,OK,74338-0000,Proprietary  ,0,2,2,2,9,11
03367400,COMMUNITY CARE COLLEGE                  ,OK,74145-6420,Proprietary  ,34,128,162,676,2368,3044
03396300,OKLAHOMA HEALTH ACADEMY                 ,OK,74105-6220,Proprietary  ,0,0,0,110,271,381
03396400,OKLAHOMA HEALTH ACADEMY                 ,OK,73160-3667,Proprietary  ,0,0,0,24,105,129
03453400,SHAWNEE BEAUTY COLLEGE                  ,OK,74801-7014,Proprietary  ,0,4,4,20,69,89
03676300,FAMILY OF FAITH COLLEGE                 ,OK,74802-1805,Private      ,0,0,0,13,28,41
03831300,INSTITUTE OF HAIR DESIGN                ,OK,74804-0000,Proprietary  ,0,0,0,16,54,70
03928300,CENTRAL STATE MASSAGE ACADEMY           ,OK,73162-6007,Proprietary  ,1,10,11,38,160,198
04051324,ART INSTITUTE OF PHOENIX (THE) - BROWN M,OK,74146-5234,Proprietary  ,5,15,20,125,420,545
04060300,AMERICAN INSTITUTE OF MEDICAL TECHNOLOGY,OK,74146-5201,Proprietary  ,1,5,6,127,445,572
04062300,BROOKLINE COLLEGE                       ,OK,73114-6318,Proprietary  ,1,2,3,37,196,233
04133600,CUTTER'S EDGE SCHOOL OF COSMETOLOGY     ,OK,74023-2905,Proprietary  ,1,0,1,3,31,34
04144400,ACADEMY OF HAIR DESIGN (THE)            ,OK,73120-6808,Proprietary  ,1,7,8,65,252,317
00163700,BETHANY THEOLOGICAL SEMINARY            ,IN,47374-0000,Private      ,0,2,2,2,74,76
00178400,ANCILLA COLLEGE-FINANCIAL AID OFFC      ,IN,46513-0001,Private      ,4,3,7,514,590,1104
00178500,ANDERSON UNIVERSITY                     ,IN,46012-3495,Private      ,5,30,35,3066,1509,4575
00178600,BALL STATE UNIVERSITY                   ,IN,47306-0880,Public       ,29,155,184,24615,10149,34764
00178700,BETHEL COLLEGE INC                      ,IN,46545-5591,Private      ,3,24,27,1771,1843,3614
00178800,BUTLER UNIVERSITY                       ,IN,46208-3487,Private      ,10,36,46,9099,2853,11952
00178900,CHRISTIAN THEOLOGICAL SEMINARY          ,IN,46208-0000,Private      ,0,3,3,16,376,392
00179200,DEPAUW UNIVERSITY                       ,IN,46135-0037,Private      ,1,0,1,3301,186,3487
00179300,EARLHAM COLLEGE                         ,IN,47374-4095,Private      ,0,3,3,1403,229,1632
00179301,EARLHAM SCHOOL OF RELIGION              ,IN,47374-0000,Private      ,0,2,2,12,65,77
00179500,UNIVERSITY OF EVANSVILLE                ,IN,47722-0002,Private      ,1,10,11,4226,1250,5476
00179800,FRANKLIN COLLEGE OF INDIANA             ,IN,46131-2623,Private      ,4,5,9,2147,418,2565
00179900,GOSHEN COLLEGE                          ,IN,46526-4794,Private      ,1,7,8,1028,600,1628
00180000,GRACE COLLEGE & THEO SEMINARY           ,IN,46590-1224,Private      ,3,8,11,2053,640,2693
00180100,HANOVER COLLEGE                         ,IN,47243-0108,Private      ,1,3,4,2653,157,2810
00180300,HUNTINGTON UNIVERSITY                   ,IN,46750-1299,Private      ,1,6,7,1503,471,1974
00180400,UNIVERSITY OF INDIANAPOLIS              ,IN,46227-3697,Private      ,14,93,107,7334,6402,13736
00180500,INDIANA INSTITUTE OF TECHNOLOGY         ,IN,46803-1297,Private      ,13,141,154,2709,6643,9352
00180700,INDIANA STATE UNIVERSITY                ,IN,47809-2501,Public       ,21,116,137,14574,8663,23237
00180800,UNIVERSITY OF SOUTHERN INDIANA          ,IN,47712-3596,Public       ,20,43,63,10330,5052,15382
00180900,INDIANA UNIVERSITY-BLOOMINGTON          ,IN,47405-7000,Public       ,37,112,149,36772,13283,50055
00181100,INDIANA UNIV-EAST                       ,IN,47374-1289,Public       ,8,56,64,2244,3332,5576
00181300,INDIANA UNIV-PURDUE UNIV INDPLS         ,IN,46202-5145,Public       ,57,331,388,23534,27803,51337
00181301,INDIANA UNIVERSITY - PURDUE UNIVERSITY I,IN,47203-1769,Public       ,3,29,32,2165,2614,4779
00181400,INDIANA UNIV KOKOMO                     ,IN,46902-3557,Public       ,9,42,51,2556,3603,6159
00181500,INDIANA UNIV-NORTHWEST                  ,IN,46408-1197,Public       ,22,93,115,4422,7443,11865
00181600,INDIANA UNIVERSITY - SOUTH BEND         ,IN,46615-0000,Public       ,13,77,90,5706,7265,12971
00181700,INDIANA UNIVERSITY-SOUTHEAST            ,IN,47150-6405,Public       ,21,96,117,4933,5056,9989
00182000,MANCHESTER COLLEGE                      ,IN,46962-1276,Private      ,1,3,4,2735,409,3144
00182100,MARIAN UNIVERSITY                       ,IN,46222-1997,Private      ,7,44,51,2523,3389,5912
00182200,INDIANA WESLEYAN UNIVERSITY             ,IN,46953-4974,Private      ,13,365,378,5026,18594,23620
00182300,ASSOCIATED MENNONITE BIBLICAL SEM       ,IN,46517-1999,Private      ,0,2,2,5,117,122
00182400,OAKLAND CITY UNIVERSITY                 ,IN,47660-1099,Private      ,2,18,20,655,822,1477
00182500,PURDUE UNIVERSITY                       ,IN,47907-2050,Public       ,30,93,123,34089,9510,43599
00182600,PURDUE UNIV NORTH CENTRAL CAMPUS        ,IN,46391-9542,Public       ,10,24,34,3333,2892,6225
00182700,PURDUE UNIV CALUMET                     ,IN,46323-2094,Public       ,23,104,127,6350,7964,14314
00182800,INDIANA UNIV-PURDUE UNIV FORT WAYNE     ,IN,46805-1499,Public       ,13,91,104,11184,10438,21622
00183000,ROSE HULMAN INSTITUTE OF TECHNOLOGY     ,IN,47803-3999,Private      ,2,2,4,3693,267,3960
00183200,UNIVERSITY OF SAINT FRANCIS             ,IN,46808-3994,Private      ,2,36,38,2686,2497,5183
00183300,ST JOSEPH'S COLLEGE                     ,IN,47978-0000,Private      ,2,3,5,1595,252,1847
00183400,CALUMET COLLEGE OF SAINT JOSEPH         ,IN,46394-2195,Private      ,5,18,23,626,1064,1690
00183500,SAINT MARY-OF-THE-WOODS COLLEGE         ,IN,47876-0067,Private      ,0,7,7,415,1390,1805
00183600,ST MARY'S COLLEGE                       ,IN,46556-5007,Private      ,0,0,0,1857,122,1979
00183800,TAYLOR UNIVERSITY                       ,IN,46989-1001,Private      ,3,4,7,2672,351,3023
00183900,TRINE UNIVERSITY                        ,IN,46703-1764,Private      ,3,15,18,3035,1174,4209
00184000,UNIVERSITY OF NOTRE DAME                ,IN,46556-5602,Private      ,5,16,21,13832,3842,17674
00184200,VALPARAISO UNIVERSITY                   ,IN,46383-6493,Private      ,9,20,29,5417,2537,7954
00184300,VINCENNES UNIVERSITY                    ,IN,47591-1523,Public       ,49,138,187,7431,5750,13181
00184400,WABASH COLLEGE                          ,IN,47933-0352,Private      ,0,2,2,1501,102,1603
00457900,INTERNATIONAL BUSINESS COLLEGE          ,IN,46804-0000,Proprietary  ,0,6,6,829,718,1547
00457901,INTERNATIONAL BUSINESS COLLEGE          ,IN,46256-0000,Proprietary  ,7,3,10,807,677,1484
00625700,SAINT ELIZABETH SCHOOL OF NURSING       ,IN,47904-2198,Private      ,0,6,6,258,582,840
00726300,HOLY CROSS COLLEGE                      ,IN,46556-0308,Private      ,1,1,2,709,161,870
00727600,SAINT MEINRAD SCHOOL OF THEOLOGY        ,IN,47577-1002,Private      ,0,0,0,1,131,132
00732900,ITT TECHNICAL INSTITUTE                 ,IN,46268-1119,Proprietary  ,428,2566,2994,4009,21096,25105
00732908,ITT TECHNICAL INSTITUTE                 ,IN,46143-1067,Proprietary  ,0,0,0,3,16,19
00732933,ITT TECHNICAL INSTITUTE                 ,IN,46635-1512,Proprietary  ,9,75,84,504,1711,2215
00732962,ITT TECHNICAL INSTITUTE                 ,IN,47630-7430,Proprietary  ,70,448,518,1141,4965,6106
00732968,ITT TECHNICAL INSTITUTE                 ,IN,46410-0000,Proprietary  ,19,42,61,265,841,1106
00732993,ITT TECHNICAL INSTITUTE                 ,IN,46825-2393,Proprietary  ,46,246,292,1439,4386,5825
00736200,MEDTECH COLLEGE                         ,IN,46250-3970,Proprietary  ,6,58,64,472,2854,3326
00736202,MEDTECH COLLEGE - GREENWOOD             ,IN,46143-6478,Proprietary  ,8,46,54,224,1376,1600
00736204,MEDTECH COLLEGE - FORT WAYNE            ,IN,46804-2209,Proprietary  ,2,31,33,280,1407,1687
00793800,LINCOLN COLLEGE OF TECHNOLOGY           ,IN,46202-0000,Proprietary  ,105,97,202,2100,1556,3656
00931306,DAYMAR COLLEGE - ROCKPORT               ,IN,47635-1506,Proprietary  ,0,1,1,13,98,111
00951500,J MICHAEL HARROLD BEAUTY ACADEMY        ,IN,47807-3390,Proprietary  ,3,9,12,93,212,305
00961200,"APEX SCHOOL OF BEAUTY CULTURE, INC      ",IN,46016-0000,Proprietary  ,0,3,3,22,71,93
00961300,MERRILLVILLE BEAUTY COLLEGE             ,IN,46410-3401,Proprietary  ,2,16,18,61,228,289
00967300,RUDAE'S SCHOOL OF BEAUTY CULTURE        ,IN,46825-5444,Proprietary  ,5,16,21,137,386,523
00977700,KAPLAN COLLEGE                          ,IN,46278-1736,Proprietary  ,7,38,45,502,2240,2742
00977702,KAPLAN COLLEGE - TEMPORARY FACILITY EXPA,IN,46268-4111,Proprietary  ,2,9,11,24,178,202
00977703,KAPLAN COLLEGE -  SE INDY               ,IN,46227-0000,Proprietary  ,21,91,112,281,1453,1734
00991700,IVY TECH COMMUNITY COLLEGE OF INDIANA   ,IN,46208-1763,Public       ,519,2833,3352,47009,122335,169344
01015100,VINCENNES BEAUTY COLLEGE                ,IN,47591-1297,Proprietary  ,1,5,6,84,146,230
01040900,LAFAYETTE BEAUTY ACADEMY                ,IN,47901-1149,Proprietary  ,3,7,10,96,247,343
01048900,NATIONAL COLLEGE                        ,IN,46250-1930,Proprietary  ,0,21,21,65,611,676
01048910,NATIONAL COLLEGE - SOUTH BEND           ,IN,46617-3123,Proprietary  ,2,17,19,134,681,815
01048911,NATIONAL COLLEGE - FORT WAYNE           ,IN,46826-4905,Proprietary  ,1,10,11,83,434,517
01061800,MID-AMERICA CLG FUNERAL SERVICE         ,IN,47130-9990,Private      ,1,1,2,72,189,261
01150500,CREATIVE HAIR STYLING ACADEMY           ,IN,46322-1554,Proprietary  ,7,14,21,132,243,375
02084800,RAVENSCROFT BEAUTY COLLEGE              ,IN,46815-0000,Proprietary  ,3,20,23,139,421,560
02087600,CONCORDIA THEOLOGICAL SEMINARY          ,IN,46825-0000,Private      ,0,11,11,13,299,312
02100402,EVEREST INSTITUTE - EVEREST COLLEGE     ,IN,46410-7064,Proprietary  ,16,64,80,375,1708,2083
02140800,MARTIN UNIVERSITY                       ,IN,46218-0000,Private      ,7,37,44,301,1987,2288
02158400,HARRISON COLLEGE                        ,IN,46204-2611,Proprietary  ,14,160,174,875,4727,5602
02158401,HARRISON COLLEGE - COLUMBUS             ,IN,47203-1843,Proprietary  ,3,27,30,196,817,1013
02158402,HARRISON COLLEGE - LAFAYETTE            ,IN,47905-4859,Proprietary  ,2,33,35,260,934,1194
02158405,HARRISON COLLEGE - TERRE HAUTE          ,IN,47802-0000,Proprietary  ,3,51,54,169,872,1041
02158407,HARRISON COLLEGE - ANDERSON             ,IN,46013-0000,Proprietary  ,2,33,35,175,864,1039
02158409,HARRISON COLLEGE - EVANSVILLE           ,IN,47715-3901,Proprietary  ,2,29,31,221,891,1112
02158410,HARRISON COLLEGE - EAST                 ,IN,46239-8903,Proprietary  ,3,40,43,282,1410,1692
02158412,HARRISON COLLEGE - FORT WAYNE           ,IN,46825-0000,Proprietary  ,2,30,32,261,1159,1420
02158413,HARRISON COLLEGE - NORTHWEST            ,IN,46278-0000,Proprietary  ,4,13,17,257,679,936
02158415,HARRISON COLLEGE - MUNCIE               ,IN,47303-0000,Proprietary  ,0,6,6,197,766,963
02158416,HARRISON COLLEGE - ELKHART              ,IN,46516-0000,Proprietary  ,2,7,9,96,652,748
02158800,DON ROBERTS BEAUTY SCHOOLS              ,IN,46383-0000,Proprietary  ,0,5,5,52,121,173
02164300,DON ROBERTS SCHOOL OF HAIR DESIGN       ,IN,46375-9999,Proprietary  ,1,7,8,43,114,157
02180108,ROSS MEDICAL EDUCATION CENTER -         ,IN,46530-4479,Proprietary  ,2,4,6,37,184,221
02201800,KAPLAN COLLEGE                          ,IN,46324-3347,Proprietary  ,7,40,47,299,1264,1563
02241700,PJ'S COLLEGE OF COSMETOLOGY             ,IN,47129-0000,Proprietary  ,3,14,17,77,273,350
02245505,FORTIS COLLEGE - INDIANAPOLIS CAMPUS    ,IN,46268-0000,Proprietary  ,0,20,20,116,593,709
02302700,J EVERETT LIGHT CAREER CENTER           ,IN,46240-0000,Public       ,1,8,9,120,563,683
02304800,PJ'S COLLEGE OF COSMETOLOGY             ,IN,47374-0000,Proprietary  ,0,7,7,50,166,216
02308900,MASTER'S OF COSMETOLOGY COLLEGE         ,IN,46809-0000,Proprietary  ,3,5,8,187,300,487
02339600,ROGER'S ACADEMY OF HAIR DESIGN          ,IN,47712-0000,Proprietary  ,6,19,25,112,303,415
02345200,EMPIRE BEAUTY SCHOOL                    ,IN,46237-0000,Proprietary  ,20,41,61,309,962,1271
02351300,KNOX BEAUTY COLLEGE                     ,IN,46534-0000,Proprietary  ,0,1,1,15,38,53
02490500,HAIR FASHIONS BY KAYE BEAUTY CLG        ,IN,46250-0000,Proprietary  ,5,16,21,138,455,593
02490800,HAIR FASHIONS BY KAYE BEAUTY CLG        ,IN,46060-0000,Proprietary  ,3,6,9,48,100,148
02607000,HAIR ARTS ACADEMY                       ,IN,47404-2419,Proprietary  ,0,6,6,75,222,297
02615800,COLLEGE OF COURT REPORTING              ,IN,46342-5969,Proprietary  ,1,13,14,42,391,433
03100600,MARION COMM TUCKER AREA VOC SCHOOL      ,IN,46952-3831,Public       ,0,4,4,87,301,388
03176300,AVIATION INSTITUTE OF MAINTENANCE       ,IN,46241-1445,Proprietary  ,7,36,43,195,657,852
03262300,DAVID DEMUTH INSTITUTE OF COSM          ,IN,47374-4101,Proprietary  ,0,0,0,25,68,93
03456700,CROSSROADS BIBLE COLLEGE                ,IN,46219-4912,Private      ,1,6,7,94,479,573
03538300,ALEXANDRIA SCH OF SCIENTIFIC THERAP     ,IN,46001-0287,Proprietary  ,0,2,2,32,103,135
04038700,IDEAL BEAUTY ACADEMY                    ,IN,47130-4215,Proprietary  ,1,7,8,37,127,164
04051304,ART INSTITUTE OF PHOENIX (THE) - ART  IN,IN,46268-1170,Proprietary  ,7,31,38,1401,1511,2912
04051311,ART INSTITUTE OF PHOENIX (THE) - BROWN M,IN,46410-5608,Proprietary  ,6,47,53,244,1213,1457
04051312,ART INSTITUTE OF PHOENIX (THE) - BROWN M,IN,46360-7362,Proprietary  ,8,28,36,152,732,884
04051318,ART INSTITUTE OF PHOENIX (THE) - BROWN M,IN,46204-1017,Proprietary  ,7,98,105,435,2383,2818
04051321,ART INSTITUTE OF PHOENIX (THE) - BROWN M,IN,46635-1176,Proprietary  ,1,23,24,316,1257,1573
04051322,ART INSTITUTE OF PHOENIX (THE) - BROWN M,IN,46805-0000,Proprietary  ,3,40,43,370,1817,2187
04100300,SUCCESS SCHOOLS                         ,IN,46410-5310,Proprietary  ,4,12,16,128,342,470
04121000,TECHSKILLS - INDIANAPOLIS               ,IN,46240-4302,Proprietary  ,5,34,39,98,504,602
04130900,HONORS BEAUTY COLLEGE                   ,IN,46256-3317,Proprietary  ,5,14,19,126,350,476
04155900,AVEDA FREDRIC'S INSTITUTE               ,IN,46250-4746,Proprietary  ,2,4,6,177,298,475
04166700,REM SPA INC                             ,IN,46013-3136,Proprietary  ,0,9,9,69,201,270
04171700,AVANT GARD THE SCHOOL                   ,IN,46214-6500,Proprietary  ,2,1,3,35,95,130
04172700,SALON PROFESSIONAL ACADEMY (THE)        ,IN,47715-7822,Proprietary  ,0,6,6,116,282,398
04184000,PAUL MITCHELL THE SCHOOL INDIANAPOLIS   ,IN,46227-6252,Proprietary  ,1,8,9,247,414,661
04186600,SALON PROFESSIONAL ACADEMY (THE)        ,IN,46901-6248,Proprietary  ,0,3,3,98,258,356
04205500,LIL LOU'S BARBER COLLEGE                ,IN,46409-2645,Proprietary  ,1,11,12,31,173,204
00190100,ALLEN COUNTY COMMUNITY COLLEGE          ,KS,66749-1607,Public       ,18,57,75,1254,1931,3185
00190200,COWLEY COUNTY COMMUNITY COLLEGE & AREA V,KS,67005-2662,Public       ,40,140,180,1965,3511,5476
00190300,BAKER UNIVERSITY                        ,KS,66006-0065,Private      ,1,103,104,1491,2632,4123
00190400,BETHANY COLLEGE                         ,KS,67456-1897,Private      ,1,0,1,803,129,932
00190500,BETHEL COLLEGE                          ,KS,67117-8061,Private      ,1,2,3,631,187,818
00190600,BUTLER COUNTY COMMUNITY COLLEGE         ,KS,67042-3280,Public       ,67,163,230,5119,6804,11923
00190700,CENTRAL BAPTIST THEOLOGY SEMINARY       ,KS,66226-3513,Private      ,0,3,3,0,74,74
00190800,CENTRAL CHRISTIAN COLLEGE OF KANSAS     ,KS,67460-5799,Private      ,4,87,91,431,897,1328
00190900,CLOUD COUNTY COMMUNITY COLLEGE          ,KS,66901-1002,Public       ,18,40,58,944,1385,2329
00191000,COFFEYVILLE COMMUNITY COLLEGE           ,KS,67337-5064,Public       ,51,18,69,1207,715,1922
00191100,COLBY COMMUNITY COLLEGE                 ,KS,67701-4099,Public       ,8,22,30,706,583,1289
00191300,DODGE CITY COMMUNITY COLLEGE            ,KS,67801-2399,Public       ,38,29,67,1070,894,1964
00191400,DONNELLY COLLEGE                        ,KS,66102-4298,Private      ,12,39,51,305,930,1235
00191500,FORT HAYS STATE UNIVERSITY              ,KS,67601-4099,Public       ,18,209,227,4403,6470,10873
00191600,FORT SCOTT COMMUNITY COLLEGE            ,KS,66701-3199,Public       ,57,30,87,1334,1273,2607
00191700,BARCLAY COLLEGE                         ,KS,67059-0288,Private      ,0,1,1,171,152,323
00191800,FRIENDS UNIVERSITY                      ,KS,67213-3397,Private      ,6,65,71,1584,3313,4897
00191900,GARDEN CITY COMMUNITY COLLEGE           ,KS,67846-6398,Public       ,28,37,65,974,854,1828
00192000,HESSTON COLLEGE                         ,KS,67062-2093,Private      ,1,4,5,520,215,735
00192100,HIGHLAND COMMUNITY COLLEGE              ,KS,66035-4062,Public       ,44,32,76,1451,1731,3182
00192300,HUTCHINSON COMMUNITY COLLEGE            ,KS,67501-5894,Public       ,62,87,149,2757,3381,6138
00192400,INDEPENDENCE COMMUNITY COLLEGE          ,KS,67301-0708,Public       ,62,29,91,774,625,1399
00192500,KANSAS CITY KANSAS COMMUNITY CLG        ,KS,66112-9978,Public       ,74,189,263,2559,6654,9213
00192600,PITTSBURG STATE UNIVERSITY              ,KS,66762-7500,Public       ,17,79,96,5889,3478,9367
00192700,EMPORIA STATE UNIVERSITY                ,KS,66801-5087,Public       ,5,44,49,3584,3223,6807
00192800,KANSAS STATE UNIVERSITY                 ,KS,66506-1104,Public       ,52,123,175,17833,8151,25984
00192900,KANSAS WESLEYAN UNIVERSITY              ,KS,67401-6196,Private      ,2,5,7,1143,424,1567
00193000,LABETTE COMMUNITY COLLEGE               ,KS,67357-4299,Public       ,6,44,50,763,1082,1845
00193100,MANHATTAN CHRISTIAN COLLEGE             ,KS,66502-4081,Private      ,1,4,5,386,159,545
00193300,MCPHERSON COLLEGE                       ,KS,67460-3899,Private      ,2,3,5,928,209,1137
00193600,NEOSHO COUNTY COMMUNITY COLLEGE         ,KS,66720-2699,Public       ,7,30,37,894,1529,2423
00193700,OTTAWA UNIVERSITY                       ,KS,66067-3399,Private      ,1,95,96,1054,3499,4553
00193800,PRATT COMMUNITY COLLEGE                 ,KS,67124-8432,Public       ,5,21,26,662,966,1628
00193900,NEWMAN UNIVERSITY                       ,KS,67213-2084,Private      ,7,34,41,1585,2184,3769
00194000,SOUTHWESTERN COLLEGE                    ,KS,67156-2499,Private      ,1,49,50,870,1548,2418
00194300,UNIVERSITY OF ST MARY                   ,KS,66048-5023,Private      ,4,45,49,729,900,1629
00194500,STERLING COLLEGE                        ,KS,67579-1533,Private      ,4,3,7,852,198,1050
00194600,TABOR COLLEGE                           ,KS,67063-1799,Private      ,1,7,8,926,354,1280
00194800,UNIVERSITY OF KANSAS                    ,KS,66045-7535,Public       ,47,153,200,18598,11742,30340
00194900,WASHBURN UNIVERSITY                     ,KS,66621-1110,Public       ,14,59,73,3710,4611,8321
00194901,WASHBURN INSTITUTE OF TECHNOLOGY        ,KS,66604-2199,Public       ,5,32,37,1006,1838,2844
00195000,WICHITA STATE UNIVERSITY                ,KS,67208-0000,Public       ,44,217,261,8166,10014,18180
00460800,BARTON COUNTY COMMUNITY COLLEGE         ,KS,67530-9283,Public       ,23,116,139,1107,2728,3835
00526400,FLINT HILLS TECHNICAL COLLEGE           ,KS,66801-5999,Public       ,3,10,13,378,640,1018
00526500,NORTH CENTRAL KANSAS TECH COLG          ,KS,67420-0000,Public       ,3,8,11,411,411,822
00526700,NORTHWEST KANSAS TECHNICAL SCHOOL       ,KS,67735-3441,Public       ,19,6,25,329,229,558
00549800,WICHITA AREA TECHNICAL COLLEGE          ,KS,67211-2099,Public       ,33,162,195,830,3777,4607
00549900,SALINA AREA TECHNICAL COLLEGE           ,KS,67401-8195,Public       ,0,2,2,234,355,589
00550000,MANHATTAN AREA TECHNICAL COLLEGE        ,KS,66503-2499,Public       ,4,22,26,478,962,1440
00675500,BROWN MACKIE COLLEGE (THE)              ,KS,67401-7307,Proprietary  ,17,120,137,564,2114,2678
00703200,MID AMERICA NAZARENE UNIVERSITY         ,KS,66062-1899,Private      ,4,60,64,1201,1647,2848
00822800,SEWARD CO COMM CO/AREA TECHNICAL SCHOOL ,KS,67905-0000,Public       ,8,23,31,633,641,1274
00824400,JOHNSON COUNTY COMMUNITY COLLEGE        ,KS,66210-1299,Public       ,46,228,274,7076,10466,17542
00833200,B-STREET DESIGN SCHOOL OF INTERNATIONAL ,KS,66502-6082,Proprietary  ,0,11,11,56,155,211
00833201,B-STREET DESIGN SCHOOL OF INTERNATIONAL ,KS,66046-2743,Proprietary  ,5,6,11,52,108,160
00869423,RASMUSSEN COLLEGE - OVERLAND PARK       ,KS,66210-2786,Proprietary  ,0,3,3,0,3,3
00869424,RASMUSSEN COLLEGE - TOPEKA              ,KS,66606-2339,Proprietary  ,1,8,9,1,8,9
01025600,BENEDICTINE COLLEGE                     ,KS,66002-1499,Private      ,1,1,2,2586,232,2818
01043800,HASKELL INDIAN NATIONS UNIVERSITY       ,KS,66046-4800,Public       ,5,3,8,1275,931,2206
01050300,WICHITA TECHNICAL INSTITUTE             ,KS,67213-1927,Proprietary  ,15,78,93,316,1617,1933
01050302,WICHITA TECHNICAL INSTITUTE - WTI TOPEKA,KS,66609-1217,Proprietary  ,4,37,41,94,604,698
01050305,WICHITA TECHNICAL INSTITUTE - EAST CAMPU,KS,67208-4243,Proprietary  ,2,31,33,99,641,740
02090700,CLEVELAND CHIROPRACTIC COLLEGE          ,KS,66210-1613,Private      ,0,4,4,57,613,670
02134800,OLD TOWN BARBER AND BEAUTY COLLEGE      ,KS,67211-0000,Proprietary  ,1,13,14,54,175,229
02257700,HAYS ACADEMY OF HAIR DESIGN             ,KS,67601-0000,Proprietary  ,2,5,7,83,139,222
02303500,AMERICAN INSTITUTE OF BAKING            ,KS,66502-0000,Private      ,0,0,0,4,3,7
02340700,LABARON HAIRDRESSING ACADEMY            ,KS,66204-0000,Proprietary  ,1,2,3,14,81,95
02590900,WRIGHT CAREER COLLEGE                   ,KS,66212-0000,Private      ,54,355,409,529,4213,4742
02599709,VATTEROTT COLLEGE - WICHITA             ,KS,67226-1304,Proprietary  ,3,49,52,123,820,943
02603100,XENON INTERNATIONAL ACADEMY             ,KS,67203-5428,Proprietary  ,12,12,24,172,331,503
02606300,PAUL MITCHELL THE SCHOOL WICHITA        ,KS,67226-2803,Proprietary  ,10,19,29,163,280,443
02611005,HERITAGE COLLEGE - WICHITA              ,KS,67210-1879,Proprietary  ,11,36,47,214,953,1167
02613000,PINNACLE CAREER INSTITUTE               ,KS,66046-2703,Proprietary  ,7,50,57,81,491,572
03031300,XENON INTERNATIONAL ACADEMY IV          ,KS,66061-3765,Proprietary  ,2,6,8,50,130,180
03066200,BRYAN COLLEGE                           ,KS,66604-2496,Proprietary  ,2,14,16,49,404,453
03450300,B-STREET DESIGN SCHOOL OF INTERNATIONAL ,KS,66611-2373,Proprietary  ,11,27,38,71,203,274
03450301,B-STREET DESIGN SCHOOL OF INTERNATIONAL ,KS,67207-5148,Proprietary  ,6,12,18,64,190,254
03450302,B-STREET DESIGN SCHOOL OF INTERNATIONAL ,KS,66212-5451,Proprietary  ,9,19,28,107,223,330
03529300,SIDNEY'S HAIRDRESSING COLLEGE           ,KS,67501-7094,Proprietary  ,1,2,3,35,74,109
04132900,Z HAIR ACADEMY                          ,KS,66046-4040,Proprietary  ,0,3,3,54,96,150
04162700,ERIC FISHER ACADEMY                     ,KS,67212-3376,Proprietary  ,1,4,5,170,255,425
04175700,ACADEMY OF AESTHETIC ARTS               ,KS,66203-3502,Proprietary  ,0,1,1,22,83,105
04179600,ENTOURAGE INSTITUTE OF BEAUTY AND ESTHET,KS,66215-3803,Proprietary  ,2,13,15,24,81,105
04205300,MITSU SATO HAIR ACADEMY                 ,KS,66212-1457,Proprietary  ,1,1,2,21,50,71
04209300,PAUL MITCHELL THE SCHOOL - OVERLAND PARK,KS,66212-4050,Proprietary  ,5,2,7,79,134,213
00203300,UNIVERSITY OF MAINE-PRESQUE ISLE        ,ME,04769-2888,Public       ,3,6,9,919,695,1614
00203500,BANGOR THEOLOGICAL SEMINARY             ,ME,04402-0411,Private      ,0,0,0,7,67,74
00203600,BATES COLLEGE                           ,ME,04240-6028,Private      ,1,0,1,2936,158,3094
00203800,BOWDOIN COLLEGE                         ,ME,04011-8451,Private      ,1,0,1,4086,126,4212
00203900,COLBY COLLEGE                           ,ME,04901-8841,Private      ,1,2,3,3225,117,3342
00204000,UNIVERSITY OF MAINE-FARMINGTON          ,ME,04938-1990,Public       ,1,6,7,2806,661,3467
00204100,UNIVERSITY OF MAINE-FORT KENT           ,ME,04743-1292,Public       ,1,9,10,700,522,1222
00204300,HUSSON UNIVERSITY                       ,ME,04401-2999,Private      ,0,18,18,2873,1771,4644
00204400,MAINE MARITIME ACADEMY                  ,ME,04420-0001,Public       ,0,1,1,1219,188,1407
00205000,UNIVERSITY OF NEW ENGLAND               ,ME,04005-9599,Private      ,1,48,49,4693,4598,9291
00205100,SAINT JOSEPH'S COLLEGE                  ,ME,04084-5236,Private      ,3,48,51,1902,1906,3808
00205200,THOMAS COLLEGE                          ,ME,04901-5097,Private      ,0,3,3,1221,363,1584
00205300,UNIVERSITY OF MAINE                     ,ME,04469-0001,Public       ,19,38,57,12047,3501,15548
00205400,UNIVERSITY OF SOUTHERN MAINE            ,ME,04104-0000,Public       ,3,29,32,7166,6697,13863
00205500,UNIVERSITY OF MAINE-MACHIAS             ,ME,04654-1397,Public       ,1,10,11,606,516,1122
00458615,KAPLAN UNIVERSITY - PORTLAND            ,ME,04106-2415,Proprietary  ,4,50,54,221,1149,1370
00458616,KAPLAN UNIVERSITY - LEWISTON            ,ME,04240-0000,Proprietary  ,7,62,69,154,1337,1491
00520400,BEAL COLLEGE                            ,ME,04401-6896,Proprietary  ,3,11,14,315,875,1190
00527600,CENTRAL MAINE COMMUNITY COLLEGE         ,ME,04210-6498,Public       ,5,14,19,1765,2545,4310
00527700,EASTERN MAINE COMMUNITY COLLEGE         ,ME,04401-4280,Public       ,7,16,23,2050,2159,4209
00552500,SOUTHERN MAINE COMMUNITY  COLLEGE       ,ME,04106-1698,Public       ,9,44,53,4637,5346,9983
00576000,NORTHERN MAINE COMMUNITY COLLEGE        ,ME,04769-2016,Public       ,1,0,1,586,736,1322
00630500,CENTRAL MAINE MEDICAL CENTER COLLEGE OF ,ME,04243-9986,Private      ,0,2,2,120,384,504
00676000,UNIVERSITY OF MAINE-AUGUSTA             ,ME,04330-9410,Public       ,4,43,47,1914,6019,7933
00685800,UNITY COLLEGE                           ,ME,04988-9502,Private      ,1,0,1,873,159,1032
00903800,MR BERNARD'S SCH HAIR FASHION INC       ,ME,04243-1163,Proprietary  ,0,11,11,57,238,295
00923100,WASHINGTON COUNTY COMMUNITY COLLEGE     ,ME,04619-9704,Public       ,0,0,0,306,346,652
00945900,EMPIRE BEAUTY SCHOOL                    ,ME,04101-3348,Proprietary  ,7,26,33,238,504,742
00982600,KENNEBEC VALLEY  COMMUNITY  COLLEGE     ,ME,04937-1367,Public       ,4,28,32,1015,2292,3307
01138500,COLLEGE OF THE ATLANTIC                 ,ME,04609-1105,Private      ,0,1,1,575,124,699
01167300,MAINE COLLEGE OF ART                    ,ME,04101-3987,Private      ,0,1,1,723,262,985
02104400,SPA TECH INSTITUTE                      ,ME,04093-0000,Proprietary  ,3,9,12,185,590,775
02347100,NEW ENGLAND SCHOOL OF COMMUNICATIONS    ,ME,04401-0000,Private      ,1,2,3,657,213,870
02361300,LANDING SCHOOL OF BOATBUILDING & DESIGN ,ME,04046-1490,Private      ,0,0,0,36,54,90
03122900,YORK COUNTY COMMUNITY COLLEGE           ,ME,04090-0529,Public       ,3,30,33,736,1227,1963
03429300,SEACOAST CAREER SCHOOLS                 ,ME,04073-0000,Proprietary  ,14,79,93,165,668,833
03612300,BIRTHWISE MIDWIFERY SCHOOL              ,ME,04009-1110,Proprietary  ,0,0,0,8,89,97
04177400,CAPILO SCHOOL OF HAIR DESIGN            ,ME,04330-0000,Proprietary  ,8,12,20,85,160,245
04185100,NORTHEAST TECHNICAL INSTITUTE           ,ME,04074-0000,Proprietary  ,6,64,70,134,914,1048
04188800,INSTITUTE FOR DOCTORAL STUDIES IN THE VI,ME,04102-0000,Private      ,0,5,5,1,60,61
04214100,COSMOTECH SCHOOL OF COSMETOLOGY         ,ME,04092-2878,Proprietary  ,5,4,9,6,6,12
00209300,ST JOHN'S COLLEGE                       ,NM,87505-4599,Private      ,0,5,5,456,244,700
00264900,SANTA FE UNIVERSITY OF ART AND DESIGN   ,NM,87505-7634,Proprietary  ,3,3,6,1100,326,1426
00265000,UNIVERSITY OF THE SOUTHWEST             ,NM,88240-9129,Private      ,2,57,59,378,952,1330
00265100,EASTERN NEW MEXICO UNIV PORTALES        ,NM,88130-6000,Public       ,17,85,102,3565,3584,7149
00265101,EASTERN NEW MEXICO UNIV-ROSWELL CAM     ,NM,88202-0000,Public       ,34,64,98,1381,2155,3536
00265300,NEW MEXICO HIGHLANDS UNIVERSITY         ,NM,87701-4436,Public       ,12,60,72,2546,2997,5543
00265400,NEW MEXICO INST OF MINING & TECH        ,NM,87801-4796,Public       ,5,11,16,1449,581,2030
00265500,NEW MEXICO JUNIOR COLLEGE               ,NM,88240-9123,Public       ,29,39,68,899,1140,2039
00265600,NEW MEXICO MILITARY INSTITUTE           ,NM,88201-5173,Public       ,4,0,4,553,70,623
00265700,NEW MEXICO STATE UNIVERSITY             ,NM,88003-8001,Public       ,64,135,199,13462,9695,23157
00265701,NEW MEXICO STATE UNIV-ALAMOGORDO        ,NM,88311-0000,Public       ,10,50,60,745,1826,2571
00265702,NEW MEXICO STATE UNIV.-DONA ANA CLG     ,NM,88003-0000,Public       ,27,82,109,3989,5732,9721
00265703,NEW MEXICO STATE UNIV-CARLSBAD          ,NM,88220-0000,Public       ,4,27,31,461,814,1275
00265704,NEW MEXICO STATE UNIV-GRANTS            ,NM,87020-0000,Public       ,5,18,23,314,737,1051
00266000,SAN JUAN COLLEGE                        ,NM,87402-4699,Public       ,30,128,158,2402,5835,8237
00266300,THE UNIVERSITY OF NEW MEXICO            ,NM,87131-0001,Public       ,167,393,560,20963,23162,44125
00266301,UNIVERSITY OF NEW MEXICO                ,NM,87301-5697,Public       ,0,0,0,64,227,291
00266302,UNIVERSITY OF NEW MEXICO                ,NM,87031-0000,Public       ,0,0,0,72,185,257
00266303,UNIVERSITY OF NEW MEXICO                ,NM,87544-2233,Public       ,0,0,0,30,20,50
00266304,UNIVERSITY OF NEW MEXICO                ,NM,87571-6401,Public       ,0,0,0,49,95,144
00266400,WESTERN NEW MEXICO UNIVERSITY           ,NM,88061-5417,Public       ,12,68,80,1583,2487,4070
00405701,NATIONAL AMERICAN UNIVERSITY            ,NM,87110-0000,Proprietary  ,0,20,20,115,861,976
00474200,CENTRAL NEW MEXICO COMMUNITY COLLEGE    ,NM,87106-4096,Public       ,262,1056,1318,10641,22903,33544
00474300,CLOVIS COMMUNITY COLLEGE                ,NM,88101-8381,Public       ,11,78,89,854,2259,3113
00996200,LUNA COMMUNITY COLLEGE                  ,NM,87701-0000,Public       ,12,33,45,596,918,1514
01063200,DEWOLFF CLG HAIRSTYLING/COSMETOLOGY     ,NM,87112-4113,Proprietary  ,2,23,25,125,322,447
01300500,OLYMPIAN UNIVERSITY OF COSMETOLOGY      ,NM,88310-5051,Proprietary  ,35,112,147,507,1623,2130
02083900,NORTHERN NEW MEXICO COLLEGE             ,NM,87530-0000,Public       ,4,18,22,752,1226,1978
02146400,INSTITUTE OF AMERICAN INDIAN ARTS       ,NM,87508-0000,Public       ,2,7,9,222,362,584
02151102,ATI COLLEGE OF HEALTH - ATI CAREER TRAIN,NM,87109-2016,Proprietary  ,0,0,0,111,375,486
02218808,BROOKLINE COLLEGE - ALBUQUERQUE         ,NM,87105-1649,Proprietary  ,19,77,96,306,1157,1463
02278100,SANTA FE COMMUNITY COLLEGE              ,NM,87507-0000,Public       ,24,117,141,1283,3253,4536
02357600,NAVAJO TECHNICAL COLLEGE                ,NM,87313-0000,Public       ,16,42,58,672,1520,2192
02511000,SOUTHWESTERN INDIAN POLYTECH INST       ,NM,87184-0000,Public       ,21,36,57,430,696,1126
02572003,COMPUTER CAREER CENTER - LAS CRUCES CAMP,NM,88011-8220,Proprietary  ,14,43,57,213,771,984
02622000,SOUTHWEST ACUPUNCTURE COLLEGE           ,NM,87505-0000,Proprietary  ,0,4,4,7,348,355
03076100,SOUTHWESTERN COLLEGE                    ,NM,87507-0000,Private      ,0,5,5,34,290,324
03206300,MESALANDS COMMUNITY COLLEGE             ,NM,88401-3352,Public       ,0,7,7,189,312,501
03430300,UNIVERSAL THERAPEUTIC MASSAGE INSTITUTE ,NM,87107-4403,Proprietary  ,2,14,16,72,285,357
03678300,PIMA MEDICAL INSTITUTE                  ,NM,87110-0000,Proprietary  ,5,36,41,418,1045,1463
03944300,MASSAGE THERAPY TRAINING INSTITUTE      ,NM,88007-0000,Proprietary  ,0,3,3,64,153,217
04162400,TONI AND GUY HAIR ACADEMY               ,NM,87106-4404,Proprietary  ,3,13,16,104,228,332
04174500,AVEDA INSTITUTE OF NEW MEXICO (THE)     ,NM,87110-3640,Proprietary  ,4,22,26,202,485,687
04178500,VOGUE COLLEGE OF COSMETOLOGY            ,NM,87505-7636,Proprietary  ,5,8,13,60,169,229
00223400,ADRIAN COLLEGE                          ,MI,49221-2575,Private      ,6,9,15,3172,504,3676
00223500,ALBION COLLEGE                          ,MI,49224-1831,Private      ,1,3,4,2521,199,2720
00223600,ALMA COLLEGE                            ,MI,48801-1599,Private      ,5,1,6,2736,210,2946
00223700,ALPENA COMMUNITY COLLEGE                ,MI,49707-1495,Public       ,3,20,23,1264,1400,2664
00223800,ANDREWS UNIVERSITY                      ,MI,49104-0750,Private      ,6,35,41,2252,1674,3926
00223900,AQUINAS COLLEGE                         ,MI,49506-1799,Private      ,3,14,17,3122,1061,4183
00224000,BAY DE NOC COMMUNITY COLLEGE            ,MI,49829-2524,Public       ,10,25,35,1401,1984,3385
00224100,CALVIN COLLEGE                          ,MI,49546-4388,Private      ,8,8,16,4811,737,5548
00224200,CALVIN THEOLOGICAL SEMINARY             ,MI,49546-4387,Private      ,0,2,2,22,226,248
00224300,CENTRAL MICHIGAN UNIVERSITY             ,MI,48859-0001,Public       ,34,196,230,26484,12755,39239
00224600,CLEARY UNIVERSITY                       ,MI,48105-2659,Private      ,5,24,29,189,1013,1202
00224700,CONCORDIA UNIVERSITY-ANN ARBOR          ,MI,48105-2797,Private      ,3,8,11,932,473,1405
00224800,CRANBROOK ACADEMY OF ART                ,MI,48303-0000,Private      ,0,2,2,44,323,367
00224900,DAVENPORT UNIVERSITY                    ,MI,49503-0000,Private      ,33,367,400,3912,15257,19169
00225100,DELTA COLLEGE                           ,MI,48710-0001,Public       ,35,155,190,7218,9954,17172
00225400,MICHIGAN STATE UNIVERSITY COLLEGE OF LAW,MI,48824-1300,Private      ,3,10,13,398,2517,2915
00225900,EASTERN MICHIGAN UNIVERSITY             ,MI,48197-2214,Public       ,79,221,300,20330,17554,37884
00226000,FERRIS STATE UNIVERSITY                 ,MI,49307-2251,Public       ,40,138,178,16788,9185,25973
00226100,CHARLES STEWART MOTT COMMUNITY CLG      ,MI,48503-2089,Public       ,80,267,347,7132,13211,20343
00226200,KETTERING UNIVERSITY                    ,MI,48504-4898,Private      ,9,12,21,2450,657,3107
00226300,GLEN OAKS COMMUNITY COLLEGE             ,MI,49032-9784,Public       ,11,47,58,765,1424,2189
00226400,GOGEBIC COMMUNITY COLLEGE               ,MI,49938-1365,Public       ,8,16,24,788,750,1538
00226500,GRACE BIBLE COLLEGE                     ,MI,49509-1998,Private      ,0,17,17,504,484,988
00226600,CORNERSTONE UNIVERSITY                  ,MI,49525-5897,Private      ,4,68,72,2476,2469,4945
00226700,GRAND RAPIDS COMMUNITY COLLEGE          ,MI,49503-3295,Public       ,74,258,332,13323,15668,28991
00226800,GRAND VALLEY STATE UNIVERSITY           ,MI,49401-9403,Public       ,27,141,168,27760,10117,37877
00226900,GREAT LAKES CHRISTIAN COLLEGE           ,MI,48917-1299,Private      ,0,2,2,256,227,483
00227000,HENRY FORD COMMUNITY COLLEGE            ,MI,48128-1495,Public       ,137,681,818,12918,24598,37516
00227300,HOPE COLLEGE                            ,MI,49423-3607,Private      ,4,4,8,4889,318,5207
00227400,JACKSON COMMUNITY COLLEGE               ,MI,49201-8399,Public       ,37,169,206,4178,6835,11013
00227500,KALAMAZOO COLLEGE                       ,MI,49006-3295,Private      ,3,11,14,2327,437,2764
00227600,KELLOGG COMMUNITY COLLEGE               ,MI,49017-3397,Public       ,22,175,197,3261,7226,10487
00227700,LAKE MICHIGAN COLLEGE                   ,MI,49022-1899,Public       ,22,103,125,2187,4242,6429
00227800,LANSING COMMUNITY COLLEGE               ,MI,48933-1293,Public       ,109,412,521,11477,15896,27373
00227900,LAWRENCE TECHNOLOGICAL UNIVERSITY       ,MI,48075-1058,Private      ,9,39,48,2260,1948,4208
00228200,MADONNA UNIVERSITY                      ,MI,48150-1173,Private      ,5,43,48,2209,4503,6712
00228400,MARYGROVE COLLEGE                       ,MI,48221-2599,Private      ,4,144,148,1408,4643,6051
00228800,ROCHESTER COLLEGE                       ,MI,48307-2764,Private      ,7,9,16,1042,1144,2186
00229000,MICHIGAN STATE UNIVERSITY               ,MI,48824-1113,Public       ,105,320,425,42948,17048,59996
00229200,MICHIGAN TECHNOLOGICAL UNIV             ,MI,49931-1295,Public       ,8,13,21,6458,1201,7659
00229300,LAKE SUPERIOR STATE UNIVERSITY          ,MI,49783-1691,Public       ,5,14,19,2902,1160,4062
00229400,MONROE COUNTY COMMUNITY CLG             ,MI,48161-9746,Public       ,20,88,108,2219,3332,5551
00229500,MONTCALM COMMUNITY COLLEGE              ,MI,48885-9723,Public       ,11,48,59,1159,1977,3136
00229700,MUSKEGON COMMUNITY COLLEGE              ,MI,49442-1432,Public       ,20,70,90,3808,4750,8558
00229900,NORTH CENTRAL MICHIGAN COLLEGE          ,MI,49770-8740,Public       ,11,28,39,1463,1968,3431
00230100,NORTHERN MICHIGAN UNIVERSITY            ,MI,49855-5316,Public       ,10,34,44,9293,3529,12822
00230200,NORTHWESTERN MICHIGAN COLLEGE           ,MI,49686-3061,Public       ,14,58,72,3188,3973,7161
00230301,OAKLAND COMMUNITY COLLEGE - ORCHARD RIDG,MI,48334-4579,Public       ,34,139,173,4664,7095,11759
00230302,OAKLAND COMMUNITY COLLEGE - ROYAL OAK CA,MI,48067-3898,Public       ,54,220,274,5645,10380,16025
00230303,OAKLAND COMMUNITY COLLEGE - SOUTHFIELD C,MI,48075-4793,Public       ,56,383,439,4849,11914,16763
00230304,OAKLAND COMMUNITY COLLEGE - AUBURN HILLS,MI,48323-2845,Public       ,42,185,227,5868,8559,14427
00230305,OAKLAND COMMUNITY COLLEGE - HIGHLAND LAK,MI,48327-4187,Public       ,28,101,129,3257,4931,8188
00230700,OAKLAND UNIVERSITY                      ,MI,48309-4401,Public       ,48,156,204,18250,12642,30892
00230800,OLIVET COLLEGE                          ,MI,49076-9902,Private      ,30,14,44,1892,358,2250
00231000,ST. CLAIR COUNTY COMMUNITY COLLEGE      ,MI,48061-0000,Public       ,16,56,72,2617,3540,6157
00231100,KUYPER COLLEGE                          ,MI,49525-9749,Private      ,0,2,2,414,258,672
00231300,SACRED HEART MAJOR SEMINARY             ,MI,48206-1799,Private      ,0,9,9,39,221,260
00231400,SAGINAW VALLEY STATE UNIV               ,MI,48710-0001,Public       ,17,68,85,11543,5212,16755
00231500,SCHOOLCRAFT COLLEGE                     ,MI,48152-2696,Public       ,56,214,270,8008,12216,20224
00231600,SIENA HEIGHTS UNIVERSITY                ,MI,49221-1796,Private      ,7,56,63,1947,2635,4582
00231700,SOUTHWESTERN MICHIGAN COLLEGE           ,MI,49047-9793,Public       ,14,44,58,2255,2699,4954
00231800,SPRING ARBOR UNIVERSITY                 ,MI,49283-9984,Private      ,1,74,75,2688,4141,6829
00232200,FINLANDIA UNIVERSITY                    ,MI,49930-1882,Private      ,2,4,6,745,352,1097
00232300,UNIVERSITY OF DETROIT MERCY             ,MI,48221-3038,Private      ,24,89,113,4133,5269,9402
00232303,UNIV OF DETROIT MERCY - LAW SCHOOL      ,MI,48226-0000,Private      ,1,9,10,108,1009,1117
00232330,UNIV OF DETROIT MERCY - DENTAL SCHOOL   ,MI,48208-2576,Private      ,2,8,10,251,722,973
00232500,UNIVERSITY OF MICHIGAN - ANN ARBOR      ,MI,48109-1316,Public       ,213,121,334,38199,15305,53504
00232501,UNIVERSITY OF MICHIGAN-MEDICAL SCH      ,MI,48109-0000,Public       ,3,5,8,366,1290,1656
00232503,UNIVERSITY OF MICHIGAN LAW SCHOOL       ,MI,48109-0000,Public       ,2,3,5,167,2878,3045
00232600,UNIVERSITY OF MICHIGAN-DEARBORN         ,MI,48128-2406,Public       ,35,100,135,7957,7677,15634
00232700,UNIVERSITY OF MICHIGAN-FLINT            ,MI,48502-1950,Public       ,31,100,131,5886,8183,14069
00232800,WASHTENAW COMMUNITY COLLEGE             ,MI,48106-0000,Public       ,69,277,346,6319,10049,16368
00232900,WAYNE STATE UNIVERSITY                  ,MI,48202-0000,Public       ,90,345,435,22475,26651,49126
00232901,WAYNE STATE UNIV SCH OF MEDICINE        ,MI,48201-3359,Public       ,8,22,30,1083,2510,3593
00232902,WAYNE STATE UNIVERSITY - LAW SCHOOL     ,MI,48202-3424,Public       ,4,12,16,300,1439,1739
00233000,WESTERN MICHIGAN UNIVERSITY             ,MI,49008-3899,Public       ,38,126,164,24628,12463,37091
00233100,WESTERN THEOLOGICAL SEMINARY            ,MI,49423-0000,Private      ,0,3,3,11,187,198
00407100,WALSH COLLEGE OF ACCT & BUS ADMN        ,MI,48007-7006,Private      ,6,99,105,437,3274,3711
00407200,NORTHWOOD UNIVERSITY                    ,MI,48640-2398,Private      ,0,34,34,2248,2199,4447
00467300,BAKER COLLEGE - FLINT                   ,MI,48507-5508,Private      ,45,268,313,3442,9269,12711
00467301,BAKER COLLEGE OF CADILLAC               ,MI,49601-0000,Private      ,8,55,63,722,2492,3214
00467302,BAKER COLLEGE OF CLINTON TOWNSHIP       ,MI,48035-0000,Private      ,30,144,174,2347,6724,9071
00467303,BAKER COLLEGE OF MUSKEGON               ,MI,49442-0000,Private      ,38,146,184,3066,5382,8448
00467304,BAKER COLLEGE OF OWOSSO                 ,MI,48867-0000,Private      ,26,69,95,1959,2793,4752
00467305,BAKER COLLEGE OF AUBURN HILLS           ,MI,48326-0000,Private      ,18,145,163,1387,4869,6256
00467306,BAKER COLLEGE OF PORT HURON             ,MI,48060-0000,Private      ,12,37,49,693,1606,2299
00467309,BAKER COLLEGE OF JACKSON                ,MI,49202-0000,Private      ,16,110,126,1150,3695,4845
00467311,BAKER COLLEGE-CASS CITY                 ,MI,48726-0000,Private      ,3,18,21,234,548,782
00467313,BAKER COLLEGE - GRADUATE ON-LINE        ,MI,48507-0000,Private      ,23,221,244,625,8335,8960
00467317,BAKER COLLEGE-ALLEN PARK                ,MI,48101-0000,Private      ,36,141,177,1697,5943,7640
00469200,DORSEY SCHOOL OF BUSINESS               ,MI,48195-2334,Proprietary  ,10,42,52,128,576,704
00469201,DORSEY SCHOOL OF BUSINESS               ,MI,48184-0000,Proprietary  ,8,32,40,119,457,576
00469202,DORSEY SCHOOL OF BUSINESS               ,MI,48071-0000,Proprietary  ,8,24,32,128,560,688
00469204,DORSEY SCHOOL OF BUSINESS               ,MI,48066-0000,Proprietary  ,37,65,102,271,906,1177
00469205,DORSEY BUSINESS SCHOOL - FARMINGTON HILL,MI,48334-3385,Proprietary  ,2,14,16,81,321,402
00469206,DORSEY BUSINESS SCHOOL - ROSEVILLE CULIN,MI,48066-4555,Proprietary  ,9,34,43,151,587,738
00469207,DORSEY BUSINESS SCHOOL - WATERFORD/PONTI,MI,48341-1037,Proprietary  ,7,56,63,145,652,797
00469208,DORSEY BUSINESS SCHOOL - SAGINAW CAMPUS ,MI,48603-5201,Proprietary  ,10,46,56,186,726,912
00469209,DORSEY SCHOOL OF BUSINESS - LANSING     ,MI,48911-5744,Proprietary  ,7,33,40,22,190,212
00489816,MCCANN SCHOOL OF BUSINESS & TECHNOLOGY -,MI,48017-1495,Proprietary  ,0,0,0,8,25,33
00491003,KAPLAN CAREER INSTITUTE - DEARBORN      ,MI,48228-0000,Proprietary  ,2,23,25,213,1049,1262
00676800,MID MICHIGAN COMMUNITY COLLEGE          ,MI,48625-9447,Public       ,20,71,91,2977,3770,6747
00677100,COLLEGE FOR CREATIVE STUDIES            ,MI,48202-4034,Private      ,8,19,27,2141,1231,3372
00694900,KALAMAZOO VALLEY COMMUNITY COLLEGE      ,MI,49003-4070,Public       ,41,200,241,7121,9991,17112
00717100,KIRTLAND COMMUNITY COLLEGE              ,MI,48653-0000,Public       ,7,47,54,1126,2132,3258
00732991,ITT TECHNICAL INSTITUTE                 ,MI,49519-1851,Proprietary  ,61,319,380,986,3507,4493
00761700,CARNEGIE INSTITUTE                      ,MI,48083-1159,Proprietary  ,0,14,14,109,533,642
00795000,WEST SHORE COMMUNITY COLLEGE            ,MI,49454-0000,Public       ,0,15,15,698,1181,1879
00817800,EMPIRE BEAUTY SCHOOL                    ,MI,49525-2440,Proprietary  ,9,24,33,317,624,941
00832903,ITT TECHNICAL INSTITUTE                 ,MI,48083-2008,Proprietary  ,0,0,0,1,2,3
00890600,MACOMB COMMUNITY COLLEGE                ,MI,48088-3896,Public       ,141,385,526,14898,18962,33860
00894600,PORT HURON COSMETOLOGY COLLEGE          ,MI,48329-1618,Proprietary  ,1,13,14,31,83,114
00923000,WAYNE COUNTY COMMUNITY CLG-DISTRICT     ,MI,48226-3010,Public       ,176,963,1139,11597,33704,45301
00982800,EVEREST INSTITUTE                       ,MI,48033-4400,Proprietary  ,9,99,108,374,1994,2368
00982801,EVEREST INSTITUTE- DEARBORN             ,MI,48124-1927,Proprietary  ,13,69,82,400,1476,1876
00982803,EVEREST INSTITUTE - DETROIT             ,MI,48207-4291,Proprietary  ,12,79,91,466,1688,2154
01047000,KALAMAZOO BEAUTY ACADEMY                ,MI,49002-5220,Proprietary  ,1,2,3,54,101,155
01082700,DAVID PRESSLEY PROF SCH OF COSMTLGY     ,MI,48067-3219,Proprietary  ,2,15,17,219,358,577
01109800,FLINT INSTITUTE OF BARBERING            ,MI,48504-4395,Proprietary  ,2,6,8,63,246,309
01229100,WRIGHT BEAUTY ACADEMY                   ,MI,49015-2696,Proprietary  ,1,5,6,44,144,188
01258405,ILLINOIS INSTITUTE OF ART (THE) - THE AR,MI,48377-2979,Proprietary  ,0,0,0,1,0,1
01262700,THOMAS M. COOLEY LAW SCHOOL             ,MI,48901-1586,Private      ,1,56,57,45,4625,4670
01321800,M J MURPHY BTY CLG MT PLEASANT          ,MI,48858-2502,Proprietary  ,1,4,5,76,154,230
02060300,MICHIGAN INSTITUTE OF AERONAUTICS       ,MI,48188-2533,Proprietary  ,10,27,37,598,983,1581
02068700,FISER'S COLLEGE OF COSMETOLOGY          ,MI,49221-0000,Proprietary  ,0,0,0,0,5,5
02099700,ROSS MEDICAL EDUCATION CENTER           ,MI,48532-0000,Proprietary  ,37,133,170,535,1925,2460
02099701,ROSS MEDICAL EDUCATION CENTER-SAGINAW   ,MI,48603-5227,Proprietary  ,1,5,6,85,269,354
02099702,ROSS MEDICAL EDUCATION CENTER-PORT HURON,MI,48060-1958,Proprietary  ,0,4,4,36,133,169
02099703,ROSS MEDICAL EDUCATION CENTER-ROOSEVELT ,MI,49441-4156,Proprietary  ,1,0,1,14,73,87
02100400,EVEREST INSTITUTE                       ,MI,49525-2301,Proprietary  ,10,69,79,342,1499,1841
02100401,EVEREST INSTITUTE - KALAMAZOO           ,MI,49009-3307,Proprietary  ,11,56,67,254,1013,1267
02125600,MICHIGAN COLLEGE OF BEAUTY              ,MI,48083-0000,Proprietary  ,7,29,36,183,540,723
02158600,MR BELA'S SCHOOL OF COSMETOLOGY         ,MI,48092-4637,Proprietary  ,2,15,17,89,236,325
02160303,INTERNATIONAL ACADEMY OF DESIGN AND TECH,MI,48083-2160,Proprietary  ,1,14,15,579,878,1457
02180100,ROSS MEDICAL EDUCATION CENTER           ,MI,48092-0000,Proprietary  ,25,74,99,275,1118,1393
02180105,ROSS MEDICAL EDUCATION CENTER-REDFORD   ,MI,48239-1260,Proprietary  ,0,1,1,46,172,218
02198900,MICHIGAN SCHOOL OF PROFESSIONAL PSYCHOLO,MI,48334-4512,Private      ,0,2,2,53,360,413
02209200,TAYLORTOWN SCHOOL OF BEAUTY             ,MI,48180-0000,Proprietary  ,7,27,34,103,322,425
02237800,SPECS HOWARD SCHOOL OF MEDIA ARTS       ,MI,48075-0000,Proprietary  ,10,36,46,742,1081,1823
02285700,BAYSHIRE BEAUTY ACADEMY                 ,MI,48708-5614,Proprietary  ,4,11,15,67,217,284
02289801,KAPLAN INSTITUTE - DETROIT CAMPUS       ,MI,48202-0000,Proprietary  ,0,6,6,252,1106,1358
02324500,MICHIGAN COLLEGE OF BEAUTY              ,MI,48161-3901,Proprietary  ,3,11,14,112,304,416
02339700,ROSS MEDICAL EDUCATION CENTER           ,MI,48116-0000,Proprietary  ,22,139,161,311,1343,1654
02339701,ROSS MEDICAL EDUCATION CENTER-ANN ARBOR ,MI,48108-1411,Proprietary  ,0,3,3,62,206,268
02339703,ROSS MEDICAL EDUCATION CENTER - DAVISON ,MI,48423-1751,Proprietary  ,1,4,5,26,112,138
02361500,MICHIGAN BARBER COLLEGE                 ,MI,48204-2244,Private      ,3,19,22,232,765,997
02363800,YESHIVA GEDOLAH OF GREATER DETROIT      ,MI,48237-0000,Private      ,6,0,6,39,5,44
02491000,WEST MI COLG OF BARBERING & BEAUTY      ,MI,49008-0000,Proprietary  ,3,5,8,54,206,260
02531806,PAUL MITCHELL THE SCHOOL -MICHIGAN      ,MI,48313-0000,Proprietary  ,1,8,9,1,9,10
02533600,ROSS MEDICAL EDUCATION CENTER           ,MI,48917-2108,Proprietary  ,24,84,108,268,1067,1335
02533601,ROSS MEDICAL EDUCATION CENTER - GRAND RA,MI,49546-2430,Proprietary  ,0,7,7,99,393,492
02588200,DOUGLAS J AVEDA INSTITUTE               ,MI,48823-4351,Proprietary  ,17,40,57,794,1076,1870
02588201,DOUGLAS J AVEDA INSTITUTE - ANN ARBOR   ,MI,48104-2211,Proprietary  ,0,6,6,207,237,444
02595700,HILLSDALE BEAUTY COLLEGE                ,MI,49242-0000,Proprietary  ,0,4,4,51,61,112
02618400,MICHIGAN CAREER & TECHNICAL INST        ,MI,49080-9254,Public       ,31,13,44,385,182,567
03005700,DETROIT BUSINESS INST. DOWNRIVER        ,MI,48193-6761,Proprietary  ,0,5,5,43,283,326
03028500,LAWTON SCHOOL                           ,MI,48075-0000,Proprietary  ,0,9,9,31,179,210
03066600,BAY MILLS COMMUNITY COLLEGE             ,MI,49715-9750,Public       ,1,9,10,207,624,831
03075200,TWIN CITY BEAUTY COLLEGE                ,MI,49085-3305,Proprietary  ,15,18,33,149,278,427
03075201,TWIN CITY BEAUTY COLLEGE - TRAVERSE CITY,MI,49686-5119,Proprietary  ,1,2,3,32,85,117
03090000,SHARP'S ACADEMY OF HAIRSTYLING          ,MI,48439-1838,Proprietary  ,0,1,1,33,66,99
03109700,HOUGHTON LAKE INST OF COSMETOLOGY       ,MI,48629-0669,Proprietary  ,5,7,12,36,56,92
03110300,THE SCHOOL OF CREATIVE HAIR DESIGN      ,MI,49036-1139,Proprietary  ,1,4,5,30,87,117
03124000,NORTHWESTERN TECHNOLOGICAL INST         ,MI,48075-2412,Proprietary  ,1,35,36,132,704,836
03284300,MICHIGAN JEWISH INSTITUTE               ,MI,48237-0000,Private      ,0,5,5,1623,891,2514
03490300,PAUL MITCHELL THE SCHOOL ESCANABA       ,MI,49829-0000,Proprietary  ,0,1,1,331,415,746
03588300,IRENE'S MYOMASSOLOGY INSTITUTE          ,MI,48033-2404,Proprietary  ,1,8,9,122,489,611
03704300,BLUE WATER COLLEGE OF COSMETOLOGY       ,MI,48040-2093,Proprietary  ,2,7,9,42,68,110
03772300,SAGINAW CHIPPEWA TRIBAL COLLEGE         ,MI,48858-0000,Public       ,0,0,0,42,125,167
03815300,IN SESSION-ARTS OF COSMETOLOGY BEAU     ,MI,48609-0000,Proprietary  ,1,20,21,71,211,282
03907300,PAUL MITCHELL THE SCHOOL GREAT LAKES    ,MI,48060-0000,Proprietary  ,3,9,12,189,253,442
03915300,CAREER QUEST LEARNING CENTER            ,MI,48910-4732,Proprietary  ,15,127,142,259,1595,1854
03915301,CAREER QUEST LEARNING CENTER - JACKSON  ,MI,49201-2475,Proprietary  ,0,11,11,14,152,166
03915302,CAREER QUEST LEARNING CENTER - KALAMAZOO,MI,49002-1711,Proprietary  ,5,25,30,24,213,237
03968300,LAKEWOOD SCHOOL OF THERAPEUTIC MASSAGE  ,MI,48060-0000,Proprietary  ,0,0,0,26,89,115
03976500,ANN ARBOR INSTITUTE OF MASSAGE THERAPY  ,MI,48103-0000,Proprietary  ,2,1,3,63,210,273
04002400,ECUMENICAL THEOLOGICAL SEMINARY         ,MI,48201-3035,Private      ,0,9,9,9,206,215
04006300,NUVO COLLEGE OF COSMETOLOGY             ,MI,49441-3822,Proprietary  ,0,4,4,40,122,162
04014300,P&A SCHOLARS BEAUTY SCHOOL              ,MI,48204-0000,Proprietary  ,6,39,45,288,834,1122
04094300,ROBERT B. MILLER COLLEGE (THE)          ,MI,49017-3306,Private      ,0,13,13,130,686,816
04121100,GALLERY COLLEGE OF BEAUTY (THE)         ,MI,48036-3591,Proprietary  ,4,13,17,129,331,460
04136300,FOCUS:  HOPE INFORMATION TECHNOLOGIES CE,MI,48238-2949,Private      ,3,17,20,208,750,958
04138400,SCHOOL OF DESIGNING ARTS                ,MI,49015-2853,Proprietary  ,1,4,5,84,148,232
04140900,INTERNATIONAL COSMETOLOGY ACADEMY       ,MI,49508-1308,Proprietary  ,2,7,9,80,249,329
04141100,FRENCH ACADEMY OF COSMETOLOGY           ,MI,49456-3207,Proprietary  ,2,5,7,49,89,138
04158400,L'ESPRIT ACADEMY                        ,MI,48150-0000,Proprietary  ,4,12,16,108,250,358
04159300,MARKETTI ACADEMY OF COSMETOLOGY         ,MI,48329-3506,Proprietary  ,1,4,5,64,134,198
04163300,COMPASS COLLEGE OF CINEMATIC ARTS       ,MI,49503-4227,Private      ,1,0,1,138,141,279
04164700,KEWEENAW BAY OJIBWA COMMUNITY COLLEGE   ,MI,49908-0000,Public       ,1,6,7,29,111,140
04169300,SCHOLARS COSMETOLOGY UNIVERSITY         ,MI,48108-0000,Proprietary  ,1,4,5,36,112,148
04183300,ABCOTT INSTITUTE                        ,MI,48075-5227,Proprietary  ,4,26,30,69,295,364
04184700,PROTEGE ACADEMY                         ,MI,48823-8660,Proprietary  ,5,5,10,79,195,274
04207000,SCHOOL OF MISSIONARY AVIATION TECHNOLOGY,MI,48846-7412,Private      ,0,0,0,10,16,26
04211200,BRIGHTON INSTITUTE OF COSMETOLOGY       ,MI,48116-8360,Proprietary  ,3,2,5,27,39,66
00233200,ANOKA-RAMSEY CC-CAMBRIDGE/COONRAPID     ,MN,55433-3499,Public       ,54,149,203,4159,5787,9946
00233400,AUGSBURG COLLEGE                        ,MN,55454-1351,Private      ,28,50,78,3199,2732,5931
00233500,RIVERLAND COMMUNITY COLLEGE             ,MN,55912-1473,Public       ,14,42,56,1129,2248,3377
00233600,BEMIDJI STATE UNIVERSITY                ,MN,56601-2699,Public       ,7,44,51,3891,2411,6302
00233700,BETHANY LUTHERAN COLLEGE INC            ,MN,56001-6163,Private      ,1,1,2,722,96,818
00233900,CENTRAL LAKES COLG-BRAINERD/STAPLES     ,MN,56401-3900,Public       ,29,50,79,1603,2360,3963
00234000,CARLETON COLLEGE                        ,MN,55057-4001,Private      ,1,0,1,3524,85,3609
00234100,COLLEGE OF ST BENEDICT                  ,MN,56374-2099,Private      ,5,0,5,2279,87,2366
00234200,ST. CATHERINE UNIVERSITY                ,MN,55105-1789,Private      ,5,47,52,2993,3980,6973
00234300,COLLEGE OF ST SCHOLASTICA               ,MN,55811-4199,Private      ,7,84,91,2566,2588,5154
00234500,UNIVERSITY OF ST THOMAS                 ,MN,55105-1096,Private      ,10,91,101,7267,4155,11422
00234600,CONCORDIA COLLEGE-MOORHEAD              ,MN,56562-0001,Private      ,2,6,8,3126,261,3387
00234700,"CONCORDIA UNIVERSITY, ST PAUL, MN       ",MN,55104-5494,Private      ,11,112,123,1508,3064,4572
00235000,VERMILION COMMUNITY COLLEGE             ,MN,55731-1996,Public       ,8,2,10,613,199,812
00235300,GUSTAVUS ADOLPHUS COLLEGE               ,MN,56082-1498,Private      ,3,3,6,3762,105,3867
00235400,HAMLINE UNIVERSITY                      ,MN,55104-1284,Private      ,4,100,104,3356,3489,6845
00235500,HIBBING COMMUNITY COLLEGE               ,MN,55746-3300,Public       ,10,32,42,743,1155,1898
00235600,ITASCA COMMUNITY COLLEGE                ,MN,55744-3397,Public       ,6,14,20,923,698,1621
00235700,LUTHER SEMINARY                         ,MN,55108-0000,Private      ,0,1,1,6,451,457
00235800,MACALESTER COLLEGE                      ,MN,55105-1899,Private      ,2,1,3,3805,265,4070
00236000,"MINNESOTA STATE UNIVERSITY, MANKATO     ",MN,56002-0000,Public       ,86,107,193,12826,5271,18097
00236100,MARTIN LUTHER COLLEGE                   ,MN,56073-3965,Private      ,1,0,1,677,69,746
00236200,MINNEAPOLIS COMM AND TECH COLLEGE       ,MN,55403-1779,Public       ,90,330,420,4747,12526,17273
00236500,MINNEAPOLIS COLLEGE OF ART & DESIGN     ,MN,55404-4343,Private      ,1,11,12,1047,638,1685
00236600,CROSSROADS COLLEGE                      ,MN,55902-2382,Private      ,0,1,1,104,135,239
00236700,MINNESOTA STATE UNIVERSITY MOORHEAD     ,MN,56563-0001,Public       ,17,63,80,5822,2953,8775
00236900,NORTH CENTRAL UNIVERSITY                ,MN,55404-1391,Private      ,3,13,16,1459,587,2046
00237000,NORTH HENNEPIN COMMUNITY COLLEGE        ,MN,55445-2299,Public       ,58,185,243,3456,6877,10333
00237100,NORTHWESTERN COLLEGE                    ,MN,55113-1598,Private      ,11,24,35,2504,1182,3686
00237300,ROCHESTER COMMUNITY/TECH COLLEGE        ,MN,55904-4999,Public       ,42,118,160,3015,4326,7341
00237500,SOUTHWEST MINNESOTA STATE UNIVERSITY    ,MN,56258-1598,Public       ,6,28,34,2250,1342,3592
00237700,ST CLOUD STATE UNIVERSITY               ,MN,56301-4498,Public       ,43,114,157,10797,5990,16787
00237900,SAINT JOHNS UNIVERSITY                  ,MN,56321-0000,Private      ,1,1,2,2040,124,2164
00238000,SAINT MARY'S UNIVERSITY                 ,MN,55987-1399,Private      ,0,57,57,1875,3608,5483
00238200,ST OLAF COLLEGE                         ,MN,55057-1098,Private      ,2,0,2,3996,113,4109
00238300,CROWN COLLEGE                           ,MN,55375-9001,Private      ,5,31,36,920,885,1805
00238500,NORTHLAND COMMUNITY & TECHNICAL CLG     ,MN,56701-2598,Public       ,9,42,51,1672,2305,3977
00238600,UNITED THEOLGCL SEMINRY TWIN CITIES     ,MN,55112-0000,Private      ,0,0,0,2,123,125
00238800,"UNIVERSITY OF MINNESOTA, DULUTH         ",MN,55812-2496,Public       ,16,32,48,11132,2668,13800
00238900,"UNIVERSITY OF MINNESOTA, MORRIS         ",MN,56267-2113,Public       ,4,3,7,2419,328,2747
00239100,WILLIAM MITCHELL COLLEGE OF LAW         ,MN,55105-0000,Private      ,0,1,1,8,1259,1267
00239300,MINNESOTA STATE COLLEGE-SE TECH         ,MN,55987-0409,Public       ,13,24,37,1016,1790,2806
00239400,WINONA STATE UNIVERSITY                 ,MN,55987-5838,Public       ,17,34,51,8152,1930,10082
00396900,UNIVERSITY OF MINNESOTA-TWIN CITIES     ,MN,55455-0422,Public       ,64,291,355,34353,20262,54615
00400900,MESABI RANGE CMNTY & TECH COLLEGE       ,MN,55792-0000,Public       ,8,20,28,641,781,1422
00405708,NATIONAL AMERICAN UNIVERSITY            ,MN,55113-0000,Proprietary  ,1,6,7,55,401,456
00405715,NATIONAL AMERICAN UNIVERSITY - BLOOMINGT,MN,55425-5550,Proprietary  ,1,4,5,66,570,636
00406900,UNIVERSITY OF MINNESOTA-CROOKSTON       ,MN,56716-5001,Public       ,3,27,30,1243,995,2238
00438600,VETERAN'S MEDICAL CTR- SCH RAD TECH     ,MN,55417-2399,Public       ,0,2,2,6,54,60
00464100,DUNWOODY COLLEGE OF TECHNOLOGY          ,MN,55403-1192,Private      ,1,30,31,765,1648,2413
00464200,GLOBE UNIVERSITY                        ,MN,55125-5408,Proprietary  ,3,69,72,1333,5026,6359
00464500,MINNEAPOLIS BUSINESS COLLEGE            ,MN,55113-4036,Proprietary  ,1,2,3,423,244,667
00464600,MINNESOTA SCHOOL OF BUSINESS            ,MN,55423-0000,Proprietary  ,10,18,28,1430,5034,6464
00525200,RIDGEWATER COLLEGE                      ,MN,56201-2098,Public       ,39,48,87,2211,2277,4488
00526300,MINNESOTA WEST CMNTY & TECH COLG        ,MN,56241-1096,Public       ,30,50,80,929,1857,2786
00553300,"SAINT PAUL COLLEGE, COMMUNITY/TECHNICAL ",MN,55102-1800,Public       ,50,278,328,3711,9581,13292
00553400,SAINT CLOUD TECHNICAL COLLEGE AND COMMUN,MN,56303-1240,Public       ,46,107,153,3016,3692,6708
00553500,PINE TECHNICAL COLLEGE                  ,MN,55063-2198,Public       ,5,34,39,306,1016,1322
00553700,SOUTH CENTRAL COLLEGE                   ,MN,56003-0000,Public       ,19,55,74,1822,2598,4420
00554100,MINNESOTA STATE COMMUNITY AND TECHNICAL ,MN,56573-1405,Public       ,31,78,109,2545,3998,6543
00554400,ALEXANDRIA TECHNICAL COLLEGE            ,MN,56308-3799,Public       ,8,16,24,1467,1126,2593
00575700,LAKE SUPERIOR COLLEGE                   ,MN,55811-3399,Public       ,15,59,74,2338,3545,5883
00575900,NORTHWEST TECHNICAL COLLEGE - BEMIDJI   ,MN,56601-4907,Public       ,9,32,41,455,1178,1633
00677500,RAINY RIVER COMMUNITY COLLEGE           ,MN,56649-2187,Public       ,2,0,2,180,164,344
00735000,ANOKA-HENNEPIN TECHNICAL COLLEGE        ,MN,55303-1590,Public       ,20,63,83,1105,3340,4445
00735100,BROWN COLLEGE                           ,MN,55120-1004,Proprietary  ,5,25,30,327,979,1306
00746200,COLLEGE OF VISUAL ARTS                  ,MN,55102-2199,Private      ,0,3,3,276,128,404
00795400,NORMANDALE COMMUNITY COLLEGE            ,MN,55431-4399,Public       ,65,168,233,5153,6534,11687
00826700,NORTHWEST TECHNICAL INSTITUTE           ,MN,55121-5001,Proprietary  ,0,3,3,57,60,117
00869400,RASMUSSEN COLLEGE - ST. CLOUD           ,MN,56301-3713,Proprietary  ,2,40,42,280,1712,1992
00869401,RASMUSSEN COLLEGE - BROOKLYN PARK       ,MN,55445-1512,Proprietary  ,5,38,43,278,1672,1950
00869406,RASMUSSEN COLLEGE - EAGAN               ,MN,55122-1346,Proprietary  ,5,28,33,272,1619,1891
00869407,RASMUSSEN COLLEGE - BLOOMINGTON         ,MN,55435-5444,Proprietary  ,3,41,44,330,3228,3558
00869409,RASMUSSEN COLLEGE - MANKATO             ,MN,56001-8658,Proprietary  ,2,26,28,335,1229,1564
00869412,RASMUSSEN COLLEGE - LAKE ELMO           ,MN,55042-8624,Proprietary  ,4,34,38,193,1118,1311
00869416,RASMUSSEN COLLEGE - MOORHEAD            ,MN,56560-4513,Proprietary  ,2,24,26,209,1023,1232
00869417,RASMUSSEN COLLEGE - BLAINE              ,MN,55014-0000,Proprietary  ,2,26,28,214,1020,1234
00905800,BETHEL UNIVERSITY                       ,MN,55112-6999,Private      ,5,85,90,3582,2910,6492
00960000,COSMETOLOGY CAREERS UNLTD-DULUTH        ,MN,55802-2031,Proprietary  ,1,7,8,28,81,109
00972200,EMPIRE BEAUTY SCHOOL                    ,MN,55119-7003,Proprietary  ,7,24,31,156,385,541
00974000,INVER HILLS COMMUNITY COLLEGE           ,MN,55076-3224,Public       ,38,112,150,2791,4394,7185
00983100,MODEL COLLEGE OF HAIR DESIGN            ,MN,56301-4280,Proprietary  ,1,4,5,140,177,317
00987000,EMPIRE BEAUTY SCHOOL                    ,MN,55420-2919,Proprietary  ,15,21,36,153,341,494
00989200,"DULUTH BUSINESS UNIV, INC.              ",MN,55807-0000,Proprietary  ,2,2,4,136,500,636
00999200,OAK HILLS CHRISTIAN COLLEGE             ,MN,56601-0000,Private      ,0,1,1,116,83,199
01024800,ART INSTITUTES INTL MINNESOTA           ,MN,55402-3137,Proprietary  ,8,37,45,1636,1557,3193
01035602,EVEREST INSTITUTE - EAGAN               ,MN,55121-1696,Proprietary  ,14,50,64,161,787,948
01037400,METROPOLITAN STATE UNIVERSITY           ,MN,55106-5000,Public       ,12,149,161,2344,9915,12259
01040200,DAKOTA COUNTY TECHNICAL COLLEGE         ,MN,55068-2999,Public       ,29,65,94,1429,2774,4203
01049000,REGENCY BEAUTY INSTITUTE                ,MN,55428-0000,Proprietary  ,287,556,843,4643,9544,14187
01049100,HENNEPIN TECHNICAL COLLEGE              ,MN,55445-2399,Public       ,17,139,156,2193,6855,9048
01054600,CENTURY COLLEGE                         ,MN,55110-1894,Public       ,63,223,286,5611,9065,14676
01173200,"MAYO CLINIC, COLLEGE OF MEDICINE        ",MN,55905-0000,Private      ,0,3,3,51,384,435
01173201,MAYO SCHOOL OF HEALTH-RELATED SCIEN     ,MN,55905-0000,Private      ,0,2,2,93,238,331
01173206,MAYO GRAD SCHOOL                        ,MN,55901-0000,Private      ,0,0,0,5,53,58
01173207,MAYO MEDICAL SCHOOL                     ,MN,55901-0000,Private      ,0,1,1,17,232,249
01232800,NORTHWESTERN HEALTH SCIENCES UNIV       ,MN,55431-1599,Private      ,0,13,13,75,999,1074
02050300,ACADEMY COLLEGE                         ,MN,55420-1554,Proprietary  ,0,8,8,76,266,342
02097300,HASTINGS BEAUTY SCHOOL                  ,MN,55033-1205,Proprietary  ,3,4,7,39,66,105
02123200,AVEDA INSTITUTE                         ,MN,55414-0000,Proprietary  ,19,32,51,568,600,1168
02159800,COSMETOLOGY CAREERS UNLTD - HIBBING     ,MN,55746-0000,Proprietary  ,1,2,3,20,64,84
02160901,"SALON PROFESSIONAL ACADEMY, THE - THE SA",MN,55428-4928,Proprietary  ,6,12,18,44,95,139
02238100,MINNESOTA SCHOOL OF COSMETOLOGY         ,MN,55125-0000,Proprietary  ,3,12,15,186,332,518
02260500,SUMMIT ACAD OPPORTUNITIES IND CTR       ,MN,55405-0000,Private      ,5,58,63,110,816,926
02263102,ANTHEM COLLEGE - ST. LOUIS PARK         ,MN,55416-2467,Proprietary  ,1,23,24,40,161,201
02504200,WALDEN UNIVERSITY                       ,MN,55401-2511,Proprietary  ,7,1975,1982,375,63620,63995
02514100,AMERICAN INDIAN OPPORTUNITIES CTR       ,MN,55404-0000,Private      ,1,15,16,29,367,396
03001200,MCNALLY SMITH COLLEGE OF MUSIC          ,MN,55101-2220,Proprietary  ,2,6,8,871,374,1245
03051900,ALFRED ADLER GRADUATE SCHOOL            ,MN,55305-0000,Private      ,0,13,13,1,388,389
03096400,LEECH LAKE TRIBAL COLLEGE               ,MN,56633-0000,Public       ,0,1,1,67,419,486
03129100,FOND DU LAC TRIBAL & COMMUNITY CLG      ,MN,55720-2984,Public       ,1,15,16,598,1110,1708
03267300,CAPELLA UNIVERSITY                      ,MN,55402-3389,Proprietary  ,17,1792,1809,294,55246,55540
03833300,AMERICAN ACADEMY OF ACUPUNCTURE AND ORIE,MN,55113-0000,Proprietary  ,0,1,1,4,103,107
03921400,WHITE EARTH TRIBAL AND COMMUNITY COLLEGE,MN,56557-0478,Private      ,0,1,1,22,145,167
04044300,HAZELDEN GRADUATE SCHOOL OF ADDICTION ST,MN,55012-0000,Private      ,0,1,1,3,162,165
04130200,INST. OF PRODUCTION AND RECORDING       ,MN,55401-1315,Proprietary  ,1,5,6,522,524,1046
04148800,CENTERPOINT MASSAGE & SHIATSU THERAPY SC,MN,55414-4525,Proprietary  ,2,10,12,49,249,298
04157600,NOVA ACADEMY OF COSMETOLOGY             ,MN,55906-4103,Proprietary  ,0,3,3,55,118,173
04160500,AVALON SCHOOL OF COSMETOLOGY            ,MN,56187-1930,Proprietary  ,0,4,4,18,46,64
04174400,ROCHESTER SCHOOL OF HAIR DESIGN         ,MN,55901-4310,Proprietary  ,1,4,5,34,85,119
04175600,PARK AVENUE SCHOOL OF COSMETOLOGY       ,MN,56470-3361,Proprietary  ,1,7,8,26,82,108
00239600,ALCORN STATE UNIVERSITY                 ,MS,39096-7500,Public       ,191,118,309,4934,4707,9641
00239700,BELHAVEN UNIVERSITY                     ,MS,39202-1789,Private      ,19,153,172,1965,5548,7513
00239800,BLUE MOUNTAIN COLLEGE                   ,MS,38610-9370,Private      ,5,13,18,629,397,1026
00240100,COAHOMA COMMUNITY COLLEGE               ,MS,38614-9799,Public       ,122,33,155,2078,2946,5024
00240200,COPIAH-LINCOLN COMMUNITY COLLEGE        ,MS,39191-0649,Public       ,78,74,152,2510,3028,5538
00240300,DELTA STATE UNIVERSITY                  ,MS,38733-0000,Public       ,74,111,185,3777,4006,7783
00240400,EAST CENTRAL COMMUNITY COLLEGE          ,MS,39327-0129,Public       ,73,72,145,2250,2710,4960
00240500,EAST MISSISSIPPI COMM COLLEGE           ,MS,39358-0000,Public       ,167,116,283,3793,4471,8264
00240700,HINDS COMMUNITY COLLEGE                 ,MS,39154-9799,Public       ,270,339,609,9094,13144,22238
00240800,HOLMES COMMUNITY COLLEGE                ,MS,39079-0000,Public       ,197,195,392,4963,7173,12136
00240900,ITAWAMBA COMMUNITY COLLEGE              ,MS,38843-1099,Public       ,114,135,249,4672,5809,10481
00241000,JACKSON STATE UNIVERSITY                ,MS,39217-0001,Public       ,275,219,494,10132,12370,22502
00241100,JONES COUNTY JUNIOR COLLEGE             ,MS,39437-3999,Public       ,115,78,193,4329,3196,7525
00241300,MERIDIAN COMMUNITY COLLEGE              ,MS,39307-5890,Public       ,55,104,159,2673,3871,6544
00241400,MILLSAPS COLLEGE                        ,MS,39201-0000,Private      ,12,17,29,1701,1030,2731
00241500,MISSISSIPPI COLLEGE                     ,MS,39058-0001,Private      ,20,74,94,3240,4144,7384
00241501,MISSISSIPPI COLLEGE - SCHOOL OF LAW     ,MS,39201-1391,Private      ,5,12,17,133,1124,1257
00241600,MISSISSIPPI DELTA CMTY COLLEGE          ,MS,38761-0000,Public       ,119,70,189,2772,3084,5856
00241700,MISSISSIPPI GULF CST CLG-PERKINSTON     ,MS,39573-0000,Public       ,61,37,98,2362,1537,3899
00241701,MISSISSIPPI GULF CST CLG-JEFF DAVIS     ,MS,39507-0000,Public       ,42,223,265,2605,5340,7945
00241702,MISSISSIPPI GULF CST CLG-JACKSON CN     ,MS,39553-0000,Public       ,45,110,155,2224,3532,5756
00242200,MISSISSIPPI UNIV FOR WOMEN              ,MS,39701-5818,Public       ,31,66,97,2118,3241,5359
00242300,MISSISSIPPI STATE UNIVERSITY            ,MS,39762-9698,Public       ,228,210,438,19267,9662,28929
00242400,MISSISSIPPI VALLEY STATE UNIVERSITY     ,MS,38941-1400,Public       ,226,80,306,3832,3861,7693
00242600,NORTHEAST MS CMNTY COLLEGE              ,MS,38829-1731,Public       ,79,46,125,3268,2741,6009
00242700,NORTHWEST MISSISSIPPI COMMUNITY CLG     ,MS,38668-1703,Public       ,140,143,283,6640,6667,13307
00243000,PEARL RIVER COMMUNITY COLLEGE           ,MS,39470-2201,Public       ,159,113,272,3787,4600,8387
00243300,RUST COLLEGE                            ,MS,38635-2328,Private      ,22,12,34,1455,798,2253
00243500,SOUTHEASTERN BAPTIST COLLEGE            ,MS,39440-0000,Private      ,0,3,3,19,93,112
00243600,SOUTHWEST MISSISSIPPI CMNTY CLG         ,MS,39666-8099,Public       ,37,47,84,1796,1781,3577
00243900,TOUGALOO COLLEGE                        ,MS,39174-9799,Private      ,37,27,64,1863,956,2819
00244000,UNIVERSITY OF MISSISSIPPI               ,MS,38677-1848,Public       ,208,177,385,17078,8958,26036
00244001,UNIVERSITY OF MISSISSIPPI - MED CTR     ,MS,39216-0000,Public       ,19,47,66,893,2812,3705
00244100,UNIVERSITY OF SOUTHERN MISSISSIPPI      ,MS,39406-0001,Public       ,163,260,423,14539,12426,26965
00244700,WILLIAM CAREY UNIVERSITY                ,MS,39401-5499,Private      ,24,119,143,2068,5329,7397
00489809,MCCANN SCHOOL OF BUSINESS & TECHNOLOGY -,MS,39503-3167,Proprietary  ,2,5,7,45,178,223
01289101,ANTONELLI COLLEGE - JACKSON             ,MS,39232-9514,Proprietary  ,12,106,118,269,1889,2158
01289102,ANTONELLI COLLEGE - HATTIESBURG         ,MS,39401-3056,Proprietary  ,10,47,57,192,967,1159
02074900,CHRIS' BEAUTY COLLEGE                   ,MS,39501-0000,Proprietary  ,8,15,23,89,235,324
02160500,NORTH MISSISSIPPI MED CTR MED TECH      ,MS,38801-0000,Private      ,2,7,9,60,221,281
02235900,ACADEMY OF HAIR DESIGN #4               ,MS,39208-0000,Proprietary  ,3,15,18,79,240,319
02244300,ACADEMY OF HAIR DESIGN #1               ,MS,38901-0000,Proprietary  ,7,10,17,145,349,494
02249900,DELTA BEAUTY COLLEGE                    ,MS,38701-0000,Proprietary  ,1,9,10,76,136,212
02251600,ACADEMY OF HAIR DESIGN #6               ,MS,39401-7581,Proprietary  ,5,12,17,143,362,505
02251700,FOSTER'S COSMETOLOGY COLLEGE            ,MS,38663-0000,Proprietary  ,1,3,4,10,40,50
02302800,MISSISSIPPI COLLEGE OF BEAUTY CULT      ,MS,39440-0000,Proprietary  ,2,8,10,41,133,174
02320800,MAGNOLIA COLLEGE OF COSMETOLOGY         ,MS,39206-0000,Proprietary  ,9,20,29,139,550,689
02502100,CREATIONS COLLEGE OF COSMETOLOGY        ,MS,38803-0000,Proprietary  ,3,7,10,62,203,265
02516200,WESLEY BIBLICAL SEMINARY                ,MS,39206-0000,Private      ,1,6,7,9,211,220
02586000,J & J HAIR DESIGN COLLEGE               ,MS,39051-3716,Proprietary  ,2,13,15,59,166,225
03004000,FINAL TOUCH BEAUTY SCHOOL               ,MS,39307-2934,Proprietary  ,0,0,0,52,136,188
03010603,VIRGINIA COLLEGE - JACKSON              ,MS,39206-5602,Proprietary  ,15,75,90,291,1509,1800
03010610,VIRGINIA COLLEGE - BILOXI               ,MS,39532-2124,Proprietary  ,7,15,22,133,607,740
03032400,KC'S SCHOOL OF HAIR DESIGN              ,MS,38863-0000,Proprietary  ,2,6,8,18,97,115
03263300,TRAXLER'S SCHOOL OF HAIR                ,MS,39212-2529,Proprietary  ,3,14,17,46,176,222
03294305,BLUE CLIFF COLLEGE - GULFPORT           ,MS,39503-0000,Proprietary  ,12,40,52,234,945,1179
03464300,ACADEMY OF HAIR DESIGN                  ,MS,39562-0000,Proprietary  ,2,18,20,17,105,122
03848300,DAY SPA CAREER COLLEGE                  ,MS,39564-0000,Proprietary  ,0,4,4,32,148,180
03963300,HEALING TOUCH SCHOOL OF MASSAGE THERAPY ,MS,39402-1300,Proprietary  ,7,16,23,75,316,391
04131300,CORINTH ACADEMY OF COSMETOLOGY          ,MS,38834-4813,Proprietary  ,1,16,17,49,183,232
04137400,MISSISSIPPI SCHOOL OF THERAPEUTIC MASSAG,MS,39216-5023,Proprietary  ,0,0,0,9,27,36
04140200,"MISSISSIPPI INSTITUTE OF AESTHETICS, NAI",MS,39056-5628,Proprietary  ,1,3,4,48,146,194
00252600,CARROLL COLLEGE                         ,MT,59625-0002,Private      ,3,2,5,2329,357,2686
00252700,UNIVERSITY OF GREAT FALLS               ,MT,59405-4996,Private      ,2,30,32,864,833,1697
00252800,MILES COMMUNITY COLLEGE                 ,MT,59301-4799,Public       ,1,3,4,337,277,614
00252900,DAWSON COMMUNITY COLLEGE                ,MT,59330-1405,Public       ,2,4,6,260,192,452
00253000,MONTANA STATE UNIVERSITY - BILLINGS     ,MT,59101-0298,Public       ,6,71,77,3244,4349,7593
00253100,MONTANA TECH OF THE UNIV OF MONTANA     ,MT,59701-8997,Public       ,2,9,11,1768,1612,3380
00253200,MONTANA STATE UNIVERSITY - BOZEMAN      ,MT,59717-4160,Public       ,15,79,94,12854,5839,18693
00253300,MONTANA STATE UNIVERSITY-NORTHERN       ,MT,59501-3148,Public       ,6,23,29,1012,1013,2025
00253400,ROCKY MOUNTAIN COLLEGE                  ,MT,59102-1796,Private      ,2,3,5,1397,543,1940
00253600,UNIVERSITY OF MONTANA (THE)             ,MT,59812-0001,Public       ,18,90,108,9801,9282,19083
00253700,UNIVERSITY OF MONTANA WESTERN (THE)     ,MT,59725-3598,Public       ,1,3,4,1556,708,2264
00677700,FLATHEAD VALLEY COMMUNITY COLLEGE       ,MT,59901-2699,Public       ,8,34,42,1067,2126,3193
00757000,HELENA COLLEGE OF TECHNOLOGY            ,MT,59601-3098,Public       ,3,22,25,566,1449,2015
00790000,BUTTE ACADEMY OF BEAUTY CULTURE         ,MT,59701-9197,Proprietary  ,0,4,4,31,87,118
00894700,"DAHL'S COLLEGE OF BEAUTY,INC            ",MT,59401-3731,Proprietary  ,0,0,0,17,46,63
00931400,GREAT FALLS COLLEGE MONTANA STATE UNIVER,MT,59405-4907,Public       ,9,69,78,864,2068,2932
02143400,SALISH KOOTENAI COLLEGE                 ,MT,59855-0000,Public       ,3,9,12,389,1183,1572
02286600,LITTLE BIG HORN COLLEGE                 ,MT,59022-0000,Public       ,0,1,1,126,253,379
02343000,FT PECK COMMUNITY COLLEGE               ,MT,59255-0000,Public       ,1,6,7,94,255,349
02510600,BLACKFEET COMMUNITY COLLEGE             ,MT,59417-0000,Private      ,0,4,4,185,444,629
02517500,FORT BELKNAP COLLEGE                    ,MT,59526-0000,Public       ,0,2,2,73,187,260
02545200,CHIEF DULL KNIFE COLLEGE                ,MT,59043-0098,Public       ,0,0,0,87,172,259
02610900,STONE CHILD COLLEGE                     ,MT,59521-9796,Public       ,7,18,25,104,267,371
02621300,ACADEMY OF COSMETOLOGY                  ,MT,59715-3544,Proprietary  ,1,0,1,59,83,142
03205300,MODERN BEAUTY SCHOOL                    ,MT,59801-8386,Proprietary  ,1,1,2,74,126,200
03763400,"ACADEMY OF NAIL, SKIN & HAIR            ",MT,59101-0000,Proprietary  ,0,6,6,112,253,365
03778300,HEALTH WORKS INSTITUTE                  ,MT,59715-0000,Proprietary  ,1,1,2,49,112,161
04163700,BITTERROOT SCHOOL OF COSMETOLOGY        ,MT,59840-3118,Proprietary  ,0,7,7,24,54,78
04164100,SALON PROFESSIONAL ACADEMY (THE)        ,MT,59405-0000,Proprietary  ,6,7,13,72,154,226
04187700,CREVIER'S SCHOOL OF COSMETOLOGY         ,MT,59901-4402,Proprietary  ,1,3,4,81,200,281
00253900,CHADRON STATE COLLEGE                   ,NE,69337-2690,Public       ,5,36,41,1915,1446,3361
00254000,COLLEGE OF ST MARY                      ,NE,68106-2606,Private      ,5,23,28,602,1396,1998
00254100,CONCORDIA UNIVERSITY                    ,NE,68434-1594,Private      ,3,25,28,1496,822,2318
00254200,CREIGHTON UNIVERSITY                    ,NE,68178-0001,Private      ,11,47,58,5786,5888,11674
00254400,DOANE COLLEGE                           ,NE,68333-2421,Private      ,5,74,79,1871,1457,3328
00254700,GRACE UNIVERSITY                        ,NE,68108-3629,Private      ,2,5,7,399,411,810
00254800,HASTINGS COLLEGE                        ,NE,68901-7621,Private      ,7,1,8,1546,202,1748
00255100,UNIVERSITY OF NEBRASKA AT KEARNEY       ,NE,68849-0001,Public       ,14,103,117,5007,2545,7552
00255300,MIDLAND UNIVERSITY                      ,NE,68025-4254,Private      ,2,4,6,1520,455,1975
00255400,UNIVERSITY OF NEBRASKA-OMAHA            ,NE,68182-0001,Public       ,30,146,176,9804,8297,18101
00255500,NEBRASKA WESLEYAN UNIVERSITY            ,NE,68504-2796,Private      ,6,14,20,2197,817,3014
00255700,MID-PLAINS COMM COLLEGE - NORTH PLATTE  ,NE,69101-9420,Public       ,7,37,44,557,899,1456
00255701,MID-PLAINS COMMUNITY COLLEGE - MCCOOK   ,NE,69001-2631,Public       ,1,13,14,282,269,551
00255900,PERU STATE COLLEGE                      ,NE,68421-0010,Public       ,17,68,85,1111,1305,2416
00256000,WESTERN NEBRASKA COMMUNITY COLLEGE      ,NE,69361-1815,Public       ,13,33,46,877,1210,2087
00256300,UNION COLLEGE                           ,NE,68506-4387,Private      ,4,2,6,905,475,1380
00256500,UNIVERSITY OF NEBRASKA-LINCOLN          ,NE,68588-0419,Public       ,32,90,122,16981,6298,23279
00256596,UNIVERSITY OF NEBRASKA - CURTIS         ,NE,69025-9522,Public       ,1,0,1,286,65,351
00256600,WAYNE STATE COLLEGE                     ,NE,68787-1172,Public       ,9,24,33,3332,1070,4402
00256700,YORK COLLEGE                            ,NE,68467-2699,Private      ,0,1,1,597,151,748
00443600,REGNL WST MEDCL CTR SCHL RAD            ,NE,69361-0000,Private      ,0,0,0,28,27,55
00458608,KAPLAN UNIVERSITY - OMAHA               ,NE,68134-1002,Proprietary  ,6,89,95,265,1903,2168
00458609,KAPLAN UNIVERSITY - LINCOLN             ,NE,68508-2668,Proprietary  ,9,57,66,160,1131,1291
00639900,BRYANLGH COLLEGE OF HEALTH SCIENCES     ,NE,68506-1398,Private      ,0,3,3,484,496,980
00640400,NEBR METHODIST CLG OF NURS ALLD HLTH    ,NE,68114-2852,Private      ,3,17,20,540,1165,1705
00689500,UNIVERSITY OF NEBRASKA-MED CTR          ,NE,68198-4265,Public       ,8,26,34,749,2870,3619
00750100,VATTEROTT COLLEGE                       ,NE,68137-1237,Proprietary  ,15,57,72,308,1403,1711
00849200,ALEGENT HEALTH SCHOOLS                  ,NE,68114-2767,Private      ,1,5,6,91,368,459
00952300,BAHNER COLLEGE OF HAIRSTYLING           ,NE,68025-3297,Proprietary  ,0,6,6,34,57,91
00961700,CAPITOL BEAUTY SCHOOL                   ,NE,68144-0000,Proprietary  ,2,6,8,168,304,472
00974300,BELLEVUE UNIVERSITY                     ,NE,68005-0000,Private      ,8,311,319,950,10190,11140
00986200,CLARKSON COLLEGE                        ,NE,68131-2739,Private      ,3,41,44,601,1593,2194
01151900,JOSEPH'S COLLEGE OF BEAUTY/ALL CAMPUSES ,NE,68510-2226,Proprietary  ,10,21,31,185,471,656
01166700,NORTHEAST COMMUNITY COLLEGE             ,NE,68702-0000,Public       ,12,43,55,1990,1777,3767
01258600,METROPOLITAN COMMUNITY COLLEGE          ,NE,68103-0000,Public       ,66,288,354,6070,15557,21627
01297600,NEBRASKA CHRISTIAN COLLEGE              ,NE,68046-4256,Private      ,0,2,2,128,71,199
02079700,COLLEGE OF HAIR DESIGN                  ,NE,68508-0000,Proprietary  ,10,9,19,230,294,524
02099500,CENTRAL COMMUNITY COLLEGE- GI           ,NE,68801-0000,Public       ,25,50,75,795,1876,2671
02099501,CENTRAL COMMUNITY COLLEGE - HASTINGS    ,NE,68902-0000,Public       ,8,20,28,1128,1047,2175
02099502,CENTRAL COMMUNITY COLLEGE - COLUMBUS    ,NE,68602-0000,Public       ,5,25,30,581,700,1281
02508300,SOUTHEAST COMM. COLLEGE-ALL CAMPUSES    ,NE,68520-0000,Public       ,42,70,112,5348,7690,13038
02550800,NEBRASKA INDIAN COMMUNITY COLLEGE       ,NE,68039-0000,Public       ,1,27,28,33,186,219
02610500,XENON INTERNATIONAL ACADEMY II          ,NE,68127-3522,Proprietary  ,5,18,23,241,392,633
03164300,THE CREATIVE CENTER                     ,NE,68164-2911,Proprietary  ,0,3,3,168,135,303
03279300,MYOTHERAPY INSTITUTE                    ,NE,68516-0000,Proprietary  ,0,0,0,36,76,112
03323300,LITTLE PRIEST TRIBAL COLLEGE            ,NE,68071-0000,Private      ,0,1,1,37,137,174
03821400,UNIVERSAL COLLEGE OF HEALING ARTS       ,NE,68112-1810,Proprietary  ,0,10,10,27,177,204
00256800,UNIVERSITY OF NEVADA RENO               ,NV,89557-0002,Public       ,71,67,138,15076,7976,23052
00256900,UNIVERSITY OF NEVADA-LAS VEGAS          ,NV,89154-1001,Public       ,109,264,373,20726,20677,41403
00697700,GREAT BASIN COLLEGE                     ,NV,89801-3348,Public       ,13,34,47,808,1648,2456
00732954,ITT TECHNICAL INSTITUTE                 ,NV,89014-6712,Proprietary  ,16,88,104,403,1214,1617
00736700,MARINELLO SCHOOLS OF BEAUTY             ,NV,89110-3563,Proprietary  ,16,44,60,276,602,878
00736701,MARINELLO SCHOOLS OF BEAUTY -           ,NV,89014-2244,Proprietary  ,3,19,22,108,293,401
00737100,MARINELLO SCHOOL OF BEAUTY              ,NV,89502-6530,Proprietary  ,11,34,45,193,521,714
00844103,ANTHEM INSTITUTE - MORRISON UNIVERSITY  ,NV,89521-4826,Proprietary  ,9,50,59,73,485,558
00919200,SIERRA NEVADA COLLEGE                   ,NV,89451-0000,Private      ,4,26,30,705,779,1484
01036200,COLLEGE OF SOUTHERN NEVADA              ,NV,89146-1139,Public       ,191,721,912,17854,31190,49044
01036300,WESTERN NEVADA COLLEGE                  ,NV,89703-0000,Public       ,81,77,158,1642,3604,5246
01323200,ACADEMY OF HAIR DESIGN                  ,NV,89146-1617,Proprietary  ,12,34,46,286,542,828
02107700,TRUCKEE MEADOWS COMMUNITY CLG           ,NV,89512-0000,Public       ,59,172,231,5159,9630,14789
02237500,EVEREST COLLEGE                         ,NV,89103-0000,Proprietary  ,31,141,172,954,2837,3791
02338512,GLENDALE CAREER COLLEGE - NEVADA CAREER ,NV,89131-3268,Proprietary  ,0,8,8,76,381,457
02616703,SCOTTSDALE CULINARY INSTITUTE - LE CORDO,NV,89144-7047,Proprietary  ,3,13,16,239,634,873
02621500,CAREER COLLEGE OF NORTHERN NEVADA       ,NV,89434-7905,Proprietary  ,25,66,91,288,1096,1384
03030603,UTAH CLG OF MASSAGE THERAPY-NSMT        ,NV,89123-0000,Proprietary  ,13,42,55,205,530,735
03031405,INTERNATIONAL ACADEMY OF DESIGN AND TECH,NV,89074-7750,Proprietary  ,7,40,47,443,753,1196
03043200,KAPLAN COLLEGE                          ,NV,89102-8618,Proprietary  ,20,123,143,836,3354,4190
03076404,BRYMAN SCHOOL OF ARIZONA (THE) - ANTHEM ,NV,89102-4514,Proprietary  ,22,60,82,124,327,451
03088200,CARSON CITY BEAUTY ACADEMY              ,NV,89706-0000,Proprietary  ,5,12,17,64,241,305
03232306,EUPHORIA INSTITUTE - SUMMERLIN          ,NV,89117-8803,Proprietary  ,1,8,9,190,421,611
03232307,EUPHORIA INSTITUTE - GREEN VALLEY       ,NV,89052-4964,Proprietary  ,13,23,36,110,280,390
03232308,EUPHORIA INSTITUTE - ALIANTE            ,NV,89131-1036,Proprietary  ,5,15,20,188,356,544
03787300,EXPERTISE SCHOOL OF BEAUTY              ,NV,89106-2516,Private      ,2,14,16,116,354,470
03838500,NORTHWEST HEALTH CAREERS                ,NV,89128-0255,Proprietary  ,9,33,42,277,897,1174
03975300,INSTITUTE OF PROFESSIONAL CAREERS       ,NV,89119-7825,Proprietary  ,1,15,16,182,580,762
04051303,ART INSTITUTE OF PHOENIX (THE) - ART INS,NV,89074-7737,Proprietary  ,3,9,12,561,604,1165
04065300,UNIVERSITY OF SOUTHERN NEVADA           ,NV,89014-2333,Private      ,2,21,23,608,2447,3055
04114300,NEVADA STATE COLLEGE                    ,NV,89002-9455,Public       ,16,77,93,2047,4179,6226
04142601,TOURO UNIVERSITY - NEVADA               ,NV,89014-8800,Private      ,1,8,9,80,1060,1140
04144800,INTERNATIONAL ACADEMY OF STYLE          ,NV,89509-3450,Proprietary  ,1,7,8,81,229,310
04147600,AVEDA INSTITUTE LAS VEGAS               ,NV,89119-6103,Proprietary  ,4,20,24,178,477,655
04171000,ADVANCED TRAINING INSTITUTE             ,NV,89115-7504,Proprietary  ,14,42,56,162,873,1035
04186300,PAUL MITCHELL THE SCHOOL LAS VEGAS      ,NV,89123-8014,Proprietary  ,15,28,43,346,557,903
04190300,AMERICAN INSTITUTE OF MEDICAL SONOGRAPHY,NV,89146-6597,Proprietary  ,2,22,24,145,704,849
04191100,DESTINATION ACADEMY FOR SPA AND SALON PR,NV,89147-8397,Proprietary  ,1,8,9,62,222,284
04203100,PAUL MITCHELL THE SCHOOL RENO           ,NV,89501-3356,Proprietary  ,6,13,19,198,308,506
00257200,COLBY-SAWYER COLLEGE                    ,NH,03257-4648,Private      ,0,0,0,2948,155,3103
00257300,DARTMOUTH COLLEGE                       ,NH,03755-3529,Private      ,3,7,10,12637,2056,14693
00257500,FRANKLIN PIERCE UNIVERSITY              ,NH,03461-0060,Private      ,6,16,22,3457,1364,4821
00257900,NEW ENGLAND COLLEGE                     ,NH,03242-3293,Private      ,11,104,115,2115,1755,3870
00258000,SOUTHERN NEW HAMPSHIRE UNIVERSITY       ,NH,03106-1045,Private      ,80,910,990,7070,19371,26441
00258100,NHTI  - CONCORD'S COMMUNITY COLLEGE     ,NH,03301-7412,Public       ,8,25,33,3005,2404,5409
00258200,MANCHESTER COMMUNITY COLLEGE            ,NH,03102-8518,Public       ,9,34,43,1541,2147,3688
00258300,GREAT BAY COMMUNITY COLLEGE             ,NH,03801-0000,Public       ,9,20,29,1146,1502,2648
00258600,RIVIER COLLEGE                          ,NH,03060-5086,Private      ,4,20,24,1465,1370,2835
00258700,SAINT ANSELM COLLEGE                    ,NH,03102-1310,Private      ,1,6,7,4403,235,4638
00258900,UNIVERSITY OF NEW HAMPSHIRE             ,NH,03824-2511,Public       ,8,20,28,21677,3973,25650
00259000,KEENE STATE COLLEGE                     ,NH,03431-0000,Public       ,6,3,9,8520,850,9370
00259100,PLYMOUTH STATE UNIVERSITY               ,NH,03264-1595,Public       ,3,7,10,7069,1814,8883
00301004,ANTIOCH UNIVERSITY                      ,NH,03431-0000,Private      ,0,4,4,7,894,901
00472900,HESSER COLLEGE                          ,NH,03103-7230,Proprietary  ,10,45,55,490,1415,1905
00472901,HESSER COLLEGE - NASHUA CAMPUS          ,NH,03063-1286,Proprietary  ,5,21,26,178,642,820
00472904,HESSER COLLEGE - PORTSMOUTH CAMPUS      ,NH,03801-3245,Proprietary  ,3,19,22,176,724,900
00472905,HESSER COLLEGE - SALEM CAMPUS           ,NH,03079-2842,Proprietary  ,2,9,11,197,719,916
00472906,HESSER COLLEGE - CONCORD CAMPUS         ,NH,03301-3415,Proprietary  ,2,13,15,113,565,678
00473100,DANIEL WEBSTER COLLEGE                  ,NH,03063-1300,Proprietary  ,3,28,31,813,472,1285
00473300,CHESTER COLLEGE OF NEW ENGLAND          ,NH,03036-4331,Private      ,0,0,0,180,41,221
00529100,WHITE MOUNTAINS COMMUNITY COLLEGE       ,NH,03570-3799,Public       ,2,5,7,416,694,1110
00702500,LEBANON COLLEGE                         ,NH,03766-0000,Private      ,0,3,3,39,122,161
00755500,LAKES REGION COMMUNITY COLLEGE          ,NH,03246-1326,Public       ,2,9,11,773,832,1605
00756000,RIVER VALLEY COMMUNITY COLLEGE          ,NH,03743-9707,Public       ,5,11,16,417,1006,1423
00849300,CONTINENTAL ACADEMIE OF HAIR DESIGN     ,NH,03103-4901,Proprietary  ,0,0,0,8,15,23
00864500,EMPIRE BEAUTY SCHOOL                    ,NH,03220-0000,Proprietary  ,7,20,27,127,182,309
00923600,NASHUA COMMUNITY COLLEGE                ,NH,03063-2052,Public       ,6,26,32,1270,1301,2571
01318900,CONTINENTAL ACADEMIE OF HAIR DESIGN     ,NH,03051-3754,Proprietary  ,0,3,3,63,58,121
02097900,UNIVERSITY NEW HAMPSHIRE SCHOOL OF LAW  ,NH,03301-0000,Private      ,0,1,1,30,677,707
02140400,ST JOSEPH SCH OF PRAC NRSG              ,NH,03060-0000,Private      ,0,16,16,62,280,342
02174800,MICHAEL'S SCHOOL OF HAIR DESIGN & ESTHET,NH,03110-0000,Proprietary  ,4,11,15,132,136,268
02179600,EMPIRE BEAUTY SCHOOL                    ,NH,03878-0000,Proprietary  ,7,17,24,127,205,332
02211600,PORTSMOUTH BTY SCH OF HAIR DESIGN       ,NH,03801-4084,Proprietary  ,0,1,1,14,32,46
02223300,MAGDALEN COLLEGE                        ,NH,03278-4012,Private      ,0,0,0,52,5,57
02245400,KEENE BEAUTY ACADEMY                    ,NH,03431-0000,Proprietary  ,1,1,2,47,58,105
02247000,NEW ENGLAND SCHOOL OF HAIR DESIGN       ,NH,03784-0000,Proprietary  ,1,5,6,44,63,107
03043100,THOMAS MORE COLLEGE OF LIBERAL ARTS     ,NH,03054-4818,Private      ,0,0,0,117,31,148
03101300,GRANITE STATE COLLEGE                   ,NH,03301-6400,Public       ,5,21,26,475,2501,2976
03182300,NEW HAMPSHIRE INSTITUTE OF ART          ,NH,03104-4858,Private      ,0,7,7,756,159,915
03437300,UPPER VALLEY TEACHER TRANING PROGRAM    ,NH,03766-1358,Private      ,0,2,2,3,47,50
03729300,NH INSTITUTE FOR THERAPEUTIC ARTS       ,NH,03051-4906,Proprietary  ,0,0,0,20,48,68
04162200,LAIRD INSTITUTE OF SPA THERAPY          ,NH,03102-5263,Proprietary  ,0,3,3,16,89,105
00267000,BAPTIST BIBLE COLG OF PENNSYLVANIA      ,PA,18411-1297,Private      ,3,14,17,671,472,1143
00322800,BRYN ATHYN COLLEGE OF THE NEW CHURCH    ,PA,19009-0717,Private      ,1,0,1,281,47,328
00322900,ALBRIGHT COLLEGE                        ,PA,19612-5234,Private      ,5,19,24,4028,1474,5502
00323000,ALLEGHENY COLLEGE                       ,PA,16335-3902,Private      ,4,5,9,3993,167,4160
00323100,COMM CLG OF ALLEGHENY-ALLEGHENY CMP     ,PA,15212-0000,Public       ,38,149,187,3832,7446,11278
00323101,"COMM CLG OF ALLEGHENY, BOYCE CAMPUS     ",PA,15146-0000,Public       ,22,59,81,1674,2922,4596
00323102,"COMM CLG OF ALLEGHENY, NORTH CAMPUS     ",PA,15237-0000,Public       ,24,76,100,2075,3046,5121
00323103,"COMM CLG OF ALLEGHENY, SOUTH CAMPUS     ",PA,15122-0000,Public       ,14,66,80,2034,2875,4909
00323300,ALVERNIA UNIVERSITY                     ,PA,19607-1799,Private      ,7,38,45,2649,1841,4490
00323500,ARCADIA UNIVERSITY                      ,PA,19038-3295,Private      ,6,22,28,6423,2450,8873
00323700,BRYN MAWR COLLEGE                       ,PA,19010-2899,Private      ,3,2,5,1980,683,2663
00323800,BUCKNELL UNIVERSITY                     ,PA,17837-2122,Private      ,1,0,1,5644,222,5866
00323900,BUCKS COUNTY COMMUNITY COLLEGE          ,PA,18940-1320,Public       ,30,111,141,4610,4811,9421
00324000,BUTLER COUNTY COMMUNITY COLLEGE         ,PA,16001-0000,Public       ,19,52,71,2189,2274,4463
00324100,CABRINI COLLEGE                         ,PA,19087-3698,Private      ,3,58,61,2304,1479,3783
00324200,CARNEGIE MELLON UNIVERSITY              ,PA,15213-3890,Private      ,7,14,21,13402,2012,15414
00324201,CARNEGIE MELLON UNIV- THE HEINZ COLLEGE ,PA,15213-0000,Private      ,1,6,7,137,750,887
00324202,CARNEGIE MELLON- TEPPER SCHOOL OF BUSINE,PA,15213-0000,Private      ,1,8,9,262,602,864
00324300,CEDAR CREST COLLEGE                     ,PA,18104-6196,Private      ,2,33,35,1159,1584,2743
00324400,CHATHAM UNIVERSITY                      ,PA,15232-2826,Private      ,2,26,28,849,2121,2970
00324500,CHESTNUT HILL COLLEGE                   ,PA,19118-2693,Private      ,4,40,44,2118,2781,4899
00324700,MISERICORDIA  UNIVERSITY                ,PA,18612-1008,Private      ,6,21,27,2786,1553,4339
00324900,COMMUNITY COLLEGE OF PHILADELPHIA       ,PA,19130-3991,Public       ,148,619,767,14038,25280,39318
00325100,CURTIS INSTITUTE OF MUSIC               ,PA,19103-6187,Private      ,1,1,2,319,157,476
00325200,DELAWARE VALLEY COLLEGE                 ,PA,18901-2697,Private      ,2,13,15,2445,584,3029
00325300,DICKINSON COLLEGE                       ,PA,17013-2896,Private      ,0,1,1,3824,183,4007
00325600,DREXEL UNIVERSITY                       ,PA,19104-2875,Private      ,59,250,309,34052,21337,55389
00325800,DUQUESNE UNIVERSITY                     ,PA,15282-0001,Private      ,13,73,86,8199,4518,12717
00325900,EASTERN UNIVERSITY                      ,PA,19087-3696,Private      ,5,54,59,2451,3110,5561
00326200,ELIZABETHTOWN COLLEGE                   ,PA,17022-2298,Private      ,2,8,10,3303,779,4082
00326300,EVANGELICAL SCHOOL OF THEOLOGY          ,PA,17067-0000,Private      ,0,1,1,1,99,100
00326500,FRANKLIN & MARSHALL COLLEGE             ,PA,17604-0000,Private      ,3,1,4,3586,194,3780
00326600,GANNON UNIVERSITY                       ,PA,16541-0001,Private      ,5,16,21,4025,1645,5670
00326700,GENEVA COLLEGE                          ,PA,15010-3599,Private      ,1,18,19,2009,1107,3116
00326800,GETTYSBURG COLLEGE                      ,PA,17325-1486,Private      ,0,3,3,4516,208,4724
00326900,GROVE CITY COLLEGE                      ,PA,16127-2104,Private      ,4,0,4,1894,57,1951
00327000,GWYNEDD-MERCY COLLEGE                   ,PA,19437-0901,Private      ,4,33,37,1877,1875,3752
00327200,HARCUM COLLEGE                          ,PA,19010-3476,Private      ,2,17,19,1031,1919,2950
00327300,HARRISBURG AREA COMMUNITY COLLEGE       ,PA,17110-2999,Public       ,128,436,564,10584,18473,29057
00327400,HAVERFORD COLLEGE                       ,PA,19041-1392,Private      ,1,1,2,2347,55,2402
00327500,HOLY FAMILY UNIVERSITY                  ,PA,19114-2094,Private      ,4,20,24,2367,2412,4779
00327600,IMMACULATA UNIVERSITY                   ,PA,19345-0647,Private      ,2,46,48,1828,2157,3985
00327700,INDIANA UNIVERSITY OF PENNSYLVANIA      ,PA,15705-1097,Public       ,129,76,205,16207,4493,20700
00327900,JUNIATA COLLEGE                         ,PA,16652-2196,Private      ,1,1,2,2460,104,2564
00328000,KEYSTONE COLLEGE                        ,PA,18440-0200,Private      ,3,18,21,1810,896,2706
00328200,KINGS COLLEGE                           ,PA,18711-0801,Private      ,3,7,10,3570,689,4259
00328300,LACKAWANNA COLLEGE                      ,PA,18509-9961,Private      ,13,20,33,2063,1384,3447
00328400,LAFAYETTE COLLEGE                       ,PA,18042-1768,Private      ,4,0,4,4614,165,4779
00328500,LANCASTER BIBLE COLLEGE                 ,PA,17601-5036,Private      ,2,42,44,883,1238,2121
00328600,LANCASTER THEOLOGICAL SEMINARY          ,PA,17603-0000,Private      ,0,0,0,7,123,130
00328700,LASALLE UNIVERSITY                      ,PA,19141-1199,Private      ,14,103,117,6909,5116,12025
00328800,LEBANON VALLEY COLLEGE                  ,PA,17003-1400,Private      ,2,0,2,2903,311,3214
00328900,LEHIGH UNIVERSITY                       ,PA,18015-1588,Private      ,8,9,17,9052,1113,10165
00329000,LINCOLN UNIVERSITY                      ,PA,19352-0999,Public       ,9,10,19,4167,1505,5672
00329100,LUTHERAN THEOLOG SEMINARY-GETTYSBRG     ,PA,17325-0000,Private      ,0,1,1,2,111,113
00329200,LUTHERAN THEOLOGICAL SEMINARY           ,PA,19119-0000,Private      ,0,2,2,2,227,229
00329300,LYCOMING COLLEGE                        ,PA,17701-5192,Private      ,0,3,3,2088,179,2267
00329400,MANOR COLLEGE                           ,PA,19046-3399,Private      ,2,6,8,855,730,1585
00329600,MARYWOOD UNIVERSITY                     ,PA,18509-1598,Private      ,4,23,27,3121,1774,4895
00329700,MERCYHURST COLLEGE                      ,PA,16546-0001,Private      ,8,8,16,4571,2155,6726
00329800,MESSIAH COLLEGE                         ,PA,17027-0000,Private      ,5,3,8,3698,423,4121
00330000,MOORE COLLEGE OF ART & DESIGN           ,PA,19103-1179,Private      ,2,5,7,804,432,1236
00330100,MORAVIAN COLLEGE                        ,PA,18018-6650,Private      ,2,4,6,2471,433,2904
00330101,MORAVIAN THEOLOGICAL SEMINARY           ,PA,18018-0000,Private      ,0,0,0,14,85,99
00330200,MOUNT ALOYSIUS COLLEGE                  ,PA,16630-1999,Private      ,4,7,11,1460,930,2390
00330300,CARLOW UNIVERSITY                       ,PA,15213-3165,Private      ,5,28,33,1378,2270,3648
00330400,MUHLENBERG COLLEGE                      ,PA,18104-5586,Private      ,1,10,11,4153,468,4621
00330600,VALLEY FORGE CHRISTIAN COLLEGE          ,PA,19460-2399,Private      ,0,4,4,916,306,1222
00330900,PEIRCE COLLEGE                          ,PA,19102-4699,Private      ,6,84,90,641,3277,3918
00331100,SALUS UNIVERSITY                        ,PA,19027-1598,Private      ,0,4,4,19,1109,1128
00331300,WIDENER UNIVERSITY                      ,PA,19013-5792,Private      ,3,25,28,4974,2972,7946
00331302,WIDENER UNIV SCH OF LAW- HARRISBURG     ,PA,17106-9381,Private      ,0,5,5,23,827,850
00331500,BLOOMSBURG UNIVERSITY OF PA             ,PA,17815-1301,Public       ,47,20,67,12984,2274,15258
00331600,CALIFORNIA UNIV OF PENNSYLVANIA         ,PA,15419-1394,Public       ,12,56,68,7255,5101,12356
00331700,CHEYNEY UNIVERSITY OF PENNSYLVANIA      ,PA,19319-0200,Public       ,8,12,20,2451,1220,3671
00331800,CLARION UNIVERSITY OF PENNSYLVANIA      ,PA,16214-1232,Public       ,13,22,35,5495,2760,8255
00332000,EAST STROUDSBURG UNIVERSITY             ,PA,18301-2999,Public       ,53,21,74,8431,2172,10603
00332100,EDINBORO UNIVERSITY OF PENNSYLVANIA     ,PA,16444-0001,Public       ,10,48,58,6626,3465,10091
00332200,KUTZTOWN UNIVERSITY OF PENNSYLVANIA     ,PA,19530-9339,Public       ,21,28,49,12586,2549,15135
00332300,LOCK HAVEN UNIV OF PENNSYLVANIA         ,PA,17745-2439,Public       ,41,29,70,6517,1615,8132
00332400,MANSFIELD UNIVERSITY                    ,PA,16933-1123,Public       ,64,28,92,3349,1103,4452
00332500,MILLERSVILLE UNIVERSITY OF PA           ,PA,17551-1800,Public       ,8,18,26,9753,2790,12543
00332600,SHIPPENSBURG UNIVERSITY                 ,PA,17257-2299,Public       ,21,33,54,8959,1916,10875
00332700,SLIPPERY ROCK UNIVERSITY                ,PA,16057-1326,Public       ,19,73,92,9264,2389,11653
00332800,WEST CHESTER UNIVERSITY                 ,PA,19383-0001,Public       ,106,67,173,18870,5342,24212
00332900,PENN STATE UNIVERSITY                   ,PA,16802-1503,Public       ,585,398,983,77779,30872,108651
00335000,UNIVERSITY OF THE ARTS (THE)            ,PA,19102-9493,Private      ,4,8,12,3533,976,4509
00335100,CAIRN UNIVERSITY                        ,PA,19047-2942,Private      ,1,6,7,872,608,1480
00335200,PHILADELPHIA CLG OSTEOPATHIC MED        ,PA,19131-0000,Private      ,0,6,6,36,3448,3484
00335300,UNIVERSITY OF THE SCIENCES IN PHILADELPH,PA,19104-4495,Private      ,3,5,8,3803,1537,5340
00335400,PHILADELPHIA UNIVERSITY                 ,PA,19144-5497,Private      ,8,41,49,4696,2546,7242
00335600,PITTSBURGH THEOLOGICAL SEMINARY         ,PA,15206-0000,Private      ,0,1,1,6,228,234
00335700,POINT PARK UNIVERSITY                   ,PA,15222-1912,Private      ,8,38,46,3833,2639,6472
00335800,REFORMED PRESBYTERIAN THEOL SEMINAR     ,PA,15208-0000,Private      ,0,0,0,0,26,26
00335900,ROBERT MORRIS UNIVERSITY                ,PA,15108-1189,Private      ,13,46,59,5279,2456,7735
00336000,ROSEMONT COLLEGE                        ,PA,19010-1699,Private      ,2,14,16,753,697,1450
00336200,SETON HILL UNIVERSITY                   ,PA,15601-1599,Private      ,0,9,9,2263,1052,3315
00336400,ST. CHARLES BORROMEO SEMINARY           ,PA,19096-0000,Private      ,0,2,2,40,50,90
00336600,SAINT FRANCIS UNIVERSITY                ,PA,15940-0600,Private      ,4,20,24,2143,842,2985
00336700,SAINT JOSEPH'S UNIVERSITY               ,PA,19131-1395,Private      ,10,126,136,7642,4424,12066
00336800,ST VINCENT COLLEGE                      ,PA,15650-2690,Private      ,3,5,8,2090,345,2435
00336900,SUSQUEHANNA UNIVERSITY                  ,PA,17870-1001,Private      ,2,0,2,3369,124,3493
00337000,SWARTHMORE COLLEGE                      ,PA,19081-1397,Private      ,1,0,1,4190,119,4309
00337100,TEMPLE UNIVERSITY                       ,PA,19122-6003,Private      ,68,164,232,36195,22339,58534
00337600,THIEL COLLEGE                           ,PA,16125-2181,Private      ,4,2,6,1887,163,2050
00337800,UNIVERSITY OF PENNSYLVANIA              ,PA,19104-6216,Private      ,26,114,140,22091,14446,36537
00337900,UNIVERSITY OF PITTSBURGH                ,PA,15260-0000,Public       ,52,132,184,30039,12013,42052
00337906,UNIVERSITY OF PITTSBURGH - SCHOOL OF MED,PA,15261-0001,Public       ,3,2,5,262,1057,1319
00337907,UNIVERSITY OF PITTSBURGH - SCHOOL OF DEN,PA,15261-2523,Public       ,0,3,3,95,421,516
00338400,UNIVERSITY OF SCRANTON                  ,PA,18510-4622,Private      ,4,59,63,8354,2164,10518
00338500,URSINUS COLLEGE                         ,PA,19426-1000,Private      ,0,1,1,3217,142,3359
00338600,VALLEY FORGE MILITARY COLLEGE           ,PA,19087-3695,Private      ,1,0,1,367,67,434
00338800,VILLANOVA UNIVERSITY                    ,PA,19085-1699,Private      ,7,58,65,12705,3313,16018
00338801,VILLANOVA UNIV SCH OF LAW               ,PA,19085-0000,Private      ,0,5,5,50,1547,1597
00338900,WASHINGTON & JEFFERSON COLLEGE          ,PA,15301-4801,Private      ,2,3,5,2813,134,2947
00339100,WAYNESBURG UNIVERSITY                   ,PA,15370-1222,Private      ,3,41,44,2177,927,3104
00339200,WESTMINSTER COLLEGE                     ,PA,16172-0002,Private      ,3,4,7,2526,140,2666
00339300,WESTMINSTER THEOLOGICAL SEMINARY        ,PA,19038-0000,Private      ,0,0,0,8,364,372
00339400,WILKES UNIVERSITY                       ,PA,18766-0998,Private      ,8,55,63,3562,1528,5090
00339500,PENNSYLVANIA COLLEGE OF TECHNOLOGY      ,PA,17701-5779,Public       ,12,14,26,5444,2571,8015
00339600,WILSON COLLEGE                          ,PA,17201-1285,Private      ,0,16,16,462,472,934
00339900,YORK COLLEGE OF PENNSYLVANIA            ,PA,17405-7199,Private      ,15,17,32,9038,1710,10748
00398600,DESALES UNIVERSITY                      ,PA,18034-9568,Private      ,5,36,41,2735,1769,4504
00398700,LA ROCHE COLLEGE                        ,PA,15237-5898,Private      ,4,11,15,1394,718,2112
00398800,NEUMANN UNIVERSITY                      ,PA,19014-1298,Private      ,8,34,42,3683,1566,5249
00405800,GRATZ COLLEGE                           ,PA,19027-3097,Private      ,0,6,6,3,154,157
00445200,MONTGOMERY COUNTY COMMUNITY COLLEGE     ,PA,19422-6300,Public       ,47,147,194,5826,7075,12901
00488900,CAMBRIA-ROWE BUSINESS COLLEGE           ,PA,15902-2494,Proprietary  ,4,20,24,165,370,535
00488901,CAMBRIA ROWE BUSINESS COLLEGE - INDIANA ,PA,15701-2804,Proprietary  ,4,4,8,4,4,8
00489000,CENTRAL PENNSYLVANIA COLLEGE            ,PA,17093-0309,Proprietary  ,6,9,15,935,1673,2608
00489300,DU BOIS BUSINESS COLLEGE                ,PA,15801-2401,Proprietary  ,0,6,6,150,312,462
00489400,ERIE BUSINESS CENTER                    ,PA,16501-1305,Proprietary  ,3,22,25,112,457,569
00489401,ERIE BUSINESS CENTER - NEW CASTLE CAMPUS,PA,16101-3950,Proprietary  ,2,10,12,47,141,188
00489800,MCCANN SCHOOL OF BUSINESS & TECHNOL     ,PA,17901-1335,Proprietary  ,71,336,407,1798,6089,7887
00489807,MCCANN SCHOOL OF BUSINESS & TECHNOLOGY -,PA,17013-3180,Proprietary  ,1,4,5,62,184,246
00489900,MERCY HOSP SCH OF NURSING               ,PA,15219-5166,Private      ,2,0,2,165,283,448
00490100,NEWPORT BUSINESS INSTITUTE              ,PA,15068-3929,Proprietary  ,0,3,3,38,96,134
00490200,PENN COMMERCIAL BUSINESS/TECHNICAL SCHL ,PA,15301-2871,Proprietary  ,4,6,10,277,484,761
00491000,KAPLAN CAREER INSTITUTE                 ,PA,17111-3571,Proprietary  ,12,45,57,299,1108,1407
00491001,THOMPSON INSTITUTE-PHILADEPHIA CAMPUS   ,PA,19104-3386,Proprietary  ,18,65,83,400,1204,1604
00491400,NEWPORT BUSINESS INSTITUTE              ,PA,17701-5855,Proprietary  ,0,3,3,18,156,174
00500701,WEST VIRGINIA CAREER INSTITUTE          ,PA,15456-0000,Proprietary  ,5,13,18,69,153,222
00531000,PITTSBURGH INST OF AERONAUTICS          ,PA,15236-0000,Private      ,2,8,10,372,296,668
00533000,FAYETTE CNTY AREA VOC TECH PRC NRSG     ,PA,15401-0000,Public       ,0,1,1,40,125,165
00533500,CENTRAL PENN INST OF SCI & TECH PNP     ,PA,16823-0000,Public       ,0,5,5,126,252,378
00536500,YORK CO AREA VOC-TECH SCH-PRAC NSG      ,PA,17402-0000,Public       ,2,10,12,105,471,576
00653400,CITIZENS SCHOOL OF NURSING              ,PA,15068-6591,Private      ,0,1,1,103,192,295
00653700,CONEMAUGH VLY MEM HOSP SCH NRSNG        ,PA,15905-4398,Private      ,1,3,4,105,145,250
00653702,CONEMAUGH HOSP- SCH HISTOTECHNOLOGY     ,PA,15905-0000,Private      ,0,0,0,14,23,37
00653704,CONEMAUGH VLY MEM HOSP SCH RAD TECH     ,PA,15905-0000,Private      ,1,1,2,31,33,64
00653706,CONEMAUGH VLY MEM HOSP SCH  MED TECH    ,PA,15905-4398,Private      ,0,0,0,7,29,36
00655100,ST MARGARET SCHL OF NURSING             ,PA,15238-3205,Private      ,1,0,1,104,266,370
00656000,OHIO VALLEY HOSP SCH OF NURSING         ,PA,15136-1694,Private      ,0,0,0,24,71,95
00656500,READING HOSPITAL SCHOOL OF HEALTH SCIENC,PA,19611-1744,Private      ,1,2,3,283,547,830
00657400,"ST LUKE'S HOSPITAL OF BETHLEHEM, PA     ",PA,18015-1065,Private      ,0,1,1,86,312,398
00657600,SEWICKLEY VALLEY HOSP SCH NRSNG         ,PA,15143-1498,Private      ,0,2,2,36,78,114
00657700,UPMC SHADYSIDE SCHOOL OF NURSING        ,PA,15232-1381,Private      ,3,5,8,211,495,706
00657800,SHARON REGIONAL SCHOOL OF NURSING       ,PA,16146-3395,Private      ,0,0,0,31,74,105
00658200,WASHINGTON HOSP SCH OF NURSING          ,PA,15301-3398,Private      ,0,1,1,69,169,238
00658202,WASHINGTON HOSP SCH OF RAD TECH         ,PA,15301-3398,Private      ,0,0,0,23,17,40
00658300,WESTERN PENN HOSP-SCH OF NURSING        ,PA,15224-1790,Private      ,2,3,5,142,225,367
00680700,COMMUNITY COLLEGE OF BEAVER COUNTY      ,PA,15061-2588,Public       ,10,48,58,1438,1808,3246
00681000,LEHIGH CARBON COMMUNITY COLLEGE         ,PA,18078-2598,Public       ,24,73,97,3644,4826,8470
00681100,LUZERNE COUNTY COMMUNITY COLLEGE        ,PA,18634-3899,Public       ,34,102,136,3735,4389,8124
00708700,ABINGTON MEM HOSP SCHL OF NURSING       ,PA,19090-1284,Private      ,1,7,8,158,464,622
00709100,EVEREST INSTITUTE                       ,PA,15222-1320,Proprietary  ,21,95,116,266,1196,1462
00711000,DELAWARE COUNTY COMMUNITY COLLEGE       ,PA,19063-1094,Public       ,72,261,333,7086,10233,17319
00719100,NORTHAMPTON COMMUNITY COLLEGE           ,PA,18020-7599,Public       ,58,110,168,7183,7408,14591
00730305,LINCOLN TECHNICAL INSTITUTE - PHILADELPH,PA,19136-1530,Proprietary  ,22,38,60,556,752,1308
00732955,ITT TECHNICAL INSTITUTE                 ,PA,19406-1212,Proprietary  ,21,76,97,270,674,944
00743000,ANTONELLI INST OF ART & PHOTOGRAPHY     ,PA,19038-8242,Proprietary  ,0,2,2,248,74,322
00743600,KAPLAN CAREER INSTITUTE - ICM CAMPUS    ,PA,15222-1977,Proprietary  ,12,52,64,336,1205,1541
00743700,PITTSBURGH TECHNICAL INSTITUTE          ,PA,15071-3205,Proprietary  ,7,14,21,2325,1248,3573
00746900,"HUSSIAN SCHOOL OF ART, INC.             ",PA,19106-0000,Proprietary  ,1,0,1,151,66,217
00747000,"ART INSTITUTE OF PITTSBURGH, THE        ",PA,15219-1328,Proprietary  ,421,2185,2606,6920,24432,31352
00752900,"CHESTER COUNTY INTERMEDIATE UNIT, PNP   ",PA,19335-3043,Public       ,0,3,3,39,193,232
00775900,LINCOLN TECHNICAL INSTITUTE             ,PA,18104-3298,Proprietary  ,12,61,73,402,955,1357
00777900,LANSDALE SCHOOL OF BUSINESS             ,PA,19454-4114,Proprietary  ,5,23,28,129,569,698
00778000,NEW CASTLE SCHOOL OF TRADES             ,PA,16143-0000,Proprietary  ,15,49,64,401,1102,1503
00778100,CHI INSTITUTE/RETS CAMPUS               ,PA,19008-3516,Proprietary  ,9,50,59,246,736,982
00783900,TRIANGLE TECH                           ,PA,15214-3897,Proprietary  ,21,35,56,298,496,794
00791200,THADDEUS STEVENS CLG OF TECHNOLOGY      ,PA,17602-0000,Public       ,5,4,9,1335,642,1977
00791600,FRANKLIN CNTY CAREER & TECH CTR-PNP     ,PA,17201-0000,Public       ,0,2,2,30,131,161
00820000,JAMESON MEMORIAL HOSP SCH NURSING       ,PA,16105-2595,Private      ,0,0,0,48,112,160
00835000,ART INSTITUTE OF PHILADELPHIA           ,PA,19103-5198,Proprietary  ,29,59,88,3886,3374,7260
00844100,ANTHEM INSTITUTE                        ,PA,19064-1243,Proprietary  ,13,44,57,304,1046,1350
00856800,VET TECH INSTITUTE                      ,PA,15222-3400,Proprietary  ,2,2,4,387,221,608
00865300,JEFFERSON CO DUBOIS VOC TECH-PR NSG     ,PA,15851-0000,Public       ,0,0,0,25,64,89
00895500,PRUONTOS HAIR DESIGN INSTITUTE          ,PA,16602-0000,Proprietary  ,0,2,2,24,45,69
00915705,WYOMING TECHNICAL INSTITUTE - BLAIRSVILL,PA,15717-8060,Proprietary  ,80,72,152,1652,1427,3079
00918600,DEAN INSTITUTE OF TECHNOLOGY            ,PA,15226-1197,Proprietary  ,4,25,29,81,231,312
00944900,PENNCO TECH                             ,PA,19007-0000,Proprietary  ,20,50,70,326,769,1095
00966400,EMPIRE BEAUTY SCHOOL                    ,PA,18052-5730,Proprietary  ,19,35,54,240,536,776
00966500,EMPIRE BEAUTY SCHOOL                    ,PA,17109-2210,Proprietary  ,7,16,23,119,294,413
00966600,EMPIRE BEAUTY SCHOOL                    ,PA,19605-2803,Proprietary  ,9,21,30,149,407,556
00972100,BRADFORD SCHOOL                         ,PA,15219-2602,Proprietary  ,3,5,8,609,247,856
00972300,ARIA HEALTH SCHOOL OF NURSING           ,PA,19053-6939,Private      ,0,2,2,254,722,976
00978300,GORDON PHILLIPS SCH OF BEAUTY CULT      ,PA,19135-0000,Proprietary  ,15,29,44,273,528,801
00986300,LANCASTER GENERAL COLLEGE OF NURSING AND,PA,17602-4955,Private      ,1,11,12,689,1335,2024
01000600,GREATER JOHNSTOWN AREA VOC TECH SCH     ,PA,15904-0000,Public       ,0,3,3,110,318,428
01005500,CRAWFORD CNTY AREA VO-TECH PRAC NUR     ,PA,16335-0000,Public       ,1,2,3,22,37,59
01017600,WESTMORELAND COUNTY COMMUNITY CLG       ,PA,15697-1895,Public       ,46,124,170,3225,4254,7479
01038800,READING AREA COMMUNITY COLLEGE          ,PA,19603-1706,Public       ,77,216,293,2712,5414,8126
01054100,EMPIRE BEAUTY SCHOOL                    ,PA,15146-2229,Proprietary  ,9,20,29,152,354,506
01054200,EMPIRE BEAUTY SCHOOL                    ,PA,18701-0000,Proprietary  ,10,30,40,195,365,560
01054300,EMPIRE BEAUTY SCHOOL                    ,PA,17701-3914,Proprietary  ,7,20,27,86,253,339
01081400,PITTSBURGH INST MORTUARY SCIENCE        ,PA,15206-3706,Private      ,1,7,8,132,387,519
01086000,GREATER ALTOONA CAREER/TECH CENTER      ,PA,16602-0000,Public       ,0,1,1,99,315,414
01096300,GREENE COUNTY VOC-TECH SCHOOL           ,PA,15370-0000,Public       ,0,2,2,17,36,53
01097000,EMPIRE BEAUTY SCHOOL                    ,PA,17042-5209,Proprietary  ,0,4,4,35,90,125
01099800,PENNSYLVANIA INSTITUTE OF TECH          ,PA,19063-4098,Private      ,18,28,46,554,1128,1682
01102000,EMPIRE BEAUTY SCHOOL                    ,PA,17604-4335,Proprietary  ,14,28,42,202,458,660
01102100,EMPIRE BEAUTY SCHOOL                    ,PA,17402-2862,Proprietary  ,14,31,45,152,422,574
01162100,AUTOMOTIVE TRAINING CENTER              ,PA,19341-1310,Proprietary  ,115,34,149,1327,674,2001
01162200,WELDER TRAINING & TESTING INST          ,PA,18109-3253,Proprietary  ,2,6,8,47,166,213
01163800,EMPIRE BEAUTY SCHOOL                    ,PA,17876-0000,Proprietary  ,1,5,6,34,72,106
01171500,SCHUYLKILL HEALTH SCHOOL OF NURSING     ,PA,17901-3692,Private      ,0,0,0,57,72,129
01191900,BEAVER FALLS BEAUTY ACADEMY             ,PA,15010-4208,Proprietary  ,6,9,15,39,75,114
01205000,ROSEDALE TECHNICAL INSTITUTE            ,PA,15205-9791,Private      ,7,11,18,303,417,720
01239300,THOMAS JEFF UNIV-CLG ALLIED HEALTH      ,PA,19107-0000,Private      ,0,5,5,369,1702,2071
01239301,THOMAS JEFFERSON UNIVERSITY - JEFFERSON ,PA,19107-5001,Private      ,3,18,21,539,3006,3545
01239303,THOMAS JEFFERSON UNIVERSITY - COLLEGE OF,PA,19107-6731,Private      ,0,9,9,292,1153,1445
01246104,LINCOLN TECHNICAL INSTITUTE             ,PA,19104-0202,Proprietary  ,16,46,62,408,1021,1429
01246105,LINCOLN TECHNICAL INSTITUTE             ,PA,19116-4202,Proprietary  ,10,19,29,240,592,832
01252300,TALMUDICAL YESHIVA OF PHILA             ,PA,19131-1296,Private      ,1,0,1,36,4,40
01260500,EMPIRE BEAUTY SCHOOL                    ,PA,17331-2405,Proprietary  ,7,32,39,117,323,440
01260600,EMPIRE BEAUTY SCHOOL                    ,PA,17901-3859,Proprietary  ,8,36,44,202,542,744
01260700,EMPIRE BEAUTY SCHOOL                    ,PA,16801-5218,Proprietary  ,2,3,5,50,78,128
01292900,SOUTH HILLS BEAUTY ACADEMY              ,PA,15216-2335,Proprietary  ,1,17,18,66,169,235
01301500,GORDON PHILLIPS SCH BEAUTY CULTURE      ,PA,19102-2701,Proprietary  ,17,46,63,291,675,966
01313400,YESHIVATH BETH MOSHE                    ,PA,18505-2196,Private      ,0,0,0,42,13,55
01321400,ROXBOROUGH MEM HOSP SCH OF NURSING      ,PA,19128-0000,Proprietary  ,0,4,4,75,290,365
01326300,SOUTH HILLS SCHOOL OF BUSINESS & TECHNOL,PA,16801-4516,Proprietary  ,0,2,2,563,557,1120
02061000,VENUS BEAUTY ACADEMY                    ,PA,19079-0000,Proprietary  ,2,3,5,55,104,159
02068300,DOUGLAS SCHOOL OF BUSINESS              ,PA,15062-0000,Proprietary  ,7,16,23,293,351,644
02090200,TRIANGLE TECH                           ,PA,16502-0000,Proprietary  ,3,4,7,110,150,260
02092500,LAUREL TECHNICAL INSTITUTE              ,PA,16146-0000,Proprietary  ,8,27,35,200,398,598
02092502,BUSINESS INSTITUTE OF PENNSYLVANIA      ,PA,16335-0000,Proprietary  ,0,1,1,17,31,48
02104003,HARRIS SCHOOL OF BUSINESS - UPPER DARBY ,PA,19082-2528,Proprietary  ,1,3,4,26,70,96
02107300,PENNSYLVANIA ACADEMY OF FINE ARTS       ,PA,19102-1424,Private      ,1,2,3,327,379,706
02112200,GREAT LAKES INSTITUTE OF TECHNOLOGY     ,PA,16509-0000,Proprietary  ,8,15,23,417,616,1033
02114200,JOHNSON COLLEGE                         ,PA,18508-0000,Private      ,4,1,5,578,356,934
02116001,SANFORD-BROWN INSTITUTE - TREVOSE       ,PA,19053-4700,Proprietary  ,0,2,2,258,829,1087
02118000,LEVITTOWN BEAUTY ACADEMY LLC            ,PA,19054-1713,Proprietary  ,2,3,5,43,60,103
02119300,PA ACAD OF COSMETOLOGY ARTS & SCI       ,PA,15904-0000,Proprietary  ,6,6,12,69,101,170
02120800,"YORKTOWNE BUSINESS INSTITUTE, INC.      ",PA,17404-0000,Proprietary  ,3,8,11,118,399,517
02127400,YORK TECHNICAL INSTITUTE                ,PA,17402-0000,Proprietary  ,44,96,140,1309,2202,3511
02129000,TRIANGLE TECH                           ,PA,15601-0000,Proprietary  ,17,29,46,368,316,684
02129001,TRIANGLE TECH - BUSINESS CAREERS INSTITU,PA,15601-3304,Proprietary  ,0,1,1,17,27,44
02144000,"VISION ACADEMY, THE                     ",PA,18103-0000,Proprietary  ,2,3,5,54,125,179
02149000,EMPIRE BEAUTY SCHOOL                    ,PA,19341-2804,Proprietary  ,13,21,34,181,408,589
02151500,CENTRAL SUSQUEHANNA LPN CENTER          ,PA,17837-8818,Public       ,1,0,1,54,213,267
02153500,OAKBRIDGE ACADEMY OF ARTS               ,PA,15068-0000,Proprietary  ,0,0,0,70,23,93
02158300,JUNIATA-MIFFLIN CO AREA VOC TECH        ,PA,17044-0000,Public       ,0,0,0,32,76,108
02161400,NORTHEASTERN HOSP SCH OF NRSG           ,PA,19134-0000,Private      ,2,2,4,104,386,490
02169600,CLEARFIELD CTY CAREER AND TECH CNTR     ,PA,16830-0000,Public       ,0,3,3,61,128,189
02174400,TRIANGLE TECH                           ,PA,15801-0000,Proprietary  ,27,16,43,391,259,650
02178900,ACADEMY OF HAIR DESIGN                  ,PA,18202-1465,Proprietary  ,18,25,43,146,314,460
02183000,ORLEANS TECHNICAL INSTITUTE             ,PA,19111-0000,Private      ,16,66,82,292,873,1165
02192800,WALNUT HILL COLLEGE                     ,PA,19104-0000,Proprietary  ,6,8,14,614,436,1050
02202300,SANFORD-BROWN INSTITUTE                 ,PA,15219-1907,Proprietary  ,7,31,38,302,1059,1361
02202301,SANFORD-BROWN INSTITUTE                 ,PA,15146-2141,Proprietary  ,1,3,4,122,410,532
02203900,ERIE INSTITUTE OF TECHNOLOGY            ,PA,16565-1002,Proprietary  ,9,16,25,210,383,593
02206200,"VISION ACADEMY, THE                     ",PA,19002-0000,Proprietary  ,3,17,20,58,139,197
02206300,STROUDSBURG SCHOOL OF COSMETOLOGY       ,PA,18360-0000,Proprietary  ,3,3,6,65,81,146
02212700,LANCASTER SCHOOL OF COSMETOLOGY         ,PA,17602-0000,Proprietary  ,3,5,8,80,210,290
02234200,ACADEMY OF MEDICAL ARTS & BUSINESS      ,PA,17112-0000,Proprietary  ,7,8,15,240,512,752
02240100,BARBER STYLING INSTITUTE                ,PA,17011-0000,Proprietary  ,0,0,0,0,1,1
02251200,SCHUYLKILL COUNTY AREA VOC TECH SCH     ,PA,17931-0000,Public       ,0,6,6,31,118,149
02251202,SCHUYLKILL COUNTY AREA VOC TECH SCH     ,PA,17931-0000,Public       ,0,0,0,9,40,49
02253900,BERKS TECHNICAL INSTITUTE               ,PA,19610-0000,Proprietary  ,22,41,63,850,1168,2018
02255200,PENNSYLVANIA SCHOOL OF BUSINESS         ,PA,18101-1604,Proprietary  ,5,40,45,152,641,793
02269900,PENNSYLVANIA COLLEGE OF ART & DESIGN    ,PA,17603-3528,Private      ,2,2,4,507,136,643
02270500,BUCKS COUNTY SCHOOL OF BEAUTY CULT      ,PA,19053-0000,Proprietary  ,1,3,4,50,60,110
02273400,RECONSTRUCTIONIST RABBINICAL COLLEG     ,PA,19095-0000,Private      ,0,0,0,0,43,43
02276600,HANOVER PUBLIC SCH DIST PRAC NURSG      ,PA,17331-0000,Public       ,0,1,1,13,82,95
02282500,LENAPE SCHOOL OF PRACTICAL NURSING      ,PA,16226-0000,Public       ,0,1,1,41,180,221
02288800,EMPIRE BEAUTY SCHOOL                    ,PA,18974-4508,Proprietary  ,7,28,35,173,450,623
02289500,PACE INSTITUTE                          ,PA,19601-0000,Proprietary  ,3,3,6,82,289,371
02289600,CONSOLIDATED SCHOOL OF BUSINESS         ,PA,17404-0000,Proprietary  ,0,6,6,61,284,345
02289700,ACADEMY OF CREATIVE HAIR DESIGN         ,PA,18702-0000,Proprietary  ,9,19,28,78,222,300
02289800,CHI INSTITUTE - FRANKLIN MILLS          ,PA,19154-0000,Proprietary  ,25,58,83,459,1167,1626
02290400,"ALTOONA BEAUTY SCHOOL, INC              ",PA,16602-0000,Proprietary  ,0,3,3,55,111,166
02292700,LANSDALE SCHOOL OF COSMETOLOGY          ,PA,19446-0000,Proprietary  ,3,6,9,34,62,96
02299300,TRINITY EPISCOPAL SCHOOL MINISTRY       ,PA,15003-0000,Private      ,0,0,0,2,122,124
02301300,PRISM CAREER INSTITUTE                  ,PA,19082-2448,Proprietary  ,10,38,48,190,861,1051
02304400,YTI CAREER INSTITUTE - MECHANICSBURG    ,PA,17055-0000,Proprietary  ,1,2,3,199,358,557
02306200,VENANGO COUNTY AREA VOC TECH SCHOOL     ,PA,16301-0000,Public       ,0,0,0,34,87,121
02310800,LANCASTER COUNTY CAREER & TECH CTR      ,PA,17584-0000,Public       ,3,15,18,181,586,767
02323000,BIBLICAL THEOLOGICAL SEMINARY           ,PA,19440-2421,Private      ,0,2,2,1,133,134
02330300,LEBANON CO CAREER & TECHNOLOGY CTR      ,PA,17042-0000,Public       ,1,5,6,63,245,308
02330600,PENNSYLVANIA GUNSMITH SCHOOL            ,PA,15202-0000,Proprietary  ,4,2,6,118,155,273
02350100,WESTERN AREA CAREER & TECHNOLOGY CT     ,PA,15317-0000,Public       ,0,2,2,41,154,195
02350200,INDIANA COUNTY TECH CTR SCH PR NSG      ,PA,15701-1465,Public       ,1,0,1,57,154,211
02353100,NORTHERN TIER CAREER CENTER             ,PA,18848-0000,Public       ,0,0,0,38,70,108
02362300,MERCER COUNTY AREA VOC TECH SCHOOL      ,PA,16137-0000,Public       ,1,0,1,25,70,95
02492600,EASTERN CTR ARTS AND TECH PR NSG        ,PA,19090-0000,Public       ,1,1,2,41,218,259
02495500,ALL-STATE CAREER SCHOOL                 ,PA,19029-0000,Proprietary  ,26,137,163,344,1264,1608
02529800,WILKES BARRE AREA CAREER AND TECHNICAL C,PA,18705-0000,Public       ,5,10,15,97,275,372
02536600,COMMONWEALTH TECH INSTIT @ HIRAM G      ,PA,15905-0000,Public       ,15,10,25,332,170,502
02544300,BUTLER BEAUTY SCHOOL                    ,PA,16001-0000,Proprietary  ,5,19,24,54,153,207
02545000,LAWRENCE COUNTY CAREER AND TECHNICAL CEN,PA,16101-0000,Public       ,0,0,0,32,99,131
02546200,LAUREL BUSINESS INSTITUTE               ,PA,15401-0877,Proprietary  ,5,14,19,140,260,400
02550000,CLARION CO AREA VOC-TECH PRAC NRSG      ,PA,16254-4637,Public       ,0,1,1,29,66,95
02554500,HAZLETON AREA CAREER CENTER PRACTICAL NU,PA,18201-0000,Public       ,1,0,1,23,92,115
02557800,ART INSTITUTE OF YORK (THE) - PENNSYLVAN,PA,17402-9012,Proprietary  ,0,13,13,817,413,1230
02566400,ALBERT EINSTEIN MED CTR DEPT DNTL       ,PA,19141-3098,Private      ,0,2,2,39,156,195
02574800,PENNSYLVANIA INSTITUTE OF TAXIDERMY     ,PA,15931-0000,Proprietary  ,0,0,0,16,32,48
02609500,CAREER TRAINING ACADEMY                 ,PA,15068-6308,Proprietary  ,5,22,27,137,367,504
02609501,CAREER TRAINING ACADEMY                 ,PA,15146-0000,Proprietary  ,0,1,1,14,42,56
02616100,JEAN MADELINE ED CTR FOR COSM           ,PA,19147-1542,Proprietary  ,5,12,17,400,486,886
03006800,LE CORDON BLEU INSTITUTE OF CULINARY ART,PA,15222-3511,Proprietary  ,0,0,0,156,203,359
03010800,FORTIS INSTITUTE                        ,PA,16506-1013,Proprietary  ,97,196,293,929,2970,3899
03011500,FORTIS INSTITUTE                        ,PA,18702-0000,Proprietary  ,6,24,30,121,325,446
03011600,FORTIS INSTITUTE                        ,PA,18509-2903,Proprietary  ,6,31,37,265,614,879
03029900,CONSOLIDATED SCHOOL OF BUSINESS         ,PA,17603-2389,Proprietary  ,5,7,12,84,234,318
03031600,DPT BUSINESS SCHOOL                     ,PA,19116-3961,Proprietary  ,0,0,0,0,4,4
03031601,DPT BUSINESS SCHOOL                     ,PA,19106-0000,Proprietary  ,0,0,0,0,4,4
03067000,ANTONELLI MEDICAL & PROF INST           ,PA,19464-9244,Proprietary  ,2,14,16,48,145,193
03072600,DCI CAREER INSTITUTE                    ,PA,15061-2307,Proprietary  ,2,6,8,43,132,175
03081900,YTI CAREER INSTITUTE - ALTOONA          ,PA,16602-4457,Proprietary  ,7,25,32,266,474,740
03090800,LAKE ERIE COLL OF OSTEOPATHIC MED       ,PA,16509-0000,Private      ,0,4,4,78,3780,3858
03098600,CAREER TECH CTR OF LACKAWANNA CNTY      ,PA,18508-0000,Public       ,1,3,4,88,280,368
03101400,FORBES ROAD CAREER & TECHNOLOGY CTR     ,PA,15146-1550,Public       ,0,0,0,16,38,54
03101500,BIDWELL TRAINING CENTER                 ,PA,15233-2233,Private      ,1,13,14,50,183,233
03103300,JNA INSTITUTE OF CULINARY ARTS          ,PA,19146-3119,Proprietary  ,3,13,16,159,277,436
03109100,METROPOLITAN CAREER CENTER              ,PA,19144-0000,Private      ,1,9,10,29,219,248
03110700,AVIATION INSTITUTE OF MAINTENANCE       ,PA,19114-1017,Proprietary  ,12,48,60,231,874,1105
03120400,REGIONAL CAREER & TECHNICAL CENTER      ,PA,16509-4699,Public       ,0,0,0,18,33,51
03128400,DELAWARE COUNTY TECHNICAL SCHOOL        ,PA,19008-1928,Public       ,0,2,2,61,218,279
03180400,PENNSYLVANIA HIGHLANDS COMMUNITY COLLEGE,PA,15904-2927,Public       ,16,37,53,1028,1043,2071
03236400,LT INTERNATIONAL BEAUTY SCHOOL          ,PA,19130-2235,Proprietary  ,3,20,23,41,159,200
03353300,ACADEMY OF VOCAL ARTS                   ,PA,19103-6685,Private      ,2,4,6,46,122,168
03380301,STAR CAREER ACADEMY - STAR PHILADELPHIA ,PA,19114-2204,Proprietary  ,23,122,145,444,1553,1997
03380304,STAR CAREER ACADEMY - STAR NORRISTOWN   ,PA,19403-2422,Proprietary  ,5,41,46,78,397,475
03439400,NAWCC SCHOOL OF HOROLOGY                ,PA,17512-2130,Private      ,0,0,0,1,13,14
03493302,ALL-STATE CAREER - WEST MIFFLIN CAMPUS  ,PA,15122-0000,Proprietary  ,12,65,77,105,518,623
03535300,HUNTINGDON COUNTY CAREER AND TECHNO     ,PA,17060-0905,Public       ,0,1,1,13,51,64
03561400,SUSQUEHANNA COUNTY CAREER & TECHNOL     ,PA,18816-0100,Public       ,0,2,2,11,25,36
03766300,PENNSYLVANIA SCHOOL OF MUSCLE THERAPY   ,PA,19406-3101,Proprietary  ,1,7,8,64,209,273
03781300,PRINCETON INFORMATION TECHNOLOGY CENTER ,PA,19038-4535,Proprietary  ,2,19,21,43,339,382
03899300,CALVARY BAPTIST THEOLOGICAL SEMINARY    ,PA,19446-4718,Private      ,0,1,1,1,48,49
03923300,PRECISION MANUFACTURING INSTITUTE       ,PA,16335-8380,Private      ,0,1,1,22,61,83
03948300,HARRISBURG UNIVERSITY OF SCIENCE AND TEC,PA,17101-2116,Private      ,5,6,11,716,349,1065
03949300,WON INSTITUTE OF GRADUATE STUDIES       ,PA,19038-4535,Private      ,0,0,0,0,55,55
03950500,NORTHWEST REGIONAL TECHNOLOGY INSTITUTE ,PA,16508-2820,Proprietary  ,3,15,18,25,83,108
03952300,NATIONAL MASSAGE THERAPY INSTITUTE      ,PA,19116-3965,Proprietary  ,23,123,146,243,894,1137
04024300,EDUCATION AND TECHNOLOGY INSTITUTE      ,PA,15601-9214,Private      ,0,2,2,22,66,88
04041300,BERKS CAREER & TECHNOLOGY CENTER        ,PA,19533-9112,Public       ,0,1,1,0,2,2
04118000,BYZANTINE CATHOLIC SEMINARY OF SAINTS CY,PA,15214-2229,Private      ,0,0,0,2,7,9
04127500,CAREER DEVELOPMENT & EMPLOYMENT         ,PA,18702-5253,Proprietary  ,0,10,10,21,99,120
04138300,INTERNATIONAL BEAUTY ACADEMY            ,PA,19149-2710,Proprietary  ,0,0,0,24,28,52
04145800,PULSE BEAUTY ACADEMY A PAUL MITCHELL PAR,PA,19335-0000,Proprietary  ,3,4,7,118,94,212
04149800,SOMERSET COUNTY TECHNOLOGY CENTER       ,PA,15501-1444,Public       ,0,7,7,29,107,136
04151700,BELLA CAPELLI ACADEMY                   ,PA,15146-2388,Proprietary  ,2,4,6,95,105,200
04151701,BELLA CAPELLI ACADEMY -                 ,PA,15205-2388,Proprietary  ,5,5,10,16,19,35
04155100,INSTITUTE OF MEDICAL CAREERS            ,PA,15235-3718,Proprietary  ,7,13,20,60,133,193
04158000,METRO BEAUTY ACADEMY                    ,PA,18106-9693,Proprietary  ,5,20,25,147,229,376
04164900,BARONE BEAUTY ACADEMY                   ,PA,17701-5316,Proprietary  ,4,4,8,43,61,104
04167200,COMMONWEALTH MEDICAL COLLEGE (THE)      ,PA,18503-3251,Private      ,0,2,2,19,597,616
04167500,WORLD A CUTS BARBER INSTITUTE           ,PA,17401-1105,Proprietary  ,2,5,7,6,28,34
04175900,LEWISTOWN HOSPITAL SCHOOL OF NURSING    ,PA,17044-1167,Private      ,0,1,1,42,61,103
04209700,NEWCOURTLAND EDUCATION CENTER SCHOOL OF ,PA,19119-2126,Private      ,0,1,1,1,35,36
00153410,EVEREST UNIVERSITY - EVEREST COLLEGE - M,WI,53212-4006,Proprietary  ,0,7,7,237,1014,1251
00267813,BRYANT & STRATTON COLLEGE - MIL DOWNTOWN,WI,53203-2608,Proprietary  ,38,200,238,966,3953,4919
00383200,ALVERNO COLLEGE                         ,WI,53234-3922,Private      ,2,27,29,1635,2884,4519
00383500,BELOIT COLLEGE                          ,WI,53511-5595,Private      ,0,1,1,2042,157,2199
00383700,CARDINAL STRITCH UNIVERSITY             ,WI,53217-9884,Private      ,1,94,95,1316,5321,6637
00383800,CARROLL UNIVERSITY                      ,WI,53186-5593,Private      ,3,8,11,4077,1059,5136
00383900,CARTHAGE COLLEGE                        ,WI,53141-0000,Private      ,4,28,32,5406,1147,6553
00384000,WESTERN TECHNICAL COLLEGE               ,WI,54601-0908,Public       ,23,68,91,2466,3074,5540
00384200,CONCORDIA UNIVERSITY WISCONSIN          ,WI,53097-2402,Private      ,10,87,97,3349,5151,8500
00384800,EDGEWOOD COLLEGE                        ,WI,53711-1958,Private      ,3,18,21,1982,1641,3623
00385000,SILVER LAKE COLLEGE                     ,WI,54220-9319,Private      ,0,7,7,236,419,655
00385400,LAKELAND COLLEGE                        ,WI,53082-0000,Private      ,4,105,109,1239,2456,3695
00385600,LAWRENCE UNIVERSITY                     ,WI,54912-0599,Private      ,0,2,2,2482,165,2647
00386100,MARIAN UNIVERSITY                       ,WI,54935-4699,Private      ,7,29,36,1531,1264,2795
00386300,MARQUETTE UNIVERSITY                    ,WI,53201-1881,Private      ,13,48,61,16678,4990,21668
00386600,MILWAUKEE AREA TECH COLLEGE             ,WI,53233-1443,Public       ,98,494,592,8383,21692,30075
00386800,MILWAUKEE SCHOOL OF ENGINEERING         ,WI,53202-3109,Private      ,6,12,18,2868,1010,3878
00386900,MOUNT MARY COLLEGE                      ,WI,53222-4597,Private      ,2,12,14,880,1660,2540
00387400,NASHOTAH HOUSE                          ,WI,53058-0000,Private      ,0,2,2,0,81,81
00387500,NORTHLAND COLLEGE                       ,WI,54806-3999,Private      ,1,0,1,818,162,980
00388400,RIPON COLLEGE                           ,WI,54971-0248,Private      ,0,0,0,1349,85,1434
00389200,ST. NORBERT COLLEGE                     ,WI,54115-2099,Private      ,2,4,6,2960,146,3106
00389500,UNIVERSITY OF WISCONSIN-MADISON         ,WI,53715-1382,Public       ,26,69,95,27937,12335,40272
00389600,UNIVERSITY OF WISCONSIN-MILWAUKEE       ,WI,53201-3165,Public       ,54,201,255,20460,15093,35553
00389700,UNIVERSITY OF WISCONSIN COLLEGES        ,WI,53708-8680,Public       ,10,45,55,3061,2557,5618
00389701,UNIVERSITY OF WISCONSIN-BARABOO         ,WI,53913-1098,Public       ,1,3,4,482,318,800
00389702,UNIVERSITY OF WISCONSIN-BARRON          ,WI,54868-2497,Public       ,1,4,5,464,306,770
00389703,UNIVERSITY OF WISCONSIN-FOND DU LAC     ,WI,54935-2998,Public       ,0,4,4,587,410,997
00389704,UNIVERSITY OF WISCONSIN-FOX VALLEY      ,WI,54952-1297,Public       ,0,5,5,1203,743,1946
00389705,UNIVERSITY OF WISCONSIN-MANITOWOC       ,WI,54220-6699,Public       ,3,2,5,433,241,674
00389706,UNIVERSITY OF WISCONSIN-MARATHON        ,WI,54401-5396,Public       ,2,6,8,1021,552,1573
00389707,UNIVERSITY OF WISCONSIN-MARINETTE       ,WI,54143-4299,Public       ,3,8,11,306,258,564
00389708,UNIVERSITY OF WISCONSIN-MARSHFIELD      ,WI,54449-3310,Public       ,0,3,3,371,247,618
00389709,UNIVERSITY OF WISCONSIN-RICHLAND        ,WI,53581-1399,Public       ,2,0,2,366,154,520
00389710,UNIVERSITY OF WISCONSIN COLLEGES - ROCK ,WI,53546-5699,Public       ,2,10,12,941,713,1654
00389711,UNIVERSITY OF WISCONSIN-SHEBOYGAN       ,WI,53081-4789,Public       ,1,3,4,623,458,1081
00389712,UNIVERSITY OF WISCONSIN-WASHINGTON      ,WI,53095-3699,Public       ,1,4,5,638,399,1037
00389713,UNIVERSITY OF WISCONSIN-WAUKESHA        ,WI,53188-2799,Public       ,5,16,21,1606,801,2407
00389900,UNIVERSITY OF WISCONSIN-GREEN BAY       ,WI,54311-7001,Public       ,6,30,36,5324,3137,8461
00391100,VITERBO UNIVERSITY                      ,WI,54601-4777,Private      ,4,32,36,2010,1501,3511
00391500,UNIVERSITY OF WISCONSIN-STOUT           ,WI,54751-0790,Public       ,13,25,38,6773,2577,9350
00391700,UNIVERSITY OF WISCONSIN-EAU CLAIRE      ,WI,54702-4004,Public       ,13,29,42,10124,2249,12373
00391900,UNIVERSITY OF WISCONSIN-LA CROSSE       ,WI,54601-3742,Public       ,15,14,29,9556,2025,11581
00392000,UNIVERSITY OF WISCONSIN-OSHKOSH         ,WI,54901-8604,Public       ,9,33,42,9821,4062,13883
00392100,UNIVERSITY OF WISCONSIN-PLATTEVILLE     ,WI,53818-3099,Public       ,9,33,42,7498,2059,9557
00392300,UNIVERSITY OF WISCONSIN-RIVER FALLS     ,WI,54022-5013,Public       ,11,24,35,5561,1699,7260
00392400,UNIVERSITY OF WISCONSIN-STEVENS POINT   ,WI,54481-3871,Public       ,8,16,24,8661,2323,10984
00392500,UNIVERSITY OF WISCONSIN-SUPERIOR        ,WI,54880-2898,Public       ,0,23,23,1935,1644,3579
00392600,UNIVERSITY OF WISCONSIN-WHITEWATER      ,WI,53190-1792,Public       ,31,38,69,10657,3131,13788
00400700,MADISON AREA TECHNICAL COLLEGE          ,WI,53704-2599,Public       ,24,83,107,5772,9882,15654
00501500,UNIVERSITY OF WISCONSIN-PARKSIDE        ,WI,53141-2000,Public       ,16,48,64,4238,2923,7161
00529400,WAUKESHA COUNTY TECHNICAL COLLEGE       ,WI,53072-4696,Public       ,5,42,47,1999,4212,6211
00530100,NORTHEAST WISCONSIN TECHNICAL COLLEGE   ,WI,54307-9042,Public       ,73,244,317,3225,6404,9629
00530400,CHIPPEWA VALLEY TECHNICAL COLLEGE       ,WI,54701-6162,Public       ,12,36,48,2689,4139,6828
00538000,MID-STATE TECHNICAL COLLEGE             ,WI,54494-5512,Public       ,9,30,39,1094,2267,3361
00538400,NICOLET AREA TECHNICAL COLLEGE          ,WI,54501-0000,Public       ,6,34,40,600,1126,1726
00538700,NORTHCENTRAL TECHNICAL COLLEGE          ,WI,54401-1899,Public       ,10,43,53,1491,3799,5290
00538900,GATEWAY TECHNICAL COLLEGE               ,WI,53144-1690,Public       ,27,80,107,3095,9552,12647
00539000,BLACKHAWK TECHNICAL COLLEGE             ,WI,53547-5009,Public       ,13,60,73,1241,3531,4772
00612601,ST LUKE'S MEDCL CTR SCHL RAD TECH       ,WI,53215-4330,Private      ,0,0,0,38,71,109
00663900,BELLIN COLLEGE                          ,WI,54305-0000,Private      ,3,4,7,310,302,612
00732934,ITT TECHNICAL INSTITUTE                 ,WI,53220-4612,Proprietary  ,43,220,263,607,2569,3176
00766900,SOUTHWEST WISCONSIN TECH COLLEGE        ,WI,53809-0000,Public       ,0,6,6,768,963,1731
00821700,PAUL MITCHELL THE SCHOOL GREEN BAY      ,WI,54324-0257,Proprietary  ,3,6,9,109,149,258
00869405,RASMUSSEN COLLEGE - WAUSAU              ,WI,54401-7804,Proprietary  ,3,17,20,186,1042,1228
00869414,RASMUSSEN COLLEGE - GREEN BAY           ,WI,54303-2349,Proprietary  ,6,28,34,187,1110,1297
00869419,RASMUSSEN COLLEGE - APPLETON            ,WI,54915-7305,Proprietary  ,6,20,26,124,714,838
00919400,LAKESHORE TECHNICAL COLLEGE             ,WI,53015-1412,Public       ,5,17,22,829,2058,2887
00925600,MORAINE PARK TECHNICAL COLLEGE          ,WI,54936-0000,Public       ,8,21,29,1180,3083,4263
00941900,STATE CLG OF BEAUTY CULT-WAUSAU         ,WI,54403-4667,Proprietary  ,1,1,2,52,86,138
00962100,HERZING UNIVERSITY                      ,WI,53718-4236,Proprietary  ,62,623,685,1494,12154,13648
00974400,FOX VALLEY TECHNICAL COLLEGE            ,WI,54913-0000,Public       ,41,212,253,3718,6913,10631
01091300,MADISON MEDIA INSTITUTE                 ,WI,53718-6787,Proprietary  ,22,29,51,770,704,1474
01148400,ADVANCED INSTITUTE OF HAIR DESIGN       ,WI,53225-0000,Proprietary  ,8,16,24,321,422,743
01182400,WISCONSIN INDIANHEAD TECH CLG WITC      ,WI,54871-9300,Public       ,11,58,69,1140,2946,4086
02077100,MILWAUKEE INST OF ART & DESIGN          ,WI,53202-0000,Private      ,2,5,7,1198,446,1644
02078000,SACRED HEART SCHOOL OF THEOLOGY         ,WI,53130-0000,Private      ,0,0,0,0,5,5
02136600,WISCONSIN LUTHERAN COLLEGE              ,WI,53226-0000,Private      ,1,8,9,1260,405,1665
02201803,KAPLAN COLLEGE - MILWAUKEE              ,WI,53212-3939,Proprietary  ,3,28,31,222,1125,1347
02239204,ANTHEM COLLEGE - BROOKFIELD             ,WI,53005-4207,Proprietary  ,11,47,58,38,139,177
02271300,WI SCH OF PROFESSIONAL PSYCHOLOGY       ,WI,53225-0000,Private      ,0,3,3,36,227,263
02317200,MARANATHA BAPTIST BIBLE COLLEGE         ,WI,53094-0000,Private      ,1,4,5,908,174,1082
02324700,EMPIRE BEAUTY SCHOOL                    ,WI,53717-0000,Proprietary  ,5,13,18,93,248,341
02332100,EMPIRE BEAUTY SCHOOL                    ,WI,54220-0000,Proprietary  ,7,19,26,111,326,437
02332101,EMPIRE BEAUTY SCHOOL - APPLETON         ,WI,54914-4644,Proprietary  ,0,3,3,35,71,106
02453500,MEDICAL COLLEGE OF WISCONSIN            ,WI,53226-0000,Private      ,0,11,11,112,1361,1473
02494300,GILL-TECH ACADEMY OF HAIR DESIGN        ,WI,54911-0000,Proprietary  ,3,9,12,90,94,184
02532200,LAC COURTE OREILLES OJIBWA CMTY CLG     ,WI,54843-0000,Public       ,0,1,1,96,528,624
03007400,LAKESIDE SCHOOL OF MASSAGE THERAPY      ,WI,53212-0000,Private      ,0,0,0,20,50,70
03061200,MIDWEST COLLEGE OF ORIENTAL MEDICINE    ,WI,53403-9747,Proprietary  ,1,1,2,32,318,350
03077600,EMPIRE BEAUTY SCHOOL                    ,WI,54304-4838,Proprietary  ,4,17,21,161,385,546
03125100,COLLEGE OF MENOMINEE NATION             ,WI,54135-0000,Private      ,1,9,10,147,598,745
03125102,COLLEGE OF  THE MENOMINEE NATION - GREEN,WI,54304-4964,Private      ,0,5,5,61,302,363
03220300,"SALON PROFESSIONAL ACADEMY, THE         ",WI,54701-7633,Proprietary  ,1,1,2,79,135,214
03309300,MONTESSORI INSTITUTE OF MILWAUKEE       ,WI,53207-0000,Private      ,0,0,0,8,58,66
03808300,INSTITUTE OF BEAUTY AND WELLNESS (THE)  ,WI,53202-5715,Proprietary  ,3,11,14,185,329,514
03822300,PAUL MITCHELL THE SCHOOL - MONROE       ,WI,53566-0000,Proprietary  ,4,4,8,33,67,100
03872500,NORTHLAND INTERNATIONAL UNIVERSITY      ,WI,54119-9285,Private      ,0,0,0,498,82,580
03925300,BLUE SKY SCHOOL OF PROFESSIONAL MASSAGE ,WI,53024-9699,Private      ,0,8,8,35,175,210
03925301,BLUE SKY SCHOOL OF PROFESSIONAL MASSAGE ,WI,54115-7407,Private      ,0,0,0,4,18,22
03925303,BLUE SKY SCHOOL OF PROFESSIONAL MASSAGE ,WI,53713-2366,Private      ,0,0,0,5,36,41
04117400,MILWAUKEE CAREER COLLEGE                ,WI,53222-4305,Proprietary  ,11,26,37,232,661,893
04118600,ACADEMY OF COSMETOLOGY                  ,WI,53548-3307,Proprietary  ,2,8,10,51,154,205
04124800,VISIONS IN HAIR DESIGN INSTITUTE OF COSM,WI,53210-1120,Proprietary  ,0,0,0,39,114,153
04132600,WISCONSIN ACADEMY (THE)                 ,WI,54157-1726,Proprietary  ,0,0,0,15,39,54
04137900,BRENSTEN EDUCATION                      ,WI,53186-0000,Proprietary  ,3,28,31,82,567,649
04138200,SALON PROFESSIONAL ACADEMY (THE)        ,WI,54914-3921,Proprietary  ,1,1,2,64,77,141
04157700,SALON PROFESSIONAL ACADEMY (THE)        ,WI,54650-8699,Proprietary  ,3,3,6,63,102,165
04159400,COLUMBIA COLLEGE OF NURSING             ,WI,53211-2952,Private      ,0,7,7,157,389,546
04165300,ACADEMY WAUKESHA (THE)                  ,WI,53072-5524,Proprietary  ,0,7,7,115,199,314
04179200,ADVANCED COLLEGE OF COSMETOLOGY         ,WI,53963-0000,Proprietary  ,0,0,0,38,37,75
04182100,FIRST CLASS COSMETOLOGY SCHOOL          ,WI,52511-0000,Proprietary  ,4,12,16,61,153,214
04183600,SALON PROFESSIONAL ACADEMY OF KENOSHA (T,WI,53142-4950,Proprietary  ,9,10,19,127,228,355
04193800,SHEPHERDS COLLEGE                       ,WI,53182-1527,Private      ,0,0,0,20,13,33
04202800,PANACHE ACADEMY OF BEAUTY               ,WI,53913-2596,Proprietary  ,0,5,5,34,70,104
00290500,NORTH CAROLINA A&T STATE UNIV           ,NC,27411-0001,Public       ,64,97,161,16406,8859,25265
00290600,APPALACHIAN STATE UNIVERSITY            ,NC,28608-2059,Public       ,37,68,105,18603,5448,24051
00290700,UNIVERSITY OF NC AT ASHEVILLE           ,NC,28804-3299,Public       ,5,16,21,4854,2515,7369
00290800,BARTON COLLEGE                          ,NC,27893-3104,Private      ,3,7,10,1805,1122,2927
00291000,BELMONT ABBEY COLLEGE                   ,NC,28012-1802,Private      ,3,23,26,1492,1557,3049
00291100,BENNETT COLLEGE                         ,NC,27401-3239,Private      ,5,6,11,1525,746,2271
00291200,BREVARD COLLEGE                         ,NC,28712-3306,Private      ,4,1,5,1139,251,1390
00291300,CAMPBELL UNIVERSITY                     ,NC,27506-0036,Private      ,13,91,104,6659,4541,11200
00291400,CATAWBA COLLEGE                         ,NC,28144-2488,Private      ,3,9,12,2076,890,2966
00291500,CENTRAL PIEDMONT COMMUNITY COLLEGE      ,NC,28204-2297,Public       ,149,599,748,11418,23504,34922
00291600,CHOWAN UNIVERSITY                       ,NC,27855-1850,Private      ,7,11,18,2492,523,3015
00291700,COLLEGE OF THE ALBEMARLE                ,NC,27909-2327,Public       ,7,37,44,1150,2167,3317
00291800,DAVIDSON COLLEGE                        ,NC,28035-7157,Private      ,4,8,12,3658,291,3949
00291900,DAVIDSON COUNTY COMMUNITY COLLEGE       ,NC,27293-0000,Public       ,24,101,125,2066,5475,7541
00292000,DUKE UNIVERSITY                         ,NC,27708-0397,Private      ,14,14,28,20196,1925,22121
00292001,DUKE UNIV - SCHOOL OF MEDICINE          ,NC,27710-0000,Private      ,3,4,7,311,1331,1642
00292002,DUKE UNIV - SCHOOL OF LAW               ,NC,27708-0000,Private      ,0,2,2,92,2485,2577
00292003,DUKE UNIV - GRAD SCH ARTS & SCIENCE     ,NC,27708-0000,Private      ,1,12,13,176,1000,1176
00292004,DUKE UNIV - FUQUA SCH OF BUSINESS       ,NC,27708-0000,Private      ,2,13,15,97,1470,1567
00292005,DUKE UNIV/NICHOLAS SCH OF ENVIRON.      ,NC,27708-0000,Private      ,1,0,1,46,459,505
00292006,DUKE UNIV - DIVINITY SCHOOL             ,NC,27708-0000,Private      ,0,14,14,291,943,1234
00292007,DUKE UNIV - SCHOOL OF NURSING           ,NC,27710-0000,Private      ,3,9,12,269,1493,1762
00292010,DUKE UNIVERSITY - SCHOOL OF PUBLIC POLIC,NC,27708-0239,Private      ,1,1,2,46,342,388
00292300,EAST CAROLINA UNIVERSITY                ,NC,27858-1818,Public       ,73,266,339,25187,14909,40096
00292600,ELIZABETH CITY STATE UNIVERSITY         ,NC,27909-7806,Public       ,13,23,36,4623,2040,6663
00292700,ELON UNIVERSITY                         ,NC,27244-2010,Private      ,4,24,28,8096,1526,9622
00292800,FAYETTEVILLE STATE UNIVERSITY           ,NC,28301-4298,Public       ,17,142,159,6026,9178,15204
00292900,GARDNER-WEBB UNIVERSITY                 ,NC,28017-0000,Private      ,6,70,76,3536,4570,8106
00293000,GREENSBORO COLLEGE                      ,NC,27401-1875,Private      ,7,30,37,2038,1705,3743
00293100,GUILFORD COLLEGE                        ,NC,27410-4171,Private      ,10,60,70,3601,4099,7700
00293300,HIGH POINT UNIVERSITY                   ,NC,27262-4221,Private      ,23,19,42,6262,1260,7522
00293400,ISOTHERMAL COMMUNITY COLLEGE            ,NC,28160-0804,Public       ,10,27,37,1083,2270,3353
00293500,LAUREL UNIVERSITY                       ,NC,27265-3197,Private      ,1,13,14,70,383,453
00293600,JOHNSON C SMITH UNIVERSITY              ,NC,28216-5398,Private      ,14,37,51,3818,2463,6281
00293700,KING'S COLLEGE-CHARLOTTE                ,NC,28204-2435,Proprietary  ,5,22,27,994,1269,2263
00293900,LEES MCRAE COLLEGE                      ,NC,28604-0000,Private      ,2,4,6,1152,364,1516
00294000,LENOIR COMMUNITY COLLEGE                ,NC,28502-0188,Public       ,17,99,116,1242,3174,4416
00294100,LENOIR-RHYNE UNIVERSITY                 ,NC,28603-0000,Private      ,2,18,20,3318,1459,4777
00294200,LIVINGSTONE COLLEGE                     ,NC,28144-5298,Private      ,8,7,15,1671,685,2356
00294300,LOUISBURG COLLEGE                       ,NC,27549-2398,Private      ,23,6,29,1549,336,1885
00294400,MARS HILL COLLEGE                       ,NC,28754-0000,Private      ,5,6,11,2431,575,3006
00294500,MEREDITH COLLEGE                        ,NC,27607-5298,Private      ,5,15,20,2255,1332,3587
00294600,METHODIST UNIVERSITY                    ,NC,28311-1420,Private      ,9,59,68,3148,2611,5759
00294700,MITCHELL COMMUNITY COLLEGE              ,NC,28677-5264,Public       ,23,64,87,1610,3256,4866
00294800,MONTREAT COLLEGE                        ,NC,28757-1267,Private      ,2,42,44,692,745,1437
00294900,MOUNT OLIVE COLLEGE                     ,NC,28365-1299,Private      ,11,155,166,1543,4966,6509
00295000,NORTH CAROLINA CENTRAL UNIVERSITY       ,NC,27707-3198,Public       ,118,96,214,11658,9336,20994
00295100,NORTH CAROLINA WESLEYAN COLLEGE         ,NC,27804-8699,Private      ,8,32,40,1391,1757,3148
00295300,PEACE COLLEGE                           ,NC,27604-1194,Private      ,6,20,26,1239,931,2170
00295400,UNIV OF NORTH CAROLINA AT PEMBROKE      ,NC,28372-1510,Public       ,29,65,94,6813,5279,12092
00295500,PFEIFFER UNIVERSITY                     ,NC,28109-0000,Private      ,2,13,15,1136,1743,2879
00295600,PIEDMONT BAPTIST COLLEGE AND GRADUATE SC,NC,27101-5025,Private      ,0,3,3,203,277,480
00295700,QUEENS UNIVERSITY OF CHARLOTTE          ,NC,28274-0001,Private      ,8,56,64,2890,3125,6015
00295800,ROCKINGHAM COMMUNITY COLLEGE            ,NC,27375-0000,Public       ,6,41,47,1063,2077,3140
00296000,SALEM COLLEGE                           ,NC,27108-0000,Private      ,0,14,14,1032,1141,2173
00296100,SANDHILLS COMMUNITY COLLEGE             ,NC,28374-8283,Public       ,27,95,122,1990,4241,6231
00296200,SHAW UNIVERSITY                         ,NC,27601-2393,Private      ,25,36,61,3389,2935,6324
00296300,SOUTHEASTERN BAPTIST THEOL SEMINARY     ,NC,27588-0000,Private      ,0,1,1,0,1,1
00296400,SOUTHEASTERN COMMUNITY COLLEGE          ,NC,28472-5422,Public       ,12,64,76,897,1968,2865
00296800,ST AUGUSTINES COLLEGE                   ,NC,27610-2298,Private      ,14,17,31,2750,1446,4196
00297000,SURRY COMMUNITY COLLEGE                 ,NC,27017-0304,Public       ,9,49,58,1503,2431,3934
00297200,NORTH CAROLINA STATE UNIV-RALEIGH       ,NC,27695-7001,Public       ,69,161,230,29673,13494,43167
00297300,GASTON COLLEGE                          ,NC,28034-1499,Public       ,27,125,152,2632,6173,8805
00297400,UNIVERSITY OF N C-CHAPEL HILL           ,NC,27514-0000,Public       ,37,167,204,28555,15757,44312
00297500,UNIVERSITY OF NC AT CHARLOTTE           ,NC,28223-0001,Public       ,56,220,276,25795,17020,42815
00297600,UNIVERSITY OF N C - GREENSBORO          ,NC,27412-0001,Public       ,45,125,170,18758,13120,31878
00297800,WAKE FOREST UNIV - UNDERGRADUATE        ,NC,27109-7246,Private      ,3,5,8,8350,591,8941
00297801,WAKE FOREST UNIV - SCH OF MEDICINE      ,NC,27157-1090,Private      ,2,3,5,188,1228,1416
00297803,WAKE FOREST GRAD SCHOOLS OF BUSINESS    ,NC,27109-7659,Private      ,0,6,6,70,904,974
00297805,WAKE FOREST UNIV - SCH OF LAW           ,NC,27109-7206,Private      ,0,4,4,57,1660,1717
00297806,WAKE FOREST UNIV - GRAD A&S/DIVINITY    ,NC,27109-7246,Private      ,1,15,16,69,728,797
00297900,WARREN WILSON COLLEGE                   ,NC,28815-0000,Private      ,3,5,8,1284,586,1870
00298000,WAYNE COMMUNITY COLLEGE                 ,NC,27533-0000,Public       ,21,83,104,1660,3929,5589
00298100,WESTERN CAROLINA UNIVERSITY             ,NC,28723-9731,Public       ,69,71,140,10619,4833,15452
00298200,WESTERN PIEDMONT COMMUNITY COLLEGE      ,NC,28655-4504,Public       ,13,79,92,1309,2686,3995
00298300,WILKES COMMUNITY COLLEGE                ,NC,28697-2100,Public       ,15,67,82,1320,2015,3335
00298400,UNIVERSITY OF N C-WILMINGTON            ,NC,28403-3297,Public       ,38,87,125,16358,6859,23217
00298500,WINGATE UNIVERSITY                      ,NC,28174-0159,Private      ,5,22,27,3951,1274,5225
00298600,WINSTON-SALEM STATE UNIVERSITY          ,NC,27102-0000,Public       ,25,102,127,8849,6669,15518
00398100,UNC SCHOOL OF THE ARTS                  ,NC,27127-2188,Public       ,4,4,8,1565,616,2181
00403300,ASHEVILLE BUNCOMBE TECH CMTY CLG        ,NC,28801-4897,Public       ,31,185,216,2998,7480,10478
00406200,PITT COMMUNITY COLLEGE                  ,NC,28590-0000,Public       ,41,170,211,5141,8655,13796
00483500,CALDWELL COMMUNITY CLG & TECH INST      ,NC,28638-2626,Public       ,15,80,95,1981,3967,5948
00483800,GUILFORD TECHNICAL COMMUNITY CLG        ,NC,27282-0309,Public       ,65,257,322,8044,18200,26244
00484400,WAKE TECHNICAL COMMUNITY COLLEGE        ,NC,27603-5696,Public       ,105,385,490,9584,19151,28735
00484500,WILSON COMMUNITY COLLEGE                ,NC,27893-3310,Public       ,21,89,110,815,2640,3455
00499201,MILLER-MOTTE TECHNICAL COLLEGE - MILLER-,NC,27511-9209,Proprietary  ,6,42,48,173,939,1112
00499202,MILLER-MOTTE TECHNICAL COLLEGE - MILLER-,NC,27604-6072,Proprietary  ,20,61,81,540,2166,2706
00499203,MILLER-MOTTE TECHNICAL COLLEGE - FAYETTE,NC,28311-7651,Proprietary  ,9,84,93,507,2803,3310
00499205,MILLER-MOTTE TECHNICAL COLLEGE - MILLER-,NC,28540-5901,Proprietary  ,5,45,50,190,1414,1604
00531600,COASTAL CAROLINA COMMUNITY COLLEGE      ,NC,28546-6816,Public       ,13,214,227,1816,6235,8051
00531700,FORSYTH TECHNICAL COMMUNITY COLLEGE     ,NC,27103-5197,Public       ,39,205,244,4749,11917,16666
00531800,CATAWBA VALLEY COMMUNITY COLLEGE        ,NC,28602-8302,Public       ,20,72,92,2761,4903,7664
00532000,CAPE FEAR COMMUNITY COLLEGE             ,NC,28401-3910,Public       ,48,187,235,5252,8584,13836
00544700,RANDOLPH COMMUNITY COLLEGE              ,NC,27204-1009,Public       ,10,54,64,1303,3228,4531
00544800,DURHAM TECHNICAL CMNTY COLLEGE          ,NC,27703-5023,Public       ,22,126,148,2404,7688,10092
00544900,CENTRAL CAROLINA COMMUNITY COLLEGE      ,NC,27330-9000,Public       ,20,88,108,1757,5189,6946
00546300,ALAMANCE COMMUNITY COLLEGE              ,NC,27253-0000,Public       ,16,95,111,2047,4632,6679
00546400,RICHMOND COMMUNITY COLLEGE              ,NC,28345-4522,Public       ,16,65,81,945,2736,3681
00575400,ROWAN-CABARRUS COMMUNITY COLLEGE        ,NC,28146-8357,Public       ,22,171,193,2738,6846,9584
00647700,CABARRUS COLLEGE OF HEALTH SCIENCES     ,NC,28025-0000,Private      ,2,20,22,405,1175,1580
00647800,MERCY HOSP SCH OF NURSING               ,NC,28207-0000,Public       ,1,25,26,289,1268,1557
00648300,WATTS SCHOOL OF NURSING                 ,NC,27704-0000,Private      ,2,5,7,118,507,625
00679900,CRAVEN COMMUNITY COLLEGE                ,NC,28562-0000,Public       ,8,102,110,1104,4170,5274
00703100,PAMLICO COMMUNITY COLLEGE               ,NC,28529-0000,Public       ,3,17,20,109,437,546
00764000,FAYETTEVILLE TECHNICAL CMTY COLLEGE     ,NC,28303-0236,Public       ,52,416,468,4696,18497,23193
00768700,JAMES SPRUNT COMMUNITY COLLEGE          ,NC,28349-0398,Public       ,7,18,25,548,1714,2262
00781400,BROOKSTONE COLLEGE OF BUSINESS          ,NC,28262-1294,Proprietary  ,2,23,25,152,756,908
00781401,BROOKSTONE COLLEGE OF BUSINESS          ,NC,27409-0000,Proprietary  ,3,21,24,127,603,730
00789200,SAMPSON COMMUNITY COLLEGE               ,NC,28328-0000,Public       ,6,21,27,625,1640,2265
00798500,SOUTH PIEDMONT COMMUNITY COLLEGE        ,NC,28135-9703,Public       ,13,53,66,1047,2614,3661
00798600,HALIFAX COMMUNITY COLLEGE               ,NC,27890-0089,Public       ,8,21,29,710,1733,2443
00798700,BLADEN COMMUNITY COLLEGE                ,NC,28332-0266,Public       ,11,43,54,708,2105,2813
00798800,MARTIN COMMUNITY COLLEGE                ,NC,27892-8307,Public       ,4,6,10,377,923,1300
00808100,CARTERET COMMUNITY COLLEGE              ,NC,28557-2989,Public       ,13,34,47,742,2052,2794
00808200,CLEVELAND COMMUNITY COLLEGE             ,NC,28150-0000,Public       ,7,88,95,1224,3278,4502
00808300,HAYWOOD COMMUNITY COLLEGE               ,NC,28721-0000,Public       ,14,62,76,734,1905,2639
00808500,MCDOWELL TECHNICAL COMMUNITY CLG        ,NC,28752-8728,Public       ,7,41,48,438,1232,1670
00808700,MONTGOMERY COMMUNITY COLLEGE            ,NC,27371-0787,Public       ,2,17,19,366,925,1291
00846600,SOUTHWESTERN COMMUNITY COLLEGE          ,NC,28779-8581,Public       ,15,41,56,1053,2071,3124
00855700,NASH COMMUNITY COLLEGE                  ,NC,27804-0488,Public       ,20,121,141,1491,3858,5349
00855800,BEAUFORT COUNTY COMMUNITY COLLEGE       ,NC,27889-7889,Public       ,14,39,53,771,2259,3030
00861200,ROBESON COMMUNITY COLLEGE               ,NC,28359-2151,Public       ,16,77,93,1435,4100,5535
00861300,ROANOKE-CHOWAN COMMUNITY COLLEGE        ,NC,27910-9522,Public       ,4,17,21,387,993,1380
00885500,EDGECOMBE COMMUNITY COLLEGE             ,NC,27886-9399,Public       ,18,114,132,1000,4089,5089
00902500,EMPIRE BEAUTY SCHOOL                    ,NC,28105-2508,Proprietary  ,11,32,43,251,718,969
00933600,JOHNSTON COMMUNITY COLLEGE              ,NC,27577-0000,Public       ,8,42,50,1880,4423,6303
00943000,TRI-COUNTY COMMUNITY COLLEGE            ,NC,28906-7919,Public       ,13,30,43,444,1109,1553
00964600,PIEDMONT COMMUNITY COLLEGE              ,NC,27573-1197,Public       ,9,47,56,604,1631,2235
00968400,BLUE RIDGE COMMUNITY COLLEGE            ,NC,28731-9624,Public       ,11,46,57,880,1920,2800
00974701,GORDON-CONWELL THEO SEM - CHARLOTTE     ,NC,28273-0000,Private      ,0,7,7,13,387,400
00990300,VANCE-GRANVILLE CMTY COLLEGE            ,NC,27536-0917,Public       ,17,101,118,1490,3932,5422
01026400,SOUTH COLLEGE                           ,NC,28803-3152,Proprietary  ,5,39,44,153,906,1059
01119400,STANLY COMMUNITY COLLEGE                ,NC,28001-7458,Public       ,12,44,56,1064,2962,4026
01119700,MAYLAND COMMUNITY COLLEGE               ,NC,28777-2777,Public       ,2,12,14,507,827,1334
01179900,PAUL MITCHELL THE SCHOOL FAYETTEVILLE   ,NC,28303-5364,Proprietary  ,9,36,45,296,842,1138
01192600,LEON'S BEAUTY SCHOOL                    ,NC,27403-2812,Proprietary  ,4,11,15,201,521,722
01303918,SOUTH UNIVERSITY - THE ART INSTITUTE OF ,NC,28217-4536,Proprietary  ,13,54,67,3195,2882,6077
02056500,MITCHELL'S HAIR STYLING ACADEMY         ,NC,27893-0000,Proprietary  ,2,2,4,40,135,175
02056501,MITCHELL'S HAIR STYLING ACADEMY - MITCHE,NC,27606-3326,Proprietary  ,0,9,9,118,398,516
02158414,HARRISON COLLEGE - THE CHEF'S ACADEMY - ,NC,27560-0000,Proprietary  ,2,17,19,101,270,371
02170700,BRUNSWICK COMMUNITY COLLEGE             ,NC,28422-0000,Public       ,7,26,33,761,1456,2217
02205000,COLLEGE OF WILMINGTON                   ,NC,28403-0000,Proprietary  ,12,33,45,241,616,857
02210400,FAYETTEVILLE BEAUTY COLLEGE             ,NC,28303-0000,Proprietary  ,0,9,9,138,527,665
02227800,MITCHELL'S HAIR STYLING ACADEMY         ,NC,27534-0000,Proprietary  ,0,4,4,36,109,145
02227900,MITCHELL'S HAIR STYLING ACADEMY         ,NC,27858-0000,Proprietary  ,0,2,2,59,145,204
02280900,MID-ATLANTIC CHRISTIAN UNIVERSITY       ,NC,27909-0000,Private      ,1,3,4,176,186,362
02326203,KAPLAN CAREER INSTITUTE - KAPLAN COLLEGE,NC,28212-6830,Proprietary  ,15,127,142,393,2440,2833
02558900,CHEVEUX SCHOOL OF HAIR DESIGN           ,NC,28540-0000,Proprietary  ,1,3,4,15,118,133
02560600,PINNACLE INSTITUTE OF COSMETOLOGY       ,NC,28115-8020,Proprietary  ,3,5,8,70,115,185
02614201,MILLER-MOTTE BUSINESS COLLEGE           ,NC,28403-0000,Proprietary  ,27,217,244,567,4190,4757
02614205,MILLER - MOTTE TECHNICAL COLLEGE - MILLE,NC,27834-5052,Proprietary  ,12,60,72,377,1449,1826
03009500,WINSTON-SALEM BARBER SCHOOL             ,NC,27107-0000,Proprietary  ,0,12,12,90,262,352
03064400,REGENCY BEAUTY INSTITUTE                ,NC,27127-0000,Proprietary  ,8,17,25,152,421,573
03089300,HERITAGE BIBLE COLLEGE                  ,NC,28335-0000,Private      ,0,0,0,31,101,132
03104200,CAROLINAS COLLEGE OF HEALTH SCIENCE     ,NC,28232-2861,Public       ,10,38,48,535,2037,2572
03109000,LIVING ARTS COLLEGE                     ,NC,27614-7076,Proprietary  ,21,27,48,707,953,1660
03361300,MEDICAL ARTS MASSAGE SCHOOL             ,NC,27616-6453,Proprietary  ,4,19,23,90,545,635
03513400,APEX SCHOOL OF THEOLOGY                 ,NC,27703-8024,Private      ,0,5,5,32,1116,1148
03555300,SOUTHEASTERN INSTITUTE                  ,NC,28217-0000,Proprietary  ,4,29,33,185,963,1148
03555400,SOUTHEASTERN SCHOOL OF NEUROMUSCULAR  MA,NC,29406-0000,Proprietary  ,6,18,24,67,259,326
03570300,CAROLINA CHRISTIAN COLLEGE              ,NC,27105-3241,Private      ,0,5,5,46,233,279
03663300,HOOD THEOLOGICAL SEMINARY               ,NC,28144-5768,Private      ,0,1,1,5,268,273
03748500,LA SHE'S BEAUTY ACADEMY                 ,NC,27707-3569,Proprietary  ,2,16,18,51,235,286
03777300,PAUL MITCHELL THE SCHOOL GASTONIA       ,NC,28054-0460,Proprietary  ,6,26,32,234,522,756
03827300,NEW LIFE THEOLOGICAL SEMINARY           ,NC,28205-1648,Private      ,1,7,8,16,360,376
04073300,JUNG TAO SCHOOL OF CLASSICAL CHINESE MED,NC,28679-9657,Private      ,0,0,0,1,69,70
04098300,TECHSKILLS - CHARLOTTE                  ,NC,28217-0000,Proprietary  ,0,0,0,82,355,437
04101300,CAROLINA SCHOOL OF BROADCASTING         ,NC,28214-8085,Proprietary  ,1,13,14,160,538,698
04115700,REGINA'S COLLEGE OF BEAUTY              ,NC,28110-2831,Proprietary  ,9,27,36,60,341,401
04120300,HEALTH AND STYLE INSTITUTE              ,NC,27265-3114,Proprietary  ,4,35,39,41,275,316
04129400,CENTER FOR MASSAGE & NATURAL HEALTH     ,NC,28787-8331,Proprietary  ,1,11,12,26,154,180
04140700,AVEDA INSTITUTE CHAPEL HILL             ,NC,27516-2559,Proprietary  ,2,13,15,205,373,578
04143500,CHARLOTTE SCHOOL OF LAW                 ,NC,28208-2816,Proprietary  ,0,17,17,99,3020,3119
04146400,DAOIST TRADITIONS COLLEGE OF CHINESE MED,NC,28801-1060,Proprietary  ,0,1,1,8,164,172
04149300,PARK WEST BARBER SCHOOL                 ,NC,27701-4022,Proprietary  ,12,53,65,189,862,1051
04154200,CAROLINA COLLEGE OF BIBLICAL STUDIES    ,NC,29303-5157,Private      ,1,8,9,37,354,391
04172800,BODY THERAPY INSTITUTE                  ,NC,27344-6728,Proprietary  ,0,0,0,24,152,176
04173000,SHEPHERDS THEOLOGICAL SEMINARY          ,NC,27518-9316,Private      ,0,0,0,3,44,47
04173700,GRACE COLLEGE OF DIVINITY               ,NC,28314-2343,Private      ,0,3,3,39,161,200
04178100,CAROLINA COLLEGE OF HAIR DESIGN         ,NC,28802-1232,Proprietary  ,0,4,4,64,186,250
04204700,PAUL MITCHELL THE SCHOOL RALEIGH        ,NC,27612-7358,Proprietary  ,14,14,28,166,305,471
04206500,MYCOMPUTERCAREER.COM                    ,NC,27606-3365,Proprietary  ,11,230,241,46,836,882
04214600,GRACE COLLEGE OF BARBERING              ,NC,28513-7178,Private      ,1,17,18,3,30,33
00298800,BISMARCK STATE COLLEGE                  ,ND,58501-1299,Public       ,14,38,52,2068,1883,3951
00298900,DICKINSON STATE UNIVERSITY              ,ND,58601-4896,Public       ,3,7,10,1055,721,1776
00299000,JAMESTOWN COLLEGE                       ,ND,58405-3401,Private      ,3,3,6,1043,183,1226
00299100,LAKE REGION STATE COLLEGE               ,ND,58301-1598,Public       ,1,20,21,477,548,1025
00299200,UNIVERSITY OF MARY                      ,ND,58504-9652,Private      ,1,55,56,1708,2048,3756
00299300,MAYVILLE STATE UNIVERSITY               ,ND,58257-1299,Public       ,2,16,18,725,363,1088
00299400,MINOT STATE UNIVERSITY                  ,ND,58707-0001,Public       ,7,40,47,1709,1604,3313
00299500,DAKOTA COLLEGE AT BOTTINEAU             ,ND,58318-1159,Public       ,3,12,15,299,300,599
00299600,NORTH DAKOTA STATE CLG OF SCIENCE       ,ND,58076-0002,Public       ,18,14,32,1799,983,2782
00299700,NORTH DAKOTA STATE UNIVERSITY           ,ND,58108-6050,Public       ,21,46,67,10613,3649,14262
00300500,UNIVERSITY OF NORTH DAKOTA              ,ND,58202-8193,Public       ,27,96,123,9317,6241,15558
00300700,WILLISTON STATE COLLEGE                 ,ND,58802-1326,Public       ,1,10,11,343,441,784
00300800,VALLEY CITY STATE UNIVERSITY            ,ND,58072-0000,Public       ,2,20,22,817,459,1276
00775600,JOSEF'S SCHOOL OF HAIR DESIGN INC       ,ND,58102-4977,Proprietary  ,1,4,5,70,126,196
00869408,RASMUSSEN COLLEGE - FARGO               ,ND,58103-7196,Proprietary  ,5,27,32,213,1013,1226
00869415,RASMUSSEN COLLEGE - BISMARCK            ,ND,58503-0000,Proprietary  ,2,21,23,72,434,506
00935400,MEDCENTER ONE COLLEGE OF NURSING        ,ND,58501-4494,Private      ,1,1,2,112,105,217
01040600,JOSEF'S SCHOOL OF HAIR DESIGN           ,ND,58201-6394,Proprietary  ,0,3,3,70,116,186
01205900,TRINITY BIBLE COLLEGE                   ,ND,58436-7150,Private      ,1,2,3,190,106,296
01229500,JZ TREND ACADEMY PAUL MITCHELL PARTNER S,ND,58501-0000,Proprietary  ,1,3,4,69,77,146
02188200,SITTING BULL COLLEGE                    ,ND,58538-9701,Public       ,0,8,8,90,402,492
02236500,LITTLE HOOP COMMUNITY COLLEGE           ,ND,58335-0000,Public       ,4,16,20,53,305,358
02242900,UNITED TRIBES TECHNICAL COLLEGE         ,ND,58504-0000,Private      ,4,21,25,280,940,1220
02298200,HEADQUARTERS ACADEMY OF HAIR DESIGN     ,ND,58701-0000,Proprietary  ,1,3,4,20,78,98
02301100,TURTLE MTN CMNTY COLG-FIN AID OFC       ,ND,58316-0000,Private      ,11,29,40,275,600,875
02553700,FORT BERTHOLD COMMUNITY COLLEGE         ,ND,58763-0000,Public       ,2,4,6,60,217,277
03087200,MOLER BARBER CLG OF HAIRSTYLING         ,ND,58103-0000,Proprietary  ,0,2,2,6,30,36
04031300,SALON PROFESSIONAL ACADEMY (THE)        ,ND,58103-3337,Proprietary  ,0,2,2,91,115,206
04139400,HAIR ACADEMY (THE)                      ,ND,58501-4929,Proprietary  ,1,0,1,50,51,101
00301005,ANTIOCH UNIV/SEATTLE                    ,WA,98121-0000,Private      ,0,8,8,161,1702,1863
00376900,BELLEVUE COLLEGE                        ,WA,98007-6484,Public       ,39,142,181,6434,9929,16363
00377000,BIG BEND COMMUNITY COLLEGE              ,WA,98837-3299,Public       ,4,28,32,1268,2232,3500
00377100,"CENTRAL WASHINGTON UNIV., FIN AID       ",WA,98926-7495,Public       ,39,116,155,13698,7076,20774
00377200,CENTRALIA COLLEGE                       ,WA,98531-4099,Public       ,4,25,29,1448,2892,4340
00377300,CLARK COLLEGE                           ,WA,98663-3598,Public       ,35,137,172,6487,13045,19532
00377400,COLUMBIA BASIN COLLEGE                  ,WA,99301-3379,Public       ,41,113,154,3908,5838,9746
00377500,EASTERN WASHINGTON UNIVERSITY           ,WA,99004-2447,Public       ,22,77,99,13777,8790,22567
00377600,EVERETT COMMUNITY COLLEGE               ,WA,98201-1352,Public       ,23,103,126,4129,8737,12866
00377700,HERITAGE UNIVERSITY                     ,WA,98948-9562,Private      ,2,13,15,748,1892,2640
00377800,GONZAGA UNIVERSITY                      ,WA,99258-0083,Private      ,13,81,94,9292,5090,14382
00377900,GRAYS HARBOR COLLEGE                    ,WA,98520-7599,Public       ,5,24,29,896,2195,3091
00378000,GREEN RIVER COMMUNITY COLLEGE           ,WA,98092-3622,Public       ,58,174,232,4315,7625,11940
00378100,HIGHLINE COMMUNITY COLLEGE              ,WA,98198-9800,Public       ,44,156,200,4390,8225,12615
00378200,LOWER COLUMBIA COLLEGE                  ,WA,98632-0310,Public       ,13,43,56,1519,4176,5695
00378300,NORTHWEST UNIVERSITY                    ,WA,98083-0000,Private      ,3,17,20,1623,1358,2981
00378400,OLYMPIC COLLEGE                         ,WA,98337-1600,Public       ,14,84,98,2693,7416,10109
00378500,PACIFIC LUTHERAN UNIVERSITY             ,WA,98447-0003,Private      ,9,26,35,5691,2891,8582
00378600,PENINSULA COLLEGE                       ,WA,98362-6660,Public       ,6,31,37,792,2362,3154
00378700,SEATTLE CENTRAL COMMUNITY COLLEGE       ,WA,98122-2413,Public       ,31,203,234,4589,10298,14887
00378703,SEATTLE VOCATIONAL INSTITUTE            ,WA,98144-0000,Public       ,13,57,70,265,1255,1520
00378800,SEATTLE PACIFIC UNIVERSITY              ,WA,98119-1997,Private      ,11,30,41,8498,3767,12265
00379000,SEATTLE UNIVERSITY                      ,WA,98122-1090,Private      ,14,67,81,10907,8369,19276
00379100,SHORELINE COMMUNITY COLLEGE             ,WA,98133-5696,Public       ,27,96,123,3256,6678,9934
00379200,SKAGIT VALLEY COLLEGE                   ,WA,98273-5899,Public       ,10,49,59,2170,4377,6547
00379300,SPOKANE COMMUNITY COLLEGE               ,WA,99207-5399,Public       ,20,128,148,5485,13526,19011
00379400,ST MARTIN'S UNIVERSITY                  ,WA,98503-7500,Private      ,2,19,21,1750,1551,3301
00379600,TACOMA COMMUNITY COLLEGE                ,WA,98466-6100,Public       ,54,223,277,5211,13719,18930
00379700,UNIVERSITY OF PUGET SOUND               ,WA,98416-1039,Private      ,4,32,36,5882,2610,8492
00379800,UNIVERSITY OF WASHINGTON                ,WA,98195-5880,Public       ,86,215,301,38476,34316,72792
00379900,WALLA WALLA UNIVERSITY                  ,WA,99324-1198,Private      ,8,9,17,2073,942,3015
00380000,WASHINGTON STATE UNIVERSITY             ,WA,99164-1035,Public       ,44,147,191,28840,16126,44966
00380100,WENATCHEE VALLEY COLLEGE                ,WA,98801-1799,Public       ,14,63,77,2087,3606,5693
00380200,WESTERN WASHINGTON UNIVERSITY           ,WA,98225-5946,Public       ,32,49,81,19896,6056,25952
00380300,WHITMAN COLLEGE                         ,WA,99362-2067,Private      ,2,1,3,2981,220,3201
00380400,WHITWORTH UNIVERSITY                    ,WA,99251-0001,Private      ,3,26,29,5399,1924,7323
00380500,YAKIMA VALLEY COMMUNITY COLLEGE         ,WA,98907-2520,Public       ,18,69,87,3738,5871,9609
00499900,BELLINGHAM TECHNICAL COLLEGE            ,WA,98225-0000,Public       ,5,44,49,1357,3901,5258
00500000,PIERCE COLLEGE                          ,WA,98498-1919,Public       ,28,225,253,4479,11068,15547
00500100,EDMONDS COMMUNITY COLLEGE               ,WA,98036-5999,Public       ,24,66,90,3392,6994,10386
00500600,WALLA WALLA COMMUNITY COLLEGE           ,WA,99362-9267,Public       ,21,75,96,2146,3468,5614
00530600,BATES TECHNICAL COLLEGE                 ,WA,98405-0000,Public       ,18,139,157,1539,5798,7337
00537200,SOUTH PUGET SOUND COMMUNITY COLLEGE     ,WA,98512-6292,Public       ,9,59,68,2822,6694,9516
00537300,LAKE WASHINGTON TECHNICAL COLLEGE       ,WA,98034-8505,Public       ,10,39,49,1153,3760,4913
00575200,CLOVER PARK TECHNICAL COLLEGE           ,WA,98499-0000,Public       ,18,100,118,1992,7890,9882
00815500,EVERGREEN STATE COLLEGE (THE)           ,WA,98505-0002,Public       ,10,36,46,4426,5211,9637
00907901,EVEREST COLLEGE                         ,WA,98684-6950,Proprietary  ,7,31,38,291,1069,1360
00938700,PERRY TECHNICAL INSTITUTE               ,WA,98903-1239,Private      ,27,34,61,937,1399,2336
00954400,SPOKANE FALLS COMMUNITY COLLEGE         ,WA,99224-5204,Public       ,17,90,107,5555,9565,15120
00970400,NORTH SEATTLE COMMUNITY COLLEGE         ,WA,98103-3599,Public       ,31,144,175,2621,7531,10152
00970600,SOUTH SEATTLE COMMUNITY COLLEGE         ,WA,98106-1499,Public       ,20,115,135,2995,6594,9589
00973900,GLEN DOW ACAD OF HAIR DESIGN            ,WA,99201-0209,Proprietary  ,7,17,24,180,389,569
01036400,WHATCOM COMMUNITY COLLEGE               ,WA,98226-8003,Public       ,9,31,40,2803,4482,7285
01043400,RENTON TECHNICAL COLLEGE                ,WA,98056-0000,Public       ,19,69,88,1404,4542,5946
01148100,DIVERS INSTITUTE OF TECHNOLOGY          ,WA,98107-0000,Proprietary  ,10,31,41,239,766,1005
01231500,CORNISH COLLEGE OF THE ARTS             ,WA,98121-4604,Private      ,3,11,14,1863,704,2567
01249600,TONI & GUY HAIRDRESSING ACADEMY         ,WA,98133-5615,Proprietary  ,1,4,5,63,129,192
01302200,CITY UNIVERSITY OF SEATTLE              ,WA,98005-0000,Private      ,1,37,38,276,2595,2871
01309400,BELLINGHAM BEAUTY SCHOOL                ,WA,98225-0000,Proprietary  ,1,5,6,66,183,249
02105300,EVERGREEN BEAUTY AND BARBER COLLEGE     ,WA,98007-3722,Proprietary  ,5,14,19,125,368,493
02106700,TRINITY LUTHERAN COLLEGE                ,WA,98201-3569,Private      ,0,2,2,297,177,474
02180000,NORTHWEST INDIAN COLLEGE                ,WA,98226-9278,Public       ,3,15,18,271,1060,1331
02184200,PAROBA COLLEGE OF COSMETOLOGY           ,WA,98208-0000,Proprietary  ,2,8,10,80,261,341
02202200,STYLEMASTERS COLLEGE OF HAIR DESIGN     ,WA,98632-0000,Proprietary  ,5,13,18,60,217,277
02203300,GENE JUAREZ ACADEMY OF BEAUTY           ,WA,98125-0000,Proprietary  ,18,43,61,568,927,1495
02222900,INTERNATIONAL AIR & HOSPITALITY ACADEMY ,WA,98661-4835,Proprietary  ,12,44,56,494,965,1459
02236800,PROFESSIONAL BEAUTY SCHOOL              ,WA,98902-0000,Proprietary  ,3,0,3,64,143,207
02242500,BASTYR UNIVERSITY                       ,WA,98028-0000,Private      ,0,16,16,252,1788,2040
02291300,ART INSTITUTE OF SEATTLE                ,WA,98121-1622,Proprietary  ,13,54,67,3076,3222,6298
02300100,EVEREST COLLEGE                         ,WA,98367-1835,Proprietary  ,4,38,42,189,846,1035
02300103,EVEREST COLLEGE - EVERETT               ,WA,98208-2610,Proprietary  ,10,62,72,387,1363,1750
02300104,EVEREST COLLEGE - TACOMA                ,WA,98402-3004,Proprietary  ,22,153,175,719,2935,3654
02326500,INTERFACE COLLEGE                       ,WA,99201-4326,Proprietary  ,2,10,12,76,442,518
02331400,NORTHWEST HAIR ACADEMY                  ,WA,98273-0000,Proprietary  ,3,6,9,77,147,224
02331402,NORTHWEST HAIR ACADEMY - EVERETT        ,WA,98204-0000,Proprietary  ,5,6,11,71,173,244
02504900,ACADEMY OF HAIR DESIGN (THE)            ,WA,98801-0000,Proprietary  ,4,7,11,68,180,248
02541900,BJ'S BEAUTY AND BARBER COLLEGE          ,WA,98409-0000,Proprietary  ,4,18,22,117,509,626
02602100,NORTHWEST COLLEGE OF ART                ,WA,98370-8625,Proprietary  ,1,1,2,197,94,291
02606200,EVEREST COLLEGE                         ,WA,98055-2990,Proprietary  ,12,86,98,337,1271,1608
02617500,EVEREST COLLEGE                         ,WA,98133-9018,Proprietary  ,39,171,210,615,2017,2632
02617503,EVEREST COLLEGE - VANCOUVER             ,WA,98684-6951,Proprietary  ,0,0,0,108,398,506
03031406,INTERNATIONAL ACADEMY OF DESIGN & TECH  ,WA,98188-3319,Proprietary  ,4,36,40,352,734,1086
03065000,CLARE'S BEAUTY COLLEGE                  ,WA,99301-0000,Proprietary  ,4,4,8,111,218,329
03071800,ITT TECHNICAL INSTITUTE                 ,WA,99216-1589,Proprietary  ,34,204,238,661,2757,3418
03071805,ITT TECHNICAL INSTITUTE - SEATTLE       ,WA,98168-3346,Proprietary  ,24,197,221,759,2878,3637
03099000,CORTIVA INSTITUTE - SEATTLE             ,WA,98109-5474,Proprietary  ,5,25,30,146,593,739
03110800,BAKKE GRADUATE UNIVERSITY               ,WA,98104-1222,Private      ,0,1,1,15,80,95
03139500,MONTESSORI SCHOOLS OF WASHINGTON        ,WA,98203-6600,Private      ,0,0,0,8,43,51
03280300,SEATTLE INST OF ORIENTAL MEDICINE       ,WA,98115-0000,Proprietary  ,0,4,4,54,229,283
03283300,NORTHWEST HVAC/R ASSOCIATION & TRAINING ,WA,99202-0000,Private      ,1,3,4,34,189,223
03466400,SEATTLE SCHOOL OF THEOLOGY AND PSYCHOLOG,WA,98121-1177,Private      ,1,7,8,31,431,462
03483500,CASCADIA COMMUNITY COLLEGE              ,WA,98011-9510,Public       ,10,22,32,1646,2053,3699
03490400,EMIL FRIES PIANO HOSPITAL & TRAININ     ,WA,98661-4323,Private      ,0,0,0,15,57,72
03689400,FAITH EVANGELICAL COLLEGE & SEMINARY    ,WA,98407-2607,Private      ,0,11,11,35,471,506
03724300,DIGIPEN INSTITUTE OF TECHNOLOGY         ,WA,98052-5170,Proprietary  ,1,7,8,1134,626,1760
03917300,EVERGREEN BEAUTY AND BARBER COLLEGE     ,WA,98208-3759,Proprietary  ,10,26,36,141,431,572
03932500,TOTAL COSMETOLOGY TRAINING CENTER       ,WA,99217-6231,Proprietary  ,7,15,22,111,399,510
03953300,YAKIMA BEAUTY SCHOOL                    ,WA,98901-2202,Proprietary  ,1,1,2,68,167,235
04120000,SUNNYSIDE BEAUTY ACADEMY                ,WA,98944-8711,Proprietary  ,2,2,4,33,57,90
04127200,VICTORIA'S ACADEMY OF COSMETOLOGY       ,WA,99336-3826,Proprietary  ,3,14,17,114,258,372
04130500,PACIFIC NORTHWEST UNIV OF HEALTH SCIENCE,WA,98901-1471,Private      ,0,7,7,85,572,657
04130800,CASCADE BEAUTY COLLEGE                  ,WA,98002-5504,Proprietary  ,0,2,2,52,165,217
04132800,INLAND MASSAGE INSTITUTE                ,WA,99218-5016,Proprietary  ,1,6,7,89,242,331
04135200,NORTHWEST AVIATION COLLEGE              ,WA,98002-1609,Proprietary  ,0,0,0,29,88,117
04149400,GARY MANUEL AVEDA INSTITUTE             ,WA,98122-3807,Proprietary  ,12,24,36,264,566,830
04149600,GP INSTITUTE OF COSMETOLOGY             ,WA,98118-2353,Proprietary  ,1,7,8,47,177,224
04155000,NORTHWEST SCHOOL OF WOODEN BOAT BUILDING,WA,98339-8706,Private      ,0,0,0,10,70,80
04161200,BAINBRIDGE GRADUATE INSTITUTE           ,WA,98110-2870,Private      ,0,5,5,3,190,193
04170100,SALON PROFESSIONAL ACADEMY (THE)        ,WA,98409-7360,Proprietary  ,2,13,15,206,486,692
04172900,ACADEMY OF COSMETOLOGY                  ,WA,99354-2651,Proprietary  ,0,6,6,69,155,224
04188900,NORTHWEST INSTITUTE OF LITERARY ARTS    ,WA,98249-0000,Private      ,0,1,1,10,47,57
04191900,PAUL MITCHELL THE SCHOOL SPOKANE        ,WA,99037-5041,Proprietary  ,12,20,32,294,465,759
00340100,BROWN UNIVERSITY                        ,RI,02912-9127,Private      ,5,4,9,19282,1018,20300
00340101,BROWN UNIVERSITY - GRADUATE SCHOOL      ,RI,02912-1827,Private      ,0,8,8,65,1639,1704
00340102,BROWN MEDICAL SCHOOL                    ,RI,02912-0000,Private      ,0,3,3,72,569,641
00340200,BRYANT UNIVERSITY                       ,RI,02917-1284,Private      ,6,6,12,5693,676,6369
00340400,JOHNSON & WALES UNIVERSITY              ,RI,02903-3703,Private      ,54,43,97,21798,5936,27734
00340600,PROVIDENCE COLLEGE                      ,RI,02918-0001,Private      ,3,15,18,8510,1167,9677
00340700,RHODE ISLAND COLLEGE                    ,RI,02908-1991,Public       ,9,35,44,8699,5270,13969
00340800,COMMUNITY COLLEGE OF RI - WARWICK       ,RI,02906-0000,Public       ,69,198,267,10519,13749,24268
00340900,RHODE ISLAND SCHOOL OF DESIGN           ,RI,02903-2784,Private      ,0,7,7,3107,1556,4663
00341000,ROGER WILLIAMS UNIVERSITY               ,RI,02809-2921,Private      ,3,15,18,8799,1940,10739
00341100,SALVE REGINA UNIVERSITY                 ,RI,02840-4192,Private      ,3,12,15,4709,599,5308
00341400,UNIVERSITY OF RHODE ISLAND              ,RI,02881-0000,Public       ,23,56,79,24459,5102,29561
00659100,ST. JOSEPH HOSP SCH OF NURSING          ,RI,02904-5199,Private      ,0,3,3,98,341,439
00784500,NEW ENGLAND INSTITUTE OF TECHNOLOGY     ,RI,02886-0000,Private      ,9,20,29,2768,3483,6251
01115900,"SAWYER SCHOOL,THE                       ",RI,02860-4117,Proprietary  ,0,0,0,246,1216,1462
01164702,SBI CAMPUS - AN AFFILIATE OF SANFORD-BRO,RI,02920-7807,Proprietary  ,0,2,2,180,636,816
02071900,ARTHUR ANGELO SCH COSMET&HAIR DSGN      ,RI,02903-0000,Proprietary  ,4,14,18,96,258,354
02176900,WARWICK ACADEMY OF BEAUTY CULTURE       ,RI,02886-1534,Proprietary  ,3,4,7,86,145,231
02531802,PAUL MITCHELL THE SCHOOL-CRANSTON       ,RI,02920-0000,Proprietary  ,1,3,4,1,3,4
02584400,NEW ENGLAND TRACTOR TRAILER TRAINING SCH,RI,02860-1752,Proprietary  ,18,99,117,130,1325,1455
03080000,NEWPORT SCHOOL OF HAIRDRESSING          ,RI,02860-4038,Proprietary  ,1,5,6,20,99,119
03232300,LINCOLN TECHNICAL INSTITUTE             ,RI,02865-4211,Proprietary  ,25,53,78,487,1113,1600
03732300,INTERNATIONAL YACHT RESTORATION SCH     ,RI,02840-6720,Private      ,0,1,1,42,75,117
04141200,TONI & GUY HAIRDRESSING ACADEMY         ,RI,02920-0000,Proprietary  ,3,5,8,140,128,268
00341700,ALLEN UNIVERSITY                        ,SC,29204-1085,Private      ,6,19,25,1294,874,2168
00341800,ANDERSON UNIVERSITY                     ,SC,29621-4035,Private      ,12,32,44,3050,1639,4689
00341900,CHARLESTON SOUTHERN UNIVERSITY          ,SC,29406-2160,Private      ,56,71,127,4938,3140,8078
00342000,BENEDICT COLLEGE                        ,SC,29204-1086,Private      ,35,23,58,5018,2212,7230
00342100,BOB JONES UNIVERSITY                    ,SC,29614-1000,Proprietary  ,7,12,19,2835,581,3416
00342200,SOUTHERN WESLEYAN UNIVERSITY            ,SC,29630-1020,Private      ,1,63,64,906,2052,2958
00342300,THE CITADEL                             ,SC,29409-0002,Public       ,16,54,70,3380,1602,4982
00342400,CLAFLIN UNIVERSITY                      ,SC,29115-4498,Private      ,74,27,101,3141,1313,4454
00342500,CLEMSON UNIVERSITY                      ,SC,29634-0001,Public       ,49,80,129,21137,4897,26034
00342600,UNIV OF SC AT SUMTER                    ,SC,29150-2498,Public       ,6,32,38,1084,1099,2183
00342700,COKER COLLEGE                           ,SC,29550-3797,Private      ,5,16,21,1192,1099,2291
00342800,COLLEGE OF CHARLESTON                   ,SC,29424-0100,Public       ,25,56,81,13169,4053,17222
00342900,COLUMBIA INTERNATIONAL UNIVERSITY       ,SC,29203-1599,Private      ,4,7,11,707,1033,1740
00343000,COLUMBIA COLLEGE                        ,SC,29203-5998,Private      ,8,46,54,1476,1988,3464
00343100,CONVERSE COLLEGE                        ,SC,29302-1931,Private      ,5,13,18,1196,879,2075
00343200,ERSKINE COLLEGE                         ,SC,29639-0000,Private      ,4,1,5,876,77,953
00343201,ERSKINE THEOLOGICAL SEMINARY            ,SC,29639-0000,Private      ,0,1,1,5,114,119
00343400,FURMAN UNIVERSITY                       ,SC,29613-5253,Private      ,9,16,25,4678,787,5465
00343500,LANDER UNIVERSITY                       ,SC,29649-2099,Public       ,14,19,33,4511,1218,5729
00343600,LIMESTONE COLLEGE                       ,SC,29340-3799,Private      ,9,61,70,1573,3824,5397
00343700,LUTHERAN THEOLOGICAL SOUTHERN SEM       ,SC,29203-5898,Private      ,0,0,0,4,191,195
00343800,MEDICAL UNIV OF SOUTH CAROLINA - FA     ,SC,29425-1760,Public       ,2,29,31,537,3963,4500
00343900,MORRIS COLLEGE                          ,SC,29150-3599,Private      ,17,9,26,1617,790,2407
00344000,NEWBERRY COLLEGE                        ,SC,29108-2197,Private      ,7,7,14,1790,468,2258
00344100,NORTH GREENVILLE COLLEGE                ,SC,29688-1892,Private      ,14,8,22,2790,578,3368
00344500,PRESBYTERIAN COLLEGE                    ,SC,29325-2503,Private      ,6,4,10,1781,364,2145
00344600,SOUTH CAROLINA STATE UNIVERSITY         ,SC,29117-4427,Public       ,31,44,75,6775,3492,10267
00344700,SPARTANBURG METHODIST COLLEGE           ,SC,29301-5899,Private      ,9,5,14,1584,397,1981
00344800,UNIVERSITY OF SOUTH CAROLINA            ,SC,29208-3999,Public       ,80,187,267,30475,14540,45015
00344900,UNIVERSITY OF SOUTH CAROLINA AIKEN      ,SC,29801-6399,Public       ,12,29,41,3893,1956,5849
00345000,UNIV OF SC AT BEAUFORT                  ,SC,29902-0000,Public       ,10,15,25,2287,1574,3861
00345100,COASTAL CAROLINA UNIVERSITY             ,SC,29528-0000,Public       ,40,83,123,14751,3808,18559
00345300,UNIV OF SC AT LANCASTER                 ,SC,29721-0889,Public       ,8,19,27,1324,1064,2388
00345400,UNIV OF SC SYSTEM SALKEHATCHIE          ,SC,29810-0617,Public       ,8,21,29,841,1222,2063
00345500,VOORHEES COLLEGE                        ,SC,29042-0000,Private      ,4,9,13,1027,551,1578
00345600,WINTHROP UNIVERSITY                     ,SC,29733-0001,Public       ,31,50,81,6961,2945,9906
00345700,WOFFORD COLLEGE                         ,SC,29303-3663,Private      ,1,3,4,2788,335,3123
00399000,FLORENCE-DARLINGTON TECH COLLEGE        ,SC,29501-0548,Public       ,46,222,268,3824,7937,11761
00399100,GREENVILLE TECHNICAL COLLEGE            ,SC,29607-2439,Public       ,119,378,497,9181,15336,24517
00399200,PIEDMONT TECHNICAL COLLEGE              ,SC,29648-1467,Public       ,45,200,245,3039,6906,9945
00399300,MIDLANDS TECHNICAL COLLEGE              ,SC,29202-0000,Public       ,96,377,473,8500,14848,23348
00399400,SPARTANBURG COMMUNITY COLLEGE           ,SC,29305-4386,Public       ,41,176,217,3919,6707,10626
00399500,CENTRAL CAROLINA TECHNICAL COLLEGE      ,SC,29150-2499,Public       ,41,166,207,2098,5917,8015
00399600,YORK TECHNICAL COLLEGE                  ,SC,29730-3395,Public       ,44,188,232,3310,6562,9872
00492000,TRIDENT TECHNICAL COLLEGE               ,SC,29423-8067,Public       ,183,708,891,8371,19286,27657
00492300,CLINTON JR COLLEGE                      ,SC,29730-5152,Private      ,2,3,5,229,208,437
00492400,FORREST JUNIOR COLLEGE                  ,SC,29624-2405,Proprietary  ,3,17,20,54,405,459
00492500,HORRY-GEORGETOWN TECH COLLEGE           ,SC,29526-9521,Public       ,51,193,244,4677,8875,13552
00492600,TRI-COUNTY TECHNICAL COLLEGE            ,SC,29670-9133,Public       ,34,101,135,4767,5502,10269
00492700,UNIV OF SC AT UNION                     ,SC,29379-0729,Public       ,0,7,7,304,409,713
00499204,MILLER-MOTTE TECHNICAL COLLEGE - CONWAY ,SC,29526-9508,Proprietary  ,12,75,87,597,1947,2544
00536300,DENMARK TECHNICAL COLLEGE               ,SC,29042-0000,Public       ,23,157,180,1203,2406,3609
00681500,ORANGEBURG-CALHOUN TECHNICAL COLG       ,SC,29118-8299,Public       ,64,93,157,1946,3267,5213
00695100,UNIVERSITY OF SOUTH CAROLINA UPSTATE    ,SC,29303-9972,Public       ,17,59,76,7170,4187,11357
00760200,NORTHEASTERN TECHNICAL COLLEGE          ,SC,29520-7015,Public       ,19,43,62,773,1534,2307
00922600,FRANCIS MARION UNIVERSITY               ,SC,29501-0000,Public       ,25,44,69,5358,2649,8007
00932200,WILLIAMSBURG TECHNICAL COLLEGE          ,SC,29556-4197,Public       ,76,39,115,425,972,1397
00991000,TECHNICAL COLLEGE OF THE LOWCOUNTRY     ,SC,29902-5441,Public       ,19,95,114,1295,3760,5055
00991100,UNIV OF SC-REGIONAL CAMPUSES ADMIN      ,SC,29208-0001,Public       ,3,6,9,235,366,601
01005600,AIKEN TECHNICAL COLLEGE                 ,SC,29802-0696,Public       ,20,100,120,2100,4110,6210
01179901,PAUL MITCHELL THE SCHOOL COLUMBIA       ,SC,29201-3126,Proprietary  ,3,4,7,3,6,9
01179902,PAUL MITCHELL THE SCHOOL CHARLESTON     ,SC,29418-6993,Proprietary  ,0,9,9,0,11,11
01209200,KENNETH SHULER SCHOOL OF COSMETOLOGY    ,SC,29732-2169,Proprietary  ,7,33,40,198,570,768
01303907,SOUTH UNIVERSITY                        ,SC,29203-6400,Proprietary  ,13,163,176,667,3730,4397
02063700,SHERMAN CLG STRAIGHT CHIROPRACTIC       ,SC,29316-0000,Private      ,0,4,4,26,331,357
02338600,CHARZANNE BEAUTY COLLEGE                ,SC,29649-0000,Proprietary  ,3,8,11,41,146,187
02341100,KENNETH SHULER SCHOOL OF COSMETOLOGY & N,SC,29210-0000,Proprietary  ,10,38,48,274,968,1242
02356600,CHARLESTON COSMETOLOGY INSTITUTE        ,SC,29420-0000,Proprietary  ,2,9,11,100,256,356
02552400,ACADEMY OF HAIR TECHNOLOGY              ,SC,29615-2363,Proprietary  ,2,10,12,93,287,380
02567600,SUMTER BEAUTY COLLEGE                   ,SC,29150-0000,Proprietary  ,0,4,4,50,154,204
02614202,MILLER - MOTTE TECHNICAL COLLEGE - NORTH,SC,29406-9239,Proprietary  ,14,82,96,405,1851,2256
03010614,VIRGINIA COLLEGE - GOLF ACADEMY OF AMERI,SC,29579-0000,Proprietary  ,2,4,6,167,333,500
03010617,VIRGINIA COLLEGE - GREENVILLE           ,SC,29607-7200,Proprietary  ,3,22,25,260,1143,1403
03010620,VIRGINIA COLLEGE - CHARLESTON           ,SC,29406-4999,Proprietary  ,6,20,26,225,1029,1254
03010621,VIRGINIA COLLEGE - COLUMBIA             ,SC,29223-7527,Proprietary  ,4,33,37,273,1224,1497
03052300,KENNETH SHULER SCH COSM & HAIR DESG     ,SC,29841-2013,Proprietary  ,9,26,35,147,488,635
03088300,ACADEMY OF COSMETOLOGY                  ,SC,29418-5667,Proprietary  ,0,0,0,79,197,276
03293300,STRAND COLLEGE OF HAIR DESIGN           ,SC,29572-4310,Proprietary  ,1,5,6,48,165,213
03304300,CENTURA COLLEGE                         ,SC,29406-9235,Proprietary  ,9,84,93,219,1437,1656
03513300,LACY COSMETOLOGY SCHOOL                 ,SC,29803-9084,Proprietary  ,4,5,9,44,136,180
03513301,LACY COSMETOLOGY SCHOOL -               ,SC,29072-0000,Proprietary  ,0,0,0,16,68,84
03513302,LACY COSMETOLOGY SCHOOL -               ,SC,29445-0000,Proprietary  ,3,1,4,27,103,130
03595300,CHARLESTON SCHOOL OF MASSAGE            ,SC,29412-8270,Proprietary  ,0,0,0,30,75,105
03709301,EDWARD VIA VIRGINIA COLLEGE OF OSTEOPATH,SC,29303-3639,Private      ,0,5,5,29,468,497
03746300,LEGRAND INSTITUTE OF COSMETOLOGY        ,SC,29020-0000,Proprietary  ,1,3,4,30,86,116
03746400,SOUTHEASTERN INSTITUTE                  ,SC,29210-0000,Proprietary  ,0,26,26,100,559,659
03768400,STYLETRENDS BARBER AND HAIRSTYLING ACADE,SC,29730-4511,Proprietary  ,1,3,4,29,133,162
03856400,W. L. BONNER COLLEGE                    ,SC,29203-0000,Private      ,0,0,0,21,134,155
03892300,HARLEY'S BEAUTY & BARBER CAREER INST.   ,SC,29204-1919,Proprietary  ,0,0,0,21,97,118
04083300,MARION COUNTY TECHNICAL EDUCATION CENTER,SC,29571-0000,Public       ,0,2,2,35,194,229
04096300,CHARLESTON SCHOOL OF LAW                ,SC,29402-0535,Proprietary  ,0,4,4,62,1299,1361
04158100,AIKEN SCHOOL OF COSMETOLOGY             ,SC,29801-4026,Proprietary  ,0,3,3,61,140,201
04166900,COSMETIC ARTS INSTITUTE                 ,SC,29488-2753,Proprietary  ,1,3,4,23,88,111
04172600,SALON 496 BARBER ACADEMY                ,SC,29607-2548,Proprietary  ,0,8,8,37,183,220
04192600,PALMETTO BEAUTY SCHOOL                  ,SC,29307-1424,Proprietary  ,3,13,16,51,224,275
04202900,JOLEI'S HAIR INSTITUTE                  ,SC,29114-9337,Proprietary  ,1,4,5,6,57,63
00345800,AUGUSTANA COLLEGE                       ,SD,57197-0001,Private      ,3,25,28,1900,336,2236
00345900,BLACK HILLS STATE UNIVERSITY            ,SD,57799-9670,Public       ,5,26,31,2604,2056,4660
00346100,DAKOTA WESLEYAN UNIVERSITY              ,SD,57301-4398,Private      ,0,0,0,805,293,1098
00346300,DAKOTA STATE UNIVERSITY                 ,SD,57042-1799,Public       ,1,11,12,1368,976,2344
00346500,MOUNT MARTY COLLEGE                     ,SD,57078-3724,Private      ,1,6,7,579,515,1094
00346600,NORTHERN STATE UNIVERSITY               ,SD,57401-7198,Public       ,0,11,11,1751,961,2712
00346700,PRESENTATION COLLEGE                    ,SD,57401-1299,Private      ,0,7,7,587,567,1154
00346900,UNIVERSITY OF SIOUX FALLS               ,SD,57105-1699,Private      ,1,14,15,1561,786,2347
00347000,SOUTH DAKOTA SCH OF MINES & TECH        ,SD,57701-3995,Public       ,1,3,4,1835,748,2583
00347100,SOUTH DAKOTA STATE UNIVERSITY           ,SD,57007-2298,Public       ,12,37,49,9007,3583,12590
00347400,UNIVERSITY OF SOUTH DAKOTA              ,SD,57069-2390,Public       ,15,40,55,5672,5218,10890
00405600,SIOUX FALLS SEMINARY                    ,SD,57105-2729,Private      ,0,3,3,3,111,114
00405700,NATIONAL AMERICAN UNIVERSITY            ,SD,57701-3692,Proprietary  ,10,172,182,1192,16227,17419
00405707,NATIONAL AMERICAN UNIVERSITY            ,SD,57105-0000,Proprietary  ,1,14,15,77,917,994
00492900,MCKENNAN HOSP-RADOLOGICAL TECH          ,SD,57101-0000,Private      ,0,2,2,20,54,74
00530900,LAKE AREA TECHNICAL INSTITUTE           ,SD,57201-0730,Public       ,5,4,9,1072,736,1808
00598700,AVERA SACRED HEART HOSPITAL SCHOOL OF RA,SD,57078-3899,Private      ,0,0,0,10,13,23
00776400,SOUTHEAST TECHNICAL INST                ,SD,57107-0000,Public       ,8,34,42,1609,2095,3704
00828400,MITCHELL TECHNICAL INSTITUTE            ,SD,57301-9931,Public       ,2,3,5,776,495,1271
01013800,STEWART SCHOOL                          ,SD,57104-0000,Proprietary  ,4,4,8,121,134,255
01014804,COLORADO TECHNICAL UNIVERSITY           ,SD,57108-2272,Proprietary  ,0,9,9,199,1019,1218
01017000,WESTERN DAKOTA TECHNICAL INSTITUTE      ,SD,57701-4018,Public       ,6,37,43,608,1307,1915
01147701,SIOUX VALLEY HOSP-MEDICAL TECH          ,SD,57117-5039,Private      ,0,1,1,25,48,73
01465900,OGLALA LAKOTA COLLEGE                   ,SD,57752-0490,Public       ,2,11,13,411,1727,2138
02137100,BLACK HILLS BEAUTY COLLEGE              ,SD,57701-0000,Proprietary  ,6,13,19,108,166,274
02143700,SINTE GLESKA UNIVERSITY                 ,SD,57570-0000,Public       ,6,17,23,191,791,982
02144600,KILIAN COMMUNITY COLLEGE                ,SD,57103-7020,Private      ,1,12,13,135,486,621
02277300,SISSETON WAHPETON COLLEGE               ,SD,57262-0000,Public       ,0,2,2,46,222,268
02297800,HEADLINES ACADEMY                       ,SD,57701-0000,Proprietary  ,1,5,6,68,179,247
00347700,AQUINAS COLLEGE                         ,TN,37205-2086,Private      ,2,9,11,367,1113,1480
00347800,AUSTIN PEAY STATE UNIVERSITY            ,TN,37044-0002,Public       ,35,197,232,9181,9942,19123
00347900,BELMONT UNIVERSITY                      ,TN,37212-3757,Private      ,10,59,69,8224,4483,12707
00348000,BETHEL UNIVERSITY                       ,TN,38201-1705,Private      ,19,458,477,2424,8436,10860
00348100,CARSON-NEWMAN COLLEGE                   ,TN,37760-2204,Private      ,4,15,19,3527,912,4439
00348200,CHRISTIAN BROTHERS UNIVERSITY           ,TN,38104-5581,Private      ,8,35,43,2681,2644,5325
00348300,COLUMBIA STATE COMMUNITY COLLEGE        ,TN,38401-5653,Public       ,35,81,116,3577,4304,7881
00348500,CUMBERLAND UNIVERSITY                   ,TN,37087-3554,Private      ,4,30,34,1642,1384,3026
00348600,LIPSCOMB UNIVERSITY                     ,TN,37204-3951,Private      ,11,74,85,4052,2964,7016
00348700,EAST TENNESSEE STATE UNIV - MAIN CAMPUS ,TN,37614-2857,Public       ,32,137,169,13717,9804,23521
00348701,EAST TENNESSEE STATE UNIV - MEDICINE    ,TN,37614-1708,Public       ,0,3,3,392,752,1144
00348709,EAST TENNESSEE STATE UNIV - PHARMACY    ,TN,37614-1704,Public       ,0,1,1,193,540,733
00349000,FISK UNIVERSITY                         ,TN,37208-3045,Private      ,6,20,26,1677,868,2545
00349200,FREED-HARDEMAN UNIVERSITY               ,TN,38340-2399,Private      ,5,11,16,1956,1028,2984
00349400,HIWASSEE COLLEGE                        ,TN,37354-4001,Private      ,8,1,9,386,177,563
00349500,JOHNSON UNIVERSITY                      ,TN,37998-9775,Private      ,2,14,16,917,676,1593
00349600,KING COLLEGE                            ,TN,37620-2699,Private      ,8,48,56,1601,2537,4138
00349900,LANE COLLEGE                            ,TN,38301-4598,Private      ,10,13,23,2771,1342,4113
00350000,LEE UNIVERSITY                          ,TN,37320-0000,Private      ,8,45,53,4552,2098,6650
00350100,LEMOYNE-OWEN COLLEGE                    ,TN,38126-6510,Private      ,14,44,58,2133,3376,5509
00350200,LINCOLN MEMORIAL UNIVERSITY             ,TN,37752-7920,Private      ,3,39,42,2253,4756,7009
00350400,MARTIN METHODIST COLLEGE                ,TN,38478-2799,Private      ,1,8,9,1062,551,1613
00350500,MARYVILLE COLLEGE                       ,TN,37804-5907,Private      ,2,3,5,2249,398,2647
00350600,MEHARRY MEDICAL COLLEGE                 ,TN,37208-0000,Private      ,3,5,8,124,1564,1688
00350700,MEMPHIS COLLEGE OF ART                  ,TN,38104-2764,Private      ,8,6,14,933,624,1557
00350900,UNIVERSITY OF MEMPHIS (THE)             ,TN,38152-4611,Public       ,84,258,342,20380,22408,42788
00351000,MIDDLE TENNESSEE STATE UNIV             ,TN,37130-0000,Public       ,67,211,278,25956,16617,42573
00351100,MILLIGAN COLLEGE                        ,TN,37682-4001,Private      ,1,10,11,1361,800,2161
00351700,SOUTHERN COLLEGE OF OPTOMETRY           ,TN,38104-2222,Private      ,0,3,3,70,725,795
00351800,SOUTHERN ADVENTIST UNIVERSITY           ,TN,37315-0370,Private      ,10,16,26,3088,1162,4250
00351900,RHODES COLLEGE                          ,TN,38112-1690,Private      ,6,6,12,3673,923,4596
00352200,TENNESSEE STATE UNIVERSITY              ,TN,37209-1561,Public       ,71,194,265,12188,12051,24239
00352300,TENNESSEE TECHNOLOGICAL UNIV            ,TN,38505-0001,Public       ,23,88,111,11672,4784,16456
00352400,TENNESSEE TEMPLE UNIVERSITY             ,TN,37404-3587,Private      ,9,49,58,511,1081,1592
00352500,TENNESSEE WESLEYAN COLLEGE              ,TN,37371-0040,Private      ,1,13,14,1371,683,2054
00352600,TREVECCA NAZARENE UNIVERSITY            ,TN,37210-2877,Private      ,3,56,59,1705,2604,4309
00352700,TUSCULUM COLLEGE                        ,TN,37743-0001,Private      ,3,32,35,2571,2213,4784
00352800,UNION UNIVERSITY                        ,TN,38305-3697,Private      ,5,92,97,3379,3815,7194
00352900,UNIVERSITY OF TENNESSEE-CHATTANOOGA     ,TN,37403-2598,Public       ,39,83,122,16844,6936,23780
00353000,UNIVERSITY OF TENNESSEE-KNOXVILLE       ,TN,37996-0150,Public       ,104,134,238,30416,12472,42888
00353006,UNIVERSITY OF TENNESSEE-HEALTH SCI CTR  ,TN,38103-0000,Public       ,7,24,31,750,4150,4900
00353100,UNIVERSITY OF TENNESSEE-MARTIN          ,TN,38238-0002,Public       ,24,71,95,8839,4696,13535
00353400,UNIVERSITY OF THE SOUTH                 ,TN,37383-1000,Private      ,1,14,15,2519,176,2695
00353500,VANDERBILT UNIVERSITY                   ,TN,37240-0001,Private      ,21,45,66,19754,7793,27547
00353501,VANDERBILT UNIV MED CTR ALLIEDHEAL      ,TN,37232-5510,Private      ,1,3,4,107,479,586
00353502,VANDERBILT UNIVERSITY - SCHOOL OF MEDICI,TN,37232-0000,Private      ,4,3,7,390,1093,1483
00353600,BRYAN COLLEGE                           ,TN,37321-7000,Private      ,0,16,16,1401,1014,2415
00399800,CHATTANOOGA STATE COMMUNITY COLLEGE     ,TN,37406-1097,Public       ,75,288,363,6653,12184,18837
00399900,CLEVELAND STATE COMMUNITY COLLEGE       ,TN,37312-2858,Public       ,18,89,107,2368,3398,5766
00402500,TN TECHNOLOGY CTR AT KNOXVILLE          ,TN,37919-2327,Public       ,2,22,24,758,2269,3027
00402600,TENNESSEE TECH. CNTR AT CROSSVILLE      ,TN,38555-4142,Public       ,3,7,10,490,764,1254
00461700,NATIONAL COLLEGE OF BUSINESS & TECH     ,TN,37211-6605,Proprietary  ,7,66,73,350,2524,2874
00493400,DAYMAR INSTITUTE                        ,TN,37217-1056,Proprietary  ,6,50,56,338,2024,2362
00493401,DAYMAR INSTITUTE - CLARKSVILLE          ,TN,37040-6718,Proprietary  ,19,62,81,136,844,980
00493404,DAYMAR INSTITUTE - MURFREESBORO         ,TN,37128-5508,Proprietary  ,8,43,51,120,471,591
00493700,JACKSON STATE COMMUNITY COLLEGE         ,TN,38301-3797,Public       ,26,61,87,3599,5181,8780
00493800,SOUTH COLLEGE                           ,TN,37909-3323,Proprietary  ,8,111,119,663,2835,3498
00494700,WEST TENNESSEE BUSINESS COLLEGE         ,TN,38301-3256,Proprietary  ,4,30,34,203,854,1057
00528000,TN TECHNOLOGY CTR AT COVINGTON          ,TN,38019-0249,Public       ,5,9,14,203,541,744
00528100,TN TECHNOLOGY CTR AT ELIZABETHTON       ,TN,37643-0789,Public       ,5,60,65,440,1248,1688
00528200,TN TECHNOLOGY CTR AT HARTSVILLE         ,TN,37074-0000,Public       ,1,3,4,267,483,750
00528300,TN TECHNOLOGY CTR AT NEWBERN            ,TN,38059-1198,Public       ,2,8,10,162,699,861
00530700,TN TECHNOLOGY CTR AT MCMINNVILLE        ,TN,37110-1322,Public       ,6,5,11,268,513,781
00535100,TENNESSEE TECHNOLOGY CENTER AT MORRISTOW,TN,37813-2094,Public       ,7,15,22,601,1326,1927
00535200,TN TECHNOLOGY CENTER AT MCKENZIE        ,TN,38201-1620,Public       ,1,9,10,187,426,613
00535300,TN TECHNOLOGY CENTER AT LIVINGSTON      ,TN,38570-1291,Public       ,2,4,6,299,544,843
00535400,TN TECHNOLOGY CTR AT JACKSON            ,TN,38301-0000,Public       ,5,21,26,550,1507,2057
00535600,TENNESSEE TECHNOLOGY CENTER AT HOHENWALD,TN,38462-0000,Public       ,4,6,10,275,554,829
00535700,TENNESSEE TECHNOLOGY CENTER AT CRUMP    ,TN,38327-3402,Public       ,3,10,13,201,538,739
00535800,TN TECHNOLOGY CENTER AT ATHENS          ,TN,37371-0848,Public       ,3,6,9,282,533,815
00535900,TENNESSEE TECHNOLOGY CENTER AT NASHVILLE,TN,37209-0000,Public       ,7,54,61,813,2754,3567
00536000,TENNESSEE TECHNOLOGY CENTER AT MEMPHIS  ,TN,38105-3604,Public       ,16,62,78,1363,3615,4978
00537800,NORTHEAST STATE COMMUNITY COLLEGE       ,TN,37617-0246,Public       ,34,136,170,3859,6247,10106
00537900,TN TECHNOLOGY CTR AT SHELBYVILLE        ,TN,37160-3697,Public       ,5,22,27,390,937,1327
00683500,DYERSBURG STATE COMMUNITY COLLEGE       ,TN,38024-0000,Public       ,17,61,78,2047,3938,5985
00683600,MOTLOW STATE COMMUNITY COLLEGE          ,TN,37388-7972,Public       ,30,93,123,3584,4199,7783
00732941,ITT TECHNICAL INSTITUTE                 ,TN,37932-3343,Proprietary  ,97,388,485,1325,4421,5746
00732958,ITT TECHNICAL INSTITUTE                 ,TN,37214-3717,Proprietary  ,39,354,393,959,3382,4341
00743900,FOUNTAINHEAD COLLEGE OF TECHNOLOGY      ,TN,37918-2583,Proprietary  ,2,28,30,253,932,1185
00778200,TENNESSEE TECHNOLOGY CENTER AT DICKSON  ,TN,37055-0000,Public       ,2,14,16,431,1039,1470
00778300,MIDDLE TENNESSEE SCH OF ANESTHESIA      ,TN,37116-0000,Private      ,0,3,3,25,203,228
00793803,NASHVILLE AUTO DIESEL COLLEGE - NASHVILL,TN,37206-3210,Proprietary  ,84,54,138,3291,1451,4742
00814500,NASHVILLE STATE TECH CMNTY COLLEGE      ,TN,37209-0000,Public       ,59,237,296,5260,12149,17409
00865500,GENESIS CAREER COLLEGE OF COOKEVILLE    ,TN,38501-1959,Proprietary  ,24,71,95,228,684,912
00885900,JOHN A GUPTON COLLEGE                   ,TN,37203-2934,Private      ,0,5,5,120,249,369
00886300,WALTERS STATE COMMUNITY COLLEGE         ,TN,37813-6899,Public       ,28,88,116,4974,5690,10664
00946400,TN TECHNOLOGY CTR AT PULASKI            ,TN,38478-4541,Public       ,4,9,13,183,440,623
00956700,TENNESSEE SCHOOL OF BEAUTY              ,TN,37921-3303,Proprietary  ,8,16,24,289,661,950
00971000,TENNESSEE TECHNOLOGY CENTER AT ONEIDA/HU,TN,37756-4149,Public       ,0,1,1,105,274,379
00991200,VOLUNTEER STATE COMMUNITY COLLEGE       ,TN,37066-3188,Public       ,39,169,208,4894,6871,11765
00991400,ROANE STATE COMMUNITY COLLEGE           ,TN,37748-8664,Public       ,52,127,179,4452,6052,10504
00998200,VICTORY UNIVERSITY                      ,TN,38111-4745,Proprietary  ,27,177,204,823,4005,4828
01032600,TN TECHNOLOGY CTR AT HARRIMAN           ,TN,37748-1109,Public       ,2,3,5,208,442,650
01043900,SOUTHWEST TENNESSEE COMMUNITY COLLG     ,TN,38104-3322,Public       ,160,374,534,10292,19250,29542
01044700,"PLAZA BEAUTY SCHOOL, INC.               ",TN,38117-4822,Proprietary  ,7,14,21,228,527,755
01046000,AMERICAN BAPTIST THEOLOGICAL SEMINA     ,TN,37207-4994,Private      ,0,2,2,41,266,307
01052900,MEMPHIS THEOLOGICAL SEMINARY            ,TN,38104-0000,Private      ,0,2,2,32,449,481
01070000,TN TECHNOLOGY CENTER AT JACKSBORO       ,TN,37757-2461,Public       ,7,9,16,196,376,572
01155300,WM R MOORE COLLEGE OF TECHNOLOGY        ,TN,38104-0000,Private      ,8,16,24,188,585,773
01216400,TENNESSEE TECHNICAL CNTR AT RIPLEY      ,TN,38063-7359,Public       ,0,4,4,112,367,479
01254700,EMMANUEL SCHOOL OF RELIGION             ,TN,37601-0000,Private      ,0,2,2,6,96,102
01269300,PELLISSIPPI STATE COMMUNITY COLLEGE     ,TN,37933-0990,Public       ,102,179,281,7481,8685,16166
02069303,VATTEROTT COLLEGE -                     ,TN,38016-5877,Proprietary  ,4,41,45,218,816,1034
02092800,TENNESSEE TECHNOLOGY CENTER AT WHITEVILL,TN,38075-0000,Public       ,1,5,6,160,334,494
02103500,TN TECHNOLOGY CTR AT MURFREESBORO       ,TN,37129-0000,Public       ,5,24,29,491,1108,1599
02106400,O'MORE COLLEGE OF DESIGN                ,TN,37064-0000,Private      ,1,1,2,186,112,298
02125300,NASHVILLE CLG OF MEDICAL CAREERS        ,TN,37115-0000,Proprietary  ,6,14,20,62,332,394
02153100,JON NAVE UNIVERSITY OF COSMETOLOGY      ,TN,37013-3347,Proprietary  ,11,24,35,283,488,771
02157100,CONCORDE CAREER COLLEGE                 ,TN,38137-0000,Proprietary  ,37,155,192,882,3290,4172
02160307,INTERNATIONAL ACADEMY OF DESIGN & TECH  ,TN,37212-0000,Proprietary  ,0,5,5,386,669,1055
02188300,PENTECOSTAL THEOLOGICAL SEMINARY        ,TN,37320-0000,Private      ,0,4,4,4,284,288
02204200,"CHATTANOOGA COLLEGE - MEDICAL, DENTAL AN",TN,37411-0000,Proprietary  ,8,51,59,309,1181,1490
02237900,TN TECHNOLOGY CENTER AT PARIS           ,TN,38242-0000,Public       ,2,4,6,217,640,857
02255000,KNOXVILLE INSTITUTE OF HAIR DESIGN      ,TN,37917-0000,Proprietary  ,4,10,14,114,402,516
02257400,ARNOLD'S BEAUTY SCHOOL                  ,TN,38358-0000,Proprietary  ,0,3,3,64,103,167
02263104,ANTHEM COLLEGE - ANTHEM CAREER COLLEGE -,TN,37214-2531,Proprietary  ,9,47,56,170,632,802
02275500,REUBEN-ALLEN COLLEGE                    ,TN,37922-0000,Proprietary  ,5,14,19,165,403,568
02278700,MR WAYNES SCH OF UNISEX HAIR DESIGN     ,TN,38501-0000,Proprietary  ,2,8,10,41,89,130
02293900,VOLUNTEER BEAUTY ACADEMY-NASHVILLE      ,TN,37115-2112,Proprietary  ,0,7,7,41,121,162
02294000,VOLUNTEER BEAUTY ACADEMY-DYERSBURG      ,TN,38024-1622,Proprietary  ,4,9,13,43,153,196
02326200,KAPLAN CAREER INSTITUTE                 ,TN,37212-5318,Proprietary  ,8,80,88,314,1691,2005
02326300,MEDVANCE INSTITUTE                      ,TN,38501-4305,Proprietary  ,15,33,48,169,458,627
02335900,VOLUNTEER BEAUTY ACADEMY-NASHVILLE      ,TN,37209-3033,Proprietary  ,0,10,10,74,224,298
02539800,QUEEN CITY COLLEGE                      ,TN,37042-0000,Proprietary  ,1,16,17,69,455,524
02540000,TENNESSEE ACADEMY OF COSMETOLOGY        ,TN,38133-0000,Proprietary  ,4,27,31,239,602,841
02578200,NOSSI COLLEGE OF ART                    ,TN,37115-5138,Proprietary  ,0,6,6,446,473,919
02595000,FAYETTEVILLE BEAUTY SCHOOL              ,TN,37334-2909,Proprietary  ,3,6,9,39,102,141
02599710,VATTEROTT COLLEGE - MEMPHIS             ,TN,38132-1714,Proprietary  ,14,95,109,541,2383,2924
02605501,REMINGTON COLLEGE - MEMPHIS CAMPUS      ,TN,38132-0000,Private      ,28,119,147,795,2748,3543
02609204,VATTEROTT COLLEGE - VATTEROTT CAREER COL,TN,38133-4727,Proprietary  ,8,52,60,362,1334,1696
02614200,MILLER MOTTE BUSINESS COLLEGE           ,TN,37040-6023,Proprietary  ,4,44,48,315,1261,1576
02614203,MILLER - MOTTE TECHNICAL COLLEGE - CHATT,TN,37421-7220,Proprietary  ,7,44,51,372,1273,1645
02614204,MILLER - MOTTE TECHNICAL COLLEGE - MADIS,TN,37072-1870,Proprietary  ,14,57,71,244,857,1101
03001800,FREE WILL BAPTIST BIBLE COLLEGE         ,TN,37205-2498,Private      ,0,2,2,255,193,448
03008800,FRANKLIN ACADEMY                        ,TN,37312-3939,Private      ,5,12,17,69,151,220
03010606,VIRGINIA COLLEGE - SCH OF BUSNSS & HLTH ,TN,37411-5600,Proprietary  ,13,72,85,225,1105,1330
03024900,TENNESSEE ACADEMY OF COSMETOLOGY        ,TN,38125-3442,Proprietary  ,7,22,29,228,477,705
03061100,GENESIS CAREER COLLEGE OF LEBANON       ,TN,37087-2718,Proprietary  ,19,48,67,144,388,532
03073404,ITT TECHNICAL INSTITUTE -               ,TN,37411-5336,Proprietary  ,0,0,0,0,2,2
03076405,BRYMAN SCHOOL OF ARIZONA (THE) - ANTHEM ,TN,38134-7345,Proprietary  ,34,121,155,87,365,452
03079100,NORTH CENTRAL INSTITUTE                 ,TN,37042-3116,Proprietary  ,2,9,11,52,293,345
03088800,"WATKINS COLLEGE OF ART, DESIGN & FILM   ",TN,37228-1306,Private      ,1,6,7,732,418,1150
03126900,STYLES & PROFILES BEAUTY COLLEGE        ,TN,38375-2109,Proprietary  ,2,3,5,28,40,68
03355400,RICHMONT GRADUATE UNIVERSITY            ,TN,37404-0000,Private      ,0,4,4,9,300,309
03440300,BAPTIST MEMORIAL COLLEGE OF HEALTH      ,TN,38104-3104,Private      ,8,27,35,1292,3236,4528
03480303,MEDVANCE INSTITUTE - NASHVILLE          ,TN,37203-1536,Proprietary  ,5,40,45,155,900,1055
03513500,WILLIAMSON CHRISTIAN COLLEGE            ,TN,37067-8237,Private      ,2,1,3,44,112,156
03647300,NEW CONCEPTS SCHOOL OF COSMETOLOGY      ,TN,37311-7373,Proprietary  ,2,5,7,35,124,159
03683300,INTERNATIONAL BARBER & STYLE COLLEGE    ,TN,37209-2205,Proprietary  ,1,24,25,76,331,407
03701300,MEMPHIS INSTITUTE OF BARBERING          ,TN,38107-4334,Proprietary  ,16,31,47,236,663,899
03774400,SHEAR ACADEMY                           ,TN,38555-4177,Proprietary  ,1,6,7,18,96,114
03830300,SAE INSTITUTE OF TECHNOLOGY             ,TN,37203-4310,Proprietary  ,3,9,12,187,318,505
03840300,OXFORD GRADUATE SCHOOL                  ,TN,37321-6736,Private      ,0,2,2,4,50,54
03841300,CAREER BEAUTY COLLEGE                   ,TN,38464-3634,Proprietary  ,4,6,10,31,74,105
03920300,INSTITUTE OF HAIR DESIGN                ,TN,38310-1801,Proprietary  ,2,4,6,28,86,114
03930300,BUCHANAN BEAUTY COLLEGE                 ,TN,37160-2741,Proprietary  ,0,11,11,44,119,163
03982300,VISIBLE SCHOOL - MUSIC AND WORSHIPS ARTS,TN,38104-5814,Private      ,2,2,4,177,145,322
04035300,TENNESSEE CAREER INSTITUTE              ,TN,38401-6335,Proprietary  ,3,16,19,85,293,378
04124100,ELITE COLLEGE OF COSMETOLOGY            ,TN,38351-1431,Proprietary  ,2,10,12,42,104,146
04157200,LOVE BEAUTY SCHOOL                      ,TN,37355-2950,Proprietary  ,2,4,6,32,117,149
04165000,MERIDIAN INSTITUTE OF SURGICAL ASSISTING,TN,37080-0758,Proprietary  ,0,4,4,7,362,369
04174600,NASHVILLE BARBER AND STYLE ACADEMY      ,TN,37208-2826,Proprietary  ,5,11,16,95,282,377
04210200,MID-SOUTH CHRISTIAN COLLEGE             ,TN,38118-3151,Private      ,4,5,9,4,5,9
04213800,SALON PROFESSIONAL ACADEMY (THE)        ,TN,37214-2163,Proprietary  ,1,8,9,41,68,109
00353700,ABILENE CHRISTIAN UNIVERSITY            ,TX,79699-3701,Private      ,22,42,64,6365,1902,8267
00353900,ALVIN COMMUNITY COLLEGE                 ,TX,77511-4807,Public       ,32,102,134,1890,3634,5524
00354000,AMARILLO COLLEGE                        ,TX,79109-2446,Public       ,53,211,264,4040,8107,12147
00354100,ANGELO STATE UNIVERSITY                 ,TX,76909-5069,Public       ,48,78,126,7498,3705,11203
00354300,AUSTIN COLLEGE                          ,TX,75090-4440,Private      ,6,3,9,2461,319,2780
00354400,AUSTIN PRESBYTERIAN THEOLOGICAL SEM     ,TX,78705-5797,Private      ,0,0,0,12,192,204
00354500,BAYLOR UNIVERSITY                       ,TX,76798-7048,Private      ,90,76,166,27319,6162,33481
00354600,COASTAL BEND COLLEGE                    ,TX,78102-2197,Public       ,46,89,135,1707,2437,4144
00354900,BLINN COLLEGE                           ,TX,77833-4098,Public       ,161,138,299,14475,6642,21117
00355300,CISCO JUNIOR COLLEGE                    ,TX,76437-9803,Public       ,23,41,64,2386,3058,5444
00355400,CLARENDON COLLEGE                       ,TX,79226-0000,Public       ,19,47,66,610,774,1384
00355600,COMMONWEALTH INST OF FUNERAL SVC        ,TX,77090-5918,Private      ,0,12,12,97,593,690
00355700,CONCORDIA UNIVERSITY TEXAS              ,TX,78726-4141,Private      ,10,117,127,2008,3213,5221
00355800,NORTH CENTRAL TEXAS COLLEGE             ,TX,76240-4699,Public       ,57,158,215,4181,6327,10508
00356000,DALLAS BAPTIST UNIVERSITY               ,TX,75211-9299,Private      ,27,120,147,4112,5497,9609
00356100,CEDAR VALLEY COLLEGE                    ,TX,75134-0000,Public       ,67,204,271,2692,6051,8743
00356200,DALLAS THEOLOGICAL SEM                  ,TX,75204-0000,Private      ,1,12,13,44,954,998
00356300,DEL MAR COLLEGE                         ,TX,78404-3897,Public       ,79,277,356,5938,9561,15499
00356400,EAST TEXAS BAPTIST UNIVERSITY           ,TX,75670-1423,Private      ,3,9,12,1897,618,2515
00356500,TEXAS A&M UNIVERSITY - COMMERCE         ,TX,75429-3011,Public       ,28,210,238,6465,9985,16450
00356800,FRANK PHILLIPS COLLEGE                  ,TX,79008-0000,Public       ,7,35,42,474,672,1146
00357000,GRAYSON COUNTY COLLEGE                  ,TX,75020-8299,Public       ,32,129,161,1974,4892,6866
00357100,HARDIN-SIMMONS UNIVERSITY               ,TX,79698-6050,Private      ,14,22,36,2512,1185,3697
00357200,TRINITY VALLEY COMMUNITY COLLEGE        ,TX,75751-2734,Public       ,64,125,189,3085,5566,8651
00357300,HILL COLLEGE                            ,TX,76645-2711,Public       ,9,49,58,1101,1849,2950
00357301,HILL COLLEGE                            ,TX,76031-0000,Public       ,23,63,86,1119,2635,3754
00357400,HOWARD COLLEGE                          ,TX,79720-0213,Public       ,27,56,83,1756,2819,4575
00357500,HOWARD PAYNE UNIVERSITY                 ,TX,76801-2715,Private      ,8,5,13,1590,458,2048
00357600,HOUSTON BAPTIST UNIVERSITY              ,TX,77074-3298,Private      ,40,58,98,5861,3994,9855
00357700,HUSTON - TILLOTSON UNIVERSITY           ,TX,78702-2795,Private      ,26,29,55,1435,1167,2602
00357800,UNIVERSITY OF THE INCARNATE WORD        ,TX,78209-6398,Private      ,25,143,168,7899,8690,16589
00357900,JACKSONVILLE COLLEGE                    ,TX,75766-4759,Private      ,2,4,6,307,268,575
00358000,KILGORE COLLEGE                         ,TX,75662-3299,Public       ,40,78,118,3602,5534,9136
00358100,LAMAR UNIVERSITY-BEAUMONT               ,TX,77710-0042,Public       ,64,479,543,9903,12319,22222
00358200,LAREDO COMMUNITY COLLEGE                ,TX,78040-4395,Public       ,120,92,212,6903,4750,11653
00358300,LEE COLLEGE                             ,TX,77520-4796,Public       ,29,93,122,2065,4710,6775
00358400,LETOURNEAU UNIVERSITY                   ,TX,75607-0000,Private      ,7,68,75,1784,3179,4963
00358500,LON MORRIS COLLEGE                      ,TX,75766-2900,Private      ,0,0,0,432,168,600
00358600,LUBBOCK CHRISTIAN UNIVERSITY            ,TX,79407-2099,Private      ,11,29,40,1891,1824,3715
00358800,UNIVERSITY OF MARY HARDIN-BAYLOR        ,TX,76513-2599,Private      ,18,59,77,4782,2091,6873
00359000,MCLENNAN COMMUNITY COLLEGE              ,TX,76708-1498,Public       ,67,177,244,5052,9210,14262
00359100,MCMURRY UNIVERSITY                      ,TX,79697-0001,Private      ,9,26,35,2051,963,3014
00359200,MIDWESTERN STATE UNIVERSITY             ,TX,76308-2099,Public       ,26,66,92,4767,3625,8392
00359300,NAVARRO COLLEGE                         ,TX,75110-4818,Public       ,125,244,369,5476,7861,13337
00359400,UNIVERSITY OF NORTH TEXAS               ,TX,76203-5017,Public       ,142,350,492,35529,24349,59878
00359500,OBLATE SCHOOL OF THEOLOGY               ,TX,78216-0000,Private      ,1,3,4,11,85,96
00359600,ODESSA COLLEGE                          ,TX,79764-7127,Public       ,29,76,105,1884,3119,5003
00359800,OUR LADY OF THE LAKE UNIVERSITY         ,TX,78207-4689,Private      ,15,135,150,2886,4232,7118
00359900,UNIVERSITY OF TEXAS - PAN AMERICAN      ,TX,78541-2999,Public       ,173,215,388,19449,11975,31424
00360000,PANOLA COLLEGE                          ,TX,75633-2397,Public       ,18,62,80,1188,2456,3644
00360100,PARIS JR COLLEGE                        ,TX,75460-6298,Public       ,58,136,194,2420,4449,6869
00360200,PAUL QUINN COLLEGE                      ,TX,75241-4398,Private      ,32,36,68,486,1009,1495
00360300,RANGER COLLEGE                          ,TX,76470-3298,Public       ,16,38,54,807,1001,1808
00360305,RANGER COLLEGE-STEPHENVILE BEAUTY COLLEG,TX,76401-5136,Public       ,4,2,6,87,120,207
00360400,RICE UNIVERSITY                         ,TX,77251-1892,Private      ,28,52,80,12005,3955,15960
00360600,SAM HOUSTON STATE UNIVERSITY            ,TX,77340-0000,Public       ,116,265,381,21680,11201,32881
00360700,ALAMO CMTY CLG DISTRICT PROGRAM         ,TX,78207-0000,Public       ,26,102,128,2376,4475,6851
00360800,ST PHILLIPS COLLEGE                     ,TX,78203-2098,Public       ,62,255,317,6631,13799,20430
00360900,SAN JACINTO CLG-CENTRAL-NORTH-SOUTH     ,TX,77501-0000,Public       ,217,511,728,12168,19559,31727
00361000,SCHREINER UNIVERSITY                    ,TX,78028-5697,Private      ,3,11,14,1572,595,2167
00361100,SOUTH PLAINS COLLEGE                    ,TX,79336-6504,Public       ,56,137,193,5439,6227,11666
00361200,UNIV OF HOUSTON-DOWNTOWN                ,TX,77002-1001,Public       ,129,341,470,14389,21172,35561
00361300,SOUTHERN METHODIST UNIVERSITY           ,TX,75275-0181,Private      ,23,86,109,9323,6558,15881
00361400,SOUTHWEST TEXAS JR COLLEGE              ,TX,78801-6221,Public       ,54,81,135,2999,3124,6123
00361500,TEXAS STATE UNIVERSITY--SAN MARCOS      ,TX,78666-4602,Public       ,223,196,419,38805,17986,56791
00361600,SOUTHWESTERN ASSEMBLIES OF GOD UNIV     ,TX,75165-2397,Private      ,3,18,21,1791,1511,3302
00361800,SOUTHWESTERN CHRISTIAN COLLEGE          ,TX,75160-3400,Private      ,0,1,1,252,251,503
00361900,SOUTHWESTERN ADVENTIST UNIVERSITY       ,TX,76059-1922,Private      ,5,6,11,811,494,1305
00362000,SOUTHWESTERN UNIVERSITY                 ,TX,78626-6111,Private      ,10,6,16,2571,388,2959
00362100,ST EDWARDS UNIVERSITY                   ,TX,78704-0000,Private      ,12,48,60,6005,3676,9681
00362300,ST MARY'S UNIV OF SAN ANTONIO           ,TX,78228-8500,Private      ,19,54,73,6027,4200,10227
00362400,STEPHEN F AUSTIN STATE UNIVERSITY       ,TX,75962-0001,Public       ,191,181,372,17854,6460,24314
00362500,SUL ROSS STATE UNIVERSITY               ,TX,79832-0113,Public       ,12,73,85,1814,2184,3998
00362600,TARRANT COUNTY COLLEGE                  ,TX,76102-6599,Public       ,398,1164,1562,21642,39777,61419
00362700,TEMPLE COLLEGE                          ,TX,76504-7435,Public       ,58,239,297,2679,7188,9867
00362800,TEXARKANA COLLEGE                       ,TX,75599-0001,Public       ,35,171,206,1751,3771,5522
00363000,PRAIRIE VIEW A&M UNIVERSITY             ,TX,77446-2967,Public       ,146,99,245,13024,7422,20446
00363100,TARLETON STATE UNIVERSITY               ,TX,76402-0000,Public       ,84,203,287,9695,8320,18015
00363200,TEXAS A&M UNIVERSITY                    ,TX,77842-0000,Public       ,230,152,382,48200,12257,60457
00363400,TEXAS STATE TECHNICAL CLG AT WACO       ,TX,76705-1695,Public       ,54,142,196,3430,5238,8668
00363500,TEXAS CHIROPRACTIC COLLEGE              ,TX,77505-1699,Private      ,0,8,8,37,380,417
00363600,TEXAS CHRISTIAN UNIVERSITY              ,TX,76129-0001,Private      ,39,44,83,16011,5393,21404
00363700,JARVIS CHRISTIAN COLLEGE                ,TX,75765-1470,Private      ,12,4,16,744,276,1020
00363800,TEXAS COLLEGE                           ,TX,75702-4500,Private      ,39,21,60,1289,1235,2524
00363900,TEXAS A&M UNIVERSITY-KINGSVILLE         ,TX,78363-8203,Public       ,47,155,202,10157,8246,18403
00364100,TEXAS LUTHERAN UNIVERSITY               ,TX,78155-5999,Private      ,7,4,11,2470,424,2894
00364200,TEXAS SOUTHERN UNIVERSITY               ,TX,77004-4598,Public       ,147,183,330,12630,16540,29170
00364400,TEXAS TECH UNIVERSITY                   ,TX,79409-2011,Public       ,136,168,304,29898,13451,43349
00364500,TEXAS WESLEYAN UNIVERSITY               ,TX,76105-1536,Private      ,11,49,60,1862,4782,6644
00364600,TEXAS WOMAN'S UNIVERSITY                ,TX,76204-5587,Public       ,36,184,220,9819,15906,25725
00364700,TRINITY UNIVERSITY                      ,TX,78212-7200,Private      ,4,30,34,4222,1219,5441
00364800,TYLER JUNIOR COLLEGE                    ,TX,75701-3436,Public       ,93,158,251,8755,9228,17983
00365100,UNIVERSITY OF DALLAS                    ,TX,75062-4799,Private      ,9,27,36,2474,2139,4613
00365200,UNIVERSITY OF HOUSTON                   ,TX,77204-2010,Public       ,183,382,565,39402,34184,73586
00365400,UNIVERSITY OF ST THOMAS                 ,TX,77006-4626,Private      ,20,54,74,2032,3438,5470
00365600,UNIVERSITY OF TEXAS-ARLINGTON           ,TX,76019-0000,Public       ,96,475,571,26162,33864,60026
00365800,UNIVERSITY OF TEXAS-AUSTIN              ,TX,78713-7758,Public       ,173,264,437,51100,24417,75517
00365900,UT HEALTH CENTER-SAN ANTONIO            ,TX,78229-3900,Public       ,19,68,87,1834,4961,6795
00366100,UNIVERSITY OF TEXAS-EL PASO             ,TX,79968-0629,Public       ,178,312,490,18829,16354,35183
00366200,VICTORIA COLLEGE                        ,TX,77901-4494,Public       ,41,147,188,2006,3810,5816
00366300,WAYLAND BAPTIST UNIVERSITY              ,TX,79072-6998,Private      ,14,200,214,1775,5194,6969
00366400,WEATHERFORD COLLEGE                     ,TX,76086-5699,Public       ,20,76,96,2855,4370,7225
00366500,WEST TEXAS A&M UNIVERSITY               ,TX,79016-0000,Public       ,65,120,185,6693,4485,11178
00366800,WHARTON COUNTY JR COLLEGE               ,TX,77488-3298,Public       ,50,89,139,3708,4193,7901
00366900,WILEY COLLEGE                           ,TX,75670-5199,Private      ,13,13,26,1448,1016,2464
00400300,CENTRAL TEXAS COLLEGE                   ,TX,76540-4199,Public       ,81,1335,1416,3706,23969,27675
00407221,NORTHWOOD UNIVERSITY                    ,TX,75104-0000,Private      ,5,15,20,699,978,1677
00445300,EL CENTRO COLLEGE                       ,TX,75202-3604,Public       ,74,482,556,6114,16110,22224
00450303,EVEREST COLLEGE - FORT WORTH SOUTH      ,TX,76115-1407,Proprietary  ,17,97,114,321,1648,1969
00481102,EVEREST INSTITUTE - EVEREST COLLEGE     ,TX,76011-6630,Proprietary  ,20,109,129,331,1461,1792
00494800,TEXAS A&M UNIV SYSTEM HEALTH SCI CT     ,TX,77840-7896,Public       ,10,13,23,2082,2785,4867
00494900,BAYLOR COLLEGE OF MEDICINE              ,TX,77030-0000,Private      ,13,20,33,1145,2361,3506
00495100,UNIV OF TEXAS HEALTH SCIENCE CENTER     ,TX,77225-0000,Public       ,14,59,73,1224,5232,6456
00495200,UNIV OF TEXAS MEDICAL BRANCH            ,TX,77550-0000,Public       ,9,65,74,894,3342,4236
00497200,GALVESTON COLLEGE                       ,TX,77550-7447,Public       ,25,85,110,1404,2442,3846
00497700,SOUTH TEXAS COLLEGE OF LAW              ,TX,77002-0000,Private      ,2,8,10,126,2337,2463
00520307,REMINGTON COLLEGE - DALLAS CAMPUS       ,TX,75041-9935,Proprietary  ,4,22,26,175,560,735
00660600,BAPTIST HS SCHOOL OF HEALTH PROFESSIONS ,TX,78229-3234,Proprietary  ,2,17,19,309,1689,1998
00661200,COVENANT SCH OF NSG & ALLIED HEALTH     ,TX,79410-0000,Private      ,2,6,8,230,603,833
00666100,ANGELINA COLLEGE                        ,TX,75902-0000,Public       ,56,144,200,2816,4732,7548
00694100,DALLAS CHRISTIAN COLLEGE                ,TX,75234-7229,Private      ,2,18,20,411,841,1252
00709600,COLLEGE OF THE MAINLAND                 ,TX,77591-2499,Public       ,33,160,193,1490,4220,5710
00728700,BRAZOSPORT COLLEGE                      ,TX,77566-3199,Public       ,65,82,147,1628,2366,3994
00732907,ITT TECHNICAL INSTITUTE                 ,TX,77063-3751,Proprietary  ,27,119,146,518,1464,1982
00732913,ITT TECHNICAL INSTITUTE                 ,TX,76011-3919,Proprietary  ,34,173,207,588,1955,2543
00732975,ITT TECHNICAL INSTITUTE                 ,TX,78249-3303,Proprietary  ,16,90,106,454,1653,2107
00754805,WESTWOOD COLLEGE OF TECHNOLOGY          ,TX,77074-0000,Proprietary  ,1,8,9,126,472,598
00793804,LINCOLN COLLEGE OF TECHNOLOGY - GRAND PR,TX,75052-7605,Proprietary  ,128,76,204,1241,996,2237
00849800,MIMS CLASSIC BEAUTY COLLEGE             ,TX,78216-0000,Proprietary  ,1,6,7,69,167,236
00850300,MOUNTAIN VIEW COLLEGE                   ,TX,75211-6599,Public       ,74,275,349,4925,8979,13904
00850400,RICHLAND COLLEGE                        ,TX,75243-2199,Public       ,115,410,525,6712,12217,18929
00851000,EASTFIELD COLLEGE                       ,TX,75150-2099,Public       ,74,318,392,5496,11013,16509
00907905,EVEREST COLLEGE                         ,TX,75206-5209,Proprietary  ,33,183,216,734,2949,3683
00908200,INTERNATIONAL BUSINESS COLLEGE          ,TX,79903-0000,Proprietary  ,11,36,47,269,811,1080
00916300,SAN ANTONIO COLLEGE                     ,TX,78212-4299,Public       ,119,434,553,14691,23961,38652
00922500,TEXAS STATE TECHNICAL COLLEGE  HARLINGEN,TX,78550-3697,Public       ,65,107,172,4265,4570,8835
00946600,KAPLAN COLLEGE                          ,TX,78216-1899,Proprietary  ,25,117,142,470,1960,2430
00946607,KAPLAN COLLEGE - MCALLEN                ,TX,78503-1622,Proprietary  ,45,42,87,608,975,1583
00946609,KAPLAN COLLEGE - CAREER CENTERS OF TEXAS,TX,78416-9900,Proprietary  ,9,52,61,301,1113,1414
00946610,KAPLAN COLLEGE - CAREER CENTERS OF TEXAS,TX,76103-2310,Proprietary  ,10,50,60,265,1294,1559
00954900,WESTERN TEXAS COLLEGE                   ,TX,79549-9501,Public       ,6,21,27,672,619,1291
00965100,TEXAS A&M INTERNATIONAL UNIVERSITY      ,TX,78041-1900,Public       ,153,84,237,6645,3921,10566
00974100,UNIVERSITY OF TEXAS AT DALLAS           ,TX,75083-0000,Public       ,55,145,200,12028,12219,24247
00976800,UNIVERSITY OF NORTH TEXAS HEALTH SCIENCE,TX,76107-2699,Public       ,5,33,38,790,3277,4067
00979700,MIDLAND COLLEGE                         ,TX,79705-6397,Public       ,15,51,66,1960,2896,4856
00982802,EVEREST INSTITUTE- AUSTIN               ,TX,78754-0000,Proprietary  ,28,134,162,485,1860,2345
00993000,UNIVERSITY OF TEXAS-PERMIAN BASIN       ,TX,79762-0001,Public       ,23,96,119,2500,3195,5695
00993200,TEXAS STATE TECH CLG-WEST TEXAS         ,TX,79556-4108,Public       ,6,32,38,410,762,1172
00993201,TEXAS STATE TECH COLLEGE-ABILENE        ,TX,79601-0000,Public       ,2,22,24,412,978,1390
00993204,TEXAS STATE TECH CLG-BRECKENRIDGE       ,TX,76424-0000,Public       ,0,5,5,69,201,270
00993205,TEXAS STATE TECH COLLEGE-BROWNWOOD      ,TX,76801-0000,Public       ,4,8,12,139,410,549
01001900,UNIV OF TEXAS SOUTHWESTERN MED CTR      ,TX,75390-9096,Public       ,4,26,30,499,2791,3290
01005700,AMERICAN COMMERCIAL COLLEGE             ,TX,79602-1399,Proprietary  ,0,2,2,29,169,198
01005900,AMERICAN COMMERCIAL COLLEGE             ,TX,79761-0000,Proprietary  ,0,11,11,53,196,249
01005901,AMERICAN COMMERCIAL COLLEGE - AMERICAN C,TX,76310-2303,Proprietary  ,3,22,25,76,431,507
01006000,VERNON COLLEGE                          ,TX,76384-4092,Public       ,18,81,99,1422,3079,4501
01011500,UNIVERSITY OF TEXAS-SAN ANTONIO         ,TX,78249-0600,Public       ,156,265,421,39279,22384,61663
01013000,WADE COLLEGE                            ,TX,75207-3199,Proprietary  ,3,16,19,259,562,821
01038700,EL PASO COMMUNITY COLLEGE               ,TX,79998-0000,Public       ,198,407,605,17396,19582,36978
01050900,HALLMARK COLLEGE OF AERONAUTICS         ,TX,78214-0000,Proprietary  ,12,63,75,365,1519,1884
01050901,HALLMARK COLLEGE OF  TECHNOLOGY-        ,TX,78230-1736,Proprietary  ,0,0,0,0,1,1
01063300,HOUSTON COMMUNITY COLLEGE               ,TX,77002-0000,Public       ,470,1620,2090,28627,64131,92758
01067400,TEXAS TECH U HEALTH SCIENCES CENTER     ,TX,79430-0000,Public       ,10,60,70,1696,5775,7471
01076100,DALLAS INSTITUTE OF FUNERAL SERVICE     ,TX,75227-4314,Private      ,1,18,19,107,548,655
01114500,LONE STAR COLLEGE SYSTEM                ,TX,77073-3499,Public       ,476,1231,1707,25319,47336,72655
01116100,TEXAS A&M UNIV CORPUS CHRISTI           ,TX,78412-5599,Public       ,65,143,208,12621,7575,20196
01116300,UNIVERSITY OF TEXAS AT TYLER            ,TX,75799-6699,Public       ,30,145,175,5795,6579,12374
01171100,UNIVERSITY OF HOUSTON-CLEAR LAKE        ,TX,77058-1002,Public       ,32,138,170,2781,9442,12223
01201500,AUSTIN COMMUNITY COLLEGE                ,TX,78752-4390,Public       ,268,760,1028,19449,31325,50774
01202000,VICTORIA BEAUTY COLLEGE                 ,TX,77901-6233,Proprietary  ,5,9,14,64,198,262
01226800,BALDWIN BEAUTY SCHOOL #5                ,TX,78704-4785,Proprietary  ,18,20,38,237,551,788
01229700,LAREDO BEAUTY COLLEGE                   ,TX,78040-1051,Proprietary  ,7,15,22,144,336,480
01248200,ATI TECHNICAL TRAINING CENTER           ,TX,75235-4622,Proprietary  ,0,0,0,167,658,825
01248209,ATI CAREER TRAINING CENTER - GARLAND    ,TX,75041-2497,Proprietary  ,0,0,0,28,182,210
01248210,ATI CAREER TRAINING CENTER - WACO       ,TX,76711-1682,Proprietary  ,0,0,0,97,365,462
01248300,COSMETOLOGY CAREER CENTER-A PAUL MITCHEL,TX,75006-2567,Proprietary  ,30,56,86,599,878,1477
01248800,INTERNATIONAL BEAUTY COLLEGE NO 3       ,TX,75040-0000,Proprietary  ,1,7,8,15,91,106
01276400,METROPLEX BEAUTY SCHOOL                 ,TX,75149-0000,Proprietary  ,1,12,13,52,194,246
01293000,CHARLES & SUE'S SCH OF HAIR DESIGN      ,TX,77801-0000,Proprietary  ,3,10,13,89,171,260
01293200,TINT SCHOOL OF MAKEUP & COSMETOLOGY     ,TX,75061-4235,Proprietary  ,2,13,15,63,229,292
01300300,NEILSON BEAUTY COLLEGE                  ,TX,75208-4637,Proprietary  ,2,5,7,49,185,234
01301600,OGLE SCHOOL HAIR SKIN NAILS             ,TX,76013-7400,Proprietary  ,35,82,117,439,1101,1540
01303912,SOUTH UNIVERSITY - THE ART INSTITUTE OF ,TX,75231-5993,Proprietary  ,28,42,70,1950,1907,3857
01303915,SOUTH UNIVERSITY - AUSTIN               ,TX,78729-8101,Proprietary  ,5,59,64,54,348,402
01323100,UNIVERSITY OF HOUSTON-VICTORIA          ,TX,77901-5731,Public       ,19,90,109,2285,4861,7146
02058600,CONLEE'S COLLEGE OF COSMETOLOGY         ,TX,78028-0000,Proprietary  ,1,4,5,25,82,107
02069302,VATTEROTT COLLEGE - VATTEROTT EDUCATION ,TX,75220-5441,Proprietary  ,0,0,0,8,114,122
02074100,CAPITOL CITY TRADE & TECHNICAL SCH      ,TX,78704-0000,Proprietary  ,15,46,61,227,826,1053
02077400,NORTH LAKE COLLEGE                      ,TX,75038-0000,Public       ,49,233,282,3523,7037,10560
02081400,ARLINGTON BAPTIST COLLEGE               ,TX,76012-0000,Private      ,3,6,9,300,497,797
02093600,SOUTHWEST SCHOOL OF ELECTRONIC          ,TX,78735-0000,Proprietary  ,2,4,6,56,176,232
02098300,WESTERN TECHNICAL COLLEGE               ,TX,79927-2105,Proprietary  ,27,84,111,943,1993,2936
02100200,BROOKHAVEN COLLEGE                      ,TX,75244-0000,Public       ,41,252,293,3423,8237,11660
02113610,AMERICAN INTERCONTINENTAL UNIV - HOUSTON,TX,77042-4516,Proprietary  ,5,33,38,328,1661,1989
02116008,SANFORD-BROWN COLLEGE - HOUSTON         ,TX,77042-8900,Proprietary  ,12,34,46,463,1719,2182
02116012,SANFORD-BROWN COLLEGE - HOUSTON NORTH LO,TX,77008-1058,Proprietary  ,3,12,15,173,755,928
02117100,ART INSTITUTE OF HOUSTON                ,TX,77056-0000,Proprietary  ,72,179,251,5934,6385,12319
02119200,COURT REPORTING INSTITUTE OF DALLAS     ,TX,75247-6913,Proprietary  ,0,6,6,62,806,868
02119202,COURT REPORTING INSTIUTE OF DALLAS - COU,TX,77040-6315,Proprietary  ,0,3,3,17,177,194
02128302,INSTITUTE FOR BUSINESS & TECHNOLOGY - LA,TX,78230-2520,Proprietary  ,4,39,43,179,673,852
02136800,AMERICAN COMMERCIAL COLLEGE             ,TX,76904-0000,Proprietary  ,1,10,11,74,275,349
02144800,VET TECH INSTITUTE OF HOUSTON           ,TX,77027-9881,Proprietary  ,3,6,9,427,511,938
02176100,PIPO ACADEMY OF HAIR DESIGN             ,TX,79903-0000,Proprietary  ,1,6,7,95,168,263
02200800,AMERICAN COMMERCIAL COLLEGE             ,TX,79411-0000,Proprietary  ,0,0,0,34,147,181
02218300,SOUTHWEST SCHOOL OF BUSINESS & TECHNICAL,TX,78221-0000,Proprietary  ,6,40,46,193,682,875
02218305,SOUTHWEST SCHOOL OF BUSINESS AND TECHNIC,TX,78501-6053,Proprietary  ,2,14,16,77,211,288
02218306,SOUTHWEST SCHOOL OF BUSINESS AND TECHNIC,TX,78413-2045,Proprietary  ,3,7,10,67,195,262
02224600,TRI-STATE BEAUTY SCHOOL #1              ,TX,79915-0000,Proprietary  ,6,20,26,152,470,622
02230500,OGLE SCHOOL HAIR SKIN NAILS             ,TX,76132-3638,Proprietary  ,38,105,143,414,1205,1619
02230600,OGLE SCHOOL HAIR SKIN NAILS             ,TX,76053-4650,Proprietary  ,25,60,85,171,459,630
02239100,CENTRAL TEXAS BEAUTY COLLEGE #2         ,TX,78664-4204,Proprietary  ,6,34,40,110,497,607
02248200,MILAN INSTITUTE OF COSMETOLOGY          ,TX,79103-0000,Proprietary  ,98,223,321,876,2679,3555
02254800,TEXAS VOCATIONAL SCHOOLS                ,TX,77901-0000,Proprietary  ,1,5,6,84,229,313
02259400,AMBERTON UNIVERSITY                     ,TX,75041-0000,Private      ,1,17,18,35,487,522
02261300,EVEREST INSTITUTE                       ,TX,78213-3841,Proprietary  ,10,85,95,338,1489,1827
02261302,EVEREST INSTITUTE - HOUSTON GREENSPOINT ,TX,77060-3249,Proprietary  ,13,86,99,360,1464,1824
02261303,EVEREST INSTITUTE - HOUSTON HOBBY       ,TX,77087-2737,Proprietary  ,20,120,140,317,1333,1650
02267100,EXPOSITO SCHOOL OF HAIR DESIGN          ,TX,79109-0000,Proprietary  ,2,3,5,45,123,168
02276000,FRANKLIN BEAUTY SCHOOL #2               ,TX,77021-0000,Proprietary  ,7,11,18,163,514,677
02285900,UNIVERSITY OF COSMETOLOGY ARTS&SCI      ,TX,78504-0000,Proprietary  ,18,50,68,256,566,822
02294800,CAPITOL CITY CAREERS                    ,TX,78745-0000,Proprietary  ,0,12,12,63,402,465
02298501,EVEREST COLLEGE- FORT WORTH             ,TX,76137-2472,Proprietary  ,25,104,129,320,1466,1786
02305300,PARKER COLLEGE OF CHIROPRACTIC          ,TX,75229-0000,Private      ,3,25,28,102,1273,1375
02306700,FORT WORTH BEAUTY SCHOOL                ,TX,76116-3299,Proprietary  ,8,37,45,155,549,704
02312200,TEXAS SCHOOL OF BUSINESS                ,TX,77073-6032,Proprietary  ,19,68,87,455,1367,1822
02312201,TEXAS SCHOOL OF BUSINESS - SOUTHWEST CAM,TX,77057-5914,Proprietary  ,0,0,0,152,616,768
02312202,TEXAS SCHOOL OF BUSINESS - FRIENDSWOOD C,TX,77546-8938,Proprietary  ,3,34,37,113,458,571
02312203,TEXAS SCHOOL OF BUSINESS - EAST CAMPUS  ,TX,77029-1916,Proprietary  ,0,0,0,166,571,737
02313901,WESTWOOD COLLEGE - DALLAS               ,TX,75243-0000,Proprietary  ,2,22,24,213,858,1071
02315400,NORTHEAST TEXAS COMMUNITY COLLEGE       ,TX,75456-0000,Public       ,36,55,91,1809,2906,4715
02318200,"KD STUDIO, ACTOR'S CONSERVATORY         ",TX,75207-2111,Proprietary  ,12,16,28,214,420,634
02320200,HOUSTON GRADUATE SCHOOL OF THEOLOGY     ,TX,77092-0000,Private      ,0,9,9,22,345,367
02326000,SAN ANTONIO BEAUTY COLLEGE NO 3         ,TX,78217-0000,Proprietary  ,1,10,11,131,252,383
02331200,BAPTIST MISSIONARY ASSN THEOL SEM       ,TX,75766-0000,Private      ,1,2,3,12,90,102
02331300,INTERACTIVE LEARNING SYSTEMS            ,TX,77502-1201,Proprietary  ,6,44,50,39,401,440
02331301,INTERACTIVE LEARNING SYSTEMS            ,TX,77081-0000,Proprietary  ,25,109,134,160,939,1099
02331304,INTERACTIVE LEARNING SYSTEMS            ,TX,77060-0000,Proprietary  ,6,45,51,45,410,455
02341300,PALO ALTO COLLEGE                       ,TX,78224-0000,Public       ,61,160,221,6201,8870,15071
02348500,LAMAR STATE COLLEGE-PORT ARTHUR         ,TX,77640-0000,Public       ,23,58,81,1387,3065,4452
02357700,PAUL MITCHELL THE SCHOOL                ,TX,77043-3412,Proprietary  ,17,38,55,404,940,1344
02358200,LAMAR STATE COLLEGE-ORANGE              ,TX,77630-0000,Public       ,19,59,78,1075,2645,3720
02361400,COLLIN COUNTY COMMUNITY COLLEGE         ,TX,75071-0000,Public       ,129,437,566,9429,15707,25136
02362000,UNIVERSAL TECHNICAL INSTITUTE           ,TX,77073-0000,Proprietary  ,94,165,259,4940,4527,9467
02362800,AUSTIN GRADUATE SCHOOL OF THEOLOGY      ,TX,78752-1333,Private      ,0,4,4,25,180,205
02521200,ARLINGTON CAREER INSTITUTE              ,TX,75050-0000,Proprietary  ,1,13,14,78,477,555
02521800,SEGUIN BEAUTY SCHOOL                    ,TX,78155-0000,Proprietary  ,4,15,19,88,173,261
02527500,HOUSTON TRAINING SCHOOLS                ,TX,77029-0000,Proprietary  ,17,88,105,272,1388,1660
02530700,SEBRING CAREER SCHOOLS                  ,TX,77083-1510,Proprietary  ,1,14,15,30,174,204
02548800,SOUTH TEXAS VO-TECH INSTITUTE           ,TX,78596-0000,Proprietary  ,11,33,44,312,426,738
02548802,SOUTH TEXAS VOCATIONAL TECHNICAL INSTITU,TX,78520-8710,Proprietary  ,19,31,50,304,415,719
02549400,SOUTH TEXAS VO-TECH INSTITUTE           ,TX,78501-0000,Proprietary  ,26,39,65,403,729,1132
02549402,SOUTH TEXAS VOCATIONAL TECHNICAL INSTITU,TX,78416-1141,Proprietary  ,24,49,73,217,613,830
02555400,UNIV OF TX MD ANDERSON CANCER CTR       ,TX,77030-0000,Public       ,3,16,19,229,920,1149
02567200,OFFICE CAREER CENTER                    ,TX,76180-0000,Proprietary  ,0,0,0,0,1,1
02568100,TEXAS BARBER COLLEGE                    ,TX,77063-3949,Proprietary  ,6,43,49,310,1174,1484
02568101,TEXAS BARBER COLLEGES & HAIRSTYLING SCHO,TX,75228-3841,Proprietary  ,9,32,41,72,328,400
02568106,TEXAS BARBER COLLEGES & HAIRSTYLING SCHO,TX,77009-0000,Proprietary  ,4,15,19,73,245,318
02568107,TEXAS BARBER COLLEGES & HAIRSTYLING SCHO,TX,77063-3951,Proprietary  ,5,18,23,56,245,301
02568108,TEXAS BARBER COLLEGES & HAIRSTYLING SCHO,TX,75241-1327,Proprietary  ,8,40,48,85,371,456
02568109,TEXAS BARBER COLLEGES & HAIRSTYLING SCHO,TX,77301-4407,Proprietary  ,0,6,6,27,89,116
02569300,LE CORDON BLEU COLLEGE OF CULINARY ARTS ,TX,78758-3647,Proprietary  ,61,194,255,1877,4737,6614
02572000,COMPUTER CAREER CENTER                  ,TX,79925-2021,Proprietary  ,58,240,298,795,2928,3723
02572004,COMPUTER CAREER CENTER - AMARILLO CAMPUS,TX,79101-2404,Proprietary  ,10,38,48,169,656,825
02572005,COMPUTER CAREER CENTER - LUBBOCK CAMPUS ,TX,79414-3517,Proprietary  ,12,57,69,208,853,1061
02572008,VISTA COLLEGE - BEAUMONT                ,TX,77701-3717,Proprietary  ,3,22,25,4,29,33
02572009,VISTA COLLEGE - LONGVIEW                ,TX,75604-1905,Proprietary  ,8,39,47,10,71,81
02572011,VISTA COLLEGE - KILLEEN                 ,TX,76541-7436,Proprietary  ,13,69,82,21,121,142
02591100,CAREER POINT COLLEGE                    ,TX,78201-2027,Proprietary  ,18,227,245,431,3354,3785
02591900,KAPLAN COLLEGE                          ,TX,79907-1525,Proprietary  ,12,85,97,670,1662,2332
02591905,KAPLAN COLLEGE - BROWNSVILLE            ,TX,78521-9905,Proprietary  ,14,47,61,310,734,1044
02596400,REDSTONE COLLEGE - LOS ANGELES          ,TX,77061-0000,Proprietary  ,20,55,75,238,467,705
02596500,ATI CAREER TRAINING CENTER              ,TX,76180-1599,Proprietary  ,0,0,0,140,623,763
02596503,ATI- CAREER TRAINING CENTER - HOUSTON (#,TX,77029-1978,Proprietary  ,0,0,0,134,513,647
02596600,ATI-CAREER TRAINING CENTER              ,TX,75220-4443,Proprietary  ,0,0,0,98,539,637
02596601,ATI CAREER TRAINING CENTER - RICHARDSON ,TX,75081-1948,Proprietary  ,0,1,1,39,171,210
02596602,ATI CAREER TRAINING CENTER - DALLAS (STE,TX,75247-6103,Proprietary  ,0,0,0,249,1025,1274
02600200,OCEAN CORPORATION (THE)                 ,TX,77099-3479,Proprietary  ,8,47,55,263,1232,1495
02604700,CENTER FOR ADVANCED LEGAL STUDIES       ,TX,77098-4151,Proprietary  ,1,22,23,54,605,659
02606202,EVEREST COLLEGE - EVEREST INSTITUTE - BI,TX,77036-8014,Proprietary  ,30,153,183,446,2174,2620
02615000,SANFORD-BROWN COLLEGE                   ,TX,75247-6931,Proprietary  ,9,41,50,611,2235,2846
03009400,SW SCH BUS & TECH CAREERS               ,TX,78212-2840,Proprietary  ,2,19,21,66,284,350
03010604,VIRGINIA COLLEGE - VIRGINIA COLLEGE AT A,TX,78723-0000,Proprietary  ,5,25,30,214,1179,1393
03011800,UNIVERSITY OF COSMETOLOGY ARTS & SCIENCE,TX,78226-1160,Proprietary  ,5,16,21,141,230,371
03019800,PCI HEALTH TRAINING CENTER              ,TX,75247-4720,Proprietary  ,16,66,82,383,1160,1543
03021500,SW SCH BUS & TECH CAREERS               ,TX,78852-4859,Proprietary  ,5,23,28,253,323,576
03025000,TEXAS COLLEGE OF COSMETOLOGY            ,TX,79605-2001,Proprietary  ,4,29,33,102,363,465
03025001,TEXAS COLLEGE OF COSMETOLOGY - SAN ANGEL,TX,76903-4708,Proprietary  ,1,1,2,49,129,178
03026000,DALFORTH AIRCRAFT TECH                  ,TX,75209-3091,Proprietary  ,0,0,0,0,1,1
03026500,REMINGTON COLLEGE - HOUSTON CAMPUS      ,TX,77082-1849,Private      ,66,298,364,1175,3824,4999
03026501,REMINGTON COLLEGE - NORTH HOUSTON CAMPUS,TX,77067-1849,Private      ,4,28,32,237,882,1119
03026506,REMINGTON COLLEGE - FT. WORTH CAMPUS    ,TX,76112-1280,Private      ,18,68,86,398,1460,1858
03028800,CIRCLE J BEAUTY SCHOOL                  ,TX,77587-3714,Proprietary  ,4,20,24,51,299,350
03030608,UTAH COLLEGE OF MASSAGE THERAPY - TEXAS ,TX,75801-4848,Proprietary  ,9,18,27,125,372,497
03030609,UTAH COLLEGE OF MASSAGE THERAPY - TEXAS ,TX,77040-6307,Proprietary  ,12,29,41,57,196,253
03031408,INTERNATIONAL ACADEMY OF DESIGN & TECHNO,TX,78229-2263,Proprietary  ,7,20,27,315,751,1066
03032300,SCHOOL OF AUTOMOTIVE MACHINISTS         ,TX,77055-1803,Proprietary  ,2,13,15,194,436,630
03035200,TINT SCHOOL OF MAKEUP & COSMETOLOGY     ,TX,75229-3734,Proprietary  ,3,32,35,149,481,630
03035300,SOUTHERN CAREERS INSTITUTE              ,TX,78704-5252,Proprietary  ,168,440,608,1145,3802,4947
03035301,SOUTHERN CAREERS INSTITUTE-PHARR        ,TX,78577-2118,Proprietary  ,26,66,92,166,443,609
03035302,SOUTHERN CAREERS INSTITUTE - CORPUS CHRI,TX,78414-2904,Proprietary  ,20,65,85,182,690,872
03035303,SOUTHERN CAREERS INSTITUTE - SAN ANTONIO,TX,78221-4351,Proprietary  ,1,3,4,90,315,405
03035305,SOUTHERN CAREERS INSTITUTE - BROWNSVILLE,TX,78520-8680,Proprietary  ,0,1,1,86,135,221
03035306,SOUTHERN CAREERS INSTITUTE - HARLINGEN  ,TX,78550-7911,Proprietary  ,4,3,7,87,148,235
03035307,SOUTHERN CAREERS INSTITUTE - CORPUS CHRI,TX,78410-1609,Proprietary  ,0,0,0,56,162,218
03035308,SOUTHERN CAREERS INSTITUTE - SAN ANTONIO,TX,78238-4114,Proprietary  ,4,5,9,4,5,9
03061800,STAR COLLEGE OF COSMETOLOGY             ,TX,75702-8214,Proprietary  ,3,18,21,154,377,531
03064600,UNIVERSITY OF TEXAS AT BROWNSVILLE      ,TX,78520-4993,Public       ,91,133,224,9654,9466,19120
03073402,ITT TECHNICAL INSTITUTE                 ,TX,75080-2208,Proprietary  ,0,0,0,0,2,2
03075400,ICC TECHNICAL INSTITUTE                 ,TX,77004-2930,Private      ,4,11,15,98,319,417
03076403,BRYMAN SCHOOL OF ARIZONA (THE) - ANTHEM ,TX,75038-4201,Proprietary  ,7,31,38,43,162,205
03079201,WESTWOOD COLLEGE OF TECHNOLOGY          ,TX,76180-0000,Proprietary  ,0,2,2,30,125,155
03103400,SOUTH TEXAS COLLEGE                     ,TX,78501-6699,Public       ,417,398,815,15965,15340,31305
03108700,ROYAL BEAUTY CAREERS                    ,TX,77069-4611,Proprietary  ,7,28,35,171,638,809
03111000,MID-CITIES BARBER COLLEGE               ,TX,75051-4810,Proprietary  ,0,0,0,67,188,255
03115800,KAPLAN COLLEGE                          ,TX,78238-4203,Proprietary  ,12,75,87,400,1500,1900
03115802,KAPLAN COLLEGE - LAREDO                 ,TX,78041-6181,Proprietary  ,1,12,13,214,559,773
03115803,KAPLAN COLLEGE-BEAUMONT                 ,TX,77701-3706,Proprietary  ,11,46,57,222,933,1155
03115804,KAPLAN COLLEGE - LUBBOCK                ,TX,79401-2601,Proprietary  ,6,31,37,203,727,930
03128100,ACADEMY OF HEALTH CARE PROFESSIONS      ,TX,77092-8108,Proprietary  ,58,213,271,750,2987,3737
03144300,NATIONAL BEAUTY COLLEGE                 ,TX,75043-4046,Proprietary  ,6,8,14,32,127,159
03153300,AMER COLL OF ACUPUNCTURE & O.M.         ,TX,77063-4104,Proprietary  ,0,7,7,19,212,231
03156400,ACADEMY OF ORIENTAL MEDICINE AT AUSTIN  ,TX,78757-1132,Proprietary  ,2,7,9,77,413,490
03159300,ARLINGTON MEDICAL INSTITUTE             ,TX,76011-0000,Proprietary  ,3,13,16,211,619,830
03170300,TEXAS A&M UNIVERSITY-TEXARKANA          ,TX,75501-0000,Public       ,11,68,79,1643,2795,4438
03179500,TEXAS COLG TRADITIONAL CHINESE MED      ,TX,78704-6748,Proprietary  ,0,2,2,16,169,185
03189400,COLLEGE OF SAINT THOMAS MORE            ,TX,76109-2323,Private      ,0,0,0,40,91,131
03237400,FARIS COMPUTER SCHOOL                   ,TX,77627-3829,Proprietary  ,1,4,5,2,38,40
03272300,KAPLAN COLLEGE                          ,TX,75234-7288,Proprietary  ,12,55,67,409,1857,2266
03272301,KAPLAN COLLEGE - MIDLAND                ,TX,79703-5531,Proprietary  ,0,7,7,118,420,538
03272303,KAPLAN COLLEGE - ARLINGTON              ,TX,76010-8121,Proprietary  ,12,60,72,346,1401,1747
03275300,TOUCH OF CLASS SCHOOL OF COSM           ,TX,75402-6314,Proprietary  ,6,25,31,70,228,298
03276300,ACADEMY OF HAIR DESIGN                  ,TX,75901-4900,Proprietary  ,4,19,23,106,368,474
03277300,ACADEMY OF HAIR DESIGN                  ,TX,77701-4650,Proprietary  ,6,16,22,83,294,377
03303300,NORTHWEST EDUCATIONAL CENTER            ,TX,77092-7055,Proprietary  ,13,45,58,83,491,574
03371300,TONI&GUY HAIRDRESSING ACADEMY           ,TX,75006-2351,Proprietary  ,5,9,14,214,325,539
03372300,NORTHWEST VISTA COLLEGE                 ,TX,78251-4217,Public       ,104,282,386,10819,12684,23503
03396500,TEXAS STATE TECHNICAL COLG/MARSHALL     ,TX,75672-7402,Public       ,10,20,30,524,810,1334
03400300,CAREER QUEST                            ,TX,78229-3539,Proprietary  ,8,38,46,134,867,1001
03412300,ADVANCED BARBER COLLEGE & HAIR DESI     ,TX,78596-0000,Proprietary  ,10,15,25,117,322,439
03416500,DALLAS NURSING INSTITUTE                ,TX,75243-5502,Proprietary  ,8,63,71,433,2065,2498
03422300,MILAN INSTITUTE                         ,TX,78238-4103,Proprietary  ,89,245,334,1048,2737,3785
03422400,COLLEGE OF BIBLICAL STUDIES-HOUSTON     ,TX,77036-3211,Private      ,2,43,45,116,1345,1461
03424400,MEDVANCE INSTITUTE                      ,TX,77057-7386,Proprietary  ,32,101,133,422,1533,1955
03426300,CAREER ADVANCEMENT CENTER               ,TX,78752-3630,Proprietary  ,29,81,110,134,656,790
03480304,MEDVANCE INSTITUTE OF BATON ROUGE - GRAN,TX,75050-2342,Proprietary  ,3,17,20,127,441,568
03509400,CORYELL COSMETOLOGY COLLEGE             ,TX,76528-2036,Proprietary  ,0,0,0,1,2,3
03520300,LUBBOCK HAIR ACADEMY                    ,TX,79410-3524,Proprietary  ,1,15,16,60,162,222
03542300,CONCORDE CAREER INSTITUTE               ,TX,76011-4016,Proprietary  ,19,74,93,328,1761,2089
03551400,STATE BEAUTY ACADEMY                    ,TX,75116-3501,Proprietary  ,0,0,0,12,49,61
03556400,KUSSAD INSTITUTE OF COURT REPORTING     ,TX,78704-5712,Proprietary  ,0,0,0,8,79,87
03573300,AVIATION INSTITUTE OF MAINTENANCE       ,TX,75209-3017,Proprietary  ,10,60,70,234,1018,1252
03610300,MJ'S BEAUTY ACADEMY INC                 ,TX,75224-4425,Proprietary  ,5,20,25,66,232,298
03612400,VALLEY GRANDE INSTITUTE FOR ACADEMI     ,TX,78596-0000,Private      ,13,51,64,149,529,678
03627300,LAMAR INSTITUTE OF TECHNOLOGY           ,TX,77705-4142,Public       ,20,62,82,2348,3958,6306
03676400,HEALTHY HAIR ACADEMY                    ,TX,75227-0000,Proprietary  ,0,11,11,70,447,517
03680300,JAY'S TECHNICAL INSTITUTE               ,TX,77031-3509,Proprietary  ,3,41,44,74,320,394
03682400,DALLAS BARBER & STYLIST COLLEGE         ,TX,75231-0000,Proprietary  ,8,64,72,205,958,1163
03714300,TREND BARBER COLLEGE                    ,TX,77071-2104,Proprietary  ,7,33,40,165,698,863
03723300,CULINARY INST ALAIN & MARIE LENOTRE     ,TX,77022-4322,Proprietary  ,9,28,37,361,833,1194
03727600,CULINARY ACADEMY OF AUSTIN              ,TX,78752-0000,Proprietary  ,10,31,41,429,650,1079
03731300,INTERNATIONAL RENOWNED BEAUTY ACADE     ,TX,76103-2504,Proprietary  ,0,0,0,37,173,210
03733300,BAPTIST UNIVERSITY OF THE AMERICAS      ,TX,78224-1336,Private      ,0,12,12,142,441,583
03756300,ANAMARC COLLEGE                         ,TX,79930-6230,Proprietary  ,20,66,86,512,1913,2425
03922300,SOUTH TEXAS BARBER COLLEGE              ,TX,78415-3463,Proprietary  ,4,5,9,69,109,178
03944400,PROFESSIONAL CAREERS INSTITUTE          ,TX,77036-2252,Proprietary  ,1,9,10,51,315,366
03944401,PROFESSIONAL CAREERS INSTITUTE          ,TX,77090-3914,Proprietary  ,4,13,17,28,192,220
03970300,HANDS ON THERAPY                        ,TX,75149-2294,Proprietary  ,3,12,15,37,213,250
03987300,TEXAS HEALTH SCHOOL                     ,TX,77079-2106,Proprietary  ,6,36,42,290,927,1217
04036300,SOUTHEAST TEXAS CAREER INSTITUTE        ,TX,77656-8601,Proprietary  ,3,5,8,75,168,243
04045300,NORTHWEST BEAUTY SCHOOL                 ,TX,77091-1208,Proprietary  ,2,12,14,85,265,350
04045400,MAI-TRIX BEAUTY COLLEGE                 ,TX,77040-0000,Proprietary  ,0,10,10,69,249,318
04082300,PROFESSIONAL CAREER TRAINING INSTITUTE  ,TX,77090-0000,Proprietary  ,2,38,40,40,429,469
04089400,CCI TRAINING CENTER                     ,TX,76011-4857,Proprietary  ,8,28,36,83,543,626
04117900,CHAMPION BEAUTY COLLEGE                 ,TX,77069-4611,Proprietary  ,2,14,16,83,418,501
04121800,CRISWELL COLLEGE                        ,TX,75246-1537,Private      ,2,11,13,127,394,521
04125400,ACADEMY AT AUSTIN (THE)                 ,TX,78660-3287,Proprietary  ,9,11,20,148,287,435
04125500,MANUEL AND THERESA'S SCHOOL OF HAIR DESI,TX,77803-3236,Proprietary  ,2,10,12,39,116,155
04129800,MEDIATECH INSTITUTE DALLAS              ,TX,75039-3105,Proprietary  ,6,15,21,182,408,590
04129801,MEDIATECH INSTITUTE - AUSTIN            ,TX,78704-8933,Proprietary  ,8,10,18,147,275,422
04129802,MEDIATECH INSTITUTE HOUSTON             ,TX,77042-4712,Proprietary  ,5,12,17,141,310,451
04131700,SOUTHWEST CAREER COLLEGE                ,TX,79925-6230,Proprietary  ,97,136,233,1028,2321,3349
04135600,CANNON INSTITUTE OF HIGHER LEARNING     ,TX,75247-9998,Proprietary  ,0,5,5,17,132,149
04136500,PCCENTER                                ,TX,75115-4214,Proprietary  ,0,8,8,21,119,140
04138500,CARDIOTECH ULTRASOUND SCHOOL            ,TX,77099-1440,Proprietary  ,1,14,15,129,711,840
04142300,AVEDA INSTITUTE SAN ANTONIO             ,TX,78215-1260,Proprietary  ,11,22,33,397,841,1238
04146700,AVIATION INSTITUTE OF MAINTENANCE       ,TX,77061-4004,Proprietary  ,20,36,56,265,682,947
04146800,SOUTH TEXAS TRAINING CENTER             ,TX,78586-7721,Proprietary  ,5,16,21,51,203,254
04152700,ASTRODOME CAREER CENTERS                ,TX,77054-2678,Proprietary  ,1,15,16,57,287,344
04154800,DUVALL'S SCHOOL OF COSMETOLOGY          ,TX,76021-4159,Proprietary  ,5,12,17,56,159,215
04155800,ADVANCED BEAUTY COLLEGE                 ,TX,75061-1918,Proprietary  ,1,14,15,29,132,161
04158500,TEXAS BEAUTY COLLEGE                    ,TX,76117-3201,Proprietary  ,2,11,13,11,108,119
04160700,AVENUE FIVE INSTITUTE                   ,TX,78757-7000,Proprietary  ,6,21,27,212,500,712
04161100,CORPUS CHRISTI BEAUTY ACADEMY           ,TX,78412-3900,Proprietary  ,1,3,4,76,183,259
04165800,SALON PROFESSIONAL ACADEMY (THE)        ,TX,75067-5390,Proprietary  ,4,5,9,66,153,219
04168700,LAWYER'S ASSISTANT SCHOOL OF DALLAS     ,TX,75201-2829,Proprietary  ,3,27,30,57,487,544
04168800,ABC BEAUTY ACADEMY                      ,TX,75042-8682,Proprietary  ,0,16,16,27,150,177
04169000,SALON & SPA INSTITUTE                   ,TX,78521-1727,Proprietary  ,1,14,15,81,161,242
04169100,DIAMONDS COSMETOLOGY COLLEGE            ,TX,75090-2657,Proprietary  ,2,13,15,33,128,161
04177900,BUCKNER BARBER SCHOOL                   ,TX,75217-1775,Proprietary  ,4,19,23,74,296,370
04178200,VOGUE COLLEGE - SAN ANTONIO             ,TX,78201-5035,Proprietary  ,2,22,24,96,262,358
04178300,VOGUE BEAUTY ACADEMY                    ,TX,78238-4402,Proprietary  ,2,23,25,132,313,445
04178400,VOGUE COLLEGE - MCALLEN                 ,TX,78501-1945,Proprietary  ,7,14,21,97,257,354
04179500,NORTH AMERICAN COLLEGE                  ,TX,77038-0000,Private      ,1,0,1,231,282,513
04184800,EXCEL LEARNING CENTER                   ,TX,79907-1400,Proprietary  ,0,9,9,26,212,238
04187800,CYBERTEX INSTITUTE OF TECHNOLOGY        ,TX,78752-3825,Proprietary  ,1,20,21,17,122,139
04193000,RGV CAREERS AN INSTITUTE FOR HIGHER LEAR,TX,78577-2106,Proprietary  ,9,28,37,32,195,227
04205200,WADE GORDON HAIRDRESSING ACADEMY        ,TX,79121-0548,Proprietary  ,3,13,16,50,165,215
04213300,SPA PROFESSIONALS ACADEMY (THE)         ,TX,78504-2569,Proprietary  ,6,14,20,22,111,133
00367000,BRIGHAM YOUNG UNIVERSITY                ,UT,84602-8406,Private      ,246,361,607,17134,15034,32168
00367100,DIXIE STATE COLLEGE OF UTAH             ,UT,84770-3876,Public       ,48,102,150,5690,5904,11594
00367200,LDS BUSINESS COLLEGE                    ,UT,84101-3500,Private      ,26,30,56,1571,1515,3086
00367400,STEVENS HENAGER COLLEGE                 ,UT,84401-1420,Proprietary  ,261,1838,2099,2536,19520,22056
00367500,UNIVERSITY OF UTAH                      ,UT,84112-9055,Public       ,109,333,442,16284,21251,37535
00367600,UTAH STATE UNIVERSITY - COLLEGE OF EASTE,UT,84501-2699,Public       ,0,0,0,736,678,1414
00367700,UTAH STATE UNIVERSITY                   ,UT,84322-1400,Public       ,120,267,387,13385,14768,28153
00367800,SOUTHERN UTAH UNIVERSITY                ,UT,84720-2470,Public       ,32,110,142,6308,4305,10613
00367900,SNOW COLLEGE                            ,UT,84627-1299,Public       ,24,17,41,3255,1363,4618
00368000,WEBER STATE UNIVERSITY                  ,UT,84408-1136,Public       ,70,316,386,9148,15709,24857
00368100,WESTMINSTER COLLEGE                     ,UT,84105-3697,Private      ,10,54,64,3108,2475,5583
00402700,UTAH VALLEY UNIVERSITY                  ,UT,84058-5999,Public       ,142,389,531,11900,21082,32982
00522000,SALT LAKE COMMUNITY COLLEGE             ,UT,84123-0000,Public       ,261,715,976,11484,24700,36184
00732953,ITT TECHNICAL INSTITUTE                 ,UT,84123-2500,Proprietary  ,33,194,227,552,2305,2857
00943300,SHERMAN KENDALL'S ACADEMY OF BEAUTY     ,UT,84106-1836,Proprietary  ,7,9,16,58,141,199
01009800,NEUMONT UNIVERSITY                      ,UT,84095-0000,Proprietary  ,3,1,4,784,147,931
01116500,UINTAH BASIN APPLIED TECHNOLOGY CLG     ,UT,84066-0000,Public       ,5,16,21,41,208,249
01116600,BROADVIEW UNIVERSITY                    ,UT,84088-4021,Proprietary  ,3,15,18,529,1669,2198
02078800,SHERMAN KENDALL'S ACADEMY OF BEAUTY     ,UT,84047-0000,Proprietary  ,3,5,8,24,67,91
02115400,BRIDGERLAND APPLIED TECHNOLOGY COLLEGE  ,UT,84321-0000,Public       ,10,34,44,523,1365,1888
02156600,DAVIS APPLIED TECHNOLOGY COLLEGE        ,UT,84037-0000,Public       ,11,59,70,631,2121,2752
02178500,EAGLE GATE COLLEGE                      ,UT,84123-0000,Proprietary  ,18,138,156,316,2114,2430
02270800,AMERITECH COLLEGE                       ,UT,84604-6927,Proprietary  ,11,162,173,319,2786,3105
02270802,AMERITECH COLLEGE - DRAPER              ,UT,84020-6545,Proprietary  ,5,21,26,88,746,834
02298500,EVEREST COLLEGE                         ,UT,84119-2668,Proprietary  ,6,67,73,211,1344,1555
02346500,OGDEN-WEBER APPLIED TECHNOLOGY COLG     ,UT,84404-0000,Public       ,20,83,103,721,2866,3587
02360800,PROVO COLLEGE                           ,UT,84601-0000,Proprietary  ,9,51,60,293,1054,1347
02504001,MARINELLO SCHOOL OF BEAUTY - MAIN STREET,UT,84041-3002,Proprietary  ,0,0,0,11,23,34
02531800,PAUL MITCHELL THE SCHOOL - PROVO        ,UT,84606-0000,Proprietary  ,27,32,59,957,1268,2225
02556800,PAUL MITCHELL THE SCHOOL                ,UT,84117-7204,Proprietary  ,16,33,49,284,615,899
02556801,PAUL MITCHELL THE SCHOOL                ,UT,84780-0000,Proprietary  ,5,12,17,80,108,188
02557700,PREMIER HAIR ACADEMY                    ,UT,84120-3603,Proprietary  ,0,0,0,5,18,23
02572700,EVANS HAIRSTYLING COLLEGE               ,UT,84770-0000,Proprietary  ,1,2,3,52,59,111
02572800,VISTA COLLEGE                           ,UT,84015-0000,Proprietary  ,4,39,43,46,577,623
02573100,EVANS HAIRSTYLING COLLEGE               ,UT,84720-0000,Proprietary  ,4,0,4,58,70,128
02612200,MARINELLO SCHOOL OF BEAUTY              ,UT,84604-1585,Proprietary  ,10,12,22,124,174,298
03030600,UTAH COLLEGE OF MASSAGE THERAPY         ,UT,84111-1606,Proprietary  ,13,41,54,324,755,1079
03030601,UTAH CLG OF MASSAGE THER-PROVO CMPS     ,UT,84042-0000,Proprietary  ,9,12,21,83,176,259
03082100,MYOTHERAPY COLLEGE OF UTAH              ,UT,84115-2522,Proprietary  ,1,11,12,30,173,203
03108200,ECHELON EDGE ACADEMY OF HAIR SKIN & NAIL,UT,84070-2004,Proprietary  ,7,9,16,51,110,161
03110400,HAIRITAGE HAIR ACADEMY                  ,UT,84770-5233,Proprietary  ,2,1,3,54,79,133
03339400,WESTERN GOVERNORS UNIVERSITY            ,UT,84107-2533,Private      ,42,1675,1717,1555,54456,56011
03413300,MOUNTAINLAND APPLIED TECHNOLOGY COLLEGE ,UT,84058-5857,Public       ,14,29,43,372,965,1337
03463300,CAREERS UNLIMITED                       ,UT,84058-0000,Proprietary  ,1,3,4,77,219,296
03467308,MARINELLO SCHOOL OF BEAUTY - OGDEN      ,UT,84405-1501,Proprietary  ,12,30,42,104,301,405
03467309,MARINELLO SCHOOL OF BEAUTY - LAYTON     ,UT,84041-3002,Proprietary  ,3,22,25,74,209,283
03617300,HEALING MOUNTAIN MASSAGE SCHOOL         ,UT,84111-0000,Proprietary  ,2,6,8,58,199,257
03829500,SKINWORKS SCHOOL OF ADVANCED SKINCARE   ,UT,84115-0000,Proprietary  ,3,5,8,48,156,204
03838300,NIGHTINGALE COLL. SCH. OF NURSING SCH. O,UT,84403-0000,Proprietary  ,1,8,9,38,220,258
03902300,RENAISSANCE SCHOOL OF THERAPEUTIC MASSAG,UT,84010-2835,Proprietary  ,0,6,6,9,42,51
03909300,MAXIMUM STYLE TEC SCHOOL OF COSMETOLOGY ,UT,84323-4679,Proprietary  ,2,3,5,57,106,163
03921300,CAMEO COLLEGE OF ESSENTIAL BEAUTY       ,UT,84115-0000,Proprietary  ,7,30,37,143,528,671
04054300,SOUTHWEST APPLIED TECHNOLOGY COLLEGE    ,UT,84720-6608,Public       ,4,10,14,113,375,488
04072300,AVEDA INSTITUTE PROVO                   ,UT,84604-1008,Proprietary  ,2,9,11,131,193,324
04118100,IMAGEWORKS ACADEMY OF HAIR DESIGN       ,UT,84660-1210,Proprietary  ,0,0,0,18,100,118
04121700,DIXIE APPLIED TECHNOLOGY COLLEGE        ,UT,84770-3025,Public       ,9,16,25,238,547,785
04142100,SKIN INSTITUTE (THE)                    ,UT,84770-6452,Proprietary  ,3,10,13,32,102,134
04145500,SKIN SCIENCE INSTITUTE (THE)            ,UT,84115-0000,Proprietary  ,3,10,13,53,222,275
04153000,RENAISSANCE ACADEMIE                    ,UT,84604-0000,Proprietary  ,1,7,8,53,80,133
04161900,MANDALYN ACADEMY                        ,UT,84003-2161,Proprietary  ,3,3,6,23,100,123
04165500,ACAYDIA SCHOOL OF AESTHETICS            ,UT,84601-0000,Proprietary  ,5,3,8,45,92,137
04169900,AMERICAN BEAUTY ACADEMY                 ,UT,84651-0000,Proprietary  ,2,5,7,39,70,109
04173200,TAYLOR ANDREWS ACADEMY OF HAIR DESIGN   ,UT,84088-6577,Proprietary  ,7,6,13,116,229,345
04183000,TOP NAILS & HAIR BEAUTY SCHOOL          ,UT,84118-0000,Proprietary  ,4,34,38,7,77,84
04184200,TAYLOR ANDREWS ACADEMY-ST. GEORGE       ,UT,84790-2139,Proprietary  ,4,8,12,89,131,220
04192700,BARBER SCHOOL (THE)                     ,UT,84047-3723,Proprietary  ,4,15,19,43,165,208
04193200,ROCKY MOUNTAIN UNIVERSITY OF HEALTH PROF,UT,84606-7312,Proprietary  ,1,20,21,30,369,399
04210300,MEDSPA ACADEMIES                        ,UT,84095-3519,Proprietary  ,5,11,16,43,180,223
04211500,BEAUTIFUL YOU SCHOOL OF NAIL TECHNOLOGY ,UT,84720-8360,Proprietary  ,1,2,3,1,6,7
04216800,BONNIE JOSEPH ACADEMY OF COSMETOLOGY & B,UT,84032-2044,Proprietary  ,0,2,2,0,23,23
04218300,MIDWIVES COLLEGE OF UTAH                ,UT,84106-2671,Private      ,0,7,7,0,10,10
00368200,BENNINGTON COLLEGE                      ,VT,05201-6001,Private      ,0,1,1,1255,303,1558
00368300,CASTLETON STATE COLLEGE                 ,VT,05735-0000,Public       ,1,2,3,3560,562,4122
00368400,CHAMPLAIN COLLEGE                       ,VT,05401-3950,Private      ,2,31,33,4222,1475,5697
00368402,WOODBURY COLLEGE                        ,VT,05602-0000,Private      ,0,0,0,3,13,16
00368500,COLLEGE OF ST JOSEPH                    ,VT,05701-3899,Private      ,0,1,1,141,261,402
00368600,GODDARD COLLEGE                         ,VT,05667-0000,Private      ,2,11,13,78,1076,1154
00368700,GREEN MOUNTAIN COLLEGE                  ,VT,05764-1199,Private      ,1,4,5,1042,321,1363
00368800,JOHNSON STATE COLLEGE                   ,VT,05656-9898,Public       ,0,6,6,1567,1056,2623
00368900,LYNDON STATE COLLEGE                    ,VT,05851-0919,Public       ,3,3,6,2246,432,2678
00369000,MARLBORO COLLEGE                        ,VT,05344-0300,Private      ,0,2,2,380,153,533
00369100,MIDDLEBURY COLLEGE                      ,VT,05753-0000,Private      ,2,1,3,4620,594,5214
00369200,NORWICH UNIVERSITY                      ,VT,05663-1035,Private      ,6,39,45,3350,1696,5046
00369300,SOUTHERN VERMONT COLLEGE                ,VT,05201-6002,Private      ,0,1,1,776,262,1038
00369400,ST MICHAELS COLLEGE                     ,VT,05439-0001,Private      ,2,13,15,4202,275,4477
00369600,UNIVERSITY OF VERMONT                   ,VT,05405-0160,Public       ,9,35,44,19718,3609,23327
00369700,VERMONT COLLEGE OF FINE ARTS            ,VT,05602-3128,Private      ,0,5,5,30,541,571
00369800,VERMONT TECHNICAL COLLEGE               ,VT,05061-0000,Public       ,1,4,5,1349,965,2314
00857500,SALON PROFESSIONAL ACADEMY (THE)        ,VT,05495-4001,Proprietary  ,2,5,7,65,103,168
00865800,O'BRIENS AVEDA INSTITUTE                ,VT,05403-7747,Proprietary  ,0,1,1,64,119,183
00886000,SIT                                     ,VT,05301-4801,Private      ,1,5,6,180,625,805
01116700,COMMUNITY COLLEGE OF VERMONT            ,VT,05676-0000,Public       ,12,83,95,2078,5232,7310
01193400,VERMONT LAW SCHOOL                      ,VT,05068-0000,Private      ,0,4,4,7,1146,1153
01218300,BURLINGTON COLLEGE                      ,VT,05401-8477,Private      ,0,2,2,336,231,567
02143500,STERLING COLLEGE                        ,VT,05827-0000,Private      ,1,1,2,146,47,193
02254000,NEW ENGLAND CULINARY INSTITUTE          ,VT,05602-0000,Proprietary  ,1,3,4,492,287,779
02532600,LANDMARK COLLEGE                        ,VT,05346-0000,Private      ,5,0,5,560,113,673
03708300,BURLINGTON TECHNICAL CENTER             ,VT,05401-2721,Public       ,0,0,0,17,42,59
04146900,ADVANCED WELDING INSTITUTE              ,VT,05403-0000,Proprietary  ,0,0,0,40,56,96
00392800,CASPER COLLEGE                          ,WY,82601-4612,Public       ,9,44,53,1542,2085,3627
00392900,EASTERN WYOMING COLLEGE                 ,WY,82240-1603,Public       ,1,7,8,543,530,1073
00393000,SHERIDAN COLLEGE                        ,WY,82801-9133,Public       ,14,34,48,1216,1495,2711
00393100,NORTHWEST COLLEGE                       ,WY,82435-1895,Public       ,5,9,14,1072,795,1867
00393200,UNIVERSITY OF WYOMING                   ,WY,82071-3663,Public       ,20,84,104,7770,5601,13371
00393300,WESTERN WYOMING COMMUNITY COLLEGE       ,WY,82902-0000,Public       ,3,9,12,1100,1359,2459
00728900,CENTRAL WYOMING COLLEGE                 ,WY,82501-0000,Public       ,5,26,31,677,1125,1802
00915700,WYOMING TECHNICAL INSTITUTE             ,WY,82072-9519,Proprietary  ,157,85,242,2430,1449,3879
00925900,LARAMIE COUNTY COMMUNITY CLG            ,WY,82007-3299,Public       ,12,70,82,1770,2696,4466
02211900,CHEEKS INTERNATIONAL ACDMY              ,WY,82001-0000,Proprietary  ,3,5,8,84,190,274
00393500,UNIV OF GUAM                            ,GU,96923-0000,Public       ,30,39,69,2770,2035,4805
01536100,GUAM COMMUNITY COLLEGE                  ,GU,96921-0000,Public       ,16,19,35,1850,1827,3677
03438300,PACIFIC ISLANDS UNIVERSITY              ,GU,96913-2619,Private      ,1,2,3,101,126,227
00393600,PONTIFICAL CATHOLIC UNIV OF PR          ,PR,00717-0777,Private      ,31,18,49,7154,5839,12993
00393700,UNIVERSITY OF THE SACRED HEART          ,PR,00914-0383,Private      ,13,22,35,4363,2885,7248
00393800,INTER-AMER UNIV PR-CNTRL ADMN           ,PR,00936-0000,Private      ,58,29,87,4133,6682,10815
00393801,INTER-AMER UNIV PR SCHL LAW             ,PR,00936-8351,Private      ,0,3,3,48,328,376
00393802,INTER AMERICAN UNIVERSITY OF PUERTO RICO,PR,00926-0000,Private      ,8,9,17,1346,1481,2827
00393803,INTER AMERICAN UNIVERSITY OF PR         ,PR,00683-0000,Private      ,11,14,25,4105,2133,6238
00393804,INTER-AMER UNIV PR-RECINTO AGUADILA     ,PR,00605-2000,Private      ,11,9,20,3249,2538,5787
00393805,INTER-AMER UNIV PR-ARECIBO CAMPUS       ,PR,00614-4050,Private      ,8,15,23,3416,2987,6403
00393806,INTER-AMER UNIV PR-BARRANQUITAS REG     ,PR,00794-0517,Private      ,196,20,216,1961,990,2951
00393807,INTER-AMER UNIV PR-FAJARDO REGIONAL     ,PR,00738-0000,Private      ,25,6,31,1538,1286,2824
00393808,INTER-AMER UNIV PR - GUAYAMA CAMPUS     ,PR,00785-4004,Private      ,82,30,112,1344,1606,2950
00393809,INTER-AMER UNIV PR-PONCE REGIONAL       ,PR,00715-0000,Private      ,12,16,28,3831,3677,7508
00393811,INTER-AMER UNIV PR-BAYAMON REG CLG      ,PR,00959-0000,Private      ,10,7,17,4475,2121,6596
00394100,COLEGIO UNIVERSITARIO DEL ESTE          ,PR,00983-0000,Private      ,26,187,213,7830,9239,17069
00394200,UNIVERSITY OF PR-CENTRAL ADMINISTRATION ,PR,00936-4984,Public       ,1,2,3,488,291,779
00394300,UNIVERSITY OF PUERTO RICO - HUMACAO UNIV,PR,00791-4300,Public       ,9,2,11,3473,644,4117
00394400,UNIVERSITY OF PUERTO RICO - MAYAGUEZ    ,PR,00680-0000,Public       ,17,9,26,9664,2331,11995
00501900,UNIV ADVENTISTA DE LAS ANTILLAS         ,PR,00681-0118,Private      ,21,10,31,1017,583,1600
00502200,BAYAMON CENTRAL UNIVERSITY              ,PR,00960-0000,Private      ,63,42,105,1262,1314,2576
00710800,UNIVERSITY OF PUERTO RICO - RIO PIEDRAS ,PR,00931-3300,Public       ,21,16,37,9134,3634,12768
00720600,UNIVERSITY OF PUERTO RICO - CAYEY UNIVER,PR,00736-5534,Public       ,9,4,13,3691,595,4286
00722800,UNIVERSITY OF PUERTO RICO - ARECIBO     ,PR,00614-4010,Public       ,14,4,18,3801,705,4506
00890200,COLUMBIA CENTRO UNIVERSITARIO           ,PR,00726-0000,Proprietary  ,42,78,120,1312,1536,2848
00965200,"UNIVERSITY OF PUERTO RICO, PONCE TECH UN",PR,00716-0000,Public       ,11,4,15,3619,629,4248
01056700,COLEGIO TECNOLOGICO DE SAN JUAN         ,PR,00918-2973,Public       ,4,9,13,868,1060,1928
01072400,CARLOS ALBIZU UNIVERSITY                ,PR,00902-3711,Private      ,0,12,12,127,922,1049
01081900,CONSERVATORIO DE MUSICA DE PUERTO RICO  ,PR,00907-3373,Public       ,2,1,3,349,130,479
01092200,UNIVERSITY OF PUERTO RICO - UTUADO      ,PR,00641-2500,Public       ,9,2,11,1496,274,1770
01097500,UNIVERSITY OF PUERTO RICO BAYAMON TECHNI,PR,00959-1911,Public       ,14,1,15,4893,865,5758
01120300,RYDER MEMORIAL HOSP SCH OF NURSING      ,PR,00792-0000,Private      ,0,0,0,36,15,51
01171900,UNIVERSIDAD DEL TURABO                  ,PR,00778-0000,Private      ,46,235,281,8813,12107,20920
01194000,ICPR JUNIOR COLLEGE                     ,PR,00919-0000,Proprietary  ,194,254,448,1790,2240,4030
01194100,AMERICAN UNIVERSITY OF PUERTO RICO      ,PR,00960-2037,Private      ,35,12,47,951,735,1686
01194101,AMERICAN UNIVERSITY OF PUERTO RICO      ,PR,00674-0000,Private      ,38,14,52,792,674,1466
01212300,"UNIVERSITY OF PUERTO RICO, AGUADILLA REG",PR,00604-0160,Public       ,5,3,8,2925,629,3554
01252500,CARIBBEAN UNIVERSITY                    ,PR,00960-0493,Private      ,44,22,66,2760,3625,6385
02063100,MBTI BUSINESS TRNG INSTITUTE            ,PR,00907-3917,Proprietary  ,120,320,440,1459,4489,5948
02100000,POLYTECHNIC UNIVERSITY OF PR            ,PR,00917-0000,Private      ,5,9,14,2660,2397,5057
02163300,UNIVERSIDAD CENTRAL DEL CARIBE          ,PR,00960-0000,Private      ,2,5,7,241,478,719
02165100,EDP COLLEGE OF PUERTO RICO              ,PR,00919-0000,Private      ,95,97,192,1039,1963,3002
02166000,CENTER FOR ADVANCED STUDIES OF PUER     ,PR,00902-0000,Private      ,0,1,1,11,314,325
02166400,INSTITUTO DE BANCA Y COMERCIO           ,PR,00925-0000,Proprietary  ,432,608,1040,10525,12890,23415
02170300,INST EDUC TECNIA OCUP LA REINA          ,PR,00674-0000,Proprietary  ,26,49,75,315,398,713
02189100,CENTRO DE ESTUDIOS MULTIDISCIPLIN       ,PR,00926-0000,Private      ,81,139,220,1732,2170,3902
02189300,EMMA'S BEAUTY ACADEMY                   ,PR,00680-0000,Proprietary  ,8,7,15,255,177,432
02195400,MODERN HAIRSTYLING INSTITUTE            ,PR,00961-0000,Proprietary  ,23,20,43,784,544,1328
02195500,MODERN HAIRSTYLING INSTITUTE            ,PR,00612-0000,Proprietary  ,0,0,0,6,15,21
02195800,LICEO E ARTE Y TECNOLGIA                ,PR,00919-0000,Proprietary  ,31,45,76,682,775,1457
02195900,MODERN HAIRSTYLING INSTITUTE            ,PR,00980-0000,Proprietary  ,0,1,1,12,11,23
02234900,ANTILLES SCHOOL OF TECH CAREERS         ,PR,00909-3006,Proprietary  ,9,29,38,234,316,550
02241901,COMMONWEALTH OF PR DEPT OF EDUC - CARLOS,PR,00986-0000,Public       ,0,3,3,10,22,32
02241902,COMMONWEALTH OF PR DEPT OF EDUC - TOMAS ,PR,00613-0000,Public       ,2,0,2,4,7,11
02241904,COMMONWEALTH OF PR DEPT OF EDUC - ITPR R,PR,00655-0000,Public       ,4,3,7,590,455,1045
02241905,COMMONWEALTH OF PR DEPT OF EDUC - JOSE A,PR,00674-0000,Public       ,0,1,1,39,26,65
02241907,COMMONWEALTH OF PR DEPT OF EDUC - ITPR R,PR,00928-0000,Public       ,4,0,4,360,319,679
02241908,COMMONWEALTH OF PR DEPT OF EDUC - ITPR R,PR,00732-0000,Public       ,5,3,8,507,361,868
02241909,COMMONWEALTH OF PR DEPT OF EDUC - TROQUE,PR,00959-0000,Public       ,0,1,1,72,19,91
02241910,COMMONWEALTH OF PR DEPT OF EDUC - ITPR R,PR,00701-1091,Public       ,1,2,3,686,326,1012
02260600,NATIONAL COLLEGE OF BUSINESS & TECH     ,PR,00960-2036,Proprietary  ,32,256,288,4354,9198,13552
02260800,HUERTAS JUNIOR COLLEGE                  ,PR,00726-0000,Proprietary  ,32,55,87,1096,1393,2489
02297700,AUTOMECA TECHNICAL COLLEGE              ,PR,00957-0000,Proprietary  ,2,6,8,1216,869,2085
02303800,AMERICAN EDUCATIONAL COLLEGE            ,PR,00961-0000,Proprietary  ,56,106,162,393,678,1071
02335500,COLEGIO BIBLICO PENTECOSTAL DE PR       ,PR,00978-0000,Private      ,1,4,5,27,219,246
02340600,HUMACAO COMMUNITY COLLEGE               ,PR,00792-0000,Private      ,17,34,51,487,649,1136
02343600,INSTITUTE OF BEAUTY CAREERS             ,PR,00613-0000,Proprietary  ,37,24,61,499,440,939
02460000,UNIVERSITY OF PUERTO RICO - MEDICAL SCIE,PR,00936-0000,Public       ,0,15,15,1017,1637,2654
02482400,PONCE SCHOOL OF MEDICINE AND HEALTH SCIE,PR,00716-2347,Private      ,0,1,1,102,758,860
02502400,SERBIA'S SCHOOL OF BEAUTY CULTURE       ,PR,00785-0000,Proprietary  ,8,30,38,164,280,444
02504500,INSTITUCION CHAVIANO DE MAYAGUEZ        ,PR,00708-0000,Proprietary  ,5,14,19,42,171,213
02505400,ATLANTIC COLLEGE                        ,PR,00970-0000,Private      ,13,15,28,1302,493,1795
02534900,PONCE PARAMEDICAL COLLEGE (POPAC)       ,PR,00731-0000,Proprietary  ,67,85,152,2137,1837,3974
02552300,COLEGIO MAYOR DE TECHNOLOGIA            ,PR,00714-0000,Proprietary  ,10,19,29,233,275,508
02562500,INTERNATIONAL TECHNICAL COLLEGE         ,PR,00918-0000,Proprietary  ,7,14,21,89,134,223
02563500,ROGIES SCHOOL OF BEAUTY CULTURE         ,PR,00910-0000,Proprietary  ,5,12,17,115,137,252
02569400,ESCUELA DE ARTES PLASTICAS              ,PR,00902-1112,Public       ,2,0,2,450,178,628
02570400,EDUCATIONAL TECHNICAL COLLEGE           ,PR,00925-3404,Proprietary  ,23,52,75,628,1108,1736
02576100,ESCUELA TECNICA DE ELECTRICIDAD         ,PR,00731-0000,Proprietary  ,12,11,23,284,385,669
02587500,UNIVERSIDAD METROPOLITANA               ,PR,00928-0000,Private      ,31,291,322,7026,10147,17173
02588600,SEMINARIO EVANGELICO DE PUERTO RICO     ,PR,00925-0000,Private      ,1,0,1,2,60,62
02593700,HISPANIC AMERICAN COLLEGE               ,PR,00725-0000,Proprietary  ,43,57,100,264,423,687
03016000,UNIVERSITY OF PUERTO RICO CAROLINA REGIO,PR,00985-0000,Public       ,18,9,27,3729,877,4606
03021900,EDIC COLLEGE                            ,PR,00726-0000,Proprietary  ,2,11,13,1242,1272,2514
03025500,MECH TECH COLLEGE                       ,PR,00725-6118,Proprietary  ,107,130,237,3091,2161,5252
03025900,"LICEO DE ARTE, DISENOS Y COMERCIO       ",PR,00726-0000,Proprietary  ,5,10,15,269,345,614
03029700,"UNIVERSAL TECHNOLOGY CLG OF PR, INC     ",PR,00605-1955,Private      ,36,75,111,569,1134,1703
03061900,COLEGIO TECHNOLOGICO Y COMERCIAL        ,PR,00602-0960,Proprietary  ,3,10,13,38,81,119
03068400,STAR BEAUTY ACADEMY                     ,PR,00961-6312,Proprietary  ,3,15,18,42,108,150
03070500,D'MART INSTITUTE                        ,PR,00794-3517,Proprietary  ,68,80,148,736,1194,1930
03075600,EMMA'S BEAUTY ACADEMY                   ,PR,00795-0000,Proprietary  ,10,5,15,426,239,665
03085700,PROFESSIONAL TECHNICAL INSTITUTION      ,PR,00960-7061,Proprietary  ,15,30,45,241,315,556
03104400,PROFESSIONAL ELECTRIC SCHOOL            ,PR,00674-1797,Proprietary  ,1,5,6,39,46,85
03106900,ESCUELA DE PERITOS ELECTRICITAS         ,PR,00662-0457,Proprietary  ,2,5,7,42,58,100
03112100,JOHN DEWEY COLLEGE                      ,PR,00915-9538,Private      ,111,324,435,2125,4644,6769
03112101,JOHN DEWEY COLLEGE                      ,PR,00986-0000,Private      ,14,45,59,541,995,1536
03112102,JOHN DEWEY COLLEGE-BAYAMON CAMPUS       ,PR,00959-0000,Private      ,12,39,51,248,452,700
03112104,JOHN DEWEY COLLEGE - YABUCOA LRNING SITE,PR,00767-0767,Private      ,3,8,11,129,256,385
03112105,JOHN DEWEY COLLEGE - FAJARDO BRANCH     ,PR,00738-0738,Private      ,12,19,31,130,229,359
03112106,JOHN DEWEY COLLEGE - ARROYO BRANCH      ,PR,00714-0714,Private      ,2,7,9,8,13,21
03112107,JOHN DEWEY COLLEGE - JUANA DIAZ BRANCH  ,PR,00795-0000,Private      ,14,27,41,204,287,491
03112108,JOHN DEWEY COLLEGE - HATILLO CAMPUS     ,PR,00659-0000,Private      ,6,16,22,141,240,381
03112109,JOHN DEWEY COLLEGE - MANATI             ,PR,00674-0000,Private      ,19,48,67,340,562,902
03115900,TRINITY COLLEGE OF PUERTO RICO          ,PR,00734-0000,Private      ,19,27,46,169,236,405
03122500,ACADEMIA SERRANT INC.                   ,PR,00717-1568,Proprietary  ,17,30,47,213,311,524
03123100,GLOBELLE TECHNICAL INSTITUTE            ,PR,00693-4218,Proprietary  ,2,4,6,114,90,204
03124200,NOVA COLLEGE DE PUERTO RICO             ,PR,00960-4016,Proprietary  ,15,43,58,158,341,499
03157600,"COLEGIO DE CINEMATOGRAFIA, ARTES Y TELEV",PR,00961-6345,Proprietary  ,18,10,28,776,483,1259
03177300,SAN JUAN BAUTISTA SCH OF MEDICINE       ,PR,00726-0000,Private      ,0,1,1,32,303,335
03326300,UNIVERSAL CAREER COMMUNITY COLLEGE      ,PR,00907-0000,Proprietary  ,0,0,0,7,11,18
03336300,CENTURY COLLEGE                         ,PR,00603-0000,Proprietary  ,3,17,20,132,181,313
03414300,MONTECLARO                              ,PR,00745-9612,Private      ,1,0,1,25,45,70
03452300,INSTITUTO PRE-VOCACIONAL E INDUSTRI     ,PR,00613-1800,Private      ,6,13,19,95,192,287
03469300,IVAEM COLLEGE                           ,PR,00725-0000,Proprietary  ,1,0,1,128,81,209
03531300,UNIVERSIDAD PENTECOSTAL MIZPA           ,PR,00928-0966,Private      ,0,0,0,27,381,408
03544300,ATENAS COLLEGE                          ,PR,00674-0000,Private      ,25,65,90,1138,1148,2286
03552300,LESTON COLLEGE                          ,PR,00961-6309,Proprietary  ,20,24,44,158,181,339
03585300,CENTRO DE CAPACITACION Y ASESORAMIE     ,PR,00612-0000,Private      ,0,0,0,9,35,44
03608300,CARIBBEAN FORENSIC & TECHNICAL COLL     ,PR,00926-0000,Proprietary  ,1,13,14,50,117,167
03638300,ROSSLYN TRAINING ACADEMY OF COSMETOLOGY ,PR,00602-3225,Proprietary  ,10,9,19,31,80,111
03735400,"CHARLIES GUARD,DETECTIVE BUREAU&ACA     ",PR,00605-0000,Proprietary  ,6,2,8,64,86,150
03751300,ESCUELA HOTELERA DE SAN JUAN            ,PR,00917-0091,Proprietary  ,15,21,36,736,435,1171
03758300,BAYAMON COMMUNITY COLLEGE               ,PR,00960-0000,Proprietary  ,1,14,15,104,306,410
03781400,INDUSTRIAL TECHNICAL COLLEGE            ,PR,00792-0000,Proprietary  ,6,18,24,140,228,368
03785300,J.G. GUAYNABO TECHNICAL COLLEGE         ,PR,00960-0000,Proprietary  ,14,25,39,74,157,231
03800300,COLEGIO TECNICO DE ELECTRICIDAD GALLOSA ,PR,00602-0000,Proprietary  ,0,0,0,18,49,67
03800400,INSTITUTE OF BEAUTY OCCUPATIONS AND TECH,PR,00676-5071,Proprietary  ,17,21,38,112,187,299
03843300,ADVANCED TECH COLLEGE                   ,PR,00961-6321,Proprietary  ,3,11,14,94,178,272
03849300,AGUADILLA TECHNICAL COLLEGE             ,PR,00603-0000,Proprietary  ,0,5,5,30,53,83
03965400,MYRANGEL BEAUTY INSTITUTE               ,PR,00754-3917,Proprietary  ,7,11,18,131,236,367
04030300,"ASPIRA DE PUERTO RICO, ACADEMIA DE TECNO",PR,00987-0000,Private      ,0,0,0,4,13,17
04107300,CARIB TECHNOLOGICAL INSTITUTE           ,PR,00960-0000,Proprietary  ,15,39,54,119,274,393
04117200,INSTITUTO EDUCATIVO PREMIER             ,PR,00731-0000,Proprietary  ,23,35,58,190,304,494
04131600,LIBERTY TECHNICAL COLLEGE               ,PR,00737-1298,Proprietary  ,7,9,16,112,117,229
04164300,GLOBAL INSTITUTE                        ,PR,00725-6485,Proprietary  ,4,6,10,18,41,59
04176000,AMERICAN TECHNICAL INSTITUTE            ,PR,00957-0000,Proprietary  ,2,15,17,41,60,101
00394600,UNIVERSITY OF THE VIRGIN ISLANDS        ,VI,00802-9990,Public       ,7,14,21,1239,982,2221
00394601,UNIV OF THE VIRGIN ISLANDS-ST CROIX     ,VI,00850-0000,Public       ,3,6,9,687,731,1418
00667700,MCGILL UNIVERSITY                       ,CN,00000-0000,Public       ,4,1,5,1672,490,2162
00667900,QUEEN'S UNIVERSITY AT KINGSTON          ,CN,00000-0000,Public       ,0,0,0,117,39,156
00668100,ST FRANCIS XAVIER UNIVERSITY            ,CN,00000-0000,Public       ,0,0,0,39,9,48
00668200,ST THOMAS UNIVERSITY                    ,CN,00000-0000,Public       ,0,1,1,40,9,49
00668300,UNIVERSITY OF GUELPH                    ,CN,00000-0000,Public       ,0,1,1,39,76,115
00668400,UNIVERSITY OF MANITOBA                  ,CN,00000-0000,Public       ,0,0,0,52,37,89
00668500,UNIVERSITY OF NEW BRUNSWICK (THE)       ,CN,00000-0000,Public       ,0,0,0,26,27,53
00668600,UNIVERSITY OF OTTAWA                    ,CN,00000-0000,Public       ,1,1,2,73,68,141
00668800,UNIVERSITY OF TORONTO                   ,CN,00000-0000,Public       ,0,4,4,437,492,929
00668900,UNIVERSITY OF WINDSOR                   ,CN,00000-0000,Public       ,0,0,0,25,54,79
00683700,UNIVERSITE LAVAL                        ,CN,00000-0000,Public       ,0,0,0,14,35,49
00683800,DALHOUSIE UNIVERSITY                    ,CN,00000-0000,Public       ,1,0,1,143,75,218
00685200,BISHOP'S UNIVERSITY                     ,CN,00000-0000,Private      ,1,0,1,73,12,85
00685300,MCMASTER UNIVERSITY                     ,CN,00000-0000,Public       ,0,1,1,28,44,72
00767900,YORK UNIVERSITY                         ,CN,00000-0000,Public       ,0,2,2,108,145,253
00787400,UNIVERSITY AT CALGARY (THE)             ,CN,00000-0000,Public       ,0,1,1,56,75,131
00814800,UNIVERSITY OF WINNIPEG                  ,CN,00000-0000,Public       ,0,0,0,24,15,39
00836200,UNIVERSITY OF ALBERTA (THE)             ,CN,00000-0000,Public       ,0,0,0,54,86,140
00836300,MOUNT SAINT VINCENT UNIVERSITY          ,CN,00000-0000,Public       ,0,0,0,8,5,13
00836400,SAINT MARY'S UNIVERSITY                 ,CN,00000-0000,Public       ,0,0,0,23,20,43
00836500,CONCORDIA UNIVERSITY - SIR GEORGE W     ,CN,00000-0000,Public       ,2,0,2,343,171,514
00836600,UNIVERSITE DE MONTREAL                  ,CN,00000-0000,Public       ,0,1,1,29,80,109
00836800,CARLETON UNIVERSITY                     ,CN,00000-0000,Public       ,1,0,1,79,54,133
00836900,UNIVERSITY OF BRITISH COLUMBIA          ,CN,00000-0000,Public       ,1,6,7,852,589,1441
00837000,"SAFA, UNIVERSITY OF VICTORIA            ",CN,00000-0000,Public       ,1,1,2,123,90,213
00844400,SIMON FRASER UNIVERSITY                 ,CN,00000-0000,Public       ,1,0,1,136,128,264
00844600,UNIVERSITY OF WESTERN ONTARIO (THE)     ,CN,00000-0000,Public       ,0,0,0,59,105,164
00844800,UNIVERSITY OF REGINA                    ,CN,00000-0000,Public       ,0,0,0,10,9,19
00844900,ACADIA UNIVERSITY                       ,CN,00000-0000,Public       ,0,1,1,57,22,79
00852600,UNIVERSITY OF WATERLOO                  ,CN,00000-0000,Public       ,0,0,0,8,1,9
00858200,WILFRID LAURIER UNIVERSITY              ,CN,00000-0000,Public       ,0,0,0,19,13,32
00891300,LAKEHEAD UNIVERSITY                     ,CN,00000-0000,Public       ,0,0,0,10,7,17
00911900,UNIVERSITE DE MONCTON                   ,CN,00000-0000,Public       ,0,0,0,0,2,2
00925200,BROCK UNIVERSITY                        ,CN,00000-0000,Public       ,0,0,0,19,16,35
00936700,UNIVERSITY OF PRINCE EDWARD ISLAND      ,CN,00000-0000,Public       ,0,0,0,31,120,151
00942100,BRANDON UNIVERSITY                      ,CN,00000-0000,Public       ,0,0,0,16,14,30
00948600,TRINITY WESTERN UNIVERSITY              ,CN,00000-0000,Private      ,0,1,1,186,82,268
00950000,MEMORIAL UNIVERSITY OF NEWFOUNDLAND     ,CN,00000-0000,Public       ,0,0,0,17,36,53
00950100,UNIVERSITY OF KING'S COLLEGE            ,CN,00000-0000,Public       ,0,0,0,33,5,38
00950300,MOUNT ALLISON UNIVERSITY                ,CN,00000-0000,Public       ,0,0,0,39,3,42
00950400,NOVA SCOTIA AGRICULTURAL COLLEGE        ,CN,00000-0000,Public       ,0,0,0,1,6,7
00950500,TRENT UNIVERSITY                        ,CN,00000-0000,Public       ,0,0,0,7,9,16
00969800,MEDICINE HAT COLLEGE                    ,CN,00000-0000,Public       ,0,0,0,1,9,10
01012300,NOVA SCOTIA COLLEGE OF ART & DESIGN     ,CN,00000-0000,Public       ,0,0,0,13,22,35
01022100,SAINT PAUL UNIVERSITY                   ,CN,00000-0000,Public       ,1,2,3,3,15,18
01045800,SHERIDAN COLLEGE OF APPLIED ARTS AN     ,CN,00000-0000,Public       ,0,0,0,40,23,63
01067500,REGENT COLLEGE                          ,CN,00000-0000,Private      ,0,1,1,9,97,106
01070300,UNIVERSITY OF LETHBRIDGE                ,CN,00000-0000,Public       ,0,0,0,10,13,23
01072000,RYERSON UNIVERSITY                      ,CN,00000-0000,Public       ,0,0,0,64,89,153
01172200,BRIERCREST BIBLE COLLEGE                ,CN,00000-0000,Private      ,0,0,0,9,9,18
01222800,HUMBER COLLEGE                          ,CN,00000-0000,Public       ,0,0,0,49,65,114
01227400,PROVIDENCE COLLEGE                      ,CN,00000-0000,Private      ,0,0,0,47,6,53
02102100,KINGSWOOD UNIVERSITY                    ,CN,00000-0000,Private      ,1,0,1,68,15,83
02167000,PRAIRIE BIBLE INST                      ,CN,00000-0000,Private      ,0,0,0,17,8,25
02184600,INSTITUTE FOR CHRISTIAN STUDIES         ,CN,00000-0000,Private      ,0,0,0,2,14,16
02195700,TAYLOR UNIVERSITY COLLEGE AND SEMINARY  ,CN,00000-0000,Private      ,0,0,0,1,2,3
02201100,COLUMBIA BIBLE COLLEGE                  ,CN,00000-0000,Private      ,0,0,0,16,12,28
02216400,TYNDALE COLLEGE & SEMINARY              ,CN,00000-0000,Private      ,1,0,1,7,23,30
02219200,UNIVERSITY OF SASKATCHEWAN              ,CN,00000-0000,Public       ,1,0,1,24,29,53
02324900,EMMANUEL BIBLE COLLEGE                  ,CN,00000-0000,Private      ,0,0,0,1,0,1
02338800,EMILY CARR UNIVERSITY OF ART AND DESIGN ,CN,00000-0000,Public       ,0,2,2,87,53,140
02577200,SALVATION ARMY WM & CATHERINE BOOTH     ,CN,00000-0000,Private      ,0,0,0,3,2,5
02593800,CONCORDIA UNIVERSITY COLLEGE            ,CN,00000-0000,Private      ,0,0,0,9,10,19
02611900,THE KING'S UNIVERSITY COLLEGE           ,CN,00000-0000,Private      ,0,0,0,2,5,7
03018300,ROCKY MOUNTAIN COLLEGE: CENTRE FOR BIBLI,CN,00000-0000,Private      ,0,0,0,0,2,2
03033800,UNIVERSITY COLLEGE OF CAPE BRETON       ,CN,00000-0000,Public       ,0,0,0,7,11,18
03078300,VANCOUVER SCHOOL OF THEOLOGY            ,CN,00000-0000,Private      ,0,0,0,2,12,14
03273300,CANADIAN COLLEGE OF NATUROPATHIC ME     ,CN,00000-0000,Private      ,0,0,0,9,43,52
03298300,ALBERTA COLLEGE OF ART & DESIGN         ,CN,00000-0000,Public       ,0,2,2,15,21,36
03332500,KWANTLEN UNIVERSITY COLLEGE             ,CN,00000-0000,Public       ,0,0,0,5,10,15
03335400,CANADIAN UNIVERSITY COLLEGE             ,CN,00000-0000,Private      ,0,0,0,52,20,72
03339300,ST. STEPHENS UNIVERSITY                 ,CN,00000-0000,Private      ,0,0,0,8,5,13
03348500,REDEEMER UNIVERSITY COLLEGE             ,CN,00000-0000,Private      ,0,0,0,8,6,14
03420300,HOLLAND COLLEGE                         ,CN,00000-0000,Public       ,0,0,0,17,10,27
03560400,NIAGARA COLLEGE-WELLAND CAMPUS          ,CN,00000-0000,Public       ,0,0,0,11,12,23
03613300,UNIV OF NORTHERN BRITISH COLUMBIA       ,CN,00000-0000,Public       ,0,0,0,13,23,36
03644400,CANADIAN MENNONITE UNIVERSITY           ,CN,00000-0000,Private      ,0,0,0,8,3,11
03674400,CANADIAN SOUTHERN BAPTIST SEMINARY      ,CN,00000-0000,Private      ,0,0,0,1,4,5
03711300,CAPILANO UNIVERSITY                     ,CN,00000-0000,Public       ,0,0,0,16,31,47
03846300,PACIFIC LIFE BIBLE COLLEGE              ,CN,00000-0000,Private      ,0,0,0,12,4,16
03847300,CRANDALL UNIVERSITY                     ,CN,00000-0000,Private      ,0,0,0,8,2,10
04075300,QUEST UNIVERSITY CANADA                 ,CN,00000-0000,Private      ,0,0,0,130,8,138
04123100,ATLANTIC SCHOOL OF THEOLOGY             ,CN,00000-0000,Public       ,0,0,0,4,11,15
04156700,AMBROSE UNIVERSITY COLLEGE              ,CN,00000-0000,Private      ,0,0,0,8,13,21
00814700,UNIVERSIDAD AUTONOMA DE GUADALAJARA     ,MX,00000-0000,Private      ,0,10,10,111,1270,1381
01041800,INST TEC Y DE ESTSUPER DE MONTERRE      ,MX,00000-0000,Private      ,0,1,1,103,88,191
01067600,UNIVERSIDAD DE MONTERREY                ,MX,00000-0000,Private      ,0,0,0,48,47,95
01093800,UNIVERSIDAD DE GUANAJUATO               ,MX,00000-0000,Public       ,0,0,0,43,50,93
02053300,CENTRO DE ESTUDIOS UNIVERSITARIOS D     ,MX,00000-0000,Private      ,0,0,0,113,172,285
04183900,CETYS UNIVERSIDAD                       ,MX,00000-0000,Private      ,1,0,1,20,12,32
01001000,AMERICAN SAMOA CMNTY COLLEGE            ,AS,96799-2609,Public       ,147,31,178,1556,503,2059
01034300,COLLEGE OF MICRONESIA - FSM             ,FM,96941-0159,Public       ,215,99,314,2611,1194,3805
01100900,PALAU COMMUNITY COLLEGE                 ,PW,96940-0009,Public       ,77,28,105,902,437,1339
03022400,COLLEGE OF THE MARSHALL ISLANDS         ,MH,96960-1258,Public       ,82,74,156,994,488,1482
03033000,NORTHERN MARIANAS COLLEGE               ,MP,96950-0000,Public       ,6,5,11,932,582,1514
