OPE ID,School,State,Zip Code,School Type,20132014Qtr6_Dependent Students,20132014Qtr6_Independent Students,Quarterly Total,YTD_20132014Qtr6_Dependent Students,YTD_20132014Qtr6_Independent Students,Award Year To Date Total
00100200,ALABAMA AGRCLTL & MECHL UNIV            ,AL,35762-1357,Public       ,72,75,147,6639,3897,10536
00100300,FAULKNER UNIVERSITY                     ,AL,36109-3398,Private      ,24,136,160,2152,4550,6702
00100400,UNIVERSITY OF MONTEVALLO                ,AL,35115-6000,Public       ,20,31,51,2647,1644,4291
00100500,ALABAMA STATE UNIVERSITY                ,AL,36101-0000,Public       ,211,133,344,10724,6579,17303
00100700,CENTRAL ALABAMA COMMUNITY COLLEGE       ,AL,35011-0000,Public       ,28,100,128,1551,2183,3734
00100800,ATHENS STATE UNIVERSITY                 ,AL,35611-1999,Public       ,13,95,108,1033,3642,4675
00100900,AUBURN UNIVERSITY                       ,AL,36849-5113,Public       ,102,134,236,19115,7220,26335
00101200,BIRMINGHAM SOUTHERN COLLEGE             ,AL,35254-0002,Private      ,8,21,29,2180,948,3128
00101300,CALHOUN COMMUNITY COLLEGE               ,AL,35609-0000,Public       ,107,290,397,5812,9129,14941
00101500,ENTERPRISE STATE COMMUNITY COLLEGE      ,AL,36331-1300,Public       ,37,66,103,1445,1956,3401
00101600,UNIVERSITY OF NORTH ALABAMA             ,AL,35632-0001,Public       ,39,59,98,5948,3229,9177
00101700,GADSDEN STATE COMMUNITY COLLEGE         ,AL,35903-2269,Public       ,54,193,247,3439,6535,9974
00101800,GEORGE C WALLACE COMMUNITY COLLEGE      ,AL,36303-0943,Public       ,75,190,265,2684,4939,7623
00101900,HUNTINGDON COLLEGE                      ,AL,36106-2148,Private      ,8,29,37,1664,888,2552
00102000,JACKSONVILLE STATE UNIVERSITY           ,AL,36265-1602,Public       ,56,131,187,7468,6154,13622
00102100,JEFFERSON DAVIS COMMUNITY COLLEGE       ,AL,36427-2790,Public       ,22,42,64,736,1009,1745
00102200,JEFFERSON STATE COMMUNITY COLLEGE       ,AL,35215-3098,Public       ,96,286,382,5466,9904,15370
00102300,JUDSON COLLEGE                          ,AL,36756-2504,Private      ,3,5,8,380,176,556
00102400,UNIVERSITY OF WEST ALABAMA              ,AL,35470-0000,Public       ,31,186,217,2807,5227,8034
00102600,MARION MILITARY INSTITUTE               ,AL,36756-3214,Public       ,5,2,7,572,105,677
00102800,MILES COLLEGE                           ,AL,35064-2697,Private      ,154,47,201,2862,1507,4369
00102900,UNIVERSITY OF MOBILE                    ,AL,36613-0000,Private      ,17,46,63,2035,2418,4453
00103000,BISHOP STATE COMMUNITY COLLEGE          ,AL,36603-5898,Public       ,64,189,253,2781,5935,8716
00103100,NORTHEAST ALABAMA STATE CMNTY COLG      ,AL,35986-0159,Public       ,87,136,223,1699,2206,3905
00103300,OAKWOOD COLLEGE                         ,AL,35896-0001,Private      ,6,24,30,2023,1282,3305
00103400,ALABAMA SOUTHERN COMMUNITY COLLEGE      ,AL,36460-5698,Public       ,53,42,95,1361,1169,2530
00103600,SAMFORD UNIVERSITY                      ,AL,35229-7000,Private      ,19,71,90,4070,3254,7324
00103700,SELMA UNIVERSITY                        ,AL,36701-0000,Private      ,0,1,1,0,1,1
00103800,SNEAD STATE COMMUNITY COLLEGE           ,AL,35957-0734,Public       ,20,72,92,1757,2170,3927
00104000,SOUTHERN UNION STATE COMMUNITY CLG      ,AL,36276-0000,Public       ,41,118,159,3785,3760,7545
00104100,SPRING HILL COLLEGE                     ,AL,36608-1791,Private      ,14,25,39,2639,1129,3768
00104400,STILLMAN COLLEGE                        ,AL,35403-0000,Private      ,56,26,82,2007,838,2845
00104600,TALLADEGA COLLEGE                       ,AL,35160-2354,Private      ,16,9,25,1159,606,1765
00104700,TROY UNIVERSITY                         ,AL,36082-0001,Public       ,88,606,694,9815,23388,33203
00105000,TUSKEGEE UNIVERSITY                     ,AL,36088-1645,Private      ,43,18,61,5526,1617,7143
00105100,UNIVERSITY OF ALABAMA (THE)             ,AL,35487-0120,Public       ,167,228,395,29327,12763,42090
00105200,UNIVERSITY OF ALABAMA AT BIRMINGHAM     ,AL,35294-1150,Public       ,77,242,319,12894,14466,27360
00105500,UNIVERSITY OF ALABAMA IN HUNTSVILLE     ,AL,35899-0001,Public       ,40,112,152,5616,5155,10771
00105700,UNIVERSITY OF SOUTH ALABAMA             ,AL,36688-0002,Public       ,104,264,368,11406,11625,23031
00105900,LAWSON STATE COMMUNITY COLLEGE          ,AL,35221-1798,Public       ,79,201,280,2556,4457,7013
00105901,LAWSON STATE COMMUNITY COLLEGE - BESSEME,AL,35021-0308,Public       ,22,73,95,893,1724,2617
00106000,FAULKNER STATE COMMUNITY COLLEGE        ,AL,36507-2698,Public       ,61,159,220,3735,4227,7962
00526000,J.F. DRAKE STATE TECH COLLEGE           ,AL,35811-1584,Public       ,19,101,120,796,2541,3337
00569100,SHELTON STATE COMMUNITY CLG             ,AL,35405-4017,Public       ,112,148,260,4787,4518,9305
00569200,REID STATE TECHNICAL COLLEGE            ,AL,36401-0000,Public       ,17,47,64,289,813,1102
00569700,NORTHWEST- SHOALS COMMUNITY COLLEGE     ,AL,35661-0000,Public       ,137,152,289,2956,2971,5927
00569900,GEORGE C WALLACE STATE CMTY COLLEGE     ,AL,36703-0000,Public       ,114,103,217,1424,2175,3599
00573300,BEVILL STATE CMTY COLLEGE-WALKER        ,AL,35148-0000,Public       ,71,144,215,2524,3762,6286
00573400,H. COUNCILL TRENHOLM STATE TECH COLLEGE ,AL,36108-0020,Public       ,39,91,130,969,2511,3480
00573401,H. C. TRENHOLM ST TECH COL-PATTERSON CAM,AL,36116-2612,Public       ,23,53,76,591,1400,1991
00787100,GEORGE C WALLACE STATE CMTY CLG         ,AL,35077-2000,Public       ,91,156,247,3937,4723,8660
00831000,AUBURN UNIVERSITY-MONTGOMERY            ,AL,36124-0000,Public       ,57,128,185,4950,5345,10295
00898800,LURLEEN B WALLACE COMMUNITY COLLEGE     ,AL,36420-0418,Public       ,34,42,76,1226,1451,2677
01055400,CONCORDIA COLLEGE                       ,AL,36701-3323,Private      ,36,11,47,875,583,1458
01218200,CHATTAHOOCHEE VALLEY CMTY CLG           ,AL,36869-7917,Public       ,29,82,111,1309,2467,3776
01303906,SOUTH UNIVERSITY - MONTGOMERY           ,AL,36116-1120,Proprietary  ,22,120,142,493,1979,2472
02170600,UNITED STATES SPORTS ACADEMY            ,AL,36526-7055,Private      ,4,27,31,50,829,879
02199700,HERITAGE CHRISTIAN UNIVERSITY           ,AL,35630-0000,Private      ,0,3,3,40,104,144
02270400,SOUTHEASTERN BIBLE COLLEGE              ,AL,35244-2083,Private      ,1,7,8,153,353,506
02285000,PAUL MITCHELL THE SCHOOL HUNTSVILLE     ,AL,35758-0000,Proprietary  ,8,13,21,116,231,347
02296000,PRINCE INSTITUTE OF PROFESSIONAL STUDIES,AL,36117-0000,Proprietary  ,0,7,7,56,393,449
02341000,FORTIS COLLEGE                          ,AL,36609-0000,Proprietary  ,44,158,202,870,2927,3797
02503400,AMRIDGE UNIVERSITY                      ,AL,36124-0000,Private      ,1,63,64,94,1401,1495
03010600,VIRGINIA COLLEGE                        ,AL,35209-5154,Proprietary  ,461,2417,2878,4645,26923,31568
03010602,VIRGINIA COLLEGE - HUNTSVILLE           ,AL,35805-0000,Proprietary  ,3,44,47,282,1183,1465
03010607,VIRGINIA COLLEGE - MOBILE               ,AL,36608-1626,Proprietary  ,11,24,35,458,1749,2207
03010616,VIRGINIA COLLEGE - MONTGOMERY           ,AL,36117-2802,Proprietary  ,25,58,83,506,2000,2506
03026516,REMINGTON COLLEGE - MOBILE              ,AL,36609-5593,Private      ,7,18,25,714,1899,2613
03032500,ALABAMA STATE CLG BARBER STYLING        ,AL,35215-0000,Proprietary  ,3,11,14,110,224,334
03361400,FORTIS COLLEGE                          ,AL,36535-0000,Proprietary  ,15,40,55,223,820,1043
03459300,SOUTHEASTERN SCHOOL OF COSMETOLOGY      ,AL,35228-0000,Private      ,3,7,10,50,192,242
03783300,BLUE CLIFF CAREER COLLEGE               ,AL,63306-4749,Proprietary  ,4,18,22,139,435,574
03894300,HUNTSVILLE BIBLE COLLEGE                ,AL,35811-0000,Private      ,0,8,8,35,278,313
04066300,CARDIAC AND VASCULAR INSTITUTE OF ULTRAS,AL,36604-1411,Proprietary  ,1,10,11,71,371,442
04067300,SELMA UNIVERSITY                        ,AL,36701-0000,Private      ,9,16,25,253,706,959
04121500,COLUMBIA SOUTHERN UNIVERSITY            ,AL,36561-3815,Proprietary  ,12,602,614,620,17547,18167
04149200,XCELL ACADEMY-A PAUL MITCHELL PARTNER SC,AL,35216-4990,Proprietary  ,6,21,27,124,335,459
04187200,NEW BEGINNING COLLEGE OF COSMETOLOGY    ,AL,35950-2415,Proprietary  ,2,5,7,77,182,259
04187300,HAIR ACADEMY (THE)                      ,AL,36111-2201,Proprietary  ,4,6,10,75,189,264
04197500,UNIVERSITY ACADEMY OF HAIR DESIGN       ,AL,35476-3100,Proprietary  ,0,5,5,50,112,162
04211000,SALON PROFESSIONAL ACADEMY (THE)        ,AL,35816-1849,Proprietary  ,2,10,12,76,206,282
04217900,NUNATION SCHOOL OF COSMETOLOGY          ,AL,35064-2222,Proprietary  ,0,7,7,0,10,10
04226700,ALABAMA COLLEGE OF OSTEOPATHIC MEDICINE ,AL,36303-2251,Private      ,1,109,110,1,109,110
00111100,ALLAN HANCOCK COLLEGE                   ,CA,93454-6399,Public       ,37,112,149,5402,6264,11666
00111300,ANTELOPE VALLEY COLLEGE                 ,CA,93536-5426,Public       ,181,422,603,8195,14005,22200
00111600,ART CENTER COLLEGE OF DESIGN            ,CA,91103-1999,Private      ,4,16,20,2061,1726,3787
00111700,AZUSA PACIFIC UNIVERSITY                ,CA,91702-7000,Private      ,27,295,322,11044,10636,21680
00111800,BAKERSFIELD COLLEGE                     ,CA,93305-1299,Public       ,207,415,622,11932,13054,24986
00111900,BARSTOW COMMUNITY COLLEGE               ,CA,92311-6608,Public       ,44,249,293,1673,5207,6880
00112000,AMER BAPT SEM OF THE WEST-BERKELEY      ,CA,94704-0000,Private      ,0,1,1,13,68,81
00112200,BIOLA UNIVERSITY                        ,CA,90639-0001,Private      ,8,14,22,6999,2486,9485
00112300,BROOKS INSTITUTE                        ,CA,93103-1809,Proprietary  ,4,5,9,568,479,1047
00112400,CABRILLO COLLEGE                        ,CA,95003-3194,Public       ,80,143,223,5673,6583,12256
00112500,CALIFORNIA BAPTIST UNIVERSITY           ,CA,92504-3297,Private      ,25,157,182,7640,6601,14241
00112700,CALIFORNIA COLLEGE OF THE ARTS          ,CA,94107-2206,Private      ,9,8,17,2498,2112,4610
00113100,CALIFORNIA INSTITUTE OF TECHNOLOGY      ,CA,91125-0001,Private      ,6,10,16,3755,793,4548
00113200,CALIFORNIA INSTITUTE OF THE ARTS        ,CA,91355-2397,Private      ,6,9,15,2824,1719,4543
00113300,CALIFORNIA LUTHERAN UNIVERSITY          ,CA,91360-2787,Private      ,8,64,72,5401,2118,7519
00113400,CALIFORNIA MARITIME ACADEMY             ,CA,94590-8181,Public       ,1,4,5,1145,505,1650
00113700,CALIF STATE UNIV-FULLERTON              ,CA,92831-3599,Public       ,71,145,216,51170,25356,76526
00113800,"CALIFORNIA STATE UNIVERSITY, EAST BAY   ",CA,94542-3000,Public       ,39,117,156,17901,15622,33523
00113900,CALIF STATE UNIV-LONG BEACH             ,CA,90840-0006,Public       ,76,143,219,60579,27153,87732
00114000,CALIF STATE UNIV-LOS ANGELES            ,CA,90032-4226,Public       ,70,158,228,38696,25009,63705
00114100,"CALIF STATE UNIV, DOMINGUEZ HILLS       ",CA,90747-0001,Public       ,40,108,148,19303,17538,36841
00114200,CALIF STATE UNIV SAN BERNARDINO         ,CA,92407-2397,Public       ,64,142,206,22553,15843,38396
00114300,CAL POLY STATE UNIVERSITY               ,CA,93407-0001,Public       ,128,33,161,39847,5259,45106
00114400,CALIF STATE POLYTECHNIC UNIV POMONA     ,CA,91768-2500,Public       ,177,81,258,36921,12881,49802
00114600,CALIF STATE UNIV - CHICO                ,CA,95929-0001,Public       ,41,58,99,23310,7896,31206
00114700,CALIF STATE UNIV - FRESNO               ,CA,93740-8026,Public       ,65,94,159,27033,14174,41207
00114900,HUMBOLDT STATE UNIVERSITY               ,CA,95521-8299,Public       ,15,30,45,13412,4836,18248
00115000,CALIF STATE UNIV-SACRAMENTO             ,CA,95819-6044,Public       ,71,143,214,33781,22130,55911
00115100,SAN DIEGO STATE UNIVERSITY              ,CA,92182-1690,Public       ,92,204,296,60432,23904,84336
00115300,CALIF STATE UNIV-NORTHRIDGE             ,CA,91330-8307,Public       ,93,124,217,43858,24465,68323
00115400,SAN FRANCISCO STATE UNIVERSITY          ,CA,94132-1740,Public       ,74,143,217,41713,21722,63435
00115500,SAN JOSE STATE UNIVERSITY               ,CA,95192-0036,Public       ,54,113,167,34593,18917,53510
00115600,SONOMA STATE UNIVERSITY                 ,CA,94928-3609,Public       ,17,22,39,14146,4216,18362
00115700,CALIF STATE UNIV-STANISLAUS             ,CA,95382-0299,Public       ,16,41,57,10363,6803,17166
00116100,CERRITOS COLLEGE                        ,CA,90650-6296,Public       ,196,297,493,19398,16341,35739
00116200,CHABOT COLLEGE                          ,CA,94545-2400,Public       ,71,168,239,7189,8746,15935
00116300,CHAFFEY COLLEGE                         ,CA,91737-9400,Public       ,130,288,418,16859,17423,34282
00116400,CHAPMAN UNIVERSITY                      ,CA,92866-1099,Private      ,6,32,38,12284,3775,16059
00116453,CHAPMAN UNIVERSITY DALE E. FOWLER SCHOOL,CA,92866-0000,Private      ,0,5,5,82,1485,1567
00116500,CHURCH DIV SCH OF THE PACIFIC           ,CA,94709-0000,Private      ,0,3,3,5,75,80
00116600,CITRUS COLLEGE                          ,CA,91741-1899,Public       ,153,218,371,11608,8984,20592
00116900,CLAREMONT GRADUATE UNIVERSITY           ,CA,91711-0000,Private      ,1,21,22,34,2031,2065
00117000,CLAREMONT MCKENNA COLLEGE               ,CA,91711-6400,Private      ,2,2,4,3796,222,4018
00117100,HARVEY MUDD COLLEGE                     ,CA,91711-5990,Private      ,0,2,2,2689,136,2825
00117200,PITZER COLLEGE                          ,CA,91711-6101,Private      ,0,2,2,3039,242,3281
00117300,POMONA COLLEGE                          ,CA,91711-6301,Private      ,4,1,5,5161,309,5470
00117400,SCRIPPS COLLEGE                         ,CA,91711-3948,Private      ,0,0,0,1976,185,2161
00117600,WEST HILLS COMMUNITY COLLEGE            ,CA,93210-1399,Public       ,10,23,33,1574,1522,3096
00117700,COGSWELL POLYTECHNICAL COLLEGE          ,CA,94089-1210,Proprietary  ,7,5,12,459,250,709
00117800,COLLEGE OF MARIN                        ,CA,94904-2590,Public       ,9,43,52,1356,2759,4115
00117801,COLG OF MARIN-INDIAN VALLEY CMPS        ,CA,94949-0000,Public       ,6,15,21,334,834,1168
00117900,NOTRE DAME DE NAMUR UNIVERSITY          ,CA,94002-1997,Private      ,2,15,17,1911,1614,3525
00118100,COLLEGE OF SAN MATEO                    ,CA,94402-3784,Public       ,71,124,195,3887,3754,7641
00118200,COLLEGE OF THE DESERT                   ,CA,92260-9305,Public       ,70,180,250,6275,7098,13373
00118300,HOLY NAMES UNIVERSITY                   ,CA,94619-1699,Private      ,1,8,9,1131,1399,2530
00118500,COLLEGE OF THE REDWOODS                 ,CA,95501-9300,Public       ,24,77,101,2875,4527,7402
00118600,COLLEGE OF THE SEQUOIAS                 ,CA,93277-2234,Public       ,102,199,301,7533,8313,15846
00118700,COLLEGE OF THE SISKIYOUS                ,CA,96094-2899,Public       ,6,27,33,1152,1366,2518
00118701,COLLEGE OF THE SISKIYOUS - YREKA CENTER ,CA,96097-9538,Public       ,4,15,19,170,463,633
00119000,CONTRA COSTA COLLEGE                    ,CA,94806-3195,Public       ,30,107,137,2884,4672,7556
00119100,DIABLO VALLEY COLLEGE                   ,CA,94523-1544,Public       ,105,213,318,7275,7407,14682
00119200,CUESTA COLLEGE                          ,CA,93403-8106,Public       ,57,121,178,5082,4829,9911
00119300,CYPRESS COLLEGE                         ,CA,90630-5897,Public       ,95,178,273,12719,11133,23852
00119600,DOMINICAN UNIVERSITY OF CALIFORNIA      ,CA,94901-2298,Private      ,7,9,16,3174,1535,4709
00119700,EL CAMINO COLLEGE                       ,CA,90506-0002,Public       ,165,358,523,16947,15947,32894
00119701,COMPTON COMMUNITY COLLEGE               ,CA,90221-5393,Public       ,70,259,329,4131,6651,10782
00119900,FOOTHILL COLLEGE                        ,CA,94022-4597,Public       ,62,170,232,4389,5779,10168
00120000,FULLER THEOLOGICAL SEMINARY             ,CA,91182-0000,Private      ,1,13,14,30,2378,2408
00120100,FULLERTON COLLEGE                       ,CA,92832-2095,Public       ,172,274,446,16500,12246,28746
00120200,GAVILAN COLLEGE                         ,CA,95020-9599,Public       ,66,62,128,2418,2599,5017
00120300,GLENDALE COMMUNITY COLLEGE              ,CA,91208-2894,Public       ,123,162,285,12007,10875,22882
00120500,GOLDEN GATE UNIVERSITY                  ,CA,94105-2967,Private      ,4,59,63,275,3680,3955
00120600,GOLDEN WEST COLLEGE                     ,CA,92647-2748,Public       ,41,123,164,10434,9187,19621
00120700,GRADUATE THEOLOGICAL UNION              ,CA,94709-0000,Private      ,0,1,1,1,309,310
00120800,GROSSMONT COLLEGE                       ,CA,92020-1799,Public       ,101,232,333,11388,13600,24988
00120900,HARTNELL COMMUNITY COLLEGE              ,CA,93901-1697,Public       ,78,98,176,4804,3959,8763
00121200,HUMPHREYS COLLEGE                       ,CA,95207-3896,Private      ,3,15,18,417,1420,1837
00121400,IMPERIAL VALLEY COLLEGE                 ,CA,92251-9787,Public       ,166,100,266,5286,4503,9789
00121500,LA SIERRA UNIVERSITY                    ,CA,92515-3332,Private      ,16,26,42,3917,1861,5778
00121600,UNIVERSITY OF LA VERNE                  ,CA,91750-4443,Private      ,10,207,217,6909,8148,15057
00121700,LASSEN COLLEGE                          ,CA,96130-3000,Public       ,7,22,29,640,825,1465
00121800,LOMA LINDA UNIVERSITY                   ,CA,92350-0001,Private      ,5,38,43,1461,6579,8040
00121900,LONG BEACH CITY COLLEGE                 ,CA,90808-1780,Public       ,151,397,548,20377,19288,39665
00122000,MASTER'S COLLEGE & SEMINARY (THE)       ,CA,91321-1200,Private      ,1,8,9,1517,552,2069
00122300,LOS ANGELES CITY COLLEGE                ,CA,90029-3588,Public       ,150,434,584,12693,19853,32546
00122400,LOS ANGELES HARBOR COLLEGE              ,CA,90744-2397,Public       ,62,153,215,5418,6566,11984
00122600,LOS ANGELES PIERCE COLLEGE              ,CA,91371-0001,Public       ,385,344,729,15259,13840,29099
00122700,LOS ANGELES TRADE TECH COLLEGE          ,CA,90015-4181,Public       ,173,524,697,8794,18482,27276
00122800,LOS ANGELES VALLEY COLLEGE              ,CA,91401-4096,Public       ,157,277,434,11636,13537,25173
00122900,SO CA UNIV  HEALTH SCIENCES             ,CA,90604-4051,Private      ,2,13,15,58,839,897
00123000,MARSHALL B. KETCHUM UNIVERSITY          ,CA,92831-1699,Private      ,0,0,0,25,522,547
00123200,AMERICAN RIVER COLLEGE                  ,CA,95841-4286,Public       ,155,616,771,16099,26129,42228
00123300,SACRAMENTO CITY COLLEGE                 ,CA,95822-1386,Public       ,162,437,599,16673,21042,37715
00123600,MENLO COLLEGE                           ,CA,94027-4301,Private      ,5,1,6,1735,270,2005
00123700,MERCED COMMUNITY COLLEGE                ,CA,95348-2898,Public       ,115,162,277,7505,7119,14624
00123800,MILLS COLLEGE                           ,CA,94613-1301,Private      ,0,11,11,2007,2110,4117
00123900,MIRACOSTA COLLEGE                       ,CA,92056-3899,Public       ,85,296,381,5895,8659,14554
00124000,MODESTO JUNIOR COLLEGE                  ,CA,95350-5800,Public       ,145,305,450,11520,14196,25716
00124200,MONTEREY PENINSULA COLLEGE              ,CA,93940-4799,Public       ,45,101,146,3539,3482,7021
00124300,MOUNT ST MARYS COLLEGE                  ,CA,90049-1599,Private      ,13,46,59,3818,2994,6812
00124500,MT. SAN ANTONIO COLLEGE                 ,CA,91789-1399,Public       ,141,246,387,22057,18632,40689
00124600,MT SAN JACINTO COLLEGE                  ,CA,92583-2399,Public       ,169,333,502,10257,14040,24297
00124700,NAPA VALLEY COLLEGE                     ,CA,94558-6236,Public       ,25,59,84,3440,3572,7012
00124900,OCCIDENTAL COLLEGE                      ,CA,90041-3314,Private      ,1,4,5,5593,484,6077
00125000,ORANGE COAST COLLEGE - FIN AID OFF      ,CA,92628-5005,Public       ,82,164,246,15557,12404,27961
00125100,OTIS COLLEGE OF ART AND DESIGN          ,CA,90045-3505,Private      ,3,13,16,1810,972,2782
00125200,HOPE INTERNATIONAL UNIVERSITY           ,CA,92631-0000,Private      ,3,13,16,916,1311,2227
00125300,FRESNO PACIFIC UNIVERSITY               ,CA,93702-4798,Private      ,13,103,116,2985,4778,7763
00125400,PACIFIC LUTHERAN THEOLOGICAL SEM        ,CA,94708-0000,Private      ,0,0,0,2,72,74
00125500,PACIFIC OAKS COLLEGE                    ,CA,91103-3606,Private      ,1,19,20,91,1696,1787
00125600,PACIFIC SCHOOL OF RELIGION              ,CA,94709-0000,Private      ,0,4,4,2,211,213
00125800,PACIFIC UNION COLLEGE                   ,CA,94508-9797,Private      ,8,4,12,2085,615,2700
00125900,PALO VERDE COLLEGE                      ,CA,92225-0000,Public       ,1,12,13,313,616,929
00126000,PALOMAR COLLEGE                         ,CA,92069-1486,Public       ,98,337,435,11757,11884,23641
00126100,PASADENA CITY COLLEGE                   ,CA,91106-2003,Public       ,119,304,423,20842,16086,36928
00126200,POINT LOMA NAZARENE UNIVERSITY          ,CA,92106-2899,Private      ,8,58,66,5138,1927,7065
00126600,LANEY COLLEGE                           ,CA,94607-4893,Public       ,111,281,392,4921,10389,15310
00126700,MERRITT COLLEGE                         ,CA,94619-3196,Public       ,50,157,207,3067,6661,9728
00126800,PORTERVILLE COLLEGE                     ,CA,93257-6059,Public       ,54,71,125,2713,2777,5490
00126900,RIO HONDO COLLEGE                       ,CA,90601-1699,Public       ,176,235,411,14540,10701,25241
00127000,RIVERSIDE CITY COLLEGE                  ,CA,92506-1299,Public       ,197,444,641,22365,22558,44923
00127200,SAN BERNARDINO VALLEY COLLEGE           ,CA,92410-2798,Public       ,128,352,480,11292,16104,27396
00127300,SAN DIEGO CITY COLLEGE                  ,CA,92101-4787,Public       ,206,533,739,12756,19037,31793
00127500,SAN DIEGO MESA COLLEGE                  ,CA,92111-4996,Public       ,143,412,555,13741,16442,30183
00127800,SAN FRANCISCO CONSERVATORY OF MUSIC     ,CA,94122-4498,Private      ,1,3,4,347,481,828
00127900,SAN FRANCISCO THEOLOGICAL SEMINARY      ,CA,94960-0000,Private      ,0,1,1,1,68,69
00128000,SAN JOAQUIN DELTA COLLEGE               ,CA,95207-6370,Public       ,205,432,637,11322,13981,25303
00128100,WILLIAM JESSUP UNIVERSITY               ,CA,95765-3707,Private      ,4,27,31,1238,873,2111
00128200,SAN JOSE CITY COLLEGE                   ,CA,95128-2797,Public       ,54,177,231,5567,8240,13807
00128400,SANTA ANA COLLEGE                       ,CA,92706-3398,Public       ,75,176,251,10151,9408,19559
00128500,SANTA BARBARA CITY COLLEGE              ,CA,93109-2394,Public       ,138,223,361,10733,7339,18072
00128600,SANTA MONICA COLLEGE                    ,CA,90405-1644,Public       ,207,301,508,23064,14915,37979
00128700,SANTA ROSA JUNIOR COLLEGE               ,CA,95401-4395,Public       ,54,145,199,7538,9093,16631
00128800,CLAREMONT SCHOOL OF THEOLOGY            ,CA,91711-0000,Private      ,0,2,2,8,328,336
00128900,SHASTA COLLEGE                          ,CA,96049-7692,Public       ,34,111,145,4430,6458,10888
00129000,SIERRA COLLEGE                          ,CA,95677-3397,Public       ,146,309,455,9988,11814,21802
00129100,SIMPSON UNIVERSITY                      ,CA,96003-8606,Private      ,6,13,19,1466,1356,2822
00129200,SOLANO COMMUNITY COLLEGE                ,CA,94534-3197,Public       ,62,246,308,4438,7233,11671
00129300,VANGUARD UNIVERSITY OF SOUTHERN CA      ,CA,92626-6597,Private      ,7,36,43,2712,1552,4264
00129400,SOUTHWESTERN COLLEGE                    ,CA,91910-7299,Public       ,107,255,362,11386,11163,22549
00129500,SOUTHWESTERN LAW SCHOOL                 ,CA,90010-1106,Private      ,2,12,14,81,2332,2413
00129600,DOMINICAN SCH PHILOSOPHY & THEOLOGY     ,CA,94709-0000,Private      ,0,1,1,10,79,89
00129900,ST JOHN'S SEMINARY COLLEGE              ,CA,93010-0000,Private      ,0,0,0,9,10,19
00130200,SAINT MARY'S COLLEGE OF CALIFORNIA      ,CA,94556-2744,Private      ,7,30,37,6006,1958,7964
00130500,STANFORD UNIVERSITY                     ,CA,94305-6106,Private      ,24,46,70,27761,4515,32276
00130501,STANFORD UNIVERSITY - SCHOOL OF MEDICINE,CA,94305-5404,Private      ,6,6,12,98,1687,1785
00130502,STANFORD UNIVERSITY - GRADUATE SCHOOL OF,CA,94305-7298,Private      ,1,36,37,109,2086,2195
00130503,STANFORD UNIVERSITY - STANFORD LAW SCHOO,CA,94305-8610,Private      ,1,4,5,267,2427,2694
00130700,FRESNO CITY COLLEGE                     ,CA,93741-0002,Public       ,177,426,603,18638,20822,39460
00130800,REEDLEY COLLEGE                         ,CA,93654-2099,Public       ,63,108,171,8159,6538,14697
00130900,TAFT COLLEGE                            ,CA,93268-2317,Public       ,28,59,87,2059,2001,4060
00131200,"UNIVERSITY OF CALIFORNIA, BERKELEY      ",CA,94720-1520,Public       ,536,196,732,60075,21789,81864
00131300,UNIVERSITY OF CALIFORNIA-DAVIS          ,CA,95616-8558,Public       ,91,65,156,56492,16104,72596
00131400,UNIVERSITY OF CALIFORNIA-IRVINE         ,CA,92697-2825,Public       ,446,155,601,62163,15951,78114
00131500,UNIVERSITY OF CALIFORNIA (UCLA)         ,CA,90095-9000,Public       ,148,199,347,77158,30309,107467
00131502,UNIV OF CALIFORNIA LOS ANG SCH MED      ,CA,90095-0000,Public       ,1,3,4,398,1256,1654
00131503,UNIV OF CALIFORNIA LOS ANG DENTAL       ,CA,90095-0000,Public       ,0,6,6,138,255,393
00131600,UNIVERSITY OF CALIFORNIA-RIVERSIDE      ,CA,92521-0209,Public       ,58,94,152,42511,11119,53630
00131700,UNIVERSITY OF CALIFORNIA-SAN DIEGO      ,CA,92093-0013,Public       ,68,86,154,55653,12370,68023
00131900,UNIVERSITY OF CALIFORNIA-SFRANCISCO     ,CA,94143-0246,Public       ,12,30,42,2052,5084,7136
00132000,UNIVERSITY OF CALIFORNIA-SANTA BARB     ,CA,93106-3180,Public       ,391,63,454,55720,8237,63957
00132100,UNIVERSITY OF CALIFORNIA-SANTA CRUZ     ,CA,95064-0001,Public       ,46,53,99,38706,6027,44733
00132200,UNIVERSITY OF REDLANDS                  ,CA,92373-0999,Private      ,7,122,129,6069,4136,10205
00132500,UNIVERSITY OF SAN FRANCISCO             ,CA,94117-1080,Private      ,12,137,149,14369,9213,23582
00132600,SANTA CLARA UNIVERSITY                  ,CA,95053-4956,Private      ,13,44,57,12505,3950,16455
00132604,JESUIT SCHOOL OF THEOLOGY - BERKELEY    ,CA,94709-1193,Private      ,0,1,1,3,60,63
00132800,UNIVERSITY OF SOUTHERN CALIFORNIA       ,CA,90089-0914,Private      ,68,284,352,47184,32485,79669
00132900,UNIVERSITY OF THE PACIFIC               ,CA,95211-0197,Private      ,13,29,42,12780,3997,16777
00132901,UNIVERSITY OF THE PACIFIC - MCGEORGE SCH,CA,95817-2799,Private      ,1,9,10,220,1610,1830
00132902,UNIV OF THE PACIFIC SCH OF DENT         ,CA,94115-0000,Private      ,1,1,2,92,719,811
00133400,VENTURA COLLEGE                         ,CA,93003-3899,Public       ,140,229,369,7290,7001,14291
00133500,VICTOR VALLEY COLLEGE                   ,CA,92395-5849,Public       ,222,396,618,8154,12365,20519
00133800,WEST VALLEY COLLEGE                     ,CA,95070-5697,Public       ,44,71,115,3657,3564,7221
00134100,WESTMONT COLLEGE                        ,CA,93108-1099,Private      ,3,2,5,2746,207,2953
00134200,WHITTIER COLLEGE                        ,CA,90601-4413,Private      ,4,12,16,4555,796,5351
00134201,WHITTIER COLLEGE - COLLEGE OF LAW       ,CA,92626-1501,Private      ,0,5,5,46,1337,1383
00134300,WOODBURY UNIVERSITY                     ,CA,91510-7846,Private      ,1,9,10,1369,1033,2402
00134400,YUBA COLLEGE                            ,CA,95901-7699,Public       ,143,153,296,4148,6225,10373
00177212,TRINITY INTERNATIONAL UNIV-CA           ,CA,92705-0000,Private      ,0,1,1,19,395,414
00188100,ASHFORD UNIVERSITY                      ,CA,92123-1406,Proprietary  ,180,6324,6504,2868,114134,117002
00274100,AMERICAN JEWISH UNIVERSITY              ,CA,90077-1599,Private      ,0,1,1,112,153,265
00301002,ANTIOCH UNIV/LOS ANGELES                ,CA,90230-7615,Private      ,0,14,14,69,1220,1289
00301003,ANTIOCH  UNIV/SANTA BARBARA             ,CA,93101-0000,Private      ,1,5,6,812,662,1474
00369110,MIDDLEBURY COLLEGE - MONTEREY INSTITUTE ,CA,93940-2691,Private      ,0,3,3,62,955,1017
00394700,UC-HASTINGS COLLEGE OF THE LAW          ,CA,94102-0000,Public       ,0,4,4,44,3016,3060
00394800,SAN FRANCISCO ART INSTITUTE             ,CA,94133-2299,Private      ,8,24,32,2147,1564,3711
00408000,STARR KING SCHOOL FOR THE MINISTRY      ,CA,94709-1299,Private      ,0,1,1,1,96,97
00448000,DE ANZA COLLEGE                         ,CA,95014-5793,Public       ,117,205,322,10863,8902,19765
00448100,OHLONE COLLEGE                          ,CA,94539-5847,Public       ,71,92,163,4304,4079,8383
00448400,JOHN F. KENNEDY UNIVERSITY              ,CA,94523-4817,Private      ,2,21,23,63,1725,1788
00449000,PATTEN UNIVERSITY                       ,CA,94601-2699,Private      ,0,0,0,47,89,136
00449400,EVEREST COLLEGE                         ,CA,92408-3752,Proprietary  ,33,99,132,668,1473,2141
00450200,CITY COLLEGE OF SAN FRANCISCO           ,CA,94112-0000,Public       ,109,453,562,10894,17054,27948
00450302,EVEREST COLLEGE - SANTA ANA             ,CA,92701-4559,Proprietary  ,29,49,78,524,732,1256
00563800,DOWNEY ADULT SCHOOL                     ,CA,90241-5610,Public       ,8,40,48,354,975,1329
00565500,HACIENDA LA PUENTE ADULT EDUC CTR       ,CA,91746-0000,Public       ,4,8,12,296,834,1130
00616500,LA CNTY CLG OF NURSING & ALLD HLTH      ,CA,90033-1018,Public       ,1,13,14,239,752,991
00672000,COLLEGE OF ALAMEDA                      ,CA,94501-2109,Public       ,78,122,200,3240,4704,7944
00673100,CASA LOMA COLLEGE                       ,CA,91405-4523,Private      ,11,31,42,315,777,1092
00697300,CANADA COLLEGE                          ,CA,94061-1099,Public       ,43,98,141,1690,2599,4289
00697500,LINCOLN UNIVERSITY                      ,CA,94612-2801,Private      ,1,5,6,42,209,251
00701200,SAMUEL MERRITT COLLEGE                  ,CA,94609-3108,Private      ,4,57,61,498,2969,3467
00704700,LOS ANGELES SOUTHWEST COLLEGE           ,CA,90047-4810,Public       ,46,201,247,4179,9561,13740
00705000,BELLUS ACADEMY                          ,CA,91950-3616,Proprietary  ,5,19,24,110,263,373
00711500,MOORPARK COLLEGE                        ,CA,93021-1695,Public       ,108,162,270,7174,5496,12670
00713000,NEWBERRY SCHOOLS OF BEAUTY              ,CA,91344-7404,Proprietary  ,6,14,20,97,126,223
00714200,LYLE'S COLLEGE OF BEAUTY                ,CA,93710-3948,Proprietary  ,14,17,31,143,244,387
00716400,BRYAN COLLEGE                           ,CA,90057-0000,Proprietary  ,24,197,221,309,2232,2541
00718700,NORTH ADRIAN'S COLLEGE OF BEAUTY        ,CA,95350-2381,Proprietary  ,15,40,55,169,351,520
00719000,WYOTECH                                 ,CA,94539-7663,Proprietary  ,34,101,135,750,1573,2323
00720300,SALON SUCCESS ACADEMY                   ,CA,91786-4060,Proprietary  ,4,10,14,154,185,339
00720400,MODERN BEAUTY ACADEMY                   ,CA,93030-7016,Proprietary  ,2,3,5,75,91,166
00720900,REDONDO BEACH BEAUTY COLLEGE            ,CA,90278-3111,Proprietary  ,2,8,10,5,19,24
00722900,WESTERN BEAUTY INSTITUTE                ,CA,91402-3104,Proprietary  ,0,0,0,196,324,520
00723400,HEALD COLLEGE                           ,CA,94105-2206,Proprietary  ,23,80,103,750,2072,2822
00723404,HEALD COLLEGE - CONCORD                 ,CA,94520-0000,Proprietary  ,45,120,165,970,2374,3344
00723405,HEALD COLLEGE - MILPITAS                ,CA,95035-8008,Proprietary  ,25,128,153,936,2556,3492
00723406,HEALD COLLEGE - HAYWARD                 ,CA,94545-2352,Proprietary  ,22,92,114,841,2196,3037
00723407,HEALD COLLEGE - MODESTO                 ,CA,95368-9095,Proprietary  ,22,76,98,841,1614,2455
00723408,HEALD COLLEGE - ROSEVILLE               ,CA,95678-5303,Proprietary  ,16,91,107,788,2235,3023
00723409,HEALD COLLEGE - SALINAS                 ,CA,93906-5100,Proprietary  ,12,45,57,818,1698,2516
00723410,HEALD COLLEGE - STOCKTON                ,CA,95210-5667,Proprietary  ,23,103,126,1131,2627,3758
00723411,HEALD COLLEGE - RANCHO CORDOVA          ,CA,95670-6005,Proprietary  ,13,80,93,647,1927,2574
00723412,HEALD COLLEGE - FRESNO                  ,CA,93704-1706,Proprietary  ,36,118,154,1469,3143,4612
00725300,FEDERICO BEAUTY INSTITUTE               ,CA,95834-1905,Proprietary  ,14,26,40,343,592,935
00729600,COLEMAN COLLEGE                         ,CA,92123-0000,Private      ,5,38,43,324,1108,1432
00732909,ITT TECHNICAL INSTITUTE                 ,CA,92868-3506,Proprietary  ,56,296,352,804,3180,3984
00732971,ITT TECHNICAL INSTITUTE                 ,CA,95670-6047,Proprietary  ,47,253,300,670,2639,3309
00732976,ITT TECHNICAL INSTITUTE                 ,CA,92408-3519,Proprietary  ,65,237,302,1305,3431,4736
00732981,ITT TECHNICAL INSTITUTE                 ,CA,92123-2662,Proprietary  ,50,290,340,909,3809,4718
00732985,ITT TECHNICAL INSTITUTE                 ,CA,91773-2933,Proprietary  ,41,178,219,658,2201,2859
00732989,ITT TECHNICAL INSTITUTE                 ,CA,90502-1356,Proprietary  ,39,224,263,618,2474,3092
00732994,ITT TECHNICAL INSTITUTE                 ,CA,91342-3664,Proprietary  ,36,174,210,591,2094,2685
00747600,MARINELLO SCHOOLS OF BEAUTY             ,CA,90023-2666,Proprietary  ,24,56,80,523,787,1310
00747602,MARINELLO SCHOOLS OF BEAUTY - SPA ACADEM,CA,90048-5101,Proprietary  ,14,20,34,182,336,518
00747603,MARINELLO SCHOOLS OF BEAUTY - INGLEWOOD ,CA,90301-2306,Proprietary  ,10,14,24,112,194,306
00747604,MARINELLO SCHOOLS OF BEAUTY - RESEDA    ,CA,91335-4218,Proprietary  ,2,1,3,26,50,76
00747606,MARINELLO SCHOOLS OF BEAUTY - WEST COVIN,CA,91790-2805,Proprietary  ,12,15,27,110,123,233
00747607,MARINELLO SCHOOLS OF BEAUTY - SAN BERNAR,CA,92410-3261,Proprietary  ,5,13,18,178,256,434
00747608,MARINELLO SCHOOLS OF BEAUTY - ONTARIO   ,CA,91762-2113,Proprietary  ,17,46,63,292,421,713
00747609,MARINELLO SCHOOLS OF BEAUTY - WHITTIER  ,CA,90601-4107,Proprietary  ,6,13,19,146,167,313
00747610,MARINELLO SCHOOLS OF BEAUTY - LOMITA    ,CA,90717-1460,Proprietary  ,6,18,24,91,164,255
00747611,MARINELLO SCHOOLS OF BEAUTY - SAN DIEGO ,CA,92126-4217,Proprietary  ,9,46,55,250,485,735
00747612,MARINELLO SCHOOLS OF BEAUTY - EL CAJON  ,CA,92020-2503,Proprietary  ,13,31,44,132,325,457
00747613,MARINELLO SCHOOLS OF BEAUTY - VICTORVILL,CA,92392-5496,Proprietary  ,15,42,57,214,424,638
00747614,MARINELLO SCHOOLS OF BEAUTY - ANAHEIM   ,CA,92801-4622,Proprietary  ,16,20,36,226,287,513
00747615,MARINELLO SCHOOLS OF BEAUTY - SIMI VALLE,CA,93065-2801,Proprietary  ,9,15,24,115,183,298
00753100,ACADEMY OF ART UNIVERSITY               ,CA,94105-3410,Proprietary  ,108,315,423,8785,13742,22527
00753600,COSUMNES RIVER COLLEGE                  ,CA,95823-5799,Public       ,83,314,397,10364,12721,23085
00754802,WESTWOOD COLLEGE OF TECHNOLOGY          ,CA,92801-0000,Proprietary  ,10,26,36,845,771,1616
00754803,WESTWOOD COLLEGE OF TECHNOLOGY          ,CA,91786-0000,Proprietary  ,29,36,65,950,1044,1994
00760600,EVEREST COLLEGE                         ,CA,90010-2221,Proprietary  ,3,26,29,439,767,1206
00760700,CONCORDE CAREER INSTITUTE               ,CA,91606-3134,Proprietary  ,28,34,62,443,847,1290
00770700,COLUMBIA COLLEGE                        ,CA,95370-8580,Public       ,15,32,47,1457,1782,3239
00771300,SKYLINE COLLEGE                         ,CA,94066-1698,Public       ,94,168,262,4300,4631,8931
00793000,CONCORDE CAREER INSTITUTE               ,CA,92108-0000,Proprietary  ,13,70,83,507,1667,2174
00799300,CALIF STATE UNIV BAKERSFIELD            ,CA,93311-1022,Public       ,45,105,150,11273,7795,19068
00807100,CONCORDE CAREER INSTITUTE               ,CA,92840-9201,Proprietary  ,23,56,79,451,1091,1542
00807300,BUTTE COMMUNITY COLLEGE                 ,CA,95965-0000,Public       ,53,114,167,8229,9876,18105
00809000,EVEREST COLLEGE                         ,CA,91803-1310,Proprietary  ,31,75,106,385,828,1213
00853700,CONCORDE CAREER INSTITUTE               ,CA,92401-0000,Proprietary  ,22,78,100,506,1391,1897
00859600,WEST LOS ANGELES COLLEGE                ,CA,90230-3500,Public       ,111,230,341,5446,9123,14569
00859700,FEATHER RIVER COLLEGE                   ,CA,95971-9124,Public       ,10,10,20,831,635,1466
00884400,CALIFORNIA CHRISTIAN COLLEGE            ,CA,93703-3599,Private      ,3,3,6,120,180,300
00884600,WRIGHT INSTITUTE                        ,CA,94704-0000,Private      ,0,3,3,6,522,528
00890300,COLLEGE OF THE CANYONS                  ,CA,91355-1899,Public       ,137,215,352,9480,7663,17143
00891800,SADDLEBACK COLLEGE                      ,CA,92692-3699,Public       ,80,237,317,6969,8271,15240
00902200,ASSOCIATED TECHNICAL COLLEGE            ,CA,90017-0000,Proprietary  ,9,64,73,202,680,882
00903200,EMPIRE COLLEGE                          ,CA,95403-2122,Proprietary  ,17,23,40,254,720,974
00915706,WYOMING TECHNICAL INSTITUTE - WEST SACRA,CA,95605-1507,Proprietary  ,0,0,0,323,399,722
00927200,CRAFTON HILLS COLLEGE                   ,CA,92399-1799,Public       ,50,98,148,4689,4802,9491
00950900,SKILLS & BUSINESS EDUCATION CENTER      ,CA,95824-1529,Public       ,4,27,31,380,1178,1558
00974800,CARRINGTON COLLEGE CALIFORNIA           ,CA,95826-3203,Proprietary  ,28,95,123,1275,2965,4240
00974801,CARRINGTON COLLEGE CALIFORNIA - SAN LEAN,CA,94578-3711,Proprietary  ,25,39,64,375,744,1119
00974802,CARRINGTON COLLEGE CALIFORNIA - PLEASANT,CA,94523-1984,Proprietary  ,16,21,37,351,780,1131
00974803,CARRINGTON COLLEGE CALIFORNIA - STOCKTON,CA,95207-5509,Proprietary  ,20,52,72,576,899,1475
00974804,CARRINGTON COLLEGE CALIFORNIA - CITRUS H,CA,95621-5577,Proprietary  ,12,52,64,344,809,1153
00974806,CARRINGTON COLLEGE CALIFORNIA -  ANTIOCH,CA,94531-1604,Proprietary  ,0,0,0,173,400,573
00974807,CARRINGTON COLLEGE CALIFORNIA - SAN JOSE,CA,95119-1325,Proprietary  ,25,58,83,638,1296,1934
00974808,CARRINGTON COLLEGE CALIFORNIA - EMERYVIL,CA,94608-3006,Proprietary  ,0,0,0,84,117,201
00974809,WESTERN CAREER COLLEGE -  EMERYVILLE SHE,CA,94608-3006,Proprietary  ,0,0,0,8,17,25
00998900,SANTA BARBARA BUSINESS COLLEGE          ,CA,93111-0000,Proprietary  ,14,40,54,382,780,1162
01011100,CERRO-COSO COMMUNITY COLLEGE            ,CA,93555-9571,Public       ,41,167,208,1065,2822,3887
01014900,PEPPERDINE UNIVERSITY                   ,CA,90263-0000,Private      ,7,117,124,9666,6785,16451
01034000,LOS MEDANOS COLLEGE                     ,CA,94565-5197,Public       ,72,138,210,4140,5422,9562
01036500,CHARLES R DREW UNIV OF MED & SCI        ,CA,90059-0000,Private      ,0,22,22,169,1084,1253
01039500,UNIVERSITY OF SAN DIEGO                 ,CA,92110-2492,Private      ,30,110,140,19419,7316,26735
01039501,UNIVERSITY OF SAN DIEGO - SCHOOL OF LAW ,CA,92110-2492,Private      ,3,10,13,241,2505,2746
01044100,PARDEE RAND GRADUATE SCHOOL             ,CA,90407-2138,Private      ,0,0,0,4,35,39
01047400,MARYMOUNT COLLEGE OF PALOS VERDES       ,CA,90275-0000,Private      ,31,3,34,1384,240,1624
01085400,THOMAS JEFFERSON SCHOOL OF LAW          ,CA,92110-0000,Private      ,1,13,14,52,2006,2058
01102400,EVEREST COLLEGE                         ,CA,94103-2091,Proprietary  ,9,24,33,177,486,663
01110700,EVEREST  COLLEGE                        ,CA,92801-5231,Proprietary  ,25,85,110,605,981,1586
01110900,EVEREST COLLEGE                         ,CA,91335-4631,Proprietary  ,34,64,98,477,903,1380
01111200,FIDM-FASHION INSTITUTE OF DESIGN        ,CA,90015-1421,Proprietary  ,28,20,48,6455,2580,9035
01111700,ALLIANT INTERNATIONAL UNIVERSITY        ,CA,92131-1799,Private      ,1,19,20,214,2338,2552
01111705,ALLIANT INTERNATIONAL UNIVERSITY - LOS A,CA,91803-1360,Private      ,0,3,3,23,722,745
01111706,ALLIANT INTERNATIONAL UNIVERSITY - SAN F,CA,94133-1221,Private      ,1,4,5,39,947,986
01111707,ALLIANT INTERNATIONAL UNIVERSITY - FRESN,CA,93727-2014,Private      ,0,7,7,83,610,693
01112100,EVEREST COLLEGE                         ,CA,94541-4007,Proprietary  ,4,15,19,132,402,534
01112300,EVEREST COLLEGE                         ,CA,90247-4163,Proprietary  ,15,82,97,278,841,1119
01146000,NATIONAL UNIVERSITY                     ,CA,92037-1011,Private      ,49,1111,1160,1284,23504,24788
01162600,PRACTICAL SCHOOLS                       ,CA,92805-0000,Proprietary  ,10,22,32,331,707,1038
01164900,LOYOLA MARYMOUNT UNIVERSITY             ,CA,90045-0000,Private      ,29,75,104,13495,4268,17763
01164901,LMU  - LOYOLA LAW SCHOOL                ,CA,90015-0019,Private      ,0,20,20,209,3117,3326
01167200,MENDOCINO COLLEGE                       ,CA,95482-3000,Public       ,38,69,107,1543,2426,3969
01170700,NORTH-WEST COLLEGE                      ,CA,91790-2097,Proprietary  ,15,51,66,337,685,1022
01179200,FRANCISCAN SCHOOL OF THEOLOGY           ,CA,94709-0000,Private      ,0,1,1,8,47,55
01182000,SAN DIEGO MIRAMAR COLLEGE               ,CA,92126-0000,Public       ,100,288,388,6167,9803,15970
01186500,CALIFORNIA HAIR DESIGN ACADEMY          ,CA,92115-0000,Proprietary  ,15,23,38,235,355,590
01186600,LU ROSS ACADEMY                         ,CA,93001-2927,Proprietary  ,17,26,43,229,407,636
01202600,BELLUS ACADEMY                          ,CA,92021-6247,Proprietary  ,5,20,25,110,240,350
01202700,GALEN COLLEGE OF CALIFORNIA             ,CA,93728-2381,Proprietary  ,0,0,0,55,115,170
01203100,SAN DIEGO CHRISTIAN COLLEGE             ,CA,92019-1157,Private      ,3,22,25,1005,817,1822
01206100,EVEREST COLLEGE                         ,CA,95128-3908,Proprietary  ,4,13,17,287,582,869
01215400,CALIFORNIA INSTITUTE OF INTEGRAL STUDIES,CA,94103-2557,Private      ,0,15,15,57,1651,1708
01230002,PALMER COLLEGE OF CHIROPRACTIC - WEST CA,CA,95134-1617,Private      ,0,0,0,22,209,231
01231600,MANCHESTER BEAUTY COLLEGE               ,CA,93726-5306,Proprietary  ,2,11,13,149,201,350
01231700,TULARE BEAUTY COLLEGE                   ,CA,93274-3432,Proprietary  ,0,5,5,36,65,101
01244600,UNIVERSAL COLLEGE OF BEAUTY             ,CA,90044-0044,Proprietary  ,1,9,10,99,175,274
01245200,EVERGREEN VALLEY COLLEGE                ,CA,95135-1598,Public       ,63,139,202,5606,6597,12203
01255000,LOS ANGELES MISSION COLLEGE             ,CA,91342-3200,Public       ,92,127,219,7040,6844,13884
01265000,MARINELLO SCHOOL OF BEAUTY              ,CA,91502-2828,Proprietary  ,33,48,81,225,427,652
01265001,MARINELLO SCHOOL OF BEAUTY - PALMDALE   ,CA,93550-4686,Proprietary  ,2,5,7,114,179,293
01284200,OXNARD COLLEGE                          ,CA,93030-0000,Public       ,84,181,265,3983,4835,8818
01287200,NORTH-WEST COLLEGE                      ,CA,91768-3199,Proprietary  ,36,64,100,396,892,1288
01287300,WYOTECH                                 ,CA,90810-3800,Proprietary  ,68,187,255,1149,2359,3508
01287301,WYOTECH - EVEREST  COLLEGE              ,CA,90034-3158,Proprietary  ,14,62,76,315,715,1030
01287302,WYOTECH - EVEREST  COLLEGE              ,CA,91746-3412,Proprietary  ,40,123,163,570,1189,1759
01290700,LAKE TAHOE COMMUNITY COLLEGE            ,CA,96150-4524,Public       ,15,45,60,844,1343,2187
01291200,MTI COLLEGE                             ,CA,95841-0000,Proprietary  ,21,74,95,670,1917,2587
01294200,ROSEMEAD BEAUTY SCHOOL                  ,CA,91770-1639,Proprietary  ,1,44,45,51,362,413
01298400,PROFESSIONAL INSTITUTE OF BEAUTY        ,CA,91731-2613,Proprietary  ,2,17,19,40,146,186
01298500,HAIR CALIFORNIA BEAUTY ACADEMY          ,CA,92867-7127,Proprietary  ,0,0,0,39,63,102
01298900,OCEANSIDE COLLEGE OF BEAUTY             ,CA,92054-5393,Proprietary  ,3,8,11,145,242,387
01301000,LANCASTER BEAUTY SCHOOL                 ,CA,93534-3098,Proprietary  ,6,18,24,153,329,482
01307400,AMERICAN BEAUTY COLLEGE                 ,CA,91790-2906,Proprietary  ,8,7,15,95,139,234
01309500,SALON SUCCESS ACADEMY                   ,CA,92879-0000,Proprietary  ,14,21,35,258,319,577
01310300,CALIFORNIA WESTERN SCHOOL OF LAW        ,CA,92101-0000,Private      ,0,10,10,136,1813,1949
01324000,LYTLE'S REDWOOD EMPIRE BEAUTY CLG       ,CA,95403-0000,Proprietary  ,10,9,19,216,291,507
02054900,MARINELLO SCHOOL OF BEAUTY              ,CA,92630-0000,Proprietary  ,23,43,66,192,385,577
02054902,MARINELLO SCHOOL OF BEAUTY - BAKERSFIELD,CA,93309-5001,Proprietary  ,12,29,41,376,504,880
02054903,MARINELLO SCHOOL OF BEAUTY - VISALIA    ,CA,93277-6228,Proprietary  ,3,7,10,112,157,269
02059800,PARIS BEAUTY COLLEGE                    ,CA,94520-2611,Proprietary  ,3,13,16,64,198,262
02061600,WAYNES COLLEGE OF BEAUTY                ,CA,93906-2830,Proprietary  ,3,2,5,67,87,154
02063500,COASTLINE COMMUNITY COLLEGE             ,CA,92708-0000,Public       ,37,356,393,2686,8935,11621
02064300,SIERRA COLLEGE OF BEAUTY                ,CA,95340-0000,Proprietary  ,0,13,13,122,216,338
02065700,CALIFORNIA BEAUTY COLLEGE               ,CA,95354-0000,Proprietary  ,6,6,12,194,256,450
02070500,CONCORDIA UNIVERSITY                    ,CA,92612-0000,Private      ,5,74,79,3444,3406,6850
02075800,SOUTHERN CA INST OF ARCHITECTURE        ,CA,90013-0000,Private      ,2,0,2,294,567,861
02086400,MARINELLO SCHOOL OF BEAUTY              ,CA,95050-0000,Proprietary  ,12,25,37,147,266,413
02086401,MARINELLO SCHOOL OF BEAUTY - SEASIDE    ,CA,93955-3615,Proprietary  ,11,32,43,126,217,343
02086402,MARINELLO SCHOOL OF BEAUTY - SAN MATEO  ,CA,94401-3801,Proprietary  ,8,11,19,76,130,206
02086403,MARINELLO SCHOOL OF BEAUTY - HAYWARD    ,CA,94541-5111,Proprietary  ,10,21,31,131,243,374
02086404,MARINELLO SCHOOL OF BEAUTY - CASTRO VALL,CA,94546-5506,Proprietary  ,3,6,9,37,80,117
02091200,ELEGANCE INTERNATIONAL                  ,CA,90028-0000,Proprietary  ,7,23,30,173,260,433
02091700,KAPLAN COLLEGE                          ,CA,92123-1509,Proprietary  ,37,135,172,847,3081,3928
02091702,KAPLAN COLLEGE - CHULA VISTA            ,CA,91910-5342,Proprietary  ,19,31,50,310,623,933
02096100,FIELDING GRADUATE UNIVERSITY            ,CA,93105-0000,Private      ,0,28,28,3,1132,1135
02099200,AMERICAN CONSERVATORY THEATER           ,CA,94108-0000,Private      ,1,4,5,110,279,389
02110200,COLUMBIA COLLEGE                        ,CA,91356-0000,Private      ,1,2,3,401,196,597
02110800,CALIFORNIA COLLEGE SAN DIEGO            ,CA,92108-3821,Proprietary  ,56,187,243,2502,3873,6375
02111300,CUYAMACA COLLEGE                        ,CA,92019-0000,Public       ,44,123,167,5260,8052,13312
02119100,MISSION COLLEGE                         ,CA,95054-1897,Public       ,40,75,115,3874,5728,9602
02120600,SAYBROOK GRADUATE SCHOOL                ,CA,94111-1920,Private      ,0,2,2,5,765,770
02120700,SAN JOAQUIN VALLEY COLLEGE              ,CA,93291-0000,Proprietary  ,150,373,523,3100,6629,9729
02125000,CAREER ACADEMY OF BEAUTY                ,CA,92845-0000,Proprietary  ,2,7,9,110,247,357
02128200,"VICTOR VALLEY BEAUTY COLLEGE, INC       ",CA,92392-0000,Proprietary  ,8,15,23,192,296,488
02128300,INSTITUTE FOR BUSINESS & TECHNOLOGY     ,CA,95050-0000,Proprietary  ,16,43,59,164,673,837
02128301,INSTITUTE FOR BUSINESS & TECHNOLOGY - NA,CA,95670-6351,Proprietary  ,4,37,41,55,261,316
02138300,PALO ALTO UNIVERSITY                    ,CA,94304-1337,Private      ,0,4,4,86,1084,1170
02161800,MUSICIANS INSTITUTE                     ,CA,90028-6157,Proprietary  ,5,13,18,1376,1123,2499
02167800,ESTES INSTITUTE OF COSMETOLOGY          ,CA,93291-0000,Proprietary  ,2,4,6,120,141,261
02178700,CITRUS HEIGHTS BEAUTY COLLEGE           ,CA,95610-1410,Proprietary  ,3,6,9,140,174,314
02179916,ARGOSY UNIVERSITY - ORANGE COUNTY       ,CA,92868-4844,Proprietary  ,0,0,0,0,1,1
02179937,WESTERN STATE COLLEGE OF LAW            ,CA,92831-3014,Proprietary  ,0,3,3,37,994,1031
02179938,"ART INSTITUTE OF CALIFORNIA, HOLLYWOOD  ",CA,91601-3112,Proprietary  ,15,31,46,3129,2095,5224
02179941,"ART INSTITUTE OF CALIFORNIA, LOS ANGELES",CA,90405-3035,Proprietary  ,28,38,66,4818,3172,7990
02179947,"ART INSTITUTE OF CALIFORNIA, SAN DIEGO  ",CA,92108-4423,Proprietary  ,20,77,97,3306,3304,6610
02185800,MOLER BARBER COLLEGE                    ,CA,94611-0000,Proprietary  ,12,28,40,78,261,339
02188400,SIERRA VALLEY COLLEGE OF COURT REPORTING,CA,93726-0000,Proprietary  ,1,4,5,85,207,292
02208600,MADERA BEAUTY COLLEGE                   ,CA,93637-3519,Proprietary  ,1,1,2,82,85,167
02211000,SALON SUCCESS ACADEMY                   ,CA,92405-0000,Proprietary  ,1,5,6,116,162,278
02220000,COLLEEN O'HARA BEAUTY ACADEMY           ,CA,92701-0000,Proprietary  ,9,11,20,96,158,254
02220200,CALIFORNIA CULINARY ACADEMY             ,CA,94102-3336,Proprietary  ,11,27,38,582,845,1427
02221300,MARINELLO SCHOOL OF BEAUTY              ,CA,92553-0000,Proprietary  ,15,20,35,212,349,561
02221303,MARINELLO SCHOOL OF BEAUTY - SAN RAFAEL ,CA,94901-3224,Proprietary  ,4,8,12,44,120,164
02222000,AMERICAN FILM INSTITUTE                 ,CA,90027-0000,Private      ,6,17,23,606,1162,1768
02226000,EAST LOS ANGELES COLLEGE                ,CA,91754-0000,Public       ,195,333,528,18694,16703,35397
02228500,LIFE CHIROPRACTIC COLLEGE WEST          ,CA,94545-0000,Private      ,0,7,7,25,588,613
02230900,FREDRICK & CHARLES BEAUTY COLLEGE       ,CA,95501-0000,Proprietary  ,0,2,2,91,165,256
02231900,GEMOLOGICAL INSTITUTE OF AMERICA        ,CA,92008-4698,Private      ,0,11,11,90,399,489
02234300,FASHION CAREERS OF CALIFORNIA           ,CA,92110-0000,Proprietary  ,0,0,0,32,27,59
02236400,"THANH LE COLG, SCH OF COSMETOLOGY       ",CA,92840-0000,Proprietary  ,1,4,5,16,54,70
02237200,PHILLIPS GRADUATE INSTITUTE             ,CA,91316-0000,Private      ,2,4,6,10,262,272
02241800,AMERICAN CAREER COLLEGE                 ,CA,90004-0000,Proprietary  ,168,386,554,2252,4690,6942
02242700,BERKELEY CITY COLLEGE                   ,CA,94704-0000,Public       ,69,139,208,4598,6104,10702
02250602,EVEREST COLLEGE                         ,CA,91761-8525,Proprietary  ,25,44,69,694,1468,2162
02255400,INTERNATIONAL SCHOOL OF COSMETOLOGY     ,CA,90250-0000,Proprietary  ,12,13,25,229,304,533
02258600,ALAMEDA BEAUTY COLLEGE                  ,CA,94501-0000,Proprietary  ,4,20,24,220,378,598
02262400,YESHIVA OHR ELCHONON CHABAD             ,CA,90046-0000,Private      ,3,0,3,128,5,133
02263101,ANTHEM COLLEGE - SACRAMENTO             ,CA,95827-3378,Proprietary  ,9,77,86,184,600,784
02267600,INSTITUTE OF TRANSPERSONAL PSYCHLGY     ,CA,94303-4624,Private      ,0,5,5,25,625,650
02270600,LIFE PACIFIC COLLEGE                    ,CA,91773-0000,Private      ,1,1,2,476,280,756
02276800,WESTMINSTER SEMINARY CALIFORNIA         ,CA,92027-0000,Private      ,0,2,2,10,168,178
02277400,SOUTH COAST COLLEGE                     ,CA,92868-2616,Proprietary  ,2,16,18,277,579,856
02282300,ALHAMBRA BEAUTY COLLEGE                 ,CA,91802-0000,Proprietary  ,2,19,21,50,174,224
02285100,HILLTOP BEAUTY SCHOOL                   ,CA,94014-0000,Proprietary  ,1,5,6,32,144,176
02298000,DESIGN INSTITUTE OF SAN DIEGO           ,CA,92121-0000,Proprietary  ,1,9,10,269,358,627
02304300,"PLATT COLLEGE, SAN DIEGO                ",CA,92115-0000,Proprietary  ,2,11,13,297,508,805
02306300,KAPLAN COLLEGE                          ,CA,95368-0000,Proprietary  ,12,24,36,362,808,1170
02306302,KAPLAN COLLEGE - FRESNO                 ,CA,93612-3802,Proprietary  ,4,20,24,245,482,727
02309500,CLOVIS ADULT EDUC                       ,CA,93611-0000,Public       ,3,9,12,112,440,552
02312400,LA COLLEGE INTERNATIONAL                ,CA,90010-0000,Proprietary  ,0,0,0,1,3,4
02321801,ITT TECHNICAL INSTITUTE                 ,CA,93030-2649,Proprietary  ,0,0,0,0,1,1
02330500,LAGUNA COLLEGE OF ART AND DESIGN        ,CA,92651-0000,Private      ,1,4,5,757,318,1075
02332800,CENTER FOR EMPLOYMENT TRAINING          ,CA,95110-0000,Private      ,76,344,420,766,2988,3754
02338500,GLENDALE CAREER COLLEGE                 ,CA,91203-1207,Proprietary  ,15,51,66,339,805,1144
02338700,MARINELLO SCHOOL OF BEAUTY              ,CA,94103-0000,Proprietary  ,7,16,23,160,268,428
02338701,MARINELLO SCHOOL OF BEAUTY - CHICO      ,CA,95928-7184,Proprietary  ,4,17,21,138,257,395
02338702,MARINELLO SCHOOL OF BEAUTY - REDDING    ,CA,96001-1023,Proprietary  ,4,20,24,115,279,394
02338703,MARINELLO SCHOOL OF BEAUTY - FRESNO     ,CA,93711-3246,Proprietary  ,12,35,47,269,398,667
02342400,ACADEMY OF RADIO BROADCASTING           ,CA,92647-3809,Proprietary  ,0,14,14,113,307,420
02343400,BELLUS ACADEMY                          ,CA,92064-4633,Proprietary  ,15,40,55,412,718,1130
02345800,MONTEBELLO BEAUTY COLLEGE               ,CA,90640-0000,Proprietary  ,0,0,0,15,18,33
02351900,KAPLAN COLLEGE                          ,CA,95660-5512,Proprietary  ,12,54,66,578,1980,2558
02351901,KAPLAN COLLEGE - BAKERSFIELD            ,CA,93304-0000,Proprietary  ,15,45,60,628,1135,1763
02358000,THOMAS AQUINAS COLLEGE                  ,CA,93060-9622,Private      ,3,0,3,404,40,444
02359300,SHASTA BIBLE COLLEGE                    ,CA,96002-0000,Private      ,0,0,0,59,108,167
02482700,WESTERN UNIVERSITY OF HEALTH S          ,CA,91766-1854,Private      ,2,12,14,201,5879,6080
02494800,LOLA BEAUTY COLLEGE                     ,CA,92641-0000,Proprietary  ,1,7,8,38,66,104
02497300,TRINITY COLLEGE                         ,CA,93277-8109,Proprietary  ,18,48,66,296,883,1179
02500000,SAN JOAQUIN COLLEGE OF LAW              ,CA,93612-0000,Private      ,1,2,3,28,345,373
02518400,THE NATIONAL HISPANIC UNIVERSITY        ,CA,95127-0000,Proprietary  ,0,8,8,515,1117,1632
02519800,AVANCE BEAUTY COLLEGE                   ,CA,92154-0000,Proprietary  ,6,11,17,175,253,428
02520200,CALIFORNIA CAREER SCHOOLS               ,CA,92805-0000,Proprietary  ,1,4,5,106,262,368
02520300,INTERIOR DESIGNERS INSTITUTE            ,CA,92660-0000,Proprietary  ,2,6,8,54,225,279
02520400,ADRIAN'S BEAUTY COLLEGE OF TURLOCK      ,CA,95382-0000,Proprietary  ,8,10,18,162,183,345
02531801,PAUL MITCHELL THE SCHOOL-COSTA MESA     ,CA,92626-3804,Proprietary  ,5,10,15,160,262,422
02531804,PAUL MITCHELL THE SCHOOL - SAN DIEGO    ,CA,92101-0000,Proprietary  ,9,17,26,200,420,620
02537200,PALOMAR INSTITUTE OF COSMETOLOGY        ,CA,92069-0000,Proprietary  ,6,17,23,241,384,625
02539100,KAPLAN COLLEGE                          ,CA,91606-3231,Proprietary  ,23,49,72,484,1110,1594
02539102,KAPLAN COLLEGE -  RIVERSIDE             ,CA,92507-4223,Proprietary  ,4,25,29,508,1105,1613
02539500,IRVINE VALLEY COLLEGE                   ,CA,92620-0000,Public       ,73,127,200,7440,5763,13203
02542300,NATIONAL HOLISTIC INSTITUTE             ,CA,94608-0000,Proprietary  ,9,53,62,278,1177,1455
02543400,BROWNSON TECHNICAL SCHOOL               ,CA,92805-0000,Proprietary  ,1,17,18,57,284,341
02545900,HYPNOSIS MOTIVATION INSTITUTE           ,CA,91356-0000,Private      ,1,21,22,10,162,172
02546400,MTI BUSINESS COLLEGE INC                ,CA,95207-0000,Proprietary  ,1,15,16,95,340,435
02549000,KAPLAN COLLEGE                          ,CA,92083-7736,Proprietary  ,20,51,71,474,1346,1820
02549005,KAPLAN COLLEGE -  PALM SPRINGS          ,CA,92262-7011,Proprietary  ,12,20,32,378,621,999
02553500,ASSOCIATED TECHNICAL COLLEGE            ,CA,92101-0000,Proprietary  ,10,69,79,193,527,720
02553600,DIVERSIFIED LANGUAGE INSTITUTE          ,CA,90017-0000,Proprietary  ,16,145,161,112,1076,1188
02559300,UNITED EDUCATION INSTITUTE              ,CA,90020-0000,Proprietary  ,236,527,763,1333,3270,4603
02559400,INTERCOAST COLLEGES                     ,CA,92868-1656,Proprietary  ,45,324,369,407,3050,3457
02565400,KAPLAN COLLEGE                          ,CA,95207-6216,Proprietary  ,0,0,0,208,397,605
02570300,LOS ANGELES ORT TECHNICAL INSTITUTE     ,CA,90048-4904,Private      ,16,118,134,192,1049,1241
02577900,SANTA BARBARA BUSINESS COLLEGE          ,CA,93309-1664,Proprietary  ,40,63,103,554,1072,1626
02578000,SANTA BARBARA BUSINESS COLLEGE          ,CA,93454-6943,Proprietary  ,10,13,23,249,510,759
02584200,NEWBRIDGE COLLEGE                       ,CA,92701-0000,Proprietary  ,0,0,0,174,442,616
02591600,NORTH-WEST COLLEGE                      ,CA,91101-1744,Proprietary  ,14,18,32,145,331,476
02595600,ASIAN AMERICAN INTERNATIONAL BTY CG     ,CA,92683-4043,Proprietary  ,4,16,20,19,133,152
02597300,SOUTH BAYLO UNIVERSITY                  ,CA,92801-1701,Private      ,0,14,14,8,377,385
02602300,CENTRAL COAST COLLEGE                   ,CA,93901-3301,Proprietary  ,12,15,27,318,432,750
02608900,PINNACLE COLLEGE                        ,CA,91803-8842,Proprietary  ,1,7,8,80,105,185
02608901,PINNACLE COLLEGE - SACRAMENTO           ,CA,95670-6386,Proprietary  ,5,9,14,96,181,277
02609000,EMPERORS COLG OF TRAD ORIENTAL MED      ,CA,90403-5609,Proprietary  ,0,1,1,6,238,244
03010611,VIRGINIA COLLEGE - GOLF ACADEMY OF AMERI,CA,92008-6512,Proprietary  ,0,2,2,42,133,175
03011300,"CALIF STATE UNIV, SAN MARCOS            ",CA,92096-0001,Public       ,133,117,250,15330,8415,23745
03019900,CAPSTONE COLLEGE                        ,CA,91402-0000,Proprietary  ,4,11,15,33,104,137
03025600,DELL'ARTE SCH OF PHYSICAL THEATRE       ,CA,95525-0816,Private      ,0,0,0,9,49,58
03027700,PACIFIC COLLEGE OF ORIENTAL MED         ,CA,92108-4408,Proprietary  ,4,22,26,98,743,841
03029600,POMONA ADULT SCHOOL                     ,CA,91766-0000,Public       ,4,8,12,179,466,645
03031409,INTERNATIONAL ACADEMY OF DESIGN AND TECH,CA,95834-9664,Proprietary  ,0,9,9,296,566,862
03035700,LAS POSITAS COLLEGE                     ,CA,94551-6750,Public       ,44,55,99,3585,3404,6989
03039900,FREMONT COLLEGE                         ,CA,90703-5342,Proprietary  ,7,41,48,430,649,1079
03043900,NEWSCHOOL OF ARCHITECTURE & DESIGN      ,CA,92101-6634,Proprietary  ,2,9,11,368,623,991
03054100,ROYALE COLLEGE OF BEAUTY                ,CA,92590-2525,Proprietary  ,7,6,13,92,124,216
03062300,WESTECH COLLEGE                         ,CA,91764-4988,Proprietary  ,23,69,92,339,950,1289
03062400,MT DIABLO ADULT EDUC LOMA VISTA CTR     ,CA,94518-1122,Public       ,3,6,9,148,347,495
03062700,PLATT COLLEGE                           ,CA,90041-0000,Proprietary  ,46,56,102,612,965,1577
03062701,PLATT COLLEGE                           ,CA,91764-0000,Proprietary  ,23,31,54,530,787,1317
03062702,PLATT COLLEGE - RIVERSIDE               ,CA,92507-0730,Proprietary  ,20,17,37,641,786,1427
03063400,MODERN TECHNOLOGY SCHOOL                ,CA,92708-9821,Proprietary  ,5,9,14,102,227,329
03067400,BALDWIN PARK ADULT SCHOOL               ,CA,91706-4897,Public       ,3,7,10,209,448,657
03067500,INSTITUTE OF TECHNOLOGY                 ,CA,93612-3217,Proprietary  ,48,140,188,827,2325,3152
03069500,SAGE COLLEGE                            ,CA,92557-6720,Proprietary  ,0,24,24,184,828,1012
03072300,EVEREST COLLEGE                         ,CA,91761-3222,Proprietary  ,44,125,169,564,1141,1705
03072700,WESTWOOD COLLEGE - LOS ANGELES          ,CA,90010-1577,Proprietary  ,33,210,243,1582,5307,6889
03078200,AMERICAN CLG TRADITIONAL CHINESE MD     ,CA,94107-2813,Private      ,0,6,6,9,327,336
03084700,VENTURA ADULT\CONTINUING EDUCATION      ,CA,93003-7313,Public       ,2,29,31,73,412,485
03094400,MARINELLO SCHOOL OF BEAUTY              ,CA,95841-2909,Proprietary  ,13,33,46,163,375,538
03094401,MARINELLO SCHOOL OF BEAUTY - CONCORD    ,CA,94520-2581,Proprietary  ,9,20,29,134,261,395
03094402,MARINELLO SCHOOL OF BEAUTY- STOCKTON    ,CA,95203-3149,Proprietary  ,6,25,31,207,326,533
03097700,CENTRAL CALIF SCH CONTINUING EDUC       ,CA,93401-6739,Proprietary  ,0,6,6,108,271,379
03098200,YO SAN UNIV TRADITIONAL CHINESE MED     ,CA,90066-1103,Private      ,0,7,7,5,240,245
03108100,SUMMIT CAREER COLLEGE                   ,CA,92324-3956,Proprietary  ,12,56,68,477,1345,1822
03109500,DONGGUK  UNIVERSITY LOS ANGELES         ,CA,90020-1765,Private      ,0,9,9,37,149,186
03113300,UEI COLLEGE                             ,CA,93727-1620,Proprietary  ,69,165,234,812,1941,2753
03113600,SOUTHERN CALIFORNIA INST OF TECHNOL     ,CA,92805-3758,Proprietary  ,20,62,82,203,705,908
03116600,EAST SAN GABRIEL VLY REG OCCUP PROG     ,CA,91790-2105,Public       ,30,90,120,357,1035,1392
03125300,JOHN WESLEY INTER. BARBER & BTY CLG     ,CA,90813-4321,Proprietary  ,3,11,14,120,245,365
03125800,PREMIERE CAREER COLLEGE                 ,CA,91706-3746,Proprietary  ,14,51,65,214,572,786
03126800,PACIFICA GRADUATE INSTITUTE             ,CA,93013-0000,Proprietary  ,1,17,18,4,1059,1063
03128700,MT SIERRA COLLEGE                       ,CA,91016-3414,Proprietary  ,3,5,8,418,455,873
03131300,FIVE BRANCHES UNIVERSITY                ,CA,95062-4669,Proprietary  ,0,8,8,24,458,482
03144400,AMERICAN CLG OF HEALTH PROFESSIONS      ,CA,92505-3038,Proprietary  ,19,53,72,335,780,1115
03150500,VIRGINIA SEWING MACHINES & SCH CTR      ,CA,90015-3535,Proprietary  ,2,16,18,37,102,139
03162300,FOUR-D SUCCESS ACADEMY                  ,CA,92324-4218,Proprietary  ,19,42,61,244,815,1059
03163300,PACIFIC STATES UNIVERSITY               ,CA,90006-0000,Private      ,0,2,2,91,99,190
03195400,EVEREST COLLEGE                         ,CA,90501-2867,Proprietary  ,8,28,36,165,400,565
03210300,LE CORDON BLEU COLLEGE OF CULINARY ARTS ,CA,91101-5221,Proprietary  ,33,119,152,2294,3557,5851
03225300,AMERICAN UNIVERSITY OF HEALTH SCIENCES  ,CA,90755-3612,Proprietary  ,2,12,14,151,389,540
03242300,CAREER NETWORK INSTITUTE                ,CA,92868-4710,Proprietary  ,10,42,52,208,835,1043
03250300,COMMUNITY BASED EDUCATION AND DEVELOPMEN,CA,90010-2722,Private      ,18,34,52,133,373,506
03260300,CALIFORNIA STATE U-MONTEREY BAY         ,CA,93955-8001,Public       ,17,38,55,13621,4609,18230
03266300,BETHESDA UNIVERSITY OF CALIFORNIA       ,CA,92801-4132,Private      ,0,2,2,158,180,338
03278300,CLARITA CAREER COLLEGE                  ,CA,91351-5432,Proprietary  ,47,116,163,659,1380,2039
03288300,ACAD CHINESE CULTURE & HEALTH SCIS      ,CA,94512-0000,Private      ,0,3,3,31,231,262
03299300,PACIFIC COLLEGE                         ,CA,92626-3160,Proprietary  ,7,36,43,153,491,644
03308300,BRISTOL UNIVERSITY                      ,CA,92806-6198,Proprietary  ,3,27,30,52,247,299
03327400,ACUPUNCTURE AND INTEGRATIVE MEDICINE COL,CA,94704-2724,Private      ,0,4,4,46,280,326
03332300,SOUTHERN CA BIBLE CLG & SEMINARY        ,CA,92019-1109,Private      ,0,12,12,18,205,223
03359300,ST. FRANCIS CAREER COLLEGE              ,CA,90262-2659,Proprietary  ,7,7,14,53,139,192
03367300,PROFESSIONAL GOLFERS CAREER COLLEGE     ,CA,92591-6013,Proprietary  ,1,2,3,120,249,369
03395300,INTERNATIONAL CAREER DEVELOPMENT        ,CA,90027-5794,Proprietary  ,55,334,389,849,6274,7123
03399300,NORTHWESTERN TECHNICAL COLLEGE          ,CA,95670-4443,Proprietary  ,5,21,26,90,381,471
03403300,EPIC BIBLE COLLEGE                      ,CA,95841-3546,Private      ,0,20,20,137,610,747
03413400,ENGLISH CENTER  (THE)                   ,CA,94607-3734,Private      ,4,23,27,47,217,264
03427400,CAREER COLLEGES OF AMERICA              ,CA,90280-7420,Proprietary  ,0,0,0,404,1228,1632
03427500,UNIVERSITY OF ANTELOPE VALLEY           ,CA,93534-3324,Proprietary  ,36,77,113,782,1484,2266
03440400,MARIAN HEALTH CAREERS CENTER            ,CA,90010-1728,Proprietary  ,2,7,9,116,254,370
03441400,VALLEY CAREER COLLEGE                   ,CA,92020-3057,Proprietary  ,0,0,0,67,195,262
03458300,MY LE'S BEAUTY COLLEGE                  ,CA,95824-3039,Proprietary  ,2,20,22,110,302,412
03467300,MARINELLO SCHOOL OF BEAUTY              ,CA,92545-3661,Proprietary  ,15,31,46,164,365,529
03467301,MARINELLO SCHOOL OF BEAUTY - CATHEDRAL C,CA,92234-6656,Proprietary  ,0,0,0,37,37,74
03467302,MARINELLO SCHOOL OF BEAUTY - MURRIETA   ,CA,92563-5039,Proprietary  ,14,28,42,172,328,500
03467303,MARINELLO SCHOOL OF BEAUTY - NAPA       ,CA,94559-1237,Proprietary  ,6,25,31,92,171,263
03467304,MARINELLO SCHOOL OF BEAUTY - CITY OF IND,CA,91748-1674,Proprietary  ,6,15,21,69,168,237
03467305,MARINELLO SCHOOL OF BEAUTY - BELL       ,CA,90201-1193,Proprietary  ,5,8,13,104,123,227
03467306,MARINELLO SCHOOL OF BEAUTY - PARAMOUNT  ,CA,90723-5256,Proprietary  ,4,15,19,146,209,355
03467307,MARINELLO SCHOOL OF BEAUTY - HUNTINGTON ,CA,92646-2552,Proprietary  ,2,14,16,135,212,347
03479300,PROFESSIONAL CAREER INSTITUTE           ,CA,90703-2522,Proprietary  ,1,6,7,104,174,278
03516300,KING'S UNIVERSITY (THE)                 ,CA,91405-2233,Private      ,2,15,17,167,563,730
03532400,ADVANCED TRAINING ASSOCIATES            ,CA,92020-1236,Proprietary  ,4,1,5,45,183,228
03542400,COPPER MOUNTAIN COLLEGE                 ,CA,92252-6102,Public       ,7,45,52,792,2284,3076
03577300,COBA ACADEMY                            ,CA,92866-1407,Proprietary  ,2,8,10,43,69,112
03590400,NTMA TRAINING CENTERS OF SOUTHERN C     ,CA,90650-0000,Private      ,15,74,89,225,732,957
03592400,IRELL & MANELLA GRADUATE SCHOOL OF BIOLO,CA,91010-0000,Private      ,0,0,0,0,22,22
03598300,AVALON BEAUTY COLLEGE                   ,CA,93103-3137,Proprietary  ,7,6,13,164,137,301
03614300,DAVID'S ACADEMY OF BEAUTY               ,CA,91780-1089,Proprietary  ,1,21,22,39,248,287
03639300,WEST COAST ULTRASOUND INSTITUTE         ,CA,90211-3312,Proprietary  ,21,87,108,489,1636,2125
03646300,DESIGN'S SCHOOL OF COSMETOLOGY          ,CA,93446-9530,Proprietary  ,10,18,28,123,247,370
03681300,CALIFORNIA HEALING ARTS COLLEGE         ,CA,90025-0000,Proprietary  ,5,31,36,118,330,448
03695300,COMMUNITY ENHANCEMENT SERVICES          ,CA,91502-2750,Private      ,4,32,36,46,232,278
03695700,SANTIAGO CANYON COLLEGE                 ,CA,92869-4512,Public       ,45,58,103,4919,3247,8166
03696300,UNIVERSITY OF THE WEST                  ,CA,91770-3709,Private      ,1,3,4,55,117,172
03698300,WEST COAST UNIVERSITY                   ,CA,91606-3206,Proprietary  ,43,131,174,2704,6278,8982
03698400,CA COLLEGE OF VOCATIONAL CAREER         ,CA,93301-1800,Proprietary  ,4,11,15,208,591,799
03736300,ADVANCE BEAUTY COLLEGE                  ,CA,92843-4752,Proprietary  ,16,64,80,99,606,705
03736301,ADVANCE BEAUTY COLLEGE - LAGUNA HILLS   ,CA,92653-1980,Proprietary  ,2,8,10,2,8,10
03740400,ATI COLLEGE                             ,CA,90650-0000,Proprietary  ,2,16,18,96,243,339
03752400,SCHOOL OF URBAN MISSIONS                ,CA,94603-0000,Private      ,0,4,4,192,323,515
03759300,COMPUTER TUTOR BUSINESS & TECH INST     ,CA,95356-0000,Proprietary  ,1,12,13,126,321,447
03786300,ADVANCED COLLEGE                        ,CA,90280-5255,Proprietary  ,3,16,19,100,340,440
03797400,CAREER CARE INSTITUTE                   ,CA,93534-4766,Proprietary  ,8,17,25,303,966,1269
03797401,CAREER CARE INSTITUTE - VENTURA         ,CA,93003-0000,Proprietary  ,2,6,8,67,241,308
03797402,CAREER CARE INSTITUTE - MORENO VALLEY   ,CA,92553-7519,Proprietary  ,0,2,2,62,179,241
03814400,SOKA UNIVERSITY OF AMERICA              ,CA,92656-8081,Private      ,2,1,3,604,68,672
03853300,KECK GRADUATE INSTITUTE OF APPLIED LIFE ,CA,91711-4817,Private      ,0,2,2,4,149,153
03868300,WORLD MISSION UNIVERSITY                ,CA,90020-1789,Private      ,0,0,0,16,127,143
03868400,LOS ANGELES MUSIC ACADEMY               ,CA,91105-2540,Proprietary  ,3,5,8,255,228,483
03871300,FOLSOM LAKE COLLEGE                     ,CA,95630-6798,Public       ,32,123,155,3955,4938,8893
03874300,CAMBRIDGE JUNIOR COLLEGE                ,CA,95993-0000,Proprietary  ,9,23,32,266,590,856
03874400,COMMMUNITY CHRISTIAN COLLEGE            ,CA,92373-4465,Private      ,0,2,2,160,150,310
03889300,STANBRIDGE COLLEGE                      ,CA,92612-0000,Proprietary  ,24,49,73,441,1516,1957
03901300,PACIFIC COAST TRADE SCHOOL              ,CA,93033-2441,Proprietary  ,2,2,4,118,312,430
03910400,NATIONAL POLYTECHNIC COLLEGE            ,CA,90040-3066,Proprietary  ,2,1,3,148,185,333
03933300,MUELLER COLLEGE OF HOLISTIC STUDIES     ,CA,92116-2630,Proprietary  ,4,11,15,56,341,397
03935300,CALIFORNIA NURSES EDUCATIONAL INSTITUTE ,CA,92234-7248,Proprietary  ,4,14,18,114,337,451
03962300,AMERICAN INSTITUTE OF MASSAGE THERAPY   ,CA,92705-5463,Proprietary  ,1,5,6,83,136,219
03964400,INTERNATIONAL SCHOOL OF BEAUTY          ,CA,92260-2740,Proprietary  ,21,30,51,156,359,515
03969600,AMERICAN AUTO INSTITUTE                 ,CA,90703-2637,Proprietary  ,112,258,370,744,1554,2298
03971300,AMERICAN CAREER COLLEGE                 ,CA,91764-4906,Proprietary  ,76,156,232,1119,2246,3365
03973300,EX'PRESSION COLLEGE FOR DIGTAL ARTS     ,CA,94608-1021,Proprietary  ,11,9,20,655,560,1215
03974500,CALIFORNIA CAREER COLLEGE               ,CA,91303-2006,Proprietary  ,2,3,5,52,170,222
03980300,CALIFORNIA STATE UNIVERSITY CHANNEL ISLA,CA,93012-8599,Public       ,22,24,46,8676,3741,12417
03995300,UNIVERSITY OF EAST-WEST MEDICINE        ,CA,94087-6106,Proprietary  ,0,4,4,17,98,115
03999300,BEAUMONT ADULT SCHOOL                   ,CA,92223-1927,Public       ,0,1,1,53,199,252
04001300,PALACE BEAUTY COLLEGE                   ,CA,90006-4233,Proprietary  ,2,6,8,98,240,338
04003300,BLAKE AUSTIN COLLEGE                    ,CA,95687-3100,Proprietary  ,7,38,45,268,656,924
04004300,THUY PRINCESS BEAUTY COLLEGE            ,CA,91766-0000,Proprietary  ,2,4,6,44,111,155
04005300,UNITED STATES UNIVERSITY                ,CA,91911-1683,Proprietary  ,3,48,51,41,516,557
04014400,PALLADIUM TECHNICAL ACADEMY             ,CA,91731-2429,Proprietary  ,4,9,13,29,79,108
04023400,PROTEUS                                 ,CA,93291-3014,Private      ,0,0,0,17,51,68
04037300,LOS ANGELES FILM SCHOOL (THE)           ,CA,90028-7300,Proprietary  ,59,93,152,2133,2667,4800
04056300,CAREER COLLEGE OF CALIFORNIA            ,CA,92705-5805,Proprietary  ,7,18,25,163,345,508
04057300,TECHSKILLS OF CALIFORNIA                ,CA,95815-4025,Proprietary  ,2,90,92,212,1212,1424
04076400,GNOMON SCHOOL OF VISUAL EFFECTS         ,CA,90038-2616,Proprietary  ,0,6,6,146,238,384
04088300,WESTMED COLLEGE                         ,CA,95128-2541,Private      ,1,15,16,142,495,637
04088301,WESTMED COLLEGE - MERCED                ,CA,95340-9165,Private      ,3,17,20,146,329,475
04092300,COASTLINE BEAUTY COLLEGE                ,CA,92708-3847,Proprietary  ,3,35,38,75,321,396
04092400,MAKE-UP DESIGNORY                       ,CA,91502-1322,Proprietary  ,6,4,10,342,389,731
04100400,TAFT UNIVERSITY SYSTEM (THE)            ,CA,92704-6954,Proprietary  ,0,17,17,14,580,594
04109300,ACADEMY OF BARBERING ARTS (THE)         ,CA,91324-3406,Proprietary  ,0,0,0,9,22,31
04111300,WEST HILLS COLLEGE LEMOORE              ,CA,93245-9248,Public       ,14,90,104,2537,3487,6024
04114500,VALLEY COLLEGE OF MEDICAL CAREERS       ,CA,91304-2354,Proprietary  ,3,12,15,91,188,279
04115300,COACHELLA VALLEY BEAUTY COLLEGE         ,CA,92253-2051,Proprietary  ,6,5,11,120,147,267
04115600,MAYFIELD COLLEGE                        ,CA,92234-7014,Proprietary  ,35,100,135,275,623,898
04116000,VIDEO SYMPHONY ENTERTRAINING            ,CA,91502-3253,Proprietary  ,7,19,26,131,449,580
04118800,NEW YORK FILM ACADEMY                   ,CA,91608-1002,Proprietary  ,17,32,49,908,1219,2127
04119200,CAREER COLLEGE CONSULTANTS              ,CA,90041-2088,Proprietary  ,2,19,21,51,214,265
04126400,CHAMPION INSTITUTE OF COSMETOLOGY       ,CA,92264-7458,Proprietary  ,0,3,3,39,66,105
04126500,COAST CAREER INSTITUTE                  ,CA,90015-3040,Proprietary  ,21,98,119,133,484,617
04127100,"UNIVERSITY OF CALIFORNIA, MERCED        ",CA,95343-5001,Public       ,74,20,94,15901,2302,18203
04127900,TUI UNIVERSITY                          ,CA,90630-5023,Proprietary  ,4,248,252,72,4013,4085
04129700,INTERNATIONAL POLYTECHNIC INSTITUTE     ,CA,92231-1737,Private      ,0,1,1,18,16,34
04129803,MEDIATECH INSTITUTE - OCEANSIDE         ,CA,92054-5116,Proprietary  ,3,12,15,72,152,224
04132400,ACADEMY OF ESTHETICS AND COSMETOLOGY    ,CA,91342-3373,Proprietary  ,2,7,9,71,91,162
04132700,INFOTECH CAREER COLLEGE                 ,CA,90706-5579,Proprietary  ,4,16,20,62,224,286
04133000,BIOHEALTH COLLEGE                       ,CA,95134-2033,Proprietary  ,2,15,17,88,375,463
04133100,CALIFORNIA UNIVERSITY OF MANAGEMENT AND ,CA,92801-1702,Private      ,0,3,3,30,111,141
04134500,CAREER COLLEGE OF SAN DIEGO             ,CA,92102-3348,Proprietary  ,12,43,55,275,1030,1305
04134700,INTERNATL PROFESSIONAL SCHL OF BODYWORK ,CA,92123-1520,Proprietary  ,1,4,5,64,303,367
04137200,BORNER'S BARBER COLLEGE                 ,CA,90047-3856,Proprietary  ,3,28,31,85,217,302
04138700,CAO INSTITUTE OF AESTHETICS (THE)       ,CA,91801-3903,Proprietary  ,7,10,17,109,200,309
04140500,HORIZON UNIVERSITY                      ,CA,92111-2622,Private      ,0,2,2,61,199,260
04141300,SAN FRANCISCO INSTITUTE OF ESTHETICS    ,CA,94103-4083,Proprietary  ,6,10,16,161,265,426
04141400,LAURUS COLLEGE                          ,CA,93401-5405,Proprietary  ,18,87,105,233,1189,1422
04141700,HEALING HANDS SCHOOL OF HOLISTIC HEALTH ,CA,92025-1722,Proprietary  ,1,9,10,56,241,297
04142500,TOURO COLLEGE LOS ANGELES               ,CA,90046-4506,Private      ,1,17,18,118,249,367
04142600,TOURO UNIVERSITY                        ,CA,94592-1118,Private      ,0,13,13,42,2989,3031
04143800,WOODLAND COMMUNITY COLLEGE              ,CA,95776-5156,Public       ,19,56,75,1607,2003,3610
04144200,CAREER DEVELOPMENT INSTITUTE            ,CA,90035-4364,Proprietary  ,3,12,15,55,244,299
04145000,SAN DIEGO CULINARY INSTITUTE            ,CA,91941-6435,Proprietary  ,4,22,26,418,734,1152
04145600,INTERNATIONAL COLLEGE OF COSMETOLOGY    ,CA,94601-3525,Proprietary  ,2,14,16,71,268,339
04146000,NATIONAL CAREER COLLEGE                 ,CA,91605-1400,Proprietary  ,6,17,23,43,186,229
04148200,BEYOND 21ST CENTURY BEAUTY ACADEMY      ,CA,90670-6316,Proprietary  ,3,3,6,39,53,92
04148900,N CALIF INSTITUTE OF COSMETOLOGY        ,CA,94577-2820,Proprietary  ,1,3,4,28,93,121
04149700,HOMESTEAD SCHOOLS                       ,CA,90505-5945,Private      ,3,29,32,80,283,363
04150000,CENTRAL NURSING COLLEGE                 ,CA,90010-2444,Proprietary  ,0,7,7,243,386,629
04150100,GOLDEN STATE COLLEGE OF COURT REPORTING ,CA,94568-2948,Proprietary  ,0,1,1,14,73,87
04150300,RWM FIBER OPTICS                        ,CA,90746-1051,Proprietary  ,2,9,11,23,158,181
04150500,"PREFERRED COLLEGE OF NURSING, LOS ANGELE",CA,90010-2202,Proprietary  ,1,5,6,136,416,552
04152800,CALIFORNIA ACADEMY (THE) - A PAUL MITCHE,CA,95825-2276,Proprietary  ,13,28,41,461,659,1120
04153900,PROVIDENCE CHRISTIAN COLLEGE            ,CA,91104-2635,Private      ,1,2,3,95,60,155
04154400,FRANKLIN CAREER COLLEGE                 ,CA,91761-1522,Proprietary  ,0,0,0,34,124,158
04155500,"ACADEMY FOR JEWISH RELIGION, CALIFORNIA ",CA,90024-3234,Private      ,2,3,5,31,108,139
04156100,TONI & GUY HAIRDRESSING ACADEMY         ,CA,95356-9695,Proprietary  ,6,10,16,107,194,301
04157800,GRACE MISSION UNIVERSITY                ,CA,92833-3860,Private      ,0,2,2,17,90,107
04158200,PAUL MITCHELL THE SCHOOL SHERMAN OAKS   ,CA,91403-5882,Proprietary  ,10,15,25,273,312,585
04158700,HOLLYWOOD BEAUTY COLLEGE                ,CA,95210-3514,Proprietary  ,2,13,15,138,259,397
04158900,FLAIR BEAUTY COLLEGE                    ,CA,91351-3381,Proprietary  ,1,11,12,49,90,139
04159600,GALAXY MEDICAL COLLEGE                  ,CA,91606-1593,Proprietary  ,0,0,0,40,71,111
04159700,AMERICAN MEDICAL SCIENCES CENTER        ,CA,91204-5108,Proprietary  ,3,6,9,88,179,267
04160100,TRINITY VOCATIONAL CENTER               ,CA,90248-4334,Proprietary  ,0,3,3,63,263,326
04160400,ANGELES COLLEGE OF NURSING              ,CA,90010-2100,Proprietary  ,6,13,19,510,715,1225
04161300,PREFERRED COLLEGE OF NURSING            ,CA,91401-1442,Proprietary  ,1,2,3,61,184,245
04161700,SHASTA SCHOOL OF COSMETOLOGY            ,CA,96003-0000,Proprietary  ,5,0,5,125,183,308
04161800,BRANDMAN UNIVERSITY                     ,CA,92618-3801,Private      ,21,447,468,570,10067,10637
04162800,S.I.C.E PAUL MITCHELL PARTNER SCHOOL    ,CA,95350-1440,Proprietary  ,16,23,39,349,458,807
04163400,COSMO BEAUTY ACADEMY                    ,CA,95605-1904,Proprietary  ,2,17,19,216,387,603
04163900,L.A. BARBER COLLEGE                     ,CA,90013-1121,Proprietary  ,0,0,0,13,29,42
04164400,ANGELES INSTITUTE                       ,CA,90712-2903,Proprietary  ,3,3,6,87,216,303
04165900,PAUL MITCHELL THE SCHOOL FRESNO         ,CA,93710-7617,Proprietary  ,7,24,31,358,408,766
04167000,PAUL MITCHELL THE SCHOOL TEMECULA       ,CA,92591-4663,Proprietary  ,16,28,44,287,338,625
04169200,TRAMY BEAUTY SCHOOL                     ,CA,92115-6347,Proprietary  ,14,40,54,141,407,548
04169700,UNITEK COLLEGE                          ,CA,94538-3185,Proprietary  ,24,172,196,527,2451,2978
04169800,GURNICK ACADEMY OF MEDICAL ARTS         ,CA,94403-1849,Proprietary  ,8,24,32,340,1540,1880
04172000,SOUTHERN CALIFORNIA UNIVERSITY SOMA     ,CA,90017-2211,Proprietary  ,0,11,11,233,403,636
04173400,SANTA ANA BEAUTY ACADEMY                ,CA,92705-7820,Proprietary  ,0,5,5,65,98,163
04173500,MORENO VALLEY COLLEGE                   ,CA,92551-2204,Public       ,74,144,218,5680,7628,13308
04175200,PAUL MITCHELL THE SCHOOL EAST BAY       ,CA,94523-5515,Proprietary  ,17,20,37,276,315,591
04175400,ELITE COSMETOLOGY SCHOOL                ,CA,92284-2860,Proprietary  ,6,13,19,55,146,201
04176100,NORCO COLLEGE                           ,CA,92860-2600,Public       ,60,102,162,5299,5492,10791
04176200,TWIN RIVERS ADULT SCHOOL                ,CA,95660-5523,Public       ,0,0,0,20,108,128
04176300,BERGIN UNIVERSITY OF CANINE STUDIES     ,CA,95407-6834,Private      ,1,7,8,33,113,146
04177200,REAL BARBERS COLLEGE (THE)              ,CA,92805-2533,Proprietary  ,17,15,32,119,196,315
04178900,HANDS-ON MEDICAL MASSAGE SCHOOL         ,CA,92373-6271,Proprietary  ,1,4,5,30,73,103
04180000,CINTA AVEDA INSTITUTE                   ,CA,94108-3204,Proprietary  ,6,15,21,205,479,684
04181200,IPPT CAREER SCHOOL                      ,CA,91601-2028,Proprietary  ,13,66,79,97,415,512
04181600,INTEGRITY COLLEGE OF HEALTH             ,CA,91104-2300,Proprietary  ,4,6,10,8,53,61
04185200,SALINAS BEAUTY COLLEGE                  ,CA,93901-2405,Proprietary  ,6,7,13,72,132,204
04185500,ACADEMY OF COUTURE ART                  ,CA,90069-5701,Proprietary  ,0,6,6,135,152,287
04185600,MEDICAL ALLIED CAREER CENTER            ,CA,90670-4710,Proprietary  ,0,2,2,17,112,129
04185700,ACADEMY FOR SALON PROFESSIONALS (THE)   ,CA,95050-4057,Proprietary  ,8,14,22,147,246,393
04186900,"INTERNATIONAL COLLEGE OF BEAUTY, ARTS & ",CA,90039-1012,Proprietary  ,2,19,21,135,242,377
04187900,JOE BLASCO MAKEUP ARTIST TRAINING CENTER,CA,90027-5580,Proprietary  ,0,0,0,194,315,509
04189300,ALLIED AMERICAN UNIVERSITY              ,CA,92653-1337,Proprietary  ,7,223,230,157,2846,3003
04189700,CALIFORNIA MIRAMAR UNIVERSITY           ,CA,92126-7501,Proprietary  ,4,26,30,560,825,1385
04189800,ACADEMY FOR SALON PROFESSIONALS         ,CA,91304-2305,Proprietary  ,0,8,8,82,175,257
04190800,SANTA ANA BEAUTY COLLEGE                ,CA,92706-2321,Proprietary  ,1,17,18,63,142,205
04190900,SUTTER BEAUTY COLLEGE                   ,CA,95991-3624,Proprietary  ,4,6,10,19,56,75
04191300,ANNENBERG SCHOOL OF NURSING             ,CA,91335-5426,Private      ,0,2,2,44,95,139
04193500,LEMELANGE ACADEMY OF HAIR               ,CA,94558-2935,Proprietary  ,3,7,10,38,91,129
04193700,JOHN PAUL THE GREAT CATHOLIC UNIVERSITY ,CA,92131-1652,Private      ,0,2,2,226,128,354
04194300,COLTON-REDLANDS-YUCAIPA REGIONAL OCCUPAT,CA,92374-2896,Public       ,2,4,6,136,228,364
04194600,BRAND COLLEGE                           ,CA,91203-3646,Proprietary  ,1,1,2,28,67,95
04195200,DIAMOND BEAUTY COLLEGE                  ,CA,91733-2180,Proprietary  ,0,5,5,11,50,61
04195400,NCP COLLEGE OF NURSING                  ,CA,94080-1005,Proprietary  ,1,14,15,122,333,455
04195401,NCP COLLEGE OF NURSING - HAYWARD CAMPUS ,CA,94541-7026,Proprietary  ,1,6,7,163,383,546
04205800,"SAE INSTITUTE OF TECHNOLOGY, LOS ANGELES",CA,90028-7219,Proprietary  ,21,28,49,289,438,727
04206800,ADVANCE BEAUTY TECHS ACADEMY            ,CA,92583-6572,Proprietary  ,0,4,4,49,119,168
04208100,UKIAH ADULT SCHOOL                      ,CA,95482-3865,Public       ,0,2,2,19,133,152
04208400,RIVERSIDE COUNTY OFFICE OF EDUCATION    ,CA,92503-3504,Public       ,0,5,5,139,342,481
04208900,ADVANCED CAREER INSTITUTE               ,CA,93291-9254,Proprietary  ,3,45,48,85,522,607
04209800,HINTON BARBER COLLEGE                   ,CA,94590-4547,Proprietary  ,1,4,5,46,125,171
04210600,ADVANCED COMPUTING INSTITUTE            ,CA,90010-3911,Proprietary  ,2,28,30,135,345,480
04211900,XAVIER COLLEGE SCHOOL OF NURSING        ,CA,95202-1332,Proprietary  ,1,22,23,159,371,530
04212000,LAWRENCE & COMPANY COLLEGE OF COSMETOLOG,CA,93230-4102,Proprietary  ,6,9,15,64,113,177
04215100,CALIFORNIA CAREER INSTITUTE             ,CA,92840-2816,Proprietary  ,2,7,9,36,210,246
04215300,COSMO FACTORY COSMETOLOGY ACADEMY (THE) ,CA,95060-4401,Proprietary  ,0,2,2,54,97,151
04216300,UEI COLLEGE                             ,CA,95065-1520,Proprietary  ,4,7,11,203,500,703
04217100,RUDOLF STEINER COLLEGE                  ,CA,95628-6811,Private      ,0,2,2,2,63,65
04217500,W INSTITUTE OF COSMETOLOGY              ,CA,94521-5385,Proprietary  ,2,2,4,32,83,115
04221800,TONI&GUY HAIRDRESSING ACADEMY           ,CA,95337-5703,Proprietary  ,7,9,16,50,99,149
04221900,COMPUTER TRAINING ACADEMY               ,CA,92507-2122,Proprietary  ,3,40,43,17,134,151
04222200,FAB SCHOOL (THE)                        ,CA,92507-3434,Proprietary  ,6,16,22,72,183,255
04223700,BAY AREA MEDICAL ACADEMY                ,CA,94102-2844,Proprietary  ,2,15,17,12,53,65
04226100,LAWRENCE AND COMPANY COLLEGE OF COSMETOL,CA,93662-3509,Proprietary  ,4,4,8,9,10,19
04228100,HIGH DESERT MEDICAL COLLEGE             ,CA,93534-1134,Proprietary  ,32,66,98,55,134,189
04228800,BAY AREA COLLEGE OF NURSING             ,CA,94303-4617,Proprietary  ,1,18,19,1,18,19
04237100,SALON PROFESSIONAL ACADEMY (THE)        ,CA,95129-5101,Proprietary  ,8,17,25,8,17,25
04237800,CALIFORNIA BARBER AND BEAUTY COLLEGE    ,CA,92115-4730,Proprietary  ,0,2,2,0,2,2
00184600,BRIAR CLIFF UNIVERSITY                  ,IA,51104-2100,Private      ,3,17,20,1315,741,2056
00184700,BUENA VISTA UNIVERSITY                  ,IA,50588-9987,Private      ,2,84,86,1799,2200,3999
00184800,SOUTHEASTERN COMMUNITY COLLEGE          ,IA,52655-0000,Public       ,22,74,96,1285,2023,3308
00185000,CENTRAL COLLEGE                         ,IA,50219-1999,Private      ,2,1,3,2206,158,2364
00185200,CLARKE UNIVERSITY                       ,IA,52001-3198,Private      ,2,8,10,1324,614,1938
00185400,COE COLLEGE                             ,IA,52402-5092,Private      ,1,2,3,2558,306,2864
00185500,DES MOINES UNIV-OSTEOPATHIC MED CTR     ,IA,50312-0000,Private      ,0,8,8,46,1788,1834
00185600,CORNELL COLLEGE                         ,IA,52314-1098,Private      ,2,0,2,2096,122,2218
00185700,SOUTHWESTERN COMMUNITY COLLEGE          ,IA,50801-1098,Public       ,2,25,27,697,739,1436
00185800,DIVINE WORD COLLEGE                     ,IA,52045-0380,Private      ,0,0,0,32,17,49
00185900,DORDT COLLEGE                           ,IA,51250-1697,Private      ,5,3,8,1555,119,1674
00186000,DRAKE UNIVERSITY                        ,IA,50311-4505,Private      ,7,24,31,4994,2305,7299
00186200,ELLSWORTH COMMUNITY COLLEGE             ,IA,50126-1199,Public       ,35,14,49,879,448,1327
00186400,IOWA LAKES COMMUNITY COLLEGE            ,IA,51334-2234,Public       ,15,25,40,1203,1103,2306
00186500,IOWA CENTRAL COMMUNITY COLLEGE          ,IA,50501-0000,Public       ,26,110,136,2987,3427,6414
00186600,GRACELAND UNIVERSITY                    ,IA,50140-1699,Private      ,6,61,67,1391,1665,3056
00186700,GRAND VIEW UNIVERSITY                   ,IA,50316-1599,Private      ,5,22,27,2193,1638,3831
00186800,GRINNELL COLLEGE                        ,IA,50112-1690,Private      ,1,2,3,2914,112,3026
00186900,IOWA STATE UNIV SCIENCE & TECHNOLOG     ,IA,50011-2028,Public       ,86,105,191,27629,6824,34453
00187100,IOWA WESLEYAN COLLEGE                   ,IA,52641-1398,Private      ,3,2,5,832,405,1237
00187300,LORAS COLLEGE                           ,IA,52004-0178,Private      ,2,3,5,2071,247,2318
00187400,LUTHER COLLEGE                          ,IA,52101-1045,Private      ,3,1,4,3291,147,3438
00187500,MARSHALLTOWN COMMUNITY COLLEGE          ,IA,50158-4760,Public       ,16,21,37,789,1008,1797
00187700,NORTH IOWA AREA COMMUNITY COLLEGE       ,IA,50401-7299,Public       ,14,21,35,1516,1255,2771
00187900,MORNINGSIDE COLLEGE                     ,IA,51106-1751,Private      ,5,56,61,2177,1044,3221
00188000,MOUNT MERCY UNIVERSITY                  ,IA,52402-4797,Private      ,1,21,22,1037,1222,2259
00188300,NORTHWESTERN COLLEGE                    ,IA,51041-1996,Private      ,1,8,9,1531,170,1701
00188700,SIMPSON COLLEGE                         ,IA,50125-1297,Private      ,1,11,12,2232,604,2836
00188900,ST AMBROSE UNIVERSITY                   ,IA,52803-2898,Private      ,6,34,40,3584,1666,5250
00189000,UNIVERSITY OF NORTHERN IOWA             ,IA,50614-0002,Public       ,16,76,92,10311,3238,13549
00189100,UNIVERSITY OF DUBUQUE                   ,IA,52001-5099,Private      ,3,22,25,2263,836,3099
00189200,UNIVERSITY OF IOWA                      ,IA,52242-1316,Public       ,43,106,149,22288,9732,32020
00189300,UPPER IOWA UNIVERSITY                   ,IA,52142-9206,Private      ,14,247,261,1581,6306,7887
00189500,WALDORF COLLEGE                         ,IA,50436-1700,Proprietary  ,3,30,33,698,856,1554
00189600,WARTBURG COLLEGE                        ,IA,50677-2200,Private      ,0,1,1,2286,124,2410
00189700,WARTBURG THEOLOGICAL SEMINARY           ,IA,52004-5004,Private      ,0,0,0,13,135,148
00190000,WILLIAM PENN UNIVERSITY                 ,IA,52577-1799,Private      ,5,35,40,1217,1284,2501
00396300,AIB COLLEGE OF BUSINESS                 ,IA,50321-1799,Private      ,5,26,31,826,953,1779
00407500,ESTRN IOWA COMMUNITY COLLEGE DIST       ,IA,52801-1221,Public       ,2,17,19,205,679,884
00407501,CLINTON COMMUNITY COLLEGE               ,IA,52732-0000,Public       ,12,81,93,563,1143,1706
00407502,MUSCATINE COMMUNITY COLLEGE             ,IA,52761-0000,Public       ,7,24,31,624,793,1417
00407503,SCOTT COMMUNITY COLLEGE                 ,IA,52722-0000,Public       ,21,70,91,1737,3362,5099
00407600,KIRKWOOD COMMUNITY COLLEGE              ,IA,52406-2068,Public       ,71,235,306,7246,8396,15642
00422009,HAMILTON COLLEGE -  COUNCIL BLUFFS      ,IA,51503-5289,Proprietary  ,0,0,0,25,273,298
00423300,MERCY/ST. LUKE'S SCH RAD TECH           ,IA,52402-0000,Private      ,0,1,1,34,67,101
00458600,KAPLAN UNIVERSITY                       ,IA,52807-2095,Proprietary  ,431,6425,6856,5223,92307,97530
00458604,KAPLAN UNIVERSITY - CEDAR RAPIDS        ,IA,52404-2998,Proprietary  ,11,93,104,203,2100,2303
00458605,KAPLAN UNIVERSITY - DES MOINES          ,IA,50323-5702,Proprietary  ,11,107,118,209,2480,2689
00458606,KAPLAN UNIVERSITY - MASON CITY          ,IA,50401-4665,Proprietary  ,4,46,50,78,1005,1083
00458607,KAPLAN UNIVERSITY - CEDAR FALLS         ,IA,50613-6309,Proprietary  ,4,65,69,156,1682,1838
00458700,NORTHEAST IOWA COMMUNITY COLLEGE        ,IA,52132-0400,Public       ,12,22,34,751,834,1585
00458701,NORTHEAST IOWA COMMUNITY COLLEGE        ,IA,52068-0000,Public       ,18,44,62,1201,1554,2755
00459500,HAWKEYE COMMUNITY COLLEGE               ,IA,50701-0000,Public       ,26,92,118,3120,3186,6306
00459800,IOWA WESTERN CMTY CLG-COUNCIL BLUFF     ,IA,51502-0000,Public       ,50,96,146,3948,4000,7948
00460000,NORTHWEST IOWA COMMUNITY COLLEGE        ,IA,51201-1046,Public       ,8,17,25,604,518,1122
00626700,IOWA METHODIST MEDICAL CENTER SCHOOLS   ,IA,50309-1499,Private      ,2,3,5,63,141,204
00627300,MERCY COLLEGE OF HEALTH SCIENCES        ,IA,50309-1239,Private      ,8,29,37,523,1185,1708
00712000,DES MOINES AREA CMTY COLLEGE            ,IA,50021-0000,Public       ,121,452,573,8098,12093,20191
00712100,FAITH BAPTIST BIBLE CLG & THEOL SEM     ,IA,50021-0000,Private      ,0,4,4,286,82,368
00729100,ST LUKE'S COLLEGE                       ,IA,51104-0263,Private      ,1,2,3,131,224,355
00731600,WESTERN IOWA TECH COMMUNITY COLLEGE     ,IA,51106-0000,Public       ,45,105,150,2174,3742,5916
00758800,CAPRI COLLEGE                           ,IA,52004-0873,Proprietary  ,8,10,18,103,169,272
00761100,EQ SCHOOL OF HAIR DESIGN                ,IA,51503-0813,Proprietary  ,0,8,8,55,85,140
00765600,AMERICAN COLLEGE OF HARISTYLING -CR     ,IA,52402-0000,Proprietary  ,0,3,3,14,57,71
00765800,AMER COLL OF HAIRSTYLING-DES MOINES     ,IA,50309-5446,Proprietary  ,2,6,8,18,72,90
00765900,LA JAMES COLLEGE OF HAIRSTYLING         ,IA,50401-3308,Proprietary  ,3,4,7,74,85,159
00771700,CAPRI COLLEGE                           ,IA,52807-2622,Proprietary  ,8,12,20,150,313,463
00794100,COLLEGE OF HAIR DESIGN                  ,IA,50703-1834,Proprietary  ,2,2,4,22,80,102
00826000,IOWA SCHOOL OF BEAUTY INC               ,IA,50322-0000,Proprietary  ,5,9,14,107,284,391
00840300,INDIAN HILLS COMMUNITY COLLEGE          ,IA,52501-1398,Public       ,43,117,160,2167,3015,5182
00840301,INDIAN HILLS COMMUNITY COLLEGE          ,IA,52544-1223,Public       ,0,0,0,15,16,31
00842400,LA JAMES INTERNATIONAL COLLEGE          ,IA,50501-5577,Proprietary  ,1,6,7,60,82,142
00959300,LA'JAMES COLLEGE OF HAIRSTYLING         ,IA,52240-0000,Proprietary  ,0,7,7,57,94,151
01111300,MAHARISHI UNIV OF MANAGEMENT            ,IA,52557-0001,Private      ,1,3,4,205,533,738
01206400,HAMILTON TECHNICAL COLLEGE              ,IA,52807-2653,Proprietary  ,5,8,13,95,317,412
01230000,PALMER COLLEGE OF CHIROPRACTIC          ,IA,52803-5287,Private      ,0,4,4,106,2227,2333
01300600,LA' JAMES INTERNATIONAL COLLEGE-CF      ,IA,50613-5242,Proprietary  ,0,2,2,70,108,178
02090300,CAPRI COLLEGE                           ,IA,52404-0000,Proprietary  ,8,10,18,175,220,395
02134500,LA JAMES INTERNATIONAL COLLEGE - DAV    ,IA,52806-3952,Proprietary  ,0,4,4,34,101,135
02160900,PCI ACADEMY                             ,IA,50010-6062,Proprietary  ,4,6,10,128,116,244
02262500,FAUST INSTITUTE OF COSMETOLOGY          ,IA,50588-0000,Proprietary  ,4,2,6,38,55,93
02274100,LA' JAMES INTERNATIONAL COLLEGE - DM    ,IA,50131-0000,Proprietary  ,2,9,11,87,164,251
02289000,AMERICAN HAIR ACADEMY                   ,IA,52627-4530,Proprietary  ,1,3,4,27,46,73
02306900,IOWA SCHOOL OF BEAUTY                   ,IA,52501-0000,Proprietary  ,1,4,5,49,81,130
02328900,EMMAUS BIBLE COLLEGE                    ,IA,52001-0000,Private      ,0,2,2,258,61,319
02330900,IOWA SCHOOL OF BEAUTY                   ,IA,50158-0000,Proprietary  ,0,1,1,19,51,70
02609200,VATTEROTT COLLEGE                       ,IA,50321-4704,Proprietary  ,8,42,50,157,751,908
03069100,ALLEN COLLEGE                           ,IA,50703-1916,Private      ,1,4,5,381,673,1054
03441300,IOWA SCHOOL OF BEAUTY                   ,IA,51106-5111,Proprietary  ,1,2,3,42,114,156
03607400,TOTAL LOOK SCHOOL OF COSMETOLOGY AND MAS,IA,52136-1053,Proprietary  ,0,0,0,10,18,28
03720300,CARLSON COLLEGE OF MASSAGE THERAPY      ,IA,52205-7519,Proprietary  ,0,0,0,24,47,71
04051313,ART INSTITUTE OF PHOENIX (THE) - BROWN M,IA,52722-3628,Proprietary  ,1,1,2,33,86,119
04089300,BIO-CHI INSTITUTE OF MASSAGE THERAPY    ,IA,51103-2138,Proprietary  ,0,0,0,9,24,33
04177800,SALON PROFESSIONAL ACADEMY (THE)        ,IA,52240-6083,Proprietary  ,1,1,2,48,71,119
04203300,AVEDA INSTITUTE DES MOINES              ,IA,50266-8137,Proprietary  ,6,6,12,230,204,434
00259600,ATLANTIC COMMUNITY COLLEGE              ,NJ,08330-2699,Public       ,35,102,137,4339,5357,9696
00259700,BLOOMFIELD COLLEGE                      ,NJ,07003-3425,Private      ,12,19,31,3044,1731,4775
00259800,CALDWELL COLLEGE                        ,NJ,07006-6195,Private      ,9,17,26,2570,1319,3889
00259900,CENTENARY COLLEGE                       ,NJ,07840-2184,Private      ,5,34,39,1846,1050,2896
00260000,COLLEGE OF SAINT ELIZABETH              ,NJ,07960-6989,Private      ,2,10,12,1079,833,1912
00260100,CUMBERLAND COUNTY COLLEGE               ,NJ,08362-9912,Public       ,34,74,108,2558,3712,6270
00260300,DREW UNIVERSITY                         ,NJ,07940-4063,Private      ,3,6,9,3227,741,3968
00260700,FAIRLEIGH DICKINSON UNIV-TEANECK        ,NJ,07666-1996,Private      ,16,72,88,4959,3415,8374
00260701,FAIRLEIGH DICKINSON UNIV-FLORHAM        ,NJ,07940-0000,Private      ,8,11,19,3817,1238,5055
00260702,FAIRLEIGH DICKINSON UNIV-ED WMS CLG     ,NJ,07601-0000,Private      ,3,9,12,591,562,1153
00260703,FAIRLEIGH DICKINSON UNIVERSITY          ,NJ,07940-0000,Private      ,3,11,14,1873,866,2739
00260800,GEORGIAN COURT UNIVERSITY               ,NJ,08701-2697,Private      ,3,19,22,1815,1473,3288
00260900,ROWAN UNIVERSITY                        ,NJ,08028-1702,Public       ,27,65,92,15399,6093,21492
00261000,FELICIAN COLLEGE                        ,NJ,07644-2198,Private      ,9,21,30,2003,1558,3561
00261300,NEW JERSEY CITY UNIVERSITY              ,NJ,07305-1597,Public       ,14,91,105,5767,7276,13043
00261500,MIDDLESEX COUNTY COLLEGE                ,NJ,08818-3050,Public       ,56,91,147,7668,5903,13571
00261600,MONMOUTH UNIVERSITY                     ,NJ,07764-1898,Private      ,15,28,43,7863,2731,10594
00261700,MONTCLAIR STATE UNIVERSITY              ,NJ,07043-9987,Public       ,37,82,119,20283,9017,29300
00261900,NEW BRUNSWICK THEOLOGICAL SEMINARY      ,NJ,08901-0000,Private      ,0,0,0,92,214,306
00262100,NEW JERSEY INST OF TECHNOLOGY           ,NJ,07102-1982,Public       ,22,58,80,7367,4237,11604
00262200,KEAN UNIVERSITY                         ,NJ,07083-7131,Public       ,32,92,124,12083,9834,21917
00262400,OCEAN COUNTY COLLEGE                    ,NJ,08754-2001,Public       ,29,89,118,5604,4992,10596
00262500,WILLIAM PATERSON UNIVERSITY             ,NJ,07470-2152,Public       ,32,61,93,13475,5865,19340
00262600,PRINCETON THEOLOGICAL SEMINARY          ,NJ,08542-0000,Private      ,0,2,2,17,608,625
00262700,PRINCETON UNIVERSITY                    ,NJ,08544-0001,Private      ,9,15,24,17097,1857,18954
00262800,RIDER UNIVERSITY                        ,NJ,08648-3099,Private      ,8,26,34,8335,1926,10261
00262900,"RUTGERS, THE STATE UNIVERSITY OF NJ     ",NJ,08901-1281,Public       ,100,317,417,51827,28947,80774
00262923,"RUTGERS, THE STATE UNIVERSITY OF NEW JER",NJ,07101-1709,Public       ,0,0,0,769,5876,6645
00263200,SETON HALL UNIVERSITY                   ,NJ,07079-2697,Private      ,26,48,74,11827,4530,16357
00263201,SETON HALL UNIVERSITY - SCHOOL OF LAW   ,NJ,07079-5210,Private      ,1,24,25,313,1804,2117
00263800,SAINT PETER'S UNIVERSITY                ,NJ,07306-5997,Private      ,10,42,52,4129,2248,6377
00263900,STEVENS INSTITUTE OF TECHNOLOGY         ,NJ,07030-5370,Private      ,5,12,17,5063,788,5851
00264200,COLLEGE OF NEW JERSEY (THE)             ,NJ,08628-0718,Public       ,12,46,58,12713,1587,14300
00264300,UNION COUNTY COLLEGE                    ,NJ,07016-1598,Public       ,43,163,206,6405,9457,15862
00473600,BERGEN COMMUNITY COLLEGE                ,NJ,07652-1595,Public       ,62,91,153,9513,6625,16138
00474000,MERCER COUNTY COMMUNITY COLLEGE         ,NJ,08690-0000,Public       ,35,123,158,3872,5055,8927
00539900,MONMOUTH COUNTY VOCATIONAL SCH DIST     ,NJ,07728-5033,Public       ,1,8,9,76,161,237
00545200,TETERBORO SCH OF AERONAUTICS            ,NJ,07608-1083,Proprietary  ,5,7,12,149,199,348
00546100,SALEM COMMUNITY COLLEGE                 ,NJ,08069-2799,Public       ,5,16,21,716,922,1638
00641700,HOLY NAME HOSPITAL SCH OF NURSING       ,NJ,07666-4254,Private      ,1,7,8,96,281,377
00642000,MOUNTAINSIDE HOSP SCH NRSG              ,NJ,07042-4898,Proprietary  ,0,1,1,47,211,258
00642100,MUHLENBERG SNYDER SCHOOLS               ,NJ,07061-3399,Private      ,0,5,5,131,559,690
00642900,ST FRANCIS MEDICAL CTR SCH NURSING      ,NJ,08629-1986,Private      ,0,2,2,54,190,244
00642902,ST FRANCIS MED CTR RAD TECH             ,NJ,08629-0000,Private      ,0,0,0,18,81,99
00686500,CAMDEN COUNTY COLLEGE                   ,NJ,08012-3240,Public       ,55,206,261,7005,10010,17015
00690100,GLOUCESTER COUNTY COLLEGE               ,NJ,08080-4249,Public       ,38,87,125,4261,3827,8088
00710700,ESSEX COUNTY COLLEGE                    ,NJ,07102-1798,Public       ,63,139,202,6835,10708,17543
00750200,BERKELEY COLLEGE                        ,NJ,07424-3367,Proprietary  ,10,39,49,2756,3931,6687
00750205,BERKELEY COLLEGE - CLIFTON              ,NJ,07011-2161,Proprietary  ,0,0,0,198,580,778
00757302,NATURAL MOTION INST OF HAIR DESIGN      ,NJ,07306-5496,Proprietary  ,0,0,0,34,90,124
00757309,EMPIRE BEAUTY SCHOOL - CHERRY HILL      ,NJ,08002-3711,Proprietary  ,0,0,0,88,236,324
00759300,PARISIAN BEAUTY ACADEMY                 ,NJ,07601-5509,Proprietary  ,4,9,13,231,317,548
00772900,COUNTY COLLEGE OF MORRIS                ,NJ,07869-0000,Public       ,19,47,66,4261,2415,6676
00773000,BURLINGTON COUNTY COLLEGE               ,NJ,08068-1599,Public       ,34,138,172,4957,5943,10900
00773100,RARITAN VALLEY COMMUNITY COLLEGE        ,NJ,08876-1265,Public       ,23,59,82,3250,2704,5954
00780401,STAR CAREER ACADEMY - STAR LAKEWOOD     ,NJ,08701-5900,Proprietary  ,10,34,44,186,553,739
00780402,STAR CAREER ACADEMY - STAR EGG HARBOR   ,NJ,08234-4863,Proprietary  ,9,16,25,116,391,507
00793808,LINCOLN TECHNICAL INSTITUTE - SOUTH PLAI,NJ,07080-2424,Proprietary  ,11,13,24,218,257,475
00793810,LINCOLN TECHNICAL INSTITUTE - MAHWAH    ,NJ,07430-2106,Proprietary  ,25,35,60,587,426,1013
00793811,LINCOLN TECHNICAL INSTITUTE - UNION     ,NJ,07083-5032,Proprietary  ,66,78,144,923,1102,2025
00794700,BETH MEDRASH GOVOHA OF AMERICA          ,NJ,08701-0000,Private      ,121,167,288,570,2107,2677
00840400,BROOKDALE COMMUNITY COLLEGE             ,NJ,07738-1597,Public       ,62,126,188,6528,5178,11706
00844101,ANTHEM INSTITUTE                        ,NJ,08002-0000,Proprietary  ,11,57,68,162,511,673
00849400,HO HO KUS SCHL OF TRADE & TECH SCIENCES ,NJ,07513-1402,Proprietary  ,8,21,29,154,297,451
00860900,RABBINICAL COLLEGE OF AMERICA           ,NJ,07960-3600,Private      ,30,2,32,113,13,126
00907800,CAPRI INSTITUTE OF HAIR DESIGN          ,NJ,07011-2111,Proprietary  ,5,11,16,128,298,426
00934400,RAMAPO COLLEGE OF NEW JERSEY            ,NJ,07430-1680,Public       ,12,28,40,8190,1762,9952
00934500,RICHARD STOCKTON COLLEGE OF NJ          ,NJ,08240-0000,Public       ,25,28,53,10122,3842,13964
00945916,EMPIRE BEAUTY SCHOOL - HAIR DESIGN SCHOO,NJ,07712-4003,Proprietary  ,0,0,0,100,184,284
00945917,EMPIRE BEAUTY SCHOOL - HAIR DESIGN SCHOO,NJ,07003-2517,Proprietary  ,0,0,0,15,45,60
00945919,EMPIRE BEAUTY SCHOOL - HAIR DESIGN SCHOO,NJ,07083-3306,Proprietary  ,0,0,0,48,112,160
00982804,EVEREST INSTITUTE - SOUTH PLAINFIELD    ,NJ,07080-1125,Proprietary  ,25,63,88,408,830,1238
00999400,PASSAIC COUNTY COMMUNITY COLLEGE        ,NJ,07505-1179,Public       ,57,136,193,4999,6246,11245
01062900,P B COSMETOLOGY EDUCATION CENTRE        ,NJ,08030-1750,Proprietary  ,0,3,3,111,147,258
01085100,ANTHEM INSTITUTE                        ,NJ,07054-3409,Proprietary  ,40,189,229,463,1156,1619
01085101,ANTHEM INSTITUTE                        ,NJ,07306-0000,Proprietary  ,0,5,5,72,203,275
01085102,ANTHEM INSTITUTE                        ,NJ,08902-0000,Proprietary  ,0,2,2,51,134,185
01090300,RIZZIERI INSTITUTE                      ,NJ,08043-4600,Proprietary  ,8,4,12,163,219,382
01152300,MORRIS COUNTY SCHOOL OF TECHNOLOGY      ,NJ,07834-0000,Public       ,0,1,1,49,117,166
01198900,TALMUDICAL ACADEMY                      ,NJ,07710-0000,Private      ,1,1,2,61,6,67
01209000,ROBERT FIANCE BEAUTY SCHOOLS            ,NJ,08861-4118,Proprietary  ,4,13,17,102,184,286
01234602,DOVER BUSINESS COLLEGE                  ,NJ,07801-4643,Proprietary  ,0,0,0,81,203,284
01246100,LINCOLN TECHNICAL INSTITUTE             ,NJ,08820-2896,Proprietary  ,13,36,49,390,829,1219
01246102,LINCOLN TECHNICAL INSTITUTE             ,NJ,08057-3212,Proprietary  ,13,47,60,275,828,1103
01246103,LINCOLN TECHNICAL INSTITUTE             ,NJ,07652-2106,Proprietary  ,19,34,53,454,852,1306
01246200,HOHOKUS - HACKENSACK SCHOOL OF BUSINESS ,NJ,07601-7197,Proprietary  ,9,24,33,145,572,717
01295400,HUDSON COUNTY COMMUNITY COLLEGE         ,NJ,07306-4012,Public       ,41,102,143,6114,7483,13597
02053700,EASTWICK COLLEGE                        ,NJ,07446-0000,Proprietary  ,8,43,51,376,1620,1996
02061800,ROMAN ACADEMY OF BEAUTY CULTURE         ,NJ,07506-0000,Proprietary  ,0,1,1,29,34,63
02079414,EMPIRE BEAUTY SCHOOL - LAUREL SPRINGS   ,NJ,08021-5602,Proprietary  ,0,0,0,100,210,310
02079415,EMPIRE BEAUTY SCHOOL - BORDENTOWN       ,NJ,08505-1513,Proprietary  ,0,0,0,16,48,64
02092300,HOHOKUS SCHOOL - RETS/NUTLEY            ,NJ,07110-0000,Proprietary  ,8,36,44,246,546,792
02103700,CAPRI INSTITUTE OF HAIR DESIGN          ,NJ,07652-0000,Proprietary  ,2,6,8,90,124,214
02104000,HARRIS SCHOOL OF BUSINESS               ,NJ,08002-2983,Proprietary  ,34,221,255,485,2066,2551
02106601,AMERICAN INSTITUTE - CLIFTON            ,NJ,07011-2345,Proprietary  ,18,76,94,298,743,1041
02106605,AMERICAN INSTITUTE - TOMS RIVER         ,NJ,08755-1524,Proprietary  ,18,53,71,98,408,506
02131100,DU CRET SCHOOL OF THE ARTS              ,NJ,07060-0000,Private      ,0,0,0,31,20,51
02131600,PENNCO TECH                             ,NJ,08012-0000,Proprietary  ,22,38,60,532,962,1494
02132300,FORTIS INSTITUTE                        ,NJ,07470-7041,Proprietary  ,30,67,97,438,758,1196
02146800,JOE KUBERT SCH OF CARTOON & GRAPHIC     ,NJ,07801-0000,Proprietary  ,0,1,1,120,74,194
02154000,DIVERS ACAD OF EASTERN SEABOARD         ,NJ,08081-1139,Proprietary  ,4,11,15,115,298,413
02183600,CAPRI INSTITUTE OF HAIR DESIGN          ,NJ,07033-0000,Proprietary  ,3,17,20,96,188,284
02192200,THOMAS EDISON STATE COLLEGE             ,NJ,08608-0000,Public       ,8,232,240,766,9998,10764
02219600,OMEGA INSTITUTE                         ,NJ,08109-0000,Proprietary  ,3,15,18,56,222,278
02223700,ROBERT FIANCE BEAUTY SCHOOLS            ,NJ,07093-4623,Proprietary  ,4,23,27,68,237,305
02223900,DRAKE COLLEGE OF BUSINESS               ,NJ,07201-0000,Proprietary  ,12,174,186,196,1430,1626
02223902,DRAKE COLLEGE OF BUSINESS - NEWARK CAMPU,NJ,07112-2760,Proprietary  ,17,218,235,345,2074,2419
02232500,UNION COUNTY VOCATIONAL TECH INST       ,NJ,07076-0000,Public       ,0,3,3,98,149,247
02234600,ATLANTIC BEAUTY & SPA ACADEMY           ,NJ,08234-2621,Proprietary  ,1,12,13,83,203,286
02246000,ROSS UNIVERSITY - MEDICAL SCHOOL        ,NJ,08837-0000,Proprietary  ,1,61,62,42,4175,4217
02248600,COOPER HEALTH SYS-CTR ALLIED HEALTH     ,NJ,08103-0000,Private      ,2,3,5,160,478,638
02265500,CAPRI INSTITUTE OF HAIR DESIGN          ,NJ,08724-0000,Proprietary  ,3,8,11,98,172,270
02277900,ROSS UNIV - SCH OF VETERINARY MED       ,NJ,08837-0000,Proprietary  ,1,33,34,26,1654,1680
02312000,BERGEN COUNTY TECHNICAL SCHOOLS         ,NJ,07601-6110,Public       ,2,6,8,119,212,331
02503900,WARREN COUNTY COMMUNITY COLLEGE         ,NJ,07882-0000,Public       ,9,17,26,813,813,1626
02523700,OCEAN COUNTY VOCATIONAL-TECH SCHOOL     ,NJ,08753-0000,Public       ,2,1,3,300,532,832
02525900,ARTISTIC ACADEMY OF HAIR DESIGN         ,NJ,07950-1409,Proprietary  ,0,0,0,107,141,248
02528200,ROBERT FIANCE BEAUTY SCHOOLS            ,NJ,07060-4840,Proprietary  ,1,13,14,67,177,244
02558700,PRISM CAREER INSTITUTE                  ,NJ,08037-0000,Proprietary  ,5,27,32,124,644,768
02568800,SUSSEX COUNTY COMMUNITY COLLEGE         ,NJ,07860-1149,Public       ,6,24,30,1706,1235,2941
02586900,HARRIS SCHOOL OF BUSINESS               ,NJ,08043-2604,Proprietary  ,19,100,119,242,1084,1326
02616402,SANFORD-BROWN INSTITUTE - ISELIN        ,NJ,08830-0000,Proprietary  ,11,29,40,341,788,1129
03077500,RABBI JACOB JOSEPH SCHOOL               ,NJ,08817-4494,Private      ,3,0,3,40,9,49
03122600,EASTERN INTERNATIONAL COLLEGE           ,NJ,07306-3906,Proprietary  ,2,11,13,210,572,782
03187300,STENOTECH CAREER INSTITUTE              ,NJ,07004-3490,Proprietary  ,2,2,4,26,56,82
03197300,INSTITUTE FOR HEALTH EDUCATION(THE)     ,NJ,07306-2929,Proprietary  ,0,8,8,66,238,304
03324300,CENTRAL CAREER SCHOOL                   ,NJ,07080-2408,Proprietary  ,6,29,35,57,278,335
03380302,STAR CAREER ACADEMY - STAR NEWARK       ,NJ,07102-4510,Proprietary  ,11,67,78,278,1022,1300
03380303,STAR CAREER ACADEMY - STAR CLIFTON      ,NJ,07011-2248,Proprietary  ,9,49,58,86,387,473
03389300,ACADEMY OF MASSAGE THERAPY              ,NJ,07631-0000,Proprietary  ,5,4,9,42,124,166
03424500,NEW COMMUNITY WORKFORCE DEVELOPMENT     ,NJ,07103-2402,Private      ,0,0,0,61,522,583
03536300,INSTITUTE FOR THERAPEUTIC MASSAGE       ,NJ,07420-1452,Proprietary  ,4,15,19,44,172,216
03625300,PERFORMANCE TRAINING INSTITUTE          ,NJ,08753-0000,Proprietary  ,0,0,0,16,50,66
03650600,PC AGE                                  ,NJ,07306-3936,Proprietary  ,2,36,38,67,386,453
03650603,PC AGE                                  ,NJ,08817-2842,Proprietary  ,0,1,1,10,63,73
03666300,PILLAR COLLEGE                          ,NJ,07102-5511,Private      ,5,15,20,106,776,882
03803300,HEALTHCARE TRAINING INSTITUTE           ,NJ,07083-3504,Proprietary  ,3,16,19,106,417,523
03811300,EASTERN SCHOOL OF ACUPUNCTURE AND TRADIT,NJ,07042-3562,Proprietary  ,0,0,0,5,99,104
04081300,BAIS MEDRASH TORAS CHESED               ,NJ,08701-0000,Private      ,5,2,7,43,24,67
04123400,YESHIVAS BE'ER YITZCHOK                 ,NJ,07208-2380,Private      ,3,1,4,27,56,83
04125000,GENTLE HEALING SCHOOL OF MASSAGE        ,NJ,08512-3600,Proprietary  ,0,2,2,6,47,53
04131100,YESHIVA TORAS CHAIM                     ,NJ,08701-2120,Private      ,1,0,1,190,5,195
04131200,TOTAL IMAGE BEAUTY ACADEMY              ,NJ,07307-2943,Proprietary  ,0,7,7,29,120,149
04134100,JERSEY COLLEGE                          ,NJ,07608-1104,Proprietary  ,13,159,172,233,2884,3117
04136400,AMERICAN INSTITUTE OF MEDICAL SCIENCES &,NJ,07080-1183,Proprietary  ,2,2,4,129,334,463
04154500,STARTING POINTS FOR CHILDREN            ,NJ,07306-0001,Private      ,2,7,9,23,141,164
04154900,NATIONAL CAREER INSTITUTE               ,NJ,07018-2011,Proprietary  ,3,32,35,30,247,277
04154901,NATIONAL CAREER INSTITUTE - JERSEY CITY ,NJ,07306-4300,Proprietary  ,3,34,37,14,85,99
04173100,LAB PAUL MITCHELL PARTNER SCHOOL (THE)  ,NJ,08628-2500,Proprietary  ,2,8,10,97,149,246
04180300,MESIVTA KESER TORAH                     ,NJ,07719-2409,Private      ,6,0,6,28,3,31
04181400,BEST CARE TRAINING INSTITUTE            ,NJ,07018-1703,Proprietary  ,0,3,3,23,226,249
04184500,CHRISTINE VALMY INTERNATIONAL SCHOOL OF ,NJ,07058-9589,Proprietary  ,3,7,10,39,88,127
04188700,ASI CAREER INSTITUTE                    ,NJ,08012-1043,Proprietary  ,1,6,7,25,239,264
04191400,SCHOOL OF COURT REPORTING (THE)         ,NJ,08053-1533,Proprietary  ,0,0,0,6,20,26
04192400,YESHIVA GEDOLAH ZICHRON LEYMA           ,NJ,07036-3905,Private      ,3,0,3,14,6,20
04207500,MEDICAL CAREER INSTITUTE                ,NJ,07712-7202,Proprietary  ,0,8,8,32,155,187
04216000,UNIVERSAL TRAINING INSTITUTE            ,NJ,08861-4106,Proprietary  ,0,13,13,31,211,242
04216100,YESHIVA YESODEI HATORAH                 ,NJ,08701-4946,Private      ,10,0,10,38,1,39
04216500,RIZZIERI INSTITUTE                      ,NJ,08043-1911,Proprietary  ,2,1,3,34,87,121
04218200,PAUL MITCHELL THE SCHOOL - JERSEY SHORE ,NJ,08723-3413,Proprietary  ,3,9,12,98,99,197
04218500,SALON PROFESSIONAL ACADEMY THE          ,NJ,07080-0000,Proprietary  ,1,11,12,19,63,82
00266500,VAUGHN COLLEGE OF AERONAUTICS AND TECHNO,NY,11369-9997,Private      ,4,13,17,1396,1115,2511
00266600,ADELPHI UNIVERSITY                      ,NY,11530-4299,Private      ,15,36,51,8996,4802,13798
00266700,DOWLING COLLEGE                         ,NY,11769-1999,Private      ,3,11,14,2139,1437,3576
00266800,ALFRED UNIVERSITY                       ,NY,14802-1205,Private      ,6,3,9,3953,745,4698
00266900,BANK STREET COLLEGE OF EDUCATION        ,NY,10025-0000,Private      ,0,8,8,25,851,876
00267100,BARD COLLEGE                            ,NY,12504-5000,Private      ,1,3,4,3117,792,3909
00267400,NEW YORK THEOLOGICAL SEMINARY           ,NY,10115-0002,Private      ,0,5,5,5,313,318
00267700,BROOKLYN LAW SCHOOL                     ,NY,11201-0000,Private      ,0,30,30,144,2701,2845
00267800,BRYANT & STRATTON COLLEGE               ,NY,14203-1713,Proprietary  ,157,1184,1341,3384,18212,21596
00267803,BRYANT & STRATTON COLLEGE - GREECE      ,NY,14606-4227,Proprietary  ,15,89,104,381,1539,1920
00267805,BRYANT & STRATTON COLLEGE - SYRACUSE    ,NY,13203-2502,Proprietary  ,25,107,132,606,1834,2440
00267807,BRYANT & STRATTON COLLEGE - ALBANY      ,NY,12205-5230,Proprietary  ,15,52,67,296,1211,1507
00268100,CANISIUS COLLEGE                        ,NY,14208-1098,Private      ,4,17,21,4908,1984,6892
00268500,CAZENOVIA COLLEGE                       ,NY,13035-1085,Private      ,1,0,1,2027,244,2271
00268700,CUNY-BROOKLYN COLLEGE                   ,NY,11210-2814,Public       ,59,77,136,21685,14181,35866
00268800,CITY COLLEGE-CUNY                       ,NY,10031-9198,Public       ,62,99,161,23458,13326,36784
00268900,CUNY-HUNTER COLLEGE                     ,NY,10021-0000,Public       ,93,135,228,32541,19382,51923
00269000,QUEENS COLLEGE-CUNY                     ,NY,11367-1597,Public       ,66,76,142,19843,10350,30193
00269100,CUNY- BOROUGH OF MANHATTAN CMTY CLG     ,NY,10007-1047,Public       ,140,149,289,32789,19856,52645
00269200,CUNY BRONX COMMUNITY COLLEGE            ,NY,10453-3102,Public       ,55,52,107,13686,12466,26152
00269300,CUNY-JOHN JAY CLG CRIMINAL JUSTICE      ,NY,10019-1093,Public       ,61,57,118,19079,9878,28957
00269400,KINGSBOROUGH COMMUNITY COLLEGE          ,NY,11235-2398,Public       ,89,66,155,17090,10943,28033
00269600,NY CITY COLLEGE OF TECHNOLOGY-CUNY      ,NY,11201-2983,Public       ,88,76,164,20808,11798,32606
00269700,QUEENSBOROUGH COMMUNITY COLLEGE         ,NY,11364-1497,Public       ,58,47,105,16459,7822,24281
00269800,CUNY THE COLLEGE OF STATEN ISLAND       ,NY,10314-6600,Public       ,60,52,112,14214,5799,20013
00269900,CLARKSON UNIVERSITY                     ,NY,13699-5615,Private      ,1,5,6,6344,549,6893
00270000,COLGATE ROCHESTER CROZER DIVINITY S     ,NY,14620-0000,Private      ,0,1,1,8,88,96
00270100,COLGATE UNIVERSITY                      ,NY,13346-1386,Private      ,3,1,4,4467,107,4574
00270300,COLLEGE OF MOUNT SAINT VINCENT          ,NY,10471-1093,Private      ,6,2,8,2802,616,3418
00270400,COLLEGE OF NEW ROCHELLE                 ,NY,10805-2339,Private      ,7,87,94,1346,4890,6236
00270500,COLLEGE OF SAINT ROSE                   ,NY,12203-1490,Private      ,3,34,37,4989,1976,6965
00270700,COLUMBIA UNIVERSITY                     ,NY,10027-0000,Private      ,14,152,166,24051,23198,47249
00270800,BARNARD COLLEGE-COLUMBIA UNIV           ,NY,10027-6598,Private      ,6,7,13,4610,522,5132
00270900,CONCORDIA COLLEGE                       ,NY,10708-1998,Private      ,3,3,6,1056,593,1649
00271000,COOPER UNION                            ,NY,10003-7120,Private      ,2,6,8,1833,380,2213
00271100,CORNELL UNIVERSITY                      ,NY,14853-2801,Private      ,13,47,60,30120,6608,36728
00271101,WEILL CORNELL MEDICAL COLLEGE AND GRADUA,NY,10021-0000,Private      ,1,5,6,49,810,859
00271200,D'YOUVILLE COLLEGE                      ,NY,14201-1084,Private      ,4,12,16,2111,2449,4560
00271300,DOMINICAN COLLEGE                       ,NY,10962-1299,Private      ,8,25,33,1868,1103,2971
00271800,ELMIRA COLLEGE                          ,NY,14901-2099,Private      ,0,6,6,2411,410,2821
00272200,FORDHAM UNIVERSITY                      ,NY,10458-5157,Private      ,24,93,117,26426,9835,36261
00272600,GENERAL THEOLOGICAL SEMINARY            ,NY,10011-0000,Private      ,0,1,1,2,82,84
00272800,HAMILTON COLLEGE                        ,NY,13323-1218,Private      ,1,0,1,3198,98,3296
00272900,HARTWICK COLLEGE                        ,NY,13820-4020,Private      ,3,1,4,4360,215,4575
00273100,HOBART & WILLIAM SMITH COLLEGES         ,NY,14456-3397,Private      ,4,1,5,3532,111,3643
00273200,HOFSTRA UNIVERSITY                      ,NY,11549-1010,Private      ,16,22,38,19054,5820,24874
00273400,HOUGHTON COLLEGE                        ,NY,14744-0128,Private      ,1,2,3,1372,215,1587
00273500,HILBERT COLLEGE                         ,NY,14075-1597,Private      ,2,6,8,1163,394,1557
00273700,IONA COLLEGE                            ,NY,10801-1890,Private      ,14,9,23,6946,1250,8196
00273900,ITHACA COLLEGE                          ,NY,14850-7130,Private      ,7,7,14,14997,1167,16164
00274000,JEWISH THEOLOGICAL SEMINARY OF AMER     ,NY,10027-4649,Private      ,1,0,1,110,165,275
00274200,THE JUILLIARD SCHOOL                    ,NY,10023-6588,Private      ,2,4,6,1688,852,2540
00274400,KEUKA COLLEGE                           ,NY,14478-0000,Private      ,3,24,27,1741,1507,3248
00274800,LEMOYNE COLLEGE                         ,NY,13214-1399,Private      ,6,11,17,5080,1027,6107
00274900,NEW YORK COLLEGE OF PODIATRIC MED       ,NY,10035-1940,Private      ,0,0,0,54,465,519
00275100,LONG ISLAND UNIVERSITY                  ,NY,11548-1326,Private      ,32,70,102,13270,11393,24663
00275800,MANHATTAN COLLEGE                       ,NY,10471-4098,Private      ,14,11,25,7036,893,7929
00275900,MANHATTAN SCHOOL OF MUSIC               ,NY,10027-4689,Private      ,4,1,5,737,702,1439
00276000,MANHATTANVILLE COLLEGE                  ,NY,10577-2132,Private      ,4,14,18,3272,890,4162
00276300,MARIA COLLEGE                           ,NY,12208-1798,Private      ,2,11,13,247,976,1223
00276500,MARIST COLLEGE                          ,NY,12601-1387,Private      ,6,18,24,10461,1717,12178
00276900,MARYMOUNT MANHATTAN COLLEGE             ,NY,10021-4597,Private      ,8,3,11,4018,430,4448
00277200,MERCY COLLEGE                           ,NY,10522-1189,Private      ,24,160,184,6428,8523,14951
00277500,MOLLOY COLLEGE                          ,NY,11570-1100,Private      ,10,20,30,4299,2654,6953
00277700,MEDAILLE COLLEGE                        ,NY,14214-2695,Private      ,2,33,35,1855,1837,3692
00277800,MOUNT SAINT MARY COLLEGE                ,NY,12550-3494,Private      ,6,13,19,3873,1343,5216
00277900,NAZARETH COLLEGE OF ROCHESTER           ,NY,14618-3790,Private      ,2,8,10,3901,1653,5554
00278200,NEW YORK INSTITUTE OF TECHNOLOGY        ,NY,11568-8000,Private      ,13,21,34,6034,2887,8921
00278202,NY INSTITUTE OF TECHNOLOGY-OSTEOPATHIC M,NY,11568-0000,Private      ,1,2,3,41,1150,1191
00278300,NEW YORK LAW SCHOOL                     ,NY,10013-0000,Private      ,0,5,5,106,2566,2672
00278400,NEW YORK MEDICAL COLLEGE                ,NY,10595-0000,Private      ,0,2,2,53,2051,2104
00278500,NEW YORK UNIVERSITY                     ,NY,10012-1091,Private      ,70,230,300,43150,30660,73810
00278520,NEW YORK UNIVERSITY - BROOKLYN          ,NY,11201-3840,Private      ,6,10,16,4013,1302,5315
00278800,NIAGARA UNIVERSITY                      ,NY,14109-2010,Private      ,2,11,13,4092,986,5078
00279000,NYACK COLLEGE                           ,NY,10960-3698,Private      ,4,18,22,1548,2172,3720
00279100,PACE UNIVERSITY - NEW YORK              ,NY,10038-1598,Private      ,21,54,75,12739,4999,17738
00279101,PACE UNIVERSITY-PLEASANTVILLE           ,NY,10570-0000,Private      ,8,24,32,4276,1535,5811
00279102,PACE UNIVERSITY - WHITE PLAINS          ,NY,10603-0000,Private      ,1,11,12,599,1826,2425
00279500,PAUL SMITHS CLG OF ARTS & SCIENCES      ,NY,12970-0000,Private      ,0,2,2,1337,179,1516
00279800,PRATT INSTITUTE                         ,NY,11205-3899,Private      ,10,9,19,5359,2614,7973
00280300,RENSSELAER POLYTECHNIC INSTITUTE        ,NY,12180-3590,Private      ,7,1,8,12292,765,13057
00280500,ROBERTS WESLEYAN COLLEGE                ,NY,14624-1997,Private      ,1,20,21,1376,1478,2854
00280600,ROCHESTER INSTITUTE OF TECHNOLOGY       ,NY,14623-5608,Private      ,21,18,39,16893,3197,20090
00280700,ROCKEFELLER UNIVERSITY                  ,NY,10021-0000,Private      ,0,0,0,38,61,99
00280800,DAEMEN COLLEGE                          ,NY,14226-3592,Private      ,2,22,24,2906,1398,4304
00281000,THE SAGE COLLEGES                       ,NY,12180-4199,Private      ,2,8,10,2085,2028,4113
00281200,TROCAIRE COLLEGE                        ,NY,14220-2094,Private      ,1,12,13,937,1899,2836
00281300,SARAH LAWRENCE COLLEGE                  ,NY,10708-5999,Private      ,3,4,7,2204,636,2840
00281400,SKIDMORE COLLEGE                        ,NY,12866-1632,Private      ,3,1,4,5016,181,5197
00281500,ST BERNARDS SCH THEOLOGY & MINISTRY     ,NY,14618-3822,Private      ,0,1,1,3,47,50
00281600,SIENA COLLEGE                           ,NY,12211-1462,Private      ,3,3,6,6673,381,7054
00281700,ST BONAVENTURE UNIVERSITY               ,NY,14778-2284,Private      ,2,0,2,3045,583,3628
00282000,ST FRANCIS COLLEGE                      ,NY,11201-4398,Private      ,12,4,16,3349,921,4270
00282100,ST JOHN FISHER COLLEGE                  ,NY,14618-3597,Private      ,3,21,24,5068,2027,7095
00282200,CHRIST THE KING SEMINARY                ,NY,14052-0607,Private      ,0,0,0,3,9,12
00282300,ST JOHN'S UNIVERSITY                    ,NY,11439-1343,Private      ,31,31,62,27483,7172,34655
00282500,ST JOSEPH'S COLLEGE                     ,NY,11205-3688,Private      ,7,5,12,1847,1018,2865
00282501,ST JOSEPH'S COLLEGE-SUFFOLK CAMPUS      ,NY,11772-0000,Private      ,11,15,26,3298,1806,5104
00282900,ST LAWRENCE UNIVERSITY                  ,NY,13617-1455,Private      ,1,4,5,2906,158,3064
00283200,ST THOMAS AQUINAS COLLEGE               ,NY,10976-1050,Private      ,4,4,8,2045,331,2376
00283300,ST VLADIMIR ORTHODOX THEOL SEM          ,NY,10707-0000,Private      ,0,2,2,0,51,51
00283400,EXCELSIOR COLLEGE                       ,NY,12203-5159,Private      ,20,871,891,540,13675,14215
00283500,SUNY AT ALBANY                          ,NY,12222-0001,Public       ,31,51,82,22904,5690,28594
00283600,BINGHAMTON UNIVERSITY (SUNY)            ,NY,13902-6000,Public       ,31,14,45,26828,3321,30149
00283700,SUNY AT BUFFALO                         ,NY,14260-0001,Public       ,41,45,86,26268,10395,36663
00283800,SUNY AT STONY BROOK                     ,NY,11794-0701,Public       ,44,92,136,30410,9095,39505
00283900,SUNY-DOWNSTATE MEDICAL CENTER           ,NY,11203-2098,Public       ,4,25,29,309,2715,3024
00284000,SUNY UPSTATE MEDICAL UNIVERSITY         ,NY,13210-2375,Public       ,1,2,3,324,1614,1938
00284100,SUNY BROCKPORT - FIN AID OFF            ,NY,14420-2914,Public       ,18,30,48,10485,3190,13675
00284200,BUFFALO STATE COLLEGE - SUNY            ,NY,14222-1095,Public       ,43,70,113,14413,5780,20193
00284300,SUNY COLLEGE-CORTLAND                   ,NY,13045-0900,Public       ,11,8,19,12476,1551,14027
00284400,SUNY AT FREDONIA                        ,NY,14063-1145,Public       ,18,5,23,7767,1095,8862
00284500,SUNY GENESEO                            ,NY,14454-1401,Public       ,12,5,17,9277,700,9977
00284600,SUNY COLLEGE-NEW PALTZ                  ,NY,12561-2499,Public       ,19,21,40,13003,2373,15376
00284700,SUNY COLLEGE-ONEONTA                    ,NY,13820-4015,Public       ,10,8,18,12163,911,13074
00284800,SUNY OSWEGO                             ,NY,13126-3599,Public       ,17,17,34,11998,2246,14244
00284900,SUNY COLLEGE AT PLATTSBURGH             ,NY,12901-2681,Public       ,16,12,28,8669,1622,10291
00285000,SUNY COLLEGE-POTSDAM                    ,NY,13676-2294,Public       ,8,8,16,5935,1012,6947
00285100,SUNY COLLEGE OF ENVIRONMENT SCIENCE AND ,NY,13210-2778,Public       ,2,3,5,2323,624,2947
00285300,SUNY MARITIME COLLEGE                   ,NY,10465-4198,Public       ,6,2,8,1945,369,2314
00285400,SUNY COLLEGE OF TECHNOLOGY-ALFRED       ,NY,14802-9951,Public       ,11,6,17,5012,1140,6152
00285500,SUNY CANTON COLG OF TECHNOLOGY          ,NY,13617-1098,Public       ,6,8,14,4077,1764,5841
00285600,SUNY AG & TECH COLLEGE-COBLESKILL       ,NY,12043-9986,Public       ,9,5,14,3328,682,4010
00285700,SUNY DELHI                              ,NY,13753-1190,Public       ,3,10,13,4296,1313,5609
00285800,SUNY FARMINGDALE                        ,NY,11735-1021,Public       ,25,30,55,7948,3117,11065
00285900,SUNY COLLEGE OF AG & TECH AT MORRISVILLE,NY,13408-0901,Public       ,4,6,10,4283,1082,5365
00286000,ADIRONDACK COMMUNITY COLLEGE            ,NY,12804-1445,Public       ,5,31,36,2453,2073,4526
00286100,CAYUGA COMMUNITY COLLEGE                ,NY,13021-3099,Public       ,14,65,79,2110,2676,4786
00286200,BROOME COMMUNITY COLLEGE                ,NY,13902-0000,Public       ,14,37,51,3719,3299,7018
00286300,CORNING COMMUNITY COLLEGE               ,NY,14830-3297,Public       ,13,28,41,2102,2131,4233
00286400,DUTCHESS COMMUNITY COLLEGE              ,NY,12601-1595,Public       ,28,63,91,4925,2932,7857
00286600,FASHION INSTITUTE OF TECHNOLOGY         ,NY,10001-5992,Public       ,17,45,62,10024,4159,14183
00286700,SUNY FULTON MONTGOMERY COMM CLG         ,NY,12095-3790,Public       ,8,14,22,2011,1317,3328
00286800,HUDSON VALLEY COMMUNITY COLLEGE         ,NY,12180-6096,Public       ,27,55,82,7195,5561,12756
00286900,JAMESTOWN COMMUNITY COLLEGE             ,NY,14702-0020,Public       ,4,4,8,2712,2118,4830
00287000,JEFFERSON COMMUNITY COLLEGE             ,NY,13601-1897,Public       ,12,90,102,1717,3311,5028
00287100,"SUNY, MOHAWK VALLEY COMMUNITY CLG       ",NY,13501-5394,Public       ,14,26,40,4643,4133,8776
00287200,MONROE COMMUNITY COLLEGE                ,NY,14623-5780,Public       ,43,76,119,11046,11107,22153
00287300,NASSAU COMMUNITY COLLEGE                ,NY,11530-6793,Public       ,103,124,227,14128,8473,22601
00287400,NIAGARA COUNTY COMMUNITY COLLEGE        ,NY,14132-9460,Public       ,5,12,17,4311,3150,7461
00287500,ONONDAGA COMMUNITY COLLEGE              ,NY,13215-4585,Public       ,33,76,109,7837,5354,13191
00287600,ORANGE COUNTY COMMUNITY COLLEGE         ,NY,10940-6441,Public       ,13,54,67,3538,2870,6408
00287700,ROCKLAND COMMUNITY COLLEGE              ,NY,10901-3611,Public       ,13,16,29,3108,2501,5609
00287800,SUFFOLK COMMUNITY COLLEGE               ,NY,11784-2899,Public       ,36,55,91,8169,4306,12475
00287801,SUFFOLK COMMUNITY CLG-W. CAMPUS         ,NY,11717-0000,Public       ,21,33,54,5692,3968,9660
00287803,SUFFOLK COMMUNITY CLG-EASTRN CAMPUS     ,NY,11901-0000,Public       ,17,15,32,2142,1431,3573
00287900,SULLIVAN COUNTY COMMUNITY COLLEGE       ,NY,12759-5151,Public       ,3,3,6,1560,852,2412
00288000,ULSTER COUNTY COMMUNITY COLLEGE         ,NY,12484-0557,Public       ,8,22,30,1407,1272,2679
00288100,SUNY WESTCHESTER COMMUNITY COLLEGE      ,NY,10595-1698,Public       ,30,94,124,7524,6092,13616
00288200,SYRACUSE UNIVERSITY                     ,NY,13244-2130,Private      ,28,140,168,27326,6973,34299
00288300,UTICA COLLEGE- UTICA                    ,NY,13502-4892,Private      ,4,35,39,4088,2517,6605
00288500,ALBANY COLLEGE OF PHARMACY AND HEALTH SC,NY,12208-3492,Private      ,3,4,7,2009,928,2937
00288600,ALBANY LAW SCHOOL                       ,NY,12208-0000,Private      ,0,4,4,79,1060,1139
00288700,ALBANY MEDICAL COLLEGE                  ,NY,12208-0000,Private      ,1,5,6,138,1361,1499
00288900,UNION COLLEGE                           ,NY,12308-2311,Private      ,2,0,2,4001,193,4194
00289000,UNION THEOLOGICAL SEMINARY              ,NY,10027-0000,Private      ,0,1,1,1,312,313
00289200,UNITED STATES MERCHANT MARINE ACADEMY   ,NY,11024-1634,Public       ,1,1,2,466,26,492
00289400,UNIVERSITY OF ROCHESTER                 ,NY,14627-9000,Private      ,10,88,98,10113,2364,12477
00289401,EASTMAN SCH OF MUSIC/UNIV ROCHESTER     ,NY,14604-0000,Private      ,0,5,5,865,489,1354
00289402,UNIV OF ROCHESTER SCHL OF MEDICINE      ,NY,14642-0000,Private      ,1,2,3,93,767,860
00289500,VASSAR COLLEGE                          ,NY,12604-0008,Private      ,2,5,7,5078,249,5327
00289600,VILLA MARIA COLLEGE-BUFFALO             ,NY,14225-3999,Private      ,1,1,2,493,372,865
00289900,WAGNER COLLEGE                          ,NY,10301-4495,Private      ,5,6,11,3191,675,3866
00290000,WEBB INSTITUTE                          ,NY,11542-1398,Private      ,1,0,1,92,12,104
00290100,WELLS COLLEGE                           ,NY,13026-0500,Private      ,3,0,3,1438,104,1542
00290300,YESHIVA UNIVERSITY                      ,NY,10033-3201,Private      ,4,13,17,2486,2773,5259
00290302,YESHIVA UNIVERSITY - BRONX CAMPUS       ,NY,10461-1975,Private      ,2,1,3,114,1388,1502
00397400,MESIVTHA TIFERETH JERUSALEM OF AMER     ,NY,10002-6382,Private      ,0,1,1,33,3,36
00397600,RABBINICAL ACAD MESIVTA RABBI CHAIM     ,NY,11230-4715,Private      ,12,0,12,51,1,52
00397700,RABBINICAL COLLEGE CH'SAN SOFER         ,NY,11204-1252,Private      ,0,0,0,3,30,33
00397800,RABBINICAL SEMINARY OF AMERICA          ,NY,11375-0000,Private      ,22,3,25,99,39,138
00397900,COLUMBIA UNIV TEACHERS COLLEGE          ,NY,10027-0000,Private      ,2,122,124,150,5656,5806
00405400,HEBREW UNION COL-JEWISH INST OF REL     ,NY,10012-0000,Private      ,0,1,1,1,242,243
00475900,"CUNY, YORK COLLEGE                      ",NY,11451-0001,Public       ,36,38,74,13867,7191,21058
00476500,CUNY GRADUATE SCH & UNIV CTR            ,NY,10016-4309,Public       ,2,35,37,163,3484,3647
00477600,CENTRAL YESHIVA TOMCHEI TMIMIM LUBA     ,NY,11230-2798,Private      ,132,5,137,485,43,528
00478800,HERKIMER COUNTY COMMUNITY COLLEGE       ,NY,13350-1598,Public       ,7,16,23,2335,1619,3954
00479800,MIRRER YESHIVA CENTRAL INST             ,NY,11223-2010,Private      ,8,0,8,90,29,119
00479900,MONROE COLLEGE                          ,NY,10468-4305,Proprietary  ,189,195,384,5524,7007,12531
00481100,EVEREST INSTITUTE                       ,NY,14621-3007,Proprietary  ,11,63,74,199,1161,1360
00506400,SAINT JAMES MERCY HOSPITAL SCHOOL OF RAD,NY,14843-2197,Private      ,0,0,0,23,28,51
00506600,FAXTON ST. LUKE'S SCHOOL OF RADIOGRAPHY ,NY,13502-4856,Private      ,0,0,0,24,40,64
00520800,THE COLLEGE OF WESTCHESTER              ,NY,10602-0000,Proprietary  ,17,33,50,1024,1070,2094
00587700,ROBERT J HOCHSTIM SCHOOL OF RADIOG      ,NY,11572-1151,Private      ,0,1,1,0,15,15
00643501,ARNOT OGDEN MEDICAL CENTER              ,NY,14905-1676,Private      ,0,3,3,59,88,147
00643800,PHILLIPS BETH ISRAEL SCH OF NURSING     ,NY,10001-6354,Private      ,0,3,3,110,424,534
00644300,COCHRAN SCH NSG-ST JOHN RVSDE HOSP      ,NY,10701-1399,Private      ,0,0,0,39,198,237
00644500,CROUSE HOSP SCH OF NURSING              ,NY,13210-1690,Private      ,1,3,4,247,448,695
00644800,ELLIS HOSPITAL SCHOOL OF NURSING        ,NY,12308-0000,Private      ,0,2,2,81,256,337
00646101,ST ELIZABETH COLLEGE OF NURSING         ,NY,13501-2998,Private      ,0,1,1,144,199,343
00646102,ST ELIZABETH SCH OF RADIOGRAPHY         ,NY,13501-0000,Private      ,0,1,1,20,35,55
00646700,SAINT JOSEPH'S COLLEGE OF NURSING       ,NY,13203-1806,Private      ,0,2,2,259,361,620
00678200,GENESEE COMMUNITY COLLEGE               ,NY,14020-9704,Public       ,18,58,76,3220,3092,6312
00678500,SCHENECTADY COUNTY COMMUNITY CLG        ,NY,12305-2294,Public       ,6,41,47,2713,2848,5561
00678700,CLINTON COMMUNITY COLLEGE               ,NY,12901-5690,Public       ,4,6,10,1303,791,2094
00678800,TOMPKINS CORTLAND COMMUNITY COLLEGE     ,NY,13053-8504,Public       ,10,32,42,2956,1853,4809
00678900,COLUMBIA-GREENE COMMUNITY COLLEGE       ,NY,12534-9543,Public       ,8,22,30,1033,1109,2142
00679100,SUNY AT PURCHASE                        ,NY,10577-1400,Public       ,14,8,22,8141,1263,9404
00702200,CUNY-LEHMAN COLLEGE                     ,NY,10468-1589,Public       ,45,89,134,15516,13659,29175
00702600,MOUNT SINAI SCHOOL OF MEDICINE          ,NY,10029-0000,Private      ,0,6,6,46,1092,1138
00710900,SUNY COLLEGE-OLD WESTBURY               ,NY,11568-0210,Public       ,15,22,37,6257,2553,8810
00711100,NORTH COUNTRY COMMUNITY COLLEGE         ,NY,12983-2046,Public       ,3,3,6,728,679,1407
00726400,MESIFTA TORAH VODAATH RABBINCAL SEM     ,NY,11218-5209,Private      ,4,21,25,27,134,161
00727300,CUNY-BERNARD BARUCH COLLEGE             ,NY,10010-5518,Public       ,39,65,104,20377,11154,31531
00730400,CULINARY INSTITUTE OF AMERICA           ,NY,12538-1499,Private      ,75,46,121,3995,1766,5761
00732916,ITT TECHNICAL INSTITUTE                 ,NY,12205-1003,Proprietary  ,10,63,73,208,756,964
00737200,AUSTIN'S SCHOOL OF SPA TECHNOLOGY       ,NY,12206-1513,Proprietary  ,6,33,39,157,524,681
00737500,ISLAND DRAFTING & TECHNICAL INST        ,NY,11701-2704,Proprietary  ,0,0,0,63,75,138
00738700,LONG ISLAND BEAUTY SCHOOL               ,NY,11788-4346,Proprietary  ,9,15,24,224,375,599
00738800,LONG ISLAND BEAUTY SCHOOL               ,NY,11550-3704,Proprietary  ,1,7,8,64,195,259
00739100,BEAUTY SCHOOL OF MIDDLETOWN             ,NY,10940-6574,Proprietary  ,3,8,11,58,109,167
00739400,BERKELEY COLLEGE                        ,NY,10017-0000,Proprietary  ,23,60,83,3580,4953,8533
00740100,MANDL SCHOOL                            ,NY,10019-5516,Proprietary  ,12,39,51,347,1117,1464
00740500,WOOD TOBE-COBURN SCHOOL                 ,NY,10016-0102,Proprietary  ,1,1,2,631,164,795
00746500,AMERICAN ACADEMY OF DRAMATIC ARTS       ,NY,10016-7089,Private      ,7,9,16,1222,464,1686
00746600,LIM COLLEGE                             ,NY,10022-5268,Proprietary  ,5,1,6,2534,605,3139
00746800,SCHOOL OF VISUAL ARTS                   ,NY,10010-3994,Proprietary  ,11,9,20,4131,1789,5920
00751800,APEX TECHNICAL SCHOOL                   ,NY,10011-0000,Proprietary  ,67,206,273,724,1952,2676
00752200,CONTINENTAL SCH OF BEAUTY CULTURE       ,NY,14623-3231,Proprietary  ,12,42,54,255,712,967
00752205,CONTINENTAL SCHOOL OF BEAUTY CULTURE - M,NY,13211-1003,Proprietary  ,0,0,0,29,57,86
00753200,FINGER LAKES COMMUNITY COLLEGE          ,NY,14424-8395,Public       ,12,27,39,3665,3055,6720
00757200,AMERICAN MUSICAL AND DRAMATIC ACAD      ,NY,10023-2106,Private      ,26,8,34,2800,602,3402
00757300,EMPIRE BEAUTY SCHOOL                    ,NY,11103-4028,Proprietary  ,51,162,213,413,1064,1477
00780400,STAR CAREER ACADEMY                     ,NY,10011-7307,Proprietary  ,23,117,140,245,1099,1344
00793809,LINCOLN TECHNICAL INSTITUTE - WHITESTONE,NY,11357-6092,Proprietary  ,26,29,55,699,461,1160
00818900,CONTINENTAL SCHOOL OF BEAUTY CULTURE - B,NY,14224-3402,Proprietary  ,4,7,11,60,131,191
00818903,CONTINENTAL SCHOOL OF BEAUTY CULTURE - B,NY,14223-2911,Proprietary  ,7,18,25,113,224,337
00843700,CHAMPLAIN VALLEY - TEC/PRN              ,NY,12901-0000,Public       ,0,1,1,31,73,104
00849500,JAMESTOWN BUSINESS COLLEGE              ,NY,14702-0429,Proprietary  ,0,15,15,201,331,532
00861100,"CUNY, HOSTOS CMTY COLLEGE               ",NY,10451-1499,Public       ,41,50,91,10199,9082,19281
00861400,RABBINICAL CLG BOBOVER YESHIVA BNEI     ,NY,11219-3293,Private      ,19,18,37,161,73,234
00861700,RABBINICAL SEM MKOR CHAIM-YESHIVA       ,NY,11219-4300,Private      ,0,0,0,0,2,2
00878800,STATE UNIVERSITY OF NEW YORK STUDENT LOA,NY,12246-0000,Public       ,1,5,6,582,379,961
00900300,OLEAN BUSINESS INSTITUTE INC            ,NY,14760-2691,Proprietary  ,0,0,0,21,56,77
00902900,NEIGHBORHOOD PLAYHOUSE                  ,NY,10022-5017,Private      ,0,0,0,29,56,85
00904300,ELMIRA BUSINESS INSTITUTE               ,NY,14901-2731,Proprietary  ,10,52,62,138,919,1057
00907700,UTICA SCHOOL OF COMMERCE                ,NY,13501-2280,Proprietary  ,5,32,37,122,490,612
00924800,SAMARITAN HOSPITAL SCH NURSING          ,NY,12180-2475,Private      ,0,2,2,84,279,363
00928300,MIDWAY-PARIS BEAUTY SCHOOL              ,NY,11385-3453,Proprietary  ,4,12,16,40,158,198
00928400,BRITTANY BEAUTY SCHOOL                  ,NY,11756-1345,Proprietary  ,8,32,40,136,325,461
00933500,MESIVTA EASTERN PKWY RABBINICAL CLG     ,NY,11218-5559,Private      ,0,0,0,30,9,39
00947900,SAINT VINCENTS CMC SI NURSING SCHOOL    ,NY,10304-3850,Proprietary  ,11,29,40,380,830,1210
00976900,METROPOLITAN COLLEGE OF NEW YORK        ,NY,10013-1919,Private      ,1,28,29,319,2210,2529
00992900,SUNY COLLEGE OF OPTOMETRY               ,NY,10036-8003,Public       ,0,0,0,25,385,410
01005100,LA GUARDIA CMTY COLLEGE - CUNY          ,NY,11101-3083,Public       ,83,89,172,19594,13153,32747
01005200,JEFFERSON-LEWIS BOCES PRAC NRSGPRG      ,NY,13601-9509,Public       ,0,4,4,45,214,259
01009700,CUNY-MEDGAR W EVERS COLLEGE             ,NY,11225-2010,Public       ,24,36,60,8334,7190,15524
01014200,TOURO COLLEGE                           ,NY,10010-4202,Private      ,26,75,101,3717,10426,14143
01014700,WESTERN SUFFOLK BOCES                   ,NY,11768-3499,Public       ,6,8,14,189,471,660
01015300,HELENE FULD COL OF NRSNG/N GEN HOSP     ,NY,10035-0000,Private      ,2,40,42,52,886,938
01028600,EMPIRE STATE COLLEGE                    ,NY,12866-4391,Public       ,4,149,153,1190,13849,15039
01037800,RABBINICAL COLLEGE OF LONG ISLAND       ,NY,11561-3244,Private      ,0,0,0,56,3,59
01054900,KEHILATH YAKOV RABBINICAL SEMINARY      ,NY,10562-1001,Private      ,33,9,42,79,24,103
01055100,NEW YORK SCH MED & DENTAL ASSISTANT     ,NY,11101-2327,Proprietary  ,12,30,42,181,397,578
01064100,SOUTHERN WESTCHESTER BOCES              ,NY,10543-0000,Public       ,1,1,2,33,210,243
01068400,ERIE COMMUNITY COLLEGE-ALL CAMPUSES     ,NY,14203-2698,Public       ,32,62,94,8892,8829,17721
01081300,AMERICAN ACAD MCALLISTER INST           ,NY,10019-3604,Private      ,0,11,11,165,674,839
01083700,SIMMONS INST OF FUNERAL SERVICE         ,NY,13207-2098,Proprietary  ,0,0,0,8,45,53
01094300,RABBINICAL COLLEGE BETH SHRAGA          ,NY,10952-3033,Private      ,3,0,3,15,0,15
01095200,PNW BOCES LPN PROGRAM                   ,NY,10598-0000,Public       ,0,1,1,18,60,78
01103100,TECHNICAL CAREER INSTITUTE              ,NY,10001-2789,Proprietary  ,92,246,338,1503,3839,5342
01118900,UNITED TALMUDICAL SEMINARY              ,NY,11211-7984,Private      ,95,18,113,1079,560,1639
01119200,BETH HAMEDRASH SHAAREI YOSHER INST      ,NY,11204-1052,Private      ,4,3,7,16,30,46
01161400,CHAMPLAIN VALLEY HOSP SCH RAD TECH      ,NY,12901-1490,Private      ,0,0,0,23,27,50
01161700,NEW YORK METHODIST HOSPITAL             ,NY,11229-9023,Private      ,1,3,4,140,534,674
01164700,SBI CAMPUS - AN AFFILIATE OF SANFORD-BRO,NY,11747-3785,Proprietary  ,9,23,32,186,415,601
01167000,YESHIVA OF NITRA RABBINICAL COLLEGE -   ,NY,10549-4112,Private      ,16,8,24,157,14,171
01167700,MEMORIAL SLOAN KETTERING CANCER CTR     ,NY,10021-6094,Private      ,0,0,0,9,53,62
01167800,SUNY INST OF TECHNOLOGY UTICA ROME      ,NY,13504-3050,Public       ,1,7,8,2212,1324,3536
01182100,YESHIVATH ZICHRON MOSHE                 ,NY,12779-0580,Private      ,11,0,11,134,1,135
01183000,BERK TRADE AND BUSINESS SCHOOL          ,NY,11101-0000,Proprietary  ,11,12,23,119,277,396
01185900,WORD OF LIFE BIBLE INSTITUTE            ,NY,12860-0129,Private      ,3,0,3,554,92,646
01186000,MERCY MED CNTR SCHL OF RADIOGRAPHY      ,NY,11570-1098,Private      ,0,1,1,21,41,62
01192100,WESTCHESTER SCH OF BEAUTY CULTURE       ,NY,10550-2295,Proprietary  ,1,7,8,59,148,207
01192200,BETH HATALMUD RABBINICAL CLG            ,NY,11214-2594,Private      ,0,0,0,45,11,56
01198400,OHR HAMEIR THEOLOGICAL SEMINARY         ,NY,10566-0990,Private      ,9,1,10,76,2,78
01201100,TALMUDICAL SEM OHOLEI TORAH             ,NY,11213-3310,Private      ,44,0,44,260,1,261
01210700,INSTITUTE OF DESIGN & CONSTRUCTION      ,NY,11201-5380,Private      ,0,6,6,60,198,258
01220300,MEMORIAL HOSPITAL SCH OF NURSING        ,NY,12204-1083,Private      ,0,2,2,61,238,299
01227700,NEW YORK CHIROPRACTIC COLLEGE           ,NY,13148-0800,Private      ,0,5,5,17,899,916
01229300,VEEB NASSAU CNTY SCHL OF PRACT NURS     ,NY,11553-3040,Public       ,1,5,6,85,277,362
01235800,PLAZA COLLEGE                           ,NY,11372-6300,Proprietary  ,13,30,43,273,986,1259
01236400,SAINT VINCENTS CATHOLIC MEDICAL CENTERS ,NY,11354-0000,Proprietary  ,3,5,8,149,689,838
01240700,SCHUYLER-CHEMUNG-TIOGA BOCES            ,NY,14903-1089,Public       ,1,6,7,28,209,237
01240701,STEUBEN SCHUYLER CHEMUNG TIOGA ALLEGANY ,NY,14870-9518,Public       ,0,1,1,1,11,12
01256100,FIVE TOWNS COLLEGE                      ,NY,11746-5871,Proprietary  ,14,1,15,1027,286,1313
01258900,ERIE 1 BOCES                            ,NY,14224-0000,Public       ,2,0,2,120,422,542
01265200,ONONDAGA CORTLAND MADISON BOCES         ,NY,13090-4500,Public       ,1,5,6,229,796,1025
01278300,OSWEGO COUNTY BOCES ADULT CAREERS       ,NY,13114-4498,Public       ,0,5,5,40,101,141
01292700,CENTRAL TECH NURSING PROGRAM            ,NY,13202-3092,Public       ,0,0,0,38,149,187
01302600,MACHZIKEI HADATH RABBINICAL COLLEGE     ,NY,11204-1805,Private      ,46,37,83,66,63,129
01302700,YESHIVATH VIZNITZ                       ,NY,10952-3021,Private      ,77,171,248,234,175,409
01302900,BORICUA COLLEGE                         ,NY,10032-1599,Private      ,11,22,33,564,1374,1938
02056400,CAPRI COSMETOLOGY LEARNING CENTER       ,NY,10954-0000,Proprietary  ,4,8,12,151,271,422
02066200,THE NEW SCHOOL                          ,NY,10011-0000,Private      ,14,36,50,6211,6190,12401
02069000,NEW YORK SCHOOL OF INTERIOR DESIGN      ,NY,10021-0000,Private      ,1,7,8,265,472,737
02075700,BRIARCLIFFE COLLEGE                     ,NY,11714-0000,Proprietary  ,7,56,63,619,1585,2204
02075702,BRIARCLIFFE COLLEGE - PATCHOGUE         ,NY,11772-3019,Proprietary  ,14,33,47,656,923,1579
02092400,RIDLEY-LOWELL SCHOOL OF BUSINESS        ,NY,13905-0000,Proprietary  ,2,16,18,56,370,426
02093700,LONG ISLAND BUSINESS INSTITUTE          ,NY,11725-0000,Proprietary  ,43,179,222,394,1323,1717
02093701,LONG ISLAND BUSINESS INSTITUTE - FLUSHIN,NY,11354-4429,Proprietary  ,0,0,0,17,45,62
02098400,HERKIMER COUNTY BOCES                   ,NY,13350-0000,Public       ,0,1,1,39,133,172
02104300,OTSEGO AREA SCHOOL OF PRAC NURSING      ,NY,12167-0000,Public       ,0,0,0,11,33,44
02105900,HAIR DESIGN INSTITUTE AT FIFTH AVE      ,NY,11220-0000,Proprietary  ,6,28,34,180,381,561
02106800,BRAMSON ORT COLLEGE                     ,NY,11375-0000,Private      ,19,65,84,378,847,1225
02110900,CATTARAUGUS/ALLEGANY BOCES              ,NY,14760-0000,Public       ,0,0,0,50,177,227
02112301,RIDLEY - LOWELL BUSINESS & TECHNICAL INS,NY,12601-3328,Proprietary  ,6,25,31,218,766,984
02116011,SANFORD-BROWN INSTITUTE - NEW YORK      ,NY,10003-2103,Proprietary  ,35,117,152,616,1894,2510
02118700,LONG ISLAND COLLEGE HOSPITAL - SCHOOL OF,NY,11201-6001,Private      ,0,3,3,155,343,498
02118702,LONG ISLAND COLLEGE HOSPITAL - SCHOOL OF,NY,11201-6001,Private      ,0,3,3,189,349,538
02124000,ORANGE ULSTER BOCES SCH OF PRAC NRS     ,NY,10924-9401,Public       ,0,2,2,40,234,274
02125500,CIRCLE IN THE SQUARE THEATRE SCHOOL     ,NY,10019-0000,Private      ,0,1,1,62,85,147
02126300,MADISON-ONEIDA BOCES PRAC NRS           ,NY,13478-0000,Public       ,0,0,0,11,85,96
02138500,BOCES RENSSELAER SCHOOL OF PN           ,NY,12033-3221,Public       ,0,0,0,23,68,91
02145800,CAYUGA ONONDAGA BOCES                   ,NY,13021-9430,Public       ,1,3,4,47,122,169
02146000,WAYNE-FINGER LAKES BOCES                ,NY,14513-0000,Public       ,0,2,2,56,322,378
02152000,YESHIVA SHAAR HATORAH ITRI TORAH        ,NY,11418-0000,Private      ,4,0,4,16,0,16
02153600,BROOME-TIOGA BOCES PN PROG              ,NY,13905-0000,Public       ,0,2,2,48,161,209
02157900,ROCHESTER GENERAL HOSPITAL              ,NY,14621-3001,Private      ,1,1,2,50,156,206
02158200,WSHNGTN-SARTGA-WARN-HMLTN-ESX BOCES     ,NY,12839-1051,Public       ,0,1,1,16,69,85
02160100,GENEVA GENERAL HOSPITAL                 ,NY,14456-0000,Private      ,0,1,1,54,202,256
02163400,NEW YORK CAREER INSTITUTE               ,NY,10007-2801,Proprietary  ,0,7,7,228,811,1039
02169100,DAVIS COLLEGE                           ,NY,13790-0000,Private      ,0,2,2,179,154,333
02170000,SWEDISH INSTITUTE                       ,NY,10001-0000,Proprietary  ,7,55,62,254,1072,1326
02170200,ALBANY SCHOHARIE SCHENECTADY            ,NY,12205-0000,Public       ,1,2,3,59,162,221
02171900,AILEY SCHOOL (THE)                      ,NY,10019-4402,Private      ,0,7,7,140,120,260
02172100,HAMILTON-FULTON-MONTGOMERY BOCES        ,NY,12095-0665,Public       ,0,0,0,32,101,133
02172800,DUTCHESS COUNTY BOCES SCH PRAC NURS     ,NY,12601-0000,Public       ,1,4,5,89,237,326
02173200,EMPIRE BEAUTY SCHOOL                    ,NY,10001-0000,Proprietary  ,64,172,236,881,1754,2635
02173900,ULSTER COUNTY BOCES PRACTICAL NRSG      ,NY,12466-0000,Public       ,0,4,4,41,209,250
02176000,CHERYL FELL'S SCHOOL OF BUSINESS        ,NY,14304-0000,Proprietary  ,1,6,7,10,113,123
02179400,EASTERN SUFFOLK BOCES                   ,NY,11713-0000,Public       ,1,0,1,194,413,607
02182200,NEW SCHOOL OF RADIO & TELEVISION        ,NY,12206-1106,Proprietary  ,1,5,6,61,128,189
02187300,DARKEI NOAM RABBINICAL COLLEGE          ,NY,11210-0000,Private      ,0,0,0,0,1,1
02191600,TORAH TEMIMAH TALMUDICAL SEMINARY       ,NY,11218-0000,Private      ,11,1,12,77,3,80
02192500,BELLEVUE HOSP CTR SCH RAD TECH          ,NY,10016-0000,Public       ,0,1,1,22,146,168
02199300,ORLEANS-NIAGARA BOCES                   ,NY,14132-0000,Public       ,0,1,1,30,107,137
02206000,HUNTER BUSINESS SCHOOL                  ,NY,11756-0000,Proprietary  ,9,61,70,335,911,1246
02217800,D.HOPFER SCH NURSING AT MT.VRN HOSP     ,NY,10550-0000,Private      ,0,0,0,51,281,332
02219500,MILDRED ELLEY                           ,NY,12206-1513,Proprietary  ,23,114,137,553,2816,3369
02235600,ERIE 2-CHAUTAUQUA-CATTARAUGUS BOCES     ,NY,14006-0000,Public       ,0,1,1,37,107,144
02265100,YESHIVA DERECH CHAIM                    ,NY,11218-0000,Private      ,4,1,5,55,20,75
02265200,GLOBAL BUSINESS INSTITUTE               ,NY,11691-0000,Private      ,0,0,0,4,45,49
02272900,ROCKLAND COUNTY BOCES PRAC NRSG SCH     ,NY,10994-0000,Public       ,1,0,1,54,136,190
02275900,"MODERN WELDING SCHOOL, INC.             ",NY,12304-0000,Proprietary  ,2,8,10,77,147,224
02287800,NATIONAL TRACTOR TRAILER SCHOOL         ,NY,13088-2505,Proprietary  ,7,95,102,64,768,832
02294900,INSTITUTE OF AUDIO RESEARCH             ,NY,10003-0000,Proprietary  ,11,13,24,372,536,908
02306500,PROFESSIONAL BUSINESS COLLEGE           ,NY,10013-5049,Private      ,31,41,72,640,1520,2160
02314200,NORTHERN WESTCHESTER SCH COSMETOL       ,NY,10566-0000,Proprietary  ,2,3,5,39,46,85
02320100,OHR SOMAYACH TANENBAUM EDUCATIONAL CENTE,NY,10952-0000,Private      ,0,0,0,2,3,5
02350600,YESHIVA AND KOLLEL HARBOTZAS TORAH      ,NY,11230-0000,Private      ,1,9,10,2,32,34
02491400,SPANISH AMERICAN INSTITUTE              ,NY,10036-0000,Private      ,0,1,1,5,18,23
02505800,YESHIVA KARLIN STOLIN RAB INSTITUTE     ,NY,11204-0000,Private      ,2,5,7,41,63,104
02505900,SH-OR YOSHUV RABBINICAL COLLEGE         ,NY,11691-0000,Private      ,2,1,3,49,21,70
02506000,ASSOCIATED BETH RIVKAH SCHOOLS          ,NY,11225-0000,Private      ,1,0,1,102,20,122
02506100,CITY UNIV OF NEW YORK-CENTRAL           ,NY,10021-0000,Public       ,5,9,14,3065,1681,4746
02506800,YESHIVAT MIKDASH MELECH                 ,NY,11230-0000,Private      ,3,1,4,70,13,83
02511500,JOFFREY BALLET SCHOOL                   ,NY,10011-0000,Proprietary  ,1,2,3,123,17,140
02513500,MAR JON SCHOOL OF BEAUTY CULTURE        ,NY,14150-0000,Proprietary  ,2,1,3,41,99,140
02525600,ART INSTITUTE OF NEW YORK CITY (THE)    ,NY,10013-2429,Proprietary  ,26,43,69,2366,1758,4124
02540800,"GLOBE INSTITUTE OF TECHNOLOGY, INC.     ",NY,10007-0000,Proprietary  ,18,45,63,466,518,984
02546000,TRI-STATE COLLEGE OF ACUPUNCTURE        ,NY,10011-0000,Proprietary  ,0,1,1,2,123,125
02546300,YESHIVA OF THE TELSHE ALUMNI            ,NY,10471-0000,Private      ,9,0,9,53,1,54
02550600,TALMUDICAL INST OF UPSTATE NY           ,NY,14607-0000,Private      ,1,0,1,6,5,11
02556700,SEMINAR L'MOROS BAIS YAAKOV             ,NY,11219-0000,Private      ,0,0,0,224,3,227
02572900,BUSINESS INFORMATICS CENTER             ,NY,11580-0000,Proprietary  ,0,0,0,21,72,93
02575400,FRENCH CULINARY INSTITUTE               ,NY,10013-2618,Proprietary  ,20,37,57,486,1083,1569
02587600,ORLO SCH HAIR DESIGN & COSMETOLOGY      ,NY,12206-1723,Proprietary  ,2,3,5,63,124,187
02599400,NEW YORK COLLEGE OF HEALTH PROFESSIONS  ,NY,11791-4413,Private      ,5,23,28,230,1024,1254
02600100,NEW YORK ACADEMY OF ART (THE)           ,NY,10013-2911,Private      ,0,5,5,262,388,650
02614900,SANFORD-BROWN INSTITUTE                 ,NY,10604-2910,Proprietary  ,0,0,0,148,391,539
02615001,SANFORD-BROWN COLLEGE - SANFORD-BROWN IN,NY,11530-4734,Proprietary  ,16,43,59,387,880,1267
02616600,SHEAR EGO INTERNATIONAL SCHOOL OF HAIR D,NY,14617-3501,Proprietary  ,1,7,8,94,198,292
02617000,CONTINENTAL SCH OF BEAUTY CULTURE       ,NY,14020-0000,Proprietary  ,2,5,7,49,105,154
02617002,CONTINENTAL SCHOOL OF BEAUTY CULTURE  - ,NY,14020-1908,Proprietary  ,4,3,7,17,31,48
02622900,BAIS MEDRASH ELYON                      ,NY,10952-3013,Private      ,8,2,10,16,9,25
03000100,YESHIVA GEDOLAH IMREI YOSEF DSPINKA     ,NY,11219-4696,Private      ,1,31,32,1,121,122
03007200,DANCE THEATRE OF HARLEM                 ,NY,10031-0000,Private      ,1,2,3,47,63,110
03027701,PACIFIC COLLEGE OF ORIENTAL MEDICINE - N,NY,10010-7108,Proprietary  ,1,14,15,51,555,606
03081600,DELAWARE CHENANGO MADISON OT. BOCES     ,NY,13815-9554,Public       ,0,0,0,26,67,93
03089700,COMPUTER CAREER CENTER                  ,NY,11530-3334,Proprietary  ,0,0,0,81,283,364
03095500,ASA INST BUSINESS & COMPUTER TECH       ,NY,11201-5208,Proprietary  ,207,577,784,2643,5416,8059
03096200,CHARLES STUART SCHOOL                   ,NY,11229-2004,Proprietary  ,0,0,0,13,61,74
03103700,ADIRONDACK BEAUTY SCHOOL                ,NY,12801-3158,Proprietary  ,0,4,4,25,63,88
03104900,SULLIVAN COUNTY BOCES                   ,NY,12754-2116,Public       ,1,1,2,24,57,81
03115300,GENESEE VALLEY BOCES                    ,NY,14020-1099,Public       ,2,0,2,69,204,273
03120700,NEW YORK CONSERVATORY FOR DRAMATIC ARTS ,NY,10011-4225,Proprietary  ,0,1,1,583,218,801
03127100,YESHIVAS NOVOMINSK                      ,NY,11219-0000,Private      ,4,0,4,56,2,58
03129200,RABBINICAL CLG OHR SHIMAR YISROEL       ,NY,11211-8102,Private      ,0,3,3,21,125,146
03147300,YESHIVA D'MONSEY                        ,NY,10952-3106,Private      ,0,14,14,3,45,48
03169300,STUDIO JEWELERS                         ,NY,10016-4112,Proprietary  ,0,1,1,9,49,58
03181400,MERKAZ BNOS                             ,NY,11214-4911,Private      ,1,18,19,10,249,259
03191300,CUNY SCHOOL OF LAW @ QUEENS COLLEGE     ,NY,11367-0000,Public       ,1,4,5,421,1215,1636
03193300,MANHATTAN SCHOOL OF COMPUTER TECH       ,NY,11230-1617,Private      ,29,115,144,309,823,1132
03203300,NEW YORK INSTITUTE OF MASSAGE           ,NY,14221-6021,Proprietary  ,0,1,1,47,188,235
03216300,UNIFICATION THEOLOGICAL SEMINARY        ,NY,12507-5021,Private      ,0,0,0,19,39,58
03328300,FRANKLIN CAREER INSTITUTE               ,NY,11550-3003,Private      ,3,16,19,68,207,275
03328301,FRANKLIN CAREER INSTITUTE - BROOKLYN    ,NY,11220-3110,Private      ,16,36,52,161,462,623
03342400,AMERICAN BARBER INSTITUTE               ,NY,10001-5271,Proprietary  ,0,0,0,18,74,92
03358300,ALLEN SCHOOL                            ,NY,11432-4901,Proprietary  ,22,222,244,245,2210,2455
03358301,ALLEN SCHOOL - BROOKLYN                 ,NY,11201-0000,Proprietary  ,17,77,94,261,1048,1309
03380300,STAR CAREER ACADEMY                     ,NY,11791-5311,Proprietary  ,10,23,33,103,360,463
03419400,NORTHEASTERN SEMINARY                   ,NY,14624-1997,Private      ,0,1,1,29,152,181
03426400,ANTHEM INSTITUTE                        ,NY,10018-0000,Proprietary  ,0,0,0,4,8,12
03433500,LIA SCHORR INSTITUTE OF COSMETIC SK     ,NY,10022-2614,Proprietary  ,0,7,7,17,83,100
03443300,NEW YORK COLLEGE OF TRADITIONAL CHINESE ,NY,11501-0000,Private      ,0,5,5,2,107,109
03496300,YESHIVA SHAAREI TORAH OF ROCKLAND       ,NY,10901-4003,Private      ,10,3,13,32,42,74
03537300,NEW YORK AUTOMOTIVE & DIESEL INSTIT     ,NY,11101-0000,Proprietary  ,18,45,63,196,448,644
03568300,LEON STUDIO ONE SCHOOL OF HAIR DESI     ,NY,14221-5323,Proprietary  ,0,3,3,33,79,112
03651300,SAINT JOSEPH'S MEDICAL CENTER SCHOO     ,NY,10701-4080,Private      ,0,3,3,19,36,55
03652300,METROPOLITAN LEARNING INSTITUTE         ,NY,11374-2101,Private      ,11,182,193,86,1388,1474
03665400,CHRISTIE'S EDUCATION                    ,NY,10036-8002,Proprietary  ,0,2,2,5,60,65
03713300,BEIS MEDRASH HEICHAL DOVID              ,NY,11691-4433,Private      ,4,0,4,27,5,32
03773300,CENTER FOR NATURAL WELLNESS SCHOOL OF MA,NY,12205-1601,Proprietary  ,0,2,2,48,238,286
03802300,UTA MESIVTA OF KIRYAS JOEL              ,NY,10950-2169,Private      ,110,163,273,747,681,1428
03809400,MICROPOWER CAREER INSTITUTE             ,NY,10001-2812,Proprietary  ,12,88,100,112,843,955
03839300,AVEDA INSTITUTE NEW YORK                ,NY,10013-1522,Proprietary  ,14,21,35,226,499,725
03881300,UNION GRADUATE COLLEGE                  ,NY,12308-3131,Private      ,0,7,7,16,205,221
03903400,AMERICAN BEAUTY SCHOOL                  ,NY,10462-8003,Proprietary  ,5,31,36,162,469,631
03941400,ELITE ACADEMY OF BEAUTY ARTS            ,NY,11223-1630,Proprietary  ,0,3,3,24,107,131
03983300,"SCHOOL OF PROFESSIONAL HORTICULTURE, AT ",NY,10458-5126,Private      ,0,1,1,13,56,69
03988300,"SAE INSTITUTE OF TECHNOLOGY, NEW YORK   ",NY,10001-2915,Proprietary  ,12,22,34,382,555,937
04043300,ACE COMPUTER TRAINING CENTER            ,NY,11375-5337,Proprietary  ,1,21,22,61,333,394
04092401,MAKE-UP DESIGNORY -                     ,NY,10012-0041,Proprietary  ,2,10,12,337,426,763
04095300,KING'S COLLEGE (THE)                    ,NY,10018-0110,Private      ,3,2,5,956,169,1125
04102300,NEW AGE TRAINING                        ,NY,10001-4006,Proprietary  ,5,40,45,46,211,257
04115500,TALMUDICAL SEMINARY OF BOBOV            ,NY,11219-3826,Private      ,17,25,42,153,157,310
04117100,EDP SCHOOL OF COMPUTER PROGRAMMING      ,NY,11235-0000,Private      ,0,1,1,21,137,158
04117700,"MONROE 2-ORLEANS BOCES, CENTER FOR WORK ",NY,14624-1119,Public       ,1,9,10,123,390,513
04119600,YESHIVA OF FAR ROCKAWAY DERECH AYSON RAB,NY,11691-5219,Private      ,3,0,3,16,1,17
04123200,INSTITUTE OF ALLIED MEDICAL PROFESSIONS ,NY,11373-5541,Private      ,1,0,1,23,146,169
04123300,HUDSON VALLEY SCHOOL OF MASSAGE THERAPY ,NY,12493-0000,Proprietary  ,0,0,0,2,2,4
04125600,CAREER SCHOOL OF NY                     ,NY,10301-2416,Private      ,0,8,8,77,157,234
04131500,COLLECTIVE (THE)                        ,NY,10011-2026,Proprietary  ,0,0,0,11,25,36
04133700,NEW YORK MEDICAL CAREER TRAINING CENTER ,NY,11354-6504,Proprietary  ,1,10,11,50,237,287
04133701,NEW YORK MEDICAL CAREER TRAINING CENTER ,NY,10018-6504,Proprietary  ,4,8,12,19,90,109
04134000,"JOHN PAOLO'S XTREME BEAUTY INSTITUTE, GO",NY,12020-1245,Proprietary  ,1,2,3,18,93,111
04134001,"JOHN PAOLO'S XTREME BEAUTY INSTITUTE, GO",NY,13417-1319,Proprietary  ,1,7,8,48,174,222
04137700,ANN MARIE'S WORLD OF BEAUTY SCHOOL      ,NY,13901-2308,Proprietary  ,1,2,3,15,39,54
04138100,YESHIVA OF MACHZIKAI HADAS              ,NY,11219-1408,Private      ,22,38,60,111,166,277
04144300,INSTITUTE OF CULINARY EDUCATION         ,NY,10010-5205,Proprietary  ,13,53,66,649,1381,2030
04148000,NEW LIFE BUSINESS INSTITUTE             ,NY,11432-6149,Proprietary  ,1,52,53,50,411,461
04151200,SALON PROFESSIONAL ACADEMY (THE)        ,NY,14150-9200,Proprietary  ,2,9,11,91,149,240
04155300,ONONDAGA SCHOOL OF THERAPEUTIC MASSAGE  ,NY,13210-1533,Proprietary  ,1,2,3,80,373,453
04156000,ACADEMY OF COSMETOLOGY & ESTHETICS NYC (,NY,10306-3003,Proprietary  ,6,5,11,181,244,425
04157500,ACCESS CAREERS                          ,NY,11201-5826,Proprietary  ,3,22,25,64,324,388
04165700,"JOHN PAOLO'S XTREME BEAUTY INSTITUTE, GO",NY,12110-3053,Proprietary  ,0,1,1,12,49,61
04166000,MANHATTAN INSTITUTE (THE)               ,NY,10016-6516,Proprietary  ,1,18,19,164,353,517
04167600,FINGER LAKES SCHOOL OF MASSAGE (THE)    ,NY,14850-1384,Proprietary  ,1,8,9,58,203,261
04167601,FINGER LAKES SCHOOL OF MASSAGE (THE) -  ,NY,10549-1103,Proprietary  ,0,6,6,16,133,149
04178700,ATELIER ESTHETIQUE INSTITUTE OF ESTHETIC,NY,10016-8804,Proprietary  ,6,26,32,53,342,395
04179800,SOTHEBY'S INSTITUTE OF ART - NY         ,NY,10022-6717,Proprietary  ,0,0,0,29,141,170
04180200,LONG ISLAND NAIL & SKIN CARE INSTITUTE  ,NY,11756-1316,Proprietary  ,1,20,21,25,141,166
04189000,LONG ISLAND BARBER INSTITUTE (THE)      ,NY,11550-6317,Proprietary  ,2,6,8,23,95,118
04190500,NEW YORK SCHOOL OF ESTHETICS & DAY SPA  ,NY,10591-3232,Proprietary  ,0,7,7,25,96,121
04192800,BE'ER YAAKOV TALMUDIC SEMINARY          ,NY,10977-1912,Private      ,20,7,27,106,212,318
04204300,AESTHETIC SCIENCE INSTITUTE (THE)       ,NY,12110-1095,Proprietary  ,0,6,6,29,99,128
04206200,DIGITAL FILM ACADEMY                    ,NY,10036-3708,Proprietary  ,0,7,7,182,274,456
04207600,AMERICAN ACADEMY OF PERSONAL TRAINING   ,NY,10011-7301,Proprietary  ,5,12,17,46,190,236
04208600,RELAY SCHOOL OF EDUCATION               ,NY,10011-4233,Private      ,0,4,4,1,218,219
04208800,GLORIA FRANCIS SCHOOL OF MAKE-UP ARTISTR,NY,11801-3873,Proprietary  ,0,6,6,14,39,53
04210100,NEW COMMUNITY COLLEGE AT CUNY (THE)     ,NY,10018-2602,Public       ,8,7,15,878,501,1379
04210700,NEW YORK INSTITUTE OF BEAUTY            ,NY,11749-1479,Proprietary  ,2,10,12,39,116,155
04212500,CACTUS ACADEMY (THE)                    ,NY,11530-3402,Proprietary  ,4,8,12,71,93,164
04213400,ACCESS CAREERS                          ,NY,11550-0000,Proprietary  ,0,14,14,3,32,35
04213500,SHARP EDGEZ BARBER INSTITUTE            ,NY,14620-0000,Proprietary  ,1,9,10,21,104,125
04215900,YESHIVA GEDOLAH KESSER TORAH            ,NY,10952-2127,Private      ,4,0,4,50,2,52
04223100,ARROJO COSMETOLOGY SCHOOL               ,NY,10014-4960,Proprietary  ,4,12,16,44,120,164
04223200,GRACE INTERNATIONAL BEAUTY SCHOOL       ,NY,11355-2446,Proprietary  ,1,20,21,1,20,21
04223800,ELECTRICAL TRAINING CENTER (THE)        ,NY,11726-2701,Proprietary  ,6,5,11,13,23,36
04225500,WESTCHESTER SCHOOL FOR DENTAL ASSISTANTS,NY,10606-1246,Proprietary  ,0,3,3,0,3,3
04228300,PAUL MITCHELL THE SCHOOL                ,NY,12305-2303,Proprietary  ,20,16,36,20,16,36
04233700,CHRISTINE VALMY INTERNATIONAL SCHOOL FOR,NY,10016-7701,Proprietary  ,5,24,29,5,24,29
00267808,BRYANT & STRATTON COLLEGE - PARMA       ,OH,44130-0000,Proprietary  ,32,125,157,667,3687,4354
00301000,ANTIOCH UNIVERSITY                      ,OH,45387-1608,Private      ,0,9,9,264,795,1059
00301100,ART ACADEMY OF CINCINNATI               ,OH,45202-7106,Private      ,0,4,4,489,274,763
00301200,ASHLAND UNIVERSITY                      ,OH,44805-3799,Private      ,4,111,115,3731,3267,6998
00301300,ATHENAEUM OF OHIO                       ,OH,45230-2000,Private      ,0,0,0,6,23,29
00301400,BALDWIN-WALLACE COLLEGE                 ,OH,44017-2088,Private      ,5,26,31,5139,1919,7058
00301600,BLUFFTON UNIVERSITY                     ,OH,45817-2104,Private      ,3,1,4,1554,406,1960
00301800,BOWLING GREEN STATE UNIVERSITY          ,OH,43403-0001,Public       ,21,58,79,20960,6592,27552
00302300,CAPITAL UNIVERSITY                      ,OH,43209-2394,Private      ,8,41,49,4445,3408,7853
00302400,CASE WESTERN RESERVE UNIV               ,OH,44106-0000,Private      ,6,26,32,11067,2361,13428
00302401,CASE WESTERN RESERVE UNIV - MED         ,OH,44106-0000,Private      ,1,8,9,102,1233,1335
00302402,CASE WESTERN RESERVE UNIV - DENTAL      ,OH,44106-0000,Private      ,0,5,5,53,332,385
00302403,CASE WESTERN RESERVE UNIV - LAW         ,OH,44106-0000,Private      ,1,6,7,34,845,879
00302404,CASE WESTERN RESERVE UNIV - UG          ,OH,44106-0000,Private      ,2,1,3,211,58,269
00302405,CASE WESTERN RESERVE UNIV - MSASS       ,OH,44106-0000,Private      ,0,3,3,20,565,585
00302406,CASE WESTERN RESERVE UNIV - NURS UG     ,OH,44106-0000,Private      ,0,6,6,283,259,542
00302407,CASE WESTERN RESERVE UNIV - WSOM        ,OH,44106-0000,Private      ,0,1,1,34,236,270
00302408,CASE WESTERN RESERVE UNIV -A&S GRAD     ,OH,44106-0000,Private      ,0,2,2,15,343,358
00302409,CASE WESTERN RESERVE UNIV -ENG GRAD     ,OH,44106-0000,Private      ,0,0,0,48,105,153
00302410,CASE WESTERN RESERVE UNIV -NURS GRD     ,OH,44106-0000,Private      ,0,3,3,15,434,449
00302500,CEDARVILLE UNIVERSITY                   ,OH,45314-8564,Private      ,6,10,16,4286,500,4786
00302600,CENTRAL STATE UNIVERSITY                ,OH,45384-1004,Public       ,12,17,29,3226,1821,5047
00302900,CINCINNATI CHRISTIAN UNIVERSITY         ,OH,45204-3200,Private      ,0,9,9,613,817,1430
00303000,OHIO CHRISTIAN UNIVERSITY               ,OH,43113-9487,Private      ,20,246,266,952,4718,5670
00303100,CLEVELAND INSTITUTE OF MUSIC            ,OH,44106-1776,Private      ,1,7,8,412,459,871
00303200,CLEVELAND STATE UNIVERSITY              ,OH,44115-2214,Public       ,50,241,291,11999,15602,27601
00303300,COLLEGE OF MT ST JOSEPH                 ,OH,45233-1670,Private      ,2,20,22,2028,1607,3635
00303500,OHIO DOMINICAN UNIVERSITY               ,OH,43219-2099,Private      ,5,42,47,2367,2881,5248
00303600,FRANCISCAN UNIV OF STEUBENVILLE         ,OH,43952-1763,Private      ,5,8,13,2671,725,3396
00303700,COLLEGE OF WOOSTER                      ,OH,44691-2363,Private      ,3,2,5,3591,173,3764
00303900,COLUMBUS COLLEGE OF ART AND DESIGN      ,OH,43215-1758,Private      ,9,13,22,1811,928,2739
00304000,CUYAHOGA COMMUNITY COLLEGE              ,OH,44115-2878,Public       ,169,778,947,12655,28471,41126
00304100,"DEFIANCE COLLEGE, THE                   ",OH,43512-1695,Private      ,7,9,16,1458,515,1973
00304200,DENISON UNIVERSITY                      ,OH,43023-1329,Private      ,2,1,3,3130,141,3271
00304300,CHANCELLOR UNIVERSITY                   ,OH,44114-0000,Proprietary  ,0,0,0,33,273,306
00304400,TRINITY LUTHERAN SEMINARY               ,OH,43209-0000,Private      ,0,3,3,5,148,153
00304500,UNIVERSITY OF FINDLAY                   ,OH,45840-3695,Private      ,7,55,62,3724,1857,5581
00304600,FRANKLIN UNIVERSITY                     ,OH,43215-5399,Private      ,15,150,165,1352,11381,12733
00304800,HEIDELBERG UNIVERSITY                   ,OH,44883-2462,Private      ,2,7,9,2015,448,2463
00304900,HIRAM COLLEGE                           ,OH,44234-1808,Private      ,3,11,14,1792,491,2283
00305000,JOHN CARROLL UNIVERSITY                 ,OH,44118-4581,Private      ,9,25,34,4747,1061,5808
00305100,KENT STATE UNIVERSITY                   ,OH,44242-0001,Public       ,46,111,157,27305,13673,40978
00305101,KENT STATE UNIVERSITY - GEAUGA CAMPUS   ,OH,44021-9500,Public       ,3,9,12,848,1057,1905
00305102,KENT STATE UNIVERSITY - STARK CAMPUS    ,OH,44720-7599,Public       ,13,45,58,3580,4256,7836
00305103,KENT STATE UNIVERSITY - TUSCARAWAS CAMPU,OH,44663-9403,Public       ,2,7,9,1062,1569,2631
00305104,KENT STATE UNIVERSITY - TRUMBULL CAMPUS ,OH,44483-1998,Public       ,4,17,21,1272,2428,3700
00305105,KENT STATE UNIVERSITY - ASHTABULA CAMPUS,OH,44004-2299,Public       ,4,21,25,988,2188,3176
00305106,KENT STATE UNIVERSITY - EAST LIVERPOOL C,OH,43920-3497,Public       ,2,13,15,506,919,1425
00305107,KENT STATE UNIVERSITY - SALEM CAMPUS    ,OH,44460-9412,Public       ,3,12,15,1074,1300,2374
00305143,KENT STATE UNIVERSITY - COLLEGE OF PODIA,OH,44131-2330,Public       ,0,0,0,31,313,344
00306500,KENYON COLLEGE                          ,OH,43022-9623,Private      ,0,3,3,2800,88,2888
00306600,LAKE ERIE COLLEGE                       ,OH,44077-3389,Private      ,3,4,7,1377,465,1842
00306800,LORAIN COUNTY COMMUNITY COLLEGE         ,OH,44035-1691,Public       ,41,152,193,4657,9119,13776
00306900,LOURDES COLLEGE                         ,OH,43560-2898,Private      ,2,10,12,1335,1915,3250
00307200,MALONE UNIVERSITY                       ,OH,44709-3897,Private      ,3,14,17,1953,1555,3508
00307300,MARIETTA COLLEGE                        ,OH,45750-4033,Private      ,2,6,8,2578,413,2991
00307500,METHODIST THEOLOGICAL SCH IN OHIO       ,OH,43015-0000,Private      ,0,0,0,2,206,208
00307600,MIAMI-JACOBS COLLEGE                    ,OH,45401-0000,Proprietary  ,0,0,0,22,74,96
00307700,MIAMI UNIVERSITY                        ,OH,45056-1831,Public       ,30,90,120,23149,6314,29463
00307800,WRIGHT STATE UNIVERSITY                 ,OH,45435-0002,Public       ,31,138,169,13680,11675,25355
00308300,UNIVERSITY OF MOUNT UNION               ,OH,44601-3993,Private      ,6,6,12,3549,369,3918
00308400,MUSKINGUM UNIVERSITY                    ,OH,43762-1199,Private      ,3,23,26,2298,773,3071
00308500,NOTRE DAME COLLEGE OF OHIO              ,OH,44121-4293,Private      ,7,37,44,2557,1923,4480
00308600,OBERLIN COLLEGE                         ,OH,44074-1090,Private      ,2,1,3,5098,219,5317
00308900,OHIO NORTHERN UNIVERSITY                ,OH,45810-1555,Private      ,5,8,13,3755,1014,4769
00309000,OHIO STATE UNIVERSITY-ALL CAMPUSES      ,OH,43210-1358,Public       ,79,183,262,57211,26993,84204
00310000,OHIO UNIVERSITY                         ,OH,45701-2979,Public       ,38,194,232,24656,13627,38283
00310002,"OHIO UNIVERSITY, ZANESVILLE CAMPUS      ",OH,43701-0000,Public       ,5,26,31,1378,1830,3208
00310003,"OHIO UNIVERSITY, LANCASTER CAMPUS       ",OH,43130-0000,Public       ,6,29,35,1603,2251,3854
00310004,"OHIO UNIVERSITY, SOUTHERN CAMPUS        ",OH,45638-0000,Public       ,4,34,38,917,2061,2978
00310005,"OHIO UNIVERSITY, CHILLICOTHE CAMPUS     ",OH,45601-0000,Public       ,6,36,42,1321,2436,3757
00310006,"OHIO UNIVERSITY, EASTERN CAMPUS         ",OH,43950-0000,Public       ,0,7,7,584,498,1082
00310008,OHIO UNIV COLL OF OSTEOPATHIC MED       ,OH,45701-0000,Public       ,0,1,1,19,601,620
00310900,OHIO WESLEYAN UNIVERSITY                ,OH,43015-2398,Private      ,6,2,8,3141,219,3360
00311000,OTTERBEIN UNIVERSITY                    ,OH,43081-2006,Private      ,3,22,25,4112,1168,5280
00311300,PONTIFICAL COLLEGE JOSEPHINUM           ,OH,43235-1498,Private      ,0,0,0,55,24,79
00311400,FIRELANDS REGIONAL MEDICAL CENTER - SOUT,OH,44870-4788,Private      ,1,1,2,68,174,242
00311500,RABBINICAL COLLEGE OF TELSHE            ,OH,44092-2584,Private      ,4,1,5,26,29,55
00311600,UNIV OF RIO GRANDE                      ,OH,45674-3131,Private      ,27,60,87,1640,2339,3979
00311900,SINCLAIR COMMUNITY COLLEGE              ,OH,45402-1460,Public       ,122,625,747,9770,19855,29625
00312100,TIFFIN UNIVERSITY                       ,OH,44883-2161,Private      ,5,45,50,2914,5991,8905
00312200,UNITED THEOLOGICAL SEMINARY             ,OH,45406-0000,Private      ,0,1,1,6,730,736
00312300,UNIVERSITY OF AKRON                     ,OH,44325-6211,Public       ,55,130,185,20651,14999,35650
00312500,UNIVERSITY OF CINCINNATI                ,OH,45221-0125,Public       ,76,385,461,30050,25047,55097
00312504,UNIVERSITY OF CINCINNATI - MEDICINE     ,OH,45267-0553,Public       ,2,14,16,428,1751,2179
00312700,UNIVERSITY OF DAYTON                    ,OH,45469-0002,Private      ,21,77,98,13026,3711,16737
00313100,UNIVERSITY OF TOLEDO                    ,OH,43606-3390,Public       ,38,100,138,17910,11275,29185
00313300,URBANA UNIVERSITY                       ,OH,43078-2091,Private      ,3,8,11,1067,1039,2106
00313400,URSULINE COLLEGE                        ,OH,44124-4398,Private      ,3,23,26,675,1463,2138
00313500,WALSH UNIVERSITY                        ,OH,44720-3396,Private      ,2,13,15,2727,1497,4224
00314100,WILBERFORCE UNIVERSITY                  ,OH,45384-1001,Private      ,2,4,6,643,490,1133
00314200,WILMINGTON COLLEGE                      ,OH,45177-2499,Private      ,3,3,6,2163,576,2739
00314300,WITTENBERG UNIVERSITY                   ,OH,45501-2199,Private      ,9,7,16,3894,490,4384
00314400,XAVIER UNIVERSITY                       ,OH,45207-1035,Private      ,9,40,49,8516,3520,12036
00314500,YOUNGSTOWN STATE UNIVERSITY             ,OH,44555-0001,Public       ,14,57,71,9656,7549,17205
00398200,CLEVELAND INSTITUTE OF ART              ,OH,44106-1700,Private      ,1,8,9,1083,373,1456
00406000,WINEBRENNER THEOLOGICAL SEMINARY        ,OH,45840-0000,Private      ,0,0,0,2,61,63
00485200,CLARK STATE COMMUNITY COLLEGE           ,OH,45505-4795,Public       ,40,224,264,2188,6855,9043
00485300,BRADFORD SCHOOL                         ,OH,43219-0000,Proprietary  ,5,8,13,769,827,1596
00485500,DAVIS COLLEGE                           ,OH,43623-4307,Proprietary  ,2,19,21,148,816,964
00486100,UNIVERSITY OF NORTHWESTERN OHIO         ,OH,45805-1498,Private      ,21,27,48,5098,2231,7329
00486600,STAUTZENBERGER COLLEGE                  ,OH,43537-4007,Proprietary  ,6,30,36,501,1740,2241
00489814,MCCANN SCHOOL OF BUSINESS & TECHNOLOGY -,OH,44131-2309,Proprietary  ,0,0,0,6,37,43
00489817,MCCANN SCHOOL OF BUSINESS & TECHNOLOGY -,OH,45241-5428,Proprietary  ,0,0,0,4,16,20
00510200,SCH OF DIAGNOSTIC IMAGING-CLEVELAND     ,OH,44119-0000,Private      ,0,4,4,16,54,70
00531300,NORTH CENTRAL STATE COLLEGE             ,OH,44901-0000,Public       ,4,34,38,1434,2741,4175
00575300,OWENS STATE COMMUNITY COLLEGE           ,OH,43699-0000,Public       ,31,118,149,6093,11240,17333
00648700,AULTMAN COLLEGE OF NURSING AND HEALTH SC,OH,44710-1799,Private      ,1,5,6,207,583,790
00648900,CHRIST COLLEGE OF NURSING AND HEALTH SCI,OH,45219-2906,Private      ,1,8,9,357,928,1285
00649400,GOOD SAMARITAN COLG-NURSING/HEALTH      ,OH,45220-2489,Private      ,1,5,6,313,802,1115
00650700,TRINIT HEALTH SYSTEM SCH OF NURSING     ,OH,43952-2667,Private      ,0,3,3,70,187,257
00680400,LAKELAND COMMUNITY COLLEGE              ,OH,44094-5198,Public       ,25,108,133,3331,7013,10344
00686700,COLUMBUS STATE COMMUNITY COLLEGE        ,OH,43215-1786,Public       ,139,586,725,14853,27950,42803
00703500,KETTERING COLLEGE OF MEDICAL ARTS       ,OH,45429-1299,Private      ,2,14,16,627,1030,1657
00708500,MOUNT VERNON NAZARENE UNIVERSITY        ,OH,43050-9500,Private      ,0,14,14,1603,976,2579
00708501,MOUNT VERNON NAZARENE UNIV - AGS        ,OH,43050-0000,Private      ,0,10,10,96,830,926
00727500,EASTERN GATEWAY COMMUNITY COLLEGE       ,OH,43952-3598,Public       ,5,23,28,1222,2681,3903
00732920,ITT TECHNICAL INSTITUTE                 ,OH,45414-3456,Proprietary  ,27,131,158,532,2192,2724
00732992,ITT TECHNICAL INSTITUTE                 ,OH,44509-4098,Proprietary  ,34,139,173,555,2116,2671
00747300,CHOFFIN CAREER & TECHNICAL CENTER       ,OH,44503-1628,Public       ,1,4,5,126,371,497
00759800,HOCKING TECHNICAL COLLEGE               ,OH,45764-9582,Public       ,11,42,53,3287,3445,6732
00812900,ADULT AND COMMUNITY EDUCATION @ HUDSON  ,OH,43211-2017,Public       ,1,18,19,70,606,676
00813200,TOLEDO SCHOOL OF PRACTICAL NURSING      ,OH,43613-5110,Public       ,1,5,6,150,550,700
00813300,ZANE STATE COLLEGE                      ,OH,43701-2626,Public       ,24,75,99,1456,2463,3919
00819400,AKRON SCHOOL OF PRACTICAL NRSG          ,OH,44311-0000,Public       ,4,3,7,185,347,532
00827800,TERRA COMMUNITY COLLEGE                 ,OH,43420-9670,Public       ,14,46,60,1022,2315,3337
00867700,NORTHWEST STATE COMMUNITY COLLEGE       ,OH,43502-9542,Public       ,3,30,33,1067,2433,3500
00888600,PORTAGE LAKES CAREER CENTER             ,OH,44685-9554,Public       ,0,2,2,27,102,129
00908803,ITT TECHNICAL INSTITUTE                 ,OH,44136-1758,Proprietary  ,0,0,0,0,2,2
00915600,WAYNE COUNTY SCHOOLS CAREER CENTER      ,OH,44677-9672,Public       ,1,4,5,64,260,324
00941200,FORTIS COLLEGE                          ,OH,44221-2998,Proprietary  ,16,60,76,242,1426,1668
00953000,GERBER AKRON BEAUTY SCHOOL              ,OH,44313-6995,Proprietary  ,0,6,6,42,171,213
00953100,SPA SCHOOL (THE)                        ,OH,43214-1524,Proprietary  ,3,16,19,80,423,503
00966000,TIFFIN ACADEMY OF HAIR DESIGN           ,OH,44883-2833,Proprietary  ,3,5,8,46,65,111
00994100,BELMONT TECHNICAL COLLEGE               ,OH,43950-9766,Public       ,3,20,23,826,1491,2317
00994200,SHAWNEE STATE UNIVERSITY                ,OH,45662-4344,Public       ,11,24,35,4656,2744,7400
01001700,PAYNE THEOLOGICAL SEMINARY              ,OH,45384-0474,Private      ,0,0,0,0,169,169
01002700,JAMES A. RHODES STATE COLLEGE           ,OH,45804-3597,Public       ,8,32,40,1701,2967,4668
01016800,NATIONWIDE BEAUTY ACADEMY               ,OH,43228-1000,Proprietary  ,1,4,5,109,306,415
01028000,OHIO STATE BEAUTY ACADEMY               ,OH,45801-0000,Proprietary  ,0,5,5,160,231,391
01032300,HANNAH E MULLINS SCH-PRAC NRSG          ,OH,44460-2906,Public       ,0,0,0,27,101,128
01034500,CINCINNATI STATE TECH & COMM CLG        ,OH,45223-2690,Public       ,50,324,374,5959,13891,19850
01045300,WASHINGTON STATE CMTY COLLEGE           ,OH,45750-9225,Public       ,9,32,41,919,1302,2221
01063000,NORTHERN INSTITUTE OF COSMETOLOGY       ,OH,44052-1803,Proprietary  ,2,2,4,26,96,122
01073600,MARION TECHNICAL COLLEGE                ,OH,43302-5694,Public       ,4,21,25,961,2071,3032
01088000,CHATFIELD COLLEGE                       ,OH,45118-9705,Private      ,6,25,31,107,496,603
01088100,STARK STATE COLLEGE OF TECHNOLOGY       ,OH,44720-7299,Public       ,27,122,149,4766,14191,18957
01090600,CINCINNATI CLG OF MORTUARY SCIENCE      ,OH,45224-1428,Private      ,0,1,1,80,229,309
01092300,UNION INSTITUTE & UNIVERSITY            ,OH,45206-1925,Private      ,1,116,117,50,2537,2587
01099300,HOBART INSTITUTE OF WELDING TECHNOLOGY  ,OH,45373-2400,Private      ,4,10,14,360,333,693
01100500,KAPLAN COLLEGE                          ,OH,43232-4827,Proprietary  ,0,0,0,137,964,1101
01104600,CENTRAL OHIO TECHNICAL COLLEGE          ,OH,43055-1767,Public       ,13,49,62,1778,4712,6490
01170300,PENTA COUNTY JOINT VOCATIONAL SCH       ,OH,43551-0000,Public       ,0,0,0,28,135,163
01174400,NATIONAL BEAUTY COLLEGE                 ,OH,44720-0000,Proprietary  ,1,5,6,54,210,264
01174500,OHIO TECHNICAL COLLEGE                  ,OH,44103-1228,Proprietary  ,16,36,52,1584,1268,2852
01182500,OHIO STATE SCHOOL OF COSMETOLOGY        ,OH,43224-1107,Proprietary  ,0,0,0,103,259,362
01212800,SOUTHWESTERN COLLEGE                    ,OH,45402-3003,Proprietary  ,0,2,2,65,393,458
01212802,SOUTHWESTERN COLLEGE                    ,OH,45005-2267,Proprietary  ,0,0,0,1,7,8
01212803,SOUTHWESTERN COLLEGE                    ,OH,45202-4304,Proprietary  ,0,0,0,5,41,46
01212804,SOUTHWESTERN COLLEGE                    ,OH,45246-3121,Proprietary  ,0,2,2,61,384,445
01212806,LINCOLN COLLEGE OF TECHNOLOGY - TOLEDO  ,OH,43615-6800,Proprietary  ,1,0,1,95,325,420
01212807,LINCOLN COLLEGE OF TECHNOLOGY - COLUMBUS,OH,43215-3602,Proprietary  ,0,0,0,17,46,63
01212808,LINCOLN COLLEGE OF TECHNOLOGY - CLEVELAN,OH,44114-3266,Proprietary  ,0,2,2,104,417,521
01216600,CAROUSEL BEAUTY COLLEGE                 ,OH,45402-8935,Proprietary  ,6,16,22,124,364,488
01224800,CENTRAL SCHOOL OF PRACTICAL NURSING     ,OH,44131-2155,Private      ,2,5,7,103,499,602
01267200,CAROUSEL BEAUTY COLLEGE                 ,OH,45044-5113,Proprietary  ,1,7,8,16,68,84
01267400,CAROUSEL OF MIAMI VALLEY BEAUTY CLG     ,OH,45424-2063,Proprietary  ,0,2,2,14,36,50
01275000,EDISON COMMUNITY COLLEGE                ,OH,45356-9239,Public       ,5,35,40,1112,2558,3670
01283800,LAURA AND ALVIN SIEGAL COLLEGE OF JUDAIC,OH,44122-7197,Private      ,0,1,1,4,10,14
01284800,MOLER-HOLLYWOOD BEAUTY COLLEGE          ,OH,45202-2577,Proprietary  ,3,20,23,51,178,229
01287000,SOUTHERN STATE COMMUNITY COLLEGE        ,OH,45133-9406,Public       ,16,83,99,1222,2614,3836
01289100,ANTONELLI COLLEGE                       ,OH,45202-2592,Proprietary  ,4,45,49,157,830,987
01289600,VIRGINIA MARTI COLLEGE OF ART AND DESIGN,OH,44107-0778,Proprietary  ,1,5,6,165,215,380
01303922,SOUTH UNIVERSITY - CLEVELAND            ,OH,44128-5919,Proprietary  ,1,50,51,74,713,787
01313200,INTERNATIONAL CLG OF BROADCASTING       ,OH,45431-1898,Proprietary  ,0,3,3,98,231,329
02052000,KAPLAN COLLEGE                          ,OH,45439-1984,Proprietary  ,6,74,80,256,1646,1902
02054300,TRUMBULL BUSINESS COLLEGE               ,OH,44484-0000,Proprietary  ,0,5,5,49,454,503
02056800,DAYMAR COLLEGE                          ,OH,45601-1038,Proprietary  ,4,13,17,39,296,335
02056802,DAYMAR COLLEGE - LANCASTER              ,OH,43130-0000,Proprietary  ,1,14,15,44,240,284
02056803,DAYMAR COLLEGE - NEW BOSTON             ,OH,45662-4900,Proprietary  ,1,6,7,32,226,258
02056804,DAYMAR COLLEGE - JACKSON                ,OH,45640-1728,Proprietary  ,0,9,9,30,178,208
02066100,OHIO STATE COLLEGE/BARBER STYLING       ,OH,43213-0000,Proprietary  ,4,35,39,155,442,597
02073300,GALLIA-JACKSON-VINTON SCH ADULT ED      ,OH,45674-0000,Public       ,0,4,4,80,229,309
02110700,CLEVELAND INST OF DENTAL-MED ASST       ,OH,44115-2285,Proprietary  ,12,35,47,177,777,954
02116009,SANFORD-BROWN COLLEGE - MIDDLEBURG HEIGH,OH,44130-8362,Proprietary  ,0,4,4,117,665,782
02116900,UPPER VALLEY JVS                        ,OH,45356-0000,Public       ,1,4,5,34,259,293
02117300,GREAT OAKS INSTITUTE OF TECHNOLOGY      ,OH,45241-1581,Public       ,0,16,16,268,1042,1310
02128600,THE ART INSTITUTE OF CINCINNATI         ,OH,45246-0000,Proprietary  ,4,6,10,556,416,972
02140700,COMMUNITY EDUCATIONAL SERVICES          ,OH,44702-1710,Public       ,0,1,1,35,243,278
02158417,"HARRISON COLLEGE - COLUMBUS, OH         ",OH,43123-0000,Proprietary  ,6,31,37,106,458,564
02158500,OHIO BUSINESS COLLEGE                   ,OH,44035-0701,Proprietary  ,4,32,36,118,643,761
02158501,OHIO BUSINESS COLLEGE                   ,OH,44870-9953,Proprietary  ,2,21,23,51,497,548
02158503,OHIO BUSINESS COLLEGE - COLUMBUS        ,OH,43229-3523,Proprietary  ,7,34,41,173,639,812
02158504,OHIO BUSINESS COLLEGE - DAYTON          ,OH,45417-4094,Proprietary  ,1,8,9,36,239,275
02168100,TRI-COUNTY JOINT VOCATIONAL SCHOOL      ,OH,45764-0000,Public       ,1,2,3,64,228,292
02187900,ASHTABULA CO JOINT VOC SCH ADULT ED     ,OH,44047-0000,Public       ,0,2,2,61,269,330
02189000,MID-EAST CAREER & TECH CENTERS-ADULT ED ,OH,43701-4600,Public       ,2,8,10,135,514,649
02190700,FORTIS COLLEGE                          ,OH,45459-0000,Proprietary  ,19,142,161,554,4494,5048
02192100,BUTLER TECHNOLOGY AND CAREER DEVELOPMENT,OH,45011-0000,Public       ,2,16,18,251,743,994
02196300,COLLINS CAREER CENTER                   ,OH,45619-0000,Public       ,0,4,4,197,642,839
02210800,MEDINA COUNTY CAREER CENTER             ,OH,44256-0000,Public       ,0,3,3,47,182,229
02220500,GOD'S BIBLE SCHOOL & COLLEGE            ,OH,45210-0000,Private      ,0,2,2,195,119,314
02220800,CAREER & TECHNOLOGY EDUCATION CENTERS OF,OH,43055-0000,Public       ,2,13,15,144,438,582
02239800,PIONEER CAREER & TECHNOLOGY CENTER      ,OH,44875-0000,Public       ,0,1,1,9,68,77
02245600,WARREN COUNTY CAREER CENTER             ,OH,45036-0000,Public       ,3,16,19,103,406,509
02246300,INSTITUTE OF MEDICAL-DENTAL TECH        ,OH,45246-3317,Proprietary  ,12,73,85,165,720,885
02263700,MIAMI VALLEY CAREER TECHNOLOGY CTR      ,OH,45315-0000,Public       ,0,10,10,166,673,839
02269400,EASTERN HILLS ACAD OF HAIR DESIGN       ,OH,45255-0000,Proprietary  ,2,4,6,34,91,125
02269500,WESTERN HILLS SCHOOL OF BEAUTY & HAIR DE,OH,45211-0000,Proprietary  ,2,22,24,67,349,416
02270100,OHIO HI-POINT CAREER CENTER             ,OH,43311-0000,Public       ,0,2,2,16,126,142
02272700,COLUMBIANA COUNTY CAREER CENTER         ,OH,44432-0000,Public       ,0,4,4,69,325,394
02287900,RAPHAEL'S SCHOOL OF BEAUTY CULTURE      ,OH,44446-0000,Proprietary  ,1,18,19,83,305,388
02289802,KAPLAN COLLEGE                          ,OH,45203-0000,Proprietary  ,0,0,0,83,550,633
02301400,OHIO VALLEY COLLEGE OF TECHNOLOGY       ,OH,43920-9139,Proprietary  ,4,28,32,107,312,419
02303600,FORTIS COLLEGE - RAVENNA CAMPUS         ,OH,44266-0000,Proprietary  ,0,0,0,79,264,343
02304700,TRI-RIVERS CAREER CENTER                ,OH,43302-0000,Public       ,0,5,5,78,335,413
02311200,AMERICAN SCHOOL OF TECHNOLOGY           ,OH,43229-0000,Proprietary  ,4,34,38,134,810,944
02315500,TOLEDO ACADEMY OF BEAUTY CULTURE - EAST ,OH,43616-0000,Proprietary  ,2,8,10,58,222,280
02324400,ALLSTATE HAIRSTYLING & BARBER CLG       ,OH,44113-0000,Proprietary  ,1,12,13,93,407,500
02328500,MOLER-PICKENS BEAUTY COLLEGE            ,OH,45014-0000,Proprietary  ,1,3,4,17,95,112
02334300,INTERNATIONAL ACAD OF HAIR DESIGN       ,OH,45239-0000,Proprietary  ,10,12,22,105,285,390
02336300,KNOX COUNTY CAREER CENTER               ,OH,43050-4298,Public       ,0,1,1,82,320,402
02336700,CUYAHOGA VALLEY CAREER CENTER           ,OH,44141-1296,Public       ,2,4,6,66,266,332
02337700,PROFESSIONAL SKILLS INSTITUTE           ,OH,43607-0000,Proprietary  ,3,5,8,166,758,924
02351500,WILLOUGHBY EASTLAKE SCH OF PRAC NSG     ,OH,44094-0000,Public       ,0,2,2,28,181,209
02352800,POLARIS CAREER CENTER-ADULT ED DEPT     ,OH,44130-0000,Public       ,0,8,8,151,533,684
02354200,SCIOTO COUNTY JOINT VOCATIONAL SCH      ,OH,45648-0000,Public       ,3,12,15,143,434,577
02359803,ITT TECHNICAL INSTITUTE -               ,OH,45212-2273,Proprietary  ,0,0,0,0,1,1
02454400,NORTHEAST OHIO MEDICAL UNIVERSITY       ,OH,44272-9621,Public       ,1,1,2,152,876,1028
02497800,GREENE COUNTY CAREER CENTER             ,OH,45385-0000,Public       ,0,4,4,45,218,263
02512600,ADULT VOCATIONAL SERVICES               ,OH,44308-0000,Public       ,0,0,0,3,11,14
02519300,OHIO STATE SCH COSMETOLOGY              ,OH,43110-2754,Proprietary  ,4,13,17,139,256,395
02522700,EASTLAND-FAIRFIELD CAREER AND TECHNICAL ,OH,43125-0000,Public       ,1,10,11,78,369,447
02528300,TDDS TECHNICAL INSTITUTE                ,OH,44429-0000,Proprietary  ,7,64,71,102,657,759
02529500,HAMRICK SCHOOL                          ,OH,44256-0000,Proprietary  ,3,33,36,32,373,405
02545800,INNER STATE BEAUTY SCHOOLS              ,OH,44124-0000,Proprietary  ,4,22,26,76,314,390
02553000,SCHOOL OF ADVERTISING ART               ,OH,45440-0000,Proprietary  ,0,0,0,260,63,323
02560000,CASAL AVEDA INSTITUTE                   ,OH,44515-0000,Proprietary  ,1,4,5,156,229,385
02560700,PICKAWAY ROSS CO JOINT VOC TECH SCH     ,OH,45601-0000,Public       ,1,2,3,113,461,574
02562300,APOLLO CAREER CENTER-ADULT EDUC         ,OH,45806-0000,Public       ,0,6,6,130,615,745
02563000,RAPHAELS SCHOOL OF BEAUTY CULTURE       ,OH,44601-2847,Proprietary  ,1,8,9,38,166,204
02568600,MAHONING COUNTY CAREER & TECH CENTR     ,OH,44406-0000,Public       ,0,3,3,37,142,179
02582900,KAPLAN CAREER INSTITUTE                 ,OH,44129-6810,Proprietary  ,1,12,13,67,687,754
02586400,TRUMBULL CAREER & TECH CENTER-ADULT     ,OH,44483-1997,Public       ,0,2,2,75,371,446
02588500,OHIO STATE SCHOOL OF COSMETOLOGY        ,OH,43081-0000,Proprietary  ,3,9,12,150,266,416
02599711,VATTEROTT COLLEGE - CLEVELAND           ,OH,44147-3502,Proprietary  ,7,44,51,69,516,585
02603800,LORAIN COUNTY JVS ADULT CAREER CTR      ,OH,44074-9799,Public       ,0,2,2,72,266,338
02611007,HERITAGE COLLEGE - COLUMBUS             ,OH,43213-4440,Proprietary  ,20,78,98,274,1127,1401
02620000,SANDUSKY CAREER CENTER                  ,OH,44870-4786,Public       ,0,1,1,24,180,204
03007900,GALLIPOLIS CAREER COLLEGE               ,OH,45631-2600,Proprietary  ,0,6,6,25,221,246
03015100,ALLIANCE HIGH SCH-CMTY SERVICES DIV     ,OH,44601-2899,Public       ,0,0,0,35,130,165
03015300,EHOVE CAREER CENTER                     ,OH,44846-9500,Public       ,1,13,14,105,468,573
03023700,MADISON ADULT CAREER CENTER             ,OH,44905-2718,Public       ,0,6,6,69,372,441
03024300,VALLEY BEAUTY SCHOOL                    ,OH,43725-2332,Proprietary  ,1,4,5,13,37,50
03026511,REMINGTON COLLEGE - CLEVELAND           ,OH,44125-1957,Private      ,4,20,24,383,1472,1855
03026512,REMINGTON COLLEGE - CLEVELAND WEST      ,OH,44070-3129,Private      ,0,0,0,54,200,254
03027100,FAIRVIEW ACADEMY                        ,OH,44126-2214,Proprietary  ,0,5,5,23,83,106
03034200,WASHINGTON COUNTY CAREER CENTER ADULT TE,OH,45750-9290,Public       ,0,25,25,147,529,676
03051400,AUBURN CAREER CENTER                    ,OH,44077-9723,Public       ,3,5,8,84,308,392
03051500,US GRANT JOINT VOCATIONAL SCHOOL        ,OH,45106-9502,Public       ,0,1,1,6,23,29
03065900,BUCKEYE CAREER CENTER                   ,OH,44663-9437,Public       ,0,9,9,60,240,300
03067600,RAPHAEL'S SCHOOL OF BEAUTY CULTURE      ,OH,44512-2222,Proprietary  ,2,12,14,66,189,255
03068200,OHIO CENTER FOR BROADCASTING            ,OH,44125-6273,Proprietary  ,3,3,6,70,248,318
03068202,OHIO CENTER FOR BROADCASTING - COLUMBUS ,OH,43213-2571,Proprietary  ,1,5,6,90,302,392
03071900,MOUNT CARMEL COLLEGE OF NURSING         ,OH,43222-1598,Private      ,2,22,24,908,1376,2284
03072303,EVEREST INSTITUTE - COLUMBUS            ,OH,43230-6653,Proprietary  ,12,81,93,196,1095,1291
03078000,OHIO CENTER FOR BROADCASTING            ,OH,45227-1509,Proprietary  ,1,3,4,61,243,304
03079000,ETI TECHNICAL COLLEGE                   ,OH,44446-4398,Proprietary  ,4,10,14,83,356,439
03084800,DELAWARE AREA CAREER CENTER             ,OH,43015-8969,Public       ,0,1,1,26,92,118
03084801,DELAWARE AREA CAREER CENTER -           ,OH,43015-9001,Public       ,0,1,1,15,57,72
03095600,VANTAGE CAREER CENTER                   ,OH,45891-1378,Public       ,0,4,4,19,121,140
03097000,MERCY COLLEGE OF NORTHWEST OHIO         ,OH,43604-1132,Private      ,6,15,21,688,1499,2187
03100100,PARAMOUNT BEAUTY ACADEMY                ,OH,45662-4136,Proprietary  ,0,13,13,47,174,221
03116200,DAYTON BARBER COLLEGE                   ,OH,45342-0000,Proprietary  ,3,12,15,30,154,184
03116300,OHIO COLLEGE OF MASSOTHERAPY            ,OH,44321-1363,Private      ,1,5,6,45,219,264
03116400,VANGUARD-SENTINELL VOC SCH DISTRICT     ,OH,43420-1197,Public       ,1,2,3,20,85,105
03117000,ASHLAND COUNTY-W HOLMES CAREER CTR      ,OH,44805-0000,Public       ,0,0,0,33,163,196
03319300,CREATIVE IMAGES-A CERTIFIED MATRIX      ,OH,45414-2557,Proprietary  ,4,15,19,122,323,445
03319301,CREATIVE IMAGES-A CERTIFIED MATRIX      ,OH,45459-0000,Proprietary  ,4,4,8,112,269,381
03416400,VALLEY BEAUTY SCHOOL                    ,OH,43701-3624,Proprietary  ,0,0,0,16,55,71
03425300,ROSEDALE BIBLE COLLEGE                  ,OH,43029-9517,Private      ,0,0,0,59,16,75
03457300,ALLEGHENY WESLEYAN COLLEGE              ,OH,44460-9598,Private      ,0,0,0,46,19,65
03468400,NATIONAL INSTITUTE OF MASSOTHERAPY      ,OH,44319-2100,Proprietary  ,0,1,1,21,122,143
03468500,ATS INSTITUTE OF TECHNOLOGY             ,OH,44143-2216,Proprietary  ,7,65,72,92,1065,1157
03475400,TRI-STATE BIBLE COLLEGE                 ,OH,45680-8402,Private      ,0,2,2,6,91,97
03534400,AMERICAN INST OF ALTERNATIVE MEDICI     ,OH,43229-1113,Proprietary  ,1,49,50,83,807,890
03583300,OHIO INSTITUTE OF ALLIED HEALTH         ,OH,45424-3646,Private      ,2,14,16,2,14,16
03626300,BROWN AVEDA INSTITUTE                   ,OH,44060-6212,Proprietary  ,7,8,15,216,382,598
03700300,REGENCY BEAUTY INSTITUTE - CLEVELAND    ,OH,44094-0000,Proprietary  ,5,15,20,259,553,812
03726300,TEMPLE BAPTIST COLLEGE                  ,OH,45240-0000,Private      ,1,2,3,91,89,180
03747300,BEXLEY HALL SEMINARY                    ,OH,43209-2325,Private      ,0,4,4,6,61,67
03776400,HEALING ARTS INSTITUTE                  ,OH,43551-3138,Proprietary  ,0,7,7,21,82,103
03837300,AVEDA FREDRIC'S INSTITUTE               ,OH,45208-1304,Proprietary  ,2,6,8,182,280,462
03882300,OREGON CAREER CENTER                    ,OH,43616-2631,Public       ,0,0,0,5,8,13
04051307,ART INSTITUTE OF PHOENIX (THE) - BROWN M,OH,45215-1107,Proprietary  ,14,66,80,429,1655,2084
04051308,ART INSTITUTE OF PHOENIX (THE) - BROWN M,OH,44320-4420,Proprietary  ,9,28,37,240,990,1230
04051317,ART INSTITUTE OF PHOENIX (THE) - BROWN M,OH,45840-6848,Proprietary  ,25,118,143,656,2907,3563
04051326,ART INSTITUTE OF PHOENIX (THE) - BROWN M,OH,44718-3674,Proprietary  ,13,54,67,169,907,1076
04068300,FOUR COUNTY CAREER CENTER               ,OH,43512-9541,Public       ,0,0,0,12,53,65
04074300,HONDROS COLLEGE                         ,OH,43081-3855,Proprietary  ,6,37,43,517,3830,4347
04117300,DAYTON SCHOOL OF MEDICAL MASSAGE        ,OH,45429-1111,Proprietary  ,13,46,59,194,674,868
04118300,NORTHCOAST MEDICAL TRAINING ACADEMY     ,OH,44240-4174,Proprietary  ,4,8,12,89,302,391
04124500,TECHSKILLS                              ,OH,43231-0000,Proprietary  ,1,37,38,67,687,754
04125700,CUT BEAUTY SCHOOL (THE)                 ,OH,44118-2918,Proprietary  ,0,0,0,52,236,288
04126000,OHIO ACADEMY PAUL MITCHELL PARTNER SCHOO,OH,44087-3107,Proprietary  ,8,7,15,163,260,423
04137800,AVEDA INSTITUTE COLUMBUS                ,OH,43201-2333,Proprietary  ,12,28,40,361,640,1001
04138000,INSTITUTE OF THERAPEUTIC MASSAGE        ,OH,45875-0350,Proprietary  ,0,3,3,9,72,81
04149100,PAUL MITCHELL THE SCHOOL CINCINNATI     ,OH,45241-1702,Proprietary  ,5,10,15,211,336,547
04149101,PAUL MITCHELL THE SCHOOL CINCINNATI - TO,OH,43560-2539,Proprietary  ,1,7,8,1,8,9
04151400,VANITY SCHOOL OF COSMETOLOGY            ,OH,44035-0000,Proprietary  ,2,2,4,37,91,128
04152100,TOLEDO RESTAURANT TRAINING CENTER       ,OH,43604-6508,Private      ,1,1,2,26,127,153
04152600,PIKE COUNTY CAREER TECHNOLOGY CENTER    ,OH,45661-9114,Public       ,0,1,1,24,104,128
04153300,OHIO ACADEMY COLUMBUS (THE)             ,OH,43231-6038,Proprietary  ,1,7,8,136,303,439
04154000,TOLLES CAREER & TECHNICAL CENTER        ,OH,43064-8854,Public       ,0,0,0,12,25,37
04166800,SALON PROFESSIONAL ACADEMY (THE)        ,OH,45551-0000,Proprietary  ,0,3,3,58,87,145
04167700,ARTISAN COLLEGE OF COSMETOLOGY (THE)    ,OH,45840-6848,Proprietary  ,0,2,2,32,45,77
04185900,ELITE SCHOOL OF COSMETOLOGY             ,OH,44857-2714,Proprietary  ,0,3,3,22,71,93
04189100,TONI & GUY HAIRDRESSING ACADEMY         ,OH,43615-1731,Proprietary  ,3,6,9,111,169,280
04192200,ATHENA CAREER ACADEMY                   ,OH,43560-2796,Proprietary  ,5,16,21,49,380,429
04206700,ELITE WELDING ACADEMY                   ,OH,45246-1013,Proprietary  ,5,6,11,7,8,15
04220900,NATIONAL PERSONAL TRAINING INSTITUTE OF ,OH,43235-5739,Proprietary  ,1,5,6,34,136,170
04225700,LABARBERIA INSTITUTE OF HAIR            ,OH,44106-1923,Proprietary  ,3,9,12,11,51,62
        ,INVALID SCHOOL CODE                     ,  ,00000-0000,,58,342,400,1418,6440,7858
00134500,ADAMS STATE COLLEGE                     ,CO,81102-2373,Public       ,13,127,140,3149,2624,5773
00134600,ARAPAHOE COMMUNITY COLLEGE              ,CO,80160-9002,Public       ,48,238,286,3738,8150,11888
00134700,COLORADO COLLEGE                        ,CO,80903-3294,Private      ,4,27,31,3555,1166,4721
00134800,COLORADO SCHOOL OF MINES                ,CO,80401-1887,Public       ,12,14,26,7082,1598,8680
00134900,UNIVERSITY OF NORTHERN COLORADO         ,CO,80639-0001,Public       ,34,120,154,11634,5927,17561
00135000,COLORADO STATE UNIVERSITY               ,CO,80523-0100,Public       ,61,169,230,27686,12106,39792
00135200,DENVER  SEMINARY                        ,CO,80120-2192,Private      ,0,9,9,8,821,829
00135300,FORT LEWIS COLLEGE                      ,CO,81301-3999,Public       ,18,17,35,5274,1909,7183
00135400,ILIFF SCHOOL OF THEOLOGY                ,CO,80210-0000,Private      ,0,2,2,20,380,400
00135500,LAMAR COMMUNITY COLLEGE                 ,CO,81052-3999,Public       ,15,27,42,507,376,883
00135800,COLORADO MESA UNIVERSITY                ,CO,81501-3122,Public       ,24,66,90,8248,4691,12939
00135900,COLORADO NORTHWESTERN COMMUNITY COLLEGE ,CO,81648-3598,Public       ,8,23,31,468,542,1010
00136000,METROPOLITAN STATE UNIVERSITY OF DENVER ,CO,80204-3362,Public       ,116,324,440,13964,19889,33853
00136100,NORTHEASTERN JUNIOR COLLEGE             ,CO,80751-2399,Public       ,17,28,45,1318,601,1919
00136200,OTERO JUNIOR COLLEGE                    ,CO,81050-3346,Public       ,20,80,100,767,847,1614
00136300,REGIS UNIVERSITY                        ,CO,80221-1099,Private      ,5,134,139,3667,9732,13399
00136500,COLORADO STATE UNIVERSITY-PUEBLO        ,CO,81001-4901,Public       ,17,64,81,5732,3766,9498
00136800,TRINIDAD STATE JR COLLEGE               ,CO,81082-2396,Public       ,5,52,57,851,1337,2188
00137000,UNIVERSITY OF COLORADO-BOULDER          ,CO,80309-0077,Public       ,93,136,229,27869,10802,38671
00137100,UNIVERSITY OF DENVER                    ,CO,80208-2000,Private      ,23,248,271,11116,11346,22462
00137200,WESTERN STATE COLLEGE                   ,CO,81231-0000,Public       ,4,23,27,2480,716,3196
00405702,NATIONAL AMERICAN UNIVERSITY - COLORADO ,CO,80920-4001,Proprietary  ,0,10,10,55,562,617
00405703,NATIONAL AMERICAN UNIVERSITY            ,CO,80222-0000,Proprietary  ,0,8,8,35,401,436
00450300,EVEREST COLLEGE                         ,CO,80916-3548,Proprietary  ,5,65,70,236,1568,1804
00450600,COLORADO MOUNTAIN COLLEGE               ,CO,81602-0000,Public       ,17,70,87,1823,2353,4176
00450700,EVEREST COLLEGE                         ,CO,80229-4339,Proprietary  ,12,73,85,174,819,993
00450701,"EVEREST COLLEGE- EVEREST COLLEGE, AURORA",CO,80012-5692,Proprietary  ,15,44,59,226,886,1112
00450800,UNIVERSITY OF COLORADO DENVER           ,CO,80204-2029,Public       ,57,311,368,10604,17612,28216
00450900,UNIV OF COLORADO AT COLO SPRINGS        ,CO,80918-3735,Public       ,49,159,208,10376,7840,18216
00559600,EMILY GRIFFITH OPPORTUNITY SCH          ,CO,80204-2197,Public       ,15,53,68,780,2805,3585
00729700,REDSTONE COLLEGE                        ,CO,80020-9988,Proprietary  ,10,34,44,347,991,1338
00732912,ITT TECHNICAL INSTITUTE                 ,CO,80229-5338,Proprietary  ,17,116,133,342,1856,2198
00754800,WESTWOOD COLLEGE - DENVER NORTH         ,CO,80221-3653,Proprietary  ,4,61,65,303,1452,1755
00754801,WESTWOOD COLLEGE - DENVER SOUTH         ,CO,80227-3653,Proprietary  ,8,42,50,174,1018,1192
00757306,EMPIRE BEAUTY SCHOOL - THORNTON         ,CO,80241-1659,Proprietary  ,0,0,0,77,148,225
00758200,AIMS COMMUNITY COLLEGE                  ,CO,80632-0000,Public       ,25,88,113,2590,4445,7035
00764900,ROCKY MOUNTAIN COLG OF ART & DESIGN     ,CO,80214-0000,Proprietary  ,26,79,105,916,1119,2035
00793300,FRONT RANGE COMMUNITY COLLEGE           ,CO,80031-2199,Public       ,100,383,483,8555,15746,24301
00793806,LINCOLN COLLEGE OF TECHNOLOGY - DENVER  ,CO,80239-3006,Proprietary  ,73,116,189,1550,1425,2975
00863500,INTELLITEC MEDICAL INSTITUTE            ,CO,80909-0000,Proprietary  ,10,45,55,165,724,889
00887100,CONCORDE CAREER INSTITUTE               ,CO,80203-0000,Proprietary  ,34,75,109,587,2162,2749
00889600,PIKES PEAK COMMUNITY COLLEGE            ,CO,80906-5498,Public       ,114,629,743,5801,16025,21826
00940100,COLORADO CHRISTIAN UNIVERSITY           ,CO,80226-7449,Private      ,8,139,147,2265,5308,7573
00945914,EMPIRE BEAUTY SCHOOL - ARVADA           ,CO,80003-4434,Proprietary  ,0,0,0,69,156,225
00954200,COMMUNITY COLLEGE OF DENVER             ,CO,80217-2026,Public       ,84,360,444,6657,13704,20361
00954300,RED ROCKS COMMUNITY COLLEGE             ,CO,80228-1255,Public       ,44,237,281,3647,7542,11189
00966407,EMPIRE BEAUTY SCHOOL - LAKEWOOD         ,CO,80266-5107,Proprietary  ,0,0,0,37,104,141
00998100,MORGAN COMMUNITY COLLEGE                ,CO,80701-4399,Public       ,25,40,65,433,1109,1542
01014800,COLORADO TECHNICAL UNIVERSITY           ,CO,80907-3896,Proprietary  ,15,184,199,523,5831,6354
01014802,COLORADO TECHNICAL UNIV - DENVER        ,CO,80111-3201,Proprietary  ,3,57,60,158,1262,1420
01014805,COLORADO TECH UNIV - ON LINE            ,CO,80907-0000,Proprietary  ,192,2558,2750,2556,47585,50141
01014812,COLORADO TECHNICAL UNIVERSITY - WESTMINS,CO,80021-3498,Proprietary  ,0,28,28,113,885,998
01014815,COLORADO TECHNCL UNIV PUEBLO            ,CO,81003-2315,Proprietary  ,0,11,11,102,444,546
01157200,COLORADO SCHOOL OF TRADES               ,CO,80215-2996,Proprietary  ,1,10,11,103,502,605
01267000,BEL-REA INST OF ANIMAL TECH             ,CO,80247-3048,Proprietary  ,2,10,12,478,773,1251
01285000,INTERNATIONAL SALON AND SPA ACADEMY     ,CO,80918-3684,Proprietary  ,11,22,33,122,430,552
01287500,PICKENS TECHNICAL COLLEGE               ,CO,80011-9307,Public       ,6,15,21,448,1157,1605
01300700,NAZARENE BIBLE COLLEGE                  ,CO,80910-3717,Private      ,1,13,14,78,773,851
02078900,ART INSTITUTE OF COLORADO (THE)         ,CO,80203-2983,Proprietary  ,35,100,135,2231,2739,4970
02116300,PUEBLO COMMUNITY COLLEGE                ,CO,81004-0000,Public       ,48,225,273,2419,6847,9266
02117500,NAROPA UNIVERSITY                       ,CO,80302-0000,Private      ,0,10,10,404,1376,1780
02141100,EMPIRE BEAUTY SCHOOL-LITTLETON          ,CO,80030-0000,Proprietary  ,0,0,0,88,185,273
02156200,DELTA - MONTROSE TECHNICAL COLLEGE      ,CO,81416-0000,Public       ,4,12,16,106,331,437
02165200,SALON PROFESSIONAL ACADEMY (THE)        ,CO,81504-5309,Proprietary  ,0,2,2,82,135,217
02167600,KAPLAN COLLEGE                          ,CO,80229-5309,Proprietary  ,0,0,0,10,64,74
02211901,CHEEKS INTERNATIONAL ACADEMY OF BEAUTY C,CO,80525-3053,Proprietary  ,0,1,1,31,100,131
02211902,CHEEKS INTERNATIONAL ACDMY BTY CULT     ,CO,80631-0000,Proprietary  ,0,1,1,26,63,89
02253700,INTELLITEC COLLEGE                      ,CO,80909-0000,Proprietary  ,15,80,95,234,1155,1389
02267500,GLENWOOD BEAUTY ACADEMY                 ,CO,81601-0000,Proprietary  ,0,5,5,21,70,91
02276900,COMMUNITY COLLEGE OF AURORA             ,CO,80011-9036,Public       ,55,285,340,3392,8461,11853
02296004,PRINCE INSTITUTE - SOUTHEAST - PRINCE IN,CO,80031-2943,Proprietary  ,0,1,1,6,106,112
02518500,HAIR DYNAMICS EDUCATION CENTER          ,CO,80525-0000,Proprietary  ,5,6,11,118,229,347
02594300,COLLEGE AMERICA - DENVER                ,CO,80222-3380,Proprietary  ,31,158,189,493,2753,3246
02611000,HERITAGE COLLEGE                        ,CO,80212-7413,Proprietary  ,22,65,87,303,911,1214
03006300,INST OF BUSINESS & MEDICAL CAREERS      ,CO,80525-3044,Proprietary  ,29,116,145,489,1764,2253
03010622,VIRGINIA COLLEGE - ECOTECH INSTITUTE - A,CO,80014-1405,Proprietary  ,3,10,13,88,379,467
03012100,REMINGTON COLLEGE - COLORADO SPRINGS CAM,CO,80215-0000,Private      ,0,2,2,11,44,55
03013100,BOULDER COLLEGE OF MASSAGE THERAPY      ,CO,80301-3295,Private      ,0,0,0,57,135,192
03014900,PLATT COLLEGE                           ,CO,80014-3141,Proprietary  ,2,15,17,72,374,446
03027400,XENON INTERNATIONAL ACADEMY III         ,CO,80014-1193,Proprietary  ,3,9,12,76,164,240
03030606,UTAH COLLEGE OF MASSAGE THERAPY - DENVER,CO,80031-2921,Proprietary  ,5,10,15,68,203,271
03030607,UTAH COLLEGE OF MASSAGE THERAPY - DENVER,CO,80012-2523,Proprietary  ,5,12,17,120,254,374
03066900,INTELLITEC COLLEGE                      ,CO,81506-3994,Proprietary  ,13,49,62,250,892,1142
03068201,OHIO CENTER FOR BROADCASTING - COLORADO ,CO,80214-4129,Proprietary  ,3,2,5,56,202,258
03076401,BRYMAN SCHOOL OF ARIZONA (THE) - ANTHEM ,CO,80014-2622,Proprietary  ,0,1,1,85,205,290
03289300,COLORADO HEIGHTS UNIVERSITY             ,CO,80236-2711,Private      ,8,10,18,181,560,741
03306300,MONTESSORI EDUC CRT OF THE ROCKIES      ,CO,80301-2587,Private      ,0,3,3,6,72,78
03534300,JONES INTERNATIONAL UNIVERSITY          ,CO,80112-3446,Proprietary  ,11,446,457,212,6462,6674
03545300,UNIVERSITY OF THE ROCKIES               ,CO,80903-3612,Proprietary  ,2,171,173,115,3253,3368
03584400,COLORADO SCHOOL OF HEALING ARTS         ,CO,80226-4332,Proprietary  ,0,3,3,85,345,430
03670300,TONI & GUY HAIRDRESSING ACADEMY         ,CO,80911-0000,Proprietary  ,4,15,19,154,285,439
03686300,COLORADO SCHOOL OF TRADITIONAL CHINESE M,CO,80206-2127,Proprietary  ,0,3,3,19,291,310
03776300,AUGUSTE ESCOFFIER SCHOOL OF CULINARY ART,CO,80305-5961,Proprietary  ,8,29,37,338,484,822
03976300,MASSAGE THERAPY INSTITUTE OF COLORADO   ,CO,80206-2127,Proprietary  ,0,7,7,88,287,375
04080300,ASPEN UNIVERSITY                        ,CO,80246-1930,Proprietary  ,1,34,35,150,1030,1180
04093300,ACADEMY OF NATURAL THERAPY              ,CO,80631-3425,Proprietary  ,3,5,8,50,152,202
04121200,INSTITUTE OF TAOIST EDUCATION AND ACUPUN,CO,80027-1028,Private      ,0,1,1,2,63,65
04125100,MONTESSORI CASA INTERNATIONAL           ,CO,80111-5263,Private      ,0,1,1,1,12,13
04127700,AMERICAN SENTINEL UNIVERSITY            ,CO,80014-6510,Proprietary  ,0,74,74,30,1996,2026
04139300,NATIONAL BEAUTY COLLEGE                 ,CO,80221-0000,Proprietary  ,0,8,8,47,204,251
04148300,DENVER SCHOOL OF NURSING                ,CO,80202-1213,Proprietary  ,2,9,11,438,1528,1966
04151100,SUMMIT SALON & BEAUTY SCHOOL            ,CO,80866-4569,Proprietary  ,0,0,0,7,18,25
04167100,AVEDA INSTITUTE DENVER                  ,CO,80202-0000,Proprietary  ,9,14,23,392,619,1011
04170200,PAUL MITCHELL THE SCHOOL COLORADO SPRING,CO,80903-0000,Proprietary  ,3,22,25,198,429,627
04172500,ROLF INSTITUTE OF STRUCTURAL INTEGRATION,CO,80301-0000,Private      ,0,5,5,12,130,142
04173800,SALON PROFESSIONAL ACADEMY (THE)        ,CO,80918-2932,Proprietary  ,0,7,7,79,188,267
04177100,PIMA MEDICAL INSTITUTE-SOUTH DENVER     ,CO,80231-0000,Proprietary  ,5,33,38,324,892,1216
04179700,UNITED BEAUTY COLLEGE                   ,CO,80223-2936,Proprietary  ,6,22,28,62,171,233
04183700,HEALING ARTS INSTITUTE                  ,CO,80525-3479,Proprietary  ,0,2,2,53,177,230
04184900,COLLEGE OF INTERNATIONAL ESTHETICS      ,CO,80002-3754,Proprietary  ,1,7,8,33,210,243
04185000,COLORADO ACADEMY OF VETERINARY TECHNOLOG,CO,80906-4944,Proprietary  ,1,2,3,139,267,406
04185400,NATIONAL PERSONAL TRAINING INSTITUTE OF ,CO,80401-3304,Proprietary  ,4,16,20,34,175,209
04195300,LONGS PEAK ACADEMY                      ,CO,80501-6458,Proprietary  ,1,7,8,67,174,241
04202600,NEW DIMENSIONS BEAUTY ACADEMY           ,CO,80138-9801,Proprietary  ,2,1,3,29,74,103
04208700,COLORADO STATE UNIVERSITY - GLOBAL CAMPU,CO,80111-0000,Public       ,14,379,393,492,8279,8771
04218900,ROCKY VISTA UNIVERSITY COLLEGE OF OSTEOP,CO,80134-9498,Proprietary  ,0,0,0,4,620,624
04221400,PAUL MITCHELL THE SCHOOL DENVER         ,CO,80226-7395,Proprietary  ,4,3,7,61,78,139
00267811,BRYANT & STRATTON COLLEGE - VIRGINIA BEA,VA,23462-4417,Proprietary  ,10,135,145,858,4262,5120
00370200,AVERETT UNIVERSITY                      ,VA,24541-3692,Private      ,9,67,76,1789,1946,3735
00370300,BLUEFIELD COLLEGE                       ,VA,24605-1799,Private      ,1,23,24,933,780,1713
00370400,BRIDGEWATER COLLEGE                     ,VA,22812-1599,Private      ,3,2,5,3629,262,3891
00370500,COLLEGE OF WILLIAM & MARY               ,VA,23187-8795,Public       ,14,37,51,11616,4697,16313
00370600,CHRISTOPHER NEWPORT UNIVERSITY          ,VA,23606-3072,Public       ,9,16,25,8812,1653,10465
00370700,RICHARD BLAND COLLEGE                   ,VA,23805-7100,Public       ,8,18,26,1545,784,2329
00370800,EASTERN MENNONITE UNIVERSITY            ,VA,22802-2462,Private      ,2,5,7,1344,682,2026
00370900,EMORY & HENRY COLLEGE                   ,VA,24327-0010,Private      ,2,1,3,1583,185,1768
00371100,FERRUM COLLEGE                          ,VA,24088-2612,Private      ,6,1,7,3197,367,3564
00371200,TIDEWATER COMMUNITY COLLEGE             ,VA,23510-1910,Public       ,149,878,1027,12874,30543,43417
00371300,HAMPDEN-SYDNEY COLLEGE                  ,VA,23943-0128,Private      ,5,1,6,1626,75,1701
00371400,HAMPTON UNIVERSITY                      ,VA,23668-0099,Private      ,39,43,82,9204,4006,13210
00371500,HOLLINS UNIVERSITY                      ,VA,24020-0000,Private      ,4,13,17,815,693,1508
00371900,LONGWOOD UNIVERSITY                     ,VA,23909-1899,Public       ,9,15,24,6014,1087,7101
00372000,LYNCHBURG COLLEGE                       ,VA,24501-3199,Private      ,5,21,26,4020,1302,5322
00372100,JAMES MADISON UNIVERSITY                ,VA,22807-3780,Public       ,33,24,57,26487,3420,29907
00372300,MARY BALDWIN COLLEGE                    ,VA,24401-3610,Private      ,9,43,52,1824,1333,3157
00372400,MARYMOUNT UNIVERSITY                    ,VA,22207-4224,Private      ,12,30,42,3227,2815,6042
00372600,NATIONAL COLLEGE                        ,VA,24153-4524,Proprietary  ,18,131,149,617,5416,6033
00372700,NORTHERN VA CMTY CLG                    ,VA,22003-3743,Public       ,241,851,1092,19125,25885,45010
00372800,OLD DOMINION UNIVERSITY                 ,VA,23529-0052,Public       ,76,304,380,20900,17821,38721
00373200,RADFORD UNIVERSITY                      ,VA,24142-6905,Public       ,17,34,51,11643,3179,14822
00373300,RANDOLPH-MACON COLLEGE                  ,VA,23005-5505,Private      ,0,2,2,2785,210,2995
00373400,RANDOLPH COLLEGE                        ,VA,24503-1526,Private      ,4,2,6,1099,233,1332
00373500,VIRGINIA COMMONWEALTH UNIVERSITY        ,VA,23284-9004,Public       ,72,187,259,26977,16342,43319
00373600,ROANOKE COLLEGE                         ,VA,24153-3794,Private      ,8,5,13,3600,346,3946
00373700,SHENANDOAH UNIVERSITY                   ,VA,22601-5195,Private      ,7,28,35,3020,2518,5538
00373800,SOUTHERN VIRGINIA UNIVERSITY            ,VA,24416-3038,Private      ,2,3,5,1118,392,1510
00373900,ST PAULS COLLEGE                        ,VA,23868-1299,Private      ,0,0,0,114,123,237
00374200,SWEET BRIAR COLLEGE                     ,VA,24595-9998,Private      ,5,0,5,1084,118,1202
00374300,UNION PRESBYTERIAN SEMINARY             ,VA,23227-0000,Private      ,0,0,0,6,119,125
00374400,UNIVERSITY OF RICHMOND                  ,VA,23173-0001,Private      ,2,40,42,6857,3310,10167
00374500,UNIVERSITY OF VIRGINIA - SFS            ,VA,22903-0000,Public       ,29,52,81,22415,8999,31414
00374600,UNIVERSITY OF MARY WASHINGTON           ,VA,22401-5358,Public       ,11,26,37,5612,1708,7320
00374700,UNIV OF VIRGINIA'S COLLEGE AT WISE      ,VA,24293-4412,Public       ,2,8,10,2055,679,2734
00374800,EASTERN SHORE COMMUNITY COLLEGE         ,VA,23410-3001,Public       ,5,15,20,415,761,1176
00374900,GEORGE MASON UNIVERSITY                 ,VA,22030-4444,Public       ,63,165,228,24763,17550,42313
00375100,PATRICK HENRY COMMUNITY COLLEGE         ,VA,24112-5311,Public       ,21,85,106,1311,2524,3835
00375200,VIRGINIA INTERMONT COLLEGE              ,VA,24201-4298,Private      ,0,2,2,541,282,823
00375300,VIRGINIA MILITARY INSTITUTE             ,VA,24450-2138,Public       ,2,1,3,2448,144,2592
00375400,VIRGINIA POLYTECH INST & STATE UNIV     ,VA,24061-2000,Public       ,149,93,242,27492,6332,33824
00375800,DANVILLE COMMUNITY COLLEGE              ,VA,24541-4004,Public       ,33,94,127,1753,3155,4908
00375900,J. SARGEANT REYNOLDS COMMUNITY CLG      ,VA,23285-0000,Public       ,66,349,415,6286,13934,20220
00376000,VIRGINIA WESTERN CMTY COLLEGE           ,VA,24038-0000,Public       ,27,158,185,3493,5374,8867
00376100,WYTHEVILLE COMMUNITY COLLEGE            ,VA,24382-3308,Public       ,40,82,122,1374,2167,3541
00376200,VIRGINIA UNIVERSITY OF LYNCHBURG        ,VA,24501-6400,Private      ,56,20,76,507,784,1291
00376400,VIRGINIA STATE UNIVERSITY               ,VA,23806-0001,Public       ,26,49,75,10326,4187,14513
00376500,NORFOLK STATE UNIVERSITY                ,VA,23504-8000,Public       ,40,110,150,9659,8725,18384
00376600,VIRGINIA UNION UNIVERSITY               ,VA,23220-1711,Private      ,22,22,44,2960,1783,4743
00376700,VIRGINIA WESLEYAN COLLEGE               ,VA,23502-5599,Private      ,4,23,27,3419,1168,4587
00376800,WASHINGTON & LEE UNIVERSITY             ,VA,24450-0303,Private      ,3,0,3,3435,1140,4575
00400400,JOHN TYLER COMMUNITY COLLEGE            ,VA,23831-5316,Public       ,46,214,260,4556,7184,11740
00450301,EVEREST COLLEGE -  MCLEAN               ,VA,22182-2214,Proprietary  ,7,35,42,100,491,591
00450702,"EVEREST COLLEGE- EVEREST COLLEGE, ARLING",VA,22203-1905,Proprietary  ,0,0,0,42,159,201
00498800,CENTRAL VIRGINIA COMMUNITY COLLEGE      ,VA,24502-2498,Public       ,12,86,98,2021,2922,4943
00499200,MILLER-MOTTE TECHNICAL COLLEGE          ,VA,24505-0000,Proprietary  ,18,51,69,412,1594,2006
00499600,DABNEY S LANCASTER COMMUNITY CLG        ,VA,24422-1000,Public       ,5,28,33,616,713,1329
00522300,NEW RIVER COMMUNITY COLLEGE             ,VA,24084-1127,Public       ,6,36,42,1767,2786,4553
00662200,COLLEGE OF HEALTH SCIENCES - CHRV       ,VA,24031-0000,Private      ,3,12,15,686,1253,1939
00681900,BLUE RIDGE COMMUNITY COLLEGE            ,VA,24486-0080,Public       ,18,84,102,2392,3011,5403
00687100,THOMAS NELSON COMMUNITY COLLEGE         ,VA,23670-0000,Public       ,55,244,299,4931,11411,16342
00709900,VIRGINIA HIGHLANDS COMMUNITY CLG        ,VA,24210-4210,Public       ,6,30,36,1207,1896,3103
00726000,SOUTHWEST VIRGINIA COMMUNITY CLG        ,VA,24641-0000,Public       ,16,39,55,1250,1970,3220
00859200,LOUISE OBICI SCHOOL OF NURSING          ,VA,23434-8038,Private      ,0,0,0,4,23,27
00865900,LORD FAIRFAX COMMUNITY COLLEGE          ,VA,22645-0047,Public       ,53,121,174,2611,3821,6432
00866000,GERMANNA COMMUNITY COLLEGE              ,VA,22508-0339,Public       ,39,138,177,3311,4955,8266
00866100,SOUTHSIDE VIRGINIA CMTY CLG             ,VA,23821-2930,Public       ,58,197,255,1944,3557,5501
00915900,PAUL D CAMP COMMUNITY COLLEGE           ,VA,23851-0737,Public       ,17,53,70,584,1488,2072
00916000,RAPPAHANNOCK COMMUNITY COLLEGE          ,VA,23149-2616,Public       ,13,56,69,996,1769,2765
00926700,EVEREST COLLEGE                         ,VA,23606-4203,Proprietary  ,13,57,70,237,1257,1494
00926701,EVEREST COLLEGE - CHESAPEAKE            ,VA,23320-2637,Proprietary  ,23,115,138,317,1603,1920
00942000,SANFORD-BROWN COLLEGE                   ,VA,22182-3913,Proprietary  ,0,3,3,46,284,330
00953500,STAUNTON SCHOOL OF COSMETOLOGY          ,VA,24401-4323,Proprietary  ,0,3,3,28,83,111
00953700,VIRGINIA SCH OF HAIR DESIGN             ,VA,23669-0000,Proprietary  ,1,6,7,60,252,312
00962900,MOUNTAIN EMPIRE COMMUNITY COLLEGE       ,VA,24219-0700,Public       ,4,26,30,1199,1994,3193
00992800,PIEDMONT VIRGINIA COMMUNITY COLLEGE     ,VA,22902-7589,Public       ,37,114,151,2023,3481,5504
01004300,BON SECOURS MEMORIAL COLLEGE OF NURSING ,VA,23227-4612,Private      ,3,16,19,385,981,1366
01019800,ECPI UNIVERSITY                         ,VA,23462-6542,Proprietary  ,49,394,443,2725,12257,14982
01019802,ECPI UNIVERSITY - NEWPORT NEWS          ,VA,23606-4298,Proprietary  ,18,97,115,72,437,509
01019807,ECPI UNIVERSITY - MANASSAS              ,VA,20109-2665,Proprietary  ,16,54,70,62,256,318
01019813,ECPI UNIVERSITY - CULINARY INSTITUTE OF ,VA,23513-2448,Proprietary  ,4,24,28,27,118,145
01019814,ECPI UNIVERSITY - VIRGINIA BEACH HEALTH ,VA,23462-6540,Proprietary  ,2,19,21,33,177,210
01019815,ECPI UNIVERSITY - RICHMOND SOUTH        ,VA,23236-3659,Proprietary  ,9,41,50,53,242,295
01019816,ECPI UNIVERSITY - INNSBROOK             ,VA,23060-3359,Proprietary  ,6,30,36,32,98,130
01019817,ECPI UNIVERSITY - RICHMOND WEST         ,VA,23294-3730,Proprietary  ,2,22,24,29,152,181
01033800,EASTERN VIRGINIA MEDICAL SCHOOL         ,VA,23501-1980,Public       ,1,15,16,152,2019,2171
01159600,SYLVAIN MELLOUL INTERNATIONAL HAIR ACADE,VA,24502-2652,Proprietary  ,0,5,5,52,162,214
01162601,WESTWOOD COLLEGE - SOUTH BAY - ARLINGTON,VA,22203-4167,Proprietary  ,10,55,65,234,822,1056
01162602,WESTWOOD COLLEGE - SOUTH BAY - ANNANDALE,VA,22003-2602,Proprietary  ,7,29,36,155,654,809
01274400,SOUTHSIDE REGIONAL MED CTR PROF SCHOOLS ,VA,23803-5133,Proprietary  ,0,8,8,112,375,487
02053000,LIBERTY UNIVERSITY                      ,VA,24502-0000,Private      ,200,3845,4045,22123,96968,119091
02083602,TESST COLLEGE OF TECHNOLOGY - KAPLAN COL,VA,23320-4422,Proprietary  ,0,0,0,8,104,112
02108800,WARDS CORNER BEAUTY ACADEMY             ,VA,23505-0000,Proprietary  ,5,23,28,104,519,623
02111600,DANVILLE REGIONAL MEDICAL CENTER SCHOOL ,VA,24541-0000,Proprietary  ,1,2,3,49,129,178
02119203,COURT REPORTING INSTITUTE OF DALLAS - CO,VA,22203-4179,Proprietary  ,0,0,0,7,41,48
02128700,CENTRAL SCHOOL OF PRACTICAL NURSING     ,VA,23502-2230,Public       ,4,9,13,130,437,567
02140000,RIVERSIDE SCHOOL OF HEALTH CAREERS      ,VA,23608-3802,Private      ,5,17,22,241,856,1097
02149901,PAUL MITCHELL THE SCHOOL-JACKSONVILLE - ,VA,22102-0000,Proprietary  ,5,12,17,92,158,250
02149902,PAUL MITCHELL THE SCHOOL-JACKSONVILLE - ,VA,22192-0000,Proprietary  ,7,7,14,95,207,302
02175800,LYNCHBURG GENERAL HOSP SCH OF NURSG     ,VA,24501-0000,Private      ,1,4,5,143,379,522
02197600,WOODROW WILSON REHABILITATION CTR       ,VA,22939-0000,Public       ,1,1,2,66,52,118
02242400,HENRICO CTY ST MARYS HOSP PRAC NRSG     ,VA,23075-0000,Public       ,0,0,0,30,89,119
02320900,TIDEWATER TECH                          ,VA,23502-1747,Proprietary  ,20,91,111,392,1457,1849
02334400,CENTURA COLLEGE                         ,VA,23452-0000,Proprietary  ,17,131,148,510,3322,3832
02342700,FORTIS COLLEGE                          ,VA,23502-4101,Proprietary  ,23,41,64,267,1236,1503
02342701,FORTIS COLLEGE - RICHMOND CAMPUS        ,VA,23236-3472,Proprietary  ,7,54,61,314,1092,1406
02358500,BON SECOURS SAINT MARY'S HOSPITAL SCHOOL,VA,23227-4612,Private      ,1,7,8,133,468,601
02538800,SUFFOLK BEAUTY ACADEMY                  ,VA,23434-0000,Proprietary  ,1,7,8,37,141,178
02541200,STRATFORD UNIVERSITY                    ,VA,22043-0000,Proprietary  ,30,195,225,657,3063,3720
02541201,STRATFORD UNIVERSITY-WOODBRIDGE         ,VA,22192-0000,Proprietary  ,4,31,35,250,1230,1480
02588900,MEDTECH INSTITUTE                       ,VA,22042-3013,Proprietary  ,44,194,238,480,1926,2406
02610100,WASHINGTON COUNTY ADULT SKILL CTR       ,VA,24210-2346,Public       ,1,15,16,58,211,269
02617508,EVEREST COLLEGE - WOODBRIDGE            ,VA,22192-6808,Proprietary  ,15,77,92,38,258,296
03002400,GRAHAM WEBB INTERNATIONAL ACAD HAIR     ,VA,22209-2129,Proprietary  ,2,7,9,71,168,239
03010700,BAR PALMA BEAUTY CAREERS  ACADEMY       ,VA,24014-2255,Proprietary  ,3,7,10,39,204,243
03042800,"VIRGINIA BEACH CITY SCHOOLS, SCH.-PR.NSG",VA,23456-0038,Public       ,3,4,7,79,258,337
03091300,REGENT UNIVERSITY                       ,VA,23464-9800,Private      ,3,184,187,1917,7491,9408
03092700,SKYLINE COLLEGE                         ,VA,24012-1603,Proprietary  ,3,22,25,113,544,657
03096500,SPRINGFIELD BEAUTY ACADEMY              ,VA,22003-3016,Proprietary  ,0,8,8,13,132,145
03106500,SENTARA NORFOLK GENERAL HOSPITAL        ,VA,23320-2843,Private      ,2,15,17,198,911,1109
03116900,BAPTIST THEOLOGICAL SEM.-RICHMOND       ,VA,23227-0000,Private      ,0,3,3,10,183,193
03126300,AVIATION INSTITUTE OF MAINTENANCE       ,VA,23320-5987,Proprietary  ,9,43,52,131,588,719
03126400,CENTURA COLLEGE                         ,VA,23235-5230,Proprietary  ,5,44,49,219,1262,1481
03127500,ADVANCED TECHNOLOGY INSTITUTE           ,VA,23462-2409,Proprietary  ,18,49,67,621,1065,1686
03280400,VIRGINIA SCHOOL OF MASSAGE              ,VA,22903-0000,Proprietary  ,6,14,20,71,240,311
03409500,RICHMOND SCHOOL OF HEALTH AND TECH      ,VA,23227-0000,Proprietary  ,5,26,31,154,696,850
03455300,CRESCENT COSMETOLOGY UNIVERSITY         ,VA,23666-3115,Proprietary  ,1,1,2,19,88,107
03559300,APPALACHIAN SCHOOL OF LAW               ,VA,24614-0000,Private      ,0,0,0,13,446,459
03645400,RUDY & KELLY ACADEMY OF HAIR AND NA     ,VA,23464-6857,Proprietary  ,7,19,26,174,446,620
03654300,CAREER TRAINING SOLUTIONS               ,VA,22406-1014,Proprietary  ,3,18,21,178,900,1078
03709300,EDWARD VIA VIRGINIA CLG OSTEOPATHIC MED ,VA,24060-6360,Private      ,0,1,1,14,891,905
03862600,VIRGINIA BAPTIST COLLEGE                ,VA,22407-0000,Private      ,0,4,4,11,36,47
03872400,INSTITUTE FOR THE PSYCHOLOGICAL SCIENCES,VA,22202-3609,Private      ,0,2,2,22,176,198
03876300,CULPEPER COSMETOLOGY TRAINING CENTER    ,VA,22701-3155,Public       ,0,0,0,34,83,117
03883400,AVIATION INSTITUTE OF MAINTENANCE       ,VA,20110-4156,Proprietary  ,3,15,18,96,380,476
04038400,AVI CAREER INSTITUTE                    ,VA,22066-1839,Proprietary  ,0,5,5,10,125,135
04110300,UNIVERSITY OF MANAGEMENT AND TECHNOLOGY ,VA,22209-1609,Proprietary  ,0,49,49,29,597,626
04124000,DOMINION SCHOOL OF HAIR DESIGN          ,VA,23062-2221,Proprietary  ,0,0,0,23,62,85
04127300,COLUMBIA COLLEGE                        ,VA,22031-4413,Proprietary  ,6,142,148,86,813,899
04133400,CENTURA COLLEGE                         ,VA,22312-2670,Proprietary  ,0,0,0,107,516,623
04133800,SOUTHEAST CULINARY & HOSPITALITY COLLEGE,VA,24201-4159,Proprietary  ,0,0,0,29,36,65
04137300,CAYCE/REILLY SCHOOL OF MASSOTHERAPY     ,VA,23451-2061,Private      ,0,3,3,23,113,136
04140000,GLOBAL HEALTH NURSE TRAINING SERVICES   ,VA,22314-4585,Proprietary  ,3,32,35,60,725,785
04153800,BETHEL COLLEGE                          ,VA,23666-3122,Private      ,0,3,3,65,164,229
04156200,INSTITUTE OF ADVANCED MEDICAL ESTHETICS ,VA,23294-4701,Proprietary  ,0,2,2,30,165,195
04169400,NORTHERN VIRGINIA SCHOOL OF THERAPEUTIC ,VA,22046-4302,Proprietary  ,4,7,11,55,186,241
04171500,COSMOPOLITAN BEAUTY & TECH SCHOOL       ,VA,22003-3204,Proprietary  ,0,24,24,28,258,286
04179900,TOMORROW'S IMAGE BARBER ACADEMY OF VIRGI,VA,23602-5532,Proprietary  ,0,4,4,20,106,126
04180600,APPALACHIAN COLLEGE OF PHARMACY         ,VA,24631-9210,Private      ,0,1,1,18,318,336
04214700,LUCKES BEAUTY ACADEMY                   ,VA,23601-1303,Proprietary  ,1,7,8,1,7,8
04218600,VIRGINIA TECH CARILION SCHOOL OF MEDICIN,VA,24016-4950,Private      ,3,3,6,15,28,43
04219000,IGLOBAL UNIVERSITY                      ,VA,22003-2400,Proprietary  ,1,1,2,1,2,3
04220100,NATIONAL PERSONAL TRAINING INSTITUTE    ,VA,22182-2412,Proprietary  ,0,0,0,0,1,1
04220400,CHRYSM INSTITUTE OF ESTHETICS (THE)     ,VA,23462-3650,Proprietary  ,1,8,9,21,160,181
04221000,"STANDARD HEALTHCARE SERVICES, COLLEGE OF",VA,22046-4612,Proprietary  ,2,6,8,11,149,160
00107000,THUNDERBIRD SCHOOL OF GLOBAL MANAGEMENT ,AZ,85306-6000,Private      ,0,5,5,43,699,742
00107100,ARIZONA WESTERN COLLEGE                 ,AZ,85366-0000,Public       ,96,136,232,5262,5564,10826
00107200,COCHISE COLLEGE                         ,AZ,85607-6190,Public       ,21,97,118,1791,3259,5050
00107300,EASTERN ARIZONA COLLEGE                 ,AZ,85552-0769,Public       ,14,23,37,1716,1837,3553
00107400,GRAND CANYON UNIVERSITY                 ,AZ,85017-3030,Proprietary  ,264,5537,5801,14954,78018,92972
00107600,GLENDALE COMMUNITY COLLEGE              ,AZ,85302-3090,Public       ,135,500,635,12454,17397,29851
00107700,MESA COMMUNITY COLLEGE                  ,AZ,85202-4866,Public       ,154,503,657,12544,21564,34108
00107800,PHOENIX COLLEGE                         ,AZ,85013-4234,Public       ,82,436,518,7086,17876,24962
00107900,YAVAPAI COLLEGE                         ,AZ,86301-3297,Public       ,31,156,187,2280,5175,7455
00108100,ARIZONA STATE UNIV (ALL CAMPUSES)       ,AZ,85287-0412,Public       ,269,940,1209,60187,50765,110952
00108200,NORTHERN ARIZONA UNIVERSITY             ,AZ,86011-0001,Public       ,173,299,472,32990,16571,49561
00108300,UNIVERSITY OF ARIZONA                   ,AZ,85721-0066,Public       ,294,285,579,35445,18366,53811
00165701,MIDWESTERN UNIVERSITY                   ,AZ,85308-0000,Private      ,2,24,26,218,4314,4532
00446700,TUCSON COLLEGE                          ,AZ,85711-3781,Proprietary  ,20,37,57,375,1026,1401
00711300,ARIZONA CHRISTIAN UNIVERSITY            ,AZ,85032-7097,Private      ,11,14,25,1140,698,1838
00726600,PIMA COUNTY COMMUNITY COLLEGE           ,AZ,85709-1110,Public       ,119,360,479,11864,18912,30776
00728300,CENTRAL ARIZONA COLLEGE                 ,AZ,85228-9779,Public       ,53,150,203,3250,5716,8966
00732911,ITT TECHNICAL INSTITUTE                 ,AZ,85282-9272,Proprietary  ,38,212,250,767,3563,4330
00732990,ITT TECHNICAL INSTITUTE                 ,AZ,85704-5829,Proprietary  ,100,308,408,961,3275,4236
00822100,UNIVERSAL TECHNICAL INSTITUTE           ,AZ,85323-7946,Proprietary  ,183,259,442,9570,7960,17530
00824600,DINÉ COLLEGE                            ,AZ,86556-0126,Public       ,11,37,48,898,1525,2423
00830300,GATEWAY COMMUNITY COLLEGE               ,AZ,85034-1795,Public       ,82,344,426,3833,10522,14355
00830302,MARICOPA SKILL CENTER                   ,AZ,85034-0000,Public       ,12,46,58,468,1807,2275
00830400,SCOTTSDALE COMMUNITY COLLEGE            ,AZ,85250-0000,Public       ,54,177,231,4731,6403,11134
00886400,ARIZONA ACADEMY OF BEAUTY               ,AZ,85712-5021,Proprietary  ,1,6,7,103,213,316
00886500,ARTISTIC BEAUTY COLLEGES-TUCSON         ,AZ,85716-3999,Proprietary  ,0,0,0,107,187,294
00945915,EMPIRE BEAUTY SCHOOL - NW PHOENIX       ,AZ,85051-8499,Proprietary  ,0,0,0,123,319,442
01054207,EMPIRE BEAUTY SCHOOL - FLAGSTAFF        ,AZ,86004-5119,Proprietary  ,0,0,0,114,210,324
01084700,ARIZONA AUTOMOTIVE INSTITUTE            ,AZ,85301-3503,Proprietary  ,48,172,220,507,1472,1979
01085800,AVALON SCHOOL OF COSMETOLOGY            ,AZ,85210-4010,Proprietary  ,43,56,99,653,1041,1694
01168900,REFRIGERATION SCHOOL                    ,AZ,85034-0000,Proprietary  ,29,100,129,235,1209,1444
01180200,ARIZONA ACADEMY OF BEAUTY-NORTH         ,AZ,85705-2720,Proprietary  ,1,9,10,60,148,208
01186200,NORTHLAND PIONEER COLLEGE               ,AZ,86025-0610,Public       ,7,50,57,737,2076,2813
01186400,MOHAVE COMMUNITY COLLEGE                ,AZ,86409-1238,Public       ,38,112,150,1685,4918,6603
01218400,INTERNATIONAL ACAD OF HAIR DESIGN       ,AZ,85225-7198,Proprietary  ,9,20,29,132,307,439
01234300,ARTISTIC BEAUTY COLLEGES-PHOENIX        ,AZ,85304-0000,Proprietary  ,0,0,0,125,260,385
01293700,ARTISTIC BEAUTY COLLEGES - PARADISE VALL,AZ,85257-0000,Proprietary  ,0,0,0,77,219,296
02065300,PRESCOTT COLLEGE                        ,AZ,86301-0000,Private      ,4,17,21,642,1256,1898
02071200,KAPLAN COLLEGE                          ,AZ,85029-4349,Proprietary  ,2,48,50,193,1445,1638
02098800,UNIVERSITY OF PHOENIX                   ,AZ,85040-0000,Proprietary  ,1032,20972,22004,19657,378191,397848
02100500,UNIVERSAL TECHNICAL INSTITUTE           ,AZ,85027-0000,Proprietary  ,90,239,329,6542,9567,16109
02100600,CARRINGTON COLLEGE                      ,AZ,85015-4096,Proprietary  ,65,228,293,2012,6022,8034
02113800,ROBERTO-VENN SCH OF LUTHIERY            ,AZ,85040-0000,Proprietary  ,1,1,2,33,75,108
02146600,SOUTH MOUNTAIN COMMUNITY COLLEGE        ,AZ,85040-0000,Public       ,31,157,188,2966,6454,9420
02160305,COLLINS COLLEGE                         ,AZ,85040-4000,Proprietary  ,1,8,9,267,617,884
02160306,INTERNATIONAL ACADEMY OF DESIGN AND TECH,AZ,85281-6705,Proprietary  ,0,3,3,42,100,142
02171500,WESTERN INTERNATIONAL UNIVERSITY        ,AZ,85021-0000,Proprietary  ,5,73,78,85,1920,2005
02177500,RIO SALADO COMMUNITY COLLEGE            ,AZ,85281-6948,Public       ,76,781,857,3409,21153,24562
02199900,AMERICAN INDIAN CLG-ASSEMBLIES GOD      ,AZ,85021-0000,Private      ,0,3,3,56,164,220
02217100,PIMA MEDICAL INSTITUTE                  ,AZ,85716-0000,Proprietary  ,237,577,814,3829,10906,14735
02218800,BROOKLINE COLLEGE                       ,AZ,85021-5815,Proprietary  ,40,199,239,489,2555,3044
02218804,BROOKLINE COLLEGE - MESA                ,AZ,85204-4448,Proprietary  ,18,60,78,247,955,1202
02218805,BROOKLINE COLLEGE - TUCSON              ,AZ,85711-5444,Proprietary  ,27,101,128,349,1217,1566
02263100,ANTHEM COLLEGE                          ,AZ,85014-0000,Proprietary  ,46,157,203,830,4191,5021
02280500,CHARLES OF ITALY BEAUTY COLLEGE         ,AZ,86403-0000,Proprietary  ,3,8,11,66,135,201
02295000,EVEREST COLLEGE                         ,AZ,85021-1610,Proprietary  ,146,1303,1449,1213,8600,9813
02295002,EVEREST COLLEGE - MESA                  ,AZ,85206-4704,Proprietary  ,7,66,73,308,1512,1820
02317800,AMERICAN INSTITUTE OF TECHNOLOGY        ,AZ,85043-0000,Proprietary  ,11,132,143,228,1444,1672
02491500,THE ART CENTER DESIGN COLLEGE           ,AZ,85716-0000,Proprietary  ,2,3,5,231,468,699
02533200,FRANK LLOYD WRIGHT SCHOOL OF ARCHITECTUR,AZ,85261-4430,Private      ,1,1,2,36,87,123
02559000,UNIVERSITY OF ADVANCING TECHNOLOGY      ,AZ,85283-0000,Proprietary  ,11,34,45,1214,1047,2261
02561900,BRILLARE HAIRDRESSING ACADEMY           ,AZ,85254-3301,Proprietary  ,5,5,10,143,207,350
02582700,CORTIVA INSTITUTE - TUCSON              ,AZ,85710-3503,Proprietary  ,8,33,41,144,370,514
02616700,LE CORDON BLEU COLLEGE OF CULINARY ARTS ,AZ,85251-2729,Proprietary  ,33,159,192,1195,4262,5457
02623600,PARADISE VALLEY COMMUNITY COLLEGE       ,AZ,85032-1210,Public       ,50,165,215,4241,6474,10715
02623800,CORTIVA INSTITUTE - SCOTTSDALE          ,AZ,85257-4218,Proprietary  ,2,7,9,37,168,205
03005000,SAFFORD COLLEGE OF BEAUTY CULTURE       ,AZ,85546-3309,Proprietary  ,0,5,5,8,46,54
03010613,VIRGINIA COLLEGE - GOLF ACADEMY OF ARIZO,AZ,85225-6742,Proprietary  ,1,3,4,38,101,139
03030604,UTAH COLLEGE OF MASSAGE THERAPY - ARIZON,AZ,85282-0000,Proprietary  ,8,23,31,130,350,480
03030605,UTAH COLLEGE OF MASSAGE THERAPY - ARIZON,AZ,85051-3470,Proprietary  ,5,13,18,218,478,696
03034400,CONSERVATORY RECORDING ARTS & SCIS      ,AZ,85282-1707,Proprietary  ,18,24,42,816,874,1690
03072200,CHANDLER-GILBERT COMMUNITY COLLEGE      ,AZ,85225-2499,Public       ,68,198,266,6501,8087,14588
03076400,BRYMAN SCHOOL OF ARIZONA                ,AZ,85029-4919,Proprietary  ,13,61,74,396,1339,1735
03097800,CARSTEN INSTITUTE OF HAIR & BEAUTY      ,AZ,85282-5404,Proprietary  ,8,11,19,123,282,405
03100400,COCONINO COUNTY COMMUNITY COLLEGE       ,AZ,86001-0000,Public       ,13,45,58,2050,2779,4829
03107000,SOUTHWEST CLG OF NATUROPATHIC MED       ,AZ,85282-0000,Private      ,0,6,6,28,682,710
03115000,ARIZONA COLLEGE OF ALLIED HEALTH        ,AZ,85302-3843,Proprietary  ,49,169,218,517,1807,2324
03120300,COLLEGE AMERICA                         ,AZ,86004-3936,Proprietary  ,62,172,234,433,1799,2232
03156300,ESTRELLA MOUNTAIN COMMUNITY COLLEGE     ,AZ,85392-1010,Public       ,78,394,472,5447,9353,14800
03347300,INTERNATIONAL BAPTIST COLLEGE           ,AZ,85282-6799,Private      ,0,2,2,45,35,80
03445300,HDS TRUCK DRIVING INSTITUTE             ,AZ,85731-0000,Proprietary  ,3,20,23,35,326,361
03478400,PHOENIX SEMINARY                        ,AZ,85018-7611,Private      ,1,4,5,6,210,216
03572300,EAST VALLEY INSTITUTE OF TECHNOLOGY     ,AZ,85201-6910,Public       ,53,25,78,547,1154,1701
03593300,SOUTHWEST INSTITUTE OF HEALING ARTS     ,AZ,85281-3658,Proprietary  ,2,56,58,210,2110,2320
03617500,PHOENIX INSTITUTE OF HERBAL MEDICINE & A,AZ,85012-0000,Proprietary  ,0,11,11,71,514,585
03695500,ARIZONA SCHOOL OF ACUPUNCTURE AND ORIENT,AZ,85712-1100,Proprietary  ,0,7,7,22,149,171
03784400,TOHONO O'ODHAM COMMUNITY COLLEGE        ,AZ,85634-3129,Public       ,2,11,13,101,159,260
03813300,NORTHCENTRAL UNIVERSITY                 ,AZ,86314-2336,Proprietary  ,3,752,755,101,9688,9789
03814300,TURNING POINT BEAUTY COLLEGE            ,AZ,85222-4229,Proprietary  ,4,7,11,33,115,148
04051300,ART INSTITUTE OF PHOENIX (THE)          ,AZ,85021-2859,Proprietary  ,328,1458,1786,8970,27784,36754
04051306,ART INSTITUTE OF PHOENIX (THE) - ART INS,AZ,85712-2732,Proprietary  ,7,31,38,589,697,1286
04051325,ART INSTITUTE OF PHOENIX (THE) - BROWN M,AZ,85712-5300,Proprietary  ,10,64,74,294,1175,1469
04051327,ART INSTITUTE OF PHOENIX (THE) - BROWN M,AZ,85029-1348,Proprietary  ,2,12,14,206,476,682
04059300,TUCSON COLLEGE OF BEAUTY                ,AZ,85705-2451,Proprietary  ,6,16,22,91,223,314
04120900,ARIZONA CULINARY INSTITUTE              ,AZ,85259-4939,Proprietary  ,4,11,15,290,438,728
04131400,ARIZONA SUMMIT LAW SCHOOL               ,AZ,85004-4418,Proprietary  ,3,22,25,107,1713,1820
04139200,UNIVERSAL BARBER COLLEGE                ,AZ,85007-3914,Proprietary  ,0,0,0,89,335,424
04148700,AMERICAN INSTITUTE OF INTERIOR DESIGN   ,AZ,85268-3827,Proprietary  ,2,3,5,38,98,136
04152900,STUDIO ACADEMY OF BEAUTY (THE)          ,AZ,85224-3600,Proprietary  ,14,47,61,151,380,531
04157400,NATIONAL PARALEGAL COLLEGE              ,AZ,85014-1262,Proprietary  ,6,87,93,98,2074,2172
04172100,CCIC BEAUTY COLLEGE                     ,AZ,85345-2410,Proprietary  ,0,0,0,7,21,28
04174100,PAUL MITCHELL THE SCHOOL PHOENIX        ,AZ,85017-1919,Proprietary  ,13,14,27,229,460,689
04174200,ALL BEAUTY COLLEGE                      ,AZ,86426-8326,Proprietary  ,2,10,12,49,178,227
04175300,PENROSE ACADEMY                         ,AZ,85254-4065,Proprietary  ,4,7,11,115,184,299
04177500,PURE AESTHETICS                         ,AZ,85711-2328,Proprietary  ,0,3,3,29,123,152
04191200,CLASSIC COOKING ACADEMY                 ,AZ,85255-8699,Private      ,0,0,0,51,77,128
04194500,AVEDA INSTITUTE TUCSON                  ,AZ,85719-4876,Proprietary  ,3,9,12,213,324,537
04217600,SESSIONS COLLEGE FOR PROFESSIONAL DESIGN,AZ,85281-2840,Proprietary  ,1,4,5,28,174,202
04233100,ARIZONA SCHOOL OF INTEGRATIVE STUDIES   ,AZ,86324-3106,Proprietary  ,1,9,10,1,12,13
04233101,ARIZONA SCHOOL OF INTEGRATIVE STUDIES - ,AZ,86001-5510,Proprietary  ,1,3,4,1,4,5
04233102,ARIZONA SCHOOL OF INTEGRATIVE STUDIES - ,AZ,86303-4711,Proprietary  ,1,3,4,1,4,5
04233103,ARIZONA SCHOOL OF INTEGRATIVE STUDIES - ,AZ,85705-8330,Proprietary  ,1,17,18,1,17,18
00142800,DELAWARE STATE UNIVERSITY               ,DE,19901-2277,Public       ,36,36,72,8752,2974,11726
00142900,GOLDEY BEACOM COLLEGE                   ,DE,19808-1993,Private      ,5,15,20,669,636,1305
00143100,UNIVERSITY OF DELAWARE                  ,DE,19716-0099,Public       ,39,52,91,27488,3767,31255
00143300,WESLEY COLLEGE                          ,DE,19901-3875,Private      ,9,16,25,2662,841,3503
00143301,WESLEY COLLEGE-CTR FOR ADULT STUDIE     ,DE,19720-0000,Private      ,0,0,0,32,229,261
00331301,WIDENER UNIV SCHOOL OF LAW - DE         ,DE,19803-0000,Private      ,0,9,9,99,1356,1455
00705300,DELAWARE TECH & CMTY COLLEGE-OWENS      ,DE,19947-0000,Public       ,42,100,142,2837,3875,6712
00794800,WILMINGTON UNIVERSITY                   ,DE,19720-6491,Private      ,43,319,362,3334,11475,14809
01172700,DELAWARE TECH & CMTY CLG-TERRY          ,DE,19901-8736,Public       ,24,91,115,2348,3315,5663
02125200,BEEBE SCHOOL OF NURSING                 ,DE,19958-1462,Private      ,2,1,3,67,128,195
02144900,DELAWARE TECH & CMTY CLG-STANTN/WLM     ,DE,19801-0000,Public       ,36,138,174,4445,5944,10389
02190400,SCHILLING DOUGLAS SCH OF HAIR DSGN      ,DE,19711-0000,Proprietary  ,6,4,10,126,161,287
02586902,STAR TECHNICAL INSTITUTE -              ,DE,19901-4615,Proprietary  ,0,4,4,32,120,152
03025800,DAWN TRAINING CENTRE                    ,DE,19805-1511,Proprietary  ,2,52,54,150,1046,1196
03543300,HARRIS SCHOOL OF BUSINESS               ,DE,19803-5341,Proprietary  ,10,54,64,190,690,880
03702300,DELAWARE LEARNING INSTITUTE OF COSMETOLO,DE,19939-9759,Proprietary  ,0,2,2,48,91,139
04130700,ACADEMY OF MASSAGE AND BODYWORK         ,DE,19701-1321,Proprietary  ,3,10,13,28,119,147
04139800,DELAWARE COLLEGE OF ART & DESIGN        ,DE,19801-3007,Private      ,2,2,4,483,168,651
04171100,DELAWARE ACADEMY PAUL MITCHELL PARTNER S,DE,19702-5108,Proprietary  ,5,12,17,117,171,288
        ,FEDERAL STUDENT AID USE ONLY            ,DC,20202-0000,,0,0,0,3,4,7
        ,OFFICIAL USE ONLY                       ,DC,20202-0000,,0,0,0,0,2,2
00143400,AMERICAN UNIVERSITY                     ,DC,20016-8020,Private      ,12,67,79,15039,10578,25617
00143700,CATHOLIC UNIVERSITY OF AMERICA          ,DC,20064-0002,Private      ,6,51,57,5973,2866,8839
00143711,"CATHOLIC UNIV AMERICA, LAW SCHOOL       ",DC,20064-0000,Private      ,0,1,1,80,1249,1329
00144100,UNIV OF THE DISTRICT OF COLUMBIA        ,DC,20008-0000,Public       ,22,135,157,3419,8144,11563
00144102,UNIV OF THE DIST OF COLU -SCHOOL OF LAW ,DC,20008-1173,Public       ,1,11,12,73,955,1028
00144300,GALLAUDET UNIVERSITY                    ,DC,20002-3695,Private      ,5,13,18,1070,1358,2428
00144400,GEORGE WASHINGTON UNIVERSITY            ,DC,20052-2353,Private      ,15,227,242,15123,12781,27904
00144402,GEORGE WASHINGTON UNIV LAW SCHL         ,DC,20052-0000,Private      ,1,10,11,109,4150,4259
00144403,GEORGE WASHINGTON UNIV SCH MED          ,DC,20052-0000,Private      ,1,21,22,129,1891,2020
00144500,GEORGETOWN UNIVERSITY                   ,DC,20057-1252,Private      ,11,65,76,13715,5793,19508
00144501,"GEORGETOWN UNIV, SCH OF MEDICINE        ",DC,20007-0000,Private      ,0,7,7,117,1508,1625
00144502,GEORGETOWN UNIVERSITY - GRADUATE SCHOOL ,DC,20057-0004,Private      ,0,57,57,68,5178,5246
00144503,GEORGETOWN UNIV LAW CENTER              ,DC,20001-0000,Private      ,0,4,4,79,4904,4983
00144800,HOWARD UNIVERSITY                       ,DC,20059-0001,Private      ,37,66,103,16217,10327,26544
00145900,STRAYER UNIVERSITY                      ,DC,20005-2603,Proprietary  ,54,947,1001,2271,56001,58272
00146000,TRINITY UNIVERSITY                      ,DC,20017-1004,Private      ,7,51,58,1620,3407,5027
00146400,WESLEY THEOLOGICAL SEMINARY             ,DC,20016-0000,Private      ,0,5,5,7,384,391
00207701,JOHNS HOPKINS UNIV SCH ADV INTL STU     ,DC,20036-0000,Private      ,1,6,7,83,1602,1685
01006500,WASHINGTON THEOLOGICAL UNION            ,DC,20012-0000,Private      ,0,0,0,9,46,55
01195000,THE CORCORAN COLLEGE OF ART & DESIG     ,DC,20006-4804,Private      ,2,3,5,366,448,814
01280300,DOMINICAN HOUSE OF STUDIES              ,DC,20017-1584,Private      ,0,1,1,4,48,52
02132800,NAT'L CONSERVATORY DRAMATIC ARTS        ,DC,20007-2758,Private      ,0,2,2,33,72,105
03104300,CAREER BLAZERS LEARNING CENTER OF WASHIN,DC,20037-1881,Proprietary  ,10,84,94,117,1171,1288
03218300,POTOMAC COLLEGE                         ,DC,20016-1860,Proprietary  ,2,21,23,89,692,781
03409600,BENNETT CAREER INSTITUTE                ,DC,20017-1754,Proprietary  ,7,37,44,166,546,712
03750300,TECHNICAL LEARNING CENTERS              ,DC,20006-3749,Proprietary  ,10,52,62,152,760,912
04114400,INSTITUTE OF WORLD POLITICS (THE)       ,DC,20036-1464,Private      ,0,1,1,16,232,248
04142700,PONTIFICAL JOHN PAUL II INSTITUTE FOR ST,DC,20064-0001,Private      ,0,0,0,2,38,40
04190000,RADIANS COLLEGE                         ,DC,20005-3542,Proprietary  ,6,30,36,85,855,940
04202500,GRADUATE SCHOOL                         ,DC,20024-2520,Private      ,0,13,13,0,24,24
00154100,ABRAHAM BALDWIN AGRICULTURAL CLG        ,GA,31794-0000,Public       ,42,51,93,3597,2281,5878
00154200,AGNES SCOTT COLLEGE                     ,GA,30030-3770,Private      ,3,12,15,1569,627,2196
00154300,DARTON COLLEGE                          ,GA,31707-3098,Public       ,70,231,301,4706,8338,13044
00154400,ALBANY STATE UNIVERSITY                 ,GA,31705-2796,Public       ,60,133,193,7537,6308,13845
00154500,ANDREW COLLEGE                          ,GA,39840-1395,Private      ,1,6,7,535,122,657
00154600,ARMSTRONG ATLANTIC STATE UNIVERSITY     ,GA,31419-1997,Public       ,85,153,238,7411,7401,14812
00154700,POINT UNIVERSITY                        ,GA,30344-1999,Private      ,9,15,24,1061,1520,2581
00155200,AUGUSTA STATE UNIVERSITY                ,GA,30904-2200,Public       ,0,0,0,5779,5890,11669
00155400,BERRY COLLEGE                           ,GA,30149-5007,Private      ,11,9,20,4336,461,4797
00155500,THOMAS UNIVERSITY                       ,GA,31792-7499,Private      ,5,46,51,563,1580,2143
00155600,BRENAU UNIVERSITY                       ,GA,30501-3668,Private      ,10,135,145,1996,4261,6257
00155700,BREWTON PARKER COLLEGE                  ,GA,30445-0000,Private      ,26,5,31,668,290,958
00155800,COLLEGE OF COASTAL GEORGIA              ,GA,31520-3644,Public       ,35,41,76,2569,3269,5838
00155900,CLARK ATLANTA UNIVERSITY                ,GA,30314-4385,Private      ,49,85,134,11820,6989,18809
00156000,COLUMBIA THEOLOGICAL SEMINARY           ,GA,30031-0000,Private      ,0,1,1,13,261,274
00156100,COLUMBUS STATE UNIVERSITY               ,GA,31907-5645,Public       ,70,219,289,7816,8086,15902
00156200,GEORGIA PERIMETER COLLEGE               ,GA,30021-0000,Public       ,229,573,802,18332,26412,44744
00156300,EMMANUEL COLLEGE                        ,GA,30639-0000,Private      ,8,1,9,917,209,1126
00156400,EMORY UNIVERSITY                        ,GA,30322-1960,Private      ,27,109,136,14071,11537,25608
00156600,FORT VALLEY STATE UNIVERSITY            ,GA,31030-3298,Public       ,30,58,88,5007,3302,8309
00156700,GAINESVILLE STATE COLLEGE               ,GA,30503-0000,Public       ,0,0,0,6116,3678,9794
00156800,INTERDENOMINATIONAL THEOLOGY CENTER     ,GA,30314-0000,Private      ,0,2,2,12,651,663
00156900,GEORGIA INSTITUTE OF TECHNOLOGY         ,GA,30332-0325,Public       ,192,110,302,22089,7414,29503
00157000,SOUTHERN POLYTECHNIC STATE UNIV         ,GA,30060-2896,Public       ,30,72,102,5775,5558,11333
00157100,GEORGIA MILITARY COLLEGE                ,GA,31061-3398,Public       ,173,274,447,6271,8202,14473
00157200,GEORGIA SOUTHERN UNIVERSITY             ,GA,30460-8065,Public       ,429,238,667,26462,9729,36191
00157300,GEORGIA SOUTHWESTERN STATE UNIV         ,GA,31709-4693,Public       ,19,72,91,3127,2723,5850
00157400,GEORGIA STATE UNIVERSITY                ,GA,30303-3010,Public       ,320,511,831,36733,33425,70158
00157500,GORDON COLLEGE                          ,GA,30204-1762,Public       ,64,56,120,5051,3424,8475
00157700,KENNESAW STATE UNIVERSITY               ,GA,30144-5591,Public       ,181,404,585,25527,18502,44029
00157800,LAGRANGE COLLEGE                        ,GA,30240-2999,Private      ,13,52,65,1701,732,2433
00157900,GEORGIA REGENTS UNIVERSITY              ,GA,30912-0004,Public       ,31,103,134,1428,4116,5544
00158000,MERCER UNIVERSITY                       ,GA,31207-0003,Private      ,39,174,213,6115,10204,16319
00158100,MIDDLE GEORGIA STATE COLLEGE            ,GA,31014-1599,Public       ,79,182,261,3961,3408,7369
00158103,MIDDLE GEORGIA STATE COLLEGE - MACON CAM,GA,31206-5145,Public       ,0,0,0,4452,5880,10332
00158200,MOREHOUSE COLLEGE                       ,GA,30314-3773,Private      ,34,24,58,5002,1703,6705
00158500,UNIVERSITY OF NORTH GEORGIA             ,GA,30597-0001,Public       ,200,141,341,10899,4834,15733
00158600,OGLETHORPE UNIVERSITY                   ,GA,30319-2737,Private      ,6,9,15,2343,869,3212
00158700,PAINE COLLEGE                           ,GA,30901-3182,Private      ,20,22,42,1520,1091,2611
00158800,PIEDMONT COLLEGE                        ,GA,30535-5644,Private      ,11,128,139,1351,2224,3575
00158900,REINHARDT UNIVERSITY                    ,GA,30183-2981,Private      ,9,13,22,1765,743,2508
00159000,SAVANNAH STATE UNIVERSITY               ,GA,31404-5298,Public       ,93,83,176,9264,4754,14018
00159100,SHORTER UNIVERSITY                      ,GA,30165-4298,Private      ,11,43,54,2220,3060,5280
00159200,SOUTH GEORGIA STATE COLLEGE             ,GA,31533-8104,Public       ,48,36,84,2296,1707,4003
00159203,SOUTH GEORGIA STATE COLLEGE - WAYCROSS C,GA,31503-0110,Public       ,10,6,16,735,812,1547
00159400,SPELMAN COLLEGE                         ,GA,30314-4399,Private      ,17,28,45,7105,2164,9269
00159600,TOCCOA FALLS COLLEGE                    ,GA,30598-0001,Private      ,1,8,9,996,322,1318
00159700,TRUETT MCCONNELL COLLEGE                ,GA,30528-1264,Private      ,0,4,4,880,289,1169
00159800,UNIVERSITY OF GEORGIA                   ,GA,30602-6114,Public       ,213,213,426,35286,13624,48910
00159900,VALDOSTA STATE UNIVERSITY               ,GA,31698-0001,Public       ,130,196,326,14683,8094,22777
00160000,WESLEYAN COLLEGE                        ,GA,31210-4407,Private      ,3,31,34,631,852,1483
00160100,UNIV OF WEST GEORGIA                    ,GA,30118-0002,Public       ,187,210,397,14842,8129,22971
00160200,GEORGIA COLLEGE & STATE UNIVERSITY      ,GA,31061-0490,Public       ,103,97,200,8677,2980,11657
00160400,YOUNG HARRIS COLLEGE                    ,GA,30582-4137,Private      ,28,2,30,1715,207,1922
00348400,COVENANT COLLEGE                        ,GA,30750-4164,Private      ,2,3,5,1453,196,1649
00395600,DALTON STATE COLLEGE                    ,GA,30720-3797,Public       ,27,85,112,4637,4047,8684
00402400,GEORGIA NORTHWESTERN TECHNICAL COLLEGE  ,GA,30161-6757,Public       ,69,301,370,3321,7941,11262
00411700,GRADY HEALTH SYSTEM                     ,GA,30303-3050,Public       ,2,20,22,205,1177,1382
00489808,MCCANN SCHOOL OF BUSINESS & TECHNOLOGY -,GA,31210-0246,Proprietary  ,0,1,1,37,175,212
00525400,LANIER TECHNICAL COLLEGE                ,GA,30566-3499,Public       ,53,180,233,2109,4973,7082
00525500,MOULTRIE TECHNICAL COLLEGE              ,GA,31768-0000,Public       ,29,152,181,771,2565,3336
00525600,WIREGRASS GEORGIA TECHNICAL COLLEGE     ,GA,31602-0929,Public       ,76,274,350,2237,6355,8592
00551100,OKEFENOKEE TECHNICAL COLLEGE            ,GA,31501-4016,Public       ,46,72,118,676,1757,2433
00559900,AUGUSTA TECHNICAL COLLEGE               ,GA,30906-3399,Public       ,81,253,334,2956,8037,10993
00560000,ATHENS TECHNICAL COLLEGE                ,GA,30601-1579,Public       ,66,214,280,3359,6304,9663
00560100,ALBANY TECHNICAL COLLEGE                ,GA,31701-2648,Public       ,93,315,408,2121,7429,9550
00561500,SOUTHWEST GEORGIA TECHNICAL COLLEGE     ,GA,31792-2622,Public       ,36,86,122,1235,2461,3696
00561700,SOUTH GEORGIA TECHNICAL COLLEGE         ,GA,31709-8167,Public       ,46,113,159,1168,2194,3362
00561800,SAVANNAH TECHNICAL COLLEGE              ,GA,31405-5594,Public       ,72,355,427,3225,10388,13613
00561900,NORTH GEORGIA TECHNICAL COLLEGE         ,GA,30523-0000,Public       ,33,102,135,1907,3025,4932
00562000,CHATTAHOOCHEE TECHNICAL COLLEGE         ,GA,30060-3398,Public       ,191,639,830,7538,14784,22322
00562100,SOUTHERN CRESCENT TECHNICAL COLLEGE     ,GA,30223-2097,Public       ,73,312,385,2882,8124,11006
00562200,DEKALB TECHNICAL COLLEGE                ,GA,30021-0000,Public       ,61,268,329,2127,8873,11000
00562400,COLUMBUS TECHNICAL COLLEGE              ,GA,31904-6572,Public       ,57,229,286,2606,6811,9417
00576300,CENTRAL GEORGIA TECHNICAL COLLEGE       ,GA,31206-3628,Public       ,168,610,778,2903,9750,12653
00576304,CENTRAL GEORGIA TECHNICAL COLLEGE -     ,GA,31088-2729,Public       ,0,0,0,1198,2903,4101
00854300,ATLANTA TECHNICAL COLLEGE               ,GA,30310-4499,Public       ,88,423,511,3797,15594,19391
00897600,CLAYTON STATE UNIVERSITY                ,GA,30260-0285,Public       ,52,197,249,7265,12308,19573
00927000,ART INSTITUTE OF ATLANTA (THE)          ,GA,30328-1649,Proprietary  ,98,197,295,9359,8725,18084
00950700,GEORGIA HIGHLANDS COLLEGE               ,GA,30162-0000,Public       ,70,106,176,5611,5051,10662
01031903,MEDIX SCHOOL                            ,GA,30080-7630,Proprietary  ,17,64,81,222,935,1157
01035601,EVEREST INSTITUTE - DEKALB              ,GA,30035-3420,Proprietary  ,0,0,0,106,473,579
01048700,WEST GEORGIA TECHNICAL COLLEGE          ,GA,30182-6476,Public       ,104,317,421,4511,9356,13867
01054212,EMPIRE BEAUTY SCHOOL - DUNWOODY         ,GA,30338-3020,Proprietary  ,0,0,0,107,253,360
01077100,GUPTON JONES COLLEGE                    ,GA,30035-4022,Private      ,0,10,10,155,427,582
01099700,EAST GEORGIA COLLEGE                    ,GA,30401-2699,Public       ,68,43,111,3688,1800,5488
01107400,BAINBRIDGE COLLEGE                      ,GA,39819-8400,Public       ,86,143,229,1415,3923,5338
01110901,EVEREST COLLEGE - EVEREST INSTITUTE     ,GA,30067-8340,Proprietary  ,10,73,83,241,1214,1455
01110902,EVEREST COLLEGE - ATLANTA               ,GA,30331-2620,Proprietary  ,29,142,171,574,2522,3096
01112301,EVEREST COLLEGE - EVEREST INSTITUTE- NOR,GA,30093-2813,Proprietary  ,17,91,108,291,1450,1741
01157400,BAUDER COLLEGE                          ,GA,30313-2439,Proprietary  ,12,72,84,617,2390,3007
01205100,PRO WAY HAIR SCHOOL                     ,GA,30083-2884,Proprietary  ,5,28,33,99,482,581
01216500,ATLANTA METROPOLITAN COLLEGE            ,GA,30310-4498,Public       ,90,233,323,4481,9508,13989
01246109,LINCOLN COLLEGE OF TECHNOLOGY - MARIETTA,GA,30067-8638,Proprietary  ,14,43,57,148,648,796
01303900,SOUTH UNIVERSITY                        ,GA,31406-4881,Proprietary  ,262,2912,3174,4327,30659,34986
02060900,BROWN CLG OF COURT REPORTING & M.T.     ,GA,30318-2570,Proprietary  ,3,14,17,55,639,694
02074800,LIFE UNIVERSITY                         ,GA,30060-0000,Private      ,8,30,38,747,3388,4135
02113613,AMERICAN INTERCONTINENTAL UNIVERSITY    ,GA,30328-1649,Proprietary  ,10,105,115,1043,3935,4978
02116000,SANFORD-BROWN COLLEGE                   ,GA,30328-4803,Proprietary  ,17,63,80,318,1523,1841
02141500,SAVANNAH COLLEGE OF ART & DESIGN        ,GA,31402-3146,Private      ,44,57,101,12155,5573,17728
02202800,AUGUSTA AREA DIET INTERN UNIV HOSP      ,GA,30901-0000,Private      ,0,4,4,20,116,136
02217200,PORTFOLIO CENTER                        ,GA,30309-0000,Proprietary  ,1,4,5,64,278,342
02266200,AMERICAN PROFESSIONAL INSTITUTE         ,GA,31201-3185,Private      ,3,18,21,109,606,715
02279500,HEART OF GEORGIA TECHNICAL COLLEGE      ,GA,31021-8896,Public       ,0,0,0,256,724,980
02284300,INTERACTIVE COLLEGE OF TECHNOLOGY       ,GA,30341-0000,Proprietary  ,42,196,238,334,2208,2542
02284308,INTERACTIVE LEARNING SYSTEMS            ,GA,30260-0000,Proprietary  ,8,16,24,73,344,417
02284309,INTERACTIVE COLLEGE OF TECHNOLOGY       ,GA,30501-0000,Proprietary  ,9,52,61,125,437,562
02285500,"CREATIVE CIRCUS, THE                    ",GA,30324-0000,Proprietary  ,1,3,4,120,382,502
02288400,GWINNETT TECHNICAL COLLEGE              ,GA,30043-5702,Public       ,82,231,313,4727,12089,16816
02313902,WESTWOOD COLLEGE - O'HARE AIRPORT - ATLA,GA,30345-2807,Proprietary  ,5,48,53,234,1054,1288
02321400,ROFFLER-MOLER HAIRSTYLING COLLEGE       ,GA,30062-0000,Proprietary  ,1,5,6,90,176,266
02354500,SOUTHEASTERN BEAUTY SCHOOLS             ,GA,31906-0000,Proprietary  ,0,0,0,25,62,87
02482100,MOREHOUSE SCHOOL OF MEDICINE            ,GA,30310-0000,Private      ,4,6,10,228,873,1101
02520000,INTERNATIONAL SCH SKIN & NAILCARE       ,GA,30342-1119,Proprietary  ,8,38,46,114,599,713
02559315,(UNITED EDUCATION INSTITUTE) - UEI MORRO,GA,30260-2941,Proprietary  ,2,10,12,50,312,362
02577000,PAUL MITCHELL THE SCHOOL - ESANI        ,GA,30076-1507,Proprietary  ,7,11,18,111,237,348
02577700,BEAUTY COLLEGE OF AMERICA               ,GA,30297-0000,Proprietary  ,0,11,11,80,192,272
02580100,IVERSON INSTITUTE                       ,GA,30341-3662,Proprietary  ,5,17,22,60,284,344
02580200,ATLANTA SCHOOL OF MASSAGE               ,GA,30338-0000,Proprietary  ,9,43,52,205,900,1105
02583000,GWINNETT COLLEGE OF BUSINESS            ,GA,30047-3447,Proprietary  ,2,20,22,158,890,1048
02614206,MILLER - MOTTE TECHNICAL COLLEGE - COLUM,GA,31907-3222,Proprietary  ,11,70,81,276,1761,2037
02614207,MILLER - MOTTE TECHNICAL COLLEGE - AUGUS,GA,30907-0921,Proprietary  ,8,58,66,272,1516,1788
03005400,GEORGIA CAREER INSTITUTE                ,GA,30013-2076,Proprietary  ,18,55,73,318,1006,1324
03010619,VIRGINIA COLLEGE - AUGUSTA              ,GA,30909-5515,Proprietary  ,8,29,37,304,1413,1717
03010623,VIRGINIA COLLEGE - MACON                ,GA,31206-3180,Proprietary  ,6,26,32,183,931,1114
03022601,WESTERN CULINARY INSTITUTE - LE CORDON B,GA,30084-5893,Proprietary  ,16,50,66,477,1286,1763
03030000,OGEECHEE TECHNICAL COLLEGE              ,GA,30458-8049,Public       ,43,156,199,1846,3772,5618
03032100,ALTAMAHA TECHNICAL COLLEGE              ,GA,31545-4465,Public       ,26,78,104,944,2276,3220
03042700,LAURUSTECHNICAL INSTITUTE               ,GA,30030-1506,Proprietary  ,12,72,84,114,904,1018
03066500,SOUTHEASTERN TECHNICAL COLLEGE          ,GA,30474-8817,Public       ,33,129,162,754,2268,3022
03072304,EVEREST COLLEGE - EVEREST INSTITUTE     ,GA,30236-0000,Proprietary  ,7,68,75,180,1120,1300
03076300,BEULAH HEIGHTS BIBLE COLLEGE            ,GA,30316-1873,Private      ,0,26,26,42,1067,1109
03079202,WESTWOOD COLLEGE - ATLANTA MIDTOWN      ,GA,30309-2848,Proprietary  ,19,67,86,659,2065,2724
03081500,SOUTHEASTERN BEAUTY SCHOOL              ,GA,31917-0000,Proprietary  ,9,22,31,93,286,379
03089100,GEORGIA INSTITUTE OF COSMETOLOGY        ,GA,30606-3152,Proprietary  ,7,50,57,267,713,980
03090600,COBB BEAUTY COLLEGE                     ,GA,30144-2828,Proprietary  ,2,11,13,91,236,327
03100900,LUTHER RICE UNIVERSITY                  ,GA,30038-2454,Private      ,1,39,40,62,1432,1494
03102000,RIVERTOWN SCHOOL OF BEAUTY              ,GA,31904-4747,Proprietary  ,12,39,51,119,473,592
03104500,ATLANTA INSTITUTE OF MUSIC              ,GA,30096-4988,Proprietary  ,4,12,16,517,620,1137
03116100,VOGUE BEAUTY AND BARBER SCHOOL          ,GA,30141-2226,Proprietary  ,3,10,13,94,338,432
03155500,OCONEE FALL LINE TECHNICAL COLLEGE      ,GA,31082-6179,Public       ,36,162,198,547,1987,2534
03173300,ATLANTA'S JOHN MARSHALL LAW SCHOOL      ,GA,30309-0000,Proprietary  ,0,16,16,77,1552,1629
03418300,GWINNETT COLLEGE-SANDY SPRINGS          ,GA,30328-3161,Proprietary  ,2,8,10,134,508,642
03445500,FAYETTE BEAUTY ACADEMY                  ,GA,30214-1191,Proprietary  ,0,18,18,42,194,236
03523300,AVIATION INSTITUTE OF MAINTENANCE       ,GA,30045-0000,Proprietary  ,22,91,113,348,1218,1566
03635300,CARVER BIBLE COLLEGE                    ,GA,30331-1300,Private      ,0,9,9,53,329,382
03748300,KEVOSNIK SCHOOL OF HAIR DESIGN          ,GA,31021-0000,Proprietary  ,0,1,1,8,68,76
03753400,MICHAEL'S SCHOOL OF BEAUTY              ,GA,30909-0000,Proprietary  ,0,0,0,49,132,181
03804400,MEDTECH INSTITUTE                       ,GA,30339-6040,Proprietary  ,17,75,92,262,1190,1452
03812300,OMNITECH INSTITUTE                      ,GA,30035-1206,Proprietary  ,3,35,38,52,445,497
04021300,AUGUSTA SCHOOL OF MASSAGE               ,GA,30809-0000,Proprietary  ,0,8,8,35,128,163
04051331,ART INSTITUTE OF PHOENIX (THE) - BROWN M,GA,30319-3054,Proprietary  ,3,20,23,256,642,898
04091300,SAVANNAH SCHOOL OF MASSAGE THERAPY      ,GA,31406-2711,Private      ,0,0,0,9,18,27
04126800,ACADEMY OF SOMATIC HEALING ARTS (ASHA)  ,GA,30071-1024,Proprietary  ,0,0,0,6,47,53
04142900,GEORGIA GWINNETT COLLEGE                ,GA,30043-7409,Public       ,114,103,217,11822,7878,19700
04147000,PAUL MITCHELL THE SCHOOL ATLANTA        ,GA,30318-5241,Proprietary  ,9,22,31,471,859,1330
04147700,LAKE LANIER SCHOOL OF MASSAGE           ,GA,30501-4546,Proprietary  ,4,14,18,58,256,314
04149900,PROFILE INSTITUTE OF BARBER-STYLING     ,GA,30315-8459,Proprietary  ,4,11,15,69,367,436
04150900,PROCESS INSTITUTE OF COSMETOLOGY (THE)  ,GA,30043-7344,Proprietary  ,7,2,9,144,221,365
04152300,GEORGIA BEAUTY ACADEMY                  ,GA,30721-3952,Proprietary  ,3,8,11,107,233,340
04156500,GEORGIA CHRISTIAN UNIVERSITY            ,GA,30047-3778,Private      ,1,1,2,45,161,206
04160200,ATLANTA BEAUTY ACADEMY                  ,GA,30340-1334,Proprietary  ,2,44,46,120,661,781
04203800,WOODRUFF MEDICAL TRAINING AND TESTING   ,GA,30033-6103,Proprietary  ,6,18,24,46,292,338
04204500,ELAINE STERLING INSTITUTE(THE)          ,GA,30342-2633,Proprietary  ,2,15,17,52,253,305
04206400,HELMS COLLEGE                           ,GA,31206-5309,Private      ,3,15,18,106,338,444
04206600,SAE INSTITUTE OF TECHNOLOGY - ATLANTA   ,GA,30303-1736,Proprietary  ,11,44,55,316,705,1021
04208000,TECHNOLOGY CENTER                       ,GA,30071-3519,Proprietary  ,1,13,14,24,263,287
04218000,UNITED MEDICAL AND BUSINESS INSTITUTE   ,GA,30344-6977,Proprietary  ,2,27,29,29,187,216
04221100,NEW HORIZONS MEDICAL INSTITUTE          ,GA,30071-2965,Proprietary  ,4,38,42,22,221,243
00149911,EVEREST COLLEGE - MERRIONETTE PARK      ,IL,60803-4517,Proprietary  ,8,70,78,213,823,1036
00162800,AMERICAN ACADEMY OF ART                 ,IL,60604-4302,Proprietary  ,4,11,15,1048,473,1521
00163300,AUGUSTANA COLLEGE                       ,IL,61201-2296,Private      ,0,7,7,5012,337,5349
00163400,AURORA UNIVERSITY                       ,IL,60506-4892,Private      ,14,144,158,4628,4138,8766
00163600,SOUTHWESTERN ILLINOIS COLLEGE           ,IL,62221-5899,Public       ,114,284,398,5269,8342,13611
00163800,BLACK HAWK COLLEGE                      ,IL,61265-5899,Public       ,25,78,103,2934,3597,6531
00163900,BLACKBURN COLLEGE                       ,IL,62626-1498,Private      ,1,2,3,804,182,986
00164000,PRAIRIE STATE COLLEGE                   ,IL,60411-8226,Public       ,41,105,146,3959,6657,10616
00164100,BRADLEY UNIVERSITY                      ,IL,61625-0002,Private      ,7,8,15,9034,1475,10509
00164300,SPOON RIVER COLLEGE                     ,IL,61520-8907,Public       ,13,11,24,943,1090,2033
00164700,CITY COLLEGES OF CHICAGO                ,IL,60606-6998,Public       ,28,129,157,3737,6482,10219
00164800,TRUMAN COLLEGE                          ,IL,60640-5691,Public       ,36,183,219,4268,8020,12288
00164900,RICHARD J DALEY COLLEGE                 ,IL,60652-1299,Public       ,42,136,178,4753,7069,11822
00165000,CITY COLLEGES OF CHICAGO-MALCOLM X      ,IL,60612-3197,Public       ,64,270,334,5495,11678,17173
00165200,HAROLD WASHINGTON COLLEGE               ,IL,60601-2403,Public       ,94,238,332,10670,12458,23128
00165400,KENNEDY KING COLLEGE                    ,IL,60621-3798,Public       ,42,250,292,3897,11143,15040
00165500,WRIGHT COLLEGE                          ,IL,60634-1591,Public       ,52,153,205,7144,8984,16128
00165700,MIDWESTERN UNIVERSITY                   ,IL,60515-1200,Private      ,0,3,3,174,3767,3941
00165900,ROSALIND FRANKLIN UNIVERSITY OF MEDICINE,IL,60064-3095,Private      ,0,10,10,67,2897,2964
00166100,CHICAGO THEOLOGICAL SEMINARY            ,IL,60637-0000,Private      ,1,3,4,19,301,320
00166300,SPERTUS COLLEGE                         ,IL,60605-1995,Private      ,0,3,3,5,107,112
00166400,UNIVERSITY OF ST FRANCIS                ,IL,60435-6188,Private      ,2,70,72,2344,2758,5102
00166500,COLUMBIA COLLEGE                        ,IL,60605-1996,Private      ,46,69,115,16011,6724,22735
00166600,CONCORDIA UNIVERSITY                    ,IL,60305-1499,Private      ,8,103,111,3203,4501,7704
00166900,DANVILLE AREA COMMUNITY COLLEGE         ,IL,61832-5199,Public       ,13,52,65,1196,2013,3209
00167100,DEPAUL UNIVERSITY                       ,IL,60604-2287,Private      ,49,224,273,25967,18941,44908
00167400,EASTERN ILLINOIS UNIVERSITY             ,IL,61920-3099,Public       ,35,44,79,12252,4308,16560
00167500,ELGIN COMMUNITY COLLEGE                 ,IL,60123-7193,Public       ,16,66,82,5046,5396,10442
00167600,ELMHURST COLLEGE                        ,IL,60126-3296,Private      ,8,11,19,4588,1591,6179
00167800,EUREKA COLLEGE                          ,IL,61530-9976,Private      ,2,1,3,1089,255,1344
00168100,HIGHLAND COMMUNITY COLLEGE              ,IL,61032-9341,Public       ,20,51,71,1096,1434,2530
00168200,GARRETT-EVANGELICAL THEOLOGICAL SEM     ,IL,60201-0000,Private      ,0,2,2,3,269,272
00168400,GREENVILLE COLLEGE                      ,IL,62246-1199,Private      ,3,11,14,1797,775,2572
00168500,HEBREW THEOLOGICAL COLLEGE              ,IL,60077-3263,Private      ,3,1,4,530,37,567
00168800,ILLINOIS COLLEGE                        ,IL,62650-2299,Private      ,1,2,3,2069,265,2334
00168900,ILLINOIS COLLEGE OF OPTOMETRY           ,IL,60616-3878,Private      ,0,2,2,44,736,780
00169100,ILLINOIS INSTITUTE OF TECHNOLOGY        ,IL,60616-0000,Private      ,6,36,42,3958,3162,7120
00169103,CHICAGO KENT COLLEGE OF LAW             ,IL,60661-0000,Private      ,0,14,14,96,2032,2128
00169200,ILLINOIS STATE UNIVERSITY               ,IL,61790-1000,Public       ,28,59,87,25233,5808,31041
00169300,NORTHEASTERN ILLINOIS UNIV              ,IL,60625-4699,Public       ,37,109,146,8998,9925,18923
00169400,CHICAGO STATE UNIVERSITY                ,IL,60628-1598,Public       ,29,163,192,7362,14150,21512
00169600,ILLINOIS WESLEYAN UNIVERSITY            ,IL,61701-0000,Private      ,2,2,4,3622,250,3872
00169800,JOHN MARSHALL LAW SCHOOL                ,IL,60604-0000,Private      ,2,6,8,96,2604,2700
00169900,JOLIET JUNIOR COLLEGE                   ,IL,60431-8938,Public       ,51,137,188,8548,8716,17264
00170000,JUDSON UNIVERSITY                       ,IL,60123-1498,Private      ,2,23,25,1245,1020,2265
00170100,KASKASKIA COLLEGE                       ,IL,62801-7878,Public       ,36,89,125,1896,2803,4699
00170300,KENDALL COLLEGE                         ,IL,60622-4278,Proprietary  ,5,24,29,1301,2516,3817
00170400,KNOX COLLEGE                            ,IL,61401-4999,Private      ,2,2,4,2626,177,2803
00170500,ILLINOIS VALLEY COMMUNITY COLLEGE       ,IL,61348-9692,Public       ,19,59,78,1752,2042,3794
00170600,LAKE FOREST COLLEGE                     ,IL,60045-2399,Private      ,2,4,6,2816,274,3090
00170700,LEWIS UNIVERSITY                        ,IL,60446-2200,Private      ,9,86,95,6272,4476,10748
00170800,LINCOLN CHRISTIAN UNIVERSITY            ,IL,62656-2167,Private      ,0,9,9,484,741,1225
00170900,LINCOLN COLLEGE                         ,IL,62656-1699,Private      ,39,16,55,1418,841,2259
00171000,LOYOLA UNIVERSITY CHICAGO               ,IL,60626-0000,Private      ,27,123,150,18988,13488,32476
00171200,LUTHERAN SCHOOL OF THEOL AT CHICAGO     ,IL,60615-0000,Private      ,0,0,0,8,131,139
00171600,MACCORMAC COLLEGE                       ,IL,60602-4405,Private      ,1,17,18,94,327,421
00171700,MACMURRAY COLLEGE                       ,IL,62650-2590,Private      ,1,2,3,1019,337,1356
00172100,MCCORMICK THEOLOGICAL SEMINARY          ,IL,60615-5108,Private      ,0,1,1,7,172,179
00172200,MCKENDREE UNIVERSITY                    ,IL,62254-1299,Private      ,7,53,60,2008,1774,3782
00172300,MEADVILLE LOMBARD THEOLOGICAL SCHOOL    ,IL,60637-1602,Private      ,0,0,0,7,80,87
00172400,MILLIKIN UNIVERSITY                     ,IL,62522-2084,Private      ,6,5,11,3503,1105,4608
00172500,MONMOUTH COLLEGE                        ,IL,61462-1963,Private      ,7,0,7,2545,249,2794
00172700,MOODY BIBLE INSTITUTE                   ,IL,60610-3214,Private      ,9,34,43,2559,2280,4839
00172800,MORTON COLLEGE                          ,IL,60804-4398,Public       ,37,73,110,3288,2721,6009
00173200,NATIONAL UNIV OF HEALTH SCIENCES        ,IL,60148-4583,Private      ,1,9,10,74,1014,1088
00173300,NATIONAL-LOUIS UNIVERSITY               ,IL,60603-3032,Private      ,2,154,156,577,7025,7602
00173400,NORTH CENTRAL COLLEGE                   ,IL,60540-4690,Private      ,7,8,15,4672,1195,5867
00173500,NORTH PARK UNIVERSITY                   ,IL,60625-4895,Private      ,8,35,43,3544,2400,5944
00173600,NORTHERN BAPTIST THEOL SEMINARY         ,IL,60148-0000,Private      ,0,1,1,1,101,102
00173700,NORTHERN ILLINOIS UNIVERSITY            ,IL,60115-2854,Public       ,87,127,214,26492,12286,38778
00173900,NORTHWESTERN UNIV                       ,IL,60208-0001,Private      ,12,133,145,21825,11619,33444
00174100,OLIVET NAZARENE UNIVERSITY              ,IL,60914-2271,Private      ,8,68,76,4138,3250,7388
00174200,IL EASTERN COMM COLGS-OLNEY CENTRAL     ,IL,62450-1099,Public       ,25,33,58,666,843,1509
00174500,QUINCY UNIVERSITY                       ,IL,62301-2699,Private      ,1,7,8,1792,762,2554
00174600,ROBERT MORRIS UNIVERSITY ILLINOIS       ,IL,60605-1225,Private      ,21,93,114,6581,6543,13124
00174700,ROCK VALLEY COLLEGE                     ,IL,61114-5699,Public       ,34,111,145,4209,6120,10329
00174800,ROCKFORD UNIVERSITY                     ,IL,61108-2393,Private      ,2,33,35,1443,1635,3078
00174900,ROOSEVELT UNIVERSITY                    ,IL,60605-1394,Private      ,23,119,142,6529,8675,15204
00175000,DOMINICAN UNIVERSITY                    ,IL,60305-1066,Private      ,4,23,27,3903,2045,5948
00175200,SAUK VALLEY COMMUNITY COLLEGE           ,IL,61021-9112,Public       ,35,52,87,1271,1413,2684
00175300,SCHOOL OF ART INSTITUTE OF CHICAGO      ,IL,60603-3013,Private      ,9,11,20,5007,2837,7844
00175600,SHIMER COLLEGE                          ,IL,60616-3893,Private      ,1,0,1,113,82,195
00175700,SOUTHEASTERN ILLINOIS COLLEGE           ,IL,62946-4925,Public       ,20,32,52,854,977,1831
00175800,SOUTHERN ILL UNIV-CARBONDALE            ,IL,62901-0000,Public       ,74,158,232,19678,10284,29962
00175900,SOUTHERN ILL UNIV-EDWARDSVILLE          ,IL,62026-1060,Public       ,35,92,127,15112,7047,22159
00175924,SO IL UNIV-SCHL OF DENTAL MEDICINE      ,IL,62002-0000,Public       ,0,0,0,14,219,233
00176500,UNIVERSITY OF ST MARY OF THE LAKE       ,IL,60060-0000,Private      ,0,1,1,6,24,30
00176700,BENEDICTINE UNIVERSITY                  ,IL,60532-0900,Private      ,9,87,96,4240,4985,9225
00176800,ST XAVIER UNIVERSITY                    ,IL,60655-3199,Private      ,23,56,79,6761,4248,11009
00176900,SOUTH SUBURBAN COLLEGE                  ,IL,60473-9978,Public       ,31,125,156,3685,7327,11012
00177100,TRINITY CHRISTIAN COLLEGE               ,IL,60463-0929,Private      ,6,13,19,1465,1096,2561
00177200,TRINITY INTERNATIONAL UNIVERSITY        ,IL,60015-1283,Private      ,0,17,17,1043,1240,2283
00177300,TRITON COLLEGE                          ,IL,60171-1995,Public       ,79,143,222,5454,6341,11795
00177400,UNIVERSITY OF CHICAGO                   ,IL,60637-1476,Private      ,20,39,59,22647,5142,27789
00177401,UNIV OF CHICAGO PRITZKER SCH OF MED     ,IL,60637-0000,Private      ,0,0,0,100,675,775
00177403,"UNIV OF CHICAGO, BOOTH SCH OF BUS       ",IL,60637-0000,Private      ,0,30,30,178,1646,1824
00177405,UNIVERSITY OF CHICAGO GRADUATE          ,IL,60637-0000,Private      ,0,16,16,155,5103,5258
00177500,UNIV OF ILLINOIS @ URBANA-CHAMPAIGN     ,IL,61820-5796,Public       ,54,141,195,35125,10157,45282
00177600,UNIV OF ILLINOIS AT CHICAGO             ,IL,60607-0000,Public       ,60,148,208,30327,22537,52864
00177800,VANDERCOOK COLLEGE OF MUSIC             ,IL,60616-3731,Private      ,0,3,3,206,141,347
00177900,IL EASTERN COMM COLGS-WABASH VALLEY     ,IL,62863-2699,Public       ,9,8,17,532,477,1009
00178000,WESTERN ILLINOIS UNIVERSITY             ,IL,61455-1390,Public       ,29,70,99,14619,5472,20091
00178100,WHEATON COLLEGE                         ,IL,60187-5535,Private      ,4,7,11,3092,694,3786
00178300,WORSHAM COLLEGE OF MORTUARY SCIENCE     ,IL,60090-2646,Proprietary  ,1,2,3,78,201,279
00396100,HARPER COLLEGE                          ,IL,60067-7398,Public       ,64,161,225,6592,6101,12693
00456000,GEM CITY COLLEGE                        ,IL,62301-4949,Proprietary  ,1,1,2,23,70,93
00456800,MIDSTATE COLLEGE                        ,IL,61614-3558,Proprietary  ,3,29,32,149,1132,1281
00621400,BLESSING RIEMAN COLLEGE OF NURSING      ,IL,62301-0000,Private      ,2,5,7,186,249,435
00621401,BLESSING HOSPITAL - SCHOOL OF MEDICAL LA,IL,62305-7005,Private      ,0,0,0,20,44,64
00621402,BLESSING HOSPITAL - SCHOOL OF RADIOLOGIC,IL,62305-7005,Private      ,0,1,1,34,55,89
00622500,TRINITY COLLEGE OF NURSING AND HEALTH SC,IL,61201-5317,Private      ,1,3,4,141,312,453
00622800,METHODIST MED CTR OF ILL SCH NRSNG      ,IL,61636-0000,Private      ,0,2,2,367,742,1109
00624000,ST FRANCIS MED CLG OF NRSG              ,IL,61603-3783,Private      ,0,4,4,414,711,1125
00638500,CHAMBERLAIN COLLEGE OF NURSING          ,IL,60101-0000,Proprietary  ,20,411,431,2682,23587,26269
00665600,COLLEGE OF DUPAGE                       ,IL,60137-6599,Public       ,114,297,411,13521,12736,26257
00675300,ILLINOIS CENTRAL COLLEGE                ,IL,61635-0001,Public       ,51,197,248,5072,6471,11543
00693100,WAUBONSEE COMMUNITY COLLEGE             ,IL,60554-0000,Public       ,39,113,152,4221,5099,9320
00711800,PARKLAND COLLEGE                        ,IL,61821-1899,Public       ,41,97,138,5387,4833,10220
00711900,REND LAKE COLLEGE                       ,IL,62846-9801,Public       ,24,44,68,1385,1847,3232
00717000,LINCOLN LAND COMMUNITY COLLEGE          ,IL,62794-9256,Public       ,15,58,73,3327,5061,8388
00726500,CARL SANDBURG COLLEGE                   ,IL,61401-9576,Public       ,18,28,46,1202,1809,3011
00730307,LINCOLN COLLEGE OF TECHNOLOGY - MELROSE ,IL,60160-1605,Proprietary  ,35,55,90,829,837,1666
00750103,VATTEROTT COLLEGE - FAIRVIEW HEIGHTS    ,IL,62208-2029,Proprietary  ,16,75,91,236,948,1184
00754900,COYNE AMERICAN INSTITUTE                ,IL,60607-1300,Proprietary  ,10,40,50,514,1654,2168
00764400,LAKE LAND COLLEGE                       ,IL,61938-9366,Public       ,23,64,87,2630,2703,5333
00768400,KISHWAUKEE COLLEGE                      ,IL,60150-9699,Public       ,17,47,64,2694,2640,5334
00769000,KANKAKEE COMMUNITY COLLEGE              ,IL,60901-6505,Public       ,37,92,129,1868,3259,5127
00769100,MCHENRY COUNTY COLLEGE                  ,IL,60012-2761,Public       ,19,62,81,2879,2966,5845
00769200,MORAINE VALLEY COMMUNITY COLLEGE        ,IL,60465-0937,Public       ,83,154,237,8609,7368,15977
00769300,SHAWNEE COMMUNITY COLLEGE               ,IL,62992-9725,Public       ,31,55,86,816,1297,2113
00769400,COLLEGE OF LAKE COUNTY                  ,IL,60030-1198,Public       ,106,219,325,5794,6835,12629
00793700,MS ROBERTS ACADEMY OF BEAUTY CULT       ,IL,60181-2930,Proprietary  ,3,5,8,30,84,114
00807600,JOHN A LOGAN COLLEGE                    ,IL,62918-2500,Public       ,40,86,126,2317,3034,5351
00809003,EVEREST COLLEGE - BEDFORD PARK          ,IL,60629-5819,Proprietary  ,16,102,118,304,1218,1522
00825900,EDUCATORS OF BEAUTY                     ,IL,61081-3611,Proprietary  ,4,6,10,78,136,214
00825901,EDUCATORS OF BEAUTY                     ,IL,61104-0000,Proprietary  ,1,9,10,76,156,232
00832800,ALVAREITA'S COLLEGE OF COSMETOLOGY      ,IL,62025-2041,Proprietary  ,2,10,12,67,136,203
00869402,RASMUSSEN COLLEGE - ROCKFORD            ,IL,61108-2513,Proprietary  ,3,36,39,315,1777,2092
00869403,RASMUSSEN COLLEGE - AURORA              ,IL,60506-6219,Proprietary  ,7,23,30,161,832,993
00869404,RASMUSSEN COLLEGE - ROMEOVILLE          ,IL,60446-0000,Proprietary  ,5,22,27,242,1034,1276
00869418,RASMUSSEN COLLEGE -  MOKENA             ,IL,60448-0000,Proprietary  ,4,16,20,91,619,710
00888000,MORRISON INSTITUTE OF TECHNOLOGY        ,IL,61270-2959,Private      ,1,0,1,147,40,187
00893800,GRAHAM HOSPITAL SCH OF NURSING          ,IL,61520-2497,Private      ,1,1,2,37,134,171
00893900,CANNELLA SCHOOL OF HAIR DESIGN          ,IL,60406-2130,Proprietary  ,1,3,4,36,111,147
00914500,GOVERNORS STATE UNIVERSITY              ,IL,60466-0975,Public       ,17,135,152,1772,8352,10124
00923200,CATHOLIC THEOLOGICAL UNION              ,IL,60615-0000,Private      ,0,0,0,5,78,83
00933300,UNIV OF ILLINOIS AT SPRINGFIELD         ,IL,62703-5407,Public       ,9,63,72,3098,4074,7172
00945918,EMPIRE BEAUTY SCHOOL - HANOVER PARK     ,IL,60133-5421,Proprietary  ,0,0,0,34,68,102
00947500,EDUCATORS OF BEAUTY                     ,IL,61301-2404,Proprietary  ,2,5,7,37,46,83
00959500,CANNELLA SCHOOL OF HAIR DESIGN          ,IL,60617-4303,Proprietary  ,2,7,9,104,255,359
00976700,OLIVE-HARVEY COLLEGE                    ,IL,60628-1696,Public       ,27,133,160,2731,6712,9443
00978600,IL EASTERN COMM COLGS-LINCOLN TRAIL     ,IL,62454-5708,Public       ,2,13,15,374,478,852
00980000,RUSH UNIVERSITY                         ,IL,60612-3806,Private      ,1,29,30,487,3919,4406
00989600,OAKTON COMMUNITY COLLEGE                ,IL,60016-1268,Public       ,50,103,153,4653,4327,8980
00998700,SAINT ANTHONY COLLEGE OF NURSING        ,IL,61108-2468,Private      ,1,9,10,224,560,784
01002000,LEWIS AND CLARK COMMUNITY COLLEGE       ,IL,62035-2466,Public       ,38,105,143,2659,3479,6138
01050100,LAKEVIEW  COLLEGE OF NURSING            ,IL,61832-3781,Private      ,1,1,2,247,348,595
01069500,TRI-COUNTY BEAUTY ACADEMY               ,IL,62056-2036,Proprietary  ,3,0,3,26,34,60
01071000,CAPITAL AREA SCH OF PRAC NRSG           ,IL,62707-0000,Public       ,0,6,6,128,685,813
01072700,DEVRY UNIVERSITY                        ,IL,60618-5994,Proprietary  ,88,1054,1142,14447,92412,106859
01083600,PIVOT POINT INTNL CSMTLGY RSRCH CTR     ,IL,60626-0000,Proprietary  ,8,16,24,415,677,1092
01087900,RICHLAND COMMUNITY COLLEGE              ,IL,62521-8513,Public       ,21,88,109,1269,2826,4095
01091303,ROCKFORD CAREER COLLEGE                 ,IL,61108-3900,Proprietary  ,2,35,37,357,1330,1687
01151002,EVEREST INSTITUTE - EVEREST COLLEGE     ,IL,60542-1610,Proprietary  ,1,10,11,204,687,891
01181000,TAYLOR BUSINESS INSTITUTE               ,IL,60606-5111,Proprietary  ,2,10,12,48,290,338
01185800,EVEREST COLLEGE                         ,IL,60077-1074,Proprietary  ,14,43,57,249,718,967
01185802,EVEREST COLLEGE - BURR RIDGE            ,IL,60527-7826,Proprietary  ,8,49,57,182,496,678
01185803,EVEREST COLLEGE - MELROSE PARK          ,IL,60160-1526,Proprietary  ,18,83,101,314,1044,1358
01236200,NORTHWESTERN COLLEGE                    ,IL,60630-2298,Proprietary  ,33,138,171,2308,4243,6551
01238500,BLOOMINGTON-NORMAL SCH RADIOGRAPHY      ,IL,61761-4604,Private      ,0,0,0,36,71,107
01258400,ILLINOIS INSTITUTE OF ART (THE)         ,IL,60654-1593,Proprietary  ,51,109,160,6257,4953,11210
01281300,JOHN WOOD COMMUNITY COLLEGE             ,IL,62305-0401,Public       ,12,55,67,1226,1589,2815
01308700,CAPRI BEAUTY COLLEGE                    ,IL,60629-1613,Proprietary  ,1,2,3,98,243,341
01308800,CAPRI OAK FOREST COLLEGE OF BEAUTY      ,IL,60452-2798,Proprietary  ,4,3,7,158,193,351
02055200,HARRINGTON COLLEGE OF DESIGN            ,IL,60606-3433,Proprietary  ,2,5,7,380,644,1024
02068100,ADLER SCH OF PROFESSIONAL PSYCHLGY      ,IL,60601-0000,Private      ,1,11,12,156,1865,2021
02069300,VATTEROTT COLLEGE                       ,IL,62305-5938,Proprietary  ,4,30,34,121,448,569
02073200,TELSHE YESHIVA-CHICAGO                  ,IL,60625-0000,Private      ,0,0,0,39,12,51
02074400,IL EASTERN COMM COLGS-FRONTIER          ,IL,62837-0000,Public       ,8,16,24,212,405,617
02075400,KELLER GRADUATE SCHOOL OF MGMT.         ,IL,60515-5683,Proprietary  ,1,207,208,76,17203,17279
02113600,AMERICAN INTERCONTINENTAL UNIVERSITY    ,IL,60192-3713,Proprietary  ,152,2429,2581,1961,33223,35184
02117400,BECK AREA CAREER CENTER                 ,IL,62278-0000,Public       ,0,3,3,36,194,230
02124400,UNIVERSITY OF SPA & COSMETOLOGY ART     ,IL,62704-0000,Proprietary  ,4,17,21,158,274,432
02150600,COSMETOLOGY AND SPA INSTITUTE (THE)     ,IL,60014-4003,Proprietary  ,11,21,32,136,243,379
02155300,THE CHICAGO SCHOOL OF PROF PSYCHOLOGY   ,IL,60610-4705,Private      ,0,45,45,119,6089,6208
02160300,INTERNATIONAL ACAD OF DESIGN & TECH     ,IL,60602-3319,Proprietary  ,1,10,11,399,692,1091
02160304,INTERNATIONAL ACADEMY OF DESIGN AND TECH,IL,60173-5160,Proprietary  ,0,0,0,140,308,448
02168600,EAST WEST UNIVERSITY                    ,IL,60605-0000,Private      ,50,43,93,1056,1721,2777
02179900,ARGOSY UNIVERSITY                       ,IL,60601-7757,Proprietary  ,327,3420,3747,10346,49084,59430
02185400,ST AUGUSTINE COLLEGE                    ,IL,60640-0000,Private      ,0,19,19,788,2490,3278
02192400,MR JOHNS SCHOOL OF COSMETOLOGY          ,IL,62521-0000,Proprietary  ,0,12,12,30,151,181
02202600,CANNELLA SCHOOL OF HAIR DESIGN          ,IL,60181-1321,Proprietary  ,1,11,12,16,98,114
02214100,RESURRECTION UNIVERSITY                 ,IL,60302-2519,Private      ,2,8,10,253,934,1187
02228100,MAC DANIEL'S BEAUTY SCHOOL              ,IL,60640-0000,Proprietary  ,5,6,11,62,137,199
02261200,HAIR PROFESSIONALS ACAD COSMETOLOGY     ,IL,60118-0000,Proprietary  ,7,30,37,65,261,326
02261201,HAIR PROFESSIONALS ACADEMY OF COSMETOLOG,IL,60118-9333,Proprietary  ,0,2,2,8,23,31
02262100,HAIR PROFESSIONALS SCH COSMETOLOGY      ,IL,60543-0000,Proprietary  ,2,4,6,44,99,143
02291200,CANNELLA SCHOOL OF HAIR DESIGN          ,IL,60639-0000,Proprietary  ,2,4,6,129,232,361
02295500,CANNELLA SCHOOL OF HAIR DESIGN          ,IL,60120-0000,Proprietary  ,1,4,5,36,97,133
02297500,OEHRLEIN SCHOOL OF COSMETOLOGY          ,IL,61611-0000,Proprietary  ,3,3,6,78,124,202
02312300,LA' JAMES COLLEGE HAIRSTYLING           ,IL,61244-0000,Proprietary  ,0,1,1,27,71,98
02313900,WESTWOOD COLLEGE - O'HARE AIRPORT       ,IL,60631-2801,Proprietary  ,5,51,56,339,932,1271
02317300,CONCEPT COLLEGE OF COSMETOLOGY          ,IL,61832-0000,Proprietary  ,4,6,10,72,168,240
02319200,LAKE FOREST GRAD SCHL OF MGMT           ,IL,60045-4824,Private      ,0,13,13,2,344,346
02323300,PROFESSIONAL'S CHOICE HAIR DSN ACAD     ,IL,60435-0000,Proprietary  ,1,4,5,55,154,209
02332200,HAIR PROFESSIONALS CAREER COLLEGE       ,IL,60178-0000,Proprietary  ,3,4,7,35,90,125
02349400,ALVAREITA'S COLLEGE OF COSMETOLOGY      ,IL,62035-0000,Proprietary  ,1,7,8,45,123,168
02349500,CANNELLA SCHOOL OF HAIR DESIGN          ,IL,60632-0000,Proprietary  ,8,15,23,149,330,479
02352200,LE CORDON BLEU COLLEGE OF CULINARY ARTS ,IL,60610-3050,Proprietary  ,20,79,99,1005,2112,3117
02498200,G SKIN & BEAUTY INSTITUTE               ,IL,60523-1805,Proprietary  ,9,32,41,133,401,534
02498201,HAIR PROFESSIONALS ACADEMY OF COSMETOLOG,IL,60563-0000,Proprietary  ,0,1,1,23,57,80
02522800,FOX COLLEGE                             ,IL,60638-1999,Proprietary  ,0,2,2,546,595,1141
02522801,FOX COLLEGE -  VET TECH INSTITUTE       ,IL,60477-4451,Proprietary  ,0,0,0,2,1,3
02527600,LEXINGTON COLLEGE                       ,IL,60607-0000,Private      ,1,0,1,98,112,210
02536700,BELL MAR BEAUTY COLLEGE                 ,IL,60650-0000,Proprietary  ,6,6,12,50,92,142
02556100,ENVIRONMENTAL TECHNICAL INSTITUTE       ,IL,60143-0000,Proprietary  ,7,35,42,145,512,657
02556600,NILES SCHOOL OF COSMETOLOGY             ,IL,60714-0000,Proprietary  ,1,3,4,20,61,81
02573700,INSTITUTE FOR CLINICAL SOCIAL WORK      ,IL,60605-1229,Private      ,0,3,3,54,339,393
02579200,INGALLS MEMORIAL HOSPITAL               ,IL,60426-0000,Private      ,0,0,0,2,20,22
02584900,"FIRST INSTITUTE, INC.                   ",IL,60014-7489,Proprietary  ,3,9,12,134,364,498
02587700,HAIR PROFESSIONALS CAREER COLLEGE       ,IL,60465-1929,Proprietary  ,6,10,16,54,139,193
02622700,KNOWLEDGE SYSTEMS INSTITUTE             ,IL,60076-0000,Private      ,0,0,0,1,11,12
03002000,HAIRMASTERS INST OF COSMETOLOGY         ,IL,61701-5547,Proprietary  ,8,6,14,67,118,185
03027702,PACIFIC COLLEGE OF ORIENTAL MEDICINE - C,IL,60613-4418,Proprietary  ,0,12,12,57,363,420
03065300,TREND SETTERS COLL OF COSMETOLOGY       ,IL,60915-0000,Proprietary  ,5,8,13,240,286,526
03072701,WESTWOOD COLLEGE - RIVER OAKS           ,IL,60409-5503,Proprietary  ,7,37,44,219,812,1031
03072702,WESTWOOD COLLEGE OF TECHNOLOGY          ,IL,60602-0000,Proprietary  ,4,47,51,415,1399,1814
03078400,CAMEO BEAUTY ACADEMY                    ,IL,60453-3196,Proprietary  ,6,11,17,66,118,184
03079200,WESTWOOD COLLEGE - DUPAGE               ,IL,60517-2321,Proprietary  ,3,26,29,258,715,973
03082900,ROSEL SCHOOL OF COSMETOLOGY             ,IL,60659-1913,Proprietary  ,0,11,11,57,162,219
03083800,HEARTLAND COMMUNITY COLLEGE             ,IL,61761-9446,Public       ,18,57,75,2778,2821,5599
03098000,ST JOHN'S COLLEGE OF NURSING            ,IL,62702-5321,Private      ,1,3,4,210,315,525
03098002,ST JOHN'S HOSP SCH MED TECH             ,IL,62769-5324,Private      ,0,0,0,38,131,169
03099700,CAIN'S BARBER COLLEGE                   ,IL,60615-3510,Proprietary  ,0,10,10,165,552,717
03099800,ILLINOIS SCHOOL OF HEALTH CAREERS       ,IL,60604-0000,Proprietary  ,1,15,16,569,1587,2156
03101800,ILLINOIS CENTER FOR BROADCASTING        ,IL,60148-7015,Proprietary  ,4,21,25,185,477,662
03128500,NATIONAL LATINO EDUCATION INSTITUTE     ,IL,60609-2205,Private      ,0,2,2,78,159,237
03199300,CHRISTIAN LIFE COLLEGE                  ,IL,60056-2522,Private      ,0,0,0,23,27,50
03368300,MIDWEST TECHNICAL INSTITUTE             ,IL,62707-8805,Proprietary  ,42,132,174,1220,4017,5237
03416300,COMPUTER SYSTEMS INSTITUTE              ,IL,60077-0000,Proprietary  ,47,182,229,471,1825,2296
03448300,BUSINESS INDUSTRIAL RESOURCES           ,IL,60659-1298,Proprietary  ,22,136,158,528,4466,4994
03455700,CORTIVA INSTITUTE - CHICAGO             ,IL,60602-3315,Proprietary  ,2,8,10,261,583,844
03455701,CORTIVA INSTITUTE - CHICAGO             ,IL,60014-6285,Proprietary  ,0,2,2,19,56,75
03490301,PAUL MITCHELL THE SCHOOL CHICAGO        ,IL,60607-0000,Proprietary  ,10,22,32,330,509,839
03490302,PAUL MITCHELL THE SCHOOL ESCANABA - PAUL,IL,60148-0000,Proprietary  ,3,6,9,3,9,12
03510300,ERIKSON INSTITUTE                       ,IL,60654-4510,Private      ,0,4,4,9,378,387
03643300,"MR. JOHN'S SCHOOL OF JACKSONVILLE,  INC,",IL,62650-3488,Proprietary  ,6,6,12,33,49,82
03655300,ILLINOIS CAREERPATH INSTITUTE           ,IL,60654-1103,Private      ,1,3,4,45,202,247
03684300,NORTHSHORE UNIVERSITY HEALTHSYSTEM SCHOO,IL,60201-9872,Private      ,0,0,0,10,61,71
03881400,EUROPEAN MASSAGE THERAPY SCHOOL         ,IL,60077-2269,Proprietary  ,0,11,11,26,198,224
03891300,SOMA INSTITUTE - THE NATIONAL SCHOOL OF ,IL,60604-4466,Proprietary  ,4,18,22,81,251,332
03914300,"CALC, INSTITUTE OF TECHNOLOGY           ",IL,62002-5931,Proprietary  ,5,15,20,68,295,363
04117500,SOLEX MEDICAL ACADEMY                   ,IL,60090-3104,Proprietary  ,0,2,2,8,52,60
04117600,LARRY'S BARBER COLLEGE                  ,IL,60628-2322,Proprietary  ,1,22,23,197,628,825
04118400,ZAREM /GOLDE ORT TECHNICAL INSTITUTE    ,IL,60077-3210,Private      ,5,35,40,47,316,363
04124700,AMBRIA COLLEGE OF NURSING               ,IL,60192-3712,Proprietary  ,3,46,49,88,666,754
04136900,UNIVERSITY OF AESTHETICS (THE)          ,IL,60622-2151,Proprietary  ,2,4,6,30,105,135
04137000,UNIVERSITY OF AESTHETICS & COSMETOLOGY (,IL,60515-4607,Proprietary  ,1,2,3,23,54,77
04137500,TRICOCI UNIVERSITY OF BEAUTY CULTURE    ,IL,60656-1805,Proprietary  ,15,15,30,318,456,774
04139000,MIDWESTERN CAREER COLLEGE               ,IL,60606-3103,Proprietary  ,4,61,65,140,852,992
04141000,AVEDA INSTITUTE CHICAGO                 ,IL,60647-0000,Proprietary  ,13,18,31,287,534,821
04147100,TRICOCI UNIVERSITY OF BEAUTY CULTURE    ,IL,60048-2906,Proprietary  ,2,5,7,112,144,256
04147200,TRICOCI UNIVERSITY OF BEAUTY CULTURE    ,IL,60455-1824,Proprietary  ,5,6,11,135,222,357
04147300,TRICOCI UNIVERSITY OF BEAUTY CULTURE    ,IL,60139-3119,Proprietary  ,8,8,16,160,167,327
04147400,TRICOCI UNIVERSITY OF BEAUTY CULTURE    ,IL,61614-4831,Proprietary  ,4,6,10,95,180,275
04147500,TRICOCI UNIVERSITY OF BEAUTY CULTURE    ,IL,61108-2337,Proprietary  ,10,17,27,134,250,384
04160600,PAUL MITCHELL THE SCHOOL NORMAL         ,IL,61761-0000,Proprietary  ,2,3,5,185,189,374
04167800,INNOVATIONS DESIGN ACADEMY              ,IL,61520-2625,Proprietary  ,1,2,3,31,82,113
04168500,SOLEX COLLEGE                           ,IL,60090-3192,Proprietary  ,4,93,97,26,447,473
04170800,UNITY COSMETOLOGY COLLEGE               ,IL,61764-9652,Proprietary  ,3,4,7,31,65,96
04171600,SALON PROFESSIONAL ACADEMY OF ELGIN (THE,IL,60123-2319,Proprietary  ,1,4,5,29,95,124
04172200,NORTHWESTERN INSTITUTE OF HEALTH AND TEC,IL,60640-4785,Private      ,0,0,0,219,604,823
04174900,SKIN CARE AND SPA INSTITUTE             ,IL,60077-2200,Proprietary  ,2,12,14,19,158,177
04175000,UNIVERSAL SPA TRAINING ACADEMY          ,IL,60515-0000,Proprietary  ,2,10,12,30,157,187
04175800,J RENEE CAREER FACILITATION             ,IL,60014-7986,Proprietary  ,1,6,7,20,150,170
04179100,PCCTI  IT & HEALTHCARE                  ,IL,60523-0000,Proprietary  ,2,22,24,43,569,612
04179101,PCCTI  IT & HEALTHCARE -                ,IL,60606-0000,Proprietary  ,0,10,10,31,260,291
04186000,CHICAGO SCHOOL FOR PIANO TECHNOLOGY (THE,IL,60612-1630,Private      ,0,0,0,19,60,79
04187400,COSMETOLOGY CONCEPTS                    ,IL,60452-2501,Proprietary  ,9,19,28,140,311,451
04189200,SALON PROFESSIONAL ACADEMY (THE)        ,IL,60404-8789,Proprietary  ,2,4,6,45,96,141
04189400,SHEAR LEARNING ACADEMY OF COSMETOLOGY   ,IL,62523-1208,Proprietary  ,0,2,2,28,51,79
04189600,STATE CAREER SCHOOL                     ,IL,60085-5129,Proprietary  ,1,6,7,58,197,255
04192000,CURVE METRIC SCHOOL OF HAIR DESIGN      ,IL,60707-1118,Proprietary  ,0,6,6,16,45,61
04195600,TRIBECA FLASHPOINT MEDIA ARTS ACADEMY   ,IL,60602-2716,Proprietary  ,5,6,11,355,271,626
04224400,NETWORKS BARBER COLLEGE                 ,IL,60409-3401,Proprietary  ,1,3,4,7,37,44
04224500,TRENZ BEAUTY ACADEMY                    ,IL,60409-0000,Proprietary  ,0,5,5,9,59,68
04225300,CREATIVE TOUCH COSMETOLOGY SCHOOL       ,IL,62298-1609,Proprietary  ,1,0,1,1,4,5
04227900,MORTHLAND COLLEGE                       ,IL,62896-2742,Private      ,1,1,2,19,7,26
04229900,DEBUTANTES SCHOOL OF COSMETOLOGY AND NAI,IL,60115-3301,Proprietary  ,5,2,7,8,8,16
00195100,ALICE LLOYD COLLEGE                     ,KY,41844-9703,Private      ,1,5,6,1325,287,1612
00195200,ASBURY COLLEGE                          ,KY,40390-1198,Private      ,3,3,6,1817,835,2652
00195300,ASBURY THEOLOGICAL SEMINARY             ,KY,40390-0000,Private      ,0,9,9,35,1461,1496
00195400,BELLARMINE UNIVERSITY                   ,KY,40205-1877,Private      ,12,82,94,5451,2616,8067
00195500,BEREA COLLEGE                           ,KY,40403-0000,Private      ,6,6,12,3377,1016,4393
00195800,BRESCIA UNIVERSITY                      ,KY,42301-3023,Private      ,1,19,20,1174,1112,2286
00195900,CAMPBELLSVILLE UNIVERSITY               ,KY,42718-2799,Private      ,8,23,31,3050,2053,5103
00196000,SPALDING UNIVERSITY                     ,KY,40203-2188,Private      ,8,52,60,1582,3538,5120
00196100,CENTRE COLLEGE                          ,KY,40422-1394,Private      ,3,4,7,2733,175,2908
00196200,UNIVERSITY OF THE CUMBERLANDS           ,KY,40769-1372,Private      ,5,82,87,2950,3723,6673
00196300,EASTERN KENTUCKY UNIVERSITY             ,KY,40475-3102,Public       ,65,216,281,14722,12011,26733
00196400,GEORGETOWN COLLEGE                      ,KY,40324-1628,Private      ,3,28,31,2325,868,3193
00196500,KENTUCKY CHRISTIAN UNIVERSITY           ,KY,41143-2205,Private      ,1,3,4,927,297,1224
00196800,KENTUCKY STATE UNIVERSITY               ,KY,40601-2355,Public       ,14,29,43,3926,2408,6334
00196900,KENTUCKY WESLEYAN COLLEGE               ,KY,42301-6057,Private      ,4,5,9,1329,475,1804
00197100,LEXINGTON THEOLOGICAL SEMINARY          ,KY,40508-0000,Private      ,0,3,3,8,129,137
00197200,LINDSEY WILSON COLLEGE                  ,KY,42728-1223,Private      ,2,21,23,3294,2047,5341
00197400,LOUISVILLE PRESBYTERIAN THEOL SEM       ,KY,40205-0000,Private      ,1,2,3,10,212,222
00197500,MIDWAY COLLEGE                          ,KY,40347-1120,Private      ,2,23,25,688,2054,2742
00197600,MOREHEAD STATE UNIVERSITY               ,KY,40351-1689,Public       ,69,120,189,9178,6113,15291
00197700,MURRAY STATE UNIVERSITY                 ,KY,42071-0009,Public       ,29,70,99,8828,5021,13849
00197900,WEST KENTUCKY CMNTY & TECHNICAL COLG    ,KY,42002-7380,Public       ,41,113,154,2427,5183,7610
00198000,UNIVERSITY OF PIKEVILLE                 ,KY,41501-1194,Private      ,1,11,12,2541,1523,4064
00198300,ST. CATHARINE COLLEGE                   ,KY,40061-9499,Private      ,1,12,13,834,515,1349
00198700,TRANSYLVANIA UNIVERSITY                 ,KY,40508-1797,Private      ,1,3,4,2183,375,2558
00198800,UNION COLLEGE                           ,KY,40906-1499,Private      ,6,29,35,1464,1003,2467
00198900,UNIVERSITY OF KENTUCKY                  ,KY,40506-0054,Public       ,85,107,192,26226,11582,37808
00198901,UNIV OF KY-COLLEGE OF DENTISTRY         ,KY,40536-0000,Public       ,0,2,2,55,309,364
00198902,UNIV OF KY-COLLEGE OF MEDICINE          ,KY,40536-0000,Public       ,1,6,7,158,661,819
00199000,ASHLAND COMMUNITY AND TECHNICAL COLLEGE ,KY,41101-3683,Public       ,21,89,110,1687,3612,5299
00199100,ELIZABETHTOWN COMMUNITY  AND TECHNICAL C,KY,42701-3081,Public       ,36,164,200,2962,6635,9597
00199300,HENDERSON COMMUNITY COLLEGE             ,KY,42420-4699,Public       ,14,57,71,670,1838,2508
00199400,HOPKINSVILLE COMMUNITY COLLEGE          ,KY,42241-2621,Public       ,17,133,150,1238,4859,6097
00199600,BIG SANDY COMMUNITY AND TECHNICAL COLG  ,KY,41653-1815,Public       ,12,75,87,2362,3729,6091
00199700,SOMERSET COMMUNITY COLLEGE              ,KY,42501-2973,Public       ,35,149,184,3510,8223,11733
00199800,SOUTHEAST KENTUCKY COMMUNITY AND TECHNIC,KY,40823-1099,Public       ,14,48,62,1543,2759,4302
00199900,UNIVERSITY OF LOUISVILLE                ,KY,40292-0000,Public       ,57,195,252,18043,15136,33179
00200100,THOMAS MORE COLLEGE                     ,KY,41017-3495,Private      ,1,46,47,1626,934,2560
00200200,WESTERN KENTUCKY UNIVERSITY             ,KY,42101-3576,Public       ,85,156,241,17991,11309,29300
00461800,SPENCERIAN COLLEGE                      ,KY,40216-2605,Proprietary  ,19,71,90,741,2043,2784
00461900,SULLIVAN UNIVERSITY                     ,KY,40205-3000,Proprietary  ,85,339,424,2536,7466,10002
00493402,DAYMAR COLLEGE - BOWLING GREEN          ,KY,42101-4063,Proprietary  ,1,15,16,145,556,701
00493403,DAYMAR COLLEGE - CLINTON                ,KY,42031-9998,Proprietary  ,0,0,0,1,42,43
00493406,DAYMAR COLLEGE - RUSSELLVILLE           ,KY,42276-1622,Proprietary  ,1,4,5,25,131,156
00524400,BLUEGRASS COMMUNITY & TECHNICAL COLLEGE ,KY,40506-0235,Public       ,49,255,304,6633,12381,19014
00527100,BOWLING GREEN TECHNICAL COLLEGE         ,KY,42101-3601,Public       ,24,73,97,2158,4516,6674
00527300,GATEWAY COMMUNITY & TECHNOLOGY COLL     ,KY,41011-0000,Public       ,27,140,167,1761,5128,6889
00696000,MAYSVILLE CMNTY & TECHNCL COLG          ,KY,41056-8910,Public       ,32,77,109,1494,3840,5334
00696100,JEFFERSON COMMUNITY AND TECHNICAL COLLEG,KY,40202-2005,Public       ,82,293,375,7877,16748,24625
00696200,HAZARD COMMUNITY COLLEGE                ,KY,41701-2402,Public       ,15,41,56,1621,2994,4615
00696203,KY TECH-KNOTT CO. TECHNOLOGY CTR        ,KY,41822-0000,Public       ,0,2,2,12,23,35
00696204,KY TECH-LESLIE COUNTY AREA TECH CTR     ,KY,41749-0000,Public       ,0,0,0,6,24,30
00696205,KY TECH-LEE COUNTY AREA TECH CTR        ,KY,41311-0000,Public       ,0,0,0,5,17,22
00696206,KY TECH-LETCHER CNTY AREA TECH CTR      ,KY,41858-0000,Public       ,1,2,3,32,92,124
00696207,KY TECH-BREATHITT COUNTY VOC ED CTR     ,KY,41339-0000,Public       ,0,2,2,38,94,132
00736205,MEDTECH COLLEGE - LEXINGTON             ,KY,40511-1200,Proprietary  ,6,45,51,160,997,1157
00757303,EMPIRE BEAUTY SCHOOL - HURSTBOURNE      ,KY,40291-1931,Proprietary  ,0,0,0,119,344,463
00757305,EMPIRE BEAUTY SCHOOL - DIXIE            ,KY,40216-4212,Proprietary  ,0,0,0,72,182,254
00842500,DAYMAR COLLEGE                          ,KY,42001-0000,Proprietary  ,3,14,17,61,396,457
00901000,MADISONVILLE COMMUNITY COLLEGE          ,KY,42431-9199,Public       ,12,51,63,1285,2831,4116
00927500,NORTHERN KENTUCKY UNIVERSITY            ,KY,41099-0001,Public       ,21,107,128,11554,8681,20235
00931300,DAYMAR COLLEGE                          ,KY,42301-5830,Proprietary  ,10,83,93,169,1659,1828
00931302,DAYMAR COLLEGE - LOUISVILLE             ,KY,40219-1973,Proprietary  ,2,12,14,139,694,833
00931304,DAYMAR COLLEGE - ALBANY                 ,KY,42602-1235,Proprietary  ,0,0,0,8,15,23
00931305,DAYMAR COLLEGE - BELLEVUE               ,KY,41073-2416,Proprietary  ,0,2,2,21,83,104
00931308,DAYMAR COLLEGE -  SCOTTSVILLE           ,KY,42164-1505,Proprietary  ,0,5,5,9,75,84
00931309,DAYMAR COLLEGE - LOUISVILLE EAST        ,KY,40245-1629,Proprietary  ,0,8,8,56,330,386
00931310,DAYMAR COLLEGE -  MADISONVILLE          ,KY,42431-0000,Proprietary  ,0,4,4,24,199,223
00945913,EMPIRE BEAUTY SCHOOL - FLORENCE         ,KY,41042-5113,Proprietary  ,0,0,0,81,204,285
01042400,SALON PROFESSIONAL ACADEMY THE          ,KY,40502-0000,Proprietary  ,7,31,38,163,426,589
01048901,NATIONAL COLLEGE - FLORENCE CAMPUS      ,KY,41042-1812,Proprietary  ,0,3,3,36,358,394
01048902,NATIONAL COLLEGE - PIKEVILLE CAMPUS     ,KY,41501-1518,Proprietary  ,1,13,14,186,608,794
01048903,NATIONAL COLLEGE - DANVILLE CAMPUS      ,KY,40422-1517,Proprietary  ,4,10,14,69,418,487
01048904,NATIONAL COLLEGE - RICHMOND CAMPUS      ,KY,40475-2309,Proprietary  ,1,12,13,73,506,579
01048906,NATIONAL COLLEGE - LOUISVILLE CAMPUS    ,KY,40216-4147,Proprietary  ,2,32,34,132,1086,1218
01048907,NATIONAL COLLEGE - LEXINGTON CAMPUS     ,KY,40509-2256,Proprietary  ,1,17,18,126,937,1063
01054210,EMPIRE BEAUTY SCHOOL - CHENOWETH        ,KY,40207-2695,Proprietary  ,0,0,0,69,151,220
01172500,COLLINS SCHOOL OF COSMETOLOGY           ,KY,40965-2809,Proprietary  ,2,5,7,35,106,141
01208800,SULLIVAN COLLEGE OF TECHNOLOGY AND DESIG,KY,40218-4528,Proprietary  ,20,41,61,642,1122,1764
01212801,SOUTHWESTERN COLLEGE                    ,KY,41042-1466,Proprietary  ,0,1,1,74,298,372
01260609,EMPIRE BEAUTY SCHOOL - HIGHLAND         ,KY,40204-1317,Proprietary  ,0,0,0,60,170,230
01272300,KY TECH-WAYNE COUNTY AREA TECH CTR      ,KY,42633-1088,Public       ,0,0,0,3,10,13
01291700,EMPIRE BEAUTY SCHOOL                    ,KY,42701-2949,Proprietary  ,0,0,0,75,175,250
02159100,"APPALACHIAN BEAUTY SCHOOL, INC.         ",KY,41503-0000,Proprietary  ,0,2,2,39,66,105
02251500,TREND SETTERS ACAD OF BEAUTY CULT       ,KY,40258-0000,Proprietary  ,4,21,25,80,334,414
02275000,JENNY LEA ACADEMY OF COSMETOLOGY        ,KY,40831-0000,Proprietary  ,5,18,23,98,351,449
02284306,INTERACTIVE LEARNING SYSTEMS            ,KY,41042-0000,Proprietary  ,1,17,18,19,124,143
02323700,PAT WILSON'S BEAUTY COLLEGE             ,KY,42420-0000,Proprietary  ,1,6,7,17,108,125
02337200,PJ'S COLLEGE OF COSMETOLOGY             ,KY,42101-0000,Proprietary  ,4,31,35,137,596,733
02340800,PAUL MITCHELL THE SCHOOL LEXINGTON      ,KY,40514-1545,Proprietary  ,9,20,29,247,439,686
02351700,PAUL MITCHELL THE SCHOOL - LOUISVILLE   ,KY,40222-0000,Proprietary  ,4,12,16,247,407,654
02491100,BECKFIELD COLLEGE                       ,KY,41042-0000,Proprietary  ,23,170,193,380,2940,3320
02518900,BARRETT & COMPANY SCH HAIR DESIGN       ,KY,40356-0000,Proprietary  ,2,9,11,49,208,257
02526100,JENNY LEA ACADEMY OF COSMETOLOGY        ,KY,41858-0000,Proprietary  ,1,1,2,31,78,109
02535600,CLEAR CREEK BAPTIST BIBLE COLLEGE       ,KY,40977-0000,Private      ,0,1,1,47,151,198
02551100,PJ'S COLLEGE OF COSMETOLOGY             ,KY,42141-2434,Proprietary  ,0,7,7,40,143,183
02560800,SOUTHEAST SCHOOL OF COSMETOLOGY         ,KY,40962-0000,Proprietary  ,0,4,4,19,100,119
02576200,MID-CONTINENT UNIVERSITY                ,KY,42066-9007,Private      ,0,3,3,481,4012,4493
03002100,KENTUCKY MOUNTAIN BIBLE COLLEGE         ,KY,41385-0010,Private      ,1,1,2,58,48,106
03007000,FRONTIER SCH OF MIDWIFERY&FAMILY NU     ,KY,41749-0000,Private      ,0,23,23,10,2220,2230
03026200,HEAD'S WEST KENTUCKY BEAUTY COLLEGE     ,KY,42431-0000,Proprietary  ,0,2,2,24,96,120
03029200,NU-TEK ACADEMY OF BEAUTY                ,KY,40353-9767,Proprietary  ,0,2,2,26,72,98
03034500,OWENSBORO COMMUNITY & TECHNICAL COLLEGE ,KY,42303-1899,Public       ,23,67,90,1939,3667,5606
03083700,GALEN HEALTH INSTITUTES                 ,KY,40207-1047,Proprietary  ,8,46,54,1009,6443,7452
03103500,MR JIM'S BEAUTY COLLEGE                 ,KY,42301-2646,Proprietary  ,0,0,0,20,40,60
03516500,EZELL'S COSMETOLOGY SCHOOL              ,KY,42071-2530,Proprietary  ,0,0,0,39,88,127
03611300,BRIGHTON CENTER'S CENTER FOR EMPLOY     ,KY,41071-1968,Private      ,3,23,26,17,152,169
03804300,BELLEFONTE ACADEMY OF BEAUTY            ,KY,41169-2015,Proprietary  ,3,20,23,38,244,282
03885300,EMPLOYMENT SOLUTIONS                    ,KY,40517-3260,Private      ,7,34,41,94,574,668
03886300,REGENCY SCHOOL OF HAIR DESIGN           ,KY,41653-1278,Proprietary  ,0,1,1,28,108,136
04038300,ATA CAREER EDUCATION                    ,KY,40223-3832,Proprietary  ,13,63,76,292,1344,1636
04051316,ART INSTITUTE OF PHOENIX (THE) - ATS - (,KY,41017-2136,Proprietary  ,2,27,29,143,696,839
04051319,ART INSTITUTE OF PHOENIX (THE) - BROWN M,KY,40219-1916,Proprietary  ,3,6,9,210,729,939
04051320,ART INSTITUTE OF PHOENIX (THE) - BROWN M,KY,42240-3579,Proprietary  ,3,16,19,56,261,317
04123900,LEXINGTON HEALING ARTS ACADEMY          ,KY,40503-1932,Proprietary  ,0,5,5,76,246,322
04177600,LINDSEY INSTITUTE OF COSMETOLOGY        ,KY,42103-8036,Proprietary  ,1,6,7,84,164,248
04177700,TRI-STATE INSTITUTE OF HAIR DESIGN      ,KY,40744-5234,Proprietary  ,3,10,13,41,137,178
04178000,SIMMONS COLLEGE OF KENTUCKY             ,KY,40203-3322,Private      ,1,5,6,45,218,263
04229300,MEDQUEST COLLEGE                        ,KY,40243-1882,Proprietary  ,11,32,43,22,70,92
00200300,CENTENARY COLLEGE OF LOUISIANA          ,LA,71104-3396,Private      ,3,6,9,1003,397,1400
00200400,DILLARD UNIVERSITY                      ,LA,70122-3097,Private      ,91,39,130,2933,1651,4584
00200500,NICHOLLS STATE UNIVERSITY               ,LA,70310-0001,Public       ,30,97,127,6496,3507,10003
00200600,GRAMBLING STATE UNIVERSITY              ,LA,71245-2215,Public       ,144,101,245,6662,4787,11449
00200700,LOUISIANA COLLEGE                       ,LA,71359-0000,Private      ,4,61,65,1402,942,2344
00200800,LOUISIANA TECH UNIVERSITY               ,LA,71272-0001,Public       ,91,102,193,8381,3823,12204
00201000,LOUISIANA STATE UNIV & A&M COLG         ,LA,70803-5710,Public       ,115,147,262,28738,10132,38870
00201100,LOUISIANA STATE UNIV-ALEXANDRIA         ,LA,71302-9121,Public       ,21,62,83,2146,2342,4488
00201200,LOUISIANA STATE UNIV-EUNICE             ,LA,70535-6726,Public       ,20,36,56,2427,2123,4550
00201300,LOUISIANA STATE UNIV-SHREVEPORT         ,LA,71115-2399,Public       ,38,178,216,3331,4615,7946
00201400,LA STATE UNIV HEALTH SCIENCES CTR       ,LA,70112-2223,Public       ,4,51,55,751,2924,3675
00201500,(THE) UNIVERSITY OF NEW ORLEANS         ,LA,70148-0001,Public       ,61,163,224,7835,8610,16445
00201600,LOYOLA UNIVERSITY NEW ORLEANS           ,LA,70118-6195,Private      ,19,58,77,5559,3574,9133
00201700,MCNEESE STATE UNIVERSITY                ,LA,70609-4510,Public       ,43,73,116,6204,4535,10739
00201900,NEW ORLEANS BAPTIST THEOL SEMINARY      ,LA,70126-0000,Private      ,0,6,6,60,330,390
00202000,UNIVERSITY OF LOUISIANA AT MONROE       ,LA,71209-9001,Public       ,76,122,198,7728,5648,13376
00202100,NORTHWESTERN STATE UNIVERSITY           ,LA,71497-0001,Public       ,65,221,286,6699,6997,13696
00202200,NOTRE DAME SEMINARY                     ,LA,70118-0000,Private      ,0,1,1,19,44,63
00202300,OUR LADY OF HOLY CROSS COLLEGE          ,LA,70131-7399,Private      ,5,34,39,679,1678,2357
00202400,SOUTHEASTERN LOUISIANA UNIV             ,LA,70402-0001,Public       ,145,141,286,12707,6742,19449
00202500,SOUTHERN UNIVERSITY A & M COLLEGE       ,LA,70813-9374,Public       ,127,135,262,8535,8155,16690
00202600,SOUTHERN UNIV NEW ORLEANS               ,LA,70126-0002,Public       ,38,113,151,2795,5679,8474
00202700,ST JOSEPH SEMINARY COLLEGE              ,LA,70457-9990,Private      ,0,0,0,61,22,83
00202900,TULANE UNIVERSITY                       ,LA,70118-5698,Private      ,33,111,144,12760,8348,21108
00203100,UNIV OF LOUISIANA AT LAFAYETTE          ,LA,70504-0001,Public       ,113,115,228,15581,7374,22955
00203200,XAVIER UNIVERSITY OF LOUISIANA          ,LA,70125-1098,Private      ,48,28,76,5385,2334,7719
00462100,AYERS CAREER COLLEGE                    ,LA,71108-5845,Proprietary  ,4,35,39,116,678,794
00462500,DELGADO COMMUNITY COLLEGE               ,LA,70119-0000,Public       ,128,506,634,10086,21005,31091
00546600,LOUISIANA TECHNICAL COLLEGE - T. H.  HAR,LA,70570-6113,Public       ,0,0,0,290,523,813
00546700,SOWELA TECHNICAL COMMUNITY COLLEGE      ,LA,70616-6950,Public       ,34,102,136,1705,2687,4392
00546702,SOWELA TECHNICAL COMMUNITY COLLEGE - MOR,LA,70546-1327,Public       ,3,12,15,98,176,274
00546800,LOUISIANA TECHNICAL COLLEGE - ACADIAN CA,LA,70526-3215,Public       ,0,0,0,93,226,319
00547100,NORTHEAST LOUISIANA TECHNICAL COLLEGE   ,LA,71292-9064,Public       ,0,0,0,287,740,1027
00547101,NORTHEAST LOUISIANA TECHNICAL COLLEGE   ,LA,71241-0000,Public       ,0,0,0,9,14,23
00547102,NORTHEAST LOUISIANA TECHNICAL COLLEGE   ,LA,71270-0000,Public       ,0,0,0,165,343,508
00547103,NORTHEAST LOUISIANA TECHNICAL COLLEGE   ,LA,71295-0000,Public       ,0,0,0,78,186,264
00547104,NORTHEAST LOUISIANA TECHNICAL COLLEGE   ,LA,71220-0000,Public       ,0,0,0,62,161,223
00548000,"LOUISIANA TECHNICAL COLLEGE, HUEY P. LON",LA,71483-3599,Public       ,0,0,0,127,242,369
00548200,LOUISIANA TECHNICAL COLLEGE - GULF AREA ,LA,70510-0878,Public       ,1,1,2,131,279,410
00548400,LOUISIANA TECHNICAL COLLEGE - EVANGELINE,LA,70582-3104,Public       ,0,0,0,40,173,213
00548800,CAPITAL AREA TECHNICAL COLLEGE          ,LA,70807-0000,Public       ,11,45,56,694,1539,2233
00548805,LA TECH COLLEGE-AVOYELLES CAMPUS        ,LA,71327-0000,Public       ,0,0,0,86,215,301
00548808,LOUISIANA TECHNICAL COLLEGE - CHARLES B.,LA,70586-0296,Public       ,0,0,0,93,167,260
00548812,LOUISIANA TECH COLG-FOLKES CAMPUS       ,LA,70748-0000,Public       ,1,6,7,43,81,124
00548817,LOUISIANA TEC CLG-JUMONVILLE MEM CP     ,LA,70760-0000,Public       ,1,5,6,36,75,111
00548818,LOUISIANA TECHNICAL COLLEGE - LAFAYETTE ,LA,70502-4909,Public       ,0,3,3,478,1007,1485
00548820,LOUISIANA TEC CLG-LAMAR SALTER CMPS     ,LA,71446-0000,Public       ,0,0,0,94,357,451
00548828,LA TECHNICAL COLG-OAKDALE CMPS          ,LA,71463-0000,Public       ,0,0,0,79,118,197
00548832,LOUISIANA TECH COLG-SHELBY JACKSON      ,LA,71334-0000,Public       ,0,0,0,95,248,343
00548838,LOUISIANA TECHNICAL COLG - TALLULAH     ,LA,71284-0000,Public       ,0,0,0,50,90,140
00548839,LOUISIANA TECHNICAL COLLEGE - TECHE AREA,LA,70562-1057,Public       ,1,1,2,227,390,617
00548842,LOUISIANA TECHNICAL COLLEGE - WESTSIDE C,LA,70765-0733,Public       ,0,2,2,41,107,148
00548900,CENTRAL LOUISIANA TECHNICAL COLLEGE     ,LA,71302-3137,Public       ,23,55,78,307,839,1146
00552600,SOUTH CENTRAL LOUISIANA TECHNICAL COLG  ,LA,70381-2148,Public       ,1,21,22,153,420,573
00552602,SOUTH CENTRAL LOUISIANA TECHNICAL COLG  ,LA,70302-4336,Public       ,3,4,7,125,267,392
00552603,SOUTH CENTRAL LOUISIANA TECHNICAL COLG  ,LA,70084-6632,Public       ,7,25,32,428,719,1147
00576100,L. E. FLETCHER TECHNICAL COMMUNITY COLLE,LA,70360-2863,Public       ,17,37,54,1293,1670,2963
00675600,NORTHSHORE TECHNICAL COLLEGE            ,LA,70427-5866,Public       ,28,56,84,395,894,1289
00675603,NORTHSHORE TECHNICAL COLLEGE - HAMMOND  ,LA,70401-0000,Public       ,16,27,43,594,1024,1618
00675604,NORTHSHORE TECHNICAL COLLEGE - FLORIDA  ,LA,70441-0000,Public       ,5,9,14,211,306,517
00768600,SOUTHERN UNIV AT SHREVEPORT/BOSSIER     ,LA,71107-4795,Public       ,60,91,151,1998,3985,5983
00806700,LSU HEALTH SCIENCES CENTR-SHREVEPOR     ,LA,71130-3932,Public       ,6,25,31,381,1248,1629
00989800,DEMMON SCHOOL OF BEAUTY                 ,LA,70607-2128,Proprietary  ,1,2,3,37,134,171
00997500,NORTHWEST LOUISIANA TECHNICAL COLLEGE   ,LA,71055-2422,Public       ,16,22,38,247,623,870
00997503,NORTHWEST LOUISIANA TECHNICAL COLLEGE   ,LA,71137-8527,Public       ,13,57,70,391,1457,1848
00997504,NORTHWEST LOUISIANA TECHNICAL COLLEGE   ,LA,71052-1236,Public       ,3,11,14,80,204,284
00997505,NORTHWEST LOUISIANA TECHNICAL COLLEGE   ,LA,71449-0790,Public       ,4,7,11,41,143,184
00997506,NORTHWEST LOUISIANA TECHNICAL COLLEGE   ,LA,71458-0657,Public       ,7,13,20,218,436,654
01005701,AMERICAN COMMERCIAL COLLEGE             ,LA,71105-2502,Proprietary  ,0,0,0,6,22,28
01109700,CLOYD'S BEAUTY SCHOOL #1                ,LA,71291-3131,Proprietary  ,5,4,9,50,151,201
01163100,"D-JAY'S SCHL OF BEAUTY, ARTS & SCI      ",LA,70806-0000,Proprietary  ,0,2,2,77,205,282
01184100,JOHN JAY BEAUTY COLLEGE                 ,LA,70124-2592,Proprietary  ,2,9,11,141,324,465
01282300,PAT GOINS RUSTON BEAUTY SCHOOL          ,LA,71270-4301,Proprietary  ,0,1,1,31,70,101
01287900,PAT GOINS BENTON ROAD BEAUTY SCHOOL     ,LA,71111-4838,Proprietary  ,2,4,6,31,146,177
01288000,CELEBRITY STYLIST BEAUTY SCHOOL         ,LA,71201-5167,Proprietary  ,3,3,6,44,94,138
02055400,BOSSIER PARISH COMMUNITY COLLEGE        ,LA,71111-0000,Public       ,108,257,365,4199,7764,11963
02055500,DELTA SCH OF BUSINESS & TECHNOLOGY      ,LA,70601-0000,Proprietary  ,1,14,15,134,511,645
02117800,AVEDA INSTITUTE LAFAYETTE               ,LA,70503-3246,Proprietary  ,3,14,17,198,280,478
02166100,NUNEZ COMMUNITY COLLEGE                 ,LA,70043-0000,Public       ,25,89,114,917,2411,3328
02166200,ITI TECHNICAL COLLEGE                   ,LA,70817-0000,Proprietary  ,23,65,88,613,1214,1827
02197500,BATON ROUGE SCHOOL OF COMPUTERS         ,LA,70809-8188,Proprietary  ,4,8,12,73,192,265
02234000,CAMERON COLLEGE                         ,LA,70119-0000,Proprietary  ,6,39,45,120,509,629
02253901,BERKS TECHNICAL INSTITUTE - CAREER TECHN,LA,71021-6126,Proprietary  ,0,0,0,224,800,1024
02253902,BERKS TECHNICAL INSTITUTE - CAREER TECHN,LA,71105-2405,Proprietary  ,0,0,0,192,669,861
02258400,AVEDA INSTITUTE BATON ROUGE             ,LA,70816-2246,Proprietary  ,6,15,21,298,423,721
02260200,DIESEL DRIVING ACADEMY                  ,LA,71109-5617,Proprietary  ,8,57,65,83,552,635
02265600,JOHN JAY KENNER ACADEMY                 ,LA,70062-0000,Proprietary  ,0,9,9,34,139,173
02269300,STEVENSON'S ACADEMY OF HAIR DESIGN      ,LA,70116-0000,Proprietary  ,2,7,9,94,300,394
02327800,PINEVILLE BEAUTY SCHOOL                 ,LA,71360-0000,Proprietary  ,1,0,1,52,130,182
02335700,BATON ROUGE GENERAL MEDICAL CENTER      ,LA,70806-3889,Private      ,2,4,6,104,237,341
02335701,BATON ROUGE GEN MED CTR SCH NSG         ,LA,70821-0000,Private      ,3,6,9,109,390,499
02335702,BATON ROUGE GEN MED CTR-RAD TECH        ,LA,70806-0000,Private      ,0,5,5,78,183,261
02338000,"CLOYD'S BEAUTY SCHOOL #2, INC           ",LA,71202-3539,Proprietary  ,5,2,7,59,146,205
02352500,"CLOYD'S BEAUTY SCHOOL #3, INC           ",LA,71201-3211,Proprietary  ,4,7,11,58,167,225
02358600,"STAGE ONE THE HAIR SCHOOL, INC.         ",LA,70605-0000,Proprietary  ,4,8,12,122,211,333
02518300,SOUTH LOUISIANA BEAUTY COLLEGE          ,LA,70363-0000,Proprietary  ,1,3,4,52,82,134
02536400,LOUISIANA ACADEMY OF BEAUTY             ,LA,70535-0000,Proprietary  ,1,3,4,41,79,120
02538300,DELTA COLLEGE OF ARTS & TECH INC        ,LA,70806-1529,Proprietary  ,9,30,39,298,973,1271
02538301,DELTA COLLEGE OF ARTS & TECHNOLOGY - LAF,LA,70508-6831,Proprietary  ,4,19,23,156,518,674
02548500,COSMETOLOGY TRAINING CENTER             ,LA,70503-0000,Proprietary  ,2,3,5,123,182,305
02554800,VANGUARD COLLEGE OF COSMETOLOGY         ,LA,70458-8823,Proprietary  ,7,14,21,272,316,588
02582200,"GUY'S ACADEMY HAIR, SKIN & NAILS        ",LA,71105-2404,Proprietary  ,0,7,7,54,242,296
02600900,AVEDA INSTITUTE                         ,LA,70433-2922,Proprietary  ,94,101,195,1522,2424,3946
02601000,AMERICAN SCHOOL OF BUSINESS             ,LA,71105-5646,Proprietary  ,3,13,16,51,229,280
02601100,OPELOUSAS SCHOOL OF COSMETOLOGY         ,LA,70570-6156,Proprietary  ,4,2,6,29,62,91
02617100,BATON ROUGE COLLEGE                     ,LA,70806-1725,Proprietary  ,0,0,0,163,219,382
02619200,DENHAM SPRINGS BEAUTY COLLEGE           ,LA,70726-3829,Proprietary  ,7,5,12,82,116,198
03010400,CRESCENT CITY SCH GAMING & BARTENDG     ,LA,70119-5507,Proprietary  ,14,121,135,142,1159,1301
03010624,VIRGINIA COLLEGE - BATON ROUGE          ,LA,70815-8604,Proprietary  ,5,16,21,163,617,780
03023500,CAMELOT CAREER COLLEGE                  ,LA,70805-7539,Proprietary  ,18,43,61,145,443,588
03026514,REMINGTON COLLEGE - LAFAYETTE           ,LA,70508-5760,Private      ,4,10,14,139,335,474
03026515,REMINGTON COLLEGE - BATON ROUGE         ,LA,70816-4040,Private      ,4,12,16,209,565,774
03027300,BLALOCK'S PROFESSIONAL BEAUTY COLLEGE   ,LA,71108-3246,Proprietary  ,3,6,9,5,14,19
03030900,DIESEL DRIVING ACADEMY                  ,LA,70815-8109,Proprietary  ,10,88,98,86,929,1015
03095100,GRETNA CAREER COLLEGE                   ,LA,70053-2436,Proprietary  ,0,0,0,6,13,19
03106200,OUR LADY OF THE LAKE COLLEGE            ,LA,70808-4345,Private      ,13,75,88,1255,2341,3596
03294300,BLUE CLIFF SCH THERAPEUTIC MASSAGE      ,LA,70002-3458,Proprietary  ,69,331,400,744,3007,3751
03294303,BLUE CLIFF COLLEGE - LAFAYETTE          ,LA,70508-3256,Proprietary  ,3,8,11,246,714,960
03294306,BLUE CLIFF COLLEGE - SHREVEPORT         ,LA,71105-6520,Proprietary  ,5,8,13,152,717,869
03332600,DELTA COLLEGE                           ,LA,70433-9042,Proprietary  ,3,14,17,201,556,757
03332601,DELTA COLLEGE - SLIDELL                 ,LA,70460-2624,Proprietary  ,4,12,16,192,623,815
03356300,MEDICAL TRAINING COLLEGE                ,LA,70816-5820,Proprietary  ,10,27,37,193,625,818
03480300,MEDVANCE INSTITUTE                      ,LA,70809-1908,Proprietary  ,7,38,45,188,659,847
03498400,OMEGA INSTITUTE OF COSMETOLOGY          ,LA,70360-0000,Proprietary  ,4,1,5,80,84,164
03727500,MOORE CAREER COLLEGE                    ,LA,70808-4191,Proprietary  ,0,13,13,18,128,146
03730300,BATON ROUGE COMMUNITY COLLEGE           ,LA,78806-4129,Public       ,118,224,342,6574,7995,14569
03789300,UNITECH TRAINING ACADEMY                ,LA,70503-5132,Proprietary  ,24,100,124,269,874,1143
03789301,UNITECH TRAINING ACADEMY - WEST MONROE  ,LA,71291-2913,Proprietary  ,10,55,65,126,617,743
03789302,UNITECH TRAINING ACADEMY - HOUMA        ,LA,70363-5556,Proprietary  ,17,30,47,132,311,443
03789303,UNITECH TRAINING ACADEMY -  ALEXANDRIA  ,LA,71303-3625,Proprietary  ,16,43,59,115,442,557
03789304,UNITECH TRAINING ACADEMY - LAKE CHARLES ,LA,70601-7887,Proprietary  ,6,34,40,151,425,576
03789400,RIVER PARISHES COMMUNITY COLLEGE        ,LA,70778-0310,Public       ,20,33,53,1084,1407,2491
03795300,CASSIA BEAUTY COLLEGE                   ,LA,70126-0000,Proprietary  ,0,1,1,19,45,64
03810500,COURT REPORTING INSTITUTE OF LOUISI     ,LA,70816-0000,Proprietary  ,0,2,2,10,110,120
03956300,SOUTH LOUISIANA COMMUNITY COLLEGE       ,LA,70506-0000,Public       ,62,81,143,3242,3985,7227
04040300,COMPASS CAREER COLLEGE                  ,LA,70403-0653,Proprietary  ,3,19,22,179,403,582
04112300,LOUISIANA CULINARY INSTITUTE            ,LA,70816-4109,Proprietary  ,11,10,21,318,411,729
04120700,ALDEN'S SCHOOL OF COSMETOLOGY           ,LA,70714-1502,Proprietary  ,0,0,0,1,0,1
04130100,LOUISIANA DELTA COMMUNITY COLLEGE       ,LA,71203-3618,Public       ,85,128,213,2193,3709,5902
04149500,A & W HEALTHCARE EDUCATORS              ,LA,70122-3146,Proprietary  ,2,10,12,75,454,529
04151600,MY-LE'S BEAUTY COLLEGE                  ,LA,70056-3150,Proprietary  ,1,10,11,19,174,193
04217000,HEALTHCARE TRAINING INSTITUTE           ,LA,70062-7630,Proprietary  ,1,19,20,32,201,233
04225900,SETTING THE STANDARD BARBERING AND NATUR,LA,71109-4124,Proprietary  ,0,5,5,5,26,31
04226000,BOS-MAN'S BARBER COLLEGE                ,LA,71106-2653,Proprietary  ,1,2,3,10,75,85
04234600,PARK PLACE PREMIER BARBER SCHOOL        ,LA,70122-3808,Proprietary  ,4,13,17,4,13,17
00143600,CAPITOL COLLEGE                         ,MD,20708-9759,Private      ,0,27,27,511,758,1269
00146200,WASHINGTON BIBLE COLLEGE                ,MD,20706-3599,Private      ,0,0,0,14,65,79
00205700,ALLEGANY COLLEGE OF MARYLAND            ,MD,21502-2596,Public       ,17,40,57,2751,2369,5120
00205800,ANNE ARUNDEL COMMUNITY COLLEGE          ,MD,21012-1895,Public       ,66,255,321,5956,10653,16609
00206100,BALTIMORE CITY COMMUNITY COLLEGE        ,MD,21215-7893,Public       ,33,246,279,4544,11831,16375
00206200,BOWIE STATE UNIVERSITY                  ,MD,20715-9465,Public       ,32,77,109,8104,6991,15095
00206300,COMMUNITY COLLEGE OF BALTIMORE COUNTY   ,MD,21228-5381,Public       ,75,391,466,11320,20316,31636
00206400,COLLEGE OF SOUTHERN MARYLAND            ,MD,20646-0910,Public       ,50,118,168,4369,6148,10517
00206500,NOTRE DAME OF MARYLAND UNIVERSITY       ,MD,21210-2476,Private      ,2,23,25,1236,2524,3760
00206700,WASHINGTON ADVENTIST UNIVERSITY         ,MD,20912-7796,Private      ,3,13,16,1029,1397,2426
00206800,COPPIN STATE UNIVERSITY                 ,MD,21216-3698,Public       ,15,55,70,4906,6702,11608
00207100,FREDERICK COMMUNITY COLLEGE             ,MD,21702-9745,Public       ,15,82,97,2505,3530,6035
00207200,FROSTBURG STATE UNIVERSITY              ,MD,21532-1099,Public       ,8,14,22,6986,2066,9052
00207300,GOUCHER COLLEGE                         ,MD,21204-2794,Private      ,4,8,12,3328,1151,4479
00207400,HAGERSTOWN COMMUNITY COLLEGE            ,MD,21742-6514,Public       ,25,114,139,2378,3918,6296
00207500,HARFORD COMMUNITY COLLEGE               ,MD,21015-1696,Public       ,29,99,128,2713,3737,6450
00207600,HOOD COLLEGE                            ,MD,21701-8575,Private      ,4,19,23,2409,1094,3503
00207700,JOHNS HOPKINS UNIVERSITY                ,MD,21218-2693,Private      ,7,40,47,9931,2917,12848
00207702,JOHNS HOPKINS UNIV SCH ARTS/SCI/ENG     ,MD,21218-0000,Private      ,4,85,89,4363,2620,6983
00207703,JOHNS HOPKINS UNIV SCH OF BUS/ED        ,MD,21046-0000,Private      ,0,26,26,96,1812,1908
00207705,JOHNS HOPKINS BLOOMBERG SCH OF PH       ,MD,21205-0000,Private      ,0,10,10,94,1753,1847
00207706,JOHNS HOPKINS UNIV SCH OF MEDICINE      ,MD,21205-0000,Private      ,1,6,7,395,1233,1628
00207707,JOHNS HOPKINS UNIV SCH OF NURSING       ,MD,21205-0000,Private      ,3,20,23,464,1865,2329
00207708,JOHNS HOPKINS UNIV PEABODY CONSERV      ,MD,21202-2397,Private      ,0,5,5,605,518,1123
00207764,JOHNS HOPKINS UNIVERSITY - CAREY BUSINES,MD,21202-4649,Private      ,0,11,11,1,38,39
00207800,LOYOLA UNIVERSITY MARYLAND              ,MD,21210-2699,Private      ,11,32,43,10317,3133,13450
00208000,MARYLAND INST COLLEGE OF ART            ,MD,21217-4191,Private      ,6,3,9,3247,1165,4412
00208300,MORGAN STATE UNIVERSITY                 ,MD,21251-0002,Public       ,39,60,99,11257,8344,19601
00208600,MOUNT SAINT MARY'S UNIVERSITY           ,MD,21727-7799,Private      ,2,12,14,3472,594,4066
00208700,NER ISRAEL RABBINICAL COLLEGE           ,MD,21208-1198,Private      ,12,15,27,121,69,190
00208900,PRINCE GEORGES COMMUNITY COLLEGE        ,MD,20774-2199,Public       ,64,277,341,8232,14835,23067
00209100,SALISBURY UNIVERSITY                    ,MD,21801-6862,Public       ,14,35,49,12743,2856,15599
00209200,ST JOHN'S COLLEGE                       ,MD,21404-0000,Private      ,0,8,8,558,261,819
00209500,ST. MARY'S COLLEGE OF MARYLAND          ,MD,20686-3001,Public       ,4,0,4,2949,402,3351
00209600,ST MARY'S SEMINARY & UNIV               ,MD,21210-1994,Private      ,0,0,0,38,88,126
00209900,TOWSON UNIVERSITY                       ,MD,21252-0002,Public       ,42,93,135,27394,10444,37838
00210200,UNIVERSITY OF BALTIMORE                 ,MD,21201-5779,Public       ,7,76,83,2624,8483,11107
00210300,"UNIVERSITY OF MARYLAND, COLLEGE PARK    ",MD,20742-5145,Public       ,65,205,270,35585,16602,52187
00210400,"UNIVERSITY OF MARYLAND, BALTIMORE       ",MD,21201-1691,Public       ,12,83,95,5399,12890,18289
00210500,UMBC                                    ,MD,21250-0002,Public       ,29,81,110,12300,7430,19730
00210600,UNIVERSITY MARYLAND EASTERN SHORE       ,MD,21853-4053,Public       ,21,20,41,6592,2744,9336
00210700,STEVENSON UNIVERSITY                    ,MD,21153-0641,Private      ,2,40,42,6869,2573,9442
00210800,WASHINGTON COLLEGE                      ,MD,21620-1197,Private      ,1,2,3,2907,195,3102
00210900,MCDANIEL COLLEGE                        ,MD,21157-4390,Private      ,2,8,10,3343,861,4204
00458612,KAPLAN COLLEGE                          ,MD,21742-2797,Proprietary  ,9,116,125,276,2343,2619
00458614,KAPLAN COLLEGE - FREDERICK              ,MD,21704-8307,Proprietary  ,0,0,0,38,255,293
00465000,CHESAPEAKE COLLEGE                      ,MD,21679-0008,Public       ,13,36,49,1399,1902,3301
00691100,MONTGOMERY COLLEGE                      ,MD,20850-1195,Public       ,87,210,297,12928,14240,27168
00734100,INTERNATIONAL BEAUTY SCHOOL             ,MD,21502-2370,Proprietary  ,7,31,38,91,538,629
00744700,DEL-MAR-VA BEAUTY ACADEMY               ,MD,21804-0000,Proprietary  ,1,3,4,84,204,288
00749100,TESST COLLEGE OF TECHNOLOGY             ,MD,21227-1063,Proprietary  ,24,82,106,556,1800,2356
00793600,LINCOLN TECHNICAL INSTITUTE             ,MD,21046-1544,Proprietary  ,74,76,150,776,1149,1925
00817500,HOWARD COMMUNITY COLLEGE                ,MD,21044-3197,Public       ,46,149,195,4568,5939,10507
00826300,AWARD BEAUTY SCHOOL                     ,MD,21740-5624,Proprietary  ,5,86,91,75,427,502
00830800,CECIL COLLEGE                           ,MD,21901-1999,Public       ,7,24,31,1326,1814,3140
00907906,EVEREST COLLEGE- EVEREST INSTITUTE      ,MD,20910-3737,Proprietary  ,13,40,53,352,1164,1516
01001400,GARRETT COMMUNITY COLLEGE               ,MD,21541-1265,Public       ,2,3,5,1100,432,1532
01031900,MEDIX SCHOOL                            ,MD,21204-2538,Proprietary  ,54,118,172,811,3289,4100
01041000,TESST COLLEGE OF TECHNOLOGY             ,MD,21286-2201,Proprietary  ,17,47,64,218,794,1012
01164400,UNIV OF MARYLAND UNIVERSITY COLLEGE     ,MD,20783-8078,Public       ,54,1830,1884,3388,46788,50176
01164402,U OF MD UNIVERSITY COLLEGE - EUROPE     ,MD,20832-0000,Public       ,1,30,31,433,1137,1570
01164404,U OF MD UNIVERSITY COLLEGE - ASIA       ,MD,31207-0000,Public       ,0,33,33,122,1337,1459
02073900,WOR-WIC COMMUNITY COLLEGE               ,MD,21804-0000,Public       ,13,80,93,1787,3229,5016
02083600,TESST COLLEGE OF TECHNOLOGY             ,MD,20705-2698,Proprietary  ,9,37,46,275,909,1184
02116005,SANFORD-BROWN INSTITUTE - LANDOVER      ,MD,20785-2287,Proprietary  ,0,0,0,47,247,294
02127900,SOJOURNER DOUGLASS COLLEGE              ,MD,21205-0000,Private      ,3,19,22,318,3614,3932
02155100,MARYLAND COLLEGE OF ART AND DESIGN      ,MD,20902-0000,Private      ,2,2,4,191,236,427
02269700,"COLORLAB ACADEMY OF HAIR, THE           ",MD,21014-3639,Proprietary  ,0,2,2,60,121,181
02331000,MARYLAND BEAUTY ACADEMY OF ESSEX        ,MD,21221-0000,Proprietary  ,4,18,22,104,325,429
02333000,HAIR ACADEMY                            ,MD,20784-0000,Proprietary  ,12,87,99,206,698,904
02343800,MONTGOMERY BEAUTY SCHOOL                ,MD,20901-0000,Proprietary  ,5,13,18,125,311,436
02494700,BALTIMORE STUDIO OF HAIR DESIGN         ,MD,21201-0000,Proprietary  ,5,8,13,152,399,551
02495000,ROBERT PAUL ACAD COSMTGY ARTS & SCI     ,MD,21093-0000,Proprietary  ,0,2,2,80,87,167
02495100,MARYLAND BEAUTY ACADEMY                 ,MD,21136-0000,Proprietary  ,0,3,3,34,94,128
02545400,NORTH AMERICAN TRADE SCHOOLS            ,MD,21244-0069,Proprietary  ,23,158,181,322,1681,2003
02573800,"L' ACADEMIE DE CUISINE, INC.            ",MD,20877-0000,Proprietary  ,0,2,2,90,258,348
02578400,MARYLAND UNIVERSITY OF INTEGRATIVE HEALT,MD,20723-6010,Private      ,0,29,29,6,679,685
03027200,BLADES SCHOOL OF HAIR DESIGN            ,MD,20619-0226,Proprietary  ,4,9,13,61,162,223
03064900,AARON'S ACADEMY OF BEAUTY               ,MD,20602-2715,Proprietary  ,0,4,4,53,127,180
03097200,AESTHETICS INSTITUTE OF COSMETOLOGY     ,MD,20877-1305,Proprietary  ,0,9,9,32,133,165
03100700,CARROLL COMMUNITY COLLEGE               ,MD,21157-6913,Public       ,11,41,52,1486,1697,3183
03148300,AMERICAN BEAUTY ACADEMY                 ,MD,20902-1911,Proprietary  ,41,102,143,389,1031,1420
03296300,BALTIMORE SCHOOL OF MASSAGE             ,MD,21090-2261,Proprietary  ,19,65,84,220,777,997
03327300,NEW CREATIONS ACADEMY OF HAIR DSN       ,MD,20746-0000,Proprietary  ,3,9,12,83,232,315
03455500,NATIONAL LABOR COLLEGE                  ,MD,20903-1790,Private      ,0,2,2,18,512,530
03493300,ALL-STATE CAREER SCHOOL                 ,MD,21224-6658,Proprietary  ,48,209,257,706,3141,3847
03667300,FAITH THEOLOGICAL SEMINARY              ,MD,21212-2624,Private      ,0,0,0,11,159,170
03771300,AMERICAN CAREER INSTITUTE               ,MD,20902-4637,Proprietary  ,0,0,0,2,15,17
03822400,MAPLE SPRINGS BAPTIST BIBLE COLLEGE & SE,MD,20743-5711,Private      ,0,0,0,1,85,86
03937300,YESHIVA COLLEGE OF THE NATION'S CAPITAL ,MD,20902-1700,Private      ,2,2,4,14,28,42
03965500,HAIR EXPRESSIONS ACADEMY                ,MD,20852-1729,Proprietary  ,6,12,18,159,271,430
04121600,FILA ACADEMY (THE)                      ,MD,21061-1634,Proprietary  ,0,4,4,7,53,60
04139700,FREDERICK SCHOOL OF COSMETOLOGY         ,MD,21701-0000,Proprietary  ,0,2,2,56,98,154
04141600,OMEGA STUDIOS' SCHOOL OF APPLIED RECORDI,MD,20852-1731,Proprietary  ,2,3,5,92,180,272
04151800,TEMPLE (THE): A PAUL MITCHELL PARTNER SC,MD,21701-5409,Proprietary  ,9,4,13,193,217,410
04167602,FINGER LAKES SCHOOL OF MASSAGE (THE)    ,MD,21701-3030,Proprietary  ,1,7,8,17,80,97
04168900,HOLISTIC MASSAGE TRAINING INSTITUTE     ,MD,21218-2407,Proprietary  ,0,8,8,36,197,233
04171501,COSMOPOLITAN BEAUTY & TECH SCHOOL -     ,MD,20143-3370,Proprietary  ,0,7,7,2,20,22
04188400,BAIS HAMEDRASH AND MESIVTA OF BALTIMORE ,MD,21209-1613,Private      ,2,1,3,51,29,80
04204000,ASPEN BEAUTY ACADEMY - LAUREL           ,MD,20724-2013,Proprietary  ,4,4,8,58,182,240
04209600,INSTITUTE OF HEALTH SCIENCES            ,MD,21031-1408,Proprietary  ,1,15,16,38,207,245
04211700,HARMON'S BEAUTY SCHOOL                  ,MD,20785-2135,Proprietary  ,0,3,3,33,72,105
00211400,AMERICAN INTERNATIONAL COLLEGE          ,MA,01109-3189,Private      ,6,36,42,2244,3460,5704
00211500,AMHERST COLLEGE                         ,MA,01002-5000,Private      ,4,3,7,4628,387,5015
00211600,ANDOVER NEWTON THEOLOGICAL SCHOOL       ,MA,02459-0000,Private      ,0,2,2,4,198,202
00211700,ANNA MARIA COLLEGE                      ,MA,01612-1198,Private      ,2,32,34,2025,828,2853
00211800,ASSUMPTION COLLEGE                      ,MA,01615-1294,Private      ,2,12,14,5056,1030,6086
00212000,MERRIMACK COLLEGE                       ,MA,01845-5800,Private      ,4,9,13,6041,673,6714
00212100,BABSON COLLEGE                          ,MA,02457-0310,Private      ,0,9,9,2970,810,3780
00212200,BAY PATH COLLEGE                        ,MA,01106-2212,Private      ,2,43,45,968,2752,3720
00212300,BECKER COLLEGE-WORCESTER                ,MA,01615-0071,Private      ,3,29,32,3258,1339,4597
00212400,BENTLEY UNIVERSITY                      ,MA,02452-4705,Private      ,1,7,8,6207,899,7106
00212600,BERKLEE COLLEGE OF MUSIC                ,MA,02215-3693,Private      ,10,24,34,5255,1713,6968
00212800,BOSTON COLLEGE                          ,MA,02467-3800,Private      ,15,16,31,18013,6146,24159
00212900,BOSTON CONSERVATORY OF MUSIC            ,MA,02215-9830,Private      ,2,2,4,1211,376,1587
00213000,BOSTON UNIVERSITY                       ,MA,02215-1789,Private      ,30,95,125,40361,18880,59241
00213300,BRANDEIS UNIVERSITY                     ,MA,02453-2700,Private      ,2,15,17,6145,1574,7719
00213900,CLARK UNIVERSITY                        ,MA,01610-1473,Private      ,1,11,12,4568,959,5527
00214000,ELMS COLLEGE                            ,MA,01013-2839,Private      ,1,9,10,1497,1189,2686
00214100,COLLEGE OF THE HOLY CROSS               ,MA,01610-2395,Private      ,2,3,5,5988,221,6209
00214300,CURRY COLLEGE                           ,MA,02186-2395,Private      ,9,33,42,5336,1714,7050
00214400,DEAN COLLEGE                            ,MA,02038-1994,Private      ,8,3,11,2028,365,2393
00214500,EASTERN NAZARENE COLLEGE                ,MA,02170-2999,Private      ,0,8,8,911,916,1827
00214507,EASTERN NAZARENE CLG - LEAD PROGRAM     ,MA,02170-0000,Private      ,0,3,3,36,444,480
00214600,EMERSON COLLEGE                         ,MA,02116-4624,Private      ,2,4,6,7654,1660,9314
00214700,EMMANUEL COLLEGE                        ,MA,02115-5798,Private      ,4,6,10,5587,612,6199
00214800,ENDICOTT COLLEGE                        ,MA,01915-2098,Private      ,3,14,17,4913,1026,5939
00214900,EPISCOPAL DIVINITY SCHOOL               ,MA,02138-0000,Private      ,0,9,9,0,88,88
00215000,FISHER COLLEGE                          ,MA,02116-1500,Private      ,5,58,63,1774,1890,3664
00215100,BENJAMIN FRANKLIN INSTITUTE OF TECH     ,MA,02116-6296,Public       ,1,3,4,613,470,1083
00215300,GORDON COLLEGE                          ,MA,01984-1899,Private      ,0,3,3,2502,243,2745
00215400,HELLENIC COLLEGE                        ,MA,02445-7496,Private      ,0,2,2,90,127,217
00215500,HARVARD UNIVERSITY                      ,MA,02138-3800,Private      ,3,13,16,4570,1029,5599
00215501,AMRCN REPERTORY THTR INST ADV THTR      ,MA,02138-0000,Private      ,0,0,0,3,136,139
00215502,HARVARD BUSINESS SCHOOL                 ,MA,02163-0000,Private      ,0,7,7,239,1760,1999
00215503,HARVARD EXTENSION SCHOOL                ,MA,02138-0000,Private      ,1,43,44,171,1713,1884
00215504,HARVARD SCH OF DENTAL MEDICINE          ,MA,02115-0000,Private      ,0,1,1,28,219,247
00215505,HARVARD UNIV GRAD SCH DESIGN            ,MA,02138-0000,Private      ,0,1,1,17,961,978
00215506,HARVARD DIVINITY SCHOOL                 ,MA,02138-0000,Private      ,0,3,3,9,510,519
00215507,HARVARD UNIV GRAD SCH ED                ,MA,02138-0000,Private      ,0,2,2,9,1593,1602
00215508,HARVARD UNIV GRAD S OF ARTS & SCIEN     ,MA,02138-0000,Private      ,1,9,10,81,917,998
00215509,HARVARD KENNEDY SCHOOL                  ,MA,02138-0000,Private      ,0,5,5,19,1352,1371
00215510,HARVARD LAW SCHOOL                      ,MA,02138-0000,Private      ,1,3,4,142,3408,3550
00215511,HARVARD UNIV MEDICAL SCHOOL             ,MA,02115-0000,Private      ,2,5,7,235,1166,1401
00215512,HARVARD UNIV SCH PUBLIC HEALTH          ,MA,02115-0000,Private      ,0,7,7,43,1076,1119
00215513,HARVARD UNIVERSITY-HARVARD COLLEGE      ,MA,02138-0000,Private      ,16,9,25,20309,1498,21807
00215700,HEBREW COLLEGE                          ,MA,02459-2237,Private      ,0,0,0,0,112,112
00215800,LASELL COLLEGE                          ,MA,02466-2716,Private      ,4,10,14,3433,652,4085
00216000,LESLEY UNIVERSITY                       ,MA,02138-2790,Private      ,6,107,113,3006,4001,7007
00216100,UMASS LOWELL                            ,MA,01854-3089,Public       ,27,111,138,14825,7580,22405
00216400,NEW ENGLAND COLLEGE OF OPTOMETRY        ,MA,02115-1129,Private      ,0,1,1,13,437,450
00216500,MASS. COLLEGE OF PHARMACY  & HEALTH SCIE,MA,02115-5804,Private      ,7,12,19,6251,4447,10698
00216700,BERKSHIRE COMMUNITY COLLEGE             ,MA,01201-5786,Public       ,3,7,10,1062,1706,2768
00216800,CAPE COD COMMUNITY COLLEGE              ,MA,02668-1599,Public       ,7,18,25,1839,2755,4594
00216900,GREENFIELD COMMUNITY COLLEGE            ,MA,01301-9739,Public       ,5,15,20,1058,1787,2845
00217000,HOLYOKE COMMUNITY COLLEGE               ,MA,01040-1099,Public       ,29,87,116,4267,5530,9797
00217100,MASSACHUSETTS BAY COMMUNITY COLLEGE     ,MA,02181-0000,Public       ,19,72,91,2636,3262,5898
00217200,MOUNT WACHUSETT COMMUNITY COLLEGE       ,MA,01440-1000,Public       ,29,95,124,2335,3934,6269
00217300,NORTH SHORE COMMUNITY COLLEGE           ,MA,01923-4093,Public       ,29,82,111,3866,5701,9567
00217400,NORTHERN ESSEX COMMUNITY COLLEGE        ,MA,01830-2399,Public       ,39,112,151,3838,5336,9174
00217500,QUINSIGAMOND COMMUNITY COLLEGE          ,MA,01606-2092,Public       ,34,134,168,4784,6977,11761
00217600,BRISTOL COMMUNITY COLLEGE               ,MA,02720-7399,Public       ,23,146,169,5049,6800,11849
00217700,MASSASOIT COMMUNITY COLLEGE             ,MA,02302-3996,Public       ,16,65,81,4209,5476,9685
00217800,MASSACHUSETTS INST OF TECHNOLOGY        ,MA,02139-4307,Private      ,10,32,42,13123,3471,16594
00218000,MASSACHUSETTS COLLEGE OF ART AND DESIGN ,MA,02115-5803,Public       ,4,2,6,2672,1017,3689
00218100,MASSACHUSETTS MARITIME ACADEMY          ,MA,02532-3400,Public       ,4,4,8,1665,184,1849
00218300,BRIDGEWATER STATE COLLEGE               ,MA,02325-0001,Public       ,29,19,48,12617,4388,17005
00218400,FITCHBURG STATE UNIVERSITY              ,MA,01420-2697,Public       ,7,28,35,6494,1986,8480
00218500,FRAMINGHAM STATE COLLEGE                ,MA,01702-2471,Public       ,12,21,33,7897,1947,9844
00218700,MASSACHUSETTS CLG OF LIBERAL ARTS       ,MA,01247-4100,Public       ,8,7,15,2554,673,3227
00218800,SALEM STATE UNIVERSITY                  ,MA,01970-5353,Public       ,99,58,157,9955,4830,14785
00218900,WESTFIELD STATE COLLEGE                 ,MA,01086-1630,Public       ,16,13,29,8590,2274,10864
00219000,WORCESTER STATE COLLEGE                 ,MA,01602-2597,Public       ,7,37,44,7009,2985,9994
00219200,MOUNT HOLYOKE COLLEGE                   ,MA,01075-1492,Private      ,2,1,3,2850,404,3254
00219300,MOUNT IDA COLLEGE                       ,MA,02459-3323,Private      ,0,2,2,1962,463,2425
00219400,NEW ENGLAND CONSERVATORY OF MUSIC       ,MA,02115-5018,Private      ,1,1,2,753,634,1387
00219700,NICHOLS COLLEGE                         ,MA,01571-6346,Private      ,7,8,15,2259,446,2705
00219900,NORTHEASTERN UNIVERSITY                 ,MA,02115-5000,Private      ,31,174,205,36407,14476,50883
00220100,PINE MANOR COLLEGE                      ,MA,02167-0000,Private      ,4,2,6,285,134,419
00220200,BLESSED JOHN XXIII NATIONAL SEMINARY    ,MA,02493-0000,Private      ,0,0,0,0,3,3
00220500,QUINCY COLLEGE                          ,MA,02169-4324,Public       ,15,102,117,2026,4487,6513
00220600,REGIS COLLEGE                           ,MA,02193-0000,Private      ,2,12,14,2241,1096,3337
00220800,SIMMONS COLLEGE                         ,MA,02115-5898,Private      ,1,58,59,3486,4064,7550
00220900,SMITH COLLEGE                           ,MA,01063-2936,Private      ,1,0,1,3624,566,4190
00220901,"SMITH COLLEGE, SCH FOR SOCIAL WORK      ",MA,01063-0000,Private      ,0,1,1,15,560,575
00221000,UNIV OF MASSACHUSETTS-DARTMOUTH         ,MA,02747-2300,Public       ,19,37,56,13354,4276,17630
00221100,SPRINGFIELD COLLEGE                     ,MA,01109-3797,Private      ,6,107,113,4195,4944,9139
00221400,ST JOHN'S SEMINARY                      ,MA,02135-8839,Private      ,3,7,10,14,45,59
00221700,STONEHILL COLLEGE                       ,MA,02357-6110,Private      ,2,4,6,6308,207,6515
00221800,SUFFOLK UNIVERSITY                      ,MA,02108-2770,Private      ,4,22,26,9363,4915,14278
00221900,TUFTS UNIVERSITY                        ,MA,02155-5808,Private      ,4,7,11,11503,2614,14117
00221901,TUFTS UNIV SCH OF DENTAL MEDICINE       ,MA,02111-0000,Private      ,0,2,2,35,975,1010
00221902,TUFTS UNIVERSITY - CUMMINGS SCHOOL OF VE,MA,01536-0000,Private      ,0,1,1,40,497,537
00221904,TUFTS UNIV SCHOOL OF MEDICINE           ,MA,02111-0000,Private      ,2,6,8,106,2132,2238
00222100,UNIV OF MASSACHUSETTS-AMHERST           ,MA,01003-0000,Public       ,43,65,108,41381,8738,50119
00222200,UNIV OF MASSACHUSETTS-BOSTON            ,MA,02125-3393,Public       ,35,153,188,14472,13043,27515
00222400,WELLESLEY COLLEGE                       ,MA,02481-8203,Private      ,2,0,2,3719,251,3970
00222500,WENTWORTH INSTITUTE OF TECHNOLOGY       ,MA,02115-5998,Private      ,8,8,16,6193,1066,7259
00222600,WESTERN NEW ENGLAND UNIVERSITY          ,MA,01119-2654,Private      ,4,12,16,6525,1860,8385
00222700,WHEATON COLLEGE                         ,MA,02766-2322,Private      ,0,0,0,2728,119,2847
00222800,WHEELOCK COLLEGE                        ,MA,02215-4176,Private      ,1,5,6,1766,949,2715
00222900,WILLIAMS COLLEGE                        ,MA,01267-2600,Private      ,1,2,3,4300,156,4456
00223300,WORCESTER POLYTECHNIC INSTITUTE         ,MA,01609-2280,Private      ,2,9,11,7925,794,8719
00267104,BARD COLLEGE - LONGY SCHOOL OF MUSIC    ,MA,02138-3599,Private      ,1,0,1,43,178,221
00396500,BAY STATE COLLEGE                       ,MA,02116-2901,Proprietary  ,10,22,32,1607,1590,3197
00396600,BOSTON ARCHITECTURAL COLLEGE            ,MA,02115-2795,Private      ,2,5,7,347,907,1254
00466100,HAMPSHIRE COLLEGE                       ,MA,01002-3359,Private      ,1,0,1,2708,265,2973
00466600,SALTER COLLEGE                          ,MA,01583-1700,Proprietary  ,68,362,430,631,3297,3928
00466700,SCHOOL OF MUSEUM OF FINE ARTS           ,MA,02115-5534,Private      ,2,0,2,693,357,1050
00466900,UPPER CAPE COD REGIONAL VOC TECH        ,MA,02532-3310,Public       ,0,3,3,33,167,200
00527900,GREATER LOWELL REGNL VOC TECH SCH       ,MA,01879-0000,Public       ,0,2,2,36,142,178
00551900,DIMAN REGIONAL VOC TECH INST            ,MA,02723-3519,Public       ,0,0,0,59,209,268
00552300,BLUE HILLS REGIONAL VOC TECH            ,MA,02021-1398,Public       ,0,3,3,45,177,222
00555700,MCCANN TECHNICAL SCHOOL                 ,MA,01247-0000,Public       ,0,0,0,32,98,130
00613600,NATIONAL AVIATION ACADEMY - NEW ENGLAND ,MA,01730-2620,Proprietary  ,9,11,20,169,280,449
00632200,BROCKTON HOSPITAL SCH OF NURSING        ,MA,02302-0000,Private      ,0,8,8,166,675,841
00632400,LABOURE COLLEGE                         ,MA,02124-0000,Private      ,3,18,21,200,968,1168
00633100,LAWRENCE MEM HOSPITAL SCH OF NRSNG      ,MA,02155-1643,Private      ,0,5,5,64,416,480
00635200,BAYSTATE MEDICAL CENTER                 ,MA,01199-0001,Private      ,0,2,2,29,131,160
00687300,MARIAN COURT COLLEGE                    ,MA,01907-2896,Private      ,0,2,2,114,139,253
00748100,GIBBS COLLEGE                           ,MA,02116-2904,Proprietary  ,0,2,2,34,132,166
00748400,NEWBURY COLLEGE                         ,MA,02445-5796,Private      ,3,3,6,2538,374,2912
00748600,THE NEW ENGLAND INSTITUTE OF ART        ,MA,02445-7295,Proprietary  ,5,17,22,1251,610,1861
00748800,KAPLAN CAREER INSTITUTE                 ,MA,02129-1644,Proprietary  ,0,0,0,28,144,172
00748801,KAPLAN CAREER INSTITUTE -               ,MA,02215-2606,Proprietary  ,0,0,0,15,82,97
00807800,SPRINGFIELD TECHNICAL COMMUNITY CLG     ,MA,01105-0000,Public       ,16,40,56,4019,6607,10626
00809002,EVEREST COLLEGE - EVEREST INSTITUTE     ,MA,02150-2333,Proprietary  ,9,35,44,189,560,749
00817807,EMPIRE BEAUTY SCHOOL - BOSTON           ,MA,02111-1204,Proprietary  ,0,0,0,158,309,467
00891600,NEW ENGLAND SCHOOL OF LAW               ,MA,02116-0000,Private      ,0,3,3,31,1799,1830
00964500,BARD COLLEGE AT SIMON'S ROCK            ,MA,01230-9702,Private      ,1,1,2,396,24,420
00974700,GORDON-CONWELL THEOLOGICAL SEMINARY     ,MA,01982-0000,Private      ,0,6,6,7,590,597
00975600,UNIVERSITY OF MASS MEDICAL CENTER       ,MA,01655-0000,Public       ,1,3,4,68,995,1063
00987700,HENRI'S SCHOOL OF HAIR DESIGN           ,MA,01420-5675,Proprietary  ,0,0,0,30,52,82
00989900,LOWELL ACADEMY HAIRSTYLING INST         ,MA,01852-1909,Proprietary  ,0,8,8,51,124,175
00993600,MIDDLESEX COMMUNITY COLLEGE             ,MA,01730-1197,Public       ,16,54,70,2080,2230,4310
00993602,"MIDDLESEX COMMUNITY COLLEGE, LOWELL     ",MA,01852-0000,Public       ,31,79,110,3450,3887,7337
01054211,EMPIRE BEAUTY SCHOOL - MALDEN           ,MA,02148-5103,Proprietary  ,0,0,0,72,150,222
01121000,BUNKER HILL COMMUNITY COLLEGE           ,MA,02129-2991,Public       ,33,96,129,7593,12710,20303
01151000,EVEREST INSTITUTE                       ,MA,02135-7638,Proprietary  ,0,1,1,138,401,539
01193000,ROXBURY COMMUNITY COLLEGE               ,MA,02120-3400,Public       ,12,65,77,1206,3699,4905
01204200,MANSFIELD BEAUTY SCHOOLS                ,MA,02169-5061,Proprietary  ,0,7,7,20,103,123
01206800,MANSFIELD BEAUTY SCHOOL                 ,MA,01103-1410,Proprietary  ,0,5,5,16,76,92
01218700,BLACKSTONE VALLEY VOCATIONAL REGIONAL SC,MA,01568-1499,Public       ,0,0,0,10,66,76
01238600,SOUTHEASTERN TECHNICAL INSTITUTE        ,MA,02375-1780,Public       ,0,4,4,48,215,263
01246108,LINCOLN TECHNICAL INSTITUTE - BROCKTON  ,MA,02401-1818,Proprietary  ,11,27,38,183,507,690
01246114,LINCOLN TECHNICAL INSTITUTE - LOWELL    ,MA,01852-5119,Proprietary  ,18,32,50,246,519,765
01246115,LINCOLN TECHNICAL INSTITUTE - SOMERVILLE,MA,02145-1102,Proprietary  ,7,39,46,153,433,586
01288100,MONTACHUSETT REG VOC TECH SCH           ,MA,01420-4649,Public       ,0,2,2,26,120,146
01294800,ROB ROY ACADEMY                         ,MA,02721-5330,Proprietary  ,3,4,7,44,109,153
02063000,MONTSERRAT COLLEGE OF ART               ,MA,01915-0000,Private      ,1,0,1,682,87,769
02079400,EMPIRE BEAUTY SCHOOL                    ,MA,01702-5232,Proprietary  ,55,132,187,526,1228,1754
02079412,EMPIRE BEAUTY SCHOOL - LOWELL           ,MA,01852-2214,Proprietary  ,0,0,0,106,192,298
02092100,MASSACHUSETTS SCHOOL OF BARBERING       ,MA,02169-5058,Proprietary  ,1,7,8,27,179,206
02122000,NEW ENGLAND HAIR ACADEMY                ,MA,02148-0000,Proprietary  ,7,15,22,83,217,300
02137000,ROB ROY ACADEMY                         ,MA,02780-0000,Proprietary  ,1,1,2,16,46,62
02137200,MASS GEN HOSP DIETETIC INTERNSHIP       ,MA,02114-0000,Private      ,1,1,2,11,60,71
02163500,NEW ENGLAND SCHOOL OF PHOTOGRAPHY       ,MA,02215-0000,Proprietary  ,0,0,0,102,145,247
02163600,MASS SCH OF PROFESSIONAL PSYCHOLOGY     ,MA,02132-0000,Private      ,0,5,5,41,910,951
02169900,ASSABET VALLEY REGIONAL VOC SCHOOL      ,MA,01752-0000,Public       ,0,1,1,20,124,144
02181600,ROB ROY ACADEMY                         ,MA,01609-0000,Proprietary  ,9,13,22,91,190,281
02182900,CAMBRIDGE COLLEGE                       ,MA,02138-5304,Private      ,9,199,208,468,3734,4202
02197900,NORTH BENNET STREET SCHOOL              ,MA,02113-0000,Private      ,0,0,0,59,175,234
02215100,HALLMARK INSTITUTE OF PHOTOGRAPHY       ,MA,01376-0000,Proprietary  ,0,1,1,131,146,277
02219501,MILDRED ELLEY - PITTSFIELD              ,MA,01201-5300,Proprietary  ,0,2,2,21,83,104
02220400,CATHERINE HINDS INST OF ESTHETICS       ,MA,01801-0000,Proprietary  ,4,8,12,75,249,324
02231600,MGH INSTITUTE OF HEALTH PROFESSION      ,MA,02129-0000,Private      ,2,19,21,106,1606,1712
02274300,CONWAY SCHOOL OF LANDSCAPE DESIGN       ,MA,01341-0179,Private      ,0,0,0,0,17,17
02325700,LABARON HAIRDRESSING ACADEMY            ,MA,02740-0000,Proprietary  ,2,1,3,25,66,91
02325800,LABARON HAIRDRESSING ACAD-BROCKTON      ,MA,02301-0000,Proprietary  ,1,1,2,24,54,78
02337400,BANCROFT SCHOOL OF MASSAGE THERAPY      ,MA,01604-4614,Proprietary  ,0,4,4,29,102,131
02338200,BAY STATE SCHOOL OF TECHNOLOGY          ,MA,02021-0000,Proprietary  ,1,10,11,74,273,347
02339400,ROB ROY ACADEMY                         ,MA,02746-0000,Proprietary  ,1,1,2,12,39,51
02491700,CORTIVA INSTITUTE -  BOSTON             ,MA,02472-2577,Proprietary  ,1,4,5,37,141,178
02523900,ELIZABETH GRADY SCHOOL OF ESTHETICS     ,MA,02155-0000,Proprietary  ,2,3,5,65,194,259
02579800,NEW ENGLAND SCHOOL OF ACUPUNCTURE       ,MA,02458-0000,Private      ,0,8,8,1,154,155
02616704,LE CORDON BLEU COLLEGE OF CULINARY ARTS ,MA,02142-1221,Proprietary  ,1,2,3,195,281,476
03066700,AILANO SCHOOL OF COSMETOLOGY            ,MA,02303-4740,Proprietary  ,1,3,4,29,93,122
03104000,SHAWSHEEN ADULT TECHNICAL INSTITUTE     ,MA,01821-5499,Public       ,0,0,0,14,78,92
03115200,MOTORING TECHNICAL TRAINING INST        ,MA,02771-5933,Proprietary  ,5,14,19,185,394,579
03120800,KAY HARVEY HAIRDRESSING ACADEMY         ,MA,01089-2701,Proprietary  ,1,4,5,22,68,90
03130500,URBAN COLLEGE OF BOSTON                 ,MA,02111-1093,Private      ,5,66,71,80,992,1072
03194300,BOSTON GRAD SCH OF PSYCHOANALYSIS       ,MA,02446-4602,Private      ,0,0,0,3,85,88
03205400,JOLIE HAIR & BEAUTY ACADEMY             ,MA,01056-2769,Proprietary  ,3,11,14,40,160,200
03235300,MASSACHUSETTS SCHOOL OF LAW             ,MA,01810-1094,Private      ,0,2,2,16,582,598
03240300,TONI & GUY HAIRDRESSING ACADEMY         ,MA,01605-2213,Proprietary  ,2,2,4,137,149,286
03240301,TONI & GUY HAIRDRESSING ACADEMY - BRAINT,MA,02184-2807,Proprietary  ,4,6,10,20,32,52
03248300,BOSTON BAPTIST COLLEGE                  ,MA,02136-4030,Private      ,1,2,3,101,69,170
03316400,FUNERAL INSTITUTE OF THE NORTHEAST      ,MA,02062-4766,Proprietary  ,0,0,0,47,123,170
03504300,NATL GRAD SCH OF QUALITY SYSTM MGMT     ,MA,02540-0000,Private      ,0,9,9,0,99,99
03570500,NORTHPOINT BIBLE COLLEGE                ,MA,01835-0000,Private      ,0,1,1,227,183,410
03763300,MEDICAL PROFESSIONAL INSTITUTE          ,MA,02148-8143,Proprietary  ,3,12,15,80,432,512
03859300,E.I.N.E.                                ,MA,01876-4709,Proprietary  ,0,2,2,11,54,65
03927303,MARINELLO SCHOOL OF BEAUTY - NORTHAMPTON,MA,01060-3947,Proprietary  ,2,12,14,34,107,141
03946300,FRANKLIN W. OLIN COLLEGE OF ENGINEERING ,MA,02492-1200,Private      ,0,0,0,613,15,628
03965300,NEW ENGLAND COLLEGE OF FINANCE          ,MA,02110-1605,Proprietary  ,4,31,35,92,1024,1116
04116900,DIGRIGOLI SCHOOL OF COSMETOLOGY         ,MA,01089-4623,Proprietary  ,1,5,6,68,106,174
04122000,TRI COUNTY REGIONAL VOCATIONAL TECHNICAL,MA,02038-0000,Public       ,0,2,2,13,99,112
04128000,MILLENNIUM TRAINING INSTITUTE           ,MA,01801-6386,Proprietary  ,1,16,17,7,238,245
04128900,CENTRAL MASS SCHOOL OF MASSAGE AND THERA,MA,01562-1712,Proprietary  ,0,0,0,3,26,29
04143200,HULT INTERNATIONAL BUSINESS SCHOOL      ,MA,02141-1805,Private      ,0,1,1,48,266,314
04153200,SOUTHERN WORCESTER COUNTY REGIONAL VOC S,MA,01507-1331,Public       ,0,0,0,13,48,61
04193100,ALEXANDER ACADEMY                       ,MA,01420-0000,Proprietary  ,1,4,5,29,79,108
04229200,JUPITER BEAUTY ACADEMY                  ,MA,02122-2834,Proprietary  ,0,9,9,0,14,14
00401200,HEBREW UNIVERSITY OF JERUSALEM (THE)    ,FC,00000-0000,Public       ,0,1,1,32,105,137
00403000,UNIVERSITY OF CAMBRIDGE                 ,FC,00000-0000,Public       ,0,0,0,7,93,100
00503400,AMERICAN UNIVERSITY OF CAIRO            ,FC,00000-0000,Private      ,1,2,3,69,144,213
00667100,KATHOLIEKE UNIVERSITEIT LEUVEN          ,FC,00000-0000,Private      ,0,0,0,3,28,31
00669000,UNIVERSITY OF COPENHAGEN                ,FC,00000-0000,Public       ,0,1,1,1,12,13
00669100,UNIVERSITY OF CAMBRIDGE - PEMBROKE      ,FC,00000-0000,Public       ,0,0,0,1,17,18
00669200,UNIVERSITY OF LEEDS                     ,FC,00000-0000,Public       ,0,1,1,22,96,118
00669300,UNIV OF LONDON-LONDON SCHOOL ECON       ,FC,00000-0000,Public       ,0,0,0,27,441,468
00669400,UNIVERSITY OF LONDON - SCHOOL OF ORIENTA,FC,00000-0000,Public       ,0,1,1,13,169,182
00669500,UNIV OF LONDON-UNIVERSITY COLLEGE       ,FC,00000-0000,Public       ,0,1,1,87,458,545
00669600,UNIV OF LONDON-SCH ADVANCED STUDY       ,FC,00000-0000,Public       ,0,0,0,0,12,12
00669700,"QUEEN MARY, UNIVERSITY OF LONDON        ",FC,00000-0000,Public       ,0,0,0,47,157,204
00669900,UNIVERSITY OF SUSSEX                    ,FC,00000-0000,Public       ,0,1,1,31,104,135
00670000,"UNIVERSITY OF YORK, THE                 ",FC,00000-0000,Public       ,0,1,1,21,168,189
00670400,UNIVERSITY COLLEGE CORK                 ,FC,00000-0000,Public       ,0,0,0,13,80,93
00671300,UPPSALA UNIVERSITY                      ,FC,00000-0000,Public       ,0,1,1,4,50,54
00671500,UNIVERSITY OF GENEVA                    ,FC,00000-0000,Public       ,0,0,0,8,103,111
00683900,UNIVERSITY OF EDINBURGH                 ,FC,00000-0000,Public       ,0,2,2,247,794,1041
00684200,UNIVERSITY OF DUBLIN TRINITY COLLEG     ,FC,00000-0000,Public       ,0,1,1,69,232,301
00685000,UNIVERSITY OF CAMBRIDGE - DOWNING C     ,FC,00000-0000,Public       ,0,0,0,1,6,7
00763200,UNIVERSITY OF BRISTOL                   ,FC,00000-0000,Public       ,0,1,1,20,86,106
00768100,COLLEGE OF EUROPE                       ,FC,00000-0000,Private      ,0,0,0,1,10,11
00770500,ROYAL COLLEGE OF SURGEONS IN IRELAN     ,FC,00000-0000,Private      ,0,0,0,7,61,68
00788100,AMERICAN UNIVERSITY OF PARIS            ,FC,00000-0000,Private      ,1,2,3,486,290,776
00837100,AMERICAN UNIVERSITY OF BEIRUT           ,FC,00000-0000,Private      ,2,1,3,114,81,195
00837300,TEL-AVIV UNIVERSITY                     ,FC,00000-0000,Public       ,0,0,0,34,112,146
00837600,VRIJE UNIVERSITEIT AMSTERDAM            ,FC,00000-0000,Public       ,0,0,0,2,32,34
00837700,UNIVERSITEIT VAN AMSTERDAM(UNIVERSI     ,FC,00000-0000,Public       ,0,0,0,16,120,136
00838000,UNIVERSITY OF WARWICK                   ,FC,00000-0000,Public       ,0,0,0,19,72,91
00838300,UNIVERSITY OF GLASGOW                   ,FC,00000-0000,Public       ,0,0,0,64,402,466
00839300,UNIVERSITY OF OSLO                      ,FC,00000-0000,Public       ,0,0,0,3,33,36
00839400,UNIVERSITY OF OXFORD                    ,FC,00000-0000,Public       ,0,0,0,27,407,434
00839800,UNIVERSITY OF SHEFFIELD (THE)           ,FC,00000-0000,Public       ,0,0,0,13,91,104
00839900,UNIVERSITY OF SOUTHAMPTON               ,FC,00000-0000,Public       ,0,0,0,17,73,90
00845200,ABERYSTWYTH UNIVERSITY                  ,FC,00000-0000,Public       ,0,0,0,29,65,94
00845800,LOUGHBOROUGH UNIVERSITY                 ,FC,00000-0000,Public       ,0,0,0,6,20,26
00846000,UNIVERSITY OF NEWCASTLE UPON TYNE       ,FC,00000-0000,Public       ,0,0,0,17,112,129
00846100,UNIVERSITY OF SAINT ANDREWS             ,FC,00000-0000,Private      ,1,1,2,321,194,515
00850500,UNIVERSITY OF MELBOURNE                 ,FC,00000-0000,Public       ,0,2,2,26,225,251
00858600,SWANSEA UNIVERSITY                      ,FC,00000-0000,Public       ,0,0,0,13,64,77
00858700,UNIVERSITY OF DURHAM                    ,FC,00000-0000,Public       ,0,1,1,32,217,249
00866500,UNIVERSITY OF KENT AT CANTERBURY (THE)  ,FC,00000-0000,Public       ,0,0,0,43,182,225
00867000,UNIVERSITY OF NEW SOUTH WALES           ,FC,00000-0000,Public       ,0,1,1,29,98,127
00868700,UNIVERSITY OF ESSEX                     ,FC,00000-0000,Public       ,0,0,0,36,157,193
00869300,CITY UNIVERSITY                         ,FC,00000-0000,Public       ,0,2,2,26,201,227
00890800,THE UNIVERSITY OF BIRMINGHAM            ,FC,00000-0000,Public       ,0,1,1,17,139,156
00891000,UNIVERSITY OF HULL                      ,FC,00000-0000,Public       ,0,0,0,8,9,17
00892000,UNIVERSITY OF NOTTINGHAM                ,FC,00000-0000,Public       ,0,1,1,22,114,136
00900600,UNIVERSITY OF SALFORD (THE)             ,FC,00000-0000,Public       ,0,1,1,5,23,28
00908400,"UNIV OF LONDON, BIRKBECK                ",FC,00000-0000,Public       ,0,0,0,8,110,118
00908500,UNIV OF LONDON KING'S COLLEGE           ,FC,00000-0000,Public       ,0,1,1,69,464,533
00908600,UNIVERSITY OF LONDON - ROYAL HOLLOWAY   ,FC,00000-0000,Public       ,0,0,0,39,86,125
00914300,BAR-ILAN UNIVERSITY                     ,FC,00000-0000,Private      ,1,0,1,24,31,55
00924900,UNIVERSITY OF LIVERPOOL                 ,FC,00000-0000,Public       ,0,2,2,32,113,145
00936800,UNIVERSITY OF ABERDEEN                  ,FC,00000-0000,Public       ,0,0,0,44,142,186
00942300,ROYAL COLLEGE OF ART                    ,FC,00000-0000,Public       ,0,1,1,4,69,73
00942800,TECHNION-ISRAEL INST OF TECHLGY         ,FC,00000-0000,Public       ,0,0,0,5,63,68
00944200,UNIVERSITY OF EXETER                    ,FC,00000-0000,Public       ,0,0,0,22,102,124
00944400,UNIVERSITY OF LANCASTER                 ,FC,00000-0000,Public       ,0,0,0,15,58,73
00963400,UNIVERSITY OF OXFORD ST CATHERINE'S     ,FC,00000-0000,Public       ,0,0,0,5,9,14
00980800,UNIVERSITY OF STRATHCLYDE               ,FC,00000-0000,Public       ,0,0,0,15,48,63
00986000,UNIVERSITY OF SURREY                    ,FC,00000-0000,Public       ,0,0,0,12,44,56
00988800,KAROLINSKA INSTITUTET                   ,FC,00000-0000,Public       ,0,0,0,0,1,1
00990600,PONTIFICAL NORTH AMERICAN COLLEGE       ,FC,00000-0000,Private      ,0,0,0,1,7,8
00992700,UNIVERSITY OF CAMBRIDGE - FITZWILLI     ,FC,00000-0000,Public       ,0,0,0,1,11,12
01006700,LUND UNIVERSITY                         ,FC,00000-0000,Public       ,0,1,1,4,72,76
01008400,UNIVERSITY OF CAPE TOWN                 ,FC,00000-0000,Public       ,0,1,1,10,81,91
01008700,UNIVERSITY OF OXFORD ST PETER'S COL     ,FC,00000-0000,Public       ,0,1,1,1,6,7
01008800,UNIVERSITY OF OXFORD - CORPUS CHRIS     ,FC,00000-0000,Public       ,0,0,0,1,1,2
01008900,CENTRAL SCHOOL OF SPEECH AND DRAMA      ,FC,00000-0000,Private      ,0,0,0,16,64,80
01009000,UNIVERSITY OF OXFORD - BALLIOL COLL     ,FC,00000-0000,Public       ,0,0,0,4,4,8
01014300,UNIVERSITY OF READING                   ,FC,00000-0000,Public       ,0,0,0,17,66,83
01015700,CARDIFF UNIVERSITY                      ,FC,00000-0000,Public       ,0,0,0,20,62,82
01015900,PONTIFICIA UNIVERSITA GREGORIANA        ,FC,00000-0000,Private      ,0,0,0,2,5,7
01016000,CG JUNG INST                            ,FC,00000-0000,Private      ,0,0,0,0,5,5
01018800,UNIVERSITY COLLEGE DUBLIN               ,FC,00000-0000,Public       ,1,0,1,54,278,332
01019000,UNIVERSITY OF CAMBRIDGE CHURCHILL C     ,FC,00000-0000,Public       ,0,0,0,0,4,4
01022800,UNIVERSITY OF STIRLING                  ,FC,00000-0000,Public       ,0,0,0,35,65,100
01033200,UNIVERSITY OF CAMBRIDGE - CLARE COL     ,FC,00000-0000,Public       ,0,0,0,0,7,7
01045600,UNIVERSITY OF HAIFA                     ,FC,00000-0000,Public       ,0,0,0,5,39,44
01047200,INST EUROPEEN OPEEN D'ADMINISTRATIO     ,FC,00000-0000,Private      ,0,1,1,1,63,64
01049300,CRANFIELD UNIVERSITY                    ,FC,00000-0000,Public       ,0,0,0,1,21,22
01052000,TRINITY LABAN CONSERVATOIRE OF MUSIC AND,FC,00000-0000,Public       ,0,0,0,4,12,16
01052500,UNIVERSITY OF HERTFORDSHIRE             ,FC,00000-0000,Public       ,0,0,0,14,24,38
01057400,LONDON INTRNTL FILM SCHOOL              ,FC,00000-0000,Private      ,0,0,0,6,25,31
01058800,AUSTRALIAN NATIONAL UNIVERSITY          ,FC,00000-0000,Public       ,0,0,0,23,51,74
01058900,BANGOR UNIVERSITY                       ,FC,00000-0000,Public       ,0,0,0,14,18,32
01059400,"RICHMOND, THE AMERICAN INT UNI IN LONDON",FC,00000-0000,Private      ,0,0,0,395,94,489
01059900,INST D'ETUDES POLITIQUES DE PARIS       ,FC,00000-0000,Public       ,0,1,1,17,146,163
01068100,MACQUARIE UNIVERSITY                    ,FC,00000-0000,Public       ,0,0,0,10,55,65
01069200,UNIVERSITY OF QUEENSLAND (THE)          ,FC,00000-0000,Public       ,1,0,1,19,409,428
01078900,UNIVERSITY OF OXFORD - WORCESTER CO     ,FC,00000-0000,Public       ,0,0,0,0,1,1
01079200,CITY AND GUILDS OF LONDON INSTITUTE     ,FC,00000-0000,Private      ,0,0,0,2,3,5
01079700,"NATIONAL UNIVERSITY OF IRELAND, MAY     ",FC,00000-0000,Public       ,0,0,0,18,20,38
01081600,KINGSTON UNIVERSITY                     ,FC,00000-0000,Public       ,0,2,2,66,240,306
01083800,UNIVERSITITY OF BERGEN (UOB)            ,FC,00000-0000,Public       ,0,0,0,1,7,8
01086400,UNIV OF DUNDEE                          ,FC,00000-0000,Public       ,0,0,0,8,53,61
01086600,UNIVERSITY OF OXFORD - MAGDALEN COLLEGE ,FC,00000-0000,Public       ,0,0,0,1,11,12
01086700,UNIVERSITY OF OXFORD ST JOHN'S COLL     ,FC,00000-0000,Public       ,0,0,0,2,8,10
01091400,MONASH UNIVERSITY                       ,FC,00000-0000,Public       ,0,0,0,13,47,60
01091500,UNIV OF EAST ANGLIA                     ,FC,00000-0000,Public       ,0,0,0,27,103,130
01094200,UNIVERSITY OF OXFORD - ST HUGH'S CO     ,FC,00000-0000,Public       ,0,0,0,0,11,11
01097700,UNIVERSIDAD CENTRAL DEL ESTE            ,FC,00000-0000,Private      ,1,3,4,98,839,937
01098000,SOMERVILLE COLLEGE                      ,FC,00000-0000,Public       ,0,0,0,4,4,8
01099900,UNIV OF OXFORD - WADHAM COLLEGE         ,FC,00000-0000,Public       ,0,0,0,0,3,3
01104400,PONTIFICIA UNIVERSITA SAN TOMMASO       ,FC,00000-0000,Private      ,0,0,0,1,11,12
01105300,UNIVERSITY OF OXFORD - ST HILDA'S C     ,FC,00000-0000,Public       ,0,0,0,1,5,6
01105400,UNIVERSITY OF OXFORD - ST ANNE'S CO     ,FC,00000-0000,Public       ,0,0,0,1,6,7
01105500,UNIV OF OXFORD - LADY MARGARET HALL     ,FC,00000-0000,Public       ,0,0,0,1,7,8
01105600,UNIVERSITY OF OXFORD - UNIVERSITY C     ,FC,00000-0000,Public       ,0,0,0,11,32,43
01105700,UNIVERSITY OF OXFORD - TRINITY COLL     ,FC,00000-0000,Public       ,0,0,0,3,10,13
01105800,UNIVERSITY OF OXFORD-ST EDMUND HALL     ,FC,00000-0000,Public       ,0,0,0,1,9,10
01105900,UNIVERSITY OF OXFORD ST ANTONY'S CO     ,FC,00000-0000,Public       ,0,0,0,0,37,37
01106000,UNIVERSITY OF OXFORD - QUEEN'S COLL     ,FC,00000-0000,Public       ,0,0,0,1,7,8
01106100,UNIVERSITY OF OXFORD - PEMBROKE COL     ,FC,00000-0000,Public       ,0,0,0,3,11,14
01106200,UNIVERSITY OF OXFORD - ORIEL COLLEG     ,FC,00000-0000,Public       ,0,0,0,0,10,10
01106300,UNIVERSITY OF OXFORD - NUFFIELD COL     ,FC,00000-0000,Public       ,0,0,0,0,2,2
01106400,UNIVERSITY OF OXFORD - NEW COLLEGE      ,FC,00000-0000,Public       ,0,0,0,2,8,10
01106500,UNIVERSITY OF OXFORD MERTON COLLEGE     ,FC,00000-0000,Public       ,0,0,0,1,9,10
01106600,UNIVERSITY OF OXFORD - LINCOLN COLL     ,FC,00000-0000,Public       ,0,0,0,0,6,6
01106700,UNIVERSITY OF OXFORD - KEBLE COLLEG     ,FC,00000-0000,Public       ,0,0,0,0,6,6
01106800,UNIVERSITY OF OXFORD - JESUS COLLEG     ,FC,00000-0000,Public       ,0,0,0,0,5,5
01106900,UNIVERSITY OF OXFORD - HERTFORD COL     ,FC,00000-0000,Public       ,0,0,0,0,7,7
01107000,UNIVERSITY OF OXFORD EXETER COLLEGE     ,FC,00000-0000,Public       ,0,0,0,3,4,7
01107100,UNIV OF OXFORD - CHRIST CHURCH          ,FC,00000-0000,Public       ,0,0,0,2,11,13
01107200,UNIVERSITY OF OXFORD - BRASENOSE CO     ,FC,00000-0000,Public       ,0,0,0,0,3,3
01109100,FLINDERS UNIVERSITY OF S AUSTRALIA      ,FC,00000-0000,Public       ,0,0,0,2,35,37
01109400,UNIVERSITY OF WESTERN AUSTRALIA (THE)   ,FC,00000-0000,Public       ,0,1,1,10,26,36
01121400,UNIVERSITY OF THE WITWATERSRAND         ,FC,00000-0000,Public       ,1,0,1,7,24,31
01122600,AARHUS UNIVERSITY                       ,FC,00000-0000,Public       ,0,0,0,3,28,31
01156700,"IMPERIAL COLLEGE OF SCIENCE, TECHNOLOGY ",FC,00000-0000,Public       ,0,0,0,25,108,133
01167900,UNIVERSITY OF BATH                      ,FC,00000-0000,Public       ,0,0,0,21,51,72
01168300,FRANKLIN COLLEGE  SWITZERLAND           ,FC,00000-0000,Private      ,0,0,0,337,20,357
01175800,UNIV OF CAMBRIDGE - PETERHOUSE          ,FC,00000-0000,Public       ,0,0,0,0,6,6
01176400,ROYAL ACADEMY OF MUSIC                  ,FC,00000-0000,Public       ,0,0,0,8,24,32
01176500,GOLDSMITHS' COLLEGE-UNIV OF LONDON      ,FC,00000-0000,Public       ,0,1,1,50,163,213
01176600,UNIV OF LONDON - INST OF EDUC           ,FC,00000-0000,Public       ,0,0,0,3,50,53
01178000,BRUNEL UNIVERSITY                       ,FC,00000-0000,Public       ,0,0,0,11,56,67
01183800,UNIVERSITY OF OXFORD - MANSFIELD CO     ,FC,00000-0000,Public       ,0,0,0,1,7,8
01207500,UNIVERSITY CAMBRIDGE - TRINITY COLL     ,FC,00000-0000,Public       ,0,0,0,2,20,22
01207800,VICTORIA UNIV OF WELLINGTON             ,FC,00000-0000,Public       ,0,1,1,22,56,78
01209600,ECOLE HÔTELIERE DE LAUSANNE             ,FC,00000-0000,Private      ,1,0,1,8,9,17
01210100,UNIVERSITY OF CAMBRIDGE - GIRTON CO     ,FC,00000-0000,Public       ,0,0,0,0,8,8
01213600,VICTORIA UNIV OF MANCHESTER (THE)       ,FC,00000-0000,Public       ,0,0,0,38,153,191
01219800,UNIVERSITY OF BRADFORD                  ,FC,00000-0000,Public       ,0,0,0,3,25,28
01220100,UNIVERSITY OF OXFORD - REGENT'S PAR     ,FC,00000-0000,Public       ,0,0,0,1,5,6
01220600,JAMES COOK UNIVERSITY                   ,FC,00000-0000,Public       ,0,0,0,25,76,101
01221500,BIRMINGHAM CITY UNIVERSITY              ,FC,00000-0000,Public       ,0,0,0,12,34,46
01222300,JAGIELLONIAN UNIVERSITY COLLEGIUM M     ,FC,00000-0000,Public       ,0,0,0,3,24,27
01222500,UNIVERSITY OF SZEGED FACULTY OF MEDICINE,FC,00000-0000,Public       ,0,0,0,1,10,11
01225800,ASTON UNIVERSITY                        ,FC,00000-0000,Public       ,0,0,0,5,20,25
01227500,UNIVERSITY OF OXFORD - WOLFSON COLL     ,FC,00000-0000,Public       ,0,0,0,0,26,26
01230200,GONVILLE & CAIUS COLLEGE                ,FC,00000-0000,Public       ,0,0,0,2,3,5
01233300,UNIVERSITY OF THE ARTS LONDON IDO - CAMB,FC,00000-0000,Public       ,0,0,0,15,12,27
01233500,ROYAL COLLEGE OF MUSIC                  ,FC,00000-0000,Public       ,0,0,0,11,26,37
01234100,UNIVERSITY OF WALES - ST DAVID'S UN     ,FC,00000-0000,Public       ,0,0,0,5,25,30
01242100,UNIV OF AUCKLAND                        ,FC,00000-0000,Public       ,1,0,1,31,99,130
01253900,UNIVERSITY OF THE ARTS LONDON IDO - CENT,FC,00000-0000,Public       ,0,0,0,23,31,54
01254000,UNIVERSIDAD DE NAVARRA                  ,FC,00000-0000,Private      ,0,1,1,18,25,43
01276500,UNIVERSITY OF OXFORD - LINACRE COLL     ,FC,00000-0000,Public       ,0,0,0,0,11,11
01276600,"NATIONAL UNIVERSITY IRELAND, GALWAY     ",FC,00000-0000,Public       ,1,0,1,33,95,128
01280200,PONTIFICIA UNIV CATOLICA MAD Y MAES     ,FC,00000-0000,Private      ,3,2,5,185,112,297
01281100,INST TECNOLOGICO DE SANTO DOMINGO       ,FC,00000-0000,Private      ,0,2,2,49,67,116
01283900,UNIVERSITY OF CAMBRIDGE - SAINT JOH     ,FC,00000-0000,Public       ,0,0,0,0,11,11
01297800,UNIVERSITY OF HUDDERSFIELD (THE)        ,FC,00000-0000,Public       ,0,0,0,8,20,28
01315300,MASSEY UNIVERSITY                       ,FC,00000-0000,Public       ,0,1,1,7,75,82
01322500,COLLEGE OF LAW                          ,FC,00000-0000,Private      ,0,0,0,0,2,2
02052400,DARWIN COLLEGE                          ,FC,00000-0000,Public       ,0,0,0,0,10,10
02082400,UNIVERSITY OF CAMBRIDGE - QUEEN'S C     ,FC,00000-0000,Public       ,0,0,0,1,25,26
02083400,UNIVERSITY OF CAMBRIDGE - WOLFSON C     ,FC,00000-0000,Public       ,0,0,0,0,18,18
02087400,UNIVERSITY OF CAMBRIDGE - NEWNHAM C     ,FC,00000-0000,Public       ,0,0,0,1,8,9
02087900,OXFORD BROOKES UNIVERSITY               ,FC,00000-0000,Public       ,0,0,0,29,95,124
02094100,BEN-GURION UNIV                         ,FC,00000-0000,Public       ,0,1,1,0,132,132
02094400,UNIV OF CAMBRIDGE - ST EDMUND'S HOU     ,FC,00000-0000,Public       ,0,0,0,2,18,20
02095500,LONDON BUS SCHOOL                       ,FC,00000-0000,Public       ,0,1,1,6,129,135
02101900,ROEHAMPTON UNIVERSITY                   ,FC,00000-0000,Public       ,0,1,1,18,104,122
02108600,LONDON ACADEMY OF MUSIC & DRAMATIC      ,FC,00000-0000,Private      ,0,0,0,16,35,51
02115900,UNIVERSITY OF PORTSMOUTH                ,FC,00000-0000,Public       ,0,0,0,10,24,34
02116700,UNIVERSITY OF CAMBRIDGE - LUCY CAVE     ,FC,00000-0000,Public       ,0,0,0,1,3,4
02120000,UNIV OF LONDON - COURTALD INST OF A     ,FC,00000-0000,Public       ,0,0,0,3,39,42
02133400,UNIVERSITY OF CAMBRIDGE - SIDNEY SU     ,FC,00000-0000,Public       ,0,0,0,1,8,9
02142000,UNIVERSITY OF CAMBRIDGE - HOMERTON      ,FC,00000-0000,Public       ,0,0,0,0,7,7
02149700,UNIVERSITY OF WINCHESTER (THE)          ,FC,00000-0000,Public       ,0,0,0,19,15,34
02156800,UNIV OF OTAGO                           ,FC,00000-0000,Public       ,0,0,0,11,42,53
02162300,"IESE BUSINESS SCH, UNIV OF NAVARRA      ",FC,00000-0000,Private      ,0,1,1,8,72,80
02167400,UNIVERSITY OF CAMBRIDGE - CORPUS CH     ,FC,00000-0000,Public       ,0,0,0,0,11,11
02177700,KING'S COLLEGE- UNIV OF CAMBRIDGE       ,FC,00000-0000,Public       ,0,0,0,7,28,35
02180500,MIDDLESEX UNIVERSITY                    ,FC,00000-0000,Public       ,0,0,0,40,106,146
02181000,UNIVERSITY OF SOUTH AUSTRALIA           ,FC,00000-0000,Public       ,0,0,0,8,11,19
02183500,UNIV OF OXFORD - WYCLIFFE HALL          ,FC,00000-0000,Public       ,0,0,0,1,10,11
02186000,UNIVERSITY OF CAMBRIDGE - MAGDALENE     ,FC,00000-0000,Public       ,0,0,0,1,5,6
02186100,UNIVERSITY OF CAMBRIDGE - EMMANUEL      ,FC,00000-0000,Public       ,0,0,0,0,6,6
02189600,UNIVERSITY OF GRONINGEN                 ,FC,00000-0000,Public       ,0,0,0,4,28,32
02194800,UNIVERSITY OF THE WEST OF ENGLAND -     ,FC,00000-0000,Public       ,0,0,0,9,13,22
02195100,UNIV OF WESTMINSTER                     ,FC,00000-0000,Public       ,0,0,0,57,137,194
02196700,GUILDHALL SCHOOL OF MUSIC & DRAMA       ,FC,00000-0000,Public       ,0,0,0,16,22,38
02207300,UNIVERSITY OF CAMBRIDGE - CHRIST'S      ,FC,00000-0000,Public       ,0,0,0,1,5,6
02207400,CHINESE UNIVERSITY OF HONG KONG (THE)   ,FC,00000-0000,Public       ,0,0,0,19,56,75
02209500,UNIVERSITEIT UTRECHT                    ,FC,00000-0000,Public       ,0,0,0,14,52,66
02210000,UNIV OF LONDON - LONDON SCHOOL OF H     ,FC,00000-0000,Public       ,0,1,1,3,94,97
02212300,UNIVERSITY OF CAMBRIDGE - ROBINSON      ,FC,00000-0000,Public       ,0,0,0,0,1,1
02225300,UNIVERSITY OF CANTERBURY                ,FC,00000-0000,Public       ,0,0,0,6,44,50
02229100,UNIVERSITY OF LEICESTER                 ,FC,00000-0000,Public       ,0,2,2,18,119,137
02229600,SACKLER SCHOOL OF MEDICINE              ,FC,00000-0000,Public       ,0,0,0,2,152,154
02232100,UNIVERSITY OF CAMBRIDGE                 ,FC,00000-0000,Public       ,0,0,0,2,26,28
02233300,"ST GEORGE'S UNIVERSITY, SCHOOL OF MEDICI",FC,00000-0000,Proprietary  ,0,10,10,24,3739,3763
02235300,LONDON METROPOLITAN UNIVERSITY          ,FC,00000-0000,Public       ,0,0,0,25,87,112
02244400,AMERICAN UNIV OF THE CARIBBEAN          ,FC,00000-0000,Proprietary  ,1,31,32,15,1814,1829
02266600,UNIVERSITY OF LONDON - SAINT GEORGE     ,FC,00000-0000,Public       ,0,0,0,3,27,30
02271700,UNIVERSITY OF CAMBRIDGE - CLARE HAL     ,FC,00000-0000,Public       ,0,0,0,0,4,4
02271900,UNIVERSITY OF OXFORD - BLACKFRIARS      ,FC,00000-0000,Public       ,0,0,0,0,5,5
02272200,UNIV OF CAMBRIDGE - NEW HALL            ,FC,00000-0000,Public       ,0,0,0,0,5,5
02273600,QUEEN'S UNIV OF BELFAST (THE)           ,FC,00000-0000,Public       ,0,0,0,12,77,89
02273900,HERIOT WATT UNIVERSITY                  ,FC,00000-0000,Public       ,0,0,0,9,54,63
02276700,NYENRODE BUSINESS UNIVERSITEIT          ,FC,00000-0000,Private      ,0,1,1,0,4,4
02293400,ECOLE DES HAUTES ETUDES COMERCIALS      ,FC,00000-0000,Public       ,0,1,1,1,32,33
02296300,UNIVERSITY OF CAMBRIDGE - JESUS COL     ,FC,00000-0000,Public       ,0,0,0,0,7,7
02310500,DE MONTFORT UNIVERSITY                  ,FC,00000-0000,Public       ,0,0,0,3,9,12
02320500,ROYAL NORTHERN COLLEGE OF MUSIC         ,FC,00000-0000,Public       ,0,0,0,0,13,13
02335100,UNIV OF CAMBRIDGE - TRINITY HALL        ,FC,00000-0000,Public       ,0,0,0,2,16,18
02338900,UNIVERSITY  FOR THE CREATIVE ARTS       ,FC,00000-0000,Public       ,0,0,0,9,13,22
02351800,UNIVERSIDAD IBEROAMERICANA (UNIBE       ,FC,00000-0000,Private      ,3,4,7,118,524,642
02352100,UNIVERSITY OF PLYMOUTH                  ,FC,00000-0000,Public       ,0,0,0,7,21,28
02355200,ECOLE SUPERIEURE DE CUISINE FRANCAISE-FE,FC,00000-0000,Public       ,0,0,0,4,17,21
02493000,ESCUELA SUPERIOR ADMINISTRACION Y D     ,FC,00000-0000,Private      ,0,0,0,6,26,32
02496700,NATIONAL FILM & TV SCHOOL               ,FC,00000-0000,Public       ,0,0,0,0,10,10
02502600,PECSI ORVOSTUDOMANYI EGYETEM (PECS      ,FC,00000-0000,Public       ,0,0,0,0,2,2
02545700,GLASGOW SCHOOL OF ART                   ,FC,00000-0000,Public       ,0,0,0,9,27,36
02561600,SOUTHAMPTON SOLENT UNIVERSITY           ,FC,00000-0000,Public       ,0,0,0,8,8,16
02579600,MURDOCH UNIVERSITY                      ,FC,00000-0000,Public       ,0,0,0,2,58,60
02588000,UNIVERSITY OF ULSTER                    ,FC,00000-0000,Public       ,0,1,1,5,20,25
02591800,CURTIN UNIVERSITY OF TECHNOLOGY         ,FC,00000-0000,Public       ,0,1,1,3,18,21
02611700,DUBLIN CITY UNIVERSITY                  ,FC,00000-0000,Public       ,0,0,0,10,37,47
02623200,UNIVERSITY OF NEWCASTLE (THE)           ,FC,00000-0000,Public       ,0,0,0,11,17,28
03012700,UNIVERSITY OF BUCKINGHAM                ,FC,00000-0000,Private      ,0,0,0,5,11,16
03029400,KEELE UNIVERSITY                        ,FC,00000-0000,Public       ,0,0,0,20,21,41
03029500,NORTHUMBRIA UNIVERSITY                  ,FC,00000-0000,Public       ,0,0,0,7,29,36
03029800,NORGES HANDELSHOYSKOLE                  ,FC,00000-0000,Public       ,0,0,0,1,3,4
03033300,MANCHESTER METROPOLITAN UNIV            ,FC,00000-0000,Public       ,0,0,0,27,49,76
03045000,UNIVERSITY OF EAST LONDON               ,FC,00000-0000,Public       ,0,0,0,36,86,122
03050100,STUDIO ART CENTERS INTERNATIONAL        ,FC,00000-0000,Private      ,0,1,1,21,47,68
03066800,PONTIFICIO ATENEO DELLA SANTA CROCE     ,FC,00000-0000,Private      ,0,0,0,0,6,6
03067200,UNIVERSITY OF SYDNEY                    ,FC,00000-0000,Public       ,1,2,3,27,255,282
03073800,UNIV OF DEBRECEN MED & HEALTH SCI       ,FC,00000-0000,Public       ,0,0,0,6,20,26
03078700,UNIVERSITA COMMERCIALE L BOCCONI        ,FC,00000-0000,Private      ,0,1,1,0,1,1
03080300,SHEFFIELD HALLAM UNIVERSITY             ,FC,00000-0000,Public       ,0,0,0,2,16,18
03084300,UNIVERSITY OF LIMERICK                  ,FC,00000-0000,Public       ,0,0,0,24,59,83
03088700,ROYAL SCOTTISH ACAD MUSIC & DRAMA       ,FC,00000-0000,Public       ,0,1,1,26,24,50
03091400,UNIVERSITY OF WOLLONGONG                ,FC,00000-0000,Public       ,0,0,0,5,22,27
03091500,UNIVERSITY OF CANBERRA                  ,FC,00000-0000,Public       ,0,0,0,4,11,15
03091700,POZNAN UNIVERSITY OF MEDICAL SCIENCES   ,FC,00000-0000,Public       ,0,1,1,9,76,85
03092500,NOTTINGHAM TRENT UNIVERSITY             ,FC,00000-0000,Public       ,0,0,0,11,29,40
03095000,RMIT UNIVERSITY                         ,FC,00000-0000,Public       ,0,0,0,17,51,68
03095400,BOND UNIVERSITY                         ,FC,00000-0000,Private      ,0,1,1,14,58,72
03095900,ESSEC BUSINESS SCHOOL                   ,FC,00000-0000,Private      ,0,0,0,0,14,14
03096100,LA TROBE UNIVERSITY                     ,FC,00000-0000,Public       ,0,1,1,12,33,45
03096900,DEAKIN UNIVERSITY                       ,FC,00000-0000,Public       ,0,0,0,5,8,13
03097100,UNIVERSITY OF WESTERN SYDNEY            ,FC,00000-0000,Public       ,0,0,0,3,6,9
03097300,VICTORIA UNIVERSITY OF TECHNOLOGY       ,FC,00000-0000,Public       ,0,1,1,4,13,17
03097500,CENTRAL QUEENSLAND UNIVERSITY           ,FC,00000-0000,Public       ,0,0,0,1,10,11
03100000,UNIVERSITY OF ADELAIDE (THE)            ,FC,00000-0000,Public       ,0,0,0,4,19,23
03101600,ASIAN INSTITUTE OF MANAGEMENT           ,FC,00000-0000,Private      ,0,2,2,3,32,35
03102500,AMERICAN UNIVERSITY OF ROME             ,FC,00000-0000,Private      ,0,0,0,159,75,234
03102800,ROBERT GORDON UNIVERSITY (THE)          ,FC,00000-0000,Public       ,0,0,0,3,48,51
03104800,GRIFFITH UNIVERSITY                     ,FC,00000-0000,Public       ,0,0,0,12,40,52
03136300,AUSTRALIAN CATHOLIC UNIVERSITY          ,FC,00000-0000,Public       ,0,0,0,4,13,17
03140300,EDITH COWAN UNIVERSITY                  ,FC,00000-0000,Public       ,0,0,0,3,5,8
03140400,NORTHERN TERRITORY UNIVERSITY           ,FC,00000-0000,Public       ,0,0,0,0,2,2
03140500,QUEENSLAND UNIVERSITY OF TECHNOLOGY     ,FC,00000-0000,Public       ,0,0,0,6,24,30
03140600,SOUTHERN CROSS UNIVERSITY               ,FC,00000-0000,Public       ,0,0,0,2,21,23
03140700,SWINBURNE UNIVERSITY OF TECHNOLOGY      ,FC,00000-0000,Public       ,0,0,0,2,13,15
03140900,UNIVERSITY OF BALLARAT                  ,FC,00000-0000,Public       ,0,0,0,0,2,2
03150400,"UNIVERSITY OF TECHNOLOGY, SYDNEY        ",FC,00000-0000,Public       ,0,1,1,7,46,53
03287300,LIVERPOOL INSTITUTE FOR PERFORMING ARTS ,FC,00000-0000,Public       ,0,0,0,13,0,13
03300300,"2ND SCHOOL OF MEDICINE, CHARLES UNI     ",FC,00000-0000,Public       ,1,0,1,3,18,21
03300400,"FIRST FACULTY OF MEDICINE, CHARLES UNIV.",FC,00000-0000,Public       ,0,0,0,3,36,39
03329300,JOHN CABOT UNIVERSITY                   ,FC,00000-0000,Private      ,0,0,0,172,35,207
03333300,MEDICAL UNIVERSITY SCHOOL OF LUBLIN     ,FC,00000-0000,Public       ,0,3,3,7,195,202
03334300,UNIVERSIDAD NORDESTANA                  ,FC,00000-0000,Private      ,0,0,0,14,72,86
03335300,MEDICAL UNIVERSITY OF SILESIA           ,FC,00000-0000,Public       ,0,0,0,5,45,50
03342300,GLASGOW CALEDONIAN UNIVERSITY           ,FC,00000-0000,Public       ,0,0,0,6,20,26
03349400,"QUEEN MARGARET UNIVERSITY, EDINBURGH    ",FC,00000-0000,Public       ,0,0,0,3,32,35
03350300,BOURNEMOUTH UNIVERSITY                  ,FC,00000-0000,Public       ,0,0,0,8,27,35
03352300,LONDON SOUTH BANK UNIVERSITY            ,FC,00000-0000,Private      ,0,0,0,15,49,64
03363300,THE ARTS EDUCATIONAL SCHOOLS LONDON     ,FC,00000-0000,Private      ,0,0,0,0,2,2
03364300,"FACULTY OF MEDICINE, PALACKY UNIVER     ",FC,00000-0000,Public       ,0,0,0,0,4,4
03365400,AUCKLAND INSTITUTE OF TECHNOLOGY        ,FC,00000-0000,Public       ,0,0,0,8,17,25
03366300,TROPICAL AGRICULTURE RESEARCH AND H     ,FC,00000-0000,Private      ,0,0,0,0,4,4
03378300,"THE 3RD FACULTY OF MEDICINE, CHARLE     ",FC,00000-0000,Public       ,0,0,0,1,8,9
03406300,"THE SCHOOL OF PHARMACY, UNIVERSITY      ",FC,00000-0000,Public       ,0,0,0,0,3,3
03418400,NAPIER UNIVERSITY                       ,FC,00000-0000,Public       ,0,0,0,13,55,68
03435300,ANGLIA  RUSKIN UNIVERSITY               ,FC,00000-0000,Private      ,0,0,0,15,36,51
03460300,INTERNATIONALES THEOLOGISCHES INSTI     ,FC,00000-0000,Private      ,0,0,0,2,21,23
03462400,UNIV OF ARTS LONDON - LON COLL OF COMMUN,FC,00000-0000,Public       ,0,0,0,14,14,28
03466300,INSTITUTO CENTROAMERICANO DE ADMINI     ,FC,00000-0000,Private      ,0,0,0,1,0,1
03473300,UNIV OF ARTS LONDON - LON COLL FASHION  ,FC,00000-0000,Public       ,1,0,1,130,144,274
03473305,UNIVERSITY OF THE ARTS LONDON - CHELSEA ,FC,00000-0000,Public       ,0,0,0,12,6,18
03473311,UNIVERSITY OF THE ARTS LONDON - WIMBLEDO,FC,00000-0000,Public       ,0,0,0,2,5,7
03474301,AVE MARIA COLLEGE                       ,FC,00000-0000,Private      ,0,0,0,110,38,148
03478300,ROYAL WELSH COLLEGE OF MUSIC AND DRAMA  ,FC,00000-0000,Public       ,0,0,0,15,18,33
03492300,UNIVERSITY OF OXFORD - GREEN TEMPLETON C,FC,00000-0000,Public       ,0,0,0,0,19,19
03492400,UNIV OF CAMBRIDGE-ST CATHERINE'S CG     ,FC,00000-0000,Public       ,0,0,0,0,6,6
03494400,UNIV OF CAMBRIDGE-SELWYN COLLEGE        ,FC,00000-0000,Public       ,0,0,0,0,7,7
03494600,UNIV OF OXFORD-HARRIS MANCHESTER        ,FC,00000-0000,Public       ,0,0,0,1,4,5
03501400,LEEDS METROPOLITAN UNIVERSITY           ,FC,00000-0000,Public       ,0,0,0,18,42,60
03507300,UNIVERSITY OF SUNDERLAND                ,FC,00000-0000,Public       ,0,0,0,5,13,18
03515300,UNIVERSITY OF CENTRAL LANCASHIRE        ,FC,00000-0000,Public       ,0,0,0,3,18,21
03517300,UNIVERSITY OF BRIGHTON                  ,FC,00000-0000,Public       ,0,0,0,11,33,44
03518300,EUROPEAN GRADUATE SCHOOL                ,FC,00000-0000,Private      ,0,33,33,0,151,151
03527300,SOFIA UNIVERSITY ST. KLIMENT OHRIDSKI   ,FC,00000-0000,Public       ,0,0,0,1,10,11
03533300,BATH SPA UNIVERSITY                     ,FC,00000-0000,Public       ,0,0,0,15,34,49
03547300,UNIVERSITY OF GLAMORGAN                 ,FC,00000-0000,Public       ,0,0,0,5,13,18
03580300,LIVERPOOL JOHN MOORES UNIVERSITY        ,FC,00000-0000,Public       ,0,0,0,7,8,15
03589400,ARTS INSTITUTE AT BOURNEMOUTH (THE)     ,FC,00000-0000,Public       ,0,0,0,11,10,21
03590300,AVONDALE COLLEGE LIMITED                ,FC,00000-0000,Private      ,0,0,0,4,4,8
03594300,GROUP ESC GRENOBLE GRAD SCH OF BUS.     ,FC,00000-0000,Private      ,0,0,0,0,22,22
03597300,JAGIELLONIAN UNIVERSITY                 ,FC,00000-0000,Public       ,0,1,1,1,28,29
03601300,UNIVERSITAT JAUME I DE CASTELLO (UJI)   ,FC,00000-0000,Public       ,0,0,0,1,16,17
03619300,UNIVERSITY OF GREENWICH                 ,FC,00000-0000,Public       ,0,0,0,32,49,81
03653400,UNIVERSIDAD DE IBEROAMERICA - UNIBE     ,FC,00000-0000,Private      ,0,0,0,4,35,39
03674300,UNIVERSITY OF ABERTAY DUNDEE            ,FC,00000-0000,Public       ,0,0,0,1,6,7
03684400,UNIVERSITY OF LINCOLN                   ,FC,00000-0000,Public       ,0,0,0,16,33,49
03684500,MEDICAL UNIVERSITY OF GDANSK            ,FC,00000-0000,Public       ,0,0,0,0,15,15
03694300,UNIVERSITY OF CHICHESTER                ,FC,00000-0000,Public       ,0,0,0,5,1,6
03716300,"UNIVERSITY OF WALES, NEWPORT            ",FC,00000-0000,Public       ,0,0,0,3,11,14
03727400,UNIVERSITY OF WAIKATO (THE)             ,FC,00000-0000,Public       ,0,0,0,8,14,22
03738300,LONDON SCHOOL OF THEOLOGY               ,FC,00000-0000,Private      ,0,0,0,1,8,9
03741300,ALRA (ACADEMY OF LIVE AND RECORDED ARTS),FC,00000-0000,Private      ,0,0,0,10,16,26
03770300,NAZARENE THEOLOGICAL COLLEGE            ,FC,00000-0000,Private      ,0,0,0,0,4,4
03780300,SABA UNIVERSITY SCHOOL OF MEDICINE      ,FC,00000-0000,Proprietary  ,0,6,6,2,192,194
03784300,MEDICAL UNIVERSITY OF BIALYSTOK         ,FC,00000-0000,Public       ,0,0,0,0,1,1
03794400,ANGLO EUROPEAN COLLEGE OF CHIROPRACTIC  ,FC,00000-0000,Private      ,0,0,0,1,3,4
03807300,ROSE BRUFORD COLLEGE                    ,FC,00000-0000,Public       ,0,0,0,5,11,16
03816400,AMERICAN GRAD SCH OF INTERNTL REL & DIPL,FC,00000-0000,Private      ,0,1,1,8,77,85
03818300,LEIPZIG GRADUATE SCHOOL OF MANAGEMENT   ,FC,00000-0000,Private      ,0,0,0,2,23,25
03824300,"ROYAL VETERINARY COLLEGE (THE), UNIVERSI",FC,00000-0000,Public       ,0,0,0,4,146,150
03829300,INTERNATIONAL CHRISTIAN COLLEGE         ,FC,00000-0000,Private      ,0,0,0,0,1,1
03850500,MEDICAL UNIVERSITY OF LODZ              ,FC,00000-0000,Public       ,0,0,0,3,17,20
03859400,UNIVERSITY COLLEGE FALMOUTH             ,FC,00000-0000,Public       ,0,0,0,12,8,20
03873300,COPENHAGEN BUSINESS SCHOOL              ,FC,00000-0000,Public       ,0,0,0,2,14,16
03880300,UNIVERSITY OF GLOUCESTERSHIRE (THE)     ,FC,00000-0000,Public       ,0,0,0,2,9,11
03897400,INTERNATIONAL SPACE UNIVERSITY          ,FC,00000-0000,Private      ,0,0,0,0,6,6
03974300,"ST. GEORGE'S UNIVERSITY, SCHOOL OF VETER",FC,00000-0000,Proprietary  ,0,1,1,8,620,628
04021400,"AMERICAN COLLEGE, DUBLIN LIMITED (THE)  ",FC,00000-0000,Private      ,0,0,0,30,35,65
04021500,CENTRAL EUROPEAN UNIVERSITY             ,FC,00000-0000,Private      ,0,2,2,4,102,106
04032300,YORK ST JOHN UNIVERSITY                 ,FC,00000-0000,Public       ,0,0,0,6,3,9
04046300,HK UNIVERSITY OF SCI & TECH (HKUST)     ,FC,00000-0000,Public       ,0,1,1,4,22,26
04070300,"RAPHAEL RECANATI INTERNATIONAL SCHOOL, T",FC,00000-0000,Private      ,0,1,1,88,67,155
04076300,NEWCASTLE COLLEGE                       ,FC,00000-0000,Public       ,0,0,0,1,2,3
04085400,NEW ZEALAND COLLEGE OF CHIROPRACTIC     ,FC,00000-0000,Private      ,0,0,0,0,5,5
04113300,LEBANESE AMERICAN UNIVERSITY            ,FC,00000-0000,Private      ,0,2,2,65,28,93
04115900,LIVERPOOL HOPE UNIVERSITY               ,FC,00000-0000,Public       ,0,0,0,5,10,15
04116300,EDHEC BUSINESS SCHOOL                   ,FC,00000-0000,Private      ,0,1,1,0,23,23
04128600,UNIVERSITY OF WORCESTER                 ,FC,00000-0000,Public       ,0,0,0,4,5,9
04128700,HERTIE SCHOOL OF GOVERNANCE             ,FC,00000-0000,Private      ,0,0,0,4,34,38
04134200,LONDON CONTEMPORARY DANCE SCHOOL        ,FC,00000-0000,Private      ,0,0,0,3,4,7
04139100,UNIVERSITA DEGLI STUDI DI SCIENZE GASTRO,FC,00000-0000,Private      ,0,0,0,1,36,37
04143700,ST MARY'S UNIVERSITY COLLEGE TWICKENHAM ,FC,00000-0000,Public       ,0,0,0,15,38,53
04168200,EUROPEAN UNIVERSITY AT ST. PETERSBURG   ,FC,00000-0000,Private      ,0,0,0,4,39,43
04171800,"INTERNATIONAL UNIVERSITY OF NURSING, ST.",FC,00000-0000,Proprietary  ,0,0,0,2,4,6
04176500,ESMT EUROPEAN SCHOOL OF MANAGEMENT AND T,FC,00000-0000,Private      ,0,0,0,4,23,27
00380600,ALDERSON BROADDUS UNIVERSITY            ,WV,26416-1051,Private      ,3,6,9,2005,481,2486
00380700,MOUNTAIN STATE UNIVERSITY               ,WV,25801-5624,Private      ,1,6,7,54,216,270
00380800,BETHANY COLLEGE                         ,WV,26032-0417,Private      ,1,1,2,1235,151,1386
00380900,BLUEFIELD STATE COLLEGE                 ,WV,24701-2198,Public       ,7,38,45,1452,2074,3526
00381000,CONCORD UNIVERSITY                      ,WV,24712-0000,Public       ,11,36,47,3009,1708,4717
00381100,DAVIS & ELKINS COLLEGE                  ,WV,26241-3996,Private      ,4,4,8,1126,380,1506
00381200,FAIRMONT STATE UNIVERSITY               ,WV,26554-2470,Public       ,12,63,75,5252,3718,8970
00381300,GLENVILLE STATE COLLEGE                 ,WV,26351-1292,Public       ,5,7,12,1560,690,2250
00381500,MARSHALL UNIVERSITY                     ,WV,25755-3300,Public       ,20,112,132,10759,8111,18870
00381600,SOUTHERN WV COMMUNITY COLLEGE           ,WV,25637-2900,Public       ,6,23,29,1350,1738,3088
00381800,UNIVERSITY OF CHARLESTON                ,WV,25304-1099,Private      ,7,20,27,2011,2307,4318
00381900,OHIO VALLEY COLLEGE                     ,WV,26105-8000,Private      ,1,9,10,516,224,740
00382000,SALEM INTERNATIONAL UNIVERSITY          ,WV,26426-0500,Proprietary  ,7,55,62,434,1024,1458
00382200,SHEPHERD UNIVERSITY                     ,WV,25443-5000,Public       ,7,23,30,4202,1903,6105
00382300,WEST LIBERTY UNIVERSITY                 ,WV,26074-0295,Public       ,4,25,29,3162,1196,4358
00382600,WEST VIRGINIA STATE UNIVERSITY          ,WV,25112-0000,Public       ,12,26,38,2593,2353,4946
00382700,WEST VIRGINIA UNIVERSITY                ,WV,26506-6201,Public       ,53,125,178,27111,10656,37767
00382711,WEST VIRGINIA UNIVERSITY - POTOMAC STATE,WV,26726-3000,Public       ,13,20,33,2014,771,2785
00382721,WEST VIRGINIA UNIV INST OF TECH         ,WV,25136-2436,Public       ,6,10,16,1492,772,2264
00382800,WEST VIRGINIA UNIV AT PARKERSBURG       ,WV,26101-9577,Public       ,12,69,81,1943,3282,5225
00383000,WEST VIRGINIA WESLEYAN COLLEGE          ,WV,26201-2600,Private      ,2,4,6,2113,372,2485
00383100,WHEELING JESUIT UNIVERSITY              ,WV,26003-6243,Private      ,2,35,37,1358,1162,2520
00500700,WEST VIRGINIA JUNIOR COLLEGE            ,WV,26505-5596,Proprietary  ,13,40,53,353,589,942
00500800,MOUNTAIN STATE COLLEGE                  ,WV,26101-3993,Proprietary  ,3,31,34,72,462,534
00754400,APPALACHIAN BIBLE COLLEGE               ,WV,25818-1353,Private      ,1,0,1,295,80,375
00757800,HUNTINGTON SCHOOL OF BEAUTY CULTURE     ,WV,25705-2030,Proprietary  ,1,2,3,112,224,336
00760000,INTERNATIONAL BEAUTY SCHOOL             ,WV,25401-3231,Proprietary  ,1,27,28,45,166,211
00835500,JAMES RUMSEY TECHNICAL INSTITUTE        ,WV,25403-0259,Public       ,1,9,10,129,459,588
00895900,CLARKSBURG BEAUTY ACADEMY               ,WV,26301-2903,Proprietary  ,5,15,20,89,158,247
00904700,HUNTINGTON JUNIOR COLLEGE               ,WV,25701-2004,Proprietary  ,10,76,86,231,1444,1675
00905400,WEST VIRGINIA NORTHERN CMTY COLLEGE     ,WV,26003-0000,Public       ,14,50,64,1130,2304,3434
01014000,MINERAL COUNTY VOCATIONAL TECH CTR      ,WV,26726-0000,Public       ,0,2,2,15,85,100
01035600,EVEREST INSTITUTE                       ,WV,25313-1304,Proprietary  ,6,38,44,96,528,624
01057300,WEST VIRGINIA JUNIOR COLLEGE            ,WV,25322-0000,Proprietary  ,9,22,31,225,528,753
01057302,WEST VIRGINIA JUNIOR COLLEGE            ,WV,26330-0000,Proprietary  ,10,16,26,227,334,561
01086100,WEST VIRGINIA BUSINESS COLLEGE          ,WV,26301-0000,Proprietary  ,4,9,13,46,236,282
01124500,WEST VIRGINIA SCH OSTEOPATHIC MED       ,WV,24901-1128,Public       ,0,2,2,34,874,908
01174900,WOOD COUNTY SCH OF PRAC NURSING         ,WV,26101-6424,Public       ,1,5,6,49,153,202
01235900,B M SPURR SCHOOL OF PRAC NURSING        ,WV,26038-1660,Private      ,0,1,1,15,47,62
01257300,WEST VIRGINIA UNIV-HOSP-RAD TECH        ,WV,26506-8062,Private      ,0,4,4,208,161,369
01274300,BENJAMIN FRANKLIN CAREER&TECH           ,WV,25064-0000,Public       ,2,3,5,105,282,387
01290400,MONONGALIA CNTY TECH ED CTR             ,WV,26501-6841,Public       ,0,3,3,96,201,297
01290500,ACADEMY OF CAREERS AND TECHNOLOGY       ,WV,25801-0000,Public       ,2,9,11,127,452,579
02057400,ROANE-JACKSON TECHNICAL CENTER          ,WV,25252-0000,Public       ,0,1,1,25,94,119
02068000,UNITED TECHNICAL CENTER                 ,WV,26301-0000,Public       ,0,4,4,43,181,224
02073400,CARVER CAREER TECH ED CTR               ,WV,25306-6397,Public       ,3,12,15,226,531,757
02145100,SCOTT COLLEGE OF COSMETOLOGY            ,WV,26003-0000,Proprietary  ,7,6,13,96,107,203
02178200,CHARLESTON SCHOOL OF BEAUTY CULTURE     ,WV,25301-0000,Proprietary  ,11,8,19,122,266,388
02218200,GARNET CAREER CENTER                    ,WV,25301-0000,Public       ,5,8,13,122,499,621
02275300,CABELL COUNTY CAREER TECHNOLOGY CTR     ,WV,25705-0000,Public       ,4,7,11,158,376,534
02524500,RALPH R WILLIS VOCATIONAL CENTER        ,WV,25601-0000,Public       ,0,1,1,34,105,139
02534800,FRED W EBERLE TECHNICAL CENTER          ,WV,26201-0000,Public       ,1,2,3,82,195,277
02535500,MERCER COUNTY TECH EDUC CNTR            ,WV,24740-0000,Public       ,0,7,7,116,354,470
02579900,NORTH CENTRAL OPPORTUNITIES INDUSTRIALIZ,WV,26554-2936,Private      ,2,5,7,52,173,225
02609400,VALLEY COLLEGE                          ,WV,25404-5711,Proprietary  ,3,23,26,52,313,365
03052000,MEREDITH MANOR EQUESTRIAN CENTRE        ,WV,26184-9707,Proprietary  ,1,1,2,277,135,412
03076500,FAYETTE INSTITUTE OF TECHNOLOGY         ,WV,25901-2174,Public       ,0,1,1,31,106,137
03084200,VALLEY COLLEGE                          ,WV,24740-3141,Proprietary  ,5,17,22,49,219,268
03084400,VALLEY COLLEGE                          ,WV,25801-2643,Proprietary  ,7,46,53,86,553,639
03098300,PUTNAM CAREER & TECHNICAL CENTER        ,WV,25070-0000,Public       ,1,2,3,99,162,261
03099200,"MOUNTAINEER BEAUTY COLLEGE, INC         ",WV,25177-2917,Proprietary  ,0,0,0,4,3,7
03102100,MORGANTOWN BEAUTY COLLEGE               ,WV,26505-5430,Proprietary  ,1,6,7,101,162,263
03123200,STANLEY TECHNICAL INSTITUTE             ,WV,26505-3751,Private      ,0,1,1,16,52,68
03327500,SOUTH BRANCH VOCATIONAL TECH CENTER     ,WV,26847-1698,Public       ,1,0,1,16,24,40
03734300,JOHN D. ROCKEFELLER IV CAREER CENTER    ,WV,26047-9424,Public       ,0,0,0,12,38,50
03819300,AMERICAN PUBLIC UNIVERSITY SYSTEM       ,WV,25414-1621,Proprietary  ,182,5302,5484,3010,79406,82416
03957300,BLUE RIDGE COMMUNITY AND TECHNICAL COLLE,WV,25401-3244,Public       ,12,51,63,1094,2734,3828
03960300,NEW RIVER COMMUNITY AND TECHNICAL COLLEG,WV,25801-2636,Public       ,11,59,70,1283,3059,4342
04028300,MOUNTAIN STATE SCHOOL OF MASSAGE        ,WV,25304-2025,Proprietary  ,0,4,4,20,93,113
04038500,PIERPONT COMMUNITY & TECHNICAL COLLEGE  ,WV,26554-2451,Public       ,6,41,47,1860,2255,4115
04038600,KANAWHA VALLEY COMMUNITY & TECH COLLEGE ,WV,25112-1000,Public       ,13,44,57,806,2140,2946
04041400,MOUNTWEST COMMUNITY AND TECHNICAL COLLEG,WV,25755-3300,Public       ,19,66,85,1179,2465,3644
04047300,BRIDGEMONT COMMUNITY & TECHNICAL COLLEGE,WV,25136-2435,Public       ,0,4,4,515,474,989
04119000,EASTERN WEST VIRGINIA COMMUNITY & TECHNI,WV,26836-0000,Public       ,6,22,28,249,775,1024
04139900,FUTURE GENERATIONS GRADUATE SCHOOL      ,WV,26807-0000,Private      ,0,1,1,0,3,3
04234800,RANDOLPH TECHNICAL CENTER               ,WV,26241-9527,Public       ,0,2,2,0,2,2
00106100,ALASKA PACIFIC UNIVERSITY               ,AK,99508-4672,Private      ,2,14,16,565,1116,1681
00106300,UNIVERSITY OF ALASKA FAIRBANKS          ,AK,99775-7500,Public       ,24,90,114,3725,4861,8586
00106500,UNIVERSITY OF ALASKA SOUTHEAST          ,AK,99801-8680,Public       ,8,56,64,952,1693,2645
00884300,ALASKA BIBLE COLLEGE                    ,AK,99588-0000,Private      ,0,0,0,40,42,82
01146200,UNIVERSITY OF ALASKA ANCHORAGE          ,AK,99514-1608,Public       ,44,209,253,7397,10440,17837
02541000,ALASKA CAREER COLLEGE                   ,AK,99507-1033,Proprietary  ,13,37,50,337,1211,1548
02576900,CHARTER COLLEGE                         ,AK,99508-0000,Proprietary  ,100,521,621,1231,4644,5875
03160300,AVTEC                                   ,AK,99664-0889,Public       ,2,7,9,290,500,790
03461300,ILISAGVIK COLLEGE                       ,AK,99723-0749,Public       ,0,2,2,41,99,140
04138600,ALASKA CHRISTIAN COLLEGE                ,AK,99669-9755,Private      ,0,0,0,44,74,118
00108500,UNIV ARKANSAS MONTICELLO                ,AR,71656-0000,Public       ,45,93,138,2700,2663,5363
00108600,UNIV OF ARKANSAS AT PINE BLUFF          ,AR,71601-2790,Public       ,148,58,206,3897,2171,6068
00108700,ARKANSAS BAPTIST COLLEGE                ,AR,72202-6099,Private      ,128,41,169,1447,1767,3214
00108800,LYON COLLEGE                            ,AR,72501-3699,Private      ,7,3,10,977,176,1153
00108900,ARKANSAS TECH UNIVERSITY                ,AR,72801-2222,Public       ,51,183,234,7383,6433,13816
00109000,ARKANSAS STATE UNIVERSITY               ,AR,72467-0000,Public       ,86,470,556,10552,13018,23570
00109002,ARKANSAS STATE UNIVERSITY - NEWPORT     ,AR,72112-1120,Public       ,0,0,0,818,1408,2226
00109006,DELTA TECHNICAL INSTITUTE               ,AR,72365-9558,Public       ,0,0,0,63,130,193
00109100,ARKANSAS STATE UNIVERSITY - BEEBE       ,AR,72012-1000,Public       ,23,81,104,2523,3473,5996
00109200,UNIVERSITY OF CENTRAL ARKANSAS          ,AR,72035-0001,Public       ,99,130,229,11009,5882,16891
00109300,CENTRAL BAPTIST COLLEGE                 ,AR,72034-6470,Private      ,4,6,10,710,747,1457
00109400,UNIVERSITY OF THE OZARKS                ,AR,72830-2880,Private      ,5,3,8,779,191,970
00109500,CROWLEYS RIDGE COLLEGE                  ,AR,72450-9775,Private      ,2,3,5,243,203,446
00109700,HARDING UNIVERSITY                      ,AR,72149-0001,Private      ,19,45,64,4331,2077,6408
00109800,HENDERSON STATE UNIVERSITY              ,AR,71999-0001,Public       ,52,35,87,4170,2148,6318
00109900,HENDRIX COLLEGE                         ,AR,72032-3080,Private      ,4,4,8,2409,365,2774
00110000,JOHN BROWN UNIVERSITY                   ,AR,72761-2747,Private      ,3,32,35,1700,1521,3221
00110100,UNIV ARKANSAS LITTLE ROCK               ,AR,72204-1099,Public       ,57,272,329,6132,11771,17903
00110200,OUACHITA BAPTIST UNIVERSITY             ,AR,71998-0001,Private      ,10,4,14,2028,261,2289
00110300,PHILANDER SMITH COLLEGE                 ,AR,72202-3718,Private      ,14,17,31,1170,1002,2172
00110400,PHILLIPS COUNTY COMMUNITY COLLEGE       ,AR,72342-0000,Public       ,34,26,60,615,999,1614
00110500,SHORTER COLLEGE                         ,AR,72114-4885,Private      ,4,38,42,111,789,900
00110600,WILLIAMS BAPTIST COLLEGE                ,AR,72476-4661,Private      ,3,5,8,660,189,849
00110700,SOUTHERN ARKANSAS UNIVERSITY            ,AR,71754-0000,Public       ,27,60,87,3224,2136,5360
00110800,UNIV ARKANSAS FAYETTEVILLE              ,AR,72701-0000,Public       ,89,159,248,19336,8148,27484
00110900,UNIVERSITY OF ARKANSAS FOR MEDICAL SCIEN,AR,72205-7102,Public       ,4,31,35,793,3432,4225
00111000,UNIVERSITY OF ARKANSAS-FORT SMITH       ,AR,72904-7397,Public       ,33,66,99,4863,4772,9635
00524500,U OF A COMM COLLEGE AT MORRILTON        ,AR,72110-9601,Public       ,19,39,58,1522,2364,3886
00570700,SEARK COLLEGE                           ,AR,71603-0000,Public       ,33,93,126,847,2320,3167
00573200,UNIV AR COMMUNITY COLLEGE AT HOPE       ,AR,71801-0000,Public       ,14,34,48,706,1422,2128
00704400,CROWLEYS RIDGE TECHNICAL INSTITUTE      ,AR,72336-0000,Public       ,3,6,9,204,436,640
00732967,ITT TECHNICAL INSTITUTE                 ,AR,72204-7739,Proprietary  ,11,83,94,336,1169,1505
00773800,SOUTHERN ARKANSAS UNIVERSITY TECH       ,AR,71701-1900,Public       ,14,37,51,684,1037,1721
00792100,PAUL MITCHELL THE SCHOOL ARKANSAS       ,AR,72701-0000,Proprietary  ,5,6,11,114,176,290
00997600,COLLEGE OF THE OUACHITAS                ,AR,72104-0816,Public       ,12,34,46,450,1355,1805
01074100,MELLIE'S BEAUTY COLLEGE                 ,AR,72901-3833,Proprietary  ,3,7,10,86,267,353
01210500,NATIONAL PARK COMMUNITY COLLEGE         ,AR,71913-9174,Public       ,12,63,75,1224,3036,4260
01226000,EAST ARKANSAS COMMUNITY COLLEGE         ,AR,72335-2204,Public       ,10,23,33,625,981,1606
01226100,NORTH ARKANSAS COLLEGE                  ,AR,72601-5508,Public       ,7,31,38,1199,2096,3295
01286000,ARKANSAS NORTHEASTERN COLLEGE           ,AR,72316-1109,Public       ,30,53,83,844,1511,2355
02052200,BLACK RIVER TECHNICAL COLLEGE           ,AR,72455-0000,Public       ,20,74,94,971,2421,3392
02073500,UNIVERSITY OF ARKANSAS COMMUNITY COLLEGE,AR,72503-0000,Public       ,17,39,56,732,1279,2011
02073700,NORTHWEST TECHNICAL INSTITUTE           ,AR,72765-0000,Public       ,3,7,10,274,635,909
02074600,SOUTH ARKANSAS COMMUNITY COLLEGE        ,AR,71731-0000,Public       ,16,64,80,811,2051,2862
02075300,PULASKI TECHNICAL COLLEGE               ,AR,72118-0000,Public       ,63,264,327,4603,15086,19689
02087000,OZARKA COLLEGE                          ,AR,72556-0000,Public       ,8,29,37,510,1446,1956
02111100,RICH MOUNTAIN COMMUNITY COLLEGE         ,AR,71953-0000,Public       ,4,17,21,402,665,1067
02202400,PROFESSIONAL COSMETOLOGY EDUC CTR       ,AR,71730-5828,Proprietary  ,1,7,8,30,87,117
02220900,COSSATOT COMMUNITY COLLEGE              ,AR,71832-0000,Public       ,4,19,23,600,1143,1743
02272400,EASTERN COLLEGE OF HEALTH VOCATIONS     ,AR,72205-3535,Proprietary  ,11,37,48,257,884,1141
02284200,NEW TYLER BARBER COLLEGE INC            ,AR,72114-0000,Proprietary  ,2,4,6,64,241,305
02287400,MARSHA KAY BEAUTY COLLEGE               ,AR,72653-0000,Proprietary  ,0,1,1,24,54,78
02330800,JEFFERSON SCHOOL OF NURSING             ,AR,71603-0000,Private      ,3,3,6,109,268,377
02339800,SOUTHERN INSTITUTE OF COSMETOLOGY       ,AR,72301-0000,Proprietary  ,5,13,18,33,96,129
02341700,CAREER ACADEMY OF HAIR DESIGN           ,AR,72764-4304,Proprietary  ,3,5,8,58,192,250
02341701,CAREER ACADEMY OF HAIR DESIGN - ROGERS  ,AR,72756-2102,Proprietary  ,3,4,7,50,162,212
02341702,CAREER ACADEMY OF HAIR DESIGN - SILOAM  ,AR,72761-4217,Proprietary  ,1,1,2,31,63,94
02341703,CAREER ACADEMY OF HAIR DESIGN - FAYETTEV,AR,72701-7731,Proprietary  ,3,1,4,5,4,9
02348200,MID-SOUTH COMMUNITY COLLEGE             ,AR,72301-0000,Public       ,27,76,103,913,2056,2969
02363500,ARTHUR'S BEAUTY COLLEGE                 ,AR,72901-0000,Proprietary  ,2,12,14,79,233,312
02525800,LEE'S SCHOOL OF COSMETOLOGY             ,AR,72114-0000,Proprietary  ,2,7,9,48,149,197
02538500,ARTHUR'S BEAUTY COLLEGE                 ,AR,72076-0000,Proprietary  ,1,12,13,90,290,380
02569600,SEARCY BEAUTY COLLEGE                   ,AR,72143-0000,Proprietary  ,7,9,16,47,152,199
03005100,ARKANSAS BEAUTY SCHOOL                  ,AR,72209-5116,Proprietary  ,4,14,18,101,273,374
03007100,HOT SPRINGS BEAUTY COLLEGE              ,AR,71901-5432,Proprietary  ,4,4,8,44,164,208
03007600,ARKANSAS BEAUTY SCHOOL-CONWAY           ,AR,72032-4354,Proprietary  ,1,5,6,74,191,265
03023400,ARKANSAS COLLEGE OF BARBERING           ,AR,72114-5615,Proprietary  ,20,25,45,103,317,420
03063300,NORTHWEST ARKANSAS COMMUNITY COLLEG     ,AR,72712-5190,Public       ,31,124,155,3976,6260,10236
03065100,ABC BEAUTY COLLEGE                      ,AR,71923-4206,Proprietary  ,0,4,4,29,111,140
03066302,BRYAN COLLEGE -                         ,AR,72756-1825,Proprietary  ,3,11,14,90,353,443
03105200,BAPTIST HEALTH SCHOOLS LITTLE ROCK      ,AR,72210-2820,Private      ,9,16,25,628,2055,2683
03115102,HERITAGE COLLEGE - LITTLE ROCK          ,AR,72227-5544,Proprietary  ,24,86,110,275,1071,1346
03124900,IMAGINE -  PAUL MITCHELL PARTNER SCHOOL ,AR,72117-2516,Proprietary  ,15,20,35,285,508,793
03214300,VELVATEX COLLEGE OF BEAUTY CULTURE      ,AR,72202-5452,Proprietary  ,1,4,5,28,81,109
03254300,MARGARET'S HAIR ACADEMY                 ,AR,71655-4905,Proprietary  ,1,4,5,43,107,150
03519400,"LYNNDALE FUNDAMENTALS OF BEAUTY SCHOOL, ",AR,71730-4804,Proprietary  ,0,0,0,8,35,43
03855300,ECCLESIA COLLEGE                        ,AR,72762-8159,Private      ,0,0,0,167,141,308
03912300,CROSSETT SCHOOL OF COSMETOLOGY          ,AR,71635-0000,Proprietary  ,2,2,4,21,51,72
03997300,ARKANSAS BEAUTY COLLEGE                 ,AR,72801-3741,Proprietary  ,1,2,3,34,116,150
04183100,WASHINGTON BARBER COLLEGE               ,AR,72209-3820,Proprietary  ,2,9,11,65,217,282
04183400,SALON PROFESSIONAL ACADEMY (THE)        ,AR,72116-7310,Proprietary  ,1,12,13,75,173,248
04203400,ARKANSAS STATE UNIVERSITY - NEWPORT     ,AR,72112-9073,Public       ,13,61,74,130,471,601
04220000,DESIGNER BARBER & STYLIST SCHOOL        ,AR,72903-3753,Proprietary  ,2,4,6,16,83,99
00133900,CORBAN UNIVERSITY                       ,OR,97301-9392,Private      ,4,7,11,2067,864,2931
00318600,BLUE MOUNTAIN COMMUNITY COLLEGE         ,OR,97801-0000,Public       ,6,20,26,1313,2318,3631
00318800,CENTRAL OREGON COMMUNITY COLLEGE        ,OR,97701-5998,Public       ,18,58,76,3508,7073,10581
00318900,CLATSOP COMMUNITY COLLEGE               ,OR,97103-3698,Public       ,3,12,15,694,1587,2281
00319100,CONCORDIA UNIVERSITY                    ,OR,97211-6099,Private      ,1,575,576,2365,10328,12693
00319300,EASTERN OREGON UNIVERSITY               ,OR,97850-2899,Public       ,4,33,37,3285,3761,7046
00319400,GEORGE FOX UNIVERSITY                   ,OR,97132-2697,Private      ,5,32,37,3850,2543,6393
00319600,LANE COMMUNITY COLLEGE                  ,OR,97405-0640,Public       ,17,96,113,7607,14146,21753
00319700,LEWIS & CLARK COLLEGE                   ,OR,97219-7899,Private      ,4,18,22,6150,3691,9841
00319800,LINFIELD COLLEGE                        ,OR,97128-6894,Private      ,3,8,11,3946,1402,5348
00319801,LINFIELD COLLEGE - PORTLAND CAMPUS      ,OR,97210-0000,Private      ,2,9,11,873,1459,2332
00319900,MARYLHURST UNIVERSITY                   ,OR,97036-7036,Private      ,2,42,44,177,1957,2134
00320300,MOUNT ANGEL SEMINARY                    ,OR,97373-9700,Private      ,0,1,1,10,22,32
00320400,MOUNT HOOD COMMUNITY COLLEGE            ,OR,97030-3300,Public       ,13,92,105,5843,10979,16822
00320600,MULTNOMAH UNIVERSITY                    ,OR,97220-5898,Private      ,0,14,14,507,1006,1513
00320700,PACIFIC NORTHWEST COLLEGE OF ART        ,OR,97209-3023,Private      ,3,2,5,835,953,1788
00320800,NORTHWEST CHRISTIAN UNIVERSITY          ,OR,97401-3727,Private      ,0,21,21,794,1067,1861
00320900,WESTERN OREGON UNIVERSITY               ,OR,97361-1394,Public       ,12,52,64,8103,3691,11794
00321000,OREGON STATE UNIVERSITY                 ,OR,97331-8507,Public       ,46,137,183,28596,16539,45135
00321100,OREGON INSTITUTE OF TECHNOLOGY          ,OR,97601-8801,Public       ,11,28,39,3356,3129,6485
00321200,PACIFIC UNIVERSITY                      ,OR,97116-1797,Private      ,6,14,20,4335,3487,7822
00321300,PORTLAND COMMUNITY COLLEGE              ,OR,97219-7198,Public       ,74,456,530,17015,41221,58236
00321311,PORTLAND COMMUNITY COLLEGE - TILLAMOOK B,OR,97141-2599,Public       ,0,4,4,254,491,745
00321600,PORTLAND STATE UNIVERSITY               ,OR,97207-0000,Public       ,59,324,383,18416,28290,46706
00321700,REED COLLEGE                            ,OR,97202-8199,Private      ,4,17,21,2916,959,3875
00321800,CHEMEKETA COMMUNITY COLLEGE             ,OR,97309-1500,Public       ,25,129,154,7492,14798,22290
00321900,SOUTHERN OREGON UNIVERSITY              ,OR,97520-5010,Public       ,13,75,88,6185,4451,10636
00322000,SOUTHWESTERN OREGON COMMUNITY CLG       ,OR,97420-2956,Public       ,5,15,20,1829,2045,3874
00322100,TREASURE VALLEY COMMUNITY COLLEGE       ,OR,97914-3423,Public       ,14,66,80,1768,3006,4774
00322200,UMPQUA COMMUNITY COLLEGE                ,OR,97470-0226,Public       ,5,25,30,1406,2942,4348
00322300,UNIVERSITY OF OREGON                    ,OR,97403-1226,Public       ,62,120,182,29702,12280,41982
00322400,UNIVERSITY OF PORTLAND                  ,OR,97203-5798,Private      ,8,29,37,11558,3827,15385
00322500,WARNER PACIFIC COLLEGE                  ,OR,97215-4099,Private      ,2,37,39,1205,2345,3550
00322700,WILLAMETTE UNIVERSITY                   ,OR,97301-3930,Private      ,3,6,9,5927,1793,7720
00487800,CLACKAMAS COMMUNITY COLLEGE             ,OR,97045-7998,Public       ,17,79,96,4626,7409,12035
00488200,OREGON HEALTH & SCIENCE UNIVERSITY      ,OR,97239-0000,Public       ,6,28,34,1319,5004,6323
00693800,LINN BENTON COMMUNITY COLLEGE           ,OR,97321-3774,Public       ,13,43,56,4411,6311,10722
00717800,WESTERN SEMINARY                        ,OR,97215-0000,Private      ,0,15,15,24,689,713
00723402,HEALD COLLEGE - PORTLAND                ,OR,97205-3432,Proprietary  ,9,54,63,438,1755,2193
00732969,ITT TECHNICAL INSTITUTE                 ,OR,97220-6819,Proprietary  ,22,161,183,665,2774,3439
00737101,MARINELLO SCHOOL OF BEAUTY - PORTLAND   ,OR,97212-3732,Proprietary  ,1,3,4,144,377,521
00781900,ART INSTITUTE OF PORTLAND (THE)         ,OR,97209-2911,Proprietary  ,10,36,46,2062,2445,4507
00888700,CONCORDE CAREER INSTITUTE               ,OR,97232-2242,Proprietary  ,8,51,59,518,1578,2096
00907900,EVEREST COLLEGE                         ,OR,97204-2296,Proprietary  ,5,30,35,331,1202,1533
00958100,SPRINGFIELD COLLEGE OF BEAUTY           ,OR,97477-5474,Proprietary  ,1,4,5,98,208,306
01012200,PHAGANS' MEDFORD BEAUTY SCHOOL          ,OR,97504-5297,Proprietary  ,1,11,12,89,290,379
01018200,ROGUE COMMUNITY COLLEGE                 ,OR,97527-0000,Public       ,12,49,61,3262,7919,11181
01050700,ACADEMY OF HAIR DESIGN                  ,OR,97301-3526,Proprietary  ,4,10,14,106,287,393
01230900,UNIVERSITY OF WESTERN STATES            ,OR,97230-3099,Private      ,0,6,6,106,838,944
01234700,PHAGANS CENTRAL OREGON BEAUTY CLG       ,OR,97701-5175,Proprietary  ,3,16,19,143,342,485
01234800,PHAGANS BEAUTY COLLEGE                  ,OR,97333-4716,Proprietary  ,1,3,4,86,161,247
01235000,PHAGANS SCHOOL OF HAIR DESIGN           ,OR,97086-7721,Proprietary  ,6,7,13,108,219,327
01235100,PHAGANS SCHOOL OF BEAUTY                ,OR,97301-4732,Proprietary  ,1,6,7,98,348,446
01300800,PHAGANS TIGARD BEAUTY SCHOOL            ,OR,97223-0000,Proprietary  ,0,5,5,42,108,150
02101000,NORTHWEST COLLEGE OF HAIR DESIGN        ,OR,97086-7702,Proprietary  ,11,32,43,338,792,1130
02101002,NORTHWEST COLLEGE                       ,OR,97007-3954,Proprietary  ,1,2,3,60,129,189
02104900,SUMNER COLLEGE                          ,OR,97219-4063,Proprietary  ,3,20,23,107,618,725
02106100,COLLEGE OF COSMETOLOGY                  ,OR,97601-0000,Proprietary  ,2,3,5,69,155,224
02154400,BEAU MONDE CLG OF HAIR DESIGN           ,OR,97205-0000,Proprietary  ,5,15,20,206,441,647
02159700,NEW HOPE CHRISTIAN COLLEGE              ,OR,97405-1194,Private      ,0,3,3,340,349,689
02201900,PHAGANS' SCHOOL OF HAIR DESIGN          ,OR,97232-0000,Proprietary  ,5,15,20,189,542,731
02239203,ANTHEM COLLEGE - BEAVERTON              ,OR,97005-0000,Proprietary  ,22,43,65,207,539,746
02311000,PAUL MITCHELL THE SCHOOL                ,OR,97205-3724,Proprietary  ,6,13,19,74,142,216
02330100,PIONEER PACIFIC COLLEGE                 ,OR,97070-0000,Proprietary  ,8,33,41,365,1274,1639
02330102,PIONEER PACIFIC COLLEGE                 ,OR,97403-0000,Proprietary  ,2,9,11,309,1241,1550
02337900,COLLEGE OF HAIR DESIGN CAREERS          ,OR,97301-0000,Proprietary  ,2,6,8,107,259,366
02344100,ROSEBURG BEAUTY COLLEGE                 ,OR,97470-0000,Proprietary  ,0,6,6,56,171,227
02534000,NATIONAL COLLEGE OF NATURAL MEDICINE    ,OR,97201-0000,Private      ,0,3,3,102,1116,1218
02578800,NORTHWEST NANNIES INSTITUTE             ,OR,97035-0000,Proprietary  ,1,0,1,34,26,60
02603700,OREGON COL OF ORIENTAL MEDICINE         ,OR,97216-0000,Private      ,1,4,5,48,555,603
02617506,EVEREST COLLEGE - EVEREST INSTITUTE     ,OR,97223-6581,Proprietary  ,7,34,41,165,616,781
03007300,OREGON COLLEGE OF ART & CRAFT           ,OR,97225-6399,Private      ,2,3,5,342,600,942
03022600,LE CORDON BLEU COLLEGE OF CULINARY ARTS ,OR,97205-2793,Proprietary  ,12,60,72,1042,2132,3174
03042500,CARRINGTON COLLEGE                      ,OR,97232-1302,Proprietary  ,6,34,40,414,1384,1798
03074400,PHAGANS NEWPORT ACAD CSMTLGY CAREER     ,OR,97365-4963,Proprietary  ,1,1,2,35,90,125
03074500,EAST-WEST COLLEGE OF THE HEALING ARTS   ,OR,97232-2765,Proprietary  ,0,6,6,144,631,775
03185300,PHAGANS GRANTS PASS COLLEGE OF BTY      ,OR,97527-0000,Proprietary  ,2,5,7,59,166,225
03428300,KLAMATH COMMUNITY COLLEGE               ,OR,97603-7121,Public       ,4,29,33,738,1817,2555
03642300,INSTITUTE OF TECHNOLOGY                 ,OR,97305-1373,Proprietary  ,1,41,42,208,773,981
03668300,BIRTHINGWAY COLLEGE OF MIDWIFERY        ,OR,97266-4042,Private      ,0,2,2,46,353,399
03783400,ABDILL CAREER COLLEGE                   ,OR,97504-7137,Proprietary  ,4,13,17,122,524,646
04146500,PORTLAND ACTORS CONSERVATORY            ,OR,97201-2557,Private      ,0,5,5,79,181,260
04151900,COLUMBIA GORGE COMMUNITY COLLEGE        ,OR,97058-3434,Public       ,2,15,17,537,1160,1697
04167400,SAGE SCHOOL OF MASSAGE & HEALING ARTS   ,OR,97701-4082,Proprietary  ,0,0,0,48,183,231
04171400,AVEDA INSTITUTE PORTLAND                ,OR,97209-3144,Proprietary  ,4,8,12,422,677,1099
04194400,AMERICAN COLLEGE OF HEALTHCARE SCIENCES ,OR,97239-3719,Proprietary  ,2,47,49,225,1226,1451
04194900,TILLAMOOK BAY COMMUNITY COLLEGE         ,OR,97141-2807,Public       ,0,2,2,56,185,241
00137400,ALBERTUS MAGNUS COLLEGE                 ,CT,06511-1189,Private      ,4,37,41,1138,1619,2757
00137403,ALBERTUS MAGNUS CLG-NEW DIMENSIONS      ,CT,06511-0000,Private      ,0,0,0,86,816,902
00137800,CENTRAL CONNECTICUT STATE UNIV          ,CT,06050-2490,Public       ,13,63,76,10830,5769,16599
00137900,CONNECTICUT COLLEGE                     ,CT,06320-4196,Private      ,1,4,5,3207,253,3460
00138000,WESTERN CONNECTICUT STATE UNIV          ,CT,06810-6826,Public       ,7,13,20,6599,2165,8764
00138500,FAIRFIELD UNIVERSITY                    ,CT,06430-0000,Private      ,6,27,33,7849,1353,9202
00138700,HARTFORD SEMINARY                       ,CT,06105-0000,Private      ,1,1,2,25,119,144
00138900,HOLY APOSTLES COLLEGE & SEMINARY        ,CT,06416-2027,Private      ,0,4,4,12,87,99
00139200,MANCHESTER COMMUNITY COLLEGE            ,CT,06045-1046,Public       ,19,63,82,4481,4949,9430
00139300,MITCHELL COLLEGE                        ,CT,06320-4498,Private      ,1,4,5,1059,352,1411
00139700,UNIVERSITY OF NEW HAVEN                 ,CT,06516-1999,Private      ,13,28,41,10421,2584,13005
00139800,NORTHWESTERN CT COMMUNITY COLLEGE       ,CT,06098-1747,Public       ,1,9,10,644,873,1517
00139900,NORWALK COMMUNITY TECHNICAL COLLEGE     ,CT,06854-1655,Public       ,11,23,34,2873,3547,6420
00140100,POST UNIVERSITY                         ,CT,06723-3240,Proprietary  ,55,712,767,2364,13754,16118
00140200,QUINNIPIAC UNIVERSITY                   ,CT,06518-1908,Private      ,13,26,39,16973,2976,19949
00140201,QUINNIPIAC UNIVERSITY SCHOOL OF LAW     ,CT,06518-0000,Private      ,0,0,0,78,755,833
00140300,SACRED HEART UNIVERSITY                 ,CT,06825-1000,Private      ,9,73,82,8260,3295,11555
00140600,SOUTHERN CONNECTICUT STATE UNIV         ,CT,06515-1355,Public       ,9,57,66,10286,6170,16456
00140900,SAINT JOSEPH COLLEGE                    ,CT,06117-2791,Private      ,6,34,40,1312,2153,3465
00141400,TRINITY COLLEGE                         ,CT,06106-3100,Private      ,3,2,5,3784,433,4217
00141600,UNIVERSITY OF BRIDGEPORT                ,CT,06601-5650,Private      ,11,47,58,3814,4005,7819
00141700,UNIVERSITY OF CONNECTICUT-STORRS        ,CT,06269-2151,Public       ,24,73,97,32290,6772,39062
00141702,UNIV CONN STAMFORD                      ,CT,06901-0000,Public       ,2,10,12,1123,796,1919
00141703,UNIV OF CONNECTICUT - TORINGTON         ,CT,06790-0000,Public       ,0,1,1,308,171,479
00141706,UNIV OF CONNECTICUT SCH LAW             ,CT,06105-0000,Public       ,0,4,4,80,1106,1186
00141707,UNIV OF CT - SCH OF SOCIAL WORK         ,CT,06117-0000,Public       ,1,14,15,198,843,1041
00141708,UNIVERSITY OF CONNECTICUT - SCHOOL OF ME,CT,06030-1920,Public       ,1,1,2,183,673,856
00141709,UNIVERSITY OF CONNECTICUT - SCHOOL OF DE,CT,06030-1920,Public       ,1,0,1,332,406,738
00142200,UNIVERSITY OF HARTFORD                  ,CT,06117-1599,Private      ,24,20,44,11107,2710,13817
00142400,WESLEYAN UNIVERSITY                     ,CT,06459-3208,Private      ,2,5,7,6007,341,6348
00142500,EASTERN CONNECTICUT STATE UNIV          ,CT,06226-2295,Public       ,7,17,24,7495,1687,9182
00142600,YALE UNIVERSITY                         ,CT,06520-8288,Private      ,13,24,37,19410,8822,28232
00280301,RENSSELAER POLYTECHNIC INSTITUTE-RENSSEL,CT,06120-2991,Private      ,0,0,0,36,50,86
00451300,HOUSATONIC COMMUNITY COLLEGE            ,CT,06604-4704,Public       ,11,41,52,3288,5216,8504
00618100,BRIDGEPORT HOSP SCHL OF NURSING         ,CT,06610-2896,Private      ,1,6,7,224,713,937
00619100,ST. VINCENT'S COLLEGE                   ,CT,06606-9966,Private      ,3,5,8,445,1181,1626
00698200,NAUGATUCK VALLEY COMM-TECH COLG         ,CT,06708-3089,Public       ,14,39,53,3767,4838,8605
00730000,ELI WHITNEY TECHNICAL HIGH SCHOOL       ,CT,06514-0000,Public       ,0,0,0,15,107,122
00730300,LINCOLN TECHNICAL INSTITUTE             ,CT,06051-0000,Proprietary  ,42,101,143,671,1532,2203
00730306,LINCOLN TECHNICAL INSTITUTE - EAST WINDS,CT,06088-9631,Proprietary  ,11,26,37,1020,634,1654
00730500,PORTER AND CHESTER INSTITUTE OF BRANFORD,CT,06405-4022,Proprietary  ,9,10,19,298,631,929
00731100,WINDHAM TECHNICAL HIGH SCHOOL           ,CT,06226-2100,Public       ,0,0,0,7,15,22
00745900,PAIER COLLEGE OF ART                    ,CT,06514-3902,Proprietary  ,0,1,1,153,91,244
00763500,CAPITAL COMMUNITY COLLEGE               ,CT,06103-1207,Public       ,12,54,66,2116,5173,7289
00803700,GATEWAY COMMUNITY-TECHNICAL COLLEGE     ,CT,06511-0000,Public       ,13,73,86,4257,7059,11316
00803800,MIDDLESEX COMMUNITY CLG                 ,CT,06457-4889,Public       ,7,30,37,1522,2037,3559
00887300,PAUL MITCHELL THE SCHOOL                ,CT,06810-6716,Proprietary  ,2,3,5,129,142,271
00887400,MARINELLO SCHOOL OF BEAUTY              ,CT,06450-4836,Proprietary  ,9,18,27,62,145,207
00887401,MARINELLO SCHOOL OF BEAUTY - HAMDEN     ,CT,06514-4132,Proprietary  ,3,18,21,38,140,178
00887402,MARINELLO SCHOOL OF BEAUTY - FAIRFIELD  ,CT,06825-4847,Proprietary  ,5,34,39,91,269,360
00887403,MARINELLO SCHOOL OF BEAUTY - WILLIMANTIC,CT,06226-1940,Proprietary  ,4,19,23,45,154,199
00887404,BRIO ACADEMY OF COSMETOLOGY -           ,CT,06605-4114,Proprietary  ,0,0,0,4,19,23
00927700,E C GOODWIN TECHNICAL HIGH SCHOOL       ,CT,06053-0000,Public       ,0,0,0,31,81,112
00940700,LINCOLN COLLEGE OF NEW ENGLAND          ,CT,06489-1057,Proprietary  ,3,27,30,640,908,1548
00940701,CLEMENS COLLEGE                         ,CT,06078-0000,Proprietary  ,0,0,0,2,1,3
00976400,TUNXIS COMMUNITY COLLEGE                ,CT,06032-3187,Public       ,17,41,58,2483,2745,5228
00976500,THREE RIVERS COMMUNITY COLLEGE          ,CT,06360-6598,Public       ,16,60,76,2325,3616,5941
00982200,ALBERT I PRINCE TECHNICAL HIGH SCHOOL   ,CT,06106-3799,Public       ,0,1,1,22,160,182
01041700,MARINELLO SCHOOL OF BEAUTY              ,CT,06108-2220,Proprietary  ,7,24,31,88,262,350
01053000,QUINEBAUG VALLEY COMMUNITY COLLEGE      ,CT,06239-1440,Public       ,4,22,26,950,1608,2558
01077900,PORTER AND CHESTER INSTITUTE-ALLCAMPUSES,CT,06615-7158,Proprietary  ,57,117,174,1845,4223,6068
01115000,ASNUNTUCK COMMUNITY COLLEGE             ,CT,06082-3800,Public       ,9,27,36,731,1086,1817
01149600,BULLARD HAVENS VOC TECH SCHOOL          ,CT,06610-3499,Public       ,0,1,1,38,154,192
01169700,VINAL REGIONAL VOC TECH SCHOOL          ,CT,06457-4918,Public       ,0,0,0,14,70,84
01184300,NORWICH TECHNICAL HIGH SCHOOL           ,CT,06360-7097,Public       ,0,2,2,15,93,108
01242500,STONE ACADEMY                           ,CT,06516-4049,Proprietary  ,26,94,120,265,1072,1337
01242503,STONE ACADEMY -WATERBURY                ,CT,06705-3823,Proprietary  ,0,3,3,47,176,223
01242504,STONE ACADEMY -  EAST HARTFORD          ,CT,06118-0000,Proprietary  ,6,22,28,76,290,366
01287700,SANFORD-BROWN COLLEGE                   ,CT,06855-1436,Proprietary  ,0,1,1,47,136,183
01291300,LEON INSTITUTE OF HAIR DESIGN           ,CT,06604-4226,Proprietary  ,0,0,0,9,40,49
02074000,BRANFORD HALL CAREER INSTITUTE          ,CT,06405-0000,Proprietary  ,102,406,508,1241,4750,5991
02106600,AMERICAN INSTITUTE                      ,CT,06110-1922,Proprietary  ,15,48,63,109,624,733
02112300,RIDLEY LOWELL BUSINESS & TECH INST      ,CT,06320-0000,Proprietary  ,14,66,80,173,956,1129
02112700,NORTH HAVEN ACADEMY                     ,CT,06473-3108,Proprietary  ,2,1,3,142,117,259
02115100,BUTLER BUSINESS SCHOOL                  ,CT,06604-0000,Proprietary  ,0,0,0,1,0,1
02148700,CONNECTICUT INST OF HAIR DESIGN         ,CT,06716-0000,Proprietary  ,2,3,5,30,52,82
02202500,NEW ENGLAND TRACTOR TRAILER SCH         ,CT,06071-2036,Proprietary  ,10,106,116,175,1695,1870
02244900,GOODWIN COLLEGE                         ,CT,06118-9980,Private      ,28,229,257,1383,5899,7282
02245300,HOWELL CHENEY TECHNICAL HIGH SCHOOL     ,CT,06040-0000,Public       ,0,0,0,10,22,32
02265900,WINDHAM COMMUNITY MEM HOSP-RAD TECH     ,CT,06226-0000,Private      ,1,1,2,14,30,44
02296100,YALE-NEW HAVEN HOSP DIETETIC INTERN     ,CT,06510-8900,Private      ,0,0,0,34,48,82
02300000,W F KAYNOR TECHNICAL HIGH SCHOOL        ,CT,06708-0000,Public       ,0,0,0,26,126,152
02316600,CONNECTICUT CTR FOR MASSAGE THERAPY     ,CT,06111-3975,Proprietary  ,7,20,27,85,255,340
02316601,CONNECTICUT CENTER FOR MASSAGE THERAPY -,CT,06880-4619,Proprietary  ,1,14,15,49,203,252
02316603,CONNECTICUT CENTER FOR MASSAGE THERAPY -,CT,06340-4619,Proprietary  ,5,13,18,48,167,215
02565000,PLATT TECHNICAL HIGH SCHOOL             ,CT,06460-2105,Public       ,0,0,0,14,44,58
03079400,LYME ACADEMY COLLEGE OF FINE ARTS       ,CT,06371-2333,Private      ,1,0,1,100,32,132
03094800,INDUSTRIAL MANAGEMENT & TRAINING        ,CT,06706-1211,Proprietary  ,1,3,4,72,185,257
03234300,CHARTER OAK STATE COLLEGE               ,CT,06053-2150,Public       ,3,67,70,169,2230,2399
03316300,LINCOLN TECHNICAL INSTITUTE - HARTFORD  ,CT,06105-3630,Proprietary  ,8,28,36,566,714,1280
03381300,CONNECTICUT TRAINING CENTER             ,CT,06108-2705,Private      ,0,0,0,1,20,21
03927300,MARINELLO SCHOOL OF BEAUTY              ,CT,06357-2447,Proprietary  ,1,7,8,32,115,147
03927301,MARINELLO SCHOOL OF BEAUTY  - TORRINGTON,CT,06790-5425,Proprietary  ,4,11,15,32,66,98
03927302,MARINELLO SCHOOL OF BEAUTY  -  ENFIELD  ,CT,06082-2946,Proprietary  ,1,2,3,41,68,109
04104300,ACADEMY DI CAPELLI - SCHOOL OF COSMETOLO,CT,06492-0000,Proprietary  ,1,4,5,71,120,191
04128800,BRANFORD ACADEMY OF HAIR & COSMETOLOGY  ,CT,06405-0000,Proprietary  ,0,5,5,27,89,116
04145400,OXFORD ACADEMY OF HAIR DESIGN           ,CT,06483-2911,Proprietary  ,2,7,9,59,78,137
04148400,EUROPEAN ACADEMY OF COSMETOLOGY AND HAIR,CT,06437-0000,Proprietary  ,0,0,0,21,25,46
04152400,INTERNATIONAL INSTITUTE OF COSMETOLOGY  ,CT,06109-0000,Proprietary  ,3,3,6,132,106,238
04162900,TONSORIAL ACADEMY OF COSMETOLOGY AND BAR,CT,06516-0000,Proprietary  ,0,0,0,4,7,11
04219200,ACE COSMETOLOGY & BARBERING TRAINING CEN,CT,06716-0000,Proprietary  ,1,4,5,15,33,48
04224200,BELLE ACADEMY OF COSMETOLOGY            ,CT,06704-0135,Proprietary  ,1,2,3,20,62,82
04230900,RICCI'S ACADEMY OF COSMETOLOGY          ,CT,06470-0000,Proprietary  ,2,4,6,19,18,37
00146600,BARRY UNIVERSITY                        ,FL,33161-6695,Private      ,34,145,179,6678,10574,17252
00146601,BARRY UNIVERSITY - ORLANDO              ,FL,32807-3673,Private      ,3,22,25,491,2376,2867
00146700,BETHUNE COOKMAN UNIVERSITY              ,FL,32114-3099,Private      ,121,51,172,8728,2569,11297
00146800,ST THOMAS UNIVERSITY                    ,FL,33054-0000,Private      ,14,66,80,1989,3271,5260
00146900,FLORIDA INSTITUTE OF TECHNOLOGY         ,FL,32901-6988,Private      ,27,259,286,5285,10104,15389
00147000,EASTERN FLORIDA STATE COLLEGE           ,FL,32922-6503,Public       ,132,370,502,7361,12370,19731
00147100,COLLEGE OF CENTRAL FLORIDA              ,FL,34474-4415,Public       ,65,189,254,5272,9157,14429
00147200,CHIPOLA  COLLEGE                        ,FL,32446-2053,Public       ,22,32,54,1251,1697,2948
00147300,CLEARWATER CHRISTIAN COLLEGE            ,FL,33759-0000,Private      ,2,7,9,838,253,1091
00147500,DAYTONA STATE COLLEGE                   ,FL,32114-2800,Public       ,153,409,562,9549,15724,25273
00147700,EDISON STATE COLLEGE                    ,FL,33906-6210,Public       ,170,248,418,9455,12125,21580
00147800,EDWARD WATERS COLLEGE                   ,FL,32209-6199,Private      ,24,30,54,1538,1258,2796
00147900,EMBRY-RIDDLE AERONAUTICAL UNIV          ,FL,32114-3900,Private      ,48,407,455,7998,11199,19197
00148000,FLORIDA A & M UNIVERSITY                ,FL,32307-3100,Public       ,382,109,491,17558,9538,27096
00148100,FLORIDA ATLANTIC UNIVERSITY             ,FL,33431-6498,Public       ,474,319,793,32517,20657,53174
00148101,FLORIDA ATLANTIC UNIVERSITY/DAVIE       ,FL,33314-0000,Public       ,47,101,148,3402,6088,9490
00148103,FLORIDA ATLANTIC UNIV-JUPITER/PSL       ,FL,33458-0000,Public       ,15,26,41,1698,1744,3442
00148200,FLORIDA COLLEGE                         ,FL,33617-5578,Private      ,1,4,5,620,142,762
00148400,FLORIDA STATE COLLEGE AT JACKSONVILLE   ,FL,32202-4030,Public       ,261,990,1251,16002,32443,48445
00148500,FLORIDA KEYS COMMUNITY COLLEGE          ,FL,33040-4397,Public       ,8,27,35,811,1014,1825
00148600,FLORIDA MEMORIAL UNIVERSITY             ,FL,33054-6199,Private      ,40,39,79,3424,1876,5300
00148700,ECKERD COLLEGE                          ,FL,33711-4744,Private      ,10,30,40,3443,1362,4805
00148800,FLORIDA SOUTHERN COLLEGE                ,FL,33801-5698,Private      ,12,52,64,4670,1831,6501
00148900,FLORIDA STATE UNIVERSITY                ,FL,32306-2430,Public       ,675,264,939,58815,21300,80115
00149000,GULF COAST STATE COLLEGE                ,FL,32401-1058,Public       ,39,133,172,3101,6090,9191
00149300,INDIAN RIVER STATE COLLEGE              ,FL,34981-5596,Public       ,200,446,646,8383,12764,21147
00149500,JACKSONVILLE UNIVERSITY                 ,FL,32211-3394,Private      ,35,199,234,4504,5525,10029
00149700,JONES COLLEGE                           ,FL,32211-5588,Private      ,4,41,45,169,1152,1321
00149900,EVEREST UNIVERSITY                      ,FL,32810-5601,Proprietary  ,22,177,199,780,4686,5466
00149901,EVEREST UNIVERSITY - ORLANDO SOUTH      ,FL,32819-7666,Proprietary  ,217,2285,2502,4561,49224,53785
00149902,EVEREST UNIVERSITY - MELBOURNE          ,FL,32905-6609,Proprietary  ,11,91,102,227,1529,1756
00149904,EVEREST UNIVERSITY - TAMPA              ,FL,33614-5801,Proprietary  ,14,154,168,683,5068,5751
00149905,EVEREST UNIVERSITY - BRANDON            ,FL,33619-1354,Proprietary  ,28,262,290,678,8274,8952
00149906,EVEREST UNIVERSITY - ORANGE PARK        ,FL,32073-1111,Proprietary  ,15,95,110,187,1444,1631
00149907,EVEREST UNIVERSITY - LARGO              ,FL,33770-2556,Proprietary  ,17,70,87,176,1097,1273
00149908,EVEREST UNIVERSITY - LAKELAND           ,FL,33801-3801,Proprietary  ,18,96,114,236,1541,1777
00149909,EVEREST UNIVERSITY - JACKSONVILLE       ,FL,32256-0000,Proprietary  ,12,116,128,374,2330,2704
00149910,EVEREST UNIVERSITY - POMPANO            ,FL,33062-2522,Proprietary  ,21,172,193,503,4689,5192
00149913,EVEREST INSTITUTE - MIAMI               ,FL,33169-4759,Proprietary  ,5,22,27,354,1487,1841
00149914,EVEREST INSTITUTE - KENDALL             ,FL,33186-1410,Proprietary  ,1,16,17,346,1092,1438
00150000,BROWARD COLLEGE- DOWNTOWN CTR           ,FL,33301-2298,Public       ,320,612,932,9072,17061,26133
00150001,BROWARD COLLEGE - DAVIE CAMPUS          ,FL,33314-0000,Public       ,321,408,729,13454,15595,29049
00150002,BROWARD COLLEGE- NORTH CAMPUS           ,FL,33066-0000,Public       ,200,328,528,8357,13143,21500
00150003,BROWARD COLLEGE- SOUTH CAMPUS           ,FL,33024-0000,Public       ,265,364,629,9613,12784,22397
00150100,FLORIDA GATEWAY COLLEGE                 ,FL,32025-2007,Public       ,39,102,141,1532,3161,4693
00150200,LAKE SUMTER COMMUNITY COLLEGE           ,FL,34788-8751,Public       ,40,80,120,2939,3557,6496
00150400,"STATE COLLEGE OF FLORIDA, MANATEE-SARASO",FL,34207-3596,Public       ,75,217,292,6116,8586,14702
00150500,LYNN UNIVERSITY                         ,FL,33431-5598,Private      ,14,43,57,2793,1374,4167
00150600,MIAMI DADE COLLEGE ADMINISTRATION ONLY  ,FL,33176-3393,Public       ,25,37,62,784,1106,1890
00150601,MIAMI DADE COLLEGE - NORTH CAMPUS       ,FL,33167-3495,Public       ,301,581,882,16393,20106,36499
00150602,MIAMI DADE COLLEGE - KENDALL CAMPUS     ,FL,33176-3393,Public       ,453,557,1010,22756,19455,42211
00150603,MIAMI DADE COLLEGE - WOLFSON CAMPUS     ,FL,33132-2297,Public       ,346,416,762,13261,14331,27592
00150604,MIAMI DADE COLLEGE - MEDICAL CAMPUS     ,FL,33127-4693,Public       ,117,237,354,4384,8717,13101
00150605,MIAMI DADE COLLEGE - HOMESTEAD CAMPUS   ,FL,33030-6009,Public       ,105,154,259,3604,4674,8278
00150606,MIAMI DADE COLLEGE -INTERAMERICAN CAMPUS,FL,33135-0000,Public       ,146,245,391,5045,8915,13960
00150607,MIAMI DADE COLLEGE - HIALEAH CAMPUS     ,FL,33012-2918,Public       ,102,159,261,4894,5981,10875
00150800,NORTH FLORIDA COMMUNITY COLLEGE         ,FL,32340-1699,Public       ,9,36,45,673,1069,1742
00150900,NOVA SOUTHEASTERN UNIVERSITY            ,FL,33314-7796,Private      ,56,623,679,8064,34119,42183
00151000,NORTHWEST FLORIDA STATE COLLEGE         ,FL,32578-1295,Public       ,31,181,212,2682,5988,8670
00151200,PALM BEACH COMMUNITY COLLEGE            ,FL,33461-4796,Public       ,323,508,831,17114,19960,37074
00151300,PENSACOLA STATE COLLEGE                 ,FL,32504-8998,Public       ,99,298,397,5757,11589,17346
00151400,POLK STATE COLLEGE                      ,FL,33881-4256,Public       ,111,283,394,6181,10091,16272
00151500,ROLLINS COLLEGE                         ,FL,32789-4499,Private      ,11,27,38,3765,1647,5412
00151900,SANTA FE COLLEGE                        ,FL,32606-6200,Public       ,157,263,420,11611,11354,22965
00152000,SEMINOLE STATE COLLEGE OF FLORIDA       ,FL,32773-6199,Public       ,191,464,655,11682,17460,29142
00152100,SOUTHEASTERN UNIVERSITY                 ,FL,33801-6099,Private      ,27,60,87,3879,2105,5984
00152200,SOUTH FLORIDA COMMUNITY COLLEGE         ,FL,33825-9399,Public       ,33,54,87,1650,2474,4124
00152300,SAINT JOHNS RIVER STATE COLLEGE         ,FL,32177-3897,Public       ,47,182,229,3471,5525,8996
00152600,SAINT LEO UNIVERSITY                    ,FL,33574-6665,Private      ,30,563,593,4521,19068,23589
00152800,ST. PETERSBURG COLLEGE                  ,FL,33760-3768,Public       ,208,707,915,12527,28654,41181
00153100,STETSON UNIVERSITY                      ,FL,32723-3761,Private      ,29,32,61,7216,1209,8425
00153101,STETSON UNIVERSITY - COLLEGE OF LAW     ,FL,33707-3299,Private      ,0,9,9,150,1853,2003
00153300,TALLAHASSEE COMMUNITY COLLEGE           ,FL,32304-2895,Public       ,204,333,537,12421,11336,23757
00153500,UNIVERSITY OF FLORIDA                   ,FL,32611-3150,Public       ,578,317,895,56100,23831,79931
00153600,UNIVERSITY OF MIAMI                     ,FL,33146-6531,Private      ,89,123,212,24896,7660,32556
00153601,UNIV OF MIAMI SCHOOL OF LAW             ,FL,33124-0000,Private      ,5,3,8,219,2403,2622
00153602,UNIV OF MIAMI-SCH OF MEDICINE           ,FL,33136-0000,Private      ,23,20,43,1260,2196,3456
00153700,UNIVERSITY OF SOUTH FLORIDA             ,FL,33620-6960,Public       ,591,407,998,49142,29577,78719
00153701,UNIV OF SOUTH FLORIDA-ST PETERSBURG     ,FL,33701-0000,Public       ,106,80,186,5988,4863,10851
00153702,UNIV OF SOUTH FLORIDA-SARASOTA          ,FL,34243-2025,Public       ,17,43,60,1487,2410,3897
00153705,UNIV OF SOUTH FLORIDA                   ,FL,33803-0000,Public       ,16,25,41,1445,1755,3200
00153706,UNIV OF SOUTH FLORIDA- MEDICINE         ,FL,33612-0000,Public       ,37,24,61,2070,2700,4770
00153800,UNIVERSITY OF TAMPA                     ,FL,33606-1490,Private      ,58,71,129,13995,4495,18490
00154000,WEBBER INTERNATIONAL UNIVERSITY         ,FL,33827-0096,Private      ,5,3,8,1516,462,1978
00173308,NATIONAL-LOUIS UNIVERSITY               ,FL,33609-0000,Private      ,1,4,5,23,154,177
00177201,TRINITY INTERNATIONAL UNIVERSITY - SOUTH,FL,33324-4611,Private      ,0,15,15,112,666,778
00349503,JOHNSON UNIVERSITY - FLORIDA            ,FL,34744-5301,Private      ,0,1,1,457,375,832
00395400,UNIV OF CENTRAL FLORIDA                 ,FL,32816-0001,Public       ,1095,535,1630,76589,37996,114585
00395500,UNIVERSITY OF WEST FLORIDA              ,FL,32514-5750,Public       ,78,221,299,12055,9709,21764
00407215,NORTHWOOD UNIVERSITY                    ,FL,33409-0000,Private      ,3,26,29,752,664,1416
00491004,KAPLAN CAREER INSTITUTE - KAPLAN COLLEGE,FL,33026-3978,Proprietary  ,0,0,0,54,473,527
00491005,KAPLAN COLLEGE JACKSONVILLE             ,FL,32216-3216,Proprietary  ,7,157,164,278,3770,4048
00558500,LIVELY TECHNICAL CENTER                 ,FL,32304-0000,Public       ,13,26,39,824,2580,3404
00558600,LINDSEY HOPKINS TECHNICAL ED CENTER     ,FL,33127-4692,Public       ,23,72,95,392,1397,1789
00559400,D G ERWIN TECHNICAL CENTER              ,FL,33610-8255,Public       ,25,64,89,807,2826,3633
00560500,PINELLAS TECH ED CTR-CLEARWATER         ,FL,33760-2194,Public       ,9,46,55,466,1894,2360
00560700,SARASOTA COUNTY TECHNICAL INSTITUTE     ,FL,34233-0000,Public       ,14,22,36,433,1168,1601
00560800,MAYNARD A. TRAVISS CAREER CENTER        ,FL,33803-9709,Public       ,1,23,24,463,1532,1995
00561200,MANATEE TECHNICAL INSTITUTE             ,FL,34210-0000,Public       ,9,29,38,641,1773,2414
00561201,MANATEE TECHNICAL INSTITUTE-EAST        ,FL,34211-0000,Public       ,3,17,20,383,1144,1527
00675000,VALENCIA COMMUNITY COLLEGE              ,FL,32802-3028,Public       ,501,798,1299,36509,35765,72274
00732910,ITT TECHNICAL INSTITUTE                 ,FL,33634-7515,Proprietary  ,75,364,439,1248,5335,6583
00732947,ITT TECHNICAL INSTITUTE                 ,FL,32746-1607,Proprietary  ,56,288,344,822,3508,4330
00736206,MEDTECH COLLEGE - MEDTECH INSTITUTE - OR,FL,32826-4906,Proprietary  ,11,53,64,220,1007,1227
00752500,SUWANNEE-HAMILTON AREA VOC TECH CTR     ,FL,32060-0000,Public       ,0,7,7,97,371,468
00752600,WASHINGTON HOLMES TECHNICAL CENTER      ,FL,32428-1699,Public       ,9,14,23,236,600,836
00755800,LEE COUNTY HIGH TECH CENTER CENTRAL     ,FL,33916-2299,Public       ,12,18,30,576,1498,2074
00787000,HILLSBOROUGH COMMUNITY COLLEGE          ,FL,33606-3572,Public       ,233,624,857,18604,27525,46129
00789300,FLAGLER COLLEGE                         ,FL,32085-1027,Private      ,20,12,32,5291,1185,6476
00789301,FLAGLER COLLEGE - TALLAHASSEE COMMUNITY ,FL,32304-2895,Private      ,6,16,22,561,1130,1691
00807500,ST JOHN VIANNEY COLLEGE SEMINARY        ,FL,33165-3244,Private      ,0,0,0,42,29,71
00822300,ST VINCENT DE PAUL REGIONL SEMINARY     ,FL,33436-0000,Private      ,0,0,0,6,25,31
00841700,STENOTYPE INST OF JACKSONVILLE          ,FL,32207-0000,Proprietary  ,2,13,15,50,480,530
00869410,RASMUSSEN COLLEGE - OCALA               ,FL,34471-7051,Proprietary  ,25,222,247,920,7748,8668
00869411,RASMUSSEN COLLEGE - NEW PORT RICHEY     ,FL,34690-4554,Proprietary  ,5,40,45,265,1537,1802
00869413,RASMUSSEN COLLEGE - FORT MYERS          ,FL,33905-7805,Proprietary  ,11,32,43,483,1919,2402
00869420,RASMUSSEN COLLEGE - TAMPA               ,FL,33610-9558,Proprietary  ,6,29,35,261,1436,1697
00869422,RASMUSSEN COLLEGE - PASCO               ,FL,33558-0000,Proprietary  ,1,10,11,112,523,635
00884800,WARNER UNIVERSITY                       ,FL,33859-8725,Private      ,11,32,43,1084,1058,2142
00884900,PALM BEACH ATLANTIC UNIVERSITY          ,FL,33401-6505,Private      ,27,63,90,3965,3293,7258
00887800,MIAMI INTERNATIONAL UNIV ART&DESIGN     ,FL,33132-1418,Proprietary  ,26,51,77,3147,3124,6271
00910400,TONI & GUY HAIRDRESSING ACADEMY         ,FL,32256-3810,Proprietary  ,0,0,0,56,148,204
00963500,FLORIDA INTERNATIONAL UNIVERSITY        ,FL,33199-0001,Public       ,740,622,1362,46376,36469,82845
00984100,UNIVERSITY OF NORTH FLORIDA             ,FL,32224-2645,Public       ,364,246,610,19286,12175,31461
00990200,SHERIDAN TECHNICAL CENTER               ,FL,33021-3399,Public       ,17,117,134,949,3165,4114
01016100,"LORAINE'S ACADEMY, INC                  ",FL,33710-0000,Proprietary  ,3,13,16,69,370,439
01019500,ART INSTITUTE OF FT LAUDERDALE          ,FL,33316-3000,Proprietary  ,30,49,79,2304,2641,4945
01065200,PASCO-HERNANDO COMMUNITY CLG            ,FL,34654-5199,Public       ,111,242,353,5984,9007,14991
01072401,CARLOS ALBIZU UNIVERSITY                ,FL,33172-0000,Private      ,0,41,41,147,1439,1586
01082600,TOM P. HANEY TECHNICAL CENTER           ,FL,32405-5099,Public       ,3,23,26,327,1511,1838
01112700,GOODING INST OF NUR ANES BAY MED CT     ,FL,32401-0000,Proprietary  ,0,2,2,36,173,209
01226300,ATLANTIC TECHNICAL CENTER               ,FL,33063-3902,Public       ,17,51,68,722,2065,2787
01246117,LINCOLN COLLEGE OF TECHNOLOGY - WEST PAL,FL,33407-3105,Proprietary  ,16,58,74,481,991,1472
01254400,FIRST COAST TECHNICAL COLLEGE           ,FL,32084-1921,Public       ,13,38,51,501,1434,1935
01257400,RINGLING SCHOOL OF ART AND DESIGN       ,FL,34234-5895,Private      ,8,5,13,2249,480,2729
01303904,SOUTH UNIVERSITY - WEST PALM BEACH CAMPU,FL,33409-5149,Proprietary  ,20,142,162,678,2615,3293
01323400,LORENZO WALKER INST OF TECHNOLOGY       ,FL,34104-4405,Public       ,9,18,27,393,852,1245
02089600,CONCORDE CAREER INSTITUTE               ,FL,32211-0000,Proprietary  ,20,104,124,394,2201,2595
02106602,AMERICAN INSTITUTE - AMERICAN INSTITUTE ,FL,34747-5161,Proprietary  ,0,0,0,2,17,19
02113609,AMERICAN INTERCONTINENTAL UNIV - WESTON ,FL,33326-3233,Proprietary  ,1,13,14,101,541,642
02115300,PINELLAS TECHNICAL EDUCATION CENTERS - S,FL,33711-0000,Public       ,14,97,111,588,2770,3358
02116006,SANFORD-BROWN INSTITUTE - FT. LAUDERDALE,FL,33309-1906,Proprietary  ,9,39,48,277,918,1195
02121801,EVEREST INSTITUTE  - HIALEAH            ,FL,33012-7193,Proprietary  ,0,0,0,46,99,145
02148200,FASHION FOCUS HAIR ACADEMY              ,FL,34231-0000,Proprietary  ,6,10,16,53,136,189
02148300,MANHATTAN BEAUTY SCHOOL                 ,FL,33611-0000,Proprietary  ,4,27,31,152,605,757
02149900,PAUL MITCHELL THE SCHOOL-JACKSONVILLE   ,FL,32205-0000,Proprietary  ,9,14,23,234,504,738
02151900,KEISER  UNIVERSITY                      ,FL,33309-0000,Private      ,364,1525,1889,6101,25572,31673
02159600,BAPTIST COLLEGE OF FLORIDA (THE)        ,FL,32440-0000,Private      ,1,7,8,350,361,711
02172700,CONCORDE CAREER INSTITUTE               ,FL,33607-0000,Proprietary  ,7,64,71,262,1246,1508
02188900,HOBE SOUND BIBLE COLLEGE                ,FL,33475-0000,Private      ,0,7,7,78,136,214
02200100,BRADENTON BEAUTY & BARBER ACADEMY       ,FL,34209-0000,Proprietary  ,1,8,9,67,232,299
02215900,ATI CAREER TRAINING CENTER              ,FL,33309-1785,Proprietary  ,1,11,12,1,11,12
02218700,FLORIDA TECHNICAL COLLEGE               ,FL,32826-2707,Proprietary  ,134,343,477,1579,5077,6656
02218707,FLORIDA TECHNICAL COLLEGE - LAKELAND    ,FL,33813-2101,Proprietary  ,1,18,19,168,698,866
02218709,FLORIDA TECHNICAL COLLEGE - DELAND      ,FL,32720-7415,Proprietary  ,20,126,146,271,1435,1706
02228300,LAKE TECHNICAL CENTER                   ,FL,32726-0000,Public       ,3,30,33,554,1743,2297
02245500,FORTIS COLLEGE                          ,FL,32789-4679,Proprietary  ,5,26,31,135,879,1014
02257900,INTERNATIONAL ACADEMY                   ,FL,32119-3541,Proprietary  ,5,40,45,100,426,526
02275100,CONCORDE CAREER INSTITUTE               ,FL,33025-0000,Proprietary  ,21,55,76,232,807,1039
02278800,SOUTHWEST FLORIDA COLLEGE               ,FL,33907-0000,Proprietary  ,43,141,184,656,2336,2992
02278801,SOUTHWEST FLORIDA COLLEGE - TAMPA       ,FL,33619-1344,Proprietary  ,11,34,45,515,1311,1826
02278802,SOUTHWEST FLORIDA COLLEGE - INSTITUTUE O,FL,33928-9469,Proprietary  ,0,18,18,56,174,230
02278803,SOUTHWEST FLORIDA COLLEGE - PORT CHARLOT,FL,33953-3100,Proprietary  ,13,44,57,190,850,1040
02279600,CORTIVA INSTITUTE - FLORIDA             ,FL,33781-0000,Proprietary  ,12,21,33,70,231,301
02283800,BEAUTY SCHOOLS OF AMERICA               ,FL,33012-3322,Proprietary  ,72,418,490,696,3659,4355
02287100,LA BELLE BEAUTY SCHOOL                  ,FL,33012-3224,Proprietary  ,3,31,34,49,278,327
02293200,ATI CAREER TRAINING CENTER              ,FL,33309-5916,Proprietary  ,1,0,1,5,7,12
02293201,ATI CAREER TRAINING CENTER - MIAMI      ,FL,33122-1707,Proprietary  ,2,8,10,9,26,35
02293202,ATI CAREER TAINING CENTER - ATI COLLEGE ,FL,87109-2016,Proprietary  ,0,4,4,9,24,33
02293600,ADVANCED TECHNICAL CENTERS              ,FL,33266-1597,Private      ,0,6,6,60,153,213
02297000,CHARLOTTE TECHNICAL CENTER              ,FL,33948-0000,Public       ,2,9,11,238,632,870
02300900,WITHLACOOCHEE TECHNICAL INSTITUTE       ,FL,34450-0000,Public       ,3,3,6,266,802,1068
02305700,FORTIS COLLEGE                          ,FL,33619-1283,Proprietary  ,0,0,0,88,450,538
02305800,FLORIDA CAREER COLLEGE                  ,FL,33012-7028,Proprietary  ,182,1105,1287,1994,8913,10907
02305810,FLORIDA CAREER COLLEGE - CLEARWATER     ,FL,33759-3924,Proprietary  ,4,8,12,120,428,548
02307400,GEORGE STONE AREA VOCATIONAL TECHNICAL  ,FL,32526-0000,Public       ,6,24,30,408,1754,2162
02314100,SCHILLER INTERNATIONAL UNIVERSITY       ,FL,33770-0000,Proprietary  ,3,7,10,89,432,521
02316200,MIAMI LAKES TECHNICAL EDUCATION CTR     ,FL,33014-0000,Public       ,43,86,129,558,1725,2283
02321200,ORANGE TECH EDUC CTR- WESTSIDE TECH     ,FL,34787-0000,Public       ,6,21,27,365,954,1319
02325100,KEY COLLEGE                             ,FL,33004-3046,Proprietary  ,0,10,10,22,97,119
02326303,MEDVANCE INSTITUTE - WEST PALM          ,FL,33461-2171,Proprietary  ,6,32,38,160,516,676
02326306,MEDVANCE INSTITUTE - MIAMI              ,FL,33173-3431,Proprietary  ,0,2,2,85,310,395
02326800,MERIDIAN COLLEGE                        ,FL,34240-8478,Proprietary  ,6,27,33,92,376,468
02326900,SUNSTATE ACADEMY OF HAIR DESIGN         ,FL,33907-1415,Proprietary  ,23,46,69,237,615,852
02329900,FLORIDA INSTITUTE OF ULTRASOUND         ,FL,32514-0000,Proprietary  ,3,7,10,129,530,659
02338400,FT PIERCE BEAUTY ACADEMY                ,FL,34982-0000,Proprietary  ,8,51,59,109,475,584
02346200,WYOTECH                                 ,FL,32174-1010,Proprietary  ,17,76,93,459,1110,1569
02362100,FULL SAIL UNIVERSITY                    ,FL,32792-0000,Proprietary  ,369,1249,1618,16559,30573,47132
02499000,ACADEMY OF COSMETOLOGY                  ,FL,32953-3311,Proprietary  ,2,12,14,91,270,361
02501500,"O*TEC, MID-FLORIDA TECH                 ",FL,32809-0000,Public       ,15,45,60,677,1993,2670
02502700,UEI (UNITED EDUCATION INSTITUTE)        ,FL,32207-5627,Proprietary  ,0,0,0,149,637,786
02502702,ADVANCED CAREER TRAINING-JACKSONVIL     ,FL,32256-0000,Proprietary  ,0,0,0,104,419,523
02504600,WINTER PARK TECH                        ,FL,32789-0000,Public       ,4,10,14,204,890,1094
02508900,TALMUDIC COLLEGE OF FLORIDA             ,FL,33139-0000,Private      ,3,3,6,43,27,70
02511700,RIDGE TECHNICAL CENTER                  ,FL,33881-0000,Public       ,4,20,24,482,1312,1794
02513200,ORLANDO TECHNICAL CENTER                ,FL,32801-0000,Public       ,8,33,41,655,2022,2677
02515400,CITY COLLEGE                            ,FL,33309-3073,Private      ,47,170,217,620,2807,3427
02517100,SARASOTA SCHOOL OF MASSAGE THERAPY      ,FL,34243-6130,Proprietary  ,3,9,12,40,216,256
02524000,SUNSTATE ACADEMY OF HAIR DESIGN         ,FL,34624-0000,Proprietary  ,7,24,31,112,343,455
02524200,ROBERT MORGAN EDUCATIONAL CENTER        ,FL,33177-0000,Public       ,48,45,93,608,1310,1918
02531803,PAUL MITCHELL THE SCHOOL - ORLANDO      ,FL,32765-6444,Proprietary  ,14,15,29,150,238,388
02531805,PAUL MITCHELL THE SCHOOL -TAMPA         ,FL,33613-0000,Proprietary  ,16,23,39,179,296,475
02547600,FLORIDA NATIONAL COLLEGE                ,FL,33012-0000,Proprietary  ,24,65,89,856,2989,3845
02547601,FLORIDA NATIONAL UNIVERSITY - SOUTH CAMP,FL,33175-2478,Proprietary  ,22,84,106,141,488,629
02547602,FLORIDA NATIONAL UNIVERSITY - TRAINING A,FL,33012-4108,Proprietary  ,3,18,21,35,102,137
02554200,RADFORD LOCKLIN TECH CENTER             ,FL,32570-0000,Public       ,0,13,13,111,391,502
02573200,LA BELLE BEAUTY ACADEMY                 ,FL,33135-0000,Proprietary  ,8,36,44,112,455,567
02597100,HERITAGE INSTITUTE                      ,FL,33912-7132,Proprietary  ,34,80,114,470,1290,1760
02598200,SOUTHERN CAREER COLLEGE                 ,FL,32211-0000,Proprietary  ,4,13,17,80,409,489
02601600,HENRY W BREWSTER TECHNICAL CENTER       ,FL,33602-0000,Public       ,8,28,36,209,966,1175
02612700,"SALON PROFESSIONAL ACADEMY - MELBOURNE, ",FL,32904-3919,Proprietary  ,10,13,23,81,244,325
02616400,SANFORD-BROWN INSTITUTE                 ,FL,32256-3520,Proprietary  ,3,39,42,215,985,1200
02616401,SANFORD-BROWN INSTITUTE - TAMPA         ,FL,33610-8304,Proprietary  ,5,23,28,186,786,972
02616705,LE CORDON BLEU COLLEGE OF CULINARY ARTS ,FL,33025-3929,Proprietary  ,5,14,19,437,639,1076
03003600,MCFATTER TECHNICAL CENTER               ,FL,33317-7499,Public       ,23,58,81,700,1740,2440
03008600,FLORIDA COLLEGE OF NATURAL HEALTH       ,FL,33064-1342,Proprietary  ,24,95,119,311,1078,1389
03010608,VIRGINIA COLLEGE - PENSACOLA            ,FL,32501-5650,Proprietary  ,4,23,27,217,1371,1588
03010612,VIRGINIA COLLEGE - GOLF ACADEMY OF AMERI,FL,32701-0000,Proprietary  ,3,3,6,66,120,186
03010618,VIRGINIA COLLEGE - JACKSONVILLE         ,FL,32207-5167,Proprietary  ,3,28,31,195,1023,1218
03012300,ASM BEAUTY WORLD ACADEMY                ,FL,33021-0000,Proprietary  ,2,21,23,48,225,273
03018500,BENE'S INTERNATIONAL SCHOOL OF BEAUTY   ,FL,34652-1637,Proprietary  ,6,27,33,125,457,582
03026508,REMINGTON COLLEGE - TAMPA               ,FL,33619-1177,Private      ,5,10,15,194,1097,1291
03028200,TRINITY COLLEGE OF FLORIDA              ,FL,34655-4401,Private      ,1,8,9,170,225,395
03031400,INTERNATIONAL ACADEMY OF DESIGN AND TECH,FL,33634-6313,Proprietary  ,44,209,253,1198,4472,5670
03031402,INTERNATIONAL ACADEMY OF DESIGN AND TECH,FL,32809-4613,Proprietary  ,8,24,32,499,918,1417
03031403,IADT - ORLANDO CULINARY ACADEMY         ,FL,32819-0000,Proprietary  ,3,8,11,253,490,743
03035800,HERITAGE INSTITUTE                      ,FL,32216-0948,Proprietary  ,11,49,60,139,829,968
03035900,NATIONAL AVIATION ACADEMY               ,FL,33760-3931,Proprietary  ,34,48,82,466,998,1464
03037500,HODGES UNIVERSITY                       ,FL,34119-7932,Private      ,44,199,243,948,4287,5235
03054200,FORTIS COLLEGE                          ,FL,33144-2373,Proprietary  ,0,2,2,92,240,332
03071600,COLLEGE OF BUSINESS & TECHNOLOGY        ,FL,33176-0000,Proprietary  ,14,85,99,414,1803,2217
03076402,BRYMAN SCHOOL OF ARIZONA (THE) - ANTHEM ,FL,32803-3509,Proprietary  ,19,66,85,238,722,960
03078003,OHIO CENTER FOR BROADCASTING - MIAMI MED,FL,33130-3042,Proprietary  ,3,14,17,21,105,126
03079800,GEORGE T BAKER AVIATION                 ,FL,33142-5687,Public       ,17,25,42,434,654,1088
03079900,CITY COLLEGE                            ,FL,32707-0000,Private      ,13,62,75,127,743,870
03089200,NOUVELLE INSTITUTE                      ,FL,33125-4141,Proprietary  ,2,45,47,43,545,588
03096300,FORTIS INSTITUTE                        ,FL,33860-0000,Proprietary  ,3,4,7,47,235,282
03100800,TAYLOR TECHNICAL INSTITUTE              ,FL,32348-0894,Public       ,1,2,3,53,206,259
03101900,TRINITY BAPTIST COLLEGE                 ,FL,32221-1398,Private      ,3,9,12,303,347,650
03103900,MARION COUNTY COMMUNITY TECH & ADUL     ,FL,34474-3172,Public       ,4,21,25,477,1755,2232
03108500,EVERGLADES UNIVERSITY                   ,FL,33431-0000,Private      ,11,119,130,263,2158,2421
03108600,COM-PU-MED VOCATIONAL CAREERS           ,FL,33012-4861,Proprietary  ,3,48,51,76,458,534
03113400,ACADEMY OF HEALING ARTS                 ,FL,33463-2113,Proprietary  ,1,8,9,45,197,242
03114700,PRAXIS INSTITUTE                        ,FL,33135-2657,Proprietary  ,3,16,19,33,354,387
03115500,ADVENTIST UNIVERSITY OF HEALTH SCIENCES ,FL,32803-1237,Private      ,15,46,61,1536,3077,4613
03123900,KEISER CAREER COLLEGE                   ,FL,33413-0000,Proprietary  ,31,150,181,449,1944,2393
03125600,MIAMI AD SCHOOL                         ,FL,33139-5203,Proprietary  ,1,5,6,127,423,550
03127900,TECHNICAL EDUCATION CTR OSCEOLA         ,FL,34744-4459,Public       ,8,29,37,456,1397,1853
03158300,LEE COUNTY HIGH TECH CENTER NORTH       ,FL,33993-2479,Public       ,1,4,5,232,635,867
03171300,UNIVERSITY OF ST. AUGUSTINE FOR HEALTH S,FL,32084-4215,Proprietary  ,3,35,38,157,2030,2187
03178400,CORAL RIDGE NURSES ASST TRAINING        ,FL,33306-0000,Proprietary  ,0,0,0,22,68,90
03224300,NEW PROFESSIONS TECHNICAL INSTITUTE     ,FL,33134-1640,Proprietary  ,13,97,110,107,891,998
03230300,CHOICE HIGH SCHOOL AND TECHNICAL CENTER ,FL,32547-1299,Public       ,4,8,12,159,706,865
03238300,FLORIDA COLLEGE OF INTEGRATIVE MED      ,FL,32809-5721,Proprietary  ,5,11,16,156,548,704
03255300,FLORIDA GULF COAST UNIVERSITY           ,FL,33965-6565,Public       ,184,102,286,19819,7250,27069
03256300,YESHIVA GEDOLAH RABBINICAL COLLEGE      ,FL,33139-4708,Private      ,6,0,6,42,18,60
03264300,SOUTH FLORIDA BIBLE COLLEGE AND THEOLOGI,FL,33441-5768,Private      ,1,8,9,21,158,179
03346300,ACAD FOR PRAC NURSING & HEALTH OCCP     ,FL,33417-4574,Private      ,7,59,66,333,1417,1750
03348400,PROFESSIONAL TRAINING CENTERS           ,FL,33184-0000,Proprietary  ,8,47,55,175,948,1123
03373300,BEACON COLLEGE                          ,FL,34748-5224,Private      ,1,1,2,200,144,344
03374300,FLORIDA COASTAL SCHOOL OF LAW           ,FL,32256-0000,Proprietary  ,0,9,9,97,2583,2680
03382300,BRADFORD-UNION AREA CAREERTECHNICAL CENT,FL,32091-2434,Public       ,0,10,10,73,376,449
03390300,LINCOLN TECHNICAL INSTITUTE             ,FL,32730-2351,Proprietary  ,5,17,22,200,506,706
03411400,INTERNATIONAL TRAINING CAREERS          ,FL,33155-1462,Private      ,4,25,29,66,493,559
03414500,ACUPUNCTURE AND MASSAGE COLLEGE         ,FL,33176-1509,Proprietary  ,3,21,24,102,440,542
03425400,CENTRAL FLORIDA INSTITUTE               ,FL,34684-4436,Proprietary  ,1,4,5,158,578,736
03429600,ATLANTIC INST OF ORIENTAL MEDICINE      ,FL,33316-0000,Private      ,1,11,12,47,289,336
03429700,EAST WEST COLLG OF NATURAL MEDICINE     ,FL,34236-4959,Proprietary  ,0,6,6,27,273,300
03433400,NEW CONCEPT MASSAGE AND BEAUTY SCHO     ,FL,33135-0000,Proprietary  ,3,24,27,46,153,199
03434300,FORTIS COLLEGE                          ,FL,32073-2999,Proprietary  ,7,34,41,159,678,837
03480301,MEDVANCE INSTITUTE - FORT LAUDERDALE    ,FL,33313-7261,Proprietary  ,5,15,20,82,316,398
03480302,MEDVANCE INSTITUTE - STUART             ,FL,34994-3000,Proprietary  ,4,23,27,160,725,885
03491400,AMERICAN ADVANCED TECHNICIANS INST      ,FL,33014-4430,Proprietary  ,4,38,42,73,213,286
03549300,ULTIMATE MEDICAL ACADEMY                ,FL,33756-4917,Proprietary  ,244,2590,2834,2116,22353,24469
03553300,KEISER CAREER COLLEGE                   ,FL,32216-0000,Proprietary  ,17,79,96,405,1757,2162
03557300,NORTH FLORIDA COSMETOLOGY INSTITUTE     ,FL,32312-0000,Proprietary  ,7,27,34,174,513,687
03564300,"INTERNATIONAL SCHOOL OF HEALTH, BEAUTY &",FL,33311-1141,Proprietary  ,5,21,26,57,267,324
03570400,ENGLISH CENTER (THE)                    ,FL,33133-2703,Public       ,3,41,44,35,425,460
03611400,FLORIDA BARBER ACADEMY                  ,FL,33441-0000,Proprietary  ,11,65,76,70,468,538
03618300,FLORIDA INSTITUTE OF ANIMAL ARTS        ,FL,32792-0000,Proprietary  ,8,10,18,205,278,483
03627400,JACKSONVILLE BEAUTY INSTITUTE           ,FL,32208-1885,Proprietary  ,7,43,50,128,497,625
03627600,FLORIDA EDUCATION INSTITUTE             ,FL,33144-5036,Proprietary  ,1,35,36,103,583,686
03661400,SOUTH FLORIDA INSTITUTE OF TECHNOLO     ,FL,33135-0000,Proprietary  ,16,215,231,231,1531,1762
03691400,AVE MARIA SCHOOL OF LAW                 ,FL,34119-1376,Private      ,5,6,11,101,643,744
03696400,SABER                                   ,FL,33134-1604,Private      ,0,30,30,76,696,772
03706300,AMERICAN INSTITUTE                      ,FL,33319-0000,Proprietary  ,9,32,41,97,392,489
03757300,ADVANCE SCIENCE INSTITUTE               ,FL,33012-0000,Proprietary  ,1,11,12,37,94,131
03801400,BEAUTY INSTITUTE (THE)                  ,FL,33409-2972,Proprietary  ,3,17,20,77,218,295
03801401,BEAUTY INSTITUTE (THE) - MARGATE        ,FL,33068-5704,Proprietary  ,0,2,2,31,84,115
03816300,ARTISTIC NAILS & BEAUTY ACADEMY         ,FL,33605-5919,Proprietary  ,9,57,66,201,665,866
03823300,FLORIDA ACADEMY OF HEALTH & BEAUTY      ,FL,33311-0000,Proprietary  ,0,10,10,17,74,91
03832300,DADE MEDICAL COLLEGE                    ,FL,33126-5534,Proprietary  ,61,290,351,1224,5213,6437
03842500,CAMBRIDGE INSTITUTE OF ALLIED HEALTH    ,FL,32750-0000,Proprietary  ,3,13,16,58,369,427
03856300,UNIVERSAL BEAUTY SCHOOL                 ,FL,33174-4406,Proprietary  ,2,19,21,42,221,263
03856500,FLORIDA SCHOOL OF TRADITIONAL MIDWIFERY ,FL,32601-5507,Private      ,0,4,4,27,188,215
03875300,MCI INSTITUTE OF TECHNOLOGY             ,FL,33409-4937,Proprietary  ,6,29,35,156,553,709
03888300,DRAGON RISES COLLEGE OF ORIENTAL MEDICIN,FL,32601-5089,Proprietary  ,0,0,0,17,98,115
03903500,SOUTHERN TECHNICAL COLLEGE              ,FL,32809-0000,Proprietary  ,27,200,227,389,2612,3001
03906300,CAREER INSTITUTE OF FLORIDA             ,FL,33773-3434,Proprietary  ,0,0,0,5,29,34
03907301,PAUL MITCHELL THE SCHOOL FT MYERS       ,FL,33907-0000,Proprietary  ,14,11,25,107,196,303
03911300,TOTAL INTERNATIONAL CAREER INSTITUTE    ,FL,33012-0000,Proprietary  ,1,18,19,11,213,224
03939300,WOLFORD COLLEGE                         ,FL,34108-1931,Proprietary  ,2,3,5,42,355,397
03939400,CENTURA INSTITUTE                       ,FL,32807-3566,Proprietary  ,1,25,26,119,571,690
03939600,DAYTONA COLLEGE                         ,FL,32174-8445,Proprietary  ,0,27,27,156,609,765
03941300,AVE MARIA UNIVERSITY                    ,FL,34142-9505,Private      ,5,1,6,1438,244,1682
03957400,NEW COLLEGE OF FLORIDA                  ,FL,34243-2109,Public       ,7,9,16,2104,554,2658
03985300,COMMERCIAL DIVING ACADEMY               ,FL,32208-0000,Proprietary  ,24,57,81,435,1158,1593
03986300,AVIATOR COLLEGE OF AERONAUTICAL SCIENCE ,FL,34946-9022,Proprietary  ,2,9,11,96,284,380
04016500,AMERICAN INSTITUTE OF BEAUTY            ,FL,33773-0000,Proprietary  ,12,49,61,119,455,574
04029300,TRENDSETTERS OF FLORIDA SCHOOL OF BEAUTY,FL,32205-4737,Proprietary  ,2,7,9,33,190,223
04038302,ATA COLLEGE-ATA CAREER EDUCATION        ,FL,34606-4300,Proprietary  ,9,40,49,127,583,710
04039300,SULLIVAN AND COGLIANO TRAINING CENTERS  ,FL,33014-6427,Proprietary  ,14,267,281,122,1963,2085
04083400,CAMBRIDGE INSTITUTE OF ALLIED HEALTH & T,FL,33484-6543,Proprietary  ,3,10,13,81,396,477
04105400,PENSACOLA SCHOOL OF MASSAGE THERAPY & HE,FL,32504-7337,Proprietary  ,3,18,21,76,401,477
04106300,PALM BEACH ACADEMY OF HEALTH & BEAUTY   ,FL,33403-2130,Proprietary  ,18,80,98,82,281,363
04116400,FUTURE-TECH INSTITUTE                   ,FL,33135-4142,Proprietary  ,2,37,39,38,298,336
04116600,TAYLOR COLLEGE                          ,FL,34420-8714,Proprietary  ,1,10,11,91,901,992
04119400,AVEDA INSTITUTE - SAINT PETERSBURG      ,FL,33701-4242,Proprietary  ,28,49,77,524,998,1522
04120400,HI-TECH SCHOOL OF COSMETOLOGY           ,FL,33174-0000,Proprietary  ,3,7,10,109,170,279
04126900,ACADEMY OF CAREER TRAINING              ,FL,34741-4644,Proprietary  ,9,34,43,189,564,753
04127400,DIGITAL MEDIA ARTS COLLEGE              ,FL,33431-5919,Proprietary  ,30,9,39,423,315,738
04128400,MANAGEMENT RESOURCES INSTITUTE          ,FL,33126-5473,Proprietary  ,3,138,141,71,1289,1360
04129900,FLORIDA SCHOOL OF MASSAGE               ,FL,32608-5419,Proprietary  ,7,13,20,92,338,430
04130400,SHEAR EXCELLENCE INTERNATIONAL HAIR ACAD,FL,33614-2783,Proprietary  ,3,14,17,56,190,246
04133500,ACADEMY FOR FIVE ELEMENT ACUPUNCTURE    ,FL,32601-6811,Private      ,1,4,5,25,149,174
04133900,FUTURA CAREER INSTITUTE                 ,FL,33012-3325,Proprietary  ,3,26,29,44,213,257
04134800,AVEDA INSTITUTE - TALLAHASSEE           ,FL,32304-3186,Proprietary  ,19,28,47,516,805,1321
04134900,ORANGE PARK BEAUTY ACADEMY              ,FL,32073-5524,Proprietary  ,0,0,0,8,16,24
04135000,COZMO THE SCHOOL                        ,FL,34135-4810,Proprietary  ,2,6,8,23,105,128
04135900,ALLIED HEALTH INSTITUTE                 ,FL,33068-0000,Proprietary  ,4,61,65,106,1484,1590
04140800,NORTH FLORIDA ACADEMY                   ,FL,32065-7758,Proprietary  ,1,5,6,37,121,158
04143000,VOCATIONAL INSTITUTE OF FLORIDA         ,FL,33135-1939,Proprietary  ,0,0,0,17,42,59
04143100,PROFESSIONAL HANDS INSTITUTE            ,FL,33135-1939,Proprietary  ,0,4,4,12,69,81
04145900,CELEBRITY SCHOOL OF BEAUTY              ,FL,33144-4153,Proprietary  ,2,36,38,105,311,416
04146200,WALTON CAREER DEVELOPMENT CENTER        ,FL,32433-1557,Public       ,3,6,9,84,277,361
04146300,MARCHMAN TECHNICAL EDUCATION CENTER     ,FL,34653-1211,Public       ,3,4,7,236,443,679
04148500,MEDICAL INSTITUTE OF PALM BEACH         ,FL,33460-5042,Proprietary  ,1,6,7,101,300,401
04150800,IMMOKALEE TECHNICAL CENTER              ,FL,34142-3146,Public       ,10,7,17,201,239,440
04151500,AMERICAN ACADEMY OF COSMETOLOGY         ,FL,32065-8026,Proprietary  ,6,24,30,76,229,305
04156300,UNIVERSITY OF FORT LAUDERDALE           ,FL,33313-5809,Private      ,0,4,4,81,162,243
04156400,AVIATION INSTITUTE OF MAINTENANCE       ,FL,32803-6487,Proprietary  ,15,37,52,295,803,1098
04157100,AEROSIM FLIGHT ACADEMY                  ,FL,32773-9683,Proprietary  ,4,8,12,141,284,425
04158300,FLAGLER TECHNICAL INSTITUTE             ,FL,32137-4714,Public       ,1,14,15,138,488,626
04162000,JOSE MARIA VARGAS UNIVERSITY            ,FL,33025-4534,Proprietary  ,0,4,4,24,128,152
04162500,HOLLYWOOD INSTITUTE OF BEAUTY CAREERS   ,FL,33020-4807,Proprietary  ,25,118,143,199,1049,1248
04163000,SALON PROFESSIONAL ACADEMY (THE)        ,FL,33624-6321,Proprietary  ,5,14,19,114,273,387
04163100,SALON PROFESSIONAL ACADEMY (THE)        ,FL,32607-1672,Proprietary  ,10,20,30,119,288,407
04163200,SALON PROFESSIONAL ACADEMY (THE)        ,FL,32162-9311,Proprietary  ,3,20,23,92,234,326
04164500,EUREKA INSTITUTE OF HEALTH AND BEAUTY   ,FL,33174-4205,Proprietary  ,1,16,17,32,143,175
04164600,D. A. DORSEY EDUCATIONAL CENTER         ,FL,33147-6304,Public       ,6,17,23,74,314,388
04167300,SALON PROFESSIONAL ACADEMY (THE)        ,FL,33904-4824,Proprietary  ,1,3,4,59,148,207
04170300,BEAUTY ACADEMY OF SOUTH FLORIDA         ,FL,33012-3221,Proprietary  ,5,27,32,49,301,350
04172300,ETERNITY COSMETOLOGY SCHOOL             ,FL,33415-5719,Proprietary  ,6,25,31,70,290,360
04176800,PROGRESSIVE TRAINING CENTERS            ,FL,33060-9238,Proprietary  ,1,2,3,1,14,15
04176900,AMERICAN HEALTH INSTITUTE               ,FL,34654-3743,Proprietary  ,3,13,16,54,193,247
04182500,MILLENNIA ATLANTIC UNIVERSITY           ,FL,33178-2369,Proprietary  ,0,3,3,19,80,99
04188300,FLORIDA ACADEMY                         ,FL,33966-1155,Proprietary  ,5,21,26,116,424,540
04192100,AMERICAN MEDICAL ACADEMY                ,FL,33186-4830,Proprietary  ,9,23,32,203,388,591
04195100,AMBIANCE BEAUTY & BARBER ACADEMY        ,FL,32935-8771,Proprietary  ,1,6,7,47,177,224
04197600,"FLORIDA INSTITUTE OF RECORDING, SOUND AN",FL,32804-3309,Proprietary  ,7,14,21,275,441,716
04204600,BEAUTY AND HEALTH INSTITUTE             ,FL,33626-2610,Proprietary  ,2,27,29,22,192,214
04206300,FLORIDA VOCATIONAL INSTITUTE            ,FL,33155-3762,Proprietary  ,1,19,20,59,276,335
04207900,SAE INSTITUTE OF TECHNOLOGY - MIAMI     ,FL,33160-4307,Proprietary  ,16,34,50,186,327,513
04209500,SHEAR FINESSE HAIRSTYLING ACADEMY       ,FL,32208-5005,Proprietary  ,1,3,4,28,113,141
04210800,ULTRASOUND MEDICAL INSTITUTE            ,FL,33462-4221,Proprietary  ,1,3,4,18,73,91
04212600,COSMIX SCHOOL OF MAKEUP ARTISTRY        ,FL,33306-1640,Proprietary  ,3,12,15,16,60,76
04213200,KAIZEN BEAUTY ACADEMY                   ,FL,33024-6609,Proprietary  ,5,4,9,24,57,81
04214500,PRESTIGE HEALTH & BEAUTY SCIENCES ACADEM,FL,33160-4102,Proprietary  ,1,9,10,3,76,79
04216600,AZURE COLLEGE                           ,FL,33169-5345,Proprietary  ,2,72,74,26,481,507
04217800,BOCA BEAUTY ACADEMY                     ,FL,33434-4178,Proprietary  ,2,15,17,76,253,329
04220200,MORE TECH INSTITUTE                     ,FL,33012-2165,Proprietary  ,1,19,20,8,65,73
04221200,BLY'S SCHOOL OF COSMETOLOGY             ,FL,32601-4021,Proprietary  ,3,13,16,30,178,208
04222100,ANTON AESTHETICS ACADEMY                ,FL,33416-4629,Proprietary  ,1,10,11,2,29,31
04223400,INTERAMERICAN TECHNICAL INSTITUTE       ,FL,00174-2950,Proprietary  ,1,16,17,1,16,17
04225000,PARISIAN SPA INSTITUTE                  ,FL,32204-4127,Proprietary  ,3,8,11,10,32,42
04225200,YECHANLAZ INSTITUTO VOCACIONAL          ,FL,33144-4817,Proprietary  ,3,33,36,5,39,44
04227500,MERRYFIELD SCHOOL OF PET GROOMING       ,FL,33334-4925,Proprietary  ,2,9,11,5,50,55
04228900,BEAUTY ANATOMY INSTITUTE OF COSMETOLOGY ,FL,33069-4313,Proprietary  ,3,6,9,5,13,18
04229700,FIRST COAST BARBER ACADEMY              ,FL,32210-8054,Proprietary  ,1,9,10,7,20,27
04233400,LEE PROFESSIONAL INSTITUTE              ,FL,33916-9320,Proprietary  ,0,11,11,0,11,11
04234500,BURNETT INTERNATIONAL COLLEGE           ,FL,33426-6591,Proprietary  ,0,26,26,0,26,26
00160500,CHAMINADE UNIV OF HONOLULU              ,HI,96816-1578,Private      ,9,47,56,2419,2669,5088
00160600,BRIGHAM YOUNG UNIV-HAWAII CAMPUS        ,HI,96762-1294,Private      ,21,25,46,2231,1163,3394
00161000,UNIVERSITY OF HAWAII AT MANOA           ,HI,96822-2399,Public       ,49,63,112,15708,10274,25982
00161100,UNIVERSITY OF HAWAII AT HILO            ,HI,96720-4091,Public       ,19,26,45,4237,3314,7551
00161200,HONOLULU COMMUNITY COLLEGE              ,HI,96817-4598,Public       ,14,41,55,2873,3751,6624
00161300,KAPIOLANI COMMUNITY COLLEGE             ,HI,96816-4421,Public       ,23,61,84,4010,4440,8450
00161400,KAUAI COMMUNITY COLLEGE                 ,HI,96766-9591,Public       ,4,8,12,701,905,1606
00161500,UNIVERSITY OF HAWAII MAUI COLLEGE       ,HI,96732-1644,Public       ,16,32,48,1949,3318,5267
00454900,LEEWARD COMMUNITY COLLEGE               ,HI,96782-3393,Public       ,44,76,120,3244,4340,7584
00525800,HAWAII COMMUNITY COLLEGE                ,HI,96720-4075,Public       ,14,20,34,1925,2942,4867
00723401,HEALD COLLEGE - HONOLULU                ,HI,96814-0000,Proprietary  ,35,173,208,1161,2823,3984
00727900,HAWAII PACIFIC UNIVERSITY               ,HI,96813-2882,Private      ,13,87,100,5426,4677,10103
01122000,WINDWARD COMMUNITY COLLEGE              ,HI,96744-0000,Public       ,8,33,41,1187,1886,3073
02100300,MED-ASSIST SCHOOL OF HAWAII             ,HI,96813-0000,Proprietary  ,3,8,11,168,388,556
02107800,UNIVERSITY OF HAWAII - WEST OAHU        ,HI,96782-0000,Public       ,10,34,44,2321,2675,4996
02139500,HAWAII INSTITUTE OF HAIR DESIGN         ,HI,96817-5195,Proprietary  ,4,19,23,128,287,415
02159701,NEW HOPE CHRISTIAN COLLEGE - HAWAII     ,HI,96819-2228,Private      ,0,0,0,80,97,177
03017800,TRAVEL INSTITUTE OF THE PACIFIC         ,HI,96814-1946,Proprietary  ,0,13,13,82,275,357
03072500,WORLD MEDICINE INSTITUTE                ,HI,96826-0000,Private      ,1,4,5,53,228,281
03735300,INST OF CLINICAL ACUPUNCTURE & ORIENT MD,HI,96813-2307,Proprietary  ,0,3,3,17,138,155
03999400,TRADITIONAL CHINESE MEDICAL COLLEGE OF H,HI,96743-8324,Private      ,0,2,2,4,59,63
04165200,MAUNA LOA HELICOPTERS                   ,HI,96740-2650,Proprietary  ,2,3,5,23,85,108
04175100,PAUL MITCHELL THE SCHOOL HONOLULU       ,HI,96816-2433,Proprietary  ,8,12,20,176,299,475
04182200,HAWAII MEDICAL INSTITUTE                ,HI,96814-3518,Proprietary  ,13,43,56,310,855,1165
00161600,BOISE STATE UNIVERSITY                  ,ID,83725-1000,Public       ,39,163,202,15103,13668,28771
00161700,"COLLEGE OF IDAHO, THE                   ",ID,83605-4432,Private      ,4,13,17,2000,736,2736
00161900,COLLEGE OF SOUTHERN IDAHO               ,ID,83301-0000,Public       ,23,70,93,3580,4534,8114
00162000,IDAHO STATE UNIVERSITY                  ,ID,83209-5377,Public       ,39,82,121,6400,9366,15766
00162100,LEWIS-CLARK STATE COLLEGE               ,ID,83501-2698,Public       ,4,30,34,2647,2870,5517
00162300,NORTH IDAHO COLLEGE                     ,ID,83814-2199,Public       ,11,84,95,3251,5305,8556
00162400,NORTHWEST NAZARENE UNIVERSITY           ,ID,83686-5897,Private      ,5,36,41,1752,1838,3590
00162500,BRIGHAM YOUNG UNIVERSITY-IDAHO          ,ID,83460-1650,Private      ,219,285,504,13900,12640,26540
00162600,UNIVERSITY OF IDAHO                     ,ID,83844-4291,Public       ,24,62,86,11053,5118,16171
00732915,ITT TECHNICAL INSTITUTE                 ,ID,83713-1529,Proprietary  ,31,216,247,542,2411,2953
00987300,MR JUAN'S CLG OF HAIR DESIGN            ,ID,83301-4154,Proprietary  ,0,4,4,43,114,157
01113300,EASTERN IDAHO TECHNICAL COLLEGE         ,ID,83404-5788,Public       ,3,16,19,482,1294,1776
02218000,CARRINGTON COLLEGE                      ,ID,83704-0000,Proprietary  ,13,75,88,549,2097,2646
02234500,BOISE BIBLE COLLEGE                     ,ID,83714-1220,Private      ,0,1,1,218,168,386
02275800,MR LEONS SCHOOL OF HAIR DESIGN          ,ID,83843-8384,Proprietary  ,1,4,5,20,68,88
02275801,MR. LEON'S SCHOOL OF HAIR DESIGN        ,ID,83501-1910,Proprietary  ,1,0,1,13,28,41
02314000,SCHOOL OF HAIRSTYLING (THE)             ,ID,83202-0000,Proprietary  ,0,2,2,22,64,86
02319800,TONI&GUY HAIRDRESSING ACADEMY           ,ID,83814-2822,Proprietary  ,3,9,12,119,210,329
02319801,TONI&GUY HAIRDRESSING ACADEMY - BOISE   ,ID,83705-2636,Proprietary  ,4,9,13,60,141,201
02349200,HEADMASTERS SCHOOL OF HAIR DESIGN       ,ID,83501-0000,Proprietary  ,2,5,7,32,83,115
02559500,RAZZLE DAZZLE CLG OF HAIR DESIGN        ,ID,83686-5104,Proprietary  ,1,9,10,109,239,348
02607100,PAUL MITCHELL THE SCHOOL BOISE          ,ID,83709-1662,Proprietary  ,5,15,20,205,300,505
03098700,ACADEMY OF COURT REPORTING              ,ID,83704-8320,Proprietary  ,17,49,66,186,530,716
03832400,COSMETOLOGY SCHOOL OF ARTS & SCIENCES   ,ID,83318-1327,Proprietary  ,0,8,8,19,91,110
04051323,ART INSTITUTE OF PHOENIX (THE) - BROWN M,ID,83709-2746,Proprietary  ,0,4,4,83,215,298
04134300,EVANS HAIRSTYLING COLLEGE               ,ID,83440-5277,Proprietary  ,1,6,7,89,58,147
04144500,HAIR ACDMY PAUL MITCHELL PARTNER SCHOOL ,ID,83440-2600,Proprietary  ,7,6,13,129,154,283
04150600,D & L ACADEMY OF HAIR DESIGN            ,ID,83301-6229,Proprietary  ,2,5,7,28,80,108
04155200,OLIVER FINLEY ACADEMY OF COSMETOLOGY    ,ID,83704-8011,Proprietary  ,7,16,23,181,392,573
04163800,MASTER EDUCATORS BEAUTY SCHOOL          ,ID,83301-4118,Proprietary  ,1,4,5,43,70,113
04168600,COLLEGE OF MASSAGE THERAPY              ,ID,83221-1758,Proprietary  ,0,1,1,28,67,95
04176700,D'SHAW INSTITUTE OF COSMETOLOGY         ,ID,83704-4406,Proprietary  ,3,4,7,56,122,178
04194800,VELVET TOUCH ACADEMY OF COSMETOLOGY     ,ID,83687-5020,Proprietary  ,3,8,11,72,139,211
04203200,BOISE BARBER COLLEGE                    ,ID,83704-5919,Proprietary  ,1,4,5,36,116,152
04203500,AUSTIN KADE ACADEMY                     ,ID,83404-5540,Proprietary  ,7,24,31,103,351,454
04207200,ACADEMY DI FIRENZE                      ,ID,83338-2329,Proprietary  ,0,1,1,14,50,64
04211800,COLLEGE OF WESTERN IDAHO                ,ID,83687-5505,Public       ,59,186,245,5250,10142,15392
00149912,EVEREST UNIVERSITY - EVEREST COLLEGE - K,MO,64114-3246,Proprietary  ,7,41,48,7,41,48
00163200,AQUINAS INSTITUTE OF THEOLOGY           ,MO,63108-3323,Private      ,0,1,1,5,106,111
00244900,AVILA UNIVERSITY                        ,MO,64145-1698,Private      ,6,31,37,1620,2027,3647
00245000,CALVARY BIBLE COLLEGE                   ,MO,64147-1341,Private      ,0,6,6,194,255,449
00245200,CENTRAL BIBLE COLLEGE                   ,MO,65803-1096,Private      ,0,0,0,188,148,336
00245300,CENTRAL METHODIST UNIVERSITY            ,MO,65248-1198,Private      ,7,46,53,1935,2572,4507
00245400,UNIVERSITY OF CENTRAL MISSOURI          ,MO,64093-5178,Public       ,27,145,172,10002,5709,15711
00245600,COLUMBIA COLLEGE                        ,MO,65216-4581,Private      ,49,795,844,3715,25424,29139
00245700,CONCORDIA SEMINARY                      ,MO,63105-3199,Private      ,0,6,6,7,456,463
00245800,COTTEY COLLEGE                          ,MO,64772-2790,Private      ,1,1,2,377,99,476
00245900,CROWDER COLLEGE                         ,MO,64850-9165,Public       ,70,96,166,2936,3721,6657
00246000,CULVER STOCKTON COLLEGE                 ,MO,63435-1299,Private      ,2,5,7,1286,247,1533
00246100,DRURY UNIVERSITY                        ,MO,65802-3791,Private      ,16,100,116,2864,4613,7477
00246200,EDEN THEOLOGICAL SEMINARY               ,MO,63119-0000,Private      ,0,1,1,3,179,182
00246300,EVANGEL UNIVERSITY                      ,MO,65802-2125,Private      ,3,20,23,2665,1248,3913
00246302,EVANGEL UNIVERSITY - ASSEMBLIES OF GOD T,MO,65802-2131,Private      ,0,2,2,25,271,296
00246400,FONTBONNE UNIVERSITY                    ,MO,63105-3098,Private      ,5,36,41,1419,2690,4109
00246600,HARRIS-STOWE STATE COLLEGE              ,MO,63103-2199,Public       ,5,30,35,1611,2320,3931
00246700,CONCEPTION SEMINARY COLLEGE             ,MO,64433-0502,Private      ,0,1,1,63,17,80
00246800,JEFFERSON COLLEGE                       ,MO,63050-2441,Public       ,65,90,155,3036,3597,6633
00247100,ST LOUIS COMMUNITY COLLEGE              ,MO,63102-0000,Public       ,168,454,622,12927,20189,33116
00247300,KANSAS CITY ART INSTITUTE               ,MO,64111-1874,Private      ,2,11,13,1414,556,1970
00247400,KANSAS CITY UNIV OF MED AND BIOSCIENCES ,MO,64106-0000,Private      ,0,7,7,117,1249,1366
00247600,KENRICK-GLENNON SEMINARY                ,MO,63119-4330,Private      ,0,0,0,29,10,39
00247700,A.T. STILL UNIV OF HEALTH SCIENCES      ,MO,63501-0000,Private      ,0,22,22,29,2903,2932
00247900,LINCOLN UNIVERSITY                      ,MO,65101-3500,Public       ,12,38,50,2470,2077,4547
00248000,LINDENWOOD UNIVERSITY                   ,MO,63301-1695,Private      ,23,211,234,7496,8657,16153
00248200,MARYVILLE UNIVERSITY                    ,MO,63141-7299,Private      ,11,154,165,2793,5056,7849
00248400,METROPOLITAN COMMUNITY COLLEGE          ,MO,64111-2408,Public       ,182,468,650,11156,17911,29067
00248500,MIDWESTERN BAPTIST THEOL SEMINARY       ,MO,64118-4697,Private      ,1,6,7,104,435,539
00248600,MINERAL AREA COLLEGE                    ,MO,63601-1000,Public       ,30,59,89,2369,2945,5314
00248800,MISSOURI SOUTHERN STATE UNIVERSITY      ,MO,64801-1595,Public       ,24,64,88,4636,4232,8868
00248900,MISSOURI VALLEY COLLEGE                 ,MO,65340-3197,Private      ,4,7,11,1832,544,2376
00249000,MISSOURI WESTERN STATE UNIVERSITY       ,MO,64507-2294,Public       ,22,50,72,4926,3203,8129
00249100,MOBERLY AREA COMMUNITY COLLEGE          ,MO,65270-1304,Public       ,95,130,225,3595,4086,7681
00249400,NAZARENE THEOLOGICAL SEMINARY           ,MO,64131-1246,Private      ,0,2,2,7,204,211
00249500,TRUMAN STATE UNIVERSITY                 ,MO,63501-4221,Public       ,8,7,15,6189,697,6886
00249600,NORTHWEST MISSOURI STATE UNIV           ,MO,64468-6001,Public       ,13,41,54,6756,1641,8397
00249800,PARK UNIVERSITY                         ,MO,64152-3795,Private      ,15,397,412,1791,11051,12842
00249900,ROCKHURST UNIVERSITY                    ,MO,64110-2561,Private      ,6,34,40,2529,1671,4200
00250000,COLLEGE OF THE OZARKS                   ,MO,65726-2502,Private      ,4,2,6,3653,459,4112
00250100,SOUTHEAST MISSOURI STATE UNIV           ,MO,63701-4799,Public       ,44,102,146,9389,5228,14617
00250200,SOUTHWEST BAPTIST UNIVERSITY            ,MO,65613-2597,Private      ,6,53,59,2318,2031,4349
00250300,MISSOURI STATE UNIVERSITY               ,MO,65897-0094,Public       ,68,131,199,17254,9806,27060
00250400,ST LOUIS COLLEGE OF PHARMACY            ,MO,63110-1088,Private      ,1,6,7,926,848,1774
00250600,SAINT LOUIS UNIVERSITY                  ,MO,63103-2097,Private      ,20,92,112,11173,8843,20016
00250900,SAINT PAUL SCHOOL OF THEOLOGY           ,MO,64127-2499,Private      ,0,1,1,7,137,144
00251200,STEPHENS COLLEGE                        ,MO,65215-0001,Private      ,1,11,12,978,745,1723
00251400,NORTH CENTRAL MISSOURI COLLEGE          ,MO,64683-1824,Public       ,13,31,44,1027,1151,2178
00251600,UNIVERSITY OF MISSOURI - COLUMBIA       ,MO,65211-1600,Public       ,77,176,253,29339,10121,39460
00251700,MISSOURI UNIVERSITY OF SCIENCE & TECHNOL,MO,65409-0250,Public       ,23,13,36,6326,1629,7955
00251800,UNIVERSITY OF MISSOURI-KANSAS CITY      ,MO,64110-2497,Public       ,30,155,185,9141,11385,20526
00251900,UNIVERSITY OF MISSOURI-ST LOUIS         ,MO,63121-4499,Public       ,37,172,209,8057,12329,20386
00252000,WASHINGTON UNIVERSITY                   ,MO,63130-4899,Private      ,12,41,53,15300,5885,21185
00252001,WASHINGTON UNIV-SCHOOL OF MEDICINE      ,MO,63110-0000,Private      ,1,5,6,240,1532,1772
00252100,WEBSTER UNIVERSITY                      ,MO,63119-3194,Private      ,12,194,206,3869,14431,18300
00252200,WENTWORTH MILITARY ACADEMY              ,MO,64067-1799,Private      ,5,9,14,402,287,689
00252300,WESTMINSTER COLLEGE                     ,MO,65251-1299,Private      ,2,3,5,1344,224,1568
00252400,WILLIAM JEWELL COLLEGE                  ,MO,64068-1896,Private      ,1,9,10,1386,376,1762
00252500,WILLIAM WOODS UNIVERSITY                ,MO,65251-2388,Private      ,2,130,132,1214,1675,2889
00405704,NATIONAL AMERICAN UNIVERSITY            ,MO,64057-1791,Proprietary  ,1,9,10,69,824,893
00439800,COX HEALTH SYSTEM SCHOOL OF RADIOLOGIC T,MO,65802-0000,Private      ,0,0,0,4,31,35
00441300,MERCY HOSPITAL SPRINGFIELD SCHOOL OF RAD,MO,65804-2263,Private      ,1,8,9,139,311,450
00470300,LOGAN COLLEGE OF CHIROPRACTIC           ,MO,63006-0000,Private      ,2,10,12,77,1063,1140
00470700,COVENANT THEOLOGICAL SEMINARY           ,MO,63141-8697,Private      ,0,4,4,4,525,529
00471100,LINN STATE TECHNICAL COLLEGE            ,MO,65051-9607,Public       ,27,10,37,1634,647,2281
00471300,THREE RIVERS COMMUNITY COLLEGE          ,MO,63901-2393,Public       ,68,99,167,2350,4397,6747
00528800,KIRKSVILLE AREA TECHNICAL CENTER        ,MO,63501-0000,Public       ,1,4,5,43,102,145
00528900,WAYNESVILLE CAREER CENTER               ,MO,65583-2131,Public       ,1,3,4,64,191,255
00542400,SOUTH CENTRAL CAREER CENTER             ,MO,65775-3334,Public       ,1,3,4,54,180,234
00542600,SIKESTON CAREER AND TECHNOLOGY CTR      ,MO,63801-0000,Public       ,3,8,11,91,363,454
00542900,ROLLA TECHNICAL INSTITUTE               ,MO,65401-3601,Public       ,6,7,13,344,474,818
00543000,POPLAR BLUFF TECHNICAL CAREER CNTR      ,MO,63901-0000,Public       ,1,1,2,81,287,368
00543800,SALINE COUNTY CAREER CENTER             ,MO,65340-0000,Public       ,0,0,0,17,63,80
00544500,TRUMAN MEDICAL CENTER SCHOOL OF NURSE AN,MO,64108-2677,Private      ,1,6,7,76,290,366
00553100,GRAND RIVER TECHNICAL SCHOOL            ,MO,64601-1299,Public       ,0,1,1,78,71,149
00553200,CAPE GIRARDEAU CAREER & TECHNOLOGY CENTE,MO,63703-7511,Public       ,2,5,7,330,724,1054
00638900,BARNES JEWISH COLLEGE OF NURSING AND ALL,MO,63110-1091,Private      ,1,13,14,723,1410,2133
00639200,RESEARCH COLLEGE OF NURSING             ,MO,64132-1199,Proprietary  ,1,8,9,149,446,595
00639201,RESEARCH MEDICAL CENTER - COLLEGE OF NUR,MO,64132-1199,Proprietary  ,0,5,5,67,229,296
00639202,RESEARCH MED CTR SCHL OF RAD TECH       ,MO,64132-0000,Proprietary  ,0,1,1,30,119,149
00666600,LUTHERAN  SCHOOL OF NURSING             ,MO,63118-3909,Proprietary  ,1,6,7,165,671,836
00732923,ITT TECHNICAL INSTITUTE                 ,MO,63045-1122,Proprietary  ,57,340,397,931,4503,5434
00754000,MISSOURI BAPTIST UNIVERSITY             ,MO,63141-8698,Private      ,10,63,73,1990,3118,5108
00808000,STATE FAIR COMMUNITY COLLEGE            ,MO,65301-0000,Public       ,57,148,205,2873,4287,7160
00826900,HILLYARD TECHNICAL CENTER               ,MO,64506-0000,Public       ,2,6,8,190,382,572
00855200,STEVENS INSTITUTE OF BUSINESS & ARTS    ,MO,63103-0000,Proprietary  ,0,5,5,137,325,462
00860600,TRI-COUNTY TECHNICAL SCHOOL             ,MO,65026-0000,Public       ,0,1,1,17,58,75
00886200,EAST CENTRAL COLLEGE                    ,MO,63084-0529,Public       ,39,80,119,2402,2914,5316
00908900,HANNIBAL-LAGRANGE COLLEGE               ,MO,63401-1999,Private      ,5,9,14,935,641,1576
00952000,NATIONAL ACADEMY OF BEAUTY ARTS         ,MO,63128-1307,Proprietary  ,3,11,14,175,397,572
00959000,INDEPENDENCE COLLEGE OF COSMETOLOGY     ,MO,64055-1105,Proprietary  ,2,5,7,67,172,239
00960700,HOUSE OF HEAVILIN BEAUTY COLLEGE        ,MO,64110-2826,Proprietary  ,1,10,11,45,203,248
00978200,SAINT LUKE'S COLLEGE OF HEALTH SCIENCES ,MO,64114-3237,Private      ,0,5,5,281,689,970
00979500,MISSOURI COLLEGE                        ,MO,63144-2901,Proprietary  ,14,49,63,283,821,1104
01014814,COLORADO TECHNL UNIV NORTH KANSAS CITY  ,MO,64116-3614,Proprietary  ,0,6,6,62,476,538
01027900,HICKEY COLLEGE                          ,MO,63146-0000,Proprietary  ,5,2,7,630,499,1129
01040500,PINNACLE CAREER INSTITUTE               ,MO,64131-3367,Proprietary  ,19,192,211,244,1995,2239
01040501,PINNACLE CAREER INSTITUTE - NORTH KANSAS,MO,64153-1151,Proprietary  ,8,45,53,99,525,624
01050303,WICHITA TECHNICAL INSTITUTE - WTI JOPLIN,MO,64801-2970,Proprietary  ,1,13,14,67,444,511
01102600,WARRENSBURG AREA VOC TECH SCH           ,MO,64093-0000,Public       ,0,2,2,56,130,186
01173500,PIKE/LINCOLN TECHNICAL CENTER           ,MO,63344-0000,Public       ,1,0,1,43,77,120
01250000,RANKEN TECHNICAL COLLEGE                ,MO,63113-2811,Private      ,20,56,76,1886,2619,4505
01258000,ST LOUIS CHRISTIAN COLLEGE              ,MO,63033-6499,Private      ,1,1,2,181,209,390
01320800,BAPTIST BIBLE COLLEGE                   ,MO,65803-3498,Private      ,0,6,6,279,283,562
02056100,FOUR RIVERS CAREER CENTER               ,MO,63090-0000,Public       ,0,2,2,29,81,110
02066900,NICHOLS CAREER CENTER                   ,MO,65101-2814,Public       ,0,0,0,74,144,218
02068200,COX HEALTH - COX COLLEGE                ,MO,65802-0000,Private      ,7,29,36,453,1407,1860
02090400,BOONSLICK TECHNICAL EDUCATION CTR       ,MO,65233-0000,Public       ,0,0,0,12,40,52
02119204,COURT REPORTING INSTITUTE OF DALLAS - CO,MO,63105-3329,Proprietary  ,1,9,10,21,258,279
02121100,MIDWEST INSTITUTE                       ,MO,63122-0000,Proprietary  ,2,14,16,74,252,326
02124500,FRANKLIN TECHNOLOGY CENTER              ,MO,64801-0000,Public       ,0,3,3,143,499,642
02142200,LEX LA RAY TECHNICAL CENTER             ,MO,64067-0000,Public       ,0,0,0,34,81,115
02154900,MISSOURI SCH OF BARB & HAIR             ,MO,63031-0000,Proprietary  ,0,3,3,29,113,142
02164200,FOREST INST PROFESSIONAL PSYCHOLOGY     ,MO,65807-0000,Private      ,0,3,3,26,383,409
02165900,CHILLICOTHE BEAUTY ACADEMY              ,MO,64601-0000,Proprietary  ,0,1,1,14,43,57
02180200,METRO BUSINESS COLLEGE                  ,MO,63701-0000,Proprietary  ,8,43,51,170,901,1071
02188000,NORTHWEST TECHNICAL SCHOOL              ,MO,64468-0000,Public       ,0,0,0,55,76,131
02188100,NORTHLAND CAREER CENTER                 ,MO,64079-8333,Public       ,0,0,0,29,73,102
02202700,OZARK CHRISTIAN COLLEGE                 ,MO,64801-0000,Private      ,1,4,5,769,261,1030
02203400,NEVADA REGIONAL TECHNICAL CENTER        ,MO,64772-0000,Public       ,2,1,3,58,90,148
02205200,SANFORD-BROWN COLLEGE                   ,MO,63026-7305,Proprietary  ,0,1,1,78,323,401
02205203,SANFORD BROWN COLLEGE-ST. PETERS        ,MO,63376-5950,Proprietary  ,2,3,5,52,215,267
02214500,SALEM COLLEGE OF HAIRSTYLING            ,MO,65401-0000,Proprietary  ,0,5,5,26,66,92
02239200,ANTHEM COLLEGE                          ,MO,63043-0000,Proprietary  ,3,30,33,156,526,682
02239202,ANTHEM COLLEGE - METRO SOUTH            ,MO,63026-0000,Proprietary  ,15,40,55,131,420,551
02250600,EVEREST COLLEGE                         ,MO,65807-2446,Proprietary  ,9,49,58,190,965,1155
02263106,ANTHEM COLLEGE - ANTHEM COLLEGE - KANSAS,MO,64114-3232,Proprietary  ,0,2,2,70,208,278
02263400,LAKE CAREER AND TECHNICAL CENTER        ,MO,65020-0000,Public       ,0,0,0,26,57,83
02266400,CENTRAL CHRISTIAN CLG OF THE BIBLE      ,MO,65270-0000,Private      ,0,0,0,244,198,442
02277500,HOUSE OF HEAVILIN OF BLUE SPRINGS       ,MO,64014-3953,Proprietary  ,2,5,7,57,159,216
02289200,COLUMBIA AREA CAREER CENTER             ,MO,65203-0000,Public       ,3,11,14,220,606,826
02295700,MISSOURI BEAUTY ACADEMY                 ,MO,63640-1827,Proprietary  ,3,8,11,66,160,226
02300105,EVEREST COLLEGE - EARTH CITY            ,MO,63045-1100,Proprietary  ,23,66,89,239,914,1153
02304000,MISSOURI TECH                           ,MO,63303-3887,Proprietary  ,5,8,13,103,266,369
02309100,AMERICAN COLLEGE OF HAIR DESIGN         ,MO,65301-2144,Proprietary  ,0,2,2,25,88,113
02313000,CASS CAREER CENTER                      ,MO,64701-0000,Public       ,0,2,2,21,85,106
02340500,ST LOUIS COLLEGE OF HEALTH CAREERS      ,MO,63110-0000,Proprietary  ,8,67,75,426,1550,1976
02342100,CAREER & TECHNOLOGY CTR AT FT OSAGE     ,MO,64058-0000,Public       ,0,1,1,26,91,117
02361600,CONCORDE CAREER COLLEGE                 ,MO,64111-0000,Proprietary  ,27,106,133,533,2184,2717
02497500,CLINTON TECHNICAL SCHOOL                ,MO,64735-2966,Public       ,0,0,0,29,100,129
02520800,MERRELL UNIV OF BTY ARTS & SCIENCES     ,MO,65109-0000,Proprietary  ,2,6,8,99,233,332
02530600,SAINT CHARLES COMMUNITY COLLEGE         ,MO,63376-0975,Public       ,61,63,124,4903,3822,8725
02543800,PARIS II EDUCATIONAL CENTER (THE)       ,MO,64118-0000,Proprietary  ,0,0,0,59,167,226
02564700,ELAINE STEVEN BEAUTY COLLEGE            ,MO,63136-0000,Proprietary  ,6,12,18,119,328,447
02564701,ELAINE STEVEN BEAUTY COLLEGE - ADVANCE B,MO,63383-2006,Proprietary  ,0,0,0,10,9,19
02564702,ELAINE STEVEN BEAUTY COLLEGE - ADVANCE B,MO,63401-2269,Proprietary  ,0,2,2,18,36,54
02568500,GRABBER SCHOOL OF HAIR DESIGN           ,MO,63011-0000,Proprietary  ,3,5,8,111,191,302
02599700,VATTEROTT COLLEGE                       ,MO,63134-2900,Proprietary  ,53,166,219,587,2343,2930
02599701,VATTEROTT COLLEGE - KANSAS CITY         ,MO,64117-0000,Proprietary  ,12,102,114,211,1594,1805
02599702,VATTEROTT COLLEGE - SPRINGFIELD LOCATION,MO,65807-5340,Proprietary  ,8,54,62,167,952,1119
02599703,VATTEROTT COLLEGE - JOPLIN              ,MO,64801-5033,Proprietary  ,4,62,66,93,730,823
02599705,VATTEROTT COLLEGE - SUNSET HILLS        ,MO,63127-1516,Proprietary  ,13,81,94,191,1021,1212
02599712,VATTEROTT COLLEGE - O'FALLON            ,MO,63366-2748,Proprietary  ,11,58,69,153,674,827
02599714,VATTEROTT COLLEGE - EX'TREME INSTITUTE B,MO,63102-2115,Proprietary  ,18,51,69,422,853,1275
02599715,VATTEROTT COLLEGE - PERSONAL FITNESS AND,MO,63132-3251,Proprietary  ,0,0,0,8,13,21
02608000,NEOSHO BEAUTY COLLEGE                   ,MO,64850-1525,Proprietary  ,1,1,2,27,61,88
02609202,VATTEROTT COLLEGE-ST JOSEPH             ,MO,64501-2911,Proprietary  ,8,33,41,147,606,753
02609203,VATTEROTT COLLEGE - L'ECOLE CULINAIRE   ,MO,63124-1103,Proprietary  ,7,32,39,191,662,853
02609206,VATTEROTT COLLEGE - L'ECOLE CULINAIRE   ,MO,64112-2110,Proprietary  ,10,41,51,55,313,368
02611004,HERITAGE COLLEGE-KANSAS CITY            ,MO,64131-4203,Proprietary  ,18,60,78,293,1150,1443
03042400,LEBANON TECHNOLOGY & CAREER CENTER      ,MO,65536-3296,Public       ,0,2,2,105,229,334
03066300,BRYAN CAREER COLLEGE                    ,MO,65806-2507,Proprietary  ,1,33,34,124,1073,1197
03066303,BRYAN COLLEGE - COLUMBIA                ,MO,65201-8248,Proprietary  ,2,18,20,130,524,654
03068600,SPECIAL SCHOOL DISTRICT OF ST. LOUIS CO.,MO,63127-0000,Public       ,0,5,5,60,614,674
03070200,CENTRAL COLLEGE OF COSMETOLOGY          ,MO,65583-0000,Proprietary  ,3,13,16,47,142,189
03070900,SE MO HOSP CLG NURSING & HEALTH SCI     ,MO,63703-4507,Private      ,0,1,1,194,515,709
03072800,DALLAS COUNTY CAREER CENTER             ,MO,65685-9152,Public       ,0,0,0,1,9,10
03077200,COSMETOLOGY CONCEPTS INSTITUTE          ,MO,65202-1972,Proprietary  ,0,5,5,63,141,204
03083000,OZARKS TECHNICAL COMMUNITY COLLEGE      ,MO,65802-3601,Public       ,116,325,441,9103,14117,23220
03092600,MESSENGER COLLEGE                       ,MO,64804-0000,Private      ,2,2,4,41,97,138
03097600,ST LOUIS HAIR ACADEMY                   ,MO,63107-1737,Proprietary  ,3,3,6,53,161,214
03101000,NEW DIMENSION SCHOOL OF HAIR DESIGN     ,MO,64801-5017,Proprietary  ,3,1,4,31,107,138
03106000,MISSOURI STATE UNIVERSITY - WEST PLAINS ,MO,65775-2715,Public       ,29,39,68,1417,1601,3018
03110900,HOUSE OF HEAVILIN BEAUTY COLLEGE        ,MO,64083-9195,Proprietary  ,1,2,3,26,68,94
03174300,HERNDON CAREER CENTER                   ,MO,64138-2695,Public       ,0,0,0,26,22,48
03519300,MISSOURI COLLEGE OF COSMETOLOGY NORTH   ,MO,65803-0000,Proprietary  ,2,10,12,87,241,328
03579300,TEXAS COUNTY TECHNICAL INSTITUTE        ,MO,65483-2700,Private      ,1,9,10,45,288,333
03616300,AVIATION INSTITUTE OF MAINTENANCE       ,MO,64129-1811,Proprietary  ,9,44,53,57,300,357
03878300,PROFESSIONAL MASSAGE TRAINING CENTER    ,MO,65803-2939,Proprietary  ,5,10,15,40,159,199
03916300,ECLIPS SCHOOL OF COSMETOLOGY AND BARBERI,MO,63703-5809,Proprietary  ,3,13,16,72,309,381
03924300,HAIR ACADEMY 110 (THE)                  ,MO,63501-2915,Proprietary  ,0,2,2,23,25,48
03970400,WELLSPRING SCHOOL OF ALLIED HEALTH      ,MO,64114-3313,Proprietary  ,4,13,17,70,290,360
04037500,ACADEMY OF HAIR DESIGN                  ,MO,65804-2303,Proprietary  ,5,14,19,112,306,418
04051329,ART INSTITUTE OF PHOENIX (THE) - BROWN M,MO,63026-2564,Proprietary  ,1,0,1,94,186,280
04118700,AMERICAN COLLEGE OF TECHNOLOGY          ,MO,64506-2006,Proprietary  ,1,34,35,31,896,927
04119100,CITY VISION COLLEGE                     ,MO,64141-3188,Private      ,0,2,2,16,131,147
04122300,GRANTHAM UNIVERSITY                     ,MO,64153-2262,Proprietary  ,40,940,980,622,13596,14218
04130300,VICTORY TRADE SCHOOL                    ,MO,65803-2754,Private      ,0,3,3,20,126,146
04130600,"CENTER FOR HEALING ARTS (THE), LLC      ",MO,63143-2103,Proprietary  ,2,7,9,41,200,241
04133300,TREND SETTERS SCHOOL OF COSMETOLOGY     ,MO,63702-7607,Proprietary  ,3,4,7,75,174,249
04145200,TRANSFORMED BARBER AND COSMETOLOGY ACADE,MO,64137-1207,Proprietary  ,3,11,14,77,249,326
04145700,THE SYSTEM A PAUL MITCHELL PARTNER SCHL ,MO,65807-5969,Proprietary  ,2,5,7,148,229,377
04146100,URSHAN GRADUATE SCHOOL OF THEOLOGY      ,MO,63031-7526,Private      ,0,0,0,43,62,105
04152200,CARTHAGE R-9 SCHOOL DISTRICT/CARTHAGE TE,MO,64836-1332,Public       ,0,0,0,16,53,69
04170600,SALON PROFESSIONAL ACADEMY (THE)        ,MO,63301-1021,Proprietary  ,2,12,14,66,158,224
04170700,PAUL MITCHELL THE SCHOOL ST LOUIS       ,MO,63108-1554,Proprietary  ,3,11,14,234,338,572
04173900,COSMETOLOGY COLLEGE OF FRANKLIN COUNTY  ,MO,63077-3448,Proprietary  ,0,0,0,23,42,65
04174000,SKIN INSTITUTE                          ,MO,63128-1307,Proprietary  ,0,3,3,29,132,161
04174800,AMERICAN TRADE SCHOOL                   ,MO,63074-1807,Proprietary  ,1,15,16,36,233,269
04179000,"SALON PROFESSIONAL ACADEMY, THE         ",MO,65616-7216,Proprietary  ,0,2,2,10,32,42
04184400,SEYMOUR BEAUTY ACADEMY                  ,MO,65746-8743,Proprietary  ,0,7,7,8,54,62
04187000,DONNA'S ACADEMY OF HAIR DESIGN          ,MO,64089-9042,Proprietary  ,0,0,0,23,34,57
04212100,ACADEMY OF SALON PROFESSIONALS          ,MO,65301-6910,Proprietary  ,1,1,2,28,72,100
04218400,CITY POINTE BEAUTY ACADEMY              ,MO,64870-2502,Proprietary  ,0,3,3,37,65,102
00314600,WESTERN OKLAHOMA STATE COLLEGE          ,OK,73521-1397,Public       ,15,36,51,778,1220,1998
00314700,BACONE COLLEGE                          ,OK,74403-1597,Private      ,12,25,37,1274,902,2176
00314900,SOUTHERN NAZARENE UNIVERSITY            ,OK,73008-2694,Private      ,4,37,41,1256,2245,3501
00315000,CAMERON UNIVERSITY                      ,OK,73505-6377,Public       ,33,108,141,2600,4876,7476
00315100,OKLAHOMA WESLEYAN UNIVERSITY            ,OK,74006-6299,Private      ,1,29,30,1075,1396,2471
00315200,UNIV OF CENTRAL OKLAHOMA                ,OK,73034-5209,Public       ,48,148,196,10930,9254,20184
00315300,CONNORS STATE COLLEGE                   ,OK,74469-2204,Public       ,21,48,69,1465,1968,3433
00315400,EAST CENTRAL UNIVERSITY                 ,OK,74820-6999,Public       ,17,69,86,3036,3092,6128
00315500,EASTERN OKLAHOMA STATE COLLEGE          ,OK,74578-4999,Public       ,14,57,71,957,1422,2379
00315600,REDLANDS COMMUNITY COLLEGE              ,OK,73036-5304,Public       ,12,43,55,879,1352,2231
00315700,LANGSTON UNIVERSITY                     ,OK,73050-0000,Public       ,26,35,61,2589,2400,4989
00315800,MURRAY STATE COLLEGE                    ,OK,73460-3137,Public       ,24,70,94,1316,1899,3215
00316000,NORTHEASTERN OKLAHOMA A & M COLLEGE     ,OK,74354-6497,Public       ,70,54,124,2056,1578,3634
00316100,NORTHEASTERN STATE UNIVERSITY           ,OK,74464-2399,Public       ,25,105,130,5609,6956,12565
00316200,NORTHERN OKLAHOMA COLLEGE               ,OK,74653-0310,Public       ,30,48,78,2282,2412,4694
00316300,NORTHWESTERN OKLAHOMA STATE UNIV        ,OK,73717-2799,Public       ,5,16,21,1763,1160,2923
00316400,OKLAHOMA BAPTIST UNIVERSITY             ,OK,74801-2590,Private      ,9,4,13,3118,628,3746
00316500,OKLAHOMA CHRISTIAN UNIVERSITY           ,OK,73131-0000,Private      ,5,19,24,2635,1198,3833
00316600,OKLAHOMA CITY UNIVERSITY                ,OK,73106-1493,Private      ,15,53,68,3027,3180,6207
00316700,UNIV OF SCIENCE & ARTS OF OKLAHOMA      ,OK,73018-5322,Public       ,10,14,24,849,572,1421
00316800,ROGERS STATE UNIVERSITY                 ,OK,74017-3252,Public       ,25,70,95,3043,3534,6577
00317000,OKLAHOMA STATE UNIVERSITY               ,OK,74078-1026,Public       ,88,120,208,20394,9481,29875
00317200,OKLAHOMA STATE UNIVERSITY-OKMULGEE      ,OK,74447-3901,Public       ,27,75,102,2273,2387,4660
00317400,OKLAHOMA PANHANDLE STATE UNIVERSITY     ,OK,73939-0000,Public       ,2,15,17,1031,569,1600
00317600,CARL ALBERT STATE COLLEGE               ,OK,74953-5208,Public       ,34,52,86,1524,2191,3715
00317800,SEMINOLE STATE COLLEGE                  ,OK,74818-0351,Public       ,17,42,59,1128,1427,2555
00317900,SOUTHEASTERN OKLAHOMA STATE UNIV        ,OK,74701-0609,Public       ,21,75,96,2660,2797,5457
00318000,SOUTHWESTERN CHRISTIAN UNIVERSITY       ,OK,73008-2335,Private      ,4,20,24,540,859,1399
00318100,SOUTHWESTERN OKLAHOMA STATE UNIV        ,OK,73096-3098,Public       ,19,51,70,3483,2295,5778
00318101,SOUTHWESTERN OK STATE UNIV AT SAYRE     ,OK,73662-0000,Public       ,2,5,7,172,241,413
00318300,ST GREGORY'S UNIVERSITY                 ,OK,74804-2499,Private      ,1,11,12,492,442,934
00318308,SAINT GREGORY'S UNIVERSITY - IPD TULSA  ,OK,74135-2499,Private      ,0,5,5,56,298,354
00318400,UNIVERSITY OF OKLAHOMA                  ,OK,73019-4078,Public       ,69,177,246,20035,12036,32071
00318401,UNIVERSITY OF OKLAHOMA-HLTH SCI CTR     ,OK,73190-0000,Public       ,3,37,40,956,3949,4905
00318500,UNIVERSITY OF TULSA                     ,OK,74104-3189,Private      ,18,26,44,4132,2592,6724
00398500,ORAL ROBERTS UNIVERSITY                 ,OK,74171-0001,Private      ,6,32,38,3350,2098,5448
00531100,TULSA COUNTY AREA VOC TECH SCHOOL       ,OK,74145-0000,Public       ,8,26,34,667,2082,2749
00531200,RED RIVER TECHNOLOGY CENTER             ,OK,73533-2700,Public       ,0,2,2,65,210,275
00533900,METRO TECHNOLOGY CENTERS SCH DIST22     ,OK,73111-0000,Public       ,7,29,36,289,1540,1829
00533903,METRO TECHNOLOGY CENTERS SCH DIST22     ,OK,73129-0000,Public       ,6,23,29,163,866,1029
00694200,MID-AMERICA CHRISTIAN UNIVERSITY        ,OK,73170-4504,Private      ,0,103,103,609,3849,4458
00767800,SPARTAN COLLEGE OF AERONAUTICS AND TECHN,OK,74115-5800,Proprietary  ,11,26,37,933,986,1919
00791100,VIRGILS BEAUTY COLLEGE                  ,OK,74401-6802,Proprietary  ,1,3,4,25,95,120
00834300,AUTRY TECHNOLOGY CENTER                 ,OK,73703-2598,Public       ,1,4,5,131,325,456
00861900,TRI COUNTY TECHNOLOGY CENTER            ,OK,74006-6029,Public       ,0,1,1,80,287,367
00918500,ROSE STATE COLLEGE                      ,OK,73110-2799,Public       ,44,211,255,3138,6563,9701
00920400,KIAMICHI TECHNOLOGY CENTER              ,OK,74578-0548,Public       ,2,18,20,317,1076,1393
00920408,KIAMICHI TECHNOLOGY CENTER - POTEAU CAMP,OK,74953-0825,Public       ,0,0,0,12,51,63
00961800,TULSA WELDING SCHOOL                    ,OK,74104-0000,Proprietary  ,164,274,438,2015,3061,5076
00964700,"OKLAHOMA STATE UNIV, OKLA CITY          ",OK,73107-6159,Public       ,67,222,289,3506,8169,11675
00970800,EVES COLLEGE OF HAIRSTYLING             ,OK,73501-0000,Proprietary  ,0,12,12,48,203,251
00976300,TULSA COMMUNITY COLLEGE                 ,OK,74135-6198,Public       ,126,378,504,9182,15159,24341
00996300,CADDO KIOWA VOC TECH CENTER             ,OK,73038-0000,Public       ,0,3,3,76,336,412
00996400,CENTRAL OKLAHOMA AREA VOC TECH SCH      ,OK,74030-9613,Public       ,1,3,4,127,377,504
00996500,CANADIAN VALLEY TECHNOLOGY CENTER       ,OK,73036-9117,Public       ,1,7,8,97,458,555
00996800,GORDON COOPER TECHNOLOGY CENTER         ,OK,74804-9913,Public       ,1,8,9,163,496,659
01005300,INDIAN CAPITAL TECHNOLGY CENTER #4      ,OK,74403-9907,Public       ,5,8,13,287,829,1116
01026600,HILLSDALE FREE WILL BAPTIST COLLEGE     ,OK,73153-0000,Private      ,1,3,4,221,126,347
01034200,SOUTHERN OKLAHOMA TECHNOLOGY CENTER     ,OK,73401-2100,Public       ,1,3,4,148,400,548
01039100,OKLAHOMA CITY COMMUNITY COLLEGE         ,OK,73159-4444,Public       ,106,382,488,5852,11131,16983
01050304,WTI TULSA CAMPUS                        ,OK,74112-3140,Proprietary  ,2,19,21,64,363,427
01071700,GREAT PLAINS TECHNOLOGY CENTER SCHOOL DI,OK,73505-8399,Public       ,6,20,26,223,863,1086
01076200,WESTERN OK AREA VOC TECH SCH DIST12     ,OK,73624-1469,Public       ,1,1,2,62,128,190
01120600,PIONEER TECHNOLOGY CENTER               ,OK,74601-1106,Public       ,2,2,4,42,266,308
01128200,OKLAHOMA STATE UNV CLG OSTEOPTHC MD     ,OK,74107-0000,Public       ,0,8,8,151,809,960
01153700,MID-AMERICA TECHNOLOGY CENTER           ,OK,73095-0210,Public       ,0,1,1,57,165,222
01227200,MOORE-NORMAN TECHNOLOGY CENTER          ,OK,73069-8399,Public       ,6,12,18,297,1064,1361
02052700,NORTHEAST TECHNOLOGY CENTER             ,OK,74361-0487,Public       ,3,7,10,212,626,838
02060800,MERIDIAN TECHNOLOGY CENTER              ,OK,74074-0000,Public       ,3,3,6,188,431,619
02126500,ENID BEAUTY COLLEGE                     ,OK,73701-0000,Proprietary  ,3,1,4,38,74,112
02184400,SAND SPRINGS BEAUTY COLLEGE             ,OK,74063-0000,Proprietary  ,4,12,16,44,152,196
02197300,HOLLYWOOD COSMETOLOGY CENTER            ,OK,73189-0000,Proprietary  ,0,8,8,29,104,133
02222700,FRANCIS TUTTLE TECHNOLOGY CENTER        ,OK,73142-0000,Public       ,13,41,54,421,1883,2304
02238500,CENTRAL STATE BEAUTY ACADEMY            ,OK,73162-6007,Proprietary  ,8,44,52,109,476,585
02250900,E OK COUNTY AREA VO-TECH                ,OK,73020-0000,Public       ,0,4,4,44,125,169
02256200,"BROKEN ARROW BEAUTY COLLEGE, INC        ",OK,74012-0000,Proprietary  ,1,16,17,106,297,403
02282100,HIGH PLAINS AREA VOC-TECH               ,OK,73801-0000,Public       ,0,1,1,32,94,126
02306800,PLATT COLLEGE                           ,OK,74145-0000,Proprietary  ,7,44,51,373,1823,2196
02510300,BEAUTY TECHNICAL COLLEGE                ,OK,74465-0000,Proprietary  ,2,3,5,21,66,87
02531200,WOODWARD BEAUTY COLLEGE                 ,OK,73801-0000,Proprietary  ,1,4,5,12,45,57
02554300,AMERICAN BEAUTY INSTITUTE               ,OK,74501-0000,Proprietary  ,0,1,1,15,75,90
02556500,YUKON BEAUTY COLLEGE                    ,OK,73099-4108,Proprietary  ,0,6,6,3,43,46
02560200,PHILLIPS THEOLOGICAL SEMINARY -         ,OK,74116-5612,Private      ,0,0,0,5,101,106
02581100,CLAREMORE BEAUTY COLLEGE                ,OK,74017-7034,Proprietary  ,1,3,4,9,45,54
02581200,CC'S COSMETOLOGY COLLEGE                ,OK,74129-0000,Proprietary  ,2,12,14,77,265,342
02591101,CAREER POINT INSTITUTE                  ,OK,74146-0000,Proprietary  ,1,9,10,80,463,543
02596501,ATI-CAREER TRAINING CENTER - OKLAHOMA CI,OK,73107-2442,Proprietary  ,1,4,5,1,4,5
02596502,ATI- CAREER TRAINING CENTER - OKLAHOMA C,OK,76101-2740,Proprietary  ,1,5,6,1,5,6
02597400,PONTOTOC TECHNOLOGY CENTER SCHOOL       ,OK,74820-8621,Public       ,0,1,1,76,246,322
02599706,VATTEROTT COLLEGE - TULSA               ,OK,74146-2205,Proprietary  ,5,27,32,83,561,644
02600000,NORTHWEST TECHNOLOG CTR SCH DIST 10     ,OK,73717-9600,Public       ,0,2,2,31,70,101
02600500,WES WATKINS TECHNOLOGY CENTER           ,OK,74883-9660,Public       ,1,0,1,42,149,191
02609205,VATTEROTT COLLEGE - OKLAHOMA CITY       ,OK,73127-2103,Proprietary  ,5,77,82,98,973,1071
03008700,SOUTHWEST TECHNOLOGY CENTER             ,OK,73521-1527,Public       ,1,2,3,57,207,264
03024700,STILLWATER BEAUTY ACADEMY               ,OK,74075-3467,Proprietary  ,1,4,5,28,69,97
03030700,OKLAHOMA SCHOOL OF PHOTOGRAPHY          ,OK,73160-3320,Proprietary  ,0,5,5,41,163,204
03030800,AMERICAN BROADCASTING SCHOOL            ,OK,73115-3334,Proprietary  ,2,24,26,63,377,440
03051100,CHISHOLM TRAIL TECHNOLOGY CENTER        ,OK,73764-6335,Public       ,0,1,1,7,81,88
03078500,TECH INST OF COSMETOLOGY ARTS & SCI     ,OK,74120-3610,Proprietary  ,0,3,3,51,166,217
03103800,SOUTHERN SCHOOL OF BEAUTY               ,OK,74701-5008,Proprietary  ,1,9,10,26,92,118
03109800,PONCA CITY BEAUTY COLLEGE               ,OK,74601-4201,Proprietary  ,1,6,7,4,44,48
03109801,BARTLESVILLE BEAUTY COLLEGE             ,OK,74003-2835,Proprietary  ,1,2,3,7,35,42
03115100,HERITAGE COLLEGE                        ,OK,73119-0000,Proprietary  ,29,123,152,302,1397,1699
03124800,PLATT COLLEGE                           ,OK,73501-3808,Proprietary  ,3,17,20,91,582,673
03124901,IMAGINE -  PAUL MITCHELL PARTNER SCHOOL ,OK,73072-4831,Proprietary  ,7,17,24,162,284,446
03126200,GREEN COUNTRY AREA VOC TECH SCHOOL      ,OK,74447-1217,Public       ,2,14,16,67,205,272
03198400,MID-DEL AREA VOCATIONAL & TECH SCH      ,OK,73110-4825,Public       ,0,6,6,58,195,253
03329400,PRYOR BEAUTY COLLEGE                    ,OK,74361-0000,Proprietary  ,1,2,3,13,56,69
03329401,PRYOR BEAUTY COLLEGE - GROVE BEAUTY COLL,OK,74345-0009,Proprietary  ,0,1,1,7,35,42
03329402,PRYOR BEAUTY COLLEGE - NORTH EAST OKLAHO,OK,74338-0000,Proprietary  ,2,1,3,3,7,10
03367400,COMMUNITY CARE COLLEGE                  ,OK,74145-6420,Proprietary  ,34,168,202,622,2273,2895
03396400,OKLAHOMA HEALTH ACADEMY                 ,OK,73160-3667,Proprietary  ,0,0,0,3,3,6
03453400,SHAWNEE BEAUTY COLLEGE                  ,OK,74801-7014,Proprietary  ,1,3,4,17,65,82
03676300,FAMILY OF FAITH COLLEGE                 ,OK,74802-1805,Private      ,0,1,1,15,34,49
03831300,INSTITUTE OF HAIR DESIGN                ,OK,74804-0000,Proprietary  ,0,5,5,8,56,64
03928300,CENTRAL STATE MASSAGE ACADEMY           ,OK,73162-6007,Proprietary  ,3,10,13,43,165,208
04051324,ART INSTITUTE OF PHOENIX (THE) - BROWN M,OK,74146-5234,Proprietary  ,2,6,8,119,439,558
04060300,AMERICAN INSTITUTE OF MEDICAL TECHNOLOGY,OK,74146-5201,Proprietary  ,0,5,5,120,380,500
04062300,BROOKLINE COLLEGE                       ,OK,73114-6318,Proprietary  ,0,0,0,26,126,152
04133600,CUTTER'S EDGE SCHOOL OF COSMETOLOGY     ,OK,74023-2905,Proprietary  ,1,0,1,9,22,31
04144400,ACADEMY OF HAIR DESIGN (THE)            ,OK,73120-6808,Proprietary  ,1,12,13,57,236,293
04184300,PAUL MITCHELL THE SCHOOL ARDMORE        ,OK,73401-3912,Proprietary  ,5,15,20,8,42,50
04213600,RIVER VALLEY COSMETOLOGY INSTITUTE      ,OK,74953-5260,Proprietary  ,1,7,8,6,35,41
04224700,JB'S HAIR DESIGN AND BARBER COLLEGE     ,OK,73139-1602,Proprietary  ,2,8,10,12,60,72
04224900,COLLEGE OF THE MUSCOGEE NATION          ,OK,74447-0917,Public       ,2,15,17,13,47,60
00163700,BETHANY THEOLOGICAL SEMINARY            ,IN,47374-0000,Private      ,0,1,1,2,69,71
00178400,ANCILLA COLLEGE-FINANCIAL AID OFFC      ,IN,46513-0001,Private      ,0,8,8,477,499,976
00178500,ANDERSON UNIVERSITY                     ,IN,46012-3495,Private      ,4,24,28,2834,1386,4220
00178600,BALL STATE UNIVERSITY                   ,IN,47306-0880,Public       ,32,131,163,24337,9930,34267
00178700,BETHEL COLLEGE INC                      ,IN,46545-5591,Private      ,2,18,20,1782,1674,3456
00178800,BUTLER UNIVERSITY                       ,IN,46208-3487,Private      ,11,34,45,9177,2819,11996
00178900,CHRISTIAN THEOLOGICAL SEMINARY          ,IN,46208-0000,Private      ,0,3,3,24,370,394
00179200,DEPAUW UNIVERSITY                       ,IN,46135-0037,Private      ,1,2,3,3383,212,3595
00179300,EARLHAM COLLEGE                         ,IN,47374-4095,Private      ,2,2,4,1611,220,1831
00179301,EARLHAM SCHOOL OF RELIGION              ,IN,47374-0000,Private      ,0,1,1,14,56,70
00179500,UNIVERSITY OF EVANSVILLE                ,IN,47722-0002,Private      ,3,14,17,3903,1137,5040
00179800,FRANKLIN COLLEGE OF INDIANA             ,IN,46131-2623,Private      ,0,5,5,2098,413,2511
00179900,GOSHEN COLLEGE                          ,IN,46526-4794,Private      ,1,6,7,1002,566,1568
00180000,GRACE COLLEGE & THEO SEMINARY           ,IN,46590-1224,Private      ,2,14,16,2157,684,2841
00180100,HANOVER COLLEGE                         ,IN,47243-0108,Private      ,0,0,0,2588,156,2744
00180300,HUNTINGTON UNIVERSITY                   ,IN,46750-1299,Private      ,0,0,0,1383,501,1884
00180400,UNIVERSITY OF INDIANAPOLIS              ,IN,46227-3697,Private      ,10,81,91,7142,6458,13600
00180500,INDIANA INSTITUTE OF TECHNOLOGY         ,IN,46803-1297,Private      ,27,249,276,2657,7930,10587
00180700,INDIANA STATE UNIVERSITY                ,IN,47809-2501,Public       ,27,117,144,15253,8387,23640
00180800,UNIVERSITY OF SOUTHERN INDIANA          ,IN,47712-3596,Public       ,11,46,57,9700,4802,14502
00180900,INDIANA UNIVERSITY-BLOOMINGTON          ,IN,47405-7000,Public       ,62,121,183,37291,12788,50079
00181100,INDIANA UNIV-EAST                       ,IN,47374-1289,Public       ,8,56,64,2185,3381,5566
00181300,INDIANA UNIV-PURDUE UNIV INDPLS         ,IN,46202-5145,Public       ,65,304,369,24789,26924,51713
00181301,INDIANA UNIVERSITY - PURDUE UNIVERSITY I,IN,47203-1769,Public       ,10,24,34,2203,2484,4687
00181400,INDIANA UNIV KOKOMO                     ,IN,46902-3557,Public       ,12,36,48,2600,3372,5972
00181500,INDIANA UNIV-NORTHWEST                  ,IN,46408-1197,Public       ,30,79,109,4607,6921,11528
00181600,INDIANA UNIVERSITY - SOUTH BEND         ,IN,46615-0000,Public       ,14,73,87,5562,6548,12110
00181700,INDIANA UNIVERSITY-SOUTHEAST            ,IN,47150-6405,Public       ,23,72,95,4820,4705,9525
00182000,MANCHESTER UNIVERSITY                   ,IN,46962-1276,Private      ,0,0,0,2336,468,2804
00182100,MARIAN UNIVERSITY                       ,IN,46222-1997,Private      ,6,37,43,2575,3465,6040
00182200,INDIANA WESLEYAN UNIVERSITY             ,IN,46953-4974,Private      ,11,371,382,4835,18333,23168
00182300,ASSOCIATED MENNONITE BIBLICAL SEM       ,IN,46517-1999,Private      ,0,1,1,13,116,129
00182400,OAKLAND CITY UNIVERSITY                 ,IN,47660-1099,Private      ,1,21,22,599,756,1355
00182500,PURDUE UNIVERSITY                       ,IN,47907-2050,Public       ,45,95,140,33263,9227,42490
00182600,PURDUE UNIV NORTH CENTRAL CAMPUS        ,IN,46391-9542,Public       ,7,19,26,3355,2830,6185
00182700,PURDUE UNIV CALUMET                     ,IN,46323-2094,Public       ,27,86,113,6060,7598,13658
00182800,INDIANA UNIV-PURDUE UNIV FORT WAYNE     ,IN,46805-1499,Public       ,21,76,97,10632,9100,19732
00183000,ROSE HULMAN INSTITUTE OF TECHNOLOGY     ,IN,47803-3999,Private      ,1,0,1,3877,224,4101
00183200,UNIVERSITY OF SAINT FRANCIS             ,IN,46808-3994,Private      ,1,28,29,2556,2479,5035
00183300,ST JOSEPH'S COLLEGE                     ,IN,47978-0000,Private      ,4,2,6,1610,253,1863
00183400,CALUMET COLLEGE OF SAINT JOSEPH         ,IN,46394-2195,Private      ,2,27,29,685,1027,1712
00183500,SAINT MARY-OF-THE-WOODS COLLEGE         ,IN,47876-0067,Private      ,2,12,14,429,1203,1632
00183600,ST MARY'S COLLEGE                       ,IN,46556-5007,Private      ,3,2,5,1879,164,2043
00183800,TAYLOR UNIVERSITY                       ,IN,46989-1001,Private      ,1,9,10,2586,376,2962
00183900,TRINE UNIVERSITY                        ,IN,46703-1764,Private      ,4,22,26,3064,1176,4240
00184000,UNIVERSITY OF NOTRE DAME                ,IN,46556-5602,Private      ,11,16,27,13857,3412,17269
00184200,VALPARAISO UNIVERSITY                   ,IN,46383-6493,Private      ,6,26,32,5835,2524,8359
00184300,VINCENNES UNIVERSITY                    ,IN,47591-1523,Public       ,46,178,224,7565,5889,13454
00184400,WABASH COLLEGE                          ,IN,47933-0352,Private      ,1,1,2,1417,84,1501
00420300,GOOD SAMARITAN HOSP RADIOGRAPHY PRG     ,IN,47591-0000,Public       ,0,0,0,0,1,1
00457900,INTERNATIONAL BUSINESS COLLEGE          ,IN,46804-0000,Proprietary  ,0,6,6,690,564,1254
00457901,INTERNATIONAL BUSINESS COLLEGE          ,IN,46256-0000,Proprietary  ,3,4,7,867,740,1607
00625700,SAINT ELIZABETH SCHOOL OF NURSING       ,IN,47904-2198,Private      ,1,0,1,247,567,814
00638510,CHAMBERLAIN COLLEGE OF NURSING - INDIANA,IN,46240-2158,Proprietary  ,1,26,27,20,219,239
00726300,HOLY CROSS COLLEGE                      ,IN,46556-0308,Private      ,2,1,3,752,172,924
00727600,SAINT MEINRAD SCHOOL OF THEOLOGY        ,IN,47577-1002,Private      ,0,0,0,1,126,127
00732900,ITT TECHNICAL INSTITUTE                 ,IN,46268-1119,Proprietary  ,372,2318,2690,4595,24463,29058
00732933,ITT TECHNICAL INSTITUTE                 ,IN,46635-1512,Proprietary  ,6,47,53,458,1528,1986
00732962,ITT TECHNICAL INSTITUTE                 ,IN,47630-7430,Proprietary  ,66,390,456,1011,5243,6254
00732968,ITT TECHNICAL INSTITUTE                 ,IN,46410-0000,Proprietary  ,7,38,45,330,1082,1412
00732993,ITT TECHNICAL INSTITUTE                 ,IN,46825-2393,Proprietary  ,52,294,346,1083,3853,4936
00736200,MEDTECH COLLEGE                         ,IN,46250-3970,Proprietary  ,4,60,64,418,2694,3112
00736202,MEDTECH COLLEGE - GREENWOOD             ,IN,46143-6478,Proprietary  ,5,22,27,252,1238,1490
00736204,MEDTECH COLLEGE - FORT WAYNE            ,IN,46804-2209,Proprietary  ,1,42,43,255,1352,1607
00757311,EMPIRE BEAUTY SCHOOL - INDIANAPOLIS     ,IN,46237-3249,Proprietary  ,0,0,0,252,712,964
00793800,LINCOLN COLLEGE OF TECHNOLOGY           ,IN,46202-0000,Proprietary  ,50,73,123,2316,1548,3864
00931306,DAYMAR COLLEGE - ROCKPORT               ,IN,47635-1506,Proprietary  ,0,0,0,10,41,51
00951500,J MICHAEL HARROLD BEAUTY ACADEMY        ,IN,47807-3390,Proprietary  ,2,11,13,92,233,325
00961200,"APEX SCHOOL OF BEAUTY CULTURE, INC      ",IN,46016-0000,Proprietary  ,0,1,1,29,87,116
00961300,MERRILLVILLE BEAUTY COLLEGE             ,IN,46410-3401,Proprietary  ,1,24,25,78,246,324
00967300,RUDAE'S SCHOOL OF BEAUTY CULTURE        ,IN,46825-5444,Proprietary  ,2,9,11,157,352,509
00977700,KAPLAN COLLEGE                          ,IN,46278-1736,Proprietary  ,0,0,0,381,1807,2188
00977702,KAPLAN COLLEGE - TEMPORARY FACILITY EXPA,IN,46268-4111,Proprietary  ,0,0,0,22,143,165
00991700,IVY TECH COMMUNITY COLLEGE OF INDIANA   ,IN,46208-1763,Public       ,531,2463,2994,47525,113147,160672
01015100,VINCENNES BEAUTY COLLEGE                ,IN,47591-1297,Proprietary  ,1,4,5,107,154,261
01040900,LAFAYETTE BEAUTY ACADEMY                ,IN,47901-1149,Proprietary  ,0,2,2,112,229,341
01048900,NATIONAL COLLEGE                        ,IN,46250-1930,Proprietary  ,2,14,16,72,574,646
01048910,NATIONAL COLLEGE - SOUTH BEND           ,IN,46617-3123,Proprietary  ,3,9,12,121,623,744
01048911,NATIONAL COLLEGE - FORT WAYNE           ,IN,46826-4905,Proprietary  ,1,5,6,82,413,495
01061800,MID-AMERICA CLG FUNERAL SERVICE         ,IN,47130-9990,Private      ,1,1,2,90,147,237
01150500,CREATIVE HAIR STYLING ACADEMY           ,IN,46322-1554,Proprietary  ,8,14,22,145,283,428
02084800,RAVENSCROFT BEAUTY COLLEGE              ,IN,46815-0000,Proprietary  ,5,12,17,122,378,500
02087600,CONCORDIA THEOLOGICAL SEMINARY          ,IN,46825-0000,Private      ,1,10,11,16,292,308
02100402,EVEREST INSTITUTE - EVEREST COLLEGE     ,IN,46410-7064,Proprietary  ,16,80,96,365,1658,2023
02140800,MARTIN UNIVERSITY                       ,IN,46218-0000,Private      ,6,25,31,239,1589,1828
02158400,HARRISON COLLEGE                        ,IN,46204-2611,Proprietary  ,23,195,218,767,4370,5137
02158401,HARRISON COLLEGE - COLUMBUS             ,IN,47203-1843,Proprietary  ,4,30,34,194,721,915
02158402,HARRISON COLLEGE - LAFAYETTE            ,IN,47905-4859,Proprietary  ,6,37,43,208,910,1118
02158405,HARRISON COLLEGE - TERRE HAUTE          ,IN,47802-0000,Proprietary  ,2,32,34,161,829,990
02158407,HARRISON COLLEGE - ANDERSON             ,IN,46013-0000,Proprietary  ,1,32,33,155,778,933
02158409,HARRISON COLLEGE - EVANSVILLE           ,IN,47715-3901,Proprietary  ,4,19,23,214,729,943
02158410,HARRISON COLLEGE - EAST                 ,IN,46239-8903,Proprietary  ,10,65,75,319,1426,1745
02158412,HARRISON COLLEGE - FORT WAYNE           ,IN,46825-0000,Proprietary  ,6,30,36,187,870,1057
02158413,HARRISON COLLEGE - NORTHWEST            ,IN,46278-0000,Proprietary  ,8,12,20,237,569,806
02158415,HARRISON COLLEGE - MUNCIE               ,IN,47303-0000,Proprietary  ,0,7,7,135,504,639
02158416,HARRISON COLLEGE - ELKHART              ,IN,46516-0000,Proprietary  ,2,21,23,93,447,540
02158800,DON ROBERTS BEAUTY SCHOOLS              ,IN,46383-0000,Proprietary  ,0,0,0,49,129,178
02164300,DON ROBERTS SCHOOL OF HAIR DESIGN       ,IN,46375-9999,Proprietary  ,3,11,14,56,109,165
02180108,ROSS MEDICAL EDUCATION CENTER -         ,IN,46530-4479,Proprietary  ,0,5,5,39,194,233
02201800,KAPLAN COLLEGE                          ,IN,46324-3347,Proprietary  ,7,40,47,273,1055,1328
02201806,KAPLAN COLLEGE - SOUTHEAST INDIANAPOLIS ,IN,46227-1493,Proprietary  ,18,84,102,296,1293,1589
02241700,PJ'S COLLEGE OF COSMETOLOGY             ,IN,47129-0000,Proprietary  ,0,13,13,81,261,342
02245505,FORTIS COLLEGE - INDIANAPOLIS CAMPUS    ,IN,46268-0000,Proprietary  ,4,17,21,105,573,678
02302700,J EVERETT LIGHT CAREER CENTER           ,IN,46240-0000,Public       ,1,3,4,120,580,700
02304800,PJ'S COLLEGE OF COSMETOLOGY             ,IN,47374-0000,Proprietary  ,0,4,4,48,177,225
02308900,MASTER'S OF COSMETOLOGY COLLEGE         ,IN,46809-0000,Proprietary  ,4,4,8,150,244,394
02339600,ROGER'S ACADEMY OF HAIR DESIGN          ,IN,47712-0000,Proprietary  ,3,12,15,105,258,363
02351300,KNOX BEAUTY COLLEGE                     ,IN,46534-0000,Proprietary  ,0,1,1,25,51,76
02490500,HAIR FASHIONS BY KAYE BEAUTY CLG        ,IN,46250-0000,Proprietary  ,1,20,21,106,462,568
02490800,HAIR FASHIONS BY KAYE BEAUTY CLG        ,IN,46060-0000,Proprietary  ,5,3,8,47,112,159
02607000,HAIR ARTS ACADEMY                       ,IN,47404-2419,Proprietary  ,6,6,12,69,182,251
02615800,COLLEGE OF COURT REPORTING              ,IN,46342-5969,Proprietary  ,0,11,11,40,387,427
03100600,MARION COMM TUCKER AREA VOC SCHOOL      ,IN,46952-3831,Public       ,0,1,1,74,189,263
03176300,AVIATION INSTITUTE OF MAINTENANCE       ,IN,46241-1445,Proprietary  ,5,22,27,148,506,654
03262300,DAVID DEMUTH INSTITUTE OF COSM          ,IN,47374-4101,Proprietary  ,0,0,0,16,31,47
03456700,CROSSROADS BIBLE COLLEGE                ,IN,46219-4912,Private      ,0,6,6,89,506,595
03538300,ALEXANDRIA SCH OF SCIENTIFIC THERAP     ,IN,46001-0287,Proprietary  ,0,1,1,19,88,107
04038700,IDEAL BEAUTY ACADEMY                    ,IN,47130-4215,Proprietary  ,3,4,7,27,99,126
04051304,ART INSTITUTE OF PHOENIX (THE) - ART  IN,IN,46268-1170,Proprietary  ,5,31,36,1267,1404,2671
04051311,ART INSTITUTE OF PHOENIX (THE) - BROWN M,IN,46410-5608,Proprietary  ,7,31,38,223,1046,1269
04051312,ART INSTITUTE OF PHOENIX (THE) - BROWN M,IN,46360-7362,Proprietary  ,2,18,20,138,525,663
04051318,ART INSTITUTE OF PHOENIX (THE) - BROWN M,IN,46204-1017,Proprietary  ,8,114,122,388,2196,2584
04051321,ART INSTITUTE OF PHOENIX (THE) - BROWN M,IN,46635-1176,Proprietary  ,9,20,29,242,924,1166
04051322,ART INSTITUTE OF PHOENIX (THE) - BROWN M,IN,46805-0000,Proprietary  ,3,41,44,265,1298,1563
04100300,SUCCESS SCHOOLS                         ,IN,46410-5310,Proprietary  ,3,19,22,105,349,454
04121000,TECHSKILLS - INDIANAPOLIS               ,IN,46240-4302,Proprietary  ,2,14,16,127,681,808
04130900,HONORS BEAUTY COLLEGE                   ,IN,46256-3317,Proprietary  ,5,10,15,122,374,496
04155900,AVEDA FREDRIC'S INSTITUTE               ,IN,46250-4746,Proprietary  ,4,7,11,190,342,532
04166700,REM SPA INC                             ,IN,46013-3136,Proprietary  ,1,9,10,65,180,245
04171700,AVANT GARD THE SCHOOL                   ,IN,46214-6500,Proprietary  ,0,1,1,41,89,130
04172700,SALON PROFESSIONAL ACADEMY (THE)        ,IN,47715-7822,Proprietary  ,4,6,10,139,216,355
04184000,PAUL MITCHELL THE SCHOOL INDIANAPOLIS   ,IN,46227-6252,Proprietary  ,5,13,18,200,397,597
04186600,SALON PROFESSIONAL ACADEMY (THE)        ,IN,46901-6248,Proprietary  ,6,5,11,90,210,300
04205500,LIL LOU'S BARBER COLLEGE                ,IN,46409-2645,Proprietary  ,3,11,14,40,229,269
04230300,EXCEL ACADEMIES OF COSMETOLOGY - MERRILL,IN,46410-5540,Proprietary  ,4,3,7,7,9,16
00190100,ALLEN COUNTY COMMUNITY COLLEGE          ,KS,66749-1607,Public       ,23,41,64,1206,1795,3001
00190200,COWLEY COUNTY COMMUNITY COLLEGE & AREA V,KS,67005-2662,Public       ,25,103,128,1864,3190,5054
00190300,BAKER UNIVERSITY                        ,KS,66006-0065,Private      ,6,81,87,1491,2553,4044
00190400,BETHANY COLLEGE                         ,KS,67456-1897,Private      ,5,3,8,850,163,1013
00190500,BETHEL COLLEGE                          ,KS,67117-8061,Private      ,3,2,5,798,182,980
00190600,BUTLER COUNTY COMMUNITY COLLEGE         ,KS,67042-3280,Public       ,50,140,190,4965,6029,10994
00190700,CENTRAL BAPTIST THEOLOGY SEMINARY       ,KS,66226-3513,Private      ,0,0,0,0,72,72
00190800,CENTRAL CHRISTIAN COLLEGE OF KANSAS     ,KS,67460-5799,Private      ,2,103,105,493,1015,1508
00190900,CLOUD COUNTY COMMUNITY COLLEGE          ,KS,66901-1002,Public       ,12,39,51,919,1186,2105
00191000,COFFEYVILLE COMMUNITY COLLEGE           ,KS,67337-5064,Public       ,51,23,74,1237,620,1857
00191100,COLBY COMMUNITY COLLEGE                 ,KS,67701-4099,Public       ,18,17,35,725,621,1346
00191300,DODGE CITY COMMUNITY COLLEGE            ,KS,67801-2399,Public       ,38,32,70,1070,851,1921
00191400,DONNELLY COLLEGE                        ,KS,66102-4298,Private      ,8,24,32,359,820,1179
00191500,FORT HAYS STATE UNIVERSITY              ,KS,67601-4099,Public       ,24,210,234,4570,7071,11641
00191600,FORT SCOTT COMMUNITY COLLEGE            ,KS,66701-3199,Public       ,58,24,82,1316,1165,2481
00191700,BARCLAY COLLEGE                         ,KS,67059-0288,Private      ,2,1,3,171,157,328
00191800,FRIENDS UNIVERSITY                      ,KS,67213-3397,Private      ,5,34,39,1475,2740,4215
00191900,GARDEN CITY COMMUNITY COLLEGE           ,KS,67846-6398,Public       ,77,30,107,1150,843,1993
00192000,HESSTON COLLEGE                         ,KS,67062-2093,Private      ,0,1,1,506,190,696
00192100,HIGHLAND COMMUNITY COLLEGE              ,KS,66035-4062,Public       ,38,35,73,1394,1613,3007
00192300,HUTCHINSON COMMUNITY COLLEGE            ,KS,67501-5894,Public       ,73,90,163,2586,3133,5719
00192400,INDEPENDENCE COMMUNITY COLLEGE          ,KS,67301-0708,Public       ,67,31,98,754,563,1317
00192500,KANSAS CITY KANSAS COMMUNITY CLG        ,KS,66112-9978,Public       ,48,192,240,2555,6182,8737
00192600,PITTSBURG STATE UNIVERSITY              ,KS,66762-7500,Public       ,23,82,105,5913,3310,9223
00192700,EMPORIA STATE UNIVERSITY                ,KS,66801-5415,Public       ,10,36,46,3708,3244,6952
00192800,KANSAS STATE UNIVERSITY                 ,KS,66506-1104,Public       ,41,113,154,18001,7923,25924
00192900,KANSAS WESLEYAN UNIVERSITY              ,KS,67401-6196,Private      ,3,7,10,1077,396,1473
00193000,LABETTE COMMUNITY COLLEGE               ,KS,67357-4299,Public       ,16,33,49,657,1001,1658
00193100,MANHATTAN CHRISTIAN COLLEGE             ,KS,66502-4081,Private      ,0,1,1,371,144,515
00193300,MCPHERSON COLLEGE                       ,KS,67460-3899,Private      ,2,1,3,919,196,1115
00193600,NEOSHO COUNTY COMMUNITY COLLEGE         ,KS,66720-2699,Public       ,10,35,45,1007,1411,2418
00193700,OTTAWA UNIVERSITY                       ,KS,66067-3399,Private      ,5,99,104,999,3276,4275
00193800,PRATT COMMUNITY COLLEGE                 ,KS,67124-8432,Public       ,11,26,37,702,911,1613
00193900,NEWMAN UNIVERSITY                       ,KS,67213-2084,Private      ,6,63,69,1497,1959,3456
00194000,SOUTHWESTERN COLLEGE                    ,KS,67156-2499,Private      ,2,56,58,914,1641,2555
00194300,UNIVERSITY OF ST MARY                   ,KS,66048-5023,Private      ,6,36,42,771,1041,1812
00194500,STERLING COLLEGE                        ,KS,67579-1533,Private      ,2,5,7,887,220,1107
00194600,TABOR COLLEGE                           ,KS,67063-1799,Private      ,4,10,14,952,327,1279
00194800,UNIVERSITY OF KANSAS                    ,KS,66045-7535,Public       ,53,127,180,18619,11292,29911
00194900,WASHBURN UNIVERSITY                     ,KS,66621-1110,Public       ,14,70,84,3865,4612,8477
00194901,WASHBURN INSTITUTE OF TECHNOLOGY        ,KS,66604-2199,Public       ,2,28,30,453,1116,1569
00195000,WICHITA STATE UNIVERSITY                ,KS,67208-0000,Public       ,50,162,212,8318,9406,17724
00460800,BARTON COUNTY COMMUNITY COLLEGE         ,KS,67530-9283,Public       ,10,89,99,1116,2795,3911
00526400,FLINT HILLS TECHNICAL COLLEGE           ,KS,66801-5999,Public       ,0,5,5,347,608,955
00526500,NORTH CENTRAL KANSAS TECH COLG          ,KS,67420-0000,Public       ,2,9,11,411,391,802
00526700,NORTHWEST KANSAS TECHNICAL SCHOOL       ,KS,67735-3441,Public       ,4,3,7,361,196,557
00549800,WICHITA AREA TECHNICAL COLLEGE          ,KS,67211-2099,Public       ,37,127,164,961,3712,4673
00549900,SALINA AREA TECHNICAL COLLEGE           ,KS,67401-8195,Public       ,0,4,4,246,319,565
00550000,MANHATTAN AREA TECHNICAL COLLEGE        ,KS,66503-2499,Public       ,0,14,14,522,969,1491
00675500,BROWN MACKIE COLLEGE (THE)              ,KS,67401-7307,Proprietary  ,10,88,98,569,2160,2729
00703200,MID AMERICA NAZARENE UNIVERSITY         ,KS,66062-1899,Private      ,5,40,45,1152,1513,2665
00822800,SEWARD CO COMM CO/AREA TECHNICAL SCHOOL ,KS,67905-0000,Public       ,9,8,17,618,557,1175
00824400,JOHNSON COUNTY COMMUNITY COLLEGE        ,KS,66210-1299,Public       ,73,212,285,6780,9357,16137
00833200,MARINELLO SCHOOL OF BEAUTY              ,KS,66502-6082,Proprietary  ,5,9,14,51,146,197
00833201,MARINELLO SCHOOL OF BEAUTY - LAWRENCE   ,KS,66046-2743,Proprietary  ,4,9,13,48,98,146
00869423,RASMUSSEN COLLEGE - OVERLAND PARK       ,KS,66210-2786,Proprietary  ,0,4,4,14,137,151
00869424,RASMUSSEN COLLEGE - TOPEKA              ,KS,66606-2339,Proprietary  ,2,14,16,64,299,363
01025600,BENEDICTINE COLLEGE                     ,KS,66002-1499,Private      ,3,5,8,2538,225,2763
01043800,HASKELL INDIAN NATIONS UNIVERSITY       ,KS,66046-4800,Public       ,5,2,7,1269,794,2063
01050300,WICHITA TECHNICAL INSTITUTE             ,KS,67213-1927,Proprietary  ,4,57,61,269,1312,1581
01050302,WICHITA TECHNICAL INSTITUTE - WTI TOPEKA,KS,66609-1217,Proprietary  ,3,19,22,84,531,615
01050305,WICHITA TECHNICAL INSTITUTE - EAST CAMPU,KS,67208-4243,Proprietary  ,5,23,28,104,519,623
02090700,CLEVELAND CHIROPRACTIC COLLEGE          ,KS,66210-1613,Private      ,0,2,2,55,623,678
02134800,OLD TOWN BARBER AND BEAUTY COLLEGE      ,KS,67211-0000,Proprietary  ,2,8,10,48,191,239
02168900,KANSAS CITY COLLEGE & BIBLE SCHOOL      ,KS,66204-1975,Private      ,2,2,4,2,2,4
02257700,HAYS ACADEMY OF HAIR DESIGN             ,KS,67601-3685,Proprietary  ,2,2,4,96,131,227
02257702,HAYS ACADEMY OF HAIR DESIGN -           ,KS,67401-0000,Proprietary  ,2,3,5,10,26,36
02340700,LABARON HAIRDRESSING ACADEMY            ,KS,66204-0000,Proprietary  ,0,2,2,24,59,83
02590900,WRIGHT CAREER COLLEGE                   ,KS,66212-0000,Private      ,47,267,314,496,3891,4387
02599709,VATTEROTT COLLEGE - WICHITA             ,KS,67226-1304,Proprietary  ,5,21,26,124,684,808
02603100,XENON INTERNATIONAL ACADEMY             ,KS,67203-5428,Proprietary  ,9,15,24,161,323,484
02606300,PAUL MITCHELL THE SCHOOL WICHITA        ,KS,67226-2803,Proprietary  ,4,10,14,124,257,381
02611005,HERITAGE COLLEGE - WICHITA              ,KS,67210-1879,Proprietary  ,9,45,54,227,828,1055
02613000,PINNACLE CAREER INSTITUTE               ,KS,66046-2703,Proprietary  ,6,29,35,88,503,591
03031300,XENON INTERNATIONAL ACADEMY IV          ,KS,66061-3765,Proprietary  ,1,0,1,43,92,135
03066200,BRYAN COLLEGE                           ,KS,66604-2496,Proprietary  ,1,13,14,54,327,381
03450300,MARINELLO SCHOOL OF BEAUTY              ,KS,66611-1101,Proprietary  ,6,18,24,72,198,270
03450301,MARINELLO SCHOOL OF BEAUTY - WICHITA    ,KS,67207-5148,Proprietary  ,1,11,12,49,163,212
03450302,MARINELLO SCHOOL OF BEAUTY - OVERLAND PA,KS,66212-5451,Proprietary  ,4,33,37,83,249,332
03529300,SIDNEY'S HAIRDRESSING COLLEGE           ,KS,67501-7094,Proprietary  ,5,3,8,31,69,100
04132900,Z HAIR ACADEMY                          ,KS,66046-4040,Proprietary  ,3,8,11,70,91,161
04162700,ERIC FISHER ACADEMY                     ,KS,67212-3376,Proprietary  ,0,2,2,159,244,403
04175700,ACADEMY OF AESTHETIC ARTS               ,KS,66203-3502,Proprietary  ,0,0,0,20,71,91
04179600,ENTOURAGE INSTITUTE OF BEAUTY AND ESTHET,KS,66215-3803,Proprietary  ,2,11,13,28,124,152
04205300,MITSU SATO HAIR ACADEMY                 ,KS,66212-1457,Proprietary  ,0,4,4,29,59,88
04209300,PAUL MITCHELL THE SCHOOL - OVERLAND PARK,KS,66212-4050,Proprietary  ,1,8,9,137,209,346
00203300,UNIVERSITY OF MAINE-PRESQUE ISLE        ,ME,04769-2888,Public       ,3,3,6,888,659,1547
00203500,BANGOR THEOLOGICAL SEMINARY             ,ME,04402-0411,Private      ,0,0,0,3,24,27
00203600,BATES COLLEGE                           ,ME,04240-6028,Private      ,2,3,5,3145,142,3287
00203800,BOWDOIN COLLEGE                         ,ME,04011-8451,Private      ,2,1,3,4169,152,4321
00203900,COLBY COLLEGE                           ,ME,04901-8841,Private      ,4,2,6,3163,128,3291
00204000,UNIVERSITY OF MAINE-FARMINGTON          ,ME,04938-1990,Public       ,2,8,10,2899,648,3547
00204100,UNIVERSITY OF MAINE-FORT KENT           ,ME,04743-1292,Public       ,1,20,21,736,616,1352
00204300,HUSSON UNIVERSITY                       ,ME,04401-2999,Private      ,0,24,24,2849,1683,4532
00204400,MAINE MARITIME ACADEMY                  ,ME,04420-0001,Public       ,0,2,2,1252,173,1425
00205000,UNIVERSITY OF NEW ENGLAND               ,ME,04005-9599,Private      ,0,41,41,4863,4946,9809
00205100,SAINT JOSEPH'S COLLEGE                  ,ME,04084-5236,Private      ,2,40,42,1887,1876,3763
00205200,THOMAS COLLEGE                          ,ME,04901-5097,Private      ,2,5,7,1228,349,1577
00205300,UNIVERSITY OF MAINE                     ,ME,04469-0001,Public       ,20,26,46,12754,3302,16056
00205400,UNIVERSITY OF SOUTHERN MAINE            ,ME,04104-0000,Public       ,10,32,42,6953,6206,13159
00205500,UNIVERSITY OF MAINE-MACHIAS             ,ME,04654-1397,Public       ,4,5,9,612,470,1082
00458615,KAPLAN UNIVERSITY - PORTLAND            ,ME,04106-2415,Proprietary  ,7,62,69,185,1174,1359
00458616,KAPLAN UNIVERSITY - LEWISTON            ,ME,04240-0000,Proprietary  ,9,74,83,164,1327,1491
00458617,KAPLAN UNIVERSITY - AUGUSTA             ,ME,04330-8038,Proprietary  ,11,63,74,41,316,357
00520400,BEAL COLLEGE                            ,ME,04401-6896,Proprietary  ,0,12,12,350,840,1190
00527600,CENTRAL MAINE COMMUNITY COLLEGE         ,ME,04210-6498,Public       ,5,18,23,1676,2360,4036
00527700,EASTERN MAINE COMMUNITY COLLEGE         ,ME,04401-4280,Public       ,7,19,26,1914,2041,3955
00552500,SOUTHERN MAINE COMMUNITY  COLLEGE       ,ME,04106-1698,Public       ,19,45,64,4388,5098,9486
00576000,NORTHERN MAINE COMMUNITY COLLEGE        ,ME,04769-2016,Public       ,0,5,5,561,666,1227
00630500,CENTRAL MAINE MEDICAL CENTER COLLEGE OF ,ME,04243-9986,Private      ,1,5,6,126,371,497
00676000,UNIVERSITY OF MAINE-AUGUSTA             ,ME,04330-9410,Public       ,5,41,46,1840,5614,7454
00685800,UNITY COLLEGE                           ,ME,04988-9502,Private      ,0,1,1,904,149,1053
00903800,MR BERNARD'S SCH HAIR FASHION INC       ,ME,04243-1163,Proprietary  ,2,4,6,52,174,226
00923100,WASHINGTON COUNTY COMMUNITY COLLEGE     ,ME,04619-9704,Public       ,0,1,1,280,331,611
00945900,EMPIRE BEAUTY SCHOOL                    ,ME,04101-3348,Proprietary  ,33,125,158,448,1049,1497
00982600,KENNEBEC VALLEY  COMMUNITY  COLLEGE     ,ME,04937-1367,Public       ,5,46,51,980,2133,3113
01138500,COLLEGE OF THE ATLANTIC                 ,ME,04609-1105,Private      ,1,0,1,623,114,737
01167300,MAINE COLLEGE OF ART                    ,ME,04101-3987,Private      ,3,1,4,737,264,1001
02104400,SPA TECH INSTITUTE                      ,ME,04093-0000,Proprietary  ,5,23,28,199,542,741
02347100,NEW ENGLAND SCHOOL OF COMMUNICATIONS    ,ME,04401-0000,Private      ,0,2,2,599,203,802
02361300,LANDING SCHOOL OF BOATBUILDING & DESIGN ,ME,04046-1490,Private      ,0,0,0,39,49,88
03122900,YORK COUNTY COMMUNITY COLLEGE           ,ME,04090-0529,Public       ,5,25,30,782,1203,1985
03429300,SEACOAST CAREER SCHOOLS                 ,ME,04073-0000,Proprietary  ,14,73,87,161,697,858
03612300,BIRTHWISE MIDWIFERY SCHOOL              ,ME,04009-1110,Proprietary  ,0,0,0,12,94,106
04177400,CAPILO SCHOOL OF HAIR DESIGN            ,ME,04330-0000,Proprietary  ,3,10,13,107,188,295
04185100,NORTHEAST TECHNICAL INSTITUTE           ,ME,04074-0000,Proprietary  ,12,76,88,153,907,1060
04188800,INSTITUTE FOR DOCTORAL STUDIES IN THE VI,ME,04102-0000,Private      ,0,0,0,2,74,76
04214100,COSMOTECH SCHOOL OF COSMETOLOGY         ,ME,04092-2878,Proprietary  ,2,3,5,25,46,71
00209300,ST JOHN'S COLLEGE                       ,NM,87505-4599,Private      ,0,2,2,382,234,616
00264900,SANTA FE UNIVERSITY OF ART AND DESIGN   ,NM,87505-7634,Proprietary  ,6,4,10,1094,354,1448
00265000,UNIVERSITY OF THE SOUTHWEST             ,NM,88240-9129,Private      ,2,77,79,368,1241,1609
00265100,EASTERN NEW MEXICO UNIV PORTALES        ,NM,88130-6000,Public       ,20,99,119,3596,3366,6962
00265101,EASTERN NEW MEXICO UNIV-ROSWELL CAM     ,NM,88202-0000,Public       ,20,56,76,1364,1860,3224
00265300,NEW MEXICO HIGHLANDS UNIVERSITY         ,NM,87701-4436,Public       ,16,65,81,2386,2927,5313
00265400,NEW MEXICO INST OF MINING & TECH        ,NM,87801-4796,Public       ,9,4,13,1483,589,2072
00265500,NEW MEXICO JUNIOR COLLEGE               ,NM,88240-9123,Public       ,21,36,57,898,1107,2005
00265600,NEW MEXICO MILITARY INSTITUTE           ,NM,88201-5173,Public       ,7,1,8,555,89,644
00265700,NEW MEXICO STATE UNIVERSITY             ,NM,88003-8001,Public       ,50,120,170,12963,9197,22160
00265701,NEW MEXICO STATE UNIV-ALAMOGORDO        ,NM,88311-0000,Public       ,15,52,67,672,1629,2301
00265702,NEW MEXICO STATE UNIV.-DONA ANA CLG     ,NM,88003-0000,Public       ,25,99,124,3653,5321,8974
00265703,NEW MEXICO STATE UNIV-CARLSBAD          ,NM,88220-0000,Public       ,3,18,21,450,762,1212
00265704,NEW MEXICO STATE UNIV-GRANTS            ,NM,87020-0000,Public       ,5,8,13,306,655,961
00266000,SAN JUAN COLLEGE                        ,NM,87402-4699,Public       ,31,120,151,2472,5743,8215
00266300,THE UNIVERSITY OF NEW MEXICO            ,NM,87131-0001,Public       ,167,348,515,21040,21910,42950
00266400,WESTERN NEW MEXICO UNIVERSITY           ,NM,88061-5417,Public       ,13,52,65,1701,2398,4099
00405701,NATIONAL AMERICAN UNIVERSITY            ,NM,87110-0000,Proprietary  ,5,11,16,122,767,889
00474200,CENTRAL NEW MEXICO COMMUNITY COLLEGE    ,NM,87106-4096,Public       ,211,765,976,10283,21136,31419
00474300,CLOVIS COMMUNITY COLLEGE                ,NM,88101-8381,Public       ,28,77,105,801,2103,2904
00996200,LUNA COMMUNITY COLLEGE                  ,NM,87701-0000,Public       ,13,31,44,602,745,1347
01063200,DEWOLFF CLG HAIRSTYLING/COSMETOLOGY     ,NM,87112-4113,Proprietary  ,1,15,16,108,282,390
01300500,OLYMPIAN UNIVERSITY OF COSMETOLOGY      ,NM,88310-5051,Proprietary  ,28,119,147,445,1460,1905
02083900,NORTHERN NEW MEXICO COLLEGE             ,NM,87530-0000,Public       ,6,21,27,717,1052,1769
02146400,INSTITUTE OF AMERICAN INDIAN ARTS       ,NM,87508-0000,Public       ,3,1,4,210,330,540
02218808,BROOKLINE COLLEGE - ALBUQUERQUE         ,NM,87105-1649,Proprietary  ,18,42,60,301,1029,1330
02278100,SANTA FE COMMUNITY COLLEGE              ,NM,87507-0000,Public       ,13,101,114,1270,3213,4483
02293203,ATI CAREER TRAINING CENTER - ALBUQUERQUE,NM,87109-2016,Proprietary  ,2,3,5,7,23,30
02357600,NAVAJO TECHNICAL COLLEGE                ,NM,87313-0000,Public       ,21,42,63,727,1714,2441
02511000,SOUTHWESTERN INDIAN POLYTECH INST       ,NM,87184-0000,Public       ,18,26,44,421,677,1098
02572003,COMPUTER CAREER CENTER - LAS CRUCES CAMP,NM,88011-8220,Proprietary  ,10,46,56,198,734,932
02622000,SOUTHWEST ACUPUNCTURE COLLEGE           ,NM,87505-0000,Proprietary  ,1,3,4,5,302,307
03076100,SOUTHWESTERN COLLEGE                    ,NM,87507-0000,Private      ,0,1,1,31,292,323
03206300,MESALANDS COMMUNITY COLLEGE             ,NM,88401-3352,Public       ,8,15,23,163,215,378
03430300,UNIVERSAL THERAPEUTIC MASSAGE INSTITUTE ,NM,87107-4403,Proprietary  ,2,10,12,52,243,295
03678300,PIMA MEDICAL INSTITUTE                  ,NM,87110-0000,Proprietary  ,7,20,27,419,1032,1451
03944300,MASSAGE THERAPY TRAINING INSTITUTE      ,NM,88007-0000,Proprietary  ,2,3,5,58,131,189
04162400,TONI AND GUY HAIRDRESSING  ACADEMY      ,NM,87110-4404,Proprietary  ,3,6,9,112,244,356
04174500,AVEDA INSTITUTE OF NEW MEXICO (THE)     ,NM,87110-3640,Proprietary  ,6,16,22,218,469,687
04178500,VOGUE COLLEGE OF COSMETOLOGY            ,NM,87505-7636,Proprietary  ,6,12,18,75,188,263
00223400,ADRIAN COLLEGE                          ,MI,49221-2575,Private      ,7,3,10,3115,493,3608
00223500,ALBION COLLEGE                          ,MI,49224-1831,Private      ,3,3,6,2813,203,3016
00223600,ALMA COLLEGE                            ,MI,48801-1599,Private      ,1,3,4,2895,240,3135
00223700,ALPENA COMMUNITY COLLEGE                ,MI,49707-1495,Public       ,10,27,37,1165,1249,2414
00223800,ANDREWS UNIVERSITY                      ,MI,49104-0750,Private      ,7,36,43,2096,1634,3730
00223900,AQUINAS COLLEGE                         ,MI,49506-1799,Private      ,4,18,22,3154,932,4086
00224000,BAY DE NOC COMMUNITY COLLEGE            ,MI,49829-2524,Public       ,11,32,43,1267,1702,2969
00224100,CALVIN COLLEGE                          ,MI,49546-4388,Private      ,0,5,5,4918,746,5664
00224200,CALVIN THEOLOGICAL SEMINARY             ,MI,49546-4387,Private      ,0,0,0,26,222,248
00224300,CENTRAL MICHIGAN UNIVERSITY             ,MI,48859-0001,Public       ,41,213,254,24727,12500,37227
00224600,CLEARY UNIVERSITY                       ,MI,48105-2659,Private      ,1,19,20,238,888,1126
00224800,CRANBROOK ACADEMY OF ART                ,MI,48303-0000,Private      ,0,0,0,40,280,320
00224900,DAVENPORT UNIVERSITY                    ,MI,49503-0000,Private      ,23,296,319,4065,13793,17858
00225100,DELTA COLLEGE                           ,MI,48710-0001,Public       ,47,141,188,7127,9103,16230
00225400,MICHIGAN STATE UNIVERSITY COLLEGE OF LAW,MI,48824-1300,Private      ,2,7,9,406,2167,2573
00225900,EASTERN MICHIGAN UNIVERSITY             ,MI,48197-2214,Public       ,87,213,300,20806,16491,37297
00226000,FERRIS STATE UNIVERSITY                 ,MI,49307-2251,Public       ,41,98,139,16689,9006,25695
00226100,CHARLES STEWART MOTT COMMUNITY CLG      ,MI,48503-2089,Public       ,69,305,374,6910,11995,18905
00226200,KETTERING UNIVERSITY                    ,MI,48504-4898,Private      ,5,8,13,2424,607,3031
00226300,GLEN OAKS COMMUNITY COLLEGE             ,MI,49032-9784,Public       ,8,15,23,757,992,1749
00226400,GOGEBIC COMMUNITY COLLEGE               ,MI,49938-1365,Public       ,8,12,20,781,624,1405
00226500,GRACE BIBLE COLLEGE                     ,MI,49509-1998,Private      ,2,14,16,568,670,1238
00226600,CORNERSTONE UNIVERSITY                  ,MI,49525-5897,Private      ,5,44,49,2517,2420,4937
00226700,GRAND RAPIDS COMMUNITY COLLEGE          ,MI,49503-3295,Public       ,77,239,316,12714,14021,26735
00226800,GRAND VALLEY STATE UNIVERSITY           ,MI,49401-9403,Public       ,36,131,167,28014,9885,37899
00226900,GREAT LAKES CHRISTIAN COLLEGE           ,MI,48917-1299,Private      ,1,4,5,238,245,483
00227000,HENRY FORD COMMUNITY COLLEGE            ,MI,48128-1495,Public       ,122,366,488,12332,19879,32211
00227300,HOPE COLLEGE                            ,MI,49423-3607,Private      ,4,1,5,5179,323,5502
00227400,JACKSON COMMUNITY COLLEGE               ,MI,49201-8399,Public       ,29,147,176,4035,5756,9791
00227500,KALAMAZOO COLLEGE                       ,MI,49006-3295,Private      ,2,10,12,2468,396,2864
00227600,KELLOGG COMMUNITY COLLEGE               ,MI,49017-3397,Public       ,28,159,187,3221,6561,9782
00227700,LAKE MICHIGAN COLLEGE                   ,MI,49022-1899,Public       ,24,102,126,2180,3775,5955
00227800,LANSING COMMUNITY COLLEGE               ,MI,48933-1293,Public       ,103,334,437,11166,13823,24989
00227900,LAWRENCE TECHNOLOGICAL UNIVERSITY       ,MI,48075-1058,Private      ,6,32,38,2250,1708,3958
00228200,MADONNA UNIVERSITY                      ,MI,48150-1173,Private      ,11,52,63,2147,3978,6125
00228400,MARYGROVE COLLEGE                       ,MI,48221-2599,Private      ,19,112,131,1501,4081,5582
00228800,ROCHESTER COLLEGE                       ,MI,48307-2764,Private      ,8,9,17,962,1002,1964
00229000,MICHIGAN STATE UNIVERSITY               ,MI,48824-1113,Public       ,111,373,484,42686,16749,59435
00229200,MICHIGAN TECHNOLOGICAL UNIV             ,MI,49931-1295,Public       ,4,10,14,6695,1101,7796
00229300,LAKE SUPERIOR STATE UNIVERSITY          ,MI,49783-1691,Public       ,7,15,22,2808,1061,3869
00229400,MONROE COUNTY COMMUNITY CLG             ,MI,48161-9746,Public       ,13,62,75,2144,2966,5110
00229500,MONTCALM COMMUNITY COLLEGE              ,MI,48885-9723,Public       ,12,43,55,1144,1814,2958
00229700,MUSKEGON COMMUNITY COLLEGE              ,MI,49442-1432,Public       ,21,76,97,3527,4131,7658
00229900,NORTH CENTRAL MICHIGAN COLLEGE          ,MI,49770-8740,Public       ,11,30,41,1359,1713,3072
00230100,NORTHERN MICHIGAN UNIVERSITY            ,MI,49855-5316,Public       ,21,37,58,8990,3312,12302
00230200,NORTHWESTERN MICHIGAN COLLEGE           ,MI,49686-3061,Public       ,12,35,47,2996,3573,6569
00230301,OAKLAND COMMUNITY COLLEGE - ORCHARD RIDG,MI,48334-4579,Public       ,41,145,186,4475,6742,11217
00230302,OAKLAND COMMUNITY COLLEGE - ROYAL OAK CA,MI,48067-3898,Public       ,51,226,277,5585,9733,15318
00230303,OAKLAND COMMUNITY COLLEGE - SOUTHFIELD C,MI,48075-4793,Public       ,71,334,405,4813,12253,17066
00230304,OAKLAND COMMUNITY COLLEGE - AUBURN HILLS,MI,48323-2845,Public       ,48,187,235,5919,7960,13879
00230305,OAKLAND COMMUNITY COLLEGE - HIGHLAND LAK,MI,48327-4187,Public       ,28,101,129,3003,4656,7659
00230700,OAKLAND UNIVERSITY                      ,MI,48309-4401,Public       ,59,156,215,18319,12179,30498
00230800,OLIVET COLLEGE                          ,MI,49076-9902,Private      ,38,6,44,1835,324,2159
00231000,ST. CLAIR COUNTY COMMUNITY COLLEGE      ,MI,48061-0000,Public       ,15,55,70,2514,3006,5520
00231100,KUYPER COLLEGE                          ,MI,49525-9749,Private      ,0,1,1,427,242,669
00231300,SACRED HEART MAJOR SEMINARY             ,MI,48206-1799,Private      ,0,2,2,44,217,261
00231400,SAGINAW VALLEY STATE UNIV               ,MI,48710-0001,Public       ,14,58,72,11022,4796,15818
00231500,SCHOOLCRAFT COLLEGE                     ,MI,48152-2696,Public       ,68,220,288,8125,11892,20017
00231600,SIENA HEIGHTS UNIVERSITY                ,MI,49221-1796,Private      ,2,61,63,1958,2660,4618
00231700,SOUTHWESTERN MICHIGAN COLLEGE           ,MI,49047-9793,Public       ,12,34,46,2439,2253,4692
00231800,SPRING ARBOR UNIVERSITY                 ,MI,49283-9984,Private      ,2,60,62,2490,3813,6303
00232200,FINLANDIA UNIVERSITY                    ,MI,49930-1882,Private      ,1,4,5,723,296,1019
00232300,UNIVERSITY OF DETROIT MERCY             ,MI,48221-3038,Private      ,7,68,75,4061,4754,8815
00232303,UNIV OF DETROIT MERCY - LAW SCHOOL      ,MI,48226-0000,Private      ,2,4,6,82,843,925
00232330,UNIV OF DETROIT MERCY - DENTAL SCHOOL   ,MI,48208-2576,Private      ,1,8,9,234,798,1032
00232500,UNIVERSITY OF MICHIGAN - ANN ARBOR      ,MI,48109-1316,Public       ,195,140,335,39917,14663,54580
00232501,UNIVERSITY OF MICHIGAN-MEDICAL SCH      ,MI,48109-0000,Public       ,7,5,12,396,1219,1615
00232503,UNIVERSITY OF MICHIGAN LAW SCHOOL       ,MI,48109-0000,Public       ,0,3,3,149,2591,2740
00232600,UNIVERSITY OF MICHIGAN-DEARBORN         ,MI,48128-2406,Public       ,30,94,124,8333,7244,15577
00232700,UNIVERSITY OF MICHIGAN-FLINT            ,MI,48502-1950,Public       ,24,144,168,5929,7876,13805
00232800,WASHTENAW COMMUNITY COLLEGE             ,MI,48106-0000,Public       ,84,270,354,6193,9482,15675
00232900,WAYNE STATE UNIVERSITY                  ,MI,48202-0000,Public       ,71,322,393,21753,24479,46232
00232901,WAYNE STATE UNIV SCH OF MEDICINE        ,MI,48201-3359,Public       ,4,25,29,1052,2406,3458
00232902,WAYNE STATE UNIVERSITY - LAW SCHOOL     ,MI,48202-3424,Public       ,3,10,13,256,1272,1528
00233000,WESTERN MICHIGAN UNIVERSITY             ,MI,49008-3899,Public       ,53,137,190,24109,11979,36088
00233100,WESTERN THEOLOGICAL SEMINARY            ,MI,49423-0000,Private      ,0,0,0,6,183,189
00384256,CONCORDIA UNIVERSITY - WISCONSIN - ANN A,MI,48105-2750,Private      ,1,10,11,1090,500,1590
00407100,WALSH COLLEGE OF ACCT & BUS ADMN        ,MI,48007-7006,Private      ,2,101,103,439,3014,3453
00407200,NORTHWOOD UNIVERSITY                    ,MI,48640-2398,Private      ,6,42,48,2250,2208,4458
00467300,BAKER COLLEGE - FLINT                   ,MI,48507-5508,Private      ,43,264,307,3186,8224,11410
00467301,BAKER COLLEGE OF CADILLAC               ,MI,49601-0000,Private      ,6,74,80,718,2186,2904
00467302,BAKER COLLEGE OF CLINTON TOWNSHIP       ,MI,48035-0000,Private      ,31,141,172,2029,5808,7837
00467303,BAKER COLLEGE OF MUSKEGON               ,MI,49442-0000,Private      ,34,152,186,2859,4627,7486
00467304,BAKER COLLEGE OF OWOSSO                 ,MI,48867-0000,Private      ,27,88,115,1949,2519,4468
00467305,BAKER COLLEGE OF AUBURN HILLS           ,MI,48326-0000,Private      ,20,107,127,1337,4253,5590
00467306,BAKER COLLEGE OF PORT HURON             ,MI,48060-0000,Private      ,9,27,36,631,1336,1967
00467309,BAKER COLLEGE OF JACKSON                ,MI,49202-0000,Private      ,17,117,134,1015,3128,4143
00467311,BAKER COLLEGE-CASS CITY                 ,MI,48726-0000,Private      ,2,23,25,201,421,622
00467313,BAKER COLLEGE - GRADUATE ON-LINE        ,MI,48507-0000,Private      ,8,225,233,612,7531,8143
00467317,BAKER COLLEGE-ALLEN PARK                ,MI,48101-0000,Private      ,22,134,156,1705,5567,7272
00469200,DORSEY SCHOOL OF BUSINESS               ,MI,48195-2334,Proprietary  ,6,35,41,122,515,637
00469201,DORSEY SCHOOL OF BUSINESS               ,MI,48184-0000,Proprietary  ,9,15,24,123,484,607
00469202,DORSEY SCHOOL OF BUSINESS               ,MI,48071-0000,Proprietary  ,15,33,48,137,534,671
00469204,DORSEY SCHOOL OF BUSINESS               ,MI,48066-0000,Proprietary  ,30,74,104,342,939,1281
00469205,DORSEY BUSINESS SCHOOL - FARMINGTON HILL,MI,48334-3385,Proprietary  ,3,14,17,72,276,348
00469206,DORSEY BUSINESS SCHOOL - ROSEVILLE CULIN,MI,48066-4555,Proprietary  ,4,34,38,165,526,691
00469207,DORSEY BUSINESS SCHOOL - WATERFORD/PONTI,MI,48341-1037,Proprietary  ,9,59,68,127,553,680
00469208,DORSEY BUSINESS SCHOOL - SAGINAW CAMPUS ,MI,48603-5201,Proprietary  ,11,54,65,128,612,740
00469209,DORSEY SCHOOL OF BUSINESS - LANSING     ,MI,48911-5744,Proprietary  ,2,43,45,90,465,555
00469210,DORSEY SCHOOL OF BUSINESS - DEARBORN    ,MI,48228-3858,Proprietary  ,13,67,80,63,337,400
00491003,KAPLAN CAREER INSTITUTE - DEARBORN      ,MI,48228-0000,Proprietary  ,4,19,23,152,847,999
00676800,MID MICHIGAN COMMUNITY COLLEGE          ,MI,48625-9447,Public       ,28,55,83,2829,3350,6179
00677100,COLLEGE FOR CREATIVE STUDIES            ,MI,48202-4034,Private      ,7,18,25,1991,1124,3115
00694900,KALAMAZOO VALLEY COMMUNITY COLLEGE      ,MI,49003-4070,Public       ,50,173,223,6571,8701,15272
00717100,KIRTLAND COMMUNITY COLLEGE              ,MI,48653-0000,Public       ,8,54,62,1031,1977,3008
00732991,ITT TECHNICAL INSTITUTE                 ,MI,49519-1851,Proprietary  ,23,221,244,881,3533,4414
00761700,CARNEGIE INSTITUTE                      ,MI,48083-1159,Proprietary  ,4,18,22,94,474,568
00795000,WEST SHORE COMMUNITY COLLEGE            ,MI,49454-0000,Public       ,3,7,10,673,1036,1709
00817800,EMPIRE BEAUTY SCHOOL                    ,MI,49525-2440,Proprietary  ,43,130,173,512,1131,1643
00832903,ITT TECHNICAL INSTITUTE                 ,MI,48083-2008,Proprietary  ,0,0,0,0,2,2
00890600,MACOMB COMMUNITY COLLEGE                ,MI,48088-3896,Public       ,135,385,520,15107,18240,33347
00894600,PORT HURON COSMETOLOGY COLLEGE          ,MI,48329-1618,Proprietary  ,1,3,4,38,92,130
00923000,WAYNE COUNTY COMMUNITY CLG-DISTRICT     ,MI,48226-3010,Public       ,184,984,1168,10273,30444,40717
00982800,EVEREST INSTITUTE                       ,MI,48033-4400,Proprietary  ,22,137,159,392,1995,2387
00982801,EVEREST INSTITUTE- DEARBORN             ,MI,48124-1927,Proprietary  ,15,90,105,386,1439,1825
00982803,EVEREST INSTITUTE - DETROIT             ,MI,48207-4291,Proprietary  ,21,98,119,446,1573,2019
01047000,KALAMAZOO BEAUTY ACADEMY                ,MI,49002-5220,Proprietary  ,1,3,4,39,92,131
01082700,DAVID PRESSLEY PROF SCH OF COSMTLGY     ,MI,48067-3219,Proprietary  ,5,10,15,221,359,580
01109800,FLINT INSTITUTE OF BARBERING            ,MI,48504-4395,Proprietary  ,0,4,4,74,224,298
01229100,WRIGHT BEAUTY ACADEMY                   ,MI,49015-2696,Proprietary  ,1,13,14,49,153,202
01262700,THOMAS M. COOLEY LAW SCHOOL             ,MI,48901-1586,Private      ,0,35,35,48,3381,3429
01321800,M J MURPHY BTY CLG MT PLEASANT          ,MI,48858-2502,Proprietary  ,2,10,12,66,153,219
02060300,MICHIGAN INSTITUTE OF AERONAUTICS       ,MI,48188-2533,Proprietary  ,19,45,64,707,900,1607
02099700,ROSS MEDICAL EDUCATION CENTER           ,MI,48532-0000,Proprietary  ,32,114,146,530,1671,2201
02099701,ROSS MEDICAL EDUCATION CENTER-SAGINAW   ,MI,48603-5227,Proprietary  ,3,4,7,72,195,267
02099702,ROSS MEDICAL EDUCATION CENTER-PORT HURON,MI,48060-1958,Proprietary  ,1,1,2,25,92,117
02099703,ROSS MEDICAL EDUCATION CENTER-ROOSEVELT ,MI,49441-4156,Proprietary  ,0,0,0,15,50,65
02100400,EVEREST INSTITUTE                       ,MI,49525-2301,Proprietary  ,11,65,76,296,1282,1578
02100401,EVEREST INSTITUTE - KALAMAZOO           ,MI,49009-3307,Proprietary  ,5,60,65,176,798,974
02125600,MICHIGAN COLLEGE OF BEAUTY              ,MI,48083-0000,Proprietary  ,10,23,33,200,469,669
02158600,MR BELA'S SCHOOL OF COSMETOLOGY         ,MI,48092-4637,Proprietary  ,0,12,12,69,211,280
02160303,INTERNATIONAL ACADEMY OF DESIGN AND TECH,MI,48083-2160,Proprietary  ,3,5,8,374,599,973
02180100,ROSS MEDICAL EDUCATION CENTER           ,MI,48092-0000,Proprietary  ,25,100,125,347,1128,1475
02180105,ROSS MEDICAL EDUCATION CENTER-REDFORD   ,MI,48239-1260,Proprietary  ,1,2,3,38,136,174
02198900,MICHIGAN SCHOOL OF PROFESSIONAL PSYCHOLO,MI,48334-4512,Private      ,0,2,2,40,326,366
02209200,TAYLORTOWN SCHOOL OF BEAUTY             ,MI,48180-0000,Proprietary  ,11,27,38,149,368,517
02237800,SPECS HOWARD SCHOOL OF MEDIA ARTS       ,MI,48075-0000,Proprietary  ,5,19,24,793,1106,1899
02285700,BAYSHIRE BEAUTY ACADEMY                 ,MI,48708-5614,Proprietary  ,0,5,5,51,185,236
02289801,KAPLAN INSTITUTE - DETROIT CAMPUS       ,MI,48202-0000,Proprietary  ,0,0,0,59,245,304
02324500,MICHIGAN COLLEGE OF BEAUTY              ,MI,48161-3901,Proprietary  ,4,8,12,110,259,369
02339700,ROSS MEDICAL EDUCATION CENTER           ,MI,48116-0000,Proprietary  ,18,121,139,305,1497,1802
02339701,ROSS MEDICAL EDUCATION CENTER-ANN ARBOR ,MI,48108-1411,Proprietary  ,1,4,5,53,180,233
02339703,ROSS MEDICAL EDUCATION CENTER - DAVISON ,MI,48423-1751,Proprietary  ,0,1,1,28,91,119
02361500,MICHIGAN BARBER COLLEGE                 ,MI,48204-2244,Private      ,4,25,29,185,676,861
02363800,YESHIVA GEDOLAH OF GREATER DETROIT      ,MI,48237-0000,Private      ,1,0,1,38,8,46
02491000,WEST MI COLG OF BARBERING & BEAUTY      ,MI,49008-0000,Proprietary  ,2,5,7,62,175,237
02531806,PAUL MITCHELL THE SCHOOL -MICHIGAN      ,MI,48313-0000,Proprietary  ,4,7,11,145,225,370
02533600,ROSS MEDICAL EDUCATION CENTER           ,MI,48917-2108,Proprietary  ,26,80,106,319,1054,1373
02533601,ROSS MEDICAL EDUCATION CENTER - GRAND RA,MI,49546-2430,Proprietary  ,0,7,7,99,366,465
02588200,DOUGLAS J AVEDA INSTITUTE               ,MI,48823-4351,Proprietary  ,23,57,80,802,1012,1814
02588201,DOUGLAS J AVEDA INSTITUTE - ANN ARBOR   ,MI,48104-2211,Proprietary  ,1,5,6,195,221,416
02595700,HILLSDALE BEAUTY COLLEGE                ,MI,49242-0000,Proprietary  ,3,2,5,87,60,147
02618400,MICHIGAN CAREER & TECHNICAL INST        ,MI,49080-9254,Public       ,43,5,48,409,141,550
03005700,DETROIT BUSINESS INST. DOWNRIVER        ,MI,48193-6761,Proprietary  ,1,3,4,41,233,274
03028500,LAWTON SCHOOL                           ,MI,48075-0000,Proprietary  ,0,0,0,13,79,92
03066600,BAY MILLS COMMUNITY COLLEGE             ,MI,49715-9750,Public       ,1,19,20,242,548,790
03075200,TWIN CITY BEAUTY COLLEGE                ,MI,49085-3305,Proprietary  ,9,14,23,163,280,443
03075201,TWIN CITY BEAUTY COLLEGE - TRAVERSE CITY,MI,49686-5119,Proprietary  ,0,1,1,44,79,123
03090000,SHARP'S ACADEMY OF HAIRSTYLING          ,MI,48439-1838,Proprietary  ,0,3,3,35,54,89
03109700,HOUGHTON LAKE INST OF COSMETOLOGY       ,MI,48629-0669,Proprietary  ,5,8,13,47,96,143
03110300,THE SCHOOL OF CREATIVE HAIR DESIGN      ,MI,49036-1139,Proprietary  ,0,7,7,39,102,141
03124000,NORTHWESTERN TECHNOLOGICAL INST         ,MI,48075-2412,Proprietary  ,4,50,54,145,691,836
03284300,MICHIGAN JEWISH INSTITUTE               ,MI,48237-0000,Private      ,10,2,12,1446,894,2340
03490300,PAUL MITCHELL THE SCHOOL ESCANABA       ,MI,49829-0000,Proprietary  ,1,8,9,182,176,358
03588300,IRENE'S MYOMASSOLOGY INSTITUTE          ,MI,48033-2404,Proprietary  ,1,12,13,108,458,566
03704300,BLUE WATER COLLEGE OF COSMETOLOGY       ,MI,48040-2093,Proprietary  ,1,6,7,30,61,91
03772300,SAGINAW CHIPPEWA TRIBAL COLLEGE         ,MI,48858-0000,Public       ,0,1,1,30,112,142
03815300,IN SESSION-ARTS OF COSMETOLOGY BEAU     ,MI,48609-0000,Proprietary  ,1,4,5,82,182,264
03907300,PAUL MITCHELL THE SCHOOL GREAT LAKES    ,MI,48060-0000,Proprietary  ,8,4,12,140,179,319
03915300,CAREER QUEST LEARNING CENTER            ,MI,48910-4732,Proprietary  ,13,47,60,206,1185,1391
03915301,CAREER QUEST LEARNING CENTER - JACKSON  ,MI,49201-2475,Proprietary  ,7,53,60,63,432,495
03915302,CAREER QUEST LEARNING CENTER - KALAMAZOO,MI,49002-1711,Proprietary  ,5,27,32,64,337,401
03968300,LAKEWOOD SCHOOL OF THERAPEUTIC MASSAGE  ,MI,48060-0000,Proprietary  ,0,2,2,20,83,103
03976500,ANN ARBOR INSTITUTE OF MASSAGE THERAPY  ,MI,48103-0000,Proprietary  ,2,2,4,67,190,257
04002400,ECUMENICAL THEOLOGICAL SEMINARY         ,MI,48201-3035,Private      ,0,8,8,14,191,205
04006300,NUVO COLLEGE OF COSMETOLOGY             ,MI,49441-3822,Proprietary  ,0,6,6,34,114,148
04014300,P&A SCHOLARS BEAUTY SCHOOL              ,MI,48204-0000,Proprietary  ,12,27,39,247,777,1024
04094300,ROBERT B. MILLER COLLEGE (THE)          ,MI,49017-3306,Private      ,2,7,9,122,598,720
04121100,GALLERY COLLEGE OF BEAUTY (THE)         ,MI,48036-3591,Proprietary  ,7,13,20,84,296,380
04136300,FOCUS:  HOPE INFORMATION TECHNOLOGIES CE,MI,48238-2949,Private      ,3,21,24,179,650,829
04138400,SCHOOL OF DESIGNING ARTS                ,MI,49015-2853,Proprietary  ,1,12,13,72,157,229
04140900,INTERNATIONAL COSMETOLOGY ACADEMY       ,MI,49508-1308,Proprietary  ,0,4,4,67,207,274
04141100,FRENCH ACADEMY OF COSMETOLOGY           ,MI,49456-3207,Proprietary  ,2,8,10,44,95,139
04158400,L'ESPRIT ACADEMY                        ,MI,48150-0000,Proprietary  ,5,13,18,130,253,383
04159300,MARKETTI ACADEMY OF COSMETOLOGY         ,MI,48329-3506,Proprietary  ,1,5,6,64,105,169
04163300,COMPASS COLLEGE OF CINEMATIC ARTS       ,MI,49503-4227,Private      ,0,0,0,147,93,240
04164700,KEWEENAW BAY OJIBWA COMMUNITY COLLEGE   ,MI,49908-0000,Public       ,0,0,0,25,112,137
04169300,SCHOLARS COSMETOLOGY UNIVERSITY         ,MI,48108-0000,Proprietary  ,2,2,4,48,121,169
04183300,ABCOTT INSTITUTE                        ,MI,48075-5227,Proprietary  ,4,25,29,71,360,431
04184700,PROTEGE ACADEMY                         ,MI,48823-8660,Proprietary  ,3,8,11,66,153,219
04207000,SCHOOL OF MISSIONARY AVIATION TECHNOLOGY,MI,48846-7412,Private      ,0,0,0,35,42,77
04211200,BRIGHTON INSTITUTE OF COSMETOLOGY       ,MI,48116-8360,Proprietary  ,4,2,6,46,78,124
04222300,MANTHANO CHRISTIAN COLLEGE              ,MI,48185-1919,Private      ,0,1,1,0,6,6
04230200,EXCEL ACADEMIES OF COSMETOLOGY          ,MI,48085-1300,Proprietary  ,1,1,2,2,4,6
04230400,EXCEL ACADEMIES OF COSMETOLOGY          ,MI,48912-4686,Proprietary  ,0,9,9,2,15,17
04230500,EXCEL ACADEMIES OF COSMETOLOGY          ,MI,49512-1781,Proprietary  ,3,5,8,5,8,13
00233200,ANOKA-RAMSEY CC-CAMBRIDGE/COONRAPID     ,MN,55433-3499,Public       ,62,152,214,4138,5574,9712
00233400,AUGSBURG COLLEGE                        ,MN,55454-1351,Private      ,28,29,57,3453,2643,6096
00233500,RIVERLAND COMMUNITY COLLEGE             ,MN,55912-1473,Public       ,13,43,56,1082,2009,3091
00233600,BEMIDJI STATE UNIVERSITY                ,MN,56601-2699,Public       ,5,51,56,3988,2371,6359
00233700,BETHANY LUTHERAN COLLEGE INC            ,MN,56001-6163,Private      ,1,1,2,718,91,809
00233900,CENTRAL LAKES COLG-BRAINERD/STAPLES     ,MN,56401-3900,Public       ,23,64,87,1540,2165,3705
00234000,CARLETON COLLEGE                        ,MN,55057-4001,Private      ,0,2,2,3748,113,3861
00234100,COLLEGE OF ST BENEDICT                  ,MN,56374-2099,Private      ,3,4,7,2257,105,2362
00234200,ST. CATHERINE UNIVERSITY                ,MN,55105-1789,Private      ,5,57,62,2987,3890,6877
00234300,COLLEGE OF ST SCHOLASTICA               ,MN,55811-4199,Private      ,11,119,130,2475,2797,5272
00234500,UNIVERSITY OF ST THOMAS                 ,MN,55105-1096,Private      ,14,122,136,7358,3935,11293
00234600,CONCORDIA COLLEGE-MOORHEAD              ,MN,56562-0001,Private      ,3,6,9,3110,240,3350
00234700,"CONCORDIA UNIVERSITY, ST PAUL, MN       ",MN,55104-5494,Private      ,9,111,120,1802,3790,5592
00235000,VERMILION COMMUNITY COLLEGE             ,MN,55731-1996,Public       ,6,3,9,553,210,763
00235300,GUSTAVUS ADOLPHUS COLLEGE               ,MN,56082-1498,Private      ,3,1,4,3604,135,3739
00235400,HAMLINE UNIVERSITY                      ,MN,55104-1284,Private      ,7,106,113,3574,3193,6767
00235500,HIBBING COMMUNITY COLLEGE               ,MN,55746-3300,Public       ,6,17,23,712,1102,1814
00235600,ITASCA COMMUNITY COLLEGE                ,MN,55744-3397,Public       ,3,19,22,859,737,1596
00235700,LUTHER SEMINARY                         ,MN,55108-0000,Private      ,0,4,4,7,400,407
00235800,MACALESTER COLLEGE                      ,MN,55105-1899,Private      ,2,3,5,3825,264,4089
00236000,"MINNESOTA STATE UNIVERSITY, MANKATO     ",MN,56002-0000,Public       ,68,123,191,12780,5134,17914
00236100,MARTIN LUTHER COLLEGE                   ,MN,56073-3965,Private      ,0,3,3,694,75,769
00236200,MINNEAPOLIS COMM AND TECH COLLEGE       ,MN,55403-1779,Public       ,63,265,328,4555,11875,16430
00236500,MINNEAPOLIS COLLEGE OF ART & DESIGN     ,MN,55404-4343,Private      ,2,8,10,1039,630,1669
00236600,CROSSROADS COLLEGE                      ,MN,55902-2382,Private      ,0,1,1,94,105,199
00236700,MINNESOTA STATE UNIVERSITY MOORHEAD     ,MN,56563-0001,Public       ,13,72,85,5509,2880,8389
00236900,NORTH CENTRAL UNIVERSITY                ,MN,55404-1391,Private      ,2,11,13,1361,536,1897
00237000,NORTH HENNEPIN COMMUNITY COLLEGE        ,MN,55445-2299,Public       ,46,156,202,3402,6616,10018
00237100,UNIVERSITY OF NORTHWESTERN- ST PAUL     ,MN,55113-1598,Private      ,10,34,44,2483,1109,3592
00237300,ROCHESTER COMMUNITY/TECH COLLEGE        ,MN,55904-4999,Public       ,36,121,157,2974,4360,7334
00237500,SOUTHWEST MINNESOTA STATE UNIVERSITY    ,MN,56258-1598,Public       ,6,16,22,2215,1315,3530
00237700,ST CLOUD STATE UNIVERSITY               ,MN,56301-4498,Public       ,40,129,169,10473,5758,16231
00237900,SAINT JOHNS UNIVERSITY                  ,MN,56321-0000,Private      ,3,2,5,2057,104,2161
00238000,SAINT MARY'S UNIVERSITY                 ,MN,55987-1399,Private      ,7,165,172,1767,3943,5710
00238200,ST OLAF COLLEGE                         ,MN,55057-1098,Private      ,2,3,5,3943,140,4083
00238300,CROWN COLLEGE                           ,MN,55375-9001,Private      ,0,33,33,949,1087,2036
00238500,NORTHLAND COMMUNITY & TECHNICAL CLG     ,MN,56701-2598,Public       ,6,25,31,1620,2049,3669
00238600,UNITED THEOLGCL SEMINRY TWIN CITIES     ,MN,55112-0000,Private      ,0,1,1,8,107,115
00238800,"UNIVERSITY OF MINNESOTA, DULUTH         ",MN,55812-2496,Public       ,20,38,58,10831,2612,13443
00238900,"UNIVERSITY OF MINNESOTA, MORRIS         ",MN,56267-2113,Public       ,3,8,11,2435,362,2797
00239100,WILLIAM MITCHELL COLLEGE OF LAW         ,MN,55105-0000,Private      ,0,1,1,11,1056,1067
00239300,MINNESOTA STATE COLLEGE-SE TECH         ,MN,55987-0409,Public       ,9,38,47,932,1715,2647
00239400,WINONA STATE UNIVERSITY                 ,MN,55987-5838,Public       ,17,49,66,7894,1967,9861
00396900,UNIVERSITY OF MINNESOTA-TWIN CITIES     ,MN,55455-0422,Public       ,74,287,361,35016,19180,54196
00400900,MESABI RANGE CMNTY & TECH COLLEGE       ,MN,55792-0000,Public       ,5,15,20,647,773,1420
00405708,NATIONAL AMERICAN UNIVERSITY            ,MN,55113-0000,Proprietary  ,1,7,8,36,366,402
00405715,NATIONAL AMERICAN UNIVERSITY - BLOOMINGT,MN,55425-5550,Proprietary  ,0,7,7,37,522,559
00406900,UNIVERSITY OF MINNESOTA-CROOKSTON       ,MN,56716-5001,Public       ,4,37,41,1186,1106,2292
00438600,VETERAN'S MEDICAL CTR- SCH RAD TECH     ,MN,55417-2399,Public       ,0,0,0,7,32,39
00464100,DUNWOODY COLLEGE OF TECHNOLOGY          ,MN,55403-1192,Private      ,3,18,21,723,1494,2217
00464200,GLOBE UNIVERSITY                        ,MN,55125-5408,Proprietary  ,5,31,36,1178,3974,5152
00464500,MINNEAPOLIS BUSINESS COLLEGE            ,MN,55113-4036,Proprietary  ,3,4,7,350,194,544
00464600,MINNESOTA SCHOOL OF BUSINESS            ,MN,55423-0000,Proprietary  ,10,24,34,1146,3766,4912
00525200,RIDGEWATER COLLEGE                      ,MN,56201-2098,Public       ,26,48,74,2039,2175,4214
00526300,MINNESOTA WEST CMNTY & TECH COLG        ,MN,56241-1096,Public       ,30,41,71,919,1651,2570
00553300,"SAINT PAUL COLLEGE, COMMUNITY/TECHNICAL ",MN,55102-1800,Public       ,55,224,279,3783,8898,12681
00553400,SAINT CLOUD TECHNICAL COLLEGE AND COMMUN,MN,56303-1240,Public       ,27,92,119,3113,3501,6614
00553500,PINE TECHNICAL COLLEGE                  ,MN,55063-2198,Public       ,6,36,42,294,972,1266
00553700,SOUTH CENTRAL COLLEGE                   ,MN,56003-0000,Public       ,13,47,60,1826,2482,4308
00554100,MINNESOTA STATE COMMUNITY AND TECHNICAL ,MN,56573-1405,Public       ,11,87,98,2402,3669,6071
00554400,ALEXANDRIA TECHNICAL COLLEGE            ,MN,56308-3799,Public       ,5,27,32,1393,1046,2439
00575700,LAKE SUPERIOR COLLEGE                   ,MN,55811-3399,Public       ,21,79,100,2287,3531,5818
00575900,NORTHWEST TECHNICAL COLLEGE - BEMIDJI   ,MN,56601-4907,Public       ,4,46,50,428,1057,1485
00677500,RAINY RIVER COMMUNITY COLLEGE           ,MN,56649-2187,Public       ,1,6,7,172,147,319
00735000,ANOKA-HENNEPIN TECHNICAL COLLEGE        ,MN,55303-1590,Public       ,11,56,67,1128,2961,4089
00735100,BROWN COLLEGE                           ,MN,55120-1004,Proprietary  ,5,35,40,231,785,1016
00746200,COLLEGE OF VISUAL ARTS                  ,MN,55102-2199,Private      ,0,0,0,65,67,132
00795400,NORMANDALE COMMUNITY COLLEGE            ,MN,55431-4399,Public       ,59,149,208,5053,6297,11350
00826700,NORTHWEST TECHNICAL INSTITUTE           ,MN,55121-5001,Proprietary  ,1,0,1,18,48,66
00869400,RASMUSSEN COLLEGE - ST. CLOUD           ,MN,56301-3713,Proprietary  ,8,29,37,290,1526,1816
00869401,RASMUSSEN COLLEGE - BROOKLYN PARK       ,MN,55445-1512,Proprietary  ,5,27,32,272,1569,1841
00869406,RASMUSSEN COLLEGE - EAGAN               ,MN,55122-1346,Proprietary  ,6,36,42,223,1376,1599
00869407,RASMUSSEN COLLEGE - BLOOMINGTON         ,MN,55435-5444,Proprietary  ,5,33,38,208,1705,1913
00869409,RASMUSSEN COLLEGE - MANKATO             ,MN,56001-8658,Proprietary  ,2,30,32,249,1162,1411
00869412,RASMUSSEN COLLEGE - LAKE ELMO           ,MN,55042-8624,Proprietary  ,3,43,46,185,1083,1268
00869416,RASMUSSEN COLLEGE - MOORHEAD            ,MN,56560-4513,Proprietary  ,2,20,22,211,902,1113
00869417,RASMUSSEN COLLEGE - BLAINE              ,MN,55014-0000,Proprietary  ,2,31,33,185,1015,1200
00905800,BETHEL UNIVERSITY                       ,MN,55112-6999,Private      ,7,77,84,3426,2788,6214
00945911,EMPIRE BEAUTY SCHOOL - ST. PAUL         ,MN,55119-7003,Proprietary  ,0,0,0,81,211,292
00960000,COSMETOLOGY CAREERS UNLTD-DULUTH        ,MN,55802-2031,Proprietary  ,2,4,6,21,63,84
00974000,INVER HILLS COMMUNITY COLLEGE           ,MN,55076-3224,Public       ,32,123,155,2781,4306,7087
00983100,MODEL COLLEGE OF HAIR DESIGN            ,MN,56301-4280,Proprietary  ,2,3,5,145,135,280
00987000,EMPIRE BEAUTY SCHOOL                    ,MN,55420-2919,Proprietary  ,0,0,0,111,199,310
00989200,"DULUTH BUSINESS UNIV, INC.              ",MN,55807-0000,Proprietary  ,1,4,5,122,379,501
00999200,OAK HILLS CHRISTIAN COLLEGE             ,MN,56601-0000,Private      ,0,0,0,130,78,208
01024800,ART INSTITUTES INTL MINNESOTA           ,MN,55402-3137,Proprietary  ,14,22,36,1330,1322,2652
01035602,EVEREST INSTITUTE - EAGAN               ,MN,55121-1696,Proprietary  ,12,56,68,108,699,807
01037400,METROPOLITAN STATE UNIVERSITY           ,MN,55106-5000,Public       ,18,159,177,2428,9923,12351
01040200,DAKOTA COUNTY TECHNICAL COLLEGE         ,MN,55068-2999,Public       ,33,61,94,1345,2518,3863
01049000,REGENCY BEAUTY INSTITUTE                ,MN,55428-0000,Proprietary  ,153,383,536,4251,8066,12317
01049100,HENNEPIN TECHNICAL COLLEGE              ,MN,55445-2399,Public       ,35,149,184,2212,6766,8978
01054600,CENTURY COLLEGE                         ,MN,55110-1894,Public       ,72,236,308,5451,8787,14238
01173200,"MAYO CLINIC, COLLEGE OF MEDICINE        ",MN,55905-0000,Private      ,1,2,3,85,414,499
01173201,MAYO SCHOOL OF HEALTH-RELATED SCIEN     ,MN,55905-0000,Private      ,1,4,5,90,243,333
01173206,MAYO GRAD SCHOOL                        ,MN,55901-0000,Private      ,1,1,2,9,59,68
01173207,MAYO MEDICAL SCHOOL                     ,MN,55901-0000,Private      ,1,1,2,35,211,246
01232800,NORTHWESTERN HEALTH SCIENCES UNIV       ,MN,55431-1599,Private      ,2,15,17,88,957,1045
02050300,ACADEMY COLLEGE                         ,MN,55420-1554,Proprietary  ,1,8,9,45,230,275
02097300,HASTINGS BEAUTY SCHOOL                  ,MN,55033-1205,Proprietary  ,2,7,9,15,57,72
02123200,AVEDA INSTITUTE                         ,MN,55414-0000,Proprietary  ,11,12,23,499,593,1092
02159800,COSMETOLOGY CAREERS UNLTD - HIBBING     ,MN,55746-0000,Proprietary  ,2,1,3,23,50,73
02160901,PCI ACADEMY - PCI ACADEMY               ,MN,55446-4928,Proprietary  ,1,5,6,41,68,109
02238100,MINNESOTA SCHOOL OF COSMETOLOGY         ,MN,55125-0000,Proprietary  ,5,12,17,169,270,439
02260500,SUMMIT ACAD OPPORTUNITIES IND CTR       ,MN,55405-0000,Private      ,10,73,83,134,907,1041
02263102,ANTHEM COLLEGE - ST. LOUIS PARK         ,MN,55416-2467,Proprietary  ,1,1,2,28,194,222
02504200,WALDEN UNIVERSITY                       ,MN,55401-2511,Proprietary  ,23,2284,2307,440,65164,65604
02514100,AMERICAN INDIAN OPPORTUNITIES CTR       ,MN,55404-0000,Private      ,0,5,5,25,333,358
03001200,MCNALLY SMITH COLLEGE OF MUSIC          ,MN,55101-2220,Proprietary  ,6,5,11,761,323,1084
03051900,ALFRED ADLER GRADUATE SCHOOL            ,MN,55305-0000,Private      ,0,6,6,1,380,381
03096400,LEECH LAKE TRIBAL COLLEGE               ,MN,56633-0000,Public       ,0,4,4,77,408,485
03129100,FOND DU LAC TRIBAL & COMMUNITY CLG      ,MN,55720-2984,Public       ,4,25,29,511,1046,1557
03267300,CAPELLA UNIVERSITY                      ,MN,55402-3389,Proprietary  ,18,1811,1829,348,57383,57731
03833300,AMERICAN ACADEMY OF ACUPUNCTURE AND ORIE,MN,55113-0000,Proprietary  ,0,3,3,1,83,84
03921400,WHITE EARTH TRIBAL AND COMMUNITY COLLEGE,MN,56557-0478,Private      ,0,3,3,18,110,128
04044300,HAZELDEN GRADUATE SCHOOL OF ADDICTION ST,MN,55012-0000,Private      ,0,3,3,7,174,181
04130200,INST. OF PRODUCTION AND RECORDING       ,MN,55401-1315,Proprietary  ,2,4,6,349,415,764
04148800,CENTERPOINT MASSAGE & SHIATSU THERAPY SC,MN,55414-4525,Proprietary  ,1,12,13,35,222,257
04157600,NOVA ACADEMY OF COSMETOLOGY             ,MN,55906-4103,Proprietary  ,1,3,4,61,126,187
04160500,AVALON SCHOOL OF COSMETOLOGY            ,MN,56187-1930,Proprietary  ,1,5,6,17,54,71
04174400,ROCHESTER SCHOOL OF HAIR DESIGN         ,MN,55901-4310,Proprietary  ,4,2,6,43,64,107
04175600,PARK AVENUE SCHOOL OF COSMETOLOGY       ,MN,56470-3361,Proprietary  ,2,15,17,25,110,135
00239600,ALCORN STATE UNIVERSITY                 ,MS,39096-7500,Public       ,156,114,270,4710,4270,8980
00239700,BELHAVEN UNIVERSITY                     ,MS,39202-1789,Private      ,24,218,242,1926,5830,7756
00239800,BLUE MOUNTAIN COLLEGE                   ,MS,38610-9370,Private      ,3,14,17,609,394,1003
00240100,COAHOMA COMMUNITY COLLEGE               ,MS,38614-9799,Public       ,118,53,171,1903,2400,4303
00240200,COPIAH-LINCOLN COMMUNITY COLLEGE        ,MS,39191-0649,Public       ,89,89,178,2556,2574,5130
00240300,DELTA STATE UNIVERSITY                  ,MS,38733-0000,Public       ,56,89,145,3780,3507,7287
00240400,EAST CENTRAL COMMUNITY COLLEGE          ,MS,39327-0129,Public       ,77,42,119,2212,2300,4512
00240500,EAST MISSISSIPPI COMM COLLEGE           ,MS,39358-0000,Public       ,170,115,285,3917,4147,8064
00240700,HINDS COMMUNITY COLLEGE                 ,MS,39154-9799,Public       ,245,324,569,8984,12062,21046
00240800,HOLMES COMMUNITY COLLEGE                ,MS,39079-0000,Public       ,191,196,387,4947,6851,11798
00240900,ITAWAMBA COMMUNITY COLLEGE              ,MS,38843-1099,Public       ,102,100,202,4715,4669,9384
00241000,JACKSON STATE UNIVERSITY                ,MS,39217-0001,Public       ,236,267,503,9445,11780,21225
00241100,JONES COUNTY JUNIOR COLLEGE             ,MS,39437-3999,Public       ,112,74,186,4555,2991,7546
00241300,MERIDIAN COMMUNITY COLLEGE              ,MS,39307-5890,Public       ,39,97,136,2513,3469,5982
00241400,MILLSAPS COLLEGE                        ,MS,39201-0000,Private      ,9,27,36,1523,957,2480
00241500,MISSISSIPPI COLLEGE                     ,MS,39058-0001,Private      ,16,69,85,3191,3894,7085
00241501,MISSISSIPPI COLLEGE - SCHOOL OF LAW     ,MS,39201-1391,Private      ,2,11,13,144,962,1106
00241600,MISSISSIPPI DELTA CMTY COLLEGE          ,MS,38761-0000,Public       ,110,85,195,2675,2625,5300
00241700,MISSISSIPPI GULF CST CLG-PERKINSTON     ,MS,39573-0000,Public       ,113,299,412,2699,2651,5350
00241701,MISSISSIPPI GULF COAST COMMUNITY COLLEGE,MS,39507-3894,Public       ,0,0,0,2367,4499,6866
00241702,MISSISSIPPI GULF COAST COMMUNITY COLLEGE,MS,39553-0100,Public       ,0,0,0,1932,2857,4789
00242200,MISSISSIPPI UNIV FOR WOMEN              ,MS,39701-5818,Public       ,29,81,110,2055,2962,5017
00242300,MISSISSIPPI STATE UNIVERSITY            ,MS,39762-9698,Public       ,200,196,396,19011,8807,27818
00242400,MISSISSIPPI VALLEY STATE UNIVERSITY     ,MS,38941-1400,Public       ,183,84,267,3770,3277,7047
00242600,NORTHEAST MS CMNTY COLLEGE              ,MS,38829-1731,Public       ,91,44,135,3176,2380,5556
00242700,NORTHWEST MISSISSIPPI COMMUNITY CLG     ,MS,38668-1703,Public       ,146,127,273,6681,6095,12776
00243000,PEARL RIVER COMMUNITY COLLEGE           ,MS,39470-2201,Public       ,113,105,218,3831,3992,7823
00243300,RUST COLLEGE                            ,MS,38635-2328,Private      ,21,9,30,1607,786,2393
00243500,SOUTHEASTERN BAPTIST COLLEGE            ,MS,39440-0000,Private      ,0,0,0,29,114,143
00243600,SOUTHWEST MISSISSIPPI CMNTY CLG         ,MS,39666-8099,Public       ,43,33,76,1753,1600,3353
00243900,TOUGALOO COLLEGE                        ,MS,39174-9799,Private      ,28,15,43,1787,886,2673
00244000,UNIVERSITY OF MISSISSIPPI               ,MS,38677-1848,Public       ,195,172,367,17492,8120,25612
00244001,UNIVERSITY OF MISSISSIPPI - MED CTR     ,MS,39216-0000,Public       ,10,47,57,885,2829,3714
00244100,UNIVERSITY OF SOUTHERN MISSISSIPPI      ,MS,39406-0001,Public       ,136,233,369,14097,11414,25511
00244700,WILLIAM CAREY UNIVERSITY                ,MS,39401-5499,Private      ,25,127,152,2153,5200,7353
00489809,MCCANN SCHOOL OF BUSINESS & TECHNOLOGY -,MS,39503-3167,Proprietary  ,1,5,6,29,208,237
01289101,ANTONELLI COLLEGE - JACKSON             ,MS,39232-9514,Proprietary  ,6,83,89,220,1679,1899
01289102,ANTONELLI COLLEGE - HATTIESBURG         ,MS,39401-3056,Proprietary  ,3,39,42,210,942,1152
02074900,CHRIS' BEAUTY COLLEGE                   ,MS,39501-0000,Proprietary  ,2,8,10,75,230,305
02160500,NORTH MISSISSIPPI MED CTR MED TECH      ,MS,38801-0000,Private      ,1,2,3,56,203,259
02235900,ACADEMY OF HAIR DESIGN #4               ,MS,39208-0000,Proprietary  ,1,12,13,90,235,325
02244300,ACADEMY OF HAIR DESIGN #1               ,MS,39204-5008,Proprietary  ,4,19,23,134,338,472
02244305,ACADEMY OF HAIR DESIGN #1-ACADEMY OF HAI,MS,38901-5108,Proprietary  ,2,4,6,6,21,27
02249900,DELTA BEAUTY COLLEGE                    ,MS,38701-0000,Proprietary  ,3,9,12,65,150,215
02251600,ACADEMY OF HAIR DESIGN #6               ,MS,39401-7581,Proprietary  ,7,25,32,118,362,480
02251700,FOSTER'S COSMETOLOGY COLLEGE            ,MS,38663-0000,Proprietary  ,1,6,7,17,57,74
02302800,MISSISSIPPI COLLEGE OF BEAUTY CULT      ,MS,39440-0000,Proprietary  ,2,9,11,52,121,173
02320800,MAGNOLIA COLLEGE OF COSMETOLOGY         ,MS,39206-0000,Proprietary  ,2,22,24,138,486,624
02502100,CREATIONS COLLEGE OF COSMETOLOGY        ,MS,38803-0000,Proprietary  ,1,3,4,53,159,212
02516200,WESLEY BIBLICAL SEMINARY                ,MS,39206-0000,Private      ,0,2,2,13,161,174
02586000,J & J HAIR DESIGN COLLEGE               ,MS,39051-3716,Proprietary  ,4,20,24,62,158,220
03004000,FINAL TOUCH BEAUTY SCHOOL               ,MS,39307-2934,Proprietary  ,0,0,0,2,7,9
03010603,VIRGINIA COLLEGE - JACKSON              ,MS,39206-5602,Proprietary  ,5,27,32,224,1267,1491
03010610,VIRGINIA COLLEGE - BILOXI               ,MS,39532-2124,Proprietary  ,2,12,14,133,544,677
03032400,KC'S SCHOOL OF HAIR DESIGN              ,MS,38863-0000,Proprietary  ,1,6,7,47,168,215
03263300,TRAXLER'S SCHOOL OF HAIR                ,MS,39212-2529,Proprietary  ,0,15,15,41,153,194
03294305,BLUE CLIFF COLLEGE - GULFPORT           ,MS,39503-0000,Proprietary  ,1,7,8,135,572,707
03464300,ACADEMY OF HAIR DESIGN                  ,MS,39562-0000,Proprietary  ,3,2,5,22,83,105
03848300,DAY SPA CAREER COLLEGE                  ,MS,39564-0000,Proprietary  ,1,3,4,21,117,138
03963300,HEALING TOUCH SCHOOL OF MASSAGE THERAPY ,MS,39402-1300,Proprietary  ,2,19,21,84,395,479
04131300,CORINTH ACADEMY OF COSMETOLOGY          ,MS,38834-4813,Proprietary  ,4,17,21,75,211,286
04140200,"MISSISSIPPI INSTITUTE OF AESTHETICS, NAI",MS,39056-5628,Proprietary  ,1,7,8,60,205,265
00252600,CARROLL COLLEGE                         ,MT,59625-0002,Private      ,2,1,3,2395,325,2720
00252700,UNIVERSITY OF GREAT FALLS               ,MT,59405-4996,Private      ,5,16,21,885,793,1678
00252800,MILES COMMUNITY COLLEGE                 ,MT,59301-4799,Public       ,0,3,3,275,220,495
00252900,DAWSON COMMUNITY COLLEGE                ,MT,59330-1405,Public       ,1,7,8,245,188,433
00253000,MONTANA STATE UNIVERSITY - BILLINGS     ,MT,59101-0298,Public       ,16,62,78,3007,4011,7018
00253100,MONTANA TECH OF THE UNIV OF MONTANA     ,MT,59701-8997,Public       ,2,9,11,1752,1682,3434
00253200,MONTANA STATE UNIVERSITY - BOZEMAN      ,MT,59717-4160,Public       ,16,85,101,13314,5568,18882
00253300,MONTANA STATE UNIVERSITY-NORTHERN       ,MT,59501-3148,Public       ,6,20,26,940,964,1904
00253400,ROCKY MOUNTAIN COLLEGE                  ,MT,59102-1796,Private      ,3,3,6,1387,568,1955
00253600,UNIVERSITY OF MONTANA (THE)             ,MT,59812-0001,Public       ,16,88,104,8857,8500,17357
00253700,UNIVERSITY OF MONTANA WESTERN (THE)     ,MT,59725-3598,Public       ,0,5,5,1463,648,2111
00677700,FLATHEAD VALLEY COMMUNITY COLLEGE       ,MT,59901-2699,Public       ,10,39,49,1015,1950,2965
00757000,HELENA COLLEGE OF TECHNOLOGY            ,MT,59601-3098,Public       ,0,19,19,562,1270,1832
00790000,BUTTE ACADEMY OF BEAUTY CULTURE         ,MT,59701-9197,Proprietary  ,0,5,5,31,89,120
00894700,"DAHL'S COLLEGE OF BEAUTY,INC            ",MT,59401-3731,Proprietary  ,0,0,0,13,23,36
00931400,GREAT FALLS COLLEGE MONTANA STATE UNIVER,MT,59405-4907,Public       ,4,41,45,747,1939,2686
02143400,SALISH KOOTENAI COLLEGE                 ,MT,59855-0000,Public       ,6,8,14,337,1073,1410
02286600,LITTLE BIG HORN COLLEGE                 ,MT,59022-0000,Public       ,0,3,3,109,260,369
02343000,FT PECK COMMUNITY COLLEGE               ,MT,59255-0000,Public       ,2,8,10,95,247,342
02510600,BLACKFEET COMMUNITY COLLEGE             ,MT,59417-0000,Private      ,0,2,2,186,511,697
02517500,FORT BELKNAP COLLEGE                    ,MT,59526-0000,Public       ,0,1,1,59,187,246
02545200,CHIEF DULL KNIFE COLLEGE                ,MT,59043-0098,Public       ,1,0,1,60,176,236
02610900,STONE CHILD COLLEGE                     ,MT,59521-9796,Public       ,4,13,17,107,290,397
02621300,ACADEMY OF COSMETOLOGY                  ,MT,59715-3544,Proprietary  ,0,1,1,46,71,117
03205300,MODERN BEAUTY SCHOOL                    ,MT,59801-8386,Proprietary  ,1,1,2,74,133,207
03763400,"ACADEMY OF NAIL, SKIN & HAIR            ",MT,59101-0000,Proprietary  ,1,3,4,84,213,297
03778300,HEALTH WORKS INSTITUTE                  ,MT,59715-0000,Proprietary  ,5,7,12,56,129,185
04163700,BITTERROOT SCHOOL OF COSMETOLOGY        ,MT,59840-3118,Proprietary  ,0,3,3,18,65,83
04164100,MONTANA ACADEMY OF SALON                ,MT,59405-0000,Proprietary  ,3,9,12,82,150,232
04187700,CREVIER'S SCHOOL OF COSMETOLOGY         ,MT,59901-4402,Proprietary  ,2,2,4,71,186,257
00253900,CHADRON STATE COLLEGE                   ,NE,69337-2690,Public       ,3,51,54,2065,1412,3477
00254000,COLLEGE OF ST MARY                      ,NE,68106-2606,Private      ,4,25,29,614,1294,1908
00254100,CONCORDIA UNIVERSITY                    ,NE,68434-1594,Private      ,1,74,75,1446,913,2359
00254200,CREIGHTON UNIVERSITY                    ,NE,68178-0001,Private      ,6,45,51,5573,5676,11249
00254400,DOANE COLLEGE                           ,NE,68333-2421,Private      ,6,68,74,1820,1415,3235
00254700,GRACE UNIVERSITY                        ,NE,68108-3629,Private      ,1,11,12,437,389,826
00254800,HASTINGS COLLEGE                        ,NE,68901-7621,Private      ,4,5,9,1493,209,1702
00255100,UNIVERSITY OF NEBRASKA AT KEARNEY       ,NE,68849-0001,Public       ,10,89,99,4976,2579,7555
00255300,MIDLAND UNIVERSITY                      ,NE,68025-4254,Private      ,2,5,7,1629,436,2065
00255400,UNIVERSITY OF NEBRASKA-OMAHA            ,NE,68182-0001,Public       ,33,134,167,10145,8151,18296
00255500,NEBRASKA WESLEYAN UNIVERSITY            ,NE,68504-2796,Private      ,3,13,16,2219,921,3140
00255700,MID-PLAINS COMM COLLEGE - NORTH PLATTE  ,NE,69101-9420,Public       ,14,30,44,575,883,1458
00255701,MID-PLAINS COMMUNITY COLLEGE - MCCOOK   ,NE,69001-2631,Public       ,4,6,10,261,240,501
00255900,PERU STATE COLLEGE                      ,NE,68421-0010,Public       ,12,47,59,1226,1246,2472
00256000,WESTERN NEBRASKA COMMUNITY COLLEGE      ,NE,69361-1815,Public       ,10,32,42,822,1119,1941
00256300,UNION COLLEGE                           ,NE,68506-4387,Private      ,0,2,2,899,483,1382
00256500,UNIVERSITY OF NEBRASKA-LINCOLN          ,NE,68588-0419,Public       ,32,81,113,17226,5872,23098
00256596,UNIVERSITY OF NEBRASKA - CURTIS         ,NE,69025-9522,Public       ,0,0,0,236,57,293
00256600,WAYNE STATE COLLEGE                     ,NE,68787-1172,Public       ,5,31,36,3330,1109,4439
00256700,YORK COLLEGE                            ,NE,68467-2699,Private      ,2,3,5,549,160,709
00443600,REGNL WST MEDCL CTR SCHL RAD            ,NE,69361-0000,Private      ,0,2,2,22,33,55
00458608,KAPLAN UNIVERSITY - OMAHA               ,NE,68134-1002,Proprietary  ,11,97,108,233,2008,2241
00458609,KAPLAN UNIVERSITY - LINCOLN             ,NE,68508-2668,Proprietary  ,6,78,84,174,1358,1532
00639900,BRYANLGH COLLEGE OF HEALTH SCIENCES     ,NE,68506-1398,Private      ,3,5,8,461,492,953
00640400,NEBR METHODIST CLG OF NURS ALLD HLTH    ,NE,68114-2852,Private      ,0,20,20,544,1177,1721
00689500,UNIVERSITY OF NEBRASKA-MED CTR          ,NE,68198-4265,Public       ,4,11,15,753,2678,3431
00750100,VATTEROTT COLLEGE                       ,NE,68137-1237,Proprietary  ,1,11,12,214,934,1148
00849200,ALEGENT HEALTH SCHOOLS                  ,NE,68114-2767,Private      ,1,5,6,115,315,430
00952300,BAHNER COLLEGE OF HAIRSTYLING           ,NE,68025-3297,Proprietary  ,0,1,1,29,56,85
00961700,CAPITOL BEAUTY SCHOOL                   ,NE,68144-0000,Proprietary  ,3,4,7,168,246,414
00974300,BELLEVUE UNIVERSITY                     ,NE,68005-0000,Private      ,17,275,292,984,10133,11117
00986200,CLARKSON COLLEGE                        ,NE,68131-2739,Private      ,4,47,51,590,1623,2213
01151900,JOSEPH'S COLLEGE OF BEAUTY/ALL CAMPUSES ,NE,68510-2226,Proprietary  ,8,19,27,180,423,603
01166700,NORTHEAST COMMUNITY COLLEGE             ,NE,68702-0000,Public       ,10,43,53,2048,1641,3689
01258600,METROPOLITAN COMMUNITY COLLEGE          ,NE,68103-0000,Public       ,54,229,283,5893,13702,19595
01297600,NEBRASKA CHRISTIAN COLLEGE              ,NE,68046-4256,Private      ,0,0,0,165,72,237
02079700,COLLEGE OF HAIR DESIGN                  ,NE,68508-0000,Proprietary  ,5,10,15,231,260,491
02099500,CENTRAL COMMUNITY COLLEGE-ALL CAMPUSES  ,NE,68801-7299,Public       ,14,74,88,830,1726,2556
02099501,CENTRAL COMMUNITY COLLEGE - HASTINGS CAM,NE,68902-7712,Public       ,0,21,21,1079,946,2025
02099502,CENTRAL COMMUNITY COLLEGE - COLUMBUS CAM,NE,68602-8031,Public       ,2,28,30,581,639,1220
02508300,SOUTHEAST COMM. COLLEGE-ALL CAMPUSES    ,NE,68520-0000,Public       ,29,83,112,5262,7012,12274
02550800,NEBRASKA INDIAN COMMUNITY COLLEGE       ,NE,68039-0000,Public       ,1,16,17,35,197,232
02610500,XENON INTERNATIONAL ACADEMY II          ,NE,68127-3522,Proprietary  ,5,16,21,237,359,596
03164300,THE CREATIVE CENTER                     ,NE,68164-2911,Proprietary  ,0,4,4,157,110,267
03279300,MYOTHERAPY INSTITUTE                    ,NE,68516-0000,Proprietary  ,1,1,2,38,52,90
03323300,LITTLE PRIEST TRIBAL COLLEGE            ,NE,68071-0000,Private      ,0,5,5,31,179,210
03821400,UNIVERSAL COLLEGE OF HEALING ARTS       ,NE,68112-1810,Proprietary  ,1,6,7,26,153,179
00256800,UNIVERSITY OF NEVADA RENO               ,NV,89557-0002,Public       ,51,67,118,16165,7819,23984
00256900,UNIVERSITY OF NEVADA-LAS VEGAS          ,NV,89154-1001,Public       ,99,266,365,22313,20316,42629
00697700,GREAT BASIN COLLEGE                     ,NV,89801-3348,Public       ,4,24,28,738,1725,2463
00732954,ITT TECHNICAL INSTITUTE                 ,NV,89014-6712,Proprietary  ,28,87,115,423,1217,1640
00736700,MARINELLO SCHOOLS OF BEAUTY             ,NV,89110-3563,Proprietary  ,21,64,85,273,615,888
00736701,MARINELLO SCHOOLS OF BEAUTY -           ,NV,89014-2244,Proprietary  ,8,30,38,107,300,407
00737100,MARINELLO SCHOOL OF BEAUTY              ,NV,89502-6530,Proprietary  ,10,31,41,181,429,610
00844103,ANTHEM INSTITUTE - MORRISON UNIVERSITY  ,NV,89521-4826,Proprietary  ,8,46,54,135,765,900
00919200,SIERRA NEVADA COLLEGE                   ,NV,89451-0000,Private      ,3,28,31,612,798,1410
01036200,COLLEGE OF SOUTHERN NEVADA              ,NV,89146-1139,Public       ,206,943,1149,17841,30338,48179
01036300,WESTERN NEVADA COLLEGE                  ,NV,89703-0000,Public       ,16,67,83,1405,3370,4775
01246110,LINCOLN TECHNICAL INSTITUTE-EUPH INST OF,NV,89117-8803,Proprietary  ,7,12,19,166,375,541
01246111,LINCOLN TECHNICAL INSTITUTE-EUPH INS OFB,NV,89052-4964,Proprietary  ,3,14,17,104,239,343
01246112,LINCOLN TECHNICAL INSTITUTE- EUPH INST O,NV,89131-1036,Proprietary  ,2,7,9,177,322,499
01323200,ACADEMY OF HAIR DESIGN                  ,NV,89146-1617,Proprietary  ,8,32,40,235,604,839
02107700,TRUCKEE MEADOWS COMMUNITY CLG           ,NV,89512-0000,Public       ,40,136,176,4985,8511,13496
02237500,EVEREST COLLEGE                         ,NV,89103-0000,Proprietary  ,33,148,181,989,2772,3761
02338512,GLENDALE CAREER COLLEGE - NEVADA CAREER ,NV,89131-3268,Proprietary  ,0,5,5,85,332,417
02616703,SCOTTSDALE CULINARY INSTITUTE - LE CORDO,NV,89144-7047,Proprietary  ,4,11,15,170,510,680
02621500,CAREER COLLEGE OF NORTHERN NEVADA       ,NV,89434-7905,Proprietary  ,10,49,59,303,1024,1327
03030603,UTAH CLG OF MASSAGE THERAPY-NSMT        ,NV,89123-0000,Proprietary  ,7,35,42,173,519,692
03031405,INTERNATIONAL ACADEMY OF DESIGN AND TECH,NV,89074-7750,Proprietary  ,9,20,29,362,658,1020
03043200,KAPLAN COLLEGE                          ,NV,89102-8618,Proprietary  ,30,106,136,882,3139,4021
03076404,BRYMAN SCHOOL OF ARIZONA (THE) - ANTHEM ,NV,89102-4514,Proprietary  ,18,51,69,238,620,858
03088200,CARSON CITY BEAUTY ACADEMY              ,NV,89706-0000,Proprietary  ,0,11,11,54,210,264
03787300,EXPERTISE SCHOOL OF BEAUTY              ,NV,89106-2516,Private      ,4,29,33,109,412,521
03838500,NORTHWEST HEALTH CAREERS                ,NV,89128-0255,Proprietary  ,14,51,65,298,937,1235
03975300,INSTITUTE OF PROFESSIONAL CAREERS       ,NV,89119-7825,Proprietary  ,1,13,14,138,493,631
04051303,ART INSTITUTE OF PHOENIX (THE) - ART INS,NV,89074-7737,Proprietary  ,4,11,15,477,470,947
04065300,ROSEMAN UNIVERSITY OF HEALTH SCIENCES   ,NV,89014-2333,Private      ,3,6,9,669,2438,3107
04114300,NEVADA STATE COLLEGE                    ,NV,89002-9455,Public       ,16,94,110,2272,4298,6570
04142601,TOURO UNIVERSITY - NEVADA               ,NV,89014-8800,Private      ,1,5,6,114,888,1002
04144800,INTERNATIONAL ACADEMY OF STYLE          ,NV,89509-3450,Proprietary  ,3,7,10,91,220,311
04147600,AVEDA INSTITUTE LAS VEGAS               ,NV,89119-6103,Proprietary  ,12,26,38,207,520,727
04171000,ADVANCED TRAINING INSTITUTE             ,NV,89115-7504,Proprietary  ,29,70,99,239,1033,1272
04186300,PAUL MITCHELL THE SCHOOL LAS VEGAS      ,NV,89123-8014,Proprietary  ,10,20,30,347,522,869
04190300,AMERICAN INSTITUTE OF MEDICAL SONOGRAPHY,NV,89146-6597,Proprietary  ,5,19,24,165,660,825
04191100,DESTINATION ACADEMY FOR SPA AND SALON PR,NV,89147-8397,Proprietary  ,0,0,0,69,216,285
04203100,PAUL MITCHELL THE SCHOOL RENO           ,NV,89501-3356,Proprietary  ,8,9,17,191,290,481
04226200,HEALTHCARE PREPARATORY INSTITUTE        ,NV,89130-2580,Proprietary  ,6,18,24,12,51,63
00257200,COLBY-SAWYER COLLEGE                    ,NH,03257-4648,Private      ,0,2,2,2838,164,3002
00257300,DARTMOUTH COLLEGE                       ,NH,03755-3529,Private      ,3,12,15,12472,1974,14446
00257500,FRANKLIN PIERCE UNIVERSITY              ,NH,03461-0060,Private      ,4,25,29,3746,1312,5058
00257900,NEW ENGLAND COLLEGE                     ,NH,03242-3293,Private      ,14,77,91,2464,2260,4724
00258000,SOUTHERN NEW HAMPSHIRE UNIVERSITY       ,NH,03106-1045,Private      ,132,1856,1988,8297,37071,45368
00258100,NHTI  - CONCORD'S COMMUNITY COLLEGE     ,NH,03301-7412,Public       ,12,30,42,3073,2311,5384
00258200,MANCHESTER COMMUNITY COLLEGE            ,NH,03102-8518,Public       ,10,46,56,1592,2171,3763
00258300,GREAT BAY COMMUNITY COLLEGE             ,NH,03801-0000,Public       ,7,19,26,1199,1557,2756
00258600,RIVIER UNIVERSITY                       ,NH,03060-5086,Private      ,2,30,32,1370,1355,2725
00258700,SAINT ANSELM COLLEGE                    ,NH,03102-1310,Private      ,3,5,8,4091,250,4341
00258900,UNIVERSITY OF NEW HAMPSHIRE             ,NH,03824-2511,Public       ,10,20,30,21768,3837,25605
00258903,UNIV OF NEW HAMPSHIRE - SCHOOL OF LAW   ,NH,03301-4115,Public       ,0,3,3,28,552,580
00259000,KEENE STATE COLLEGE                     ,NH,03431-0000,Public       ,8,6,14,8156,834,8990
00259100,PLYMOUTH STATE UNIVERSITY               ,NH,03264-1595,Public       ,4,8,12,7013,1702,8715
00301004,ANTIOCH UNIVERSITY                      ,NH,03431-0000,Private      ,0,5,5,10,852,862
00472900,HESSER COLLEGE                          ,NH,03103-7230,Proprietary  ,13,49,62,406,1365,1771
00472901,HESSER COLLEGE - NASHUA CAMPUS          ,NH,03063-1286,Proprietary  ,4,16,20,162,491,653
00472904,HESSER COLLEGE - PORTSMOUTH CAMPUS      ,NH,03801-3245,Proprietary  ,0,0,0,109,436,545
00472905,HESSER COLLEGE - SALEM CAMPUS           ,NH,03079-2842,Proprietary  ,12,21,33,208,582,790
00472906,HESSER COLLEGE - CONCORD CAMPUS         ,NH,03301-3415,Proprietary  ,0,0,0,84,334,418
00473100,DANIEL WEBSTER COLLEGE                  ,NH,03063-1300,Proprietary  ,2,18,20,817,482,1299
00529100,WHITE MOUNTAINS COMMUNITY COLLEGE       ,NH,03570-3799,Public       ,0,5,5,392,607,999
00702500,LEBANON COLLEGE                         ,NH,03766-0000,Private      ,0,2,2,47,106,153
00755500,LAKES REGION COMMUNITY COLLEGE          ,NH,03246-1326,Public       ,3,10,13,721,864,1585
00756000,RIVER VALLEY COMMUNITY COLLEGE          ,NH,03743-9707,Public       ,6,16,22,453,957,1410
00864500,EMPIRE BEAUTY SCHOOL                    ,NH,03220-0000,Proprietary  ,0,6,6,155,205,360
00923600,NASHUA COMMUNITY COLLEGE                ,NH,03063-2052,Public       ,7,15,22,1321,1291,2612
01318900,CONTINENTAL ACADEMIE OF HAIR DESIGN     ,NH,03051-3754,Proprietary  ,2,1,3,79,50,129
02140400,ST JOSEPH SCH OF PRAC NRSG              ,NH,03060-0000,Private      ,3,11,14,75,299,374
02174800,MICHAEL'S SCHOOL OF HAIR DESIGN & ESTHET,NH,03110-0000,Proprietary  ,0,4,4,124,147,271
02179600,EMPIRE BEAUTY SCHOOL                    ,NH,03878-0000,Proprietary  ,5,10,15,123,169,292
02211600,PORTSMOUTH BTY SCH OF HAIR DESIGN       ,NH,03801-4084,Proprietary  ,0,0,0,35,40,75
02245400,KEENE BEAUTY ACADEMY                    ,NH,03431-0000,Proprietary  ,0,1,1,50,57,107
02247000,NEW ENGLAND SCHOOL OF HAIR DESIGN       ,NH,03784-0000,Proprietary  ,1,3,4,56,51,107
03043100,THOMAS MORE COLLEGE OF LIBERAL ARTS     ,NH,03054-4818,Private      ,0,0,0,112,30,142
03101300,GRANITE STATE COLLEGE                   ,NH,03301-6400,Public       ,2,27,29,484,2536,3020
03182300,NEW HAMPSHIRE INSTITUTE OF ART          ,NH,03104-4858,Private      ,1,4,5,745,225,970
03437300,UPPER VALLEY TEACHER TRANING PROGRAM    ,NH,03766-1358,Private      ,0,1,1,3,44,47
03729300,NH INSTITUTE FOR THERAPEUTIC ARTS       ,NH,03051-4906,Proprietary  ,0,0,0,11,50,61
04162200,LAIRD INSTITUTE OF SPA THERAPY          ,NH,03102-5263,Proprietary  ,3,12,15,26,107,133
00267000,BAPTIST BIBLE COLG OF PENNSYLVANIA      ,PA,18411-1297,Private      ,2,11,13,605,520,1125
00322800,BRYN ATHYN COLLEGE OF THE NEW CHURCH    ,PA,19009-0717,Private      ,2,0,2,310,50,360
00322900,ALBRIGHT COLLEGE                        ,PA,19612-5234,Private      ,8,15,23,4547,1429,5976
00323000,ALLEGHENY COLLEGE                       ,PA,16335-3902,Private      ,4,1,5,3862,149,4011
00323100,COMM CLG OF ALLEGHENY-ALLEGHENY CMP     ,PA,15212-0000,Public       ,39,138,177,3630,7144,10774
00323101,"COMM CLG OF ALLEGHENY, BOYCE CAMPUS     ",PA,15146-0000,Public       ,19,62,81,1721,2898,4619
00323102,"COMM CLG OF ALLEGHENY, NORTH CAMPUS     ",PA,15237-0000,Public       ,31,71,102,2078,2971,5049
00323103,"COMM CLG OF ALLEGHENY, SOUTH CAMPUS     ",PA,15122-0000,Public       ,12,51,63,1999,2638,4637
00323300,ALVERNIA UNIVERSITY                     ,PA,19607-1799,Private      ,12,31,43,2610,1851,4461
00323500,ARCADIA UNIVERSITY                      ,PA,19038-3295,Private      ,5,24,29,6561,2203,8764
00323700,BRYN MAWR COLLEGE                       ,PA,19010-2899,Private      ,1,4,5,1844,632,2476
00323800,BUCKNELL UNIVERSITY                     ,PA,17837-2122,Private      ,4,1,5,5462,226,5688
00323900,BUCKS COUNTY COMMUNITY COLLEGE          ,PA,18940-1320,Public       ,37,89,126,4661,4514,9175
00324000,BUTLER COUNTY COMMUNITY COLLEGE         ,PA,16001-0000,Public       ,27,61,88,2174,2227,4401
00324100,CABRINI COLLEGE                         ,PA,19087-3698,Private      ,3,32,35,2111,1119,3230
00324200,CARNEGIE MELLON UNIVERSITY              ,PA,15213-3890,Private      ,7,10,17,13700,1853,15553
00324201,CARNEGIE MELLON UNIV- THE HEINZ COLLEGE ,PA,15213-0000,Private      ,0,4,4,174,716,890
00324202,CARNEGIE MELLON- TEPPER SCHOOL OF BUSINE,PA,15213-0000,Private      ,0,6,6,270,592,862
00324300,CEDAR CREST COLLEGE                     ,PA,18104-6196,Private      ,2,36,38,1128,1555,2683
00324400,CHATHAM UNIVERSITY                      ,PA,15232-2826,Private      ,2,24,26,768,1956,2724
00324500,CHESTNUT HILL COLLEGE                   ,PA,19118-2693,Private      ,2,42,44,1844,2583,4427
00324700,MISERICORDIA  UNIVERSITY                ,PA,18612-1008,Private      ,3,23,26,2811,1571,4382
00324900,COMMUNITY COLLEGE OF PHILADELPHIA       ,PA,19130-3991,Public       ,131,517,648,14222,25653,39875
00325100,CURTIS INSTITUTE OF MUSIC               ,PA,19103-6187,Private      ,0,0,0,333,147,480
00325200,DELAWARE VALLEY COLLEGE                 ,PA,18901-2697,Private      ,7,10,17,2412,490,2902
00325300,DICKINSON COLLEGE                       ,PA,17013-2896,Private      ,2,3,5,3667,177,3844
00325600,DREXEL UNIVERSITY                       ,PA,19104-2875,Private      ,62,275,337,35488,20356,55844
00325800,DUQUESNE UNIVERSITY                     ,PA,15282-0001,Private      ,4,69,73,8341,4175,12516
00325900,EASTERN UNIVERSITY                      ,PA,19087-3696,Private      ,8,66,74,2455,2926,5381
00326200,ELIZABETHTOWN COLLEGE                   ,PA,17022-2298,Private      ,2,12,14,3281,837,4118
00326300,EVANGELICAL SCHOOL OF THEOLOGY          ,PA,17067-0000,Private      ,0,1,1,0,90,90
00326500,FRANKLIN & MARSHALL COLLEGE             ,PA,17604-0000,Private      ,3,4,7,3643,215,3858
00326600,GANNON UNIVERSITY                       ,PA,16541-0001,Private      ,4,15,19,3826,1582,5408
00326700,GENEVA COLLEGE                          ,PA,15010-3599,Private      ,0,7,7,1914,952,2866
00326800,GETTYSBURG COLLEGE                      ,PA,17325-1486,Private      ,1,4,5,4380,210,4590
00326900,GROVE CITY COLLEGE                      ,PA,16127-2104,Private      ,1,1,2,1929,72,2001
00327000,GWYNEDD-MERCY COLLEGE                   ,PA,19437-0901,Private      ,2,22,24,1656,1843,3499
00327200,HARCUM COLLEGE                          ,PA,19010-3476,Private      ,4,16,20,1075,1994,3069
00327300,HARRISBURG AREA COMMUNITY COLLEGE       ,PA,17110-2999,Public       ,127,448,575,10442,17256,27698
00327400,HAVERFORD COLLEGE                       ,PA,19041-1392,Private      ,0,1,1,2204,76,2280
00327500,HOLY FAMILY UNIVERSITY                  ,PA,19114-2094,Private      ,9,27,36,2293,2208,4501
00327600,IMMACULATA UNIVERSITY                   ,PA,19345-0647,Private      ,2,44,46,1923,1991,3914
00327700,INDIANA UNIVERSITY OF PENNSYLVANIA      ,PA,15705-1097,Public       ,154,76,230,15631,4308,19939
00327900,JUNIATA COLLEGE                         ,PA,16652-2196,Private      ,1,1,2,2627,134,2761
00328000,KEYSTONE COLLEGE                        ,PA,18440-0200,Private      ,9,19,28,1783,819,2602
00328200,KINGS COLLEGE                           ,PA,18711-0801,Private      ,7,11,18,3312,645,3957
00328300,LACKAWANNA COLLEGE                      ,PA,18509-9961,Private      ,8,18,26,1970,1261,3231
00328400,LAFAYETTE COLLEGE                       ,PA,18042-1768,Private      ,4,3,7,4607,158,4765
00328500,LANCASTER BIBLE COLLEGE                 ,PA,17601-5036,Private      ,3,28,31,849,1276,2125
00328600,LANCASTER THEOLOGICAL SEMINARY          ,PA,17603-0000,Private      ,0,3,3,3,138,141
00328700,LASALLE UNIVERSITY                      ,PA,19141-1199,Private      ,33,102,135,6881,4753,11634
00328800,LEBANON VALLEY COLLEGE                  ,PA,17003-1400,Private      ,3,4,7,3127,337,3464
00328900,LEHIGH UNIVERSITY                       ,PA,18015-1588,Private      ,7,15,22,9579,1100,10679
00329000,LINCOLN UNIVERSITY                      ,PA,19352-0999,Public       ,10,7,17,3870,1443,5313
00329100,LUTHERAN THEOLOG SEMINARY-GETTYSBRG     ,PA,17325-0000,Private      ,0,1,1,2,94,96
00329200,LUTHERAN THEOLOGICAL SEMINARY           ,PA,19119-0000,Private      ,0,0,0,2,207,209
00329300,LYCOMING COLLEGE                        ,PA,17701-5192,Private      ,1,2,3,2021,197,2218
00329400,MANOR COLLEGE                           ,PA,19046-3399,Private      ,5,4,9,764,651,1415
00329600,MARYWOOD UNIVERSITY                     ,PA,18509-1598,Private      ,6,22,28,3017,1594,4611
00329700,MERCYHURST UNIVERSITY                   ,PA,16546-0001,Private      ,6,13,19,4331,1945,6276
00329800,MESSIAH COLLEGE                         ,PA,17027-0000,Private      ,2,12,14,3587,521,4108
00330000,MOORE COLLEGE OF ART & DESIGN           ,PA,19103-1179,Private      ,3,7,10,670,432,1102
00330100,MORAVIAN COLLEGE                        ,PA,18018-6650,Private      ,1,5,6,2231,433,2664
00330101,MORAVIAN THEOLOGICAL SEMINARY           ,PA,18018-0000,Private      ,0,0,0,19,68,87
00330200,MOUNT ALOYSIUS COLLEGE                  ,PA,16630-1999,Private      ,3,12,15,1500,983,2483
00330300,CARLOW UNIVERSITY                       ,PA,15213-3165,Private      ,2,25,27,1311,2291,3602
00330400,MUHLENBERG COLLEGE                      ,PA,18104-5586,Private      ,1,12,13,4221,483,4704
00330600,VALLEY FORGE CHRISTIAN COLLEGE          ,PA,19460-2399,Private      ,4,3,7,856,318,1174
00330900,PEIRCE COLLEGE                          ,PA,19102-4699,Private      ,8,90,98,650,3157,3807
00331100,SALUS UNIVERSITY                        ,PA,19027-1598,Private      ,0,4,4,8,1169,1177
00331300,WIDENER UNIVERSITY                      ,PA,19013-5792,Private      ,9,18,27,5189,2895,8084
00331302,WIDENER UNIV SCH OF LAW- HARRISBURG     ,PA,17106-9381,Private      ,0,4,4,40,656,696
00331500,BLOOMSBURG UNIVERSITY OF PA             ,PA,17815-1301,Public       ,53,23,76,13403,2357,15760
00331600,CALIFORNIA UNIV OF PENNSYLVANIA         ,PA,15419-1394,Public       ,14,58,72,6735,4768,11503
00331700,CHEYNEY UNIVERSITY OF PENNSYLVANIA      ,PA,19319-0200,Public       ,12,10,22,2223,1081,3304
00331800,CLARION UNIVERSITY OF PENNSYLVANIA      ,PA,16214-1232,Public       ,20,21,41,5235,2542,7777
00332000,EAST STROUDSBURG UNIVERSITY             ,PA,18301-2999,Public       ,59,34,93,8080,2174,10254
00332100,EDINBORO UNIVERSITY OF PENNSYLVANIA     ,PA,16444-0001,Public       ,16,63,79,6193,3220,9413
00332200,KUTZTOWN UNIVERSITY OF PENNSYLVANIA     ,PA,19530-9339,Public       ,29,27,56,12044,2477,14521
00332300,LOCK HAVEN UNIV OF PENNSYLVANIA         ,PA,17745-2439,Public       ,118,41,159,6323,1599,7922
00332400,MANSFIELD UNIVERSITY                    ,PA,16933-1123,Public       ,70,18,88,3248,988,4236
00332500,MILLERSVILLE UNIVERSITY OF PA           ,PA,17551-1800,Public       ,16,18,34,9167,2737,11904
00332600,SHIPPENSBURG UNIVERSITY                 ,PA,17257-2299,Public       ,23,26,49,8953,1931,10884
00332700,SLIPPERY ROCK UNIVERSITY                ,PA,16057-1326,Public       ,16,68,84,8933,2378,11311
00332800,WEST CHESTER UNIVERSITY                 ,PA,19383-0001,Public       ,115,51,166,18962,5415,24377
00332900,PENN STATE UNIVERSITY                   ,PA,16802-1503,Public       ,603,471,1074,73885,30301,104186
00335000,UNIVERSITY OF THE ARTS (THE)            ,PA,19102-9493,Private      ,9,4,13,3340,806,4146
00335100,CAIRN UNIVERSITY                        ,PA,19047-2942,Private      ,2,2,4,791,534,1325
00335200,PHILADELPHIA CLG OSTEOPATHIC MED        ,PA,19131-0000,Private      ,0,11,11,54,3510,3564
00335300,UNIVERSITY OF THE SCIENCES IN PHILADELPH,PA,19104-4495,Private      ,4,5,9,3703,1636,5339
00335400,PHILADELPHIA UNIVERSITY                 ,PA,19144-5497,Private      ,7,49,56,4842,2654,7496
00335600,PITTSBURGH THEOLOGICAL SEMINARY         ,PA,15206-0000,Private      ,0,1,1,6,197,203
00335700,POINT PARK UNIVERSITY                   ,PA,15222-1912,Private      ,7,47,54,3712,2549,6261
00335800,REFORMED PRESBYTERIAN THEOL SEMINAR     ,PA,15208-0000,Private      ,0,0,0,0,26,26
00335900,ROBERT MORRIS UNIVERSITY                ,PA,15108-1189,Private      ,15,43,58,5580,2410,7990
00336000,ROSEMONT COLLEGE                        ,PA,19010-1699,Private      ,3,10,13,789,702,1491
00336200,SETON HILL UNIVERSITY                   ,PA,15601-1599,Private      ,2,10,12,2378,984,3362
00336400,ST. CHARLES BORROMEO SEMINARY           ,PA,19096-0000,Private      ,0,0,0,45,41,86
00336600,SAINT FRANCIS UNIVERSITY                ,PA,15940-0600,Private      ,2,29,31,2178,859,3037
00336700,SAINT JOSEPH'S UNIVERSITY               ,PA,19131-1395,Private      ,4,141,145,7922,4398,12320
00336800,ST VINCENT COLLEGE                      ,PA,15650-2690,Private      ,2,3,5,2185,318,2503
00336900,SUSQUEHANNA UNIVERSITY                  ,PA,17870-1001,Private      ,5,2,7,3321,141,3462
00337000,SWARTHMORE COLLEGE                      ,PA,19081-1397,Private      ,1,1,2,3929,139,4068
00337100,TEMPLE UNIVERSITY                       ,PA,19122-6003,Private      ,92,172,264,36791,22125,58916
00337600,THIEL COLLEGE                           ,PA,16125-2181,Private      ,2,2,4,1980,179,2159
00337800,UNIVERSITY OF PENNSYLVANIA              ,PA,19104-6216,Private      ,19,99,118,22328,13462,35790
00337900,UNIVERSITY OF PITTSBURGH                ,PA,15260-0000,Public       ,47,140,187,31458,11322,42780
00337906,UNIVERSITY OF PITTSBURGH - SCHOOL OF MED,PA,15261-0001,Public       ,1,2,3,223,1039,1262
00337907,UNIVERSITY OF PITTSBURGH - SCHOOL OF DEN,PA,15261-2523,Public       ,1,1,2,93,413,506
00338400,UNIVERSITY OF SCRANTON                  ,PA,18510-4622,Private      ,12,68,80,8051,1880,9931
00338500,URSINUS COLLEGE                         ,PA,19426-1000,Private      ,2,1,3,3153,130,3283
00338600,VALLEY FORGE MILITARY COLLEGE           ,PA,19087-3695,Private      ,4,2,6,519,70,589
00338800,VILLANOVA UNIVERSITY                    ,PA,19085-1699,Private      ,10,56,66,12724,3326,16050
00338801,VILLANOVA UNIV SCH OF LAW               ,PA,19085-0000,Private      ,0,2,2,33,1066,1099
00338900,WASHINGTON & JEFFERSON COLLEGE          ,PA,15301-4801,Private      ,3,1,4,2738,112,2850
00339100,WAYNESBURG UNIVERSITY                   ,PA,15370-1222,Private      ,1,18,19,2152,868,3020
00339200,WESTMINSTER COLLEGE                     ,PA,16172-0002,Private      ,1,4,5,2394,184,2578
00339300,WESTMINSTER THEOLOGICAL SEMINARY        ,PA,19038-0000,Private      ,0,0,0,3,326,329
00339400,WILKES UNIVERSITY                       ,PA,18766-0998,Private      ,7,38,45,3699,1561,5260
00339500,PENNSYLVANIA COLLEGE OF TECHNOLOGY      ,PA,17701-5779,Public       ,9,15,24,5468,2438,7906
00339600,WILSON COLLEGE                          ,PA,17201-1285,Private      ,1,7,8,419,434,853
00339900,YORK COLLEGE OF PENNSYLVANIA            ,PA,17405-7199,Private      ,8,21,29,9242,1606,10848
00398600,DESALES UNIVERSITY                      ,PA,18034-9568,Private      ,5,28,33,2867,1761,4628
00398700,LA ROCHE COLLEGE                        ,PA,15237-5898,Private      ,6,7,13,1261,673,1934
00398800,NEUMANN UNIVERSITY                      ,PA,19014-1298,Private      ,11,32,43,3365,1539,4904
00405800,GRATZ COLLEGE                           ,PA,19027-3097,Private      ,0,5,5,4,143,147
00445200,MONTGOMERY COUNTY COMMUNITY COLLEGE     ,PA,19422-6300,Public       ,47,122,169,5846,6768,12614
00488900,CAMBRIA-ROWE BUSINESS COLLEGE           ,PA,15902-2494,Proprietary  ,4,12,16,149,316,465
00488901,CAMBRIA ROWE BUSINESS COLLEGE - INDIANA ,PA,15701-2804,Proprietary  ,2,8,10,25,67,92
00489000,CENTRAL PENNSYLVANIA COLLEGE            ,PA,17093-0309,Proprietary  ,8,16,24,1185,1693,2878
00489300,DU BOIS BUSINESS COLLEGE                ,PA,15801-2401,Proprietary  ,2,8,10,162,314,476
00489400,ERIE BUSINESS CENTER                    ,PA,16501-1305,Proprietary  ,2,21,23,96,422,518
00489401,ERIE BUSINESS CENTER - NEW CASTLE CAMPUS,PA,16101-3950,Proprietary  ,2,10,12,40,143,183
00489800,MCCANN SCHOOL OF BUSINESS & TECHNOL     ,PA,17901-1335,Proprietary  ,71,389,460,1883,6964,8847
00489807,MCCANN SCHOOL OF BUSINESS & TECHNOLOGY -,PA,17013-3180,Proprietary  ,1,0,1,48,129,177
00489900,MERCY HOSP SCH OF NURSING               ,PA,15219-5166,Private      ,3,3,6,174,295,469
00490100,NEWPORT BUSINESS INSTITUTE              ,PA,15068-3929,Proprietary  ,0,0,0,24,71,95
00490200,PENN COMMERCIAL BUSINESS/TECHNICAL SCHL ,PA,15301-2871,Proprietary  ,0,6,6,250,463,713
00491000,KAPLAN CAREER INSTITUTE                 ,PA,17111-3571,Proprietary  ,9,40,49,295,1007,1302
00491001,THOMPSON INSTITUTE-PHILADEPHIA CAMPUS   ,PA,19104-3386,Proprietary  ,16,40,56,440,1094,1534
00491400,NEWPORT BUSINESS INSTITUTE              ,PA,17701-5855,Proprietary  ,0,0,0,15,103,118
00500701,WEST VIRGINIA CAREER INSTITUTE          ,PA,15456-0000,Proprietary  ,3,11,14,77,142,219
00531000,PITTSBURGH INST OF AERONAUTICS          ,PA,15236-0000,Private      ,0,4,4,405,343,748
00533000,FAYETTE CNTY AREA VOC TECH PRC NRSG     ,PA,15401-0000,Public       ,1,2,3,55,129,184
00533500,CENTRAL PENN INST OF SCI & TECH PNP     ,PA,16823-0000,Public       ,1,3,4,170,288,458
00536500,YORK CO AREA VOC-TECH SCH-PRAC NSG      ,PA,17402-0000,Public       ,2,15,17,77,428,505
00653400,CITIZENS SCHOOL OF NURSING              ,PA,15068-6591,Private      ,1,3,4,111,197,308
00653700,CONEMAUGH VLY MEM HOSP SCH NRSNG        ,PA,15905-4398,Private      ,0,2,2,123,141,264
00653702,CONEMAUGH HOSP- SCH HISTOTECHNOLOGY     ,PA,15905-0000,Private      ,0,0,0,6,9,15
00653704,CONEMAUGH VLY MEM HOSP SCH RAD TECH     ,PA,15905-0000,Private      ,0,1,1,35,31,66
00653706,CONEMAUGH VLY MEM HOSP SCH  MED TECH    ,PA,15905-4398,Private      ,0,0,0,14,17,31
00655100,ST MARGARET SCHL OF NURSING             ,PA,15238-3205,Private      ,1,3,4,113,263,376
00656000,OHIO VALLEY HOSP SCH OF NURSING         ,PA,15136-1694,Private      ,0,0,0,31,69,100
00656500,READING HOSPITAL SCHOOL OF HEALTH SCIENC,PA,19611-1744,Private      ,4,4,8,289,537,826
00657400,"ST LUKE'S HOSPITAL OF BETHLEHEM, PA     ",PA,18015-1065,Private      ,2,3,5,105,291,396
00657600,SEWICKLEY VALLEY HOSP SCH NRSNG         ,PA,15143-1498,Private      ,0,0,0,25,59,84
00657700,UPMC SHADYSIDE SCHOOL OF NURSING        ,PA,15232-1381,Private      ,2,4,6,243,541,784
00657800,SHARON REGIONAL SCHOOL OF NURSING       ,PA,16146-3395,Private      ,0,1,1,27,65,92
00658200,WASHINGTON HOSP SCH OF NURSING          ,PA,15301-3398,Private      ,0,2,2,49,125,174
00658202,WASHINGTON HOSP SCH OF RAD TECH         ,PA,15301-3398,Private      ,0,0,0,18,27,45
00658300,WESTERN PENN HOSP-SCH OF NURSING        ,PA,15224-1790,Private      ,2,3,5,147,252,399
00680700,COMMUNITY COLLEGE OF BEAVER COUNTY      ,PA,15061-2588,Public       ,21,38,59,1420,1652,3072
00681000,LEHIGH CARBON COMMUNITY COLLEGE         ,PA,18078-2598,Public       ,19,55,74,3626,4583,8209
00681100,LUZERNE COUNTY COMMUNITY COLLEGE        ,PA,18634-3899,Public       ,30,83,113,3511,4274,7785
00708700,ABINGTON MEM HOSP SCHL OF NURSING       ,PA,19090-1284,Private      ,0,3,3,127,410,537
00709100,EVEREST INSTITUTE                       ,PA,15222-1320,Proprietary  ,15,94,109,310,1159,1469
00711000,DELAWARE COUNTY COMMUNITY COLLEGE       ,PA,19063-1094,Public       ,52,249,301,7208,10167,17375
00719100,NORTHAMPTON COMMUNITY COLLEGE           ,PA,18020-7599,Public       ,40,118,158,7069,7316,14385
00730305,LINCOLN TECHNICAL INSTITUTE - PHILADELPH,PA,19136-1530,Proprietary  ,26,31,57,402,547,949
00732955,ITT TECHNICAL INSTITUTE                 ,PA,19406-1212,Proprietary  ,17,62,79,313,825,1138
00743000,ANTONELLI INST OF ART & PHOTOGRAPHY     ,PA,19038-8242,Proprietary  ,3,0,3,246,68,314
00743600,KAPLAN CAREER INSTITUTE - ICM CAMPUS    ,PA,15222-1977,Proprietary  ,9,57,66,287,1156,1443
00743700,PITTSBURGH TECHNICAL INSTITUTE          ,PA,15071-3205,Proprietary  ,11,23,34,2337,1297,3634
00746900,"HUSSIAN SCHOOL OF ART, INC.             ",PA,19106-0000,Proprietary  ,0,0,0,117,39,156
00747000,"ART INSTITUTE OF PITTSBURGH, THE        ",PA,15219-1328,Proprietary  ,293,1721,2014,5376,21094,26470
00752900,"CHESTER COUNTY INTERMEDIATE UNIT, PNP   ",PA,19335-3043,Public       ,0,2,2,46,184,230
00757307,EMPIRE BEAUTY SCHOOL - WARMINSTER       ,PA,18974-4508,Proprietary  ,0,0,0,127,295,422
00777900,LANSDALE SCHOOL OF BUSINESS             ,PA,19454-4114,Proprietary  ,3,24,27,120,488,608
00778000,NEW CASTLE SCHOOL OF TRADES             ,PA,16143-0000,Proprietary  ,11,52,63,476,975,1451
00778100,CHI INSTITUTE/RETS CAMPUS               ,PA,19008-3516,Proprietary  ,10,37,47,175,622,797
00783900,TRIANGLE TECH                           ,PA,15214-3897,Proprietary  ,17,29,46,298,473,771
00791200,THADDEUS STEVENS CLG OF TECHNOLOGY      ,PA,17602-0000,Public       ,10,8,18,1415,653,2068
00791600,FRANKLIN CNTY CAREER & TECH CTR-PNP     ,PA,17201-0000,Public       ,0,3,3,34,148,182
00793807,LINCOLN TECHNICAL INSITUTE - ALLENTOWN  ,PA,18104-3212,Proprietary  ,28,54,82,387,918,1305
00817803,EMPIRE BEAUTY SCHOOL - HARRISBURG       ,PA,17109-2210,Proprietary  ,0,0,0,86,193,279
00817804,EMPIRE BEAUTY SCHOOL - WILLIAMSPORT     ,PA,17701-3914,Proprietary  ,0,0,0,78,140,218
00817806,EMPIRE BEAUTY SCHOOL - LEBANON          ,PA,17042-5209,Proprietary  ,0,0,0,27,38,65
00817809,EMPIRE BEAUTY SCHOOL - CENTER CITY PHILA,PA,19102-2701,Proprietary  ,0,0,0,190,429,619
00820000,JAMESON MEMORIAL HOSP SCH NURSING       ,PA,16105-2595,Private      ,1,1,2,46,105,151
00835000,ART INSTITUTE OF PHILADELPHIA           ,PA,19103-5198,Proprietary  ,36,64,100,3398,3168,6566
00844100,ANTHEM INSTITUTE                        ,PA,19064-1243,Proprietary  ,12,54,66,146,540,686
00856800,VET TECH INSTITUTE                      ,PA,15222-3400,Proprietary  ,0,2,2,419,227,646
00865300,JEFFERSON CO DUBOIS VOC TECH-PR NSG     ,PA,15851-0000,Public       ,0,0,0,22,49,71
00895500,PRUONTOS HAIR DESIGN INSTITUTE          ,PA,16602-0000,Proprietary  ,0,1,1,35,43,78
00915705,WYOMING TECHNICAL INSTITUTE - BLAIRSVILL,PA,15717-8060,Proprietary  ,54,61,115,1375,1200,2575
00918600,DEAN INSTITUTE OF TECHNOLOGY            ,PA,15226-1197,Proprietary  ,2,15,17,65,237,302
00944900,PENNCO TECH                             ,PA,19007-0000,Proprietary  ,18,47,65,348,767,1115
00966400,EMPIRE BEAUTY SCHOOL                    ,PA,18052-5730,Proprietary  ,43,130,173,449,1115,1564
00966405,EMPIRE BEAUTY SCHOOL - MONROEVILLE      ,PA,15146-2229,Proprietary  ,0,0,0,116,213,329
00966408,EMPIRE BEAUTY SCHOOL - LANCASTER        ,PA,17604-4335,Proprietary  ,0,0,0,131,242,373
00966411,EMPIRE BEAUTY SCHOOL - SHAMOKIN DAM     ,PA,17876-0397,Proprietary  ,0,0,0,27,33,60
00966412,EMPIRE BEAUTY SCHOOL - EXTON            ,PA,19341-2804,Proprietary  ,0,0,0,150,237,387
00966600,EMPIRE BEAUTY SCHOOL                    ,PA,19605-2803,Proprietary  ,0,0,0,114,227,341
00972100,BRADFORD SCHOOL                         ,PA,15219-2602,Proprietary  ,1,3,4,605,224,829
00972300,ARIA HEALTH SCHOOL OF NURSING           ,PA,19053-6939,Private      ,0,1,1,160,391,551
00978300,GORDON PHILLIPS SCH OF BEAUTY CULT      ,PA,19135-0000,Proprietary  ,0,0,0,166,302,468
00986300,LANCASTER GENERAL COLLEGE OF NURSING AND,PA,17602-4955,Private      ,0,15,15,716,1302,2018
01000600,GREATER JOHNSTOWN AREA VOC TECH SCH     ,PA,15904-0000,Public       ,1,4,5,101,309,410
01005500,CRAWFORD CNTY AREA VO-TECH PRAC NUR     ,PA,16335-0000,Public       ,1,0,1,19,42,61
01017600,WESTMORELAND COUNTY COMMUNITY CLG       ,PA,15697-1895,Public       ,42,130,172,3251,4033,7284
01038800,READING AREA COMMUNITY COLLEGE          ,PA,19603-1706,Public       ,72,195,267,2574,4856,7430
01054200,EMPIRE BEAUTY SCHOOL                    ,PA,18701-0000,Proprietary  ,47,116,163,438,968,1406
01054205,EMPIRE BEAUTY SCHOOL - YORK             ,PA,17402-2862,Proprietary  ,0,0,0,126,243,369
01081400,PITTSBURGH INST MORTUARY SCIENCE        ,PA,15206-3706,Private      ,0,6,6,128,346,474
01086000,GREATER ALTOONA CAREER/TECH CENTER      ,PA,16602-0000,Public       ,0,1,1,134,284,418
01096300,GREENE COUNTY VOC-TECH SCHOOL           ,PA,15370-0000,Public       ,1,1,2,16,41,57
01099800,PENNSYLVANIA INSTITUTE OF TECH          ,PA,19063-4098,Private      ,6,65,71,503,1038,1541
01162100,AUTOMOTIVE TRAINING CENTER              ,PA,19341-1310,Proprietary  ,98,30,128,1147,533,1680
01162200,WELDER TRAINING & TESTING INST          ,PA,18109-3253,Proprietary  ,1,4,5,50,146,196
01171500,SCHUYLKILL HEALTH SCHOOL OF NURSING     ,PA,17901-3692,Private      ,1,0,1,71,69,140
01191900,BEAVER FALLS BEAUTY ACADEMY             ,PA,15010-4208,Proprietary  ,1,5,6,25,67,92
01205000,ROSEDALE TECHNICAL INSTITUTE            ,PA,15205-9791,Private      ,7,23,30,361,433,794
01239300,THOMAS JEFF UNIV-CLG ALLIED HEALTH      ,PA,19107-0000,Private      ,1,14,15,362,1579,1941
01239301,THOMAS JEFFERSON UNIVERSITY - JEFFERSON ,PA,19107-5001,Private      ,0,31,31,456,2838,3294
01239303,THOMAS JEFFERSON UNIVERSITY - COLLEGE OF,PA,19107-6731,Private      ,1,13,14,256,1078,1334
01246104,LINCOLN TECHNICAL INSTITUTE             ,PA,19104-0202,Proprietary  ,16,55,71,411,908,1319
01246105,LINCOLN TECHNICAL INSTITUTE             ,PA,19116-4202,Proprietary  ,5,28,33,295,665,960
01252300,TALMUDICAL YESHIVA OF PHILA             ,PA,19131-1296,Private      ,3,0,3,48,6,54
01260500,EMPIRE BEAUTY SCHOOL                    ,PA,17331-2405,Proprietary  ,0,0,0,66,182,248
01260600,EMPIRE BEAUTY SCHOOL                    ,PA,17901-3859,Proprietary  ,36,100,136,375,1017,1392
01260607,EMPIRE BEAUTY SCHOOL - STATE COLLEGE    ,PA,16801-5218,Proprietary  ,0,0,0,41,40,81
01292900,SOUTH HILLS BEAUTY ACADEMY              ,PA,15216-2335,Proprietary  ,9,16,25,82,187,269
01313400,YESHIVATH BETH MOSHE                    ,PA,18505-2196,Private      ,2,1,3,35,13,48
01321400,ROXBOROUGH MEM HOSP SCH OF NURSING      ,PA,19128-0000,Proprietary  ,0,7,7,105,389,494
01326300,SOUTH HILLS SCHOOL OF BUSINESS & TECHNOL,PA,16801-4516,Proprietary  ,3,0,3,574,517,1091
02061000,VENUS BEAUTY ACADEMY                    ,PA,19079-0000,Proprietary  ,1,3,4,74,99,173
02068300,DOUGLAS SCHOOL OF BUSINESS              ,PA,15062-0000,Proprietary  ,4,9,13,290,267,557
02090200,TRIANGLE TECH                           ,PA,16502-0000,Proprietary  ,4,4,8,127,125,252
02092500,LAUREL TECHNICAL INSTITUTE              ,PA,16146-0000,Proprietary  ,9,24,33,193,380,573
02092502,BUSINESS INSTITUTE OF PENNSYLVANIA      ,PA,16335-0000,Proprietary  ,0,0,0,11,32,43
02104003,HARRIS SCHOOL OF BUSINESS - UPPER DARBY ,PA,19082-2528,Proprietary  ,0,1,1,35,54,89
02107300,PENNSYLVANIA ACADEMY OF FINE ARTS       ,PA,19102-1424,Private      ,1,4,5,319,349,668
02112200,GREAT LAKES INSTITUTE OF TECHNOLOGY     ,PA,16509-0000,Proprietary  ,8,16,24,436,589,1025
02114200,JOHNSON COLLEGE                         ,PA,18508-0000,Private      ,1,6,7,523,354,877
02116001,SANFORD-BROWN INSTITUTE - TREVOSE       ,PA,19053-4700,Proprietary  ,0,0,0,60,139,199
02118000,LEVITTOWN BEAUTY ACADEMY LLC            ,PA,19054-1713,Proprietary  ,3,2,5,42,53,95
02119300,PA ACAD OF COSMETOLOGY ARTS & SCI       ,PA,15904-0000,Proprietary  ,3,9,12,68,100,168
02120800,"YORKTOWNE BUSINESS INSTITUTE, INC.      ",PA,17404-0000,Proprietary  ,3,20,23,123,360,483
02127400,YORK TECHNICAL INSTITUTE                ,PA,17402-0000,Proprietary  ,23,78,101,1296,2003,3299
02129000,TRIANGLE TECH                           ,PA,15601-0000,Proprietary  ,10,21,31,316,331,647
02129001,TRIANGLE TECH - BUSINESS CAREERS INSTITU,PA,15601-3304,Proprietary  ,0,0,0,8,21,29
02144000,"VISION ACADEMY, THE                     ",PA,18103-0000,Proprietary  ,0,9,9,37,132,169
02151500,CENTRAL SUSQUEHANNA LPN CENTER          ,PA,17837-8818,Public       ,0,0,0,57,175,232
02153500,OAKBRIDGE ACADEMY OF ARTS               ,PA,15068-0000,Proprietary  ,0,0,0,71,15,86
02158300,JUNIATA-MIFFLIN CO AREA VOC TECH        ,PA,17044-0000,Public       ,0,0,0,17,66,83
02161400,NORTHEASTERN HOSP SCH OF NRSG           ,PA,19134-0000,Private      ,0,11,11,94,329,423
02169600,CLEARFIELD CTY CAREER AND TECH CNTR     ,PA,16830-0000,Public       ,0,2,2,52,137,189
02174400,TRIANGLE TECH                           ,PA,15801-0000,Proprietary  ,22,17,39,380,253,633
02178900,ACADEMY OF HAIR DESIGN                  ,PA,18202-1465,Proprietary  ,6,20,26,151,318,469
02183000,ORLEANS TECHNICAL INSTITUTE             ,PA,19111-0000,Private      ,6,31,37,250,774,1024
02192800,WALNUT HILL COLLEGE                     ,PA,19104-0000,Proprietary  ,3,14,17,569,474,1043
02202300,SANFORD-BROWN INSTITUTE                 ,PA,15219-1907,Proprietary  ,2,2,4,193,669,862
02202301,SANFORD-BROWN INSTITUTE                 ,PA,15146-2141,Proprietary  ,0,0,0,42,130,172
02203900,ERIE INSTITUTE OF TECHNOLOGY            ,PA,16565-1002,Proprietary  ,3,25,28,224,330,554
02206200,"VISION ACADEMY, THE                     ",PA,19002-0000,Proprietary  ,2,8,10,97,158,255
02206300,STROUDSBURG SCHOOL OF COSMETOLOGY       ,PA,18360-0000,Proprietary  ,3,7,10,71,73,144
02212700,LANCASTER SCHOOL OF COSMETOLOGY         ,PA,17602-0000,Proprietary  ,3,10,13,77,200,277
02234200,ACADEMY OF MEDICAL ARTS & BUSINESS      ,PA,17112-0000,Proprietary  ,8,26,34,278,539,817
02251200,SCHUYLKILL COUNTY AREA VOC TECH SCH     ,PA,17931-0000,Public       ,1,9,10,25,148,173
02251202,SCHUYLKILL COUNTY AREA VOC TECH SCH     ,PA,17931-0000,Public       ,0,2,2,6,39,45
02253900,BERKS TECHNICAL INSTITUTE               ,PA,19610-1168,Proprietary  ,34,95,129,900,1524,2424
02255200,PENNSYLVANIA SCHOOL OF BUSINESS         ,PA,18101-1604,Proprietary  ,0,0,0,83,430,513
02269900,PENNSYLVANIA COLLEGE OF ART & DESIGN    ,PA,17603-3528,Private      ,1,4,5,446,115,561
02270500,BUCKS COUNTY SCHOOL OF BEAUTY CULT      ,PA,19053-0000,Proprietary  ,1,1,2,51,67,118
02273400,RECONSTRUCTIONIST RABBINICAL COLLEG     ,PA,19095-0000,Private      ,0,0,0,0,37,37
02276600,HANOVER PUBLIC SCH DIST PRAC NURSG      ,PA,17331-0000,Public       ,0,0,0,12,80,92
02282500,LENAPE SCHOOL OF PRACTICAL NURSING      ,PA,16226-0000,Public       ,2,1,3,55,155,210
02289500,PACE INSTITUTE                          ,PA,19601-0000,Proprietary  ,1,3,4,47,170,217
02289600,CONSOLIDATED SCHOOL OF BUSINESS         ,PA,17404-0000,Proprietary  ,3,12,15,60,228,288
02289700,ACADEMY OF CREATIVE HAIR DESIGN         ,PA,18702-0000,Proprietary  ,8,15,23,121,286,407
02289800,CHI INSTITUTE - FRANKLIN MILLS          ,PA,19154-0000,Proprietary  ,16,48,64,431,1026,1457
02290400,"ALTOONA BEAUTY SCHOOL, INC              ",PA,16602-0000,Proprietary  ,0,4,4,58,111,169
02292700,LANSDALE SCHOOL OF COSMETOLOGY          ,PA,19446-0000,Proprietary  ,0,1,1,29,53,82
02299300,TRINITY EPISCOPAL SCHOOL MINISTRY       ,PA,15003-0000,Private      ,0,0,0,2,106,108
02301300,PRISM CAREER INSTITUTE                  ,PA,19082-2448,Proprietary  ,5,15,20,159,608,767
02304400,YTI CAREER INSTITUTE - MECHANICSBURG    ,PA,17055-0000,Proprietary  ,1,4,5,110,143,253
02306200,VENANGO COUNTY AREA VOC TECH SCHOOL     ,PA,16301-0000,Public       ,0,1,1,31,93,124
02310800,LANCASTER COUNTY CAREER & TECH CTR      ,PA,17584-0000,Public       ,4,17,21,203,636,839
02323000,BIBLICAL THEOLOGICAL SEMINARY           ,PA,19440-2421,Private      ,0,0,0,2,123,125
02330300,LEBANON CO CAREER & TECHNOLOGY CTR      ,PA,17042-0000,Public       ,1,7,8,64,283,347
02330600,PENNSYLVANIA GUNSMITH SCHOOL            ,PA,15202-0000,Proprietary  ,2,4,6,102,133,235
02350100,WESTERN AREA CAREER & TECHNOLOGY CT     ,PA,15317-0000,Public       ,0,0,0,29,109,138
02350200,INDIANA COUNTY TECH CTR SCH PR NSG      ,PA,15701-1465,Public       ,2,1,3,59,144,203
02353100,NORTHERN TIER CAREER CENTER             ,PA,18848-0000,Public       ,0,0,0,31,87,118
02362300,MERCER COUNTY AREA VOC TECH SCHOOL      ,PA,16137-0000,Public       ,0,1,1,21,59,80
02492600,EASTERN CTR ARTS AND TECH PR NSG        ,PA,19090-0000,Public       ,0,5,5,38,177,215
02495500,ALL-STATE CAREER SCHOOL                 ,PA,19029-0000,Proprietary  ,15,124,139,311,1216,1527
02529800,WILKES BARRE AREA CAREER AND TECHNICAL C,PA,18705-0000,Public       ,3,3,6,110,264,374
02536600,COMMONWEALTH TECH INSTIT @ HIRAM G      ,PA,15905-0000,Public       ,14,12,26,292,133,425
02544300,BUTLER BEAUTY SCHOOL                    ,PA,16001-0000,Proprietary  ,13,18,31,72,152,224
02545000,LAWRENCE COUNTY CAREER AND TECHNICAL CEN,PA,16101-0000,Public       ,0,2,2,26,80,106
02546200,LAUREL BUSINESS INSTITUTE               ,PA,15401-0877,Proprietary  ,7,16,23,192,228,420
02550000,CLARION CO AREA VOC-TECH PRAC NRSG      ,PA,16254-4637,Public       ,0,0,0,27,92,119
02554500,HAZLETON AREA CAREER CENTER PRACTICAL NU,PA,18201-0000,Public       ,1,0,1,49,102,151
02557800,ART INSTITUTE OF YORK (THE) - PENNSYLVAN,PA,17402-9012,Proprietary  ,4,7,11,687,347,1034
02566400,ALBERT EINSTEIN MED CTR DEPT DNTL       ,PA,19141-3098,Private      ,0,1,1,36,158,194
02574800,PENNSYLVANIA INSTITUTE OF TAXIDERMY     ,PA,15931-0000,Proprietary  ,0,0,0,17,27,44
02609500,CAREER TRAINING ACADEMY                 ,PA,15068-6308,Proprietary  ,15,39,54,141,406,547
02609501,CAREER TRAINING ACADEMY                 ,PA,15146-0000,Proprietary  ,0,1,1,23,56,79
02616100,JEAN MADELINE ED CTR FOR COSM           ,PA,19147-1542,Proprietary  ,8,15,23,334,448,782
02617507,EVEREST COLLEGE - EVEREST INSTITUTE - BE,PA,19020-2062,Proprietary  ,17,59,76,57,180,237
03006800,LE CORDON BLEU INSTITUTE OF CULINARY ART,PA,15222-3511,Proprietary  ,0,0,0,29,27,56
03010800,FORTIS INSTITUTE                        ,PA,16506-1013,Proprietary  ,63,198,261,893,2553,3446
03011500,FORTIS INSTITUTE                        ,PA,18702-0000,Proprietary  ,4,30,34,113,337,450
03011600,FORTIS INSTITUTE                        ,PA,18509-2903,Proprietary  ,10,34,44,235,565,800
03029900,CONSOLIDATED SCHOOL OF BUSINESS         ,PA,17603-2389,Proprietary  ,7,15,22,83,212,295
03067000,ANTONELLI MEDICAL & PROF INST           ,PA,19464-9244,Proprietary  ,2,16,18,49,204,253
03072600,DCI CAREER INSTITUTE                    ,PA,15061-2307,Proprietary  ,5,7,12,58,138,196
03081900,YTI CAREER INSTITUTE - ALTOONA          ,PA,16602-4457,Proprietary  ,4,21,25,281,433,714
03090800,LAKE ERIE COLL OF OSTEOPATHIC MED       ,PA,16509-0000,Private      ,0,6,6,73,4003,4076
03098600,CAREER TECH CTR OF LACKAWANNA CNTY      ,PA,18508-0000,Public       ,1,3,4,95,257,352
03101400,FORBES ROAD CAREER & TECHNOLOGY CTR     ,PA,15146-1550,Public       ,0,0,0,13,35,48
03101500,BIDWELL TRAINING CENTER                 ,PA,15233-2233,Private      ,7,33,40,47,191,238
03103300,JNA INSTITUTE OF CULINARY ARTS          ,PA,19146-3119,Proprietary  ,2,8,10,126,267,393
03109100,METROPOLITAN CAREER CENTER              ,PA,19144-0000,Private      ,0,10,10,45,205,250
03110700,AVIATION INSTITUTE OF MAINTENANCE       ,PA,19114-1017,Proprietary  ,11,37,48,215,639,854
03120400,REGIONAL CAREER & TECHNICAL CENTER      ,PA,16509-4699,Public       ,0,0,0,20,31,51
03128400,DELAWARE COUNTY TECHNICAL SCHOOL        ,PA,19008-1928,Public       ,1,2,3,57,242,299
03180400,PENNSYLVANIA HIGHLANDS COMMUNITY COLLEGE,PA,15904-2927,Public       ,18,28,46,1071,1013,2084
03236400,LT INTERNATIONAL BEAUTY SCHOOL          ,PA,19130-2235,Proprietary  ,1,11,12,42,150,192
03353300,ACADEMY OF VOCAL ARTS                   ,PA,19103-6685,Private      ,0,0,0,54,115,169
03380301,STAR CAREER ACADEMY - STAR PHILADELPHIA ,PA,19114-2204,Proprietary  ,32,151,183,545,1645,2190
03380304,STAR CAREER ACADEMY - STAR NORRISTOWN   ,PA,19403-2422,Proprietary  ,4,32,36,78,370,448
03493302,ALL-STATE CAREER - WEST MIFFLIN CAMPUS  ,PA,15122-0000,Proprietary  ,0,2,2,45,194,239
03535300,HUNTINGDON COUNTY CAREER AND TECHNO     ,PA,17060-0905,Public       ,0,1,1,9,47,56
03561400,SUSQUEHANNA COUNTY CAREER & TECHNOL     ,PA,18816-0100,Public       ,0,1,1,20,95,115
03766300,PENNSYLVANIA SCHOOL OF MUSCLE THERAPY   ,PA,19406-3101,Proprietary  ,3,20,23,83,261,344
03781300,PRINCETON INFORMATION TECHNOLOGY CENTER ,PA,19038-4535,Proprietary  ,7,56,63,52,467,519
03899300,CALVARY BAPTIST THEOLOGICAL SEMINARY    ,PA,19446-4718,Private      ,0,0,0,2,16,18
03923300,PRECISION MANUFACTURING INSTITUTE       ,PA,16335-8380,Private      ,3,3,6,26,79,105
03948300,HARRISBURG UNIVERSITY OF SCIENCE AND TEC,PA,17101-2116,Private      ,5,15,20,861,344,1205
03949300,WON INSTITUTE OF GRADUATE STUDIES       ,PA,19038-4535,Private      ,0,0,0,0,69,69
03950500,NORTHWEST REGIONAL TECHNOLOGY INSTITUTE ,PA,16508-2820,Proprietary  ,0,19,19,24,134,158
03952300,NATIONAL MASSAGE THERAPY INSTITUTE      ,PA,19116-3965,Proprietary  ,1,4,5,166,742,908
04024300,EDUCATION AND TECHNOLOGY INSTITUTE      ,PA,15601-9214,Private      ,0,0,0,16,49,65
04041300,BERKS CAREER & TECHNOLOGY CENTER        ,PA,19533-9112,Public       ,1,1,2,32,68,100
04118000,BYZANTINE CATHOLIC SEMINARY OF SAINTS CY,PA,15214-2229,Private      ,0,0,0,1,10,11
04127500,CDE CAREER INSTITUTE                    ,PA,18372-9034,Proprietary  ,0,10,10,9,90,99
04145800,PULSE BEAUTY ACADEMY A PAUL MITCHELL PAR,PA,19335-0000,Proprietary  ,3,3,6,99,116,215
04149800,SOMERSET COUNTY TECHNOLOGY CENTER       ,PA,15501-1444,Public       ,1,0,1,33,131,164
04151700,BELLA CAPELLI ACADEMY                   ,PA,15146-2388,Proprietary  ,1,2,3,86,86,172
04151701,BELLA CAPELLI ACADEMY -                 ,PA,15205-2388,Proprietary  ,3,5,8,97,91,188
04155100,INSTITUTE OF MEDICAL CAREERS            ,PA,15235-3718,Proprietary  ,2,16,18,40,193,233
04158000,METRO BEAUTY ACADEMY                    ,PA,18106-9693,Proprietary  ,5,22,27,128,244,372
04164900,BARONE BEAUTY ACADEMY                   ,PA,17701-5316,Proprietary  ,2,1,3,60,69,129
04167200,COMMONWEALTH MEDICAL COLLEGE (THE)      ,PA,18503-3251,Private      ,0,4,4,17,717,734
04167500,WORLD A CUTS BARBER INSTITUTE           ,PA,17401-1105,Proprietary  ,1,16,17,22,114,136
04175900,LEWISTOWN HOSPITAL SCHOOL OF NURSING    ,PA,17044-1167,Private      ,0,0,0,32,54,86
04209700,NEWCOURTLAND EDUCATION CENTER SCHOOL OF ,PA,19119-2126,Private      ,0,0,0,12,58,70
04215500,CHAMP'S BARBER SCHOOL                   ,PA,17603-3809,Proprietary  ,7,21,28,23,95,118
04221300,PHILADELPHIA TECHNICIAN TRAINING        ,PA,19138-1324,Private      ,4,16,20,13,73,86
04224600,BARBER SCHOOL OF PITTSBURGH             ,PA,15220-5537,Proprietary  ,3,7,10,23,95,118
04226300,DIVINE CROWN ACADEMY OF COSMETOLOGY     ,PA,17104-2103,Proprietary  ,2,6,8,8,17,25
00153410,EVEREST UNIVERSITY - EVEREST COLLEGE - M,WI,53212-4006,Proprietary  ,0,0,0,64,224,288
00267813,BRYANT & STRATTON COLLEGE - MIL DOWNTOWN,WI,53203-2608,Proprietary  ,33,145,178,997,3566,4563
00383200,ALVERNO COLLEGE                         ,WI,53234-3922,Private      ,3,20,23,1628,2845,4473
00383500,BELOIT COLLEGE                          ,WI,53511-5595,Private      ,2,7,9,2110,167,2277
00383700,CARDINAL STRITCH UNIVERSITY             ,WI,53217-9884,Private      ,8,65,73,1347,4924,6271
00383800,CARROLL UNIVERSITY                      ,WI,53186-5593,Private      ,3,8,11,4082,1045,5127
00383900,CARTHAGE COLLEGE                        ,WI,53141-0000,Private      ,7,33,40,5219,1042,6261
00384000,WESTERN TECHNICAL COLLEGE               ,WI,54601-0908,Public       ,21,72,93,2381,2819,5200
00384200,CONCORDIA UNIVERSITY WISCONSIN          ,WI,53097-2402,Private      ,25,119,144,3643,5448,9091
00384800,EDGEWOOD COLLEGE                        ,WI,53711-1958,Private      ,0,26,26,1970,1517,3487
00385000,SILVER LAKE COLLEGE                     ,WI,54220-9319,Private      ,0,6,6,237,405,642
00385400,LAKELAND COLLEGE                        ,WI,53082-0000,Private      ,2,81,83,1390,2274,3664
00385600,LAWRENCE UNIVERSITY                     ,WI,54912-0599,Private      ,4,1,5,2469,178,2647
00386100,MARIAN UNIVERSITY                       ,WI,54935-4699,Private      ,2,24,26,1516,1137,2653
00386300,MARQUETTE UNIVERSITY                    ,WI,53201-1881,Private      ,77,31,108,17111,4762,21873
00386600,MILWAUKEE AREA TECH COLLEGE             ,WI,53233-1443,Public       ,96,439,535,8464,21209,29673
00386800,MILWAUKEE SCHOOL OF ENGINEERING         ,WI,53202-3109,Private      ,6,10,16,2947,1009,3956
00386900,MOUNT MARY UNIVERSITY                   ,WI,53222-4597,Private      ,2,14,16,855,1481,2336
00387400,NASHOTAH HOUSE                          ,WI,53058-0000,Private      ,0,0,0,1,80,81
00387500,NORTHLAND COLLEGE                       ,WI,54806-3999,Private      ,0,1,1,885,144,1029
00388400,RIPON COLLEGE                           ,WI,54971-0248,Private      ,1,0,1,1364,89,1453
00389200,ST. NORBERT COLLEGE                     ,WI,54115-2099,Private      ,4,1,5,2785,149,2934
00389500,UNIVERSITY OF WISCONSIN-MADISON         ,WI,53715-1382,Public       ,42,67,109,27948,11407,39355
00389600,UNIVERSITY OF WISCONSIN-MILWAUKEE       ,WI,53201-3165,Public       ,67,191,258,19595,14680,34275
00389700,UNIVERSITY OF WISCONSIN COLLEGES        ,WI,53708-8680,Public       ,14,32,46,3017,2370,5387
00389701,UNIVERSITY OF WISCONSIN-BARABOO         ,WI,53913-1098,Public       ,2,3,5,425,260,685
00389702,UNIVERSITY OF WISCONSIN-BARRON          ,WI,54868-2497,Public       ,7,3,10,422,253,675
00389703,UNIVERSITY OF WISCONSIN-FOND DU LAC     ,WI,54935-2998,Public       ,3,6,9,638,360,998
00389704,UNIVERSITY OF WISCONSIN-FOX VALLEY      ,WI,54952-1297,Public       ,5,6,11,1332,670,2002
00389705,UNIVERSITY OF WISCONSIN-MANITOWOC       ,WI,54220-6699,Public       ,3,3,6,396,199,595
00389706,UNIVERSITY OF WISCONSIN-MARATHON        ,WI,54401-5396,Public       ,4,6,10,1022,494,1516
00389707,UNIVERSITY OF WISCONSIN-MARINETTE       ,WI,54143-4299,Public       ,1,3,4,330,234,564
00389708,UNIVERSITY OF WISCONSIN-MARSHFIELD      ,WI,54449-3310,Public       ,2,5,7,393,243,636
00389709,UNIVERSITY OF WISCONSIN-RICHLAND        ,WI,53581-1399,Public       ,1,1,2,359,144,503
00389710,UNIVERSITY OF WISCONSIN COLLEGES - ROCK ,WI,53546-5699,Public       ,7,13,20,910,696,1606
00389711,UNIVERSITY OF WISCONSIN-SHEBOYGAN       ,WI,53081-4789,Public       ,1,1,2,579,380,959
00389712,UNIVERSITY OF WISCONSIN-WASHINGTON      ,WI,53095-3699,Public       ,4,9,13,758,332,1090
00389713,UNIVERSITY OF WISCONSIN-WAUKESHA        ,WI,53188-2799,Public       ,7,19,26,1646,772,2418
00389900,UNIVERSITY OF WISCONSIN-GREEN BAY       ,WI,54311-7001,Public       ,2,23,25,4991,2940,7931
00391100,VITERBO UNIVERSITY                      ,WI,54601-4777,Private      ,3,51,54,1947,1444,3391
00391500,UNIVERSITY OF WISCONSIN-STOUT           ,WI,54751-0790,Public       ,9,37,46,6588,2476,9064
00391700,UNIVERSITY OF WISCONSIN-EAU CLAIRE      ,WI,54702-4004,Public       ,15,40,55,9849,2180,12029
00391900,UNIVERSITY OF WISCONSIN-LA CROSSE       ,WI,54601-3742,Public       ,6,17,23,9428,1923,11351
00392000,UNIVERSITY OF WISCONSIN-OSHKOSH         ,WI,54901-8604,Public       ,17,28,45,9698,3961,13659
00392100,UNIVERSITY OF WISCONSIN-PLATTEVILLE     ,WI,53818-3099,Public       ,10,41,51,7601,2028,9629
00392300,UNIVERSITY OF WISCONSIN-RIVER FALLS     ,WI,54022-5013,Public       ,11,41,52,5240,1591,6831
00392400,UNIVERSITY OF WISCONSIN-STEVENS POINT   ,WI,54481-3871,Public       ,11,12,23,8621,2310,10931
00392500,UNIVERSITY OF WISCONSIN-SUPERIOR        ,WI,54880-2898,Public       ,6,33,39,1805,1627,3432
00392600,UNIVERSITY OF WISCONSIN-WHITEWATER      ,WI,53190-1792,Public       ,49,50,99,10850,3016,13866
00400700,MADISON AREA TECHNICAL COLLEGE          ,WI,53704-2599,Public       ,28,114,142,5767,9532,15299
00501500,UNIVERSITY OF WISCONSIN-PARKSIDE        ,WI,53141-2000,Public       ,15,34,49,4126,2770,6896
00529400,WAUKESHA COUNTY TECHNICAL COLLEGE       ,WI,53072-4696,Public       ,16,47,63,1827,4017,5844
00530100,NORTHEAST WISCONSIN TECHNICAL COLLEGE   ,WI,54307-9042,Public       ,78,191,269,3390,6333,9723
00530400,CHIPPEWA VALLEY TECHNICAL COLLEGE       ,WI,54701-6162,Public       ,8,28,36,2604,3821,6425
00538000,MID-STATE TECHNICAL COLLEGE             ,WI,54494-5512,Public       ,3,30,33,1032,2110,3142
00538400,NICOLET AREA TECHNICAL COLLEGE          ,WI,54501-0000,Public       ,8,32,40,620,1088,1708
00538700,NORTHCENTRAL TECHNICAL COLLEGE          ,WI,54401-1899,Public       ,7,33,40,1565,3545,5110
00538900,GATEWAY TECHNICAL COLLEGE               ,WI,53144-1690,Public       ,19,76,95,2926,8607,11533
00539000,BLACKHAWK TECHNICAL COLLEGE             ,WI,53547-5009,Public       ,19,83,102,1131,3240,4371
00663900,BELLIN COLLEGE                          ,WI,54305-0000,Private      ,1,6,7,351,255,606
00732934,ITT TECHNICAL INSTITUTE                 ,WI,53220-4612,Proprietary  ,42,227,269,484,2485,2969
00766900,SOUTHWEST WISCONSIN TECH COLLEGE        ,WI,53809-0000,Public       ,0,10,10,818,907,1725
00778103,CHI INSTITUTE/RETS CAMPUS - KAPLAN COLLE,WI,53212-3939,Proprietary  ,0,0,0,107,538,645
00821700,PAUL MITCHELL THE SCHOOL GREEN BAY      ,WI,54324-0257,Proprietary  ,1,3,4,125,157,282
00869405,RASMUSSEN COLLEGE - WAUSAU              ,WI,54401-7804,Proprietary  ,2,15,17,142,950,1092
00869414,RASMUSSEN COLLEGE - GREEN BAY           ,WI,54303-2349,Proprietary  ,1,19,20,176,1016,1192
00869419,RASMUSSEN COLLEGE - APPLETON            ,WI,54915-7305,Proprietary  ,7,24,31,128,752,880
00919400,LAKESHORE TECHNICAL COLLEGE             ,WI,53015-1412,Public       ,6,15,21,839,1882,2721
00925600,MORAINE PARK TECHNICAL COLLEGE          ,WI,54936-0000,Public       ,6,17,23,1220,2898,4118
00941900,STATE CLG OF BEAUTY CULT-WAUSAU         ,WI,54403-4667,Proprietary  ,2,1,3,51,85,136
00962100,HERZING UNIVERSITY                      ,WI,53718-4236,Proprietary  ,78,706,784,1345,12105,13450
00974400,FOX VALLEY TECHNICAL COLLEGE            ,WI,54913-0000,Public       ,41,139,180,3677,6577,10254
01091300,MADISON MEDIA INSTITUTE                 ,WI,53718-6787,Proprietary  ,17,22,39,707,678,1385
01148400,ADVANCED INSTITUTE OF HAIR DESIGN       ,WI,53225-0000,Proprietary  ,11,18,29,326,367,693
01182400,WISCONSIN INDIANHEAD TECH CLG WITC      ,WI,54871-9300,Public       ,21,52,73,1183,2633,3816
01260610,EMPIRE BEAUTY SCHOOL - MADISON          ,WI,53717-1111,Proprietary  ,0,0,0,73,155,228
01260611,EMPIRE BEAUTY SCHOOL - GREEN BAY        ,WI,54304-4838,Proprietary  ,0,0,0,77,177,254
02077100,MILWAUKEE INST OF ART & DESIGN          ,WI,53202-0000,Private      ,3,6,9,1165,458,1623
02078000,SACRED HEART SCHOOL OF THEOLOGY         ,WI,53130-0000,Private      ,0,0,0,1,4,5
02136600,WISCONSIN LUTHERAN COLLEGE              ,WI,53226-0000,Private      ,6,27,33,1367,452,1819
02173208,EMPIRE BEAUTY SCHOOL - MANITOWOC        ,WI,54220-5040,Proprietary  ,0,0,0,79,199,278
02173209,EMPIRE BEAUTY SCHOOL - APPLETON         ,WI,54914-4644,Proprietary  ,0,0,0,23,38,61
02239204,ANTHEM COLLEGE - BROOKFIELD             ,WI,53005-4207,Proprietary  ,8,43,51,101,442,543
02271300,WI SCH OF PROFESSIONAL PSYCHOLOGY       ,WI,53225-0000,Private      ,1,4,5,34,204,238
02317200,MARANATHA BAPTIST BIBLE COLLEGE         ,WI,53094-0000,Private      ,2,11,13,900,230,1130
02453500,MEDICAL COLLEGE OF WISCONSIN            ,WI,53226-0000,Private      ,3,2,5,130,1311,1441
02494300,GILL-TECH ACADEMY OF HAIR DESIGN        ,WI,54911-0000,Proprietary  ,4,4,8,65,92,157
02532200,LAC COURTE OREILLES OJIBWA CMTY CLG     ,WI,54843-0000,Public       ,4,23,27,76,515,591
03061200,MIDWEST COLLEGE OF ORIENTAL MEDICINE    ,WI,53403-9747,Proprietary  ,0,3,3,29,296,325
03125100,COLLEGE OF MENOMINEE NATION             ,WI,54135-0000,Private      ,3,6,9,126,553,679
03125102,COLLEGE OF  THE MENOMINEE NATION - GREEN,WI,54304-4964,Private      ,1,8,9,66,303,369
03220300,"SALON PROFESSIONAL ACADEMY, THE         ",WI,54701-7633,Proprietary  ,3,4,7,79,115,194
03309300,MONTESSORI INSTITUTE OF MILWAUKEE       ,WI,53207-0000,Private      ,0,1,1,7,53,60
03808300,INSTITUTE OF BEAUTY AND WELLNESS (THE)  ,WI,53202-5715,Proprietary  ,5,7,12,181,316,497
03822300,PAUL MITCHELL THE SCHOOL - MONROE       ,WI,53566-0000,Proprietary  ,6,3,9,46,49,95
03872500,NORTHLAND INTERNATIONAL UNIVERSITY      ,WI,54119-9285,Private      ,0,0,0,354,72,426
03925300,BLUE SKY SCHOOL OF PROFESSIONAL MASSAGE ,WI,53024-9699,Private      ,1,1,2,14,72,86
03925301,BLUE SKY SCHOOL OF PROFESSIONAL MASSAGE ,WI,54115-7407,Private      ,1,3,4,13,61,74
03925303,BLUE SKY SCHOOL OF PROFESSIONAL MASSAGE ,WI,53713-2366,Private      ,0,5,5,17,70,87
04117400,MILWAUKEE CAREER COLLEGE                ,WI,53222-4305,Proprietary  ,11,32,43,308,770,1078
04118600,ACADEMY OF COSMETOLOGY                  ,WI,53548-3307,Proprietary  ,1,5,6,45,144,189
04124800,VISIONS IN HAIR DESIGN INSTITUTE OF COSM,WI,53210-1120,Proprietary  ,0,3,3,47,110,157
04132600,WISCONSIN ACADEMY (THE)                 ,WI,54157-1726,Proprietary  ,1,3,4,19,38,57
04137900,BRENSTEN EDUCATION                      ,WI,53186-0000,Proprietary  ,2,83,85,50,644,694
04138200,SALON PROFESSIONAL ACADEMY (THE)        ,WI,54914-3921,Proprietary  ,1,5,6,72,87,159
04157700,SALON PROFESSIONAL ACADEMY (THE)        ,WI,54650-8699,Proprietary  ,4,6,10,75,111,186
04159400,COLUMBIA COLLEGE OF NURSING             ,WI,53211-2952,Private      ,1,2,3,177,354,531
04165300,ACADEMY WAUKESHA (THE)                  ,WI,53072-5524,Proprietary  ,7,10,17,109,158,267
04179200,ADVANCED COLLEGE OF COSMETOLOGY         ,WI,53963-0000,Proprietary  ,0,0,0,42,36,78
04182100,FIRST CLASS COSMETOLOGY SCHOOL          ,WI,52511-0000,Proprietary  ,1,5,6,49,105,154
04183600,SALON PROFESSIONAL ACADEMY OF KENOSHA (T,WI,53142-4950,Proprietary  ,4,10,14,103,210,313
04193800,SHEPHERDS COLLEGE                       ,WI,53182-1527,Private      ,0,0,0,27,19,46
04202800,PANACHE ACADEMY OF BEAUTY               ,WI,53913-2596,Proprietary  ,1,2,3,31,71,102
04219300,EAST-WEST HEALING ARTS INSTITUTE        ,WI,53719-1133,Proprietary  ,1,5,6,3,12,15
00290500,NORTH CAROLINA A&T STATE UNIV           ,NC,27411-0001,Public       ,59,78,137,16843,8340,25183
00290600,APPALACHIAN STATE UNIVERSITY            ,NC,28608-2059,Public       ,36,72,108,18835,5488,24323
00290700,UNIVERSITY OF NC AT ASHEVILLE           ,NC,28804-3299,Public       ,5,18,23,4890,2344,7234
00290800,BARTON COLLEGE                          ,NC,27893-3104,Private      ,6,10,16,1752,962,2714
00291000,BELMONT ABBEY COLLEGE                   ,NC,28012-1802,Private      ,4,18,22,1541,1389,2930
00291100,BENNETT COLLEGE                         ,NC,27401-3239,Private      ,2,3,5,1372,662,2034
00291200,BREVARD COLLEGE                         ,NC,28712-3306,Private      ,2,3,5,1354,265,1619
00291300,CAMPBELL UNIVERSITY                     ,NC,27506-0036,Private      ,23,80,103,6187,4641,10828
00291400,CATAWBA COLLEGE                         ,NC,28144-2488,Private      ,5,11,16,2051,803,2854
00291500,CENTRAL PIEDMONT COMMUNITY COLLEGE      ,NC,28204-2297,Public       ,142,588,730,12254,23846,36100
00291600,CHOWAN UNIVERSITY                       ,NC,27855-1850,Private      ,8,8,16,2238,497,2735
00291700,COLLEGE OF THE ALBEMARLE                ,NC,27909-2327,Public       ,15,35,50,1178,2096,3274
00291800,DAVIDSON COLLEGE                        ,NC,28035-7157,Private      ,3,3,6,3474,314,3788
00291900,DAVIDSON COUNTY COMMUNITY COLLEGE       ,NC,27293-0000,Public       ,22,88,110,2174,5536,7710
00292000,DUKE UNIVERSITY                         ,NC,27708-0397,Private      ,15,15,30,19926,2486,22412
00292001,DUKE UNIV - SCHOOL OF MEDICINE          ,NC,27710-0000,Private      ,1,6,7,269,1169,1438
00292002,DUKE UNIV - SCHOOL OF LAW               ,NC,27708-0000,Private      ,0,3,3,101,2135,2236
00292003,DUKE UNIV - GRAD SCH ARTS & SCIENCE     ,NC,27708-0000,Private      ,0,5,5,172,876,1048
00292004,DUKE UNIV - FUQUA SCH OF BUSINESS       ,NC,27708-0000,Private      ,0,9,9,120,1205,1325
00292005,DUKE UNIV/NICHOLAS SCH OF ENVIRON.      ,NC,27708-0000,Private      ,0,1,1,51,402,453
00292006,DUKE UNIV - DIVINITY SCHOOL             ,NC,27708-0000,Private      ,3,7,10,384,856,1240
00292007,DUKE UNIV - SCHOOL OF NURSING           ,NC,27710-0000,Private      ,1,10,11,275,1556,1831
00292010,DUKE UNIVERSITY - SCHOOL OF PUBLIC POLIC,NC,27708-0239,Private      ,0,0,0,62,277,339
00292300,EAST CAROLINA UNIVERSITY                ,NC,27858-1818,Public       ,96,252,348,25226,14240,39466
00292600,ELIZABETH CITY STATE UNIVERSITY         ,NC,27909-7806,Public       ,15,23,38,3788,1772,5560
00292700,ELON UNIVERSITY                         ,NC,27244-2010,Private      ,4,14,18,8071,1473,9544
00292800,FAYETTEVILLE STATE UNIVERSITY           ,NC,28301-4298,Public       ,34,141,175,5870,9114,14984
00292900,GARDNER-WEBB UNIVERSITY                 ,NC,28017-0000,Private      ,13,58,71,3438,4318,7756
00293000,GREENSBORO COLLEGE                      ,NC,27401-1875,Private      ,10,31,41,2135,1623,3758
00293100,GUILFORD COLLEGE                        ,NC,27410-4171,Private      ,13,52,65,3355,3651,7006
00293300,HIGH POINT UNIVERSITY                   ,NC,27262-4221,Private      ,12,24,36,5728,1062,6790
00293400,ISOTHERMAL COMMUNITY COLLEGE            ,NC,28160-0804,Public       ,7,53,60,1053,1929,2982
00293500,LAUREL UNIVERSITY                       ,NC,27265-3197,Private      ,3,10,13,68,372,440
00293600,JOHNSON C SMITH UNIVERSITY              ,NC,28216-5398,Private      ,20,42,62,3377,2274,5651
00293700,KING'S COLLEGE-CHARLOTTE                ,NC,28204-2435,Proprietary  ,4,26,30,1024,1138,2162
00293900,LEES MCRAE COLLEGE                      ,NC,28604-0000,Private      ,4,3,7,1355,437,1792
00294000,LENOIR COMMUNITY COLLEGE                ,NC,28502-0188,Public       ,17,85,102,1238,3085,4323
00294100,LENOIR-RHYNE UNIVERSITY                 ,NC,28603-0000,Private      ,6,22,28,3243,1339,4582
00294200,LIVINGSTONE COLLEGE                     ,NC,28144-5298,Private      ,14,13,27,1733,679,2412
00294300,LOUISBURG COLLEGE                       ,NC,27549-2398,Private      ,43,10,53,1468,322,1790
00294400,MARS HILL COLLEGE                       ,NC,28754-0000,Private      ,6,8,14,2392,585,2977
00294500,MEREDITH COLLEGE                        ,NC,27607-5298,Private      ,1,11,12,2235,1274,3509
00294600,METHODIST UNIVERSITY                    ,NC,28311-1420,Private      ,16,53,69,3027,2627,5654
00294700,MITCHELL COMMUNITY COLLEGE              ,NC,28677-5264,Public       ,12,50,62,1508,2827,4335
00294800,MONTREAT COLLEGE                        ,NC,28757-1267,Private      ,1,23,24,580,834,1414
00294900,UNIVERSITY OF MOUNT OLIVE               ,NC,28365-1299,Private      ,10,150,160,1553,4710,6263
00295000,NORTH CAROLINA CENTRAL UNIVERSITY       ,NC,27707-3198,Public       ,53,85,138,10092,8397,18489
00295100,NORTH CAROLINA WESLEYAN COLLEGE         ,NC,27804-8699,Private      ,12,39,51,1254,1852,3106
00295300,PEACE COLLEGE                           ,NC,27604-1194,Private      ,4,13,17,1501,1017,2518
00295400,UNIV OF NORTH CAROLINA AT PEMBROKE      ,NC,28372-1510,Public       ,27,73,100,7074,4920,11994
00295500,PFEIFFER UNIVERSITY                     ,NC,28109-0000,Private      ,1,23,24,1213,1592,2805
00295600,PIEDMONT INTERNATIONAL UNIVERSITY       ,NC,27101-5025,Private      ,1,3,4,194,253,447
00295700,QUEENS UNIVERSITY OF CHARLOTTE          ,NC,28274-0001,Private      ,16,85,101,2635,2943,5578
00295800,ROCKINGHAM COMMUNITY COLLEGE            ,NC,27375-0000,Public       ,8,37,45,1071,1855,2926
00296000,SALEM COLLEGE                           ,NC,27108-0000,Private      ,4,6,10,1054,1113,2167
00296100,SANDHILLS COMMUNITY COLLEGE             ,NC,28374-8283,Public       ,23,70,93,1967,3967,5934
00296200,SHAW UNIVERSITY                         ,NC,27601-2393,Private      ,21,42,63,3599,2694,6293
00296300,SOUTHEASTERN BAPTIST THEOL SEMINARY     ,NC,27588-0000,Private      ,0,1,1,52,122,174
00296400,SOUTHEASTERN COMMUNITY COLLEGE          ,NC,28472-5422,Public       ,14,50,64,793,1647,2440
00296800,ST AUGUSTINES COLLEGE                   ,NC,27610-2298,Private      ,6,8,14,2593,1210,3803
00297000,SURRY COMMUNITY COLLEGE                 ,NC,27017-0304,Public       ,13,22,35,1470,2205,3675
00297200,NORTH CAROLINA STATE UNIV-RALEIGH       ,NC,27695-7001,Public       ,74,162,236,30143,13061,43204
00297300,GASTON COLLEGE                          ,NC,28034-1499,Public       ,21,110,131,2607,5778,8385
00297400,UNIVERSITY OF N C-CHAPEL HILL           ,NC,27514-0000,Public       ,40,135,175,28640,14494,43134
00297500,UNIVERSITY OF NC AT CHARLOTTE           ,NC,28223-0001,Public       ,75,246,321,27405,16350,43755
00297600,UNIVERSITY OF N C - GREENSBORO          ,NC,27412-0001,Public       ,45,99,144,18790,12367,31157
00297800,WAKE FOREST UNIV - UNDERGRADUATE        ,NC,27109-7246,Private      ,10,5,15,7945,598,8543
00297801,WAKE FOREST UNIV - SCH OF MEDICINE      ,NC,27157-1090,Private      ,3,2,5,177,1191,1368
00297803,WAKE FOREST GRAD SCHOOLS OF BUSINESS    ,NC,27109-7659,Private      ,1,10,11,69,937,1006
00297805,WAKE FOREST UNIV - SCH OF LAW           ,NC,27109-7206,Private      ,0,5,5,55,1389,1444
00297806,WAKE FOREST UNIV - GRAD A&S/DIVINITY    ,NC,27109-7246,Private      ,1,11,12,50,815,865
00297900,WARREN WILSON COLLEGE                   ,NC,28815-0000,Private      ,2,4,6,1403,547,1950
00298000,WAYNE COMMUNITY COLLEGE                 ,NC,27533-0000,Public       ,11,98,109,1712,4090,5802
00298100,WESTERN CAROLINA UNIVERSITY             ,NC,28723-9731,Public       ,88,63,151,10994,4785,15779
00298200,WESTERN PIEDMONT COMMUNITY COLLEGE      ,NC,28655-4504,Public       ,12,47,59,1248,2227,3475
00298300,WILKES COMMUNITY COLLEGE                ,NC,28697-2100,Public       ,16,56,72,1367,1898,3265
00298400,UNIVERSITY OF N C-WILMINGTON            ,NC,28403-3297,Public       ,45,116,161,16849,6910,23759
00298500,WINGATE UNIVERSITY                      ,NC,28174-0159,Private      ,14,11,25,4518,1454,5972
00298600,WINSTON-SALEM STATE UNIVERSITY          ,NC,27102-0000,Public       ,44,102,146,7982,6366,14348
00398100,UNC SCHOOL OF THE ARTS                  ,NC,27127-2188,Public       ,3,7,10,1552,585,2137
00403300,ASHEVILLE BUNCOMBE TECH CMTY CLG        ,NC,28801-4897,Public       ,35,150,185,3123,7163,10286
00406200,PITT COMMUNITY COLLEGE                  ,NC,28590-0000,Public       ,53,154,207,5254,8940,14194
00483500,CALDWELL COMMUNITY CLG & TECH INST      ,NC,28638-2626,Public       ,13,71,84,1812,3114,4926
00483800,GUILFORD TECHNICAL COMMUNITY CLG        ,NC,27282-0309,Public       ,44,195,239,7571,16820,24391
00484400,WAKE TECHNICAL COMMUNITY COLLEGE        ,NC,27603-5696,Public       ,78,328,406,10564,19959,30523
00484500,WILSON COMMUNITY COLLEGE                ,NC,27893-3310,Public       ,18,66,84,831,2548,3379
00499201,MILLER-MOTTE TECHNICAL COLLEGE - MILLER-,NC,27511-9209,Proprietary  ,7,31,38,180,878,1058
00499202,MILLER-MOTTE TECHNICAL COLLEGE - MILLER-,NC,27604-6072,Proprietary  ,9,58,67,481,1979,2460
00499203,MILLER-MOTTE TECHNICAL COLLEGE - FAYETTE,NC,28311-7651,Proprietary  ,11,91,102,475,2713,3188
00499205,MILLER-MOTTE TECHNICAL COLLEGE - MILLER-,NC,28540-5901,Proprietary  ,4,74,78,171,1430,1601
00531600,COASTAL CAROLINA COMMUNITY COLLEGE      ,NC,28546-6816,Public       ,31,202,233,1814,6216,8030
00531700,FORSYTH TECHNICAL COMMUNITY COLLEGE     ,NC,27103-5197,Public       ,51,215,266,4879,11123,16002
00531800,CATAWBA VALLEY COMMUNITY COLLEGE        ,NC,28602-8302,Public       ,13,49,62,2669,4391,7060
00532000,CAPE FEAR COMMUNITY COLLEGE             ,NC,28401-3910,Public       ,46,191,237,5141,8082,13223
00544700,RANDOLPH COMMUNITY COLLEGE              ,NC,27204-1009,Public       ,14,35,49,1369,2918,4287
00544800,DURHAM TECHNICAL CMNTY COLLEGE          ,NC,27703-5023,Public       ,29,177,206,2454,7464,9918
00544900,CENTRAL CAROLINA COMMUNITY COLLEGE      ,NC,27330-9000,Public       ,20,87,107,1925,4861,6786
00546300,ALAMANCE COMMUNITY COLLEGE              ,NC,27253-0000,Public       ,18,83,101,2133,4424,6557
00546400,RICHMOND COMMUNITY COLLEGE              ,NC,28345-4522,Public       ,11,53,64,972,2504,3476
00575400,ROWAN-CABARRUS COMMUNITY COLLEGE        ,NC,28146-8357,Public       ,25,148,173,2699,6531,9230
00647700,CABARRUS COLLEGE OF HEALTH SCIENCES     ,NC,28025-0000,Private      ,1,11,12,430,1022,1452
00647800,MERCY HOSP SCH OF NURSING               ,NC,28207-0000,Public       ,4,16,20,241,1142,1383
00648300,WATTS SCHOOL OF NURSING                 ,NC,27704-0000,Private      ,1,3,4,115,457,572
00679900,CRAVEN COMMUNITY COLLEGE                ,NC,28562-0000,Public       ,18,104,122,1111,4127,5238
00703100,PAMLICO COMMUNITY COLLEGE               ,NC,28529-0000,Public       ,0,8,8,105,420,525
00764000,FAYETTEVILLE TECHNICAL CMTY COLLEGE     ,NC,28303-0236,Public       ,61,424,485,4673,18470,23143
00768700,JAMES SPRUNT COMMUNITY COLLEGE          ,NC,28349-0398,Public       ,4,13,17,456,1516,1972
00781400,BROOKSTONE COLLEGE OF BUSINESS          ,NC,28262-1294,Proprietary  ,3,29,32,160,786,946
00781401,BROOKSTONE COLLEGE OF BUSINESS          ,NC,27409-0000,Proprietary  ,2,31,33,113,613,726
00789200,SAMPSON COMMUNITY COLLEGE               ,NC,28328-0000,Public       ,3,21,24,586,1466,2052
00798500,SOUTH PIEDMONT COMMUNITY COLLEGE        ,NC,28135-9703,Public       ,13,38,51,1038,2388,3426
00798600,HALIFAX COMMUNITY COLLEGE               ,NC,27890-0089,Public       ,3,22,25,650,1467,2117
00798700,BLADEN COMMUNITY COLLEGE                ,NC,28332-0266,Public       ,6,51,57,628,1778,2406
00798800,MARTIN COMMUNITY COLLEGE                ,NC,27892-8307,Public       ,1,9,10,366,929,1295
00808100,CARTERET COMMUNITY COLLEGE              ,NC,28557-2989,Public       ,6,40,46,750,1972,2722
00808200,CLEVELAND COMMUNITY COLLEGE             ,NC,28150-0000,Public       ,9,68,77,1197,2978,4175
00808300,HAYWOOD COMMUNITY COLLEGE               ,NC,28721-0000,Public       ,5,38,43,730,1883,2613
00808500,MCDOWELL TECHNICAL COMMUNITY CLG        ,NC,28752-8728,Public       ,7,43,50,403,1099,1502
00808700,MONTGOMERY COMMUNITY COLLEGE            ,NC,27371-0787,Public       ,4,16,20,372,834,1206
00846600,SOUTHWESTERN COMMUNITY COLLEGE          ,NC,28779-8581,Public       ,8,46,54,965,1964,2929
00855700,NASH COMMUNITY COLLEGE                  ,NC,27804-0488,Public       ,19,97,116,1565,3844,5409
00855800,BEAUFORT COUNTY COMMUNITY COLLEGE       ,NC,27889-7889,Public       ,8,43,51,797,2310,3107
00861200,ROBESON COMMUNITY COLLEGE               ,NC,28359-2151,Public       ,24,67,91,1366,3637,5003
00861300,ROANOKE-CHOWAN COMMUNITY COLLEGE        ,NC,27910-9522,Public       ,2,6,8,377,921,1298
00885500,EDGECOMBE COMMUNITY COLLEGE             ,NC,27886-9399,Public       ,12,92,104,952,3944,4896
00902500,EMPIRE BEAUTY SCHOOL                    ,NC,28105-2508,Proprietary  ,0,0,0,179,384,563
00933600,JOHNSTON COMMUNITY COLLEGE              ,NC,27577-0000,Public       ,10,46,56,1899,4205,6104
00943000,TRI-COUNTY COMMUNITY COLLEGE            ,NC,28906-7919,Public       ,3,35,38,456,1063,1519
00964600,PIEDMONT COMMUNITY COLLEGE              ,NC,27573-1197,Public       ,12,51,63,578,1415,1993
00968400,BLUE RIDGE COMMUNITY COLLEGE            ,NC,28731-9624,Public       ,7,34,41,862,1919,2781
00974701,GORDON-CONWELL THEO SEM - CHARLOTTE     ,NC,28273-0000,Private      ,0,3,3,16,351,367
00990300,VANCE-GRANVILLE CMTY COLLEGE            ,NC,27536-0917,Public       ,22,103,125,1486,3682,5168
01019804,ECPI UNIVERSITY - GREENSBORO            ,NC,27409-9048,Proprietary  ,6,21,27,24,216,240
01019805,ECPI UNIVERSITY - CHARLOTTE             ,NC,28208-5886,Proprietary  ,9,57,66,75,494,569
01019810,ECPI UNIVERSITY - RALEIGH               ,NC,27613-7387,Proprietary  ,9,79,88,46,325,371
01019812,ECPI UNIVERSITY - CONCORD               ,NC,28262-0000,Proprietary  ,3,27,30,23,202,225
01026400,SOUTH COLLEGE                           ,NC,28803-3152,Proprietary  ,12,57,69,182,878,1060
01119400,STANLY COMMUNITY COLLEGE                ,NC,28001-7458,Public       ,15,50,65,1015,2805,3820
01119700,MAYLAND COMMUNITY COLLEGE               ,NC,28777-2777,Public       ,3,11,14,454,709,1163
01179900,PAUL MITCHELL THE SCHOOL FAYETTEVILLE   ,NC,28303-5364,Proprietary  ,6,15,21,235,698,933
01192600,LEON'S BEAUTY SCHOOL                    ,NC,27403-2812,Proprietary  ,5,8,13,224,407,631
01303918,SOUTH UNIVERSITY - THE ART INSTITUTE OF ,NC,28217-4536,Proprietary  ,19,30,49,2111,1764,3875
02056500,MITCHELL'S HAIR STYLING ACADEMY         ,NC,27893-0000,Proprietary  ,2,4,6,36,105,141
02056501,MITCHELL'S HAIR STYLING ACADEMY - MITCHE,NC,27606-3326,Proprietary  ,4,3,7,122,348,470
02158414,HARRISON COLLEGE - THE CHEF'S ACADEMY - ,NC,27560-0000,Proprietary  ,6,11,17,99,305,404
02170700,BRUNSWICK COMMUNITY COLLEGE             ,NC,28422-0000,Public       ,3,18,21,700,1315,2015
02205000,COLLEGE OF WILMINGTON                   ,NC,28403-0000,Proprietary  ,11,43,54,284,792,1076
02210400,FAYETTEVILLE BEAUTY COLLEGE             ,NC,28303-0000,Proprietary  ,1,12,13,138,522,660
02227800,MITCHELL'S HAIR STYLING ACADEMY         ,NC,27534-0000,Proprietary  ,1,2,3,28,95,123
02227900,MITCHELL'S HAIR STYLING ACADEMY         ,NC,27858-0000,Proprietary  ,0,3,3,57,115,172
02280900,MID-ATLANTIC CHRISTIAN UNIVERSITY       ,NC,27909-0000,Private      ,0,14,14,172,222,394
02326203,KAPLAN CAREER INSTITUTE - KAPLAN COLLEGE,NC,28212-6830,Proprietary  ,7,68,75,374,2201,2575
02558900,CHEVEUX SCHOOL OF HAIR DESIGN           ,NC,28540-0000,Proprietary  ,0,3,3,15,121,136
02560600,PINNACLE INSTITUTE OF COSMETOLOGY       ,NC,28115-8020,Proprietary  ,3,5,8,77,143,220
02614201,MILLER-MOTTE BUSINESS COLLEGE           ,NC,28403-0000,Proprietary  ,27,299,326,590,4853,5443
02614205,MILLER - MOTTE TECHNICAL COLLEGE - MILLE,NC,27834-5052,Proprietary  ,7,64,71,341,1329,1670
03009500,WINSTON-SALEM BARBER SCHOOL             ,NC,27107-0000,Proprietary  ,3,4,7,80,234,314
03064400,REGENCY BEAUTY INSTITUTE                ,NC,27127-0000,Proprietary  ,7,19,26,166,394,560
03089300,HERITAGE BIBLE COLLEGE                  ,NC,28335-0000,Private      ,0,0,0,32,80,112
03104200,CAROLINAS COLLEGE OF HEALTH SCIENCE     ,NC,28232-2861,Public       ,3,38,41,566,1911,2477
03109000,LIVING ARTS COLLEGE                     ,NC,27614-7076,Proprietary  ,13,22,35,686,900,1586
03361300,MEDICAL ARTS MASSAGE SCHOOL             ,NC,27616-6453,Proprietary  ,2,18,20,112,490,602
03513400,APEX SCHOOL OF THEOLOGY                 ,NC,27703-8024,Private      ,1,24,25,27,1245,1272
03555300,SOUTHEASTERN INSTITUTE                  ,NC,28217-0000,Proprietary  ,6,52,58,181,892,1073
03555400,SOUTHEASTERN SCHOOL OF NEUROMUSCULAR  MA,NC,29406-0000,Proprietary  ,8,13,21,81,241,322
03570300,CAROLINA CHRISTIAN COLLEGE              ,NC,27105-3241,Private      ,1,1,2,35,183,218
03663300,HOOD THEOLOGICAL SEMINARY               ,NC,28144-5768,Private      ,0,4,4,3,238,241
03748500,DURHAM BEAUTY ACADEMY                   ,NC,27707-3569,Proprietary  ,0,22,22,42,226,268
03777300,PAUL MITCHELL THE SCHOOL GASTONIA       ,NC,28054-0460,Proprietary  ,8,26,34,239,562,801
03827300,NEW LIFE THEOLOGICAL SEMINARY           ,NC,28205-1648,Private      ,1,9,10,26,326,352
04073300,JUNG TAO SCHOOL OF CLASSICAL CHINESE MED,NC,28679-9657,Private      ,0,0,0,2,63,65
04101300,CAROLINA SCHOOL OF BROADCASTING         ,NC,28214-8085,Proprietary  ,0,10,10,165,476,641
04115700,REGINA'S COLLEGE OF BEAUTY              ,NC,28110-2831,Proprietary  ,2,32,34,51,297,348
04120300,HEALTH AND STYLE INSTITUTE              ,NC,27265-3114,Proprietary  ,8,49,57,75,375,450
04129400,CENTER FOR MASSAGE & NATURAL HEALTH     ,NC,28787-8331,Proprietary  ,1,0,1,33,140,173
04140700,AVEDA INSTITUTE CHAPEL HILL             ,NC,27516-2559,Proprietary  ,8,15,23,211,329,540
04143500,CHARLOTTE SCHOOL OF LAW                 ,NC,28208-2816,Proprietary  ,0,21,21,120,2834,2954
04146400,DAOIST TRADITIONS COLLEGE OF CHINESE MED,NC,28801-1060,Proprietary  ,0,0,0,7,132,139
04149300,PARK WEST BARBER SCHOOL                 ,NC,27701-4022,Proprietary  ,13,55,68,205,894,1099
04154200,CAROLINA COLLEGE OF BIBLICAL STUDIES    ,NC,29303-5157,Private      ,1,10,11,34,358,392
04172800,BODY THERAPY INSTITUTE                  ,NC,27344-6728,Proprietary  ,0,2,2,24,136,160
04173000,SHEPHERDS THEOLOGICAL SEMINARY          ,NC,27518-9316,Private      ,0,0,0,0,51,51
04173700,GRACE COLLEGE OF DIVINITY               ,NC,28314-2343,Private      ,1,7,8,33,172,205
04178100,CAROLINA COLLEGE OF HAIR DESIGN         ,NC,28802-1232,Proprietary  ,1,1,2,65,157,222
04204700,PAUL MITCHELL THE SCHOOL RALEIGH        ,NC,27612-7358,Proprietary  ,4,10,14,160,308,468
04206500,MYCOMPUTERCAREER.COM                    ,NC,27606-3365,Proprietary  ,10,80,90,93,1062,1155
04214600,GRACE COLLEGE OF BARBERING              ,NC,28513-7178,Private      ,3,5,8,17,86,103
04219100,ALEXANDER PAUL INSTITUTE OF HAIR DESIGN ,NC,27858-3344,Proprietary  ,1,2,3,16,35,51
04227600,SHERRILL'S UNIVERSITY OF BARBER & COSMET,NC,27610-2431,Proprietary  ,11,26,37,11,26,37
04228400,BEYOND MEASURE BARBERING INSTITUTE      ,NC,27302-2323,Proprietary  ,1,7,8,6,25,31
00298800,BISMARCK STATE COLLEGE                  ,ND,58501-1299,Public       ,23,53,76,2047,1728,3775
00298900,DICKINSON STATE UNIVERSITY              ,ND,58601-4896,Public       ,2,12,14,858,641,1499
00299000,JAMESTOWN COLLEGE                       ,ND,58405-3401,Private      ,5,4,9,1048,228,1276
00299100,LAKE REGION STATE COLLEGE               ,ND,58301-1598,Public       ,0,24,24,409,558,967
00299200,UNIVERSITY OF MARY                      ,ND,58504-9652,Private      ,2,35,37,1731,1733,3464
00299300,MAYVILLE STATE UNIVERSITY               ,ND,58257-1299,Public       ,2,13,15,684,375,1059
00299400,MINOT STATE UNIVERSITY                  ,ND,58707-0001,Public       ,4,28,32,1613,1538,3151
00299500,DAKOTA COLLEGE AT BOTTINEAU             ,ND,58318-1159,Public       ,7,12,19,336,294,630
00299600,NORTH DAKOTA STATE CLG OF SCIENCE       ,ND,58076-0002,Public       ,11,21,32,1712,850,2562
00299700,NORTH DAKOTA STATE UNIVERSITY           ,ND,58108-6050,Public       ,22,60,82,10721,3575,14296
00300500,UNIVERSITY OF NORTH DAKOTA              ,ND,58202-8193,Public       ,36,124,160,8962,6259,15221
00300700,WILLISTON STATE COLLEGE                 ,ND,58802-1326,Public       ,6,9,15,346,396,742
00300800,VALLEY CITY STATE UNIVERSITY            ,ND,58072-0000,Public       ,1,22,23,766,422,1188
00775600,JOSEF'S SCHOOL OF HAIR DESIGN INC       ,ND,58102-4977,Proprietary  ,3,6,9,70,114,184
00869408,RASMUSSEN COLLEGE - FARGO               ,ND,58103-7196,Proprietary  ,5,18,23,203,871,1074
00869415,RASMUSSEN COLLEGE - BISMARCK            ,ND,58503-0000,Proprietary  ,1,11,12,74,429,503
00935400,MEDCENTER ONE COLLEGE OF NURSING        ,ND,58501-4494,Private      ,0,0,0,116,124,240
01040600,JOSEF'S SCHOOL OF HAIR DESIGN           ,ND,58201-6394,Proprietary  ,4,6,10,75,126,201
01205900,TRINITY BIBLE COLLEGE                   ,ND,58436-7150,Private      ,2,1,3,205,96,301
01229500,JZ TREND ACADEMY PAUL MITCHELL PARTNER S,ND,58501-0000,Proprietary  ,1,2,3,53,58,111
02188200,SITTING BULL COLLEGE                    ,ND,58538-9701,Public       ,0,13,13,100,395,495
02236500,LITTLE HOOP COMMUNITY COLLEGE           ,ND,58335-0000,Public       ,2,13,15,59,268,327
02242900,UNITED TRIBES TECHNICAL COLLEGE         ,ND,58504-0000,Private      ,4,21,25,285,855,1140
02298200,HEADQUARTERS ACADEMY OF HAIR DESIGN     ,ND,58701-0000,Proprietary  ,5,4,9,52,90,142
02301100,TURTLE MTN CMNTY COLG-FIN AID OFC       ,ND,58316-0000,Private      ,9,46,55,245,641,886
02553700,FORT BERTHOLD COMMUNITY COLLEGE         ,ND,58763-0000,Public       ,0,0,0,51,171,222
03087200,MOLER BARBER CLG OF HAIRSTYLING         ,ND,58103-0000,Proprietary  ,1,0,1,5,19,24
04031300,SALON PROFESSIONAL ACADEMY (THE)        ,ND,58103-3337,Proprietary  ,0,4,4,102,81,183
04139400,HAIR ACADEMY (THE)                      ,ND,58501-4929,Proprietary  ,3,6,9,42,47,89
04223500,LYNNES WELDING TRAINING                 ,ND,58102-4018,Proprietary  ,0,3,3,3,10,13
00301005,ANTIOCH UNIV/SEATTLE                    ,WA,98121-0000,Private      ,1,12,13,162,1597,1759
00376900,BELLEVUE COLLEGE                        ,WA,98007-6484,Public       ,29,145,174,6532,9860,16392
00377000,BIG BEND COMMUNITY COLLEGE              ,WA,98837-3299,Public       ,7,30,37,1358,2126,3484
00377100,"CENTRAL WASHINGTON UNIV., FIN AID       ",WA,98926-7495,Public       ,51,109,160,13819,7154,20973
00377200,CENTRALIA COLLEGE                       ,WA,98531-4099,Public       ,6,31,37,1529,2751,4280
00377300,CLARK COLLEGE                           ,WA,98663-3598,Public       ,36,122,158,6499,11954,18453
00377400,COLUMBIA BASIN COLLEGE                  ,WA,99301-3379,Public       ,45,111,156,4065,5732,9797
00377500,EASTERN WASHINGTON UNIVERSITY           ,WA,99004-2447,Public       ,36,108,144,14065,8775,22840
00377600,EVERETT COMMUNITY COLLEGE               ,WA,98201-1352,Public       ,26,101,127,4347,8900,13247
00377700,HERITAGE UNIVERSITY                     ,WA,98948-9562,Private      ,3,20,23,696,1756,2452
00377800,GONZAGA UNIVERSITY                      ,WA,99258-0083,Private      ,17,87,104,9331,4498,13829
00377900,GRAYS HARBOR COLLEGE                    ,WA,98520-7599,Public       ,4,30,34,904,2032,2936
00378000,GREEN RIVER COMMUNITY COLLEGE           ,WA,98092-3622,Public       ,61,196,257,4257,7413,11670
00378100,HIGHLINE COMMUNITY COLLEGE              ,WA,98198-9800,Public       ,36,164,200,4452,7873,12325
00378200,LOWER COLUMBIA COLLEGE                  ,WA,98632-0310,Public       ,9,50,59,1624,4104,5728
00378300,NORTHWEST UNIVERSITY                    ,WA,98083-0000,Private      ,3,28,31,1718,1409,3127
00378400,OLYMPIC COLLEGE                         ,WA,98337-1600,Public       ,21,81,102,2739,7178,9917
00378500,PACIFIC LUTHERAN UNIVERSITY             ,WA,98447-0003,Private      ,14,40,54,5606,2954,8560
00378600,PENINSULA COLLEGE                       ,WA,98362-6660,Public       ,5,20,25,772,2390,3162
00378700,SEATTLE CENTRAL COMMUNITY COLLEGE       ,WA,98122-2413,Public       ,45,199,244,4504,9958,14462
00378703,SEATTLE VOCATIONAL INSTITUTE            ,WA,98144-0000,Public       ,3,43,46,278,1127,1405
00378800,SEATTLE PACIFIC UNIVERSITY              ,WA,98119-1997,Private      ,18,31,49,8405,3691,12096
00379000,SEATTLE UNIVERSITY                      ,WA,98122-1090,Private      ,26,59,85,10881,8081,18962
00379100,SHORELINE COMMUNITY COLLEGE             ,WA,98133-5696,Public       ,16,86,102,3248,6399,9647
00379200,SKAGIT VALLEY COLLEGE                   ,WA,98273-5899,Public       ,14,39,53,2120,4260,6380
00379300,SPOKANE COMMUNITY COLLEGE               ,WA,99207-5399,Public       ,17,103,120,5282,12500,17782
00379400,ST MARTIN'S UNIVERSITY                  ,WA,98503-7500,Private      ,1,32,33,1696,1611,3307
00379600,TACOMA COMMUNITY COLLEGE                ,WA,98466-6100,Public       ,58,250,308,5497,13620,19117
00379700,UNIVERSITY OF PUGET SOUND               ,WA,98416-1039,Private      ,11,37,48,5870,2734,8604
00379800,UNIVERSITY OF WASHINGTON                ,WA,98195-1122,Public       ,74,208,282,41643,34078,75721
00379900,WALLA WALLA UNIVERSITY                  ,WA,99324-1198,Private      ,7,14,21,2059,971,3030
00380000,WASHINGTON STATE UNIVERSITY             ,WA,99164-1035,Public       ,81,148,229,29522,16060,45582
00380100,WENATCHEE VALLEY COLLEGE                ,WA,98801-1799,Public       ,18,75,93,2138,3348,5486
00380200,WESTERN WASHINGTON UNIVERSITY           ,WA,98225-5946,Public       ,35,52,87,19688,6064,25752
00380300,WHITMAN COLLEGE                         ,WA,99362-2067,Private      ,0,2,2,2765,222,2987
00380400,WHITWORTH UNIVERSITY                    ,WA,99251-0001,Private      ,6,33,39,4693,1828,6521
00380500,YAKIMA VALLEY COMMUNITY COLLEGE         ,WA,98907-2520,Public       ,17,77,94,3619,5525,9144
00499900,BELLINGHAM TECHNICAL COLLEGE            ,WA,98225-0000,Public       ,11,59,70,1343,3581,4924
00500000,PIERCE COLLEGE                          ,WA,98498-1919,Public       ,26,192,218,4591,10858,15449
00500100,EDMONDS COMMUNITY COLLEGE               ,WA,98036-5999,Public       ,20,97,117,3345,6528,9873
00500600,WALLA WALLA COMMUNITY COLLEGE           ,WA,99362-9267,Public       ,26,80,106,2176,3367,5543
00530600,BATES TECHNICAL COLLEGE                 ,WA,98405-0000,Public       ,18,113,131,1579,5757,7336
00537200,SOUTH PUGET SOUND COMMUNITY COLLEGE     ,WA,98512-6292,Public       ,14,59,73,2836,6503,9339
00537300,LAKE WASHINGTON TECHNICAL COLLEGE       ,WA,98034-8505,Public       ,9,42,51,1162,3513,4675
00575200,CLOVER PARK TECHNICAL COLLEGE           ,WA,98499-0000,Public       ,12,101,113,1980,7600,9580
00815500,EVERGREEN STATE COLLEGE (THE)           ,WA,98505-0002,Public       ,12,43,55,4236,5192,9428
00907901,EVEREST COLLEGE                         ,WA,98684-6950,Proprietary  ,4,28,32,300,1021,1321
00938700,PERRY TECHNICAL INSTITUTE               ,WA,98903-1239,Private      ,33,38,71,977,1480,2457
00954400,SPOKANE FALLS COMMUNITY COLLEGE         ,WA,99224-5204,Public       ,23,74,97,5552,8925,14477
00970400,NORTH SEATTLE COMMUNITY COLLEGE         ,WA,98103-3599,Public       ,25,155,180,2572,7323,9895
00970600,SOUTH SEATTLE COMMUNITY COLLEGE         ,WA,98106-1499,Public       ,26,127,153,3086,6444,9530
00973900,GLEN DOW ACAD OF HAIR DESIGN            ,WA,99201-0209,Proprietary  ,2,10,12,157,409,566
01036400,WHATCOM COMMUNITY COLLEGE               ,WA,98226-8003,Public       ,8,42,50,2682,4183,6865
01043400,RENTON TECHNICAL COLLEGE                ,WA,98056-0000,Public       ,16,63,79,1452,4247,5699
01148100,DIVERS INSTITUTE OF TECHNOLOGY          ,WA,98107-0000,Proprietary  ,14,32,46,242,812,1054
01231500,CORNISH COLLEGE OF THE ARTS             ,WA,98121-4604,Private      ,3,6,9,1878,685,2563
01249600,TONI & GUY HAIRDRESSING ACADEMY         ,WA,98133-5615,Proprietary  ,0,1,1,61,119,180
01302200,CITY UNIVERSITY OF SEATTLE              ,WA,98005-0000,Private      ,3,38,41,344,2619,2963
02105300,EVERGREEN BEAUTY AND BARBER COLLEGE     ,WA,98007-3722,Proprietary  ,2,10,12,114,307,421
02106700,TRINITY LUTHERAN COLLEGE                ,WA,98201-3569,Private      ,1,4,5,296,172,468
02180000,NORTHWEST INDIAN COLLEGE                ,WA,98226-9278,Public       ,7,29,36,248,1067,1315
02184200,PAROBA COLLEGE OF COSMETOLOGY           ,WA,98208-0000,Proprietary  ,1,14,15,61,299,360
02202200,STYLEMASTERS COLLEGE OF HAIR DESIGN     ,WA,98632-0000,Proprietary  ,0,14,14,55,225,280
02203300,GENE JUAREZ BEAUTY SCHOOLS              ,WA,98043-5427,Proprietary  ,7,22,29,489,801,1290
02222900,INTERNATIONAL AIR & HOSPITALITY ACADEMY ,WA,98661-4835,Proprietary  ,14,43,57,474,971,1445
02236800,PROFESSIONAL BEAUTY SCHOOL              ,WA,98902-0000,Proprietary  ,0,4,4,68,159,227
02242500,BASTYR UNIVERSITY                       ,WA,98028-0000,Private      ,3,14,17,266,1881,2147
02291300,ART INSTITUTE OF SEATTLE                ,WA,98121-1622,Proprietary  ,18,45,63,2803,2874,5677
02300100,EVEREST COLLEGE                         ,WA,98367-1835,Proprietary  ,6,28,34,172,772,944
02300103,EVEREST COLLEGE - EVERETT               ,WA,98208-2610,Proprietary  ,11,80,91,379,1311,1690
02300104,EVEREST COLLEGE - TACOMA                ,WA,98402-3004,Proprietary  ,25,138,163,715,2833,3548
02326500,INTERFACE COLLEGE                       ,WA,99201-4326,Proprietary  ,2,10,12,76,396,472
02331400,NORTHWEST HAIR ACADEMY                  ,WA,98273-0000,Proprietary  ,2,12,14,64,171,235
02331402,NORTHWEST HAIR ACADEMY - EVERETT        ,WA,98204-0000,Proprietary  ,1,8,9,60,168,228
02331403,NORTHWEST HAIR ACADEMY - BELLINGHAM     ,WA,98226-5515,Proprietary  ,0,2,2,62,164,226
02331404,NORTHWEST HAIR ACADEMY - YAKIMA         ,WA,98901-2305,Proprietary  ,0,3,3,58,125,183
02504900,ACADEMY OF HAIR DESIGN (THE)            ,WA,98801-0000,Proprietary  ,0,0,0,91,178,269
02541900,BJ'S BEAUTY AND BARBER COLLEGE          ,WA,98409-0000,Proprietary  ,4,8,12,112,482,594
02602100,NORTHWEST COLLEGE OF ART                ,WA,98370-8625,Proprietary  ,1,2,3,207,110,317
02606200,EVEREST COLLEGE                         ,WA,98055-2990,Proprietary  ,14,77,91,358,1162,1520
02617500,EVEREST COLLEGE                         ,WA,98133-9018,Proprietary  ,5,49,54,721,2074,2795
03031406,INTERNATIONAL ACADEMY OF DESIGN & TECH  ,WA,98188-3319,Proprietary  ,5,20,25,341,748,1089
03065000,LUCAS MARC ACADEMY                      ,WA,99352-9700,Proprietary  ,3,3,6,96,191,287
03071800,ITT TECHNICAL INSTITUTE                 ,WA,99216-1589,Proprietary  ,24,171,195,572,2462,3034
03071805,ITT TECHNICAL INSTITUTE - SEATTLE       ,WA,98168-3346,Proprietary  ,29,209,238,753,3011,3764
03099000,CORTIVA INSTITUTE - SEATTLE             ,WA,98109-5474,Proprietary  ,11,32,43,199,635,834
03110800,BAKKE GRADUATE UNIVERSITY               ,WA,98104-1222,Private      ,0,4,4,14,105,119
03139500,MONTESSORI SCHOOLS OF WASHINGTON        ,WA,98203-6600,Private      ,0,1,1,3,40,43
03280300,SEATTLE INST OF ORIENTAL MEDICINE       ,WA,98115-0000,Proprietary  ,3,5,8,61,225,286
03283300,NORTHWEST HVAC/R ASSOCIATION & TRAINING ,WA,99202-0000,Private      ,1,0,1,51,160,211
03466400,SEATTLE SCHOOL OF THEOLOGY AND PSYCHOLOG,WA,98121-1177,Private      ,3,2,5,119,587,706
03483500,CASCADIA COMMUNITY COLLEGE              ,WA,98011-9510,Public       ,4,23,27,1713,2035,3748
03490400,EMIL FRIES PIANO HOSPITAL & TRAININ     ,WA,98661-4323,Private      ,0,1,1,9,40,49
03670301,TONI&GUY HAIRDRESSING ACADEMY -         ,WA,98225-4526,Proprietary  ,3,10,13,5,24,29
03689400,FAITH EVANGELICAL COLLEGE & SEMINARY    ,WA,98407-2607,Private      ,0,9,9,43,442,485
03724300,DIGIPEN INSTITUTE OF TECHNOLOGY         ,WA,98052-5170,Proprietary  ,3,2,5,1223,589,1812
03917300,EVERGREEN BEAUTY AND BARBER COLLEGE     ,WA,98208-3759,Proprietary  ,10,23,33,173,530,703
03932500,TOTAL COSMETOLOGY TRAINING CENTER       ,WA,99217-6231,Proprietary  ,4,13,17,96,387,483
04120000,SUNNYSIDE BEAUTY ACADEMY                ,WA,98944-8711,Proprietary  ,0,2,2,22,45,67
04127200,VICTORIA'S ACADEMY OF COSMETOLOGY       ,WA,99336-3826,Proprietary  ,3,10,13,97,268,365
04130500,PACIFIC NORTHWEST UNIV OF HEALTH SCIENCE,WA,98901-1471,Private      ,1,0,1,79,621,700
04130800,CASCADE BEAUTY COLLEGE                  ,WA,98002-5504,Proprietary  ,0,5,5,47,162,209
04132800,INLAND MASSAGE INSTITUTE                ,WA,99218-5016,Proprietary  ,0,3,3,54,240,294
04149400,GARY MANUEL AVEDA INSTITUTE             ,WA,98122-3807,Proprietary  ,13,25,38,251,563,814
04149600,GP INSTITUTE OF COSMETOLOGY             ,WA,98118-2353,Proprietary  ,0,0,0,35,91,126
04155000,NORTHWEST SCHOOL OF WOODEN BOAT BUILDING,WA,98339-8706,Private      ,0,1,1,11,100,111
04161200,BAINBRIDGE GRADUATE INSTITUTE           ,WA,98110-2870,Private      ,0,2,2,5,183,188
04170100,SALON PROFESSIONAL ACADEMY (THE)        ,WA,98409-7360,Proprietary  ,5,8,13,174,464,638
04172900,ACADEMY OF COSMETOLOGY                  ,WA,99354-2651,Proprietary  ,0,5,5,69,180,249
04188900,NORTHWEST INSTITUTE OF LITERARY ARTS    ,WA,98249-0000,Private      ,0,1,1,10,51,61
04191900,PAUL MITCHELL THE SCHOOL SPOKANE        ,WA,99037-5041,Proprietary  ,1,14,15,259,442,701
04223600,ACADEMY OF INTERACTIVE ENTERTAINMENT    ,WA,98109-4623,Private      ,0,7,7,31,89,120
00340100,BROWN UNIVERSITY                        ,RI,02912-9127,Private      ,4,6,10,18820,1045,19865
00340101,BROWN UNIVERSITY - GRADUATE SCHOOL      ,RI,02912-1827,Private      ,0,4,4,55,1647,1702
00340102,BROWN MEDICAL SCHOOL                    ,RI,02912-0000,Private      ,0,3,3,70,563,633
00340200,BRYANT UNIVERSITY                       ,RI,02917-1284,Private      ,5,4,9,5536,612,6148
00340400,JOHNSON & WALES UNIVERSITY              ,RI,02903-3703,Private      ,62,68,130,21081,5605,26686
00340600,PROVIDENCE COLLEGE                      ,RI,02918-0001,Private      ,4,13,17,8575,1198,9773
00340700,RHODE ISLAND COLLEGE                    ,RI,02908-1991,Public       ,11,42,53,8760,5307,14067
00340800,COMMUNITY COLLEGE OF RI - WARWICK       ,RI,02906-0000,Public       ,60,198,258,10658,13633,24291
00340900,RHODE ISLAND SCHOOL OF DESIGN           ,RI,02903-2784,Private      ,4,8,12,3078,1311,4389
00341000,ROGER WILLIAMS UNIVERSITY               ,RI,02809-2921,Private      ,4,13,17,8823,1752,10575
00341100,SALVE REGINA UNIVERSITY                 ,RI,02840-4192,Private      ,0,9,9,4787,628,5415
00341400,UNIVERSITY OF RHODE ISLAND              ,RI,02881-0000,Public       ,26,49,75,24644,5071,29715
00659100,ST. JOSEPH HOSP SCH OF NURSING          ,RI,02904-5199,Private      ,0,3,3,110,361,471
00784400,SANFORD-BROWN INSTITUTE                 ,RI,02920-7807,Proprietary  ,0,0,0,27,136,163
00784500,NEW ENGLAND INSTITUTE OF TECHNOLOGY     ,RI,02886-0000,Private      ,9,18,27,2732,3437,6169
00817811,EMPIRE BEAUTY SCHOOL - PROVIDENCE       ,RI,02903-3042,Proprietary  ,0,0,0,80,160,240
01246116,LINCOLN TECHNICAL INSTITUTE - LINCOLN   ,RI,02865-4211,Proprietary  ,14,51,65,495,1062,1557
01260608,EMPIRE BEAUTY SCHOOL - WARWICK          ,RI,02886-1534,Proprietary  ,0,0,0,77,97,174
02531802,PAUL MITCHELL THE SCHOOL-CRANSTON       ,RI,02920-0000,Proprietary  ,5,5,10,112,113,225
02584400,NEW ENGLAND TRACTOR TRAILER TRAINING SCH,RI,02860-1752,Proprietary  ,22,192,214,186,1405,1591
03080000,NEWPORT SCHOOL OF HAIRDRESSING          ,RI,02860-4038,Proprietary  ,0,3,3,14,84,98
03732300,INTERNATIONAL YACHT RESTORATION SCH     ,RI,02840-6720,Private      ,0,0,0,33,67,100
04141200,TONI & GUY HAIRDRESSING ACADEMY         ,RI,02920-0000,Proprietary  ,9,3,12,139,123,262
00341700,ALLEN UNIVERSITY                        ,SC,29204-1085,Private      ,11,16,27,1215,751,1966
00341800,ANDERSON UNIVERSITY                     ,SC,29621-4035,Private      ,6,40,46,3334,1658,4992
00341900,CHARLESTON SOUTHERN UNIVERSITY          ,SC,29406-2160,Private      ,63,57,120,5157,3121,8278
00342000,BENEDICT COLLEGE                        ,SC,29204-1086,Private      ,36,29,65,4022,1941,5963
00342100,BOB JONES UNIVERSITY                    ,SC,29614-1000,Proprietary  ,7,16,23,2832,553,3385
00342200,SOUTHERN WESLEYAN UNIVERSITY            ,SC,29630-1020,Private      ,7,53,60,948,1975,2923
00342300,THE CITADEL                             ,SC,29409-0002,Public       ,14,48,62,3621,1644,5265
00342400,CLAFLIN UNIVERSITY                      ,SC,29115-4498,Private      ,120,39,159,3110,1296,4406
00342500,CLEMSON UNIVERSITY                      ,SC,29634-0001,Public       ,76,101,177,21935,4850,26785
00342600,UNIV OF SC AT SUMTER                    ,SC,29150-2498,Public       ,9,19,28,1037,974,2011
00342700,COKER COLLEGE                           ,SC,29550-3797,Private      ,5,19,24,1290,1100,2390
00342800,COLLEGE OF CHARLESTON                   ,SC,29424-0100,Public       ,39,41,80,13284,3984,17268
00342900,COLUMBIA INTERNATIONAL UNIVERSITY       ,SC,29203-1599,Private      ,2,15,17,753,961,1714
00343000,COLUMBIA COLLEGE                        ,SC,29203-5998,Private      ,8,77,85,1373,2067,3440
00343100,CONVERSE COLLEGE                        ,SC,29302-1931,Private      ,5,11,16,1261,865,2126
00343200,ERSKINE COLLEGE                         ,SC,29639-0000,Private      ,3,0,3,760,72,832
00343201,ERSKINE THEOLOGICAL SEMINARY            ,SC,29639-0000,Private      ,0,1,1,6,112,118
00343400,FURMAN UNIVERSITY                       ,SC,29613-5253,Private      ,7,14,21,4556,704,5260
00343500,LANDER UNIVERSITY                       ,SC,29649-2099,Public       ,18,17,35,4405,1113,5518
00343600,LIMESTONE COLLEGE                       ,SC,29340-3799,Private      ,16,75,91,2090,3620,5710
00343700,LUTHERAN THEOLOGICAL SOUTHERN SEM       ,SC,29203-5898,Private      ,0,1,1,9,154,163
00343800,MEDICAL UNIV OF SOUTH CAROLINA - FA     ,SC,29425-1760,Public       ,3,23,26,544,3812,4356
00343900,MORRIS COLLEGE                          ,SC,29150-3599,Private      ,17,12,29,1484,735,2219
00344000,NEWBERRY COLLEGE                        ,SC,29108-2197,Private      ,10,11,21,1800,449,2249
00344100,NORTH GREENVILLE COLLEGE                ,SC,29688-1892,Private      ,8,9,17,2809,564,3373
00344500,PRESBYTERIAN COLLEGE                    ,SC,29325-2503,Private      ,1,2,3,1848,471,2319
00344600,SOUTH CAROLINA STATE UNIVERSITY         ,SC,29117-4427,Public       ,36,35,71,5362,2985,8347
00344700,SPARTANBURG METHODIST COLLEGE           ,SC,29301-5899,Private      ,5,10,15,1651,385,2036
00344800,UNIVERSITY OF SOUTH CAROLINA            ,SC,29208-3999,Public       ,90,225,315,31246,13864,45110
00344900,UNIVERSITY OF SOUTH CAROLINA AIKEN      ,SC,29801-6399,Public       ,19,22,41,3753,1993,5746
00345000,UNIV OF SC AT BEAUFORT                  ,SC,29902-0000,Public       ,11,25,36,2301,1489,3790
00345100,COASTAL CAROLINA UNIVERSITY             ,SC,29528-0000,Public       ,81,71,152,14912,3799,18711
00345300,UNIV OF SC AT LANCASTER                 ,SC,29721-0889,Public       ,5,9,14,1284,972,2256
00345400,UNIV OF SC SYSTEM SALKEHATCHIE          ,SC,29810-0617,Public       ,3,12,15,773,881,1654
00345500,VOORHEES COLLEGE                        ,SC,29042-0000,Private      ,5,10,15,863,424,1287
00345600,WINTHROP UNIVERSITY                     ,SC,29733-0001,Public       ,21,42,63,7083,2717,9800
00345700,WOFFORD COLLEGE                         ,SC,29303-3663,Private      ,3,6,9,2852,314,3166
00399000,FLORENCE-DARLINGTON TECH COLLEGE        ,SC,29501-0548,Public       ,64,190,254,3760,7515,11275
00399100,GREENVILLE TECHNICAL COLLEGE            ,SC,29607-2439,Public       ,131,334,465,9127,14138,23265
00399200,PIEDMONT TECHNICAL COLLEGE              ,SC,29648-1467,Public       ,45,190,235,3042,6596,9638
00399300,MIDLANDS TECHNICAL COLLEGE              ,SC,29202-0000,Public       ,99,352,451,8330,13594,21924
00399400,SPARTANBURG COMMUNITY COLLEGE           ,SC,29305-4386,Public       ,47,139,186,3871,6270,10141
00399500,CENTRAL CAROLINA TECHNICAL COLLEGE      ,SC,29150-2499,Public       ,49,162,211,2115,5395,7510
00399600,YORK TECHNICAL COLLEGE                  ,SC,29730-3395,Public       ,42,153,195,3556,6289,9845
00492000,TRIDENT TECHNICAL COLLEGE               ,SC,29423-8067,Public       ,180,550,730,8389,18485,26874
00492300,CLINTON JR COLLEGE                      ,SC,29730-5152,Private      ,1,6,7,225,248,473
00492400,FORREST JUNIOR COLLEGE                  ,SC,29624-2405,Proprietary  ,4,25,29,64,436,500
00492500,HORRY-GEORGETOWN TECH COLLEGE           ,SC,29526-9521,Public       ,46,131,177,4617,8490,13107
00492600,TRI-COUNTY TECHNICAL COLLEGE            ,SC,29670-9133,Public       ,38,106,144,4717,4836,9553
00492700,UNIV OF SC AT UNION                     ,SC,29379-0729,Public       ,3,3,6,316,408,724
00499204,MILLER-MOTTE TECHNICAL COLLEGE - CONWAY ,SC,29526-9508,Proprietary  ,10,64,74,519,1835,2354
00536300,DENMARK TECHNICAL COLLEGE               ,SC,29042-0000,Public       ,18,116,134,940,2600,3540
00681500,ORANGEBURG-CALHOUN TECHNICAL COLG       ,SC,29118-8299,Public       ,58,74,132,2082,3257,5339
00695100,UNIVERSITY OF SOUTH CAROLINA UPSTATE    ,SC,29303-9972,Public       ,34,69,103,6963,4077,11040
00760200,NORTHEASTERN TECHNICAL COLLEGE          ,SC,29520-7015,Public       ,21,40,61,764,1353,2117
00922600,FRANCIS MARION UNIVERSITY               ,SC,29501-0000,Public       ,31,35,66,5218,2459,7677
00932200,WILLIAMSBURG TECHNICAL COLLEGE          ,SC,29556-4197,Public       ,36,32,68,382,868,1250
00991000,TECHNICAL COLLEGE OF THE LOWCOUNTRY     ,SC,29902-5441,Public       ,13,95,108,1331,3673,5004
00991100,UNIV OF SC-REGIONAL CAMPUSES ADMIN      ,SC,29208-0001,Public       ,5,6,11,272,380,652
01005600,AIKEN TECHNICAL COLLEGE                 ,SC,29802-0696,Public       ,26,85,111,2066,4026,6092
01019806,ECPI UNIVERSITY - GREENVILLE            ,SC,29615-4232,Proprietary  ,6,33,39,33,202,235
01019809,ECPI UNIVERSITY - CHARLESTON            ,SC,29420-4264,Proprietary  ,9,44,53,30,216,246
01019811,ECPI UNIVERSITY - COLUMBIA              ,SC,29210-6467,Proprietary  ,6,21,27,15,140,155
01179901,PAUL MITCHELL THE SCHOOL COLUMBIA       ,SC,29201-3126,Proprietary  ,3,9,12,99,238,337
01179902,PAUL MITCHELL THE SCHOOL CHARLESTON     ,SC,29418-6993,Proprietary  ,6,9,15,106,245,351
01179903,PAUL MITCHELL THE SCHOOL FAYETTEVILLE - ,SC,29607-0000,Proprietary  ,1,7,8,3,11,14
01209200,KENNETH SHULER SCHOOL OF COSMETOLOGY    ,SC,29732-2169,Proprietary  ,5,26,31,212,551,763
01303907,SOUTH UNIVERSITY                        ,SC,29203-6400,Proprietary  ,25,164,189,634,3593,4227
02063700,SHERMAN CLG STRAIGHT CHIROPRACTIC       ,SC,29316-0000,Private      ,0,1,1,19,394,413
02338600,CHARZANNE BEAUTY COLLEGE                ,SC,29649-0000,Proprietary  ,0,13,13,30,127,157
02341100,KENNETH SHULER SCHOOL OF COSMETOLOGY & N,SC,29210-0000,Proprietary  ,9,43,52,278,863,1141
02356600,CHARLESTON COSMETOLOGY INSTITUTE        ,SC,29420-0000,Proprietary  ,1,11,12,72,245,317
02359802,ITT TECHNICAL INSTITUTE -               ,SC,29615-4506,Proprietary  ,0,0,0,0,1,1
02552400,ACADEMY OF HAIR TECHNOLOGY              ,SC,29615-2363,Proprietary  ,1,12,13,66,260,326
02567600,SUMTER BEAUTY COLLEGE                   ,SC,29150-0000,Proprietary  ,1,7,8,37,136,173
02614202,MILLER - MOTTE TECHNICAL COLLEGE - NORTH,SC,29406-9239,Proprietary  ,14,56,70,451,1716,2167
03010614,VIRGINIA COLLEGE - GOLF ACADEMY OF AMERI,SC,29579-0000,Proprietary  ,2,3,5,131,237,368
03010617,VIRGINIA COLLEGE - GREENVILLE           ,SC,29607-7200,Proprietary  ,2,23,25,213,1015,1228
03010620,VIRGINIA COLLEGE - CHARLESTON           ,SC,29406-4999,Proprietary  ,12,20,32,219,913,1132
03010621,VIRGINIA COLLEGE - COLUMBIA             ,SC,29223-7527,Proprietary  ,4,26,30,219,1068,1287
03052300,KENNETH SHULER SCH COSM & HAIR DESG     ,SC,29841-2013,Proprietary  ,6,35,41,160,451,611
03088300,ACADEMY OF COSMETOLOGY                  ,SC,29418-5667,Proprietary  ,0,0,0,8,15,23
03293300,STRAND COLLEGE OF HAIR DESIGN           ,SC,29572-4310,Proprietary  ,0,2,2,52,149,201
03304300,CENTURA COLLEGE                         ,SC,29406-9235,Proprietary  ,7,56,63,145,887,1032
03513300,LACY COSMETOLOGY SCHOOL                 ,SC,29803-9084,Proprietary  ,0,0,0,31,83,114
03513301,LACY COSMETOLOGY SCHOOL -               ,SC,29072-0000,Proprietary  ,0,0,0,22,60,82
03513302,LACY COSMETOLOGY SCHOOL -               ,SC,29445-0000,Proprietary  ,0,0,0,20,67,87
03513303,LACY COSMETOLOGY SCHOOL - WEST ASHLEY   ,SC,29407-4605,Proprietary  ,0,0,0,6,38,44
03709301,EDWARD VIA VIRGINIA COLLEGE OF OSTEOPATH,SC,29303-3639,Private      ,0,5,5,23,613,636
03746300,LEGRAND INSTITUTE OF COSMETOLOGY        ,SC,29020-0000,Proprietary  ,0,1,1,22,78,100
03746400,SOUTHEASTERN INSTITUTE                  ,SC,29210-0000,Proprietary  ,10,28,38,101,560,661
03768400,STYLETRENDS BARBER AND HAIRSTYLING ACADE,SC,29730-4511,Proprietary  ,1,5,6,27,126,153
03856400,W. L. BONNER COLLEGE                    ,SC,29203-0000,Private      ,0,0,0,11,94,105
04083300,MARION COUNTY TECHNICAL EDUCATION CENTER,SC,29571-0000,Public       ,1,2,3,33,183,216
04096300,CHARLESTON SCHOOL OF LAW                ,SC,29402-0535,Proprietary  ,1,4,5,58,1098,1156
04158100,AIKEN SCHOOL OF COSMETOLOGY             ,SC,29801-4026,Proprietary  ,2,7,9,46,130,176
04166900,COSMETIC ARTS INSTITUTE                 ,SC,29488-2753,Proprietary  ,1,4,5,24,77,101
04172600,SALON 496 BARBER ACADEMY                ,SC,29607-2548,Proprietary  ,0,9,9,19,179,198
04192600,PALMETTO BEAUTY SCHOOL                  ,SC,29307-1424,Proprietary  ,4,18,22,57,205,262
04202900,JOLEI'S HAIR INSTITUTE                  ,SC,29114-9337,Proprietary  ,1,2,3,11,94,105
00345800,AUGUSTANA COLLEGE                       ,SD,57197-0001,Private      ,5,26,31,1749,325,2074
00345900,BLACK HILLS STATE UNIVERSITY            ,SD,57799-9670,Public       ,7,28,35,2503,1927,4430
00346100,DAKOTA WESLEYAN UNIVERSITY              ,SD,57301-4398,Private      ,4,4,8,835,305,1140
00346300,DAKOTA STATE UNIVERSITY                 ,SD,57042-1799,Public       ,4,12,16,1419,1026,2445
00346500,MOUNT MARTY COLLEGE                     ,SD,57078-3724,Private      ,1,8,9,544,486,1030
00346600,NORTHERN STATE UNIVERSITY               ,SD,57401-7198,Public       ,0,9,9,1712,885,2597
00346700,PRESENTATION COLLEGE                    ,SD,57401-1299,Private      ,2,2,4,649,559,1208
00346900,UNIVERSITY OF SIOUX FALLS               ,SD,57105-1699,Private      ,0,13,13,1440,759,2199
00347000,SOUTH DAKOTA SCH OF MINES & TECH        ,SD,57701-3995,Public       ,2,8,10,2135,766,2901
00347100,SOUTH DAKOTA STATE UNIVERSITY           ,SD,57007-2298,Public       ,11,34,45,8790,3497,12287
00347400,UNIVERSITY OF SOUTH DAKOTA              ,SD,57069-2390,Public       ,11,50,61,5728,4848,10576
00405600,SIOUX FALLS SEMINARY                    ,SD,57105-2729,Private      ,0,4,4,4,103,107
00405700,NATIONAL AMERICAN UNIVERSITY            ,SD,57701-3692,Proprietary  ,10,134,144,1078,16713,17791
00405707,NATIONAL AMERICAN UNIVERSITY            ,SD,57105-0000,Proprietary  ,0,10,10,86,907,993
00492900,MCKENNAN HOSP-RADOLOGICAL TECH          ,SD,57101-0000,Private      ,1,0,1,25,42,67
00530900,LAKE AREA TECHNICAL INSTITUTE           ,SD,57201-0730,Public       ,3,7,10,1200,658,1858
00598700,AVERA SACRED HEART HOSPITAL SCHOOL OF RA,SD,57078-3899,Private      ,0,0,0,8,15,23
00776400,SOUTHEAST TECHNICAL INST                ,SD,57107-0000,Public       ,9,37,46,1510,1940,3450
00828400,MITCHELL TECHNICAL INSTITUTE            ,SD,57301-9931,Public       ,2,2,4,809,479,1288
01013800,STEWART SCHOOL                          ,SD,57104-0000,Proprietary  ,6,7,13,134,133,267
01014804,COLORADO TECHNICAL UNIVERSITY           ,SD,57108-2272,Proprietary  ,0,5,5,85,492,577
01017000,WESTERN DAKOTA TECHNICAL INSTITUTE      ,SD,57701-4018,Public       ,7,15,22,544,1212,1756
01147701,SIOUX VALLEY HOSP-MEDICAL TECH          ,SD,57117-5039,Private      ,0,0,0,22,34,56
01465900,OGLALA LAKOTA COLLEGE                   ,SD,57752-0490,Public       ,0,13,13,404,1633,2037
02137100,BLACK HILLS BEAUTY COLLEGE              ,SD,57701-0000,Proprietary  ,3,5,8,119,176,295
02143700,SINTE GLESKA UNIVERSITY                 ,SD,57570-0000,Public       ,2,18,20,145,683,828
02144600,KILIAN COMMUNITY COLLEGE                ,SD,57103-7020,Private      ,0,10,10,116,444,560
02277300,SISSETON WAHPETON COLLEGE               ,SD,57262-0000,Public       ,3,3,6,60,212,272
02297800,HEADLINES ACADEMY                       ,SD,57701-0000,Proprietary  ,3,5,8,57,168,225
00347700,AQUINAS COLLEGE                         ,TN,37205-2086,Private      ,2,13,15,378,933,1311
00347800,AUSTIN PEAY STATE UNIVERSITY            ,TN,37044-0002,Public       ,30,244,274,9142,9496,18638
00347900,BELMONT UNIVERSITY                      ,TN,37212-3757,Private      ,14,45,59,8552,4246,12798
00348000,BETHEL UNIVERSITY                       ,TN,38201-1705,Private      ,9,304,313,2478,8561,11039
00348100,CARSON - NEWMAN UNIVERSITY              ,TN,37760-2204,Private      ,7,25,32,3870,967,4837
00348200,CHRISTIAN BROTHERS UNIVERSITY           ,TN,38104-5581,Private      ,7,46,53,2580,2463,5043
00348300,COLUMBIA STATE COMMUNITY COLLEGE        ,TN,38401-5653,Public       ,43,97,140,3593,3974,7567
00348500,CUMBERLAND UNIVERSITY                   ,TN,37087-3554,Private      ,3,24,27,1725,1287,3012
00348600,LIPSCOMB UNIVERSITY                     ,TN,37204-3951,Private      ,9,66,75,4349,3053,7402
00348700,EAST TENNESSEE STATE UNIV - MAIN CAMPUS ,TN,37614-2857,Public       ,28,136,164,13041,9661,22702
00348701,EAST TENNESSEE STATE UNIV - MEDICINE    ,TN,37614-1708,Public       ,3,6,9,433,707,1140
00348709,EAST TENNESSEE STATE UNIV - PHARMACY    ,TN,37614-1704,Public       ,0,2,2,167,545,712
00349000,FISK UNIVERSITY                         ,TN,37208-3045,Private      ,10,18,28,1834,905,2739
00349200,FREED-HARDEMAN UNIVERSITY               ,TN,38340-2399,Private      ,4,25,29,1891,928,2819
00349400,HIWASSEE COLLEGE                        ,TN,37354-4001,Private      ,3,6,9,401,215,616
00349500,JOHNSON UNIVERSITY                      ,TN,37998-9775,Private      ,2,22,24,1067,711,1778
00349600,KING COLLEGE                            ,TN,37620-2699,Private      ,8,80,88,1615,2930,4545
00349900,LANE COLLEGE                            ,TN,38301-4598,Private      ,14,11,25,2239,1148,3387
00350000,LEE UNIVERSITY                          ,TN,37320-0000,Private      ,8,50,58,4509,2172,6681
00350100,LEMOYNE-OWEN COLLEGE                    ,TN,38126-6510,Private      ,20,36,56,2005,2980,4985
00350200,LINCOLN MEMORIAL UNIVERSITY             ,TN,37752-7920,Private      ,4,59,63,2022,3996,6018
00350400,MARTIN METHODIST COLLEGE                ,TN,38478-2799,Private      ,4,8,12,1176,517,1693
00350500,MARYVILLE COLLEGE                       ,TN,37804-5907,Private      ,2,2,4,2342,417,2759
00350600,MEHARRY MEDICAL COLLEGE                 ,TN,37208-0000,Private      ,0,8,8,129,1430,1559
00350700,MEMPHIS COLLEGE OF ART                  ,TN,38104-2764,Private      ,7,6,13,905,546,1451
00350900,UNIVERSITY OF MEMPHIS (THE)             ,TN,38152-4611,Public       ,95,264,359,19559,20166,39725
00351000,MIDDLE TENNESSEE STATE UNIV             ,TN,37130-0000,Public       ,121,207,328,25476,15435,40911
00351100,MILLIGAN COLLEGE                        ,TN,37682-4001,Private      ,0,7,7,1344,796,2140
00351700,SOUTHERN COLLEGE OF OPTOMETRY           ,TN,38104-2222,Private      ,0,3,3,82,734,816
00351800,SOUTHERN ADVENTIST UNIVERSITY           ,TN,37315-0370,Private      ,7,17,24,3008,1163,4171
00351900,RHODES COLLEGE                          ,TN,38112-1690,Private      ,11,8,19,3598,865,4463
00352200,TENNESSEE STATE UNIVERSITY              ,TN,37209-1561,Public       ,69,158,227,12056,11176,23232
00352300,TENNESSEE TECHNOLOGICAL UNIV            ,TN,38505-0001,Public       ,19,72,91,11900,4351,16251
00352400,TENNESSEE TEMPLE UNIVERSITY             ,TN,37404-3587,Private      ,4,42,46,595,1049,1644
00352500,TENNESSEE WESLEYAN COLLEGE              ,TN,37371-0040,Private      ,2,15,17,1234,765,1999
00352600,TREVECCA NAZARENE UNIVERSITY            ,TN,37210-2877,Private      ,6,84,90,1754,2413,4167
00352700,TUSCULUM COLLEGE                        ,TN,37743-0001,Private      ,6,36,42,2554,2132,4686
00352800,UNION UNIVERSITY                        ,TN,38305-3697,Private      ,3,76,79,3127,3619,6746
00352900,UNIVERSITY OF TENNESSEE-CHATTANOOGA     ,TN,37403-2598,Public       ,67,94,161,16822,6462,23284
00353000,UNIVERSITY OF TENNESSEE-KNOXVILLE       ,TN,37996-0150,Public       ,124,114,238,30083,11807,41890
00353006,UNIVERSITY OF TENNESSEE-HEALTH SCI CTR  ,TN,38103-0000,Public       ,8,36,44,750,4233,4983
00353100,UNIVERSITY OF TENNESSEE-MARTIN          ,TN,38238-0002,Public       ,17,81,98,8516,4205,12721
00353400,UNIVERSITY OF THE SOUTH                 ,TN,37383-1000,Private      ,1,10,11,2587,169,2756
00353500,VANDERBILT UNIVERSITY                   ,TN,37240-0001,Private      ,27,52,79,20827,7773,28600
00353501,VANDERBILT UNIV MED CTR ALLIEDHEAL      ,TN,37232-5510,Private      ,2,5,7,261,800,1061
00353502,VANDERBILT UNIVERSITY - SCHOOL OF MEDICI,TN,37232-0000,Private      ,0,0,0,47,27,74
00353600,BRYAN COLLEGE                           ,TN,37321-7000,Private      ,3,18,21,1340,1046,2386
00399800,CHATTANOOGA STATE COMMUNITY COLLEGE     ,TN,37406-1097,Public       ,52,245,297,6739,11415,18154
00399900,CLEVELAND STATE COMMUNITY COLLEGE       ,TN,37312-2858,Public       ,24,72,96,2393,3156,5549
00402500,TN TECHNOLOGY CTR AT KNOXVILLE          ,TN,37919-2327,Public       ,2,21,23,830,2220,3050
00402600,TENNESSEE TECH. CNTR AT CROSSVILLE      ,TN,38555-4142,Public       ,4,10,14,647,748,1395
00461700,NATIONAL COLLEGE OF BUSINESS & TECH     ,TN,37211-6605,Proprietary  ,11,44,55,341,2366,2707
00493400,DAYMAR INSTITUTE                        ,TN,37217-1056,Proprietary  ,3,19,22,161,777,938
00493401,DAYMAR INSTITUTE - CLARKSVILLE          ,TN,37040-6718,Proprietary  ,17,65,82,256,1218,1474
00493404,DAYMAR INSTITUTE - MURFREESBORO         ,TN,37128-5508,Proprietary  ,4,31,35,166,674,840
00493700,JACKSON STATE COMMUNITY COLLEGE         ,TN,38301-3797,Public       ,12,69,81,3417,4689,8106
00493800,SOUTH COLLEGE                           ,TN,37909-3323,Proprietary  ,13,115,128,612,2717,3329
00494700,WEST TENNESSEE BUSINESS COLLEGE         ,TN,38301-3256,Proprietary  ,5,30,35,167,768,935
00528000,TN TECHNOLOGY CTR AT COVINGTON          ,TN,38019-0249,Public       ,2,3,5,192,443,635
00528100,TN TECHNOLOGY CTR AT ELIZABETHTON       ,TN,37643-0789,Public       ,13,39,52,416,1170,1586
00528200,TN TECHNOLOGY CTR AT HARTSVILLE         ,TN,37074-0000,Public       ,0,2,2,261,415,676
00528300,TN TECHNOLOGY CTR AT NEWBERN            ,TN,38059-1198,Public       ,3,3,6,158,545,703
00530700,TENNESSEE COLLEGE OF APPLIED TECHNOLOGY-,TN,37110-1322,Public       ,1,9,10,231,475,706
00535100,TENNESSEE TECHNOLOGY CENTER AT MORRISTOW,TN,37813-2094,Public       ,3,22,25,578,1257,1835
00535200,TN TECHNOLOGY CENTER AT MCKENZIE        ,TN,38201-1620,Public       ,1,4,5,153,378,531
00535300,TN TECHNOLOGY CENTER AT LIVINGSTON      ,TN,38570-1291,Public       ,2,6,8,311,498,809
00535400,TN TECHNOLOGY CTR AT JACKSON            ,TN,38301-0000,Public       ,0,15,15,534,1393,1927
00535600,TENNESSEE TECHNOLOGY CENTER AT HOHENWALD,TN,38462-0000,Public       ,4,8,12,270,499,769
00535700,TENNESSEE TECHNOLOGY CENTER AT CRUMP    ,TN,38327-3402,Public       ,2,5,7,201,470,671
00535800,TN TECHNOLOGY CENTER AT ATHENS          ,TN,37371-0848,Public       ,0,4,4,284,482,766
00535900,TENNESSEE TECHNOLOGY CENTER AT NASHVILLE,TN,37209-0000,Public       ,10,39,49,889,2524,3413
00536000,TENNESSEE TECHNOLOGY CENTER AT MEMPHIS  ,TN,38105-3604,Public       ,21,46,67,1443,3442,4885
00537800,NORTHEAST STATE COMMUNITY COLLEGE       ,TN,37617-0246,Public       ,28,101,129,3814,5458,9272
00537900,TN TECHNOLOGY CTR AT SHELBYVILLE        ,TN,37160-3697,Public       ,3,11,14,394,818,1212
00683500,DYERSBURG STATE COMMUNITY COLLEGE       ,TN,38024-0000,Public       ,13,58,71,1948,3246,5194
00683600,MOTLOW STATE COMMUNITY COLLEGE          ,TN,37388-7972,Public       ,33,76,109,3726,3983,7709
00732941,ITT TECHNICAL INSTITUTE                 ,TN,37932-3343,Proprietary  ,74,332,406,1301,4877,6178
00732958,ITT TECHNICAL INSTITUTE                 ,TN,37214-3717,Proprietary  ,40,277,317,871,3563,4434
00743900,FOUNTAINHEAD COLLEGE OF TECHNOLOGY      ,TN,37918-0000,Proprietary  ,1,17,18,228,722,950
00778200,TENNESSEE TECHNOLOGY CENTER AT DICKSON  ,TN,37055-0000,Public       ,8,4,12,421,1024,1445
00778300,MIDDLE TENNESSEE SCH OF ANESTHESIA      ,TN,37116-0000,Private      ,1,0,1,18,187,205
00793803,NASHVILLE AUTO DIESEL COLLEGE - NASHVILL,TN,37206-3210,Proprietary  ,70,54,124,3079,1197,4276
00814500,NASHVILLE STATE TECH CMNTY COLLEGE      ,TN,37209-0000,Public       ,64,259,323,5700,12137,17837
00865500,GENESIS CAREER COLLEGE OF COOKEVILLE    ,TN,38501-1959,Proprietary  ,23,64,87,246,703,949
00885900,JOHN A GUPTON COLLEGE                   ,TN,37203-2934,Private      ,1,2,3,95,241,336
00886300,WALTERS STATE COMMUNITY COLLEGE         ,TN,37813-6899,Public       ,21,91,112,4938,5109,10047
00946400,TN TECHNOLOGY CTR AT PULASKI            ,TN,38478-4541,Public       ,0,4,4,184,389,573
00956700,TENNESSEE SCHOOL OF BEAUTY              ,TN,37921-3303,Proprietary  ,6,17,23,250,585,835
00971000,TENNESSEE TECHNOLOGY CENTER AT ONEIDA/HU,TN,37756-4149,Public       ,2,6,8,117,264,381
00991200,VOLUNTEER STATE COMMUNITY COLLEGE       ,TN,37066-3188,Public       ,49,150,199,4900,6123,11023
00991400,ROANE STATE COMMUNITY COLLEGE           ,TN,37748-8664,Public       ,39,95,134,4473,5619,10092
00998200,VICTORY UNIVERSITY                      ,TN,38111-4745,Proprietary  ,6,9,15,957,3611,4568
01032600,TN TECHNOLOGY CTR AT HARRIMAN           ,TN,37748-1109,Public       ,2,6,8,223,410,633
01043900,SOUTHWEST TENNESSEE COMMUNITY COLLG     ,TN,38104-3322,Public       ,212,392,604,10167,17599,27766
01044700,"PLAZA BEAUTY SCHOOL, INC.               ",TN,38117-4822,Proprietary  ,10,15,25,193,424,617
01046000,AMERICAN BAPTIST THEOLOGICAL SEMINA     ,TN,37207-4994,Private      ,0,3,3,55,292,347
01052900,MEMPHIS THEOLOGICAL SEMINARY            ,TN,38104-0000,Private      ,1,8,9,25,434,459
01070000,TN TECHNOLOGY CENTER AT JACKSBORO       ,TN,37757-2461,Public       ,5,1,6,172,319,491
01155300,WM R MOORE COLLEGE OF TECHNOLOGY        ,TN,38104-0000,Private      ,3,8,11,180,526,706
01216400,TENNESSEE COLLEGE OF APPLIED TECHNOLOGY ,TN,38063-7359,Public       ,1,3,4,84,347,431
01254700,EMMANUEL SCHOOL OF RELIGION             ,TN,37601-0000,Private      ,0,1,1,6,73,79
01269300,PELLISSIPPI STATE COMMUNITY COLLEGE     ,TN,37933-0990,Public       ,96,153,249,7644,8217,15861
02069303,VATTEROTT COLLEGE -                     ,TN,38016-5877,Proprietary  ,13,58,71,228,781,1009
02092800,TENNESSEE TECHNOLOGY CENTER AT WHITEVILL,TN,38075-0000,Public       ,1,6,7,136,383,519
02103500,TENNESSEE COLLEGE OF APPLIED TECHNOLOGY ,TN,37129-3311,Public       ,7,18,25,477,1081,1558
02106400,O'MORE COLLEGE OF DESIGN                ,TN,37064-0000,Private      ,1,0,1,204,123,327
02125300,NASHVILLE CLG OF MEDICAL CAREERS        ,TN,37115-0000,Proprietary  ,2,18,20,64,287,351
02153100,JON NAVE UNIVERSITY OF COSMETOLOGY      ,TN,37013-3347,Proprietary  ,3,13,16,266,351,617
02157100,CONCORDE CAREER COLLEGE                 ,TN,38137-0000,Proprietary  ,40,192,232,1022,3772,4794
02160307,INTERNATIONAL ACADEMY OF DESIGN & TECH  ,TN,37212-0000,Proprietary  ,1,3,4,179,359,538
02188300,PENTECOSTAL THEOLOGICAL SEMINARY        ,TN,37320-0000,Private      ,0,6,6,6,303,309
02204200,"CHATTANOOGA COLLEGE - MEDICAL, DENTAL AN",TN,37411-0000,Proprietary  ,12,47,59,312,1138,1450
02237900,TN TECHNOLOGY CENTER AT PARIS           ,TN,38242-0000,Public       ,1,5,6,175,631,806
02255000,KNOXVILLE INSTITUTE OF HAIR DESIGN      ,TN,37917-0000,Proprietary  ,1,8,9,98,340,438
02257400,ARNOLD'S BEAUTY SCHOOL                  ,TN,38358-0000,Proprietary  ,0,5,5,49,110,159
02263104,ANTHEM COLLEGE - ANTHEM CAREER COLLEGE -,TN,37214-2531,Proprietary  ,17,51,68,262,844,1106
02275500,REUBEN-ALLEN COLLEGE                    ,TN,37922-0000,Proprietary  ,5,16,21,160,366,526
02278700,MR WAYNES SCH OF UNISEX HAIR DESIGN     ,TN,38501-0000,Proprietary  ,0,2,2,41,83,124
02293900,VOLUNTEER BEAUTY ACADEMY-NASHVILLE      ,TN,37115-2112,Proprietary  ,2,3,5,28,85,113
02294000,VOLUNTEER BEAUTY ACADEMY-DYERSBURG      ,TN,38024-1622,Proprietary  ,3,4,7,38,139,177
02326200,KAPLAN CAREER INSTITUTE                 ,TN,37212-5318,Proprietary  ,14,70,84,272,1373,1645
02326300,MEDVANCE INSTITUTE                      ,TN,38501-4305,Proprietary  ,16,19,35,191,449,640
02335900,VOLUNTEER BEAUTY ACADEMY-NASHVILLE      ,TN,37209-3033,Proprietary  ,3,6,9,80,179,259
02539800,QUEEN CITY COLLEGE                      ,TN,37042-0000,Proprietary  ,3,22,25,89,453,542
02540000,TENNESSEE ACADEMY OF COSMETOLOGY        ,TN,38133-0000,Proprietary  ,12,27,39,238,513,751
02578200,NOSSI COLLEGE OF ART                    ,TN,37115-5138,Proprietary  ,2,9,11,407,388,795
02595000,FAYETTEVILLE BEAUTY SCHOOL              ,TN,37334-2909,Proprietary  ,1,7,8,37,92,129
02599710,VATTEROTT COLLEGE - MEMPHIS             ,TN,38132-1714,Proprietary  ,31,106,137,593,2266,2859
02609204,VATTEROTT COLLEGE - VATTEROTT CAREER COL,TN,38133-4727,Proprietary  ,21,60,81,405,1322,1727
02614200,MILLER MOTTE BUSINESS COLLEGE           ,TN,37040-6023,Proprietary  ,5,40,45,293,1250,1543
02614203,MILLER - MOTTE TECHNICAL COLLEGE - CHATT,TN,37421-7220,Proprietary  ,7,44,51,335,1185,1520
02614204,MILLER - MOTTE TECHNICAL COLLEGE - MADIS,TN,37072-1870,Proprietary  ,5,53,58,211,873,1084
03001800,FREE WILL BAPTIST BIBLE COLLEGE         ,TN,37205-2498,Private      ,0,1,1,265,196,461
03008800,FRANKLIN ACADEMY                        ,TN,37312-3939,Private      ,6,16,22,45,174,219
03010606,VIRGINIA COLLEGE - SCH OF BUSNSS & HLTH ,TN,37411-5600,Proprietary  ,9,75,84,268,1232,1500
03024900,TENNESSEE ACADEMY OF COSMETOLOGY        ,TN,38125-3442,Proprietary  ,8,20,28,218,491,709
03026517,REMINGTON COLLEGE - MEMPHIS             ,TN,38132-2107,Private      ,8,23,31,679,1973,2652
03061100,GENESIS CAREER COLLEGE OF LEBANON       ,TN,37087-2718,Proprietary  ,14,23,37,118,339,457
03076405,BRYMAN SCHOOL OF ARIZONA (THE) - ANTHEM ,TN,38134-7345,Proprietary  ,23,114,137,262,1186,1448
03079100,NORTH CENTRAL INSTITUTE                 ,TN,37042-3116,Proprietary  ,0,9,9,54,284,338
03088800,"WATKINS COLLEGE OF ART, DESIGN & FILM   ",TN,37228-1306,Private      ,0,5,5,621,393,1014
03126900,STYLES & PROFILES BEAUTY COLLEGE        ,TN,38375-2109,Proprietary  ,0,2,2,25,53,78
03253300,PAUL MITCHELL THE SCHOOL MEMPHIS        ,TN,38133-4067,Proprietary  ,5,6,11,87,170,257
03355400,RICHMONT GRADUATE UNIVERSITY            ,TN,37404-0000,Private      ,0,2,2,10,295,305
03440300,BAPTIST MEMORIAL COLLEGE OF HEALTH      ,TN,38104-3104,Private      ,5,31,36,1359,2972,4331
03480303,MEDVANCE INSTITUTE - NASHVILLE          ,TN,37203-1536,Proprietary  ,6,24,30,129,718,847
03513500,WILLIAMSON CHRISTIAN COLLEGE            ,TN,37067-8237,Private      ,1,1,2,29,83,112
03647300,NEW CONCEPTS SCHOOL OF COSMETOLOGY      ,TN,37311-7373,Proprietary  ,1,6,7,30,111,141
03683300,INTERNATIONAL BARBER & STYLE COLLEGE    ,TN,37209-2205,Proprietary  ,4,30,34,61,289,350
03701300,MEMPHIS INSTITUTE OF BARBERING          ,TN,38107-4334,Proprietary  ,12,35,47,263,659,922
03774400,SHEAR ACADEMY                           ,TN,38555-4177,Proprietary  ,0,3,3,23,102,125
03830300,SAE INSTITUTE OF TECHNOLOGY             ,TN,37203-4310,Proprietary  ,15,29,44,186,310,496
03840300,OXFORD GRADUATE SCHOOL                  ,TN,37321-6736,Private      ,0,3,3,4,43,47
03841300,CAREER BEAUTY COLLEGE                   ,TN,38464-3634,Proprietary  ,2,7,9,22,68,90
03920300,INSTITUTE OF HAIR DESIGN                ,TN,38310-1801,Proprietary  ,1,10,11,25,86,111
03930300,BUCHANAN BEAUTY COLLEGE                 ,TN,37160-2741,Proprietary  ,2,4,6,48,111,159
03982300,VISIBLE SCHOOL - MUSIC AND WORSHIPS ARTS,TN,38104-5814,Private      ,1,0,1,166,133,299
04035300,TENNESSEE CAREER INSTITUTE              ,TN,38401-6335,Proprietary  ,5,12,17,105,304,409
04124100,ELITE COLLEGE OF COSMETOLOGY            ,TN,38351-1431,Proprietary  ,0,2,2,33,76,109
04157200,LOVE BEAUTY SCHOOL                      ,TN,37355-2950,Proprietary  ,1,5,6,32,97,129
04165000,MERIDIAN INSTITUTE OF SURGICAL ASSISTING,TN,37080-0758,Proprietary  ,1,16,17,12,462,474
04174600,NASHVILLE BARBER AND STYLE ACADEMY      ,TN,37208-2826,Proprietary  ,2,13,15,79,223,302
04210200,MID-SOUTH CHRISTIAN COLLEGE             ,TN,38118-3151,Private      ,1,3,4,42,172,214
04213800,SALON PROFESSIONAL ACADEMY (THE)        ,TN,37214-2163,Proprietary  ,0,1,1,101,145,246
04215200,VIBE BARBER COLLEGE                     ,TN,38107-2538,Proprietary  ,4,27,31,4,36,40
04223900,MIND BODY INSTITUTE                     ,TN,37214-1012,Proprietary  ,0,6,6,1,19,20
00353700,ABILENE CHRISTIAN UNIVERSITY            ,TX,79699-3701,Private      ,23,53,76,6527,1836,8363
00353900,ALVIN COMMUNITY COLLEGE                 ,TX,77511-4807,Public       ,24,92,116,1840,3479,5319
00354000,AMARILLO COLLEGE                        ,TX,79109-2446,Public       ,46,204,250,4011,7502,11513
00354100,ANGELO STATE UNIVERSITY                 ,TX,76909-5069,Public       ,45,92,137,6831,3550,10381
00354300,AUSTIN COLLEGE                          ,TX,75090-4440,Private      ,5,4,9,2340,337,2677
00354400,AUSTIN PRESBYTERIAN THEOLOGICAL SEM     ,TX,78705-5797,Private      ,2,2,4,7,172,179
00354500,BAYLOR UNIVERSITY                       ,TX,76798-7048,Private      ,122,71,193,26781,5723,32504
00354600,COASTAL BEND COLLEGE                    ,TX,78102-2197,Public       ,35,51,86,1712,2161,3873
00354900,BLINN COLLEGE                           ,TX,77833-4098,Public       ,157,148,305,15542,6820,22362
00355300,CISCO JUNIOR COLLEGE                    ,TX,76437-9803,Public       ,17,39,56,2202,2916,5118
00355400,CLARENDON COLLEGE                       ,TX,79226-0000,Public       ,12,54,66,669,713,1382
00355600,COMMONWEALTH INST OF FUNERAL SVC        ,TX,77090-5918,Private      ,3,7,10,114,581,695
00355700,CONCORDIA UNIVERSITY TEXAS              ,TX,78726-4141,Private      ,7,84,91,1889,3118,5007
00355800,NORTH CENTRAL TEXAS COLLEGE             ,TX,76240-4699,Public       ,64,158,222,4380,6333,10713
00356000,DALLAS BAPTIST UNIVERSITY               ,TX,75211-9299,Private      ,17,154,171,3951,5204,9155
00356100,CEDAR VALLEY COLLEGE                    ,TX,75134-0000,Public       ,49,176,225,2610,5997,8607
00356200,DALLAS THEOLOGICAL SEM                  ,TX,75204-0000,Private      ,0,12,12,51,999,1050
00356300,DEL MAR COLLEGE                         ,TX,78404-3897,Public       ,83,237,320,5812,9088,14900
00356400,EAST TEXAS BAPTIST UNIVERSITY           ,TX,75670-1423,Private      ,2,11,13,1777,543,2320
00356500,TEXAS A&M UNIVERSITY - COMMERCE         ,TX,75429-3011,Public       ,44,241,285,6800,9180,15980
00356800,FRANK PHILLIPS COLLEGE                  ,TX,79008-0000,Public       ,11,37,48,438,642,1080
00357000,GRAYSON COUNTY COLLEGE                  ,TX,75020-8299,Public       ,36,142,178,2037,4464,6501
00357100,HARDIN-SIMMONS UNIVERSITY               ,TX,79698-6050,Private      ,8,8,16,2402,1124,3526
00357200,TRINITY VALLEY COMMUNITY COLLEGE        ,TX,75751-2734,Public       ,56,126,182,2899,5282,8181
00357300,HILL COLLEGE                            ,TX,76645-2711,Public       ,17,43,60,1138,1888,3026
00357301,HILL COLLEGE                            ,TX,76031-0000,Public       ,18,65,83,1184,2452,3636
00357400,HOWARD COUNTY JUNIOR COLLEGE DISTRICT   ,TX,79720-0213,Public       ,26,62,88,1588,2476,4064
00357500,HOWARD PAYNE UNIVERSITY                 ,TX,76801-2715,Private      ,6,6,12,1633,450,2083
00357600,HOUSTON BAPTIST UNIVERSITY              ,TX,77074-3298,Private      ,36,67,103,6132,4170,10302
00357700,HUSTON - TILLOTSON UNIVERSITY           ,TX,78702-2795,Private      ,8,32,40,1475,1236,2711
00357800,UNIVERSITY OF THE INCARNATE WORD        ,TX,78209-6398,Private      ,30,141,171,7844,8073,15917
00357900,JACKSONVILLE COLLEGE                    ,TX,75766-4759,Private      ,1,5,6,329,290,619
00358000,KILGORE COLLEGE                         ,TX,75662-3299,Public       ,46,90,136,3513,5272,8785
00358100,LAMAR UNIVERSITY-BEAUMONT               ,TX,77710-0042,Public       ,80,477,557,9213,13146,22359
00358200,LAREDO COMMUNITY COLLEGE                ,TX,78040-4395,Public       ,117,72,189,6774,4260,11034
00358300,LEE COLLEGE                             ,TX,77520-4796,Public       ,33,112,145,2138,4566,6704
00358400,LETOURNEAU UNIVERSITY                   ,TX,75607-0000,Private      ,4,80,84,1757,2775,4532
00358600,LUBBOCK CHRISTIAN UNIVERSITY            ,TX,79407-2099,Private      ,5,35,40,1721,1706,3427
00358800,UNIVERSITY OF MARY HARDIN-BAYLOR        ,TX,76513-2599,Private      ,23,47,70,5268,2062,7330
00359000,MCLENNAN COMMUNITY COLLEGE              ,TX,76708-1498,Public       ,62,172,234,4975,8385,13360
00359100,MCMURRY UNIVERSITY                      ,TX,79697-0001,Private      ,9,18,27,1773,854,2627
00359200,MIDWESTERN STATE UNIVERSITY             ,TX,76308-2099,Public       ,29,72,101,5310,3544,8854
00359300,NAVARRO COLLEGE                         ,TX,75110-4818,Public       ,96,250,346,5426,7560,12986
00359400,UNIVERSITY OF NORTH TEXAS               ,TX,76203-5017,Public       ,172,404,576,35853,23744,59597
00359500,OBLATE SCHOOL OF THEOLOGY               ,TX,78216-0000,Private      ,0,0,0,10,84,94
00359600,ODESSA COLLEGE                          ,TX,79764-7127,Public       ,16,72,88,1737,3086,4823
00359800,OUR LADY OF THE LAKE UNIVERSITY         ,TX,78207-4689,Private      ,17,126,143,3367,4391,7758
00359900,UNIVERSITY OF TEXAS - PAN AMERICAN      ,TX,78541-2999,Public       ,155,232,387,21580,12021,33601
00360000,PANOLA COLLEGE                          ,TX,75633-2397,Public       ,11,69,80,1215,2382,3597
00360100,PARIS JR COLLEGE                        ,TX,75460-6298,Public       ,70,162,232,2366,3789,6155
00360200,PAUL QUINN COLLEGE                      ,TX,75241-4398,Private      ,51,26,77,522,853,1375
00360300,RANGER COLLEGE                          ,TX,76470-3298,Public       ,16,36,52,826,970,1796
00360305,RANGER COLLEGE-STEPHENVILE BEAUTY COLLEG,TX,76401-5136,Public       ,3,4,7,86,112,198
00360400,RICE UNIVERSITY                         ,TX,77251-1892,Private      ,18,32,50,11593,3619,15212
00360600,SAM HOUSTON STATE UNIVERSITY            ,TX,77340-0000,Public       ,134,253,387,23016,11509,34525
00360700,ALAMO CMTY CLG DISTRICT PROGRAM         ,TX,78207-0000,Public       ,14,67,81,2549,4400,6949
00360800,ST PHILLIPS COLLEGE                     ,TX,78203-2098,Public       ,52,236,288,6194,12540,18734
00360900,SAN JACINTO CLG-CENTRAL-NORTH-SOUTH     ,TX,77501-0000,Public       ,196,442,638,12249,19056,31305
00361000,SCHREINER UNIVERSITY                    ,TX,78028-5697,Private      ,4,15,19,1639,549,2188
00361100,SOUTH PLAINS COLLEGE                    ,TX,79336-6504,Public       ,50,118,168,5341,6038,11379
00361200,UNIV OF HOUSTON-DOWNTOWN                ,TX,77002-1001,Public       ,120,342,462,14125,21021,35146
00361300,SOUTHERN METHODIST UNIVERSITY           ,TX,75275-0181,Private      ,21,73,94,9576,6088,15664
00361400,SOUTHWEST TEXAS JR COLLEGE              ,TX,78801-6221,Public       ,83,82,165,3033,2863,5896
00361500,TEXAS STATE UNIVERSITY--SAN MARCOS      ,TX,78666-4602,Public       ,227,221,448,40133,16975,57108
00361600,SOUTHWESTERN ASSEMBLIES OF GOD UNIV     ,TX,75165-2397,Private      ,6,25,31,1759,1353,3112
00361800,SOUTHWESTERN CHRISTIAN COLLEGE          ,TX,75160-3400,Private      ,1,4,5,240,187,427
00361900,SOUTHWESTERN ADVENTIST UNIVERSITY       ,TX,76059-1922,Private      ,1,5,6,814,487,1301
00362000,SOUTHWESTERN UNIVERSITY                 ,TX,78626-6111,Private      ,3,3,6,2879,385,3264
00362100,ST EDWARDS UNIVERSITY                   ,TX,78704-0000,Private      ,17,36,53,6169,3175,9344
00362300,ST MARY'S UNIV OF SAN ANTONIO           ,TX,78228-8500,Private      ,12,41,53,5592,3795,9387
00362400,STEPHEN F AUSTIN STATE UNIVERSITY       ,TX,75962-0001,Public       ,161,181,342,17109,6179,23288
00362500,SUL ROSS STATE UNIVERSITY               ,TX,79832-0113,Public       ,22,62,84,1864,2098,3962
00362600,TARRANT COUNTY COLLEGE                  ,TX,76102-6599,Public       ,453,1257,1710,22321,39447,61768
00362700,TEMPLE COLLEGE                          ,TX,76504-7435,Public       ,52,218,270,2682,6921,9603
00362800,TEXARKANA COLLEGE                       ,TX,75599-0001,Public       ,37,175,212,1701,4114,5815
00363000,PRAIRIE VIEW A&M UNIVERSITY             ,TX,77446-2967,Public       ,121,85,206,12183,6940,19123
00363100,TARLETON STATE UNIVERSITY               ,TX,76402-0000,Public       ,83,207,290,10411,8892,19303
00363200,TEXAS A&M UNIVERSITY                    ,TX,77843-1246,Public       ,223,185,408,50862,13005,63867
00363208,TEXAS A&M UNIVERSITY - HEALTH SCIENCE CE,TX,77807-3260,Public       ,13,20,33,1828,2730,4558
00363400,TEXAS STATE TECHNICAL CLG AT WACO       ,TX,76705-1695,Public       ,46,96,142,3338,4521,7859
00363500,TEXAS CHIROPRACTIC COLLEGE              ,TX,77505-1699,Private      ,0,8,8,22,349,371
00363600,TEXAS CHRISTIAN UNIVERSITY              ,TX,76129-0001,Private      ,31,69,100,14912,5123,20035
00363700,JARVIS CHRISTIAN COLLEGE                ,TX,75765-1470,Private      ,22,23,45,707,325,1032
00363800,TEXAS COLLEGE                           ,TX,75702-4500,Private      ,22,23,45,1235,1309,2544
00363900,TEXAS A&M UNIVERSITY-KINGSVILLE         ,TX,78363-8203,Public       ,50,134,184,11111,8299,19410
00364100,TEXAS LUTHERAN UNIVERSITY               ,TX,78155-5999,Private      ,1,7,8,2195,369,2564
00364200,TEXAS SOUTHERN UNIVERSITY               ,TX,77004-4598,Public       ,110,195,305,11926,15217,27143
00364400,TEXAS TECH UNIVERSITY                   ,TX,79409-2011,Public       ,134,205,339,30840,13333,44173
00364500,TEXAS WESLEYAN UNIVERSITY               ,TX,76105-1536,Private      ,12,54,66,2081,4668,6749
00364600,TEXAS WOMAN'S UNIVERSITY                ,TX,76204-5587,Public       ,37,202,239,10404,15165,25569
00364700,TRINITY UNIVERSITY                      ,TX,78212-7200,Private      ,13,20,33,4001,1175,5176
00364800,TYLER JUNIOR COLLEGE                    ,TX,75701-3436,Public       ,107,177,284,8981,8602,17583
00365100,UNIVERSITY OF DALLAS                    ,TX,75062-4799,Private      ,7,31,38,2627,2098,4725
00365200,UNIVERSITY OF HOUSTON                   ,TX,77204-2010,Public       ,205,380,585,38095,32414,70509
00365400,UNIVERSITY OF ST THOMAS                 ,TX,77006-4626,Private      ,14,53,67,1982,3364,5346
00365600,UNIVERSITY OF TEXAS-ARLINGTON           ,TX,76019-0000,Public       ,110,572,682,26757,34242,60999
00365800,UNIVERSITY OF TEXAS-AUSTIN              ,TX,78713-7758,Public       ,136,245,381,52162,23411,75573
00365900,UT HEALTH CENTER-SAN ANTONIO            ,TX,78229-3900,Public       ,11,43,54,1717,4849,6566
00366100,UNIVERSITY OF TEXAS-EL PASO             ,TX,79968-0629,Public       ,189,301,490,19149,16114,35263
00366200,VICTORIA COLLEGE                        ,TX,77901-4494,Public       ,26,87,113,2021,3433,5454
00366300,WAYLAND BAPTIST UNIVERSITY              ,TX,79072-6998,Private      ,8,166,174,1609,5086,6695
00366400,WEATHERFORD COLLEGE                     ,TX,76086-5699,Public       ,26,82,108,2864,4304,7168
00366500,WEST TEXAS A&M UNIVERSITY               ,TX,79016-0000,Public       ,74,131,205,6848,4701,11549
00366800,WHARTON COUNTY JR COLLEGE               ,TX,77488-3298,Public       ,74,86,160,3822,4096,7918
00366900,WILEY COLLEGE                           ,TX,75670-5199,Private      ,11,18,29,1374,954,2328
00400300,CENTRAL TEXAS COLLEGE                   ,TX,76540-4199,Public       ,76,1123,1199,3738,24511,28249
00407221,NORTHWOOD UNIVERSITY                    ,TX,75104-0000,Private      ,5,27,32,763,928,1691
00445300,EL CENTRO COLLEGE                       ,TX,75202-3604,Public       ,78,422,500,5973,15293,21266
00450303,EVEREST COLLEGE - FORT WORTH SOUTH      ,TX,76115-1407,Proprietary  ,14,103,117,332,1536,1868
00481102,EVEREST INSTITUTE - EVEREST COLLEGE     ,TX,76011-6630,Proprietary  ,16,87,103,347,1402,1749
00494900,BAYLOR COLLEGE OF MEDICINE              ,TX,77030-0000,Private      ,16,29,45,1141,2417,3558
00495100,UNIV OF TEXAS HEALTH SCIENCE CENTER     ,TX,77225-0000,Public       ,11,57,68,1332,5208,6540
00495200,UNIV OF TEXAS MEDICAL BRANCH            ,TX,77550-0000,Public       ,11,56,67,882,3330,4212
00497200,GALVESTON COLLEGE                       ,TX,77550-7447,Public       ,32,71,103,1392,2355,3747
00497700,SOUTH TEXAS COLLEGE OF LAW              ,TX,77002-0000,Private      ,1,11,12,118,2018,2136
00520307,REMINGTON COLLEGE - DALLAS CAMPUS       ,TX,75041-9935,Proprietary  ,0,0,0,86,266,352
00660600,BAPTIST HS SCHOOL OF HEALTH PROFESSIONS ,TX,78229-3234,Proprietary  ,3,20,23,286,1563,1849
00661200,COVENANT SCH OF NSG & ALLIED HEALTH     ,TX,79410-0000,Private      ,1,7,8,243,595,838
00666100,ANGELINA COLLEGE                        ,TX,75902-0000,Public       ,36,109,145,2773,4590,7363
00694100,DALLAS CHRISTIAN COLLEGE                ,TX,75234-7229,Private      ,2,17,19,458,765,1223
00709600,COLLEGE OF THE MAINLAND                 ,TX,77591-2499,Public       ,35,135,170,1569,3945,5514
00728700,BRAZOSPORT COLLEGE                      ,TX,77566-3199,Public       ,71,77,148,1661,2485,4146
00732907,ITT TECHNICAL INSTITUTE                 ,TX,77063-3751,Proprietary  ,18,95,113,654,2141,2795
00732913,ITT TECHNICAL INSTITUTE                 ,TX,76011-3919,Proprietary  ,23,181,204,559,2178,2737
00732975,ITT TECHNICAL INSTITUTE                 ,TX,78249-3303,Proprietary  ,12,107,119,468,1635,2103
00754805,WESTWOOD COLLEGE OF TECHNOLOGY          ,TX,77074-0000,Proprietary  ,0,0,0,66,287,353
00793804,LINCOLN COLLEGE OF TECHNOLOGY - GRAND PR,TX,75052-7605,Proprietary  ,102,84,186,1395,961,2356
00849800,MIMS CLASSIC BEAUTY COLLEGE             ,TX,78216-0000,Proprietary  ,1,4,5,49,146,195
00850300,MOUNTAIN VIEW COLLEGE                   ,TX,75211-6599,Public       ,51,221,272,4766,8283,13049
00850400,RICHLAND COLLEGE                        ,TX,75243-2199,Public       ,105,385,490,6871,11937,18808
00851000,EASTFIELD COLLEGE                       ,TX,75150-2099,Public       ,71,295,366,5608,10746,16354
00907905,EVEREST COLLEGE                         ,TX,75206-5209,Proprietary  ,43,214,257,771,2860,3631
00908200,INTERNATIONAL BUSINESS COLLEGE          ,TX,79903-0000,Proprietary  ,7,32,39,181,597,778
00916300,SAN ANTONIO COLLEGE                     ,TX,78212-4299,Public       ,131,411,542,14519,22407,36926
00922500,TEXAS STATE TECHNICAL COLLEGE  HARLINGEN,TX,78550-3697,Public       ,39,128,167,4572,4686,9258
00946600,KAPLAN COLLEGE                          ,TX,78216-1899,Proprietary  ,31,85,116,437,1679,2116
00946607,KAPLAN COLLEGE - MCALLEN                ,TX,78503-1622,Proprietary  ,27,36,63,514,738,1252
00946609,KAPLAN COLLEGE - CAREER CENTERS OF TEXAS,TX,78416-9900,Proprietary  ,4,38,42,266,1001,1267
00946610,KAPLAN COLLEGE - CAREER CENTERS OF TEXAS,TX,76103-2310,Proprietary  ,9,40,49,250,1162,1412
00954900,WESTERN TEXAS COLLEGE                   ,TX,79549-9501,Public       ,9,14,23,697,588,1285
00965100,TEXAS A&M INTERNATIONAL UNIVERSITY      ,TX,78041-1900,Public       ,101,60,161,6757,3744,10501
00974100,UNIVERSITY OF TEXAS AT DALLAS           ,TX,75083-0000,Public       ,58,172,230,13318,12160,25478
00976800,UNIVERSITY OF NORTH TEXAS HEALTH SCIENCE,TX,76107-2699,Public       ,13,37,50,805,3427,4232
00979700,MIDLAND COLLEGE                         ,TX,79705-6397,Public       ,18,42,60,1836,2845,4681
00982802,EVEREST INSTITUTE- AUSTIN               ,TX,78754-0000,Proprietary  ,40,121,161,497,1554,2051
00993000,UNIVERSITY OF TEXAS-PERMIAN BASIN       ,TX,79762-0001,Public       ,14,75,89,2402,3696,6098
00993200,TEXAS STATE TECH CLG-WEST TEXAS         ,TX,79556-4108,Public       ,15,33,48,507,839,1346
00993201,TEXAS STATE TECH COLLEGE-ABILENE        ,TX,79601-0000,Public       ,1,20,21,378,919,1297
00993204,TEXAS STATE TECH CLG-BRECKENRIDGE       ,TX,76424-0000,Public       ,1,4,5,73,151,224
00993205,TEXAS STATE TECH COLLEGE-BROWNWOOD      ,TX,76801-0000,Public       ,2,9,11,121,376,497
01001900,UNIV OF TEXAS SOUTHWESTERN MED CTR      ,TX,75390-9096,Public       ,5,24,29,477,2744,3221
01005700,AMERICAN COMMERCIAL COLLEGE             ,TX,79602-1399,Proprietary  ,0,0,0,15,60,75
01005900,AMERICAN COMMERCIAL COLLEGE             ,TX,79761-0000,Proprietary  ,1,7,8,43,182,225
01005901,AMERICAN COMMERCIAL COLLEGE - AMERICAN C,TX,76310-2303,Proprietary  ,0,9,9,88,411,499
01006000,VERNON COLLEGE                          ,TX,76384-4092,Public       ,35,83,118,1453,2973,4426
01011500,UNIVERSITY OF TEXAS-SAN ANTONIO         ,TX,78249-0600,Public       ,151,240,391,36981,20695,57676
01013000,WADE COLLEGE                            ,TX,75207-3199,Proprietary  ,3,10,13,255,454,709
01038700,EL PASO COMMUNITY COLLEGE               ,TX,79998-0000,Public       ,168,394,562,17426,18406,35832
01050900,HALLMARK COLLEGE OF AERONAUTICS         ,TX,78214-0000,Private      ,25,95,120,358,1498,1856
01062400,LIGHTHOUSE CAREER INSTITUTE             ,TX,75231-5033,Private      ,4,8,12,16,78,94
01063300,HOUSTON COMMUNITY COLLEGE               ,TX,77002-0000,Public       ,485,1589,2074,28596,63447,92043
01067400,TEXAS TECH U HEALTH SCIENCES CENTER     ,TX,79430-0000,Public       ,13,82,95,1713,6017,7730
01076100,DALLAS INSTITUTE OF FUNERAL SERVICE     ,TX,75227-4314,Private      ,2,13,15,124,555,679
01114500,LONE STAR COLLEGE SYSTEM                ,TX,77073-3499,Public       ,455,1334,1789,26302,48468,74770
01116100,TEXAS A&M UNIV CORPUS CHRISTI           ,TX,78412-5599,Public       ,64,122,186,13198,7418,20616
01116300,UNIVERSITY OF TEXAS AT TYLER            ,TX,75799-6699,Public       ,24,176,200,5911,6941,12852
01171100,UNIVERSITY OF HOUSTON-CLEAR LAKE        ,TX,77058-1002,Public       ,37,154,191,2973,9186,12159
01201500,AUSTIN COMMUNITY COLLEGE                ,TX,78752-4390,Public       ,245,661,906,18796,28089,46885
01202000,VICTORIA BEAUTY COLLEGE                 ,TX,77901-6233,Proprietary  ,4,10,14,56,191,247
01226800,BALDWIN BEAUTY SCHOOL #5                ,TX,78704-4785,Proprietary  ,12,16,28,205,513,718
01229700,LAREDO BEAUTY COLLEGE                   ,TX,78040-1051,Proprietary  ,4,13,17,170,300,470
01248200,ATI TECHNICAL TRAINING CENTER           ,TX,75235-4622,Proprietary  ,0,7,7,0,7,7
01248209,ATI CAREER TRAINING CENTER - GARLAND    ,TX,75041-2497,Proprietary  ,0,5,5,0,5,5
01248210,ATI CAREER TRAINING CENTER - WACO       ,TX,76711-1682,Proprietary  ,0,6,6,0,6,6
01248300,COSMETOLOGY CAREER CENTER-A PAUL MITCHEL,TX,75006-2567,Proprietary  ,42,76,118,615,893,1508
01248800,INTERNATIONAL BEAUTY COLLEGE NO 3       ,TX,75040-0000,Proprietary  ,0,5,5,20,113,133
01276400,METROPLEX BEAUTY SCHOOL                 ,TX,75149-0000,Proprietary  ,1,14,15,37,170,207
01293000,CHARLES & SUE'S SCH OF HAIR DESIGN      ,TX,77801-0000,Proprietary  ,2,2,4,99,145,244
01293200,TINT SCHOOL OF MAKEUP & COSMETOLOGY     ,TX,75061-4235,Proprietary  ,5,26,31,59,195,254
01300300,NEILSON BEAUTY COLLEGE                  ,TX,75208-4637,Proprietary  ,2,8,10,53,151,204
01301600,OGLE SCHOOL HAIR SKIN NAILS             ,TX,76013-7400,Proprietary  ,34,66,100,501,1109,1610
01303912,SOUTH UNIVERSITY - THE ART INSTITUTE OF ,TX,75231-5993,Proprietary  ,22,45,67,1877,1721,3598
01303915,SOUTH UNIVERSITY - AUSTIN               ,TX,78729-8101,Proprietary  ,10,57,67,253,836,1089
01323100,UNIVERSITY OF HOUSTON-VICTORIA          ,TX,77901-5731,Public       ,22,101,123,2773,4790,7563
02058600,CONLEE'S COLLEGE OF COSMETOLOGY         ,TX,78028-0000,Proprietary  ,0,2,2,25,67,92
02074100,CAPITOL CITY TRADE & TECHNICAL SCH      ,TX,78704-0000,Proprietary  ,11,35,46,190,624,814
02077400,NORTH LAKE COLLEGE                      ,TX,75038-0000,Public       ,42,251,293,3525,7045,10570
02081400,ARLINGTON BAPTIST COLLEGE               ,TX,76012-0000,Private      ,7,11,18,294,432,726
02093600,SOUTHWEST SCHOOL OF ELECTRONIC          ,TX,78735-0000,Proprietary  ,1,4,5,42,114,156
02098300,WESTERN TECHNICAL COLLEGE               ,TX,79927-2105,Proprietary  ,28,98,126,929,2011,2940
02100200,BROOKHAVEN COLLEGE                      ,TX,75244-0000,Public       ,52,207,259,3417,7857,11274
02113610,AMERICAN INTERCONTINENTAL UNIV - HOUSTON,TX,77042-4516,Proprietary  ,6,50,56,272,1527,1799
02116008,SANFORD-BROWN COLLEGE - HOUSTON         ,TX,77042-8900,Proprietary  ,22,69,91,498,1577,2075
02116012,SANFORD-BROWN COLLEGE - HOUSTON NORTH LO,TX,77008-1058,Proprietary  ,0,13,13,111,474,585
02117100,ART INSTITUTE OF HOUSTON                ,TX,77056-0000,Proprietary  ,96,168,264,5607,6249,11856
02119200,COURT REPORTING INSTITUTE OF DALLAS     ,TX,75247-6913,Proprietary  ,0,9,9,58,541,599
02119202,COURT REPORTING INSTIUTE OF DALLAS - COU,TX,77040-6315,Proprietary  ,0,0,0,10,73,83
02128302,INSTITUTE FOR BUSINESS & TECHNOLOGY - LA,TX,78230-2520,Proprietary  ,8,27,35,159,490,649
02136800,AMERICAN COMMERCIAL COLLEGE             ,TX,76904-0000,Proprietary  ,2,11,13,73,221,294
02144800,VET TECH INSTITUTE OF HOUSTON           ,TX,77027-9881,Proprietary  ,6,12,18,445,486,931
02176100,PIPO ACADEMY OF HAIR DESIGN             ,TX,79903-0000,Proprietary  ,1,3,4,57,149,206
02200800,AMERICAN COMMERCIAL COLLEGE             ,TX,79411-0000,Proprietary  ,0,0,0,6,5,11
02218300,SOUTHWEST SCHOOL OF BUSINESS & TECHNICAL,TX,78221-0000,Proprietary  ,8,36,44,155,517,672
02218305,SOUTHWEST SCHOOL OF BUSINESS AND TECHNIC,TX,78501-6053,Proprietary  ,1,7,8,63,175,238
02218306,SOUTHWEST SCHOOL OF BUSINESS AND TECHNIC,TX,78413-2045,Proprietary  ,0,0,0,54,194,248
02224600,TRI-STATE BEAUTY SCHOOL #1              ,TX,79915-0000,Proprietary  ,7,30,37,124,418,542
02228400,TEXAS AERO TECHNOLOGY                   ,TX,75209-0000,Proprietary  ,0,0,0,0,1,1
02230500,OGLE SCHOOL HAIR SKIN NAILS             ,TX,76132-3638,Proprietary  ,25,74,99,442,1264,1706
02230600,OGLE SCHOOL HAIR SKIN NAILS             ,TX,76053-4650,Proprietary  ,21,46,67,260,606,866
02239100,CENTRAL TEXAS BEAUTY COLLEGE #2         ,TX,78664-4204,Proprietary  ,7,27,34,124,447,571
02248200,MILAN INSTITUTE OF COSMETOLOGY          ,TX,79103-0000,Proprietary  ,87,186,273,816,2240,3056
02254800,TEXAS VOCATIONAL SCHOOLS                ,TX,77901-0000,Proprietary  ,0,4,4,63,196,259
02259400,AMBERTON UNIVERSITY                     ,TX,75041-0000,Private      ,0,19,19,41,522,563
02261300,EVEREST INSTITUTE                       ,TX,78213-3841,Proprietary  ,25,116,141,328,1357,1685
02261302,EVEREST INSTITUTE - HOUSTON GREENSPOINT ,TX,77060-3249,Proprietary  ,30,122,152,418,1669,2087
02261303,EVEREST INSTITUTE - HOUSTON HOBBY       ,TX,77087-2737,Proprietary  ,30,132,162,353,1370,1723
02267100,EXPOSITO SCHOOL OF HAIR DESIGN          ,TX,79109-0000,Proprietary  ,1,6,7,49,107,156
02276000,FRANKLIN BEAUTY SCHOOL #2               ,TX,77021-0000,Proprietary  ,0,0,0,135,420,555
02285900,UNIVERSITY OF COSMETOLOGY ARTS&SCI      ,TX,78504-0000,Proprietary  ,25,60,85,295,548,843
02294800,CAPITOL CITY CAREERS                    ,TX,78745-0000,Proprietary  ,3,11,14,51,292,343
02298501,EVEREST COLLEGE- FORT WORTH             ,TX,76137-2472,Proprietary  ,18,72,90,332,1458,1790
02305300,PARKER COLLEGE OF CHIROPRACTIC          ,TX,75229-0000,Private      ,0,16,16,121,1411,1532
02306700,FORT WORTH BEAUTY SCHOOL                ,TX,76116-3299,Proprietary  ,9,25,34,128,520,648
02312200,TEXAS SCHOOL OF BUSINESS                ,TX,77073-6032,Proprietary  ,6,47,53,385,1474,1859
02312201,TEXAS SCHOOL OF BUSINESS - SOUTHWEST CAM,TX,77057-5914,Proprietary  ,0,0,0,28,108,136
02312202,TEXAS SCHOOL OF BUSINESS - FRIENDSWOOD C,TX,77546-8938,Proprietary  ,4,28,32,113,421,534
02312203,TEXAS SCHOOL OF BUSINESS - EAST CAMPUS  ,TX,77029-1916,Proprietary  ,0,0,0,29,77,106
02313901,WESTWOOD COLLEGE - DALLAS               ,TX,75243-0000,Proprietary  ,2,15,17,161,708,869
02315400,NORTHEAST TEXAS COMMUNITY COLLEGE       ,TX,75456-0000,Public       ,24,75,99,1891,2750,4641
02318200,"KD STUDIO, ACTOR'S CONSERVATORY         ",TX,75207-2111,Proprietary  ,13,9,22,221,354,575
02320200,HOUSTON GRADUATE SCHOOL OF THEOLOGY     ,TX,77092-0000,Private      ,1,9,10,21,365,386
02326000,SAN ANTONIO BEAUTY COLLEGE NO 3         ,TX,78217-0000,Proprietary  ,4,24,28,104,221,325
02331200,BAPTIST MISSIONARY ASSN THEOL SEM       ,TX,75766-0000,Private      ,0,1,1,10,105,115
02331300,INTERACTIVE LEARNING SYSTEMS            ,TX,77502-1201,Proprietary  ,11,58,69,59,411,470
02331301,INTERACTIVE LEARNING SYSTEMS            ,TX,77081-0000,Proprietary  ,26,139,165,179,1034,1213
02331304,INTERACTIVE LEARNING SYSTEMS            ,TX,77060-0000,Proprietary  ,6,48,54,43,384,427
02341300,PALO ALTO COLLEGE                       ,TX,78224-0000,Public       ,67,152,219,6103,8305,14408
02348500,LAMAR STATE COLLEGE-PORT ARTHUR         ,TX,77640-0000,Public       ,11,49,60,1327,2583,3910
02357700,PAUL MITCHELL THE SCHOOL                ,TX,77043-3412,Proprietary  ,22,41,63,503,1031,1534
02358200,LAMAR STATE COLLEGE-ORANGE              ,TX,77630-0000,Public       ,17,51,68,1086,2405,3491
02361400,COLLIN COUNTY COMMUNITY COLLEGE         ,TX,75071-0000,Public       ,166,435,601,9637,15265,24902
02362000,UNIVERSAL TECHNICAL INSTITUTE           ,TX,77073-0000,Proprietary  ,100,170,270,5714,4908,10622
02362800,AUSTIN GRADUATE SCHOOL OF THEOLOGY      ,TX,78752-1333,Private      ,0,1,1,18,135,153
02521200,ARLINGTON CAREER INSTITUTE              ,TX,75050-0000,Proprietary  ,3,10,13,78,472,550
02521800,SEGUIN BEAUTY SCHOOL                    ,TX,78155-0000,Proprietary  ,7,11,18,70,143,213
02527500,HOUSTON TRAINING SCHOOLS                ,TX,77029-0000,Proprietary  ,8,87,95,262,1279,1541
02530700,SEBRING CAREER SCHOOLS                  ,TX,77083-1510,Proprietary  ,2,23,25,36,159,195
02548800,SOUTH TEXAS VO-TECH INSTITUTE           ,TX,78596-0000,Proprietary  ,27,35,62,287,418,705
02548802,SOUTH TEXAS VOCATIONAL TECHNICAL INSTITU,TX,78520-8710,Proprietary  ,31,31,62,289,393,682
02549400,SOUTH TEXAS VO-TECH INSTITUTE           ,TX,78501-0000,Proprietary  ,43,59,102,396,556,952
02549402,SOUTH TEXAS VOCATIONAL TECHNICAL INSTITU,TX,78416-1141,Proprietary  ,9,58,67,199,663,862
02555400,UNIV OF TX MD ANDERSON CANCER CTR       ,TX,77030-0000,Public       ,4,9,13,279,914,1193
02567200,OFFICE CAREER CENTER                    ,TX,76180-0000,Proprietary  ,0,0,0,0,1,1
02568100,TEXAS BARBER COLLEGE                    ,TX,77063-3949,Proprietary  ,11,33,44,177,746,923
02568101,TEXAS BARBER COLLEGES & HAIRSTYLING SCHO,TX,75228-3841,Proprietary  ,6,29,35,149,543,692
02568106,TEXAS BARBER COLLEGES & HAIRSTYLING SCHO,TX,77009-0000,Proprietary  ,2,23,25,125,444,569
02568107,TEXAS BARBER COLLEGES & HAIRSTYLING SCHO,TX,77063-3951,Proprietary  ,1,17,18,123,460,583
02568108,TEXAS BARBER COLLEGES & HAIRSTYLING SCHO,TX,75241-1327,Proprietary  ,8,36,44,150,619,769
02568109,TEXAS BARBER COLLEGES & HAIRSTYLING SCHO,TX,77301-4407,Proprietary  ,2,0,2,43,135,178
02569300,LE CORDON BLEU COLLEGE OF CULINARY ARTS ,TX,78758-3647,Proprietary  ,31,143,174,1604,3569,5173
02572000,COMPUTER CAREER CENTER                  ,TX,79925-2021,Proprietary  ,75,255,330,805,2346,3151
02572004,COMPUTER CAREER CENTER - AMARILLO CAMPUS,TX,79101-2404,Proprietary  ,7,41,48,166,619,785
02572005,COMPUTER CAREER CENTER - LUBBOCK CAMPUS ,TX,79414-3517,Proprietary  ,14,41,55,209,821,1030
02572008,VISTA COLLEGE - BEAUMONT                ,TX,77701-3717,Proprietary  ,11,73,84,144,858,1002
02572009,VISTA COLLEGE - LONGVIEW                ,TX,75604-1905,Proprietary  ,9,67,76,167,1033,1200
02572011,VISTA COLLEGE - KILLEEN                 ,TX,76541-7436,Proprietary  ,9,86,95,189,1317,1506
02591100,CAREER POINT COLLEGE                    ,TX,78201-2027,Proprietary  ,39,310,349,411,3158,3569
02591900,KAPLAN COLLEGE                          ,TX,79907-1525,Proprietary  ,14,66,80,528,1542,2070
02591905,KAPLAN COLLEGE - BROWNSVILLE            ,TX,78521-9905,Proprietary  ,13,31,44,261,680,941
02596400,REDSTONE COLLEGE - LOS ANGELES          ,TX,77061-0000,Proprietary  ,16,53,69,205,508,713
02596500,ATI CAREER TRAINING CENTER              ,TX,76180-1599,Proprietary  ,1,2,3,1,2,3
02596503,ATI- CAREER TRAINING CENTER - HOUSTON (#,TX,77029-1978,Proprietary  ,0,2,2,0,2,2
02596600,ATI-CAREER TRAINING CENTER              ,TX,75220-4443,Proprietary  ,0,8,8,44,168,212
02596601,ATI CAREER TRAINING CENTER - RICHARDSON ,TX,75081-1948,Proprietary  ,0,3,3,15,55,70
02596602,ATI CAREER TRAINING CENTER - DALLAS (STE,TX,75247-6103,Proprietary  ,0,9,9,74,209,283
02600200,OCEAN CORPORATION (THE)                 ,TX,77099-3479,Proprietary  ,3,28,31,246,1121,1367
02604700,CENTER FOR ADVANCED LEGAL STUDIES       ,TX,77098-4151,Proprietary  ,0,33,33,54,595,649
02606202,EVEREST COLLEGE - EVEREST INSTITUTE - BI,TX,77036-8014,Proprietary  ,39,168,207,515,2237,2752
02615000,SANFORD-BROWN COLLEGE                   ,TX,75247-6931,Proprietary  ,18,74,92,456,1870,2326
03009400,SW SCH BUS & TECH CAREERS               ,TX,78212-2840,Proprietary  ,6,22,28,66,255,321
03010604,VIRGINIA COLLEGE - VIRGINIA COLLEGE AT A,TX,78723-0000,Proprietary  ,3,19,22,185,835,1020
03011800,UNIVERSITY OF COSMETOLOGY ARTS & SCIENCE,TX,78226-1194,Proprietary  ,2,7,9,112,204,316
03019800,PCI HEALTH TRAINING CENTER              ,TX,75247-4720,Proprietary  ,10,40,50,342,1051,1393
03019801,PCI HEALTH TRAINING CENTER - RICHARDSON ,TX,75081-2321,Proprietary  ,8,23,31,63,149,212
03021500,SW SCH BUS & TECH CAREERS               ,TX,78852-4859,Proprietary  ,15,17,32,229,288,517
03025000,TEXAS COLLEGE OF COSMETOLOGY            ,TX,79605-2001,Proprietary  ,7,36,43,105,383,488
03025001,TEXAS COLLEGE OF COSMETOLOGY - SAN ANGEL,TX,76903-4708,Proprietary  ,3,4,7,58,111,169
03026500,REMINGTON COLLEGE - HOUSTON CAMPUS      ,TX,77082-1849,Private      ,145,671,816,2255,7447,9702
03026501,REMINGTON COLLEGE - NORTH HOUSTON CAMPUS,TX,77067-1849,Private      ,4,16,20,229,901,1130
03026506,REMINGTON COLLEGE - FT. WORTH CAMPUS    ,TX,76112-1280,Private      ,19,53,72,376,1265,1641
03028800,CIRCLE J BEAUTY SCHOOL                  ,TX,77587-3714,Proprietary  ,6,26,32,72,270,342
03030608,UTAH COLLEGE OF MASSAGE THERAPY - TEXAS ,TX,75801-4848,Proprietary  ,5,14,19,176,384,560
03030609,UTAH COLLEGE OF MASSAGE THERAPY - TEXAS ,TX,77040-6307,Proprietary  ,7,14,21,185,554,739
03031408,INTERNATIONAL ACADEMY OF DESIGN & TECHNO,TX,78229-2263,Proprietary  ,10,28,38,283,682,965
03032300,SCHOOL OF AUTOMOTIVE MACHINISTS         ,TX,77055-1803,Proprietary  ,1,26,27,200,467,667
03035200,TINT SCHOOL OF MAKEUP & COSMETOLOGY     ,TX,75229-3734,Proprietary  ,7,33,40,167,520,687
03035300,SOUTHERN CAREERS INSTITUTE              ,TX,78704-5252,Proprietary  ,170,605,775,1320,4501,5821
03035301,SOUTHERN CAREERS INSTITUTE-PHARR        ,TX,78577-2118,Proprietary  ,21,77,98,169,494,663
03035302,SOUTHERN CAREERS INSTITUTE - CORPUS CHRI,TX,78414-2904,Proprietary  ,13,72,85,186,762,948
03035303,SOUTHERN CAREERS INSTITUTE - SAN ANTONIO,TX,78221-4351,Proprietary  ,1,5,6,62,277,339
03035305,SOUTHERN CAREERS INSTITUTE - BROWNSVILLE,TX,78520-8680,Proprietary  ,0,0,0,87,138,225
03035306,SOUTHERN CAREERS INSTITUTE - HARLINGEN  ,TX,78550-7911,Proprietary  ,1,5,6,90,165,255
03035307,SOUTHERN CAREERS INSTITUTE - CORPUS CHRI,TX,78410-1609,Proprietary  ,0,0,0,14,44,58
03035308,SOUTHERN CAREERS INSTITUTE - SAN ANTONIO,TX,78238-4114,Proprietary  ,26,135,161,151,744,895
03061800,STAR COLLEGE OF COSMETOLOGY             ,TX,75702-8214,Proprietary  ,5,14,19,166,395,561
03064600,UNIVERSITY OF TEXAS AT BROWNSVILLE      ,TX,78520-4993,Public       ,64,189,253,9444,8860,18304
03075400,ICC TECHNICAL INSTITUTE                 ,TX,77004-2930,Private      ,1,13,14,102,328,430
03076403,BRYMAN SCHOOL OF ARIZONA (THE) - ANTHEM ,TX,75038-4201,Proprietary  ,12,36,48,119,375,494
03079201,WESTWOOD COLLEGE OF TECHNOLOGY          ,TX,76180-0000,Proprietary  ,0,0,0,13,32,45
03103400,SOUTH TEXAS COLLEGE                     ,TX,78501-6699,Public       ,367,416,783,16895,14180,31075
03108700,ROYAL BEAUTY CAREERS                    ,TX,77069-4611,Proprietary  ,11,28,39,162,572,734
03115800,KAPLAN COLLEGE                          ,TX,78238-4203,Proprietary  ,26,47,73,372,1434,1806
03115802,KAPLAN COLLEGE - LAREDO                 ,TX,78041-6181,Proprietary  ,7,21,28,265,538,803
03115803,KAPLAN COLLEGE-BEAUMONT                 ,TX,77701-3706,Proprietary  ,8,37,45,178,845,1023
03115804,KAPLAN COLLEGE - LUBBOCK                ,TX,79401-2601,Proprietary  ,6,40,46,177,676,853
03128100,COLLEGE OF HEALTH CARE PROFESSIONS (THE),TX,77092-8108,Proprietary  ,48,187,235,944,3387,4331
03144300,NATIONAL BEAUTY COLLEGE                 ,TX,75043-4046,Proprietary  ,7,7,14,44,123,167
03153300,AMER COLL OF ACUPUNCTURE & O.M.         ,TX,77063-4104,Proprietary  ,0,11,11,25,200,225
03156400,ACADEMY OF ORIENTAL MEDICINE AT AUSTIN  ,TX,78757-1132,Proprietary  ,2,1,3,71,381,452
03159300,ARLINGTON MEDICAL INSTITUTE             ,TX,76011-0000,Proprietary  ,9,13,22,229,561,790
03170300,TEXAS A&M UNIVERSITY-TEXARKANA          ,TX,75501-0000,Public       ,15,65,80,1479,2509,3988
03179500,TEXAS HEALTH AND SCIENCE UNIVERSITY     ,TX,78704-6748,Proprietary  ,4,13,17,40,221,261
03237400,FARIS COMPUTER SCHOOL                   ,TX,77627-3829,Proprietary  ,0,1,1,9,32,41
03272300,KAPLAN COLLEGE                          ,TX,75234-7288,Proprietary  ,10,60,70,389,1810,2199
03272301,KAPLAN COLLEGE - MIDLAND                ,TX,79703-5531,Proprietary  ,0,0,0,57,193,250
03272303,KAPLAN COLLEGE - ARLINGTON              ,TX,76010-8121,Proprietary  ,11,41,52,350,1296,1646
03275300,TOUCH OF CLASS SCHOOL OF COSM           ,TX,75402-6314,Proprietary  ,10,25,35,77,220,297
03276300,ACADEMY OF HAIR DESIGN                  ,TX,75901-4900,Proprietary  ,5,27,32,100,371,471
03277300,ACADEMY OF HAIR DESIGN                  ,TX,77701-4650,Proprietary  ,1,15,16,60,254,314
03303300,NORTHWEST EDUCATIONAL CENTER            ,TX,77092-7055,Proprietary  ,6,48,54,95,489,584
03371300,TONI&GUY HAIRDRESSING ACADEMY           ,TX,75006-2351,Proprietary  ,7,12,19,170,276,446
03372300,NORTHWEST VISTA COLLEGE                 ,TX,78251-4217,Public       ,119,226,345,10854,12117,22971
03396500,TEXAS STATE TECHNICAL COLG/MARSHALL     ,TX,75672-7402,Public       ,12,21,33,484,751,1235
03400300,CAREER QUEST                            ,TX,78229-3539,Proprietary  ,14,54,68,146,785,931
03412300,ADVANCED BARBER COLLEGE & HAIR DESI     ,TX,78596-0000,Proprietary  ,13,13,26,130,273,403
03416500,DALLAS NURSING INSTITUTE                ,TX,75243-5502,Proprietary  ,10,56,66,424,1717,2141
03422300,MILAN INSTITUTE                         ,TX,78238-4103,Proprietary  ,75,196,271,965,2531,3496
03422400,COLLEGE OF BIBLICAL STUDIES-HOUSTON     ,TX,77036-3211,Private      ,5,36,41,134,1319,1453
03424400,MEDVANCE INSTITUTE                      ,TX,77057-7386,Proprietary  ,14,76,90,281,1242,1523
03426300,COLLEGE OF HEALTH CARE PROFESSIONS (THE),TX,78752-3630,Proprietary  ,18,49,67,221,854,1075
03480304,MEDVANCE INSTITUTE OF BATON ROUGE - GRAN,TX,75050-2342,Proprietary  ,0,13,13,103,365,468
03520300,LUBBOCK HAIR ACADEMY                    ,TX,79410-3524,Proprietary  ,4,9,13,57,158,215
03542300,CONCORDE CAREER INSTITUTE               ,TX,76011-4016,Proprietary  ,24,100,124,374,1851,2225
03556400,KUSSAD INSTITUTE OF COURT REPORTING     ,TX,78704-5712,Proprietary  ,0,3,3,13,54,67
03573300,AVIATION INSTITUTE OF MAINTENANCE       ,TX,75209-3017,Proprietary  ,6,45,51,207,905,1112
03610300,MJ'S BEAUTY ACADEMY INC                 ,TX,75224-0000,Proprietary  ,9,15,24,83,284,367
03612400,VALLEY GRANDE INSTITUTE FOR ACADEMI     ,TX,78596-0000,Private      ,7,25,32,174,510,684
03627300,LAMAR INSTITUTE OF TECHNOLOGY           ,TX,77705-4142,Public       ,17,56,73,2162,3765,5927
03676400,HEALTHY HAIR ACADEMY                    ,TX,75227-0000,Proprietary  ,0,0,0,26,82,108
03680300,JAY'S TECHNICAL INSTITUTE               ,TX,77031-3509,Proprietary  ,4,17,21,40,247,287
03682400,DALLAS BARBER & STYLIST COLLEGE         ,TX,75231-0000,Proprietary  ,10,48,58,225,906,1131
03714300,TREND BARBER COLLEGE                    ,TX,77071-2104,Proprietary  ,8,38,46,123,590,713
03723300,CULINARY INST ALAIN & MARIE LENOTRE     ,TX,77022-4322,Proprietary  ,7,41,48,308,836,1144
03727600,CULINARY ACADEMY OF AUSTIN              ,TX,78752-0000,Proprietary  ,13,22,35,401,580,981
03731300,INTERNATIONAL RENOWNED BEAUTY ACADE     ,TX,76103-2504,Proprietary  ,0,0,0,4,12,16
03733300,BAPTIST UNIVERSITY OF THE AMERICAS      ,TX,78224-1336,Private      ,1,8,9,150,414,564
03756300,ANAMARC COLLEGE                         ,TX,79930-6230,Proprietary  ,7,53,60,411,1755,2166
03922300,SOUTH TEXAS BARBER COLLEGE              ,TX,78415-3463,Proprietary  ,2,1,3,51,114,165
03944400,PROFESSIONAL CAREERS INSTITUTE          ,TX,77036-2252,Proprietary  ,1,15,16,37,249,286
03944401,PROFESSIONAL CAREERS INSTITUTE          ,TX,77090-3914,Proprietary  ,0,14,14,47,311,358
03970300,HANDS ON THERAPY                        ,TX,75149-2294,Proprietary  ,2,12,14,41,177,218
03987300,TEXAS HEALTH SCHOOL                     ,TX,77079-2106,Proprietary  ,7,21,28,313,844,1157
04036300,SOUTHEAST TEXAS CAREER INSTITUTE        ,TX,77656-8601,Proprietary  ,5,10,15,73,171,244
04045300,NORTHWEST BEAUTY SCHOOL                 ,TX,77091-1208,Proprietary  ,6,8,14,73,228,301
04045400,MAI-TRIX BEAUTY COLLEGE                 ,TX,77040-0000,Proprietary  ,5,6,11,70,223,293
04082300,PROFESSIONAL CAREER TRAINING INSTITUTE  ,TX,77090-0000,Proprietary  ,1,40,41,67,417,484
04089400,CCI TRAINING CENTER                     ,TX,76011-4857,Proprietary  ,4,45,49,57,517,574
04117900,CHAMPION BEAUTY COLLEGE                 ,TX,77069-4611,Proprietary  ,5,21,26,99,430,529
04121800,CRISWELL COLLEGE                        ,TX,75246-1537,Private      ,0,4,4,157,493,650
04125400,ACADEMY AT AUSTIN (THE)                 ,TX,78660-3287,Proprietary  ,6,12,18,127,254,381
04125500,MANUEL AND THERESA'S SCHOOL OF HAIR DESI,TX,77803-3236,Proprietary  ,4,8,12,58,109,167
04129800,MEDIATECH INSTITUTE DALLAS              ,TX,75039-3105,Proprietary  ,10,21,31,175,378,553
04129801,MEDIATECH INSTITUTE - AUSTIN            ,TX,78704-8933,Proprietary  ,5,11,16,94,217,311
04129802,MEDIATECH INSTITUTE HOUSTON             ,TX,77042-4712,Proprietary  ,5,11,16,146,337,483
04131700,SOUTHWEST CAREER COLLEGE                ,TX,79925-6230,Proprietary  ,80,177,257,1133,2449,3582
04135600,CANNON INSTITUTE OF HIGHER LEARNING     ,TX,75247-9998,Proprietary  ,1,4,5,25,136,161
04136500,PCCENTER                                ,TX,75115-4214,Proprietary  ,0,9,9,21,113,134
04138500,CARDIOTECH ULTRASOUND SCHOOL            ,TX,77099-1440,Proprietary  ,3,17,20,133,623,756
04142300,AVEDA INSTITUTE SAN ANTONIO             ,TX,78215-1260,Proprietary  ,10,18,28,356,810,1166
04146700,AVIATION INSTITUTE OF MAINTENANCE       ,TX,77061-4004,Proprietary  ,17,50,67,236,682,918
04146800,SOUTH TEXAS TRAINING CENTER             ,TX,78586-7721,Proprietary  ,3,24,27,69,176,245
04152700,ASTRODOME CAREER CENTERS                ,TX,77054-2678,Proprietary  ,2,10,12,51,268,319
04154800,DUVALL'S SCHOOL OF COSMETOLOGY          ,TX,76021-4159,Proprietary  ,3,9,12,58,95,153
04155800,ADVANCED BEAUTY COLLEGE                 ,TX,75061-1918,Proprietary  ,0,2,2,35,114,149
04158500,TEXAS BEAUTY COLLEGE                    ,TX,76117-3201,Proprietary  ,1,6,7,15,80,95
04160700,AVENUE FIVE INSTITUTE                   ,TX,78757-7000,Proprietary  ,9,22,31,179,503,682
04161100,CORPUS CHRISTI BEAUTY ACADEMY           ,TX,78412-3900,Proprietary  ,0,0,0,58,123,181
04165800,SALON PROFESSIONAL ACADEMY (THE)        ,TX,75067-5390,Proprietary  ,1,9,10,60,144,204
04168700,LAWYER'S ASSISTANT SCHOOL OF DALLAS     ,TX,75201-2829,Proprietary  ,3,33,36,82,522,604
04168800,ABC BEAUTY ACADEMY                      ,TX,75042-8682,Proprietary  ,3,10,13,39,149,188
04169000,SALON & SPA INSTITUTE                   ,TX,78521-1727,Proprietary  ,1,5,6,93,167,260
04169100,DIAMONDS COSMETOLOGY COLLEGE            ,TX,75090-2657,Proprietary  ,3,11,14,34,135,169
04177900,BUCKNER BARBER SCHOOL                   ,TX,75217-1775,Proprietary  ,4,6,10,84,245,329
04178200,VOGUE COLLEGE - SAN ANTONIO             ,TX,78201-5035,Proprietary  ,3,17,20,72,269,341
04178300,VOGUE BEAUTY ACADEMY                    ,TX,78238-4402,Proprietary  ,3,13,16,89,279,368
04178400,VOGUE COLLEGE - MCALLEN                 ,TX,78501-1945,Proprietary  ,2,16,18,125,289,414
04179500,NORTH AMERICAN UNIVERSITY               ,TX,77038-1221,Private      ,3,6,9,284,287,571
04184800,EXCEL LEARNING CENTER                   ,TX,79907-1400,Proprietary  ,2,28,30,49,332,381
04187800,CYBERTEX INSTITUTE OF TECHNOLOGY        ,TX,78752-3825,Proprietary  ,3,33,36,68,357,425
04193000,RGV CAREERS AN INSTITUTE FOR HIGHER LEAR,TX,78577-2106,Proprietary  ,3,22,25,59,338,397
04205200,WADE GORDON HAIRDRESSING ACADEMY        ,TX,79121-0548,Proprietary  ,4,17,21,74,186,260
04206501,MYCOMPUTERCAREER.COM - DALLAS           ,TX,75062-8173,Proprietary  ,5,111,116,12,306,318
04206502,MYCOMPUTERCAREER.COM - HOUSTON          ,TX,77056-6764,Proprietary  ,7,87,94,23,340,363
04207300,SCHOOL FOR ALLIED HEALTH PROFESSIONALS  ,TX,76018-4104,Proprietary  ,5,10,15,6,13,19
04213300,SPA PROFESSIONALS ACADEMY (THE)         ,TX,78504-2569,Proprietary  ,2,6,8,58,144,202
04215000,TOTAL TRANSFORMATION INSTITUTE OF COSMET,TX,78666-8115,Proprietary  ,2,3,5,23,54,77
04215400,GRACE SCHOOL OF THEOLOGY                ,TX,77384-4894,Private      ,0,4,4,4,38,42
04219700,GEMINI SCHOOL OF VISUAL ARTS & COMMUNICA,TX,78613-2642,Proprietary  ,0,0,0,9,11,20
04224100,COSMETOLOGY ACADEMY OF TEXARKANA        ,TX,75503-4855,Proprietary  ,3,20,23,20,115,135
04226400,MT TRAINING CENTER                      ,TX,75051-3542,Proprietary  ,0,22,22,8,74,82
04229000,BARBER INSTITUTE OF TEXAS               ,TX,75602-3456,Proprietary  ,0,6,6,6,34,40
04231200,NEECEE'S COLLEGE OF COSMETOLOGY         ,TX,79605-4735,Proprietary  ,1,9,10,10,24,34
04231300,YAHWEH BEAUTY ACADEMY                   ,TX,76543-4153,Proprietary  ,2,15,17,4,26,30
04231900,ALAMO CITY BARBER COLLEGE               ,TX,78250-3227,Proprietary  ,4,26,30,25,85,110
04232400,EXCEL LEARNING CENTER - SAN ANTONIO     ,TX,78230-4823,Proprietary  ,1,9,10,1,9,10
04232900,PREPARING PEOPLE BARBER STYLING COLLEGE ,TX,75215-2415,Proprietary  ,3,24,27,5,39,44
00367000,BRIGHAM YOUNG UNIVERSITY                ,UT,84602-8406,Private      ,211,286,497,16047,14974,31021
00367100,DIXIE STATE COLLEGE OF UTAH             ,UT,84770-3876,Public       ,52,81,133,5795,5477,11272
00367200,LDS BUSINESS COLLEGE                    ,UT,84101-3500,Private      ,30,46,76,1416,1522,2938
00367400,STEVENS HENAGER COLLEGE                 ,UT,84401-1420,Proprietary  ,315,2543,2858,2505,19972,22477
00367500,UNIVERSITY OF UTAH                      ,UT,84112-9055,Public       ,107,293,400,15787,20142,35929
00367700,UTAH STATE UNIVERSITY                   ,UT,84322-1400,Public       ,125,279,404,13559,15167,28726
00367800,SOUTHERN UTAH UNIVERSITY                ,UT,84720-2470,Public       ,30,106,136,5879,4118,9997
00367900,SNOW COLLEGE                            ,UT,84627-1299,Public       ,32,22,54,3242,1430,4672
00368000,WEBER STATE UNIVERSITY                  ,UT,84408-1136,Public       ,96,285,381,8609,15183,23792
00368100,WESTMINSTER COLLEGE                     ,UT,84105-3697,Private      ,8,62,70,2909,2317,5226
00402700,UTAH VALLEY UNIVERSITY                  ,UT,84058-5999,Public       ,173,349,522,11255,19975,31230
00522000,SALT LAKE COMMUNITY COLLEGE             ,UT,84123-0000,Public       ,193,666,859,10637,23017,33654
00732953,ITT TECHNICAL INSTITUTE                 ,UT,84123-2500,Proprietary  ,15,164,179,492,2371,2863
00943300,SHERMAN KENDALL'S ACADEMY OF BEAUTY     ,UT,84106-1836,Proprietary  ,2,10,12,38,129,167
01009800,NEUMONT UNIVERSITY                      ,UT,84095-0000,Proprietary  ,2,3,5,852,138,990
01116500,UINTAH BASIN APPLIED TECHNOLOGY CLG     ,UT,84066-0000,Public       ,0,14,14,29,199,228
01116600,BROADVIEW UNIVERSITY                    ,UT,84088-4021,Proprietary  ,2,18,20,454,1361,1815
02078800,SHERMAN KENDALL'S ACADEMY OF BEAUTY     ,UT,84047-0000,Proprietary  ,2,5,7,27,65,92
02115400,BRIDGERLAND APPLIED TECHNOLOGY COLLEGE  ,UT,84321-0000,Public       ,7,26,33,457,1246,1703
02156600,DAVIS APPLIED TECHNOLOGY COLLEGE        ,UT,84037-0000,Public       ,19,54,73,600,1922,2522
02178500,EAGLE GATE COLLEGE                      ,UT,84123-0000,Proprietary  ,8,76,84,265,1582,1847
02270800,AMERITECH COLLEGE                       ,UT,84604-6927,Proprietary  ,5,47,52,179,1824,2003
02270802,AMERITECH COLLEGE - DRAPER              ,UT,84020-6545,Proprietary  ,1,17,18,99,873,972
02298500,EVEREST COLLEGE                         ,UT,84119-2668,Proprietary  ,12,86,98,239,1286,1525
02346500,OGDEN-WEBER APPLIED TECHNOLOGY COLG     ,UT,84404-0000,Public       ,13,67,80,697,2635,3332
02360800,PROVO COLLEGE                           ,UT,84601-0000,Proprietary  ,5,49,54,276,861,1137
02531800,PAUL MITCHELL THE SCHOOL - PROVO        ,UT,84606-0000,Proprietary  ,3,3,6,338,432,770
02556800,PAUL MITCHELL THE SCHOOL                ,UT,84117-7204,Proprietary  ,21,31,52,283,534,817
02556801,PAUL MITCHELL THE SCHOOL                ,UT,84780-0000,Proprietary  ,16,13,29,125,173,298
02572700,EVANS HAIRSTYLING COLLEGE               ,UT,84770-0000,Proprietary  ,3,2,5,43,52,95
02572800,VISTA COLLEGE                           ,UT,84015-0000,Proprietary  ,2,54,56,56,630,686
02573100,EVANS HAIRSTYLING COLLEGE               ,UT,84720-0000,Proprietary  ,5,2,7,52,59,111
02612200,MARINELLO SCHOOL OF BEAUTY              ,UT,84604-1585,Proprietary  ,6,8,14,87,141,228
03030600,UTAH COLLEGE OF MASSAGE THERAPY         ,UT,84111-1606,Proprietary  ,23,25,48,269,575,844
03030601,UTAH CLG OF MASSAGE THER-PROVO CMPS     ,UT,84042-0000,Proprietary  ,6,3,9,69,148,217
03082100,MYOTHERAPY COLLEGE OF UTAH              ,UT,84115-2522,Proprietary  ,1,7,8,27,143,170
03108200,ECHELON EDGE ACADEMY OF HAIR SKIN & NAIL,UT,84070-2004,Proprietary  ,0,9,9,26,93,119
03110400,HAIRITAGE HAIR ACADEMY                  ,UT,84770-5233,Proprietary  ,4,0,4,40,60,100
03339400,WESTERN GOVERNORS UNIVERSITY            ,UT,84107-2533,Private      ,48,2576,2624,1795,65011,66806
03413300,MOUNTAINLAND APPLIED TECHNOLOGY COLLEGE ,UT,84043-0000,Public       ,13,36,49,385,987,1372
03463300,CAREERS UNLIMITED                       ,UT,84058-0000,Proprietary  ,1,3,4,74,201,275
03467308,MARINELLO SCHOOL OF BEAUTY - OGDEN      ,UT,84405-1501,Proprietary  ,10,12,22,86,307,393
03467309,MARINELLO SCHOOL OF BEAUTY - LAYTON     ,UT,84041-3002,Proprietary  ,6,10,16,70,174,244
03617300,HEALING MOUNTAIN MASSAGE SCHOOL         ,UT,84111-0000,Proprietary  ,0,2,2,55,240,295
03829500,SKINWORKS SCHOOL OF ADVANCED SKINCARE   ,UT,84115-0000,Proprietary  ,5,7,12,50,147,197
03838300,NIGHTINGALE COLL. SCH. OF NURSING SCH. O,UT,84403-0000,Proprietary  ,2,10,12,40,318,358
03902300,RENAISSANCE SCHOOL OF THERAPEUTIC MASSAG,UT,84010-2835,Proprietary  ,0,0,0,5,17,22
03909300,PAUL MITCHELL THE SCHOOL LOGAN          ,UT,84323-4679,Proprietary  ,3,6,9,60,113,173
03921300,CAMEO COLLEGE OF ESSENTIAL BEAUTY       ,UT,84115-0000,Proprietary  ,6,19,25,137,499,636
04054300,SOUTHWEST APPLIED TECHNOLOGY COLLEGE    ,UT,84720-6608,Public       ,3,7,10,117,290,407
04072300,AVEDA INSTITUTE PROVO                   ,UT,84604-1008,Proprietary  ,2,1,3,142,173,315
04118100,IMAGEWORKS ACADEMY OF HAIR DESIGN       ,UT,84660-1210,Proprietary  ,0,0,0,2,8,10
04121700,DIXIE APPLIED TECHNOLOGY COLLEGE        ,UT,84770-3025,Public       ,10,13,23,255,430,685
04142100,SKIN INSTITUTE (THE)                    ,UT,84770-6452,Proprietary  ,0,0,0,31,93,124
04145500,SKIN SCIENCE INSTITUTE (THE)            ,UT,84115-0000,Proprietary  ,2,12,14,52,218,270
04153000,RENAISSANCE ACADEMIE                    ,UT,84604-0000,Proprietary  ,3,8,11,45,113,158
04161900,MANDALYN ACADEMY                        ,UT,84003-2161,Proprietary  ,2,5,7,33,92,125
04165500,ACAYDIA SCHOOL OF AESTHETICS            ,UT,84601-0000,Proprietary  ,2,3,5,44,86,130
04169900,AMERICAN BEAUTY ACADEMY                 ,UT,84651-0000,Proprietary  ,3,5,8,25,67,92
04173200,TAYLOR ANDREWS ACADEMY OF HAIR DESIGN   ,UT,84088-6577,Proprietary  ,9,15,24,123,214,337
04173201,TAYLOR ANDREWS ACADEMY -  OREM          ,UT,84004-1872,Proprietary  ,3,5,8,12,14,26
04183000,TOP NAILS & HAIR BEAUTY SCHOOL          ,UT,84118-0000,Proprietary  ,0,15,15,23,136,159
04184200,TAYLOR ANDREWS ACADEMY-ST. GEORGE       ,UT,84790-2139,Proprietary  ,4,7,11,84,144,228
04192700,BARBER SCHOOL (THE)                     ,UT,84047-3723,Proprietary  ,2,15,17,33,173,206
04193200,ROCKY MOUNTAIN UNIVERSITY OF HEALTH PROF,UT,84606-7312,Proprietary  ,0,34,34,26,484,510
04210300,MEDSPA ACADEMIES                        ,UT,84095-3519,Proprietary  ,1,6,7,49,227,276
04211500,BEAUTIFUL YOU SCHOOL OF NAIL TECHNOLOGY ,UT,84720-8360,Proprietary  ,1,0,1,11,24,35
04216800,BONNIE JOSEPH ACADEMY OF COSMETOLOGY & B,UT,84032-2044,Proprietary  ,0,2,2,4,48,52
04218300,MIDWIVES COLLEGE OF UTAH                ,UT,84106-2671,Private      ,0,10,10,21,293,314
00368200,BENNINGTON COLLEGE                      ,VT,05201-6001,Private      ,2,6,8,1142,252,1394
00368300,CASTLETON STATE COLLEGE                 ,VT,05735-0000,Public       ,4,3,7,3424,552,3976
00368400,CHAMPLAIN COLLEGE                       ,VT,05401-3950,Private      ,7,31,38,4494,1506,6000
00368500,COLLEGE OF ST JOSEPH                    ,VT,05701-3899,Private      ,1,4,5,150,228,378
00368600,GODDARD COLLEGE                         ,VT,05667-0000,Private      ,0,10,10,53,955,1008
00368700,GREEN MOUNTAIN COLLEGE                  ,VT,05764-1199,Private      ,0,6,6,898,349,1247
00368800,JOHNSON STATE COLLEGE                   ,VT,05656-9898,Public       ,2,4,6,1438,987,2425
00368900,LYNDON STATE COLLEGE                    ,VT,05851-0919,Public       ,2,1,3,2079,420,2499
00369000,MARLBORO COLLEGE                        ,VT,05344-0300,Private      ,0,5,5,368,155,523
00369100,MIDDLEBURY COLLEGE                      ,VT,05753-0000,Private      ,0,6,6,4704,592,5296
00369200,NORWICH UNIVERSITY                      ,VT,05663-1035,Private      ,4,53,57,3341,1809,5150
00369300,SOUTHERN VERMONT COLLEGE                ,VT,05201-6002,Private      ,0,2,2,655,187,842
00369400,ST MICHAELS COLLEGE                     ,VT,05439-0001,Private      ,4,8,12,4054,250,4304
00369600,UNIVERSITY OF VERMONT                   ,VT,05405-0160,Public       ,21,28,49,19313,3466,22779
00369700,VERMONT COLLEGE OF FINE ARTS            ,VT,05602-3128,Private      ,0,4,4,28,493,521
00369800,VERMONT TECHNICAL COLLEGE               ,VT,05061-0000,Public       ,2,4,6,1216,927,2143
00857500,SALON PROFESSIONAL ACADEMY (THE)        ,VT,05495-4001,Proprietary  ,0,0,0,49,86,135
00865800,O'BRIENS AVEDA INSTITUTE                ,VT,05403-7747,Proprietary  ,2,1,3,42,99,141
00886000,SIT                                     ,VT,05301-4801,Private      ,1,5,6,217,600,817
01116700,COMMUNITY COLLEGE OF VERMONT            ,VT,05676-0000,Public       ,39,177,216,2082,5127,7209
01193400,VERMONT LAW SCHOOL                      ,VT,05068-0000,Private      ,0,4,4,4,1049,1053
01218300,BURLINGTON COLLEGE                      ,VT,05401-8477,Private      ,1,2,3,309,224,533
02143500,STERLING COLLEGE                        ,VT,05827-0000,Private      ,0,0,0,128,65,193
02254000,NEW ENGLAND CULINARY INSTITUTE          ,VT,05602-0000,Proprietary  ,1,4,5,452,256,708
02532600,LANDMARK COLLEGE                        ,VT,05346-0000,Private      ,1,0,1,588,99,687
03708300,BURLINGTON TECHNICAL CENTER             ,VT,05401-2721,Public       ,0,0,0,12,18,30
04146900,ADVANCED WELDING INSTITUTE              ,VT,05403-0000,Proprietary  ,1,4,5,51,63,114
00392800,CASPER COLLEGE                          ,WY,82601-4612,Public       ,6,39,45,1541,1990,3531
00392900,EASTERN WYOMING COLLEGE                 ,WY,82240-1603,Public       ,0,15,15,589,481,1070
00393000,SHERIDAN COLLEGE                        ,WY,82801-9133,Public       ,11,27,38,1186,1370,2556
00393100,NORTHWEST COLLEGE                       ,WY,82435-1895,Public       ,6,14,20,1003,690,1693
00393200,UNIVERSITY OF WYOMING                   ,WY,82071-2000,Public       ,28,132,160,7947,5500,13447
00393300,WESTERN WYOMING COMMUNITY COLLEGE       ,WY,82902-0000,Public       ,3,16,19,1045,1335,2380
00728900,CENTRAL WYOMING COLLEGE                 ,WY,82501-0000,Public       ,4,26,30,635,955,1590
00915700,WYOMING TECHNICAL INSTITUTE             ,WY,82072-9519,Proprietary  ,121,54,175,1954,1238,3192
00925900,LARAMIE COUNTY COMMUNITY CLG            ,WY,82007-3299,Public       ,17,104,121,1789,2766,4555
02211900,CHEEKS INTERNATIONAL ACDMY              ,WY,82001-0000,Proprietary  ,3,12,15,59,203,262
00393500,UNIV OF GUAM                            ,GU,96923-0000,Public       ,28,51,79,2816,2163,4979
01536100,GUAM COMMUNITY COLLEGE                  ,GU,96921-0000,Public       ,12,26,38,1925,2002,3927
03438300,PACIFIC ISLANDS UNIVERSITY              ,GU,96913-2619,Private      ,2,4,6,114,145,259
00393600,PONTIFICAL CATHOLIC UNIV OF PR          ,PR,00717-0777,Private      ,24,29,53,6806,5517,12323
00393700,UNIVERSITY OF THE SACRED HEART          ,PR,00914-0383,Private      ,5,23,28,4001,2645,6646
00393800,INTER-AMER UNIV PR-CNTRL ADMN           ,PR,00936-0000,Private      ,124,38,162,3840,6163,10003
00393801,INTER-AMER UNIV PR SCHL LAW             ,PR,00936-8351,Private      ,1,5,6,35,333,368
00393802,INTER AMERICAN UNIVERSITY OF PUERTO RICO,PR,00926-0000,Private      ,13,12,25,1161,1241,2402
00393803,INTER AMERICAN UNIVERSITY OF PR         ,PR,00683-0000,Private      ,10,11,21,3955,2016,5971
00393804,INTER-AMER UNIV PR-RECINTO AGUADILA     ,PR,00605-2000,Private      ,53,13,66,3308,2176,5484
00393805,INTER-AMER UNIV PR-ARECIBO CAMPUS       ,PR,00614-4050,Private      ,11,20,31,3198,2635,5833
00393806,INTER-AMER UNIV PR-BARRANQUITAS REG     ,PR,00794-0517,Private      ,124,20,144,1943,870,2813
00393807,INTER-AMER UNIV PR-FAJARDO REGIONAL     ,PR,00738-0000,Private      ,6,6,12,1581,1183,2764
00393808,INTER-AMER UNIV PR - GUAYAMA CAMPUS     ,PR,00785-4004,Private      ,60,15,75,1364,1333,2697
00393809,INTER-AMER UNIV PR-PONCE REGIONAL       ,PR,00715-0000,Private      ,101,21,122,4020,3219,7239
00393811,INTER-AMER UNIV PR-BAYAMON REG CLG      ,PR,00959-0000,Private      ,8,6,14,4150,1872,6022
00394100,UNIVERSIDAD DEL ESTE                    ,PR,00984-2010,Private      ,33,178,211,7749,8937,16686
00394200,UNIVERSITY OF PR-CENTRAL ADMINISTRATION ,PR,00936-4984,Public       ,4,4,8,403,289,692
00394300,UNIVERSITY OF PUERTO RICO - HUMACAO UNIV,PR,00791-4300,Public       ,6,1,7,3209,478,3687
00394400,UNIVERSITY OF PUERTO RICO - MAYAGUEZ    ,PR,00680-0000,Public       ,13,7,20,9019,2018,11037
00501900,UNIV ADVENTISTA DE LAS ANTILLAS         ,PR,00681-0118,Private      ,6,3,9,1038,657,1695
00502200,BAYAMON CENTRAL UNIVERSITY              ,PR,00960-0000,Private      ,76,31,107,1252,1341,2593
00710800,UNIVERSITY OF PUERTO RICO - RIO PIEDRAS ,PR,00931-3300,Public       ,20,23,43,9335,3406,12741
00720600,UNIVERSITY OF PUERTO RICO - CAYEY UNIVER,PR,00736-5534,Public       ,18,3,21,3654,454,4108
00722800,UNIVERSITY OF PUERTO RICO - ARECIBO     ,PR,00614-4010,Public       ,11,1,12,3781,620,4401
00890200,COLUMBIA CENTRO UNIVERSITARIO           ,PR,00726-0000,Proprietary  ,31,63,94,1441,1448,2889
00965200,"UNIVERSITY OF PUERTO RICO, PONCE TECH UN",PR,00716-0000,Public       ,4,4,8,3436,482,3918
01056700,COLEGIO TECNOLOGICO DE SAN JUAN         ,PR,00918-2973,Public       ,1,6,7,810,875,1685
01072400,CARLOS ALBIZU UNIVERSITY                ,PR,00902-3711,Private      ,8,15,23,124,925,1049
01081900,CONSERVATORIO DE MUSICA DE PUERTO RICO  ,PR,00907-3373,Public       ,0,0,0,351,137,488
01092200,UNIVERSITY OF PUERTO RICO - UTUADO      ,PR,00641-2500,Public       ,9,4,13,1613,276,1889
01097500,UNIVERSITY OF PUERTO RICO BAYAMON TECHNI,PR,00959-1911,Public       ,9,4,13,4598,707,5305
01120300,RYDER MEMORIAL HOSP SCH OF NURSING      ,PR,00792-0000,Private      ,0,0,0,19,17,36
01171900,UNIVERSIDAD DEL TURABO                  ,PR,00778-0000,Private      ,23,177,200,8983,11657,20640
01194000,ICPR JUNIOR COLLEGE                     ,PR,00919-0000,Proprietary  ,165,227,392,1815,2351,4166
01194100,AMERICAN UNIVERSITY OF PUERTO RICO      ,PR,00960-2037,Private      ,41,9,50,810,603,1413
01194101,AMERICAN UNIVERSITY OF PUERTO RICO      ,PR,00674-0000,Private      ,77,15,92,855,612,1467
01212300,"UNIVERSITY OF PUERTO RICO, AGUADILLA REG",PR,00604-0160,Public       ,4,1,5,2885,542,3427
01252500,CARIBBEAN UNIVERSITY                    ,PR,00960-0493,Private      ,88,29,117,2693,3263,5956
02063100,MBTI BUSINESS TRNG INSTITUTE            ,PR,00907-3917,Proprietary  ,101,278,379,1728,4979,6707
02100000,POLYTECHNIC UNIVERSITY OF PR            ,PR,00917-0000,Private      ,7,9,16,2386,2398,4784
02163300,UNIVERSIDAD CENTRAL DEL CARIBE          ,PR,00960-0000,Private      ,2,4,6,206,441,647
02165100,EDP COLLEGE OF PUERTO RICO              ,PR,00919-0000,Private      ,134,124,258,1188,2028,3216
02166000,CENTER FOR ADVANCED STUDIES OF PUER     ,PR,00902-0000,Private      ,0,5,5,6,282,288
02166400,INSTITUTO DE BANCA Y COMERCIO           ,PR,00925-0000,Proprietary  ,429,698,1127,9454,11397,20851
02170300,INST EDUC TECNIA OCUP LA REINA          ,PR,00674-0000,Proprietary  ,15,18,33,297,315,612
02189100,CENTRO DE ESTUDIOS MULTIDISCIPLIN       ,PR,00926-0000,Private      ,68,138,206,1732,2069,3801
02189300,EMMA'S BEAUTY ACADEMY                   ,PR,00680-0000,Proprietary  ,17,14,31,258,154,412
02195400,MODERN HAIRSTYLING INSTITUTE            ,PR,00961-0000,Proprietary  ,19,23,42,777,531,1308
02195500,MODERN HAIRSTYLING INSTITUTE            ,PR,00612-0000,Proprietary  ,0,0,0,8,12,20
02195800,LICEO E ARTE Y TECNOLGIA                ,PR,00919-0000,Proprietary  ,19,40,59,807,907,1714
02195900,MODERN HAIRSTYLING INSTITUTE            ,PR,00980-0000,Proprietary  ,0,0,0,13,11,24
02234900,ANTILLES SCHOOL OF TECH CAREERS         ,PR,00909-3006,Proprietary  ,14,22,36,327,503,830
02241901,COMMONWEALTH OF PR DEPT OF EDUC - CARLOS,PR,00986-0000,Public       ,1,0,1,12,15,27
02241902,COMMONWEALTH OF PR DEPT OF EDUC - TOMAS ,PR,00613-0000,Public       ,0,0,0,3,4,7
02241904,COMMONWEALTH OF PR DEPT OF EDUC - ITPR R,PR,00655-0000,Public       ,0,0,0,569,386,955
02241905,COMMONWEALTH OF PR DEPT OF EDUC - JOSE A,PR,00674-0000,Public       ,0,0,0,38,21,59
02241907,COMMONWEALTH OF PR DEPT OF EDUC - ITPR R,PR,00928-0000,Public       ,2,3,5,305,212,517
02241908,COMMONWEALTH OF PR DEPT OF EDUC - ITPR R,PR,00732-0000,Public       ,2,1,3,481,283,764
02241909,COMMONWEALTH OF PR DEPT OF EDUC - TROQUE,PR,00959-0000,Public       ,2,1,3,62,21,83
02241910,COMMONWEALTH OF PR DEPT OF EDUC - ITPR R,PR,00701-1091,Public       ,1,1,2,592,227,819
02260600,NATIONAL COLLEGE OF BUSINESS & TECH     ,PR,00960-2036,Proprietary  ,25,162,187,5115,10407,15522
02260800,HUERTAS COLLEGE                         ,PR,00726-0000,Proprietary  ,24,69,93,981,1148,2129
02297700,AUTOMECA TECHNICAL COLLEGE              ,PR,00957-0000,Proprietary  ,2,4,6,1187,802,1989
02303800,AMERICAN EDUCATIONAL COLLEGE            ,PR,00961-0000,Proprietary  ,85,115,200,408,775,1183
02335500,COLEGIO BIBLICO PENTECOSTAL DE PR       ,PR,00978-0000,Private      ,0,0,0,27,222,249
02340600,HUMACAO COMMUNITY COLLEGE               ,PR,00792-0000,Private      ,19,38,57,462,538,1000
02343600,INSTITUTE OF BEAUTY CAREERS             ,PR,00613-0000,Proprietary  ,45,30,75,427,318,745
02460000,UNIVERSITY OF PUERTO RICO - MEDICAL SCIE,PR,00936-0000,Public       ,0,6,6,688,1519,2207
02482400,PONCE SCHOOL OF MEDICINE AND HEALTH SCIE,PR,00716-2347,Private      ,0,3,3,84,743,827
02502400,SERBIA'S SCHOOL OF BEAUTY CULTURE       ,PR,00785-0000,Proprietary  ,7,12,19,190,328,518
02504500,INSTITUCION CHAVIANO DE MAYAGUEZ        ,PR,00708-0000,Proprietary  ,5,2,7,43,73,116
02505400,ATLANTIC COLLEGE                        ,PR,00970-0000,Private      ,6,7,13,1245,478,1723
02534900,PONCE PARAMEDICAL COLLEGE (POPAC)       ,PR,00731-0000,Proprietary  ,51,101,152,1920,1599,3519
02552300,COLEGIO MAYOR DE TECHNOLOGIA            ,PR,00714-0000,Proprietary  ,17,18,35,197,238,435
02562500,INTERNATIONAL TECHNICAL COLLEGE         ,PR,00918-0000,Proprietary  ,10,23,33,73,130,203
02563500,ROGIES SCHOOL OF BEAUTY CULTURE         ,PR,00910-0000,Proprietary  ,0,2,2,50,63,113
02569400,ESCUELA DE ARTES PLASTICAS              ,PR,00902-1112,Public       ,1,0,1,426,165,591
02570400,EDUCATIONAL TECHNICAL COLLEGE           ,PR,00925-3404,Proprietary  ,23,45,68,556,1063,1619
02576100,ESCUELA TECNICA DE ELECTRICIDAD         ,PR,00731-0000,Proprietary  ,7,11,18,291,349,640
02587500,UNIVERSIDAD METROPOLITANA               ,PR,00928-0000,Private      ,44,189,233,7220,9759,16979
02588600,SEMINARIO EVANGELICO DE PUERTO RICO     ,PR,00925-0000,Private      ,0,2,2,3,77,80
02593700,HISPANIC AMERICAN COLLEGE               ,PR,00725-0000,Proprietary  ,14,40,54,239,368,607
03016000,UNIVERSITY OF PUERTO RICO CAROLINA REGIO,PR,00985-0000,Public       ,20,6,26,3798,770,4568
03021900,EDIC COLLEGE                            ,PR,00726-0000,Proprietary  ,39,73,112,1227,1252,2479
03025500,MECH TECH COLLEGE                       ,PR,00725-6118,Proprietary  ,87,116,203,3193,2237,5430
03025900,"LICEO DE ARTE, DISENOS Y COMERCIO       ",PR,00726-0000,Proprietary  ,12,19,31,257,435,692
03029700,"UNIVERSAL TECHNOLOGY CLG OF PR, INC     ",PR,00605-0000,Private      ,31,68,99,592,1076,1668
03061900,COLEGIO TECHNOLOGICO Y COMERCIAL        ,PR,00602-0960,Proprietary  ,2,3,5,48,78,126
03068400,STAR BEAUTY ACADEMY                     ,PR,00961-6312,Proprietary  ,11,25,36,55,89,144
03070500,D'MART INSTITUTE                        ,PR,00794-3517,Proprietary  ,79,87,166,708,1056,1764
03075600,EMMA'S BEAUTY ACADEMY                   ,PR,00795-0000,Proprietary  ,45,20,65,368,228,596
03085700,PROFESSIONAL TECHNICAL INSTITUTION      ,PR,00960-7061,Proprietary  ,12,15,27,249,290,539
03104400,PROFESSIONAL ELECTRIC SCHOOL            ,PR,00674-1797,Proprietary  ,0,4,4,40,49,89
03106900,ESCUELA DE PERITOS ELECTRICITAS         ,PR,00662-0457,Proprietary  ,4,4,8,57,56,113
03112100,JOHN DEWEY COLLEGE                      ,PR,00915-9538,Private      ,114,267,381,1899,3951,5850
03112101,JOHN DEWEY COLLEGE                      ,PR,00986-0000,Private      ,22,48,70,437,805,1242
03112102,JOHN DEWEY COLLEGE-BAYAMON CAMPUS       ,PR,00959-0000,Private      ,13,26,39,162,329,491
03112104,JOHN DEWEY COLLEGE - YABUCOA LRNING SITE,PR,00767-0767,Private      ,8,19,27,31,52,83
03112105,JOHN DEWEY COLLEGE - FAJARDO BRANCH     ,PR,00738-0738,Private      ,15,27,42,199,360,559
03112106,JOHN DEWEY COLLEGE - ARROYO BRANCH      ,PR,00714-0714,Private      ,6,8,14,72,136,208
03112107,JOHN DEWEY COLLEGE - JUANA DIAZ BRANCH  ,PR,00795-0000,Private      ,12,17,29,216,308,524
03112108,JOHN DEWEY COLLEGE - HATILLO CAMPUS     ,PR,00659-0000,Private      ,4,9,13,128,232,360
03112109,JOHN DEWEY COLLEGE - MANATI             ,PR,00674-0000,Private      ,20,26,46,399,620,1019
03112110,DEWEY UNIVERSITY - MAYAGUEZ             ,PR,00682-0000,Private      ,10,28,38,10,28,38
03115900,TRINITY COLLEGE OF PUERTO RICO          ,PR,00734-0000,Private      ,27,29,56,205,277,482
03122500,ACADEMIA SERRANT INC.                   ,PR,00717-1568,Proprietary  ,13,32,45,258,341,599
03123100,GLOBELLE TECHNICAL INSTITUTE            ,PR,00693-4218,Proprietary  ,9,7,16,96,86,182
03124200,NOVA COLLEGE DE PUERTO RICO             ,PR,00960-4016,Proprietary  ,20,29,49,172,320,492
03157600,"COLEGIO DE CINEMATOGRAFIA, ARTES Y TELEV",PR,00961-6345,Proprietary  ,12,20,32,801,477,1278
03177300,SAN JUAN BAUTISTA SCH OF MEDICINE       ,PR,00726-0000,Private      ,0,1,1,24,325,349
03336300,CENTURY COLLEGE                         ,PR,00603-0000,Proprietary  ,6,6,12,131,206,337
03414300,MONTECLARO                              ,PR,00745-9612,Private      ,1,0,1,20,28,48
03452300,INSTITUTO PRE-VOCACIONAL E INDUSTRI     ,PR,00613-1800,Private      ,0,2,2,97,238,335
03469300,IVAEM COLLEGE                           ,PR,00725-0000,Proprietary  ,1,1,2,109,67,176
03531300,UNIVERSIDAD PENTECOSTAL MIZPA           ,PR,00928-0966,Private      ,0,0,0,33,361,394
03544300,ATENAS COLLEGE                          ,PR,00674-0000,Private      ,28,40,68,1027,919,1946
03552300,LESTON COLLEGE                          ,PR,00961-6309,Proprietary  ,14,13,27,158,147,305
03585300,CENTRO DE CAPACITACION Y ASESORAMIE     ,PR,00612-0000,Private      ,0,0,0,1,9,10
03608300,CARIBBEAN FORENSIC & TECHNICAL COLL     ,PR,00926-0000,Proprietary  ,2,6,8,50,107,157
03638300,ROSSLYN TRAINING ACADEMY OF COSMETOLOGY ,PR,00602-3225,Proprietary  ,0,0,0,25,62,87
03735400,"CHARLIES GUARD,DETECTIVE BUREAU&ACA     ",PR,00605-0000,Proprietary  ,8,7,15,77,78,155
03751300,ESCUELA HOTELERA DE SAN JUAN            ,PR,00917-0091,Proprietary  ,6,29,35,756,531,1287
03758300,BAYAMON COMMUNITY COLLEGE               ,PR,00960-0000,Proprietary  ,6,26,32,102,328,430
03781400,INDUSTRIAL TECHNICAL COLLEGE            ,PR,00792-0000,Proprietary  ,8,25,33,165,295,460
03785300,J.G. GUAYNABO TECHNICAL COLLEGE         ,PR,00960-0000,Proprietary  ,2,8,10,44,105,149
03800300,COLEGIO TECNICO DE ELECTRICIDAD GALLOSA ,PR,00602-0000,Proprietary  ,1,0,1,24,52,76
03800400,INSTITUTE OF BEAUTY OCCUPATIONS AND TECH,PR,00676-5071,Proprietary  ,20,22,42,143,195,338
03843300,ADVANCED TECH COLLEGE                   ,PR,00961-6321,Proprietary  ,0,1,1,44,112,156
03849300,AGUADILLA TECHNICAL COLLEGE             ,PR,00603-0000,Proprietary  ,8,6,14,48,102,150
03965400,MYRANGEL BEAUTY INSTITUTE               ,PR,00754-3917,Proprietary  ,25,36,61,153,243,396
04030300,"ASPIRA DE PUERTO RICO, ACADEMIA DE TECNO",PR,00987-0000,Private      ,0,0,0,2,4,6
04107300,CARIB TECHNOLOGICAL INSTITUTE           ,PR,00960-0000,Proprietary  ,75,38,113,216,263,479
04117200,INSTITUTO EDUCATIVO PREMIER             ,PR,00731-0000,Proprietary  ,11,25,36,197,262,459
04131600,LIBERTY TECHNICAL COLLEGE               ,PR,00737-1298,Proprietary  ,2,3,5,99,135,234
04164300,GLOBAL INSTITUTE                        ,PR,00725-6485,Proprietary  ,0,7,7,29,36,65
04176000,AMERICAN TECHNICAL INSTITUTE            ,PR,00957-0000,Proprietary  ,7,8,15,28,55,83
00394600,UNIVERSITY OF THE VIRGIN ISLANDS        ,VI,00802-9990,Public       ,7,7,14,1179,894,2073
00394601,UNIV OF THE VIRGIN ISLANDS-ST CROIX     ,VI,00850-0000,Public       ,3,9,12,608,707,1315
00667700,MCGILL UNIVERSITY                       ,CN,00000-0000,Public       ,1,2,3,1547,457,2004
00667900,QUEEN'S UNIVERSITY AT KINGSTON          ,CN,00000-0000,Public       ,0,0,0,106,42,148
00668100,ST FRANCIS XAVIER UNIVERSITY            ,CN,00000-0000,Public       ,0,0,0,28,11,39
00668200,ST THOMAS UNIVERSITY                    ,CN,00000-0000,Public       ,0,0,0,47,5,52
00668300,UNIVERSITY OF GUELPH                    ,CN,00000-0000,Public       ,1,2,3,49,87,136
00668400,UNIVERSITY OF MANITOBA                  ,CN,00000-0000,Public       ,0,0,0,59,49,108
00668500,UNIVERSITY OF NEW BRUNSWICK (THE)       ,CN,00000-0000,Public       ,0,0,0,29,18,47
00668600,UNIVERSITY OF OTTAWA                    ,CN,00000-0000,Public       ,0,2,2,55,83,138
00668800,UNIVERSITY OF TORONTO                   ,CN,00000-0000,Public       ,0,1,1,366,405,771
00668900,UNIVERSITY OF WINDSOR                   ,CN,00000-0000,Public       ,0,0,0,29,58,87
00683700,UNIVERSITE LAVAL                        ,CN,00000-0000,Public       ,1,0,1,12,36,48
00683800,DALHOUSIE UNIVERSITY                    ,CN,00000-0000,Public       ,0,0,0,132,67,199
00683805,DALHOUSIE UNIVERSITY - AGRICULTURAL CAMP,CN,00000-0000,Public       ,0,0,0,2,4,6
00685200,BISHOP'S UNIVERSITY                     ,CN,00000-0000,Private      ,0,0,0,65,7,72
00685300,MCMASTER UNIVERSITY                     ,CN,00000-0000,Public       ,0,0,0,24,30,54
00767900,YORK UNIVERSITY                         ,CN,00000-0000,Public       ,0,2,2,90,112,202
00787400,UNIVERSITY AT CALGARY (THE)             ,CN,00000-0000,Public       ,0,0,0,52,71,123
00814800,UNIVERSITY OF WINNIPEG                  ,CN,00000-0000,Public       ,0,0,0,28,17,45
00836200,UNIVERSITY OF ALBERTA (THE)             ,CN,00000-0000,Public       ,0,0,0,51,46,97
00836300,MOUNT SAINT VINCENT UNIVERSITY          ,CN,00000-0000,Public       ,0,0,0,10,7,17
00836400,SAINT MARY'S UNIVERSITY                 ,CN,00000-0000,Public       ,2,0,2,18,16,34
00836500,CONCORDIA UNIVERSITY - SIR GEORGE W     ,CN,00000-0000,Public       ,2,2,4,284,173,457
00836600,UNIVERSITE DE MONTREAL                  ,CN,00000-0000,Public       ,0,3,3,26,68,94
00836800,CARLETON UNIVERSITY                     ,CN,00000-0000,Public       ,0,1,1,73,45,118
00836900,UNIVERSITY OF BRITISH COLUMBIA          ,CN,00000-0000,Public       ,1,7,8,885,584,1469
00837000,"SAFA, UNIVERSITY OF VICTORIA            ",CN,00000-0000,Public       ,0,3,3,142,71,213
00844400,SIMON FRASER UNIVERSITY                 ,CN,00000-0000,Public       ,0,1,1,153,114,267
00844600,UNIVERSITY OF WESTERN ONTARIO (THE)     ,CN,00000-0000,Public       ,0,2,2,57,90,147
00844800,UNIVERSITY OF REGINA                    ,CN,00000-0000,Public       ,0,1,1,8,11,19
00844900,ACADIA UNIVERSITY                       ,CN,00000-0000,Public       ,0,0,0,55,16,71
00852600,UNIVERSITY OF WATERLOO                  ,CN,00000-0000,Public       ,2,0,2,60,31,91
00858200,WILFRID LAURIER UNIVERSITY              ,CN,00000-0000,Public       ,0,0,0,11,12,23
00891300,LAKEHEAD UNIVERSITY                     ,CN,00000-0000,Public       ,0,0,0,8,8,16
00911900,UNIVERSITE DE MONCTON                   ,CN,00000-0000,Public       ,0,0,0,1,1,2
00925200,BROCK UNIVERSITY                        ,CN,00000-0000,Public       ,0,0,0,12,12,24
00936700,UNIVERSITY OF PRINCE EDWARD ISLAND      ,CN,00000-0000,Public       ,0,0,0,22,107,129
00942100,BRANDON UNIVERSITY                      ,CN,00000-0000,Public       ,0,0,0,13,14,27
00948600,TRINITY WESTERN UNIVERSITY              ,CN,00000-0000,Private      ,0,0,0,127,65,192
00950000,MEMORIAL UNIVERSITY OF NEWFOUNDLAND     ,CN,00000-0000,Public       ,0,1,1,17,32,49
00950100,UNIVERSITY OF KING'S COLLEGE            ,CN,00000-0000,Public       ,0,0,0,32,5,37
00950300,MOUNT ALLISON UNIVERSITY                ,CN,00000-0000,Public       ,0,0,0,33,3,36
00950500,TRENT UNIVERSITY                        ,CN,00000-0000,Public       ,0,0,0,10,3,13
00969800,MEDICINE HAT COLLEGE                    ,CN,00000-0000,Public       ,0,0,0,5,4,9
01012300,NOVA SCOTIA COLLEGE OF ART & DESIGN     ,CN,00000-0000,Public       ,0,0,0,16,13,29
01022100,SAINT PAUL UNIVERSITY                   ,CN,00000-0000,Public       ,0,0,0,4,20,24
01045800,SHERIDAN COLLEGE OF APPLIED ARTS AN     ,CN,00000-0000,Public       ,0,1,1,61,29,90
01067500,REGENT COLLEGE                          ,CN,00000-0000,Private      ,0,0,0,8,77,85
01070300,UNIVERSITY OF LETHBRIDGE                ,CN,00000-0000,Public       ,0,1,1,5,8,13
01072000,RYERSON UNIVERSITY                      ,CN,00000-0000,Public       ,0,1,1,65,72,137
01172200,BRIERCREST BIBLE COLLEGE                ,CN,00000-0000,Private      ,0,0,0,9,6,15
01222800,HUMBER COLLEGE                          ,CN,00000-0000,Public       ,0,0,0,44,54,98
01227400,PROVIDENCE COLLEGE                      ,CN,00000-0000,Private      ,1,0,1,34,5,39
02102100,KINGSWOOD UNIVERSITY                    ,CN,00000-0000,Private      ,0,0,0,64,19,83
02167000,PRAIRIE BIBLE INST                      ,CN,00000-0000,Private      ,0,1,1,13,8,21
02184600,INSTITUTE FOR CHRISTIAN STUDIES         ,CN,00000-0000,Private      ,0,0,0,4,3,7
02195700,TAYLOR UNIVERSITY COLLEGE AND SEMINARY  ,CN,00000-0000,Private      ,0,0,0,2,4,6
02201100,COLUMBIA BIBLE COLLEGE                  ,CN,00000-0000,Private      ,0,0,0,15,14,29
02216400,TYNDALE COLLEGE & SEMINARY              ,CN,00000-0000,Private      ,0,0,0,6,16,22
02219200,UNIVERSITY OF SASKATCHEWAN              ,CN,00000-0000,Public       ,0,0,0,16,31,47
02324900,EMMANUEL BIBLE COLLEGE                  ,CN,00000-0000,Private      ,0,0,0,1,2,3
02338800,EMILY CARR UNIVERSITY OF ART AND DESIGN ,CN,00000-0000,Public       ,0,0,0,73,53,126
02577200,SALVATION ARMY WM & CATHERINE BOOTH     ,CN,00000-0000,Private      ,0,0,0,3,1,4
02593800,CONCORDIA UNIVERSITY COLLEGE            ,CN,00000-0000,Private      ,0,0,0,12,14,26
02611900,THE KING'S UNIVERSITY COLLEGE           ,CN,00000-0000,Private      ,0,0,0,3,7,10
03018300,ROCKY MOUNTAIN COLLEGE: CENTRE FOR BIBLI,CN,00000-0000,Private      ,0,0,0,2,2,4
03033800,UNIVERSITY COLLEGE OF CAPE BRETON       ,CN,00000-0000,Public       ,0,0,0,6,6,12
03078300,VANCOUVER SCHOOL OF THEOLOGY            ,CN,00000-0000,Private      ,0,0,0,2,11,13
03273300,CANADIAN COLLEGE OF NATUROPATHIC ME     ,CN,00000-0000,Private      ,0,0,0,3,21,24
03298300,ALBERTA COLLEGE OF ART & DESIGN         ,CN,00000-0000,Public       ,0,0,0,26,29,55
03332500,KWANTLEN UNIVERSITY COLLEGE             ,CN,00000-0000,Public       ,0,0,0,5,16,21
03335400,CANADIAN UNIVERSITY COLLEGE             ,CN,00000-0000,Private      ,0,0,0,47,23,70
03339300,ST. STEPHENS UNIVERSITY                 ,CN,00000-0000,Private      ,0,0,0,3,2,5
03348500,REDEEMER UNIVERSITY COLLEGE             ,CN,00000-0000,Private      ,0,0,0,14,4,18
03420300,HOLLAND COLLEGE                         ,CN,00000-0000,Public       ,0,0,0,14,11,25
03560400,NIAGARA COLLEGE-WELLAND CAMPUS          ,CN,00000-0000,Public       ,0,0,0,16,13,29
03613300,UNIV OF NORTHERN BRITISH COLUMBIA       ,CN,00000-0000,Public       ,0,0,0,7,18,25
03644400,CANADIAN MENNONITE UNIVERSITY           ,CN,00000-0000,Private      ,0,0,0,8,4,12
03674400,CANADIAN SOUTHERN BAPTIST SEMINARY      ,CN,00000-0000,Private      ,0,0,0,1,5,6
03711300,CAPILANO UNIVERSITY                     ,CN,00000-0000,Public       ,0,0,0,17,23,40
03846300,PACIFIC LIFE BIBLE COLLEGE              ,CN,00000-0000,Private      ,0,0,0,12,5,17
03847300,CRANDALL UNIVERSITY                     ,CN,00000-0000,Private      ,0,0,0,3,3,6
04075300,QUEST UNIVERSITY CANADA                 ,CN,00000-0000,Private      ,0,0,0,150,7,157
04123100,ATLANTIC SCHOOL OF THEOLOGY             ,CN,00000-0000,Public       ,0,0,0,1,8,9
04156700,AMBROSE UNIVERSITY COLLEGE              ,CN,00000-0000,Private      ,0,0,0,11,14,25
00814700,UNIVERSIDAD AUTONOMA DE GUADALAJARA     ,MX,00000-0000,Private      ,1,5,6,86,1289,1375
01041800,INST TEC Y DE ESTSUPER DE MONTERRE      ,MX,00000-0000,Private      ,0,0,0,96,75,171
01067600,UNIVERSIDAD DE MONTERREY                ,MX,00000-0000,Private      ,0,1,1,34,41,75
01093800,UNIVERSIDAD DE GUANAJUATO               ,MX,00000-0000,Public       ,0,0,0,26,46,72
01230100,UNIV AUTON DE TAMAULIPAS FAC DEMED      ,MX,00000-0000,Public       ,0,0,0,1,6,7
02053300,CENTRO DE ESTUDIOS UNIVERSITARIOS D     ,MX,00000-0000,Private      ,0,2,2,54,92,146
04183900,CETYS UNIVERSIDAD                       ,MX,00000-0000,Private      ,2,4,6,106,76,182
01001000,AMERICAN SAMOA CMNTY COLLEGE            ,AS,96799-2609,Public       ,94,24,118,1390,500,1890
01034300,COLLEGE OF MICRONESIA - FSM             ,FM,96941-0159,Public       ,214,102,316,2428,1164,3592
01100900,PALAU COMMUNITY COLLEGE                 ,PW,96940-0009,Public       ,45,30,75,854,366,1220
03022400,COLLEGE OF THE MARSHALL ISLANDS         ,MH,96960-1258,Public       ,46,112,158,992,517,1509
03033000,NORTHERN MARIANAS COLLEGE               ,MP,96950-0000,Public       ,8,0,8,968,523,1491
