OPE ID,School,State,Zip Code,School Type,20132014Qtr5_Dependent Students,20132014Qtr5_Independent Students,Quarterly Total,YTD_20132014Qtr5_Dependent Students,YTD_20132014Qtr5_nan,Independent Students,Award Year To Date Total
00100200,ALABAMA AGRCLTL & MECHL UNIV            ,AL,35762-1357,Public       ,129,131,260,6567,,3822,10389
00100300,FAULKNER UNIVERSITY                     ,AL,36109-3398,Private      ,53,188,241,2128,,4414,6542
00100400,UNIVERSITY OF MONTEVALLO                ,AL,35115-6000,Public       ,35,49,84,2627,,1613,4240
00100500,ALABAMA STATE UNIVERSITY                ,AL,36101-0000,Public       ,252,218,470,10513,,6446,16959
00100700,CENTRAL ALABAMA COMMUNITY COLLEGE       ,AL,35011-0000,Public       ,54,95,149,1523,,2083,3606
00100800,ATHENS STATE UNIVERSITY                 ,AL,35611-1999,Public       ,16,126,142,1020,,3547,4567
00100900,AUBURN UNIVERSITY                       ,AL,36849-5113,Public       ,341,244,585,19013,,7086,26099
00101200,BIRMINGHAM SOUTHERN COLLEGE             ,AL,35254-0002,Private      ,44,40,84,2172,,927,3099
00101300,CALHOUN COMMUNITY COLLEGE               ,AL,35609-0000,Public       ,153,404,557,5705,,8839,14544
00101500,ENTERPRISE STATE COMMUNITY COLLEGE      ,AL,36331-1300,Public       ,46,80,126,1408,,1890,3298
00101600,UNIVERSITY OF NORTH ALABAMA             ,AL,35632-0001,Public       ,96,90,186,5909,,3170,9079
00101700,GADSDEN STATE COMMUNITY COLLEGE         ,AL,35903-2269,Public       ,109,269,378,3385,,6342,9727
00101800,GEORGE C WALLACE COMMUNITY COLLEGE      ,AL,36303-0943,Public       ,81,217,298,2609,,4749,7358
00101900,HUNTINGDON COLLEGE                      ,AL,36106-2148,Private      ,37,38,75,1656,,859,2515
00102000,JACKSONVILLE STATE UNIVERSITY           ,AL,36265-1602,Public       ,121,193,314,7412,,6023,13435
00102100,JEFFERSON DAVIS COMMUNITY COLLEGE       ,AL,36427-2790,Public       ,29,46,75,714,,967,1681
00102200,JEFFERSON STATE COMMUNITY COLLEGE       ,AL,35215-3098,Public       ,131,417,548,5370,,9618,14988
00102300,JUDSON COLLEGE                          ,AL,36756-2504,Private      ,10,11,21,377,,171,548
00102400,UNIVERSITY OF WEST ALABAMA              ,AL,35470-0000,Public       ,72,263,335,2776,,5041,7817
00102600,MARION MILITARY INSTITUTE               ,AL,36756-3214,Public       ,6,0,6,567,,103,670
00102800,MILES COLLEGE                           ,AL,35064-2697,Private      ,68,50,118,2708,,1460,4168
00102900,UNIVERSITY OF MOBILE                    ,AL,36613-0000,Private      ,34,58,92,2018,,2372,4390
00103000,BISHOP STATE COMMUNITY COLLEGE          ,AL,36603-5898,Public       ,84,238,322,2717,,5746,8463
00103100,NORTHEAST ALABAMA STATE CMNTY COLG      ,AL,35986-0159,Public       ,118,115,233,1612,,2070,3682
00103300,OAKWOOD COLLEGE                         ,AL,35896-0001,Private      ,30,42,72,2017,,1258,3275
00103400,ALABAMA SOUTHERN COMMUNITY COLLEGE      ,AL,36460-5698,Public       ,61,50,111,1308,,1127,2435
00103600,SAMFORD UNIVERSITY                      ,AL,35229-7000,Private      ,57,94,151,4051,,3183,7234
00103800,SNEAD STATE COMMUNITY COLLEGE           ,AL,35957-0734,Public       ,71,96,167,1737,,2098,3835
00104000,SOUTHERN UNION STATE COMMUNITY CLG      ,AL,36276-0000,Public       ,73,153,226,3744,,3642,7386
00104100,SPRING HILL COLLEGE                     ,AL,36608-1791,Private      ,44,42,86,2625,,1104,3729
00104400,STILLMAN COLLEGE                        ,AL,35403-0000,Private      ,52,36,88,1951,,812,2763
00104600,TALLADEGA COLLEGE                       ,AL,35160-2354,Private      ,33,27,60,1143,,597,1740
00104700,TROY UNIVERSITY                         ,AL,36082-0001,Public       ,196,1017,1213,9727,,22782,32509
00105000,TUSKEGEE UNIVERSITY                     ,AL,36088-1645,Private      ,77,37,114,5483,,1599,7082
00105100,UNIVERSITY OF ALABAMA (THE)             ,AL,35487-0120,Public       ,410,394,804,29160,,12535,41695
00105200,UNIVERSITY OF ALABAMA AT BIRMINGHAM     ,AL,35294-1150,Public       ,238,444,682,12817,,14224,27041
00105500,UNIVERSITY OF ALABAMA IN HUNTSVILLE     ,AL,35899-0001,Public       ,97,194,291,5576,,5043,10619
00105700,UNIVERSITY OF SOUTH ALABAMA             ,AL,36688-0002,Public       ,188,362,550,11302,,11361,22663
00105900,LAWSON STATE COMMUNITY COLLEGE          ,AL,35221-1798,Public       ,123,291,414,2477,,4256,6733
00105901,LAWSON STATE COMMUNITY COLLEGE - BESSEME,AL,35021-0308,Public       ,43,91,134,871,,1651,2522
00106000,FAULKNER STATE COMMUNITY COLLEGE        ,AL,36507-2698,Public       ,99,160,259,3674,,4068,7742
00526000,J.F. DRAKE STATE TECH COLLEGE           ,AL,35811-1584,Public       ,36,157,193,777,,2440,3217
00569100,SHELTON STATE COMMUNITY CLG             ,AL,35405-4017,Public       ,130,133,263,4675,,4370,9045
00569200,REID STATE TECHNICAL COLLEGE            ,AL,36401-0000,Public       ,15,49,64,272,,766,1038
00569700,NORTHWEST- SHOALS COMMUNITY COLLEGE     ,AL,35661-0000,Public       ,127,159,286,2819,,2819,5638
00569900,GEORGE C WALLACE STATE CMTY COLLEGE     ,AL,36703-0000,Public       ,77,99,176,1310,,2072,3382
00573300,BEVILL STATE CMTY COLLEGE-WALKER        ,AL,35148-0000,Public       ,120,186,306,2453,,3618,6071
00573400,H. COUNCILL TRENHOLM STATE TECH COLLEGE ,AL,36108-0020,Public       ,33,119,152,930,,2420,3350
00573401,H. C. TRENHOLM ST TECH COL-PATTERSON CAM,AL,36116-2612,Public       ,23,63,86,568,,1347,1915
00787100,GEORGE C WALLACE STATE CMTY CLG         ,AL,35077-2000,Public       ,116,211,327,3846,,4567,8413
00831000,AUBURN UNIVERSITY-MONTGOMERY            ,AL,36124-0000,Public       ,93,204,297,4893,,5217,10110
00898800,LURLEEN B WALLACE COMMUNITY COLLEGE     ,AL,36420-0418,Public       ,62,77,139,1192,,1409,2601
01055400,CONCORDIA COLLEGE                       ,AL,36701-3323,Private      ,27,26,53,839,,572,1411
01218200,CHATTAHOOCHEE VALLEY CMTY CLG           ,AL,36869-7917,Public       ,36,135,171,1280,,2385,3665
01303906,SOUTH UNIVERSITY - MONTGOMERY           ,AL,36116-1120,Proprietary  ,26,148,174,471,,1859,2330
02170600,UNITED STATES SPORTS ACADEMY            ,AL,36526-7055,Private      ,1,49,50,46,,802,848
02199700,HERITAGE CHRISTIAN UNIVERSITY           ,AL,35630-0000,Private      ,1,3,4,40,,101,141
02270400,SOUTHEASTERN BIBLE COLLEGE              ,AL,35244-2083,Private      ,4,15,19,152,,346,498
02285000,PAUL MITCHELL THE SCHOOL HUNTSVILLE     ,AL,35758-0000,Proprietary  ,11,19,30,108,,218,326
02296000,PRINCE INSTITUTE OF PROFESSIONAL STUDIES,AL,36117-0000,Proprietary  ,6,30,36,56,,386,442
02341000,FORTIS COLLEGE                          ,AL,36609-0000,Proprietary  ,59,241,300,826,,2769,3595
02503400,AMRIDGE UNIVERSITY                      ,AL,36124-0000,Private      ,2,87,89,93,,1338,1431
03010600,VIRGINIA COLLEGE                        ,AL,35209-5154,Proprietary  ,454,2581,3035,4184,,24506,28690
03010602,VIRGINIA COLLEGE - HUNTSVILLE           ,AL,35805-0000,Proprietary  ,10,60,70,279,,1139,1418
03010607,VIRGINIA COLLEGE - MOBILE               ,AL,36608-1626,Proprietary  ,28,139,167,447,,1725,2172
03010616,VIRGINIA COLLEGE - MONTGOMERY           ,AL,36117-2802,Proprietary  ,28,157,185,481,,1942,2423
03026516,REMINGTON COLLEGE - MOBILE              ,AL,36609-5593,Private      ,12,41,53,707,,1881,2588
03032500,ALABAMA STATE CLG BARBER STYLING        ,AL,35215-0000,Proprietary  ,7,13,20,107,,213,320
03361400,FORTIS COLLEGE                          ,AL,36535-0000,Proprietary  ,12,85,97,208,,780,988
03459300,SOUTHEASTERN SCHOOL OF COSMETOLOGY      ,AL,35228-0000,Private      ,2,27,29,47,,185,232
03783300,BLUE CLIFF CAREER COLLEGE               ,AL,63306-4749,Proprietary  ,6,25,31,135,,417,552
03894300,HUNTSVILLE BIBLE COLLEGE                ,AL,35811-0000,Private      ,1,16,17,35,,270,305
04066300,CARDIAC AND VASCULAR INSTITUTE OF ULTRAS,AL,36604-1411,Proprietary  ,2,12,14,70,,361,431
04067300,SELMA UNIVERSITY                        ,AL,36701-0000,Private      ,19,43,62,244,,690,934
04121500,COLUMBIA SOUTHERN UNIVERSITY            ,AL,36561-3815,Proprietary  ,41,1418,1459,608,,16945,17553
04149200,XCELL ACADEMY-A PAUL MITCHELL PARTNER SC,AL,35216-4990,Proprietary  ,5,23,28,118,,314,432
04187200,NEW BEGINNING COLLEGE OF COSMETOLOGY    ,AL,35950-2415,Proprietary  ,6,8,14,75,,177,252
04187300,HAIR ACADEMY (THE)                      ,AL,36111-2201,Proprietary  ,0,10,10,71,,183,254
04197500,UNIVERSITY ACADEMY OF HAIR DESIGN       ,AL,35476-3100,Proprietary  ,4,5,9,50,,107,157
04211000,SALON PROFESSIONAL ACADEMY (THE)        ,AL,35816-1849,Proprietary  ,2,9,11,74,,196,270
04217900,NUNATION SCHOOL OF COSMETOLOGY          ,AL,35064-2222,Proprietary  ,0,3,3,0,,3,3
00111100,ALLAN HANCOCK COLLEGE                   ,CA,93454-6399,Public       ,137,343,480,5365,,6152,11517
00111300,ANTELOPE VALLEY COLLEGE                 ,CA,93536-5426,Public       ,384,1028,1412,8014,,13583,21597
00111600,ART CENTER COLLEGE OF DESIGN            ,CA,91103-1999,Private      ,52,47,99,2057,,1710,3767
00111700,AZUSA PACIFIC UNIVERSITY                ,CA,91702-7000,Private      ,118,572,690,11017,,10341,21358
00111800,BAKERSFIELD COLLEGE                     ,CA,93305-1299,Public       ,352,707,1059,11725,,12639,24364
00111900,BARSTOW COMMUNITY COLLEGE               ,CA,92311-6608,Public       ,78,430,508,1629,,4958,6587
00112000,AMER BAPT SEM OF THE WEST-BERKELEY      ,CA,94704-0000,Private      ,0,2,2,13,,67,80
00112200,BIOLA UNIVERSITY                        ,CA,90639-0001,Private      ,77,51,128,6991,,2472,9463
00112300,BROOKS INSTITUTE                        ,CA,93103-1809,Proprietary  ,17,18,35,564,,474,1038
00112400,CABRILLO COLLEGE                        ,CA,95003-3194,Public       ,201,406,607,5593,,6440,12033
00112500,CALIFORNIA BAPTIST UNIVERSITY           ,CA,92504-3297,Private      ,116,312,428,7615,,6444,14059
00112700,CALIFORNIA COLLEGE OF THE ARTS          ,CA,94107-2206,Private      ,44,46,90,2489,,2104,4593
00113100,CALIFORNIA INSTITUTE OF TECHNOLOGY      ,CA,91125-0001,Private      ,35,24,59,3749,,783,4532
00113200,CALIFORNIA INSTITUTE OF THE ARTS        ,CA,91355-2397,Private      ,52,28,80,2818,,1710,4528
00113300,CALIFORNIA LUTHERAN UNIVERSITY          ,CA,91360-2787,Private      ,56,89,145,5393,,2054,7447
00113400,CALIFORNIA MARITIME ACADEMY             ,CA,94590-8181,Public       ,13,21,34,1144,,501,1645
00113700,CALIF STATE UNIV-FULLERTON              ,CA,92831-3599,Public       ,507,488,995,51099,,25211,76310
00113800,"CALIFORNIA STATE UNIVERSITY, EAST BAY   ",CA,94542-3000,Public       ,230,433,663,17862,,15505,33367
00113900,CALIF STATE UNIV-LONG BEACH             ,CA,90840-0006,Public       ,674,543,1217,60503,,27010,87513
00114000,CALIF STATE UNIV-LOS ANGELES            ,CA,90032-4226,Public       ,433,490,923,38626,,24851,63477
00114100,"CALIF STATE UNIV, DOMINGUEZ HILLS       ",CA,90747-0001,Public       ,204,355,559,19263,,17430,36693
00114200,CALIF STATE UNIV SAN BERNARDINO         ,CA,92407-2397,Public       ,238,362,600,22489,,15701,38190
00114300,CAL POLY STATE UNIVERSITY               ,CA,93407-0001,Public       ,349,116,465,39719,,5226,44945
00114400,CALIF STATE POLYTECHNIC UNIV POMONA     ,CA,91768-2500,Public       ,387,251,638,36744,,12800,49544
00114600,CALIF STATE UNIV - CHICO                ,CA,95929-0001,Public       ,255,131,386,23269,,7838,31107
00114700,CALIF STATE UNIV - FRESNO               ,CA,93740-8026,Public       ,269,293,562,26968,,14080,41048
00114900,HUMBOLDT STATE UNIVERSITY               ,CA,95521-8299,Public       ,150,90,240,13397,,4806,18203
00115000,CALIF STATE UNIV-SACRAMENTO             ,CA,95819-6044,Public       ,397,470,867,33710,,21987,55697
00115100,SAN DIEGO STATE UNIVERSITY              ,CA,92182-1690,Public       ,680,569,1249,60340,,23700,84040
00115300,CALIF STATE UNIV-NORTHRIDGE             ,CA,91330-8307,Public       ,488,485,973,43765,,24341,68106
00115400,SAN FRANCISCO STATE UNIVERSITY          ,CA,94132-1740,Public       ,380,395,775,41639,,21579,63218
00115500,SAN JOSE STATE UNIVERSITY               ,CA,95192-0036,Public       ,401,382,783,34539,,18804,53343
00115600,SONOMA STATE UNIVERSITY                 ,CA,94928-3609,Public       ,122,81,203,14129,,4194,18323
00115700,CALIF STATE UNIV-STANISLAUS             ,CA,95382-0299,Public       ,92,116,208,10347,,6762,17109
00116100,CERRITOS COLLEGE                        ,CA,90650-6296,Public       ,477,649,1126,19202,,16044,35246
00116200,CHABOT COLLEGE                          ,CA,94545-2400,Public       ,222,474,696,7118,,8578,15696
00116300,CHAFFEY COLLEGE                         ,CA,91737-9400,Public       ,431,801,1232,16729,,17135,33864
00116400,CHAPMAN UNIVERSITY                      ,CA,92866-1099,Private      ,124,105,229,12278,,3743,16021
00116453,CHAPMAN UNIVERSITY DALE E. FOWLER SCHOOL,CA,92866-0000,Private      ,3,9,12,82,,1480,1562
00116500,CHURCH DIV SCH OF THE PACIFIC           ,CA,94709-0000,Private      ,0,2,2,5,,72,77
00116600,CITRUS COLLEGE                          ,CA,91741-1899,Public       ,412,595,1007,11455,,8766,20221
00116900,CLAREMONT GRADUATE UNIVERSITY           ,CA,91711-0000,Private      ,0,49,49,33,,2010,2043
00117000,CLAREMONT MCKENNA COLLEGE               ,CA,91711-6400,Private      ,23,7,30,3794,,220,4014
00117100,HARVEY MUDD COLLEGE                     ,CA,91711-5990,Private      ,15,3,18,2689,,134,2823
00117200,PITZER COLLEGE                          ,CA,91711-6101,Private      ,18,9,27,3039,,240,3279
00117300,POMONA COLLEGE                          ,CA,91711-6301,Private      ,46,20,66,5157,,308,5465
00117400,SCRIPPS COLLEGE                         ,CA,91711-3948,Private      ,7,5,12,1976,,185,2161
00117600,WEST HILLS COMMUNITY COLLEGE            ,CA,93210-1399,Public       ,37,69,106,1564,,1499,3063
00117700,COGSWELL POLYTECHNICAL COLLEGE          ,CA,94089-1210,Proprietary  ,9,10,19,452,,245,697
00117800,COLLEGE OF MARIN                        ,CA,94904-2590,Public       ,57,203,260,1347,,2716,4063
00117801,COLG OF MARIN-INDIAN VALLEY CMPS        ,CA,94949-0000,Public       ,13,48,61,328,,819,1147
00117900,NOTRE DAME DE NAMUR UNIVERSITY          ,CA,94002-1997,Private      ,19,50,69,1909,,1599,3508
00118100,COLLEGE OF SAN MATEO                    ,CA,94402-3784,Public       ,172,232,404,3816,,3630,7446
00118200,COLLEGE OF THE DESERT                   ,CA,92260-9305,Public       ,269,431,700,6205,,6918,13123
00118300,HOLY NAMES UNIVERSITY                   ,CA,94619-1699,Private      ,11,45,56,1130,,1391,2521
00118500,COLLEGE OF THE REDWOODS                 ,CA,95501-9300,Public       ,92,225,317,2851,,4450,7301
00118600,COLLEGE OF THE SEQUOIAS                 ,CA,93277-2234,Public       ,178,396,574,7431,,8114,15545
00118700,COLLEGE OF THE SISKIYOUS                ,CA,96094-2899,Public       ,29,55,84,1146,,1339,2485
00118701,COLLEGE OF THE SISKIYOUS - YREKA CENTER ,CA,96097-9538,Public       ,3,18,21,166,,448,614
00119000,CONTRA COSTA COLLEGE                    ,CA,94806-3195,Public       ,108,324,432,2854,,4565,7419
00119100,DIABLO VALLEY COLLEGE                   ,CA,94523-1544,Public       ,315,500,815,7170,,7194,14364
00119200,CUESTA COLLEGE                          ,CA,93403-8106,Public       ,160,301,461,5025,,4708,9733
00119300,CYPRESS COLLEGE                         ,CA,90630-5897,Public       ,338,516,854,12624,,10955,23579
00119600,DOMINICAN UNIVERSITY OF CALIFORNIA      ,CA,94901-2298,Private      ,32,41,73,3167,,1526,4693
00119700,EL CAMINO COLLEGE                       ,CA,90506-0002,Public       ,524,826,1350,16782,,15589,32371
00119701,COMPTON COMMUNITY COLLEGE               ,CA,90221-5393,Public       ,176,534,710,4061,,6392,10453
00119900,FOOTHILL COLLEGE                        ,CA,94022-4597,Public       ,171,402,573,4327,,5609,9936
00120000,FULLER THEOLOGICAL SEMINARY             ,CA,91182-0000,Private      ,0,82,82,29,,2365,2394
00120100,FULLERTON COLLEGE                       ,CA,92832-2095,Public       ,442,704,1146,16328,,11972,28300
00120200,GAVILAN COLLEGE                         ,CA,95020-9599,Public       ,107,184,291,2352,,2537,4889
00120300,GLENDALE COMMUNITY COLLEGE              ,CA,91208-2894,Public       ,467,706,1173,11884,,10713,22597
00120500,GOLDEN GATE UNIVERSITY                  ,CA,94105-2967,Private      ,16,135,151,271,,3621,3892
00120600,GOLDEN WEST COLLEGE                     ,CA,92647-2748,Public       ,233,428,661,10393,,9064,19457
00120700,GRADUATE THEOLOGICAL UNION              ,CA,94709-0000,Private      ,0,6,6,1,,308,309
00120800,GROSSMONT COLLEGE                       ,CA,92020-1799,Public       ,339,582,921,11287,,13368,24655
00120900,HARTNELL COMMUNITY COLLEGE              ,CA,93901-1697,Public       ,188,258,446,4726,,3861,8587
00121200,HUMPHREYS COLLEGE                       ,CA,95207-3896,Private      ,16,75,91,414,,1405,1819
00121400,IMPERIAL VALLEY COLLEGE                 ,CA,92251-9787,Public       ,185,274,459,5120,,4403,9523
00121500,LA SIERRA UNIVERSITY                    ,CA,92515-3332,Private      ,64,89,153,3901,,1835,5736
00121600,UNIVERSITY OF LA VERNE                  ,CA,91750-4443,Private      ,98,454,552,6899,,7941,14840
00121700,LASSEN COLLEGE                          ,CA,96130-3000,Public       ,19,57,76,633,,803,1436
00121800,LOMA LINDA UNIVERSITY                   ,CA,92350-0001,Private      ,18,109,127,1456,,6541,7997
00121900,LONG BEACH CITY COLLEGE                 ,CA,90808-1780,Public       ,666,1143,1809,20226,,18891,39117
00122000,MASTER'S COLLEGE & SEMINARY (THE)       ,CA,91321-1200,Private      ,12,22,34,1516,,544,2060
00122300,LOS ANGELES CITY COLLEGE                ,CA,90029-3588,Public       ,498,1270,1768,12543,,19419,31962
00122400,LOS ANGELES HARBOR COLLEGE              ,CA,90744-2397,Public       ,266,473,739,5356,,6413,11769
00122600,LOS ANGELES PIERCE COLLEGE              ,CA,91371-0001,Public       ,604,899,1503,14874,,13496,28370
00122700,LOS ANGELES TRADE TECH COLLEGE          ,CA,90015-4181,Public       ,480,1618,2098,8621,,17958,26579
00122800,LOS ANGELES VALLEY COLLEGE              ,CA,91401-4096,Public       ,501,944,1445,11479,,13260,24739
00122900,SO CA UNIV  HEALTH SCIENCES             ,CA,90604-4051,Private      ,2,19,21,56,,826,882
00123000,MARSHALL B. KETCHUM UNIVERSITY          ,CA,92831-1699,Private      ,2,6,8,25,,522,547
00123200,AMERICAN RIVER COLLEGE                  ,CA,95841-4286,Public       ,448,1311,1759,15944,,25513,41457
00123300,SACRAMENTO CITY COLLEGE                 ,CA,95822-1386,Public       ,450,1004,1454,16511,,20605,37116
00123600,MENLO COLLEGE                           ,CA,94027-4301,Private      ,25,3,28,1730,,269,1999
00123700,MERCED COMMUNITY COLLEGE                ,CA,95348-2898,Public       ,220,353,573,7390,,6957,14347
00123800,MILLS COLLEGE                           ,CA,94613-1301,Private      ,25,69,94,2007,,2099,4106
00123900,MIRACOSTA COLLEGE                       ,CA,92056-3899,Public       ,152,415,567,5810,,8363,14173
00124000,MODESTO JUNIOR COLLEGE                  ,CA,95350-5800,Public       ,311,675,986,11375,,13891,25266
00124200,MONTEREY PENINSULA COLLEGE              ,CA,93940-4799,Public       ,150,254,404,3494,,3381,6875
00124300,MOUNT ST MARYS COLLEGE                  ,CA,90049-1599,Private      ,38,85,123,3805,,2948,6753
00124500,MT. SAN ANTONIO COLLEGE                 ,CA,91789-1399,Public       ,810,1188,1998,21916,,18386,40302
00124600,MT SAN JACINTO COLLEGE                  ,CA,92583-2399,Public       ,291,702,993,10088,,13707,23795
00124700,NAPA VALLEY COLLEGE                     ,CA,94558-6236,Public       ,99,203,302,3415,,3513,6928
00124900,OCCIDENTAL COLLEGE                      ,CA,90041-3314,Private      ,45,8,53,5592,,480,6072
00125000,ORANGE COAST COLLEGE - FIN AID OFF      ,CA,92628-5005,Public       ,362,621,983,15475,,12240,27715
00125100,OTIS COLLEGE OF ART AND DESIGN          ,CA,90045-3505,Private      ,36,36,72,1807,,959,2766
00125200,HOPE INTERNATIONAL UNIVERSITY           ,CA,92631-0000,Private      ,19,54,73,913,,1298,2211
00125300,FRESNO PACIFIC UNIVERSITY               ,CA,93702-4798,Private      ,41,271,312,2972,,4675,7647
00125400,PACIFIC LUTHERAN THEOLOGICAL SEM        ,CA,94708-0000,Private      ,0,2,2,2,,72,74
00125500,PACIFIC OAKS COLLEGE                    ,CA,91103-3606,Private      ,2,62,64,90,,1677,1767
00125600,PACIFIC SCHOOL OF RELIGION              ,CA,94709-0000,Private      ,0,0,0,2,,207,209
00125800,PACIFIC UNION COLLEGE                   ,CA,94508-9797,Private      ,34,31,65,2077,,611,2688
00125900,PALO VERDE COLLEGE                      ,CA,92225-0000,Public       ,17,57,74,312,,604,916
00126000,PALOMAR COLLEGE                         ,CA,92069-1486,Public       ,293,721,1014,11659,,11547,23206
00126100,PASADENA CITY COLLEGE                   ,CA,91106-2003,Public       ,487,759,1246,20723,,15782,36505
00126200,POINT LOMA NAZARENE UNIVERSITY          ,CA,92106-2899,Private      ,42,108,150,5130,,1869,6999
00126600,LANEY COLLEGE                           ,CA,94607-4893,Public       ,189,750,939,4810,,10108,14918
00126700,MERRITT COLLEGE                         ,CA,94619-3196,Public       ,94,441,535,3017,,6504,9521
00126800,PORTERVILLE COLLEGE                     ,CA,93257-6059,Public       ,68,145,213,2659,,2706,5365
00126900,RIO HONDO COLLEGE                       ,CA,90601-1699,Public       ,370,561,931,14364,,10466,24830
00127000,RIVERSIDE CITY COLLEGE                  ,CA,92506-1299,Public       ,777,1367,2144,22168,,22114,44282
00127200,SAN BERNARDINO VALLEY COLLEGE           ,CA,92410-2798,Public       ,244,725,969,11164,,15752,26916
00127300,SAN DIEGO CITY COLLEGE                  ,CA,92101-4787,Public       ,346,1006,1352,12550,,18504,31054
00127500,SAN DIEGO MESA COLLEGE                  ,CA,92111-4996,Public       ,381,890,1271,13598,,16030,29628
00127800,SAN FRANCISCO CONSERVATORY OF MUSIC     ,CA,94122-4498,Private      ,2,8,10,346,,478,824
00127900,SAN FRANCISCO THEOLOGICAL SEMINARY      ,CA,94960-0000,Private      ,0,2,2,1,,67,68
00128000,SAN JOAQUIN DELTA COLLEGE               ,CA,95207-6370,Public       ,408,807,1215,11117,,13549,24666
00128100,WILLIAM JESSUP UNIVERSITY               ,CA,95765-3707,Private      ,18,54,72,1234,,846,2080
00128200,SAN JOSE CITY COLLEGE                   ,CA,95128-2797,Public       ,173,473,646,5513,,8063,13576
00128400,SANTA ANA COLLEGE                       ,CA,92706-3398,Public       ,344,646,990,10076,,9232,19308
00128500,SANTA BARBARA CITY COLLEGE              ,CA,93109-2394,Public       ,343,384,727,10595,,7116,17711
00128600,SANTA MONICA COLLEGE                    ,CA,90405-1644,Public       ,783,952,1735,22857,,14614,37471
00128700,SANTA ROSA JUNIOR COLLEGE               ,CA,95401-4395,Public       ,270,524,794,7484,,8948,16432
00128800,CLAREMONT SCHOOL OF THEOLOGY            ,CA,91711-0000,Private      ,0,3,3,8,,326,334
00128900,SHASTA COLLEGE                          ,CA,96049-7692,Public       ,110,294,404,4396,,6347,10743
00129000,SIERRA COLLEGE                          ,CA,95677-3397,Public       ,345,645,990,9842,,11505,21347
00129100,SIMPSON UNIVERSITY                      ,CA,96003-8606,Private      ,18,31,49,1460,,1343,2803
00129200,SOLANO COMMUNITY COLLEGE                ,CA,94534-3197,Public       ,184,443,627,4376,,6987,11363
00129300,VANGUARD UNIVERSITY OF SOUTHERN CA      ,CA,92626-6597,Private      ,29,60,89,2705,,1516,4221
00129400,SOUTHWESTERN COLLEGE                    ,CA,91910-7299,Public       ,335,649,984,11279,,10908,22187
00129500,SOUTHWESTERN LAW SCHOOL                 ,CA,90010-1106,Private      ,2,20,22,79,,2320,2399
00129600,DOMINICAN SCH PHILOSOPHY & THEOLOGY     ,CA,94709-0000,Private      ,0,3,3,10,,78,88
00129900,ST JOHN'S SEMINARY COLLEGE              ,CA,93010-0000,Private      ,1,0,1,9,,10,19
00130200,SAINT MARY'S COLLEGE OF CALIFORNIA      ,CA,94556-2744,Private      ,58,77,135,5999,,1928,7927
00130500,STANFORD UNIVERSITY                     ,CA,94305-6106,Private      ,234,197,431,27737,,4469,32206
00130501,STANFORD UNIVERSITY - SCHOOL OF MEDICINE,CA,94305-5404,Private      ,3,36,39,92,,1681,1773
00130502,STANFORD UNIVERSITY - GRADUATE SCHOOL OF,CA,94305-7298,Private      ,4,51,55,108,,2050,2158
00130503,STANFORD UNIVERSITY - STANFORD LAW SCHOO,CA,94305-8610,Private      ,5,15,20,266,,2423,2689
00130700,FRESNO CITY COLLEGE                     ,CA,93741-0002,Public       ,386,902,1288,18461,,20396,38857
00130800,REEDLEY COLLEGE                         ,CA,93654-2099,Public       ,230,335,565,8096,,6430,14526
00130900,TAFT COLLEGE                            ,CA,93268-2317,Public       ,55,84,139,2031,,1942,3973
00131200,UNIVERSITY OF CALIFORNIA-BERKELEY       ,CA,94720-1520,Public       ,568,467,1035,59539,,21593,81132
00131300,UNIVERSITY OF CALIFORNIA-DAVIS          ,CA,95616-8558,Public       ,486,251,737,56401,,16039,72440
00131400,UNIVERSITY OF CALIFORNIA-IRVINE         ,CA,92697-2825,Public       ,579,343,922,61717,,15796,77513
00131500,UNIVERSITY OF CALIFORNIA (UCLA)         ,CA,90095-9000,Public       ,789,669,1458,77010,,30110,107120
00131502,UNIV OF CALIFORNIA LOS ANG SCH MED      ,CA,90095-0000,Public       ,11,14,25,397,,1253,1650
00131503,UNIV OF CALIFORNIA LOS ANG DENTAL       ,CA,90095-0000,Public       ,2,4,6,138,,249,387
00131600,UNIVERSITY OF CALIFORNIA-RIVERSIDE      ,CA,92521-0209,Public       ,437,283,720,42453,,11025,53478
00131700,UNIVERSITY OF CALIFORNIA-SAN DIEGO      ,CA,92093-0013,Public       ,509,283,792,55585,,12284,67869
00131900,UNIVERSITY OF CALIFORNIA-SFRANCISCO     ,CA,94143-0246,Public       ,42,98,140,2040,,5054,7094
00132000,UNIVERSITY OF CALIFORNIA-SANTA BARB     ,CA,93106-3180,Public       ,522,194,716,55329,,8174,63503
00132100,UNIVERSITY OF CALIFORNIA-SANTA CRUZ     ,CA,95064-0001,Public       ,338,144,482,38660,,5974,44634
00132200,UNIVERSITY OF REDLANDS                  ,CA,92373-0999,Private      ,58,252,310,6062,,4014,10076
00132500,UNIVERSITY OF SAN FRANCISCO             ,CA,94117-1080,Private      ,171,253,424,14357,,9076,23433
00132600,SANTA CLARA UNIVERSITY                  ,CA,95053-4956,Private      ,86,105,191,12492,,3906,16398
00132604,JESUIT SCHOOL OF THEOLOGY - BERKELEY    ,CA,94709-1193,Private      ,0,1,1,3,,59,62
00132800,UNIVERSITY OF SOUTHERN CALIFORNIA       ,CA,90089-0914,Private      ,473,724,1197,47116,,32201,79317
00132900,UNIVERSITY OF THE PACIFIC               ,CA,95211-0197,Private      ,109,94,203,12767,,3968,16735
00132901,UNIVERSITY OF THE PACIFIC - MCGEORGE SCH,CA,95817-2799,Private      ,1,21,22,219,,1601,1820
00132902,UNIV OF THE PACIFIC SCH OF DENT         ,CA,94115-0000,Private      ,4,8,12,91,,718,809
00133400,VENTURA COLLEGE                         ,CA,93003-3899,Public       ,187,292,479,7150,,6772,13922
00133500,VICTOR VALLEY COLLEGE                   ,CA,92395-5849,Public       ,339,819,1158,7932,,11969,19901
00133800,WEST VALLEY COLLEGE                     ,CA,95070-5697,Public       ,119,253,372,3613,,3493,7106
00134100,WESTMONT COLLEGE                        ,CA,93108-1099,Private      ,27,10,37,2743,,205,2948
00134200,WHITTIER COLLEGE                        ,CA,90601-4413,Private      ,46,23,69,4551,,784,5335
00134201,WHITTIER COLLEGE - COLLEGE OF LAW       ,CA,92626-1501,Private      ,4,3,7,46,,1332,1378
00134300,WOODBURY UNIVERSITY                     ,CA,91510-7846,Private      ,10,27,37,1368,,1024,2392
00134400,YUBA COLLEGE                            ,CA,95901-7699,Public       ,151,436,587,4005,,6072,10077
00177212,TRINITY INTERNATIONAL UNIV-CA           ,CA,92705-0000,Private      ,0,11,11,19,,394,413
00188100,ASHFORD UNIVERSITY                      ,CA,92123-1406,Proprietary  ,189,8636,8825,2688,,107810,110498
00274100,AMERICAN JEWISH UNIVERSITY              ,CA,90077-1599,Private      ,1,3,4,112,,152,264
00301002,ANTIOCH UNIV/LOS ANGELES                ,CA,90230-7615,Private      ,4,65,69,69,,1206,1275
00301003,ANTIOCH  UNIV/SANTA BARBARA             ,CA,93101-0000,Private      ,16,23,39,811,,657,1468
00369110,MIDDLEBURY COLLEGE - MONTEREY INSTITUTE ,CA,93940-2691,Private      ,3,18,21,62,,952,1014
00394700,UC-HASTINGS COLLEGE OF THE LAW          ,CA,94102-0000,Public       ,1,15,16,44,,3012,3056
00394800,SAN FRANCISCO ART INSTITUTE             ,CA,94133-2299,Private      ,46,52,98,2139,,1540,3679
00408000,STARR KING SCHOOL FOR THE MINISTRY      ,CA,94709-1299,Private      ,0,2,2,1,,95,96
00448000,DE ANZA COLLEGE                         ,CA,95014-5793,Public       ,389,636,1025,10746,,8697,19443
00448100,OHLONE COLLEGE                          ,CA,94539-5847,Public       ,141,250,391,4233,,3987,8220
00448400,JOHN F. KENNEDY UNIVERSITY              ,CA,94523-4817,Private      ,5,97,102,61,,1704,1765
00449000,PATTEN UNIVERSITY                       ,CA,94601-2699,Private      ,0,0,0,47,,89,136
00449400,EVEREST COLLEGE                         ,CA,92408-3752,Proprietary  ,62,178,240,635,,1374,2009
00450200,CITY COLLEGE OF SAN FRANCISCO           ,CA,94112-0000,Public       ,294,980,1274,10785,,16601,27386
00450302,EVEREST COLLEGE - SANTA ANA             ,CA,92701-4559,Proprietary  ,30,78,108,495,,683,1178
00563800,DOWNEY ADULT SCHOOL                     ,CA,90241-5610,Public       ,31,85,116,346,,935,1281
00565500,HACIENDA LA PUENTE ADULT EDUC CTR       ,CA,91746-0000,Public       ,10,36,46,292,,826,1118
00616500,LA CNTY CLG OF NURSING & ALLD HLTH      ,CA,90033-1018,Public       ,8,32,40,238,,739,977
00672000,COLLEGE OF ALAMEDA                      ,CA,94501-2109,Public       ,137,325,462,3162,,4582,7744
00673100,CASA LOMA COLLEGE                       ,CA,91405-4523,Private      ,29,70,99,304,,746,1050
00697300,CANADA COLLEGE                          ,CA,94061-1099,Public       ,95,166,261,1647,,2501,4148
00697500,LINCOLN UNIVERSITY                      ,CA,94612-2801,Private      ,1,7,8,41,,204,245
00701200,SAMUEL MERRITT COLLEGE                  ,CA,94609-3108,Private      ,10,112,122,494,,2912,3406
00704700,LOS ANGELES SOUTHWEST COLLEGE           ,CA,90047-4810,Public       ,229,693,922,4133,,9360,13493
00705000,BELLUS ACADEMY                          ,CA,91950-3616,Proprietary  ,15,34,49,105,,244,349
00711500,MOORPARK COLLEGE                        ,CA,93021-1695,Public       ,195,221,416,7066,,5334,12400
00713000,NEWBERRY SCHOOLS OF BEAUTY              ,CA,91344-7404,Proprietary  ,6,11,17,91,,112,203
00714200,LYLE'S COLLEGE OF BEAUTY                ,CA,93710-3948,Proprietary  ,7,28,35,129,,227,356
00716400,BRYAN COLLEGE                           ,CA,90057-0000,Proprietary  ,31,286,317,285,,2035,2320
00718700,NORTH ADRIAN'S COLLEGE OF BEAUTY        ,CA,95350-2381,Proprietary  ,15,38,53,154,,311,465
00719000,WYOTECH                                 ,CA,94539-7663,Proprietary  ,67,167,234,716,,1472,2188
00720300,SALON SUCCESS ACADEMY                   ,CA,91786-4060,Proprietary  ,13,18,31,150,,175,325
00720400,MODERN BEAUTY ACADEMY                   ,CA,93030-7016,Proprietary  ,5,7,12,73,,88,161
00720900,REDONDO BEACH BEAUTY COLLEGE            ,CA,90278-3111,Proprietary  ,3,11,14,3,,11,14
00722900,WESTERN BEAUTY INSTITUTE                ,CA,91402-3104,Proprietary  ,0,0,0,196,,324,520
00723400,HEALD COLLEGE                           ,CA,94105-2206,Proprietary  ,49,180,229,727,,1992,2719
00723404,HEALD COLLEGE - CONCORD                 ,CA,94520-0000,Proprietary  ,70,232,302,925,,2254,3179
00723405,HEALD COLLEGE - MILPITAS                ,CA,95035-8008,Proprietary  ,76,241,317,911,,2428,3339
00723406,HEALD COLLEGE - HAYWARD                 ,CA,94545-2352,Proprietary  ,50,203,253,819,,2104,2923
00723407,HEALD COLLEGE - MODESTO                 ,CA,95368-9095,Proprietary  ,45,119,164,819,,1538,2357
00723408,HEALD COLLEGE - ROSEVILLE               ,CA,95678-5303,Proprietary  ,46,190,236,772,,2144,2916
00723409,HEALD COLLEGE - SALINAS                 ,CA,93906-5100,Proprietary  ,25,128,153,806,,1653,2459
00723410,HEALD COLLEGE - STOCKTON                ,CA,95210-5667,Proprietary  ,48,190,238,1108,,2524,3632
00723411,HEALD COLLEGE - RANCHO CORDOVA          ,CA,95670-6005,Proprietary  ,49,168,217,634,,1847,2481
00723412,HEALD COLLEGE - FRESNO                  ,CA,93704-1706,Proprietary  ,57,228,285,1433,,3025,4458
00725300,FEDERICO BEAUTY INSTITUTE               ,CA,95834-1905,Proprietary  ,29,65,94,329,,566,895
00729600,COLEMAN COLLEGE                         ,CA,92123-0000,Private      ,38,112,150,319,,1070,1389
00732909,ITT TECHNICAL INSTITUTE                 ,CA,92868-3506,Proprietary  ,96,366,462,748,,2884,3632
00732971,ITT TECHNICAL INSTITUTE                 ,CA,95670-6047,Proprietary  ,58,287,345,623,,2386,3009
00732976,ITT TECHNICAL INSTITUTE                 ,CA,92408-3519,Proprietary  ,128,415,543,1240,,3194,4434
00732981,ITT TECHNICAL INSTITUTE                 ,CA,92123-2662,Proprietary  ,68,433,501,859,,3519,4378
00732985,ITT TECHNICAL INSTITUTE                 ,CA,91773-2933,Proprietary  ,78,221,299,617,,2023,2640
00732989,ITT TECHNICAL INSTITUTE                 ,CA,90502-1356,Proprietary  ,76,314,390,579,,2250,2829
00732994,ITT TECHNICAL INSTITUTE                 ,CA,91342-3664,Proprietary  ,68,281,349,555,,1920,2475
00747600,MARINELLO SCHOOLS OF BEAUTY             ,CA,90023-2666,Proprietary  ,37,90,127,499,,731,1230
00747602,MARINELLO SCHOOLS OF BEAUTY - SPA ACADEM,CA,90048-5101,Proprietary  ,12,35,47,168,,316,484
00747603,MARINELLO SCHOOLS OF BEAUTY - INGLEWOOD ,CA,90301-2306,Proprietary  ,12,22,34,102,,180,282
00747604,MARINELLO SCHOOLS OF BEAUTY - RESEDA    ,CA,91335-4218,Proprietary  ,0,6,6,24,,49,73
00747606,MARINELLO SCHOOLS OF BEAUTY - WEST COVIN,CA,91790-2805,Proprietary  ,10,19,29,98,,108,206
00747607,MARINELLO SCHOOLS OF BEAUTY - SAN BERNAR,CA,92410-3261,Proprietary  ,7,16,23,173,,243,416
00747608,MARINELLO SCHOOLS OF BEAUTY - ONTARIO   ,CA,91762-2113,Proprietary  ,34,49,83,275,,375,650
00747609,MARINELLO SCHOOLS OF BEAUTY - WHITTIER  ,CA,90601-4107,Proprietary  ,10,21,31,140,,154,294
00747610,MARINELLO SCHOOLS OF BEAUTY - LOMITA    ,CA,90717-1460,Proprietary  ,10,15,25,85,,146,231
00747611,MARINELLO SCHOOLS OF BEAUTY - SAN DIEGO ,CA,92126-4217,Proprietary  ,13,55,68,241,,439,680
00747612,MARINELLO SCHOOLS OF BEAUTY - EL CAJON  ,CA,92020-2503,Proprietary  ,7,53,60,119,,294,413
00747613,MARINELLO SCHOOLS OF BEAUTY - VICTORVILL,CA,92392-5496,Proprietary  ,18,41,59,199,,382,581
00747614,MARINELLO SCHOOLS OF BEAUTY - ANAHEIM   ,CA,92801-4622,Proprietary  ,15,51,66,210,,267,477
00747615,MARINELLO SCHOOLS OF BEAUTY - SIMI VALLE,CA,93065-2801,Proprietary  ,14,23,37,106,,168,274
00753100,ACADEMY OF ART UNIVERSITY               ,CA,94105-3410,Proprietary  ,237,571,808,8677,,13427,22104
00753600,COSUMNES RIVER COLLEGE                  ,CA,95823-5799,Public       ,307,590,897,10281,,12407,22688
00754802,WESTWOOD COLLEGE OF TECHNOLOGY          ,CA,92801-0000,Proprietary  ,34,61,95,835,,745,1580
00754803,WESTWOOD COLLEGE OF TECHNOLOGY          ,CA,91786-0000,Proprietary  ,40,86,126,921,,1008,1929
00760600,EVEREST COLLEGE                         ,CA,90010-2221,Proprietary  ,21,55,76,436,,741,1177
00760700,CONCORDE CAREER INSTITUTE               ,CA,91606-3134,Proprietary  ,38,93,131,415,,813,1228
00770700,COLUMBIA COLLEGE                        ,CA,95370-8580,Public       ,48,112,160,1442,,1750,3192
00771300,SKYLINE COLLEGE                         ,CA,94066-1698,Public       ,163,284,447,4206,,4463,8669
00793000,CONCORDE CAREER INSTITUTE               ,CA,92108-0000,Proprietary  ,51,171,222,494,,1597,2091
00799300,CALIF STATE UNIV BAKERSFIELD            ,CA,93311-1022,Public       ,150,285,435,11228,,7690,18918
00807100,CONCORDE CAREER INSTITUTE               ,CA,92840-9201,Proprietary  ,29,98,127,428,,1035,1463
00807300,BUTTE COMMUNITY COLLEGE                 ,CA,95965-0000,Public       ,206,414,620,8176,,9762,17938
00809000,EVEREST COLLEGE                         ,CA,91803-1310,Proprietary  ,21,92,113,354,,753,1107
00853700,CONCORDE CAREER INSTITUTE               ,CA,92401-0000,Proprietary  ,40,117,157,484,,1313,1797
00859600,WEST LOS ANGELES COLLEGE                ,CA,90230-3500,Public       ,278,692,970,5335,,8893,14228
00859700,FEATHER RIVER COLLEGE                   ,CA,95971-9124,Public       ,24,41,65,821,,625,1446
00884400,CALIFORNIA CHRISTIAN COLLEGE            ,CA,93703-3599,Private      ,3,14,17,117,,177,294
00884600,WRIGHT INSTITUTE                        ,CA,94704-0000,Private      ,0,7,7,6,,519,525
00890300,COLLEGE OF THE CANYONS                  ,CA,91355-1899,Public       ,414,601,1015,9343,,7448,16791
00891800,SADDLEBACK COLLEGE                      ,CA,92692-3699,Public       ,186,456,642,6889,,8034,14923
00902200,ASSOCIATED TECHNICAL COLLEGE            ,CA,90017-0000,Proprietary  ,10,70,80,193,,616,809
00903200,EMPIRE COLLEGE                          ,CA,95403-2122,Proprietary  ,26,82,108,237,,697,934
00915706,WYOMING TECHNICAL INSTITUTE - WEST SACRA,CA,95605-1507,Proprietary  ,2,4,6,323,,399,722
00927200,CRAFTON HILLS COLLEGE                   ,CA,92399-1799,Public       ,128,190,318,4639,,4704,9343
00950900,SKILLS & BUSINESS EDUCATION CENTER      ,CA,95824-1529,Public       ,24,98,122,376,,1151,1527
00974800,CARRINGTON COLLEGE CALIFORNIA           ,CA,95826-3203,Proprietary  ,91,262,353,1247,,2870,4117
00974801,CARRINGTON COLLEGE CALIFORNIA - SAN LEAN,CA,94578-3711,Proprietary  ,31,107,138,350,,705,1055
00974802,CARRINGTON COLLEGE CALIFORNIA - PLEASANT,CA,94523-1984,Proprietary  ,43,103,146,335,,759,1094
00974803,CARRINGTON COLLEGE CALIFORNIA - STOCKTON,CA,95207-5509,Proprietary  ,41,83,124,556,,847,1403
00974804,CARRINGTON COLLEGE CALIFORNIA - CITRUS H,CA,95621-5577,Proprietary  ,35,90,125,332,,757,1089
00974806,CARRINGTON COLLEGE CALIFORNIA -  ANTIOCH,CA,94531-1604,Proprietary  ,0,0,0,173,,400,573
00974807,CARRINGTON COLLEGE CALIFORNIA - SAN JOSE,CA,95119-1325,Proprietary  ,52,116,168,613,,1238,1851
00974808,CARRINGTON COLLEGE CALIFORNIA - EMERYVIL,CA,94608-3006,Proprietary  ,0,0,0,84,,117,201
00974809,WESTERN CAREER COLLEGE -  EMERYVILLE SHE,CA,94608-3006,Proprietary  ,0,0,0,8,,17,25
00998900,SANTA BARBARA BUSINESS COLLEGE          ,CA,93111-0000,Proprietary  ,17,79,96,368,,740,1108
01011100,CERRO-COSO COMMUNITY COLLEGE            ,CA,93555-9571,Public       ,51,163,214,1024,,2655,3679
01014900,PEPPERDINE UNIVERSITY                   ,CA,90263-0000,Private      ,84,227,311,9659,,6668,16327
01034000,LOS MEDANOS COLLEGE                     ,CA,94565-5197,Public       ,192,377,569,4068,,5284,9352
01036500,CHARLES R DREW UNIV OF MED & SCI        ,CA,90059-0000,Private      ,3,30,33,169,,1062,1231
01039500,UNIVERSITY OF SAN DIEGO                 ,CA,92110-2492,Private      ,198,225,423,19389,,7206,26595
01039501,UNIVERSITY OF SAN DIEGO - SCHOOL OF LAW ,CA,92110-2492,Private      ,4,33,37,238,,2495,2733
01044100,PARDEE RAND GRADUATE SCHOOL             ,CA,90407-2138,Private      ,0,2,2,4,,35,39
01047400,MARYMOUNT COLLEGE OF PALOS VERDES       ,CA,90275-0000,Private      ,26,8,34,1353,,237,1590
01085400,THOMAS JEFFERSON SCHOOL OF LAW          ,CA,92110-0000,Private      ,2,45,47,51,,1993,2044
01102400,EVEREST COLLEGE                         ,CA,94103-2091,Proprietary  ,8,43,51,168,,462,630
01110700,EVEREST  COLLEGE                        ,CA,92801-5231,Proprietary  ,42,106,148,580,,896,1476
01110900,EVEREST COLLEGE                         ,CA,91335-4631,Proprietary  ,45,146,191,443,,839,1282
01111200,FIDM-FASHION INSTITUTE OF DESIGN        ,CA,90015-1421,Proprietary  ,152,118,270,6427,,2560,8987
01111700,ALLIANT INTERNATIONAL UNIVERSITY        ,CA,92131-1799,Private      ,10,58,68,213,,2319,2532
01111705,ALLIANT INTERNATIONAL UNIVERSITY - LOS A,CA,91803-1360,Private      ,0,13,13,23,,719,742
01111706,ALLIANT INTERNATIONAL UNIVERSITY - SAN F,CA,94133-1221,Private      ,5,23,28,38,,943,981
01111707,ALLIANT INTERNATIONAL UNIVERSITY - FRESN,CA,93727-2014,Private      ,2,23,25,83,,603,686
01112100,EVEREST COLLEGE                         ,CA,94541-4007,Proprietary  ,7,24,31,128,,387,515
01112300,EVEREST COLLEGE                         ,CA,90247-4163,Proprietary  ,17,129,146,263,,759,1022
01146000,NATIONAL UNIVERSITY                     ,CA,92037-1011,Private      ,95,2397,2492,1235,,22393,23628
01162600,PRACTICAL SCHOOLS                       ,CA,92805-0000,Proprietary  ,15,41,56,321,,685,1006
01164900,LOYOLA MARYMOUNT UNIVERSITY             ,CA,90045-0000,Private      ,118,121,239,13466,,4193,17659
01164901,LMU  - LOYOLA LAW SCHOOL                ,CA,90015-0019,Private      ,5,22,27,209,,3097,3306
01167200,MENDOCINO COLLEGE                       ,CA,95482-3000,Public       ,64,189,253,1505,,2357,3862
01170700,NORTH-WEST COLLEGE                      ,CA,91790-2097,Proprietary  ,35,92,127,322,,634,956
01179200,FRANCISCAN SCHOOL OF THEOLOGY           ,CA,94709-0000,Private      ,0,2,2,8,,46,54
01182000,SAN DIEGO MIRAMAR COLLEGE               ,CA,92126-0000,Public       ,154,539,693,6067,,9515,15582
01186500,CALIFORNIA HAIR DESIGN ACADEMY          ,CA,92115-0000,Proprietary  ,11,28,39,220,,332,552
01186600,LU ROSS ACADEMY                         ,CA,93001-2927,Proprietary  ,22,46,68,212,,381,593
01202600,BELLUS ACADEMY                          ,CA,92021-6247,Proprietary  ,10,27,37,105,,220,325
01202700,GALEN COLLEGE OF CALIFORNIA             ,CA,93728-2381,Proprietary  ,0,0,0,55,,115,170
01203100,SAN DIEGO CHRISTIAN COLLEGE             ,CA,92019-1157,Private      ,13,51,64,1002,,795,1797
01206100,EVEREST COLLEGE                         ,CA,95128-3908,Proprietary  ,20,41,61,283,,569,852
01215400,CALIFORNIA INSTITUTE OF INTEGRAL STUDIES,CA,94103-2557,Private      ,3,19,22,57,,1636,1693
01230002,PALMER COLLEGE OF CHIROPRACTIC - WEST CA,CA,95134-1617,Private      ,0,0,0,22,,209,231
01231600,MANCHESTER BEAUTY COLLEGE               ,CA,93726-5306,Proprietary  ,7,17,24,147,,190,337
01231700,TULARE BEAUTY COLLEGE                   ,CA,93274-3432,Proprietary  ,2,12,14,36,,60,96
01244600,UNIVERSAL COLLEGE OF BEAUTY             ,CA,90044-0044,Proprietary  ,2,12,14,98,,166,264
01245200,EVERGREEN VALLEY COLLEGE                ,CA,95135-1598,Public       ,197,373,570,5543,,6458,12001
01255000,LOS ANGELES MISSION COLLEGE             ,CA,91342-3200,Public       ,257,480,737,6948,,6717,13665
01265000,MARINELLO SCHOOL OF BEAUTY              ,CA,91502-2828,Proprietary  ,33,69,102,192,,379,571
01265001,MARINELLO SCHOOL OF BEAUTY - PALMDALE   ,CA,93550-4686,Proprietary  ,3,10,13,112,,174,286
01284200,OXNARD COLLEGE                          ,CA,93030-0000,Public       ,100,202,302,3899,,4654,8553
01287200,NORTH-WEST COLLEGE                      ,CA,91768-3199,Proprietary  ,34,108,142,360,,828,1188
01287300,WYOTECH                                 ,CA,90810-3800,Proprietary  ,87,288,375,1081,,2172,3253
01287301,WYOTECH - EVEREST  COLLEGE              ,CA,90034-3158,Proprietary  ,26,70,96,301,,653,954
01287302,WYOTECH - EVEREST  COLLEGE              ,CA,91746-3412,Proprietary  ,65,152,217,530,,1066,1596
01290700,LAKE TAHOE COMMUNITY COLLEGE            ,CA,96150-4524,Public       ,49,96,145,829,,1298,2127
01291200,MTI COLLEGE                             ,CA,95841-0000,Proprietary  ,34,183,217,649,,1843,2492
01294200,ROSEMEAD BEAUTY SCHOOL                  ,CA,91770-1639,Proprietary  ,2,53,55,50,,318,368
01298400,PROFESSIONAL INSTITUTE OF BEAUTY        ,CA,91731-2613,Proprietary  ,4,25,29,38,,129,167
01298500,HAIR CALIFORNIA BEAUTY ACADEMY          ,CA,92867-7127,Proprietary  ,6,8,14,39,,63,102
01298900,OCEANSIDE COLLEGE OF BEAUTY             ,CA,92054-5393,Proprietary  ,11,23,34,142,,234,376
01301000,LANCASTER BEAUTY SCHOOL                 ,CA,93534-3098,Proprietary  ,16,41,57,147,,311,458
01307400,AMERICAN BEAUTY COLLEGE                 ,CA,91790-2906,Proprietary  ,5,14,19,87,,132,219
01309500,SALON SUCCESS ACADEMY                   ,CA,92879-6561,Proprietary  ,21,39,60,244,,298,542
01310300,CALIFORNIA WESTERN SCHOOL OF LAW        ,CA,92101-0000,Private      ,3,26,29,136,,1803,1939
01324000,LYTLE'S REDWOOD EMPIRE BEAUTY CLG       ,CA,95403-0000,Proprietary  ,12,24,36,206,,282,488
02054900,MARINELLO SCHOOL OF BEAUTY              ,CA,92630-0000,Proprietary  ,20,43,63,169,,342,511
02054902,MARINELLO SCHOOL OF BEAUTY - BAKERSFIELD,CA,93309-5001,Proprietary  ,18,45,63,364,,475,839
02054903,MARINELLO SCHOOL OF BEAUTY - VISALIA    ,CA,93277-6228,Proprietary  ,6,6,12,109,,150,259
02059800,PARIS BEAUTY COLLEGE                    ,CA,94520-2611,Proprietary  ,10,26,36,61,,185,246
02061600,WAYNES COLLEGE OF BEAUTY                ,CA,93906-2830,Proprietary  ,6,9,15,64,,85,149
02063500,COASTLINE COMMUNITY COLLEGE             ,CA,92708-0000,Public       ,76,632,708,2649,,8579,11228
02064300,SIERRA COLLEGE OF BEAUTY                ,CA,95340-0000,Proprietary  ,10,19,29,122,,203,325
02065700,CALIFORNIA BEAUTY COLLEGE               ,CA,95354-0000,Proprietary  ,12,12,24,188,,250,438
02070500,CONCORDIA UNIVERSITY                    ,CA,92612-0000,Private      ,32,320,352,3439,,3332,6771
02075800,SOUTHERN CA INST OF ARCHITECTURE        ,CA,90013-0000,Private      ,6,6,12,292,,567,859
02086400,MARINELLO SCHOOL OF BEAUTY              ,CA,95050-0000,Proprietary  ,15,29,44,135,,241,376
02086401,MARINELLO SCHOOL OF BEAUTY - SEASIDE    ,CA,93955-3615,Proprietary  ,11,26,37,115,,185,300
02086402,MARINELLO SCHOOL OF BEAUTY - SAN MATEO  ,CA,94401-3801,Proprietary  ,6,10,16,68,,119,187
02086403,MARINELLO SCHOOL OF BEAUTY - HAYWARD    ,CA,94541-5111,Proprietary  ,4,25,29,121,,222,343
02086404,MARINELLO SCHOOL OF BEAUTY - CASTRO VALL,CA,94546-5506,Proprietary  ,6,20,26,34,,74,108
02091200,ELEGANCE INTERNATIONAL                  ,CA,90028-0000,Proprietary  ,16,29,45,166,,237,403
02091700,KAPLAN COLLEGE                          ,CA,92123-1509,Proprietary  ,59,246,305,810,,2946,3756
02091702,KAPLAN COLLEGE - CHULA VISTA            ,CA,91910-5342,Proprietary  ,23,57,80,291,,592,883
02096100,FIELDING GRADUATE UNIVERSITY            ,CA,93105-0000,Private      ,0,76,76,3,,1104,1107
02099200,AMERICAN CONSERVATORY THEATER           ,CA,94108-0000,Private      ,5,7,12,109,,275,384
02110200,COLUMBIA COLLEGE                        ,CA,91356-0000,Private      ,9,4,13,400,,194,594
02110800,CALIFORNIA COLLEGE SAN DIEGO            ,CA,92108-3821,Proprietary  ,78,246,324,2446,,3686,6132
02111300,CUYAMACA COLLEGE                        ,CA,92019-0000,Public       ,171,340,511,5216,,7929,13145
02119100,MISSION COLLEGE                         ,CA,95054-1897,Public       ,132,289,421,3834,,5653,9487
02120600,SAYBROOK GRADUATE SCHOOL                ,CA,94111-1920,Private      ,0,19,19,5,,763,768
02120700,SAN JOAQUIN VALLEY COLLEGE              ,CA,93291-0000,Proprietary  ,339,706,1045,2950,,6256,9206
02125000,CAREER ACADEMY OF BEAUTY                ,CA,92845-0000,Proprietary  ,8,28,36,108,,240,348
02128200,"VICTOR VALLEY BEAUTY COLLEGE, INC       ",CA,92392-0000,Proprietary  ,14,20,34,184,,281,465
02128300,INSTITUTE FOR BUSINESS & TECHNOLOGY     ,CA,95050-0000,Proprietary  ,21,97,118,148,,630,778
02128301,INSTITUTE FOR BUSINESS & TECHNOLOGY - NA,CA,95670-6351,Proprietary  ,12,62,74,51,,224,275
02138300,PALO ALTO UNIVERSITY                    ,CA,94304-1337,Private      ,2,13,15,86,,1080,1166
02161800,MUSICIANS INSTITUTE                     ,CA,90028-6157,Proprietary  ,46,88,134,1371,,1110,2481
02167800,ESTES INSTITUTE OF COSMETOLOGY          ,CA,93291-0000,Proprietary  ,2,7,9,118,,137,255
02178700,CITRUS HEIGHTS BEAUTY COLLEGE           ,CA,95610-1410,Proprietary  ,10,12,22,137,,168,305
02179916,ARGOSY UNIVERSITY - ORANGE COUNTY       ,CA,92868-4844,Proprietary  ,0,0,0,0,,1,1
02179937,WESTERN STATE COLLEGE OF LAW            ,CA,92831-3014,Proprietary  ,3,11,14,37,,991,1028
02179938,"ART INSTITUTE OF CALIFORNIA, HOLLYWOOD  ",CA,91601-3112,Proprietary  ,109,122,231,3114,,2064,5178
02179941,"ART INSTITUTE OF CALIFORNIA, LOS ANGELES",CA,90405-3035,Proprietary  ,124,121,245,4790,,3134,7924
02179947,"ART INSTITUTE OF CALIFORNIA, SAN DIEGO  ",CA,92108-4423,Proprietary  ,90,193,283,3286,,3227,6513
02185800,MOLER BARBER COLLEGE                    ,CA,94611-0000,Proprietary  ,4,22,26,66,,233,299
02188400,SIERRA VALLEY COLLEGE OF COURT REPORTING,CA,93726-0000,Proprietary  ,3,16,19,84,,203,287
02208600,MADERA BEAUTY COLLEGE                   ,CA,93637-3519,Proprietary  ,5,3,8,81,,84,165
02211000,SALON SUCCESS ACADEMY                   ,CA,92405-0000,Proprietary  ,5,14,19,115,,157,272
02220000,COLLEEN O'HARA BEAUTY ACADEMY           ,CA,92701-0000,Proprietary  ,7,14,21,87,,147,234
02220200,CALIFORNIA CULINARY ACADEMY             ,CA,94102-3336,Proprietary  ,37,62,99,571,,818,1389
02221300,MARINELLO SCHOOL OF BEAUTY              ,CA,92553-0000,Proprietary  ,20,45,65,197,,329,526
02221303,MARINELLO SCHOOL OF BEAUTY - SAN RAFAEL ,CA,94901-3224,Proprietary  ,3,9,12,40,,112,152
02222000,AMERICAN FILM INSTITUTE                 ,CA,90027-0000,Private      ,24,46,70,600,,1145,1745
02226000,EAST LOS ANGELES COLLEGE                ,CA,91754-0000,Public       ,632,982,1614,18499,,16370,34869
02228500,LIFE CHIROPRACTIC COLLEGE WEST          ,CA,94545-0000,Private      ,1,21,22,25,,581,606
02230900,FREDRICK & CHARLES BEAUTY COLLEGE       ,CA,95501-0000,Proprietary  ,6,12,18,91,,163,254
02231900,GEMOLOGICAL INSTITUTE OF AMERICA        ,CA,92008-4698,Private      ,8,39,47,90,,388,478
02234300,FASHION CAREERS OF CALIFORNIA           ,CA,92110-0000,Proprietary  ,0,0,0,32,,27,59
02236400,"THANH LE COLG, SCH OF COSMETOLOGY       ",CA,92840-0000,Proprietary  ,2,16,18,15,,50,65
02237200,PHILLIPS GRADUATE INSTITUTE             ,CA,91316-0000,Private      ,1,15,16,8,,258,266
02241800,AMERICAN CAREER COLLEGE                 ,CA,90004-0000,Proprietary  ,225,512,737,2084,,4304,6388
02242700,BERKELEY CITY COLLEGE                   ,CA,94704-0000,Public       ,169,341,510,4529,,5965,10494
02250602,EVEREST COLLEGE                         ,CA,91761-8525,Proprietary  ,23,84,107,669,,1424,2093
02255400,INTERNATIONAL SCHOOL OF COSMETOLOGY     ,CA,90250-0000,Proprietary  ,17,32,49,217,,291,508
02258600,ALAMEDA BEAUTY COLLEGE                  ,CA,94501-0000,Proprietary  ,13,41,54,216,,358,574
02262400,YESHIVA OHR ELCHONON CHABAD             ,CA,90046-0000,Private      ,9,0,9,125,,5,130
02263101,ANTHEM COLLEGE - SACRAMENTO             ,CA,95827-3378,Proprietary  ,18,84,102,175,,523,698
02267600,INSTITUTE OF TRANSPERSONAL PSYCHLGY     ,CA,94303-4624,Private      ,0,10,10,25,,620,645
02270600,LIFE PACIFIC COLLEGE                    ,CA,91773-0000,Private      ,10,21,31,475,,279,754
02276800,WESTMINSTER SEMINARY CALIFORNIA         ,CA,92027-0000,Private      ,1,3,4,10,,166,176
02277400,SOUTH COAST COLLEGE                     ,CA,92868-2616,Proprietary  ,10,35,45,275,,563,838
02282300,ALHAMBRA BEAUTY COLLEGE                 ,CA,91802-0000,Proprietary  ,0,23,23,48,,155,203
02285100,HILLTOP BEAUTY SCHOOL                   ,CA,94014-0000,Proprietary  ,4,20,24,31,,139,170
02298000,DESIGN INSTITUTE OF SAN DIEGO           ,CA,92121-0000,Proprietary  ,7,13,20,268,,349,617
02304300,"PLATT COLLEGE, SAN DIEGO                ",CA,92115-0000,Proprietary  ,22,30,52,295,,497,792
02306300,KAPLAN COLLEGE                          ,CA,95368-0000,Proprietary  ,29,82,111,350,,784,1134
02306302,KAPLAN COLLEGE - FRESNO                 ,CA,93612-3802,Proprietary  ,14,58,72,241,,462,703
02309500,CLOVIS ADULT EDUC                       ,CA,93611-0000,Public       ,6,20,26,109,,431,540
02312400,LA COLLEGE INTERNATIONAL                ,CA,90010-0000,Proprietary  ,0,0,0,1,,3,4
02321801,ITT TECHNICAL INSTITUTE                 ,CA,93030-2649,Proprietary  ,0,1,1,0,,1,1
02330500,LAGUNA COLLEGE OF ART AND DESIGN        ,CA,92651-0000,Private      ,6,8,14,756,,314,1070
02332800,CENTER FOR EMPLOYMENT TRAINING          ,CA,95110-0000,Private      ,134,503,637,690,,2644,3334
02338500,GLENDALE CAREER COLLEGE                 ,CA,91203-1207,Proprietary  ,34,91,125,324,,754,1078
02338700,MARINELLO SCHOOL OF BEAUTY              ,CA,94103-0000,Proprietary  ,8,30,38,153,,252,405
02338701,MARINELLO SCHOOL OF BEAUTY - CHICO      ,CA,95928-7184,Proprietary  ,7,33,40,134,,240,374
02338702,MARINELLO SCHOOL OF BEAUTY - REDDING    ,CA,96001-1023,Proprietary  ,7,34,41,111,,259,370
02338703,MARINELLO SCHOOL OF BEAUTY - FRESNO     ,CA,93711-3246,Proprietary  ,18,50,68,257,,363,620
02342400,ACADEMY OF RADIO BROADCASTING           ,CA,92647-3809,Proprietary  ,3,21,24,113,,293,406
02343400,BELLUS ACADEMY                          ,CA,92064-4633,Proprietary  ,30,99,129,397,,678,1075
02345800,MONTEBELLO BEAUTY COLLEGE               ,CA,90640-0000,Proprietary  ,0,0,0,15,,18,33
02351900,KAPLAN COLLEGE                          ,CA,95660-5512,Proprietary  ,35,172,207,566,,1926,2492
02351901,KAPLAN COLLEGE - BAKERSFIELD            ,CA,93304-0000,Proprietary  ,42,115,157,613,,1090,1703
02358000,THOMAS AQUINAS COLLEGE                  ,CA,93060-9622,Private      ,3,1,4,401,,40,441
02359300,SHASTA BIBLE COLLEGE                    ,CA,96002-0000,Private      ,4,5,9,59,,108,167
02482700,WESTERN UNIVERSITY OF HEALTH S          ,CA,91766-1854,Private      ,2,40,42,199,,5867,6066
02494800,LOLA BEAUTY COLLEGE                     ,CA,92641-0000,Proprietary  ,3,10,13,37,,59,96
02497300,TRINITY COLLEGE                         ,CA,93277-8109,Proprietary  ,33,111,144,278,,835,1113
02500000,SAN JOAQUIN COLLEGE OF LAW              ,CA,93612-0000,Private      ,1,2,3,27,,343,370
02518400,THE NATIONAL HISPANIC UNIVERSITY        ,CA,95127-0000,Proprietary  ,10,37,47,515,,1109,1624
02519800,AVANCE BEAUTY COLLEGE                   ,CA,92154-0000,Proprietary  ,5,24,29,169,,242,411
02520200,CALIFORNIA CAREER SCHOOLS               ,CA,92805-0000,Proprietary  ,5,27,32,105,,258,363
02520300,INTERIOR DESIGNERS INSTITUTE            ,CA,92660-0000,Proprietary  ,2,26,28,52,,219,271
02520400,ADRIAN'S BEAUTY COLLEGE OF TURLOCK      ,CA,95382-0000,Proprietary  ,12,19,31,154,,173,327
02531801,PAUL MITCHELL THE SCHOOL-COSTA MESA     ,CA,92626-3804,Proprietary  ,24,37,61,155,,252,407
02531804,PAUL MITCHELL THE SCHOOL - SAN DIEGO    ,CA,92101-0000,Proprietary  ,24,53,77,191,,403,594
02537200,PALOMAR INSTITUTE OF COSMETOLOGY        ,CA,92069-0000,Proprietary  ,12,38,50,235,,367,602
02539100,KAPLAN COLLEGE                          ,CA,91606-3231,Proprietary  ,44,111,155,461,,1061,1522
02539102,KAPLAN COLLEGE -  RIVERSIDE             ,CA,92507-4223,Proprietary  ,19,82,101,504,,1080,1584
02539500,IRVINE VALLEY COLLEGE                   ,CA,92620-0000,Public       ,179,295,474,7367,,5636,13003
02542300,NATIONAL HOLISTIC INSTITUTE             ,CA,94608-0000,Proprietary  ,33,141,174,269,,1124,1393
02543400,BROWNSON TECHNICAL SCHOOL               ,CA,92805-0000,Proprietary  ,12,41,53,56,,267,323
02545900,HYPNOSIS MOTIVATION INSTITUTE           ,CA,91356-0000,Private      ,1,26,27,9,,141,150
02546400,MTI BUSINESS COLLEGE INC                ,CA,95207-0000,Proprietary  ,5,42,47,94,,325,419
02549000,KAPLAN COLLEGE                          ,CA,92083-7736,Proprietary  ,54,151,205,454,,1295,1749
02549005,KAPLAN COLLEGE -  PALM SPRINGS          ,CA,92262-7011,Proprietary  ,20,71,91,366,,601,967
02553500,ASSOCIATED TECHNICAL COLLEGE            ,CA,92101-0000,Proprietary  ,13,49,62,183,,458,641
02553600,DIVERSIFIED LANGUAGE INSTITUTE          ,CA,90017-0000,Proprietary  ,15,162,177,96,,931,1027
02559300,UNITED EDUCATION INSTITUTE              ,CA,90020-0000,Proprietary  ,260,705,965,1097,,2743,3840
02559400,INTERCOAST COLLEGES                     ,CA,92868-1656,Proprietary  ,59,431,490,362,,2726,3088
02565400,KAPLAN COLLEGE                          ,CA,95207-6216,Proprietary  ,0,0,0,208,,397,605
02570300,LOS ANGELES ORT TECHNICAL INSTITUTE     ,CA,90048-4904,Private      ,19,166,185,176,,931,1107
02577900,SANTA BARBARA BUSINESS COLLEGE          ,CA,93309-1664,Proprietary  ,36,87,123,514,,1009,1523
02578000,SANTA BARBARA BUSINESS COLLEGE          ,CA,93454-6943,Proprietary  ,12,31,43,239,,497,736
02584200,NEWBRIDGE COLLEGE                       ,CA,92701-0000,Proprietary  ,0,0,0,174,,442,616
02591600,NORTH-WEST COLLEGE                      ,CA,91101-1744,Proprietary  ,16,26,42,131,,313,444
02595600,ASIAN AMERICAN INTERNATIONAL BTY CG     ,CA,92683-4043,Proprietary  ,1,15,16,15,,117,132
02597300,SOUTH BAYLO UNIVERSITY                  ,CA,92801-1701,Private      ,0,24,24,8,,363,371
02602300,CENTRAL COAST COLLEGE                   ,CA,93901-3301,Proprietary  ,38,52,90,306,,417,723
02608900,PINNACLE COLLEGE                        ,CA,91803-8842,Proprietary  ,3,10,13,79,,98,177
02608901,PINNACLE COLLEGE - SACRAMENTO           ,CA,95670-6386,Proprietary  ,15,16,31,91,,172,263
02609000,EMPERORS COLG OF TRAD ORIENTAL MED      ,CA,90403-5609,Proprietary  ,0,14,14,6,,237,243
03010611,VIRGINIA COLLEGE - GOLF ACADEMY OF AMERI,CA,92008-6512,Proprietary  ,1,5,6,42,,131,173
03011300,"CALIF STATE UNIV, SAN MARCOS            ",CA,92096-0001,Public       ,167,238,405,15197,,8298,23495
03019900,CAPSTONE COLLEGE                        ,CA,91402-0000,Proprietary  ,4,11,15,29,,93,122
03025600,DELL'ARTE SCH OF PHYSICAL THEATRE       ,CA,95525-0816,Private      ,0,2,2,9,,49,58
03027700,PACIFIC COLLEGE OF ORIENTAL MED         ,CA,92108-4408,Proprietary  ,3,56,59,94,,721,815
03029600,POMONA ADULT SCHOOL                     ,CA,91766-0000,Public       ,12,57,69,175,,458,633
03031409,INTERNATIONAL ACADEMY OF DESIGN AND TECH,CA,95834-9664,Proprietary  ,3,27,30,296,,557,853
03035700,LAS POSITAS COLLEGE                     ,CA,94551-6750,Public       ,101,218,319,3541,,3349,6890
03039900,FREMONT COLLEGE                         ,CA,90703-5342,Proprietary  ,20,40,60,423,,608,1031
03043900,NEWSCHOOL OF ARCHITECTURE & DESIGN      ,CA,92101-6634,Proprietary  ,12,16,28,366,,614,980
03054100,ROYALE COLLEGE OF BEAUTY                ,CA,92590-2525,Proprietary  ,9,17,26,85,,118,203
03062300,WESTECH COLLEGE                         ,CA,91764-4988,Proprietary  ,43,100,143,316,,881,1197
03062400,MT DIABLO ADULT EDUC LOMA VISTA CTR     ,CA,94518-1122,Public       ,5,35,40,145,,341,486
03062700,PLATT COLLEGE                           ,CA,90041-0000,Proprietary  ,49,96,145,566,,909,1475
03062701,PLATT COLLEGE                           ,CA,91764-0000,Proprietary  ,27,54,81,507,,756,1263
03062702,PLATT COLLEGE - RIVERSIDE               ,CA,92507-0730,Proprietary  ,31,56,87,621,,769,1390
03063400,MODERN TECHNOLOGY SCHOOL                ,CA,92708-9821,Proprietary  ,5,20,25,97,,218,315
03067400,BALDWIN PARK ADULT SCHOOL               ,CA,91706-4897,Public       ,23,39,62,206,,441,647
03067500,INSTITUTE OF TECHNOLOGY                 ,CA,93612-3217,Proprietary  ,90,286,376,779,,2185,2964
03069500,SAGE COLLEGE                            ,CA,92557-6720,Proprietary  ,13,67,80,184,,804,988
03072300,EVEREST COLLEGE                         ,CA,91761-3222,Proprietary  ,40,131,171,520,,1016,1536
03072700,WESTWOOD COLLEGE - LOS ANGELES          ,CA,90010-1577,Proprietary  ,84,442,526,1549,,5097,6646
03078200,AMERICAN CLG TRADITIONAL CHINESE MD     ,CA,94107-2813,Private      ,1,13,14,9,,321,330
03084700,VENTURA ADULT\CONTINUING EDUCATION      ,CA,93003-7313,Public       ,14,46,60,71,,383,454
03094400,ELITE PROGRESSIVE SCHOOL OF COSM        ,CA,95841-2909,Proprietary  ,15,38,53,150,,342,492
03094401,MARINELLO SCHOOL OF BEAUTY - CONCORD    ,CA,94520-2581,Proprietary  ,15,35,50,125,,241,366
03094402,MARINELLO SCHOOL OF BEAUTY- STOCKTON    ,CA,95203-3149,Proprietary  ,19,32,51,201,,301,502
03097700,CENTRAL CALIF SCH CONTINUING EDUC       ,CA,93401-6739,Proprietary  ,6,38,44,108,,265,373
03098200,YO SAN UNIV TRADITIONAL CHINESE MED     ,CA,90066-1103,Private      ,1,19,20,5,,233,238
03108100,SUMMIT CAREER COLLEGE                   ,CA,92324-3956,Proprietary  ,39,152,191,465,,1289,1754
03109500,DONGGUK  UNIVERSITY LOS ANGELES         ,CA,90020-1765,Private      ,2,19,21,37,,140,177
03113300,UEI COLLEGE                             ,CA,93727-1620,Proprietary  ,146,428,574,743,,1776,2519
03113600,SOUTHERN CALIFORNIA INST OF TECHNOL     ,CA,92805-3758,Proprietary  ,12,98,110,183,,643,826
03116600,EAST SAN GABRIEL VLY REG OCCUP PROG     ,CA,91790-2105,Public       ,56,149,205,327,,945,1272
03125300,JOHN WESLEY INTER. BARBER & BTY CLG     ,CA,90813-4321,Proprietary  ,10,24,34,117,,234,351
03125800,PREMIERE CAREER COLLEGE                 ,CA,91706-3746,Proprietary  ,23,60,83,200,,521,721
03126800,PACIFICA GRADUATE INSTITUTE             ,CA,93013-0000,Proprietary  ,0,28,28,3,,1042,1045
03128700,MT SIERRA COLLEGE                       ,CA,91016-3414,Proprietary  ,8,23,31,415,,450,865
03131300,FIVE BRANCHES UNIVERSITY                ,CA,95062-4669,Proprietary  ,0,14,14,24,,450,474
03144400,AMERICAN CLG OF HEALTH PROFESSIONS      ,CA,92505-3038,Proprietary  ,19,77,96,316,,727,1043
03150500,VIRGINIA SEWING MACHINES & SCH CTR      ,CA,90015-3535,Proprietary  ,5,17,22,35,,86,121
03162300,FOUR-D SUCCESS ACADEMY                  ,CA,92324-4218,Proprietary  ,21,81,102,225,,773,998
03163300,PACIFIC STATES UNIVERSITY               ,CA,90006-0000,Private      ,3,5,8,91,,97,188
03195400,EVEREST COLLEGE                         ,CA,90501-2867,Proprietary  ,12,43,55,157,,372,529
03210300,LE CORDON BLEU COLLEGE OF CULINARY ARTS ,CA,91101-5221,Proprietary  ,135,338,473,2261,,3438,5699
03225300,AMERICAN UNIVERSITY OF HEALTH SCIENCES  ,CA,90755-3612,Proprietary  ,6,20,26,149,,377,526
03242300,CAREER NETWORK INSTITUTE                ,CA,92868-4710,Proprietary  ,27,110,137,198,,793,991
03250300,COMMUNITY BASED EDUCATION AND DEVELOPMEN,CA,90010-2722,Private      ,17,64,81,115,,339,454
03260300,CALIFORNIA STATE U-MONTEREY BAY         ,CA,93955-8001,Public       ,131,151,282,13604,,4571,18175
03266300,BETHESDA UNIVERSITY OF CALIFORNIA       ,CA,92801-4132,Private      ,8,7,15,158,,178,336
03278300,CLARITA CAREER COLLEGE                  ,CA,91351-5432,Proprietary  ,72,189,261,612,,1264,1876
03288300,ACAD CHINESE CULTURE & HEALTH SCIS      ,CA,94512-0000,Private      ,3,10,13,31,,228,259
03299300,PACIFIC COLLEGE                         ,CA,92626-3160,Proprietary  ,2,37,39,146,,455,601
03308300,BRISTOL UNIVERSITY                      ,CA,92806-6198,Proprietary  ,10,72,82,49,,220,269
03327400,ACUPUNCTURE AND INTEGRATIVE MEDICINE COL,CA,94704-2724,Private      ,0,10,10,46,,276,322
03332300,SOUTHERN CA BIBLE CLG & SEMINARY        ,CA,92019-1109,Private      ,0,15,15,18,,193,211
03359300,ST. FRANCIS CAREER COLLEGE              ,CA,90262-2659,Proprietary  ,1,4,5,46,,132,178
03367300,PROFESSIONAL GOLFERS CAREER COLLEGE     ,CA,92591-6013,Proprietary  ,10,13,23,119,,247,366
03395300,INTERNATIONAL CAREER DEVELOPMENT        ,CA,90027-5794,Proprietary  ,108,694,802,794,,5940,6734
03399300,NORTHWESTERN TECHNICAL COLLEGE          ,CA,95670-4443,Proprietary  ,3,16,19,85,,360,445
03403300,EPIC BIBLE COLLEGE                      ,CA,95841-3546,Private      ,4,45,49,137,,590,727
03413400,ENGLISH CENTER  (THE)                   ,CA,94607-3734,Private      ,6,35,41,43,,194,237
03427400,CAREER COLLEGES OF AMERICA              ,CA,90280-7420,Proprietary  ,2,3,5,404,,1228,1632
03427500,UNIVERSITY OF ANTELOPE VALLEY           ,CA,93534-3324,Proprietary  ,54,146,200,746,,1407,2153
03440400,MARIAN HEALTH CAREERS CENTER            ,CA,90010-1728,Proprietary  ,6,19,25,114,,247,361
03441400,VALLEY CAREER COLLEGE                   ,CA,92020-3057,Proprietary  ,0,0,0,67,,195,262
03458300,MY LE'S BEAUTY COLLEGE                  ,CA,95824-3039,Proprietary  ,4,22,26,108,,282,390
03467300,MARINELLO SCHOOL OF BEAUTY              ,CA,92545-3661,Proprietary  ,19,55,74,149,,334,483
03467301,MARINELLO SCHOOL OF BEAUTY - CATHEDRAL C,CA,92234-6656,Proprietary  ,0,3,3,37,,37,74
03467302,MARINELLO SCHOOL OF BEAUTY - MURRIETA   ,CA,92563-5039,Proprietary  ,14,37,51,158,,300,458
03467303,MARINELLO SCHOOL OF BEAUTY - NAPA       ,CA,94559-1237,Proprietary  ,8,22,30,86,,146,232
03467304,MARINELLO SCHOOL OF BEAUTY - CITY OF IND,CA,91748-1674,Proprietary  ,7,23,30,63,,153,216
03467305,MARINELLO SCHOOL OF BEAUTY - BELL       ,CA,90201-1193,Proprietary  ,16,17,33,99,,115,214
03467306,MARINELLO SCHOOL OF BEAUTY - PARAMOUNT  ,CA,90723-5256,Proprietary  ,11,28,39,142,,194,336
03467307,MARINELLO SCHOOL OF BEAUTY - HUNTINGTON ,CA,92646-2552,Proprietary  ,9,19,28,133,,198,331
03479300,PROFESSIONAL CAREER INSTITUTE           ,CA,90703-2522,Proprietary  ,5,14,19,103,,168,271
03516300,KING'S UNIVERSITY (THE)                 ,CA,91405-2233,Private      ,5,34,39,165,,548,713
03532400,ADVANCED TRAINING ASSOCIATES            ,CA,92020-1236,Proprietary  ,5,23,28,41,,182,223
03542400,COPPER MOUNTAIN COLLEGE                 ,CA,92252-6102,Public       ,33,114,147,785,,2239,3024
03577300,COBA ACADEMY                            ,CA,92866-1407,Proprietary  ,6,7,13,41,,61,102
03590400,NTMA TRAINING CENTERS OF SOUTHERN C     ,CA,90650-0000,Private      ,31,129,160,210,,658,868
03592400,IRELL & MANELLA GRADUATE SCHOOL OF BIOLO,CA,91010-0000,Private      ,0,0,0,0,,22,22
03598300,AVALON BEAUTY COLLEGE                   ,CA,93103-3137,Proprietary  ,10,8,18,157,,131,288
03614300,DAVID'S ACADEMY OF BEAUTY               ,CA,91780-1089,Proprietary  ,1,29,30,38,,227,265
03639300,WEST COAST ULTRASOUND INSTITUTE         ,CA,90211-3312,Proprietary  ,35,131,166,468,,1549,2017
03646300,DESIGN'S SCHOOL OF COSMETOLOGY          ,CA,93446-9530,Proprietary  ,12,33,45,113,,229,342
03681300,CALIFORNIA HEALING ARTS COLLEGE         ,CA,90025-0000,Proprietary  ,8,15,23,113,,299,412
03695300,COMMUNITY ENHANCEMENT SERVICES          ,CA,91502-2750,Private      ,4,25,29,42,,200,242
03695700,SANTIAGO CANYON COLLEGE                 ,CA,92869-4512,Public       ,202,250,452,4874,,3189,8063
03696300,UNIVERSITY OF THE WEST                  ,CA,91770-3709,Private      ,2,6,8,54,,114,168
03698300,WEST COAST UNIVERSITY                   ,CA,91606-3206,Proprietary  ,170,425,595,2661,,6147,8808
03698400,CA COLLEGE OF VOCATIONAL CAREER         ,CA,93301-1800,Proprietary  ,10,57,67,204,,580,784
03736300,ADVANCE BEAUTY COLLEGE                  ,CA,92843-4752,Proprietary  ,13,111,124,83,,542,625
03740400,ATI COLLEGE                             ,CA,90650-0000,Proprietary  ,6,20,26,94,,227,321
03752400,SCHOOL OF URBAN MISSIONS                ,CA,94603-0000,Private      ,7,17,24,192,,319,511
03759300,COMPUTER TUTOR BUSINESS & TECH INST     ,CA,95356-0000,Proprietary  ,8,34,42,125,,309,434
03786300,ADVANCED COLLEGE                        ,CA,90280-5255,Proprietary  ,10,26,36,97,,324,421
03797400,CAREER CARE INSTITUTE                   ,CA,93534-4766,Proprietary  ,19,119,138,295,,949,1244
03797401,CAREER CARE INSTITUTE - VENTURA         ,CA,93003-0000,Proprietary  ,1,15,16,65,,235,300
03797402,CAREER CARE INSTITUTE - MORENO VALLEY   ,CA,92553-7519,Proprietary  ,3,8,11,62,,177,239
03814400,SOKA UNIVERSITY OF AMERICA              ,CA,92656-8081,Private      ,7,0,7,602,,67,669
03853300,KECK GRADUATE INSTITUTE OF APPLIED LIFE ,CA,91711-4817,Private      ,0,4,4,4,,147,151
03868300,WORLD MISSION UNIVERSITY                ,CA,90020-1789,Private      ,1,10,11,16,,127,143
03868400,LOS ANGELES MUSIC ACADEMY               ,CA,91105-2540,Proprietary  ,6,18,24,252,,223,475
03871300,FOLSOM LAKE COLLEGE                     ,CA,95630-6798,Public       ,111,221,332,3923,,4815,8738
03874300,CAMBRIDGE JUNIOR COLLEGE                ,CA,95993-0000,Proprietary  ,20,70,90,257,,567,824
03874400,COMMMUNITY CHRISTIAN COLLEGE            ,CA,92373-4465,Private      ,4,6,10,160,,148,308
03889300,STANBRIDGE COLLEGE                      ,CA,92612-0000,Proprietary  ,37,154,191,417,,1467,1884
03901300,PACIFIC COAST TRADE SCHOOL              ,CA,93033-2441,Proprietary  ,3,24,27,116,,310,426
03910400,NATIONAL POLYTECHNIC COLLEGE            ,CA,90040-3066,Proprietary  ,8,15,23,146,,184,330
03933300,MUELLER COLLEGE OF HOLISTIC STUDIES     ,CA,92116-2630,Proprietary  ,5,26,31,52,,330,382
03935300,CALIFORNIA NURSES EDUCATIONAL INSTITUTE ,CA,92234-7248,Proprietary  ,3,21,24,110,,323,433
03962300,AMERICAN INSTITUTE OF MASSAGE THERAPY   ,CA,92705-5463,Proprietary  ,3,14,17,82,,131,213
03964400,INTERNATIONAL SCHOOL OF BEAUTY          ,CA,92260-2740,Proprietary  ,11,21,32,135,,329,464
03969600,AMERICAN AUTO INSTITUTE                 ,CA,90703-2637,Proprietary  ,119,277,396,632,,1296,1928
03971300,AMERICAN CAREER COLLEGE                 ,CA,91764-4906,Proprietary  ,100,224,324,1043,,2090,3133
03973300,EX'PRESSION COLLEGE FOR DIGTAL ARTS     ,CA,94608-1021,Proprietary  ,34,33,67,644,,551,1195
03974500,CALIFORNIA CAREER COLLEGE               ,CA,91303-2006,Proprietary  ,5,15,20,50,,167,217
03980300,CALIFORNIA STATE UNIVERSITY CHANNEL ISLA,CA,93012-8599,Public       ,80,96,176,8654,,3717,12371
03995300,UNIVERSITY OF EAST-WEST MEDICINE        ,CA,94087-6106,Proprietary  ,0,11,11,17,,94,111
03999300,BEAUMONT ADULT SCHOOL                   ,CA,92223-1927,Public       ,3,8,11,53,,198,251
04001300,PALACE BEAUTY COLLEGE                   ,CA,90006-4233,Proprietary  ,6,20,26,96,,234,330
04003300,BLAKE AUSTIN COLLEGE                    ,CA,95687-3100,Proprietary  ,32,77,109,261,,618,879
04004300,THUY PRINCESS BEAUTY COLLEGE            ,CA,91766-0000,Proprietary  ,5,13,18,42,,107,149
04005300,UNITED STATES UNIVERSITY                ,CA,91911-1683,Proprietary  ,6,57,63,38,,468,506
04014400,PALLADIUM TECHNICAL ACADEMY             ,CA,91731-2429,Proprietary  ,2,11,13,25,,70,95
04023400,PROTEUS                                 ,CA,93291-3014,Private      ,0,0,0,17,,51,68
04037300,LOS ANGELES FILM SCHOOL (THE)           ,CA,90028-7300,Proprietary  ,160,211,371,2074,,2574,4648
04056300,CAREER COLLEGE OF CALIFORNIA            ,CA,92705-5805,Proprietary  ,16,32,48,156,,327,483
04057300,TECHSKILLS OF CALIFORNIA                ,CA,95815-4025,Proprietary  ,11,134,145,210,,1122,1332
04076400,GNOMON SCHOOL OF VISUAL EFFECTS         ,CA,90038-2616,Proprietary  ,6,15,21,146,,232,378
04088300,WESTMED COLLEGE                         ,CA,95128-2541,Private      ,8,43,51,141,,480,621
04088301,WESTMED COLLEGE - MERCED                ,CA,95340-9165,Private      ,10,25,35,143,,312,455
04092300,COASTLINE BEAUTY COLLEGE                ,CA,92708-3847,Proprietary  ,1,46,47,72,,286,358
04092400,MAKE-UP DESIGNORY                       ,CA,91502-1322,Proprietary  ,26,31,57,336,,385,721
04100400,TAFT UNIVERSITY SYSTEM (THE)            ,CA,92704-6954,Proprietary  ,0,33,33,14,,563,577
04109300,ACADEMY OF BARBERING ARTS (THE)         ,CA,91324-3406,Proprietary  ,0,0,0,9,,22,31
04111300,WEST HILLS COLLEGE LEMOORE              ,CA,93245-9248,Public       ,53,151,204,2523,,3397,5920
04114500,VALLEY COLLEGE OF MEDICAL CAREERS       ,CA,91304-2354,Proprietary  ,10,16,26,88,,176,264
04115300,COACHELLA VALLEY BEAUTY COLLEGE         ,CA,92253-2051,Proprietary  ,9,14,23,114,,142,256
04115600,MAYFIELD COLLEGE                        ,CA,92234-7014,Proprietary  ,38,85,123,240,,523,763
04116000,VIDEO SYMPHONY ENTERTRAINING            ,CA,91502-3253,Proprietary  ,15,41,56,124,,430,554
04118800,NEW YORK FILM ACADEMY                   ,CA,91608-1002,Proprietary  ,40,78,118,891,,1187,2078
04119200,CAREER COLLEGE CONSULTANTS              ,CA,90041-2088,Proprietary  ,2,24,26,49,,195,244
04126400,CHAMPION INSTITUTE OF COSMETOLOGY       ,CA,92264-7458,Proprietary  ,3,7,10,39,,63,102
04126500,COAST CAREER INSTITUTE                  ,CA,90015-3040,Proprietary  ,20,106,126,112,,386,498
04127100,"UNIVERSITY OF CALIFORNIA, MERCED        ",CA,95343-5001,Public       ,138,44,182,15827,,2282,18109
04127900,TUI UNIVERSITY                          ,CA,90630-5023,Proprietary  ,11,432,443,68,,3765,3833
04129700,INTERNATIONAL POLYTECHNIC INSTITUTE     ,CA,92231-1737,Private      ,1,0,1,18,,15,33
04129803,MEDIATECH INSTITUTE - OCEANSIDE         ,CA,92054-5116,Proprietary  ,8,14,22,69,,140,209
04132400,ACADEMY OF ESTHETICS AND COSMETOLOGY    ,CA,91342-3373,Proprietary  ,3,4,7,69,,84,153
04132700,INFOTECH CAREER COLLEGE                 ,CA,90706-5579,Proprietary  ,8,27,35,58,,208,266
04133000,BIOHEALTH COLLEGE                       ,CA,95134-2033,Proprietary  ,5,30,35,86,,360,446
04133100,CALIFORNIA UNIVERSITY OF MANAGEMENT AND ,CA,92801-1702,Private      ,2,6,8,30,,108,138
04134500,CAREER COLLEGE OF SAN DIEGO             ,CA,92102-3348,Proprietary  ,13,69,82,263,,987,1250
04134700,INTERNATL PROFESSIONAL SCHL OF BODYWORK ,CA,92123-1520,Proprietary  ,2,17,19,63,,299,362
04137200,BORNER'S BARBER COLLEGE                 ,CA,90047-3856,Proprietary  ,10,21,31,82,,189,271
04138700,CAO INSTITUTE OF AESTHETICS (THE)       ,CA,91801-3903,Proprietary  ,5,16,21,102,,190,292
04140500,HORIZON UNIVERSITY                      ,CA,92111-2622,Private      ,0,11,11,61,,197,258
04141300,SAN FRANCISCO INSTITUTE OF ESTHETICS    ,CA,94103-4083,Proprietary  ,16,31,47,155,,255,410
04141400,LAURUS COLLEGE                          ,CA,93401-5405,Proprietary  ,25,158,183,215,,1102,1317
04141700,HEALING HANDS SCHOOL OF HOLISTIC HEALTH ,CA,92025-1722,Proprietary  ,3,28,31,55,,232,287
04142500,TOURO COLLEGE LOS ANGELES               ,CA,90046-4506,Private      ,4,32,36,117,,232,349
04142600,TOURO UNIVERSITY                        ,CA,94592-1118,Private      ,1,56,57,42,,2976,3018
04143800,WOODLAND COMMUNITY COLLEGE              ,CA,95776-5156,Public       ,49,88,137,1588,,1947,3535
04144200,CAREER DEVELOPMENT INSTITUTE            ,CA,90035-4364,Proprietary  ,2,20,22,52,,232,284
04145000,SAN DIEGO CULINARY INSTITUTE            ,CA,91941-6435,Proprietary  ,20,63,83,414,,712,1126
04145600,INTERNATIONAL COLLEGE OF COSMETOLOGY    ,CA,94601-3525,Proprietary  ,4,29,33,69,,254,323
04146000,NATIONAL CAREER COLLEGE                 ,CA,91605-1400,Proprietary  ,4,35,39,37,,169,206
04148200,BEYOND 21ST CENTURY BEAUTY ACADEMY      ,CA,90670-6316,Proprietary  ,6,8,14,36,,50,86
04148900,N CALIF INSTITUTE OF COSMETOLOGY        ,CA,94577-2820,Proprietary  ,3,6,9,27,,90,117
04149700,HOMESTEAD SCHOOLS                       ,CA,90505-5945,Private      ,9,44,53,77,,254,331
04150000,CENTRAL NURSING COLLEGE                 ,CA,90010-2444,Proprietary  ,9,40,49,243,,379,622
04150100,GOLDEN STATE COLLEGE OF COURT REPORTING ,CA,94568-2948,Proprietary  ,0,3,3,14,,72,86
04150300,RWM FIBER OPTICS                        ,CA,90746-1051,Proprietary  ,3,12,15,21,,149,170
04150500,"PREFERRED COLLEGE OF NURSING, LOS ANGELE",CA,90010-2202,Proprietary  ,3,20,23,135,,411,546
04152800,CALIFORNIA ACADEMY (THE) - A PAUL MITCHE,CA,95825-2276,Proprietary  ,19,55,74,448,,631,1079
04153900,PROVIDENCE CHRISTIAN COLLEGE            ,CA,91104-2635,Private      ,0,5,5,94,,58,152
04154400,FRANKLIN CAREER COLLEGE                 ,CA,91761-1522,Proprietary  ,0,0,0,34,,124,158
04155500,"ACADEMY FOR JEWISH RELIGION, CALIFORNIA ",CA,90024-3234,Private      ,2,6,8,29,,105,134
04156100,TONI & GUY HAIRDRESSING ACADEMY         ,CA,95356-9695,Proprietary  ,11,14,25,101,,184,285
04157800,GRACE MISSION UNIVERSITY                ,CA,92833-3860,Private      ,1,8,9,17,,88,105
04158200,PAUL MITCHELL THE SCHOOL SHERMAN OAKS   ,CA,91403-5882,Proprietary  ,17,29,46,263,,297,560
04158700,HOLLYWOOD BEAUTY COLLEGE                ,CA,95210-3514,Proprietary  ,7,17,24,136,,246,382
04158900,FLAIR BEAUTY COLLEGE                    ,CA,91351-3381,Proprietary  ,7,7,14,48,,79,127
04159600,GALAXY MEDICAL COLLEGE                  ,CA,91606-1593,Proprietary  ,1,4,5,40,,71,111
04159700,AMERICAN MEDICAL SCIENCES CENTER        ,CA,91204-5108,Proprietary  ,7,9,16,85,,173,258
04160100,TRINITY VOCATIONAL CENTER               ,CA,90248-4334,Proprietary  ,9,39,48,63,,260,323
04160400,ANGELES COLLEGE OF NURSING              ,CA,90010-2100,Proprietary  ,20,40,60,504,,702,1206
04161300,PREFERRED COLLEGE OF NURSING            ,CA,91401-1442,Proprietary  ,3,14,17,60,,182,242
04161700,SHASTA SCHOOL OF COSMETOLOGY            ,CA,96003-0000,Proprietary  ,9,21,30,120,,183,303
04161800,BRANDMAN UNIVERSITY                     ,CA,92618-3801,Private      ,31,687,718,549,,9620,10169
04162800,S.I.C.E PAUL MITCHELL PARTNER SCHOOL    ,CA,95350-1440,Proprietary  ,29,46,75,333,,435,768
04163400,COSMO BEAUTY ACADEMY                    ,CA,95605-1904,Proprietary  ,7,39,46,214,,370,584
04163900,L.A. BARBER COLLEGE                     ,CA,90013-1121,Proprietary  ,0,0,0,13,,29,42
04164400,ANGELES INSTITUTE                       ,CA,90712-2903,Proprietary  ,5,22,27,84,,213,297
04165900,PAUL MITCHELL THE SCHOOL FRESNO         ,CA,93710-7617,Proprietary  ,27,14,41,351,,384,735
04167000,PAUL MITCHELL THE SCHOOL TEMECULA       ,CA,92591-4663,Proprietary  ,35,42,77,271,,310,581
04169200,TRAMY BEAUTY SCHOOL                     ,CA,92115-6347,Proprietary  ,6,38,44,127,,367,494
04169700,UNITEK COLLEGE                          ,CA,94538-3185,Proprietary  ,55,318,373,503,,2279,2782
04169800,GURNICK ACADEMY OF MEDICAL ARTS         ,CA,94403-1849,Proprietary  ,23,88,111,332,,1516,1848
04172000,SOUTHERN CALIFORNIA UNIVERSITY SOMA     ,CA,90017-2211,Proprietary  ,7,31,38,233,,392,625
04173400,SANTA ANA BEAUTY ACADEMY                ,CA,92705-7820,Proprietary  ,1,8,9,65,,93,158
04173500,MORENO VALLEY COLLEGE                   ,CA,92551-2204,Public       ,272,521,793,5606,,7484,13090
04175200,PAUL MITCHELL THE SCHOOL EAST BAY       ,CA,94523-5515,Proprietary  ,22,22,44,259,,295,554
04175400,ELITE COSMETOLOGY SCHOOL                ,CA,92284-2860,Proprietary  ,5,17,22,49,,133,182
04176100,NORCO COLLEGE                           ,CA,92860-2600,Public       ,261,358,619,5239,,5390,10629
04176200,TWIN RIVERS ADULT SCHOOL                ,CA,95660-5523,Public       ,1,3,4,20,,108,128
04176300,BERGIN UNIVERSITY OF CANINE STUDIES     ,CA,95407-6834,Private      ,0,3,3,32,,106,138
04177200,REAL BARBERS COLLEGE (THE)              ,CA,92805-2533,Proprietary  ,12,27,39,102,,181,283
04178900,HANDS-ON MEDICAL MASSAGE SCHOOL         ,CA,92373-6271,Proprietary  ,1,6,7,29,,69,98
04180000,CINTA AVEDA INSTITUTE                   ,CA,94108-3204,Proprietary  ,25,44,69,199,,464,663
04181200,IPPT CAREER SCHOOL                      ,CA,91601-2028,Proprietary  ,24,97,121,84,,349,433
04181600,INTEGRITY COLLEGE OF HEALTH             ,CA,91104-2300,Proprietary  ,1,18,19,4,,47,51
04185200,SALINAS BEAUTY COLLEGE                  ,CA,93901-2405,Proprietary  ,6,20,26,66,,125,191
04185500,ACADEMY OF COUTURE ART                  ,CA,90069-5701,Proprietary  ,3,5,8,135,,146,281
04185600,MEDICAL ALLIED CAREER CENTER            ,CA,90670-4710,Proprietary  ,1,13,14,17,,110,127
04185700,ACADEMY FOR SALON PROFESSIONALS (THE)   ,CA,95050-4057,Proprietary  ,6,20,26,139,,232,371
04186900,"INTERNATIONAL COLLEGE OF BEAUTY, ARTS & ",CA,90039-1012,Proprietary  ,5,18,23,133,,223,356
04187900,JOE BLASCO MAKEUP ARTIST TRAINING CENTER,CA,90027-5580,Proprietary  ,0,1,1,194,,315,509
04189300,ALLIED AMERICAN UNIVERSITY              ,CA,92653-1337,Proprietary  ,26,331,357,150,,2623,2773
04189700,CALIFORNIA MIRAMAR UNIVERSITY           ,CA,92126-7501,Proprietary  ,22,41,63,556,,799,1355
04189800,ACADEMY FOR SALON PROFESSIONALS         ,CA,91304-2305,Proprietary  ,2,18,20,82,,167,249
04190800,SANTA ANA BEAUTY COLLEGE                ,CA,92706-2321,Proprietary  ,3,24,27,62,,125,187
04190900,SUTTER BEAUTY COLLEGE                   ,CA,95991-3624,Proprietary  ,6,15,21,15,,50,65
04191300,ANNENBERG SCHOOL OF NURSING             ,CA,91335-5426,Private      ,2,10,12,44,,93,137
04193500,LEMELANGE ACADEMY OF HAIR               ,CA,94558-2935,Proprietary  ,3,15,18,35,,84,119
04193700,JOHN PAUL THE GREAT CATHOLIC UNIVERSITY ,CA,92131-1652,Private      ,4,12,16,226,,126,352
04194300,COLTON-REDLANDS-YUCAIPA REGIONAL OCCUPAT,CA,92374-2896,Public       ,6,6,12,134,,224,358
04194600,BRAND COLLEGE                           ,CA,91203-3646,Proprietary  ,1,8,9,27,,66,93
04195200,DIAMOND BEAUTY COLLEGE                  ,CA,91733-2180,Proprietary  ,1,8,9,11,,45,56
04195400,NCP COLLEGE OF NURSING                  ,CA,94080-1005,Proprietary  ,6,18,24,121,,319,440
04195401,NCP COLLEGE OF NURSING - HAYWARD CAMPUS ,CA,94541-7026,Proprietary  ,7,20,27,162,,377,539
04205800,"SAE INSTITUTE OF TECHNOLOGY, LOS ANGELES",CA,90028-7219,Proprietary  ,24,54,78,268,,410,678
04206800,ADVANCE BEAUTY TECHS ACADEMY            ,CA,92583-6572,Proprietary  ,3,7,10,49,,115,164
04208100,UKIAH ADULT SCHOOL                      ,CA,95482-3865,Public       ,1,8,9,19,,131,150
04208400,RIVERSIDE COUNTY OFFICE OF EDUCATION    ,CA,92503-3504,Public       ,11,30,41,139,,337,476
04208900,ADVANCED CAREER INSTITUTE               ,CA,93291-9254,Proprietary  ,10,69,79,82,,477,559
04209800,HINTON BARBER COLLEGE                   ,CA,94590-4547,Proprietary  ,4,21,25,45,,121,166
04210600,ADVANCED COMPUTING INSTITUTE            ,CA,90010-3911,Proprietary  ,11,48,59,133,,317,450
04211900,XAVIER COLLEGE SCHOOL OF NURSING        ,CA,95202-1332,Proprietary  ,3,21,24,158,,349,507
04212000,LAWRENCE & COMPANY COLLEGE OF COSMETOLOG,CA,93230-4102,Proprietary  ,7,12,19,58,,104,162
04215100,CALIFORNIA CAREER INSTITUTE             ,CA,92840-2816,Proprietary  ,1,21,22,34,,203,237
04215300,COSMO FACTORY COSMETOLOGY ACADEMY (THE) ,CA,95060-4401,Proprietary  ,3,10,13,54,,95,149
04216300,UEI COLLEGE                             ,CA,95065-1520,Proprietary  ,76,205,281,199,,493,692
04217100,RUDOLF STEINER COLLEGE                  ,CA,95628-6811,Private      ,0,7,7,2,,61,63
04217500,W INSTITUTE OF COSMETOLOGY              ,CA,94521-5385,Proprietary  ,3,5,8,30,,81,111
04221800,TONI&GUY HAIRDRESSING ACADEMY           ,CA,95337-5703,Proprietary  ,7,26,33,43,,90,133
04221900,COMPUTER TRAINING ACADEMY               ,CA,92507-2122,Proprietary  ,7,58,65,14,,94,108
04222200,FAB SCHOOL (THE)                        ,CA,92507-3434,Proprietary  ,22,36,58,66,,167,233
04223700,BAY AREA MEDICAL ACADEMY                ,CA,94102-2844,Proprietary  ,10,38,48,10,,38,48
04226100,LAWRENCE AND COMPANY COLLEGE OF COSMETOL,CA,93662-3509,Proprietary  ,5,3,8,5,,6,11
04228100,HIGH DESERT MEDICAL COLLEGE             ,CA,93534-1134,Proprietary  ,23,68,91,23,,68,91
00184600,BRIAR CLIFF UNIVERSITY                  ,IA,51104-2100,Private      ,14,26,40,1312,,724,2036
00184700,BUENA VISTA UNIVERSITY                  ,IA,50588-9987,Private      ,11,97,108,1797,,2116,3913
00184800,SOUTHEASTERN COMMUNITY COLLEGE          ,IA,52655-0000,Public       ,37,109,146,1263,,1949,3212
00185000,CENTRAL COLLEGE                         ,IA,50219-1999,Private      ,14,7,21,2204,,157,2361
00185200,CLARKE UNIVERSITY                       ,IA,52001-3198,Private      ,10,15,25,1322,,606,1928
00185400,COE COLLEGE                             ,IA,52402-5092,Private      ,22,12,34,2557,,304,2861
00185500,DES MOINES UNIV-OSTEOPATHIC MED CTR     ,IA,50312-0000,Private      ,0,18,18,46,,1780,1826
00185600,CORNELL COLLEGE                         ,IA,52314-1098,Private      ,15,4,19,2094,,122,2216
00185700,SOUTHWESTERN COMMUNITY COLLEGE          ,IA,50801-1098,Public       ,8,37,45,695,,714,1409
00185800,DIVINE WORD COLLEGE                     ,IA,52045-0380,Private      ,1,0,1,32,,17,49
00185900,DORDT COLLEGE                           ,IA,51250-1697,Private      ,6,5,11,1550,,116,1666
00186000,DRAKE UNIVERSITY                        ,IA,50311-4505,Private      ,41,48,89,4987,,2281,7268
00186200,ELLSWORTH COMMUNITY COLLEGE             ,IA,50126-1199,Public       ,21,21,42,844,,434,1278
00186400,IOWA LAKES COMMUNITY COLLEGE            ,IA,51334-2234,Public       ,22,46,68,1188,,1078,2266
00186500,IOWA CENTRAL COMMUNITY COLLEGE          ,IA,50501-0000,Public       ,61,214,275,2961,,3317,6278
00186600,GRACELAND UNIVERSITY                    ,IA,50140-1699,Private      ,11,80,91,1385,,1604,2989
00186700,GRAND VIEW UNIVERSITY                   ,IA,50316-1599,Private      ,11,63,74,2188,,1616,3804
00186800,GRINNELL COLLEGE                        ,IA,50112-1690,Private      ,19,2,21,2913,,110,3023
00186900,IOWA STATE UNIV SCIENCE & TECHNOLOG     ,IA,50011-2028,Public       ,205,136,341,27543,,6719,34262
00187100,IOWA WESLEYAN COLLEGE                   ,IA,52641-1398,Private      ,9,11,20,829,,403,1232
00187300,LORAS COLLEGE                           ,IA,52004-0178,Private      ,13,6,19,2069,,244,2313
00187400,LUTHER COLLEGE                          ,IA,52101-1045,Private      ,8,3,11,3288,,146,3434
00187500,MARSHALLTOWN COMMUNITY COLLEGE          ,IA,50158-4760,Public       ,22,47,69,773,,987,1760
00187700,NORTH IOWA AREA COMMUNITY COLLEGE       ,IA,50401-7299,Public       ,38,59,97,1502,,1234,2736
00187900,MORNINGSIDE COLLEGE                     ,IA,51106-1751,Private      ,10,56,66,2172,,988,3160
00188000,MOUNT MERCY UNIVERSITY                  ,IA,52402-4797,Private      ,9,45,54,1036,,1201,2237
00188300,NORTHWESTERN COLLEGE                    ,IA,51041-1996,Private      ,2,5,7,1530,,162,1692
00188700,SIMPSON COLLEGE                         ,IA,50125-1297,Private      ,9,12,21,2231,,593,2824
00188900,ST AMBROSE UNIVERSITY                   ,IA,52803-2898,Private      ,24,65,89,3578,,1632,5210
00189000,UNIVERSITY OF NORTHERN IOWA             ,IA,50614-0002,Public       ,77,101,178,10295,,3162,13457
00189100,UNIVERSITY OF DUBUQUE                   ,IA,52001-5099,Private      ,18,45,63,2260,,814,3074
00189200,UNIVERSITY OF IOWA                      ,IA,52242-1316,Public       ,187,212,399,22245,,9626,31871
00189300,UPPER IOWA UNIVERSITY                   ,IA,52142-9206,Private      ,22,308,330,1567,,6059,7626
00189500,WALDORF COLLEGE                         ,IA,50436-1700,Proprietary  ,10,76,86,695,,826,1521
00189600,WARTBURG COLLEGE                        ,IA,50677-2200,Private      ,16,3,19,2286,,123,2409
00189700,WARTBURG THEOLOGICAL SEMINARY           ,IA,52004-5004,Private      ,0,1,1,13,,135,148
00190000,WILLIAM PENN UNIVERSITY                 ,IA,52577-1799,Private      ,14,64,78,1212,,1249,2461
00396300,AIB COLLEGE OF BUSINESS                 ,IA,50321-1799,Private      ,11,57,68,821,,927,1748
00407500,ESTRN IOWA COMMUNITY COLLEGE DIST       ,IA,52801-1221,Public       ,5,34,39,203,,662,865
00407501,CLINTON COMMUNITY COLLEGE               ,IA,52732-0000,Public       ,17,122,139,551,,1062,1613
00407502,MUSCATINE COMMUNITY COLLEGE             ,IA,52761-0000,Public       ,13,40,53,617,,769,1386
00407503,SCOTT COMMUNITY COLLEGE                 ,IA,52722-0000,Public       ,52,183,235,1716,,3292,5008
00407600,KIRKWOOD COMMUNITY COLLEGE              ,IA,52406-2068,Public       ,175,482,657,7175,,8161,15336
00422009,HAMILTON COLLEGE -  COUNCIL BLUFFS      ,IA,51503-5289,Proprietary  ,0,0,0,25,,273,298
00423300,MERCY/ST. LUKE'S SCH RAD TECH           ,IA,52402-0000,Private      ,1,1,2,34,,66,100
00458600,KAPLAN UNIVERSITY                       ,IA,52807-2095,Proprietary  ,642,9548,10190,4792,,85882,90674
00458604,KAPLAN UNIVERSITY - CEDAR RAPIDS        ,IA,52404-2998,Proprietary  ,17,175,192,192,,2007,2199
00458605,KAPLAN UNIVERSITY - DES MOINES          ,IA,50323-5702,Proprietary  ,17,216,233,198,,2373,2571
00458606,KAPLAN UNIVERSITY - MASON CITY          ,IA,50401-4665,Proprietary  ,12,78,90,74,,959,1033
00458607,KAPLAN UNIVERSITY - CEDAR FALLS         ,IA,50613-6309,Proprietary  ,9,129,138,152,,1617,1769
00458700,NORTHEAST IOWA COMMUNITY COLLEGE        ,IA,52132-0400,Public       ,9,34,43,739,,812,1551
00458701,NORTHEAST IOWA COMMUNITY COLLEGE        ,IA,52068-0000,Public       ,45,59,104,1183,,1510,2693
00459500,HAWKEYE COMMUNITY COLLEGE               ,IA,50701-0000,Public       ,67,153,220,3094,,3094,6188
00459800,IOWA WESTERN CMTY CLG-COUNCIL BLUFF     ,IA,51502-0000,Public       ,81,162,243,3898,,3904,7802
00460000,NORTHWEST IOWA COMMUNITY COLLEGE        ,IA,51201-1046,Public       ,11,20,31,596,,501,1097
00626700,IOWA METHODIST MEDICAL CENTER SCHOOLS   ,IA,50309-1499,Private      ,2,7,9,61,,138,199
00627300,MERCY COLLEGE OF HEALTH SCIENCES        ,IA,50309-1239,Private      ,9,30,39,515,,1156,1671
00712000,DES MOINES AREA CMTY COLLEGE            ,IA,50021-0000,Public       ,195,640,835,7977,,11641,19618
00712100,FAITH BAPTIST BIBLE CLG & THEOL SEM     ,IA,50021-0000,Private      ,2,2,4,286,,78,364
00729100,ST LUKE'S COLLEGE                       ,IA,51104-0263,Private      ,1,7,8,130,,222,352
00731600,WESTERN IOWA TECH COMMUNITY COLLEGE     ,IA,51106-0000,Public       ,47,195,242,2129,,3637,5766
00758800,CAPRI COLLEGE                           ,IA,52004-0873,Proprietary  ,12,22,34,95,,159,254
00761100,EQ SCHOOL OF HAIR DESIGN                ,IA,51503-0813,Proprietary  ,2,10,12,55,,77,132
00765600,AMERICAN COLLEGE OF HARISTYLING -CR     ,IA,52402-0000,Proprietary  ,2,2,4,14,,54,68
00765800,AMER COLL OF HAIRSTYLING-DES MOINES     ,IA,50309-5446,Proprietary  ,1,8,9,16,,66,82
00765900,LA JAMES COLLEGE OF HAIRSTYLING         ,IA,50401-3308,Proprietary  ,3,14,17,71,,81,152
00771700,CAPRI COLLEGE                           ,IA,52807-2622,Proprietary  ,15,33,48,142,,301,443
00794100,COLLEGE OF HAIR DESIGN                  ,IA,50703-1834,Proprietary  ,4,7,11,20,,78,98
00826000,IOWA SCHOOL OF BEAUTY INC               ,IA,50322-0000,Proprietary  ,10,34,44,102,,275,377
00840300,INDIAN HILLS COMMUNITY COLLEGE          ,IA,52501-1398,Public       ,62,185,247,2124,,2898,5022
00840301,INDIAN HILLS COMMUNITY COLLEGE          ,IA,52544-1223,Public       ,0,0,0,15,,16,31
00842400,LA JAMES INTERNATIONAL COLLEGE          ,IA,50501-5577,Proprietary  ,3,6,9,59,,76,135
00959300,LA'JAMES COLLEGE OF HAIRSTYLING         ,IA,52240-0000,Proprietary  ,2,9,11,57,,87,144
01111300,MAHARISHI UNIV OF MANAGEMENT            ,IA,52557-0001,Private      ,2,10,12,204,,530,734
01206400,HAMILTON TECHNICAL COLLEGE              ,IA,52807-2653,Proprietary  ,4,30,34,90,,309,399
01230000,PALMER COLLEGE OF CHIROPRACTIC          ,IA,52803-5287,Private      ,4,45,49,106,,2223,2329
01300600,LA' JAMES INTERNATIONAL COLLEGE-CF      ,IA,50613-5242,Proprietary  ,1,6,7,70,,106,176
02090300,CAPRI COLLEGE                           ,IA,52404-0000,Proprietary  ,16,28,44,167,,210,377
02134500,LA JAMES INTERNATIONAL COLLEGE - DAV    ,IA,52806-3952,Proprietary  ,2,15,17,34,,97,131
02160900,PCI ACADEMY                             ,IA,50010-6062,Proprietary  ,4,10,14,124,,110,234
02262500,FAUST INSTITUTE OF COSMETOLOGY          ,IA,50588-0000,Proprietary  ,1,6,7,34,,53,87
02274100,LA' JAMES INTERNATIONAL COLLEGE - DM    ,IA,50131-0000,Proprietary  ,2,14,16,85,,155,240
02289000,AMERICAN HAIR ACADEMY                   ,IA,52627-4530,Proprietary  ,0,3,3,26,,43,69
02306900,IOWA SCHOOL OF BEAUTY                   ,IA,52501-0000,Proprietary  ,3,5,8,48,,77,125
02328900,EMMAUS BIBLE COLLEGE                    ,IA,52001-0000,Private      ,0,4,4,258,,59,317
02330900,IOWA SCHOOL OF BEAUTY                   ,IA,50158-0000,Proprietary  ,3,6,9,19,,50,69
02609200,VATTEROTT COLLEGE                       ,IA,50321-4704,Proprietary  ,10,72,82,149,,709,858
03069100,ALLEN COLLEGE                           ,IA,50703-1916,Private      ,7,17,24,380,,669,1049
03441300,IOWA SCHOOL OF BEAUTY                   ,IA,51106-5111,Proprietary  ,2,7,9,41,,112,153
03607400,TOTAL LOOK SCHOOL OF COSMETOLOGY AND MAS,IA,52136-1053,Proprietary  ,1,3,4,10,,18,28
03720300,CARLSON COLLEGE OF MASSAGE THERAPY      ,IA,52205-7519,Proprietary  ,2,4,6,24,,47,71
04051313,ART INSTITUTE OF PHOENIX (THE) - BROWN M,IA,52722-3628,Proprietary  ,0,4,4,32,,85,117
04089300,BIO-CHI INSTITUTE OF MASSAGE THERAPY    ,IA,51103-2138,Proprietary  ,0,0,0,9,,24,33
04177800,SALON PROFESSIONAL ACADEMY (THE)        ,IA,52240-6083,Proprietary  ,8,9,17,47,,70,117
04203300,AVEDA INSTITUTE DES MOINES              ,IA,50266-8137,Proprietary  ,15,23,38,224,,198,422
00259600,ATLANTIC COMMUNITY COLLEGE              ,NJ,08330-2699,Public       ,104,251,355,4304,,5255,9559
00259700,BLOOMFIELD COLLEGE                      ,NJ,07003-3425,Private      ,36,44,80,3032,,1712,4744
00259800,CALDWELL COLLEGE                        ,NJ,07006-6195,Private      ,36,44,80,2561,,1302,3863
00259900,CENTENARY COLLEGE                       ,NJ,07840-2184,Private      ,16,47,63,1841,,1016,2857
00260000,COLLEGE OF SAINT ELIZABETH              ,NJ,07960-6989,Private      ,22,30,52,1077,,823,1900
00260100,CUMBERLAND COUNTY COLLEGE               ,NJ,08362-9912,Public       ,32,95,127,2524,,3638,6162
00260300,DREW UNIVERSITY                         ,NJ,07940-4063,Private      ,27,19,46,3224,,735,3959
00260700,FAIRLEIGH DICKINSON UNIV-TEANECK        ,NJ,07666-1996,Private      ,69,158,227,4943,,3343,8286
00260701,FAIRLEIGH DICKINSON UNIV-FLORHAM        ,NJ,07940-0000,Private      ,50,35,85,3809,,1227,5036
00260702,FAIRLEIGH DICKINSON UNIV-ED WMS CLG     ,NJ,07601-0000,Private      ,17,28,45,588,,553,1141
00260703,FAIRLEIGH DICKINSON UNIVERSITY          ,NJ,07940-0000,Private      ,25,29,54,1870,,855,2725
00260800,GEORGIAN COURT UNIVERSITY               ,NJ,08701-2697,Private      ,25,54,79,1812,,1454,3266
00260900,ROWAN UNIVERSITY                        ,NJ,08028-1702,Public       ,150,179,329,15372,,6028,21400
00261000,FELICIAN COLLEGE                        ,NJ,07644-2198,Private      ,36,79,115,1994,,1537,3531
00261300,NEW JERSEY CITY UNIVERSITY              ,NJ,07305-1597,Public       ,82,238,320,5753,,7185,12938
00261500,MIDDLESEX COUNTY COLLEGE                ,NJ,08818-3050,Public       ,141,228,369,7612,,5812,13424
00261600,MONMOUTH UNIVERSITY                     ,NJ,07764-1898,Private      ,81,71,152,7848,,2703,10551
00261700,MONTCLAIR STATE UNIVERSITY              ,NJ,07043-9987,Public       ,193,251,444,20246,,8935,29181
00261900,NEW BRUNSWICK THEOLOGICAL SEMINARY      ,NJ,08901-0000,Private      ,1,1,2,92,,214,306
00262100,NEW JERSEY INST OF TECHNOLOGY           ,NJ,07102-1982,Public       ,108,157,265,7345,,4179,11524
00262200,KEAN UNIVERSITY                         ,NJ,07083-7131,Public       ,135,287,422,12051,,9742,21793
00262400,OCEAN COUNTY COLLEGE                    ,NJ,08754-2001,Public       ,147,264,411,5575,,4903,10478
00262500,WILLIAM PATERSON UNIVERSITY             ,NJ,07470-2152,Public       ,158,136,294,13443,,5804,19247
00262600,PRINCETON THEOLOGICAL SEMINARY          ,NJ,08542-0000,Private      ,2,9,11,17,,606,623
00262700,PRINCETON UNIVERSITY                    ,NJ,08544-0001,Private      ,118,32,150,17088,,1842,18930
00262800,RIDER UNIVERSITY                        ,NJ,08648-3099,Private      ,92,52,144,8327,,1900,10227
00262900,"RUTGERS, THE STATE UNIVERSITY OF NJ     ",NJ,08901-1281,Public       ,549,776,1325,51727,,28630,80357
00262923,"RUTGERS, THE STATE UNIVERSITY OF NEW JER",NJ,07101-1709,Public       ,0,0,0,769,,5876,6645
00263200,SETON HALL UNIVERSITY                   ,NJ,07079-2697,Private      ,137,115,252,11801,,4482,16283
00263201,SETON HALL UNIVERSITY - SCHOOL OF LAW   ,NJ,07079-5210,Private      ,7,27,34,312,,1780,2092
00263800,SAINT PETER'S UNIVERSITY                ,NJ,07306-5997,Private      ,57,103,160,4119,,2206,6325
00263900,STEVENS INSTITUTE OF TECHNOLOGY         ,NJ,07030-5370,Private      ,36,24,60,5058,,776,5834
00264200,COLLEGE OF NEW JERSEY (THE)             ,NJ,08628-0718,Public       ,107,68,175,12701,,1541,14242
00264300,UNION COUNTY COLLEGE                    ,NJ,07016-1598,Public       ,192,426,618,6362,,9294,15656
00473600,BERGEN COMMUNITY COLLEGE                ,NJ,07652-1595,Public       ,239,316,555,9451,,6534,15985
00474000,MERCER COUNTY COMMUNITY COLLEGE         ,NJ,08690-0000,Public       ,94,313,407,3837,,4932,8769
00539900,MONMOUTH COUNTY VOCATIONAL SCH DIST     ,NJ,07728-5033,Public       ,3,7,10,75,,153,228
00545200,TETERBORO SCH OF AERONAUTICS            ,NJ,07608-1083,Proprietary  ,15,19,34,144,,192,336
00546100,SALEM COMMUNITY COLLEGE                 ,NJ,08069-2799,Public       ,14,43,57,711,,906,1617
00641700,HOLY NAME HOSPITAL SCH OF NURSING       ,NJ,07666-4254,Private      ,2,9,11,95,,274,369
00642000,MOUNTAINSIDE HOSP SCH NRSG              ,NJ,07042-4898,Proprietary  ,1,6,7,47,,210,257
00642100,MUHLENBERG SNYDER SCHOOLS               ,NJ,07061-3399,Private      ,3,13,16,131,,554,685
00642900,ST FRANCIS MEDICAL CTR SCH NURSING      ,NJ,08629-1986,Private      ,3,6,9,54,,188,242
00642902,ST FRANCIS MED CTR RAD TECH             ,NJ,08629-0000,Private      ,0,3,3,18,,81,99
00686500,CAMDEN COUNTY COLLEGE                   ,NJ,08012-3240,Public       ,166,477,643,6950,,9804,16754
00690100,GLOUCESTER COUNTY COLLEGE               ,NJ,08080-4249,Public       ,80,147,227,4223,,3740,7963
00710700,ESSEX COUNTY COLLEGE                    ,NJ,07102-1798,Public       ,143,393,536,6772,,10569,17341
00750200,BERKELEY COLLEGE                        ,NJ,07424-3367,Proprietary  ,103,250,353,2746,,3892,6638
00750205,BERKELEY COLLEGE - CLIFTON              ,NJ,07011-2161,Proprietary  ,0,0,0,198,,580,778
00757302,NATURAL MOTION INST OF HAIR DESIGN      ,NJ,07306-5496,Proprietary  ,0,0,0,34,,90,124
00757309,EMPIRE BEAUTY SCHOOL - CHERRY HILL      ,NJ,08002-3711,Proprietary  ,0,0,0,88,,236,324
00759300,PARISIAN BEAUTY ACADEMY                 ,NJ,07601-5509,Proprietary  ,14,27,41,227,,308,535
00772900,COUNTY COLLEGE OF MORRIS                ,NJ,07869-0000,Public       ,65,95,160,4242,,2368,6610
00773000,BURLINGTON COUNTY COLLEGE               ,NJ,08068-1599,Public       ,95,328,423,4923,,5805,10728
00773100,RARITAN VALLEY COMMUNITY COLLEGE        ,NJ,08876-1265,Public       ,115,143,258,3227,,2645,5872
00780401,STAR CAREER ACADEMY - STAR LAKEWOOD     ,NJ,08701-5900,Proprietary  ,23,59,82,176,,519,695
00780402,STAR CAREER ACADEMY - STAR EGG HARBOR   ,NJ,08234-4863,Proprietary  ,9,43,52,107,,375,482
00793808,LINCOLN TECHNICAL INSTITUTE - SOUTH PLAI,NJ,07080-2424,Proprietary  ,10,27,37,207,,244,451
00793810,LINCOLN TECHNICAL INSTITUTE - MAHWAH    ,NJ,07430-2106,Proprietary  ,52,46,98,562,,391,953
00793811,LINCOLN TECHNICAL INSTITUTE - UNION     ,NJ,07083-5032,Proprietary  ,86,139,225,857,,1024,1881
00794700,BETH MEDRASH GOVOHA OF AMERICA          ,NJ,08701-0000,Private      ,106,177,283,449,,1940,2389
00840400,BROOKDALE COMMUNITY COLLEGE             ,NJ,07738-1597,Public       ,203,342,545,6466,,5052,11518
00844101,ANTHEM INSTITUTE                        ,NJ,08002-0000,Proprietary  ,18,63,81,151,,454,605
00849400,HO HO KUS SCHL OF TRADE & TECH SCIENCES ,NJ,07513-1402,Proprietary  ,17,29,46,146,,276,422
00860900,RABBINICAL COLLEGE OF AMERICA           ,NJ,07960-3600,Private      ,20,3,23,83,,11,94
00907800,CAPRI INSTITUTE OF HAIR DESIGN          ,NJ,07011-2111,Proprietary  ,9,30,39,123,,287,410
00934400,RAMAPO COLLEGE OF NEW JERSEY            ,NJ,07430-1680,Public       ,90,52,142,8178,,1734,9912
00934500,RICHARD STOCKTON COLLEGE OF NJ          ,NJ,08240-0000,Public       ,103,113,216,10097,,3814,13911
00945916,EMPIRE BEAUTY SCHOOL - HAIR DESIGN SCHOO,NJ,07712-4003,Proprietary  ,0,0,0,100,,184,284
00945917,EMPIRE BEAUTY SCHOOL - HAIR DESIGN SCHOO,NJ,07003-2517,Proprietary  ,0,0,0,15,,45,60
00945919,EMPIRE BEAUTY SCHOOL - HAIR DESIGN SCHOO,NJ,07083-3306,Proprietary  ,0,0,0,48,,112,160
00982804,EVEREST INSTITUTE - SOUTH PLAINFIELD    ,NJ,07080-1125,Proprietary  ,58,119,177,383,,767,1150
00999400,PASSAIC COUNTY COMMUNITY COLLEGE        ,NJ,07505-1179,Public       ,263,431,694,4942,,6110,11052
01062900,P B COSMETOLOGY EDUCATION CENTRE        ,NJ,08030-1750,Proprietary  ,1,11,12,111,,144,255
01085100,ANTHEM INSTITUTE                        ,NJ,07054-3409,Proprietary  ,69,203,272,423,,967,1390
01085101,ANTHEM INSTITUTE                        ,NJ,07306-0000,Proprietary  ,0,9,9,72,,198,270
01085102,ANTHEM INSTITUTE                        ,NJ,08902-0000,Proprietary  ,1,14,15,51,,132,183
01090300,RIZZIERI INSTITUTE                      ,NJ,08043-4600,Proprietary  ,13,25,38,155,,215,370
01152300,MORRIS COUNTY SCHOOL OF TECHNOLOGY      ,NJ,07834-0000,Public       ,0,2,2,49,,116,165
01198900,TALMUDICAL ACADEMY                      ,NJ,07710-0000,Private      ,2,0,2,60,,5,65
01209000,ROBERT FIANCE BEAUTY SCHOOLS            ,NJ,08861-4118,Proprietary  ,9,26,35,98,,171,269
01234602,DOVER BUSINESS COLLEGE                  ,NJ,07801-4643,Proprietary  ,0,0,0,81,,203,284
01246100,LINCOLN TECHNICAL INSTITUTE             ,NJ,08820-2896,Proprietary  ,24,73,97,377,,793,1170
01246102,LINCOLN TECHNICAL INSTITUTE             ,NJ,08057-3212,Proprietary  ,19,75,94,262,,781,1043
01246103,LINCOLN TECHNICAL INSTITUTE             ,NJ,07652-2106,Proprietary  ,14,76,90,435,,818,1253
01246200,HOHOKUS - HACKENSACK SCHOOL OF BUSINESS ,NJ,07601-7197,Proprietary  ,16,69,85,136,,548,684
01295400,HUDSON COUNTY COMMUNITY COLLEGE         ,NJ,07306-4012,Public       ,228,378,606,6073,,7381,13454
02053700,EASTWICK COLLEGE                        ,NJ,07446-0000,Proprietary  ,20,124,144,368,,1577,1945
02061800,ROMAN ACADEMY OF BEAUTY CULTURE         ,NJ,07506-0000,Proprietary  ,0,7,7,29,,33,62
02079414,EMPIRE BEAUTY SCHOOL - LAUREL SPRINGS   ,NJ,08021-5602,Proprietary  ,0,0,0,100,,210,310
02079415,EMPIRE BEAUTY SCHOOL - BORDENTOWN       ,NJ,08505-1513,Proprietary  ,0,0,0,16,,48,64
02092300,HOHOKUS SCHOOL - RETS/NUTLEY            ,NJ,07110-0000,Proprietary  ,28,50,78,238,,510,748
02103700,CAPRI INSTITUTE OF HAIR DESIGN          ,NJ,07652-0000,Proprietary  ,7,14,21,88,,118,206
02104000,HARRIS SCHOOL OF BUSINESS               ,NJ,08002-2983,Proprietary  ,83,360,443,451,,1845,2296
02106601,AMERICAN INSTITUTE - CLIFTON            ,NJ,07011-2345,Proprietary  ,36,110,146,280,,667,947
02106605,AMERICAN INSTITUTE - TOMS RIVER         ,NJ,08755-1524,Proprietary  ,22,95,117,80,,355,435
02131100,DU CRET SCHOOL OF THE ARTS              ,NJ,07060-0000,Private      ,3,1,4,31,,20,51
02131600,PENNCO TECH                             ,NJ,08012-0000,Proprietary  ,58,116,174,510,,924,1434
02132300,BERDAN INSTITUTE                        ,NJ,07512-0000,Proprietary  ,36,98,134,408,,691,1099
02146800,JOE KUBERT SCH OF CARTOON & GRAPHIC     ,NJ,07801-0000,Proprietary  ,0,2,2,120,,73,193
02154000,DIVERS ACAD OF EASTERN SEABOARD         ,NJ,08081-1139,Proprietary  ,12,35,47,111,,287,398
02183600,CAPRI INSTITUTE OF HAIR DESIGN          ,NJ,07033-0000,Proprietary  ,8,30,38,93,,171,264
02192200,THOMAS EDISON STATE COLLEGE             ,NJ,08608-0000,Public       ,29,779,808,758,,9766,10524
02219600,OMEGA INSTITUTE                         ,NJ,08109-0000,Proprietary  ,7,19,26,53,,207,260
02223700,ROBERT FIANCE BEAUTY SCHOOLS            ,NJ,07093-4623,Proprietary  ,14,53,67,64,,214,278
02223900,DRAKE COLLEGE OF BUSINESS               ,NJ,07201-0000,Proprietary  ,24,155,179,184,,1256,1440
02223902,DRAKE COLLEGE OF BUSINESS - NEWARK CAMPU,NJ,07112-2760,Proprietary  ,36,255,291,328,,1856,2184
02232500,UNION COUNTY VOCATIONAL TECH INST       ,NJ,07076-0000,Public       ,2,12,14,98,,146,244
02234600,ATLANTIC BEAUTY & SPA ACADEMY           ,NJ,08234-2621,Proprietary  ,9,20,29,82,,191,273
02246000,ROSS UNIVERSITY - MEDICAL SCHOOL        ,NJ,08837-0000,Proprietary  ,0,144,144,41,,4114,4155
02248600,COOPER HEALTH SYS-CTR ALLIED HEALTH     ,NJ,08103-0000,Private      ,5,16,21,158,,475,633
02265500,CAPRI INSTITUTE OF HAIR DESIGN          ,NJ,08724-0000,Proprietary  ,12,15,27,95,,164,259
02277900,ROSS UNIV - SCH OF VETERINARY MED       ,NJ,08837-0000,Proprietary  ,2,62,64,25,,1621,1646
02312000,BERGEN COUNTY TECHNICAL SCHOOLS         ,NJ,07601-6110,Public       ,5,13,18,117,,206,323
02503900,WARREN COUNTY COMMUNITY COLLEGE         ,NJ,07882-0000,Public       ,29,32,61,804,,796,1600
02523700,OCEAN COUNTY VOCATIONAL-TECH SCHOOL     ,NJ,08753-0000,Public       ,12,18,30,298,,531,829
02525900,ARTISTIC ACADEMY OF HAIR DESIGN         ,NJ,07950-1409,Proprietary  ,4,17,21,107,,141,248
02528200,ROBERT FIANCE BEAUTY SCHOOLS            ,NJ,07060-4840,Proprietary  ,9,23,32,66,,164,230
02558700,PRISM CAREER INSTITUTE                  ,NJ,08037-0000,Proprietary  ,13,75,88,119,,617,736
02568800,SUSSEX COUNTY COMMUNITY COLLEGE         ,NJ,07860-1149,Public       ,64,71,135,1700,,1211,2911
02586900,HARRIS SCHOOL OF BUSINESS               ,NJ,08043-2604,Proprietary  ,33,183,216,223,,984,1207
02616402,SANFORD-BROWN INSTITUTE - ISELIN        ,NJ,08830-0000,Proprietary  ,34,75,109,330,,759,1089
03077500,RABBI JACOB JOSEPH SCHOOL               ,NJ,08817-4494,Private      ,1,0,1,37,,9,46
03122600,EASTERN INTERNATIONAL COLLEGE           ,NJ,07306-3906,Proprietary  ,13,34,47,208,,561,769
03187300,STENOTECH CAREER INSTITUTE              ,NJ,07004-3490,Proprietary  ,1,6,7,24,,54,78
03197300,INSTITUTE FOR HEALTH EDUCATION(THE)     ,NJ,07306-2929,Proprietary  ,3,21,24,66,,230,296
03324300,CENTRAL CAREER SCHOOL                   ,NJ,07080-2408,Proprietary  ,7,37,44,51,,249,300
03380302,STAR CAREER ACADEMY - STAR NEWARK       ,NJ,07102-4510,Proprietary  ,31,110,141,267,,955,1222
03380303,STAR CAREER ACADEMY - STAR CLIFTON      ,NJ,07011-2248,Proprietary  ,9,55,64,77,,338,415
03389300,ACADEMY OF MASSAGE THERAPY              ,NJ,07631-0000,Proprietary  ,2,8,10,37,,120,157
03424500,NEW COMMUNITY WORKFORCE DEVELOPMENT     ,NJ,07103-2402,Private      ,0,0,0,61,,522,583
03536300,INSTITUTE FOR THERAPEUTIC MASSAGE       ,NJ,07420-1452,Proprietary  ,7,31,38,40,,157,197
03625300,PERFORMANCE TRAINING INSTITUTE          ,NJ,08753-0000,Proprietary  ,0,0,0,16,,50,66
03650600,PC AGE                                  ,NJ,07306-3936,Proprietary  ,6,33,39,65,,350,415
03650603,PC AGE                                  ,NJ,08817-2842,Proprietary  ,1,4,5,10,,62,72
03666300,PILLAR COLLEGE                          ,NJ,07102-5511,Private      ,9,90,99,101,,761,862
03803300,HEALTHCARE TRAINING INSTITUTE           ,NJ,07083-3504,Proprietary  ,5,46,51,103,,401,504
03811300,EASTERN SCHOOL OF ACUPUNCTURE AND TRADIT,NJ,07042-3562,Proprietary  ,0,12,12,5,,99,104
04081300,BAIS MEDRASH TORAS CHESED               ,NJ,08701-0000,Private      ,5,3,8,38,,22,60
04123400,YESHIVAS BE'ER YITZCHOK                 ,NJ,07208-2380,Private      ,0,1,1,24,,55,79
04125000,GENTLE HEALING SCHOOL OF MASSAGE        ,NJ,08512-3600,Proprietary  ,3,4,7,6,,45,51
04131100,YESHIVA TORAS CHAIM                     ,NJ,08701-2120,Private      ,5,1,6,189,,5,194
04131200,TOTAL IMAGE BEAUTY ACADEMY              ,NJ,07307-2943,Proprietary  ,1,16,17,29,,113,142
04134100,CENTER FOR ALLIED HEALTH & NURSING EDUCA,NJ,07601-5801,Proprietary  ,19,264,283,220,,2725,2945
04136400,AMERICAN INSTITUTE OF MEDICAL SCIENCES &,NJ,07080-1183,Proprietary  ,10,26,36,127,,332,459
04154500,STARTING POINTS FOR CHILDREN            ,NJ,07306-0001,Private      ,3,13,16,21,,134,155
04154900,NATIONAL CAREER INSTITUTE               ,NJ,07018-2011,Proprietary  ,2,40,42,27,,215,242
04154901,NATIONAL CAREER INSTITUTE - JERSEY CITY ,NJ,07306-4300,Proprietary  ,4,22,26,11,,51,62
04173100,LAB PAUL MITCHELL PARTNER SCHOOL (THE)  ,NJ,08628-2500,Proprietary  ,8,18,26,95,,141,236
04180300,MESIVTA KESER TORAH                     ,NJ,07719-2409,Private      ,7,1,8,22,,3,25
04181400,BEST CARE TRAINING INSTITUTE            ,NJ,07018-1703,Proprietary  ,4,26,30,23,,223,246
04184500,CHRISTINE VALMY INTERNATIONAL SCHOOL OF ,NJ,07058-9589,Proprietary  ,4,11,15,36,,81,117
04188700,ASI CAREER INSTITUTE                    ,NJ,08012-1043,Proprietary  ,3,39,42,24,,233,257
04191400,SCHOOL OF COURT REPORTING (THE)         ,NJ,08053-1533,Proprietary  ,0,0,0,6,,20,26
04192400,YESHIVA GEDOLAH ZICHRON LEYMA           ,NJ,07036-3905,Private      ,3,1,4,11,,6,17
04207500,MEDICAL CAREER INSTITUTE                ,NJ,07712-7202,Proprietary  ,2,21,23,32,,147,179
04216000,UNIVERSAL TRAINING INSTITUTE            ,NJ,08861-4106,Proprietary  ,4,8,12,31,,198,229
04216100,YESHIVA YESODEI HATORAH                 ,NJ,08701-4946,Private      ,25,1,26,28,,1,29
04216500,RIZZIERI INSTITUTE                      ,NJ,08043-1911,Proprietary  ,2,12,14,32,,86,118
04218200,PAUL MITCHELL THE SCHOOL - JERSEY SHORE ,NJ,08723-3413,Proprietary  ,15,11,26,95,,90,185
04218500,SALON PROFESSIONAL ACADEMY THE          ,NJ,07080-0000,Proprietary  ,2,21,23,18,,52,70
00266500,VAUGHN COLLEGE OF AERONAUTICS AND TECHNO,NY,11369-9997,Private      ,38,44,82,1392,,1102,2494
00266600,ADELPHI UNIVERSITY                      ,NY,11530-4299,Private      ,108,157,265,8981,,4766,13747
00266700,DOWLING COLLEGE                         ,NY,11769-1999,Private      ,26,52,78,2136,,1426,3562
00266800,ALFRED UNIVERSITY                       ,NY,14802-1205,Private      ,35,17,52,3947,,742,4689
00266900,BANK STREET COLLEGE OF EDUCATION        ,NY,10025-0000,Private      ,0,26,26,25,,843,868
00267100,BARD COLLEGE                            ,NY,12504-5000,Private      ,32,10,42,3116,,789,3905
00267400,NEW YORK THEOLOGICAL SEMINARY           ,NY,10115-0002,Private      ,1,18,19,5,,308,313
00267700,BROOKLYN LAW SCHOOL                     ,NY,11201-0000,Private      ,4,31,35,144,,2671,2815
00267800,BRYANT & STRATTON COLLEGE               ,NY,14203-1713,Proprietary  ,284,1739,2023,3227,,17028,20255
00267803,BRYANT & STRATTON COLLEGE - GREECE      ,NY,14606-4227,Proprietary  ,31,117,148,366,,1450,1816
00267805,BRYANT & STRATTON COLLEGE - SYRACUSE    ,NY,13203-2502,Proprietary  ,33,171,204,581,,1727,2308
00267807,BRYANT & STRATTON COLLEGE - ALBANY      ,NY,12205-5230,Proprietary  ,17,111,128,281,,1159,1440
00268100,CANISIUS COLLEGE                        ,NY,14208-1098,Private      ,30,56,86,4904,,1967,6871
00268500,CAZENOVIA COLLEGE                       ,NY,13035-1085,Private      ,16,3,19,2026,,244,2270
00268700,CUNY-BROOKLYN COLLEGE                   ,NY,11210-2814,Public       ,310,441,751,21626,,14104,35730
00268800,CITY COLLEGE-CUNY                       ,NY,10031-9198,Public       ,329,415,744,23396,,13227,36623
00268900,CUNY-HUNTER COLLEGE                     ,NY,10021-0000,Public       ,446,482,928,32448,,19247,51695
00269000,QUEENS COLLEGE-CUNY                     ,NY,11367-1597,Public       ,331,391,722,19777,,10274,30051
00269100,CUNY- BOROUGH OF MANHATTAN CMTY CLG     ,NY,10007-1047,Public       ,739,625,1364,32649,,19707,52356
00269200,CUNY BRONX COMMUNITY COLLEGE            ,NY,10453-3102,Public       ,389,458,847,13631,,12414,26045
00269300,CUNY-JOHN JAY CLG CRIMINAL JUSTICE      ,NY,10019-1093,Public       ,283,302,585,19018,,9821,28839
00269400,KINGSBOROUGH COMMUNITY COLLEGE          ,NY,11235-2398,Public       ,714,691,1405,17001,,10877,27878
00269600,NY CITY COLLEGE OF TECHNOLOGY-CUNY      ,NY,11201-2983,Public       ,408,428,836,20720,,11722,32442
00269700,QUEENSBOROUGH COMMUNITY COLLEGE         ,NY,11364-1497,Public       ,390,308,698,16401,,7775,24176
00269800,CUNY THE COLLEGE OF STATEN ISLAND       ,NY,10314-6600,Public       ,254,184,438,14154,,5747,19901
00269900,CLARKSON UNIVERSITY                     ,NY,13699-5615,Private      ,40,9,49,6343,,544,6887
00270000,COLGATE ROCHESTER CROZER DIVINITY S     ,NY,14620-0000,Private      ,0,3,3,8,,87,95
00270100,COLGATE UNIVERSITY                      ,NY,13346-1386,Private      ,37,2,39,4464,,106,4570
00270300,COLLEGE OF MOUNT SAINT VINCENT          ,NY,10471-1093,Private      ,34,20,54,2796,,614,3410
00270400,COLLEGE OF NEW ROCHELLE                 ,NY,10805-2339,Private      ,45,350,395,1339,,4803,6142
00270500,COLLEGE OF SAINT ROSE                   ,NY,12203-1490,Private      ,43,90,133,4986,,1942,6928
00270700,COLUMBIA UNIVERSITY                     ,NY,10027-0000,Private      ,226,403,629,24037,,23046,47083
00270800,BARNARD COLLEGE-COLUMBIA UNIV           ,NY,10027-6598,Private      ,37,18,55,4604,,515,5119
00270900,CONCORDIA COLLEGE                       ,NY,10708-1998,Private      ,7,19,26,1053,,590,1643
00271000,COOPER UNION                            ,NY,10003-7120,Private      ,16,10,26,1831,,374,2205
00271100,CORNELL UNIVERSITY                      ,NY,14853-2801,Private      ,200,108,308,30107,,6561,36668
00271101,WEILL CORNELL MEDICAL COLLEGE AND GRADUA,NY,10021-0000,Private      ,1,34,35,48,,805,853
00271200,D'YOUVILLE COLLEGE                      ,NY,14201-1084,Private      ,15,46,61,2107,,2437,4544
00271300,DOMINICAN COLLEGE                       ,NY,10962-1299,Private      ,20,63,83,1860,,1078,2938
00271800,ELMIRA COLLEGE                          ,NY,14901-2099,Private      ,13,9,22,2411,,404,2815
00272200,FORDHAM UNIVERSITY                      ,NY,10458-5157,Private      ,214,210,424,26402,,9742,36144
00272600,GENERAL THEOLOGICAL SEMINARY            ,NY,10011-0000,Private      ,1,1,2,2,,81,83
00272800,HAMILTON COLLEGE                        ,NY,13323-1218,Private      ,20,2,22,3197,,98,3295
00272900,HARTWICK COLLEGE                        ,NY,13820-4020,Private      ,37,5,42,4357,,214,4571
00273100,HOBART & WILLIAM SMITH COLLEGES         ,NY,14456-3397,Private      ,23,4,27,3528,,110,3638
00273200,HOFSTRA UNIVERSITY                      ,NY,11549-1010,Private      ,227,126,353,19038,,5798,24836
00273400,HOUGHTON COLLEGE                        ,NY,14744-0128,Private      ,5,12,17,1371,,213,1584
00273500,HILBERT COLLEGE                         ,NY,14075-1597,Private      ,9,14,23,1161,,388,1549
00273700,IONA COLLEGE                            ,NY,10801-1890,Private      ,66,36,102,6932,,1241,8173
00273900,ITHACA COLLEGE                          ,NY,14850-7130,Private      ,102,20,122,14990,,1160,16150
00274000,JEWISH THEOLOGICAL SEMINARY OF AMER     ,NY,10027-4649,Private      ,0,0,0,109,,165,274
00274200,THE JUILLIARD SCHOOL                    ,NY,10023-6588,Private      ,13,10,23,1686,,848,2534
00274400,KEUKA COLLEGE                           ,NY,14478-0000,Private      ,16,69,85,1738,,1483,3221
00274800,LEMOYNE COLLEGE                         ,NY,13214-1399,Private      ,53,43,96,5074,,1016,6090
00274900,NEW YORK COLLEGE OF PODIATRIC MED       ,NY,10035-1940,Private      ,1,6,7,54,,465,519
00275100,LONG ISLAND UNIVERSITY                  ,NY,11548-1326,Private      ,178,407,585,13238,,11323,24561
00275800,MANHATTAN COLLEGE                       ,NY,10471-4098,Private      ,66,37,103,7022,,882,7904
00275900,MANHATTAN SCHOOL OF MUSIC               ,NY,10027-4689,Private      ,5,13,18,733,,701,1434
00276000,MANHATTANVILLE COLLEGE                  ,NY,10577-2132,Private      ,39,51,90,3268,,876,4144
00276300,MARIA COLLEGE                           ,NY,12208-1798,Private      ,10,61,71,245,,965,1210
00276500,MARIST COLLEGE                          ,NY,12601-1387,Private      ,86,71,157,10455,,1699,12154
00276900,MARYMOUNT MANHATTAN COLLEGE             ,NY,10021-4597,Private      ,46,18,64,4010,,427,4437
00277200,MERCY COLLEGE                           ,NY,10522-1189,Private      ,124,361,485,6404,,8363,14767
00277500,MOLLOY COLLEGE                          ,NY,11570-1100,Private      ,43,74,117,4289,,2634,6923
00277700,MEDAILLE COLLEGE                        ,NY,14214-2695,Private      ,16,83,99,1853,,1804,3657
00277800,MOUNT SAINT MARY COLLEGE                ,NY,12550-3494,Private      ,33,61,94,3867,,1330,5197
00277900,NAZARETH COLLEGE OF ROCHESTER           ,NY,14618-3790,Private      ,32,21,53,3899,,1645,5544
00278200,NEW YORK INSTITUTE OF TECHNOLOGY        ,NY,11568-8000,Private      ,103,112,215,6021,,2866,8887
00278202,NY INSTITUTE OF TECHNOLOGY-OSTEOPATHIC M,NY,11568-0000,Private      ,1,3,4,40,,1148,1188
00278300,NEW YORK LAW SCHOOL                     ,NY,10013-0000,Private      ,2,18,20,106,,2561,2667
00278400,NEW YORK MEDICAL COLLEGE                ,NY,10595-0000,Private      ,1,10,11,53,,2049,2102
00278500,NEW YORK UNIVERSITY                     ,NY,10012-1091,Private      ,471,673,1144,43080,,30430,73510
00278520,NEW YORK UNIVERSITY - BROOKLYN          ,NY,11201-3840,Private      ,31,59,90,4007,,1292,5299
00278800,NIAGARA UNIVERSITY                      ,NY,14109-2010,Private      ,18,31,49,4090,,975,5065
00279000,NYACK COLLEGE                           ,NY,10960-3698,Private      ,17,138,155,1544,,2154,3698
00279100,PACE UNIVERSITY - NEW YORK              ,NY,10038-1598,Private      ,150,201,351,12718,,4945,17663
00279101,PACE UNIVERSITY-PLEASANTVILLE           ,NY,10570-0000,Private      ,41,58,99,4268,,1511,5779
00279102,PACE UNIVERSITY - WHITE PLAINS          ,NY,10603-0000,Private      ,14,45,59,598,,1815,2413
00279500,PAUL SMITHS CLG OF ARTS & SCIENCES      ,NY,12970-0000,Private      ,9,0,9,1337,,177,1514
00279800,PRATT INSTITUTE                         ,NY,11205-3899,Private      ,48,57,105,5349,,2605,7954
00280300,RENSSELAER POLYTECHNIC INSTITUTE        ,NY,12180-3590,Private      ,93,23,116,12285,,764,13049
00280500,ROBERTS WESLEYAN COLLEGE                ,NY,14624-1997,Private      ,12,85,97,1375,,1458,2833
00280600,ROCHESTER INSTITUTE OF TECHNOLOGY       ,NY,14623-5608,Private      ,131,67,198,16872,,3179,20051
00280700,ROCKEFELLER UNIVERSITY                  ,NY,10021-0000,Private      ,2,4,6,38,,61,99
00280800,DAEMEN COLLEGE                          ,NY,14226-3592,Private      ,22,57,79,2904,,1376,4280
00281000,THE SAGE COLLEGES                       ,NY,12180-4199,Private      ,18,46,64,2083,,2020,4103
00281200,TROCAIRE COLLEGE                        ,NY,14220-2094,Private      ,15,61,76,936,,1887,2823
00281300,SARAH LAWRENCE COLLEGE                  ,NY,10708-5999,Private      ,23,14,37,2201,,632,2833
00281400,SKIDMORE COLLEGE                        ,NY,12866-1632,Private      ,31,4,35,5013,,180,5193
00281500,ST BERNARDS SCH THEOLOGY & MINISTRY     ,NY,14618-3822,Private      ,0,0,0,3,,46,49
00281600,SIENA COLLEGE                           ,NY,12211-1462,Private      ,33,11,44,6670,,378,7048
00281700,ST BONAVENTURE UNIVERSITY               ,NY,14778-2284,Private      ,20,10,30,3043,,583,3626
00282000,ST FRANCIS COLLEGE                      ,NY,11201-4398,Private      ,54,33,87,3337,,917,4254
00282100,ST JOHN FISHER COLLEGE                  ,NY,14618-3597,Private      ,35,47,82,5065,,2006,7071
00282200,CHRIST THE KING SEMINARY                ,NY,14052-0607,Private      ,0,0,0,3,,9,12
00282300,ST JOHN'S UNIVERSITY                    ,NY,11439-1343,Private      ,277,133,410,27452,,7141,34593
00282500,ST JOSEPH'S COLLEGE                     ,NY,11205-3688,Private      ,20,47,67,1840,,1013,2853
00282501,ST JOSEPH'S COLLEGE-SUFFOLK CAMPUS      ,NY,11772-0000,Private      ,50,92,142,3287,,1791,5078
00282900,ST LAWRENCE UNIVERSITY                  ,NY,13617-1455,Private      ,15,5,20,2905,,154,3059
00283200,ST THOMAS AQUINAS COLLEGE               ,NY,10976-1050,Private      ,32,14,46,2041,,327,2368
00283300,ST VLADIMIR ORTHODOX THEOL SEM          ,NY,10707-0000,Private      ,0,1,1,0,,49,49
00283400,EXCELSIOR COLLEGE                       ,NY,12203-5159,Private      ,41,1337,1378,520,,12804,13324
00283500,SUNY AT ALBANY                          ,NY,12222-0001,Public       ,237,119,356,22873,,5639,28512
00283600,BINGHAMTON UNIVERSITY (SUNY)            ,NY,13902-6000,Public       ,243,70,313,26797,,3307,30104
00283700,SUNY AT BUFFALO                         ,NY,14260-0001,Public       ,273,208,481,26227,,10350,36577
00283800,SUNY AT STONY BROOK                     ,NY,11794-0701,Public       ,368,240,608,30366,,9003,39369
00283900,SUNY-DOWNSTATE MEDICAL CENTER           ,NY,11203-2098,Public       ,1,58,59,305,,2690,2995
00284000,SUNY UPSTATE MEDICAL UNIVERSITY         ,NY,13210-2375,Public       ,6,30,36,323,,1612,1935
00284100,SUNY BROCKPORT - FIN AID OFF            ,NY,14420-2914,Public       ,97,93,190,10467,,3160,13627
00284200,BUFFALO STATE COLLEGE - SUNY            ,NY,14222-1095,Public       ,196,176,372,14370,,5710,20080
00284300,SUNY COLLEGE-CORTLAND                   ,NY,13045-0900,Public       ,88,33,121,12465,,1543,14008
00284400,SUNY AT FREDONIA                        ,NY,14063-1145,Public       ,71,22,93,7749,,1090,8839
00284500,SUNY GENESEO                            ,NY,14454-1401,Public       ,70,16,86,9265,,695,9960
00284600,SUNY COLLEGE-NEW PALTZ                  ,NY,12561-2499,Public       ,122,54,176,12984,,2352,15336
00284700,SUNY COLLEGE-ONEONTA                    ,NY,13820-4015,Public       ,95,20,115,12153,,903,13056
00284800,SUNY OSWEGO                             ,NY,13126-3599,Public       ,122,72,194,11981,,2229,14210
00284900,SUNY COLLEGE AT PLATTSBURGH             ,NY,12901-2681,Public       ,81,43,124,8653,,1610,10263
00285000,SUNY COLLEGE-POTSDAM                    ,NY,13676-2294,Public       ,57,28,85,5927,,1004,6931
00285100,SUNY COLLEGE OF ENVIRONMENT SCIENCE AND ,NY,13210-2778,Public       ,17,10,27,2321,,621,2942
00285300,SUNY MARITIME COLLEGE                   ,NY,10465-4198,Public       ,23,15,38,1939,,367,2306
00285400,SUNY COLLEGE OF TECHNOLOGY-ALFRED       ,NY,14802-9951,Public       ,42,37,79,5001,,1134,6135
00285500,SUNY CANTON COLG OF TECHNOLOGY          ,NY,13617-1098,Public       ,29,49,78,4071,,1756,5827
00285600,SUNY AG & TECH COLLEGE-COBLESKILL       ,NY,12043-9986,Public       ,32,14,46,3319,,677,3996
00285700,SUNY DELHI                              ,NY,13753-1190,Public       ,47,63,110,4293,,1303,5596
00285800,SUNY FARMINGDALE                        ,NY,11735-1021,Public       ,128,117,245,7923,,3087,11010
00285900,SUNY COLLEGE OF AG & TECH AT MORRISVILLE,NY,13408-0901,Public       ,64,38,102,4279,,1076,5355
00286000,ADIRONDACK COMMUNITY COLLEGE            ,NY,12804-2004,Public       ,79,104,183,2448,,2042,4490
00286100,CAYUGA COMMUNITY COLLEGE                ,NY,13021-3099,Public       ,63,155,218,2096,,2611,4707
00286200,BROOME COMMUNITY COLLEGE                ,NY,13902-0000,Public       ,90,180,270,3705,,3262,6967
00286300,CORNING COMMUNITY COLLEGE               ,NY,14830-3297,Public       ,58,91,149,2089,,2103,4192
00286400,DUTCHESS COMMUNITY COLLEGE              ,NY,12601-1595,Public       ,139,151,290,4897,,2869,7766
00286600,FASHION INSTITUTE OF TECHNOLOGY         ,NY,10001-5992,Public       ,130,107,237,10007,,4114,14121
00286700,SUNY FULTON MONTGOMERY COMM CLG         ,NY,12095-3790,Public       ,52,53,105,2003,,1303,3306
00286800,HUDSON VALLEY COMMUNITY COLLEGE         ,NY,12180-6096,Public       ,161,250,411,7168,,5506,12674
00286900,JAMESTOWN COMMUNITY COLLEGE             ,NY,14702-0020,Public       ,48,64,112,2708,,2114,4822
00287000,JEFFERSON COMMUNITY COLLEGE             ,NY,13601-1897,Public       ,43,192,235,1705,,3221,4926
00287100,"SUNY, MOHAWK VALLEY COMMUNITY CLG       ",NY,13501-5394,Public       ,97,192,289,4629,,4107,8736
00287200,MONROE COMMUNITY COLLEGE                ,NY,14623-5780,Public       ,218,404,622,11003,,11031,22034
00287300,NASSAU COMMUNITY COLLEGE                ,NY,11530-6793,Public       ,393,345,738,14025,,8349,22374
00287400,NIAGARA COUNTY COMMUNITY COLLEGE        ,NY,14132-9460,Public       ,70,86,156,4306,,3138,7444
00287500,ONONDAGA COMMUNITY COLLEGE              ,NY,13215-4585,Public       ,184,277,461,7804,,5278,13082
00287600,ORANGE COUNTY COMMUNITY COLLEGE         ,NY,10940-6441,Public       ,113,134,247,3525,,2816,6341
00287700,ROCKLAND COMMUNITY COLLEGE              ,NY,10901-3611,Public       ,129,168,297,3095,,2485,5580
00287800,SUFFOLK COMMUNITY COLLEGE               ,NY,11784-2899,Public       ,163,166,329,8133,,4251,12384
00287801,SUFFOLK COMMUNITY CLG-W. CAMPUS         ,NY,11717-0000,Public       ,106,151,257,5671,,3935,9606
00287803,SUFFOLK COMMUNITY CLG-EASTRN CAMPUS     ,NY,11901-0000,Public       ,45,65,110,2125,,1416,3541
00287900,SULLIVAN COUNTY COMMUNITY COLLEGE       ,NY,12759-5151,Public       ,36,32,68,1557,,849,2406
00288000,ULSTER COUNTY COMMUNITY COLLEGE         ,NY,12484-0557,Public       ,43,42,85,1399,,1250,2649
00288100,SUNY WESTCHESTER COMMUNITY COLLEGE      ,NY,10595-1698,Public       ,231,270,501,7494,,5998,13492
00288200,SYRACUSE UNIVERSITY                     ,NY,13244-2130,Private      ,234,205,439,27298,,6833,34131
00288300,UTICA COLLEGE- UTICA                    ,NY,13502-4892,Private      ,38,98,136,4084,,2482,6566
00288500,ALBANY COLLEGE OF PHARMACY AND HEALTH SC,NY,12208-3492,Private      ,14,10,24,2006,,924,2930
00288600,ALBANY LAW SCHOOL                       ,NY,12208-0000,Private      ,0,7,7,79,,1056,1135
00288700,ALBANY MEDICAL COLLEGE                  ,NY,12208-0000,Private      ,1,7,8,137,,1356,1493
00288900,UNION COLLEGE                           ,NY,12308-2311,Private      ,26,7,33,3999,,193,4192
00289000,UNION THEOLOGICAL SEMINARY              ,NY,10027-0000,Private      ,1,3,4,1,,311,312
00289200,UNITED STATES MERCHANT MARINE ACADEMY   ,NY,11024-1699,Public       ,5,1,6,465,,25,490
00289400,UNIVERSITY OF ROCHESTER                 ,NY,14627-9000,Private      ,69,102,171,10103,,2276,12379
00289401,EASTMAN SCH OF MUSIC/UNIV ROCHESTER     ,NY,14604-0000,Private      ,4,8,12,865,,484,1349
00289402,UNIV OF ROCHESTER SCHL OF MEDICINE      ,NY,14642-0000,Private      ,2,7,9,92,,765,857
00289500,VASSAR COLLEGE                          ,NY,12604-0008,Private      ,33,7,40,5076,,244,5320
00289600,VILLA MARIA COLLEGE-BUFFALO             ,NY,14225-3999,Private      ,7,12,19,492,,371,863
00289900,WAGNER COLLEGE                          ,NY,10301-4495,Private      ,37,15,52,3186,,669,3855
00290000,WEBB INSTITUTE                          ,NY,11542-1398,Private      ,0,0,0,91,,12,103
00290100,WELLS COLLEGE                           ,NY,13026-0500,Private      ,18,1,19,1435,,104,1539
00290300,YESHIVA UNIVERSITY                      ,NY,10033-3201,Private      ,22,30,52,2482,,2760,5242
00290302,YESHIVA UNIVERSITY - BRONX CAMPUS       ,NY,10461-1975,Private      ,6,7,13,112,,1387,1499
00397400,MESIVTHA TIFERETH JERUSALEM OF AMER     ,NY,10002-6382,Private      ,3,1,4,33,,2,35
00397600,RABBINICAL ACAD MESIVTA RABBI CHAIM     ,NY,11230-4715,Private      ,17,0,17,39,,1,40
00397700,RABBINICAL COLLEGE CH'SAN SOFER         ,NY,11204-1252,Private      ,0,1,1,3,,30,33
00397800,RABBINICAL SEMINARY OF AMERICA          ,NY,11375-0000,Private      ,11,7,18,77,,36,113
00397900,COLUMBIA UNIV TEACHERS COLLEGE          ,NY,10027-0000,Private      ,7,224,231,148,,5534,5682
00405400,HEBREW UNION COL-JEWISH INST OF REL     ,NY,10012-0000,Private      ,0,3,3,1,,241,242
00475900,"CUNY, YORK COLLEGE                      ",NY,11451-0001,Public       ,223,189,412,13831,,7153,20984
00476500,CUNY GRADUATE SCH & UNIV CTR            ,NY,10016-4309,Public       ,3,128,131,161,,3449,3610
00477600,CENTRAL YESHIVA TOMCHEI TMIMIM LUBA     ,NY,11230-2798,Private      ,185,7,192,353,,38,391
00478800,HERKIMER COUNTY COMMUNITY COLLEGE       ,NY,13350-1598,Public       ,41,57,98,2328,,1603,3931
00479800,MIRRER YESHIVA CENTRAL INST             ,NY,11223-2010,Private      ,12,3,15,82,,29,111
00479900,MONROE COLLEGE                          ,NY,10468-4305,Proprietary  ,220,340,560,5335,,6812,12147
00481100,EVEREST INSTITUTE                       ,NY,14621-3007,Proprietary  ,19,112,131,188,,1098,1286
00506400,SAINT JAMES MERCY HOSPITAL SCHOOL OF RAD,NY,14843-2197,Private      ,0,0,0,23,,28,51
00506600,FAXTON ST. LUKE'S SCHOOL OF RADIOGRAPHY ,NY,13502-4856,Private      ,0,0,0,24,,40,64
00520800,THE COLLEGE OF WESTCHESTER              ,NY,10602-0000,Proprietary  ,33,64,97,1007,,1037,2044
00587700,ROBERT J HOCHSTIM SCHOOL OF RADIOG      ,NY,11572-1151,Private      ,0,0,0,0,,14,14
00643501,ARNOT OGDEN MEDICAL CENTER              ,NY,14905-1676,Private      ,1,1,2,59,,85,144
00643800,PHILLIPS BETH ISRAEL SCH OF NURSING     ,NY,10001-6354,Private      ,3,9,12,110,,421,531
00644300,COCHRAN SCH NSG-ST JOHN RVSDE HOSP      ,NY,10701-1399,Private      ,0,4,4,39,,198,237
00644500,CROUSE HOSP SCH OF NURSING              ,NY,13210-1690,Private      ,4,12,16,246,,445,691
00644800,ELLIS HOSPITAL SCHOOL OF NURSING        ,NY,12308-0000,Private      ,0,8,8,81,,254,335
00646101,ST ELIZABETH COLLEGE OF NURSING         ,NY,13501-2998,Private      ,1,2,3,144,,198,342
00646102,ST ELIZABETH SCH OF RADIOGRAPHY         ,NY,13501-0000,Private      ,0,2,2,20,,34,54
00646700,SAINT JOSEPH'S COLLEGE OF NURSING       ,NY,13203-1806,Private      ,5,9,14,259,,359,618
00678200,GENESEE COMMUNITY COLLEGE               ,NY,14020-9704,Public       ,42,133,175,3202,,3034,6236
00678500,SCHENECTADY COUNTY COMMUNITY CLG        ,NY,12305-2294,Public       ,78,171,249,2707,,2807,5514
00678700,CLINTON COMMUNITY COLLEGE               ,NY,12901-5690,Public       ,38,40,78,1299,,785,2084
00678800,TOMPKINS CORTLAND COMMUNITY COLLEGE     ,NY,13053-8504,Public       ,62,72,134,2946,,1821,4767
00678900,COLUMBIA-GREENE COMMUNITY COLLEGE       ,NY,12534-9543,Public       ,40,65,105,1025,,1087,2112
00679100,SUNY AT PURCHASE                        ,NY,10577-1400,Public       ,98,30,128,8127,,1255,9382
00702200,CUNY-LEHMAN COLLEGE                     ,NY,10468-1589,Public       ,236,341,577,15471,,13570,29041
00702600,MOUNT SINAI SCHOOL OF MEDICINE          ,NY,10029-0000,Private      ,3,13,16,46,,1086,1132
00710900,SUNY COLLEGE-OLD WESTBURY               ,NY,11568-0210,Public       ,88,61,149,6242,,2531,8773
00711100,NORTH COUNTRY COMMUNITY COLLEGE         ,NY,12983-2046,Public       ,15,26,41,725,,676,1401
00726400,MESIFTA TORAH VODAATH RABBINCAL SEM     ,NY,11218-5209,Private      ,6,60,66,23,,113,136
00727300,CUNY-BERNARD BARUCH COLLEGE             ,NY,10010-5518,Public       ,286,317,603,20338,,11089,31427
00730400,CULINARY INSTITUTE OF AMERICA           ,NY,12538-1499,Private      ,173,102,275,3920,,1720,5640
00732916,ITT TECHNICAL INSTITUTE                 ,NY,12205-1003,Proprietary  ,17,76,93,198,,693,891
00737200,AUSTIN'S SCHOOL OF SPA TECHNOLOGY       ,NY,12206-1513,Proprietary  ,13,64,77,151,,491,642
00737500,ISLAND DRAFTING & TECHNICAL INST        ,NY,11701-2704,Proprietary  ,3,7,10,63,,75,138
00738700,LONG ISLAND BEAUTY SCHOOL               ,NY,11788-4346,Proprietary  ,27,49,76,215,,360,575
00738800,LONG ISLAND BEAUTY SCHOOL               ,NY,11550-3704,Proprietary  ,12,32,44,63,,188,251
00739100,BEAUTY SCHOOL OF MIDDLETOWN             ,NY,10940-6574,Proprietary  ,3,11,14,55,,101,156
00739400,BERKELEY COLLEGE                        ,NY,10017-0000,Proprietary  ,122,362,484,3557,,4893,8450
00740100,MANDL SCHOOL                            ,NY,10019-5516,Proprietary  ,17,75,92,335,,1078,1413
00740500,WOOD TOBE-COBURN SCHOOL                 ,NY,10016-0102,Proprietary  ,14,4,18,630,,163,793
00746500,AMERICAN ACADEMY OF DRAMATIC ARTS       ,NY,10016-7089,Private      ,19,14,33,1215,,455,1670
00746600,LIM COLLEGE                             ,NY,10022-5268,Proprietary  ,27,21,48,2529,,604,3133
00746800,SCHOOL OF VISUAL ARTS                   ,NY,10010-3994,Proprietary  ,40,38,78,4120,,1780,5900
00751800,APEX TECHNICAL SCHOOL                   ,NY,10011-0000,Proprietary  ,108,297,405,657,,1746,2403
00752200,CONTINENTAL SCH OF BEAUTY CULTURE       ,NY,14623-3231,Proprietary  ,28,102,130,243,,670,913
00752205,CONTINENTAL SCHOOL OF BEAUTY CULTURE - M,NY,13211-1003,Proprietary  ,0,3,3,29,,57,86
00753200,FINGER LAKES COMMUNITY COLLEGE          ,NY,14424-8395,Public       ,59,123,182,3653,,3028,6681
00757200,AMERICAN MUSICAL AND DRAMATIC ACAD      ,NY,10023-2106,Private      ,59,16,75,2774,,594,3368
00757300,EMPIRE BEAUTY SCHOOL                    ,NY,11103-4028,Proprietary  ,61,228,289,362,,902,1264
00780400,STAR CAREER ACADEMY                     ,NY,10011-7307,Proprietary  ,33,128,161,222,,982,1204
00793809,LINCOLN TECHNICAL INSTITUTE - WHITESTONE,NY,11357-6092,Proprietary  ,58,61,119,673,,432,1105
00818900,CONTINENTAL SCHOOL OF BEAUTY CULTURE - B,NY,14224-3402,Proprietary  ,9,16,25,56,,124,180
00818903,CONTINENTAL SCHOOL OF BEAUTY CULTURE - B,NY,14223-2911,Proprietary  ,5,13,18,106,,206,312
00843700,CHAMPLAIN VALLEY - TEC/PRN              ,NY,12901-0000,Public       ,0,3,3,31,,72,103
00849500,JAMESTOWN BUSINESS COLLEGE              ,NY,14702-0429,Proprietary  ,7,34,41,201,,316,517
00861100,"CUNY, HOSTOS CMTY COLLEGE               ",NY,10451-1499,Public       ,204,259,463,10158,,9032,19190
00861400,RABBINICAL CLG BOBOVER YESHIVA BNEI     ,NY,11219-3293,Private      ,30,13,43,142,,55,197
00861700,RABBINICAL SEM MKOR CHAIM-YESHIVA       ,NY,11219-4300,Private      ,0,0,0,0,,2,2
00878800,STATE UNIVERSITY OF NEW YORK STUDENT LOA,NY,12246-0000,Public       ,6,13,19,581,,374,955
00900300,OLEAN BUSINESS INSTITUTE INC            ,NY,14760-2691,Proprietary  ,0,0,0,21,,56,77
00902900,NEIGHBORHOOD PLAYHOUSE                  ,NY,10022-5017,Private      ,1,2,3,29,,56,85
00904300,ELMIRA BUSINESS INSTITUTE               ,NY,14901-2731,Proprietary  ,21,115,136,128,,867,995
00907700,UTICA SCHOOL OF COMMERCE                ,NY,13501-2280,Proprietary  ,1,50,51,117,,458,575
00924800,SAMARITAN HOSPITAL SCH NURSING          ,NY,12180-2475,Private      ,1,9,10,84,,277,361
00928300,MIDWAY-PARIS BEAUTY SCHOOL              ,NY,11385-3453,Proprietary  ,2,20,22,36,,146,182
00928400,BRITTANY BEAUTY SCHOOL                  ,NY,11756-1345,Proprietary  ,14,41,55,128,,293,421
00933500,MESIVTA EASTERN PKWY RABBINICAL CLG     ,NY,11218-5559,Private      ,5,0,5,30,,9,39
00947900,SAINT VINCENTS CMC SI NURSING SCHOOL    ,NY,10304-3850,Proprietary  ,17,30,47,369,,801,1170
00976900,METROPOLITAN COLLEGE OF NEW YORK        ,NY,10013-1919,Private      ,11,117,128,318,,2182,2500
00992900,SUNY COLLEGE OF OPTOMETRY               ,NY,10036-8003,Public       ,1,5,6,25,,385,410
01005100,LA GUARDIA CMTY COLLEGE - CUNY          ,NY,11101-3083,Public       ,701,728,1429,19511,,13064,32575
01005200,JEFFERSON-LEWIS BOCES PRAC NRSGPRG      ,NY,13601-9509,Public       ,1,8,9,45,,210,255
01009700,CUNY-MEDGAR W EVERS COLLEGE             ,NY,11225-2010,Public       ,209,301,510,8310,,7154,15464
01014200,TOURO COLLEGE                           ,NY,10010-4202,Private      ,183,498,681,3691,,10351,14042
01014700,WESTERN SUFFOLK BOCES                   ,NY,11768-3499,Public       ,18,37,55,183,,463,646
01015300,HELENE FULD COL OF NRSNG/N GEN HOSP     ,NY,10035-0000,Private      ,4,76,80,50,,846,896
01028600,EMPIRE STATE COLLEGE                    ,NY,12866-4391,Public       ,60,670,730,1186,,13700,14886
01037800,RABBINICAL COLLEGE OF LONG ISLAND       ,NY,11561-3244,Private      ,14,0,14,56,,3,59
01054900,KEHILATH YAKOV RABBINICAL SEMINARY      ,NY,10562-1001,Private      ,5,9,14,46,,15,61
01055100,NEW YORK SCH MED & DENTAL ASSISTANT     ,NY,11101-2327,Proprietary  ,24,51,75,169,,367,536
01064100,SOUTHERN WESTCHESTER BOCES              ,NY,10543-0000,Public       ,1,5,6,32,,209,241
01068400,ERIE COMMUNITY COLLEGE-ALL CAMPUSES     ,NY,14203-2698,Public       ,256,331,587,8860,,8767,17627
01081300,AMERICAN ACAD MCALLISTER INST           ,NY,10019-3604,Private      ,4,23,27,165,,663,828
01083700,SIMMONS INST OF FUNERAL SERVICE         ,NY,13207-2098,Proprietary  ,1,0,1,8,,45,53
01094300,RABBINICAL COLLEGE BETH SHRAGA          ,NY,10952-3033,Private      ,3,0,3,12,,0,12
01095200,PNW BOCES LPN PROGRAM                   ,NY,10598-0000,Public       ,0,1,1,18,,59,77
01103100,TECHNICAL CAREER INSTITUTE              ,NY,10001-2789,Proprietary  ,124,391,515,1411,,3593,5004
01118900,UNITED TALMUDICAL SEMINARY              ,NY,11211-7984,Private      ,387,252,639,984,,542,1526
01119200,BETH HAMEDRASH SHAAREI YOSHER INST      ,NY,11204-1052,Private      ,4,4,8,12,,27,39
01161400,CHAMPLAIN VALLEY HOSP SCH RAD TECH      ,NY,12901-1490,Private      ,0,0,0,23,,27,50
01161700,NEW YORK METHODIST HOSPITAL             ,NY,11229-9023,Private      ,4,31,35,139,,531,670
01164700,SBI CAMPUS - AN AFFILIATE OF SANFORD-BRO,NY,11747-3785,Proprietary  ,11,35,46,177,,392,569
01167000,YESHIVA OF NITRA RABBINICAL COLLEGE -   ,NY,10549-4112,Private      ,79,6,85,141,,6,147
01167700,MEMORIAL SLOAN KETTERING CANCER CTR     ,NY,10021-6094,Private      ,0,3,3,9,,53,62
01167800,SUNY INST OF TECHNOLOGY UTICA ROME      ,NY,13504-3050,Public       ,24,29,53,2211,,1317,3528
01182100,YESHIVATH ZICHRON MOSHE                 ,NY,12779-0580,Private      ,14,0,14,123,,1,124
01183000,BERK TRADE AND BUSINESS SCHOOL          ,NY,11101-0000,Proprietary  ,16,35,51,108,,265,373
01185900,WORD OF LIFE BIBLE INSTITUTE            ,NY,12860-0129,Private      ,10,1,11,551,,92,643
01186000,MERCY MED CNTR SCHL OF RADIOGRAPHY      ,NY,11570-1098,Private      ,0,3,3,21,,40,61
01192100,WESTCHESTER SCH OF BEAUTY CULTURE       ,NY,10550-2295,Proprietary  ,7,14,21,58,,141,199
01192200,BETH HATALMUD RABBINICAL CLG            ,NY,11214-2594,Private      ,33,2,35,45,,11,56
01198400,OHR HAMEIR THEOLOGICAL SEMINARY         ,NY,10566-0990,Private      ,29,0,29,67,,1,68
01201100,TALMUDICAL SEM OHOLEI TORAH             ,NY,11213-3310,Private      ,64,1,65,216,,1,217
01210700,INSTITUTE OF DESIGN & CONSTRUCTION      ,NY,11201-5380,Private      ,1,21,22,60,,192,252
01220300,MEMORIAL HOSPITAL SCH OF NURSING        ,NY,12204-1083,Private      ,0,7,7,61,,236,297
01227700,NEW YORK CHIROPRACTIC COLLEGE           ,NY,13148-0800,Private      ,0,18,18,17,,894,911
01229300,VEEB NASSAU CNTY SCHL OF PRACT NURS     ,NY,11553-3040,Public       ,0,8,8,84,,272,356
01235800,PLAZA COLLEGE                           ,NY,11372-6300,Proprietary  ,15,88,103,260,,956,1216
01236400,SAINT VINCENTS CATHOLIC MEDICAL CENTERS ,NY,11354-0000,Proprietary  ,7,17,24,146,,684,830
01240700,SCHUYLER-CHEMUNG-TIOGA BOCES            ,NY,14903-1089,Public       ,3,22,25,27,,203,230
01240701,STEUBEN SCHUYLER CHEMUNG TIOGA ALLEGANY ,NY,14870-9518,Public       ,0,1,1,1,,10,11
01256100,FIVE TOWNS COLLEGE                      ,NY,11746-5871,Proprietary  ,23,11,34,1013,,285,1298
01258900,ERIE 1 BOCES                            ,NY,14224-0000,Public       ,9,32,41,118,,422,540
01265200,ONONDAGA CORTLAND MADISON BOCES         ,NY,13090-4500,Public       ,19,79,98,228,,791,1019
01278300,OSWEGO COUNTY BOCES ADULT CAREERS       ,NY,13114-4498,Public       ,2,13,15,40,,96,136
01292700,CENTRAL TECH NURSING PROGRAM            ,NY,13202-3092,Public       ,1,3,4,38,,149,187
01302600,MACHZIKEI HADATH RABBINICAL COLLEGE     ,NY,11204-1805,Private      ,19,25,44,20,,26,46
01302700,YESHIVATH VIZNITZ                       ,NY,10952-3021,Private      ,147,1,148,157,,4,161
01302900,BORICUA COLLEGE                         ,NY,10032-1599,Private      ,33,100,133,553,,1352,1905
02056400,CAPRI COSMETOLOGY LEARNING CENTER       ,NY,10954-0000,Proprietary  ,15,44,59,147,,263,410
02066200,THE NEW SCHOOL                          ,NY,10011-0000,Private      ,89,148,237,6197,,6154,12351
02069000,NEW YORK SCHOOL OF INTERIOR DESIGN      ,NY,10021-0000,Private      ,6,22,28,264,,465,729
02075700,BRIARCLIFFE COLLEGE                     ,NY,11714-0000,Proprietary  ,22,91,113,612,,1529,2141
02075702,BRIARCLIFFE COLLEGE - PATCHOGUE         ,NY,11772-3019,Proprietary  ,16,53,69,642,,890,1532
02092400,RIDLEY-LOWELL SCHOOL OF BUSINESS        ,NY,13905-0000,Proprietary  ,6,59,65,54,,354,408
02093700,LONG ISLAND BUSINESS INSTITUTE          ,NY,11725-0000,Proprietary  ,51,156,207,351,,1144,1495
02093701,LONG ISLAND BUSINESS INSTITUTE - FLUSHIN,NY,11354-4429,Proprietary  ,2,4,6,17,,45,62
02098400,HERKIMER COUNTY BOCES                   ,NY,13350-0000,Public       ,0,1,1,39,,132,171
02104300,OTSEGO AREA SCHOOL OF PRAC NURSING      ,NY,12167-0000,Public       ,0,0,0,11,,33,44
02105900,HAIR DESIGN INSTITUTE AT FIFTH AVE      ,NY,11220-0000,Proprietary  ,15,51,66,174,,353,527
02106800,BRAMSON ORT COLLEGE                     ,NY,11375-0000,Private      ,56,104,160,359,,782,1141
02110900,CATTARAUGUS/ALLEGANY BOCES              ,NY,14760-0000,Public       ,2,4,6,50,,177,227
02112301,RIDLEY - LOWELL BUSINESS & TECHNICAL INS,NY,12601-3328,Proprietary  ,25,110,135,212,,741,953
02116011,SANFORD-BROWN INSTITUTE - NEW YORK      ,NY,10003-2103,Proprietary  ,60,208,268,581,,1777,2358
02118700,LONG ISLAND COLLEGE HOSPITAL - SCHOOL OF,NY,11201-6001,Private      ,3,8,11,155,,340,495
02118702,LONG ISLAND COLLEGE HOSPITAL - SCHOOL OF,NY,11201-6001,Private      ,4,11,15,189,,346,535
02124000,ORANGE ULSTER BOCES SCH OF PRAC NRS     ,NY,10924-9401,Public       ,4,11,15,40,,232,272
02125500,CIRCLE IN THE SQUARE THEATRE SCHOOL     ,NY,10019-0000,Private      ,0,6,6,62,,84,146
02126300,MADISON-ONEIDA BOCES PRAC NRS           ,NY,13478-0000,Public       ,0,1,1,11,,85,96
02138500,BOCES RENSSELAER SCHOOL OF PN           ,NY,12033-3221,Public       ,0,2,2,23,,68,91
02145800,CAYUGA ONONDAGA BOCES                   ,NY,13021-9430,Public       ,0,5,5,46,,119,165
02146000,WAYNE-FINGER LAKES BOCES                ,NY,14513-0000,Public       ,0,4,4,56,,320,376
02152000,YESHIVA SHAAR HATORAH ITRI TORAH        ,NY,11418-0000,Private      ,7,0,7,12,,0,12
02153600,BROOME-TIOGA BOCES PN PROG              ,NY,13905-0000,Public       ,1,3,4,48,,159,207
02157900,ROCHESTER GENERAL HOSPITAL              ,NY,14621-3001,Private      ,0,2,2,49,,155,204
02158200,WSHNGTN-SARTGA-WARN-HMLTN-ESX BOCES     ,NY,12839-1051,Public       ,1,2,3,16,,68,84
02160100,GENEVA GENERAL HOSPITAL                 ,NY,14456-0000,Private      ,1,2,3,54,,201,255
02163400,NEW YORK CAREER INSTITUTE               ,NY,10007-2801,Proprietary  ,9,63,72,228,,804,1032
02169100,DAVIS COLLEGE                           ,NY,13790-0000,Private      ,1,6,7,179,,152,331
02170000,SWEDISH INSTITUTE                       ,NY,10001-0000,Proprietary  ,29,115,144,247,,1017,1264
02170200,ALBANY SCHOHARIE SCHENECTADY            ,NY,12205-0000,Public       ,0,2,2,58,,160,218
02171900,AILEY SCHOOL (THE)                      ,NY,10019-4402,Private      ,2,5,7,140,,113,253
02172100,HAMILTON-FULTON-MONTGOMERY BOCES        ,NY,12095-0665,Public       ,2,6,8,32,,101,133
02172800,DUTCHESS COUNTY BOCES SCH PRAC NURS     ,NY,12601-0000,Public       ,9,12,21,88,,233,321
02173200,EMPIRE BEAUTY SCHOOL                    ,NY,10001-0000,Proprietary  ,112,262,374,817,,1582,2399
02173900,ULSTER COUNTY BOCES PRACTICAL NRSG      ,NY,12466-0000,Public       ,0,3,3,41,,205,246
02176000,CHERYL FELL'S SCHOOL OF BUSINESS        ,NY,14304-0000,Proprietary  ,2,14,16,9,,107,116
02179400,EASTERN SUFFOLK BOCES                   ,NY,11713-0000,Public       ,1,14,15,193,,413,606
02182200,NEW SCHOOL OF RADIO & TELEVISION        ,NY,12206-1106,Proprietary  ,5,20,25,60,,123,183
02187300,DARKEI NOAM RABBINICAL COLLEGE          ,NY,11210-0000,Private      ,0,0,0,0,,1,1
02191600,TORAH TEMIMAH TALMUDICAL SEMINARY       ,NY,11218-0000,Private      ,25,0,25,66,,2,68
02192500,BELLEVUE HOSP CTR SCH RAD TECH          ,NY,10016-0000,Public       ,0,6,6,22,,145,167
02199300,ORLEANS-NIAGARA BOCES                   ,NY,14132-0000,Public       ,6,17,23,30,,106,136
02206000,HUNTER BUSINESS SCHOOL                  ,NY,11756-0000,Proprietary  ,45,129,174,326,,850,1176
02217800,D.HOPFER SCH NURSING AT MT.VRN HOSP     ,NY,10550-0000,Private      ,0,0,0,51,,281,332
02219500,MILDRED ELLEY                           ,NY,12206-1513,Proprietary  ,63,346,409,530,,2702,3232
02235600,ERIE 2-CHAUTAUQUA-CATTARAUGUS BOCES     ,NY,14006-0000,Public       ,2,5,7,37,,106,143
02265100,YESHIVA DERECH CHAIM                    ,NY,11218-0000,Private      ,8,1,9,51,,19,70
02265200,GLOBAL BUSINESS INSTITUTE               ,NY,11691-0000,Private      ,0,0,0,4,,45,49
02272900,ROCKLAND COUNTY BOCES PRAC NRSG SCH     ,NY,10994-0000,Public       ,0,1,1,53,,136,189
02275900,"MODERN WELDING SCHOOL, INC.             ",NY,12304-0000,Proprietary  ,8,26,34,75,,139,214
02287800,NATIONAL TRACTOR TRAILER SCHOOL         ,NY,13088-2505,Proprietary  ,15,119,134,57,,673,730
02294900,INSTITUTE OF AUDIO RESEARCH             ,NY,10003-0000,Proprietary  ,43,89,132,361,,523,884
02306500,PROFESSIONAL BUSINESS COLLEGE           ,NY,10013-5049,Private      ,115,196,311,609,,1479,2088
02314200,NORTHERN WESTCHESTER SCH COSMETOL       ,NY,10566-0000,Proprietary  ,5,5,10,37,,43,80
02320100,OHR SOMAYACH TANENBAUM EDUCATIONAL CENTE,NY,10952-0000,Private      ,0,0,0,2,,3,5
02350600,YESHIVA AND KOLLEL HARBOTZAS TORAH      ,NY,11230-0000,Private      ,1,4,5,1,,23,24
02491400,SPANISH AMERICAN INSTITUTE              ,NY,10036-0000,Private      ,1,3,4,5,,17,22
02505800,YESHIVA KARLIN STOLIN RAB INSTITUTE     ,NY,11204-0000,Private      ,30,24,54,39,,58,97
02505900,SH-OR YOSHUV RABBINICAL COLLEGE         ,NY,11691-0000,Private      ,4,1,5,47,,20,67
02506000,ASSOCIATED BETH RIVKAH SCHOOLS          ,NY,11225-0000,Private      ,2,1,3,101,,20,121
02506100,CITY UNIV OF NEW YORK-CENTRAL           ,NY,10021-0000,Public       ,31,42,73,3060,,1672,4732
02506800,YESHIVAT MIKDASH MELECH                 ,NY,11230-0000,Private      ,6,0,6,67,,12,79
02511500,JOFFREY BALLET SCHOOL                   ,NY,10011-0000,Proprietary  ,1,0,1,122,,15,137
02513500,MAR JON SCHOOL OF BEAUTY CULTURE        ,NY,14150-0000,Proprietary  ,1,8,9,39,,98,137
02525600,ART INSTITUTE OF NEW YORK CITY (THE)    ,NY,10013-2429,Proprietary  ,101,111,212,2340,,1715,4055
02540800,"GLOBE INSTITUTE OF TECHNOLOGY, INC.     ",NY,10007-0000,Proprietary  ,44,61,105,448,,473,921
02546000,TRI-STATE COLLEGE OF ACUPUNCTURE        ,NY,10011-0000,Proprietary  ,0,4,4,2,,122,124
02546300,YESHIVA OF THE TELSHE ALUMNI            ,NY,10471-0000,Private      ,12,0,12,44,,1,45
02550600,TALMUDICAL INST OF UPSTATE NY           ,NY,14607-0000,Private      ,0,0,0,5,,5,10
02556700,SEMINAR L'MOROS BAIS YAAKOV             ,NY,11219-0000,Private      ,6,0,6,224,,3,227
02572900,BUSINESS INFORMATICS CENTER             ,NY,11580-0000,Proprietary  ,0,4,4,21,,72,93
02575400,FRENCH CULINARY INSTITUTE               ,NY,10013-2618,Proprietary  ,32,92,124,466,,1046,1512
02587600,ORLO SCH HAIR DESIGN & COSMETOLOGY      ,NY,12206-1723,Proprietary  ,8,16,24,61,,121,182
02599400,NEW YORK COLLEGE OF HEALTH PROFESSIONS  ,NY,11791-4413,Private      ,9,49,58,225,,1001,1226
02600100,NEW YORK ACADEMY OF ART (THE)           ,NY,10013-2911,Private      ,11,12,23,262,,383,645
02614900,SANFORD-BROWN INSTITUTE                 ,NY,10604-2910,Proprietary  ,3,5,8,148,,391,539
02615001,SANFORD-BROWN COLLEGE - SANFORD-BROWN IN,NY,11530-4734,Proprietary  ,28,95,123,371,,837,1208
02616600,SHEAR EGO INTERNATIONAL SCHOOL OF HAIR D,NY,14617-3501,Proprietary  ,4,21,25,93,,191,284
02617000,CONTINENTAL SCH OF BEAUTY CULTURE       ,NY,14020-0000,Proprietary  ,3,7,10,47,,100,147
02617002,CONTINENTAL SCHOOL OF BEAUTY CULTURE  - ,NY,14020-1908,Proprietary  ,3,9,12,13,,28,41
02622900,BAIS MEDRASH ELYON                      ,NY,10952-3013,Private      ,4,6,10,8,,7,15
03000100,YESHIVA GEDOLAH IMREI YOSEF DSPINKA     ,NY,11219-4696,Private      ,0,46,46,0,,90,90
03007200,DANCE THEATRE OF HARLEM                 ,NY,10031-0000,Private      ,1,6,7,46,,61,107
03027701,PACIFIC COLLEGE OF ORIENTAL MEDICINE - N,NY,10010-7108,Proprietary  ,4,19,23,50,,541,591
03081600,DELAWARE CHENANGO MADISON OT. BOCES     ,NY,13815-9554,Public       ,2,1,3,26,,67,93
03089700,COMPUTER CAREER CENTER                  ,NY,11530-3334,Proprietary  ,0,0,0,81,,283,364
03095500,ASA INST BUSINESS & COMPUTER TECH       ,NY,11201-5208,Proprietary  ,291,673,964,2436,,4839,7275
03096200,CHARLES STUART SCHOOL                   ,NY,11229-2004,Proprietary  ,1,6,7,13,,61,74
03103700,ADIRONDACK BEAUTY SCHOOL                ,NY,12801-3158,Proprietary  ,0,5,5,25,,59,84
03104900,SULLIVAN COUNTY BOCES                   ,NY,12754-2116,Public       ,2,3,5,23,,56,79
03115300,GENESEE VALLEY BOCES                    ,NY,14020-1099,Public       ,3,17,20,67,,204,271
03120700,NEW YORK CONSERVATORY FOR DRAMATIC ARTS ,NY,10011-4225,Proprietary  ,8,5,13,583,,217,800
03127100,YESHIVAS NOVOMINSK                      ,NY,11219-0000,Private      ,4,0,4,52,,2,54
03129200,RABBINICAL CLG OHR SHIMAR YISROEL       ,NY,11211-8102,Private      ,5,22,27,21,,122,143
03147300,YESHIVA D'MONSEY                        ,NY,10952-3106,Private      ,2,30,32,3,,31,34
03169300,STUDIO JEWELERS                         ,NY,10016-4112,Proprietary  ,0,3,3,9,,48,57
03181400,MERKAZ BNOS                             ,NY,11214-4911,Private      ,1,10,11,9,,231,240
03191300,CUNY SCHOOL OF LAW @ QUEENS COLLEGE     ,NY,11367-0000,Public       ,11,22,33,420,,1211,1631
03193300,MANHATTAN SCHOOL OF COMPUTER TECH       ,NY,11230-1617,Private      ,38,89,127,280,,708,988
03203300,NEW YORK INSTITUTE OF MASSAGE           ,NY,14221-6021,Proprietary  ,3,18,21,47,,187,234
03216300,UNIFICATION THEOLOGICAL SEMINARY        ,NY,12507-5021,Private      ,0,2,2,19,,39,58
03328300,FRANKLIN CAREER INSTITUTE               ,NY,11550-3003,Private      ,11,22,33,65,,191,256
03328301,FRANKLIN CAREER INSTITUTE - BROOKLYN    ,NY,11220-3110,Private      ,12,39,51,145,,426,571
03342400,AMERICAN BARBER INSTITUTE               ,NY,10001-5271,Proprietary  ,0,0,0,18,,74,92
03358300,ALLEN SCHOOL                            ,NY,11432-4901,Proprietary  ,39,365,404,223,,1988,2211
03358301,ALLEN SCHOOL - BROOKLYN                 ,NY,11201-0000,Proprietary  ,40,145,185,244,,971,1215
03380300,STAR CAREER ACADEMY                     ,NY,11791-5311,Proprietary  ,8,43,51,93,,337,430
03419400,NORTHEASTERN SEMINARY                   ,NY,14624-1997,Private      ,2,7,9,29,,151,180
03426400,ANTHEM INSTITUTE                        ,NY,10018-0000,Proprietary  ,0,0,0,4,,8,12
03433500,LIA SCHORR INSTITUTE OF COSMETIC SK     ,NY,10022-2614,Proprietary  ,1,11,12,17,,76,93
03443300,NEW YORK COLLEGE OF TRADITIONAL CHINESE ,NY,11501-0000,Private      ,0,11,11,2,,102,104
03496300,YESHIVA SHAAREI TORAH OF ROCKLAND       ,NY,10901-4003,Private      ,9,4,13,22,,39,61
03537300,NEW YORK AUTOMOTIVE & DIESEL INSTIT     ,NY,11101-0000,Proprietary  ,23,69,92,178,,403,581
03568300,LEON STUDIO ONE SCHOOL OF HAIR DESI     ,NY,14221-5323,Proprietary  ,4,4,8,33,,76,109
03651300,SAINT JOSEPH'S MEDICAL CENTER SCHOO     ,NY,10701-4080,Private      ,0,3,3,19,,33,52
03652300,METROPOLITAN LEARNING INSTITUTE         ,NY,11374-2101,Private      ,6,116,122,75,,1206,1281
03665400,CHRISTIE'S EDUCATION                    ,NY,10036-8002,Proprietary  ,0,2,2,5,,58,63
03713300,BEIS MEDRASH HEICHAL DOVID              ,NY,11691-4433,Private      ,3,3,6,23,,5,28
03773300,CENTER FOR NATURAL WELLNESS SCHOOL OF MA,NY,12205-1601,Proprietary  ,1,19,20,48,,236,284
03802300,UTA MESIVTA OF KIRYAS JOEL              ,NY,10950-2169,Private      ,234,212,446,637,,518,1155
03809400,MICROPOWER CAREER INSTITUTE             ,NY,10001-2812,Proprietary  ,12,143,155,100,,755,855
03839300,AVEDA INSTITUTE NEW YORK                ,NY,10013-1522,Proprietary  ,19,53,72,212,,478,690
03881300,UNION GRADUATE COLLEGE                  ,NY,12308-3131,Private      ,0,13,13,16,,198,214
03903400,AMERICAN BEAUTY SCHOOL                  ,NY,10462-8003,Proprietary  ,7,53,60,157,,438,595
03941400,ELITE ACADEMY OF BEAUTY ARTS            ,NY,11223-1630,Proprietary  ,1,11,12,24,,104,128
03983300,"SCHOOL OF PROFESSIONAL HORTICULTURE, AT ",NY,10458-5126,Private      ,2,2,4,13,,55,68
03988300,"SAE INSTITUTE OF TECHNOLOGY, NEW YORK   ",NY,10001-2915,Proprietary  ,30,61,91,370,,533,903
04043300,ACE COMPUTER TRAINING CENTER            ,NY,11375-5337,Proprietary  ,15,48,63,60,,312,372
04092401,MAKE-UP DESIGNORY -                     ,NY,10012-0041,Proprietary  ,20,36,56,335,,416,751
04095300,KING'S COLLEGE (THE)                    ,NY,10018-0110,Private      ,11,13,24,953,,167,1120
04102300,NEW AGE TRAINING                        ,NY,10001-4006,Proprietary  ,6,23,29,41,,171,212
04115500,TALMUDICAL SEMINARY OF BOBOV            ,NY,11219-3826,Private      ,72,64,136,136,,132,268
04117100,EDP SCHOOL OF COMPUTER PROGRAMMING      ,NY,11235-0000,Private      ,1,10,11,21,,136,157
04117700,"MONROE 2-ORLEANS BOCES, CENTER FOR WORK ",NY,14624-1119,Public       ,11,56,67,122,,381,503
04119600,YESHIVA OF FAR ROCKAWAY DERECH AYSON RAB,NY,11691-5219,Private      ,2,0,2,13,,1,14
04123200,INSTITUTE OF ALLIED MEDICAL PROFESSIONS ,NY,11373-5541,Private      ,0,8,8,22,,146,168
04123300,HUDSON VALLEY SCHOOL OF MASSAGE THERAPY ,NY,12493-0000,Proprietary  ,0,0,0,2,,2,4
04125600,CAREER SCHOOL OF NY                     ,NY,10301-2416,Private      ,4,12,16,77,,149,226
04131500,COLLECTIVE (THE)                        ,NY,10011-2026,Proprietary  ,0,2,2,11,,25,36
04133700,NEW YORK MEDICAL CAREER TRAINING CENTER ,NY,11354-6504,Proprietary  ,3,28,31,49,,227,276
04133701,NEW YORK MEDICAL CAREER TRAINING CENTER ,NY,10018-6504,Proprietary  ,4,25,29,15,,82,97
04134000,"JOHN PAOLO'S XTREME BEAUTY INSTITUTE, GO",NY,12020-1245,Proprietary  ,3,14,17,17,,91,108
04134001,"JOHN PAOLO'S XTREME BEAUTY INSTITUTE, GO",NY,13417-1319,Proprietary  ,5,18,23,47,,167,214
04137700,ANN MARIE'S WORLD OF BEAUTY SCHOOL      ,NY,13901-2308,Proprietary  ,0,3,3,14,,37,51
04138100,YESHIVA OF MACHZIKAI HADAS              ,NY,11219-1408,Private      ,72,21,93,89,,128,217
04144300,INSTITUTE OF CULINARY EDUCATION         ,NY,10010-5205,Proprietary  ,63,142,205,636,,1328,1964
04148000,NEW LIFE BUSINESS INSTITUTE             ,NY,11432-6149,Proprietary  ,6,63,69,49,,359,408
04151200,SALON PROFESSIONAL ACADEMY (THE)        ,NY,14150-9200,Proprietary  ,8,18,26,89,,140,229
04155300,ONONDAGA SCHOOL OF THERAPEUTIC MASSAGE  ,NY,13210-1533,Proprietary  ,0,2,2,79,,371,450
04156000,ACADEMY OF COSMETOLOGY & ESTHETICS NYC (,NY,10306-3003,Proprietary  ,2,10,12,175,,239,414
04157500,ACCESS CAREERS                          ,NY,11201-5826,Proprietary  ,8,38,46,61,,302,363
04165700,"JOHN PAOLO'S XTREME BEAUTY INSTITUTE, GO",NY,12110-3053,Proprietary  ,3,6,9,12,,48,60
04166000,MANHATTAN INSTITUTE (THE)               ,NY,10016-6516,Proprietary  ,17,39,56,163,,335,498
04167600,FINGER LAKES SCHOOL OF MASSAGE (THE)    ,NY,14850-1384,Proprietary  ,1,20,21,57,,195,252
04167601,FINGER LAKES SCHOOL OF MASSAGE (THE) -  ,NY,10549-1103,Proprietary  ,1,16,17,16,,127,143
04178700,ATELIER ESTHETIQUE INSTITUTE OF ESTHETIC,NY,10016-8804,Proprietary  ,6,43,49,47,,316,363
04179800,SOTHEBY'S INSTITUTE OF ART - NY         ,NY,10022-6717,Proprietary  ,0,1,1,29,,141,170
04180200,LONG ISLAND NAIL & SKIN CARE INSTITUTE  ,NY,11756-1316,Proprietary  ,2,26,28,24,,121,145
04189000,LONG ISLAND BARBER INSTITUTE (THE)      ,NY,11550-6317,Proprietary  ,3,15,18,21,,89,110
04190500,NEW YORK SCHOOL OF ESTHETICS & DAY SPA  ,NY,10591-3232,Proprietary  ,3,9,12,25,,89,114
04192800,BE'ER YAAKOV TALMUDIC SEMINARY          ,NY,10977-1912,Private      ,86,42,128,86,,205,291
04204300,AESTHETIC SCIENCE INSTITUTE (THE)       ,NY,12110-1095,Proprietary  ,2,12,14,29,,93,122
04206200,DIGITAL FILM ACADEMY                    ,NY,10036-3708,Proprietary  ,10,13,23,182,,267,449
04207600,AMERICAN ACADEMY OF PERSONAL TRAINING   ,NY,10011-7301,Proprietary  ,4,38,42,41,,178,219
04208600,RELAY SCHOOL OF EDUCATION               ,NY,10011-4233,Private      ,0,7,7,1,,214,215
04208800,GLORIA FRANCIS SCHOOL OF MAKE-UP ARTISTR,NY,11801-3873,Proprietary  ,7,15,22,14,,33,47
04210100,NEW COMMUNITY COLLEGE AT CUNY (THE)     ,NY,10018-2602,Public       ,30,18,48,870,,494,1364
04210700,NEW YORK INSTITUTE OF BEAUTY            ,NY,11749-1479,Proprietary  ,5,24,29,37,,106,143
04212500,CACTUS ACADEMY (THE)                    ,NY,11530-3402,Proprietary  ,6,10,16,67,,85,152
04213400,ACCESS CAREERS                          ,NY,11550-0000,Proprietary  ,3,16,19,3,,18,21
04213500,SHARP EDGEZ BARBER INSTITUTE            ,NY,14620-0000,Proprietary  ,7,18,25,20,,95,115
04215900,YESHIVA GEDOLAH KESSER TORAH            ,NY,10952-2127,Private      ,9,1,10,46,,2,48
04223100,ARROJO COSMETOLOGY SCHOOL               ,NY,10014-4960,Proprietary  ,10,26,36,40,,108,148
04223800,ELECTRICAL TRAINING CENTER (THE)        ,NY,11726-2701,Proprietary  ,4,13,17,7,,18,25
00267808,BRYANT & STRATTON COLLEGE - PARMA       ,OH,44130-0000,Proprietary  ,63,196,259,635,,3562,4197
00301000,ANTIOCH UNIVERSITY                      ,OH,45387-1608,Private      ,0,28,28,264,,786,1050
00301100,ART ACADEMY OF CINCINNATI               ,OH,45202-7106,Private      ,4,9,13,489,,270,759
00301200,ASHLAND UNIVERSITY                      ,OH,44805-3799,Private      ,24,163,187,3727,,3156,6883
00301300,ATHENAEUM OF OHIO                       ,OH,45230-2000,Private      ,0,1,1,6,,23,29
00301400,BALDWIN-WALLACE COLLEGE                 ,OH,44017-2088,Private      ,31,62,93,5134,,1893,7027
00301600,BLUFFTON UNIVERSITY                     ,OH,45817-2104,Private      ,11,14,25,1551,,405,1956
00301800,BOWLING GREEN STATE UNIVERSITY          ,OH,43403-0001,Public       ,171,149,320,20939,,6534,27473
00302300,CAPITAL UNIVERSITY                      ,OH,43209-2394,Private      ,30,110,140,4437,,3367,7804
00302400,CASE WESTERN RESERVE UNIV               ,OH,44106-0000,Private      ,69,72,141,11061,,2335,13396
00302401,CASE WESTERN RESERVE UNIV - MED         ,OH,44106-0000,Private      ,3,10,13,101,,1225,1326
00302402,CASE WESTERN RESERVE UNIV - DENTAL      ,OH,44106-0000,Private      ,3,3,6,53,,327,380
00302403,CASE WESTERN RESERVE UNIV - LAW         ,OH,44106-0000,Private      ,1,11,12,33,,839,872
00302404,CASE WESTERN RESERVE UNIV - UG          ,OH,44106-0000,Private      ,0,2,2,209,,57,266
00302405,CASE WESTERN RESERVE UNIV - MSASS       ,OH,44106-0000,Private      ,0,7,7,20,,562,582
00302406,CASE WESTERN RESERVE UNIV - NURS UG     ,OH,44106-0000,Private      ,8,7,15,283,,253,536
00302407,CASE WESTERN RESERVE UNIV - WSOM        ,OH,44106-0000,Private      ,0,3,3,34,,235,269
00302408,CASE WESTERN RESERVE UNIV -A&S GRAD     ,OH,44106-0000,Private      ,1,10,11,15,,341,356
00302409,CASE WESTERN RESERVE UNIV -ENG GRAD     ,OH,44106-0000,Private      ,2,5,7,48,,105,153
00302410,CASE WESTERN RESERVE UNIV -NURS GRD     ,OH,44106-0000,Private      ,1,20,21,15,,431,446
00302500,CEDARVILLE UNIVERSITY                   ,OH,45314-8564,Private      ,27,18,45,4280,,490,4770
00302600,CENTRAL STATE UNIVERSITY                ,OH,45384-1004,Public       ,64,40,104,3214,,1804,5018
00302900,CINCINNATI CHRISTIAN UNIVERSITY         ,OH,45204-3200,Private      ,6,38,44,613,,808,1421
00303000,OHIO CHRISTIAN UNIVERSITY               ,OH,43113-9487,Private      ,27,424,451,932,,4472,5404
00303100,CLEVELAND INSTITUTE OF MUSIC            ,OH,44106-1776,Private      ,2,14,16,411,,452,863
00303200,CLEVELAND STATE UNIVERSITY              ,OH,44115-2214,Public       ,147,483,630,11949,,15361,27310
00303300,COLLEGE OF MT ST JOSEPH                 ,OH,45233-1670,Private      ,16,51,67,2026,,1587,3613
00303500,OHIO DOMINICAN UNIVERSITY               ,OH,43219-2099,Private      ,17,123,140,2362,,2839,5201
00303600,FRANCISCAN UNIV OF STEUBENVILLE         ,OH,43952-1763,Private      ,18,21,39,2666,,717,3383
00303700,COLLEGE OF WOOSTER                      ,OH,44691-2363,Private      ,19,10,29,3588,,171,3759
00303900,COLUMBUS COLLEGE OF ART AND DESIGN      ,OH,43215-1758,Private      ,11,36,47,1802,,915,2717
00304000,CUYAHOGA COMMUNITY COLLEGE              ,OH,44115-2878,Public       ,386,1454,1840,12486,,27693,40179
00304100,"DEFIANCE COLLEGE, THE                   ",OH,43512-1695,Private      ,15,18,33,1451,,506,1957
00304200,DENISON UNIVERSITY                      ,OH,43023-1329,Private      ,17,2,19,3128,,140,3268
00304300,CHANCELLOR UNIVERSITY                   ,OH,44114-0000,Proprietary  ,0,0,0,33,,273,306
00304400,TRINITY LUTHERAN SEMINARY               ,OH,43209-0000,Private      ,0,5,5,5,,145,150
00304500,UNIVERSITY OF FINDLAY                   ,OH,45840-3695,Private      ,31,52,83,3717,,1802,5519
00304600,FRANKLIN UNIVERSITY                     ,OH,43215-5399,Private      ,22,433,455,1337,,11231,12568
00304800,HEIDELBERG UNIVERSITY                   ,OH,44883-2462,Private      ,16,6,22,2013,,441,2454
00304900,HIRAM COLLEGE                           ,OH,44234-1808,Private      ,22,17,39,1789,,480,2269
00305000,JOHN CARROLL UNIVERSITY                 ,OH,44118-4581,Private      ,33,30,63,4738,,1036,5774
00305100,KENT STATE UNIVERSITY                   ,OH,44242-0001,Public       ,213,314,527,27259,,13562,40821
00305101,KENT STATE UNIVERSITY - GEAUGA CAMPUS   ,OH,44021-9500,Public       ,10,22,32,845,,1048,1893
00305102,KENT STATE UNIVERSITY - STARK CAMPUS    ,OH,44720-7599,Public       ,49,97,146,3567,,4211,7778
00305103,KENT STATE UNIVERSITY - TUSCARAWAS CAMPU,OH,44663-9403,Public       ,9,45,54,1060,,1562,2622
00305104,KENT STATE UNIVERSITY - TRUMBULL CAMPUS ,OH,44483-1998,Public       ,18,69,87,1268,,2411,3679
00305105,KENT STATE UNIVERSITY - ASHTABULA CAMPUS,OH,44004-2299,Public       ,12,56,68,984,,2167,3151
00305106,KENT STATE UNIVERSITY - EAST LIVERPOOL C,OH,43920-3497,Public       ,8,30,38,504,,906,1410
00305107,KENT STATE UNIVERSITY - SALEM CAMPUS    ,OH,44460-9412,Public       ,17,31,48,1071,,1288,2359
00305143,KENT STATE UNIVERSITY - COLLEGE OF PODIA,OH,44131-2330,Public       ,0,0,0,31,,313,344
00306500,KENYON COLLEGE                          ,OH,43022-9623,Private      ,22,4,26,2800,,85,2885
00306600,LAKE ERIE COLLEGE                       ,OH,44077-3389,Private      ,10,21,31,1374,,461,1835
00306800,LORAIN COUNTY COMMUNITY COLLEGE         ,OH,44035-1691,Public       ,152,483,635,4616,,8967,13583
00306900,LOURDES COLLEGE                         ,OH,43560-2898,Private      ,8,46,54,1333,,1905,3238
00307200,MALONE UNIVERSITY                       ,OH,44709-3897,Private      ,12,52,64,1950,,1541,3491
00307300,MARIETTA COLLEGE                        ,OH,45750-4033,Private      ,19,24,43,2576,,407,2983
00307500,METHODIST THEOLOGICAL SCH IN OHIO       ,OH,43015-0000,Private      ,0,6,6,2,,206,208
00307600,MIAMI-JACOBS COLLEGE                    ,OH,45401-0000,Proprietary  ,0,0,0,22,,74,96
00307700,MIAMI UNIVERSITY                        ,OH,45056-1831,Public       ,216,260,476,23119,,6224,29343
00307800,WRIGHT STATE UNIVERSITY                 ,OH,45435-0002,Public       ,100,316,416,13649,,11537,25186
00308300,UNIVERSITY OF MOUNT UNION               ,OH,44601-3993,Private      ,26,12,38,3543,,363,3906
00308400,MUSKINGUM UNIVERSITY                    ,OH,43762-1199,Private      ,12,49,61,2295,,750,3045
00308500,NOTRE DAME COLLEGE OF OHIO              ,OH,44121-4293,Private      ,26,92,118,2550,,1886,4436
00308600,OBERLIN COLLEGE                         ,OH,44074-1090,Private      ,23,3,26,5096,,218,5314
00308900,OHIO NORTHERN UNIVERSITY                ,OH,45810-1555,Private      ,22,16,38,3750,,1006,4756
00309000,OHIO STATE UNIVERSITY-ALL CAMPUSES      ,OH,43210-1358,Public       ,420,569,989,57132,,26810,83942
00310000,OHIO UNIVERSITY                         ,OH,45701-2979,Public       ,197,618,815,24618,,13433,38051
00310002,"OHIO UNIVERSITY, ZANESVILLE CAMPUS      ",OH,43701-0000,Public       ,14,55,69,1373,,1804,3177
00310003,"OHIO UNIVERSITY, LANCASTER CAMPUS       ",OH,43130-0000,Public       ,23,69,92,1597,,2222,3819
00310004,"OHIO UNIVERSITY, SOUTHERN CAMPUS        ",OH,45638-0000,Public       ,18,82,100,913,,2027,2940
00310005,"OHIO UNIVERSITY, CHILLICOTHE CAMPUS     ",OH,45601-0000,Public       ,18,73,91,1315,,2400,3715
00310006,"OHIO UNIVERSITY, EASTERN CAMPUS         ",OH,43950-0000,Public       ,7,29,36,584,,491,1075
00310008,OHIO UNIV COLL OF OSTEOPATHIC MED       ,OH,45701-0000,Public       ,2,0,2,19,,600,619
00310900,OHIO WESLEYAN UNIVERSITY                ,OH,43015-2398,Private      ,21,7,28,3135,,217,3352
00311000,OTTERBEIN UNIVERSITY                    ,OH,43081-2006,Private      ,28,47,75,4109,,1146,5255
00311300,PONTIFICAL COLLEGE JOSEPHINUM           ,OH,43235-1498,Private      ,1,1,2,55,,24,79
00311400,FIRELANDS REGIONAL MEDICAL CENTER - SOUT,OH,44870-4788,Private      ,0,4,4,67,,173,240
00311500,RABBINICAL COLLEGE OF TELSHE            ,OH,44092-2584,Private      ,4,3,7,22,,28,50
00311600,UNIV OF RIO GRANDE                      ,OH,45674-3131,Private      ,28,105,133,1613,,2279,3892
00311900,SINCLAIR COMMUNITY COLLEGE              ,OH,45402-1460,Public       ,217,961,1178,9648,,19230,28878
00312100,TIFFIN UNIVERSITY                       ,OH,44883-2161,Private      ,23,132,155,2909,,5946,8855
00312200,UNITED THEOLOGICAL SEMINARY             ,OH,45406-0000,Private      ,0,15,15,6,,729,735
00312300,UNIVERSITY OF AKRON                     ,OH,44325-6211,Public       ,194,319,513,20596,,14869,35465
00312500,UNIVERSITY OF CINCINNATI                ,OH,45221-0125,Public       ,281,889,1170,29974,,24662,54636
00312504,UNIVERSITY OF CINCINNATI - MEDICINE     ,OH,45267-0553,Public       ,6,33,39,426,,1737,2163
00312700,UNIVERSITY OF DAYTON                    ,OH,45469-0002,Private      ,83,117,200,13005,,3634,16639
00313100,UNIVERSITY OF TOLEDO                    ,OH,43606-3390,Public       ,141,219,360,17872,,11175,29047
00313300,URBANA UNIVERSITY                       ,OH,43078-2091,Private      ,9,39,48,1064,,1031,2095
00313400,URSULINE COLLEGE                        ,OH,44124-4398,Private      ,4,42,46,672,,1440,2112
00313500,WALSH UNIVERSITY                        ,OH,44720-3396,Private      ,22,45,67,2725,,1484,4209
00314100,WILBERFORCE UNIVERSITY                  ,OH,45384-1001,Private      ,2,24,26,641,,486,1127
00314200,WILMINGTON COLLEGE                      ,OH,45177-2499,Private      ,23,11,34,2160,,573,2733
00314300,WITTENBERG UNIVERSITY                   ,OH,45501-2199,Private      ,28,12,40,3885,,483,4368
00314400,XAVIER UNIVERSITY                       ,OH,45207-1035,Private      ,75,112,187,8507,,3480,11987
00314500,YOUNGSTOWN STATE UNIVERSITY             ,OH,44555-0001,Public       ,122,165,287,9642,,7492,17134
00398200,CLEVELAND INSTITUTE OF ART              ,OH,44106-1700,Private      ,17,17,34,1082,,365,1447
00406000,WINEBRENNER THEOLOGICAL SEMINARY        ,OH,45840-0000,Private      ,0,3,3,2,,61,63
00485200,CLARK STATE COMMUNITY COLLEGE           ,OH,45505-4795,Public       ,48,360,408,2148,,6631,8779
00485300,BRADFORD SCHOOL                         ,OH,43219-0000,Proprietary  ,21,54,75,764,,819,1583
00485500,DAVIS COLLEGE                           ,OH,43623-4307,Proprietary  ,5,47,52,146,,797,943
00486100,UNIVERSITY OF NORTHWESTERN OHIO         ,OH,45805-1498,Private      ,103,123,226,5077,,2204,7281
00486600,STAUTZENBERGER COLLEGE                  ,OH,43537-4007,Proprietary  ,33,118,151,495,,1710,2205
00489814,MCCANN SCHOOL OF BUSINESS & TECHNOLOGY -,OH,44131-2309,Proprietary  ,0,0,0,6,,37,43
00489817,MCCANN SCHOOL OF BUSINESS & TECHNOLOGY -,OH,45241-5428,Proprietary  ,0,0,0,4,,16,20
00510200,SCH OF DIAGNOSTIC IMAGING-CLEVELAND     ,OH,44119-0000,Private      ,0,6,6,16,,50,66
00531300,NORTH CENTRAL STATE COLLEGE             ,OH,44901-0000,Public       ,17,73,90,1430,,2707,4137
00575300,OWENS STATE COMMUNITY COLLEGE           ,OH,43699-0000,Public       ,140,392,532,6062,,11122,17184
00648700,AULTMAN COLLEGE OF NURSING AND HEALTH SC,OH,44710-1799,Private      ,4,12,16,206,,578,784
00648900,CHRIST COLLEGE OF NURSING AND HEALTH SCI,OH,45219-2906,Private      ,3,26,29,356,,920,1276
00649400,GOOD SAMARITAN COLG-NURSING/HEALTH      ,OH,45220-2489,Private      ,3,33,36,312,,797,1109
00650700,TRINIT HEALTH SYSTEM SCH OF NURSING     ,OH,43952-2667,Private      ,0,2,2,70,,184,254
00680400,LAKELAND COMMUNITY COLLEGE              ,OH,44094-5198,Public       ,67,268,335,3306,,6905,10211
00686700,COLUMBUS STATE COMMUNITY COLLEGE        ,OH,43215-1786,Public       ,328,1336,1664,14714,,27364,42078
00703500,KETTERING COLLEGE OF MEDICAL ARTS       ,OH,45429-1299,Private      ,5,42,47,625,,1016,1641
00708500,MOUNT VERNON NAZARENE UNIVERSITY        ,OH,43050-9500,Private      ,18,60,78,1603,,962,2565
00708501,MOUNT VERNON NAZARENE UNIV - AGS        ,OH,43050-0000,Private      ,2,43,45,96,,820,916
00727500,EASTERN GATEWAY COMMUNITY COLLEGE       ,OH,43952-3598,Public       ,47,160,207,1217,,2658,3875
00732920,ITT TECHNICAL INSTITUTE                 ,OH,45414-3456,Proprietary  ,31,229,260,505,,2061,2566
00732992,ITT TECHNICAL INSTITUTE                 ,OH,44509-4098,Proprietary  ,57,252,309,521,,1977,2498
00747300,CHOFFIN CAREER & TECHNICAL CENTER       ,OH,44503-1628,Public       ,2,15,17,125,,367,492
00759800,HOCKING TECHNICAL COLLEGE               ,OH,45764-9582,Public       ,46,126,172,3276,,3403,6679
00812900,ADULT AND COMMUNITY EDUCATION @ HUDSON  ,OH,43211-2017,Public       ,4,35,39,69,,588,657
00813200,TOLEDO SCHOOL OF PRACTICAL NURSING      ,OH,43613-5110,Public       ,5,21,26,149,,545,694
00813300,ZANE STATE COLLEGE                      ,OH,43701-2626,Public       ,38,121,159,1432,,2388,3820
00819400,AKRON SCHOOL OF PRACTICAL NRSG          ,OH,44311-0000,Public       ,4,11,15,181,,344,525
00827800,TERRA COMMUNITY COLLEGE                 ,OH,43420-9670,Public       ,23,103,126,1008,,2269,3277
00867700,NORTHWEST STATE COMMUNITY COLLEGE       ,OH,43502-9542,Public       ,14,79,93,1064,,2403,3467
00888600,PORTAGE LAKES CAREER CENTER             ,OH,44685-9554,Public       ,1,4,5,27,,100,127
00908803,ITT TECHNICAL INSTITUTE                 ,OH,44136-1758,Proprietary  ,0,0,0,0,,2,2
00915600,WAYNE COUNTY SCHOOLS CAREER CENTER      ,OH,44677-9672,Public       ,5,9,14,63,,256,319
00941200,FORTIS COLLEGE                          ,OH,44221-2998,Proprietary  ,18,140,158,226,,1366,1592
00953000,GERBER AKRON BEAUTY SCHOOL              ,OH,44313-6995,Proprietary  ,3,13,16,42,,165,207
00953100,SPA SCHOOL (THE)                        ,OH,43214-1524,Proprietary  ,7,35,42,77,,407,484
00966000,TIFFIN ACADEMY OF HAIR DESIGN           ,OH,44883-2833,Proprietary  ,5,4,9,43,,60,103
00994100,BELMONT TECHNICAL COLLEGE               ,OH,43950-9766,Public       ,12,65,77,823,,1471,2294
00994200,SHAWNEE STATE UNIVERSITY                ,OH,45662-4344,Public       ,35,67,102,4645,,2720,7365
01001700,PAYNE THEOLOGICAL SEMINARY              ,OH,45384-0474,Private      ,0,4,4,0,,169,169
01002700,JAMES A. RHODES STATE COLLEGE           ,OH,45804-3597,Public       ,20,107,127,1693,,2935,4628
01016800,NATIONWIDE BEAUTY ACADEMY               ,OH,43228-1000,Proprietary  ,7,17,24,108,,302,410
01028000,OHIO STATE BEAUTY ACADEMY               ,OH,45801-0000,Proprietary  ,7,23,30,160,,226,386
01032300,HANNAH E MULLINS SCH-PRAC NRSG          ,OH,44460-2906,Public       ,2,4,6,27,,101,128
01034500,CINCINNATI STATE TECH & COMM CLG        ,OH,45223-2690,Public       ,155,690,845,5909,,13567,19476
01045300,WASHINGTON STATE CMTY COLLEGE           ,OH,45750-9225,Public       ,16,58,74,910,,1270,2180
01063000,NORTHERN INSTITUTE OF COSMETOLOGY       ,OH,44052-1803,Proprietary  ,2,12,14,24,,94,118
01073600,MARION TECHNICAL COLLEGE                ,OH,43302-5694,Public       ,10,64,74,957,,2050,3007
01088000,CHATFIELD COLLEGE                       ,OH,45118-9705,Private      ,4,24,28,101,,471,572
01088100,STARK STATE COLLEGE OF TECHNOLOGY       ,OH,44720-7299,Public       ,116,366,482,4739,,14069,18808
01090600,CINCINNATI CLG OF MORTUARY SCIENCE      ,OH,45224-1428,Private      ,0,3,3,80,,228,308
01092300,UNION INSTITUTE & UNIVERSITY            ,OH,45206-1925,Private      ,3,190,193,49,,2421,2470
01099300,HOBART INSTITUTE OF WELDING TECHNOLOGY  ,OH,45373-2400,Private      ,30,31,61,356,,323,679
01100500,KAPLAN COLLEGE                          ,OH,43232-4827,Proprietary  ,1,25,26,137,,964,1101
01104600,CENTRAL OHIO TECHNICAL COLLEGE          ,OH,43055-1767,Public       ,24,126,150,1765,,4663,6428
01170300,PENTA COUNTY JOINT VOCATIONAL SCH       ,OH,43551-0000,Public       ,2,5,7,28,,135,163
01174400,NATIONAL BEAUTY COLLEGE                 ,OH,44720-0000,Proprietary  ,3,9,12,53,,205,258
01174500,OHIO TECHNICAL COLLEGE                  ,OH,44103-1228,Proprietary  ,44,100,144,1568,,1232,2800
01182500,OHIO STATE SCHOOL OF COSMETOLOGY        ,OH,43224-1107,Proprietary  ,0,0,0,103,,259,362
01212800,SOUTHWESTERN COLLEGE                    ,OH,45402-3003,Proprietary  ,3,23,26,65,,391,456
01212802,SOUTHWESTERN COLLEGE                    ,OH,45005-2267,Proprietary  ,0,0,0,1,,7,8
01212803,SOUTHWESTERN COLLEGE                    ,OH,45202-4304,Proprietary  ,0,0,0,5,,41,46
01212804,SOUTHWESTERN COLLEGE                    ,OH,45246-3121,Proprietary  ,2,20,22,61,,382,443
01212806,LINCOLN COLLEGE OF TECHNOLOGY - TOLEDO  ,OH,43615-6800,Proprietary  ,2,4,6,94,,325,419
01212807,LINCOLN COLLEGE OF TECHNOLOGY - COLUMBUS,OH,43215-3602,Proprietary  ,0,0,0,17,,46,63
01212808,LINCOLN COLLEGE OF TECHNOLOGY - CLEVELAN,OH,44114-3266,Proprietary  ,5,13,18,104,,415,519
01216600,CAROUSEL BEAUTY COLLEGE                 ,OH,45402-8935,Proprietary  ,11,29,40,118,,348,466
01224800,CENTRAL SCHOOL OF PRACTICAL NURSING     ,OH,44131-2155,Private      ,2,35,37,101,,494,595
01267200,CAROUSEL BEAUTY COLLEGE                 ,OH,45044-5113,Proprietary  ,0,7,7,15,,61,76
01267400,CAROUSEL OF MIAMI VALLEY BEAUTY CLG     ,OH,45424-2063,Proprietary  ,3,2,5,14,,34,48
01275000,EDISON COMMUNITY COLLEGE                ,OH,45356-9239,Public       ,23,85,108,1107,,2523,3630
01283800,LAURA AND ALVIN SIEGAL COLLEGE OF JUDAIC,OH,44122-7197,Private      ,1,0,1,4,,9,13
01284800,MOLER-HOLLYWOOD BEAUTY COLLEGE          ,OH,45202-2577,Proprietary  ,7,15,22,48,,158,206
01287000,SOUTHERN STATE COMMUNITY COLLEGE        ,OH,45133-9406,Public       ,23,120,143,1206,,2531,3737
01289100,ANTONELLI COLLEGE                       ,OH,45202-2592,Proprietary  ,9,82,91,153,,785,938
01289600,VIRGINIA MARTI COLLEGE OF ART AND DESIGN,OH,44107-0778,Proprietary  ,10,12,22,164,,210,374
01303922,SOUTH UNIVERSITY - CLEVELAND            ,OH,44128-5919,Proprietary  ,7,98,105,73,,663,736
01313200,INTERNATIONAL CLG OF BROADCASTING       ,OH,45431-1898,Proprietary  ,2,22,24,98,,228,326
02052000,KAPLAN COLLEGE                          ,OH,45439-1984,Proprietary  ,16,142,158,250,,1572,1822
02054300,TRUMBULL BUSINESS COLLEGE               ,OH,44484-0000,Proprietary  ,8,40,48,49,,449,498
02056800,DAYMAR COLLEGE                          ,OH,45601-1038,Proprietary  ,1,21,22,35,,283,318
02056802,DAYMAR COLLEGE - LANCASTER              ,OH,43130-0000,Proprietary  ,6,24,30,43,,226,269
02056803,DAYMAR COLLEGE - NEW BOSTON             ,OH,45662-4900,Proprietary  ,0,23,23,31,,220,251
02056804,DAYMAR COLLEGE - JACKSON                ,OH,45640-1728,Proprietary  ,0,15,15,30,,169,199
02066100,OHIO STATE COLLEGE/BARBER STYLING       ,OH,43213-0000,Proprietary  ,12,48,60,151,,407,558
02073300,GALLIA-JACKSON-VINTON SCH ADULT ED      ,OH,45674-0000,Public       ,1,5,6,80,,225,305
02110700,CLEVELAND INST OF DENTAL-MED ASST       ,OH,44115-2285,Proprietary  ,13,88,101,165,,742,907
02116009,SANFORD-BROWN COLLEGE - MIDDLEBURG HEIGH,OH,44130-8362,Proprietary  ,1,9,10,117,,661,778
02116900,UPPER VALLEY JVS                        ,OH,45356-0000,Public       ,6,26,32,33,,255,288
02117300,GREAT OAKS INSTITUTE OF TECHNOLOGY      ,OH,45241-1581,Public       ,12,71,83,268,,1026,1294
02128600,THE ART INSTITUTE OF CINCINNATI         ,OH,45246-0000,Proprietary  ,18,21,39,552,,410,962
02140700,COMMUNITY EDUCATIONAL SERVICES          ,OH,44702-1710,Public       ,2,2,4,35,,242,277
02158417,"HARRISON COLLEGE - COLUMBUS, OH         ",OH,43123-0000,Proprietary  ,13,52,65,100,,427,527
02158500,OHIO BUSINESS COLLEGE                   ,OH,44035-0701,Proprietary  ,14,54,68,114,,611,725
02158501,OHIO BUSINESS COLLEGE                   ,OH,44870-9953,Proprietary  ,5,29,34,49,,476,525
02158503,OHIO BUSINESS COLLEGE - COLUMBUS        ,OH,43229-3523,Proprietary  ,9,56,65,166,,605,771
02158504,OHIO BUSINESS COLLEGE - DAYTON          ,OH,45417-4094,Proprietary  ,1,16,17,35,,231,266
02168100,TRI-COUNTY JOINT VOCATIONAL SCHOOL      ,OH,45764-0000,Public       ,4,18,22,63,,226,289
02187900,ASHTABULA CO JOINT VOC SCH ADULT ED     ,OH,44047-0000,Public       ,2,15,17,61,,267,328
02189000,ADULT CENTER FOR EDUCATION              ,OH,43701-0000,Public       ,7,39,46,133,,506,639
02190700,FORTIS COLLEGE                          ,OH,45459-0000,Proprietary  ,41,271,312,535,,4352,4887
02192100,BUTLER TECHNOLOGY AND CAREER DEVELOPMENT,OH,45011-0000,Public       ,11,50,61,249,,727,976
02196300,COLLINS CAREER CENTER                   ,OH,45619-0000,Public       ,12,35,47,197,,638,835
02210800,MEDINA COUNTY CAREER CENTER             ,OH,44256-0000,Public       ,0,6,6,47,,179,226
02220500,GOD'S BIBLE SCHOOL & COLLEGE            ,OH,45210-0000,Private      ,3,9,12,195,,117,312
02220800,CAREER & TECHNOLOGY EDUCATION CENTERS OF,OH,43055-0000,Public       ,3,31,34,142,,425,567
02239800,PIONEER CAREER & TECHNOLOGY CENTER      ,OH,44875-0000,Public       ,1,4,5,9,,67,76
02245600,WARREN COUNTY CAREER CENTER             ,OH,45036-0000,Public       ,9,41,50,100,,390,490
02246300,INSTITUTE OF MEDICAL-DENTAL TECH        ,OH,45246-3317,Proprietary  ,23,182,205,153,,647,800
02263700,MIAMI VALLEY CAREER TECHNOLOGY CTR      ,OH,45315-0000,Public       ,7,45,52,166,,663,829
02269400,EASTERN HILLS ACAD OF HAIR DESIGN       ,OH,45255-0000,Proprietary  ,4,5,9,32,,87,119
02269500,WESTERN HILLS SCHOOL OF BEAUTY & HAIR DE,OH,45211-0000,Proprietary  ,6,40,46,65,,327,392
02270100,OHIO HI-POINT CAREER CENTER             ,OH,43311-0000,Public       ,0,4,4,16,,124,140
02272700,COLUMBIANA COUNTY CAREER CENTER         ,OH,44432-0000,Public       ,3,19,22,69,,321,390
02287900,RAPHAEL'S SCHOOL OF BEAUTY CULTURE      ,OH,44446-0000,Proprietary  ,7,39,46,82,,287,369
02289802,KAPLAN COLLEGE                          ,OH,45203-0000,Proprietary  ,0,0,0,83,,550,633
02301400,OHIO VALLEY COLLEGE OF TECHNOLOGY       ,OH,43920-9139,Proprietary  ,4,27,31,103,,284,387
02303600,FORTIS COLLEGE - RAVENNA CAMPUS         ,OH,44266-0000,Proprietary  ,2,17,19,79,,264,343
02304700,TRI-RIVERS CAREER CENTER                ,OH,43302-0000,Public       ,0,13,13,78,,330,408
02311200,AMERICAN SCHOOL OF TECHNOLOGY           ,OH,43229-0000,Proprietary  ,8,69,77,130,,776,906
02315500,TOLEDO ACADEMY OF BEAUTY CULTURE - EAST ,OH,43616-0000,Proprietary  ,4,30,34,56,,214,270
02324400,ALLSTATE HAIRSTYLING & BARBER CLG       ,OH,44113-0000,Proprietary  ,2,23,25,92,,395,487
02328500,MOLER-PICKENS BEAUTY COLLEGE            ,OH,45014-0000,Proprietary  ,3,22,25,16,,92,108
02334300,INTERNATIONAL ACAD OF HAIR DESIGN       ,OH,45239-0000,Proprietary  ,7,22,29,95,,273,368
02336300,KNOX COUNTY CAREER CENTER               ,OH,43050-4298,Public       ,2,19,21,82,,319,401
02336700,CUYAHOGA VALLEY CAREER CENTER           ,OH,44141-1296,Public       ,2,9,11,64,,262,326
02337700,PROFESSIONAL SKILLS INSTITUTE           ,OH,43607-0000,Proprietary  ,4,32,36,163,,753,916
02351500,WILLOUGHBY EASTLAKE SCH OF PRAC NSG     ,OH,44094-0000,Public       ,1,14,15,28,,179,207
02352800,POLARIS CAREER CENTER-ADULT ED DEPT     ,OH,44130-0000,Public       ,8,43,51,151,,525,676
02354200,SCIOTO COUNTY JOINT VOCATIONAL SCH      ,OH,45648-0000,Public       ,14,28,42,140,,422,562
02359803,ITT TECHNICAL INSTITUTE -               ,OH,45212-2273,Proprietary  ,0,0,0,0,,1,1
02454400,NORTHEAST OHIO MEDICAL UNIVERSITY       ,OH,44272-9621,Public       ,2,4,6,151,,875,1026
02497800,GREENE COUNTY CAREER CENTER             ,OH,45385-0000,Public       ,2,13,15,45,,214,259
02512600,ADULT VOCATIONAL SERVICES               ,OH,44308-0000,Public       ,0,0,0,3,,11,14
02519300,OHIO STATE SCH COSMETOLOGY              ,OH,43110-2754,Proprietary  ,11,19,30,135,,243,378
02522700,EASTLAND-FAIRFIELD CAREER AND TECHNICAL ,OH,43125-0000,Public       ,9,36,45,77,,359,436
02528300,TDDS TECHNICAL INSTITUTE                ,OH,44429-0000,Proprietary  ,17,92,109,95,,593,688
02529500,HAMRICK SCHOOL                          ,OH,44256-0000,Proprietary  ,4,55,59,29,,340,369
02545800,INNER STATE BEAUTY SCHOOLS              ,OH,44124-0000,Proprietary  ,6,26,32,72,,292,364
02553000,SCHOOL OF ADVERTISING ART               ,OH,45440-0000,Proprietary  ,2,2,4,260,,63,323
02560000,CASAL AVEDA INSTITUTE                   ,OH,44515-0000,Proprietary  ,10,18,28,155,,225,380
02560700,PICKAWAY ROSS CO JOINT VOC TECH SCH     ,OH,45601-0000,Public       ,5,19,24,112,,459,571
02562300,APOLLO CAREER CENTER-ADULT EDUC         ,OH,45806-0000,Public       ,3,46,49,130,,609,739
02563000,RAPHAELS SCHOOL OF BEAUTY CULTURE       ,OH,44601-2847,Proprietary  ,4,14,18,37,,158,195
02568600,MAHONING COUNTY CAREER & TECH CENTR     ,OH,44406-0000,Public       ,3,10,13,37,,139,176
02582900,KAPLAN CAREER INSTITUTE                 ,OH,44129-6810,Proprietary  ,8,73,81,66,,675,741
02586400,TRUMBULL CAREER & TECH CENTER-ADULT     ,OH,44483-1997,Public       ,4,29,33,75,,369,444
02588500,OHIO STATE SCHOOL OF COSMETOLOGY        ,OH,43081-0000,Proprietary  ,15,26,41,147,,257,404
02599711,VATTEROTT COLLEGE - CLEVELAND           ,OH,44147-3502,Proprietary  ,4,72,76,62,,472,534
02603800,LORAIN COUNTY JVS ADULT CAREER CTR      ,OH,44074-9799,Public       ,5,13,18,72,,264,336
02611007,HERITAGE COLLEGE - COLUMBUS             ,OH,43213-4440,Proprietary  ,31,121,152,254,,1049,1303
02620000,SANDUSKY CAREER CENTER                  ,OH,44870-4786,Public       ,1,4,5,24,,179,203
03007900,GALLIPOLIS CAREER COLLEGE               ,OH,45631-2600,Proprietary  ,1,17,18,25,,215,240
03015100,ALLIANCE HIGH SCH-CMTY SERVICES DIV     ,OH,44601-2899,Public       ,0,6,6,35,,130,165
03015300,EHOVE CAREER CENTER                     ,OH,44846-9500,Public       ,4,25,29,104,,455,559
03023700,MADISON ADULT CAREER CENTER             ,OH,44905-2718,Public       ,1,10,11,69,,366,435
03024300,VALLEY BEAUTY SCHOOL                    ,OH,43725-2332,Proprietary  ,3,7,10,12,,33,45
03026511,REMINGTON COLLEGE - CLEVELAND           ,OH,44125-1957,Private      ,9,41,50,379,,1452,1831
03026512,REMINGTON COLLEGE - CLEVELAND WEST      ,OH,44070-3129,Private      ,0,10,10,54,,200,254
03027100,FAIRVIEW ACADEMY                        ,OH,44126-2214,Proprietary  ,2,3,5,23,,78,101
03034200,WASHINGTON COUNTY CAREER CENTER ADULT TE,OH,45750-9290,Public       ,12,110,122,147,,504,651
03051400,AUBURN CAREER CENTER                    ,OH,44077-9723,Public       ,7,21,28,81,,303,384
03051500,US GRANT JOINT VOCATIONAL SCHOOL        ,OH,45106-9502,Public       ,0,1,1,6,,22,28
03065900,BUCKEYE CAREER CENTER                   ,OH,44663-9437,Public       ,0,10,10,60,,231,291
03067600,RAPHAEL'S SCHOOL OF BEAUTY CULTURE      ,OH,44512-2222,Proprietary  ,10,27,37,64,,177,241
03068200,OHIO CENTER FOR BROADCASTING            ,OH,44125-6273,Proprietary  ,7,32,39,67,,245,312
03068202,OHIO CENTER FOR BROADCASTING - COLUMBUS ,OH,43213-2571,Proprietary  ,9,28,37,89,,297,386
03071900,MOUNT CARMEL COLLEGE OF NURSING         ,OH,43222-1598,Private      ,14,35,49,906,,1354,2260
03072303,EVEREST INSTITUTE - COLUMBUS            ,OH,43230-6653,Proprietary  ,24,136,160,184,,1014,1198
03078000,OHIO CENTER FOR BROADCASTING            ,OH,45227-1509,Proprietary  ,3,15,18,60,,240,300
03079000,ETI TECHNICAL COLLEGE                   ,OH,44446-4398,Proprietary  ,6,30,36,79,,346,425
03084800,DELAWARE AREA CAREER CENTER             ,OH,43015-8969,Public       ,0,4,4,26,,91,117
03084801,DELAWARE AREA CAREER CENTER -           ,OH,43015-9001,Public       ,0,2,2,15,,56,71
03095600,VANTAGE CAREER CENTER                   ,OH,45891-1378,Public       ,0,1,1,19,,117,136
03097000,MERCY COLLEGE OF NORTHWEST OHIO         ,OH,43604-1132,Private      ,5,34,39,682,,1484,2166
03100100,PARAMOUNT BEAUTY ACADEMY                ,OH,45662-4136,Proprietary  ,4,13,17,47,,161,208
03116200,DAYTON BARBER COLLEGE                   ,OH,45342-0000,Proprietary  ,2,17,19,27,,142,169
03116300,OHIO COLLEGE OF MASSOTHERAPY            ,OH,44321-1363,Private      ,3,16,19,44,,214,258
03116400,VANGUARD-SENTINELL VOC SCH DISTRICT     ,OH,43420-1197,Public       ,0,1,1,19,,83,102
03117000,ASHLAND COUNTY-W HOLMES CAREER CTR      ,OH,44805-0000,Public       ,0,5,5,33,,163,196
03319300,CREATIVE IMAGES-A CERTIFIED MATRIX      ,OH,45414-2557,Proprietary  ,6,32,38,118,,308,426
03319301,CREATIVE IMAGES-A CERTIFIED MATRIX      ,OH,45459-0000,Proprietary  ,5,20,25,108,,265,373
03416400,VALLEY BEAUTY SCHOOL                    ,OH,43701-3624,Proprietary  ,1,2,3,16,,55,71
03425300,ROSEDALE BIBLE COLLEGE                  ,OH,43029-9517,Private      ,1,0,1,59,,16,75
03457300,ALLEGHENY WESLEYAN COLLEGE              ,OH,44460-9598,Private      ,1,1,2,46,,19,65
03468400,NATIONAL INSTITUTE OF MASSOTHERAPY      ,OH,44319-2100,Proprietary  ,0,8,8,21,,121,142
03468500,ATS INSTITUTE OF TECHNOLOGY             ,OH,44143-2216,Proprietary  ,5,56,61,85,,1000,1085
03475400,TRI-STATE BIBLE COLLEGE                 ,OH,45680-8402,Private      ,0,9,9,6,,89,95
03534400,AMERICAN INST OF ALTERNATIVE MEDICI     ,OH,43229-1113,Proprietary  ,4,65,69,82,,758,840
03626300,BROWN AVEDA INSTITUTE                   ,OH,44060-6212,Proprietary  ,10,35,45,209,,374,583
03700300,REGENCY BEAUTY INSTITUTE - CLEVELAND    ,OH,44094-0000,Proprietary  ,18,59,77,254,,538,792
03726300,TEMPLE BAPTIST COLLEGE                  ,OH,45240-0000,Private      ,2,2,4,90,,87,177
03747300,BEXLEY HALL SEMINARY                    ,OH,43209-2325,Private      ,0,4,4,6,,57,63
03776400,HEALING ARTS INSTITUTE                  ,OH,43551-3138,Proprietary  ,2,7,9,21,,75,96
03837300,AVEDA FREDRIC'S INSTITUTE               ,OH,45208-1304,Proprietary  ,8,31,39,180,,274,454
03882300,OREGON CAREER CENTER                    ,OH,43616-2631,Public       ,0,0,0,5,,8,13
04051307,ART INSTITUTE OF PHOENIX (THE) - BROWN M,OH,45215-1107,Proprietary  ,21,99,120,415,,1589,2004
04051308,ART INSTITUTE OF PHOENIX (THE) - BROWN M,OH,44320-4420,Proprietary  ,4,51,55,231,,962,1193
04051317,ART INSTITUTE OF PHOENIX (THE) - BROWN M,OH,45840-6848,Proprietary  ,49,228,277,631,,2789,3420
04051326,ART INSTITUTE OF PHOENIX (THE) - BROWN M,OH,44718-3674,Proprietary  ,7,79,86,156,,853,1009
04068300,FOUR COUNTY CAREER CENTER               ,OH,43512-9541,Public       ,1,1,2,12,,53,65
04074300,HONDROS COLLEGE                         ,OH,43081-3855,Proprietary  ,19,259,278,511,,3793,4304
04117300,DAYTON SCHOOL OF MEDICAL MASSAGE        ,OH,45429-1111,Proprietary  ,14,75,89,181,,628,809
04118300,NORTHCOAST MEDICAL TRAINING ACADEMY     ,OH,44240-4174,Proprietary  ,10,40,50,85,,294,379
04124500,TECHSKILLS                              ,OH,43231-0000,Proprietary  ,9,109,118,66,,650,716
04125700,CUT BEAUTY SCHOOL (THE)                 ,OH,44118-2918,Proprietary  ,0,0,0,52,,236,288
04126000,OHIO ACADEMY PAUL MITCHELL PARTNER SCHOO,OH,44087-3107,Proprietary  ,11,21,32,155,,253,408
04137800,AVEDA INSTITUTE COLUMBUS                ,OH,43201-2333,Proprietary  ,32,61,93,349,,612,961
04138000,INSTITUTE OF THERAPEUTIC MASSAGE        ,OH,45875-0350,Proprietary  ,0,4,4,9,,69,78
04149100,PAUL MITCHELL THE SCHOOL CINCINNATI     ,OH,45241-1702,Proprietary  ,15,31,46,206,,326,532
04149101,PAUL MITCHELL THE SCHOOL CINCINNATI - TO,OH,43560-2539,Proprietary  ,0,1,1,0,,1,1
04151400,VANITY SCHOOL OF COSMETOLOGY            ,OH,44035-0000,Proprietary  ,2,5,7,35,,89,124
04152100,TOLEDO RESTAURANT TRAINING CENTER       ,OH,43604-6508,Private      ,3,6,9,25,,126,151
04152600,PIKE COUNTY CAREER TECHNOLOGY CENTER    ,OH,45661-9114,Public       ,1,3,4,24,,103,127
04153300,OHIO ACADEMY COLUMBUS (THE)             ,OH,43231-6038,Proprietary  ,8,19,27,135,,296,431
04154000,TOLLES CAREER & TECHNICAL CENTER        ,OH,43064-8854,Public       ,0,0,0,12,,25,37
04166800,SALON PROFESSIONAL ACADEMY (THE)        ,OH,45551-0000,Proprietary  ,3,7,10,58,,84,142
04167700,ARTISAN COLLEGE OF COSMETOLOGY (THE)    ,OH,45840-6848,Proprietary  ,4,3,7,32,,43,75
04185900,ELITE SCHOOL OF COSMETOLOGY             ,OH,44857-2714,Proprietary  ,1,10,11,22,,68,90
04189100,TONI & GUY HAIRDRESSING ACADEMY         ,OH,43615-1731,Proprietary  ,5,15,20,108,,163,271
04192200,ATHENA CAREER ACADEMY                   ,OH,43560-2796,Proprietary  ,4,41,45,44,,364,408
04206700,ELITE WELDING ACADEMY                   ,OH,45246-1013,Proprietary  ,2,2,4,2,,2,4
04220900,NATIONAL PERSONAL TRAINING INSTITUTE OF ,OH,43235-5739,Proprietary  ,1,16,17,33,,131,164
04225700,LABARBERIA INSTITUTE OF HAIR            ,OH,44106-1923,Proprietary  ,1,14,15,8,,42,50
        ,INVALID SCHOOL CODE                     ,  ,00000-0000,,106,720,826,1360,,6098,7458
00134500,ADAMS STATE COLLEGE                     ,CO,81102-2373,Public       ,46,124,170,3136,,2497,5633
00134600,ARAPAHOE COMMUNITY COLLEGE              ,CO,80160-9002,Public       ,123,413,536,3690,,7912,11602
00134700,COLORADO COLLEGE                        ,CO,80903-3294,Private      ,34,62,96,3551,,1139,4690
00134800,COLORADO SCHOOL OF MINES                ,CO,80401-1887,Public       ,50,40,90,7070,,1584,8654
00134900,UNIVERSITY OF NORTHERN COLORADO         ,CO,80639-0001,Public       ,124,207,331,11600,,5807,17407
00135000,COLORADO STATE UNIVERSITY               ,CO,80523-0100,Public       ,290,366,656,27625,,11937,39562
00135200,DENVER  SEMINARY                        ,CO,80120-2192,Private      ,1,22,23,8,,812,820
00135300,FORT LEWIS COLLEGE                      ,CO,81301-3999,Public       ,77,54,131,5256,,1892,7148
00135400,ILIFF SCHOOL OF THEOLOGY                ,CO,80210-0000,Private      ,1,9,10,20,,378,398
00135500,LAMAR COMMUNITY COLLEGE                 ,CO,81052-3999,Public       ,10,27,37,492,,349,841
00135800,COLORADO MESA UNIVERSITY                ,CO,81501-3122,Public       ,125,203,328,8224,,4625,12849
00135900,COLORADO NORTHWESTERN COMMUNITY COLLEGE ,CO,81648-3598,Public       ,6,37,43,460,,519,979
00136000,METROPOLITAN STATE UNIVERSITY OF DENVER ,CO,80204-3362,Public       ,316,689,1005,13848,,19565,33413
00136100,NORTHEASTERN JUNIOR COLLEGE             ,CO,80751-2399,Public       ,19,42,61,1301,,573,1874
00136200,OTERO JUNIOR COLLEGE                    ,CO,81050-3346,Public       ,29,82,111,747,,767,1514
00136300,REGIS UNIVERSITY                        ,CO,80221-1099,Private      ,33,406,439,3662,,9598,13260
00136500,COLORADO STATE UNIVERSITY-PUEBLO        ,CO,81001-4901,Public       ,79,154,233,5715,,3702,9417
00136800,TRINIDAD STATE JR COLLEGE               ,CO,81082-2396,Public       ,24,78,102,846,,1285,2131
00137000,UNIVERSITY OF COLORADO-BOULDER          ,CO,80309-0077,Public       ,358,294,652,27776,,10666,38442
00137100,UNIVERSITY OF DENVER                    ,CO,80208-2000,Private      ,115,400,515,11093,,11098,22191
00137200,WESTERN STATE COLLEGE                   ,CO,81231-0000,Public       ,18,23,41,2476,,693,3169
00405702,NATIONAL AMERICAN UNIVERSITY - COLORADO ,CO,80920-4001,Proprietary  ,3,32,35,55,,552,607
00405703,NATIONAL AMERICAN UNIVERSITY            ,CO,80222-0000,Proprietary  ,2,13,15,35,,393,428
00450300,EVEREST COLLEGE                         ,CO,80916-3548,Proprietary  ,16,113,129,231,,1503,1734
00450600,COLORADO MOUNTAIN COLLEGE               ,CO,81602-0000,Public       ,53,118,171,1806,,2283,4089
00450700,EVEREST COLLEGE                         ,CO,80229-4339,Proprietary  ,18,93,111,162,,746,908
00450701,"EVEREST COLLEGE- EVEREST COLLEGE, AURORA",CO,80012-5692,Proprietary  ,23,96,119,211,,842,1053
00450800,UNIVERSITY OF COLORADO DENVER           ,CO,80204-2029,Public       ,184,597,781,10547,,17301,27848
00450900,UNIV OF COLORADO AT COLO SPRINGS        ,CO,80918-3735,Public       ,173,379,552,10327,,7681,18008
00559600,EMILY GRIFFITH OPPORTUNITY SCH          ,CO,80204-2197,Public       ,37,234,271,765,,2752,3517
00729700,REDSTONE COLLEGE                        ,CO,80020-9988,Proprietary  ,21,79,100,337,,957,1294
00732912,ITT TECHNICAL INSTITUTE                 ,CO,80229-5338,Proprietary  ,27,235,262,325,,1740,2065
00754800,WESTWOOD COLLEGE - DENVER NORTH         ,CO,80221-3653,Proprietary  ,16,107,123,299,,1391,1690
00754801,WESTWOOD COLLEGE - DENVER SOUTH         ,CO,80227-3653,Proprietary  ,8,90,98,166,,976,1142
00757306,EMPIRE BEAUTY SCHOOL - THORNTON         ,CO,80241-1659,Proprietary  ,0,0,0,77,,148,225
00758200,AIMS COMMUNITY COLLEGE                  ,CO,80632-0000,Public       ,80,224,304,2565,,4357,6922
00764900,ROCKY MOUNTAIN COLG OF ART & DESIGN     ,CO,80214-0000,Proprietary  ,32,113,145,890,,1040,1930
00793300,FRONT RANGE COMMUNITY COLLEGE           ,CO,80031-2199,Public       ,297,782,1079,8455,,15363,23818
00793806,LINCOLN COLLEGE OF TECHNOLOGY - DENVER  ,CO,80239-3006,Proprietary  ,153,139,292,1477,,1309,2786
00863500,INTELLITEC MEDICAL INSTITUTE            ,CO,80909-0000,Proprietary  ,6,62,68,155,,679,834
00887100,CONCORDE CAREER INSTITUTE               ,CO,80203-0000,Proprietary  ,61,252,313,553,,2087,2640
00889600,PIKES PEAK COMMUNITY COLLEGE            ,CO,80906-5498,Public       ,265,1139,1404,5687,,15396,21083
00940100,COLORADO CHRISTIAN UNIVERSITY           ,CO,80226-7449,Private      ,38,511,549,2257,,5169,7426
00945914,EMPIRE BEAUTY SCHOOL - ARVADA           ,CO,80003-4434,Proprietary  ,0,0,0,69,,156,225
00954200,COMMUNITY COLLEGE OF DENVER             ,CO,80217-2026,Public       ,176,704,880,6573,,13344,19917
00954300,RED ROCKS COMMUNITY COLLEGE             ,CO,80228-1255,Public       ,136,465,601,3603,,7305,10908
00966407,EMPIRE BEAUTY SCHOOL - LAKEWOOD         ,CO,80266-5107,Proprietary  ,0,0,0,37,,104,141
00998100,MORGAN COMMUNITY COLLEGE                ,CO,80701-4399,Public       ,39,64,103,408,,1069,1477
01014800,COLORADO TECHNICAL UNIVERSITY           ,CO,80907-3896,Proprietary  ,33,429,462,508,,5647,6155
01014802,COLORADO TECHNICAL UNIV - DENVER        ,CO,80111-3201,Proprietary  ,6,116,122,155,,1205,1360
01014805,COLORADO TECH UNIV - ON LINE            ,CO,80907-0000,Proprietary  ,366,4954,5320,2364,,45027,47391
01014812,COLORADO TECHNICAL UNIVERSITY - WESTMINS,CO,80021-3498,Proprietary  ,6,65,71,113,,857,970
01014815,COLORADO TECHNCL UNIV PUEBLO            ,CO,81003-2315,Proprietary  ,3,21,24,102,,433,535
01157200,COLORADO SCHOOL OF TRADES               ,CO,80215-2996,Proprietary  ,5,15,20,102,,492,594
01267000,BEL-REA INST OF ANIMAL TECH             ,CO,80247-3048,Proprietary  ,12,35,47,476,,763,1239
01285000,INTERNATIONAL SALON AND SPA ACADEMY     ,CO,80918-3684,Proprietary  ,10,45,55,111,,408,519
01287500,PICKENS TECHNICAL COLLEGE               ,CO,80011-9307,Public       ,13,47,60,442,,1142,1584
01300700,NAZARENE BIBLE COLLEGE                  ,CO,80910-3717,Private      ,3,56,59,77,,760,837
02078900,ART INSTITUTE OF COLORADO (THE)         ,CO,80203-2983,Proprietary  ,98,212,310,2196,,2639,4835
02116300,PUEBLO COMMUNITY COLLEGE                ,CO,81004-0000,Public       ,93,394,487,2371,,6622,8993
02117500,NAROPA UNIVERSITY                       ,CO,80302-0000,Private      ,8,33,41,404,,1366,1770
02141100,EMPIRE BEAUTY SCHOOL-LITTLETON          ,CO,80030-0000,Proprietary  ,0,0,0,88,,185,273
02156200,DELTA - MONTROSE TECHNICAL COLLEGE      ,CO,81416-0000,Public       ,8,27,35,102,,319,421
02165200,SALON PROFESSIONAL ACADEMY (THE)        ,CO,81504-5309,Proprietary  ,2,18,20,82,,133,215
02167600,KAPLAN COLLEGE                          ,CO,80229-5309,Proprietary  ,0,0,0,10,,64,74
02211901,CHEEKS INTERNATIONAL ACADEMY OF BEAUTY C,CO,80525-3053,Proprietary  ,0,4,4,31,,99,130
02211902,CHEEKS INTERNATIONAL ACDMY BTY CULT     ,CO,80631-0000,Proprietary  ,0,1,1,26,,62,88
02253700,INTELLITEC COLLEGE                      ,CO,80909-0000,Proprietary  ,34,164,198,219,,1075,1294
02267500,GLENWOOD BEAUTY ACADEMY                 ,CO,81601-0000,Proprietary  ,2,14,16,21,,65,86
02276900,COMMUNITY COLLEGE OF AURORA             ,CO,80011-9036,Public       ,100,448,548,3337,,8176,11513
02296004,PRINCE INSTITUTE - SOUTHEAST - PRINCE IN,CO,80031-2943,Proprietary  ,0,6,6,6,,105,111
02518500,HAIR DYNAMICS EDUCATION CENTER          ,CO,80525-0000,Proprietary  ,15,15,30,113,,223,336
02594300,COLLEGE AMERICA - DENVER                ,CO,80222-3380,Proprietary  ,37,256,293,462,,2595,3057
02611000,HERITAGE COLLEGE                        ,CO,80212-7413,Proprietary  ,28,112,140,281,,846,1127
03006300,INST OF BUSINESS & MEDICAL CAREERS      ,CO,80525-3044,Proprietary  ,51,174,225,460,,1648,2108
03010622,VIRGINIA COLLEGE - ECOTECH INSTITUTE - A,CO,80014-1405,Proprietary  ,4,21,25,85,,369,454
03012100,REMINGTON COLLEGE - COLORADO SPRINGS CAM,CO,80215-0000,Private      ,0,2,2,11,,42,53
03013100,BOULDER COLLEGE OF MASSAGE THERAPY      ,CO,80301-3295,Private      ,0,0,0,57,,135,192
03014900,PLATT COLLEGE                           ,CO,80014-3141,Proprietary  ,5,21,26,70,,359,429
03027400,XENON INTERNATIONAL ACADEMY III         ,CO,80014-1193,Proprietary  ,7,13,20,73,,155,228
03030606,UTAH COLLEGE OF MASSAGE THERAPY - DENVER,CO,80031-2921,Proprietary  ,9,28,37,63,,193,256
03030607,UTAH COLLEGE OF MASSAGE THERAPY - DENVER,CO,80012-2523,Proprietary  ,17,32,49,115,,242,357
03066900,INTELLITEC COLLEGE                      ,CO,81506-3994,Proprietary  ,29,108,137,237,,843,1080
03068201,OHIO CENTER FOR BROADCASTING - COLORADO ,CO,80214-4129,Proprietary  ,5,15,20,53,,200,253
03076401,BRYMAN SCHOOL OF ARIZONA (THE) - ANTHEM ,CO,80014-2622,Proprietary  ,2,7,9,85,,204,289
03289300,COLORADO HEIGHTS UNIVERSITY             ,CO,80236-2711,Private      ,17,63,80,173,,550,723
03306300,MONTESSORI EDUC CRT OF THE ROCKIES      ,CO,80301-2587,Private      ,1,4,5,6,,69,75
03534300,JONES INTERNATIONAL UNIVERSITY          ,CO,80112-3446,Proprietary  ,28,741,769,201,,6016,6217
03545300,UNIVERSITY OF THE ROCKIES               ,CO,80903-3612,Proprietary  ,4,297,301,113,,3082,3195
03584400,COLORADO SCHOOL OF HEALING ARTS         ,CO,80226-4332,Proprietary  ,4,21,25,85,,342,427
03670300,TONI & GUY HAIRDRESSING ACADEMY         ,CO,80911-0000,Proprietary  ,9,24,33,150,,270,420
03686300,COLORADO SCHOOL OF TRADITIONAL CHINESE M,CO,80206-2127,Proprietary  ,1,27,28,19,,288,307
03776300,AUGUSTE ESCOFFIER SCHOOL OF CULINARY ART,CO,80305-5961,Proprietary  ,33,66,99,330,,455,785
03976300,MASSAGE THERAPY INSTITUTE OF COLORADO   ,CO,80206-2127,Proprietary  ,7,23,30,88,,280,368
04080300,ASPEN UNIVERSITY                        ,CO,80246-1930,Proprietary  ,6,78,84,149,,996,1145
04093300,ACADEMY OF NATURAL THERAPY              ,CO,80631-3425,Proprietary  ,2,13,15,47,,147,194
04121200,INSTITUTE OF TAOIST EDUCATION AND ACUPUN,CO,80027-1028,Private      ,0,2,2,2,,62,64
04125100,MONTESSORI CASA INTERNATIONAL           ,CO,80111-5263,Private      ,0,0,0,1,,11,12
04127700,AMERICAN SENTINEL UNIVERSITY            ,CO,80014-6510,Proprietary  ,2,147,149,30,,1922,1952
04139300,NATIONAL BEAUTY COLLEGE                 ,CO,80221-0000,Proprietary  ,1,21,22,47,,196,243
04148300,DENVER SCHOOL OF NURSING                ,CO,80202-1213,Proprietary  ,22,66,88,436,,1519,1955
04151100,SUMMIT SALON & BEAUTY SCHOOL            ,CO,80866-4569,Proprietary  ,0,0,0,7,,18,25
04167100,AVEDA INSTITUTE DENVER                  ,CO,80202-0000,Proprietary  ,26,37,63,383,,605,988
04170200,PAUL MITCHELL THE SCHOOL COLORADO SPRING,CO,80903-0000,Proprietary  ,14,50,64,195,,407,602
04172500,ROLF INSTITUTE OF STRUCTURAL INTEGRATION,CO,80301-0000,Private      ,0,13,13,12,,125,137
04173800,SALON PROFESSIONAL ACADEMY (THE)        ,CO,80918-2932,Proprietary  ,5,19,24,79,,181,260
04177100,PIMA MEDICAL INSTITUTE-SOUTH DENVER     ,CO,80231-0000,Proprietary  ,28,70,98,319,,859,1178
04179700,UNITED BEAUTY COLLEGE                   ,CO,80223-2936,Proprietary  ,6,22,28,56,,149,205
04183700,HEALING ARTS INSTITUTE                  ,CO,80525-3479,Proprietary  ,3,13,16,53,,175,228
04184900,COLLEGE OF INTERNATIONAL ESTHETICS      ,CO,80002-3754,Proprietary  ,1,36,37,32,,203,235
04185000,COLORADO ACADEMY OF VETERINARY TECHNOLOG,CO,80906-4944,Proprietary  ,5,19,24,138,,265,403
04185400,NATIONAL PERSONAL TRAINING INSTITUTE OF ,CO,80401-3304,Proprietary  ,5,22,27,30,,159,189
04195300,LONGS PEAK ACADEMY                      ,CO,80501-6458,Proprietary  ,1,20,21,66,,167,233
04202600,NEW DIMENSIONS BEAUTY ACADEMY           ,CO,80138-9801,Proprietary  ,1,9,10,27,,73,100
04208700,COLORADO STATE UNIVERSITY - GLOBAL CAMPU,CO,80111-0000,Public       ,33,766,799,478,,7900,8378
04218900,ROCKY VISTA UNIVERSITY COLLEGE OF OSTEOP,CO,80134-9498,Proprietary  ,0,3,3,4,,620,624
04221400,PAUL MITCHELL THE SCHOOL DENVER         ,CO,80226-7395,Proprietary  ,12,16,28,57,,75,132
00267811,BRYANT & STRATTON COLLEGE - VIRGINIA BEA,VA,23462-4417,Proprietary  ,64,312,376,848,,4127,4975
00370200,AVERETT UNIVERSITY                      ,VA,24541-3692,Private      ,20,160,180,1780,,1879,3659
00370300,BLUEFIELD COLLEGE                       ,VA,24605-1799,Private      ,9,29,38,932,,757,1689
00370400,BRIDGEWATER COLLEGE                     ,VA,22812-1599,Private      ,29,7,36,3626,,260,3886
00370500,COLLEGE OF WILLIAM & MARY               ,VA,23187-8795,Public       ,106,55,161,11602,,4660,16262
00370600,CHRISTOPHER NEWPORT UNIVERSITY          ,VA,23606-3072,Public       ,84,48,132,8803,,1637,10440
00370700,RICHARD BLAND COLLEGE                   ,VA,23805-7100,Public       ,24,35,59,1537,,766,2303
00370800,EASTERN MENNONITE UNIVERSITY            ,VA,22802-2462,Private      ,13,27,40,1342,,677,2019
00370900,EMORY & HENRY COLLEGE                   ,VA,24327-0010,Private      ,14,3,17,1581,,184,1765
00371100,FERRUM COLLEGE                          ,VA,24088-2612,Private      ,24,8,32,3191,,366,3557
00371200,TIDEWATER COMMUNITY COLLEGE             ,VA,23510-1910,Public       ,301,1524,1825,12725,,29665,42390
00371300,HAMPDEN-SYDNEY COLLEGE                  ,VA,23943-0128,Private      ,11,1,12,1621,,74,1695
00371400,HAMPTON UNIVERSITY                      ,VA,23668-0099,Private      ,142,117,259,9165,,3963,13128
00371500,HOLLINS UNIVERSITY                      ,VA,24020-0000,Private      ,11,27,38,811,,680,1491
00371900,LONGWOOD UNIVERSITY                     ,VA,23909-1899,Public       ,43,21,64,6005,,1072,7077
00372000,LYNCHBURG COLLEGE                       ,VA,24501-3199,Private      ,25,32,57,4015,,1281,5296
00372100,JAMES MADISON UNIVERSITY                ,VA,22807-3780,Public       ,214,80,294,26454,,3396,29850
00372300,MARY BALDWIN COLLEGE                    ,VA,24401-3610,Private      ,27,57,84,1815,,1290,3105
00372400,MARYMOUNT UNIVERSITY                    ,VA,22207-4224,Private      ,39,84,123,3215,,2785,6000
00372600,NATIONAL COLLEGE                        ,VA,24153-4524,Proprietary  ,50,418,468,599,,5285,5884
00372700,NORTHERN VA CMTY CLG                    ,VA,22003-3743,Public       ,534,1538,2072,18884,,25034,43918
00372800,OLD DOMINION UNIVERSITY                 ,VA,23529-0052,Public       ,273,632,905,20824,,17517,38341
00373200,RADFORD UNIVERSITY                      ,VA,24142-6905,Public       ,119,68,187,11626,,3145,14771
00373300,RANDOLPH-MACON COLLEGE                  ,VA,23005-5505,Private      ,27,6,33,2785,,208,2993
00373400,RANDOLPH COLLEGE                        ,VA,24503-1526,Private      ,12,7,19,1095,,231,1326
00373500,VIRGINIA COMMONWEALTH UNIVERSITY        ,VA,23284-9004,Public       ,330,381,711,26905,,16155,43060
00373600,ROANOKE COLLEGE                         ,VA,24153-3794,Private      ,25,8,33,3592,,341,3933
00373700,SHENANDOAH UNIVERSITY                   ,VA,22601-5195,Private      ,23,69,92,3013,,2490,5503
00373800,SOUTHERN VIRGINIA UNIVERSITY            ,VA,24416-3038,Private      ,18,7,25,1116,,389,1505
00373900,ST PAULS COLLEGE                        ,VA,23868-1299,Private      ,0,0,0,114,,123,237
00374200,SWEET BRIAR COLLEGE                     ,VA,24595-9998,Private      ,14,7,21,1079,,118,1197
00374300,UNION PRESBYTERIAN SEMINARY             ,VA,23227-0000,Private      ,0,6,6,6,,119,125
00374400,UNIVERSITY OF RICHMOND                  ,VA,23173-0001,Private      ,52,78,130,6855,,3270,10125
00374500,UNIVERSITY OF VIRGINIA - SFS            ,VA,22903-0000,Public       ,180,132,312,22386,,8947,31333
00374600,UNIVERSITY OF MARY WASHINGTON           ,VA,22401-5358,Public       ,64,50,114,5601,,1682,7283
00374700,UNIV OF VIRGINIA'S COLLEGE AT WISE      ,VA,24293-4412,Public       ,16,21,37,2053,,671,2724
00374800,EASTERN SHORE COMMUNITY COLLEGE         ,VA,23410-3001,Public       ,5,18,23,410,,746,1156
00374900,GEORGE MASON UNIVERSITY                 ,VA,22030-4444,Public       ,322,512,834,24700,,17385,42085
00375100,PATRICK HENRY COMMUNITY COLLEGE         ,VA,24112-5311,Public       ,26,88,114,1290,,2439,3729
00375200,VIRGINIA INTERMONT COLLEGE              ,VA,24201-4298,Private      ,8,5,13,541,,280,821
00375300,VIRGINIA MILITARY INSTITUTE             ,VA,24450-2138,Public       ,32,6,38,2446,,143,2589
00375400,VIRGINIA POLYTECH INST & STATE UNIV     ,VA,24061-2000,Public       ,250,164,414,27343,,6239,33582
00375800,DANVILLE COMMUNITY COLLEGE              ,VA,24541-4004,Public       ,65,147,212,1720,,3061,4781
00375900,J. SARGEANT REYNOLDS COMMUNITY CLG      ,VA,23285-0000,Public       ,124,581,705,6220,,13585,19805
00376000,VIRGINIA WESTERN CMTY COLLEGE           ,VA,24038-0000,Public       ,55,235,290,3466,,5216,8682
00376100,WYTHEVILLE COMMUNITY COLLEGE            ,VA,24382-3308,Public       ,30,83,113,1334,,2085,3419
00376200,VIRGINIA UNIVERSITY OF LYNCHBURG        ,VA,24501-6400,Private      ,8,14,22,451,,764,1215
00376400,VIRGINIA STATE UNIVERSITY               ,VA,23806-0001,Public       ,115,113,228,10300,,4138,14438
00376500,NORFOLK STATE UNIVERSITY                ,VA,23504-8000,Public       ,102,238,340,9619,,8615,18234
00376600,VIRGINIA UNION UNIVERSITY               ,VA,23220-1711,Private      ,69,62,131,2938,,1761,4699
00376700,VIRGINIA WESLEYAN COLLEGE               ,VA,23502-5599,Private      ,28,35,63,3415,,1145,4560
00376800,WASHINGTON & LEE UNIVERSITY             ,VA,24450-0303,Private      ,21,4,25,3432,,1140,4572
00400400,JOHN TYLER COMMUNITY COLLEGE            ,VA,23831-5316,Public       ,118,289,407,4510,,6970,11480
00450301,EVEREST COLLEGE -  MCLEAN               ,VA,22182-2214,Proprietary  ,11,41,52,93,,456,549
00450702,"EVEREST COLLEGE- EVEREST COLLEGE, ARLING",VA,22203-1905,Proprietary  ,0,0,0,42,,159,201
00498800,CENTRAL VIRGINIA COMMUNITY COLLEGE      ,VA,24502-2498,Public       ,37,116,153,2009,,2836,4845
00499200,MILLER-MOTTE TECHNICAL COLLEGE          ,VA,24505-0000,Proprietary  ,27,173,200,394,,1543,1937
00499600,DABNEY S LANCASTER COMMUNITY CLG        ,VA,24422-1000,Public       ,16,26,42,611,,685,1296
00522300,NEW RIVER COMMUNITY COLLEGE             ,VA,24084-1127,Public       ,39,127,166,1761,,2750,4511
00662200,COLLEGE OF HEALTH SCIENCES - CHRV       ,VA,24031-0000,Private      ,4,37,41,683,,1241,1924
00681900,BLUE RIDGE COMMUNITY COLLEGE            ,VA,24486-0080,Public       ,45,159,204,2374,,2927,5301
00687100,THOMAS NELSON COMMUNITY COLLEGE         ,VA,23670-0000,Public       ,124,506,630,4876,,11167,16043
00709900,VIRGINIA HIGHLANDS COMMUNITY CLG        ,VA,24210-4210,Public       ,28,68,96,1201,,1866,3067
00726000,SOUTHWEST VIRGINIA COMMUNITY CLG        ,VA,24641-0000,Public       ,31,109,140,1234,,1931,3165
00859200,LOUISE OBICI SCHOOL OF NURSING          ,VA,23434-8038,Private      ,0,0,0,4,,23,27
00865900,LORD FAIRFAX COMMUNITY COLLEGE          ,VA,22645-0047,Public       ,52,179,231,2558,,3700,6258
00866000,GERMANNA COMMUNITY COLLEGE              ,VA,22508-0339,Public       ,86,246,332,3272,,4817,8089
00866100,SOUTHSIDE VIRGINIA CMTY CLG             ,VA,23821-2930,Public       ,81,252,333,1886,,3360,5246
00915900,PAUL D CAMP COMMUNITY COLLEGE           ,VA,23851-0737,Public       ,12,68,80,567,,1435,2002
00916000,RAPPAHANNOCK COMMUNITY COLLEGE          ,VA,23149-2616,Public       ,23,121,144,983,,1713,2696
00926700,EVEREST COLLEGE                         ,VA,23606-4203,Proprietary  ,22,108,130,224,,1200,1424
00926701,EVEREST COLLEGE - CHESAPEAKE            ,VA,23320-2637,Proprietary  ,32,164,196,294,,1488,1782
00942000,SANFORD-BROWN COLLEGE                   ,VA,22182-3913,Proprietary  ,1,8,9,46,,281,327
00953500,STAUNTON SCHOOL OF COSMETOLOGY          ,VA,24401-4323,Proprietary  ,3,7,10,28,,80,108
00953700,VIRGINIA SCH OF HAIR DESIGN             ,VA,23669-0000,Proprietary  ,3,15,18,59,,246,305
00962900,MOUNTAIN EMPIRE COMMUNITY COLLEGE       ,VA,24219-0700,Public       ,33,117,150,1195,,1968,3163
00992800,PIEDMONT VIRGINIA COMMUNITY COLLEGE     ,VA,22902-7589,Public       ,36,162,198,1986,,3367,5353
01004300,BON SECOURS MEMORIAL COLLEGE OF NURSING ,VA,23227-4612,Private      ,7,29,36,382,,965,1347
01019800,ECPI UNIVERSITY                         ,VA,23462-6542,Proprietary  ,127,795,922,2676,,11863,14539
01019802,ECPI UNIVERSITY - NEWPORT NEWS          ,VA,23606-4298,Proprietary  ,29,161,190,54,,340,394
01019807,ECPI UNIVERSITY - MANASSAS              ,VA,20109-2665,Proprietary  ,22,101,123,46,,202,248
01019813,ECPI UNIVERSITY - CULINARY INSTITUTE OF ,VA,23513-2448,Proprietary  ,10,35,45,23,,94,117
01019814,ECPI UNIVERSITY - VIRGINIA BEACH HEALTH ,VA,23462-6540,Proprietary  ,4,53,57,31,,158,189
01019815,ECPI UNIVERSITY - RICHMOND SOUTH        ,VA,23236-3659,Proprietary  ,11,86,97,44,,201,245
01019816,ECPI UNIVERSITY - INNSBROOK             ,VA,23060-3359,Proprietary  ,11,31,42,26,,68,94
01019817,ECPI UNIVERSITY - RICHMOND WEST         ,VA,23294-3730,Proprietary  ,6,48,54,27,,130,157
01033800,EASTERN VIRGINIA MEDICAL SCHOOL         ,VA,23501-1980,Public       ,5,29,34,151,,2004,2155
01159600,SYLVAIN MELLOUL INTERNATIONAL HAIR ACADE,VA,24502-2652,Proprietary  ,3,16,19,52,,157,209
01162601,WESTWOOD COLLEGE - SOUTH BAY - ARLINGTON,VA,22203-4167,Proprietary  ,15,63,78,224,,767,991
01162602,WESTWOOD COLLEGE - SOUTH BAY - ANNANDALE,VA,22003-2602,Proprietary  ,12,61,73,148,,625,773
01274400,SOUTHSIDE REGIONAL MED CTR PROF SCHOOLS ,VA,23803-5133,Proprietary  ,3,9,12,112,,367,479
02053000,LIBERTY UNIVERSITY                      ,VA,24502-0000,Private      ,440,6299,6739,21923,,93123,115046
02083602,TESST COLLEGE OF TECHNOLOGY - KAPLAN COL,VA,23320-4422,Proprietary  ,0,0,0,8,,104,112
02108800,WARDS CORNER BEAUTY ACADEMY             ,VA,23505-0000,Proprietary  ,4,47,51,99,,496,595
02111600,DANVILLE REGIONAL MEDICAL CENTER SCHOOL ,VA,24541-0000,Proprietary  ,1,2,3,48,,127,175
02119203,COURT REPORTING INSTITUTE OF DALLAS - CO,VA,22203-4179,Proprietary  ,0,0,0,7,,41,48
02128700,CENTRAL SCHOOL OF PRACTICAL NURSING     ,VA,23502-2230,Public       ,5,26,31,126,,428,554
02140000,RIVERSIDE SCHOOL OF HEALTH CAREERS      ,VA,23608-3802,Private      ,5,19,24,236,,839,1075
02149901,PAUL MITCHELL THE SCHOOL-JACKSONVILLE - ,VA,22102-0000,Proprietary  ,14,25,39,87,,146,233
02149902,PAUL MITCHELL THE SCHOOL-JACKSONVILLE - ,VA,22192-0000,Proprietary  ,15,24,39,88,,200,288
02175800,LYNCHBURG GENERAL HOSP SCH OF NURSG     ,VA,24501-0000,Private      ,1,11,12,142,,375,517
02197600,WOODROW WILSON REHABILITATION CTR       ,VA,22939-0000,Public       ,11,11,22,65,,51,116
02242400,HENRICO CTY ST MARYS HOSP PRAC NRSG     ,VA,23075-0000,Public       ,1,1,2,30,,89,119
02320900,TIDEWATER TECH                          ,VA,23502-1747,Proprietary  ,30,121,151,372,,1366,1738
02334400,CENTURA COLLEGE                         ,VA,23452-0000,Proprietary  ,36,216,252,493,,3191,3684
02342700,FORTIS COLLEGE                          ,VA,23502-4101,Proprietary  ,24,131,155,244,,1195,1439
02342701,FORTIS COLLEGE - RICHMOND CAMPUS        ,VA,23236-3472,Proprietary  ,20,85,105,307,,1038,1345
02358500,BON SECOURS SAINT MARY'S HOSPITAL SCHOOL,VA,23227-4612,Private      ,4,15,19,132,,461,593
02538800,SUFFOLK BEAUTY ACADEMY                  ,VA,23434-0000,Proprietary  ,4,11,15,36,,134,170
02541200,STRATFORD UNIVERSITY                    ,VA,22043-0000,Proprietary  ,36,311,347,627,,2868,3495
02541201,STRATFORD UNIVERSITY-WOODBRIDGE         ,VA,22192-0000,Proprietary  ,5,53,58,246,,1199,1445
02588900,MEDTECH INSTITUTE                       ,VA,22042-3013,Proprietary  ,70,305,375,436,,1732,2168
02610100,WASHINGTON COUNTY ADULT SKILL CTR       ,VA,24210-2346,Public       ,8,8,16,57,,196,253
02617508,EVEREST COLLEGE - WOODBRIDGE            ,VA,22192-6808,Proprietary  ,17,133,150,23,,181,204
03002400,GRAHAM WEBB INTERNATIONAL ACAD HAIR     ,VA,22209-2129,Proprietary  ,8,18,26,69,,161,230
03010700,BAR PALMA BEAUTY CAREERS  ACADEMY       ,VA,24014-2255,Proprietary  ,1,10,11,36,,197,233
03042800,"VIRGINIA BEACH CITY SCHOOLS, SCH.-PR.NSG",VA,23456-0038,Public       ,0,16,16,76,,254,330
03091300,REGENT UNIVERSITY                       ,VA,23464-9800,Private      ,18,291,309,1914,,7307,9221
03092700,SKYLINE COLLEGE                         ,VA,24012-1603,Proprietary  ,6,46,52,110,,522,632
03096500,SPRINGFIELD BEAUTY ACADEMY              ,VA,22003-3016,Proprietary  ,0,10,10,13,,124,137
03106500,SENTARA NORFOLK GENERAL HOSPITAL        ,VA,23320-2843,Private      ,5,39,44,196,,896,1092
03116900,BAPTIST THEOLOGICAL SEM.-RICHMOND       ,VA,23227-0000,Private      ,0,7,7,10,,180,190
03126300,AVIATION INSTITUTE OF MAINTENANCE       ,VA,23320-5987,Proprietary  ,14,63,77,122,,545,667
03126400,CENTURA COLLEGE                         ,VA,23235-5230,Proprietary  ,10,95,105,214,,1218,1432
03127500,ADVANCED TECHNOLOGY INSTITUTE           ,VA,23462-2409,Proprietary  ,30,98,128,603,,1016,1619
03280400,VIRGINIA SCHOOL OF MASSAGE              ,VA,22903-0000,Proprietary  ,7,30,37,65,,226,291
03409500,RICHMOND SCHOOL OF HEALTH AND TECH      ,VA,23227-0000,Proprietary  ,13,48,61,149,,670,819
03455300,CRESCENT COSMETOLOGY UNIVERSITY         ,VA,23666-3115,Proprietary  ,0,5,5,18,,87,105
03559300,APPALACHIAN SCHOOL OF LAW               ,VA,24614-0000,Private      ,1,6,7,13,,446,459
03645400,RUDY & KELLY ACADEMY OF HAIR AND NA     ,VA,23464-6857,Proprietary  ,9,39,48,167,,427,594
03654300,CAREER TRAINING SOLUTIONS               ,VA,22406-1014,Proprietary  ,13,83,96,175,,882,1057
03709300,EDWARD VIA VIRGINIA CLG OSTEOPATHIC MED ,VA,24060-6360,Private      ,0,2,2,14,,890,904
03862600,VIRGINIA BAPTIST COLLEGE                ,VA,22407-0000,Private      ,1,15,16,11,,32,43
03872400,INSTITUTE FOR THE PSYCHOLOGICAL SCIENCES,VA,22202-3609,Private      ,1,4,5,22,,174,196
03876300,CULPEPER COSMETOLOGY TRAINING CENTER    ,VA,22701-3155,Public       ,2,7,9,34,,83,117
03883400,AVIATION INSTITUTE OF MAINTENANCE       ,VA,20110-4156,Proprietary  ,7,33,40,93,,365,458
04038400,AVI CAREER INSTITUTE                    ,VA,22066-1839,Proprietary  ,2,18,20,10,,120,130
04110300,UNIVERSITY OF MANAGEMENT AND TECHNOLOGY ,VA,22209-1609,Proprietary  ,1,69,70,29,,548,577
04124000,DOMINION SCHOOL OF HAIR DESIGN          ,VA,23062-2221,Proprietary  ,4,6,10,23,,62,85
04127300,COLUMBIA COLLEGE                        ,VA,22031-4413,Proprietary  ,6,133,139,80,,671,751
04133400,CENTURA COLLEGE                         ,VA,22312-2670,Proprietary  ,9,26,35,107,,516,623
04133800,SOUTHEAST CULINARY & HOSPITALITY COLLEGE,VA,24201-4159,Proprietary  ,0,0,0,29,,36,65
04137300,CAYCE/REILLY SCHOOL OF MASSOTHERAPY     ,VA,23451-2061,Private      ,1,7,8,23,,110,133
04140000,GLOBAL HEALTH NURSE TRAINING SERVICES   ,VA,22314-4585,Proprietary  ,1,47,48,57,,693,750
04153800,BETHEL COLLEGE                          ,VA,23666-3122,Private      ,0,7,7,65,,161,226
04156200,INSTITUTE OF ADVANCED MEDICAL ESTHETICS ,VA,23294-4701,Proprietary  ,3,17,20,30,,163,193
04169400,NORTHERN VIRGINIA SCHOOL OF THERAPEUTIC ,VA,22046-4302,Proprietary  ,2,18,20,51,,179,230
04171500,COSMOPOLITAN BEAUTY & TECH SCHOOL       ,VA,22003-3204,Proprietary  ,1,36,37,28,,234,262
04179900,TOMORROW'S IMAGE BARBER ACADEMY OF VIRGI,VA,23602-5532,Proprietary  ,2,14,16,20,,102,122
04180600,APPALACHIAN COLLEGE OF PHARMACY         ,VA,24631-9210,Private      ,1,2,3,18,,317,335
04218600,VIRGINIA TECH CARILION SCHOOL OF MEDICIN,VA,24016-4950,Private      ,6,13,19,12,,25,37
04219000,IGLOBAL UNIVERSITY                      ,VA,22003-2400,Proprietary  ,0,1,1,0,,1,1
04220100,NATIONAL PERSONAL TRAINING INSTITUTE    ,VA,22182-2412,Proprietary  ,0,1,1,0,,1,1
04220400,CHRYSM INSTITUTE OF ESTHETICS (THE)     ,VA,23462-3650,Proprietary  ,2,28,30,20,,152,172
04221000,"STANDARD HEALTHCARE SERVICES, COLLEGE OF",VA,22046-4612,Proprietary  ,2,33,35,9,,143,152
00107000,THUNDERBIRD SCHOOL OF GLOBAL MANAGEMENT ,AZ,85306-6000,Private      ,1,20,21,43,,694,737
00107100,ARIZONA WESTERN COLLEGE                 ,AZ,85366-0000,Public       ,131,224,355,5166,,5428,10594
00107200,COCHISE COLLEGE                         ,AZ,85607-6190,Public       ,58,206,264,1770,,3162,4932
00107300,EASTERN ARIZONA COLLEGE                 ,AZ,85552-0769,Public       ,44,91,135,1702,,1814,3516
00107400,GRAND CANYON UNIVERSITY                 ,AZ,85017-3030,Proprietary  ,451,8123,8574,14690,,72481,87171
00107600,GLENDALE COMMUNITY COLLEGE              ,AZ,85302-3090,Public       ,324,838,1162,12319,,16897,29216
00107700,MESA COMMUNITY COLLEGE                  ,AZ,85202-4866,Public       ,332,933,1265,12390,,21061,33451
00107800,PHOENIX COLLEGE                         ,AZ,85013-4234,Public       ,179,801,980,7004,,17440,24444
00107900,YAVAPAI COLLEGE                         ,AZ,86301-3297,Public       ,53,200,253,2249,,5019,7268
00108100,ARIZONA STATE UNIV (ALL CAMPUSES)       ,AZ,85287-0412,Public       ,899,2098,2997,59918,,49825,109743
00108200,NORTHERN ARIZONA UNIVERSITY             ,AZ,86011-0001,Public       ,515,626,1141,32817,,16272,49089
00108300,UNIVERSITY OF ARIZONA                   ,AZ,85721-0066,Public       ,653,645,1298,35151,,18081,53232
00165701,MIDWESTERN UNIVERSITY                   ,AZ,85308-0000,Private      ,9,66,75,216,,4290,4506
00446700,TUCSON COLLEGE                          ,AZ,85711-3781,Proprietary  ,30,127,157,355,,989,1344
00711300,ARIZONA CHRISTIAN UNIVERSITY            ,AZ,85032-7097,Private      ,30,45,75,1129,,684,1813
00726600,PIMA COUNTY COMMUNITY COLLEGE           ,AZ,85709-1110,Public       ,383,951,1334,11745,,18552,30297
00728300,CENTRAL ARIZONA COLLEGE                 ,AZ,85228-9779,Public       ,119,300,419,3197,,5566,8763
00732911,ITT TECHNICAL INSTITUTE                 ,AZ,85282-9272,Proprietary  ,89,382,471,729,,3351,4080
00732990,ITT TECHNICAL INSTITUTE                 ,AZ,85704-5829,Proprietary  ,102,395,497,861,,2967,3828
00822100,UNIVERSAL TECHNICAL INSTITUTE           ,AZ,85323-7946,Proprietary  ,559,701,1260,9387,,7701,17088
00824600,DINÉ COLLEGE                            ,AZ,86556-0126,Public       ,35,82,117,887,,1488,2375
00830300,GATEWAY COMMUNITY COLLEGE               ,AZ,85034-1795,Public       ,138,565,703,3751,,10178,13929
00830302,MARICOPA SKILL CENTER                   ,AZ,85034-0000,Public       ,26,122,148,456,,1761,2217
00830400,SCOTTSDALE COMMUNITY COLLEGE            ,AZ,85250-0000,Public       ,135,313,448,4677,,6226,10903
00886400,ARIZONA ACADEMY OF BEAUTY               ,AZ,85712-5021,Proprietary  ,7,18,25,102,,207,309
00886500,ARTISTIC BEAUTY COLLEGES-TUCSON         ,AZ,85716-3999,Proprietary  ,0,0,0,107,,187,294
00945915,EMPIRE BEAUTY SCHOOL - NW PHOENIX       ,AZ,85051-8499,Proprietary  ,0,0,0,123,,319,442
01054207,EMPIRE BEAUTY SCHOOL - FLAGSTAFF        ,AZ,86004-5119,Proprietary  ,0,0,0,114,,210,324
01084700,ARIZONA AUTOMOTIVE INSTITUTE            ,AZ,85301-3503,Proprietary  ,75,259,334,459,,1300,1759
01085800,AVALON SCHOOL OF COSMETOLOGY            ,AZ,85210-4010,Proprietary  ,53,86,139,610,,985,1595
01168900,REFRIGERATION SCHOOL                    ,AZ,85034-0000,Proprietary  ,30,174,204,206,,1109,1315
01180200,ARIZONA ACADEMY OF BEAUTY-NORTH         ,AZ,85705-2720,Proprietary  ,4,12,16,59,,139,198
01186200,NORTHLAND PIONEER COLLEGE               ,AZ,86025-0610,Public       ,24,86,110,730,,2026,2756
01186400,MOHAVE COMMUNITY COLLEGE                ,AZ,86409-1238,Public       ,48,219,267,1647,,4806,6453
01218400,INTERNATIONAL ACAD OF HAIR DESIGN       ,AZ,85225-7198,Proprietary  ,9,24,33,123,,287,410
01234300,ARTISTIC BEAUTY COLLEGES-PHOENIX        ,AZ,85304-0000,Proprietary  ,0,0,0,125,,260,385
01293700,ARTISTIC BEAUTY COLLEGES - PARADISE VALL,AZ,85257-0000,Proprietary  ,0,0,0,77,,219,296
02065300,PRESCOTT COLLEGE                        ,AZ,86301-0000,Private      ,6,32,38,638,,1239,1877
02071200,KAPLAN COLLEGE                          ,AZ,85029-4349,Proprietary  ,8,97,105,191,,1397,1588
02098800,UNIVERSITY OF PHOENIX                   ,AZ,85040-0000,Proprietary  ,2093,40539,42632,18625,,357219,375844
02100500,UNIVERSAL TECHNICAL INSTITUTE           ,AZ,85027-0000,Proprietary  ,400,722,1122,6452,,9328,15780
02100600,CARRINGTON COLLEGE                      ,AZ,85015-4096,Proprietary  ,163,537,700,1947,,5794,7741
02113800,ROBERTO-VENN SCH OF LUTHIERY            ,AZ,85040-0000,Proprietary  ,2,5,7,32,,74,106
02146600,SOUTH MOUNTAIN COMMUNITY COLLEGE        ,AZ,85040-0000,Public       ,92,328,420,2935,,6297,9232
02160305,COLLINS COLLEGE                         ,AZ,85040-4000,Proprietary  ,4,23,27,266,,609,875
02160306,INTERNATIONAL ACADEMY OF DESIGN AND TECH,AZ,85281-6705,Proprietary  ,2,7,9,42,,97,139
02171500,WESTERN INTERNATIONAL UNIVERSITY        ,AZ,85021-0000,Proprietary  ,7,179,186,80,,1847,1927
02177500,RIO SALADO COMMUNITY COLLEGE            ,AZ,85281-6948,Public       ,184,1464,1648,3333,,20372,23705
02199900,AMERICAN INDIAN CLG-ASSEMBLIES GOD      ,AZ,85021-0000,Private      ,3,9,12,56,,161,217
02217100,PIMA MEDICAL INSTITUTE                  ,AZ,85716-0000,Proprietary  ,428,1207,1635,3592,,10329,13921
02218800,BROOKLINE COLLEGE                       ,AZ,85021-5815,Proprietary  ,47,291,338,449,,2356,2805
02218804,BROOKLINE COLLEGE - MESA                ,AZ,85204-4448,Proprietary  ,27,109,136,229,,895,1124
02218805,BROOKLINE COLLEGE - TUCSON              ,AZ,85711-5444,Proprietary  ,36,137,173,322,,1116,1438
02263100,ANTHEM COLLEGE                          ,AZ,85014-0000,Proprietary  ,80,363,443,784,,4034,4818
02280500,CHARLES OF ITALY BEAUTY COLLEGE         ,AZ,86403-0000,Proprietary  ,4,13,17,63,,127,190
02295000,EVEREST COLLEGE                         ,AZ,85021-1610,Proprietary  ,154,1300,1454,1067,,7297,8364
02295002,EVEREST COLLEGE - MESA                  ,AZ,85206-4704,Proprietary  ,22,119,141,301,,1446,1747
02317800,AMERICAN INSTITUTE OF TECHNOLOGY        ,AZ,85043-0000,Proprietary  ,16,270,286,217,,1312,1529
02491500,THE ART CENTER DESIGN COLLEGE           ,AZ,85716-0000,Proprietary  ,8,16,24,229,,465,694
02533200,FRANK LLOYD WRIGHT SCHOOL OF ARCHITECTUR,AZ,85261-4430,Private      ,2,4,6,35,,86,121
02559000,UNIVERSITY OF ADVANCING TECHNOLOGY      ,AZ,85283-0000,Proprietary  ,33,73,106,1203,,1013,2216
02561900,BRILLARE HAIRDRESSING ACADEMY           ,AZ,85254-3301,Proprietary  ,8,9,17,138,,202,340
02582700,CORTIVA INSTITUTE - TUCSON              ,AZ,85710-3503,Proprietary  ,6,41,47,136,,337,473
02616700,LE CORDON BLEU COLLEGE OF CULINARY ARTS ,AZ,85251-2729,Proprietary  ,95,480,575,1162,,4103,5265
02623600,PARADISE VALLEY COMMUNITY COLLEGE       ,AZ,85032-1210,Public       ,127,312,439,4191,,6309,10500
02623800,CORTIVA INSTITUTE - SCOTTSDALE          ,AZ,85257-4218,Proprietary  ,7,19,26,35,,161,196
03005000,SAFFORD COLLEGE OF BEAUTY CULTURE       ,AZ,85546-3309,Proprietary  ,0,5,5,8,,41,49
03010613,VIRGINIA COLLEGE - GOLF ACADEMY OF ARIZO,AZ,85225-6742,Proprietary  ,0,5,5,37,,98,135
03030604,UTAH COLLEGE OF MASSAGE THERAPY - ARIZON,AZ,85282-0000,Proprietary  ,11,37,48,122,,327,449
03030605,UTAH COLLEGE OF MASSAGE THERAPY - ARIZON,AZ,85051-3470,Proprietary  ,24,62,86,213,,465,678
03034400,CONSERVATORY RECORDING ARTS & SCIS      ,AZ,85282-1707,Proprietary  ,56,66,122,798,,850,1648
03072200,CHANDLER-GILBERT COMMUNITY COLLEGE      ,AZ,85225-2499,Public       ,166,336,502,6433,,7889,14322
03076400,BRYMAN SCHOOL OF ARIZONA                ,AZ,85029-4919,Proprietary  ,37,119,156,383,,1278,1661
03097800,CARSTEN INSTITUTE OF HAIR & BEAUTY      ,AZ,85282-5404,Proprietary  ,13,36,49,115,,271,386
03100400,COCONINO COUNTY COMMUNITY COLLEGE       ,AZ,86001-0000,Public       ,50,113,163,2037,,2734,4771
03107000,SOUTHWEST CLG OF NATUROPATHIC MED       ,AZ,85282-0000,Private      ,2,25,27,28,,676,704
03115000,ARIZONA COLLEGE OF ALLIED HEALTH        ,AZ,85302-3843,Proprietary  ,51,241,292,468,,1638,2106
03120300,COLLEGE AMERICA                         ,AZ,86004-3936,Proprietary  ,49,199,248,371,,1627,1998
03156300,ESTRELLA MOUNTAIN COMMUNITY COLLEGE     ,AZ,85392-1010,Public       ,182,447,629,5369,,8959,14328
03347300,INTERNATIONAL BAPTIST COLLEGE           ,AZ,85282-6799,Private      ,3,3,6,45,,33,78
03445300,HDS TRUCK DRIVING INSTITUTE             ,AZ,85731-0000,Proprietary  ,1,45,46,32,,306,338
03478400,PHOENIX SEMINARY                        ,AZ,85018-7611,Private      ,1,12,13,5,,206,211
03572300,EAST VALLEY INSTITUTE OF TECHNOLOGY     ,AZ,85201-6910,Public       ,27,56,83,494,,1129,1623
03593300,SOUTHWEST INSTITUTE OF HEALING ARTS     ,AZ,85281-3658,Proprietary  ,17,225,242,208,,2054,2262
03617500,PHOENIX INSTITUTE OF HERBAL MEDICINE & A,AZ,85012-0000,Proprietary  ,3,32,35,71,,503,574
03695500,ARIZONA SCHOOL OF ACUPUNCTURE AND ORIENT,AZ,85712-1100,Proprietary  ,0,8,8,22,,142,164
03784400,TOHONO O'ODHAM COMMUNITY COLLEGE        ,AZ,85634-3129,Public       ,6,18,24,99,,148,247
03813300,NORTHCENTRAL UNIVERSITY                 ,AZ,86314-2336,Proprietary  ,4,1268,1272,98,,8936,9034
03814300,TURNING POINT BEAUTY COLLEGE            ,AZ,85222-4229,Proprietary  ,3,13,16,29,,108,137
04051300,ART INSTITUTE OF PHOENIX (THE)          ,AZ,85021-2859,Proprietary  ,673,2508,3181,8642,,26326,34968
04051306,ART INSTITUTE OF PHOENIX (THE) - ART INS,AZ,85712-2732,Proprietary  ,24,52,76,582,,666,1248
04051325,ART INSTITUTE OF PHOENIX (THE) - BROWN M,AZ,85712-5300,Proprietary  ,26,102,128,284,,1111,1395
04051327,ART INSTITUTE OF PHOENIX (THE) - BROWN M,AZ,85029-1348,Proprietary  ,8,23,31,204,,464,668
04059300,TUCSON COLLEGE OF BEAUTY                ,AZ,85705-2451,Proprietary  ,7,27,34,85,,207,292
04120900,ARIZONA CULINARY INSTITUTE              ,AZ,85259-4939,Proprietary  ,15,26,41,286,,427,713
04131400,PHOENIX SCHOOL OF LAW                   ,AZ,85012-3330,Proprietary  ,3,41,44,104,,1691,1795
04139200,UNIVERSAL BARBER COLLEGE                ,AZ,85007-3914,Proprietary  ,0,1,1,89,,335,424
04148700,AMERICAN INSTITUTE OF INTERIOR DESIGN   ,AZ,85268-3827,Proprietary  ,2,10,12,36,,95,131
04152900,STUDIO ACADEMY OF BEAUTY (THE)          ,AZ,85224-3600,Proprietary  ,24,56,80,137,,333,470
04157400,NATIONAL PARALEGAL COLLEGE              ,AZ,85014-1262,Proprietary  ,7,210,217,92,,1987,2079
04172100,CCIC BEAUTY COLLEGE                     ,AZ,85345-2410,Proprietary  ,0,0,0,7,,21,28
04174100,PAUL MITCHELL THE SCHOOL PHOENIX        ,AZ,85017-1919,Proprietary  ,16,28,44,216,,446,662
04174200,ALL BEAUTY COLLEGE                      ,AZ,86426-8326,Proprietary  ,3,16,19,47,,168,215
04175300,PENROSE ACADEMY                         ,AZ,85254-4065,Proprietary  ,12,17,29,111,,177,288
04177500,PURE AESTHETICS                         ,AZ,85711-2328,Proprietary  ,1,12,13,29,,120,149
04191200,CLASSIC COOKING ACADEMY                 ,AZ,85255-8699,Private      ,2,4,6,51,,77,128
04194500,AVEDA INSTITUTE TUCSON                  ,AZ,85719-4876,Proprietary  ,22,35,57,210,,315,525
04217600,SESSIONS COLLEGE FOR PROFESSIONAL DESIGN,AZ,85281-2840,Proprietary  ,3,17,20,27,,170,197
04233100,ARIZONA SCHOOL OF INTEGRATIVE STUDIES   ,AZ,86324-3106,Proprietary  ,0,3,3,0,,3,3
04233101,ARIZONA SCHOOL OF INTEGRATIVE STUDIES - ,AZ,86001-5510,Proprietary  ,0,1,1,0,,1,1
04233102,ARIZONA SCHOOL OF INTEGRATIVE STUDIES - ,AZ,86303-4711,Proprietary  ,0,1,1,0,,1,1
00142800,DELAWARE STATE UNIVERSITY               ,DE,19901-2277,Public       ,126,99,225,8716,,2938,11654
00142900,GOLDEY BEACOM COLLEGE                   ,DE,19808-1993,Private      ,14,34,48,664,,621,1285
00143100,UNIVERSITY OF DELAWARE                  ,DE,19716-0099,Public       ,199,153,352,27449,,3715,31164
00143300,WESLEY COLLEGE                          ,DE,19901-3875,Private      ,34,28,62,2653,,825,3478
00143301,WESLEY COLLEGE-CTR FOR ADULT STUDIE     ,DE,19720-0000,Private      ,1,1,2,32,,229,261
00331301,WIDENER UNIV SCHOOL OF LAW - DE         ,DE,19803-0000,Private      ,3,21,24,99,,1347,1446
00705300,DELAWARE TECH & CMTY COLLEGE-OWENS      ,DE,19947-0000,Public       ,59,185,244,2795,,3775,6570
00794800,WILMINGTON UNIVERSITY                   ,DE,19720-6491,Private      ,77,664,741,3291,,11156,14447
01172700,DELAWARE TECH & CMTY CLG-TERRY          ,DE,19901-8736,Public       ,41,163,204,2324,,3224,5548
02125200,BEEBE SCHOOL OF NURSING                 ,DE,19958-1462,Private      ,1,5,6,65,,127,192
02144900,DELAWARE TECH & CMTY CLG-STANTN/WLM     ,DE,19801-0000,Public       ,84,280,364,4409,,5806,10215
02190400,SCHILLING DOUGLAS SCH OF HAIR DSGN      ,DE,19711-0000,Proprietary  ,10,17,27,120,,157,277
02586902,STAR TECHNICAL INSTITUTE -              ,DE,19901-4615,Proprietary  ,0,7,7,32,,116,148
03025800,DAWN TRAINING CENTRE                    ,DE,19805-1511,Proprietary  ,13,137,150,148,,994,1142
03543300,HARRIS SCHOOL OF BUSINESS               ,DE,19803-5341,Proprietary  ,28,108,136,180,,636,816
03702300,DELAWARE LEARNING INSTITUTE OF COSMETOLO,DE,19939-9759,Proprietary  ,3,8,11,48,,89,137
04130700,ACADEMY OF MASSAGE AND BODYWORK         ,DE,19701-1321,Proprietary  ,3,10,13,25,,109,134
04139800,DELAWARE COLLEGE OF ART & DESIGN        ,DE,19801-3007,Private      ,8,8,16,481,,166,647
04171100,DELAWARE ACADEMY PAUL MITCHELL PARTNER S,DE,19702-5108,Proprietary  ,7,13,20,112,,159,271
        ,FEDERAL STUDENT AID USE ONLY            ,DC,20202-0000,,0,0,0,3,,4,7
        ,OFFICIAL USE ONLY                       ,DC,20202-0000,,0,0,0,0,,2,2
00143400,AMERICAN UNIVERSITY                     ,DC,20016-8020,Private      ,114,197,311,15027,,10511,25538
00143700,CATHOLIC UNIVERSITY OF AMERICA          ,DC,20064-0002,Private      ,56,108,164,5967,,2815,8782
00143711,"CATHOLIC UNIV AMERICA, LAW SCHOOL       ",DC,20064-0000,Private      ,3,12,15,80,,1248,1328
00144100,UNIV OF THE DISTRICT OF COLUMBIA        ,DC,20008-0000,Public       ,60,300,360,3397,,8009,11406
00144102,UNIV OF THE DIST OF COLU -SCHOOL OF LAW ,DC,20008-1173,Public       ,1,20,21,72,,944,1016
00144300,GALLAUDET UNIVERSITY                    ,DC,20002-3695,Private      ,6,29,35,1065,,1345,2410
00144400,GEORGE WASHINGTON UNIVERSITY            ,DC,20052-2353,Private      ,134,434,568,15108,,12554,27662
00144402,GEORGE WASHINGTON UNIV LAW SCHL         ,DC,20052-0000,Private      ,5,37,42,108,,4140,4248
00144403,GEORGE WASHINGTON UNIV SCH MED          ,DC,20052-0000,Private      ,5,28,33,128,,1870,1998
00144500,GEORGETOWN UNIVERSITY                   ,DC,20057-1252,Private      ,110,203,313,13704,,5728,19432
00144501,"GEORGETOWN UNIV, SCH OF MEDICINE        ",DC,20007-0000,Private      ,3,9,12,117,,1501,1618
00144502,GEORGETOWN UNIVERSITY - GRADUATE SCHOOL ,DC,20057-0004,Private      ,0,122,122,68,,5121,5189
00144503,GEORGETOWN UNIV LAW CENTER              ,DC,20001-0000,Private      ,2,31,33,79,,4900,4979
00144800,HOWARD UNIVERSITY                       ,DC,20059-0001,Private      ,218,232,450,16180,,10261,26441
00145900,STRAYER UNIVERSITY                      ,DC,20005-2603,Proprietary  ,215,4131,4346,2217,,55054,57271
00146000,TRINITY UNIVERSITY                      ,DC,20017-1004,Private      ,20,99,119,1613,,3356,4969
00146400,WESLEY THEOLOGICAL SEMINARY             ,DC,20016-0000,Private      ,0,16,16,7,,379,386
00207701,JOHNS HOPKINS UNIV SCH ADV INTL STU     ,DC,20036-0000,Private      ,3,33,36,82,,1596,1678
01006500,WASHINGTON THEOLOGICAL UNION            ,DC,20012-0000,Private      ,0,0,0,9,,46,55
01195000,THE CORCORAN COLLEGE OF ART & DESIG     ,DC,20006-4804,Private      ,3,11,14,364,,445,809
01280300,DOMINICAN HOUSE OF STUDIES              ,DC,20017-1584,Private      ,0,2,2,4,,47,51
02132800,NAT'L CONSERVATORY DRAMATIC ARTS        ,DC,20007-2758,Private      ,1,4,5,33,,70,103
03104300,CAREER BLAZERS LEARNING CENTER OF WASHIN,DC,20037-1881,Proprietary  ,21,185,206,107,,1087,1194
03218300,POTOMAC COLLEGE                         ,DC,20016-1860,Proprietary  ,4,42,46,87,,671,758
03409600,BENNETT CAREER INSTITUTE                ,DC,20017-1754,Proprietary  ,8,60,68,159,,509,668
03750300,TECHNICAL LEARNING CENTERS              ,DC,20006-3749,Proprietary  ,25,99,124,142,,708,850
04114400,INSTITUTE OF WORLD POLITICS (THE)       ,DC,20036-1464,Private      ,1,7,8,16,,231,247
04142700,PONTIFICAL JOHN PAUL II INSTITUTE FOR ST,DC,20064-0001,Private      ,0,3,3,2,,38,40
04190000,RADIANS COLLEGE                         ,DC,20005-3542,Proprietary  ,5,65,70,79,,825,904
04202500,GRADUATE SCHOOL                         ,DC,20024-2520,Private      ,0,11,11,0,,11,11
00154100,ABRAHAM BALDWIN AGRICULTURAL CLG        ,GA,31794-0000,Public       ,68,77,145,3555,,2230,5785
00154200,AGNES SCOTT COLLEGE                     ,GA,30030-3770,Private      ,21,27,48,1566,,615,2181
00154300,DARTON COLLEGE                          ,GA,31707-3098,Public       ,90,284,374,4636,,8107,12743
00154400,ALBANY STATE UNIVERSITY                 ,GA,31705-2796,Public       ,133,194,327,7477,,6175,13652
00154500,ANDREW COLLEGE                          ,GA,39840-1395,Private      ,7,5,12,534,,116,650
00154600,ARMSTRONG ATLANTIC STATE UNIVERSITY     ,GA,31419-1997,Public       ,124,284,408,7326,,7248,14574
00154700,POINT UNIVERSITY                        ,GA,30344-1999,Private      ,17,41,58,1052,,1505,2557
00155200,AUGUSTA STATE UNIVERSITY                ,GA,30904-2200,Public       ,33,86,119,5779,,5890,11669
00155400,BERRY COLLEGE                           ,GA,30149-5007,Private      ,37,25,62,4325,,452,4777
00155500,THOMAS UNIVERSITY                       ,GA,31792-7499,Private      ,10,66,76,558,,1534,2092
00155600,BRENAU UNIVERSITY                       ,GA,30501-3668,Private      ,40,189,229,1986,,4126,6112
00155700,BREWTON PARKER COLLEGE                  ,GA,30445-0000,Private      ,9,11,20,642,,285,927
00155800,COLLEGE OF COASTAL GEORGIA              ,GA,31520-3644,Public       ,47,111,158,2534,,3228,5762
00155900,CLARK ATLANTA UNIVERSITY                ,GA,30314-4385,Private      ,214,192,406,11771,,6904,18675
00156000,COLUMBIA THEOLOGICAL SEMINARY           ,GA,30031-0000,Private      ,0,9,9,13,,260,273
00156100,COLUMBUS STATE UNIVERSITY               ,GA,31907-5645,Public       ,107,332,439,7746,,7867,15613
00156200,GEORGIA PERIMETER COLLEGE               ,GA,30021-0000,Public       ,486,1130,1616,18103,,25839,43942
00156300,EMMANUEL COLLEGE                        ,GA,30639-0000,Private      ,5,3,8,909,,208,1117
00156400,EMORY UNIVERSITY                        ,GA,30322-1960,Private      ,152,282,434,14044,,11428,25472
00156600,FORT VALLEY STATE UNIVERSITY            ,GA,31030-3298,Public       ,73,107,180,4977,,3244,8221
00156700,GAINESVILLE STATE COLLEGE               ,GA,30503-0000,Public       ,0,0,0,6116,,3678,9794
00156800,INTERDENOMINATIONAL THEOLOGY CENTER     ,GA,30314-0000,Private      ,0,14,14,12,,649,661
00156900,GEORGIA INSTITUTE OF TECHNOLOGY         ,GA,30332-0325,Public       ,275,242,517,21897,,7304,29201
00157000,SOUTHERN POLYTECHNIC STATE UNIV         ,GA,30060-2896,Public       ,80,167,247,5745,,5486,11231
00157100,GEORGIA MILITARY COLLEGE                ,GA,31061-3398,Public       ,262,537,799,6098,,7928,14026
00157200,GEORGIA SOUTHERN UNIVERSITY             ,GA,30460-8065,Public       ,597,337,934,26033,,9491,35524
00157300,GEORGIA SOUTHWESTERN STATE UNIV         ,GA,31709-4693,Public       ,48,85,133,3108,,2651,5759
00157400,GEORGIA STATE UNIVERSITY                ,GA,30303-3010,Public       ,823,896,1719,36413,,32914,69327
00157500,GORDON COLLEGE                          ,GA,30204-1762,Public       ,75,87,162,4987,,3368,8355
00157700,KENNESAW STATE UNIVERSITY               ,GA,30144-5591,Public       ,407,571,978,25346,,18098,43444
00157800,LAGRANGE COLLEGE                        ,GA,30240-2999,Private      ,27,22,49,1688,,680,2368
00157900,GEORGIA REGENTS UNIVERSITY              ,GA,30912-0004,Public       ,43,139,182,1397,,4013,5410
00158000,MERCER UNIVERSITY                       ,GA,31207-0003,Private      ,85,290,375,6076,,10030,16106
00158100,MIDDLE GEORGIA STATE COLLEGE            ,GA,31014-1599,Public       ,79,157,236,3882,,3226,7108
00158103,MIDDLE GEORGIA STATE COLLEGE - MACON CAM,GA,31206-5145,Public       ,42,111,153,4452,,5880,10332
00158200,MOREHOUSE COLLEGE                       ,GA,30314-3773,Private      ,84,41,125,4968,,1679,6647
00158500,UNIVERSITY OF NORTH GEORGIA             ,GA,30597-0001,Public       ,226,204,430,10699,,4693,15392
00158600,OGLETHORPE UNIVERSITY                   ,GA,30319-2737,Private      ,31,32,63,2337,,860,3197
00158700,PAINE COLLEGE                           ,GA,30901-3182,Private      ,42,32,74,1500,,1069,2569
00158800,PIEDMONT COLLEGE                        ,GA,30535-5644,Private      ,19,72,91,1340,,2096,3436
00158900,REINHARDT UNIVERSITY                    ,GA,30183-2981,Private      ,27,32,59,1756,,730,2486
00159000,SAVANNAH STATE UNIVERSITY               ,GA,31404-5298,Public       ,152,154,306,9171,,4671,13842
00159100,SHORTER UNIVERSITY                      ,GA,30165-4298,Private      ,22,148,170,2209,,3017,5226
00159200,SOUTH GEORGIA COLLEGE                   ,GA,31533-8104,Public       ,45,66,111,2248,,1671,3919
00159203,SOUTH GEORGIA STATE COLLEGE - WAYCROSS C,GA,31503-0110,Public       ,13,29,42,725,,806,1531
00159400,SPELMAN COLLEGE                         ,GA,30314-4399,Private      ,116,67,183,7088,,2136,9224
00159600,TOCCOA FALLS COLLEGE                    ,GA,30598-0001,Private      ,8,7,15,995,,314,1309
00159700,TRUETT MCCONNELL COLLEGE                ,GA,30528-1264,Private      ,8,13,21,880,,285,1165
00159800,UNIVERSITY OF GEORGIA                   ,GA,30602-6114,Public       ,335,316,651,35073,,13411,48484
00159900,VALDOSTA STATE UNIVERSITY               ,GA,31698-0001,Public       ,230,247,477,14553,,7898,22451
00160000,WESLEYAN COLLEGE                        ,GA,31210-4407,Private      ,16,39,55,628,,821,1449
00160100,UNIV OF WEST GEORGIA                    ,GA,30118-0002,Public       ,220,228,448,14655,,7919,22574
00160200,GEORGIA COLLEGE & STATE UNIVERSITY      ,GA,31061-0490,Public       ,166,109,275,8574,,2883,11457
00160400,YOUNG HARRIS COLLEGE                    ,GA,30582-4137,Private      ,16,7,23,1687,,205,1892
00348400,COVENANT COLLEGE                        ,GA,30750-4164,Private      ,10,8,18,1451,,193,1644
00395600,DALTON STATE COLLEGE                    ,GA,30720-3797,Public       ,60,117,177,4610,,3962,8572
00402400,GEORGIA NORTHWESTERN TECHNICAL COLLEGE  ,GA,30161-6757,Public       ,90,349,439,3252,,7640,10892
00411700,GRADY HEALTH SYSTEM                     ,GA,30303-3050,Public       ,7,47,54,203,,1157,1360
00489808,MCCANN SCHOOL OF BUSINESS & TECHNOLOGY -,GA,31210-0246,Proprietary  ,3,10,13,37,,174,211
00525400,LANIER TECHNICAL COLLEGE                ,GA,30566-3499,Public       ,55,237,292,2056,,4793,6849
00525500,MOULTRIE TECHNICAL COLLEGE              ,GA,31768-0000,Public       ,33,176,209,742,,2413,3155
00525600,WIREGRASS GEORGIA TECHNICAL COLLEGE     ,GA,31602-0929,Public       ,98,417,515,2161,,6081,8242
00551100,OKEFENOKEE TECHNICAL COLLEGE            ,GA,31501-4016,Public       ,26,93,119,630,,1685,2315
00559900,AUGUSTA TECHNICAL COLLEGE               ,GA,30906-3399,Public       ,85,331,416,2875,,7784,10659
00560000,ATHENS TECHNICAL COLLEGE                ,GA,30601-1579,Public       ,91,306,397,3293,,6090,9383
00560100,ALBANY TECHNICAL COLLEGE                ,GA,31701-2648,Public       ,97,367,464,2028,,7114,9142
00561500,SOUTHWEST GEORGIA TECHNICAL COLLEGE     ,GA,31792-2622,Public       ,43,104,147,1199,,2375,3574
00561700,SOUTH GEORGIA TECHNICAL COLLEGE         ,GA,31709-8167,Public       ,54,143,197,1122,,2081,3203
00561800,SAVANNAH TECHNICAL COLLEGE              ,GA,31405-5594,Public       ,102,555,657,3153,,10033,13186
00561900,NORTH GEORGIA TECHNICAL COLLEGE         ,GA,30523-0000,Public       ,65,147,212,1874,,2923,4797
00562000,CHATTAHOOCHEE TECHNICAL COLLEGE         ,GA,30060-3398,Public       ,201,562,763,7347,,14145,21492
00562100,SOUTHERN CRESCENT TECHNICAL COLLEGE     ,GA,30223-2097,Public       ,61,309,370,2809,,7812,10621
00562200,DEKALB TECHNICAL COLLEGE                ,GA,30021-0000,Public       ,67,370,437,2066,,8605,10671
00562400,COLUMBUS TECHNICAL COLLEGE              ,GA,31904-6572,Public       ,102,343,445,2549,,6582,9131
00576300,CENTRAL GEORGIA TECHNICAL COLLEGE       ,GA,31206-3628,Public       ,153,688,841,2735,,9140,11875
00576304,CENTRAL GEORGIA TECHNICAL COLLEGE -     ,GA,31088-2729,Public       ,0,0,0,1198,,2903,4101
00854300,ATLANTA TECHNICAL COLLEGE               ,GA,30310-4499,Public       ,110,730,840,3709,,15171,18880
00897600,CLAYTON STATE UNIVERSITY                ,GA,30260-0285,Public       ,119,347,466,7213,,12111,19324
00927000,ART INSTITUTE OF ATLANTA (THE)          ,GA,30328-1649,Proprietary  ,341,570,911,9261,,8528,17789
00950700,GEORGIA HIGHLANDS COLLEGE               ,GA,30162-0000,Public       ,89,138,227,5541,,4945,10486
01031903,MEDIX SCHOOL                            ,GA,30080-7630,Proprietary  ,23,86,109,205,,871,1076
01035601,EVEREST INSTITUTE - DEKALB              ,GA,30035-3420,Proprietary  ,0,0,0,106,,473,579
01048700,WEST GEORGIA TECHNICAL COLLEGE          ,GA,30182-6476,Public       ,126,414,540,4407,,9039,13446
01054212,EMPIRE BEAUTY SCHOOL - DUNWOODY         ,GA,30338-3020,Proprietary  ,0,0,0,107,,253,360
01077100,GUPTON JONES COLLEGE                    ,GA,30035-4022,Private      ,6,33,39,155,,417,572
01099700,EAST GEORGIA COLLEGE                    ,GA,30401-2699,Public       ,85,62,147,3620,,1757,5377
01107400,BAINBRIDGE COLLEGE                      ,GA,39819-8400,Public       ,45,162,207,1329,,3780,5109
01110901,EVEREST COLLEGE - EVEREST INSTITUTE     ,GA,30067-8340,Proprietary  ,19,107,126,231,,1141,1372
01110902,EVEREST COLLEGE - ATLANTA               ,GA,30331-2620,Proprietary  ,34,242,276,545,,2380,2925
01112301,EVEREST COLLEGE - EVEREST INSTITUTE- NOR,GA,30093-2813,Proprietary  ,22,147,169,274,,1359,1633
01157400,BAUDER COLLEGE                          ,GA,30313-2439,Proprietary  ,40,158,198,605,,2318,2923
01205100,PRO WAY HAIR SCHOOL                     ,GA,30083-2884,Proprietary  ,12,42,54,94,,454,548
01216500,ATLANTA METROPOLITAN COLLEGE            ,GA,30310-4498,Public       ,131,380,511,4391,,9275,13666
01246109,LINCOLN COLLEGE OF TECHNOLOGY - MARIETTA,GA,30067-8638,Proprietary  ,6,63,69,134,,605,739
01303900,SOUTH UNIVERSITY                        ,GA,31406-4881,Proprietary  ,381,3994,4375,4065,,27747,31812
02060900,BROWN CLG OF COURT REPORTING & M.T.     ,GA,30318-2570,Proprietary  ,1,53,54,52,,625,677
02074800,LIFE UNIVERSITY                         ,GA,30060-0000,Private      ,19,71,90,739,,3358,4097
02113613,AMERICAN INTERCONTINENTAL UNIVERSITY    ,GA,30328-1649,Proprietary  ,43,280,323,1033,,3830,4863
02116000,SANFORD-BROWN COLLEGE                   ,GA,30328-4803,Proprietary  ,30,126,156,301,,1460,1761
02141500,SAVANNAH COLLEGE OF ART & DESIGN        ,GA,31402-3146,Private      ,155,188,343,12111,,5516,17627
02202800,AUGUSTA AREA DIET INTERN UNIV HOSP      ,GA,30901-0000,Private      ,0,3,3,20,,112,132
02217200,PORTFOLIO CENTER                        ,GA,30309-0000,Proprietary  ,3,15,18,63,,274,337
02266200,AMERICAN PROFESSIONAL INSTITUTE         ,GA,31201-3185,Private      ,4,31,35,106,,588,694
02279500,HEART OF GEORGIA TECHNICAL COLLEGE      ,GA,31021-8896,Public       ,0,0,0,256,,724,980
02284300,INTERACTIVE COLLEGE OF TECHNOLOGY       ,GA,30341-0000,Proprietary  ,46,293,339,292,,2012,2304
02284308,INTERACTIVE LEARNING SYSTEMS            ,GA,30260-0000,Proprietary  ,11,41,52,65,,328,393
02284309,INTERACTIVE COLLEGE OF TECHNOLOGY       ,GA,30501-0000,Proprietary  ,10,40,50,116,,385,501
02285500,"CREATIVE CIRCUS, THE                    ",GA,30324-0000,Proprietary  ,8,22,30,119,,379,498
02288400,GWINNETT TECHNICAL COLLEGE              ,GA,30043-5702,Public       ,102,432,534,4645,,11858,16503
02313902,WESTWOOD COLLEGE - O'HARE AIRPORT - ATLA,GA,30345-2807,Proprietary  ,14,95,109,229,,1006,1235
02321400,ROFFLER-MOLER HAIRSTYLING COLLEGE       ,GA,30062-0000,Proprietary  ,3,12,15,89,,171,260
02354500,SOUTHEASTERN BEAUTY SCHOOLS             ,GA,31906-0000,Proprietary  ,0,0,0,25,,62,87
02482100,MOREHOUSE SCHOOL OF MEDICINE            ,GA,30310-0000,Private      ,7,17,24,224,,867,1091
02520000,INTERNATIONAL SCH SKIN & NAILCARE       ,GA,30342-1119,Proprietary  ,8,73,81,106,,561,667
02559315,(UNITED EDUCATION INSTITUTE) - UEI MORRO,GA,30260-2941,Proprietary  ,2,13,15,48,,302,350
02577000,PAUL MITCHELL THE SCHOOL - ESANI        ,GA,30076-1507,Proprietary  ,10,31,41,104,,226,330
02577700,BEAUTY COLLEGE OF AMERICA               ,GA,30297-0000,Proprietary  ,4,16,20,80,,181,261
02580100,IVERSON INSTITUTE                       ,GA,30341-3662,Proprietary  ,0,29,29,55,,267,322
02580200,ATLANTA SCHOOL OF MASSAGE               ,GA,30338-0000,Proprietary  ,20,94,114,196,,857,1053
02583000,GWINNETT COLLEGE OF BUSINESS            ,GA,30047-3447,Proprietary  ,12,63,75,156,,870,1026
02614206,MILLER - MOTTE TECHNICAL COLLEGE - COLUM,GA,31907-3222,Proprietary  ,21,146,167,265,,1691,1956
02614207,MILLER - MOTTE TECHNICAL COLLEGE - AUGUS,GA,30907-0921,Proprietary  ,23,120,143,264,,1458,1722
03005400,GEORGIA CAREER INSTITUTE                ,GA,30013-2076,Proprietary  ,34,102,136,300,,951,1251
03010619,VIRGINIA COLLEGE - AUGUSTA              ,GA,30909-5515,Proprietary  ,11,57,68,296,,1384,1680
03010623,VIRGINIA COLLEGE - MACON                ,GA,31206-3180,Proprietary  ,11,40,51,177,,905,1082
03022601,WESTERN CULINARY INSTITUTE - LE CORDON B,GA,30084-5893,Proprietary  ,23,129,152,461,,1236,1697
03030000,OGEECHEE TECHNICAL COLLEGE              ,GA,30458-8049,Public       ,63,203,266,1803,,3616,5419
03032100,ALTAMAHA TECHNICAL COLLEGE              ,GA,31545-4465,Public       ,41,150,191,918,,2198,3116
03042700,LAURUSTECHNICAL INSTITUTE               ,GA,30030-1506,Proprietary  ,22,167,189,102,,832,934
03066500,SOUTHEASTERN TECHNICAL COLLEGE          ,GA,30474-8817,Public       ,35,120,155,721,,2139,2860
03072304,EVEREST COLLEGE - EVEREST INSTITUTE     ,GA,30236-0000,Proprietary  ,15,97,112,173,,1052,1225
03076300,BEULAH HEIGHTS BIBLE COLLEGE            ,GA,30316-1873,Private      ,1,53,54,42,,1041,1083
03079202,WESTWOOD COLLEGE - ATLANTA MIDTOWN      ,GA,30309-2848,Proprietary  ,40,143,183,640,,1998,2638
03081500,SOUTHEASTERN BEAUTY SCHOOL              ,GA,31917-0000,Proprietary  ,5,19,24,84,,264,348
03089100,GEORGIA INSTITUTE OF COSMETOLOGY        ,GA,30606-3152,Proprietary  ,21,66,87,260,,663,923
03090600,COBB BEAUTY COLLEGE                     ,GA,30144-2828,Proprietary  ,7,15,22,89,,225,314
03100900,LUTHER RICE UNIVERSITY                  ,GA,30038-2454,Private      ,4,63,67,61,,1393,1454
03102000,RIVERTOWN SCHOOL OF BEAUTY              ,GA,31904-4747,Proprietary  ,7,43,50,107,,434,541
03104500,ATLANTA INSTITUTE OF MUSIC              ,GA,30096-4988,Proprietary  ,24,38,62,513,,608,1121
03116100,VOGUE BEAUTY AND BARBER SCHOOL          ,GA,30141-2226,Proprietary  ,7,27,34,91,,328,419
03155500,OCONEE FALL LINE TECHNICAL COLLEGE      ,GA,31082-6179,Public       ,39,130,169,511,,1825,2336
03173300,ATLANTA'S JOHN MARSHALL LAW SCHOOL      ,GA,30309-0000,Proprietary  ,2,31,33,77,,1536,1613
03418300,GWINNETT COLLEGE-SANDY SPRINGS          ,GA,30328-3161,Proprietary  ,6,35,41,132,,500,632
03445500,FAYETTE BEAUTY ACADEMY                  ,GA,30214-1191,Proprietary  ,4,15,19,42,,176,218
03523300,AVIATION INSTITUTE OF MAINTENANCE       ,GA,30045-0000,Proprietary  ,29,134,163,326,,1127,1453
03635300,CARVER BIBLE COLLEGE                    ,GA,30331-1300,Private      ,5,24,29,53,,320,373
03748300,KEVOSNIK SCHOOL OF HAIR DESIGN          ,GA,31021-0000,Proprietary  ,1,8,9,8,,67,75
03753400,MICHAEL'S SCHOOL OF BEAUTY              ,GA,30909-0000,Proprietary  ,0,0,0,49,,132,181
03804400,MEDTECH INSTITUTE                       ,GA,30339-6040,Proprietary  ,17,100,117,245,,1115,1360
03812300,OMNITECH INSTITUTE                      ,GA,30035-1206,Proprietary  ,10,42,52,49,,410,459
04021300,AUGUSTA SCHOOL OF MASSAGE               ,GA,30809-0000,Proprietary  ,2,13,15,35,,120,155
04051331,ART INSTITUTE OF PHOENIX (THE) - BROWN M,GA,30319-3054,Proprietary  ,7,43,50,253,,622,875
04091300,SAVANNAH SCHOOL OF MASSAGE THERAPY      ,GA,31406-2711,Private      ,0,0,0,9,,18,27
04126800,ACADEMY OF SOMATIC HEALING ARTS (ASHA)  ,GA,30071-1024,Proprietary  ,0,0,0,6,,47,53
04142900,GEORGIA GWINNETT COLLEGE                ,GA,30043-7409,Public       ,196,244,440,11708,,7775,19483
04147000,PAUL MITCHELL THE SCHOOL ATLANTA        ,GA,30318-5241,Proprietary  ,24,67,91,462,,837,1299
04147700,LAKE LANIER SCHOOL OF MASSAGE           ,GA,30501-4546,Proprietary  ,3,31,34,54,,242,296
04149900,PROFILE INSTITUTE OF BARBER-STYLING     ,GA,30315-8459,Proprietary  ,2,33,35,65,,356,421
04150900,PROCESS INSTITUTE OF COSMETOLOGY (THE)  ,GA,30043-7344,Proprietary  ,8,20,28,137,,219,356
04152300,GEORGIA BEAUTY ACADEMY                  ,GA,30721-3952,Proprietary  ,4,15,19,104,,225,329
04156500,GEORGIA CHRISTIAN UNIVERSITY            ,GA,30047-3778,Private      ,1,18,19,44,,160,204
04160200,ATLANTA BEAUTY ACADEMY                  ,GA,30340-1334,Proprietary  ,7,65,72,118,,617,735
04203800,WOODRUFF MEDICAL TRAINING AND TESTING   ,GA,30033-6103,Proprietary  ,5,40,45,40,,274,314
04204500,ELAINE STERLING INSTITUTE(THE)          ,GA,30342-2633,Proprietary  ,4,39,43,50,,238,288
04206400,HELMS COLLEGE                           ,GA,31206-5309,Private      ,8,22,30,103,,323,426
04206600,SAE INSTITUTE OF TECHNOLOGY - ATLANTA   ,GA,30303-1736,Proprietary  ,25,68,93,305,,661,966
04208000,TECHNOLOGY CENTER                       ,GA,30071-3519,Proprietary  ,2,23,25,23,,250,273
04218000,UNITED MEDICAL AND BUSINESS INSTITUTE   ,GA,30344-6977,Proprietary  ,6,24,30,27,,160,187
04221100,NEW HORIZONS MEDICAL INSTITUTE          ,GA,30071-2965,Proprietary  ,9,82,91,18,,183,201
00149911,EVEREST COLLEGE - MERRIONETTE PARK      ,IL,60803-4517,Proprietary  ,26,115,141,205,,753,958
00162800,AMERICAN ACADEMY OF ART                 ,IL,60604-4302,Proprietary  ,15,16,31,1044,,462,1506
00163300,AUGUSTANA COLLEGE                       ,IL,61201-2296,Private      ,28,9,37,5012,,330,5342
00163400,AURORA UNIVERSITY                       ,IL,60506-4892,Private      ,41,161,202,4614,,3994,8608
00163600,SOUTHWESTERN ILLINOIS COLLEGE           ,IL,62221-5899,Public       ,178,413,591,5155,,8058,13213
00163800,BLACK HAWK COLLEGE                      ,IL,61265-5899,Public       ,50,143,193,2909,,3519,6428
00163900,BLACKBURN COLLEGE                       ,IL,62626-1498,Private      ,5,6,11,803,,180,983
00164000,PRAIRIE STATE COLLEGE                   ,IL,60411-8226,Public       ,97,315,412,3918,,6552,10470
00164100,BRADLEY UNIVERSITY                      ,IL,61625-0002,Private      ,69,37,106,9027,,1467,10494
00164300,SPOON RIVER COLLEGE                     ,IL,61520-8907,Public       ,20,41,61,930,,1079,2009
00164700,CITY COLLEGES OF CHICAGO                ,IL,60606-6998,Public       ,80,298,378,3709,,6353,10062
00164800,TRUMAN COLLEGE                          ,IL,60640-5691,Public       ,130,345,475,4232,,7837,12069
00164900,RICHARD J DALEY COLLEGE                 ,IL,60652-1299,Public       ,146,326,472,4711,,6933,11644
00165000,CITY COLLEGES OF CHICAGO-MALCOLM X      ,IL,60612-3197,Public       ,181,554,735,5431,,11408,16839
00165200,HAROLD WASHINGTON COLLEGE               ,IL,60601-2403,Public       ,269,514,783,10576,,12220,22796
00165400,KENNEDY KING COLLEGE                    ,IL,60621-3798,Public       ,105,529,634,3855,,10893,14748
00165500,WRIGHT COLLEGE                          ,IL,60634-1591,Public       ,160,385,545,7092,,8831,15923
00165700,MIDWESTERN UNIVERSITY                   ,IL,60515-1200,Private      ,0,30,30,174,,3764,3938
00165900,ROSALIND FRANKLIN UNIVERSITY OF MEDICINE,IL,60064-3095,Private      ,1,42,43,67,,2887,2954
00166100,CHICAGO THEOLOGICAL SEMINARY            ,IL,60637-0000,Private      ,0,15,15,18,,298,316
00166300,SPERTUS COLLEGE                         ,IL,60605-1995,Private      ,0,8,8,5,,104,109
00166400,UNIVERSITY OF ST FRANCIS                ,IL,60435-6188,Private      ,20,118,138,2342,,2688,5030
00166500,COLUMBIA COLLEGE                        ,IL,60605-1996,Private      ,232,221,453,15965,,6655,22620
00166600,CONCORDIA UNIVERSITY                    ,IL,60305-1499,Private      ,36,242,278,3195,,4398,7593
00166900,DANVILLE AREA COMMUNITY COLLEGE         ,IL,61832-5199,Public       ,37,103,140,1183,,1961,3144
00167100,DEPAUL UNIVERSITY                       ,IL,60604-2287,Private      ,309,637,946,25918,,18717,44635
00167400,EASTERN ILLINOIS UNIVERSITY             ,IL,61920-3099,Public       ,181,118,299,12217,,4264,16481
00167500,ELGIN COMMUNITY COLLEGE                 ,IL,60123-7193,Public       ,109,180,289,5030,,5330,10360
00167600,ELMHURST COLLEGE                        ,IL,60126-3296,Private      ,53,43,96,4580,,1580,6160
00167800,EUREKA COLLEGE                          ,IL,61530-9976,Private      ,13,5,18,1087,,254,1341
00168100,HIGHLAND COMMUNITY COLLEGE              ,IL,61032-9341,Public       ,33,90,123,1076,,1383,2459
00168200,GARRETT-EVANGELICAL THEOLOGICAL SEM     ,IL,60201-0000,Private      ,0,7,7,3,,267,270
00168400,GREENVILLE COLLEGE                      ,IL,62246-1199,Private      ,19,41,60,1794,,764,2558
00168500,HEBREW THEOLOGICAL COLLEGE              ,IL,60077-3263,Private      ,10,3,13,527,,36,563
00168800,ILLINOIS COLLEGE                        ,IL,62650-2299,Private      ,16,6,22,2068,,263,2331
00168900,ILLINOIS COLLEGE OF OPTOMETRY           ,IL,60616-3878,Private      ,1,6,7,44,,734,778
00169100,ILLINOIS INSTITUTE OF TECHNOLOGY        ,IL,60616-0000,Private      ,52,120,172,3952,,3126,7078
00169103,CHICAGO KENT COLLEGE OF LAW             ,IL,60661-0000,Private      ,6,24,30,96,,2018,2114
00169200,ILLINOIS STATE UNIVERSITY               ,IL,61790-1000,Public       ,251,120,371,25205,,5749,30954
00169300,NORTHEASTERN ILLINOIS UNIV              ,IL,60625-4699,Public       ,147,293,440,8961,,9816,18777
00169400,CHICAGO STATE UNIVERSITY                ,IL,60628-1598,Public       ,119,450,569,7333,,13987,21320
00169600,ILLINOIS WESLEYAN UNIVERSITY            ,IL,61701-0000,Private      ,26,6,32,3620,,248,3868
00169800,JOHN MARSHALL LAW SCHOOL                ,IL,60604-0000,Private      ,0,41,41,94,,2598,2692
00169900,JOLIET JUNIOR COLLEGE                   ,IL,60431-8938,Public       ,169,393,562,8497,,8579,17076
00170000,JUDSON UNIVERSITY                       ,IL,60123-1498,Private      ,16,89,105,1243,,997,2240
00170100,KASKASKIA COLLEGE                       ,IL,62801-7878,Public       ,46,141,187,1860,,2714,4574
00170300,KENDALL COLLEGE                         ,IL,60622-4278,Proprietary  ,33,131,164,1296,,2492,3788
00170400,KNOX COLLEGE                            ,IL,61401-4999,Private      ,19,5,24,2624,,175,2799
00170500,ILLINOIS VALLEY COMMUNITY COLLEGE       ,IL,61348-9692,Public       ,40,85,125,1733,,1983,3716
00170600,LAKE FOREST COLLEGE                     ,IL,60045-2399,Private      ,29,6,35,2814,,270,3084
00170700,LEWIS UNIVERSITY                        ,IL,60446-2200,Private      ,78,190,268,6263,,4390,10653
00170800,LINCOLN CHRISTIAN UNIVERSITY            ,IL,62656-2167,Private      ,4,28,32,484,,732,1216
00170900,LINCOLN COLLEGE                         ,IL,62656-1699,Private      ,18,37,55,1379,,825,2204
00171000,LOYOLA UNIVERSITY CHICAGO               ,IL,60626-0000,Private      ,222,329,551,18961,,13365,32326
00171200,LUTHERAN SCHOOL OF THEOL AT CHICAGO     ,IL,60615-0000,Private      ,0,4,4,8,,131,139
00171600,MACCORMAC COLLEGE                       ,IL,60602-4405,Private      ,3,19,22,93,,310,403
00171700,MACMURRAY COLLEGE                       ,IL,62650-2590,Private      ,12,9,21,1018,,335,1353
00172100,MCCORMICK THEOLOGICAL SEMINARY          ,IL,60615-5108,Private      ,0,4,4,7,,171,178
00172200,MCKENDREE UNIVERSITY                    ,IL,62254-1299,Private      ,20,84,104,2001,,1721,3722
00172300,MEADVILLE LOMBARD THEOLOGICAL SCHOOL    ,IL,60637-1602,Private      ,0,3,3,7,,80,87
00172400,MILLIKIN UNIVERSITY                     ,IL,62522-2084,Private      ,29,39,68,3497,,1100,4597
00172500,MONMOUTH COLLEGE                        ,IL,61462-1963,Private      ,22,11,33,2538,,249,2787
00172700,MOODY BIBLE INSTITUTE                   ,IL,60610-3214,Private      ,35,102,137,2550,,2246,4796
00172800,MORTON COLLEGE                          ,IL,60804-4398,Public       ,92,110,202,3251,,2648,5899
00173200,NATIONAL UNIV OF HEALTH SCIENCES        ,IL,60148-4583,Private      ,2,25,27,73,,1005,1078
00173300,NATIONAL-LOUIS UNIVERSITY               ,IL,60603-3032,Private      ,13,445,458,575,,6871,7446
00173400,NORTH CENTRAL COLLEGE                   ,IL,60540-4690,Private      ,57,40,97,4665,,1187,5852
00173500,NORTH PARK UNIVERSITY                   ,IL,60625-4895,Private      ,39,99,138,3536,,2365,5901
00173600,NORTHERN BAPTIST THEOL SEMINARY         ,IL,60148-0000,Private      ,0,4,4,1,,100,101
00173700,NORTHERN ILLINOIS UNIVERSITY            ,IL,60115-2854,Public       ,331,295,626,26405,,12159,38564
00173900,NORTHWESTERN UNIV                       ,IL,60208-0001,Private      ,145,310,455,21813,,11486,33299
00174100,OLIVET NAZARENE UNIVERSITY              ,IL,60914-2271,Private      ,47,200,247,4130,,3182,7312
00174200,IL EASTERN COMM COLGS-OLNEY CENTRAL     ,IL,62450-1099,Public       ,23,33,56,641,,810,1451
00174500,QUINCY UNIVERSITY                       ,IL,62301-2699,Private      ,13,22,35,1791,,755,2546
00174600,ROBERT MORRIS UNIVERSITY ILLINOIS       ,IL,60605-1225,Private      ,124,330,454,6560,,6450,13010
00174700,ROCK VALLEY COLLEGE                     ,IL,61114-5699,Public       ,100,284,384,4175,,6009,10184
00174800,ROCKFORD UNIVERSITY                     ,IL,61108-2393,Private      ,23,71,94,1441,,1602,3043
00174900,ROOSEVELT UNIVERSITY                    ,IL,60605-1394,Private      ,101,255,356,6506,,8556,15062
00175000,DOMINICAN UNIVERSITY                    ,IL,60305-1066,Private      ,49,47,96,3899,,2022,5921
00175200,SAUK VALLEY COMMUNITY COLLEGE           ,IL,61021-9112,Public       ,28,77,105,1236,,1361,2597
00175300,SCHOOL OF ART INSTITUTE OF CHICAGO      ,IL,60603-3013,Private      ,64,70,134,4998,,2826,7824
00175600,SHIMER COLLEGE                          ,IL,60616-3893,Private      ,0,1,1,112,,82,194
00175700,SOUTHEASTERN ILLINOIS COLLEGE           ,IL,62946-4925,Public       ,27,42,69,834,,945,1779
00175800,SOUTHERN ILL UNIV-CARBONDALE            ,IL,62901-0000,Public       ,234,312,546,19604,,10126,29730
00175900,SOUTHERN ILL UNIV-EDWARDSVILLE          ,IL,62026-1060,Public       ,179,185,364,15077,,6955,22032
00175924,SO IL UNIV-SCHL OF DENTAL MEDICINE      ,IL,62002-0000,Public       ,1,1,2,14,,219,233
00176500,UNIVERSITY OF ST MARY OF THE LAKE       ,IL,60060-0000,Private      ,0,2,2,6,,23,29
00176700,BENEDICTINE UNIVERSITY                  ,IL,60532-0900,Private      ,47,246,293,4231,,4898,9129
00176800,ST XAVIER UNIVERSITY                    ,IL,60655-3199,Private      ,99,126,225,6738,,4192,10930
00176900,SOUTH SUBURBAN COLLEGE                  ,IL,60473-9978,Public       ,93,340,433,3654,,7202,10856
00177100,TRINITY CHRISTIAN COLLEGE               ,IL,60463-0929,Private      ,15,36,51,1459,,1083,2542
00177200,TRINITY INTERNATIONAL UNIVERSITY        ,IL,60015-1283,Private      ,13,34,47,1043,,1223,2266
00177300,TRITON COLLEGE                          ,IL,60171-1995,Public       ,221,381,602,5375,,6198,11573
00177400,UNIVERSITY OF CHICAGO                   ,IL,60637-1476,Private      ,196,139,335,22627,,5103,27730
00177401,UNIV OF CHICAGO PRITZKER SCH OF MED     ,IL,60637-0000,Private      ,0,5,5,100,,675,775
00177403,"UNIV OF CHICAGO, BOOTH SCH OF BUS       ",IL,60637-0000,Private      ,2,68,70,178,,1616,1794
00177405,UNIVERSITY OF CHICAGO GRADUATE          ,IL,60637-0000,Private      ,2,75,77,155,,5087,5242
00177500,UNIV OF ILLINOIS @ URBANA-CHAMPAIGN     ,IL,61820-5796,Public       ,314,211,525,35071,,10016,45087
00177600,UNIV OF ILLINOIS AT CHICAGO             ,IL,60607-0000,Public       ,361,467,828,30267,,22389,52656
00177800,VANDERCOOK COLLEGE OF MUSIC             ,IL,60616-3731,Private      ,0,7,7,206,,138,344
00177900,IL EASTERN COMM COLGS-WABASH VALLEY     ,IL,62863-2699,Public       ,13,20,33,523,,469,992
00178000,WESTERN ILLINOIS UNIVERSITY             ,IL,61455-1390,Public       ,183,138,321,14590,,5402,19992
00178100,WHEATON COLLEGE                         ,IL,60187-5535,Private      ,16,18,34,3088,,687,3775
00178300,WORSHAM COLLEGE OF MORTUARY SCIENCE     ,IL,60090-2646,Proprietary  ,1,21,22,77,,199,276
00396100,HARPER COLLEGE                          ,IL,60067-7398,Public       ,180,329,509,6528,,5940,12468
00456000,GEM CITY COLLEGE                        ,IL,62301-4949,Proprietary  ,1,3,4,22,,69,91
00456800,MIDSTATE COLLEGE                        ,IL,61614-3558,Proprietary  ,6,78,84,146,,1103,1249
00621400,BLESSING RIEMAN COLLEGE OF NURSING      ,IL,62301-0000,Private      ,2,13,15,184,,244,428
00621401,BLESSING HOSPITAL - SCHOOL OF MEDICAL LA,IL,62305-7005,Private      ,0,0,0,20,,44,64
00621402,BLESSING HOSPITAL - SCHOOL OF RADIOLOGIC,IL,62305-7005,Private      ,1,3,4,34,,54,88
00622500,TRINITY COLLEGE OF NURSING AND HEALTH SC,IL,61201-5317,Private      ,2,13,15,140,,309,449
00622800,METHODIST MED CTR OF ILL SCH NRSNG      ,IL,61636-0000,Private      ,3,11,14,367,,740,1107
00624000,ST FRANCIS MED CLG OF NRSG              ,IL,61603-3783,Private      ,5,14,19,414,,707,1121
00638500,CHAMBERLAIN COLLEGE OF NURSING          ,IL,60101-0000,Proprietary  ,53,1844,1897,2662,,23176,25838
00665600,COLLEGE OF DUPAGE                       ,IL,60137-6599,Public       ,338,686,1024,13407,,12439,25846
00675300,ILLINOIS CENTRAL COLLEGE                ,IL,61635-0001,Public       ,123,341,464,5021,,6274,11295
00693100,WAUBONSEE COMMUNITY COLLEGE             ,IL,60554-0000,Public       ,113,263,376,4182,,4986,9168
00711800,PARKLAND COLLEGE                        ,IL,61821-1899,Public       ,91,191,282,5346,,4736,10082
00711900,REND LAKE COLLEGE                       ,IL,62846-9801,Public       ,30,60,90,1361,,1803,3164
00717000,LINCOLN LAND COMMUNITY COLLEGE          ,IL,62794-9256,Public       ,55,140,195,3312,,5003,8315
00726500,CARL SANDBURG COLLEGE                   ,IL,61401-9576,Public       ,18,63,81,1184,,1781,2965
00730307,LINCOLN COLLEGE OF TECHNOLOGY - MELROSE ,IL,60160-1605,Proprietary  ,60,87,147,794,,782,1576
00750103,VATTEROTT COLLEGE - FAIRVIEW HEIGHTS    ,IL,62208-2029,Proprietary  ,28,120,148,220,,873,1093
00754900,COYNE AMERICAN INSTITUTE                ,IL,60607-1300,Proprietary  ,37,118,155,504,,1614,2118
00764400,LAKE LAND COLLEGE                       ,IL,61938-9366,Public       ,45,98,143,2607,,2639,5246
00768400,KISHWAUKEE COLLEGE                      ,IL,60150-9699,Public       ,38,87,125,2677,,2593,5270
00769000,KANKAKEE COMMUNITY COLLEGE              ,IL,60901-6505,Public       ,47,153,200,1831,,3167,4998
00769100,MCHENRY COUNTY COLLEGE                  ,IL,60012-2761,Public       ,68,165,233,2860,,2904,5764
00769200,MORAINE VALLEY COMMUNITY COLLEGE        ,IL,60465-0937,Public       ,225,350,575,8526,,7214,15740
00769300,SHAWNEE COMMUNITY COLLEGE               ,IL,62992-9725,Public       ,39,109,148,785,,1242,2027
00769400,COLLEGE OF LAKE COUNTY                  ,IL,60030-1198,Public       ,212,400,612,5688,,6616,12304
00793700,MS ROBERTS ACADEMY OF BEAUTY CULT       ,IL,60181-2930,Proprietary  ,3,11,14,27,,79,106
00807600,JOHN A LOGAN COLLEGE                    ,IL,62918-2500,Public       ,57,139,196,2277,,2948,5225
00809003,EVEREST COLLEGE - BEDFORD PARK          ,IL,60629-5819,Proprietary  ,43,150,193,288,,1116,1404
00825900,EDUCATORS OF BEAUTY                     ,IL,61081-3611,Proprietary  ,6,18,24,74,,130,204
00825901,EDUCATORS OF BEAUTY                     ,IL,61104-0000,Proprietary  ,4,7,11,75,,147,222
00832800,ALVAREITA'S COLLEGE OF COSMETOLOGY      ,IL,62025-2041,Proprietary  ,6,9,15,65,,126,191
00869402,RASMUSSEN COLLEGE - ROCKFORD            ,IL,61108-2513,Proprietary  ,16,139,155,312,,1741,2053
00869403,RASMUSSEN COLLEGE - AURORA              ,IL,60506-6219,Proprietary  ,5,59,64,154,,809,963
00869404,RASMUSSEN COLLEGE - ROMEOVILLE          ,IL,60446-0000,Proprietary  ,11,86,97,237,,1012,1249
00869418,RASMUSSEN COLLEGE -  MOKENA             ,IL,60448-0000,Proprietary  ,7,64,71,87,,603,690
00888000,MORRISON INSTITUTE OF TECHNOLOGY        ,IL,61270-2959,Private      ,0,1,1,146,,40,186
00893800,GRAHAM HOSPITAL SCH OF NURSING          ,IL,61520-2497,Private      ,2,0,2,36,,133,169
00893900,CANNELLA SCHOOL OF HAIR DESIGN          ,IL,60406-2130,Proprietary  ,2,10,12,35,,108,143
00914500,GOVERNORS STATE UNIVERSITY              ,IL,60466-0975,Public       ,43,296,339,1755,,8217,9972
00923200,CATHOLIC THEOLOGICAL UNION              ,IL,60615-0000,Private      ,0,2,2,5,,78,83
00933300,UNIV OF ILLINOIS AT SPRINGFIELD         ,IL,62703-5407,Public       ,50,133,183,3089,,4011,7100
00945918,EMPIRE BEAUTY SCHOOL - HANOVER PARK     ,IL,60133-5421,Proprietary  ,0,0,0,34,,68,102
00947500,EDUCATORS OF BEAUTY                     ,IL,61301-2404,Proprietary  ,3,6,9,35,,41,76
00959500,CANNELLA SCHOOL OF HAIR DESIGN          ,IL,60617-4303,Proprietary  ,5,32,37,102,,248,350
00976700,OLIVE-HARVEY COLLEGE                    ,IL,60628-1696,Public       ,101,353,454,2704,,6579,9283
00978600,IL EASTERN COMM COLGS-LINCOLN TRAIL     ,IL,62454-5708,Public       ,17,20,37,372,,465,837
00980000,RUSH UNIVERSITY                         ,IL,60612-3806,Private      ,11,108,119,486,,3890,4376
00989600,OAKTON COMMUNITY COLLEGE                ,IL,60016-1268,Public       ,143,245,388,4603,,4224,8827
00998700,SAINT ANTHONY COLLEGE OF NURSING        ,IL,61108-2468,Private      ,5,22,27,223,,551,774
01002000,LEWIS AND CLARK COMMUNITY COLLEGE       ,IL,62035-2466,Public       ,66,168,234,2621,,3374,5995
01050100,LAKEVIEW  COLLEGE OF NURSING            ,IL,61832-3781,Private      ,2,4,6,246,,347,593
01069500,TRI-COUNTY BEAUTY ACADEMY               ,IL,62056-2036,Proprietary  ,1,1,2,23,,34,57
01071000,CAPITAL AREA SCH OF PRAC NRSG           ,IL,62707-0000,Public       ,6,15,21,128,,679,807
01072700,DEVRY UNIVERSITY                        ,IL,60618-5994,Proprietary  ,701,5931,6632,14359,,91358,105717
01083600,PIVOT POINT INTNL CSMTLGY RSRCH CTR     ,IL,60626-0000,Proprietary  ,24,57,81,407,,661,1068
01087900,RICHLAND COMMUNITY COLLEGE              ,IL,62521-8513,Public       ,38,147,185,1248,,2738,3986
01091303,ROCKFORD CAREER COLLEGE                 ,IL,61108-3900,Proprietary  ,21,111,132,355,,1295,1650
01151002,EVEREST INSTITUTE - EVEREST COLLEGE     ,IL,60542-1610,Proprietary  ,7,48,55,203,,677,880
01181000,TAYLOR BUSINESS INSTITUTE               ,IL,60606-5111,Proprietary  ,3,13,16,46,,280,326
01185800,EVEREST COLLEGE                         ,IL,60077-1074,Proprietary  ,29,82,111,235,,675,910
01185802,EVEREST COLLEGE - BURR RIDGE            ,IL,60527-7826,Proprietary  ,27,68,95,174,,447,621
01185803,EVEREST COLLEGE - MELROSE PARK          ,IL,60160-1526,Proprietary  ,30,144,174,296,,961,1257
01236200,NORTHWESTERN COLLEGE                    ,IL,60630-2298,Proprietary  ,68,244,312,2275,,4105,6380
01238500,BLOOMINGTON-NORMAL SCH RADIOGRAPHY      ,IL,61761-4604,Private      ,0,3,3,36,,71,107
01258400,ILLINOIS INSTITUTE OF ART (THE)         ,IL,60654-1593,Proprietary  ,248,321,569,6206,,4844,11050
01281300,JOHN WOOD COMMUNITY COLLEGE             ,IL,62305-0401,Public       ,31,95,126,1214,,1534,2748
01308700,CAPRI BEAUTY COLLEGE                    ,IL,60629-1613,Proprietary  ,3,9,12,97,,241,338
01308800,CAPRI OAK FOREST COLLEGE OF BEAUTY      ,IL,60452-2798,Proprietary  ,11,16,27,154,,190,344
02055200,HARRINGTON COLLEGE OF DESIGN            ,IL,60606-3433,Proprietary  ,8,30,38,378,,639,1017
02068100,ADLER SCH OF PROFESSIONAL PSYCHLGY      ,IL,60601-0000,Private      ,1,27,28,155,,1854,2009
02069300,VATTEROTT COLLEGE                       ,IL,62305-5938,Proprietary  ,11,30,41,117,,418,535
02073200,TELSHE YESHIVA-CHICAGO                  ,IL,60625-0000,Private      ,6,0,6,39,,12,51
02074400,IL EASTERN COMM COLGS-FRONTIER          ,IL,62837-0000,Public       ,4,19,23,204,,389,593
02075400,KELLER GRADUATE SCHOOL OF MGMT.         ,IL,60515-5683,Proprietary  ,6,880,886,75,,16996,17071
02113600,AMERICAN INTERCONTINENTAL UNIVERSITY    ,IL,60192-3713,Proprietary  ,255,3673,3928,1809,,30794,32603
02117400,BECK AREA CAREER CENTER                 ,IL,62278-0000,Public       ,0,4,4,36,,191,227
02124400,UNIVERSITY OF SPA & COSMETOLOGY ART     ,IL,62704-0000,Proprietary  ,14,19,33,154,,257,411
02150600,COSMETOLOGY AND SPA INSTITUTE (THE)     ,IL,60014-4003,Proprietary  ,11,18,29,125,,222,347
02155300,THE CHICAGO SCHOOL OF PROF PSYCHOLOGY   ,IL,60610-4705,Private      ,2,156,158,119,,6044,6163
02160300,INTERNATIONAL ACAD OF DESIGN & TECH     ,IL,60602-3319,Proprietary  ,12,47,59,398,,682,1080
02160304,INTERNATIONAL ACADEMY OF DESIGN AND TECH,IL,60173-5160,Proprietary  ,6,27,33,140,,308,448
02168600,EAST WEST UNIVERSITY                    ,IL,60605-0000,Private      ,30,67,97,1006,,1678,2684
02179900,ARGOSY UNIVERSITY                       ,IL,60601-7757,Proprietary  ,734,5192,5926,10019,,45664,55683
02185400,ST AUGUSTINE COLLEGE                    ,IL,60640-0000,Private      ,45,176,221,788,,2471,3259
02192400,MR JOHNS SCHOOL OF COSMETOLOGY          ,IL,62521-0000,Proprietary  ,3,14,17,30,,139,169
02202600,CANNELLA SCHOOL OF HAIR DESIGN          ,IL,60181-1321,Proprietary  ,0,6,6,15,,87,102
02214100,RESURRECTION UNIVERSITY                 ,IL,60302-2519,Private      ,1,17,18,251,,926,1177
02228100,MAC DANIEL'S BEAUTY SCHOOL              ,IL,60640-0000,Proprietary  ,1,13,14,57,,131,188
02261200,HAIR PROFESSIONALS ACAD COSMETOLOGY     ,IL,60118-0000,Proprietary  ,12,30,42,58,,231,289
02261201,HAIR PROFESSIONALS ACADEMY OF COSMETOLOG,IL,60118-9333,Proprietary  ,0,1,1,8,,21,29
02262100,HAIR PROFESSIONALS SCH COSMETOLOGY      ,IL,60543-0000,Proprietary  ,5,10,15,42,,95,137
02291200,CANNELLA SCHOOL OF HAIR DESIGN          ,IL,60639-0000,Proprietary  ,6,19,25,127,,228,355
02295500,CANNELLA SCHOOL OF HAIR DESIGN          ,IL,60120-0000,Proprietary  ,0,4,4,35,,93,128
02297500,OEHRLEIN SCHOOL OF COSMETOLOGY          ,IL,61611-0000,Proprietary  ,1,8,9,75,,121,196
02312300,LA' JAMES COLLEGE HAIRSTYLING           ,IL,61244-0000,Proprietary  ,3,5,8,27,,70,97
02313900,WESTWOOD COLLEGE - O'HARE AIRPORT       ,IL,60631-2801,Proprietary  ,25,88,113,334,,881,1215
02317300,CONCEPT COLLEGE OF COSMETOLOGY          ,IL,61832-0000,Proprietary  ,4,10,14,68,,162,230
02319200,LAKE FOREST GRAD SCHL OF MGMT           ,IL,60045-4824,Private      ,0,34,34,2,,331,333
02323300,PROFESSIONAL'S CHOICE HAIR DSN ACAD     ,IL,60435-0000,Proprietary  ,5,15,20,54,,150,204
02332200,HAIR PROFESSIONALS CAREER COLLEGE       ,IL,60178-0000,Proprietary  ,3,11,14,32,,86,118
02349400,ALVAREITA'S COLLEGE OF COSMETOLOGY      ,IL,62035-0000,Proprietary  ,4,12,16,44,,116,160
02349500,CANNELLA SCHOOL OF HAIR DESIGN          ,IL,60632-0000,Proprietary  ,6,27,33,141,,315,456
02352200,LE CORDON BLEU COLLEGE OF CULINARY ARTS ,IL,60610-3050,Proprietary  ,47,187,234,985,,2033,3018
02498200,G SKIN & BEAUTY INSTITUTE               ,IL,60523-1805,Proprietary  ,10,52,62,124,,369,493
02498201,HAIR PROFESSIONALS ACADEMY OF COSMETOLOG,IL,60563-0000,Proprietary  ,1,0,1,23,,56,79
02522800,FOX COLLEGE                             ,IL,60638-1999,Proprietary  ,21,26,47,546,,593,1139
02522801,FOX COLLEGE -  VET TECH INSTITUTE       ,IL,60477-4451,Proprietary  ,2,1,3,2,,1,3
02527600,LEXINGTON COLLEGE                       ,IL,60607-0000,Private      ,3,4,7,97,,112,209
02536700,BELL MAR BEAUTY COLLEGE                 ,IL,60650-0000,Proprietary  ,4,4,8,44,,86,130
02556100,ENVIRONMENTAL TECHNICAL INSTITUTE       ,IL,60143-0000,Proprietary  ,25,89,114,138,,477,615
02556600,NILES SCHOOL OF COSMETOLOGY             ,IL,60714-0000,Proprietary  ,0,8,8,19,,58,77
02573700,INSTITUTE FOR CLINICAL SOCIAL WORK      ,IL,60605-1229,Private      ,3,15,18,54,,336,390
02579200,INGALLS MEMORIAL HOSPITAL               ,IL,60426-0000,Private      ,0,0,0,2,,20,22
02584900,"FIRST INSTITUTE, INC.                   ",IL,60014-7489,Proprietary  ,14,39,53,131,,355,486
02587700,HAIR PROFESSIONALS CAREER COLLEGE       ,IL,60465-1929,Proprietary  ,6,14,20,48,,129,177
02622700,KNOWLEDGE SYSTEMS INSTITUTE             ,IL,60076-0000,Private      ,0,1,1,1,,11,12
03002000,HAIRMASTERS INST OF COSMETOLOGY         ,IL,61701-5547,Proprietary  ,4,14,18,59,,112,171
03027702,PACIFIC COLLEGE OF ORIENTAL MEDICINE - C,IL,60613-4418,Proprietary  ,4,22,26,57,,351,408
03065300,TREND SETTERS COLL OF COSMETOLOGY       ,IL,60915-0000,Proprietary  ,20,24,44,235,,278,513
03072701,WESTWOOD COLLEGE - RIVER OAKS           ,IL,60409-5503,Proprietary  ,10,73,83,212,,775,987
03072702,WESTWOOD COLLEGE OF TECHNOLOGY          ,IL,60602-0000,Proprietary  ,22,112,134,411,,1352,1763
03078400,CAMEO BEAUTY ACADEMY                    ,IL,60453-3196,Proprietary  ,6,11,17,60,,107,167
03079200,WESTWOOD COLLEGE - DUPAGE               ,IL,60517-2321,Proprietary  ,12,39,51,255,,689,944
03082900,ROSEL SCHOOL OF COSMETOLOGY             ,IL,60659-1913,Proprietary  ,1,18,19,57,,151,208
03083800,HEARTLAND COMMUNITY COLLEGE             ,IL,61761-9446,Public       ,75,130,205,2760,,2764,5524
03098000,ST JOHN'S COLLEGE OF NURSING            ,IL,62702-5321,Private      ,2,4,6,209,,312,521
03098002,ST JOHN'S HOSP SCH MED TECH             ,IL,62769-5324,Private      ,1,6,7,38,,131,169
03099700,CAIN'S BARBER COLLEGE                   ,IL,60615-3510,Proprietary  ,2,43,45,165,,542,707
03099800,ILLINOIS SCHOOL OF HEALTH CAREERS       ,IL,60604-0000,Proprietary  ,19,73,92,568,,1572,2140
03101800,ILLINOIS CENTER FOR BROADCASTING        ,IL,60148-7015,Proprietary  ,13,58,71,181,,456,637
03128500,NATIONAL LATINO EDUCATION INSTITUTE     ,IL,60609-2205,Private      ,6,12,18,78,,157,235
03199300,CHRISTIAN LIFE COLLEGE                  ,IL,60056-2522,Private      ,1,4,5,23,,27,50
03368300,MIDWEST TECHNICAL INSTITUTE             ,IL,62707-8805,Proprietary  ,157,607,764,1178,,3885,5063
03416300,COMPUTER SYSTEMS INSTITUTE              ,IL,60077-0000,Proprietary  ,70,287,357,424,,1643,2067
03448300,BUSINESS INDUSTRIAL RESOURCES           ,IL,60659-1298,Proprietary  ,74,501,575,506,,4330,4836
03455700,CORTIVA INSTITUTE - CHICAGO             ,IL,60602-3315,Proprietary  ,34,81,115,259,,575,834
03455701,CORTIVA INSTITUTE - CHICAGO             ,IL,60014-6285,Proprietary  ,4,1,5,19,,54,73
03490301,PAUL MITCHELL THE SCHOOL CHICAGO        ,IL,60607-0000,Proprietary  ,35,65,100,320,,487,807
03490302,PAUL MITCHELL THE SCHOOL ESCANABA - PAUL,IL,60148-0000,Proprietary  ,0,3,3,0,,3,3
03510300,ERIKSON INSTITUTE                       ,IL,60654-4510,Private      ,0,5,5,9,,374,383
03643300,"MR. JOHN'S SCHOOL OF JACKSONVILLE,  INC,",IL,62650-3488,Proprietary  ,1,4,5,27,,43,70
03655300,ILLINOIS CAREERPATH INSTITUTE           ,IL,60610-4705,Private      ,0,2,2,44,,199,243
03684300,NORTHSHORE UNIVERSITY HEALTHSYSTEM SCHOO,IL,60201-9872,Private      ,0,2,2,10,,61,71
03881400,EUROPEAN MASSAGE THERAPY SCHOOL         ,IL,60077-2269,Proprietary  ,7,36,43,26,,187,213
03891300,SOMA INSTITUTE - THE NATIONAL SCHOOL OF ,IL,60604-4466,Proprietary  ,11,34,45,77,,233,310
03914300,"CALC, INSTITUTE OF TECHNOLOGY           ",IL,62002-5931,Proprietary  ,6,32,38,63,,280,343
04117500,SOLEX MEDICAL ACADEMY                   ,IL,60090-3104,Proprietary  ,0,7,7,8,,50,58
04117600,LARRY'S BARBER COLLEGE                  ,IL,60628-2322,Proprietary  ,13,43,56,196,,606,802
04118400,ZAREM /GOLDE ORT TECHNICAL INSTITUTE    ,IL,60077-3210,Private      ,9,28,37,42,,281,323
04124700,AMBRIA COLLEGE OF NURSING               ,IL,60192-3712,Proprietary  ,6,64,70,85,,620,705
04136900,UNIVERSITY OF AESTHETICS (THE)          ,IL,60622-2151,Proprietary  ,2,9,11,28,,101,129
04137000,UNIVERSITY OF AESTHETICS & COSMETOLOGY (,IL,60515-4607,Proprietary  ,3,9,12,22,,52,74
04137500,TRICOCI UNIVERSITY OF BEAUTY CULTURE    ,IL,60656-1805,Proprietary  ,14,37,51,303,,441,744
04139000,MIDWESTERN CAREER COLLEGE               ,IL,60606-3103,Proprietary  ,9,55,64,136,,791,927
04141000,AVEDA INSTITUTE CHICAGO                 ,IL,60647-0000,Proprietary  ,11,47,58,274,,516,790
04147100,TRICOCI UNIVERSITY OF BEAUTY CULTURE    ,IL,60048-2906,Proprietary  ,4,17,21,110,,139,249
04147200,TRICOCI UNIVERSITY OF BEAUTY CULTURE    ,IL,60455-1824,Proprietary  ,12,23,35,130,,216,346
04147300,TRICOCI UNIVERSITY OF BEAUTY CULTURE    ,IL,60139-3119,Proprietary  ,5,15,20,152,,159,311
04147400,TRICOCI UNIVERSITY OF BEAUTY CULTURE    ,IL,61614-4831,Proprietary  ,5,19,24,91,,174,265
04147500,TRICOCI UNIVERSITY OF BEAUTY CULTURE    ,IL,61108-2337,Proprietary  ,10,26,36,124,,233,357
04160600,PAUL MITCHELL THE SCHOOL NORMAL         ,IL,61761-0000,Proprietary  ,2,13,15,183,,186,369
04167800,INNOVATIONS DESIGN ACADEMY              ,IL,61520-2625,Proprietary  ,2,4,6,30,,80,110
04168500,SOLEX COLLEGE                           ,IL,60090-3192,Proprietary  ,2,80,82,22,,354,376
04170800,UNITY COSMETOLOGY COLLEGE               ,IL,61764-9652,Proprietary  ,3,3,6,28,,61,89
04171600,SALON PROFESSIONAL ACADEMY OF ELGIN (THE,IL,60123-2319,Proprietary  ,1,9,10,28,,91,119
04172200,NORTHWESTERN INSTITUTE OF HEALTH AND TEC,IL,60640-4785,Private      ,0,0,0,219,,604,823
04174900,SKIN CARE AND SPA INSTITUTE             ,IL,60077-2200,Proprietary  ,1,17,18,17,,146,163
04175000,UNIVERSAL SPA TRAINING ACADEMY          ,IL,60515-0000,Proprietary  ,2,26,28,28,,147,175
04175800,J RENEE CAREER FACILITATION             ,IL,60014-7986,Proprietary  ,2,11,13,19,,144,163
04179100,PCCTI  IT & HEALTHCARE                  ,IL,60523-0000,Proprietary  ,1,40,41,41,,547,588
04179101,PCCTI  IT & HEALTHCARE -                ,IL,60606-0000,Proprietary  ,2,12,14,31,,250,281
04186000,CHICAGO SCHOOL FOR PIANO TECHNOLOGY (THE,IL,60612-1630,Private      ,0,3,3,19,,60,79
04187400,COSMETOLOGY CONCEPTS                    ,IL,60452-2501,Proprietary  ,9,28,37,131,,292,423
04189200,SALON PROFESSIONAL ACADEMY (THE)        ,IL,60404-8789,Proprietary  ,6,9,15,43,,92,135
04189400,SHEAR LEARNING ACADEMY OF COSMETOLOGY   ,IL,62523-1208,Proprietary  ,0,2,2,28,,49,77
04189600,STATE CAREER SCHOOL                     ,IL,60085-5129,Proprietary  ,4,17,21,57,,191,248
04192000,CURVE METRIC SCHOOL OF HAIR DESIGN      ,IL,60707-1118,Proprietary  ,2,3,5,16,,39,55
04195600,TRIBECA FLASHPOINT MEDIA ARTS ACADEMY   ,IL,60602-2716,Proprietary  ,13,16,29,350,,265,615
04224400,NETWORKS BARBER COLLEGE                 ,IL,60409-3401,Proprietary  ,2,11,13,6,,34,40
04224500,TRENZ BEAUTY ACADEMY                    ,IL,60409-0000,Proprietary  ,3,14,17,9,,54,63
04225300,CREATIVE TOUCH COSMETOLOGY SCHOOL       ,IL,62298-1609,Proprietary  ,0,3,3,0,,4,4
04227900,MORTHLAND COLLEGE                       ,IL,62896-2742,Private      ,9,4,13,18,,6,24
04229900,DEBUTANTES SCHOOL OF COSMETOLOGY AND NAI,IL,60115-3301,Proprietary  ,0,4,4,3,,6,9
00195100,ALICE LLOYD COLLEGE                     ,KY,41844-9703,Private      ,12,8,20,1324,,282,1606
00195200,ASBURY COLLEGE                          ,KY,40390-1198,Private      ,18,38,56,1814,,832,2646
00195300,ASBURY THEOLOGICAL SEMINARY             ,KY,40390-0000,Private      ,1,28,29,35,,1452,1487
00195400,BELLARMINE UNIVERSITY                   ,KY,40205-1877,Private      ,76,132,208,5439,,2534,7973
00195500,BEREA COLLEGE                           ,KY,40403-0000,Private      ,45,31,76,3371,,1010,4381
00195800,BRESCIA UNIVERSITY                      ,KY,42301-3023,Private      ,22,57,79,1173,,1093,2266
00195900,CAMPBELLSVILLE UNIVERSITY               ,KY,42718-2799,Private      ,44,88,132,3042,,2030,5072
00196000,SPALDING UNIVERSITY                     ,KY,40203-2188,Private      ,29,133,162,1574,,3486,5060
00196100,CENTRE COLLEGE                          ,KY,40422-1394,Private      ,15,7,22,2730,,171,2901
00196200,UNIVERSITY OF THE CUMBERLANDS           ,KY,40769-1372,Private      ,34,277,311,2945,,3641,6586
00196300,EASTERN KENTUCKY UNIVERSITY             ,KY,40475-3102,Public       ,231,433,664,14657,,11795,26452
00196400,GEORGETOWN COLLEGE                      ,KY,40324-1628,Private      ,40,33,73,2322,,840,3162
00196500,KENTUCKY CHRISTIAN UNIVERSITY           ,KY,41143-2205,Private      ,17,6,23,926,,294,1220
00196800,KENTUCKY STATE UNIVERSITY               ,KY,40601-2355,Public       ,71,67,138,3912,,2379,6291
00196900,KENTUCKY WESLEYAN COLLEGE               ,KY,42301-6057,Private      ,20,20,40,1325,,470,1795
00197100,LEXINGTON THEOLOGICAL SEMINARY          ,KY,40508-0000,Private      ,0,5,5,8,,126,134
00197200,LINDSEY WILSON COLLEGE                  ,KY,42728-1223,Private      ,48,55,103,3292,,2026,5318
00197400,LOUISVILLE PRESBYTERIAN THEOL SEM       ,KY,40205-0000,Private      ,0,3,3,9,,210,219
00197500,MIDWAY COLLEGE                          ,KY,40347-1120,Private      ,4,48,52,686,,2031,2717
00197600,MOREHEAD STATE UNIVERSITY               ,KY,40351-1689,Public       ,124,190,314,9109,,5993,15102
00197700,MURRAY STATE UNIVERSITY                 ,KY,42071-0009,Public       ,106,135,241,8799,,4951,13750
00197900,WEST KENTUCKY CMNTY & TECHNICAL COLG    ,KY,42002-7380,Public       ,81,246,327,2386,,5070,7456
00198000,UNIVERSITY OF PIKEVILLE                 ,KY,41501-1194,Private      ,52,28,80,2540,,1512,4052
00198300,ST. CATHARINE COLLEGE                   ,KY,40061-9499,Private      ,18,16,34,833,,503,1336
00198700,TRANSYLVANIA UNIVERSITY                 ,KY,40508-1797,Private      ,20,15,35,2182,,372,2554
00198800,UNION COLLEGE                           ,KY,40906-1499,Private      ,15,45,60,1458,,974,2432
00198900,UNIVERSITY OF KENTUCKY                  ,KY,40506-0054,Public       ,333,272,605,26141,,11475,37616
00198901,UNIV OF KY-COLLEGE OF DENTISTRY         ,KY,40536-0000,Public       ,3,1,4,55,,307,362
00198902,UNIV OF KY-COLLEGE OF MEDICINE          ,KY,40536-0000,Public       ,2,8,10,157,,655,812
00199000,ASHLAND COMMUNITY AND TECHNICAL COLLEGE ,KY,41101-3683,Public       ,48,173,221,1666,,3523,5189
00199100,ELIZABETHTOWN COMMUNITY  AND TECHNICAL C,KY,42701-3081,Public       ,101,319,420,2926,,6471,9397
00199300,HENDERSON COMMUNITY COLLEGE             ,KY,42420-4699,Public       ,10,100,110,656,,1781,2437
00199400,HOPKINSVILLE COMMUNITY COLLEGE          ,KY,42241-2621,Public       ,26,310,336,1221,,4726,5947
00199600,BIG SANDY COMMUNITY AND TECHNICAL COLG  ,KY,41653-1815,Public       ,60,200,260,2350,,3654,6004
00199700,SOMERSET COMMUNITY COLLEGE              ,KY,42501-2973,Public       ,72,347,419,3475,,8074,11549
00199800,SOUTHEAST KENTUCKY COMMUNITY AND TECHNIC,KY,40823-1099,Public       ,62,209,271,1529,,2711,4240
00199900,UNIVERSITY OF LOUISVILLE                ,KY,40292-0000,Public       ,261,411,672,17986,,14941,32927
00200100,THOMAS MORE COLLEGE                     ,KY,41017-3495,Private      ,18,68,86,1625,,888,2513
00200200,WESTERN KENTUCKY UNIVERSITY             ,KY,42101-3576,Public       ,318,367,685,17906,,11153,29059
00461800,SPENCERIAN COLLEGE                      ,KY,40216-2605,Proprietary  ,32,138,170,722,,1972,2694
00461900,SULLIVAN UNIVERSITY                     ,KY,40205-3000,Proprietary  ,180,538,718,2451,,7127,9578
00493402,DAYMAR COLLEGE - BOWLING GREEN          ,KY,42101-4063,Proprietary  ,6,31,37,144,,541,685
00493403,DAYMAR COLLEGE - CLINTON                ,KY,42031-9998,Proprietary  ,0,1,1,1,,42,43
00493406,DAYMAR COLLEGE - RUSSELLVILLE           ,KY,42276-1622,Proprietary  ,1,12,13,24,,127,151
00524400,BLUEGRASS COMMUNITY & TECHNICAL COLLEGE ,KY,40506-0235,Public       ,154,584,738,6584,,12126,18710
00527100,BOWLING GREEN TECHNICAL COLLEGE         ,KY,42101-3601,Public       ,54,161,215,2134,,4443,6577
00527300,GATEWAY COMMUNITY & TECHNOLOGY COLL     ,KY,41011-0000,Public       ,72,311,383,1734,,4988,6722
00696000,MAYSVILLE CMNTY & TECHNCL COLG          ,KY,41056-8910,Public       ,41,206,247,1462,,3763,5225
00696100,JEFFERSON COMMUNITY AND TECHNICAL COLLEG,KY,40202-2005,Public       ,185,601,786,7795,,16455,24250
00696200,HAZARD COMMUNITY COLLEGE                ,KY,41701-2402,Public       ,26,109,135,1606,,2953,4559
00696203,KY TECH-KNOTT CO. TECHNOLOGY CTR        ,KY,41822-0000,Public       ,0,0,0,12,,21,33
00696204,KY TECH-LESLIE COUNTY AREA TECH CTR     ,KY,41749-0000,Public       ,0,1,1,6,,24,30
00696205,KY TECH-LEE COUNTY AREA TECH CTR        ,KY,41311-0000,Public       ,0,0,0,5,,17,22
00696206,KY TECH-LETCHER CNTY AREA TECH CTR      ,KY,41858-0000,Public       ,0,6,6,31,,90,121
00696207,KY TECH-BREATHITT COUNTY VOC ED CTR     ,KY,41339-0000,Public       ,0,7,7,38,,92,130
00736205,MEDTECH COLLEGE - LEXINGTON             ,KY,40511-1200,Proprietary  ,13,136,149,154,,952,1106
00757303,EMPIRE BEAUTY SCHOOL - HURSTBOURNE      ,KY,40291-1931,Proprietary  ,0,0,0,119,,344,463
00757305,EMPIRE BEAUTY SCHOOL - DIXIE            ,KY,40216-4212,Proprietary  ,0,0,0,72,,182,254
00842500,DAYMAR COLLEGE                          ,KY,42001-0000,Proprietary  ,1,30,31,58,,382,440
00901000,MADISONVILLE COMMUNITY COLLEGE          ,KY,42431-9199,Public       ,35,122,157,1273,,2780,4053
00927500,NORTHERN KENTUCKY UNIVERSITY            ,KY,41099-0001,Public       ,154,239,393,11533,,8574,20107
00931300,DAYMAR COLLEGE                          ,KY,42301-5830,Proprietary  ,12,121,133,159,,1576,1735
00931302,DAYMAR COLLEGE - LOUISVILLE             ,KY,40219-1973,Proprietary  ,4,37,41,137,,682,819
00931304,DAYMAR COLLEGE - ALBANY                 ,KY,42602-1235,Proprietary  ,1,0,1,8,,15,23
00931305,DAYMAR COLLEGE - BELLEVUE               ,KY,41073-2416,Proprietary  ,1,5,6,21,,81,102
00931308,DAYMAR COLLEGE -  SCOTTSVILLE           ,KY,42164-1505,Proprietary  ,0,9,9,9,,70,79
00931309,DAYMAR COLLEGE - LOUISVILLE EAST        ,KY,40245-1629,Proprietary  ,0,18,18,56,,322,378
00931310,DAYMAR COLLEGE -  MADISONVILLE          ,KY,42431-0000,Proprietary  ,0,16,16,24,,195,219
00945913,EMPIRE BEAUTY SCHOOL - FLORENCE         ,KY,41042-5113,Proprietary  ,0,0,0,81,,204,285
01042400,SALON PROFESSIONAL ACADEMY THE          ,KY,40502-0000,Proprietary  ,13,39,52,156,,395,551
01048901,NATIONAL COLLEGE - FLORENCE CAMPUS      ,KY,41042-1812,Proprietary  ,3,20,23,36,,355,391
01048902,NATIONAL COLLEGE - PIKEVILLE CAMPUS     ,KY,41501-1518,Proprietary  ,6,39,45,185,,595,780
01048903,NATIONAL COLLEGE - DANVILLE CAMPUS      ,KY,40422-1517,Proprietary  ,5,39,44,65,,408,473
01048904,NATIONAL COLLEGE - RICHMOND CAMPUS      ,KY,40475-2309,Proprietary  ,1,31,32,72,,494,566
01048906,NATIONAL COLLEGE - LOUISVILLE CAMPUS    ,KY,40216-4147,Proprietary  ,13,93,106,130,,1054,1184
01048907,NATIONAL COLLEGE - LEXINGTON CAMPUS     ,KY,40509-2256,Proprietary  ,7,50,57,125,,920,1045
01054210,EMPIRE BEAUTY SCHOOL - CHENOWETH        ,KY,40207-2695,Proprietary  ,0,0,0,69,,151,220
01172500,COLLINS SCHOOL OF COSMETOLOGY           ,KY,40965-2809,Proprietary  ,3,11,14,33,,101,134
01208800,SULLIVAN COLLEGE OF TECHNOLOGY AND DESIG,KY,40218-4528,Proprietary  ,33,80,113,622,,1081,1703
01212801,SOUTHWESTERN COLLEGE                    ,KY,41042-1466,Proprietary  ,1,6,7,74,,297,371
01260609,EMPIRE BEAUTY SCHOOL - HIGHLAND         ,KY,40204-1317,Proprietary  ,0,0,0,60,,170,230
01272300,KY TECH-WAYNE COUNTY AREA TECH CTR      ,KY,42633-1088,Public       ,1,3,4,3,,10,13
01291700,EMPIRE BEAUTY SCHOOL                    ,KY,42701-2949,Proprietary  ,0,0,0,75,,175,250
02159100,"APPALACHIAN BEAUTY SCHOOL, INC.         ",KY,41503-0000,Proprietary  ,2,5,7,39,,64,103
02251500,TREND SETTERS ACAD OF BEAUTY CULT       ,KY,40258-0000,Proprietary  ,5,43,48,76,,313,389
02275000,JENNY LEA ACADEMY OF COSMETOLOGY        ,KY,40831-0000,Proprietary  ,4,35,39,93,,333,426
02284306,INTERACTIVE LEARNING SYSTEMS            ,KY,41042-0000,Proprietary  ,0,14,14,18,,107,125
02323700,PAT WILSON'S BEAUTY COLLEGE             ,KY,42420-0000,Proprietary  ,1,6,7,16,,102,118
02337200,PJ'S COLLEGE OF COSMETOLOGY             ,KY,42101-0000,Proprietary  ,7,64,71,133,,565,698
02340800,PAUL MITCHELL THE SCHOOL LEXINGTON      ,KY,40514-1545,Proprietary  ,9,38,47,238,,419,657
02351700,PAUL MITCHELL THE SCHOOL - LOUISVILLE   ,KY,40222-0000,Proprietary  ,10,24,34,243,,395,638
02491100,BECKFIELD COLLEGE                       ,KY,41042-0000,Proprietary  ,37,306,343,357,,2770,3127
02518900,BARRETT & COMPANY SCH HAIR DESIGN       ,KY,40356-0000,Proprietary  ,3,17,20,47,,199,246
02526100,JENNY LEA ACADEMY OF COSMETOLOGY        ,KY,41858-0000,Proprietary  ,0,4,4,30,,77,107
02535600,CLEAR CREEK BAPTIST BIBLE COLLEGE       ,KY,40977-0000,Private      ,0,6,6,47,,150,197
02551100,PJ'S COLLEGE OF COSMETOLOGY             ,KY,42141-2434,Proprietary  ,2,17,19,40,,136,176
02560800,SOUTHEAST SCHOOL OF COSMETOLOGY         ,KY,40962-0000,Proprietary  ,2,5,7,19,,96,115
02576200,MID-CONTINENT UNIVERSITY                ,KY,42066-9007,Private      ,16,245,261,481,,4009,4490
03002100,KENTUCKY MOUNTAIN BIBLE COLLEGE         ,KY,41385-0010,Private      ,2,2,4,57,,47,104
03007000,FRONTIER SCH OF MIDWIFERY&FAMILY NU     ,KY,41749-0000,Private      ,0,221,221,10,,2197,2207
03026200,HEAD'S WEST KENTUCKY BEAUTY COLLEGE     ,KY,42431-0000,Proprietary  ,1,5,6,24,,94,118
03029200,NU-TEK ACADEMY OF BEAUTY                ,KY,40353-9767,Proprietary  ,1,6,7,26,,70,96
03034500,OWENSBORO COMMUNITY & TECHNICAL COLLEGE ,KY,42303-1899,Public       ,39,177,216,1916,,3600,5516
03083700,GALEN HEALTH INSTITUTES                 ,KY,40207-1047,Proprietary  ,48,448,496,1001,,6397,7398
03103500,MR JIM'S BEAUTY COLLEGE                 ,KY,42301-2646,Proprietary  ,0,0,0,20,,40,60
03516500,EZELL'S COSMETOLOGY SCHOOL              ,KY,42071-2530,Proprietary  ,0,0,0,39,,88,127
03611300,BRIGHTON CENTER'S CENTER FOR EMPLOY     ,KY,41071-1968,Private      ,5,32,37,14,,129,143
03804300,BELLEFONTE ACADEMY OF BEAUTY            ,KY,41169-2015,Proprietary  ,3,24,27,35,,224,259
03885300,EMPLOYMENT SOLUTIONS                    ,KY,40517-3260,Private      ,5,61,66,87,,540,627
03886300,REGENCY SCHOOL OF HAIR DESIGN           ,KY,41653-1278,Proprietary  ,0,2,2,28,,107,135
04038300,ATA CAREER EDUCATION                    ,KY,40223-3832,Proprietary  ,28,125,153,279,,1281,1560
04051316,ART INSTITUTE OF PHOENIX (THE) - ATS - (,KY,41017-2136,Proprietary  ,6,51,57,141,,669,810
04051319,ART INSTITUTE OF PHOENIX (THE) - BROWN M,KY,40219-1916,Proprietary  ,9,28,37,207,,723,930
04051320,ART INSTITUTE OF PHOENIX (THE) - BROWN M,KY,42240-3579,Proprietary  ,3,9,12,53,,245,298
04123900,LEXINGTON HEALING ARTS ACADEMY          ,KY,40503-1932,Proprietary  ,8,21,29,76,,241,317
04177600,LINDSEY INSTITUTE OF COSMETOLOGY        ,KY,42103-8036,Proprietary  ,3,8,11,83,,158,241
04177700,TRI-STATE INSTITUTE OF HAIR DESIGN      ,KY,40744-5234,Proprietary  ,3,11,14,38,,127,165
04178000,SIMMONS COLLEGE OF KENTUCKY             ,KY,40203-3322,Private      ,4,12,16,44,,213,257
04229300,MEDQUEST COLLEGE                        ,KY,40243-1882,Proprietary  ,11,38,49,11,,38,49
00200300,CENTENARY COLLEGE OF LOUISIANA          ,LA,71104-3396,Private      ,13,15,28,1000,,391,1391
00200400,DILLARD UNIVERSITY                      ,LA,70122-3097,Private      ,54,61,115,2842,,1612,4454
00200500,NICHOLLS STATE UNIVERSITY               ,LA,70310-0001,Public       ,80,125,205,6466,,3410,9876
00200600,GRAMBLING STATE UNIVERSITY              ,LA,71245-2215,Public       ,123,138,261,6518,,4686,11204
00200700,LOUISIANA COLLEGE                       ,LA,71359-0000,Private      ,17,65,82,1398,,881,2279
00200800,LOUISIANA TECH UNIVERSITY               ,LA,71272-0001,Public       ,110,155,265,8290,,3721,12011
00201000,LOUISIANA STATE UNIV & A&M COLG         ,LA,70803-5710,Public       ,327,258,585,28623,,9985,38608
00201100,LOUISIANA STATE UNIV-ALEXANDRIA         ,LA,71302-9121,Public       ,33,92,125,2125,,2280,4405
00201200,LOUISIANA STATE UNIV-EUNICE             ,LA,70535-6726,Public       ,47,67,114,2407,,2087,4494
00201300,LOUISIANA STATE UNIV-SHREVEPORT         ,LA,71115-2399,Public       ,62,204,266,3293,,4437,7730
00201400,LA STATE UNIV HEALTH SCIENCES CTR       ,LA,70112-2223,Public       ,14,70,84,747,,2873,3620
00201500,(THE) UNIVERSITY OF NEW ORLEANS         ,LA,70148-0001,Public       ,131,260,391,7774,,8447,16221
00201600,LOYOLA UNIVERSITY NEW ORLEANS           ,LA,70118-6195,Private      ,85,97,182,5540,,3516,9056
00201700,MCNEESE STATE UNIVERSITY                ,LA,70609-4510,Public       ,100,174,274,6161,,4462,10623
00201900,NEW ORLEANS BAPTIST THEOL SEMINARY      ,LA,70126-0000,Private      ,1,14,15,60,,324,384
00202000,UNIVERSITY OF LOUISIANA AT MONROE       ,LA,71209-9001,Public       ,116,165,281,7652,,5526,13178
00202100,NORTHWESTERN STATE UNIVERSITY           ,LA,71497-0001,Public       ,117,321,438,6634,,6776,13410
00202200,NOTRE DAME SEMINARY                     ,LA,70118-0000,Private      ,2,5,7,19,,43,62
00202300,OUR LADY OF HOLY CROSS COLLEGE          ,LA,70131-7399,Private      ,13,62,75,674,,1644,2318
00202400,SOUTHEASTERN LOUISIANA UNIV             ,LA,70402-0001,Public       ,225,249,474,12562,,6601,19163
00202500,SOUTHERN UNIVERSITY A & M COLLEGE       ,LA,70813-9374,Public       ,161,282,443,8408,,8020,16428
00202600,SOUTHERN UNIV NEW ORLEANS               ,LA,70126-0002,Public       ,83,209,292,2757,,5566,8323
00202700,ST JOSEPH SEMINARY COLLEGE              ,LA,70457-9990,Private      ,0,1,1,61,,22,83
00202900,TULANE UNIVERSITY                       ,LA,70118-5698,Private      ,124,187,311,12727,,8237,20964
00203100,UNIV OF LOUISIANA AT LAFAYETTE          ,LA,70504-0001,Public       ,217,256,473,15468,,7259,22727
00203200,XAVIER UNIVERSITY OF LOUISIANA          ,LA,70125-1098,Private      ,74,75,149,5337,,2306,7643
00462100,AYERS CAREER COLLEGE                    ,LA,71108-5845,Proprietary  ,13,75,88,112,,643,755
00462500,DELGADO COMMUNITY COLLEGE               ,LA,70119-0000,Public       ,311,808,1119,9958,,20499,30457
00546700,SOWELA TECHNICAL COMMUNITY COLLEGE      ,LA,70616-6950,Public       ,48,143,191,1671,,2585,4256
00546702,SOWELA TECHNICAL COMMUNITY COLLEGE - MOR,LA,70546-1327,Public       ,4,11,15,95,,164,259
00547100,NORTHEAST LOUISIANA TECHNICAL COLLEGE   ,LA,71292-9064,Public       ,0,0,0,287,,740,1027
00547101,NORTHEAST LOUISIANA TECHNICAL COLLEGE   ,LA,71241-0000,Public       ,0,0,0,9,,14,23
00547102,NORTHEAST LOUISIANA TECHNICAL COLLEGE   ,LA,71270-0000,Public       ,0,0,0,165,,343,508
00547103,NORTHEAST LOUISIANA TECHNICAL COLLEGE   ,LA,71295-0000,Public       ,0,0,0,78,,186,264
00547104,NORTHEAST LOUISIANA TECHNICAL COLLEGE   ,LA,71220-0000,Public       ,0,0,0,62,,161,223
00548000,"LOUISIANA TECHNICAL COLLEGE, HUEY P. LON",LA,71483-3599,Public       ,0,0,0,127,,242,369
00548800,CAPITAL AREA TECHNICAL COLLEGE          ,LA,70807-0000,Public       ,27,75,102,683,,1494,2177
00548805,LA TECH COLLEGE-AVOYELLES CAMPUS        ,LA,71327-0000,Public       ,0,0,0,86,,215,301
00548812,LOUISIANA TECH COLG-FOLKES CAMPUS       ,LA,70748-0000,Public       ,5,5,10,42,,75,117
00548817,LOUISIANA TEC CLG-JUMONVILLE MEM CP     ,LA,70760-0000,Public       ,2,8,10,35,,70,105
00548820,LOUISIANA TEC CLG-LAMAR SALTER CMPS     ,LA,71446-0000,Public       ,0,0,0,94,,357,451
00548828,LA TECHNICAL COLG-OAKDALE CMPS          ,LA,71463-0000,Public       ,0,0,0,79,,118,197
00548832,LOUISIANA TECH COLG-SHELBY JACKSON      ,LA,71334-0000,Public       ,0,0,0,95,,248,343
00548838,LOUISIANA TECHNICAL COLG - TALLULAH     ,LA,71284-0000,Public       ,0,0,0,50,,90,140
00548842,LOUISIANA TECHNICAL COLLEGE - WESTSIDE C,LA,70765-0733,Public       ,2,5,7,41,,105,146
00548900,CENTRAL LOUISIANA TECHNICAL COLLEGE     ,LA,71302-3137,Public       ,22,74,96,284,,784,1068
00552600,SOUTH CENTRAL LOUISIANA TECHNICAL COLG  ,LA,70381-2148,Public       ,11,16,27,152,,399,551
00552602,SOUTH CENTRAL LOUISIANA TECHNICAL COLG  ,LA,70302-4336,Public       ,2,16,18,122,,263,385
00552603,SOUTH CENTRAL LOUISIANA TECHNICAL COLG  ,LA,70084-6632,Public       ,14,41,55,421,,694,1115
00576100,L. E. FLETCHER TECHNICAL COMMUNITY COLLE,LA,70360-2863,Public       ,39,60,99,1276,,1633,2909
00675600,NORTHSHORE TECHNICAL COLLEGE            ,LA,70427-5866,Public       ,31,67,98,367,,838,1205
00675603,NORTHSHORE TECHNICAL COLLEGE - HAMMOND  ,LA,70401-0000,Public       ,20,40,60,578,,997,1575
00675604,NORTHSHORE TECHNICAL COLLEGE - FLORIDA  ,LA,70441-0000,Public       ,6,12,18,206,,297,503
00768600,SOUTHERN UNIV AT SHREVEPORT/BOSSIER     ,LA,71107-4795,Public       ,87,195,282,1938,,3894,5832
00806700,LSU HEALTH SCIENCES CENTR-SHREVEPOR     ,LA,71130-3932,Public       ,15,41,56,375,,1223,1598
00989800,DEMMON SCHOOL OF BEAUTY                 ,LA,70607-2128,Proprietary  ,4,12,16,36,,132,168
00997500,NORTHWEST LOUISIANA TECHNICAL COLLEGE   ,LA,71055-2422,Public       ,14,54,68,231,,601,832
00997503,NORTHWEST LOUISIANA TECHNICAL COLLEGE   ,LA,71137-8527,Public       ,23,90,113,378,,1400,1778
00997504,NORTHWEST LOUISIANA TECHNICAL COLLEGE   ,LA,71052-1236,Public       ,10,18,28,77,,193,270
00997505,NORTHWEST LOUISIANA TECHNICAL COLLEGE   ,LA,71449-0790,Public       ,3,14,17,37,,136,173
00997506,NORTHWEST LOUISIANA TECHNICAL COLLEGE   ,LA,71458-0657,Public       ,11,21,32,211,,423,634
01005701,AMERICAN COMMERCIAL COLLEGE             ,LA,71105-2502,Proprietary  ,0,0,0,6,,22,28
01109700,CLOYD'S BEAUTY SCHOOL #1                ,LA,71291-3131,Proprietary  ,1,18,19,45,,147,192
01163100,"D-JAY'S SCHL OF BEAUTY, ARTS & SCI      ",LA,70806-0000,Proprietary  ,4,13,17,77,,203,280
01184100,JOHN JAY BEAUTY COLLEGE                 ,LA,70124-2592,Proprietary  ,4,24,28,139,,315,454
01282300,PAT GOINS RUSTON BEAUTY SCHOOL          ,LA,71270-4301,Proprietary  ,1,6,7,31,,69,100
01287900,PAT GOINS BENTON ROAD BEAUTY SCHOOL     ,LA,71111-4838,Proprietary  ,2,17,19,29,,142,171
01288000,CELEBRITY STYLIST BEAUTY SCHOOL         ,LA,71201-5167,Proprietary  ,6,10,16,41,,91,132
02055400,BOSSIER PARISH COMMUNITY COLLEGE        ,LA,71111-0000,Public       ,175,487,662,4091,,7507,11598
02055500,DELTA SCH OF BUSINESS & TECHNOLOGY      ,LA,70601-0000,Proprietary  ,9,42,51,133,,497,630
02117800,AVEDA INSTITUTE LAFAYETTE               ,LA,70503-3246,Proprietary  ,16,39,55,195,,266,461
02166100,NUNEZ COMMUNITY COLLEGE                 ,LA,70043-0000,Public       ,60,160,220,892,,2322,3214
02166200,ITI TECHNICAL COLLEGE                   ,LA,70817-0000,Proprietary  ,30,115,145,590,,1149,1739
02197500,BATON ROUGE SCHOOL OF COMPUTERS         ,LA,70809-8188,Proprietary  ,3,8,11,69,,184,253
02234000,CAMERON COLLEGE                         ,LA,70119-0000,Proprietary  ,13,49,62,114,,470,584
02253901,BERKS TECHNICAL INSTITUTE - CAREER TECHN,LA,71021-6126,Proprietary  ,0,0,0,224,,800,1024
02253902,BERKS TECHNICAL INSTITUTE - CAREER TECHN,LA,71105-2405,Proprietary  ,0,0,0,192,,669,861
02258400,AVEDA INSTITUTE BATON ROUGE             ,LA,70816-2246,Proprietary  ,19,30,49,292,,408,700
02260200,DIESEL DRIVING ACADEMY                  ,LA,71109-5617,Proprietary  ,10,86,96,75,,495,570
02265600,JOHN JAY KENNER ACADEMY                 ,LA,70062-0000,Proprietary  ,4,14,18,34,,130,164
02269300,STEVENSON'S ACADEMY OF HAIR DESIGN      ,LA,70116-0000,Proprietary  ,4,17,21,92,,293,385
02327800,PINEVILLE BEAUTY SCHOOL                 ,LA,71360-0000,Proprietary  ,3,8,11,51,,130,181
02335700,BATON ROUGE GENERAL MEDICAL CENTER      ,LA,70806-3889,Private      ,3,12,15,102,,233,335
02335701,BATON ROUGE GEN MED CTR SCH NSG         ,LA,70821-0000,Private      ,4,15,19,106,,384,490
02335702,BATON ROUGE GEN MED CTR-RAD TECH        ,LA,70806-0000,Private      ,1,7,8,78,,178,256
02338000,"CLOYD'S BEAUTY SCHOOL #2, INC           ",LA,71202-3539,Proprietary  ,5,15,20,54,,144,198
02352500,"CLOYD'S BEAUTY SCHOOL #3, INC           ",LA,71201-3211,Proprietary  ,5,18,23,54,,160,214
02358600,"STAGE ONE THE HAIR SCHOOL, INC.         ",LA,70605-0000,Proprietary  ,8,23,31,118,,203,321
02518300,SOUTH LOUISIANA BEAUTY COLLEGE          ,LA,70363-0000,Proprietary  ,2,4,6,51,,79,130
02536400,LOUISIANA ACADEMY OF BEAUTY             ,LA,70535-0000,Proprietary  ,1,5,6,40,,76,116
02538300,DELTA COLLEGE OF ARTS & TECH INC        ,LA,70806-1529,Proprietary  ,16,85,101,289,,943,1232
02538301,DELTA COLLEGE OF ARTS & TECHNOLOGY - LAF,LA,70508-6831,Proprietary  ,8,39,47,152,,499,651
02548500,COSMETOLOGY TRAINING CENTER             ,LA,70503-0000,Proprietary  ,8,10,18,121,,179,300
02554800,VANGUARD COLLEGE OF COSMETOLOGY         ,LA,70458-8823,Proprietary  ,13,25,38,265,,302,567
02582200,"GUY'S ACADEMY HAIR, SKIN & NAILS        ",LA,71105-2404,Proprietary  ,5,14,19,54,,235,289
02600900,AVEDA INSTITUTE                         ,LA,70433-2922,Proprietary  ,161,269,430,1428,,2323,3751
02601000,AMERICAN SCHOOL OF BUSINESS             ,LA,71105-5646,Proprietary  ,5,23,28,48,,216,264
02601100,OPELOUSAS SCHOOL OF COSMETOLOGY         ,LA,70570-6156,Proprietary  ,3,1,4,25,,60,85
02617100,BATON ROUGE COLLEGE                     ,LA,70806-1725,Proprietary  ,0,0,0,163,,219,382
02619200,DENHAM SPRINGS BEAUTY COLLEGE           ,LA,70726-3829,Proprietary  ,6,13,19,75,,111,186
03010400,CRESCENT CITY SCH GAMING & BARTENDG     ,LA,70119-5507,Proprietary  ,22,177,199,128,,1038,1166
03010624,VIRGINIA COLLEGE - BATON ROUGE          ,LA,70815-8604,Proprietary  ,7,40,47,158,,601,759
03023500,CAMELOT CAREER COLLEGE                  ,LA,70805-7539,Proprietary  ,13,55,68,127,,400,527
03026514,REMINGTON COLLEGE - LAFAYETTE           ,LA,70508-5760,Private      ,6,24,30,135,,325,460
03026515,REMINGTON COLLEGE - BATON ROUGE         ,LA,70816-4040,Private      ,8,31,39,205,,553,758
03027300,BLALOCK'S PROFESSIONAL BEAUTY COLLEGE   ,LA,71108-3246,Proprietary  ,2,8,10,2,,8,10
03030900,DIESEL DRIVING ACADEMY                  ,LA,70815-8109,Proprietary  ,10,178,188,76,,841,917
03095100,GRETNA CAREER COLLEGE                   ,LA,70053-2436,Proprietary  ,0,0,0,6,,13,19
03106200,OUR LADY OF THE LAKE COLLEGE            ,LA,70808-4345,Private      ,15,84,99,1242,,2266,3508
03294300,BLUE CLIFF SCH THERAPEUTIC MASSAGE      ,LA,70002-3458,Proprietary  ,110,523,633,675,,2676,3351
03294303,BLUE CLIFF COLLEGE - LAFAYETTE          ,LA,70508-3256,Proprietary  ,8,20,28,243,,706,949
03294306,BLUE CLIFF COLLEGE - SHREVEPORT         ,LA,71105-6520,Proprietary  ,4,25,29,147,,709,856
03332600,DELTA COLLEGE                           ,LA,70433-9042,Proprietary  ,14,33,47,198,,542,740
03332601,DELTA COLLEGE - SLIDELL                 ,LA,70460-2624,Proprietary  ,9,39,48,188,,611,799
03356300,MEDICAL TRAINING COLLEGE                ,LA,70816-5820,Proprietary  ,21,65,86,183,,598,781
03480300,MEDVANCE INSTITUTE                      ,LA,70809-1908,Proprietary  ,7,63,70,181,,621,802
03498400,OMEGA INSTITUTE OF COSMETOLOGY          ,LA,70360-0000,Proprietary  ,3,5,8,76,,83,159
03727500,MOORE CAREER COLLEGE                    ,LA,70808-4191,Proprietary  ,3,15,18,18,,115,133
03730300,BATON ROUGE COMMUNITY COLLEGE           ,LA,78806-4129,Public       ,218,429,647,6456,,7771,14227
03789300,UNITECH TRAINING ACADEMY                ,LA,70503-5132,Proprietary  ,18,129,147,245,,774,1019
03789301,UNITECH TRAINING ACADEMY - WEST MONROE  ,LA,71291-2913,Proprietary  ,14,62,76,116,,562,678
03789302,UNITECH TRAINING ACADEMY - HOUMA        ,LA,70363-5556,Proprietary  ,12,38,50,115,,281,396
03789303,UNITECH TRAINING ACADEMY -  ALEXANDRIA  ,LA,71303-3625,Proprietary  ,4,44,48,99,,399,498
03789304,UNITECH TRAINING ACADEMY - LAKE CHARLES ,LA,70601-7887,Proprietary  ,10,52,62,145,,391,536
03789400,RIVER PARISHES COMMUNITY COLLEGE        ,LA,70778-0310,Public       ,29,52,81,1064,,1374,2438
03795300,CASSIA BEAUTY COLLEGE                   ,LA,70126-0000,Proprietary  ,2,6,8,19,,44,63
03810500,COURT REPORTING INSTITUTE OF LOUISI     ,LA,70816-0000,Proprietary  ,0,5,5,10,,108,118
03956300,SOUTH LOUISIANA COMMUNITY COLLEGE       ,LA,70506-0000,Public       ,67,142,209,3180,,3904,7084
03956309,SOUTH LOUISIANA COMMUNITY COLLEGE - ACAD,LA,70526-4109,Public       ,1,3,4,93,,226,319
03956310,SOUTH LOUISIANA COMMUNITY COLLEGE - EVAN,LA,70582-0000,Public       ,1,4,5,40,,173,213
03956311,SOUTH LOUISIANA COMMUNITY COLLEGE - GULF,LA,70510-0000,Public       ,6,7,13,130,,278,408
03956312,SOUTH LOUISIANA COMMUNITY COLLEGE - T. H,LA,70570-0000,Public       ,6,18,24,290,,523,813
03956313,SOUTH LOUISIANA COMMUNITY COLLEGE - TECH,LA,70562-0000,Public       ,4,18,22,226,,389,615
03956315,SOUTH LOUISIANA COMMUNITY COLLEGE - C B ,LA,70586-0000,Public       ,2,8,10,93,,167,260
03956317,SOUTH LOUISIANA COMMUNITY COLLEGE - ARDO,LA,70506-0000,Public       ,5,27,32,478,,1004,1482
04040300,COMPASS CAREER COLLEGE                  ,LA,70403-0653,Proprietary  ,10,34,44,176,,384,560
04112300,LOUISIANA CULINARY INSTITUTE            ,LA,70816-4109,Proprietary  ,15,29,44,307,,401,708
04120700,ALDEN'S SCHOOL OF COSMETOLOGY           ,LA,70714-1502,Proprietary  ,0,0,0,1,,0,1
04130100,LOUISIANA DELTA COMMUNITY COLLEGE       ,LA,71203-3618,Public       ,69,195,264,2108,,3581,5689
04149500,A & W HEALTHCARE EDUCATORS              ,LA,70122-3146,Proprietary  ,3,21,24,73,,444,517
04151600,MY-LE'S BEAUTY COLLEGE                  ,LA,70056-3150,Proprietary  ,4,21,25,18,,164,182
04217000,HEALTHCARE TRAINING INSTITUTE           ,LA,70062-7630,Proprietary  ,3,14,17,31,,182,213
04225900,SETTING THE STANDARD BARBERING AND NATUR,LA,71109-4124,Proprietary  ,1,3,4,5,,21,26
04226000,BOS-MAN'S BARBER COLLEGE                ,LA,71106-2653,Proprietary  ,1,15,16,9,,73,82
00143600,CAPITOL COLLEGE                         ,MD,20708-9759,Private      ,9,43,52,511,,731,1242
00146200,WASHINGTON BIBLE COLLEGE                ,MD,20706-3599,Private      ,0,0,0,14,,65,79
00205700,ALLEGANY COLLEGE OF MARYLAND            ,MD,21502-2596,Public       ,44,94,138,2734,,2329,5063
00205800,ANNE ARUNDEL COMMUNITY COLLEGE          ,MD,21012-1895,Public       ,211,687,898,5890,,10398,16288
00206100,BALTIMORE CITY COMMUNITY COLLEGE        ,MD,21215-7893,Public       ,145,608,753,4511,,11585,16096
00206200,BOWIE STATE UNIVERSITY                  ,MD,20715-9465,Public       ,127,249,376,8072,,6914,14986
00206300,COMMUNITY COLLEGE OF BALTIMORE COUNTY   ,MD,21228-5381,Public       ,426,1163,1589,11245,,19925,31170
00206400,COLLEGE OF SOUTHERN MARYLAND            ,MD,20646-0910,Public       ,127,355,482,4319,,6030,10349
00206500,NOTRE DAME OF MARYLAND UNIVERSITY       ,MD,21210-2476,Private      ,22,91,113,1234,,2501,3735
00206700,WASHINGTON ADVENTIST UNIVERSITY         ,MD,20912-7796,Private      ,14,52,66,1026,,1384,2410
00206800,COPPIN STATE UNIVERSITY                 ,MD,21216-3698,Public       ,79,204,283,4891,,6647,11538
00207100,FREDERICK COMMUNITY COLLEGE             ,MD,21702-9745,Public       ,70,229,299,2490,,3448,5938
00207200,FROSTBURG STATE UNIVERSITY              ,MD,21532-1099,Public       ,88,77,165,6978,,2052,9030
00207300,GOUCHER COLLEGE                         ,MD,21204-2794,Private      ,34,53,87,3324,,1143,4467
00207400,HAGERSTOWN COMMUNITY COLLEGE            ,MD,21742-6514,Public       ,52,235,287,2353,,3804,6157
00207500,HARFORD COMMUNITY COLLEGE               ,MD,21015-1696,Public       ,84,205,289,2684,,3638,6322
00207600,HOOD COLLEGE                            ,MD,21701-8575,Private      ,23,49,72,2405,,1075,3480
00207700,JOHNS HOPKINS UNIVERSITY                ,MD,21218-2693,Private      ,79,82,161,9924,,2877,12801
00207702,JOHNS HOPKINS UNIV SCH ARTS/SCI/ENG     ,MD,21218-0000,Private      ,25,128,153,4359,,2535,6894
00207703,JOHNS HOPKINS UNIV SCH OF BUS/ED        ,MD,21046-0000,Private      ,2,55,57,96,,1786,1882
00207705,JOHNS HOPKINS BLOOMBERG SCH OF PH       ,MD,21205-0000,Private      ,1,29,30,94,,1743,1837
00207706,JOHNS HOPKINS UNIV SCH OF MEDICINE      ,MD,21205-0000,Private      ,4,15,19,394,,1227,1621
00207707,JOHNS HOPKINS UNIV SCH OF NURSING       ,MD,21205-0000,Private      ,12,67,79,461,,1845,2306
00207708,JOHNS HOPKINS UNIV PEABODY CONSERV      ,MD,21202-2397,Private      ,4,5,9,605,,513,1118
00207764,JOHNS HOPKINS UNIVERSITY - CAREY BUSINES,MD,21202-4649,Private      ,1,27,28,1,,27,28
00207800,LOYOLA UNIVERSITY MARYLAND              ,MD,21210-2699,Private      ,84,77,161,10306,,3101,13407
00208000,MARYLAND INST COLLEGE OF ART            ,MD,21217-4191,Private      ,27,31,58,3241,,1162,4403
00208300,MORGAN STATE UNIVERSITY                 ,MD,21251-0002,Public       ,181,239,420,11218,,8284,19502
00208600,MOUNT SAINT MARY'S UNIVERSITY           ,MD,21727-7799,Private      ,42,26,68,3470,,582,4052
00208700,NER ISRAEL RABBINICAL COLLEGE           ,MD,21208-1198,Private      ,11,3,14,109,,54,163
00208900,PRINCE GEORGES COMMUNITY COLLEGE        ,MD,20774-2199,Public       ,280,741,1021,8168,,14558,22726
00209100,SALISBURY UNIVERSITY                    ,MD,21801-6862,Public       ,127,82,209,12729,,2821,15550
00209200,ST JOHN'S COLLEGE                       ,MD,21404-0000,Private      ,6,17,23,558,,253,811
00209500,ST. MARY'S COLLEGE OF MARYLAND          ,MD,20686-3001,Public       ,15,13,28,2945,,402,3347
00209600,ST MARY'S SEMINARY & UNIV               ,MD,21210-1994,Private      ,1,3,4,38,,88,126
00209900,TOWSON UNIVERSITY                       ,MD,21252-0002,Public       ,293,320,613,27352,,10351,37703
00210200,UNIVERSITY OF BALTIMORE                 ,MD,21201-5779,Public       ,45,255,300,2617,,8407,11024
00210300,"UNIVERSITY OF MARYLAND, COLLEGE PARK    ",MD,20742-5145,Public       ,419,608,1027,35520,,16397,51917
00210400,"UNIVERSITY OF MARYLAND, BALTIMORE       ",MD,21201-1691,Public       ,113,324,437,5387,,12807,18194
00210500,UMBC                                    ,MD,21250-0002,Public       ,157,244,401,12271,,7349,19620
00210600,UNIVERSITY MARYLAND EASTERN SHORE       ,MD,21853-4053,Public       ,92,81,173,6571,,2724,9295
00210700,STEVENSON UNIVERSITY                    ,MD,21153-0641,Private      ,57,101,158,6867,,2533,9400
00210800,WASHINGTON COLLEGE                      ,MD,21620-1197,Private      ,18,4,22,2906,,193,3099
00210900,MCDANIEL COLLEGE                        ,MD,21157-4390,Private      ,26,35,61,3341,,853,4194
00458612,KAPLAN COLLEGE                          ,MD,21742-2797,Proprietary  ,15,239,254,267,,2227,2494
00458614,KAPLAN COLLEGE - FREDERICK              ,MD,21704-8307,Proprietary  ,0,0,0,38,,255,293
00465000,CHESAPEAKE COLLEGE                      ,MD,21679-0008,Public       ,37,111,148,1386,,1866,3252
00691100,MONTGOMERY COLLEGE                      ,MD,20850-1195,Public       ,347,705,1052,12841,,14030,26871
00734100,INTERNATIONAL BEAUTY SCHOOL             ,MD,21502-2370,Proprietary  ,8,67,75,84,,507,591
00744700,DEL-MAR-VA BEAUTY ACADEMY               ,MD,21804-0000,Proprietary  ,2,9,11,83,,201,284
00749100,TESST COLLEGE OF TECHNOLOGY             ,MD,21227-1063,Proprietary  ,45,146,191,532,,1718,2250
00793600,LINCOLN TECHNICAL INSTITUTE             ,MD,21046-1544,Proprietary  ,84,121,205,702,,1073,1775
00817500,HOWARD COMMUNITY COLLEGE                ,MD,21044-3197,Public       ,148,325,473,4522,,5790,10312
00826300,AWARD BEAUTY SCHOOL                     ,MD,21740-5624,Proprietary  ,9,89,98,70,,341,411
00830800,CECIL COLLEGE                           ,MD,21901-1999,Public       ,38,113,151,1319,,1790,3109
00907906,EVEREST COLLEGE- EVEREST INSTITUTE      ,MD,20910-3737,Proprietary  ,38,128,166,339,,1124,1463
01001400,GARRETT COMMUNITY COLLEGE               ,MD,21541-1265,Public       ,12,18,30,1098,,429,1527
01031900,MEDIX SCHOOL                            ,MD,21204-2538,Proprietary  ,74,319,393,757,,3171,3928
01041000,TESST COLLEGE OF TECHNOLOGY             ,MD,21286-2201,Proprietary  ,16,72,88,201,,747,948
01164400,UNIV OF MARYLAND UNIVERSITY COLLEGE     ,MD,20783-8078,Public       ,156,3776,3932,3334,,44958,48292
01164402,U OF MD UNIVERSITY COLLEGE - EUROPE     ,MD,20832-0000,Public       ,7,81,88,432,,1107,1539
01164404,U OF MD UNIVERSITY COLLEGE - ASIA       ,MD,31207-0000,Public       ,9,115,124,122,,1304,1426
02073900,WOR-WIC COMMUNITY COLLEGE               ,MD,21804-0000,Public       ,55,153,208,1774,,3149,4923
02083600,TESST COLLEGE OF TECHNOLOGY             ,MD,20705-2698,Proprietary  ,26,97,123,266,,872,1138
02116005,SANFORD-BROWN INSTITUTE - LANDOVER      ,MD,20785-2287,Proprietary  ,0,0,0,47,,247,294
02127900,SOJOURNER DOUGLASS COLLEGE              ,MD,21205-0000,Private      ,17,177,194,315,,3595,3910
02155100,MARYLAND COLLEGE OF ART AND DESIGN      ,MD,20902-0000,Private      ,6,13,19,189,,234,423
02269700,"COLORLAB ACADEMY OF HAIR, THE           ",MD,21014-3639,Proprietary  ,6,6,12,60,,119,179
02331000,MARYLAND BEAUTY ACADEMY OF ESSEX        ,MD,21221-0000,Proprietary  ,8,33,41,100,,307,407
02333000,HAIR ACADEMY                            ,MD,20784-0000,Proprietary  ,21,119,140,194,,611,805
02343800,MONTGOMERY BEAUTY SCHOOL                ,MD,20901-0000,Proprietary  ,7,33,40,120,,298,418
02494700,BALTIMORE STUDIO OF HAIR DESIGN         ,MD,21201-0000,Proprietary  ,9,31,40,147,,391,538
02495000,ROBERT PAUL ACAD COSMTGY ARTS & SCI     ,MD,21093-0000,Proprietary  ,4,8,12,80,,85,165
02495100,MARYLAND BEAUTY ACADEMY                 ,MD,21136-0000,Proprietary  ,1,10,11,34,,91,125
02545400,NORTH AMERICAN TRADE SCHOOLS            ,MD,21244-0069,Proprietary  ,30,202,232,299,,1523,1822
02573800,"L' ACADEMIE DE CUISINE, INC.            ",MD,20877-0000,Proprietary  ,6,12,18,90,,256,346
02578400,MARYLAND UNIVERSITY OF INTEGRATIVE HEALT,MD,20723-6010,Private      ,1,69,70,6,,650,656
03027200,BLADES SCHOOL OF HAIR DESIGN            ,MD,20619-0226,Proprietary  ,8,16,24,57,,153,210
03064900,AARON'S ACADEMY OF BEAUTY               ,MD,20602-2715,Proprietary  ,0,10,10,53,,123,176
03097200,AESTHETICS INSTITUTE OF COSMETOLOGY     ,MD,20877-1305,Proprietary  ,2,18,20,32,,124,156
03100700,CARROLL COMMUNITY COLLEGE               ,MD,21157-6913,Public       ,62,108,170,1475,,1656,3131
03148300,AMERICAN BEAUTY ACADEMY                 ,MD,20902-1911,Proprietary  ,54,142,196,348,,929,1277
03296300,BALTIMORE SCHOOL OF MASSAGE             ,MD,21090-2261,Proprietary  ,32,115,147,201,,712,913
03327300,NEW CREATIONS ACADEMY OF HAIR DSN       ,MD,20746-0000,Proprietary  ,7,23,30,80,,223,303
03455500,NATIONAL LABOR COLLEGE                  ,MD,20903-1790,Private      ,2,13,15,18,,510,528
03493300,ALL-STATE CAREER SCHOOL                 ,MD,21224-6658,Proprietary  ,68,427,495,658,,2932,3590
03667300,FAITH THEOLOGICAL SEMINARY              ,MD,21212-2624,Private      ,0,11,11,11,,159,170
03771300,AMERICAN CAREER INSTITUTE               ,MD,20902-4637,Proprietary  ,0,0,0,2,,15,17
03822400,MAPLE SPRINGS BAPTIST BIBLE COLLEGE & SE,MD,20743-5711,Private      ,0,2,2,1,,85,86
03937300,YESHIVA COLLEGE OF THE NATION'S CAPITAL ,MD,20902-1700,Private      ,2,0,2,12,,26,38
03965500,HAIR EXPRESSIONS ACADEMY                ,MD,20852-1729,Proprietary  ,16,21,37,153,,259,412
04121600,FILA ACADEMY (THE)                      ,MD,21061-1634,Proprietary  ,1,6,7,7,,49,56
04139700,FREDERICK SCHOOL OF COSMETOLOGY         ,MD,21701-0000,Proprietary  ,5,4,9,56,,96,152
04141600,OMEGA STUDIOS' SCHOOL OF APPLIED RECORDI,MD,20852-1731,Proprietary  ,11,13,24,90,,177,267
04151800,TEMPLE (THE): A PAUL MITCHELL PARTNER SC,MD,21701-5409,Proprietary  ,12,19,31,184,,213,397
04167602,FINGER LAKES SCHOOL OF MASSAGE (THE)    ,MD,21701-3030,Proprietary  ,4,16,20,16,,73,89
04168900,HOLISTIC MASSAGE TRAINING INSTITUTE     ,MD,21218-2407,Proprietary  ,0,10,10,36,,189,225
04171501,COSMOPOLITAN BEAUTY & TECH SCHOOL -     ,MD,20143-3370,Proprietary  ,2,12,14,2,,13,15
04188400,BAIS HAMEDRASH AND MESIVTA OF BALTIMORE ,MD,21209-1613,Private      ,5,2,7,49,,28,77
04204000,ASPEN BEAUTY ACADEMY - LAUREL           ,MD,20724-2013,Proprietary  ,7,19,26,54,,178,232
04209600,INSTITUTE OF HEALTH SCIENCES            ,MD,21031-1408,Proprietary  ,2,17,19,37,,192,229
04211700,HARMON'S BEAUTY SCHOOL                  ,MD,20785-2135,Proprietary  ,1,3,4,33,,69,102
00211400,AMERICAN INTERNATIONAL COLLEGE          ,MA,01109-3189,Private      ,20,126,146,2238,,3424,5662
00211500,AMHERST COLLEGE                         ,MA,01002-5000,Private      ,38,15,53,4624,,384,5008
00211600,ANDOVER NEWTON THEOLOGICAL SCHOOL       ,MA,02459-0000,Private      ,0,3,3,4,,196,200
00211700,ANNA MARIA COLLEGE                      ,MA,01612-1198,Private      ,15,54,69,2023,,796,2819
00211800,ASSUMPTION COLLEGE                      ,MA,01615-1294,Private      ,43,38,81,5054,,1018,6072
00212000,MERRIMACK COLLEGE                       ,MA,01845-5800,Private      ,48,21,69,6037,,664,6701
00212100,BABSON COLLEGE                          ,MA,02457-0310,Private      ,21,46,67,2970,,801,3771
00212200,BAY PATH COLLEGE                        ,MA,01106-2212,Private      ,10,134,144,966,,2709,3675
00212300,BECKER COLLEGE-WORCESTER                ,MA,01615-0071,Private      ,36,55,91,3255,,1310,4565
00212400,BENTLEY UNIVERSITY                      ,MA,02452-4705,Private      ,39,26,65,6206,,892,7098
00212600,BERKLEE COLLEGE OF MUSIC                ,MA,02215-3693,Private      ,73,90,163,5245,,1689,6934
00212800,BOSTON COLLEGE                          ,MA,02467-3800,Private      ,98,90,188,17998,,6130,24128
00212900,BOSTON CONSERVATORY OF MUSIC            ,MA,02215-9830,Private      ,8,4,12,1209,,374,1583
00213000,BOSTON UNIVERSITY                       ,MA,02215-1789,Private      ,334,333,667,40331,,18785,59116
00213300,BRANDEIS UNIVERSITY                     ,MA,02453-2700,Private      ,38,26,64,6143,,1559,7702
00213900,CLARK UNIVERSITY                        ,MA,01610-1473,Private      ,31,29,60,4567,,948,5515
00214000,ELMS COLLEGE                            ,MA,01013-2839,Private      ,10,28,38,1496,,1180,2676
00214100,COLLEGE OF THE HOLY CROSS               ,MA,01610-2395,Private      ,32,6,38,5986,,218,6204
00214300,CURRY COLLEGE                           ,MA,02186-2395,Private      ,49,66,115,5327,,1681,7008
00214400,DEAN COLLEGE                            ,MA,02038-1994,Private      ,24,21,45,2020,,362,2382
00214500,EASTERN NAZARENE COLLEGE                ,MA,02170-2999,Private      ,6,25,31,911,,908,1819
00214507,EASTERN NAZARENE CLG - LEAD PROGRAM     ,MA,02170-0000,Private      ,0,9,9,36,,441,477
00214600,EMERSON COLLEGE                         ,MA,02116-4624,Private      ,64,21,85,7652,,1656,9308
00214700,EMMANUEL COLLEGE                        ,MA,02115-5798,Private      ,36,14,50,5583,,606,6189
00214800,ENDICOTT COLLEGE                        ,MA,01915-2098,Private      ,44,54,98,4910,,1012,5922
00214900,EPISCOPAL DIVINITY SCHOOL               ,MA,02138-0000,Private      ,0,5,5,0,,79,79
00215000,FISHER COLLEGE                          ,MA,02116-1500,Private      ,45,153,198,1769,,1832,3601
00215100,BENJAMIN FRANKLIN INSTITUTE OF TECH     ,MA,02116-6296,Public       ,14,28,42,612,,467,1079
00215300,GORDON COLLEGE                          ,MA,01984-1899,Private      ,20,13,33,2502,,240,2742
00215400,HELLENIC COLLEGE                        ,MA,02445-7496,Private      ,2,3,5,90,,125,215
00215500,HARVARD UNIVERSITY                      ,MA,02138-3800,Private      ,44,42,86,4567,,1016,5583
00215501,AMRCN REPERTORY THTR INST ADV THTR      ,MA,02138-0000,Private      ,0,2,2,3,,136,139
00215502,HARVARD BUSINESS SCHOOL                 ,MA,02163-0000,Private      ,5,24,29,239,,1753,1992
00215503,HARVARD EXTENSION SCHOOL                ,MA,02138-0000,Private      ,6,107,113,170,,1670,1840
00215504,HARVARD SCH OF DENTAL MEDICINE          ,MA,02115-0000,Private      ,1,2,3,28,,218,246
00215505,HARVARD UNIV GRAD SCH DESIGN            ,MA,02138-0000,Private      ,3,11,14,17,,960,977
00215506,HARVARD DIVINITY SCHOOL                 ,MA,02138-0000,Private      ,0,4,4,9,,507,516
00215507,HARVARD UNIV GRAD SCH ED                ,MA,02138-0000,Private      ,1,21,22,9,,1591,1600
00215508,HARVARD UNIV GRAD S OF ARTS & SCIEN     ,MA,02138-0000,Private      ,1,18,19,80,,908,988
00215509,HARVARD KENNEDY SCHOOL                  ,MA,02138-0000,Private      ,1,9,10,19,,1347,1366
00215510,HARVARD LAW SCHOOL                      ,MA,02138-0000,Private      ,3,26,29,141,,3405,3546
00215511,HARVARD UNIV MEDICAL SCHOOL             ,MA,02115-0000,Private      ,6,5,11,233,,1161,1394
00215512,HARVARD UNIV SCH PUBLIC HEALTH          ,MA,02115-0000,Private      ,2,12,14,43,,1069,1112
00215513,HARVARD UNIVERSITY-HARVARD COLLEGE      ,MA,02138-0000,Private      ,137,50,187,20293,,1489,21782
00215700,HEBREW COLLEGE                          ,MA,02459-2237,Private      ,0,4,4,0,,112,112
00215800,LASELL COLLEGE                          ,MA,02466-2716,Private      ,21,23,44,3429,,642,4071
00216000,LESLEY UNIVERSITY                       ,MA,02138-2790,Private      ,31,157,188,3000,,3894,6894
00216100,UMASS LOWELL                            ,MA,01854-3089,Public       ,181,290,471,14798,,7469,22267
00216400,NEW ENGLAND COLLEGE OF OPTOMETRY        ,MA,02115-1129,Private      ,1,2,3,13,,436,449
00216500,MASS. COLLEGE OF PHARMACY  & HEALTH SCIE,MA,02115-5804,Private      ,53,56,109,6244,,4435,10679
00216700,BERKSHIRE COMMUNITY COLLEGE             ,MA,01201-5786,Public       ,23,56,79,1059,,1699,2758
00216800,CAPE COD COMMUNITY COLLEGE              ,MA,02668-1599,Public       ,35,135,170,1832,,2737,4569
00216900,GREENFIELD COMMUNITY COLLEGE            ,MA,01301-9739,Public       ,29,75,104,1053,,1772,2825
00217000,HOLYOKE COMMUNITY COLLEGE               ,MA,01040-1099,Public       ,88,195,283,4238,,5443,9681
00217100,MASSACHUSETTS BAY COMMUNITY COLLEGE     ,MA,02181-0000,Public       ,65,129,194,2617,,3190,5807
00217200,MOUNT WACHUSETT COMMUNITY COLLEGE       ,MA,01440-1000,Public       ,58,185,243,2306,,3839,6145
00217300,NORTH SHORE COMMUNITY COLLEGE           ,MA,01923-4093,Public       ,80,208,288,3837,,5619,9456
00217400,NORTHERN ESSEX COMMUNITY COLLEGE        ,MA,01830-2399,Public       ,99,240,339,3799,,5224,9023
00217500,QUINSIGAMOND COMMUNITY COLLEGE          ,MA,01606-2092,Public       ,115,337,452,4750,,6843,11593
00217600,BRISTOL COMMUNITY COLLEGE               ,MA,02720-7399,Public       ,106,295,401,5026,,6654,11680
00217700,MASSASOIT COMMUNITY COLLEGE             ,MA,02302-3996,Public       ,86,204,290,4193,,5411,9604
00217800,MASSACHUSETTS INST OF TECHNOLOGY        ,MA,02139-4307,Private      ,79,123,202,13113,,3439,16552
00218000,MASSACHUSETTS COLLEGE OF ART AND DESIGN ,MA,02115-5803,Public       ,21,18,39,2668,,1015,3683
00218100,MASSACHUSETTS MARITIME ACADEMY          ,MA,02532-3400,Public       ,16,8,24,1661,,180,1841
00218300,BRIDGEWATER STATE COLLEGE               ,MA,02325-0001,Public       ,113,104,217,12588,,4369,16957
00218400,FITCHBURG STATE UNIVERSITY              ,MA,01420-2697,Public       ,45,54,99,6487,,1958,8445
00218500,FRAMINGHAM STATE COLLEGE                ,MA,01702-2471,Public       ,77,48,125,7885,,1926,9811
00218700,MASSACHUSETTS CLG OF LIBERAL ARTS       ,MA,01247-4100,Public       ,25,18,43,2546,,666,3212
00218800,SALEM STATE UNIVERSITY                  ,MA,01970-5353,Public       ,165,138,303,9856,,4772,14628
00218900,WESTFIELD STATE COLLEGE                 ,MA,01086-1630,Public       ,73,53,126,8574,,2261,10835
00219000,WORCESTER STATE COLLEGE                 ,MA,01602-2597,Public       ,59,97,156,7002,,2948,9950
00219200,MOUNT HOLYOKE COLLEGE                   ,MA,01075-1492,Private      ,16,11,27,2848,,403,3251
00219300,MOUNT IDA COLLEGE                       ,MA,02459-3323,Private      ,15,6,21,1962,,461,2423
00219400,NEW ENGLAND CONSERVATORY OF MUSIC       ,MA,02115-5018,Private      ,3,2,5,752,,633,1385
00219700,NICHOLS COLLEGE                         ,MA,01571-6346,Private      ,13,18,31,2252,,438,2690
00219900,NORTHEASTERN UNIVERSITY                 ,MA,02115-5000,Private      ,301,519,820,36376,,14302,50678
00220100,PINE MANOR COLLEGE                      ,MA,02167-0000,Private      ,2,3,5,281,,132,413
00220200,BLESSED JOHN XXIII NATIONAL SEMINARY    ,MA,02493-0000,Private      ,0,0,0,0,,3,3
00220500,QUINCY COLLEGE                          ,MA,02169-4324,Public       ,43,162,205,2011,,4385,6396
00220600,REGIS COLLEGE                           ,MA,02193-0000,Private      ,21,23,44,2239,,1084,3323
00220800,SIMMONS COLLEGE                         ,MA,02115-5898,Private      ,23,127,150,3485,,4006,7491
00220900,SMITH COLLEGE                           ,MA,01063-2936,Private      ,22,8,30,3623,,566,4189
00220901,"SMITH COLLEGE, SCH FOR SOCIAL WORK      ",MA,01063-0000,Private      ,0,12,12,15,,559,574
00221000,UNIV OF MASSACHUSETTS-DARTMOUTH         ,MA,02747-2300,Public       ,117,109,226,13335,,4239,17574
00221100,SPRINGFIELD COLLEGE                     ,MA,01109-3797,Private      ,32,176,208,4189,,4837,9026
00221400,ST JOHN'S SEMINARY                      ,MA,02135-8839,Private      ,0,5,5,11,,38,49
00221700,STONEHILL COLLEGE                       ,MA,02357-6110,Private      ,32,7,39,6306,,203,6509
00221800,SUFFOLK UNIVERSITY                      ,MA,02108-2770,Private      ,69,52,121,9359,,4893,14252
00221900,TUFTS UNIVERSITY                        ,MA,02155-5808,Private      ,65,47,112,11499,,2607,14106
00221901,TUFTS UNIV SCH OF DENTAL MEDICINE       ,MA,02111-0000,Private      ,1,4,5,35,,973,1008
00221902,TUFTS UNIVERSITY - CUMMINGS SCHOOL OF VE,MA,01536-0000,Private      ,1,4,5,40,,496,536
00221904,TUFTS UNIV SCHOOL OF MEDICINE           ,MA,02111-0000,Private      ,5,13,18,104,,2126,2230
00222100,UNIV OF MASSACHUSETTS-AMHERST           ,MA,01003-0000,Public       ,325,208,533,41338,,8673,50011
00222200,UNIV OF MASSACHUSETTS-BOSTON            ,MA,02125-3393,Public       ,187,395,582,14437,,12890,27327
00222400,WELLESLEY COLLEGE                       ,MA,02481-8203,Private      ,16,4,20,3717,,251,3968
00222500,WENTWORTH INSTITUTE OF TECHNOLOGY       ,MA,02115-5998,Private      ,67,31,98,6185,,1058,7243
00222600,WESTERN NEW ENGLAND UNIVERSITY          ,MA,01119-2654,Private      ,58,27,85,6521,,1848,8369
00222700,WHEATON COLLEGE                         ,MA,02766-2322,Private      ,9,3,12,2728,,119,2847
00222800,WHEELOCK COLLEGE                        ,MA,02215-4176,Private      ,10,23,33,1765,,944,2709
00222900,WILLIAMS COLLEGE                        ,MA,01267-2600,Private      ,15,1,16,4299,,154,4453
00223300,WORCESTER POLYTECHNIC INSTITUTE         ,MA,01609-2280,Private      ,51,37,88,7923,,785,8708
00267104,BARD COLLEGE - LONGY SCHOOL OF MUSIC    ,MA,02138-3599,Private      ,0,1,1,42,,178,220
00396500,BAY STATE COLLEGE                       ,MA,02116-2901,Proprietary  ,22,51,73,1597,,1568,3165
00396600,BOSTON ARCHITECTURAL COLLEGE            ,MA,02115-2795,Private      ,4,16,20,345,,902,1247
00466100,HAMPSHIRE COLLEGE                       ,MA,01002-3359,Private      ,20,7,27,2707,,265,2972
00466600,SALTER COLLEGE                          ,MA,01583-1700,Proprietary  ,79,446,525,563,,2935,3498
00466700,SCHOOL OF MUSEUM OF FINE ARTS           ,MA,02115-5534,Private      ,5,5,10,691,,357,1048
00466900,UPPER CAPE COD REGIONAL VOC TECH        ,MA,02532-3310,Public       ,0,3,3,33,,164,197
00527900,GREATER LOWELL REGNL VOC TECH SCH       ,MA,01879-0000,Public       ,0,0,0,36,,140,176
00551900,DIMAN REGIONAL VOC TECH INST            ,MA,02723-3519,Public       ,1,4,5,59,,209,268
00552300,BLUE HILLS REGIONAL VOC TECH            ,MA,02021-1398,Public       ,0,5,5,45,,174,219
00555700,MCCANN TECHNICAL SCHOOL                 ,MA,01247-0000,Public       ,1,0,1,32,,98,130
00613600,NATIONAL AVIATION ACADEMY - NEW ENGLAND ,MA,01730-2620,Proprietary  ,11,31,42,160,,269,429
00632200,BROCKTON HOSPITAL SCH OF NURSING        ,MA,02302-0000,Private      ,2,11,13,166,,667,833
00632400,LABOURE COLLEGE                         ,MA,02124-5698,Private      ,4,44,48,197,,950,1147
00633100,LAWRENCE MEM HOSPITAL SCH OF NRSNG      ,MA,02155-1643,Private      ,1,6,7,64,,411,475
00635200,BAYSTATE MEDICAL CENTER                 ,MA,01199-0001,Private      ,0,3,3,29,,129,158
00687300,MARIAN COURT COLLEGE                    ,MA,01907-2896,Private      ,1,8,9,114,,137,251
00748100,GIBBS COLLEGE                           ,MA,02116-2904,Proprietary  ,1,4,5,34,,130,164
00748400,NEWBURY COLLEGE                         ,MA,02445-5796,Private      ,20,12,32,2535,,371,2906
00748600,THE NEW ENGLAND INSTITUTE OF ART        ,MA,02445-7295,Proprietary  ,29,46,75,1246,,593,1839
00748800,KAPLAN CAREER INSTITUTE                 ,MA,02129-1644,Proprietary  ,0,1,1,28,,144,172
00748801,KAPLAN CAREER INSTITUTE -               ,MA,02215-2606,Proprietary  ,0,0,0,15,,82,97
00807800,SPRINGFIELD TECHNICAL COMMUNITY CLG     ,MA,01105-0000,Public       ,101,230,331,4003,,6567,10570
00809002,EVEREST COLLEGE - EVEREST INSTITUTE     ,MA,02150-2333,Proprietary  ,18,69,87,180,,525,705
00817807,EMPIRE BEAUTY SCHOOL - BOSTON           ,MA,02111-1204,Proprietary  ,0,0,0,158,,309,467
00891600,NEW ENGLAND SCHOOL OF LAW               ,MA,02116-0000,Private      ,0,11,11,31,,1796,1827
00964500,BARD COLLEGE AT SIMON'S ROCK            ,MA,01230-9702,Private      ,2,2,4,395,,23,418
00974700,GORDON-CONWELL THEOLOGICAL SEMINARY     ,MA,01982-0000,Private      ,0,27,27,7,,584,591
00975600,UNIVERSITY OF MASS MEDICAL CENTER       ,MA,01655-0000,Public       ,5,17,22,67,,992,1059
00987700,HENRI'S SCHOOL OF HAIR DESIGN           ,MA,01420-5675,Proprietary  ,5,4,9,30,,52,82
00989900,LOWELL ACADEMY HAIRSTYLING INST         ,MA,01852-1909,Proprietary  ,2,10,12,51,,116,167
00993600,MIDDLESEX COMMUNITY COLLEGE             ,MA,01730-1197,Public       ,41,82,123,2064,,2176,4240
00993602,"MIDDLESEX COMMUNITY COLLEGE, LOWELL     ",MA,01852-0000,Public       ,99,207,306,3419,,3808,7227
01054211,EMPIRE BEAUTY SCHOOL - MALDEN           ,MA,02148-5103,Proprietary  ,0,0,0,72,,150,222
01121000,BUNKER HILL COMMUNITY COLLEGE           ,MA,02129-2991,Public       ,125,326,451,7560,,12614,20174
01151000,EVEREST INSTITUTE                       ,MA,02135-7638,Proprietary  ,7,26,33,138,,400,538
01193000,ROXBURY COMMUNITY COLLEGE               ,MA,02120-3400,Public       ,43,158,201,1194,,3634,4828
01204200,MANSFIELD BEAUTY SCHOOLS                ,MA,02169-5061,Proprietary  ,2,6,8,20,,96,116
01206800,MANSFIELD BEAUTY SCHOOL                 ,MA,01103-1410,Proprietary  ,1,7,8,16,,71,87
01218700,BLACKSTONE VALLEY VOCATIONAL REGIONAL SC,MA,01568-1499,Public       ,0,1,1,10,,66,76
01238600,SOUTHEASTERN TECHNICAL INSTITUTE        ,MA,02375-1780,Public       ,0,5,5,48,,211,259
01246108,LINCOLN TECHNICAL INSTITUTE - BROCKTON  ,MA,02401-1818,Proprietary  ,24,46,70,172,,480,652
01246114,LINCOLN TECHNICAL INSTITUTE - LOWELL    ,MA,01852-5119,Proprietary  ,20,54,74,228,,487,715
01246115,LINCOLN TECHNICAL INSTITUTE - SOMERVILLE,MA,02145-1102,Proprietary  ,22,52,74,146,,394,540
01288100,MONTACHUSETT REG VOC TECH SCH           ,MA,01420-4649,Public       ,1,5,6,26,,118,144
01294800,ROB ROY ACADEMY                         ,MA,02721-5330,Proprietary  ,5,18,23,41,,105,146
02063000,MONTSERRAT COLLEGE OF ART               ,MA,01915-0000,Private      ,9,4,13,681,,87,768
02079400,EMPIRE BEAUTY SCHOOL                    ,MA,01702-5232,Proprietary  ,75,230,305,471,,1096,1567
02079412,EMPIRE BEAUTY SCHOOL - LOWELL           ,MA,01852-2214,Proprietary  ,0,0,0,106,,192,298
02092100,MASSACHUSETTS SCHOOL OF BARBERING       ,MA,02169-5058,Proprietary  ,2,19,21,26,,172,198
02122000,NEW ENGLAND HAIR ACADEMY                ,MA,02148-0000,Proprietary  ,5,25,30,76,,202,278
02137000,ROB ROY ACADEMY                         ,MA,02780-0000,Proprietary  ,2,6,8,15,,45,60
02137200,MASS GEN HOSP DIETETIC INTERNSHIP       ,MA,02114-0000,Private      ,0,0,0,10,,59,69
02163500,NEW ENGLAND SCHOOL OF PHOTOGRAPHY       ,MA,02215-0000,Proprietary  ,1,5,6,102,,145,247
02163600,MASS SCH OF PROFESSIONAL PSYCHOLOGY     ,MA,02132-0000,Private      ,0,11,11,41,,905,946
02169900,ASSABET VALLEY REGIONAL VOC SCHOOL      ,MA,01752-0000,Public       ,0,5,5,20,,123,143
02181600,ROB ROY ACADEMY                         ,MA,01609-0000,Proprietary  ,20,29,49,82,,177,259
02182900,CAMBRIDGE COLLEGE                       ,MA,02138-5304,Private      ,62,269,331,459,,3535,3994
02197900,NORTH BENNET STREET SCHOOL              ,MA,02113-0000,Private      ,0,5,5,59,,175,234
02215100,HALLMARK INSTITUTE OF PHOTOGRAPHY       ,MA,01376-0000,Proprietary  ,3,1,4,131,,145,276
02219501,MILDRED ELLEY - PITTSFIELD              ,MA,01201-5300,Proprietary  ,0,2,2,21,,81,102
02220400,CATHERINE HINDS INST OF ESTHETICS       ,MA,01801-0000,Proprietary  ,5,30,35,71,,241,312
02231600,MGH INSTITUTE OF HEALTH PROFESSION      ,MA,02129-0000,Private      ,6,42,48,104,,1587,1691
02274300,CONWAY SCHOOL OF LANDSCAPE DESIGN       ,MA,01341-0179,Private      ,0,0,0,0,,17,17
02325700,LABARON HAIRDRESSING ACADEMY            ,MA,02740-0000,Proprietary  ,1,6,7,23,,65,88
02325800,LABARON HAIRDRESSING ACAD-BROCKTON      ,MA,02301-0000,Proprietary  ,0,6,6,23,,53,76
02337400,BANCROFT SCHOOL OF MASSAGE THERAPY      ,MA,01604-4614,Proprietary  ,2,9,11,29,,98,127
02338200,BAY STATE SCHOOL OF TECHNOLOGY          ,MA,02021-0000,Proprietary  ,3,31,34,73,,263,336
02339400,ROB ROY ACADEMY                         ,MA,02746-0000,Proprietary  ,0,1,1,11,,38,49
02491700,CORTIVA INSTITUTE -  BOSTON             ,MA,02472-2577,Proprietary  ,5,16,21,36,,137,173
02523900,ELIZABETH GRADY SCHOOL OF ESTHETICS     ,MA,02155-0000,Proprietary  ,6,22,28,63,,191,254
02579800,NEW ENGLAND SCHOOL OF ACUPUNCTURE       ,MA,02458-0000,Private      ,0,6,6,1,,146,147
02616704,LE CORDON BLEU COLLEGE OF CULINARY ARTS ,MA,02142-1221,Proprietary  ,6,17,23,194,,279,473
03066700,AILANO SCHOOL OF COSMETOLOGY            ,MA,02303-4740,Proprietary  ,1,12,13,28,,90,118
03104000,SHAWSHEEN ADULT TECHNICAL INSTITUTE     ,MA,01821-5499,Public       ,0,1,1,14,,78,92
03115200,MOTORING TECHNICAL TRAINING INST        ,MA,02771-5933,Proprietary  ,23,47,70,180,,380,560
03120800,KAY HARVEY HAIRDRESSING ACADEMY         ,MA,01089-2701,Proprietary  ,0,6,6,21,,64,85
03130500,URBAN COLLEGE OF BOSTON                 ,MA,02111-1093,Private      ,7,85,92,75,,926,1001
03194300,BOSTON GRAD SCH OF PSYCHOANALYSIS       ,MA,02446-4602,Private      ,0,2,2,3,,85,88
03205400,JOLIE HAIR & BEAUTY ACADEMY             ,MA,01056-2769,Proprietary  ,5,33,38,37,,149,186
03235300,MASSACHUSETTS SCHOOL OF LAW             ,MA,01810-1094,Private      ,0,8,8,16,,580,596
03240300,TONI & GUY HAIRDRESSING ACADEMY         ,MA,01605-2213,Proprietary  ,6,14,20,135,,147,282
03240301,TONI & GUY HAIRDRESSING ACADEMY - BRAINT,MA,02184-2807,Proprietary  ,3,12,15,16,,26,42
03248300,BOSTON BAPTIST COLLEGE                  ,MA,02136-4030,Private      ,4,1,5,100,,67,167
03316400,FUNERAL INSTITUTE OF THE NORTHEAST      ,MA,02062-4766,Proprietary  ,1,9,10,47,,123,170
03504300,NATL GRAD SCH OF QUALITY SYSTM MGMT     ,MA,02540-0000,Private      ,0,14,14,0,,90,90
03570500,NORTHPOINT BIBLE COLLEGE                ,MA,01835-0000,Private      ,7,9,16,227,,182,409
03763300,MEDICAL PROFESSIONAL INSTITUTE          ,MA,02148-8143,Proprietary  ,4,26,30,77,,420,497
03859300,E.I.N.E.                                ,MA,01876-4709,Proprietary  ,0,10,10,11,,52,63
03927303,BRIO ACADEMY OF COSMETOLOGY - NORTHHAMPT,MA,01060-3947,Proprietary  ,2,12,14,32,,95,127
03946300,FRANKLIN W. OLIN COLLEGE OF ENGINEERING ,MA,02492-1200,Private      ,4,1,5,613,,15,628
03965300,NEW ENGLAND COLLEGE OF FINANCE          ,MA,02110-1605,Proprietary  ,2,99,101,88,,993,1081
04039300,SULLIVAN AND COGLIANO TRAINING CENTER   ,MA,02301-4921,Proprietary  ,25,323,348,108,,1696,1804
04116900,DIGRIGOLI SCHOOL OF COSMETOLOGY         ,MA,01089-4623,Proprietary  ,4,6,10,67,,101,168
04122000,TRI COUNTY REGIONAL VOCATIONAL TECHNICAL,MA,02038-0000,Public       ,0,1,1,13,,97,110
04128000,MILLENNIUM TRAINING INSTITUTE           ,MA,01801-6386,Proprietary  ,0,36,36,6,,222,228
04128900,CENTRAL MASS SCHOOL OF MASSAGE AND THERA,MA,01562-1712,Proprietary  ,1,2,3,3,,26,29
04143200,HULT INTERNATIONAL BUSINESS SCHOOL      ,MA,02141-1805,Private      ,1,3,4,48,,265,313
04153200,SOUTHERN WORCESTER COUNTY REGIONAL VOC S,MA,01507-1331,Public       ,0,2,2,13,,48,61
04193100,ALEXANDER ACADEMY                       ,MA,01420-0000,Proprietary  ,6,4,10,28,,75,103
04229200,JUPITER BEAUTY ACADEMY                  ,MA,02122-2834,Proprietary  ,0,5,5,0,,5,5
00401200,HEBREW UNIVERSITY OF JERUSALEM (THE)    ,FC,00000-0000,Public       ,1,2,3,32,,104,136
00403000,UNIVERSITY OF CAMBRIDGE                 ,FC,00000-0000,Public       ,0,3,3,7,,93,100
00503400,AMERICAN UNIVERSITY OF CAIRO            ,FC,00000-0000,Private      ,0,2,2,68,,142,210
00667100,KATHOLIEKE UNIVERSITEIT LEUVEN          ,FC,00000-0000,Private      ,0,0,0,3,,28,31
00669000,UNIVERSITY OF COPENHAGEN                ,FC,00000-0000,Public       ,0,1,1,1,,11,12
00669100,UNIVERSITY OF CAMBRIDGE - PEMBROKE      ,FC,00000-0000,Public       ,0,0,0,1,,17,18
00669200,UNIVERSITY OF LEEDS                     ,FC,00000-0000,Public       ,0,1,1,22,,95,117
00669300,UNIV OF LONDON-LONDON SCHOOL ECON       ,FC,00000-0000,Public       ,2,5,7,27,,441,468
00669400,UNIVERSITY OF LONDON - SCHOOL OF ORIENTA,FC,00000-0000,Public       ,1,0,1,13,,168,181
00669500,UNIV OF LONDON-UNIVERSITY COLLEGE       ,FC,00000-0000,Public       ,0,3,3,87,,457,544
00669600,UNIV OF LONDON-SCH ADVANCED STUDY       ,FC,00000-0000,Public       ,0,1,1,0,,12,12
00669700,"QUEEN MARY, UNIVERSITY OF LONDON        ",FC,00000-0000,Public       ,2,1,3,47,,157,204
00669900,UNIVERSITY OF SUSSEX                    ,FC,00000-0000,Public       ,0,5,5,31,,103,134
00670000,"UNIVERSITY OF YORK, THE                 ",FC,00000-0000,Public       ,0,2,2,21,,167,188
00670400,UNIVERSITY COLLEGE CORK                 ,FC,00000-0000,Public       ,0,1,1,13,,80,93
00671300,UPPSALA UNIVERSITY                      ,FC,00000-0000,Public       ,0,0,0,4,,49,53
00671500,UNIVERSITY OF GENEVA                    ,FC,00000-0000,Public       ,0,5,5,8,,103,111
00683900,UNIVERSITY OF EDINBURGH                 ,FC,00000-0000,Public       ,2,8,10,247,,792,1039
00684200,UNIVERSITY OF DUBLIN TRINITY COLLEG     ,FC,00000-0000,Public       ,1,3,4,69,,231,300
00685000,UNIVERSITY OF CAMBRIDGE - DOWNING C     ,FC,00000-0000,Public       ,0,1,1,1,,6,7
00763200,UNIVERSITY OF BRISTOL                   ,FC,00000-0000,Public       ,0,1,1,20,,85,105
00768100,COLLEGE OF EUROPE                       ,FC,00000-0000,Private      ,0,0,0,1,,10,11
00770500,ROYAL COLLEGE OF SURGEONS IN IRELAN     ,FC,00000-0000,Private      ,0,0,0,7,,61,68
00788100,AMERICAN UNIVERSITY OF PARIS            ,FC,00000-0000,Private      ,5,7,12,485,,288,773
00837100,AMERICAN UNIVERSITY OF BEIRUT           ,FC,00000-0000,Private      ,3,5,8,112,,80,192
00837300,TEL-AVIV UNIVERSITY                     ,FC,00000-0000,Public       ,0,0,0,34,,112,146
00837600,VRIJE UNIVERSITEIT AMSTERDAM            ,FC,00000-0000,Public       ,1,0,1,2,,32,34
00837700,UNIVERSITEIT VAN AMSTERDAM(UNIVERSI     ,FC,00000-0000,Public       ,0,2,2,16,,120,136
00838000,UNIVERSITY OF WARWICK                   ,FC,00000-0000,Public       ,1,0,1,19,,72,91
00838300,UNIVERSITY OF GLASGOW                   ,FC,00000-0000,Public       ,0,2,2,64,,402,466
00839300,UNIVERSITY OF OSLO                      ,FC,00000-0000,Public       ,0,1,1,3,,33,36
00839400,UNIVERSITY OF OXFORD                    ,FC,00000-0000,Public       ,0,7,7,27,,407,434
00839800,UNIVERSITY OF SHEFFIELD (THE)           ,FC,00000-0000,Public       ,1,0,1,13,,91,104
00839900,UNIVERSITY OF SOUTHAMPTON               ,FC,00000-0000,Public       ,0,0,0,17,,73,90
00845200,ABERYSTWYTH UNIVERSITY                  ,FC,00000-0000,Public       ,0,1,1,29,,65,94
00845800,LOUGHBOROUGH UNIVERSITY                 ,FC,00000-0000,Public       ,0,1,1,6,,20,26
00846000,UNIVERSITY OF NEWCASTLE UPON TYNE       ,FC,00000-0000,Public       ,0,0,0,17,,112,129
00846100,UNIVERSITY OF SAINT ANDREWS             ,FC,00000-0000,Private      ,2,3,5,320,,193,513
00850500,UNIVERSITY OF MELBOURNE                 ,FC,00000-0000,Public       ,1,21,22,26,,223,249
00858600,SWANSEA UNIVERSITY                      ,FC,00000-0000,Public       ,0,1,1,13,,64,77
00858700,UNIVERSITY OF DURHAM                    ,FC,00000-0000,Public       ,0,4,4,32,,216,248
00866500,UNIVERSITY OF KENT AT CANTERBURY (THE)  ,FC,00000-0000,Public       ,1,3,4,43,,182,225
00867000,UNIVERSITY OF NEW SOUTH WALES           ,FC,00000-0000,Public       ,3,10,13,29,,97,126
00868700,UNIVERSITY OF ESSEX                     ,FC,00000-0000,Public       ,0,0,0,36,,157,193
00869300,CITY UNIVERSITY                         ,FC,00000-0000,Public       ,1,3,4,26,,199,225
00890800,THE UNIVERSITY OF BIRMINGHAM            ,FC,00000-0000,Public       ,2,4,6,17,,138,155
00891000,UNIVERSITY OF HULL                      ,FC,00000-0000,Public       ,0,0,0,8,,9,17
00892000,UNIVERSITY OF NOTTINGHAM                ,FC,00000-0000,Public       ,0,1,1,22,,113,135
00900600,UNIVERSITY OF SALFORD (THE)             ,FC,00000-0000,Public       ,0,2,2,5,,22,27
00908400,"UNIV OF LONDON, BIRKBECK                ",FC,00000-0000,Public       ,0,2,2,8,,110,118
00908500,UNIV OF LONDON KING'S COLLEGE           ,FC,00000-0000,Public       ,1,6,7,69,,463,532
00908600,UNIVERSITY OF LONDON - ROYAL HOLLOWAY   ,FC,00000-0000,Public       ,2,1,3,39,,86,125
00914300,BAR-ILAN UNIVERSITY                     ,FC,00000-0000,Private      ,0,0,0,23,,31,54
00924900,UNIVERSITY OF LIVERPOOL                 ,FC,00000-0000,Public       ,0,5,5,32,,111,143
00936800,UNIVERSITY OF ABERDEEN                  ,FC,00000-0000,Public       ,0,3,3,44,,142,186
00942300,ROYAL COLLEGE OF ART                    ,FC,00000-0000,Public       ,0,1,1,4,,68,72
00942800,TECHNION-ISRAEL INST OF TECHLGY         ,FC,00000-0000,Public       ,0,3,3,5,,63,68
00944200,UNIVERSITY OF EXETER                    ,FC,00000-0000,Public       ,1,0,1,22,,102,124
00944400,UNIVERSITY OF LANCASTER                 ,FC,00000-0000,Public       ,0,0,0,15,,58,73
00963400,UNIVERSITY OF OXFORD ST CATHERINE'S     ,FC,00000-0000,Public       ,0,0,0,5,,9,14
00980800,UNIVERSITY OF STRATHCLYDE               ,FC,00000-0000,Public       ,0,2,2,15,,48,63
00986000,UNIVERSITY OF SURREY                    ,FC,00000-0000,Public       ,1,2,3,12,,44,56
00988800,KAROLINSKA INSTITUTET                   ,FC,00000-0000,Public       ,0,0,0,0,,1,1
00990600,PONTIFICAL NORTH AMERICAN COLLEGE       ,FC,00000-0000,Private      ,0,0,0,1,,7,8
00992700,UNIVERSITY OF CAMBRIDGE - FITZWILLI     ,FC,00000-0000,Public       ,0,0,0,1,,11,12
01006700,LUND UNIVERSITY                         ,FC,00000-0000,Public       ,0,0,0,4,,71,75
01008400,UNIVERSITY OF CAPE TOWN                 ,FC,00000-0000,Public       ,0,3,3,10,,80,90
01008700,UNIVERSITY OF OXFORD ST PETER'S COL     ,FC,00000-0000,Public       ,0,0,0,1,,5,6
01008800,UNIVERSITY OF OXFORD - CORPUS CHRIS     ,FC,00000-0000,Public       ,0,0,0,1,,1,2
01008900,CENTRAL SCHOOL OF SPEECH AND DRAMA      ,FC,00000-0000,Private      ,0,0,0,16,,64,80
01009000,UNIVERSITY OF OXFORD - BALLIOL COLL     ,FC,00000-0000,Public       ,0,0,0,4,,4,8
01014300,UNIVERSITY OF READING                   ,FC,00000-0000,Public       ,0,2,2,17,,66,83
01015700,CARDIFF UNIVERSITY                      ,FC,00000-0000,Public       ,1,1,2,20,,62,82
01015900,PONTIFICIA UNIVERSITA GREGORIANA        ,FC,00000-0000,Private      ,0,0,0,2,,5,7
01016000,CG JUNG INST                            ,FC,00000-0000,Private      ,0,0,0,0,,5,5
01018800,UNIVERSITY COLLEGE DUBLIN               ,FC,00000-0000,Public       ,1,4,5,53,,278,331
01019000,UNIVERSITY OF CAMBRIDGE CHURCHILL C     ,FC,00000-0000,Public       ,0,0,0,0,,4,4
01022800,UNIVERSITY OF STIRLING                  ,FC,00000-0000,Public       ,1,1,2,35,,65,100
01033200,UNIVERSITY OF CAMBRIDGE - CLARE COL     ,FC,00000-0000,Public       ,0,0,0,0,,7,7
01045600,UNIVERSITY OF HAIFA                     ,FC,00000-0000,Public       ,0,3,3,5,,39,44
01047200,INST EUROPEEN OPEEN D'ADMINISTRATIO     ,FC,00000-0000,Private      ,0,1,1,1,,62,63
01049300,CRANFIELD UNIVERSITY                    ,FC,00000-0000,Public       ,0,0,0,1,,21,22
01052000,TRINITY LABAN CONSERVATOIRE OF MUSIC AND,FC,00000-0000,Public       ,0,0,0,4,,12,16
01052500,UNIVERSITY OF HERTFORDSHIRE             ,FC,00000-0000,Public       ,0,3,3,14,,24,38
01057400,LONDON INTRNTL FILM SCHOOL              ,FC,00000-0000,Private      ,0,1,1,6,,25,31
01058800,AUSTRALIAN NATIONAL UNIVERSITY          ,FC,00000-0000,Public       ,2,5,7,23,,51,74
01058900,BANGOR UNIVERSITY                       ,FC,00000-0000,Public       ,0,0,0,14,,18,32
01059400,"RICHMOND, THE AMERICAN INT UNI IN LONDON",FC,00000-0000,Private      ,5,0,5,395,,94,489
01059900,INST D'ETUDES POLITIQUES DE PARIS       ,FC,00000-0000,Public       ,0,1,1,17,,145,162
01068100,MACQUARIE UNIVERSITY                    ,FC,00000-0000,Public       ,0,4,4,10,,55,65
01069200,UNIVERSITY OF QUEENSLAND (THE)          ,FC,00000-0000,Public       ,3,21,24,18,,409,427
01078900,UNIVERSITY OF OXFORD - WORCESTER CO     ,FC,00000-0000,Public       ,0,0,0,0,,1,1
01079200,CITY AND GUILDS OF LONDON INSTITUTE     ,FC,00000-0000,Private      ,0,0,0,2,,3,5
01079700,"NATIONAL UNIVERSITY OF IRELAND, MAY     ",FC,00000-0000,Public       ,0,0,0,18,,20,38
01081600,KINGSTON UNIVERSITY                     ,FC,00000-0000,Public       ,0,3,3,66,,238,304
01083800,UNIVERSITITY OF BERGEN (UOB)            ,FC,00000-0000,Public       ,0,0,0,1,,7,8
01086400,UNIV OF DUNDEE                          ,FC,00000-0000,Public       ,0,0,0,8,,53,61
01086600,UNIVERSITY OF OXFORD - MAGDALEN COLLEGE ,FC,00000-0000,Public       ,0,0,0,1,,11,12
01086700,UNIVERSITY OF OXFORD ST JOHN'S COLL     ,FC,00000-0000,Public       ,0,0,0,2,,8,10
01091400,MONASH UNIVERSITY                       ,FC,00000-0000,Public       ,1,5,6,13,,47,60
01091500,UNIV OF EAST ANGLIA                     ,FC,00000-0000,Public       ,1,0,1,27,,103,130
01094200,UNIVERSITY OF OXFORD - ST HUGH'S CO     ,FC,00000-0000,Public       ,0,0,0,0,,11,11
01097700,UNIVERSIDAD CENTRAL DEL ESTE            ,FC,00000-0000,Private      ,1,3,4,97,,836,933
01098000,SOMERVILLE COLLEGE                      ,FC,00000-0000,Public       ,0,0,0,4,,4,8
01099900,UNIV OF OXFORD - WADHAM COLLEGE         ,FC,00000-0000,Public       ,0,0,0,0,,3,3
01104400,PONTIFICIA UNIVERSITA SAN TOMMASO       ,FC,00000-0000,Private      ,0,1,1,1,,11,12
01105300,UNIVERSITY OF OXFORD - ST HILDA'S C     ,FC,00000-0000,Public       ,0,0,0,1,,5,6
01105400,UNIVERSITY OF OXFORD - ST ANNE'S CO     ,FC,00000-0000,Public       ,0,0,0,1,,6,7
01105500,UNIV OF OXFORD - LADY MARGARET HALL     ,FC,00000-0000,Public       ,0,0,0,1,,7,8
01105600,UNIVERSITY OF OXFORD - UNIVERSITY C     ,FC,00000-0000,Public       ,1,0,1,11,,32,43
01105700,UNIVERSITY OF OXFORD - TRINITY COLL     ,FC,00000-0000,Public       ,0,0,0,3,,10,13
01105800,UNIVERSITY OF OXFORD-ST EDMUND HALL     ,FC,00000-0000,Public       ,0,0,0,1,,9,10
01105900,UNIVERSITY OF OXFORD ST ANTONY'S CO     ,FC,00000-0000,Public       ,0,0,0,0,,37,37
01106000,UNIVERSITY OF OXFORD - QUEEN'S COLL     ,FC,00000-0000,Public       ,0,1,1,1,,7,8
01106100,UNIVERSITY OF OXFORD - PEMBROKE COL     ,FC,00000-0000,Public       ,0,0,0,3,,11,14
01106200,UNIVERSITY OF OXFORD - ORIEL COLLEG     ,FC,00000-0000,Public       ,0,0,0,0,,10,10
01106300,UNIVERSITY OF OXFORD - NUFFIELD COL     ,FC,00000-0000,Public       ,0,0,0,0,,2,2
01106400,UNIVERSITY OF OXFORD - NEW COLLEGE      ,FC,00000-0000,Public       ,0,0,0,2,,8,10
01106500,UNIVERSITY OF OXFORD MERTON COLLEGE     ,FC,00000-0000,Public       ,0,0,0,1,,9,10
01106600,UNIVERSITY OF OXFORD - LINCOLN COLL     ,FC,00000-0000,Public       ,0,0,0,0,,6,6
01106700,UNIVERSITY OF OXFORD - KEBLE COLLEG     ,FC,00000-0000,Public       ,0,0,0,0,,6,6
01106800,UNIVERSITY OF OXFORD - JESUS COLLEG     ,FC,00000-0000,Public       ,0,0,0,0,,5,5
01106900,UNIVERSITY OF OXFORD - HERTFORD COL     ,FC,00000-0000,Public       ,0,0,0,0,,7,7
01107000,UNIVERSITY OF OXFORD EXETER COLLEGE     ,FC,00000-0000,Public       ,1,0,1,3,,4,7
01107100,UNIV OF OXFORD - CHRIST CHURCH          ,FC,00000-0000,Public       ,0,0,0,2,,11,13
01107200,UNIVERSITY OF OXFORD - BRASENOSE CO     ,FC,00000-0000,Public       ,0,0,0,0,,3,3
01109100,FLINDERS UNIVERSITY OF S AUSTRALIA      ,FC,00000-0000,Public       ,0,4,4,2,,35,37
01109400,UNIVERSITY OF WESTERN AUSTRALIA (THE)   ,FC,00000-0000,Public       ,0,0,0,10,,25,35
01121400,UNIVERSITY OF THE WITWATERSRAND         ,FC,00000-0000,Public       ,1,1,2,6,,24,30
01122600,AARHUS UNIVERSITY                       ,FC,00000-0000,Public       ,0,0,0,3,,28,31
01156700,"IMPERIAL COLLEGE OF SCIENCE, TECHNOLOGY ",FC,00000-0000,Public       ,0,2,2,25,,108,133
01167900,UNIVERSITY OF BATH                      ,FC,00000-0000,Public       ,1,0,1,21,,51,72
01168300,FRANKLIN COLLEGE  SWITZERLAND           ,FC,00000-0000,Private      ,3,0,3,337,,20,357
01175800,UNIV OF CAMBRIDGE - PETERHOUSE          ,FC,00000-0000,Public       ,0,0,0,0,,6,6
01176400,ROYAL ACADEMY OF MUSIC                  ,FC,00000-0000,Public       ,0,0,0,8,,24,32
01176500,GOLDSMITHS' COLLEGE-UNIV OF LONDON      ,FC,00000-0000,Public       ,0,4,4,50,,162,212
01176600,UNIV OF LONDON - INST OF EDUC           ,FC,00000-0000,Public       ,0,1,1,3,,50,53
01178000,BRUNEL UNIVERSITY                       ,FC,00000-0000,Public       ,1,0,1,11,,56,67
01183800,UNIVERSITY OF OXFORD - MANSFIELD CO     ,FC,00000-0000,Public       ,0,0,0,1,,7,8
01207500,UNIVERSITY CAMBRIDGE - TRINITY COLL     ,FC,00000-0000,Public       ,0,0,0,2,,20,22
01207800,VICTORIA UNIV OF WELLINGTON             ,FC,00000-0000,Public       ,0,3,3,22,,55,77
01209600,ECOLE HÔTELIERE DE LAUSANNE             ,FC,00000-0000,Private      ,1,0,1,7,,9,16
01210100,UNIVERSITY OF CAMBRIDGE - GIRTON CO     ,FC,00000-0000,Public       ,0,0,0,0,,8,8
01213600,VICTORIA UNIV OF MANCHESTER (THE)       ,FC,00000-0000,Public       ,0,2,2,38,,153,191
01219800,UNIVERSITY OF BRADFORD                  ,FC,00000-0000,Public       ,1,0,1,3,,25,28
01220100,UNIVERSITY OF OXFORD - REGENT'S PAR     ,FC,00000-0000,Public       ,0,0,0,1,,5,6
01220600,JAMES COOK UNIVERSITY                   ,FC,00000-0000,Public       ,1,4,5,25,,76,101
01221500,BIRMINGHAM CITY UNIVERSITY              ,FC,00000-0000,Public       ,0,1,1,12,,34,46
01222300,JAGIELLONIAN UNIVERSITY COLLEGIUM M     ,FC,00000-0000,Public       ,0,0,0,3,,24,27
01222500,UNIVERSITY OF SZEGED FACULTY OF MEDICINE,FC,00000-0000,Public       ,0,0,0,1,,10,11
01225800,ASTON UNIVERSITY                        ,FC,00000-0000,Public       ,0,0,0,5,,20,25
01227500,UNIVERSITY OF OXFORD - WOLFSON COLL     ,FC,00000-0000,Public       ,0,0,0,0,,26,26
01230200,GONVILLE & CAIUS COLLEGE                ,FC,00000-0000,Public       ,0,0,0,2,,3,5
01233300,UNIVERSITY OF THE ARTS LONDON IDO - CAMB,FC,00000-0000,Public       ,0,0,0,15,,12,27
01233500,ROYAL COLLEGE OF MUSIC                  ,FC,00000-0000,Public       ,0,0,0,11,,26,37
01234100,UNIVERSITY OF WALES - ST DAVID'S UN     ,FC,00000-0000,Public       ,0,0,0,5,,25,30
01242100,UNIV OF AUCKLAND                        ,FC,00000-0000,Public       ,2,6,8,30,,99,129
01253900,UNIVERSITY OF THE ARTS LONDON IDO - CENT,FC,00000-0000,Public       ,0,0,0,23,,31,54
01254000,UNIVERSIDAD DE NAVARRA                  ,FC,00000-0000,Private      ,1,0,1,18,,24,42
01276500,UNIVERSITY OF OXFORD - LINACRE COLL     ,FC,00000-0000,Public       ,0,0,0,0,,11,11
01276600,"NATIONAL UNIVERSITY IRELAND, GALWAY     ",FC,00000-0000,Public       ,0,1,1,32,,95,127
01280200,PONTIFICIA UNIV CATOLICA MAD Y MAES     ,FC,00000-0000,Private      ,5,3,8,182,,110,292
01281100,INST TECNOLOGICO DE SANTO DOMINGO       ,FC,00000-0000,Private      ,3,0,3,49,,65,114
01283900,UNIVERSITY OF CAMBRIDGE - SAINT JOH     ,FC,00000-0000,Public       ,0,0,0,0,,11,11
01297800,UNIVERSITY OF HUDDERSFIELD (THE)        ,FC,00000-0000,Public       ,0,0,0,8,,20,28
01315300,MASSEY UNIVERSITY                       ,FC,00000-0000,Public       ,1,11,12,7,,74,81
01322500,COLLEGE OF LAW                          ,FC,00000-0000,Private      ,0,0,0,0,,2,2
02052400,DARWIN COLLEGE                          ,FC,00000-0000,Public       ,0,0,0,0,,10,10
02082400,UNIVERSITY OF CAMBRIDGE - QUEEN'S C     ,FC,00000-0000,Public       ,0,0,0,1,,25,26
02083400,UNIVERSITY OF CAMBRIDGE - WOLFSON C     ,FC,00000-0000,Public       ,0,1,1,0,,18,18
02087400,UNIVERSITY OF CAMBRIDGE - NEWNHAM C     ,FC,00000-0000,Public       ,0,0,0,1,,8,9
02087900,OXFORD BROOKES UNIVERSITY               ,FC,00000-0000,Public       ,1,3,4,29,,95,124
02094100,BEN-GURION UNIV                         ,FC,00000-0000,Public       ,0,0,0,0,,131,131
02094400,UNIV OF CAMBRIDGE - ST EDMUND'S HOU     ,FC,00000-0000,Public       ,0,0,0,2,,18,20
02095500,LONDON BUS SCHOOL                       ,FC,00000-0000,Public       ,0,5,5,6,,128,134
02101900,ROEHAMPTON UNIVERSITY                   ,FC,00000-0000,Public       ,0,1,1,18,,103,121
02108600,LONDON ACADEMY OF MUSIC & DRAMATIC      ,FC,00000-0000,Private      ,0,0,0,16,,35,51
02115900,UNIVERSITY OF PORTSMOUTH                ,FC,00000-0000,Public       ,0,2,2,10,,24,34
02116700,UNIVERSITY OF CAMBRIDGE - LUCY CAVE     ,FC,00000-0000,Public       ,0,0,0,1,,3,4
02120000,UNIV OF LONDON - COURTALD INST OF A     ,FC,00000-0000,Public       ,0,1,1,3,,39,42
02133400,UNIVERSITY OF CAMBRIDGE - SIDNEY SU     ,FC,00000-0000,Public       ,0,0,0,1,,8,9
02142000,UNIVERSITY OF CAMBRIDGE - HOMERTON      ,FC,00000-0000,Public       ,0,0,0,0,,7,7
02149700,UNIVERSITY OF WINCHESTER (THE)          ,FC,00000-0000,Public       ,0,1,1,19,,15,34
02156800,UNIV OF OTAGO                           ,FC,00000-0000,Public       ,0,4,4,11,,42,53
02162300,"IESE BUSINESS SCH, UNIV OF NAVARRA      ",FC,00000-0000,Private      ,0,4,4,8,,71,79
02167400,UNIVERSITY OF CAMBRIDGE - CORPUS CH     ,FC,00000-0000,Public       ,0,0,0,0,,11,11
02177700,KING'S COLLEGE- UNIV OF CAMBRIDGE       ,FC,00000-0000,Public       ,1,0,1,7,,28,35
02180500,MIDDLESEX UNIVERSITY                    ,FC,00000-0000,Public       ,0,0,0,40,,106,146
02181000,UNIVERSITY OF SOUTH AUSTRALIA           ,FC,00000-0000,Public       ,0,0,0,8,,11,19
02183500,UNIV OF OXFORD - WYCLIFFE HALL          ,FC,00000-0000,Public       ,0,0,0,1,,10,11
02186000,UNIVERSITY OF CAMBRIDGE - MAGDALENE     ,FC,00000-0000,Public       ,0,0,0,1,,5,6
02186100,UNIVERSITY OF CAMBRIDGE - EMMANUEL      ,FC,00000-0000,Public       ,0,0,0,0,,6,6
02189600,UNIVERSITY OF GRONINGEN                 ,FC,00000-0000,Public       ,0,0,0,4,,28,32
02194800,UNIVERSITY OF THE WEST OF ENGLAND -     ,FC,00000-0000,Public       ,0,0,0,9,,13,22
02195100,UNIV OF WESTMINSTER                     ,FC,00000-0000,Public       ,0,2,2,57,,137,194
02196700,GUILDHALL SCHOOL OF MUSIC & DRAMA       ,FC,00000-0000,Public       ,0,0,0,16,,22,38
02207300,UNIVERSITY OF CAMBRIDGE - CHRIST'S      ,FC,00000-0000,Public       ,0,0,0,1,,5,6
02207400,CHINESE UNIVERSITY OF HONG KONG (THE)   ,FC,00000-0000,Public       ,1,3,4,19,,56,75
02209500,UNIVERSITEIT UTRECHT                    ,FC,00000-0000,Public       ,0,0,0,14,,52,66
02210000,UNIV OF LONDON - LONDON SCHOOL OF H     ,FC,00000-0000,Public       ,0,5,5,3,,93,96
02212300,UNIVERSITY OF CAMBRIDGE - ROBINSON      ,FC,00000-0000,Public       ,0,0,0,0,,1,1
02225300,UNIVERSITY OF CANTERBURY                ,FC,00000-0000,Public       ,0,0,0,6,,44,50
02229100,UNIVERSITY OF LEICESTER                 ,FC,00000-0000,Public       ,0,2,2,18,,117,135
02229600,SACKLER SCHOOL OF MEDICINE              ,FC,00000-0000,Public       ,1,0,1,2,,152,154
02232100,UNIVERSITY OF CAMBRIDGE                 ,FC,00000-0000,Public       ,0,0,0,2,,26,28
02233300,"ST GEORGE'S UNIVERSITY, SCHOOL OF MEDICI",FC,00000-0000,Proprietary  ,1,38,39,24,,3729,3753
02235300,LONDON METROPOLITAN UNIVERSITY          ,FC,00000-0000,Public       ,0,0,0,25,,87,112
02244400,AMERICAN UNIV OF THE CARIBBEAN          ,FC,00000-0000,Proprietary  ,0,67,67,14,,1783,1797
02266600,UNIVERSITY OF LONDON - SAINT GEORGE     ,FC,00000-0000,Public       ,1,0,1,3,,27,30
02271700,UNIVERSITY OF CAMBRIDGE - CLARE HAL     ,FC,00000-0000,Public       ,0,0,0,0,,4,4
02271900,UNIVERSITY OF OXFORD - BLACKFRIARS      ,FC,00000-0000,Public       ,0,0,0,0,,5,5
02272200,UNIV OF CAMBRIDGE - NEW HALL            ,FC,00000-0000,Public       ,0,0,0,0,,5,5
02273600,QUEEN'S UNIV OF BELFAST (THE)           ,FC,00000-0000,Public       ,0,0,0,12,,77,89
02273900,HERIOT WATT UNIVERSITY                  ,FC,00000-0000,Public       ,0,6,6,9,,54,63
02276700,NYENRODE BUSINESS UNIVERSITEIT          ,FC,00000-0000,Private      ,0,0,0,0,,3,3
02293400,ECOLE DES HAUTES ETUDES COMERCIALS      ,FC,00000-0000,Public       ,0,2,2,1,,31,32
02296300,UNIVERSITY OF CAMBRIDGE - JESUS COL     ,FC,00000-0000,Public       ,0,0,0,0,,7,7
02310500,DE MONTFORT UNIVERSITY                  ,FC,00000-0000,Public       ,0,0,0,3,,9,12
02320500,ROYAL NORTHERN COLLEGE OF MUSIC         ,FC,00000-0000,Public       ,0,1,1,0,,13,13
02335100,UNIV OF CAMBRIDGE - TRINITY HALL        ,FC,00000-0000,Public       ,0,0,0,2,,16,18
02338900,UNIVERSITY  FOR THE CREATIVE ARTS       ,FC,00000-0000,Public       ,1,0,1,9,,13,22
02351800,UNIVERSIDAD IBEROAMERICANA (UNIBE       ,FC,00000-0000,Private      ,5,10,15,115,,520,635
02352100,UNIVERSITY OF PLYMOUTH                  ,FC,00000-0000,Public       ,2,0,2,7,,21,28
02355200,ECOLE SUPERIEURE DE CUISINE FRANCAISE-FE,FC,00000-0000,Public       ,0,0,0,4,,17,21
02493000,ESCUELA SUPERIOR ADMINISTRACION Y D     ,FC,00000-0000,Private      ,1,1,2,6,,26,32
02496700,NATIONAL FILM & TV SCHOOL               ,FC,00000-0000,Public       ,0,0,0,0,,10,10
02502600,PECSI ORVOSTUDOMANYI EGYETEM (PECS      ,FC,00000-0000,Public       ,0,0,0,0,,2,2
02545700,GLASGOW SCHOOL OF ART                   ,FC,00000-0000,Public       ,0,0,0,9,,27,36
02561600,SOUTHAMPTON SOLENT UNIVERSITY           ,FC,00000-0000,Public       ,0,0,0,8,,8,16
02579600,MURDOCH UNIVERSITY                      ,FC,00000-0000,Public       ,1,4,5,2,,58,60
02588000,UNIVERSITY OF ULSTER                    ,FC,00000-0000,Public       ,0,0,0,5,,19,24
02591800,CURTIN UNIVERSITY OF TECHNOLOGY         ,FC,00000-0000,Public       ,0,1,1,3,,17,20
02611700,DUBLIN CITY UNIVERSITY                  ,FC,00000-0000,Public       ,0,1,1,10,,37,47
02623200,UNIVERSITY OF NEWCASTLE (THE)           ,FC,00000-0000,Public       ,0,2,2,11,,17,28
03012700,UNIVERSITY OF BUCKINGHAM                ,FC,00000-0000,Private      ,0,1,1,5,,11,16
03029400,KEELE UNIVERSITY                        ,FC,00000-0000,Public       ,0,0,0,20,,21,41
03029500,NORTHUMBRIA UNIVERSITY                  ,FC,00000-0000,Public       ,0,1,1,7,,29,36
03029800,NORGES HANDELSHOYSKOLE                  ,FC,00000-0000,Public       ,0,0,0,1,,3,4
03033300,MANCHESTER METROPOLITAN UNIV            ,FC,00000-0000,Public       ,0,0,0,27,,49,76
03045000,UNIVERSITY OF EAST LONDON               ,FC,00000-0000,Public       ,0,0,0,36,,86,122
03050100,STUDIO ART CENTERS INTERNATIONAL        ,FC,00000-0000,Private      ,0,2,2,21,,46,67
03066800,PONTIFICIO ATENEO DELLA SANTA CROCE     ,FC,00000-0000,Private      ,0,0,0,0,,6,6
03067200,UNIVERSITY OF SYDNEY                    ,FC,00000-0000,Public       ,0,26,26,26,,253,279
03073800,UNIV OF DEBRECEN MED & HEALTH SCI       ,FC,00000-0000,Public       ,1,0,1,6,,20,26
03080300,SHEFFIELD HALLAM UNIVERSITY             ,FC,00000-0000,Public       ,0,0,0,2,,16,18
03084300,UNIVERSITY OF LIMERICK                  ,FC,00000-0000,Public       ,0,0,0,24,,59,83
03088700,ROYAL SCOTTISH ACAD MUSIC & DRAMA       ,FC,00000-0000,Public       ,0,0,0,26,,23,49
03091400,UNIVERSITY OF WOLLONGONG                ,FC,00000-0000,Public       ,0,0,0,5,,22,27
03091500,UNIVERSITY OF CANBERRA                  ,FC,00000-0000,Public       ,0,0,0,4,,11,15
03091700,POZNAN UNIVERSITY OF MEDICAL SCIENCES   ,FC,00000-0000,Public       ,1,0,1,9,,75,84
03092500,NOTTINGHAM TRENT UNIVERSITY             ,FC,00000-0000,Public       ,0,0,0,11,,29,40
03095000,RMIT UNIVERSITY                         ,FC,00000-0000,Public       ,2,6,8,17,,51,68
03095400,BOND UNIVERSITY                         ,FC,00000-0000,Private      ,1,4,5,14,,57,71
03095900,ESSEC BUSINESS SCHOOL                   ,FC,00000-0000,Private      ,0,0,0,0,,14,14
03096100,LA TROBE UNIVERSITY                     ,FC,00000-0000,Public       ,0,3,3,12,,32,44
03096900,DEAKIN UNIVERSITY                       ,FC,00000-0000,Public       ,0,1,1,5,,8,13
03097100,UNIVERSITY OF WESTERN SYDNEY            ,FC,00000-0000,Public       ,0,0,0,3,,6,9
03097300,VICTORIA UNIVERSITY OF TECHNOLOGY       ,FC,00000-0000,Public       ,0,1,1,4,,12,16
03097500,CENTRAL QUEENSLAND UNIVERSITY           ,FC,00000-0000,Public       ,0,0,0,1,,10,11
03100000,UNIVERSITY OF ADELAIDE (THE)            ,FC,00000-0000,Public       ,0,0,0,4,,19,23
03101600,ASIAN INSTITUTE OF MANAGEMENT           ,FC,00000-0000,Private      ,0,1,1,3,,30,33
03102500,AMERICAN UNIVERSITY OF ROME             ,FC,00000-0000,Private      ,2,0,2,159,,75,234
03102800,ROBERT GORDON UNIVERSITY (THE)          ,FC,00000-0000,Public       ,0,1,1,3,,48,51
03104800,GRIFFITH UNIVERSITY                     ,FC,00000-0000,Public       ,0,1,1,12,,40,52
03136300,AUSTRALIAN CATHOLIC UNIVERSITY          ,FC,00000-0000,Public       ,0,2,2,4,,13,17
03140300,EDITH COWAN UNIVERSITY                  ,FC,00000-0000,Public       ,0,0,0,3,,5,8
03140400,NORTHERN TERRITORY UNIVERSITY           ,FC,00000-0000,Public       ,0,0,0,0,,2,2
03140500,QUEENSLAND UNIVERSITY OF TECHNOLOGY     ,FC,00000-0000,Public       ,0,1,1,6,,24,30
03140600,SOUTHERN CROSS UNIVERSITY               ,FC,00000-0000,Public       ,0,0,0,2,,21,23
03140700,SWINBURNE UNIVERSITY OF TECHNOLOGY      ,FC,00000-0000,Public       ,0,1,1,2,,13,15
03140900,UNIVERSITY OF BALLARAT                  ,FC,00000-0000,Public       ,0,0,0,0,,2,2
03150400,"UNIVERSITY OF TECHNOLOGY, SYDNEY        ",FC,00000-0000,Public       ,1,4,5,7,,45,52
03287300,LIVERPOOL INSTITUTE FOR PERFORMING ARTS ,FC,00000-0000,Public       ,0,0,0,13,,0,13
03300300,"2ND SCHOOL OF MEDICINE, CHARLES UNI     ",FC,00000-0000,Public       ,0,1,1,2,,18,20
03300400,"FIRST FACULTY OF MEDICINE, CHARLES UNIV.",FC,00000-0000,Public       ,0,0,0,3,,36,39
03329300,JOHN CABOT UNIVERSITY                   ,FC,00000-0000,Private      ,2,0,2,172,,35,207
03333300,MEDICAL UNIVERSITY SCHOOL OF LUBLIN     ,FC,00000-0000,Public       ,1,19,20,7,,192,199
03334300,UNIVERSIDAD NORDESTANA                  ,FC,00000-0000,Private      ,0,0,0,14,,72,86
03335300,MEDICAL UNIVERSITY OF SILESIA           ,FC,00000-0000,Public       ,1,5,6,5,,45,50
03342300,GLASGOW CALEDONIAN UNIVERSITY           ,FC,00000-0000,Public       ,0,0,0,6,,20,26
03349400,"QUEEN MARGARET UNIVERSITY, EDINBURGH    ",FC,00000-0000,Public       ,0,0,0,3,,32,35
03350300,BOURNEMOUTH UNIVERSITY                  ,FC,00000-0000,Public       ,1,0,1,8,,27,35
03352300,LONDON SOUTH BANK UNIVERSITY            ,FC,00000-0000,Private      ,1,0,1,15,,49,64
03363300,THE ARTS EDUCATIONAL SCHOOLS LONDON     ,FC,00000-0000,Private      ,0,0,0,0,,2,2
03364300,"FACULTY OF MEDICINE, PALACKY UNIVER     ",FC,00000-0000,Public       ,0,0,0,0,,4,4
03365400,AUCKLAND INSTITUTE OF TECHNOLOGY        ,FC,00000-0000,Public       ,0,0,0,8,,17,25
03366300,TROPICAL AGRICULTURE RESEARCH AND H     ,FC,00000-0000,Private      ,0,0,0,0,,4,4
03378300,"THE 3RD FACULTY OF MEDICINE, CHARLE     ",FC,00000-0000,Public       ,0,0,0,1,,8,9
03406300,"THE SCHOOL OF PHARMACY, UNIVERSITY      ",FC,00000-0000,Public       ,0,0,0,0,,3,3
03418400,NAPIER UNIVERSITY                       ,FC,00000-0000,Public       ,1,1,2,13,,55,68
03435300,ANGLIA  RUSKIN UNIVERSITY               ,FC,00000-0000,Private      ,0,1,1,15,,36,51
03460300,INTERNATIONALES THEOLOGISCHES INSTI     ,FC,00000-0000,Private      ,0,0,0,2,,21,23
03462400,UNIV OF ARTS LONDON - LON COLL OF COMMUN,FC,00000-0000,Public       ,0,0,0,14,,14,28
03466300,INSTITUTO CENTROAMERICANO DE ADMINI     ,FC,00000-0000,Private      ,0,0,0,1,,0,1
03473300,UNIV OF ARTS LONDON - LON COLL FASHION  ,FC,00000-0000,Public       ,2,0,2,129,,144,273
03473305,UNIVERSITY OF THE ARTS LONDON - CHELSEA ,FC,00000-0000,Public       ,0,0,0,12,,6,18
03473311,UNIVERSITY OF THE ARTS LONDON - WIMBLEDO,FC,00000-0000,Public       ,0,0,0,2,,5,7
03474301,AVE MARIA COLLEGE                       ,FC,00000-0000,Private      ,0,0,0,110,,38,148
03478300,ROYAL WELSH COLLEGE OF MUSIC AND DRAMA  ,FC,00000-0000,Public       ,0,0,0,15,,18,33
03492300,UNIVERSITY OF OXFORD - GREEN TEMPLETON C,FC,00000-0000,Public       ,0,1,1,0,,19,19
03492400,UNIV OF CAMBRIDGE-ST CATHERINE'S CG     ,FC,00000-0000,Public       ,0,0,0,0,,6,6
03494400,UNIV OF CAMBRIDGE-SELWYN COLLEGE        ,FC,00000-0000,Public       ,0,0,0,0,,7,7
03494600,UNIV OF OXFORD-HARRIS MANCHESTER        ,FC,00000-0000,Public       ,0,0,0,1,,4,5
03501400,LEEDS METROPOLITAN UNIVERSITY           ,FC,00000-0000,Public       ,1,2,3,18,,42,60
03507300,UNIVERSITY OF SUNDERLAND                ,FC,00000-0000,Public       ,0,0,0,5,,13,18
03515300,UNIVERSITY OF CENTRAL LANCASHIRE        ,FC,00000-0000,Public       ,0,0,0,3,,18,21
03517300,UNIVERSITY OF BRIGHTON                  ,FC,00000-0000,Public       ,0,0,0,11,,33,44
03518300,EUROPEAN GRADUATE SCHOOL                ,FC,00000-0000,Private      ,0,19,19,0,,118,118
03527300,SOFIA UNIVERSITY ST. KLIMENT OHRIDSKI   ,FC,00000-0000,Public       ,0,0,0,1,,10,11
03533300,BATH SPA UNIVERSITY                     ,FC,00000-0000,Public       ,1,0,1,15,,34,49
03547300,UNIVERSITY OF GLAMORGAN                 ,FC,00000-0000,Public       ,0,0,0,5,,13,18
03580300,LIVERPOOL JOHN MOORES UNIVERSITY        ,FC,00000-0000,Public       ,0,0,0,7,,8,15
03589400,ARTS INSTITUTE AT BOURNEMOUTH (THE)     ,FC,00000-0000,Public       ,1,0,1,11,,10,21
03590300,AVONDALE COLLEGE LIMITED                ,FC,00000-0000,Private      ,0,0,0,4,,4,8
03594300,GROUP ESC GRENOBLE GRAD SCH OF BUS.     ,FC,00000-0000,Private      ,0,0,0,0,,22,22
03597300,JAGIELLONIAN UNIVERSITY                 ,FC,00000-0000,Public       ,0,0,0,1,,27,28
03601300,UNIVERSITAT JAUME I DE CASTELLO (UJI)   ,FC,00000-0000,Public       ,0,0,0,1,,16,17
03619300,UNIVERSITY OF GREENWICH                 ,FC,00000-0000,Public       ,0,0,0,32,,49,81
03653400,UNIVERSIDAD DE IBEROAMERICA - UNIBE     ,FC,00000-0000,Private      ,0,2,2,4,,35,39
03674300,UNIVERSITY OF ABERTAY DUNDEE            ,FC,00000-0000,Public       ,0,0,0,1,,6,7
03684400,UNIVERSITY OF LINCOLN                   ,FC,00000-0000,Public       ,0,0,0,16,,33,49
03684500,MEDICAL UNIVERSITY OF GDANSK            ,FC,00000-0000,Public       ,0,0,0,0,,15,15
03694300,UNIVERSITY OF CHICHESTER                ,FC,00000-0000,Public       ,0,0,0,5,,1,6
03716300,"UNIVERSITY OF WALES, NEWPORT            ",FC,00000-0000,Public       ,0,0,0,3,,11,14
03727400,UNIVERSITY OF WAIKATO (THE)             ,FC,00000-0000,Public       ,0,0,0,8,,14,22
03738300,LONDON SCHOOL OF THEOLOGY               ,FC,00000-0000,Private      ,0,0,0,1,,8,9
03741300,ALRA (ACADEMY OF LIVE AND RECORDED ARTS),FC,00000-0000,Private      ,0,0,0,10,,16,26
03770300,NAZARENE THEOLOGICAL COLLEGE            ,FC,00000-0000,Private      ,0,0,0,0,,4,4
03780300,SABA UNIVERSITY SCHOOL OF MEDICINE      ,FC,00000-0000,Proprietary  ,0,32,32,2,,186,188
03784300,MEDICAL UNIVERSITY OF BIALYSTOK         ,FC,00000-0000,Public       ,0,1,1,0,,1,1
03794400,ANGLO EUROPEAN COLLEGE OF CHIROPRACTIC  ,FC,00000-0000,Private      ,0,0,0,1,,3,4
03807300,ROSE BRUFORD COLLEGE                    ,FC,00000-0000,Public       ,0,0,0,5,,11,16
03816400,AMERICAN GRAD SCH OF INTERNTL REL & DIPL,FC,00000-0000,Private      ,0,1,1,8,,76,84
03818300,LEIPZIG GRADUATE SCHOOL OF MANAGEMENT   ,FC,00000-0000,Private      ,0,1,1,2,,23,25
03824300,"ROYAL VETERINARY COLLEGE (THE), UNIVERSI",FC,00000-0000,Public       ,0,0,0,4,,146,150
03829300,INTERNATIONAL CHRISTIAN COLLEGE         ,FC,00000-0000,Private      ,0,0,0,0,,1,1
03850500,MEDICAL UNIVERSITY OF LODZ              ,FC,00000-0000,Public       ,0,0,0,3,,17,20
03859400,UNIVERSITY COLLEGE FALMOUTH             ,FC,00000-0000,Public       ,0,0,0,12,,8,20
03873300,COPENHAGEN BUSINESS SCHOOL              ,FC,00000-0000,Public       ,0,1,1,2,,14,16
03880300,UNIVERSITY OF GLOUCESTERSHIRE (THE)     ,FC,00000-0000,Public       ,0,0,0,2,,9,11
03897400,INTERNATIONAL SPACE UNIVERSITY          ,FC,00000-0000,Private      ,0,0,0,0,,6,6
03974300,"ST. GEORGE'S UNIVERSITY, SCHOOL OF VETER",FC,00000-0000,Proprietary  ,0,3,3,8,,619,627
04021400,"AMERICAN COLLEGE, DUBLIN LIMITED (THE)  ",FC,00000-0000,Private      ,0,0,0,30,,35,65
04021500,CENTRAL EUROPEAN UNIVERSITY             ,FC,00000-0000,Private      ,1,3,4,4,,100,104
04032300,YORK ST JOHN UNIVERSITY                 ,FC,00000-0000,Public       ,0,0,0,6,,3,9
04046300,HK UNIVERSITY OF SCI & TECH (HKUST)     ,FC,00000-0000,Public       ,0,3,3,4,,21,25
04070300,"RAPHAEL RECANATI INTERNATIONAL SCHOOL, T",FC,00000-0000,Private      ,1,0,1,88,,66,154
04076300,NEWCASTLE COLLEGE                       ,FC,00000-0000,Public       ,0,0,0,1,,2,3
04085400,NEW ZEALAND COLLEGE OF CHIROPRACTIC     ,FC,00000-0000,Private      ,0,1,1,0,,5,5
04113300,LEBANESE AMERICAN UNIVERSITY            ,FC,00000-0000,Private      ,2,0,2,65,,26,91
04115900,LIVERPOOL HOPE UNIVERSITY               ,FC,00000-0000,Public       ,0,0,0,5,,10,15
04116300,EDHEC BUSINESS SCHOOL                   ,FC,00000-0000,Private      ,0,1,1,0,,22,22
04128600,UNIVERSITY OF WORCESTER                 ,FC,00000-0000,Public       ,0,0,0,4,,5,9
04128700,HERTIE SCHOOL OF GOVERNANCE             ,FC,00000-0000,Private      ,0,1,1,4,,34,38
04134200,LONDON CONTEMPORARY DANCE SCHOOL        ,FC,00000-0000,Private      ,0,0,0,3,,4,7
04139100,UNIVERSITA DEGLI STUDI DI SCIENZE GASTRO,FC,00000-0000,Private      ,0,2,2,1,,36,37
04143700,ST MARY'S UNIVERSITY COLLEGE TWICKENHAM ,FC,00000-0000,Public       ,1,0,1,15,,38,53
04168200,EUROPEAN UNIVERSITY AT ST. PETERSBURG   ,FC,00000-0000,Private      ,0,1,1,4,,39,43
04171800,"INTERNATIONAL UNIVERSITY OF NURSING, ST.",FC,00000-0000,Proprietary  ,0,0,0,2,,4,6
04176500,ESMT EUROPEAN SCHOOL OF MANAGEMENT AND T,FC,00000-0000,Private      ,0,2,2,4,,23,27
00380600,ALDERSON BROADDUS UNIVERSITY            ,WV,26416-1051,Private      ,24,19,43,2002,,475,2477
00380700,MOUNTAIN STATE UNIVERSITY               ,WV,25801-5624,Private      ,5,13,18,53,,210,263
00380800,BETHANY COLLEGE                         ,WV,26032-0417,Private      ,10,9,19,1234,,150,1384
00380900,BLUEFIELD STATE COLLEGE                 ,WV,24701-2198,Public       ,22,66,88,1445,,2036,3481
00381000,CONCORD UNIVERSITY                      ,WV,24712-0000,Public       ,25,54,79,2998,,1672,4670
00381100,DAVIS & ELKINS COLLEGE                  ,WV,26241-3996,Private      ,14,9,23,1122,,376,1498
00381200,FAIRMONT STATE UNIVERSITY               ,WV,26554-2470,Public       ,55,94,149,5240,,3655,8895
00381300,GLENVILLE STATE COLLEGE                 ,WV,26351-1292,Public       ,19,27,46,1555,,683,2238
00381500,MARSHALL UNIVERSITY                     ,WV,25755-3300,Public       ,103,226,329,10739,,7999,18738
00381600,SOUTHERN WV COMMUNITY COLLEGE           ,WV,25637-2900,Public       ,27,62,89,1344,,1715,3059
00381800,UNIVERSITY OF CHARLESTON                ,WV,25304-1099,Private      ,34,80,114,2004,,2287,4291
00381900,OHIO VALLEY COLLEGE                     ,WV,26105-8000,Private      ,10,17,27,515,,215,730
00382000,SALEM INTERNATIONAL UNIVERSITY          ,WV,26426-0500,Proprietary  ,12,76,88,427,,969,1396
00382200,SHEPHERD UNIVERSITY                     ,WV,25443-5000,Public       ,47,74,121,4195,,1880,6075
00382300,WEST LIBERTY UNIVERSITY                 ,WV,26074-0295,Public       ,30,47,77,3158,,1171,4329
00382600,WEST VIRGINIA STATE UNIVERSITY          ,WV,25112-0000,Public       ,51,60,111,2581,,2327,4908
00382700,WEST VIRGINIA UNIVERSITY                ,WV,26506-6201,Public       ,203,270,473,27058,,10531,37589
00382711,WEST VIRGINIA UNIVERSITY - POTOMAC STATE,WV,26726-3000,Public       ,24,20,44,2001,,751,2752
00382721,WEST VIRGINIA UNIV INST OF TECH         ,WV,25136-2436,Public       ,15,25,40,1486,,762,2248
00382800,WEST VIRGINIA UNIV AT PARKERSBURG       ,WV,26101-9577,Public       ,39,122,161,1931,,3213,5144
00383000,WEST VIRGINIA WESLEYAN COLLEGE          ,WV,26201-2600,Private      ,20,10,30,2111,,368,2479
00383100,WHEELING JESUIT UNIVERSITY              ,WV,26003-6243,Private      ,5,55,60,1356,,1127,2483
00500700,WEST VIRGINIA JUNIOR COLLEGE            ,WV,26505-5596,Proprietary  ,15,68,83,340,,549,889
00500800,MOUNTAIN STATE COLLEGE                  ,WV,26101-3993,Proprietary  ,5,33,38,69,,431,500
00754400,APPALACHIAN BIBLE COLLEGE               ,WV,25818-1353,Private      ,2,7,9,294,,80,374
00757800,HUNTINGTON SCHOOL OF BEAUTY CULTURE     ,WV,25705-2030,Proprietary  ,1,5,6,111,,222,333
00760000,INTERNATIONAL BEAUTY SCHOOL             ,WV,25401-3231,Proprietary  ,5,22,27,44,,139,183
00835500,JAMES RUMSEY TECHNICAL INSTITUTE        ,WV,25403-0259,Public       ,5,34,39,128,,450,578
00895900,CLARKSBURG BEAUTY ACADEMY               ,WV,26301-2903,Proprietary  ,10,14,24,84,,143,227
00904700,HUNTINGTON JUNIOR COLLEGE               ,WV,25701-2004,Proprietary  ,9,106,115,221,,1368,1589
00905400,WEST VIRGINIA NORTHERN CMTY COLLEGE     ,WV,26003-0000,Public       ,24,123,147,1116,,2254,3370
01014000,MINERAL COUNTY VOCATIONAL TECH CTR      ,WV,26726-0000,Public       ,0,5,5,15,,83,98
01035600,EVEREST INSTITUTE                       ,WV,25313-1304,Proprietary  ,5,46,51,90,,490,580
01057300,WEST VIRGINIA JUNIOR COLLEGE            ,WV,25322-0000,Proprietary  ,8,37,45,216,,506,722
01057302,WEST VIRGINIA JUNIOR COLLEGE            ,WV,26330-0000,Proprietary  ,17,20,37,217,,318,535
01086100,WEST VIRGINIA BUSINESS COLLEGE          ,WV,26301-0000,Proprietary  ,2,17,19,42,,227,269
01124500,WEST VIRGINIA SCH OSTEOPATHIC MED       ,WV,24901-1128,Public       ,0,2,2,34,,872,906
01174900,WOOD COUNTY SCH OF PRAC NURSING         ,WV,26101-6424,Public       ,2,4,6,48,,148,196
01235900,B M SPURR SCHOOL OF PRAC NURSING        ,WV,26038-1660,Private      ,0,1,1,15,,46,61
01257300,WEST VIRGINIA UNIV-HOSP-RAD TECH        ,WV,26506-8062,Private      ,3,8,11,208,,157,365
01274300,BENJAMIN FRANKLIN CAREER&TECH           ,WV,25064-0000,Public       ,6,17,23,103,,279,382
01290400,MONONGALIA CNTY TECH ED CTR             ,WV,26501-6841,Public       ,2,5,7,96,,198,294
01290500,ACADEMY OF CAREERS AND TECHNOLOGY       ,WV,25801-0000,Public       ,3,27,30,125,,443,568
02057400,ROANE-JACKSON TECHNICAL CENTER          ,WV,25252-0000,Public       ,1,3,4,25,,93,118
02068000,UNITED TECHNICAL CENTER                 ,WV,26301-0000,Public       ,2,14,16,43,,177,220
02073400,CARVER CAREER TECH ED CTR               ,WV,25306-6397,Public       ,3,23,26,223,,519,742
02145100,SCOTT COLLEGE OF COSMETOLOGY            ,WV,26003-0000,Proprietary  ,8,10,18,89,,101,190
02178200,CHARLESTON SCHOOL OF BEAUTY CULTURE     ,WV,25301-0000,Proprietary  ,5,28,33,111,,258,369
02218200,GARNET CAREER CENTER                    ,WV,25301-0000,Public       ,5,32,37,117,,491,608
02275300,CABELL COUNTY CAREER TECHNOLOGY CTR     ,WV,25705-0000,Public       ,5,21,26,154,,369,523
02524500,RALPH R WILLIS VOCATIONAL CENTER        ,WV,25601-0000,Public       ,1,8,9,34,,104,138
02534800,FRED W EBERLE TECHNICAL CENTER          ,WV,26201-0000,Public       ,1,10,11,81,,193,274
02535500,MERCER COUNTY TECH EDUC CNTR            ,WV,24740-0000,Public       ,3,19,22,116,,347,463
02579900,NORTH CENTRAL OPPORTUNITIES INDUSTRIALIZ,WV,26554-2936,Private      ,3,25,28,50,,168,218
02609400,VALLEY COLLEGE                          ,WV,25404-5711,Proprietary  ,7,47,54,49,,290,339
03052000,MEREDITH MANOR EQUESTRIAN CENTRE        ,WV,26184-9707,Proprietary  ,11,4,15,276,,134,410
03076500,FAYETTE INSTITUTE OF TECHNOLOGY         ,WV,25901-2174,Public       ,1,8,9,31,,105,136
03084200,VALLEY COLLEGE                          ,WV,24740-3141,Proprietary  ,6,22,28,44,,202,246
03084400,VALLEY COLLEGE                          ,WV,25801-2643,Proprietary  ,11,62,73,79,,507,586
03098300,PUTNAM CAREER & TECHNICAL CENTER        ,WV,25070-0000,Public       ,0,6,6,98,,160,258
03099200,"MOUNTAINEER BEAUTY COLLEGE, INC         ",WV,25177-2917,Proprietary  ,0,0,0,4,,3,7
03102100,MORGANTOWN BEAUTY COLLEGE               ,WV,26505-5430,Proprietary  ,2,9,11,100,,156,256
03123200,STANLEY TECHNICAL INSTITUTE             ,WV,26505-3751,Private      ,1,3,4,16,,51,67
03327500,SOUTH BRANCH VOCATIONAL TECH CENTER     ,WV,26847-1698,Public       ,1,1,2,15,,24,39
03734300,JOHN D. ROCKEFELLER IV CAREER CENTER    ,WV,26047-9424,Public       ,0,7,7,12,,38,50
03819300,AMERICAN PUBLIC UNIVERSITY SYSTEM       ,WV,25414-1621,Proprietary  ,281,8337,8618,2828,,74104,76932
03957300,BLUE RIDGE COMMUNITY AND TECHNICAL COLLE,WV,25401-3244,Public       ,35,117,152,1082,,2683,3765
03960300,NEW RIVER COMMUNITY AND TECHNICAL COLLEG,WV,25801-2636,Public       ,38,133,171,1272,,3000,4272
04028300,MOUNTAIN STATE SCHOOL OF MASSAGE        ,WV,25304-2025,Proprietary  ,1,12,13,20,,89,109
04038500,PIERPONT COMMUNITY & TECHNICAL COLLEGE  ,WV,26554-2451,Public       ,26,79,105,1854,,2214,4068
04038600,KANAWHA VALLEY COMMUNITY & TECH COLLEGE ,WV,25112-1000,Public       ,23,92,115,793,,2096,2889
04041400,MOUNTWEST COMMUNITY AND TECHNICAL COLLEG,WV,25755-3300,Public       ,29,97,126,1160,,2399,3559
04047300,BRIDGEMONT COMMUNITY & TECHNICAL COLLEGE,WV,25136-2435,Public       ,5,19,24,515,,470,985
04119000,EASTERN WEST VIRGINIA COMMUNITY & TECHNI,WV,26836-0000,Public       ,5,44,49,243,,753,996
04139900,FUTURE GENERATIONS GRADUATE SCHOOL      ,WV,26807-0000,Private      ,0,0,0,0,,2,2
00106100,ALASKA PACIFIC UNIVERSITY               ,AK,99508-4672,Private      ,8,46,54,563,,1102,1665
00106300,UNIVERSITY OF ALASKA FAIRBANKS          ,AK,99775-7500,Public       ,64,272,336,3701,,4771,8472
00106500,UNIVERSITY OF ALASKA SOUTHEAST          ,AK,99801-8680,Public       ,27,87,114,944,,1637,2581
00884300,ALASKA BIBLE COLLEGE                    ,AK,99588-0000,Private      ,0,2,2,40,,42,82
01146200,UNIVERSITY OF ALASKA ANCHORAGE          ,AK,99514-1608,Public       ,173,512,685,7353,,10231,17584
02541000,ALASKA CAREER COLLEGE                   ,AK,99507-1033,Proprietary  ,31,126,157,324,,1174,1498
02576900,CHARTER COLLEGE                         ,AK,99508-0000,Proprietary  ,143,655,798,1131,,4123,5254
03160300,AVTEC                                   ,AK,99664-0889,Public       ,9,15,24,288,,493,781
03461300,ILISAGVIK COLLEGE                       ,AK,99723-0749,Public       ,2,8,10,41,,97,138
04138600,ALASKA CHRISTIAN COLLEGE                ,AK,99669-9755,Private      ,3,9,12,44,,74,118
00108500,UNIV ARKANSAS MONTICELLO                ,AR,71656-0000,Public       ,45,96,141,2655,,2570,5225
00108600,UNIV OF ARKANSAS AT PINE BLUFF          ,AR,71601-2790,Public       ,47,73,120,3749,,2113,5862
00108700,ARKANSAS BAPTIST COLLEGE                ,AR,72202-6099,Private      ,36,52,88,1319,,1726,3045
00108800,LYON COLLEGE                            ,AR,72501-3699,Private      ,13,8,21,970,,173,1143
00108900,ARKANSAS TECH UNIVERSITY                ,AR,72801-2222,Public       ,105,198,303,7332,,6250,13582
00109000,ARKANSAS STATE UNIVERSITY               ,AR,72467-0000,Public       ,127,534,661,10466,,12548,23014
00109002,ARKANSAS STATE UNIVERSITY - NEWPORT     ,AR,72112-1120,Public       ,0,0,0,818,,1408,2226
00109006,DELTA TECHNICAL INSTITUTE               ,AR,72365-9558,Public       ,0,0,0,63,,130,193
00109100,ARKANSAS STATE UNIVERSITY - BEEBE       ,AR,72012-1000,Public       ,43,127,170,2500,,3392,5892
00109200,UNIVERSITY OF CENTRAL ARKANSAS          ,AR,72035-0001,Public       ,118,152,270,10910,,5752,16662
00109300,CENTRAL BAPTIST COLLEGE                 ,AR,72034-6470,Private      ,8,39,47,706,,741,1447
00109400,UNIVERSITY OF THE OZARKS                ,AR,72830-2880,Private      ,9,5,14,774,,188,962
00109500,CROWLEYS RIDGE COLLEGE                  ,AR,72450-9775,Private      ,4,8,12,241,,200,441
00109700,HARDING UNIVERSITY                      ,AR,72149-0001,Private      ,40,70,110,4312,,2032,6344
00109800,HENDERSON STATE UNIVERSITY              ,AR,71999-0001,Public       ,60,62,122,4118,,2113,6231
00109900,HENDRIX COLLEGE                         ,AR,72032-3080,Private      ,26,8,34,2405,,361,2766
00110000,JOHN BROWN UNIVERSITY                   ,AR,72761-2747,Private      ,17,70,87,1697,,1489,3186
00110100,UNIV ARKANSAS LITTLE ROCK               ,AR,72204-1099,Public       ,83,355,438,6075,,11499,17574
00110200,OUACHITA BAPTIST UNIVERSITY             ,AR,71998-0001,Private      ,21,12,33,2018,,257,2275
00110300,PHILANDER SMITH COLLEGE                 ,AR,72202-3718,Private      ,18,43,61,1156,,985,2141
00110400,PHILLIPS COUNTY COMMUNITY COLLEGE       ,AR,72342-0000,Public       ,26,61,87,581,,973,1554
00110500,SHORTER COLLEGE                         ,AR,72114-4885,Private      ,11,89,100,107,,751,858
00110600,WILLIAMS BAPTIST COLLEGE                ,AR,72476-4661,Private      ,4,8,12,657,,184,841
00110700,SOUTHERN ARKANSAS UNIVERSITY            ,AR,71754-0000,Public       ,49,74,123,3197,,2076,5273
00110800,UNIV ARKANSAS FAYETTEVILLE              ,AR,72701-0000,Public       ,223,188,411,19247,,7989,27236
00110900,UNIVERSITY OF ARKANSAS FOR MEDICAL SCIEN,AR,72205-7102,Public       ,15,67,82,789,,3401,4190
00111000,UNIVERSITY OF ARKANSAS-FORT SMITH       ,AR,72904-7397,Public       ,66,119,185,4830,,4706,9536
00524500,U OF A COMM COLLEGE AT MORRILTON        ,AR,72110-9601,Public       ,40,75,115,1503,,2325,3828
00570700,SEARK COLLEGE                           ,AR,71603-0000,Public       ,33,98,131,814,,2227,3041
00573200,UNIV AR COMMUNITY COLLEGE AT HOPE       ,AR,71801-0000,Public       ,21,81,102,692,,1388,2080
00704400,CROWLEYS RIDGE TECHNICAL INSTITUTE      ,AR,72336-0000,Public       ,13,23,36,201,,430,631
00732967,ITT TECHNICAL INSTITUTE                 ,AR,72204-7739,Proprietary  ,16,119,135,325,,1086,1411
00773800,SOUTHERN ARKANSAS UNIVERSITY TECH       ,AR,71701-1900,Public       ,12,40,52,670,,1000,1670
00792100,PAUL MITCHELL THE SCHOOL ARKANSAS       ,AR,72701-0000,Proprietary  ,7,17,24,109,,170,279
00997600,COLLEGE OF THE OUACHITAS                ,AR,72104-0816,Public       ,6,67,73,438,,1321,1759
01074100,MELLIE'S BEAUTY COLLEGE                 ,AR,72901-3833,Proprietary  ,7,24,31,83,,260,343
01210500,NATIONAL PARK COMMUNITY COLLEGE         ,AR,71913-9174,Public       ,37,157,194,1212,,2973,4185
01226000,EAST ARKANSAS COMMUNITY COLLEGE         ,AR,72335-2204,Public       ,16,56,72,615,,958,1573
01226100,NORTH ARKANSAS COLLEGE                  ,AR,72601-5508,Public       ,25,72,97,1192,,2065,3257
01286000,ARKANSAS NORTHEASTERN COLLEGE           ,AR,72316-1109,Public       ,32,84,116,814,,1458,2272
02052200,BLACK RIVER TECHNICAL COLLEGE           ,AR,72455-0000,Public       ,26,75,101,951,,2347,3298
02073500,UNIVERSITY OF ARKANSAS COMMUNITY COLLEGE,AR,72503-0000,Public       ,21,61,82,715,,1240,1955
02073700,NORTHWEST TECHNICAL INSTITUTE           ,AR,72765-0000,Public       ,6,18,24,271,,628,899
02074600,SOUTH ARKANSAS COMMUNITY COLLEGE        ,AR,71731-0000,Public       ,15,51,66,795,,1987,2782
02075300,PULASKI TECHNICAL COLLEGE               ,AR,72118-0000,Public       ,89,374,463,4540,,14822,19362
02087000,OZARKA COLLEGE                          ,AR,72556-0000,Public       ,18,75,93,502,,1417,1919
02111100,RICH MOUNTAIN COMMUNITY COLLEGE         ,AR,71953-0000,Public       ,19,55,74,398,,648,1046
02202400,PROFESSIONAL COSMETOLOGY EDUC CTR       ,AR,71730-5828,Proprietary  ,0,4,4,29,,80,109
02220900,COSSATOT COMMUNITY COLLEGE              ,AR,71832-0000,Public       ,10,65,75,596,,1124,1720
02272400,EASTERN COLLEGE OF HEALTH VOCATIONS     ,AR,72205-3535,Proprietary  ,23,92,115,246,,847,1093
02284200,NEW TYLER BARBER COLLEGE INC            ,AR,72114-0000,Proprietary  ,3,11,14,62,,237,299
02287400,MARSHA KAY BEAUTY COLLEGE               ,AR,72653-0000,Proprietary  ,0,3,3,24,,53,77
02330800,JEFFERSON SCHOOL OF NURSING             ,AR,71603-0000,Private      ,1,3,4,106,,265,371
02339800,SOUTHERN INSTITUTE OF COSMETOLOGY       ,AR,72301-0000,Proprietary  ,4,8,12,28,,83,111
02341700,CAREER ACADEMY OF HAIR DESIGN           ,AR,72764-4304,Proprietary  ,6,11,17,55,,187,242
02341701,CAREER ACADEMY OF HAIR DESIGN - ROGERS  ,AR,72756-2102,Proprietary  ,6,14,20,47,,158,205
02341702,CAREER ACADEMY OF HAIR DESIGN - SILOAM  ,AR,72761-4217,Proprietary  ,1,8,9,30,,62,92
02341703,CAREER ACADEMY OF HAIR DESIGN - FAYETTEV,AR,72701-7731,Proprietary  ,2,3,5,2,,3,5
02348200,MID-SOUTH COMMUNITY COLLEGE             ,AR,72301-0000,Public       ,43,162,205,886,,1980,2866
02363500,ARTHUR'S BEAUTY COLLEGE                 ,AR,72901-0000,Proprietary  ,8,17,25,77,,221,298
02525800,LEE'S SCHOOL OF COSMETOLOGY             ,AR,72114-0000,Proprietary  ,0,5,5,46,,142,188
02538500,ARTHUR'S BEAUTY COLLEGE                 ,AR,72076-0000,Proprietary  ,9,33,42,89,,278,367
02569600,SEARCY BEAUTY COLLEGE                   ,AR,72143-0000,Proprietary  ,4,11,15,40,,143,183
03005100,ARKANSAS BEAUTY SCHOOL                  ,AR,72209-5116,Proprietary  ,2,9,11,97,,259,356
03007100,HOT SPRINGS BEAUTY COLLEGE              ,AR,71901-5432,Proprietary  ,2,11,13,40,,160,200
03007600,ARKANSAS BEAUTY SCHOOL-CONWAY           ,AR,72032-4354,Proprietary  ,3,11,14,73,,186,259
03023400,ARKANSAS COLLEGE OF BARBERING           ,AR,72114-5615,Proprietary  ,9,30,39,83,,292,375
03063300,NORTHWEST ARKANSAS COMMUNITY COLLEG     ,AR,72712-5190,Public       ,76,212,288,3945,,6136,10081
03065100,ABC BEAUTY COLLEGE                      ,AR,71923-4206,Proprietary  ,3,7,10,29,,107,136
03066302,BRYAN COLLEGE -                         ,AR,72756-1825,Proprietary  ,2,29,31,87,,342,429
03105200,BAPTIST HEALTH SCHOOLS LITTLE ROCK      ,AR,72210-2820,Private      ,6,35,41,619,,2039,2658
03115102,HERITAGE COLLEGE - LITTLE ROCK          ,AR,72227-5544,Proprietary  ,37,125,162,251,,985,1236
03124900,IMAGINE -  PAUL MITCHELL PARTNER SCHOOL ,AR,72117-2516,Proprietary  ,15,32,47,270,,488,758
03214300,VELVATEX COLLEGE OF BEAUTY CULTURE      ,AR,72202-5452,Proprietary  ,0,1,1,27,,77,104
03254300,MARGARET'S HAIR ACADEMY                 ,AR,71655-4905,Proprietary  ,0,14,14,42,,103,145
03519400,"LYNNDALE FUNDAMENTALS OF BEAUTY SCHOOL, ",AR,71730-4804,Proprietary  ,0,3,3,8,,35,43
03855300,ECCLESIA COLLEGE                        ,AR,72762-8159,Private      ,2,7,9,167,,141,308
03912300,CROSSETT SCHOOL OF COSMETOLOGY          ,AR,71635-0000,Proprietary  ,0,4,4,19,,49,68
03997300,ARKANSAS BEAUTY COLLEGE                 ,AR,72801-3741,Proprietary  ,2,7,9,33,,114,147
04183100,WASHINGTON BARBER COLLEGE               ,AR,72209-3820,Proprietary  ,7,16,23,63,,208,271
04183400,SALON PROFESSIONAL ACADEMY (THE)        ,AR,72116-7310,Proprietary  ,0,4,4,74,,161,235
04203400,ARKANSAS STATE UNIVERSITY - NEWPORT     ,AR,72112-9073,Public       ,27,89,116,117,,410,527
04220000,DESIGNER BARBER & STYLIST SCHOOL        ,AR,72903-3753,Proprietary  ,2,14,16,14,,79,93
00133900,CORBAN UNIVERSITY                       ,OR,97301-9392,Private      ,23,32,55,2063,,857,2920
00318600,BLUE MOUNTAIN COMMUNITY COLLEGE         ,OR,97801-0000,Public       ,53,130,183,1307,,2298,3605
00318800,CENTRAL OREGON COMMUNITY COLLEGE        ,OR,97701-5998,Public       ,125,409,534,3490,,7015,10505
00318900,CLATSOP COMMUNITY COLLEGE               ,OR,97103-3698,Public       ,38,108,146,691,,1575,2266
00319100,CONCORDIA UNIVERSITY                    ,OR,97211-6099,Private      ,29,1313,1342,2364,,9753,12117
00319300,EASTERN OREGON UNIVERSITY               ,OR,97850-2899,Public       ,59,117,176,3281,,3728,7009
00319400,GEORGE FOX UNIVERSITY                   ,OR,97132-2697,Private      ,51,75,126,3845,,2511,6356
00319600,LANE COMMUNITY COLLEGE                  ,OR,97405-0640,Public       ,212,680,892,7590,,14050,21640
00319700,LEWIS & CLARK COLLEGE                   ,OR,97219-7899,Private      ,51,74,125,6146,,3673,9819
00319800,LINFIELD COLLEGE                        ,OR,97128-6894,Private      ,51,58,109,3943,,1394,5337
00319801,LINFIELD COLLEGE - PORTLAND CAMPUS      ,OR,97210-0000,Private      ,22,54,76,871,,1450,2321
00319900,MARYLHURST UNIVERSITY                   ,OR,97036-7036,Private      ,9,103,112,175,,1915,2090
00320300,MOUNT ANGEL SEMINARY                    ,OR,97373-0505,Private      ,1,1,2,10,,21,31
00320400,MOUNT HOOD COMMUNITY COLLEGE            ,OR,97030-3300,Public       ,205,590,795,5830,,10887,16717
00320600,MULTNOMAH UNIVERSITY                    ,OR,97220-5898,Private      ,7,36,43,507,,992,1499
00320700,PACIFIC NORTHWEST COLLEGE OF ART        ,OR,97209-3023,Private      ,14,20,34,832,,951,1783
00320800,NORTHWEST CHRISTIAN UNIVERSITY          ,OR,97401-3727,Private      ,13,47,60,794,,1046,1840
00320900,WESTERN OREGON UNIVERSITY               ,OR,97361-1394,Public       ,119,92,211,8091,,3639,11730
00321000,OREGON STATE UNIVERSITY                 ,OR,97331-8507,Public       ,413,621,1034,28550,,16402,44952
00321100,OREGON INSTITUTE OF TECHNOLOGY          ,OR,97601-8801,Public       ,54,112,166,3345,,3101,6446
00321200,PACIFIC UNIVERSITY                      ,OR,97116-1797,Private      ,59,54,113,4329,,3473,7802
00321300,PORTLAND COMMUNITY COLLEGE              ,OR,97219-7198,Public       ,669,2140,2809,16941,,40765,57706
00321311,PORTLAND COMMUNITY COLLEGE - TILLAMOOK B,OR,97141-2599,Public       ,3,26,29,254,,487,741
00321600,PORTLAND STATE UNIVERSITY               ,OR,97207-0000,Public       ,405,938,1343,18357,,27966,46323
00321700,REED COLLEGE                            ,OR,97202-8199,Private      ,25,37,62,2912,,942,3854
00321800,CHEMEKETA COMMUNITY COLLEGE             ,OR,97309-1500,Public       ,223,635,858,7467,,14669,22136
00321900,SOUTHERN OREGON UNIVERSITY              ,OR,97520-5010,Public       ,93,175,268,6172,,4376,10548
00322000,SOUTHWESTERN OREGON COMMUNITY CLG       ,OR,97420-2956,Public       ,32,92,124,1824,,2030,3854
00322100,TREASURE VALLEY COMMUNITY COLLEGE       ,OR,97914-3423,Public       ,59,186,245,1754,,2940,4694
00322200,UMPQUA COMMUNITY COLLEGE                ,OR,97470-0226,Public       ,47,175,222,1401,,2917,4318
00322300,UNIVERSITY OF OREGON                    ,OR,97403-1226,Public       ,403,302,705,29640,,12160,41800
00322400,UNIVERSITY OF PORTLAND                  ,OR,97203-5798,Private      ,156,128,284,11550,,3798,15348
00322500,WARNER PACIFIC COLLEGE                  ,OR,97215-4099,Private      ,20,124,144,1203,,2308,3511
00322700,WILLAMETTE UNIVERSITY                   ,OR,97301-3930,Private      ,56,36,92,5924,,1787,7711
00487800,CLACKAMAS COMMUNITY COLLEGE             ,OR,97045-7998,Public       ,178,426,604,4609,,7330,11939
00488200,OREGON HEALTH & SCIENCE UNIVERSITY      ,OR,97239-0000,Public       ,26,109,135,1313,,4976,6289
00693800,LINN BENTON COMMUNITY COLLEGE           ,OR,97321-3774,Public       ,94,250,344,4398,,6268,10666
00717800,WESTERN SEMINARY                        ,OR,97215-0000,Private      ,1,37,38,24,,674,698
00723402,HEALD COLLEGE - PORTLAND                ,OR,97205-3432,Proprietary  ,39,179,218,429,,1701,2130
00732969,ITT TECHNICAL INSTITUTE                 ,OR,97220-6819,Proprietary  ,37,264,301,643,,2613,3256
00737101,MARINELLO SCHOOL OF BEAUTY - PORTLAND   ,OR,97212-3732,Proprietary  ,12,37,49,143,,374,517
00781900,ART INSTITUTE OF PORTLAND (THE)         ,OR,97209-2911,Proprietary  ,61,115,176,2052,,2409,4461
00888700,CONCORDE CAREER INSTITUTE               ,OR,97232-2242,Proprietary  ,40,149,189,510,,1527,2037
00907900,EVEREST COLLEGE                         ,OR,97204-2296,Proprietary  ,18,92,110,326,,1172,1498
00958100,SPRINGFIELD COLLEGE OF BEAUTY           ,OR,97477-5474,Proprietary  ,5,14,19,97,,204,301
01012200,PHAGANS' MEDFORD BEAUTY SCHOOL          ,OR,97504-5297,Proprietary  ,5,20,25,88,,279,367
01018200,ROGUE COMMUNITY COLLEGE                 ,OR,97527-0000,Public       ,121,454,575,3250,,7870,11120
01050700,ACADEMY OF HAIR DESIGN                  ,OR,97301-3526,Proprietary  ,1,17,18,102,,277,379
01230900,UNIVERSITY OF WESTERN STATES            ,OR,97230-3099,Private      ,3,28,31,106,,832,938
01234700,PHAGANS CENTRAL OREGON BEAUTY CLG       ,OR,97701-5175,Proprietary  ,14,25,39,140,,326,466
01234800,PHAGANS BEAUTY COLLEGE                  ,OR,97333-4716,Proprietary  ,3,16,19,85,,158,243
01235000,PHAGANS SCHOOL OF HAIR DESIGN           ,OR,97086-7721,Proprietary  ,10,17,27,102,,212,314
01235100,PHAGANS SCHOOL OF BEAUTY                ,OR,97301-4732,Proprietary  ,5,30,35,97,,342,439
01300800,PHAGANS TIGARD BEAUTY SCHOOL            ,OR,97223-0000,Proprietary  ,4,8,12,42,,103,145
02101000,NORTHWEST COLLEGE OF HAIR DESIGN        ,OR,97086-7702,Proprietary  ,29,64,93,327,,760,1087
02101002,NORTHWEST COLLEGE                       ,OR,97007-3954,Proprietary  ,4,8,12,59,,127,186
02104900,COLLEGE OF LEGAL ARTS                   ,OR,97219-9998,Proprietary  ,4,42,46,104,,598,702
02106100,COLLEGE OF COSMETOLOGY                  ,OR,97601-0000,Proprietary  ,4,7,11,67,,152,219
02154400,BEAU MONDE CLG OF HAIR DESIGN           ,OR,97205-0000,Proprietary  ,17,31,48,201,,426,627
02159700,NEW HOPE CHRISTIAN COLLEGE              ,OR,97405-1194,Private      ,7,13,20,340,,346,686
02201900,PHAGANS' SCHOOL OF HAIR DESIGN          ,OR,97232-0000,Proprietary  ,10,43,53,184,,527,711
02239203,ANTHEM COLLEGE - BEAVERTON              ,OR,97005-0000,Proprietary  ,19,73,92,185,,496,681
02311000,PAUL MITCHELL THE SCHOOL                ,OR,97205-3724,Proprietary  ,12,28,40,68,,129,197
02330100,PIONEER PACIFIC COLLEGE                 ,OR,97070-0000,Proprietary  ,35,102,137,357,,1241,1598
02330102,PIONEER PACIFIC COLLEGE                 ,OR,97403-0000,Proprietary  ,13,80,93,307,,1232,1539
02337900,COLLEGE OF HAIR DESIGN CAREERS          ,OR,97301-0000,Proprietary  ,2,12,14,105,,253,358
02344100,ROSEBURG BEAUTY COLLEGE                 ,OR,97470-0000,Proprietary  ,1,8,9,56,,165,221
02534000,NATIONAL COLLEGE OF NATURAL MEDICINE    ,OR,97201-0000,Private      ,2,24,26,102,,1113,1215
02578800,NORTHWEST NANNIES INSTITUTE             ,OR,97035-0000,Proprietary  ,2,2,4,33,,26,59
02603700,OREGON COL OF ORIENTAL MEDICINE         ,OR,97216-0000,Private      ,2,9,11,47,,551,598
02617506,EVEREST COLLEGE - EVEREST INSTITUTE     ,OR,97223-6581,Proprietary  ,19,74,93,158,,582,740
03007300,OREGON COLLEGE OF ART & CRAFT           ,OR,97225-6399,Private      ,11,20,31,340,,597,937
03022600,LE CORDON BLEU COLLEGE OF CULINARY ARTS ,OR,97205-2793,Proprietary  ,52,186,238,1030,,2072,3102
03042500,CARRINGTON COLLEGE                      ,OR,97232-1302,Proprietary  ,40,107,147,408,,1350,1758
03074400,PHAGANS NEWPORT ACAD CSMTLGY CAREER     ,OR,97365-4963,Proprietary  ,5,6,11,34,,89,123
03074500,EAST-WEST COLLEGE OF THE HEALING ARTS   ,OR,97232-2765,Proprietary  ,4,41,45,144,,625,769
03185300,PHAGANS GRANTS PASS COLLEGE OF BTY      ,OR,97527-0000,Proprietary  ,8,10,18,57,,161,218
03428300,KLAMATH COMMUNITY COLLEGE               ,OR,97603-7121,Public       ,22,110,132,734,,1788,2522
03642300,INSTITUTE OF TECHNOLOGY                 ,OR,97305-1373,Proprietary  ,10,58,68,207,,732,939
03668300,BIRTHINGWAY COLLEGE OF MIDWIFERY        ,OR,97266-4042,Private      ,0,15,15,46,,351,397
03783400,ABDILL CAREER COLLEGE                   ,OR,97504-7137,Proprietary  ,5,51,56,118,,511,629
04146500,PORTLAND ACTORS CONSERVATORY            ,OR,97201-2557,Private      ,1,10,11,79,,176,255
04151900,COLUMBIA GORGE COMMUNITY COLLEGE        ,OR,97058-3434,Public       ,19,94,113,535,,1145,1680
04167400,SAGE SCHOOL OF MASSAGE & HEALING ARTS   ,OR,97701-4082,Proprietary  ,4,17,21,48,,183,231
04171400,AVEDA INSTITUTE PORTLAND                ,OR,97209-3144,Proprietary  ,20,28,48,418,,669,1087
04194400,AMERICAN COLLEGE OF HEALTHCARE SCIENCES ,OR,97239-3719,Proprietary  ,6,150,156,223,,1179,1402
04194900,TILLAMOOK BAY COMMUNITY COLLEGE         ,OR,97141-2807,Public       ,5,26,31,56,,183,239
00137400,ALBERTUS MAGNUS COLLEGE                 ,CT,06511-1189,Private      ,14,125,139,1134,,1582,2716
00137403,ALBERTUS MAGNUS CLG-NEW DIMENSIONS      ,CT,06511-0000,Private      ,0,0,0,86,,816,902
00137800,CENTRAL CONNECTICUT STATE UNIV          ,CT,06050-2490,Public       ,130,174,304,10817,,5706,16523
00137900,CONNECTICUT COLLEGE                     ,CT,06320-4196,Private      ,15,9,24,3206,,249,3455
00138000,WESTERN CONNECTICUT STATE UNIV          ,CT,06810-6826,Public       ,78,63,141,6592,,2152,8744
00138500,FAIRFIELD UNIVERSITY                    ,CT,06430-0000,Private      ,58,59,117,7843,,1326,9169
00138700,HARTFORD SEMINARY                       ,CT,06105-0000,Private      ,2,6,8,24,,118,142
00138900,HOLY APOSTLES COLLEGE & SEMINARY        ,CT,06416-2027,Private      ,0,3,3,12,,83,95
00139200,MANCHESTER COMMUNITY COLLEGE            ,CT,06045-1046,Public       ,109,236,345,4462,,4886,9348
00139300,MITCHELL COLLEGE                        ,CT,06320-4498,Private      ,5,8,13,1058,,348,1406
00139700,UNIVERSITY OF NEW HAVEN                 ,CT,06516-1999,Private      ,103,76,179,10408,,2556,12964
00139800,NORTHWESTERN CT COMMUNITY COLLEGE       ,CT,06098-1747,Public       ,16,30,46,643,,864,1507
00139900,NORWALK COMMUNITY TECHNICAL COLLEGE     ,CT,06854-1655,Public       ,79,130,209,2862,,3524,6386
00140100,POST UNIVERSITY                         ,CT,06723-3240,Proprietary  ,132,1490,1622,2309,,13042,15351
00140200,QUINNIPIAC UNIVERSITY                   ,CT,06518-1908,Private      ,159,84,243,16960,,2950,19910
00140201,QUINNIPIAC UNIVERSITY SCHOOL OF LAW     ,CT,06518-0000,Private      ,3,7,10,78,,755,833
00140300,SACRED HEART UNIVERSITY                 ,CT,06825-1000,Private      ,71,166,237,8251,,3222,11473
00140600,SOUTHERN CONNECTICUT STATE UNIV         ,CT,06515-1355,Public       ,115,164,279,10277,,6113,16390
00140900,SAINT JOSEPH COLLEGE                    ,CT,06117-2791,Private      ,11,71,82,1306,,2119,3425
00141400,TRINITY COLLEGE                         ,CT,06106-3100,Private      ,27,7,34,3781,,431,4212
00141600,UNIVERSITY OF BRIDGEPORT                ,CT,06601-5650,Private      ,54,134,188,3803,,3958,7761
00141700,UNIVERSITY OF CONNECTICUT-STORRS        ,CT,06269-2151,Public       ,307,191,498,32266,,6699,38965
00141702,UNIV CONN STAMFORD                      ,CT,06901-0000,Public       ,11,28,39,1121,,786,1907
00141703,UNIV OF CONNECTICUT - TORINGTON         ,CT,06790-0000,Public       ,6,7,13,308,,170,478
00141706,UNIV OF CONNECTICUT SCH LAW             ,CT,06105-0000,Public       ,4,7,11,80,,1102,1182
00141707,UNIV OF CT - SCH OF SOCIAL WORK         ,CT,06117-0000,Public       ,2,20,22,197,,829,1026
00141708,UNIVERSITY OF CONNECTICUT - SCHOOL OF ME,CT,06030-1920,Public       ,2,6,8,182,,672,854
00141709,UNIVERSITY OF CONNECTICUT - SCHOOL OF DE,CT,06030-1920,Public       ,6,3,9,331,,406,737
00142200,UNIVERSITY OF HARTFORD                  ,CT,06117-1599,Private      ,131,76,207,11083,,2690,13773
00142400,WESLEYAN UNIVERSITY                     ,CT,06459-3208,Private      ,36,17,53,6005,,336,6341
00142500,EASTERN CONNECTICUT STATE UNIV          ,CT,06226-2295,Public       ,71,51,122,7488,,1670,9158
00142600,YALE UNIVERSITY                         ,CT,06520-8288,Private      ,124,110,234,19397,,8798,28195
00280301,RENSSELAER POLYTECHNIC INSTITUTE-RENSSEL,CT,06120-2991,Private      ,2,4,6,36,,50,86
00451300,HOUSATONIC COMMUNITY COLLEGE            ,CT,06604-4704,Public       ,71,153,224,3277,,5175,8452
00618100,BRIDGEPORT HOSP SCHL OF NURSING         ,CT,06610-2896,Private      ,7,21,28,223,,707,930
00619100,ST. VINCENT'S COLLEGE                   ,CT,06606-9966,Private      ,11,31,42,442,,1176,1618
00698200,NAUGATUCK VALLEY COMM-TECH COLG         ,CT,06708-3089,Public       ,92,214,306,3753,,4799,8552
00730000,ELI WHITNEY TECHNICAL HIGH SCHOOL       ,CT,06514-0000,Public       ,0,5,5,15,,107,122
00730300,LINCOLN TECHNICAL INSTITUTE             ,CT,06051-0000,Proprietary  ,50,151,201,629,,1431,2060
00730306,LINCOLN TECHNICAL INSTITUTE - EAST WINDS,CT,06088-9631,Proprietary  ,48,84,132,1009,,608,1617
00730500,PORTER AND CHESTER INSTITUTE OF BRANFORD,CT,06405-4022,Proprietary  ,32,66,98,289,,621,910
00731100,WINDHAM TECHNICAL HIGH SCHOOL           ,CT,06226-2100,Public       ,0,0,0,7,,15,22
00745900,PAIER COLLEGE OF ART                    ,CT,06514-3902,Proprietary  ,0,7,7,153,,90,243
00763500,CAPITAL COMMUNITY COLLEGE               ,CT,06103-1207,Public       ,55,171,226,2104,,5119,7223
00803700,GATEWAY COMMUNITY-TECHNICAL COLLEGE     ,CT,06511-0000,Public       ,124,256,380,4244,,6986,11230
00803800,MIDDLESEX COMMUNITY CLG                 ,CT,06457-4889,Public       ,45,88,133,1515,,2007,3522
00887300,PAUL MITCHELL THE SCHOOL                ,CT,06810-6716,Proprietary  ,7,8,15,127,,139,266
00887400,BRIO ACADEMY OF COSMETOLOGY             ,CT,06450-4836,Proprietary  ,8,18,26,53,,127,180
00887401,BRIO ACADEMY OF COSMETOLOGY - HAMDEN    ,CT,06514-4132,Proprietary  ,9,15,24,35,,122,157
00887402,BRIO ACADEMY OF COSMETOLOGY - FAIRFIELD ,CT,06824-6690,Proprietary  ,10,44,54,86,,235,321
00887403,BRIO ACADEMY OF COSMETOLOGY - WILLIMANTI,CT,06226-1940,Proprietary  ,5,31,36,41,,135,176
00887404,BRIO ACADEMY OF COSMETOLOGY -           ,CT,06605-4114,Proprietary  ,0,0,0,4,,19,23
00927700,E C GOODWIN TECHNICAL HIGH SCHOOL       ,CT,06053-0000,Public       ,1,5,6,31,,81,112
00940700,LINCOLN COLLEGE OF NEW ENGLAND          ,CT,06489-1057,Proprietary  ,18,41,59,637,,881,1518
00940701,CLEMENS COLLEGE                         ,CT,06078-0000,Proprietary  ,0,0,0,2,,1,3
00976400,TUNXIS COMMUNITY COLLEGE                ,CT,06032-3187,Public       ,55,91,146,2466,,2704,5170
00976500,THREE RIVERS COMMUNITY COLLEGE          ,CT,06360-6598,Public       ,52,155,207,2309,,3556,5865
00982200,ALBERT I PRINCE TECHNICAL HIGH SCHOOL   ,CT,06106-3799,Public       ,2,6,8,22,,159,181
01041700,BRIO ACADEMY OF EAST HARTFORD           ,CT,06108-2220,Proprietary  ,6,39,45,81,,238,319
01053000,QUINEBAUG VALLEY COMMUNITY COLLEGE      ,CT,06239-1440,Public       ,24,74,98,946,,1586,2532
01077900,PORTER AND CHESTER INSTITUTE-ALLCAMPUSES,CT,06615-7158,Proprietary  ,186,500,686,1788,,4106,5894
01115000,ASNUNTUCK COMMUNITY COLLEGE             ,CT,06082-3800,Public       ,24,74,98,722,,1059,1781
01149600,BULLARD HAVENS VOC TECH SCHOOL          ,CT,06610-3499,Public       ,5,7,12,38,,153,191
01169700,VINAL REGIONAL VOC TECH SCHOOL          ,CT,06457-4918,Public       ,2,7,9,14,,70,84
01184300,NORWICH TECHNICAL HIGH SCHOOL           ,CT,06360-7097,Public       ,0,4,4,15,,91,106
01242500,STONE ACADEMY                           ,CT,06516-4049,Proprietary  ,33,141,174,239,,978,1217
01242503,STONE ACADEMY -WATERBURY                ,CT,06705-3823,Proprietary  ,2,10,12,47,,173,220
01242504,STONE ACADEMY -  EAST HARTFORD          ,CT,06118-0000,Proprietary  ,4,13,17,70,,268,338
01287700,SANFORD-BROWN COLLEGE                   ,CT,06855-1436,Proprietary  ,1,2,3,47,,135,182
01291300,LEON INSTITUTE OF HAIR DESIGN           ,CT,06604-4226,Proprietary  ,0,1,1,9,,40,49
02074000,BRANFORD HALL CAREER INSTITUTE          ,CT,06405-0000,Proprietary  ,199,767,966,1139,,4344,5483
02106600,AMERICAN INSTITUTE                      ,CT,06110-1922,Proprietary  ,9,88,97,94,,576,670
02112300,RIDLEY LOWELL BUSINESS & TECH INST      ,CT,06320-0000,Proprietary  ,12,106,118,159,,890,1049
02112700,NORTH HAVEN ACADEMY                     ,CT,06473-3108,Proprietary  ,7,7,14,140,,116,256
02115100,BUTLER BUSINESS SCHOOL                  ,CT,06604-0000,Proprietary  ,0,0,0,1,,0,1
02148700,CONNECTICUT INST OF HAIR DESIGN         ,CT,06716-0000,Proprietary  ,1,3,4,28,,49,77
02202500,NEW ENGLAND TRACTOR TRAILER SCH         ,CT,06071-2036,Proprietary  ,40,422,462,165,,1589,1754
02244900,GOODWIN COLLEGE                         ,CT,06118-9980,Private      ,58,408,466,1355,,5670,7025
02245300,HOWELL CHENEY TECHNICAL HIGH SCHOOL     ,CT,06040-0000,Public       ,1,2,3,10,,22,32
02265900,WINDHAM COMMUNITY MEM HOSP-RAD TECH     ,CT,06226-0000,Private      ,0,1,1,13,,29,42
02296100,YALE-NEW HAVEN HOSP DIETETIC INTERN     ,CT,06510-8900,Private      ,0,3,3,34,,48,82
02300000,W F KAYNOR TECHNICAL HIGH SCHOOL        ,CT,06708-0000,Public       ,1,5,6,26,,126,152
02316600,CONNECTICUT CTR FOR MASSAGE THERAPY     ,CT,06111-3975,Proprietary  ,16,53,69,78,,235,313
02316601,CONNECTICUT CENTER FOR MASSAGE THERAPY -,CT,06880-4619,Proprietary  ,5,29,34,48,,189,237
02316603,CONNECTICUT CENTER FOR MASSAGE THERAPY -,CT,06340-4619,Proprietary  ,5,28,33,43,,154,197
02565000,PLATT TECHNICAL HIGH SCHOOL             ,CT,06460-2105,Public       ,0,1,1,14,,44,58
03079400,LYME ACADEMY COLLEGE OF FINE ARTS       ,CT,06371-2333,Private      ,0,0,0,99,,32,131
03094800,INDUSTRIAL MANAGEMENT & TRAINING        ,CT,06706-1211,Proprietary  ,7,15,22,71,,182,253
03234300,CHARTER OAK STATE COLLEGE               ,CT,06053-2150,Public       ,8,145,153,166,,2163,2329
03316300,LINCOLN TECHNICAL INSTITUTE - HARTFORD  ,CT,06105-3630,Proprietary  ,21,73,94,558,,686,1244
03381300,CONNECTICUT TRAINING CENTER             ,CT,06108-2705,Private      ,0,0,0,1,,20,21
03927300,ALBERT SCHOOL (THE)                     ,CT,06357-2447,Proprietary  ,0,14,14,31,,108,139
03927301,BRIO ACADEMY OF COSMETOLOGY - TORRINGTON,CT,06790-5425,Proprietary  ,4,8,12,28,,55,83
03927302,BRIO ACADEMY OF COSMETOLOGY  -  ENFIELD ,CT,06082-2946,Proprietary  ,5,6,11,40,,66,106
04104300,ACADEMY DI CAPELLI - SCHOOL OF COSMETOLO,CT,06492-0000,Proprietary  ,9,19,28,70,,116,186
04128800,BRANFORD ACADEMY OF HAIR & COSMETOLOGY  ,CT,06405-0000,Proprietary  ,1,9,10,27,,84,111
04145400,OXFORD ACADEMY OF HAIR DESIGN           ,CT,06483-2911,Proprietary  ,7,2,9,57,,71,128
04148400,EUROPEAN ACADEMY OF COSMETOLOGY AND HAIR,CT,06437-0000,Proprietary  ,0,2,2,21,,25,46
04152400,INTERNATIONAL INSTITUTE OF COSMETOLOGY  ,CT,06109-0000,Proprietary  ,8,14,22,129,,103,232
04162900,TONSORIAL ACADEMY OF COSMETOLOGY AND BAR,CT,06516-0000,Proprietary  ,0,0,0,4,,7,11
04219200,ACE COSMETOLOGY & BARBERING TRAINING CEN,CT,06716-0000,Proprietary  ,4,3,7,14,,29,43
04224200,BELLE ACADEMY OF COSMETOLOGY            ,CT,06704-0135,Proprietary  ,5,17,22,19,,60,79
04230900,RICCI'S ACADEMY OF COSMETOLOGY          ,CT,06470-0000,Proprietary  ,8,2,10,17,,14,31
00146600,BARRY UNIVERSITY                        ,FL,33161-6695,Private      ,182,291,473,6644,,10429,17073
00146601,BARRY UNIVERSITY - ORLANDO              ,FL,32807-3673,Private      ,22,55,77,488,,2354,2842
00146700,BETHUNE COOKMAN UNIVERSITY              ,FL,32114-3099,Private      ,290,95,385,8607,,2518,11125
00146800,ST THOMAS UNIVERSITY                    ,FL,33054-0000,Private      ,65,89,154,1975,,3205,5180
00146900,FLORIDA INSTITUTE OF TECHNOLOGY         ,FL,32901-6988,Private      ,120,736,856,5258,,9845,15103
00147000,BREVARD COMMUNITY COLLEGE               ,FL,32922-6503,Public       ,240,568,808,7229,,12000,19229
00147100,COLLEGE OF CENTRAL FLORIDA              ,FL,34474-4415,Public       ,123,318,441,5207,,8968,14175
00147200,CHIPOLA  COLLEGE                        ,FL,32446-2053,Public       ,35,59,94,1229,,1665,2894
00147300,CLEARWATER CHRISTIAN COLLEGE            ,FL,33759-0000,Private      ,6,11,17,836,,246,1082
00147500,DAYTONA STATE COLLEGE                   ,FL,32114-2800,Public       ,291,817,1108,9396,,15315,24711
00147700,EDISON STATE COLLEGE                    ,FL,33906-6210,Public       ,257,469,726,9285,,11877,21162
00147800,EDWARD WATERS COLLEGE                   ,FL,32209-6199,Private      ,35,68,103,1514,,1228,2742
00147900,EMBRY-RIDDLE AERONAUTICAL UNIV          ,FL,32114-3900,Private      ,109,932,1041,7950,,10792,18742
00148000,FLORIDA A & M UNIVERSITY                ,FL,32307-3100,Public       ,592,240,832,17176,,9429,26605
00148100,FLORIDA ATLANTIC UNIVERSITY             ,FL,33431-6498,Public       ,1160,600,1760,32043,,20338,52381
00148101,FLORIDA ATLANTIC UNIVERSITY/DAVIE       ,FL,33314-0000,Public       ,99,225,324,3355,,5987,9342
00148103,FLORIDA ATLANTIC UNIV-JUPITER/PSL       ,FL,33458-0000,Public       ,57,61,118,1683,,1718,3401
00148200,FLORIDA COLLEGE                         ,FL,33617-5578,Private      ,6,4,10,619,,138,757
00148400,FLORIDA STATE COLLEGE AT JACKSONVILLE   ,FL,32202-4030,Public       ,574,1762,2336,15741,,31453,47194
00148500,FLORIDA KEYS COMMUNITY COLLEGE          ,FL,33040-4397,Public       ,31,42,73,803,,987,1790
00148600,FLORIDA MEMORIAL UNIVERSITY             ,FL,33054-6199,Private      ,102,69,171,3384,,1837,5221
00148700,ECKERD COLLEGE                          ,FL,33711-4744,Private      ,41,62,103,3433,,1332,4765
00148800,FLORIDA SOUTHERN COLLEGE                ,FL,33801-5698,Private      ,57,93,150,4658,,1779,6437
00148900,FLORIDA STATE UNIVERSITY                ,FL,32306-2430,Public       ,2145,582,2727,58140,,21036,79176
00149000,GULF COAST STATE COLLEGE                ,FL,32401-1058,Public       ,93,218,311,3062,,5957,9019
00149300,INDIAN RIVER STATE COLLEGE              ,FL,34981-5596,Public       ,235,516,751,8183,,12318,20501
00149500,JACKSONVILLE UNIVERSITY                 ,FL,32211-3394,Private      ,104,309,413,4469,,5326,9795
00149700,JONES COLLEGE                           ,FL,32211-5588,Private      ,9,52,61,165,,1111,1276
00149900,EVEREST UNIVERSITY                      ,FL,32810-5601,Proprietary  ,41,250,291,758,,4509,5267
00149901,EVEREST UNIVERSITY - ORLANDO SOUTH      ,FL,32819-7666,Proprietary  ,494,4467,4961,4344,,46939,51283
00149902,EVEREST UNIVERSITY - MELBOURNE          ,FL,32905-6609,Proprietary  ,17,111,128,216,,1438,1654
00149904,EVEREST UNIVERSITY - TAMPA              ,FL,33614-5801,Proprietary  ,37,293,330,669,,4914,5583
00149905,EVEREST UNIVERSITY - BRANDON            ,FL,33619-1354,Proprietary  ,36,415,451,650,,8012,8662
00149906,EVEREST UNIVERSITY - ORANGE PARK        ,FL,32073-1111,Proprietary  ,16,143,159,172,,1349,1521
00149907,EVEREST UNIVERSITY - LARGO              ,FL,33770-2556,Proprietary  ,10,95,105,159,,1027,1186
00149908,EVEREST UNIVERSITY - LAKELAND           ,FL,33801-3801,Proprietary  ,14,111,125,218,,1445,1663
00149909,EVEREST UNIVERSITY - JACKSONVILLE       ,FL,32256-0000,Proprietary  ,19,171,190,362,,2214,2576
00149910,EVEREST UNIVERSITY - POMPANO            ,FL,33062-2522,Proprietary  ,47,312,359,482,,4517,4999
00149913,EVEREST INSTITUTE - MIAMI               ,FL,33169-4759,Proprietary  ,28,129,157,349,,1465,1814
00149914,EVEREST INSTITUTE - KENDALL             ,FL,33186-1410,Proprietary  ,15,70,85,345,,1076,1421
00150000,BROWARD COLLEGE- DOWNTOWN CTR           ,FL,33301-2298,Public       ,330,950,1280,8752,,16449,25201
00150001,BROWARD COLLEGE - DAVIE CAMPUS          ,FL,33314-0000,Public       ,340,628,968,13133,,15187,28320
00150002,BROWARD COLLEGE- NORTH CAMPUS           ,FL,33066-0000,Public       ,212,499,711,8157,,12815,20972
00150003,BROWARD COLLEGE- SOUTH CAMPUS           ,FL,33024-0000,Public       ,269,521,790,9348,,12420,21768
00150100,FLORIDA GATEWAY COLLEGE                 ,FL,32025-2007,Public       ,39,138,177,1493,,3059,4552
00150200,LAKE SUMTER COMMUNITY COLLEGE           ,FL,34788-8751,Public       ,71,153,224,2899,,3477,6376
00150400,"STATE COLLEGE OF FLORIDA, MANATEE-SARASO",FL,34207-3596,Public       ,128,291,419,6041,,8369,14410
00150500,LYNN UNIVERSITY                         ,FL,33431-5598,Private      ,69,70,139,2779,,1331,4110
00150600,MIAMI DADE COLLEGE ADMINISTRATION ONLY  ,FL,33176-3393,Public       ,33,67,100,759,,1069,1828
00150601,MIAMI DADE COLLEGE - NORTH CAMPUS       ,FL,33167-3495,Public       ,626,963,1589,16092,,19525,35617
00150602,MIAMI DADE COLLEGE - KENDALL CAMPUS     ,FL,33176-3393,Public       ,718,984,1702,22303,,18898,41201
00150603,MIAMI DADE COLLEGE - WOLFSON CAMPUS     ,FL,33132-2297,Public       ,502,745,1247,12915,,13915,26830
00150604,MIAMI DADE COLLEGE - MEDICAL CAMPUS     ,FL,33127-4693,Public       ,160,355,515,4267,,8480,12747
00150605,MIAMI DADE COLLEGE - HOMESTEAD CAMPUS   ,FL,33030-6009,Public       ,126,257,383,3499,,4520,8019
00150606,MIAMI DADE COLLEGE -INTERAMERICAN CAMPUS,FL,33135-0000,Public       ,213,501,714,4899,,8670,13569
00150607,MIAMI DADE COLLEGE - HIALEAH CAMPUS     ,FL,33012-2918,Public       ,192,275,467,4792,,5822,10614
00150800,NORTH FLORIDA COMMUNITY COLLEGE         ,FL,32340-1699,Public       ,20,34,54,664,,1033,1697
00150900,NOVA SOUTHEASTERN UNIVERSITY            ,FL,33314-7796,Private      ,210,1074,1284,8008,,33496,41504
00151000,NORTHWEST FLORIDA STATE COLLEGE         ,FL,32578-1295,Public       ,81,258,339,2651,,5807,8458
00151200,PALM BEACH COMMUNITY COLLEGE            ,FL,33461-4796,Public       ,502,913,1415,16791,,19452,36243
00151300,PENSACOLA STATE COLLEGE                 ,FL,32504-8998,Public       ,173,605,778,5658,,11291,16949
00151400,POLK STATE COLLEGE                      ,FL,33881-4256,Public       ,161,374,535,6070,,9808,15878
00151500,ROLLINS COLLEGE                         ,FL,32789-4499,Private      ,89,58,147,3754,,1620,5374
00151900,SANTA FE COLLEGE                        ,FL,32606-6200,Public       ,291,450,741,11454,,11091,22545
00152000,SEMINOLE STATE COLLEGE OF FLORIDA       ,FL,32773-6199,Public       ,338,736,1074,11491,,16996,28487
00152100,SOUTHEASTERN UNIVERSITY                 ,FL,33801-6099,Private      ,64,94,158,3852,,2045,5897
00152200,SOUTH FLORIDA COMMUNITY COLLEGE         ,FL,33825-9399,Public       ,51,83,134,1617,,2420,4037
00152300,SAINT JOHNS RIVER STATE COLLEGE         ,FL,32177-3897,Public       ,89,215,304,3424,,5343,8767
00152600,SAINT LEO UNIVERSITY                    ,FL,33574-6665,Private      ,139,1189,1328,4491,,18505,22996
00152800,ST. PETERSBURG COLLEGE                  ,FL,33760-3768,Public       ,359,1167,1526,12319,,27947,40266
00153100,STETSON UNIVERSITY                      ,FL,32723-3761,Private      ,161,45,206,7187,,1177,8364
00153101,STETSON UNIVERSITY - COLLEGE OF LAW     ,FL,33707-3299,Private      ,4,21,25,150,,1844,1994
00153300,TALLAHASSEE COMMUNITY COLLEGE           ,FL,32304-2895,Public       ,353,419,772,12217,,11003,23220
00153500,UNIVERSITY OF FLORIDA                   ,FL,32611-3150,Public       ,1593,704,2297,55522,,23514,79036
00153600,UNIVERSITY OF MIAMI                     ,FL,33146-6531,Private      ,473,245,718,24807,,7537,32344
00153601,UNIV OF MIAMI SCHOOL OF LAW             ,FL,33124-0000,Private      ,10,23,33,214,,2400,2614
00153602,UNIV OF MIAMI-SCH OF MEDICINE           ,FL,33136-0000,Private      ,49,51,100,1237,,2176,3413
00153700,UNIVERSITY OF SOUTH FLORIDA             ,FL,33620-6960,Public       ,1523,775,2298,48551,,29170,77721
00153701,UNIV OF SOUTH FLORIDA-ST PETERSBURG     ,FL,33701-0000,Public       ,200,150,350,5882,,4783,10665
00153702,UNIV OF SOUTH FLORIDA-SARASOTA          ,FL,34243-2025,Public       ,31,72,103,1470,,2367,3837
00153705,UNIV OF SOUTH FLORIDA                   ,FL,33803-0000,Public       ,43,69,112,1429,,1730,3159
00153706,UNIV OF SOUTH FLORIDA- MEDICINE         ,FL,33612-0000,Public       ,79,49,128,2033,,2676,4709
00153800,UNIVERSITY OF TAMPA                     ,FL,33606-1490,Private      ,291,149,440,13937,,4424,18361
00154000,WEBBER INTERNATIONAL UNIVERSITY         ,FL,33827-0096,Private      ,15,12,27,1511,,459,1970
00173308,NATIONAL-LOUIS UNIVERSITY               ,FL,33609-0000,Private      ,1,9,10,22,,150,172
00177201,TRINITY INTERNATIONAL UNIVERSITY - SOUTH,FL,33324-4611,Private      ,6,39,45,112,,651,763
00395400,UNIV OF CENTRAL FLORIDA                 ,FL,32816-0001,Public       ,2917,1050,3967,75494,,37461,112955
00395500,UNIVERSITY OF WEST FLORIDA              ,FL,32514-5750,Public       ,312,388,700,11977,,9488,21465
00407215,NORTHWOOD UNIVERSITY                    ,FL,33409-0000,Private      ,19,34,53,749,,638,1387
00491004,KAPLAN CAREER INSTITUTE - KAPLAN COLLEGE,FL,33026-3978,Proprietary  ,0,0,0,54,,473,527
00491005,KAPLAN COLLEGE JACKSONVILLE             ,FL,32216-3216,Proprietary  ,24,291,315,271,,3613,3884
00558500,LIVELY TECHNICAL CENTER                 ,FL,32304-0000,Public       ,20,85,105,811,,2554,3365
00558600,LINDSEY HOPKINS TECHNICAL ED CENTER     ,FL,33127-4692,Public       ,19,117,136,369,,1325,1694
00559400,D G ERWIN TECHNICAL CENTER              ,FL,33610-8255,Public       ,46,176,222,782,,2762,3544
00560500,PINELLAS TECH ED CTR-CLEARWATER         ,FL,33760-2194,Public       ,29,138,167,457,,1848,2305
00560700,SARASOTA COUNTY TECHNICAL INSTITUTE     ,FL,34233-0000,Public       ,25,57,82,419,,1146,1565
00560800,MAYNARD A. TRAVISS CAREER CENTER        ,FL,33803-9709,Public       ,15,79,94,462,,1509,1971
00561200,MANATEE TECHNICAL INSTITUTE             ,FL,34210-0000,Public       ,33,122,155,632,,1744,2376
00561201,MANATEE TECHNICAL INSTITUTE-EAST        ,FL,34211-0000,Public       ,7,41,48,380,,1127,1507
00675000,VALENCIA COMMUNITY COLLEGE              ,FL,32802-3028,Public       ,1682,1503,3185,36008,,34967,70975
00732910,ITT TECHNICAL INSTITUTE                 ,FL,33634-7515,Proprietary  ,125,607,732,1173,,4971,6144
00732947,ITT TECHNICAL INSTITUTE                 ,FL,32746-1607,Proprietary  ,76,413,489,766,,3220,3986
00736206,MEDTECH COLLEGE - MEDTECH INSTITUTE - OR,FL,32826-4906,Proprietary  ,18,105,123,209,,954,1163
00752500,SUWANNEE-HAMILTON AREA VOC TECH CTR     ,FL,32060-0000,Public       ,3,26,29,97,,364,461
00752600,WASHINGTON HOLMES TECHNICAL CENTER      ,FL,32428-1699,Public       ,21,35,56,227,,586,813
00755800,LEE COUNTY HIGH TECH CENTER CENTRAL     ,FL,33916-2299,Public       ,26,64,90,564,,1480,2044
00787000,HILLSBOROUGH COMMUNITY COLLEGE          ,FL,33606-3572,Public       ,437,1077,1514,18371,,26901,45272
00789300,FLAGLER COLLEGE                         ,FL,32085-1027,Private      ,88,27,115,5271,,1173,6444
00789301,FLAGLER COLLEGE - TALLAHASSEE COMMUNITY ,FL,32304-2895,Private      ,11,48,59,555,,1114,1669
00807500,ST JOHN VIANNEY COLLEGE SEMINARY        ,FL,33165-3244,Private      ,1,0,1,42,,29,71
00822300,ST VINCENT DE PAUL REGIONL SEMINARY     ,FL,33436-0000,Private      ,0,0,0,6,,25,31
00841700,STENOTYPE INST OF JACKSONVILLE          ,FL,32207-0000,Proprietary  ,2,32,34,48,,467,515
00869410,RASMUSSEN COLLEGE - OCALA               ,FL,34471-7051,Proprietary  ,70,614,684,895,,7526,8421
00869411,RASMUSSEN COLLEGE - NEW PORT RICHEY     ,FL,34690-4554,Proprietary  ,18,103,121,260,,1497,1757
00869413,RASMUSSEN COLLEGE - FORT MYERS          ,FL,33905-7805,Proprietary  ,26,100,126,472,,1887,2359
00869420,RASMUSSEN COLLEGE - TAMPA               ,FL,33610-9558,Proprietary  ,19,98,117,255,,1407,1662
00869422,RASMUSSEN COLLEGE - PASCO               ,FL,33558-0000,Proprietary  ,8,41,49,111,,513,624
00884800,WARNER UNIVERSITY                       ,FL,33859-8725,Private      ,28,43,71,1073,,1026,2099
00884900,PALM BEACH ATLANTIC UNIVERSITY          ,FL,33401-6505,Private      ,73,114,187,3938,,3230,7168
00887800,MIAMI INTERNATIONAL UNIV ART&DESIGN     ,FL,33132-1418,Proprietary  ,120,184,304,3121,,3073,6194
00910400,TONI & GUY HAIRDRESSING ACADEMY         ,FL,32256-3810,Proprietary  ,2,7,9,56,,148,204
00963500,FLORIDA INTERNATIONAL UNIVERSITY        ,FL,33199-0001,Public       ,1842,1039,2881,45636,,35847,81483
00984100,UNIVERSITY OF NORTH FLORIDA             ,FL,32224-2645,Public       ,808,402,1210,18922,,11929,30851
00990200,SHERIDAN TECHNICAL CENTER               ,FL,33021-3399,Public       ,46,246,292,932,,3048,3980
01016100,"LORAINE'S ACADEMY, INC                  ",FL,33710-0000,Proprietary  ,9,39,48,66,,357,423
01019500,ART INSTITUTE OF FT LAUDERDALE          ,FL,33316-3000,Proprietary  ,102,150,252,2274,,2592,4866
01065200,PASCO-HERNANDO COMMUNITY CLG            ,FL,34654-5199,Public       ,191,455,646,5873,,8765,14638
01072401,CARLOS ALBIZU UNIVERSITY                ,FL,33172-0000,Private      ,4,65,69,147,,1398,1545
01082600,TOM P. HANEY TECHNICAL CENTER           ,FL,32405-5099,Public       ,18,68,86,324,,1488,1812
01112700,GOODING INST OF NUR ANES BAY MED CT     ,FL,32401-0000,Proprietary  ,1,3,4,36,,171,207
01226300,ATLANTIC TECHNICAL CENTER               ,FL,33063-3902,Public       ,35,118,153,705,,2014,2719
01246117,LINCOLN COLLEGE OF TECHNOLOGY - WEST PAL,FL,33407-3105,Proprietary  ,56,87,143,465,,933,1398
01254400,FIRST COAST TECHNICAL COLLEGE           ,FL,32084-1921,Public       ,31,90,121,488,,1396,1884
01257400,RINGLING SCHOOL OF ART AND DESIGN       ,FL,34234-5895,Private      ,35,10,45,2241,,475,2716
01303904,SOUTH UNIVERSITY - WEST PALM BEACH CAMPU,FL,33409-5149,Proprietary  ,33,197,230,658,,2473,3131
01323400,LORENZO WALKER INST OF TECHNOLOGY       ,FL,34104-4405,Public       ,15,41,56,384,,834,1218
02089600,CONCORDE CAREER INSTITUTE               ,FL,32211-0000,Proprietary  ,40,198,238,374,,2097,2471
02106602,AMERICAN INSTITUTE - AMERICAN INSTITUTE ,FL,34747-5161,Proprietary  ,0,0,0,2,,17,19
02113609,AMERICAN INTERCONTINENTAL UNIV - WESTON ,FL,33326-3233,Proprietary  ,1,24,25,100,,528,628
02115300,PINELLAS TECHNICAL EDUCATION CENTERS - S,FL,33711-0000,Public       ,47,198,245,574,,2673,3247
02116006,SANFORD-BROWN INSTITUTE - FT. LAUDERDALE,FL,33309-1906,Proprietary  ,12,54,66,268,,879,1147
02121801,EVEREST INSTITUTE  - HIALEAH            ,FL,33012-7193,Proprietary  ,0,0,0,46,,99,145
02148200,FASHION FOCUS HAIR ACADEMY              ,FL,34231-0000,Proprietary  ,3,8,11,47,,126,173
02148300,MANHATTAN BEAUTY SCHOOL                 ,FL,33611-0000,Proprietary  ,4,41,45,148,,578,726
02149900,PAUL MITCHELL THE SCHOOL-JACKSONVILLE   ,FL,32205-0000,Proprietary  ,7,28,35,225,,490,715
02151900,KEISER  UNIVERSITY                      ,FL,33309-0000,Private      ,432,2107,2539,5737,,24047,29784
02156700,FLORIDA CHRISTIAN COLLEGE               ,FL,34744-0000,Private      ,7,17,24,457,,374,831
02159600,BAPTIST COLLEGE OF FLORIDA (THE)        ,FL,32440-0000,Private      ,6,9,15,349,,354,703
02172700,CONCORDE CAREER INSTITUTE               ,FL,33607-0000,Proprietary  ,20,83,103,255,,1182,1437
02188900,HOBE SOUND BIBLE COLLEGE                ,FL,33475-0000,Private      ,3,9,12,78,,129,207
02200100,BRADENTON BEAUTY & BARBER ACADEMY       ,FL,34209-0000,Proprietary  ,8,26,34,66,,224,290
02218700,FLORIDA TECHNICAL COLLEGE               ,FL,32826-2707,Proprietary  ,144,562,706,1445,,4734,6179
02218707,FLORIDA TECHNICAL COLLEGE - LAKELAND    ,FL,33813-2101,Proprietary  ,8,44,52,167,,680,847
02218709,FLORIDA TECHNICAL COLLEGE - DELAND      ,FL,32720-7415,Proprietary  ,26,157,183,251,,1309,1560
02228300,LAKE TECHNICAL CENTER                   ,FL,32726-0000,Public       ,31,98,129,551,,1713,2264
02245500,FORTIS COLLEGE                          ,FL,32789-4679,Proprietary  ,14,55,69,130,,853,983
02257900,INTERNATIONAL ACADEMY                   ,FL,32119-3541,Proprietary  ,7,33,40,95,,386,481
02275100,CONCORDE CAREER INSTITUTE               ,FL,33025-0000,Proprietary  ,28,98,126,211,,752,963
02278800,SOUTHWEST FLORIDA COLLEGE               ,FL,33907-0000,Proprietary  ,39,163,202,613,,2195,2808
02278801,SOUTHWEST FLORIDA COLLEGE - TAMPA       ,FL,33619-1344,Proprietary  ,15,79,94,504,,1277,1781
02278802,SOUTHWEST FLORIDA COLLEGE - INSTITUTUE O,FL,33928-9469,Proprietary  ,4,8,12,56,,156,212
02278803,SOUTHWEST FLORIDA COLLEGE - PORT CHARLOT,FL,33953-3100,Proprietary  ,13,61,74,177,,806,983
02279600,CORTIVA INSTITUTE - FLORIDA             ,FL,33781-0000,Proprietary  ,8,29,37,58,,210,268
02283800,BEAUTY SCHOOLS OF AMERICA               ,FL,33012-3322,Proprietary  ,96,445,541,624,,3241,3865
02287100,LA BELLE BEAUTY SCHOOL                  ,FL,33012-3224,Proprietary  ,4,46,50,46,,247,293
02293200,ATI CAREER TRAINING CENTER              ,FL,33309-5916,Proprietary  ,0,0,0,4,,7,11
02293201,ATI CAREER TRAINING CENTER - MIAMI      ,FL,33122-1707,Proprietary  ,0,0,0,7,,18,25
02293202,ATI CAREER TAINING CENTER - ATI COLLEGE ,FL,87109-2016,Proprietary  ,0,0,0,9,,20,29
02293600,ADVANCED TECHNICAL CENTERS              ,FL,33266-1597,Private      ,0,9,9,60,,147,207
02297000,CHARLOTTE TECHNICAL CENTER              ,FL,33948-0000,Public       ,5,21,26,236,,623,859
02300900,WITHLACOOCHEE TECHNICAL INSTITUTE       ,FL,34450-0000,Public       ,3,29,32,263,,799,1062
02305700,FORTIS COLLEGE                          ,FL,33619-1283,Proprietary  ,0,2,2,88,,450,538
02305800,FLORIDA CAREER COLLEGE                  ,FL,33012-7028,Proprietary  ,258,1369,1627,1812,,7808,9620
02305810,FLORIDA CAREER COLLEGE - CLEARWATER     ,FL,33759-3924,Proprietary  ,3,22,25,116,,420,536
02307400,GEORGE STONE AREA VOCATIONAL TECHNICAL  ,FL,32526-0000,Public       ,28,104,132,402,,1730,2132
02314100,SCHILLER INTERNATIONAL UNIVERSITY       ,FL,33770-0000,Proprietary  ,4,42,46,86,,425,511
02316200,MIAMI LAKES TECHNICAL EDUCATION CTR     ,FL,33014-0000,Public       ,54,170,224,515,,1639,2154
02321200,ORANGE TECH EDUC CTR- WESTSIDE TECH     ,FL,34787-0000,Public       ,32,82,114,359,,933,1292
02325100,KEY COLLEGE                             ,FL,33004-3046,Proprietary  ,4,8,12,22,,87,109
02326303,MEDVANCE INSTITUTE - WEST PALM          ,FL,33461-2171,Proprietary  ,15,54,69,154,,484,638
02326306,MEDVANCE INSTITUTE - MIAMI              ,FL,33173-3431,Proprietary  ,3,9,12,85,,308,393
02326800,MERIDIAN COLLEGE                        ,FL,34240-8478,Proprietary  ,6,35,41,86,,349,435
02326900,SUNSTATE ACADEMY OF HAIR DESIGN         ,FL,33907-1415,Proprietary  ,12,63,75,214,,569,783
02329900,FLORIDA INSTITUTE OF ULTRASOUND         ,FL,32514-0000,Proprietary  ,5,18,23,126,,523,649
02338400,FT PIERCE BEAUTY ACADEMY                ,FL,34982-0000,Proprietary  ,13,69,82,101,,424,525
02346200,WYOTECH                                 ,FL,32174-1010,Proprietary  ,33,96,129,442,,1034,1476
02362100,FULL SAIL UNIVERSITY                    ,FL,32792-0000,Proprietary  ,885,2362,3247,16190,,29324,45514
02499000,ACADEMY OF COSMETOLOGY                  ,FL,32953-3311,Proprietary  ,7,28,35,89,,258,347
02501500,"O*TEC, MID-FLORIDA TECH                 ",FL,32809-0000,Public       ,41,135,176,662,,1948,2610
02502700,UEI (UNITED EDUCATION INSTITUTE)        ,FL,32207-5627,Proprietary  ,4,18,22,149,,637,786
02502702,ADVANCED CAREER TRAINING-JACKSONVIL     ,FL,32256-0000,Proprietary  ,0,0,0,104,,419,523
02504600,WINTER PARK TECH                        ,FL,32789-0000,Public       ,12,78,90,200,,880,1080
02508900,TALMUDIC COLLEGE OF FLORIDA             ,FL,33139-0000,Private      ,2,2,4,40,,24,64
02511700,RIDGE TECHNICAL CENTER                  ,FL,33881-0000,Public       ,32,58,90,478,,1292,1770
02513200,ORLANDO TECHNICAL CENTER                ,FL,32801-0000,Public       ,29,122,151,647,,1989,2636
02515400,CITY COLLEGE                            ,FL,33309-3073,Private      ,46,218,264,573,,2637,3210
02517100,SARASOTA SCHOOL OF MASSAGE THERAPY      ,FL,34243-6130,Proprietary  ,3,28,31,37,,207,244
02524000,SUNSTATE ACADEMY OF HAIR DESIGN         ,FL,34624-0000,Proprietary  ,10,37,47,105,,319,424
02524200,ROBERT MORGAN EDUCATIONAL CENTER        ,FL,33177-0000,Public       ,30,84,114,560,,1265,1825
02531803,PAUL MITCHELL THE SCHOOL - ORLANDO      ,FL,32765-6444,Proprietary  ,13,25,38,136,,223,359
02531805,PAUL MITCHELL THE SCHOOL -TAMPA         ,FL,33613-0000,Proprietary  ,9,27,36,163,,273,436
02547600,FLORIDA NATIONAL COLLEGE                ,FL,33012-0000,Proprietary  ,54,198,252,832,,2924,3756
02547601,FLORIDA NATIONAL UNIVERSITY - SOUTH CAMP,FL,33175-2478,Proprietary  ,60,206,266,119,,404,523
02547602,FLORIDA NATIONAL UNIVERSITY - TRAINING A,FL,33012-4108,Proprietary  ,15,33,48,32,,84,116
02554200,RADFORD LOCKLIN TECH CENTER             ,FL,32570-0000,Public       ,6,25,31,111,,378,489
02573200,LA BELLE BEAUTY ACADEMY                 ,FL,33135-0000,Proprietary  ,14,71,85,104,,419,523
02597100,HERITAGE INSTITUTE                      ,FL,33912-7132,Proprietary  ,52,153,205,436,,1210,1646
02598200,SOUTHERN CAREER COLLEGE                 ,FL,32211-0000,Proprietary  ,4,36,40,76,,396,472
02601600,HENRY W BREWSTER TECHNICAL CENTER       ,FL,33602-0000,Public       ,15,69,84,201,,938,1139
02612700,"SALON PROFESSIONAL ACADEMY - MELBOURNE, ",FL,32904-3919,Proprietary  ,1,17,18,71,,231,302
02616400,SANFORD-BROWN INSTITUTE                 ,FL,32256-3520,Proprietary  ,13,69,82,212,,946,1158
02616401,SANFORD-BROWN INSTITUTE - TAMPA         ,FL,33610-8304,Proprietary  ,9,59,68,181,,763,944
02616705,LE CORDON BLEU COLLEGE OF CULINARY ARTS ,FL,33025-3929,Proprietary  ,22,34,56,432,,625,1057
03003600,MCFATTER TECHNICAL CENTER               ,FL,33317-7499,Public       ,39,135,174,677,,1682,2359
03008600,FLORIDA COLLEGE OF NATURAL HEALTH       ,FL,33064-1342,Proprietary  ,33,137,170,287,,983,1270
03010608,VIRGINIA COLLEGE - PENSACOLA            ,FL,32501-5650,Proprietary  ,12,62,74,213,,1348,1561
03010612,VIRGINIA COLLEGE - GOLF ACADEMY OF AMERI,FL,32701-0000,Proprietary  ,0,7,7,63,,117,180
03010618,VIRGINIA COLLEGE - JACKSONVILLE         ,FL,32207-5167,Proprietary  ,6,59,65,192,,995,1187
03012300,ASM BEAUTY WORLD ACADEMY                ,FL,33021-0000,Proprietary  ,1,22,23,46,,204,250
03018500,BENE'S INTERNATIONAL SCHOOL OF BEAUTY   ,FL,34652-1637,Proprietary  ,14,72,86,119,,430,549
03026508,REMINGTON COLLEGE - TAMPA               ,FL,33619-1177,Private      ,9,47,56,189,,1087,1276
03028200,TRINITY COLLEGE OF FLORIDA              ,FL,34655-4401,Private      ,2,12,14,169,,217,386
03031400,INTERNATIONAL ACADEMY OF DESIGN AND TECH,FL,33634-6313,Proprietary  ,99,432,531,1154,,4263,5417
03031402,INTERNATIONAL ACADEMY OF DESIGN AND TECH,FL,32809-4613,Proprietary  ,22,42,64,491,,894,1385
03031403,IADT - ORLANDO CULINARY ACADEMY         ,FL,32819-0000,Proprietary  ,12,25,37,250,,482,732
03035800,HERITAGE INSTITUTE                      ,FL,32216-0948,Proprietary  ,13,105,118,128,,780,908
03035900,NATIONAL AVIATION ACADEMY               ,FL,33760-3931,Proprietary  ,43,89,132,432,,950,1382
03037500,HODGES UNIVERSITY                       ,FL,34119-7932,Private      ,64,293,357,904,,4088,4992
03054200,FORTIS COLLEGE                          ,FL,33144-2373,Proprietary  ,2,13,15,92,,238,330
03071600,COLLEGE OF BUSINESS & TECHNOLOGY        ,FL,33176-0000,Proprietary  ,37,247,284,400,,1718,2118
03076402,BRYMAN SCHOOL OF ARIZONA (THE) - ANTHEM ,FL,32803-3509,Proprietary  ,26,89,115,219,,656,875
03078003,OHIO CENTER FOR BROADCASTING - MIAMI MED,FL,33130-3042,Proprietary  ,4,31,35,18,,91,109
03079800,GEORGE T BAKER AVIATION                 ,FL,33142-5687,Public       ,27,56,83,417,,629,1046
03079900,CITY COLLEGE                            ,FL,32707-0000,Private      ,11,69,80,114,,681,795
03089200,NOUVELLE INSTITUTE                      ,FL,33125-4141,Proprietary  ,9,74,83,41,,500,541
03096300,FORTIS INSTITUTE                        ,FL,33860-0000,Proprietary  ,1,25,26,44,,231,275
03100800,TAYLOR TECHNICAL INSTITUTE              ,FL,32348-0894,Public       ,1,6,7,52,,204,256
03101900,TRINITY BAPTIST COLLEGE                 ,FL,32221-1398,Private      ,7,24,31,300,,338,638
03103900,MARION COUNTY COMMUNITY TECH & ADUL     ,FL,34474-3172,Public       ,16,56,72,473,,1734,2207
03108500,EVERGLADES UNIVERSITY                   ,FL,33431-0000,Private      ,13,168,181,252,,2039,2291
03108600,COM-PU-MED VOCATIONAL CAREERS           ,FL,33012-4861,Proprietary  ,9,67,76,73,,410,483
03113400,ACADEMY OF HEALING ARTS                 ,FL,33463-2113,Proprietary  ,1,21,22,44,,189,233
03114700,PRAXIS INSTITUTE                        ,FL,33135-2657,Proprietary  ,5,51,56,30,,338,368
03115500,ADVENTIST UNIVERSITY OF HEALTH SCIENCES ,FL,32803-1237,Private      ,49,113,162,1521,,3031,4552
03123900,KEISER CAREER COLLEGE                   ,FL,33413-0000,Proprietary  ,43,183,226,418,,1794,2212
03125600,MIAMI AD SCHOOL                         ,FL,33139-5203,Proprietary  ,5,18,23,126,,418,544
03127900,TECHNICAL EDUCATION CTR OSCEOLA         ,FL,34744-4459,Public       ,23,87,110,448,,1368,1816
03158300,LEE COUNTY HIGH TECH CENTER NORTH       ,FL,33993-2479,Public       ,12,25,37,231,,631,862
03171300,UNIVERSITY OF ST. AUGUSTINE FOR HEALTH S,FL,32084-4215,Proprietary  ,6,168,174,154,,1995,2149
03178400,CORAL RIDGE NURSES ASST TRAINING        ,FL,33306-0000,Proprietary  ,0,0,0,22,,68,90
03224300,NEW PROFESSIONS TECHNICAL INSTITUTE     ,FL,33134-1640,Proprietary  ,19,152,171,94,,794,888
03230300,CHOICE HIGH SCHOOL AND TECHNICAL CENTER ,FL,32547-1299,Public       ,6,27,33,155,,698,853
03238300,FLORIDA COLLEGE OF INTEGRATIVE MED      ,FL,32809-5721,Proprietary  ,7,23,30,151,,537,688
03255300,FLORIDA GULF COAST UNIVERSITY           ,FL,33965-6565,Public       ,741,238,979,19635,,7148,26783
03256300,YESHIVA GEDOLAH RABBINICAL COLLEGE      ,FL,33139-4708,Private      ,2,0,2,36,,18,54
03264300,SOUTH FLORIDA BIBLE COLLEGE AND THEOLOGI,FL,33441-5768,Private      ,0,8,8,20,,150,170
03346300,ACAD FOR PRAC NURSING & HEALTH OCCP     ,FL,33417-4574,Private      ,19,85,104,326,,1358,1684
03348400,PROFESSIONAL TRAINING CENTERS           ,FL,33184-0000,Proprietary  ,17,139,156,167,,901,1068
03373300,BEACON COLLEGE                          ,FL,34748-5224,Private      ,6,10,16,199,,143,342
03374300,FLORIDA COASTAL SCHOOL OF LAW           ,FL,32256-0000,Proprietary  ,2,55,57,97,,2574,2671
03382300,BRADFORD-UNION AREA CAREERTECHNICAL CENT,FL,32091-2434,Public       ,7,34,41,73,,366,439
03390300,LINCOLN TECHNICAL INSTITUTE             ,FL,32730-2351,Proprietary  ,12,43,55,195,,489,684
03411400,INTERNATIONAL TRAINING CAREERS          ,FL,33155-1462,Private      ,7,95,102,62,,468,530
03414500,ACUPUNCTURE AND MASSAGE COLLEGE         ,FL,33176-1509,Proprietary  ,6,31,37,99,,419,518
03425400,CENTRAL FLORIDA INSTITUTE               ,FL,34684-4436,Proprietary  ,3,14,17,157,,574,731
03429600,ATLANTIC INST OF ORIENTAL MEDICINE      ,FL,33316-0000,Private      ,4,19,23,46,,278,324
03429700,EAST WEST COLLG OF NATURAL MEDICINE     ,FL,34236-4959,Proprietary  ,2,15,17,27,,267,294
03433400,NEW CONCEPT MASSAGE AND BEAUTY SCHO     ,FL,33135-0000,Proprietary  ,2,23,25,43,,129,172
03434300,FORTIS COLLEGE                          ,FL,32073-2999,Proprietary  ,14,54,68,152,,644,796
03480301,MEDVANCE INSTITUTE - FORT LAUDERDALE    ,FL,33313-7261,Proprietary  ,3,32,35,77,,301,378
03480302,MEDVANCE INSTITUTE - STUART             ,FL,34994-3000,Proprietary  ,10,74,84,156,,702,858
03491400,AMERICAN ADVANCED TECHNICIANS INST      ,FL,33014-4430,Proprietary  ,5,30,35,69,,175,244
03549300,ULTIMATE MEDICAL ACADEMY                ,FL,33756-4917,Proprietary  ,297,3044,3341,1872,,19763,21635
03553300,KEISER CAREER COLLEGE                   ,FL,32216-0000,Proprietary  ,19,130,149,388,,1678,2066
03557300,NORTH FLORIDA COSMETOLOGY INSTITUTE     ,FL,32312-0000,Proprietary  ,5,35,40,167,,486,653
03564300,"INTERNATIONAL SCHOOL OF HEALTH, BEAUTY &",FL,33311-1141,Proprietary  ,0,33,33,52,,246,298
03570400,ENGLISH CENTER (THE)                    ,FL,33133-2703,Public       ,1,38,39,32,,384,416
03611400,FLORIDA BARBER ACADEMY                  ,FL,33441-0000,Proprietary  ,9,63,72,59,,403,462
03618300,FLORIDA INSTITUTE OF ANIMAL ARTS        ,FL,32792-0000,Proprietary  ,12,31,43,197,,268,465
03627400,JACKSONVILLE BEAUTY INSTITUTE           ,FL,32208-1885,Proprietary  ,9,56,65,121,,454,575
03627600,FLORIDA EDUCATION INSTITUTE             ,FL,33144-5036,Proprietary  ,8,96,104,102,,548,650
03661400,SOUTH FLORIDA INSTITUTE OF TECHNOLO     ,FL,33135-0000,Proprietary  ,28,217,245,215,,1316,1531
03691400,AVE MARIA SCHOOL OF LAW                 ,FL,34119-1376,Private      ,5,10,15,96,,637,733
03696400,SABER                                   ,FL,33134-1604,Private      ,6,51,57,76,,666,742
03706300,AMERICAN INSTITUTE                      ,FL,33319-0000,Proprietary  ,12,56,68,88,,360,448
03757300,ADVANCE SCIENCE INSTITUTE               ,FL,33012-0000,Proprietary  ,3,11,14,36,,83,119
03801400,BEAUTY INSTITUTE (THE)                  ,FL,33409-2972,Proprietary  ,6,19,25,74,,201,275
03801401,BEAUTY INSTITUTE (THE) - MARGATE        ,FL,33068-5704,Proprietary  ,2,1,3,31,,82,113
03816300,ARTISTIC NAILS & BEAUTY ACADEMY         ,FL,33605-5919,Proprietary  ,15,78,93,192,,608,800
03823300,FLORIDA ACADEMY OF HEALTH & BEAUTY      ,FL,33311-0000,Proprietary  ,2,8,10,17,,64,81
03832300,DADE MEDICAL COLLEGE                    ,FL,33126-5534,Proprietary  ,69,428,497,1163,,4923,6086
03842500,CAMBRIDGE INSTITUTE OF ALLIED HEALTH    ,FL,32750-0000,Proprietary  ,5,29,34,55,,356,411
03856300,UNIVERSAL BEAUTY SCHOOL                 ,FL,33174-4406,Proprietary  ,10,37,47,40,,202,242
03856500,FLORIDA SCHOOL OF TRADITIONAL MIDWIFERY ,FL,32601-5507,Private      ,2,2,4,27,,184,211
03875300,MCI INSTITUTE OF TECHNOLOGY             ,FL,33409-4937,Proprietary  ,12,77,89,150,,524,674
03888300,DRAGON RISES COLLEGE OF ORIENTAL MEDICIN,FL,32601-5089,Proprietary  ,1,4,5,17,,98,115
03903500,SOUTHERN TECHNICAL COLLEGE              ,FL,32809-0000,Proprietary  ,46,280,326,362,,2412,2774
03906300,CAREER INSTITUTE OF FLORIDA             ,FL,33773-3434,Proprietary  ,0,0,0,5,,29,34
03907301,PAUL MITCHELL THE SCHOOL FT MYERS       ,FL,33907-0000,Proprietary  ,7,22,29,93,,185,278
03911300,TOTAL INTERNATIONAL CAREER INSTITUTE    ,FL,33012-0000,Proprietary  ,0,27,27,10,,195,205
03939300,WOLFORD COLLEGE                         ,FL,34108-1931,Proprietary  ,1,12,13,40,,352,392
03939400,CENTURA INSTITUTE                       ,FL,32807-3566,Proprietary  ,9,39,48,118,,546,664
03939600,DAYTONA COLLEGE                         ,FL,32174-8445,Proprietary  ,11,58,69,156,,582,738
03941300,AVE MARIA UNIVERSITY                    ,FL,34142-9505,Private      ,27,8,35,1433,,243,1676
03957400,NEW COLLEGE OF FLORIDA                  ,FL,34243-2109,Public       ,38,10,48,2097,,545,2642
03985300,COMMERCIAL DIVING ACADEMY               ,FL,32208-0000,Proprietary  ,31,121,152,411,,1101,1512
03986300,AVIATOR COLLEGE OF AERONAUTICAL SCIENCE ,FL,34946-9022,Proprietary  ,6,24,30,94,,275,369
04016500,AMERICAN INSTITUTE OF BEAUTY            ,FL,33773-0000,Proprietary  ,12,54,66,107,,406,513
04029300,TRENDSETTERS OF FLORIDA SCHOOL OF BEAUTY,FL,32205-4737,Proprietary  ,1,20,21,31,,183,214
04038302,ATA COLLEGE-ATA CAREER EDUCATION        ,FL,34606-4300,Proprietary  ,16,60,76,118,,543,661
04083400,CAMBRIDGE INSTITUTE OF ALLIED HEALTH & T,FL,33484-6543,Proprietary  ,4,20,24,78,,386,464
04105400,PENSACOLA SCHOOL OF MASSAGE THERAPY & HE,FL,32504-7337,Proprietary  ,3,29,32,73,,383,456
04106300,PALM BEACH ACADEMY OF HEALTH & BEAUTY   ,FL,33403-2130,Proprietary  ,10,44,54,64,,201,265
04116400,FUTURE-TECH INSTITUTE                   ,FL,33135-4142,Proprietary  ,4,26,30,36,,261,297
04116600,TAYLOR COLLEGE                          ,FL,34420-8714,Proprietary  ,1,18,19,90,,891,981
04119400,AVEDA INSTITUTE - SAINT PETERSBURG      ,FL,33701-4242,Proprietary  ,52,76,128,496,,949,1445
04120400,HI-TECH SCHOOL OF COSMETOLOGY           ,FL,33174-0000,Proprietary  ,9,12,21,106,,163,269
04126900,ACADEMY OF CAREER TRAINING              ,FL,34741-4644,Proprietary  ,6,55,61,180,,530,710
04127400,DIGITAL MEDIA ARTS COLLEGE              ,FL,33431-5919,Proprietary  ,20,8,28,393,,306,699
04128400,MANAGEMENT RESOURCES INSTITUTE          ,FL,33126-5473,Proprietary  ,7,161,168,68,,1151,1219
04129900,FLORIDA SCHOOL OF MASSAGE               ,FL,32608-5419,Proprietary  ,8,39,47,85,,325,410
04130400,SHEAR EXCELLENCE INTERNATIONAL HAIR ACAD,FL,33614-2783,Proprietary  ,7,24,31,53,,176,229
04133500,ACADEMY FOR FIVE ELEMENT ACUPUNCTURE    ,FL,32601-6811,Private      ,0,5,5,24,,145,169
04133900,FUTURA CAREER INSTITUTE                 ,FL,33012-3325,Proprietary  ,6,31,37,41,,187,228
04134800,AVEDA INSTITUTE - TALLAHASSEE           ,FL,32304-3186,Proprietary  ,48,59,107,497,,777,1274
04134900,ORANGE PARK BEAUTY ACADEMY              ,FL,32073-5524,Proprietary  ,0,0,0,8,,16,24
04135000,COZMO THE SCHOOL                        ,FL,34135-4810,Proprietary  ,1,13,14,21,,99,120
04135900,ALLIED HEALTH INSTITUTE                 ,FL,33068-0000,Proprietary  ,6,103,109,102,,1423,1525
04140800,NORTH FLORIDA ACADEMY                   ,FL,32065-7758,Proprietary  ,1,12,13,36,,116,152
04143000,VOCATIONAL INSTITUTE OF FLORIDA         ,FL,33135-1939,Proprietary  ,0,0,0,17,,42,59
04143100,PROFESSIONAL HANDS INSTITUTE            ,FL,33135-1939,Proprietary  ,0,10,10,12,,65,77
04145900,CELEBRITY SCHOOL OF BEAUTY              ,FL,33144-4153,Proprietary  ,5,25,30,103,,275,378
04146200,WALTON CAREER DEVELOPMENT CENTER        ,FL,32433-1557,Public       ,2,9,11,81,,271,352
04146300,MARCHMAN TECHNICAL EDUCATION CENTER     ,FL,34653-1211,Public       ,8,19,27,233,,439,672
04148500,MEDICAL INSTITUTE OF PALM BEACH         ,FL,33460-5042,Proprietary  ,7,14,21,100,,294,394
04150800,IMMOKALEE TECHNICAL CENTER              ,FL,34142-3146,Public       ,13,5,18,191,,232,423
04151500,AMERICAN ACADEMY OF COSMETOLOGY         ,FL,32065-8026,Proprietary  ,1,22,23,70,,205,275
04156300,UNIVERSITY OF FORT LAUDERDALE           ,FL,33313-5809,Private      ,2,10,12,81,,158,239
04156400,AVIATION INSTITUTE OF MAINTENANCE       ,FL,32803-6487,Proprietary  ,21,57,78,280,,766,1046
04157100,AEROSIM FLIGHT ACADEMY                  ,FL,32773-9683,Proprietary  ,12,25,37,137,,276,413
04158300,FLAGLER TECHNICAL INSTITUTE             ,FL,32137-4714,Public       ,7,26,33,137,,474,611
04162000,JOSE MARIA VARGAS UNIVERSITY            ,FL,33025-4534,Proprietary  ,2,4,6,24,,124,148
04162500,HOLLYWOOD INSTITUTE OF BEAUTY CAREERS   ,FL,33020-4807,Proprietary  ,18,154,172,174,,931,1105
04163000,SALON PROFESSIONAL ACADEMY (THE)        ,FL,33624-6321,Proprietary  ,6,24,30,109,,259,368
04163100,SALON PROFESSIONAL ACADEMY (THE)        ,FL,32607-1672,Proprietary  ,10,17,27,109,,268,377
04163200,SALON PROFESSIONAL ACADEMY (THE)        ,FL,32162-9311,Proprietary  ,3,20,23,89,,214,303
04164500,EUREKA INSTITUTE OF HEALTH AND BEAUTY   ,FL,33174-4205,Proprietary  ,2,15,17,31,,127,158
04164600,D. A. DORSEY EDUCATIONAL CENTER         ,FL,33147-6304,Public       ,13,44,57,68,,297,365
04167300,SALON PROFESSIONAL ACADEMY (THE)        ,FL,33904-4824,Proprietary  ,3,9,12,58,,145,203
04170300,BEAUTY ACADEMY OF SOUTH FLORIDA         ,FL,33012-3221,Proprietary  ,7,47,54,44,,274,318
04172300,ETERNITY COSMETOLOGY SCHOOL             ,FL,33415-5719,Proprietary  ,6,43,49,64,,265,329
04176800,PROGRESSIVE TRAINING CENTERS            ,FL,33060-9238,Proprietary  ,0,8,8,0,,12,12
04176900,AMERICAN HEALTH INSTITUTE               ,FL,34654-3743,Proprietary  ,5,18,23,51,,180,231
04182500,MILLENNIA ATLANTIC UNIVERSITY           ,FL,33178-2369,Proprietary  ,2,9,11,19,,77,96
04188300,FLORIDA ACADEMY                         ,FL,33966-1155,Proprietary  ,9,40,49,111,,403,514
04192100,AMERICAN MEDICAL ACADEMY                ,FL,33186-4830,Proprietary  ,16,20,36,194,,365,559
04195100,AMBIANCE BEAUTY & BARBER ACADEMY        ,FL,32935-8771,Proprietary  ,2,11,13,46,,171,217
04197600,"FLORIDA INSTITUTE OF RECORDING, SOUND AN",FL,32804-3309,Proprietary  ,23,44,67,268,,427,695
04204600,BEAUTY AND HEALTH INSTITUTE             ,FL,33626-2610,Proprietary  ,8,38,46,20,,165,185
04206300,FLORIDA VOCATIONAL INSTITUTE            ,FL,33155-3762,Proprietary  ,5,30,35,58,,257,315
04207900,SAE INSTITUTE OF TECHNOLOGY - MIAMI     ,FL,33160-4307,Proprietary  ,26,32,58,170,,293,463
04209500,SHEAR FINESSE HAIRSTYLING ACADEMY       ,FL,32208-5005,Proprietary  ,0,10,10,27,,110,137
04210800,ULTRASOUND MEDICAL INSTITUTE            ,FL,33462-4221,Proprietary  ,1,5,6,17,,70,87
04212600,COSMIX SCHOOL OF MAKEUP ARTISTRY        ,FL,33306-1640,Proprietary  ,7,29,36,13,,48,61
04213200,KAIZEN BEAUTY ACADEMY                   ,FL,33024-6609,Proprietary  ,2,4,6,19,,53,72
04214500,PRESTIGE HEALTH & BEAUTY SCIENCES ACADEM,FL,33160-4102,Proprietary  ,0,17,17,2,,67,69
04216600,AZURE COLLEGE                           ,FL,33169-5345,Proprietary  ,13,227,240,24,,409,433
04217800,BOCA BEAUTY ACADEMY                     ,FL,33434-4178,Proprietary  ,8,32,40,74,,238,312
04220200,MORE TECH INSTITUTE                     ,FL,33012-2165,Proprietary  ,2,19,21,7,,46,53
04221200,BLY'S SCHOOL OF COSMETOLOGY             ,FL,32601-4021,Proprietary  ,5,17,22,27,,165,192
04222100,ANTON AESTHETICS ACADEMY                ,FL,33416-4629,Proprietary  ,1,4,5,1,,19,20
04225000,PARISIAN SPA INSTITUTE                  ,FL,32204-4127,Proprietary  ,7,24,31,7,,24,31
04225200,YECHANLAZ INSTITUTO VOCACIONAL          ,FL,33144-4817,Proprietary  ,2,6,8,2,,6,8
04227500,MERRYFIELD SCHOOL OF PET GROOMING       ,FL,33334-4925,Proprietary  ,1,21,22,3,,41,44
04228900,BEAUTY ANATOMY INSTITUTE OF COSMETOLOGY ,FL,33069-4313,Proprietary  ,2,6,8,2,,7,9
04229700,FIRST COAST BARBER ACADEMY              ,FL,32210-8054,Proprietary  ,6,11,17,6,,11,17
00160500,CHAMINADE UNIV OF HONOLULU              ,HI,96816-1578,Private      ,37,115,152,2410,,2622,5032
00160600,BRIGHAM YOUNG UNIV-HAWAII CAMPUS        ,HI,96762-1294,Private      ,78,56,134,2210,,1138,3348
00161000,UNIVERSITY OF HAWAII AT MANOA           ,HI,96822-2399,Public       ,217,220,437,15659,,10211,25870
00161100,UNIVERSITY OF HAWAII AT HILO            ,HI,96720-4091,Public       ,44,48,92,4218,,3288,7506
00161200,HONOLULU COMMUNITY COLLEGE              ,HI,96817-4598,Public       ,53,97,150,2859,,3710,6569
00161300,KAPIOLANI COMMUNITY COLLEGE             ,HI,96816-4421,Public       ,89,125,214,3987,,4379,8366
00161400,KAUAI COMMUNITY COLLEGE                 ,HI,96766-9591,Public       ,18,27,45,697,,897,1594
00161500,UNIVERSITY OF HAWAII MAUI COLLEGE       ,HI,96732-1644,Public       ,30,87,117,1933,,3286,5219
00454900,LEEWARD COMMUNITY COLLEGE               ,HI,96782-3393,Public       ,79,147,226,3200,,4264,7464
00525800,HAWAII COMMUNITY COLLEGE                ,HI,96720-4075,Public       ,33,48,81,1911,,2922,4833
00723401,HEALD COLLEGE - HONOLULU                ,HI,96814-0000,Proprietary  ,76,244,320,1126,,2650,3776
00727900,HAWAII PACIFIC UNIVERSITY               ,HI,96813-2882,Private      ,93,181,274,5413,,4590,10003
01122000,WINDWARD COMMUNITY COLLEGE              ,HI,96744-0000,Public       ,28,51,79,1179,,1853,3032
02100300,MED-ASSIST SCHOOL OF HAWAII             ,HI,96813-0000,Proprietary  ,8,25,33,165,,380,545
02107800,UNIVERSITY OF HAWAII - WEST OAHU        ,HI,96782-0000,Public       ,33,67,100,2311,,2641,4952
02139500,HAWAII INSTITUTE OF HAIR DESIGN         ,HI,96817-5195,Proprietary  ,6,22,28,124,,268,392
02159701,NEW HOPE CHRISTIAN COLLEGE - HAWAII     ,HI,96819-2228,Private      ,0,0,0,80,,97,177
03017800,TRAVEL INSTITUTE OF THE PACIFIC         ,HI,96814-1946,Proprietary  ,9,34,43,82,,262,344
03072500,WORLD MEDICINE INSTITUTE                ,HI,96826-0000,Private      ,0,8,8,52,,224,276
03735300,INST OF CLINICAL ACUPUNCTURE & ORIENT MD,HI,96813-2307,Proprietary  ,0,3,3,17,,135,152
03999400,TRADITIONAL CHINESE MEDICAL COLLEGE OF H,HI,96743-8324,Private      ,0,2,2,4,,57,61
04165200,MAUNA LOA HELICOPTERS                   ,HI,96740-2650,Proprietary  ,1,3,4,21,,82,103
04175100,PAUL MITCHELL THE SCHOOL HONOLULU       ,HI,96816-2433,Proprietary  ,14,19,33,168,,287,455
04182200,HAWAII MEDICAL INSTITUTE                ,HI,96814-3518,Proprietary  ,25,84,109,297,,812,1109
00161600,BOISE STATE UNIVERSITY                  ,ID,83725-1000,Public       ,184,411,595,15064,,13505,28569
00161700,"COLLEGE OF IDAHO, THE                   ",ID,83605-4432,Private      ,26,23,49,1996,,723,2719
00161900,COLLEGE OF SOUTHERN IDAHO               ,ID,83301-0000,Public       ,82,203,285,3557,,4464,8021
00162000,IDAHO STATE UNIVERSITY                  ,ID,83209-5377,Public       ,137,229,366,6361,,9284,15645
00162100,LEWIS-CLARK STATE COLLEGE               ,ID,83501-2698,Public       ,43,98,141,2643,,2840,5483
00162300,NORTH IDAHO COLLEGE                     ,ID,83814-2199,Public       ,62,171,233,3240,,5221,8461
00162400,NORTHWEST NAZARENE UNIVERSITY           ,ID,83686-5897,Private      ,16,74,90,1747,,1802,3549
00162500,BRIGHAM YOUNG UNIVERSITY-IDAHO          ,ID,83460-1650,Private      ,659,679,1338,13681,,12355,26036
00162600,UNIVERSITY OF IDAHO                     ,ID,83844-4291,Public       ,118,151,269,11029,,5056,16085
00732915,ITT TECHNICAL INSTITUTE                 ,ID,83713-1529,Proprietary  ,52,300,352,511,,2195,2706
00987300,MR JUAN'S CLG OF HAIR DESIGN            ,ID,83301-4154,Proprietary  ,2,10,12,43,,110,153
01113300,EASTERN IDAHO TECHNICAL COLLEGE         ,ID,83404-5788,Public       ,26,31,57,479,,1278,1757
02218000,CARRINGTON COLLEGE                      ,ID,83704-0000,Proprietary  ,48,185,233,536,,2022,2558
02234500,BOISE BIBLE COLLEGE                     ,ID,83714-1220,Private      ,4,12,16,218,,167,385
02275800,MR LEONS SCHOOL OF HAIR DESIGN          ,ID,83843-8384,Proprietary  ,2,5,7,19,,64,83
02275801,MR. LEON'S SCHOOL OF HAIR DESIGN        ,ID,83501-1910,Proprietary  ,0,6,6,12,,28,40
02314000,SCHOOL OF HAIRSTYLING (THE)             ,ID,83202-0000,Proprietary  ,0,4,4,22,,62,84
02319800,TONI&GUY HAIRDRESSING ACADEMY           ,ID,83814-2822,Proprietary  ,8,17,25,116,,201,317
02319801,TONI&GUY HAIRDRESSING ACADEMY - BOISE   ,ID,83705-2636,Proprietary  ,4,21,25,56,,132,188
02349200,HEADMASTERS SCHOOL OF HAIR DESIGN       ,ID,83501-0000,Proprietary  ,0,9,9,30,,78,108
02559500,RAZZLE DAZZLE CLG OF HAIR DESIGN        ,ID,83686-5104,Proprietary  ,6,21,27,108,,230,338
02607100,PAUL MITCHELL THE SCHOOL BOISE          ,ID,83709-1662,Proprietary  ,13,24,37,200,,285,485
03098700,ACADEMY OF COURT REPORTING              ,ID,83704-8320,Proprietary  ,22,67,89,169,,481,650
03832400,COSMETOLOGY SCHOOL OF ARTS & SCIENCES   ,ID,83318-1327,Proprietary  ,0,11,11,19,,83,102
04051323,ART INSTITUTE OF PHOENIX (THE) - BROWN M,ID,83709-2746,Proprietary  ,2,14,16,83,,211,294
04134300,EVANS HAIRSTYLING COLLEGE               ,ID,83440-5277,Proprietary  ,5,2,7,88,,52,140
04144500,HAIR ACDMY PAUL MITCHELL PARTNER SCHOOL ,ID,83440-2600,Proprietary  ,4,7,11,122,,148,270
04150600,D & L ACADEMY OF HAIR DESIGN            ,ID,83301-6229,Proprietary  ,2,4,6,26,,75,101
04155200,OLIVER FINLEY ACADEMY OF COSMETOLOGY    ,ID,83704-8011,Proprietary  ,17,46,63,174,,376,550
04163800,MASTER EDUCATORS BEAUTY SCHOOL          ,ID,83301-4118,Proprietary  ,3,4,7,42,,66,108
04168600,COLLEGE OF MASSAGE THERAPY              ,ID,83221-1758,Proprietary  ,1,1,2,28,,66,94
04176700,D'SHAW INSTITUTE OF COSMETOLOGY         ,ID,83704-4406,Proprietary  ,4,10,14,53,,118,171
04194800,VELVET TOUCH ACADEMY OF COSMETOLOGY     ,ID,83687-5020,Proprietary  ,5,10,15,69,,131,200
04203200,BOISE BARBER COLLEGE                    ,ID,83704-5919,Proprietary  ,1,15,16,35,,112,147
04203500,AUSTIN KADE ACADEMY                     ,ID,83404-5540,Proprietary  ,5,54,59,96,,327,423
04207200,ACADEMY DI FIRENZE                      ,ID,83338-2329,Proprietary  ,1,6,7,14,,49,63
04211800,COLLEGE OF WESTERN IDAHO                ,ID,83687-5505,Public       ,131,392,523,5191,,9956,15147
00163200,AQUINAS INSTITUTE OF THEOLOGY           ,MO,63108-3323,Private      ,1,5,6,5,,105,110
00244900,AVILA UNIVERSITY                        ,MO,64145-1698,Private      ,15,81,96,1614,,1996,3610
00245000,CALVARY BIBLE COLLEGE                   ,MO,64147-1341,Private      ,1,12,13,194,,249,443
00245200,CENTRAL BIBLE COLLEGE                   ,MO,65803-1096,Private      ,0,0,0,188,,148,336
00245300,CENTRAL METHODIST UNIVERSITY            ,MO,65248-1198,Private      ,19,103,122,1928,,2526,4454
00245400,UNIVERSITY OF CENTRAL MISSOURI          ,MO,64093-5178,Public       ,90,217,307,9975,,5564,15539
00245600,COLUMBIA COLLEGE                        ,MO,65216-4581,Private      ,113,1603,1716,3666,,24629,28295
00245700,CONCORDIA SEMINARY                      ,MO,63105-3199,Private      ,1,14,15,7,,450,457
00245800,COTTEY COLLEGE                          ,MO,64772-2790,Private      ,6,2,8,376,,98,474
00245900,CROWDER COLLEGE                         ,MO,64850-9165,Public       ,112,174,286,2866,,3625,6491
00246000,CULVER STOCKTON COLLEGE                 ,MO,63435-1299,Private      ,8,7,15,1284,,242,1526
00246100,DRURY UNIVERSITY                        ,MO,65802-3791,Private      ,42,196,238,2848,,4513,7361
00246200,EDEN THEOLOGICAL SEMINARY               ,MO,63119-0000,Private      ,0,6,6,3,,178,181
00246300,EVANGEL UNIVERSITY                      ,MO,65802-2125,Private      ,10,26,36,2662,,1228,3890
00246302,EVANGEL UNIVERSITY - ASSEMBLIES OF GOD T,MO,65802-2131,Private      ,3,10,13,25,,269,294
00246400,FONTBONNE UNIVERSITY                    ,MO,63105-3098,Private      ,17,83,100,1414,,2654,4068
00246600,HARRIS-STOWE STATE COLLEGE              ,MO,63103-2199,Public       ,39,90,129,1606,,2290,3896
00246700,CONCEPTION SEMINARY COLLEGE             ,MO,64433-0502,Private      ,2,0,2,63,,16,79
00246800,JEFFERSON COLLEGE                       ,MO,63050-2441,Public       ,62,142,204,2971,,3507,6478
00247100,ST LOUIS COMMUNITY COLLEGE              ,MO,63102-0000,Public       ,280,895,1175,12759,,19735,32494
00247300,KANSAS CITY ART INSTITUTE               ,MO,64111-1874,Private      ,12,18,30,1412,,545,1957
00247400,KANSAS CITY UNIV OF MED AND BIOSCIENCES ,MO,64106-0000,Private      ,0,7,7,117,,1242,1359
00247600,KENRICK-GLENNON SEMINARY                ,MO,63119-4330,Private      ,1,0,1,29,,10,39
00247700,A.T. STILL UNIV OF HEALTH SCIENCES      ,MO,63501-0000,Private      ,2,73,75,29,,2881,2910
00247900,LINCOLN UNIVERSITY                      ,MO,65101-3500,Public       ,49,75,124,2458,,2039,4497
00248000,LINDENWOOD UNIVERSITY                   ,MO,63301-1695,Private      ,67,419,486,7473,,8446,15919
00248200,MARYVILLE UNIVERSITY                    ,MO,63141-7299,Private      ,23,219,242,2782,,4902,7684
00248400,METROPOLITAN COMMUNITY COLLEGE          ,MO,64111-2408,Public       ,244,813,1057,10974,,17443,28417
00248500,MIDWESTERN BAPTIST THEOL SEMINARY       ,MO,64118-4697,Private      ,3,15,18,103,,429,532
00248600,MINERAL AREA COLLEGE                    ,MO,63601-1000,Public       ,34,106,140,2339,,2886,5225
00248800,MISSOURI SOUTHERN STATE UNIVERSITY      ,MO,64801-1595,Public       ,67,111,178,4612,,4168,8780
00248900,MISSOURI VALLEY COLLEGE                 ,MO,65340-3197,Private      ,13,20,33,1828,,537,2365
00249000,MISSOURI WESTERN STATE UNIVERSITY       ,MO,64507-2294,Public       ,63,100,163,4904,,3153,8057
00249100,MOBERLY AREA COMMUNITY COLLEGE          ,MO,65270-1304,Public       ,99,163,262,3500,,3956,7456
00249400,NAZARENE THEOLOGICAL SEMINARY           ,MO,64131-1246,Private      ,0,2,2,7,,202,209
00249500,TRUMAN STATE UNIVERSITY                 ,MO,63501-4221,Public       ,58,15,73,6181,,690,6871
00249600,NORTHWEST MISSOURI STATE UNIV           ,MO,64468-6001,Public       ,59,67,126,6743,,1600,8343
00249800,PARK UNIVERSITY                         ,MO,64152-3795,Private      ,37,874,911,1776,,10654,12430
00249900,ROCKHURST UNIVERSITY                    ,MO,64110-2561,Private      ,16,55,71,2523,,1637,4160
00250000,COLLEGE OF THE OZARKS                   ,MO,65726-2502,Private      ,29,12,41,3649,,457,4106
00250100,SOUTHEAST MISSOURI STATE UNIV           ,MO,63701-4799,Public       ,109,178,287,9345,,5126,14471
00250200,SOUTHWEST BAPTIST UNIVERSITY            ,MO,65613-2597,Private      ,22,85,107,2312,,1978,4290
00250300,MISSOURI STATE UNIVERSITY               ,MO,65897-0094,Public       ,181,273,454,17186,,9675,26861
00250400,ST LOUIS COLLEGE OF PHARMACY            ,MO,63110-1088,Private      ,8,9,17,925,,842,1767
00250600,SAINT LOUIS UNIVERSITY                  ,MO,63103-2097,Private      ,97,240,337,11153,,8751,19904
00250900,SAINT PAUL SCHOOL OF THEOLOGY           ,MO,64127-2499,Private      ,0,7,7,7,,136,143
00251200,STEPHENS COLLEGE                        ,MO,65215-0001,Private      ,17,16,33,977,,734,1711
00251400,NORTH CENTRAL MISSOURI COLLEGE          ,MO,64683-1824,Public       ,26,39,65,1014,,1120,2134
00251600,UNIVERSITY OF MISSOURI-COLUMBIA         ,MO,65211-1600,Public       ,296,285,581,29262,,9945,39207
00251700,MISSOURI UNIVERSITY OF SCIENCE & TECHNOL,MO,65409-0250,Public       ,54,50,104,6303,,1616,7919
00251800,UNIVERSITY OF MISSOURI-KANSAS CITY      ,MO,64110-2497,Public       ,117,311,428,9111,,11230,20341
00251900,UNIVERSITY OF MISSOURI-ST LOUIS         ,MO,63121-4499,Public       ,110,378,488,8020,,12157,20177
00252000,WASHINGTON UNIVERSITY                   ,MO,63130-4899,Private      ,136,127,263,15288,,5844,21132
00252001,WASHINGTON UNIV-SCHOOL OF MEDICINE      ,MO,63110-0000,Private      ,9,13,22,239,,1527,1766
00252100,WEBSTER UNIVERSITY                      ,MO,63119-3194,Private      ,50,605,655,3857,,14237,18094
00252200,WENTWORTH MILITARY ACADEMY              ,MO,64067-1799,Private      ,5,11,16,397,,278,675
00252300,WESTMINSTER COLLEGE                     ,MO,65251-1299,Private      ,12,7,19,1342,,221,1563
00252400,WILLIAM JEWELL COLLEGE                  ,MO,64068-1896,Private      ,14,14,28,1385,,367,1752
00252500,WILLIAM WOODS UNIVERSITY                ,MO,65251-2388,Private      ,12,148,160,1212,,1545,2757
00405704,NATIONAL AMERICAN UNIVERSITY            ,MO,64057-1791,Proprietary  ,2,27,29,68,,815,883
00439800,COX HEALTH SYSTEM SCHOOL OF RADIOLOGIC T,MO,65802-0000,Private      ,0,0,0,4,,31,35
00441300,MERCY HOSPITAL SPRINGFIELD SCHOOL OF RAD,MO,65804-2263,Private      ,4,8,12,138,,303,441
00470300,LOGAN COLLEGE OF CHIROPRACTIC           ,MO,63006-0000,Private      ,2,25,27,75,,1053,1128
00470700,COVENANT THEOLOGICAL SEMINARY           ,MO,63141-8697,Private      ,1,7,8,4,,521,525
00471100,LINN STATE TECHNICAL COLLEGE            ,MO,65051-9607,Public       ,30,18,48,1607,,637,2244
00471300,THREE RIVERS COMMUNITY COLLEGE          ,MO,63901-2393,Public       ,81,184,265,2282,,4298,6580
00528800,KIRKSVILLE AREA TECHNICAL CENTER        ,MO,63501-0000,Public       ,1,3,4,42,,98,140
00528900,WAYNESVILLE CAREER CENTER               ,MO,65583-2131,Public       ,0,4,4,63,,188,251
00542400,SOUTH CENTRAL CAREER CENTER             ,MO,65775-3334,Public       ,1,2,3,53,,177,230
00542600,SIKESTON CAREER AND TECHNOLOGY CTR      ,MO,63801-0000,Public       ,3,11,14,88,,355,443
00542900,ROLLA TECHNICAL INSTITUTE               ,MO,65401-3601,Public       ,3,23,26,338,,467,805
00543000,POPLAR BLUFF TECHNICAL CAREER CNTR      ,MO,63901-0000,Public       ,5,12,17,80,,286,366
00543800,SALINE COUNTY CAREER CENTER             ,MO,65340-0000,Public       ,0,2,2,17,,63,80
00544500,TRUMAN MEDICAL CENTER SCHOOL OF NURSE AN,MO,64108-2677,Private      ,1,12,13,75,,284,359
00553100,GRAND RIVER TECHNICAL SCHOOL            ,MO,64601-1299,Public       ,1,2,3,78,,70,148
00553200,CAPE GIRARDEAU CAREER & TECHNOLOGY CENTE,MO,63703-7511,Public       ,3,29,32,328,,719,1047
00638900,BARNES JEWISH COLLEGE OF NURSING AND ALL,MO,63110-1091,Private      ,5,23,28,722,,1397,2119
00639200,RESEARCH COLLEGE OF NURSING             ,MO,64132-1199,Proprietary  ,1,14,15,148,,438,586
00639201,RESEARCH MEDICAL CENTER - COLLEGE OF NUR,MO,64132-1199,Proprietary  ,0,5,5,67,,224,291
00639202,RESEARCH MED CTR SCHL OF RAD TECH       ,MO,64132-0000,Proprietary  ,0,2,2,30,,118,148
00666600,LUTHERAN  SCHOOL OF NURSING             ,MO,63118-3909,Proprietary  ,0,12,12,164,,665,829
00732923,ITT TECHNICAL INSTITUTE                 ,MO,63045-1122,Proprietary  ,100,458,558,874,,4163,5037
00754000,MISSOURI BAPTIST UNIVERSITY             ,MO,63141-8698,Private      ,28,143,171,1980,,3055,5035
00808000,STATE FAIR COMMUNITY COLLEGE            ,MO,65301-0000,Public       ,81,258,339,2816,,4139,6955
00826900,HILLYARD TECHNICAL CENTER               ,MO,64506-0000,Public       ,4,13,17,188,,376,564
00855200,STEVENS INSTITUTE OF BUSINESS & ARTS    ,MO,63103-0000,Proprietary  ,4,20,24,137,,320,457
00860600,TRI-COUNTY TECHNICAL SCHOOL             ,MO,65026-0000,Public       ,0,1,1,17,,57,74
00886200,EAST CENTRAL COLLEGE                    ,MO,63084-0529,Public       ,56,133,189,2363,,2834,5197
00908900,HANNIBAL-LAGRANGE COLLEGE               ,MO,63401-1999,Private      ,11,20,31,930,,632,1562
00952000,NATIONAL ACADEMY OF BEAUTY ARTS         ,MO,63128-1307,Proprietary  ,12,26,38,172,,386,558
00959000,INDEPENDENCE COLLEGE OF COSMETOLOGY     ,MO,64055-1105,Proprietary  ,5,11,16,65,,167,232
00960700,HOUSE OF HEAVILIN BEAUTY COLLEGE        ,MO,64110-2826,Proprietary  ,1,12,13,44,,193,237
00978200,SAINT LUKE'S COLLEGE OF HEALTH SCIENCES ,MO,64114-3237,Private      ,7,16,23,281,,684,965
00979500,MISSOURI COLLEGE                        ,MO,63144-2901,Proprietary  ,23,92,115,269,,772,1041
01014814,COLORADO TECHNL UNIV NORTH KANSAS CITY  ,MO,64116-3614,Proprietary  ,1,18,19,62,,470,532
01027900,HICKEY COLLEGE                          ,MO,63146-0000,Proprietary  ,41,34,75,625,,497,1122
01040500,PINNACLE CAREER INSTITUTE               ,MO,64131-3367,Proprietary  ,27,269,296,225,,1803,2028
01040501,PINNACLE CAREER INSTITUTE - NORTH KANSAS,MO,64153-1151,Proprietary  ,9,58,67,91,,480,571
01050303,WICHITA TECHNICAL INSTITUTE - WTI JOPLIN,MO,64801-2970,Proprietary  ,4,57,61,66,,431,497
01102600,WARRENSBURG AREA VOC TECH SCH           ,MO,64093-0000,Public       ,0,5,5,56,,128,184
01173500,PIKE/LINCOLN TECHNICAL CENTER           ,MO,63344-0000,Public       ,0,2,2,42,,77,119
01250000,RANKEN TECHNICAL COLLEGE                ,MO,63113-2811,Private      ,43,131,174,1866,,2563,4429
01258000,ST LOUIS CHRISTIAN COLLEGE              ,MO,63033-6499,Private      ,2,6,8,180,,208,388
01320800,BAPTIST BIBLE COLLEGE                   ,MO,65803-3498,Private      ,2,12,14,279,,277,556
02056100,FOUR RIVERS CAREER CENTER               ,MO,63090-0000,Public       ,0,4,4,29,,79,108
02066900,NICHOLS CAREER CENTER                   ,MO,65101-2814,Public       ,0,0,0,74,,144,218
02068200,COX HEALTH - COX COLLEGE                ,MO,65802-0000,Private      ,6,40,46,446,,1378,1824
02090400,BOONSLICK TECHNICAL EDUCATION CTR       ,MO,65233-0000,Public       ,0,0,0,12,,40,52
02119204,COURT REPORTING INSTITUTE OF DALLAS - CO,MO,63105-3329,Proprietary  ,3,25,28,20,,249,269
02121100,MIDWEST INSTITUTE                       ,MO,63122-0000,Proprietary  ,10,27,37,72,,238,310
02124500,FRANKLIN TECHNOLOGY CENTER              ,MO,64801-0000,Public       ,6,21,27,143,,496,639
02142200,LEX LA RAY TECHNICAL CENTER             ,MO,64067-0000,Public       ,0,3,3,34,,81,115
02154900,MISSOURI SCH OF BARB & HAIR             ,MO,63031-0000,Proprietary  ,1,14,15,29,,110,139
02164200,FOREST INST PROFESSIONAL PSYCHOLOGY     ,MO,65807-0000,Private      ,0,10,10,26,,380,406
02165900,CHILLICOTHE BEAUTY ACADEMY              ,MO,64601-0000,Proprietary  ,0,2,2,14,,42,56
02180200,METRO BUSINESS COLLEGE                  ,MO,63701-0000,Proprietary  ,7,70,77,162,,858,1020
02188000,NORTHWEST TECHNICAL SCHOOL              ,MO,64468-0000,Public       ,1,2,3,55,,76,131
02188100,NORTHLAND CAREER CENTER                 ,MO,64079-8333,Public       ,0,2,2,29,,73,102
02202700,OZARK CHRISTIAN COLLEGE                 ,MO,64801-0000,Private      ,6,9,15,768,,257,1025
02203400,NEVADA REGIONAL TECHNICAL CENTER        ,MO,64772-0000,Public       ,3,4,7,56,,89,145
02205200,SANFORD-BROWN COLLEGE                   ,MO,63026-7305,Proprietary  ,0,7,7,78,,322,400
02205203,SANFORD BROWN COLLEGE-ST. PETERS        ,MO,63376-5950,Proprietary  ,0,8,8,50,,212,262
02214500,SALEM COLLEGE OF HAIRSTYLING            ,MO,65401-0000,Proprietary  ,5,11,16,26,,61,87
02239200,ANTHEM COLLEGE                          ,MO,63043-0000,Proprietary  ,9,48,57,153,,496,649
02239202,ANTHEM COLLEGE - METRO SOUTH            ,MO,63026-0000,Proprietary  ,9,46,55,116,,380,496
02250600,EVEREST COLLEGE                         ,MO,65807-2446,Proprietary  ,8,85,93,181,,916,1097
02263106,ANTHEM COLLEGE - ANTHEM COLLEGE - KANSAS,MO,64114-3232,Proprietary  ,1,5,6,70,,206,276
02263400,LAKE CAREER AND TECHNICAL CENTER        ,MO,65020-0000,Public       ,1,1,2,26,,57,83
02266400,CENTRAL CHRISTIAN CLG OF THE BIBLE      ,MO,65270-0000,Private      ,2,6,8,244,,198,442
02277500,HOUSE OF HEAVILIN OF BLUE SPRINGS       ,MO,64014-3953,Proprietary  ,2,12,14,55,,154,209
02289200,COLUMBIA AREA CAREER CENTER             ,MO,65203-0000,Public       ,5,19,24,217,,595,812
02295700,MISSOURI BEAUTY ACADEMY                 ,MO,63640-1827,Proprietary  ,7,18,25,63,,152,215
02300105,EVEREST COLLEGE - EARTH CITY            ,MO,63045-1100,Proprietary  ,16,77,93,216,,848,1064
02304000,MISSOURI TECH                           ,MO,63303-3887,Proprietary  ,3,18,21,98,,258,356
02309100,AMERICAN COLLEGE OF HAIR DESIGN         ,MO,65301-2144,Proprietary  ,0,7,7,25,,86,111
02313000,CASS CAREER CENTER                      ,MO,64701-0000,Public       ,0,3,3,21,,83,104
02340500,ST LOUIS COLLEGE OF HEALTH CAREERS      ,MO,63110-0000,Proprietary  ,24,99,123,418,,1483,1901
02342100,CAREER & TECHNOLOGY CTR AT FT OSAGE     ,MO,64058-0000,Public       ,0,5,5,26,,90,116
02361600,CONCORDE CAREER COLLEGE                 ,MO,64111-0000,Proprietary  ,51,233,284,506,,2078,2584
02497500,CLINTON TECHNICAL SCHOOL                ,MO,64735-2966,Public       ,3,6,9,29,,100,129
02520800,MERRELL UNIV OF BTY ARTS & SCIENCES     ,MO,65109-0000,Proprietary  ,6,15,21,97,,227,324
02530600,SAINT CHARLES COMMUNITY COLLEGE         ,MO,63376-0975,Public       ,101,141,242,4842,,3759,8601
02543800,PARIS II EDUCATIONAL CENTER (THE)       ,MO,64118-0000,Proprietary  ,3,24,27,59,,167,226
02564700,ELAINE STEVEN BEAUTY COLLEGE            ,MO,63136-0000,Proprietary  ,8,32,40,113,,316,429
02564701,ELAINE STEVEN BEAUTY COLLEGE - ADVANCE B,MO,63383-2006,Proprietary  ,0,0,0,10,,9,19
02564702,ELAINE STEVEN BEAUTY COLLEGE - ADVANCE B,MO,63401-2269,Proprietary  ,1,2,3,18,,34,52
02568500,GRABBER SCHOOL OF HAIR DESIGN           ,MO,63011-0000,Proprietary  ,12,19,31,108,,186,294
02599700,VATTEROTT COLLEGE                       ,MO,63134-2900,Proprietary  ,61,232,293,534,,2177,2711
02599701,VATTEROTT COLLEGE - KANSAS CITY         ,MO,64117-0000,Proprietary  ,12,160,172,199,,1492,1691
02599702,VATTEROTT COLLEGE - SPRINGFIELD LOCATION,MO,65807-5340,Proprietary  ,19,96,115,159,,898,1057
02599703,VATTEROTT COLLEGE - JOPLIN              ,MO,64801-5033,Proprietary  ,11,81,92,89,,668,757
02599705,VATTEROTT COLLEGE - SUNSET HILLS        ,MO,63127-1516,Proprietary  ,17,101,118,178,,940,1118
02599712,VATTEROTT COLLEGE - O'FALLON            ,MO,63366-2748,Proprietary  ,23,101,124,142,,616,758
02599714,VATTEROTT COLLEGE - EX'TREME INSTITUTE B,MO,63102-2115,Proprietary  ,30,68,98,404,,802,1206
02599715,VATTEROTT COLLEGE - PERSONAL FITNESS AND,MO,63132-3251,Proprietary  ,0,0,0,8,,13,21
02608000,NEOSHO BEAUTY COLLEGE                   ,MO,64850-1525,Proprietary  ,1,6,7,26,,60,86
02609202,VATTEROTT COLLEGE-ST JOSEPH             ,MO,64501-2911,Proprietary  ,17,83,100,139,,573,712
02609203,VATTEROTT COLLEGE - L'ECOLE CULINAIRE   ,MO,63124-1103,Proprietary  ,12,63,75,184,,630,814
02609206,VATTEROTT COLLEGE - L'ECOLE CULINAIRE   ,MO,64112-2110,Proprietary  ,14,66,80,45,,272,317
02611004,HERITAGE COLLEGE-KANSAS CITY            ,MO,64131-4203,Proprietary  ,21,118,139,275,,1090,1365
03042400,LEBANON TECHNOLOGY & CAREER CENTER      ,MO,65536-3296,Public       ,2,10,12,105,,227,332
03066300,BRYAN CAREER COLLEGE                    ,MO,65806-2507,Proprietary  ,4,142,146,123,,1040,1163
03066303,BRYAN COLLEGE - COLUMBIA                ,MO,65201-8248,Proprietary  ,8,26,34,128,,506,634
03068600,SPECIAL SCHOOL DISTRICT OF ST. LOUIS CO.,MO,63127-0000,Public       ,4,40,44,60,,609,669
03070200,CENTRAL COLLEGE OF COSMETOLOGY          ,MO,65583-0000,Proprietary  ,1,14,15,44,,129,173
03070900,SE MO HOSP CLG NURSING & HEALTH SCI     ,MO,63703-4507,Private      ,3,14,17,194,,514,708
03072800,DALLAS COUNTY CAREER CENTER             ,MO,65685-9152,Public       ,0,0,0,1,,9,10
03077200,COSMETOLOGY CONCEPTS INSTITUTE          ,MO,65202-1972,Proprietary  ,0,7,7,63,,136,199
03083000,OZARKS TECHNICAL COMMUNITY COLLEGE      ,MO,65802-3601,Public       ,214,535,749,8987,,13792,22779
03092600,MESSENGER COLLEGE                       ,MO,64804-0000,Private      ,1,13,14,39,,95,134
03097600,ST LOUIS HAIR ACADEMY                   ,MO,63107-1737,Proprietary  ,4,11,15,50,,158,208
03101000,NEW DIMENSION SCHOOL OF HAIR DESIGN     ,MO,64801-5017,Proprietary  ,1,11,12,28,,106,134
03106000,MISSOURI STATE UNIVERSITY - WEST PLAINS ,MO,65775-2715,Public       ,39,61,100,1388,,1562,2950
03110900,HOUSE OF HEAVILIN BEAUTY COLLEGE        ,MO,64083-9195,Proprietary  ,0,2,2,25,,66,91
03174300,HERNDON CAREER CENTER                   ,MO,64138-2695,Public       ,1,2,3,26,,22,48
03519300,MISSOURI COLLEGE OF COSMETOLOGY NORTH   ,MO,65803-0000,Proprietary  ,4,18,22,85,,231,316
03579300,TEXAS COUNTY TECHNICAL INSTITUTE        ,MO,65483-2700,Private      ,0,6,6,44,,279,323
03616300,AVIATION INSTITUTE OF MAINTENANCE       ,MO,64129-1811,Proprietary  ,4,11,15,48,,256,304
03878300,PROFESSIONAL MASSAGE TRAINING CENTER    ,MO,65803-2939,Proprietary  ,0,9,9,35,,149,184
03916300,ECLIPS SCHOOL OF COSMETOLOGY AND BARBERI,MO,63703-5809,Proprietary  ,11,32,43,69,,296,365
03924300,HAIR ACADEMY 110 (THE)                  ,MO,63501-2915,Proprietary  ,3,0,3,23,,23,46
03970400,WELLSPRING SCHOOL OF ALLIED HEALTH      ,MO,64114-3313,Proprietary  ,6,45,51,66,,277,343
04037500,ACADEMY OF HAIR DESIGN                  ,MO,65804-2303,Proprietary  ,5,30,35,107,,292,399
04051329,ART INSTITUTE OF PHOENIX (THE) - BROWN M,MO,63026-2564,Proprietary  ,3,8,11,93,,186,279
04118700,AMERICAN COLLEGE OF TECHNOLOGY          ,MO,64506-2006,Proprietary  ,2,99,101,30,,862,892
04119100,CITY VISION COLLEGE                     ,MO,64141-3188,Private      ,2,11,13,16,,129,145
04122300,GRANTHAM UNIVERSITY                     ,MO,64153-2262,Proprietary  ,79,1558,1637,582,,12656,13238
04130300,VICTORY TRADE SCHOOL                    ,MO,65803-2754,Private      ,1,15,16,20,,123,143
04130600,"CENTER FOR HEALING ARTS (THE), LLC      ",MO,63143-2103,Proprietary  ,4,20,24,39,,193,232
04133300,TREND SETTERS SCHOOL OF COSMETOLOGY     ,MO,63702-7607,Proprietary  ,7,19,26,72,,170,242
04145200,TRANSFORMED BARBER AND COSMETOLOGY ACADE,MO,64137-1207,Proprietary  ,4,15,19,74,,238,312
04145700,THE SYSTEM A PAUL MITCHELL PARTNER SCHL ,MO,65807-5969,Proprietary  ,2,18,20,146,,224,370
04146100,URSHAN GRADUATE SCHOOL OF THEOLOGY      ,MO,63031-7526,Private      ,2,1,3,43,,62,105
04152200,CARTHAGE R-9 SCHOOL DISTRICT/CARTHAGE TE,MO,64836-1332,Public       ,0,1,1,16,,53,69
04170600,SALON PROFESSIONAL ACADEMY (THE)        ,MO,63301-1021,Proprietary  ,7,14,21,64,,146,210
04170700,PAUL MITCHELL THE SCHOOL ST LOUIS       ,MO,63108-1554,Proprietary  ,17,16,33,231,,327,558
04173900,COSMETOLOGY COLLEGE OF FRANKLIN COUNTY  ,MO,63077-3448,Proprietary  ,1,4,5,23,,42,65
04174000,SKIN INSTITUTE                          ,MO,63128-1307,Proprietary  ,5,10,15,29,,129,158
04174800,AMERICAN TRADE SCHOOL                   ,MO,63074-1807,Proprietary  ,3,19,22,35,,218,253
04179000,"SALON PROFESSIONAL ACADEMY, THE         ",MO,65616-7216,Proprietary  ,2,9,11,10,,30,40
04184400,SEYMOUR BEAUTY ACADEMY                  ,MO,65746-8743,Proprietary  ,0,2,2,8,,47,55
04187000,DONNA'S ACADEMY OF HAIR DESIGN          ,MO,64089-9042,Proprietary  ,1,4,5,23,,34,57
04212100,ACADEMY OF SALON PROFESSIONALS          ,MO,65301-6910,Proprietary  ,0,5,5,27,,71,98
04218400,CITY POINTE BEAUTY ACADEMY              ,MO,64870-2502,Proprietary  ,2,9,11,37,,62,99
00314600,WESTERN OKLAHOMA STATE COLLEGE          ,OK,73521-1397,Public       ,24,57,81,763,,1184,1947
00314700,BACONE COLLEGE                          ,OK,74403-1597,Private      ,25,46,71,1262,,877,2139
00314900,SOUTHERN NAZARENE UNIVERSITY            ,OK,73008-2694,Private      ,22,135,157,1252,,2208,3460
00315000,CAMERON UNIVERSITY                      ,OK,73505-6377,Public       ,59,179,238,2567,,4768,7335
00315100,OKLAHOMA WESLEYAN UNIVERSITY            ,OK,74006-6299,Private      ,13,152,165,1074,,1367,2441
00315200,UNIV OF CENTRAL OKLAHOMA                ,OK,73034-5209,Public       ,179,297,476,10882,,9106,19988
00315300,CONNORS STATE COLLEGE                   ,OK,74469-9700,Public       ,35,95,130,1444,,1920,3364
00315400,EAST CENTRAL UNIVERSITY                 ,OK,74820-6999,Public       ,41,110,151,3019,,3023,6042
00315500,EASTERN OKLAHOMA STATE COLLEGE          ,OK,74578-4999,Public       ,26,71,97,943,,1365,2308
00315600,REDLANDS COMMUNITY COLLEGE              ,OK,73036-5304,Public       ,21,60,81,867,,1309,2176
00315700,LANGSTON UNIVERSITY                     ,OK,73050-0000,Public       ,55,93,148,2563,,2365,4928
00315800,MURRAY STATE COLLEGE                    ,OK,73460-3137,Public       ,32,94,126,1292,,1829,3121
00316000,NORTHEASTERN OKLAHOMA A & M COLLEGE     ,OK,74354-6497,Public       ,65,73,138,1986,,1524,3510
00316100,NORTHEASTERN STATE UNIVERSITY           ,OK,74464-2399,Public       ,65,204,269,5584,,6851,12435
00316200,NORTHERN OKLAHOMA COLLEGE               ,OK,74653-0310,Public       ,57,105,162,2252,,2364,4616
00316300,NORTHWESTERN OKLAHOMA STATE UNIV        ,OK,73717-2799,Public       ,24,33,57,1758,,1144,2902
00316400,OKLAHOMA BAPTIST UNIVERSITY             ,OK,74801-2590,Private      ,44,22,66,3109,,624,3733
00316500,OKLAHOMA CHRISTIAN UNIVERSITY           ,OK,73131-0000,Private      ,34,51,85,2630,,1179,3809
00316600,OKLAHOMA CITY UNIVERSITY                ,OK,73106-1493,Private      ,50,89,139,3012,,3127,6139
00316700,UNIV OF SCIENCE & ARTS OF OKLAHOMA      ,OK,73018-5322,Public       ,11,15,26,839,,558,1397
00316800,ROGERS STATE UNIVERSITY                 ,OK,74017-3252,Public       ,59,133,192,3018,,3464,6482
00317000,OKLAHOMA STATE UNIVERSITY               ,OK,74078-1026,Public       ,322,264,586,20306,,9361,29667
00317200,OKLAHOMA STATE UNIVERSITY-OKMULGEE      ,OK,74447-3901,Public       ,54,111,165,2246,,2312,4558
00317400,OKLAHOMA PANHANDLE STATE UNIVERSITY     ,OK,73939-0000,Public       ,19,25,44,1029,,554,1583
00317600,CARL ALBERT STATE COLLEGE               ,OK,74953-5208,Public       ,41,91,132,1490,,2139,3629
00317800,SEMINOLE STATE COLLEGE                  ,OK,74818-0351,Public       ,40,88,128,1111,,1385,2496
00317900,SOUTHEASTERN OKLAHOMA STATE UNIV        ,OK,74701-0609,Public       ,49,135,184,2639,,2722,5361
00318000,SOUTHWESTERN CHRISTIAN UNIVERSITY       ,OK,73008-2335,Private      ,10,54,64,536,,839,1375
00318100,SOUTHWESTERN OKLAHOMA STATE UNIV        ,OK,73096-3098,Public       ,67,85,152,3464,,2244,5708
00318101,SOUTHWESTERN OK STATE UNIV AT SAYRE     ,OK,73662-0000,Public       ,10,10,20,170,,236,406
00318300,ST GREGORY'S UNIVERSITY                 ,OK,74804-2499,Private      ,5,20,25,491,,431,922
00318308,SAINT GREGORY'S UNIVERSITY - IPD TULSA  ,OK,74135-2499,Private      ,1,10,11,56,,293,349
00318400,UNIVERSITY OF OKLAHOMA                  ,OK,73019-4078,Public       ,270,395,665,19966,,11859,31825
00318401,UNIVERSITY OF OKLAHOMA-HLTH SCI CTR     ,OK,73190-0000,Public       ,13,83,96,953,,3912,4865
00318500,UNIVERSITY OF TULSA                     ,OK,74104-3189,Private      ,54,76,130,4114,,2566,6680
00398500,ORAL ROBERTS UNIVERSITY                 ,OK,74171-0001,Private      ,35,88,123,3344,,2066,5410
00531100,TULSA COUNTY AREA VOC TECH SCHOOL       ,OK,74145-0000,Public       ,26,97,123,659,,2056,2715
00531200,RED RIVER TECHNOLOGY CENTER             ,OK,73533-2700,Public       ,3,15,18,65,,208,273
00533900,METRO TECHNOLOGY CENTERS SCH DIST22     ,OK,73111-0000,Public       ,17,97,114,282,,1511,1793
00533903,METRO TECHNOLOGY CENTERS SCH DIST22     ,OK,73129-0000,Public       ,8,61,69,157,,843,1000
00694200,MID-AMERICA CHRISTIAN UNIVERSITY        ,OK,73170-4504,Private      ,21,269,290,609,,3746,4355
00767800,SPARTAN COLLEGE OF AERONAUTICS AND TECHN,OK,74115-5800,Proprietary  ,33,85,118,922,,960,1882
00791100,VIRGILS BEAUTY COLLEGE                  ,OK,74401-6802,Proprietary  ,0,11,11,24,,92,116
00834300,AUTRY TECHNOLOGY CENTER                 ,OK,73703-2598,Public       ,5,9,14,130,,321,451
00861900,TRI COUNTY TECHNOLOGY CENTER            ,OK,74006-6029,Public       ,1,10,11,80,,286,366
00918500,ROSE STATE COLLEGE                      ,OK,73110-2799,Public       ,119,385,504,3094,,6352,9446
00920400,KIAMICHI TECHNOLOGY CENTER              ,OK,74578-0548,Public       ,16,93,109,315,,1058,1373
00920408,KIAMICHI TECHNOLOGY CENTER - POTEAU CAMP,OK,74953-0825,Public       ,0,0,0,12,,51,63
00961800,TULSA WELDING SCHOOL                    ,OK,74104-0000,Proprietary  ,279,441,720,1851,,2787,4638
00964700,"OKLAHOMA STATE UNIV, OKLA CITY          ",OK,73107-6159,Public       ,119,456,575,3439,,7947,11386
00970800,EVES COLLEGE OF HAIRSTYLING             ,OK,73501-4359,Proprietary  ,3,27,30,48,,191,239
00976300,TULSA COMMUNITY COLLEGE                 ,OK,74135-6198,Public       ,235,757,992,9056,,14781,23837
00996300,CADDO KIOWA VOC TECH CENTER             ,OK,73038-0000,Public       ,2,17,19,76,,333,409
00996400,CENTRAL OKLAHOMA AREA VOC TECH SCH      ,OK,74030-9613,Public       ,8,40,48,126,,374,500
00996500,CANADIAN VALLEY TECHNOLOGY CENTER       ,OK,73036-9117,Public       ,6,31,37,96,,451,547
00996800,GORDON COOPER TECHNOLOGY CENTER         ,OK,74804-9913,Public       ,13,25,38,162,,488,650
01005300,INDIAN CAPITAL TECHNOLGY CENTER #4      ,OK,74403-9907,Public       ,15,45,60,282,,821,1103
01026600,HILLSDALE FREE WILL BAPTIST COLLEGE     ,OK,73153-0000,Private      ,0,7,7,220,,123,343
01034200,SOUTHERN OKLAHOMA TECHNOLOGY CENTER     ,OK,73401-2100,Public       ,3,20,23,147,,397,544
01039100,OKLAHOMA CITY COMMUNITY COLLEGE         ,OK,73159-4444,Public       ,237,703,940,5746,,10749,16495
01050304,WTI TULSA CAMPUS                        ,OK,74112-3140,Proprietary  ,4,27,31,62,,344,406
01071700,GREAT PLAINS TECHNOLOGY CENTER SCHOOL DI,OK,73505-8399,Public       ,7,30,37,217,,843,1060
01076200,WESTERN OK AREA VOC TECH SCH DIST12     ,OK,73624-1469,Public       ,3,5,8,61,,127,188
01120600,PIONEER TECHNOLOGY CENTER               ,OK,74601-1106,Public       ,4,20,24,40,,264,304
01128200,OKLAHOMA STATE UNV CLG OSTEOPTHC MD     ,OK,74107-0000,Public       ,2,20,22,151,,801,952
01153700,MID-AMERICA TECHNOLOGY CENTER           ,OK,73095-0210,Public       ,2,15,17,57,,164,221
01227200,MOORE-NORMAN TECHNOLOGY CENTER          ,OK,73069-8399,Public       ,12,57,69,291,,1052,1343
02052700,NORTHEAST TECHNOLOGY CENTER             ,OK,74361-0487,Public       ,6,32,38,209,,619,828
02060800,MERIDIAN TECHNOLOGY CENTER              ,OK,74074-0000,Public       ,4,19,23,185,,428,613
02126500,ENID BEAUTY COLLEGE                     ,OK,73701-0000,Proprietary  ,5,7,12,35,,73,108
02184400,SAND SPRINGS BEAUTY COLLEGE             ,OK,74063-0000,Proprietary  ,3,13,16,40,,140,180
02197300,HOLLYWOOD COSMETOLOGY CENTER            ,OK,73189-0000,Proprietary  ,1,7,8,29,,96,125
02222700,FRANCIS TUTTLE TECHNOLOGY CENTER        ,OK,73142-0000,Public       ,34,150,184,408,,1842,2250
02238500,CENTRAL STATE BEAUTY ACADEMY            ,OK,73162-6007,Proprietary  ,9,52,61,101,,432,533
02250900,E OK COUNTY AREA VO-TECH                ,OK,73020-0000,Public       ,0,0,0,44,,121,165
02256200,"BROKEN ARROW BEAUTY COLLEGE, INC        ",OK,74012-0000,Proprietary  ,10,30,40,105,,281,386
02282100,HIGH PLAINS AREA VOC-TECH               ,OK,73801-0000,Public       ,0,3,3,32,,93,125
02306800,PLATT COLLEGE                           ,OK,74145-0000,Proprietary  ,24,166,190,366,,1779,2145
02510300,BEAUTY TECHNICAL COLLEGE                ,OK,74465-0000,Proprietary  ,0,4,4,19,,63,82
02531200,WOODWARD BEAUTY COLLEGE                 ,OK,73801-0000,Proprietary  ,0,1,1,11,,41,52
02554300,AMERICAN BEAUTY INSTITUTE               ,OK,74501-0000,Proprietary  ,0,2,2,15,,74,89
02556500,YUKON BEAUTY COLLEGE                    ,OK,73099-4108,Proprietary  ,0,4,4,3,,37,40
02560200,PHILLIPS THEOLOGICAL SEMINARY -         ,OK,74116-5612,Private      ,0,2,2,5,,101,106
02581100,CLAREMORE BEAUTY COLLEGE                ,OK,74017-7034,Proprietary  ,0,4,4,8,,42,50
02581200,CC'S COSMETOLOGY COLLEGE                ,OK,74129-0000,Proprietary  ,2,24,26,75,,253,328
02591101,CAREER POINT INSTITUTE                  ,OK,74146-0000,Proprietary  ,5,22,27,79,,454,533
02597400,PONTOTOC TECHNOLOGY CENTER SCHOOL       ,OK,74820-8621,Public       ,3,11,14,76,,245,321
02599706,VATTEROTT COLLEGE - TULSA               ,OK,74146-2205,Proprietary  ,6,51,57,78,,534,612
02600000,NORTHWEST TECHNOLOG CTR SCH DIST 10     ,OK,73717-9600,Public       ,1,0,1,31,,68,99
02600500,WES WATKINS TECHNOLOGY CENTER           ,OK,74883-9660,Public       ,1,0,1,41,,149,190
02609205,VATTEROTT COLLEGE - OKLAHOMA CITY       ,OK,73127-2103,Proprietary  ,8,108,116,93,,896,989
03008700,SOUTHWEST TECHNOLOGY CENTER             ,OK,73521-1527,Public       ,3,13,16,56,,205,261
03024700,STILLWATER BEAUTY ACADEMY               ,OK,74075-3467,Proprietary  ,0,5,5,27,,65,92
03030700,OKLAHOMA SCHOOL OF PHOTOGRAPHY          ,OK,73160-3320,Proprietary  ,0,10,10,41,,158,199
03030800,AMERICAN BROADCASTING SCHOOL            ,OK,73115-3334,Proprietary  ,2,34,36,61,,353,414
03051100,CHISHOLM TRAIL TECHNOLOGY CENTER        ,OK,73764-6335,Public       ,2,8,10,7,,80,87
03078500,TECH INST OF COSMETOLOGY ARTS & SCI     ,OK,74120-3610,Proprietary  ,4,12,16,51,,163,214
03103800,SOUTHERN SCHOOL OF BEAUTY               ,OK,74701-5008,Proprietary  ,0,11,11,25,,83,108
03109800,PONCA CITY BEAUTY COLLEGE               ,OK,74601-4201,Proprietary  ,0,4,4,3,,38,41
03109801,BARTLESVILLE BEAUTY COLLEGE             ,OK,74003-2835,Proprietary  ,0,2,2,6,,33,39
03115100,HERITAGE COLLEGE                        ,OK,73119-0000,Proprietary  ,33,188,221,273,,1274,1547
03124800,PLATT COLLEGE                           ,OK,73501-3808,Proprietary  ,13,54,67,88,,565,653
03124901,IMAGINE -  PAUL MITCHELL PARTNER SCHOOL ,OK,73072-4831,Proprietary  ,9,20,29,155,,267,422
03126200,GREEN COUNTRY AREA VOC TECH SCHOOL      ,OK,74447-1217,Public       ,5,13,18,65,,191,256
03198400,MID-DEL AREA VOCATIONAL & TECH SCH      ,OK,73110-4825,Public       ,3,18,21,58,,189,247
03329400,PRYOR BEAUTY COLLEGE                    ,OK,74361-0000,Proprietary  ,1,6,7,12,,54,66
03329401,PRYOR BEAUTY COLLEGE - GROVE BEAUTY COLL,OK,74345-0009,Proprietary  ,0,5,5,7,,34,41
03329402,PRYOR BEAUTY COLLEGE - NORTH EAST OKLAHO,OK,74338-0000,Proprietary  ,0,1,1,1,,6,7
03367400,COMMUNITY CARE COLLEGE                  ,OK,74145-6420,Proprietary  ,73,325,398,588,,2105,2693
03396400,OKLAHOMA HEALTH ACADEMY                 ,OK,73160-3667,Proprietary  ,0,0,0,3,,3,6
03453400,SHAWNEE BEAUTY COLLEGE                  ,OK,74801-7014,Proprietary  ,0,7,7,16,,62,78
03676300,FAMILY OF FAITH COLLEGE                 ,OK,74802-1805,Private      ,0,0,0,15,,33,48
03831300,INSTITUTE OF HAIR DESIGN                ,OK,74804-0000,Proprietary  ,1,6,7,8,,51,59
03928300,CENTRAL STATE MASSAGE ACADEMY           ,OK,73162-6007,Proprietary  ,4,14,18,40,,155,195
04051324,ART INSTITUTE OF PHOENIX (THE) - BROWN M,OK,74146-5234,Proprietary  ,4,28,32,117,,433,550
04060300,AMERICAN INSTITUTE OF MEDICAL TECHNOLOGY,OK,74146-5201,Proprietary  ,5,28,33,120,,375,495
04062300,BROOKLINE COLLEGE                       ,OK,73114-6318,Proprietary  ,0,0,0,26,,126,152
04133600,CUTTER'S EDGE SCHOOL OF COSMETOLOGY     ,OK,74023-2905,Proprietary  ,0,9,9,8,,22,30
04144400,ACADEMY OF HAIR DESIGN (THE)            ,OK,73120-6808,Proprietary  ,3,19,22,56,,224,280
04184300,PAUL MITCHELL THE SCHOOL ARDMORE        ,OK,73401-3912,Proprietary  ,2,12,14,3,,27,30
04213600,RIVER VALLEY COSMETOLOGY INSTITUTE      ,OK,74953-5260,Proprietary  ,4,23,27,5,,28,33
04224700,JB'S HAIR DESIGN AND BARBER COLLEGE     ,OK,73139-1602,Proprietary  ,3,18,21,10,,52,62
04224900,COLLEGE OF THE MUSCOGEE NATION          ,OK,74447-0917,Public       ,6,11,17,11,,32,43
00163700,BETHANY THEOLOGICAL SEMINARY            ,IN,47374-0000,Private      ,0,1,1,2,,68,70
00178400,ANCILLA COLLEGE-FINANCIAL AID OFFC      ,IN,46513-0001,Private      ,10,12,22,477,,491,968
00178500,ANDERSON UNIVERSITY                     ,IN,46012-3495,Private      ,15,63,78,2830,,1362,4192
00178600,BALL STATE UNIVERSITY                   ,IN,47306-0880,Public       ,202,313,515,24305,,9799,34104
00178700,BETHEL COLLEGE INC                      ,IN,46545-5591,Private      ,13,59,72,1780,,1656,3436
00178800,BUTLER UNIVERSITY                       ,IN,46208-3487,Private      ,92,106,198,9166,,2785,11951
00178900,CHRISTIAN THEOLOGICAL SEMINARY          ,IN,46208-0000,Private      ,1,12,13,24,,367,391
00179200,DEPAUW UNIVERSITY                       ,IN,46135-0037,Private      ,31,9,40,3382,,210,3592
00179300,EARLHAM COLLEGE                         ,IN,47374-4095,Private      ,14,8,22,1609,,218,1827
00179301,EARLHAM SCHOOL OF RELIGION              ,IN,47374-0000,Private      ,1,1,2,14,,55,69
00179500,UNIVERSITY OF EVANSVILLE                ,IN,47722-0002,Private      ,24,30,54,3900,,1123,5023
00179800,FRANKLIN COLLEGE OF INDIANA             ,IN,46131-2623,Private      ,11,11,22,2098,,408,2506
00179900,GOSHEN COLLEGE                          ,IN,46526-4794,Private      ,7,14,21,1001,,560,1561
00180000,GRACE COLLEGE & THEO SEMINARY           ,IN,46590-1224,Private      ,10,26,36,2155,,670,2825
00180100,HANOVER COLLEGE                         ,IN,47243-0108,Private      ,13,5,18,2588,,156,2744
00180300,HUNTINGTON UNIVERSITY                   ,IN,46750-1299,Private      ,4,18,22,1383,,501,1884
00180400,UNIVERSITY OF INDIANAPOLIS              ,IN,46227-3697,Private      ,87,212,299,7132,,6377,13509
00180500,INDIANA INSTITUTE OF TECHNOLOGY         ,IN,46803-1297,Private      ,55,528,583,2630,,7681,10311
00180700,INDIANA STATE UNIVERSITY                ,IN,47809-2501,Public       ,153,266,419,15226,,8270,23496
00180800,UNIVERSITY OF SOUTHERN INDIANA          ,IN,47712-3596,Public       ,70,126,196,9689,,4756,14445
00180900,INDIANA UNIVERSITY-BLOOMINGTON          ,IN,47405-7000,Public       ,330,304,634,37229,,12667,49896
00181100,INDIANA UNIV-EAST                       ,IN,47374-1289,Public       ,26,135,161,2177,,3325,5502
00181300,INDIANA UNIV-PURDUE UNIV INDPLS         ,IN,46202-5145,Public       ,286,748,1034,24724,,26620,51344
00181301,INDIANA UNIVERSITY - PURDUE UNIVERSITY I,IN,47203-1769,Public       ,34,79,113,2193,,2460,4653
00181400,INDIANA UNIV KOKOMO                     ,IN,46902-3557,Public       ,45,93,138,2588,,3336,5924
00181500,INDIANA UNIV-NORTHWEST                  ,IN,46408-1197,Public       ,75,211,286,4577,,6842,11419
00181600,INDIANA UNIVERSITY - SOUTH BEND         ,IN,46615-0000,Public       ,60,194,254,5548,,6475,12023
00181700,INDIANA UNIVERSITY-SOUTHEAST            ,IN,47150-6405,Public       ,76,171,247,4797,,4633,9430
00182000,MANCHESTER COLLEGE                      ,IN,46962-1276,Private      ,21,6,27,2336,,468,2804
00182100,MARIAN UNIVERSITY                       ,IN,46222-1997,Private      ,36,129,165,2569,,3428,5997
00182200,INDIANA WESLEYAN UNIVERSITY             ,IN,46953-4974,Private      ,54,1223,1277,4824,,17962,22786
00182300,ASSOCIATED MENNONITE BIBLICAL SEM       ,IN,46517-1999,Private      ,1,2,3,13,,115,128
00182400,OAKLAND CITY UNIVERSITY                 ,IN,47660-1099,Private      ,5,39,44,598,,735,1333
00182500,PURDUE UNIVERSITY                       ,IN,47907-2050,Public       ,246,230,476,33218,,9132,42350
00182600,PURDUE UNIV NORTH CENTRAL CAMPUS        ,IN,46391-9542,Public       ,31,66,97,3348,,2811,6159
00182700,PURDUE UNIV CALUMET                     ,IN,46323-2094,Public       ,76,282,358,6033,,7512,13545
00182800,INDIANA UNIV-PURDUE UNIV FORT WAYNE     ,IN,46805-1499,Public       ,102,240,342,10611,,9024,19635
00183000,ROSE HULMAN INSTITUTE OF TECHNOLOGY     ,IN,47803-3999,Private      ,24,12,36,3876,,224,4100
00183200,UNIVERSITY OF SAINT FRANCIS             ,IN,46808-3994,Private      ,14,79,93,2555,,2451,5006
00183300,ST JOSEPH'S COLLEGE                     ,IN,47978-0000,Private      ,10,6,16,1606,,251,1857
00183400,CALUMET COLLEGE OF SAINT JOSEPH         ,IN,46394-2195,Private      ,10,49,59,683,,1000,1683
00183500,SAINT MARY-OF-THE-WOODS COLLEGE         ,IN,47876-0067,Private      ,3,62,65,427,,1191,1618
00183600,ST MARY'S COLLEGE                       ,IN,46556-5007,Private      ,10,1,11,1876,,162,2038
00183800,TAYLOR UNIVERSITY                       ,IN,46989-1001,Private      ,16,19,35,2585,,367,2952
00183900,TRINE UNIVERSITY                        ,IN,46703-1764,Private      ,20,42,62,3060,,1154,4214
00184000,UNIVERSITY OF NOTRE DAME                ,IN,46556-5602,Private      ,103,61,164,13846,,3396,17242
00184200,VALPARAISO UNIVERSITY                   ,IN,46383-6493,Private      ,57,49,106,5829,,2498,8327
00184300,VINCENNES UNIVERSITY                    ,IN,47591-1523,Public       ,115,338,453,7519,,5711,13230
00184400,WABASH COLLEGE                          ,IN,47933-0352,Private      ,13,3,16,1416,,83,1499
00420300,GOOD SAMARITAN HOSP RADIOGRAPHY PRG     ,IN,47591-0000,Public       ,0,0,0,0,,1,1
00457900,INTERNATIONAL BUSINESS COLLEGE          ,IN,46804-0000,Proprietary  ,12,28,40,690,,558,1248
00457901,INTERNATIONAL BUSINESS COLLEGE          ,IN,46256-0000,Proprietary  ,19,46,65,864,,736,1600
00625700,SAINT ELIZABETH SCHOOL OF NURSING       ,IN,47904-2198,Private      ,4,10,14,246,,567,813
00638510,CHAMBERLAIN COLLEGE OF NURSING - INDIANA,IN,46240-2158,Proprietary  ,4,84,88,19,,193,212
00726300,HOLY CROSS COLLEGE                      ,IN,46556-0308,Private      ,7,5,12,750,,171,921
00727600,SAINT MEINRAD SCHOOL OF THEOLOGY        ,IN,47577-1002,Private      ,0,1,1,1,,126,127
00732900,ITT TECHNICAL INSTITUTE                 ,IN,46268-1119,Proprietary  ,547,3099,3646,4223,,22145,26368
00732933,ITT TECHNICAL INSTITUTE                 ,IN,46635-1512,Proprietary  ,20,86,106,452,,1481,1933
00732962,ITT TECHNICAL INSTITUTE                 ,IN,47630-7430,Proprietary  ,110,637,747,945,,4853,5798
00732968,ITT TECHNICAL INSTITUTE                 ,IN,46410-0000,Proprietary  ,16,73,89,323,,1044,1367
00732993,ITT TECHNICAL INSTITUTE                 ,IN,46825-2393,Proprietary  ,68,410,478,1031,,3559,4590
00736200,MEDTECH COLLEGE                         ,IN,46250-3970,Proprietary  ,15,140,155,414,,2634,3048
00736202,MEDTECH COLLEGE - GREENWOOD             ,IN,46143-6478,Proprietary  ,18,76,94,247,,1216,1463
00736204,MEDTECH COLLEGE - FORT WAYNE            ,IN,46804-2209,Proprietary  ,11,99,110,254,,1310,1564
00757311,EMPIRE BEAUTY SCHOOL - INDIANAPOLIS     ,IN,46237-3249,Proprietary  ,0,0,0,252,,712,964
00793800,LINCOLN COLLEGE OF TECHNOLOGY           ,IN,46202-0000,Proprietary  ,188,165,353,2266,,1475,3741
00931306,DAYMAR COLLEGE - ROCKPORT               ,IN,47635-1506,Proprietary  ,0,6,6,10,,41,51
00951500,J MICHAEL HARROLD BEAUTY ACADEMY        ,IN,47807-3390,Proprietary  ,9,13,22,90,,222,312
00961200,"APEX SCHOOL OF BEAUTY CULTURE, INC      ",IN,46016-0000,Proprietary  ,0,10,10,29,,86,115
00961300,MERRILLVILLE BEAUTY COLLEGE             ,IN,46410-3401,Proprietary  ,15,39,54,77,,222,299
00967300,RUDAE'S SCHOOL OF BEAUTY CULTURE        ,IN,46825-5444,Proprietary  ,7,27,34,155,,343,498
00977700,KAPLAN COLLEGE                          ,IN,46278-1736,Proprietary  ,9,89,98,381,,1807,2188
00977702,KAPLAN COLLEGE - TEMPORARY FACILITY EXPA,IN,46268-4111,Proprietary  ,0,4,4,22,,143,165
00991700,IVY TECH COMMUNITY COLLEGE OF INDIANA   ,IN,46208-1763,Public       ,1248,5124,6372,46994,,110684,157678
01015100,VINCENNES BEAUTY COLLEGE                ,IN,47591-1297,Proprietary  ,4,10,14,106,,150,256
01040900,LAFAYETTE BEAUTY ACADEMY                ,IN,47901-1149,Proprietary  ,9,21,30,112,,227,339
01048900,NATIONAL COLLEGE                        ,IN,46250-1930,Proprietary  ,2,36,38,70,,560,630
01048910,NATIONAL COLLEGE - SOUTH BEND           ,IN,46617-3123,Proprietary  ,3,33,36,118,,614,732
01048911,NATIONAL COLLEGE - FORT WAYNE           ,IN,46826-4905,Proprietary  ,1,23,24,81,,408,489
01061800,MID-AMERICA CLG FUNERAL SERVICE         ,IN,47130-9990,Private      ,3,8,11,89,,146,235
01150500,CREATIVE HAIR STYLING ACADEMY           ,IN,46322-1554,Proprietary  ,7,21,28,137,,269,406
02084800,RAVENSCROFT BEAUTY COLLEGE              ,IN,46815-0000,Proprietary  ,9,32,41,117,,366,483
02087600,CONCORDIA THEOLOGICAL SEMINARY          ,IN,46825-0000,Private      ,0,8,8,15,,282,297
02100402,EVEREST INSTITUTE - EVEREST COLLEGE     ,IN,46410-7064,Proprietary  ,29,157,186,349,,1578,1927
02140800,MARTIN UNIVERSITY                       ,IN,46218-0000,Private      ,9,71,80,233,,1564,1797
02158400,HARRISON COLLEGE                        ,IN,46204-2611,Proprietary  ,54,329,383,744,,4175,4919
02158401,HARRISON COLLEGE - COLUMBUS             ,IN,47203-1843,Proprietary  ,17,52,69,190,,691,881
02158402,HARRISON COLLEGE - LAFAYETTE            ,IN,47905-4859,Proprietary  ,13,55,68,202,,873,1075
02158405,HARRISON COLLEGE - TERRE HAUTE          ,IN,47802-0000,Proprietary  ,9,65,74,159,,797,956
02158407,HARRISON COLLEGE - ANDERSON             ,IN,46013-0000,Proprietary  ,7,67,74,154,,746,900
02158409,HARRISON COLLEGE - EVANSVILLE           ,IN,47715-3901,Proprietary  ,10,57,67,210,,710,920
02158410,HARRISON COLLEGE - EAST                 ,IN,46239-8903,Proprietary  ,23,90,113,309,,1361,1670
02158412,HARRISON COLLEGE - FORT WAYNE           ,IN,46825-0000,Proprietary  ,8,74,82,181,,840,1021
02158413,HARRISON COLLEGE - NORTHWEST            ,IN,46278-0000,Proprietary  ,9,29,38,229,,557,786
02158415,HARRISON COLLEGE - MUNCIE               ,IN,47303-0000,Proprietary  ,5,15,20,135,,497,632
02158416,HARRISON COLLEGE - ELKHART              ,IN,46516-0000,Proprietary  ,6,33,39,91,,426,517
02158800,DON ROBERTS BEAUTY SCHOOLS              ,IN,46383-0000,Proprietary  ,1,10,11,49,,129,178
02164300,DON ROBERTS SCHOOL OF HAIR DESIGN       ,IN,46375-9999,Proprietary  ,4,12,16,53,,98,151
02180108,ROSS MEDICAL EDUCATION CENTER -         ,IN,46530-4479,Proprietary  ,1,13,14,39,,189,228
02201800,KAPLAN COLLEGE                          ,IN,46324-3347,Proprietary  ,9,88,97,266,,1015,1281
02201806,KAPLAN COLLEGE - SOUTHEAST INDIANAPOLIS ,IN,46227-1493,Proprietary  ,39,154,193,278,,1209,1487
02241700,PJ'S COLLEGE OF COSMETOLOGY             ,IN,47129-0000,Proprietary  ,7,23,30,81,,248,329
02245505,FORTIS COLLEGE - INDIANAPOLIS CAMPUS    ,IN,46268-0000,Proprietary  ,5,48,53,101,,556,657
02302700,J EVERETT LIGHT CAREER CENTER           ,IN,46240-0000,Public       ,3,16,19,119,,577,696
02304800,PJ'S COLLEGE OF COSMETOLOGY             ,IN,47374-0000,Proprietary  ,2,15,17,48,,173,221
02308900,MASTER'S OF COSMETOLOGY COLLEGE         ,IN,46809-0000,Proprietary  ,5,14,19,146,,240,386
02339600,ROGER'S ACADEMY OF HAIR DESIGN          ,IN,47712-0000,Proprietary  ,5,19,24,102,,246,348
02351300,KNOX BEAUTY COLLEGE                     ,IN,46534-0000,Proprietary  ,0,7,7,25,,50,75
02490500,HAIR FASHIONS BY KAYE BEAUTY CLG        ,IN,46250-0000,Proprietary  ,5,33,38,105,,442,547
02490800,HAIR FASHIONS BY KAYE BEAUTY CLG        ,IN,46060-0000,Proprietary  ,2,16,18,42,,109,151
02607000,HAIR ARTS ACADEMY                       ,IN,47404-2419,Proprietary  ,2,18,20,63,,176,239
02615800,COLLEGE OF COURT REPORTING              ,IN,46342-5969,Proprietary  ,4,23,27,40,,376,416
03100600,MARION COMM TUCKER AREA VOC SCHOOL      ,IN,46952-3831,Public       ,1,12,13,74,,188,262
03176300,AVIATION INSTITUTE OF MAINTENANCE       ,IN,46241-1445,Proprietary  ,12,50,62,143,,484,627
03262300,DAVID DEMUTH INSTITUTE OF COSM          ,IN,47374-4101,Proprietary  ,0,0,0,16,,31,47
03456700,CROSSROADS BIBLE COLLEGE                ,IN,46219-4912,Private      ,2,35,37,89,,500,589
03538300,ALEXANDRIA SCH OF SCIENTIFIC THERAP     ,IN,46001-0287,Proprietary  ,1,4,5,19,,87,106
04038700,IDEAL BEAUTY ACADEMY                    ,IN,47130-4215,Proprietary  ,3,8,11,24,,95,119
04051304,ART INSTITUTE OF PHOENIX (THE) - ART  IN,IN,46268-1170,Proprietary  ,55,98,153,1262,,1373,2635
04051311,ART INSTITUTE OF PHOENIX (THE) - BROWN M,IN,46410-5608,Proprietary  ,10,65,75,216,,1015,1231
04051312,ART INSTITUTE OF PHOENIX (THE) - BROWN M,IN,46360-7362,Proprietary  ,7,35,42,136,,507,643
04051318,ART INSTITUTE OF PHOENIX (THE) - BROWN M,IN,46204-1017,Proprietary  ,10,164,174,380,,2082,2462
04051321,ART INSTITUTE OF PHOENIX (THE) - BROWN M,IN,46635-1176,Proprietary  ,12,49,61,233,,904,1137
04051322,ART INSTITUTE OF PHOENIX (THE) - BROWN M,IN,46805-0000,Proprietary  ,8,73,81,262,,1257,1519
04100300,SUCCESS SCHOOLS                         ,IN,46410-5310,Proprietary  ,9,32,41,102,,330,432
04121000,TECHSKILLS - INDIANAPOLIS               ,IN,46240-4302,Proprietary  ,5,109,114,125,,667,792
04130900,HONORS BEAUTY COLLEGE                   ,IN,46256-3317,Proprietary  ,8,29,37,117,,364,481
04155900,AVEDA FREDRIC'S INSTITUTE               ,IN,46250-4746,Proprietary  ,5,29,34,186,,335,521
04166700,REM SPA INC                             ,IN,46013-3136,Proprietary  ,1,21,22,64,,171,235
04171700,AVANT GARD THE SCHOOL                   ,IN,46214-6500,Proprietary  ,2,7,9,41,,88,129
04172700,SALON PROFESSIONAL ACADEMY (THE)        ,IN,47715-7822,Proprietary  ,6,11,17,135,,210,345
04184000,PAUL MITCHELL THE SCHOOL INDIANAPOLIS   ,IN,46227-6252,Proprietary  ,6,34,40,195,,384,579
04186600,SALON PROFESSIONAL ACADEMY (THE)        ,IN,46901-6248,Proprietary  ,4,16,20,84,,205,289
04205500,LIL LOU'S BARBER COLLEGE                ,IN,46409-2645,Proprietary  ,0,22,22,37,,218,255
04230300,EXCEL ACADEMIES OF COSMETOLOGY - MERRILL,IN,46410-5540,Proprietary  ,3,6,9,3,,6,9
00190100,ALLEN COUNTY COMMUNITY COLLEGE          ,KS,66749-1607,Public       ,30,88,118,1183,,1754,2937
00190200,COWLEY COUNTY COMMUNITY COLLEGE & AREA V,KS,67005-2662,Public       ,52,164,216,1839,,3087,4926
00190300,BAKER UNIVERSITY                        ,KS,66006-0065,Private      ,18,224,242,1485,,2472,3957
00190400,BETHANY COLLEGE                         ,KS,67456-1897,Private      ,13,9,22,845,,160,1005
00190500,BETHEL COLLEGE                          ,KS,67117-8061,Private      ,14,6,20,795,,180,975
00190600,BUTLER COUNTY COMMUNITY COLLEGE         ,KS,67042-3280,Public       ,153,291,444,4915,,5889,10804
00190700,CENTRAL BAPTIST THEOLOGY SEMINARY       ,KS,66226-3513,Private      ,0,3,3,0,,72,72
00190800,CENTRAL CHRISTIAN COLLEGE OF KANSAS     ,KS,67460-5799,Private      ,9,151,160,491,,912,1403
00190900,CLOUD COUNTY COMMUNITY COLLEGE          ,KS,66901-1002,Public       ,14,71,85,907,,1147,2054
00191000,COFFEYVILLE COMMUNITY COLLEGE           ,KS,67337-5064,Public       ,53,30,83,1186,,597,1783
00191100,COLBY COMMUNITY COLLEGE                 ,KS,67701-4099,Public       ,13,29,42,707,,604,1311
00191300,DODGE CITY COMMUNITY COLLEGE            ,KS,67801-2399,Public       ,34,64,98,1032,,819,1851
00191400,DONNELLY COLLEGE                        ,KS,66102-4298,Private      ,17,54,71,351,,796,1147
00191500,FORT HAYS STATE UNIVERSITY              ,KS,67601-4099,Public       ,33,268,301,4546,,6861,11407
00191600,FORT SCOTT COMMUNITY COLLEGE            ,KS,66701-3199,Public       ,61,57,118,1258,,1141,2399
00191700,BARCLAY COLLEGE                         ,KS,67059-0288,Private      ,7,14,21,169,,156,325
00191800,FRIENDS UNIVERSITY                      ,KS,67213-3397,Private      ,20,111,131,1470,,2706,4176
00191900,GARDEN CITY COMMUNITY COLLEGE           ,KS,67846-6398,Public       ,47,51,98,1073,,813,1886
00192000,HESSTON COLLEGE                         ,KS,67062-2093,Private      ,1,3,4,506,,189,695
00192100,HIGHLAND COMMUNITY COLLEGE              ,KS,66035-4062,Public       ,29,68,97,1356,,1578,2934
00192300,HUTCHINSON COMMUNITY COLLEGE            ,KS,67501-5894,Public       ,79,169,248,2513,,3043,5556
00192400,INDEPENDENCE COMMUNITY COLLEGE          ,KS,67301-0708,Public       ,43,23,66,687,,532,1219
00192500,KANSAS CITY KANSAS COMMUNITY CLG        ,KS,66112-9978,Public       ,84,288,372,2507,,5990,8497
00192600,PITTSBURG STATE UNIVERSITY              ,KS,66762-7500,Public       ,59,99,158,5890,,3228,9118
00192700,EMPORIA STATE UNIVERSITY                ,KS,66801-5087,Public       ,40,124,164,3698,,3208,6906
00192800,KANSAS STATE UNIVERSITY                 ,KS,66506-1104,Public       ,192,256,448,17960,,7810,25770
00192900,KANSAS WESLEYAN UNIVERSITY              ,KS,67401-6196,Private      ,13,14,27,1074,,389,1463
00193000,LABETTE COMMUNITY COLLEGE               ,KS,67357-4299,Public       ,15,66,81,641,,968,1609
00193100,MANHATTAN CHRISTIAN COLLEGE             ,KS,66502-4081,Private      ,1,6,7,371,,143,514
00193300,MCPHERSON COLLEGE                       ,KS,67460-3899,Private      ,6,4,10,917,,195,1112
00193600,NEOSHO COUNTY COMMUNITY COLLEGE         ,KS,66720-2699,Public       ,19,72,91,997,,1376,2373
00193700,OTTAWA UNIVERSITY                       ,KS,66067-3399,Private      ,21,258,279,994,,3177,4171
00193800,PRATT COMMUNITY COLLEGE                 ,KS,67124-8432,Public       ,12,47,59,691,,885,1576
00193900,NEWMAN UNIVERSITY                       ,KS,67213-2084,Private      ,16,93,109,1491,,1896,3387
00194000,SOUTHWESTERN COLLEGE                    ,KS,67156-2499,Private      ,6,93,99,912,,1585,2497
00194300,UNIVERSITY OF ST MARY                   ,KS,66048-5023,Private      ,10,62,72,765,,1005,1770
00194500,STERLING COLLEGE                        ,KS,67579-1533,Private      ,12,19,31,885,,215,1100
00194600,TABOR COLLEGE                           ,KS,67063-1799,Private      ,14,24,38,948,,317,1265
00194800,UNIVERSITY OF KANSAS                    ,KS,66045-7535,Public       ,245,307,552,18566,,11165,29731
00194900,WASHBURN UNIVERSITY                     ,KS,66621-1110,Public       ,49,126,175,3851,,4542,8393
00194901,WASHBURN INSTITUTE OF TECHNOLOGY        ,KS,66604-2199,Public       ,9,35,44,451,,1088,1539
00195000,WICHITA STATE UNIVERSITY                ,KS,67208-0000,Public       ,148,334,482,8268,,9244,17512
00460800,BARTON COUNTY COMMUNITY COLLEGE         ,KS,67530-9283,Public       ,28,207,235,1106,,2706,3812
00526400,FLINT HILLS TECHNICAL COLLEGE           ,KS,66801-5999,Public       ,2,16,18,347,,603,950
00526500,NORTH CENTRAL KANSAS TECH COLG          ,KS,67420-0000,Public       ,7,13,20,409,,382,791
00526700,NORTHWEST KANSAS TECHNICAL SCHOOL       ,KS,67735-3441,Public       ,7,7,14,357,,193,550
00549800,WICHITA AREA TECHNICAL COLLEGE          ,KS,67211-2099,Public       ,52,250,302,924,,3585,4509
00549900,SALINA AREA TECHNICAL COLLEGE           ,KS,67401-8195,Public       ,6,9,15,246,,315,561
00550000,MANHATTAN AREA TECHNICAL COLLEGE        ,KS,66503-2499,Public       ,13,29,42,522,,955,1477
00675500,BROWN MACKIE COLLEGE (THE)              ,KS,67401-7307,Proprietary  ,24,186,210,559,,2072,2631
00703200,MID AMERICA NAZARENE UNIVERSITY         ,KS,66062-1899,Private      ,9,89,98,1147,,1473,2620
00822800,SEWARD CO COMM CO/AREA TECHNICAL SCHOOL ,KS,67905-0000,Public       ,18,27,45,609,,549,1158
00824400,JOHNSON COUNTY COMMUNITY COLLEGE        ,KS,66210-1299,Public       ,153,392,545,6707,,9145,15852
00833200,B-STREET DESIGN SCHOOL OF INTERNATIONAL ,KS,66502-6082,Proprietary  ,7,25,32,46,,137,183
00833201,B-STREET DESIGN SCHOOL OF INTERNATIONAL ,KS,66046-2743,Proprietary  ,4,9,13,44,,89,133
00869423,RASMUSSEN COLLEGE - OVERLAND PARK       ,KS,66210-2786,Proprietary  ,2,37,39,14,,133,147
00869424,RASMUSSEN COLLEGE - TOPEKA              ,KS,66606-2339,Proprietary  ,7,35,42,62,,285,347
01025600,BENEDICTINE COLLEGE                     ,KS,66002-1499,Private      ,17,8,25,2535,,220,2755
01043800,HASKELL INDIAN NATIONS UNIVERSITY       ,KS,66046-4800,Public       ,28,26,54,1264,,792,2056
01050300,WICHITA TECHNICAL INSTITUTE             ,KS,67213-1927,Proprietary  ,32,141,173,265,,1255,1520
01050302,WICHITA TECHNICAL INSTITUTE - WTI TOPEKA,KS,66609-1217,Proprietary  ,3,58,61,81,,512,593
01050305,WICHITA TECHNICAL INSTITUTE - EAST CAMPU,KS,67208-4243,Proprietary  ,5,45,50,99,,496,595
02090700,CLEVELAND CHIROPRACTIC COLLEGE          ,KS,66210-1613,Private      ,2,9,11,55,,621,676
02134800,OLD TOWN BARBER AND BEAUTY COLLEGE      ,KS,67211-0000,Proprietary  ,3,16,19,46,,183,229
02257700,HAYS ACADEMY OF HAIR DESIGN             ,KS,67601-3685,Proprietary  ,4,8,12,94,,129,223
02257702,HAYS ACADEMY OF HAIR DESIGN -           ,KS,67401-0000,Proprietary  ,2,3,5,8,,23,31
02340700,LABARON HAIRDRESSING ACADEMY            ,KS,66204-0000,Proprietary  ,2,5,7,24,,57,81
02590900,WRIGHT CAREER COLLEGE                   ,KS,66212-0000,Private      ,40,399,439,449,,3624,4073
02599709,VATTEROTT COLLEGE - WICHITA             ,KS,67226-1304,Proprietary  ,9,72,81,119,,663,782
02603100,XENON INTERNATIONAL ACADEMY             ,KS,67203-5428,Proprietary  ,10,30,40,152,,308,460
02606300,PAUL MITCHELL THE SCHOOL WICHITA        ,KS,67226-2803,Proprietary  ,10,19,29,120,,247,367
02611005,HERITAGE COLLEGE - WICHITA              ,KS,67210-1879,Proprietary  ,17,96,113,218,,783,1001
02613000,PINNACLE CAREER INSTITUTE               ,KS,66046-2703,Proprietary  ,9,51,60,82,,474,556
03031300,XENON INTERNATIONAL ACADEMY IV          ,KS,66061-3765,Proprietary  ,4,10,14,42,,92,134
03066200,BRYAN COLLEGE                           ,KS,66604-2496,Proprietary  ,3,29,32,53,,314,367
03450300,B-STREET DESIGN SCHOOL OF INTERNATIONAL ,KS,66611-2373,Proprietary  ,9,15,24,66,,180,246
03450301,B-STREET DESIGN SCHOOL OF INTERNATIONAL ,KS,67207-5148,Proprietary  ,6,19,25,48,,152,200
03450302,MARINELLO SCHOOL OF BEAUTY - OVERLAND PA,KS,66212-5451,Proprietary  ,11,44,55,79,,216,295
03529300,SIDNEY'S HAIRDRESSING COLLEGE           ,KS,67501-7094,Proprietary  ,1,4,5,26,,66,92
04132900,Z HAIR ACADEMY                          ,KS,66046-4040,Proprietary  ,9,7,16,67,,83,150
04162700,ERIC FISHER ACADEMY                     ,KS,67212-3376,Proprietary  ,13,23,36,159,,242,401
04175700,ACADEMY OF AESTHETIC ARTS               ,KS,66203-3502,Proprietary  ,3,12,15,20,,71,91
04179600,ENTOURAGE INSTITUTE OF BEAUTY AND ESTHET,KS,66215-3803,Proprietary  ,2,20,22,26,,113,139
04205300,MITSU SATO HAIR ACADEMY                 ,KS,66212-1457,Proprietary  ,1,6,7,29,,55,84
04209300,PAUL MITCHELL THE SCHOOL - OVERLAND PARK,KS,66212-4050,Proprietary  ,5,15,20,136,,201,337
00203300,UNIVERSITY OF MAINE-PRESQUE ISLE        ,ME,04769-2888,Public       ,6,17,23,885,,656,1541
00203500,BANGOR THEOLOGICAL SEMINARY             ,ME,04402-0411,Private      ,0,0,0,3,,24,27
00203600,BATES COLLEGE                           ,ME,04240-6028,Private      ,18,6,24,3143,,139,3282
00203800,BOWDOIN COLLEGE                         ,ME,04011-8451,Private      ,21,4,25,4167,,151,4318
00203900,COLBY COLLEGE                           ,ME,04901-8841,Private      ,16,2,18,3159,,126,3285
00204000,UNIVERSITY OF MAINE-FARMINGTON          ,ME,04938-1990,Public       ,15,13,28,2897,,640,3537
00204100,UNIVERSITY OF MAINE-FORT KENT           ,ME,04743-1292,Public       ,5,24,29,735,,596,1331
00204300,HUSSON UNIVERSITY                       ,ME,04401-2999,Private      ,26,39,65,2849,,1659,4508
00204400,MAINE MARITIME ACADEMY                  ,ME,04420-0001,Public       ,13,4,17,1252,,171,1423
00205000,UNIVERSITY OF NEW ENGLAND               ,ME,04005-9599,Private      ,30,131,161,4863,,4905,9768
00205100,SAINT JOSEPH'S COLLEGE                  ,ME,04084-5236,Private      ,11,81,92,1885,,1836,3721
00205200,THOMAS COLLEGE                          ,ME,04901-5097,Private      ,16,9,25,1226,,344,1570
00205300,UNIVERSITY OF MAINE                     ,ME,04469-0001,Public       ,98,79,177,12734,,3276,16010
00205400,UNIVERSITY OF SOUTHERN MAINE            ,ME,04104-0000,Public       ,61,143,204,6943,,6174,13117
00205500,UNIVERSITY OF MAINE-MACHIAS             ,ME,04654-1397,Public       ,5,18,23,608,,465,1073
00458615,KAPLAN UNIVERSITY - PORTLAND            ,ME,04106-2415,Proprietary  ,9,75,84,178,,1112,1290
00458616,KAPLAN UNIVERSITY - LEWISTON            ,ME,04240-0000,Proprietary  ,7,93,100,155,,1253,1408
00458617,KAPLAN UNIVERSITY - AUGUSTA             ,ME,04330-8038,Proprietary  ,12,94,106,30,,253,283
00520400,BEAL COLLEGE                            ,ME,04401-6896,Proprietary  ,9,65,74,350,,828,1178
00527600,CENTRAL MAINE COMMUNITY COLLEGE         ,ME,04210-6498,Public       ,34,76,110,1671,,2342,4013
00527700,EASTERN MAINE COMMUNITY COLLEGE         ,ME,04401-4280,Public       ,23,56,79,1907,,2022,3929
00552500,SOUTHERN MAINE COMMUNITY  COLLEGE       ,ME,04106-1698,Public       ,68,144,212,4369,,5053,9422
00576000,NORTHERN MAINE COMMUNITY COLLEGE        ,ME,04769-2016,Public       ,12,18,30,561,,661,1222
00630500,CENTRAL MAINE MEDICAL CENTER COLLEGE OF ,ME,04243-9986,Private      ,0,5,5,125,,366,491
00676000,UNIVERSITY OF MAINE-AUGUSTA             ,ME,04330-9410,Public       ,32,150,182,1835,,5573,7408
00685800,UNITY COLLEGE                           ,ME,04988-9502,Private      ,8,4,12,904,,148,1052
00903800,MR BERNARD'S SCH HAIR FASHION INC       ,ME,04243-1163,Proprietary  ,5,20,25,50,,170,220
00923100,WASHINGTON COUNTY COMMUNITY COLLEGE     ,ME,04619-9704,Public       ,5,5,10,280,,330,610
00945900,EMPIRE BEAUTY SCHOOL                    ,ME,04101-3348,Proprietary  ,63,207,270,415,,924,1339
00982600,KENNEBEC VALLEY  COMMUNITY  COLLEGE     ,ME,04937-1367,Public       ,16,61,77,975,,2087,3062
01138500,COLLEGE OF THE ATLANTIC                 ,ME,04609-1105,Private      ,1,4,5,622,,114,736
01167300,MAINE COLLEGE OF ART                    ,ME,04101-3987,Private      ,11,10,21,734,,263,997
02104400,SPA TECH INSTITUTE                      ,ME,04093-0000,Proprietary  ,22,66,88,194,,519,713
02347100,NEW ENGLAND SCHOOL OF COMMUNICATIONS    ,ME,04401-0000,Private      ,7,6,13,599,,201,800
02361300,LANDING SCHOOL OF BOATBUILDING & DESIGN ,ME,04046-1490,Private      ,0,0,0,39,,49,88
03122900,YORK COUNTY COMMUNITY COLLEGE           ,ME,04090-0529,Public       ,17,64,81,777,,1178,1955
03429300,SEACOAST CAREER SCHOOLS                 ,ME,04073-0000,Proprietary  ,24,119,143,147,,624,771
03612300,BIRTHWISE MIDWIFERY SCHOOL              ,ME,04009-1110,Proprietary  ,0,4,4,12,,94,106
04177400,CAPILO SCHOOL OF HAIR DESIGN            ,ME,04330-0000,Proprietary  ,11,22,33,104,,178,282
04185100,NORTHEAST TECHNICAL INSTITUTE           ,ME,04074-0000,Proprietary  ,20,132,152,141,,831,972
04188800,INSTITUTE FOR DOCTORAL STUDIES IN THE VI,ME,04102-0000,Private      ,0,3,3,2,,74,76
04214100,COSMOTECH SCHOOL OF COSMETOLOGY         ,ME,04092-2878,Proprietary  ,3,4,7,23,,43,66
00209300,ST JOHN'S COLLEGE                       ,NM,87505-4599,Private      ,5,13,18,382,,232,614
00264900,SANTA FE UNIVERSITY OF ART AND DESIGN   ,NM,87505-7634,Proprietary  ,15,11,26,1088,,350,1438
00265000,UNIVERSITY OF THE SOUTHWEST             ,NM,88240-9129,Private      ,8,67,75,366,,1164,1530
00265100,EASTERN NEW MEXICO UNIV PORTALES        ,NM,88130-6000,Public       ,49,141,190,3576,,3267,6843
00265101,EASTERN NEW MEXICO UNIV-ROSWELL CAM     ,NM,88202-0000,Public       ,45,115,160,1344,,1804,3148
00265300,NEW MEXICO HIGHLANDS UNIVERSITY         ,NM,87701-4436,Public       ,42,86,128,2370,,2862,5232
00265400,NEW MEXICO INST OF MINING & TECH        ,NM,87801-4796,Public       ,23,20,43,1474,,585,2059
00265500,NEW MEXICO JUNIOR COLLEGE               ,NM,88240-9123,Public       ,26,53,79,877,,1071,1948
00265600,NEW MEXICO MILITARY INSTITUTE           ,NM,88201-5173,Public       ,20,1,21,548,,88,636
00265700,NEW MEXICO STATE UNIVERSITY             ,NM,88003-8001,Public       ,229,288,517,12913,,9077,21990
00265701,NEW MEXICO STATE UNIV-ALAMOGORDO        ,NM,88311-0000,Public       ,33,91,124,657,,1577,2234
00265702,NEW MEXICO STATE UNIV.-DONA ANA CLG     ,NM,88003-0000,Public       ,100,248,348,3628,,5222,8850
00265703,NEW MEXICO STATE UNIV-CARLSBAD          ,NM,88220-0000,Public       ,18,57,75,447,,744,1191
00265704,NEW MEXICO STATE UNIV-GRANTS            ,NM,87020-0000,Public       ,16,43,59,301,,647,948
00266000,SAN JUAN COLLEGE                        ,NM,87402-4699,Public       ,88,222,310,2441,,5623,8064
00266300,THE UNIVERSITY OF NEW MEXICO            ,NM,87131-0001,Public       ,404,826,1230,20873,,21562,42435
00266400,WESTERN NEW MEXICO UNIVERSITY           ,NM,88061-5417,Public       ,38,74,112,1688,,2346,4034
00405701,NATIONAL AMERICAN UNIVERSITY            ,NM,87110-0000,Proprietary  ,2,40,42,117,,756,873
00474200,CENTRAL NEW MEXICO COMMUNITY COLLEGE    ,NM,87106-4096,Public       ,280,1072,1352,10072,,20371,30443
00474300,CLOVIS COMMUNITY COLLEGE                ,NM,88101-8381,Public       ,36,131,167,773,,2026,2799
00996200,LUNA COMMUNITY COLLEGE                  ,NM,87701-0000,Public       ,24,35,59,589,,714,1303
01063200,DEWOLFF CLG HAIRSTYLING/COSMETOLOGY     ,NM,87112-4113,Proprietary  ,7,24,31,107,,267,374
01300500,OLYMPIAN UNIVERSITY OF COSMETOLOGY      ,NM,88310-5051,Proprietary  ,37,184,221,417,,1341,1758
02083900,NORTHERN NEW MEXICO COLLEGE             ,NM,87530-0000,Public       ,29,77,106,711,,1031,1742
02146400,INSTITUTE OF AMERICAN INDIAN ARTS       ,NM,87508-0000,Public       ,5,14,19,207,,329,536
02218808,BROOKLINE COLLEGE - ALBUQUERQUE         ,NM,87105-1649,Proprietary  ,25,82,107,283,,987,1270
02278100,SANTA FE COMMUNITY COLLEGE              ,NM,87507-0000,Public       ,43,197,240,1257,,3112,4369
02293203,ATI CAREER TRAINING CENTER - ALBUQUERQUE,NM,87109-2016,Proprietary  ,0,0,0,5,,20,25
02357600,NAVAJO TECHNICAL COLLEGE                ,NM,87313-0000,Public       ,39,146,185,706,,1672,2378
02511000,SOUTHWESTERN INDIAN POLYTECH INST       ,NM,87184-0000,Public       ,20,41,61,403,,651,1054
02572003,COMPUTER CAREER CENTER - LAS CRUCES CAMP,NM,88011-8220,Proprietary  ,17,78,95,188,,688,876
02622000,SOUTHWEST ACUPUNCTURE COLLEGE           ,NM,87505-0000,Proprietary  ,0,5,5,4,,299,303
03076100,SOUTHWESTERN COLLEGE                    ,NM,87507-0000,Private      ,0,8,8,31,,291,322
03206300,MESALANDS COMMUNITY COLLEGE             ,NM,88401-3352,Public       ,4,22,26,155,,200,355
03430300,UNIVERSAL THERAPEUTIC MASSAGE INSTITUTE ,NM,87107-4403,Proprietary  ,1,23,24,50,,233,283
03678300,PIMA MEDICAL INSTITUTE                  ,NM,87110-0000,Proprietary  ,25,70,95,412,,1012,1424
03944300,MASSAGE THERAPY TRAINING INSTITUTE      ,NM,88007-0000,Proprietary  ,2,7,9,56,,128,184
04162400,TONI AND GUY HAIR ACADEMY               ,NM,87106-4404,Proprietary  ,10,22,32,109,,238,347
04174500,AVEDA INSTITUTE OF NEW MEXICO (THE)     ,NM,87110-3640,Proprietary  ,4,30,34,212,,453,665
04178500,VOGUE COLLEGE OF COSMETOLOGY            ,NM,87505-7636,Proprietary  ,5,24,29,69,,176,245
00223400,ADRIAN COLLEGE                          ,MI,49221-2575,Private      ,27,24,51,3108,,490,3598
00223500,ALBION COLLEGE                          ,MI,49224-1831,Private      ,18,8,26,2810,,200,3010
00223600,ALMA COLLEGE                            ,MI,48801-1599,Private      ,25,6,31,2894,,237,3131
00223700,ALPENA COMMUNITY COLLEGE                ,MI,49707-1495,Public       ,29,37,66,1155,,1222,2377
00223800,ANDREWS UNIVERSITY                      ,MI,49104-0750,Private      ,25,68,93,2089,,1598,3687
00223900,AQUINAS COLLEGE                         ,MI,49506-1799,Private      ,25,29,54,3150,,914,4064
00224000,BAY DE NOC COMMUNITY COLLEGE            ,MI,49829-2524,Public       ,19,67,86,1256,,1670,2926
00224100,CALVIN COLLEGE                          ,MI,49546-4388,Private      ,27,26,53,4918,,741,5659
00224200,CALVIN THEOLOGICAL SEMINARY             ,MI,49546-4387,Private      ,0,6,6,26,,222,248
00224300,CENTRAL MICHIGAN UNIVERSITY             ,MI,48859-0001,Public       ,212,532,744,24686,,12287,36973
00224600,CLEARY UNIVERSITY                       ,MI,48105-2659,Private      ,3,34,37,237,,869,1106
00224700,CONCORDIA UNIVERSITY-ANN ARBOR          ,MI,48105-2797,Private      ,11,30,41,1089,,490,1579
00224800,CRANBROOK ACADEMY OF ART                ,MI,48303-0000,Private      ,1,5,6,40,,280,320
00224900,DAVENPORT UNIVERSITY                    ,MI,49503-0000,Private      ,60,539,599,4042,,13497,17539
00225100,DELTA COLLEGE                           ,MI,48710-0001,Public       ,106,428,534,7080,,8962,16042
00225400,MICHIGAN STATE UNIVERSITY COLLEGE OF LAW,MI,48824-1300,Private      ,9,20,29,404,,2160,2564
00225900,EASTERN MICHIGAN UNIVERSITY             ,MI,48197-2214,Public       ,254,465,719,20719,,16278,36997
00226000,FERRIS STATE UNIVERSITY                 ,MI,49307-2251,Public       ,160,194,354,16648,,8908,25556
00226100,CHARLES STEWART MOTT COMMUNITY CLG      ,MI,48503-2089,Public       ,151,602,753,6841,,11690,18531
00226200,KETTERING UNIVERSITY                    ,MI,48504-4898,Private      ,29,28,57,2419,,599,3018
00226300,GLEN OAKS COMMUNITY COLLEGE             ,MI,49032-9784,Public       ,9,42,51,749,,977,1726
00226400,GOGEBIC COMMUNITY COLLEGE               ,MI,49938-1365,Public       ,14,14,28,773,,612,1385
00226500,GRACE BIBLE COLLEGE                     ,MI,49509-1998,Private      ,3,44,47,566,,656,1222
00226600,CORNERSTONE UNIVERSITY                  ,MI,49525-5897,Private      ,11,151,162,2512,,2376,4888
00226700,GRAND RAPIDS COMMUNITY COLLEGE          ,MI,49503-3295,Public       ,191,568,759,12637,,13782,26419
00226800,GRAND VALLEY STATE UNIVERSITY           ,MI,49401-9403,Public       ,202,272,474,27978,,9754,37732
00226900,GREAT LAKES CHRISTIAN COLLEGE           ,MI,48917-1299,Private      ,4,6,10,237,,241,478
00227000,HENRY FORD COMMUNITY COLLEGE            ,MI,48128-1495,Public       ,279,723,1002,12210,,19513,31723
00227300,HOPE COLLEGE                            ,MI,49423-3607,Private      ,29,4,33,5175,,322,5497
00227400,JACKSON COMMUNITY COLLEGE               ,MI,49201-8399,Public       ,95,271,366,4006,,5609,9615
00227500,KALAMAZOO COLLEGE                       ,MI,49006-3295,Private      ,10,15,25,2466,,386,2852
00227600,KELLOGG COMMUNITY COLLEGE               ,MI,49017-3397,Public       ,47,248,295,3193,,6402,9595
00227700,LAKE MICHIGAN COLLEGE                   ,MI,49022-1899,Public       ,44,203,247,2156,,3673,5829
00227800,LANSING COMMUNITY COLLEGE               ,MI,48933-1293,Public       ,180,459,639,11063,,13489,24552
00227900,LAWRENCE TECHNOLOGICAL UNIVERSITY       ,MI,48075-1058,Private      ,25,66,91,2244,,1676,3920
00228200,MADONNA UNIVERSITY                      ,MI,48150-1173,Private      ,26,89,115,2136,,3926,6062
00228400,MARYGROVE COLLEGE                       ,MI,48221-2599,Private      ,15,169,184,1482,,3969,5451
00228800,ROCHESTER COLLEGE                       ,MI,48307-2764,Private      ,10,33,43,954,,993,1947
00229000,MICHIGAN STATE UNIVERSITY               ,MI,48824-1113,Public       ,427,551,978,42575,,16376,58951
00229200,MICHIGAN TECHNOLOGICAL UNIV             ,MI,49931-1295,Public       ,41,17,58,6691,,1091,7782
00229300,LAKE SUPERIOR STATE UNIVERSITY          ,MI,49783-1691,Public       ,18,23,41,2801,,1046,3847
00229400,MONROE COUNTY COMMUNITY CLG             ,MI,48161-9746,Public       ,45,91,136,2131,,2904,5035
00229500,MONTCALM COMMUNITY COLLEGE              ,MI,48885-9723,Public       ,19,60,79,1132,,1771,2903
00229700,MUSKEGON COMMUNITY COLLEGE              ,MI,49442-1432,Public       ,77,191,268,3506,,4055,7561
00229900,NORTH CENTRAL MICHIGAN COLLEGE          ,MI,49770-8740,Public       ,29,70,99,1348,,1683,3031
00230100,NORTHERN MICHIGAN UNIVERSITY            ,MI,49855-5316,Public       ,81,91,172,8969,,3275,12244
00230200,NORTHWESTERN MICHIGAN COLLEGE           ,MI,49686-3061,Public       ,41,133,174,2984,,3538,6522
00230301,OAKLAND COMMUNITY COLLEGE - ORCHARD RIDG,MI,48334-4579,Public       ,87,253,340,4434,,6597,11031
00230302,OAKLAND COMMUNITY COLLEGE - ROYAL OAK CA,MI,48067-3898,Public       ,125,387,512,5534,,9507,15041
00230303,OAKLAND COMMUNITY COLLEGE - SOUTHFIELD C,MI,48075-4793,Public       ,116,487,603,4742,,11919,16661
00230304,OAKLAND COMMUNITY COLLEGE - AUBURN HILLS,MI,48323-2845,Public       ,103,325,428,5871,,7773,13644
00230305,OAKLAND COMMUNITY COLLEGE - HIGHLAND LAK,MI,48327-4187,Public       ,72,182,254,2975,,4555,7530
00230700,OAKLAND UNIVERSITY                      ,MI,48309-4401,Public       ,212,346,558,18260,,12023,30283
00230800,OLIVET COLLEGE                          ,MI,49076-9902,Private      ,24,7,31,1797,,318,2115
00231000,ST. CLAIR COUNTY COMMUNITY COLLEGE      ,MI,48061-0000,Public       ,42,142,184,2499,,2951,5450
00231100,KUYPER COLLEGE                          ,MI,49525-9749,Private      ,1,10,11,427,,241,668
00231300,SACRED HEART MAJOR SEMINARY             ,MI,48206-1799,Private      ,2,12,14,44,,215,259
00231400,SAGINAW VALLEY STATE UNIV               ,MI,48710-0001,Public       ,92,151,243,11008,,4738,15746
00231500,SCHOOLCRAFT COLLEGE                     ,MI,48152-2696,Public       ,176,487,663,8057,,11672,19729
00231600,SIENA HEIGHTS UNIVERSITY                ,MI,49221-1796,Private      ,14,111,125,1956,,2599,4555
00231700,SOUTHWESTERN MICHIGAN COLLEGE           ,MI,49047-9793,Public       ,30,84,114,2427,,2219,4646
00231800,SPRING ARBOR UNIVERSITY                 ,MI,49283-9984,Private      ,24,203,227,2488,,3753,6241
00232200,FINLANDIA UNIVERSITY                    ,MI,49930-1882,Private      ,4,2,6,722,,292,1014
00232300,UNIVERSITY OF DETROIT MERCY             ,MI,48221-3038,Private      ,53,145,198,4054,,4686,8740
00232303,UNIV OF DETROIT MERCY - LAW SCHOOL      ,MI,48226-0000,Private      ,2,16,18,80,,839,919
00232330,UNIV OF DETROIT MERCY - DENTAL SCHOOL   ,MI,48208-2576,Private      ,3,11,14,233,,790,1023
00232500,UNIVERSITY OF MICHIGAN - ANN ARBOR      ,MI,48109-1316,Public       ,381,278,659,39722,,14523,54245
00232501,UNIVERSITY OF MICHIGAN-MEDICAL SCH      ,MI,48109-0000,Public       ,11,14,25,389,,1214,1603
00232503,UNIVERSITY OF MICHIGAN LAW SCHOOL       ,MI,48109-0000,Public       ,3,21,24,149,,2588,2737
00232600,UNIVERSITY OF MICHIGAN-DEARBORN         ,MI,48128-2406,Public       ,113,198,311,8303,,7150,15453
00232700,UNIVERSITY OF MICHIGAN-FLINT            ,MI,48502-1950,Public       ,93,265,358,5905,,7732,13637
00232800,WASHTENAW COMMUNITY COLLEGE             ,MI,48106-0000,Public       ,197,490,687,6109,,9212,15321
00232900,WAYNE STATE UNIVERSITY                  ,MI,48202-0000,Public       ,308,731,1039,21682,,24157,45839
00232901,WAYNE STATE UNIV SCH OF MEDICINE        ,MI,48201-3359,Public       ,24,48,72,1048,,2381,3429
00232902,WAYNE STATE UNIVERSITY - LAW SCHOOL     ,MI,48202-3424,Public       ,5,28,33,253,,1262,1515
00233000,WESTERN MICHIGAN UNIVERSITY             ,MI,49008-3899,Public       ,241,290,531,24056,,11842,35898
00233100,WESTERN THEOLOGICAL SEMINARY            ,MI,49423-0000,Private      ,0,3,3,6,,183,189
00407100,WALSH COLLEGE OF ACCT & BUS ADMN        ,MI,48007-7006,Private      ,2,191,193,437,,2913,3350
00407200,NORTHWOOD UNIVERSITY                    ,MI,48640-2398,Private      ,27,89,116,2244,,2166,4410
00467300,BAKER COLLEGE - FLINT                   ,MI,48507-5508,Private      ,89,442,531,3143,,7960,11103
00467301,BAKER COLLEGE OF CADILLAC               ,MI,49601-0000,Private      ,29,178,207,712,,2112,2824
00467302,BAKER COLLEGE OF CLINTON TOWNSHIP       ,MI,48035-0000,Private      ,77,288,365,1998,,5667,7665
00467303,BAKER COLLEGE OF MUSKEGON               ,MI,49442-0000,Private      ,69,285,354,2825,,4475,7300
00467304,BAKER COLLEGE OF OWOSSO                 ,MI,48867-0000,Private      ,62,151,213,1922,,2431,4353
00467305,BAKER COLLEGE OF AUBURN HILLS           ,MI,48326-0000,Private      ,56,221,277,1317,,4146,5463
00467306,BAKER COLLEGE OF PORT HURON             ,MI,48060-0000,Private      ,26,82,108,622,,1309,1931
00467309,BAKER COLLEGE OF JACKSON                ,MI,49202-0000,Private      ,34,183,217,998,,3011,4009
00467311,BAKER COLLEGE-CASS CITY                 ,MI,48726-0000,Private      ,10,30,40,199,,398,597
00467313,BAKER COLLEGE - GRADUATE ON-LINE        ,MI,48507-0000,Private      ,26,427,453,604,,7306,7910
00467317,BAKER COLLEGE-ALLEN PARK                ,MI,48101-0000,Private      ,70,310,380,1683,,5433,7116
00469200,DORSEY SCHOOL OF BUSINESS               ,MI,48195-2334,Proprietary  ,12,54,66,116,,480,596
00469201,DORSEY SCHOOL OF BUSINESS               ,MI,48184-0000,Proprietary  ,6,47,53,114,,469,583
00469202,DORSEY SCHOOL OF BUSINESS               ,MI,48071-0000,Proprietary  ,4,49,53,122,,501,623
00469204,DORSEY SCHOOL OF BUSINESS               ,MI,48066-0000,Proprietary  ,28,88,116,312,,865,1177
00469205,DORSEY BUSINESS SCHOOL - FARMINGTON HILL,MI,48334-3385,Proprietary  ,6,12,18,69,,262,331
00469206,DORSEY BUSINESS SCHOOL - ROSEVILLE CULIN,MI,48066-4555,Proprietary  ,7,51,58,161,,492,653
00469207,DORSEY BUSINESS SCHOOL - WATERFORD/PONTI,MI,48341-1037,Proprietary  ,18,56,74,118,,494,612
00469208,DORSEY BUSINESS SCHOOL - SAGINAW CAMPUS ,MI,48603-5201,Proprietary  ,6,64,70,117,,558,675
00469209,DORSEY SCHOOL OF BUSINESS - LANSING     ,MI,48911-5744,Proprietary  ,7,41,48,88,,422,510
00469210,DORSEY SCHOOL OF BUSINESS - DEARBORN    ,MI,48228-3858,Proprietary  ,18,70,88,50,,270,320
00491003,KAPLAN CAREER INSTITUTE - DEARBORN      ,MI,48228-0000,Proprietary  ,5,55,60,148,,828,976
00676800,MID MICHIGAN COMMUNITY COLLEGE          ,MI,48625-9447,Public       ,44,127,171,2801,,3295,6096
00677100,COLLEGE FOR CREATIVE STUDIES            ,MI,48202-4034,Private      ,33,33,66,1984,,1106,3090
00694900,KALAMAZOO VALLEY COMMUNITY COLLEGE      ,MI,49003-4070,Public       ,113,331,444,6521,,8528,15049
00717100,KIRTLAND COMMUNITY COLLEGE              ,MI,48653-0000,Public       ,23,90,113,1023,,1923,2946
00732991,ITT TECHNICAL INSTITUTE                 ,MI,49519-1851,Proprietary  ,78,361,439,858,,3312,4170
00761700,CARNEGIE INSTITUTE                      ,MI,48083-1159,Proprietary  ,10,37,47,90,,456,546
00795000,WEST SHORE COMMUNITY COLLEGE            ,MI,49454-0000,Public       ,10,32,42,670,,1029,1699
00817800,EMPIRE BEAUTY SCHOOL                    ,MI,49525-2440,Proprietary  ,76,227,303,469,,1001,1470
00832903,ITT TECHNICAL INSTITUTE                 ,MI,48083-2008,Proprietary  ,0,0,0,0,,2,2
00890600,MACOMB COMMUNITY COLLEGE                ,MI,48088-3896,Public       ,283,775,1058,14972,,17855,32827
00894600,PORT HURON COSMETOLOGY COLLEGE          ,MI,48329-1618,Proprietary  ,7,6,13,37,,89,126
00923000,WAYNE COUNTY COMMUNITY CLG-DISTRICT     ,MI,48226-3010,Public       ,312,1365,1677,10089,,29460,39549
00982800,EVEREST INSTITUTE                       ,MI,48033-4400,Proprietary  ,38,172,210,370,,1858,2228
00982801,EVEREST INSTITUTE- DEARBORN             ,MI,48124-1927,Proprietary  ,38,156,194,371,,1349,1720
00982803,EVEREST INSTITUTE - DETROIT             ,MI,48207-4291,Proprietary  ,27,112,139,425,,1475,1900
01047000,KALAMAZOO BEAUTY ACADEMY                ,MI,49002-5220,Proprietary  ,2,9,11,38,,89,127
01082700,DAVID PRESSLEY PROF SCH OF COSMTLGY     ,MI,48067-3219,Proprietary  ,16,25,41,216,,349,565
01109800,FLINT INSTITUTE OF BARBERING            ,MI,48504-4395,Proprietary  ,3,19,22,74,,220,294
01229100,WRIGHT BEAUTY ACADEMY                   ,MI,49015-2696,Proprietary  ,1,9,10,48,,140,188
01262700,THOMAS M. COOLEY LAW SCHOOL             ,MI,48901-1586,Private      ,1,74,75,48,,3346,3394
01321800,M J MURPHY BTY CLG MT PLEASANT          ,MI,48858-2502,Proprietary  ,3,10,13,64,,143,207
02060300,MICHIGAN INSTITUTE OF AERONAUTICS       ,MI,48188-2533,Proprietary  ,35,94,129,688,,855,1543
02099700,ROSS MEDICAL EDUCATION CENTER           ,MI,48532-0000,Proprietary  ,56,220,276,498,,1557,2055
02099701,ROSS MEDICAL EDUCATION CENTER-SAGINAW   ,MI,48603-5227,Proprietary  ,1,14,15,69,,191,260
02099702,ROSS MEDICAL EDUCATION CENTER-PORT HURON,MI,48060-1958,Proprietary  ,1,2,3,24,,91,115
02099703,ROSS MEDICAL EDUCATION CENTER-ROOSEVELT ,MI,49441-4156,Proprietary  ,1,3,4,15,,50,65
02100400,EVEREST INSTITUTE                       ,MI,49525-2301,Proprietary  ,12,117,129,285,,1217,1502
02100401,EVEREST INSTITUTE - KALAMAZOO           ,MI,49009-3307,Proprietary  ,13,91,104,171,,738,909
02125600,MICHIGAN COLLEGE OF BEAUTY              ,MI,48083-0000,Proprietary  ,17,54,71,190,,446,636
02158600,MR BELA'S SCHOOL OF COSMETOLOGY         ,MI,48092-4637,Proprietary  ,6,12,18,69,,199,268
02160303,INTERNATIONAL ACADEMY OF DESIGN AND TECH,MI,48083-2160,Proprietary  ,9,12,21,371,,594,965
02180100,ROSS MEDICAL EDUCATION CENTER           ,MI,48092-0000,Proprietary  ,31,165,196,322,,1028,1350
02180105,ROSS MEDICAL EDUCATION CENTER-REDFORD   ,MI,48239-1260,Proprietary  ,1,6,7,37,,134,171
02198900,MICHIGAN SCHOOL OF PROFESSIONAL PSYCHOLO,MI,48334-4512,Private      ,2,4,6,40,,324,364
02209200,TAYLORTOWN SCHOOL OF BEAUTY             ,MI,48180-0000,Proprietary  ,15,43,58,138,,341,479
02237800,SPECS HOWARD SCHOOL OF MEDIA ARTS       ,MI,48075-0000,Proprietary  ,37,82,119,788,,1087,1875
02285700,BAYSHIRE BEAUTY ACADEMY                 ,MI,48708-5614,Proprietary  ,1,24,25,51,,180,231
02289801,KAPLAN INSTITUTE - DETROIT CAMPUS       ,MI,48202-0000,Proprietary  ,0,0,0,59,,245,304
02324500,MICHIGAN COLLEGE OF BEAUTY              ,MI,48161-3901,Proprietary  ,7,26,33,106,,251,357
02339700,ROSS MEDICAL EDUCATION CENTER           ,MI,48116-0000,Proprietary  ,44,213,257,287,,1376,1663
02339701,ROSS MEDICAL EDUCATION CENTER-ANN ARBOR ,MI,48108-1411,Proprietary  ,3,9,12,52,,176,228
02339703,ROSS MEDICAL EDUCATION CENTER - DAVISON ,MI,48423-1751,Proprietary  ,2,4,6,28,,90,118
02361500,MICHIGAN BARBER COLLEGE                 ,MI,48204-2244,Private      ,13,48,61,181,,651,832
02363800,YESHIVA GEDOLAH OF GREATER DETROIT      ,MI,48237-0000,Private      ,7,0,7,37,,8,45
02491000,WEST MI COLG OF BARBERING & BEAUTY      ,MI,49008-0000,Proprietary  ,5,9,14,60,,170,230
02531806,PAUL MITCHELL THE SCHOOL -MICHIGAN      ,MI,48313-0000,Proprietary  ,13,19,32,141,,218,359
02533600,ROSS MEDICAL EDUCATION CENTER           ,MI,48917-2108,Proprietary  ,41,138,179,293,,974,1267
02533601,ROSS MEDICAL EDUCATION CENTER - GRAND RA,MI,49546-2430,Proprietary  ,3,20,23,99,,359,458
02588200,DOUGLAS J AVEDA INSTITUTE               ,MI,48823-4351,Proprietary  ,49,92,141,779,,955,1734
02588201,DOUGLAS J AVEDA INSTITUTE - ANN ARBOR   ,MI,48104-2211,Proprietary  ,8,11,19,194,,216,410
02595700,HILLSDALE BEAUTY COLLEGE                ,MI,49242-0000,Proprietary  ,3,8,11,84,,58,142
02618400,MICHIGAN CAREER & TECHNICAL INST        ,MI,49080-9254,Public       ,50,14,64,366,,136,502
03005700,DETROIT BUSINESS INST. DOWNRIVER        ,MI,48193-6761,Proprietary  ,5,8,13,40,,230,270
03028500,LAWTON SCHOOL                           ,MI,48075-0000,Proprietary  ,0,0,0,13,,79,92
03066600,BAY MILLS COMMUNITY COLLEGE             ,MI,49715-9750,Public       ,11,29,40,241,,529,770
03075200,TWIN CITY BEAUTY COLLEGE                ,MI,49085-3305,Proprietary  ,12,22,34,154,,266,420
03075201,TWIN CITY BEAUTY COLLEGE - TRAVERSE CITY,MI,49686-5119,Proprietary  ,1,4,5,44,,78,122
03090000,SHARP'S ACADEMY OF HAIRSTYLING          ,MI,48439-1838,Proprietary  ,2,3,5,35,,51,86
03109700,HOUGHTON LAKE INST OF COSMETOLOGY       ,MI,48629-0669,Proprietary  ,1,8,9,42,,88,130
03110300,THE SCHOOL OF CREATIVE HAIR DESIGN      ,MI,49036-1139,Proprietary  ,9,19,28,39,,95,134
03124000,NORTHWESTERN TECHNOLOGICAL INST         ,MI,48075-2412,Proprietary  ,18,97,115,141,,641,782
03284300,MICHIGAN JEWISH INSTITUTE               ,MI,48237-0000,Private      ,104,70,174,1436,,892,2328
03490300,PAUL MITCHELL THE SCHOOL ESCANABA       ,MI,49829-0000,Proprietary  ,7,16,23,181,,168,349
03588300,IRENE'S MYOMASSOLOGY INSTITUTE          ,MI,48033-2404,Proprietary  ,6,30,36,107,,446,553
03704300,BLUE WATER COLLEGE OF COSMETOLOGY       ,MI,48040-2093,Proprietary  ,3,12,15,29,,55,84
03772300,SAGINAW CHIPPEWA TRIBAL COLLEGE         ,MI,48858-0000,Public       ,2,11,13,30,,111,141
03815300,IN SESSION-ARTS OF COSMETOLOGY BEAU     ,MI,48609-0000,Proprietary  ,3,19,22,81,,178,259
03907300,PAUL MITCHELL THE SCHOOL GREAT LAKES    ,MI,48060-0000,Proprietary  ,9,13,22,132,,175,307
03915300,CAREER QUEST LEARNING CENTER            ,MI,48910-4732,Proprietary  ,17,142,159,193,,1138,1331
03915301,CAREER QUEST LEARNING CENTER - JACKSON  ,MI,49201-2475,Proprietary  ,6,98,104,56,,379,435
03915302,CAREER QUEST LEARNING CENTER - KALAMAZOO,MI,49002-1711,Proprietary  ,4,44,48,59,,310,369
03968300,LAKEWOOD SCHOOL OF THERAPEUTIC MASSAGE  ,MI,48060-0000,Proprietary  ,0,9,9,20,,81,101
03976500,ANN ARBOR INSTITUTE OF MASSAGE THERAPY  ,MI,48103-0000,Proprietary  ,6,11,17,65,,188,253
04002400,ECUMENICAL THEOLOGICAL SEMINARY         ,MI,48201-3035,Private      ,1,6,7,14,,183,197
04006300,NUVO COLLEGE OF COSMETOLOGY             ,MI,49441-3822,Proprietary  ,4,4,8,34,,108,142
04014300,P&A SCHOLARS BEAUTY SCHOOL              ,MI,48204-0000,Proprietary  ,13,41,54,235,,750,985
04094300,ROBERT B. MILLER COLLEGE (THE)          ,MI,49017-3306,Private      ,0,20,20,120,,591,711
04121100,GALLERY COLLEGE OF BEAUTY (THE)         ,MI,48036-3591,Proprietary  ,3,29,32,77,,283,360
04136300,FOCUS:  HOPE INFORMATION TECHNOLOGIES CE,MI,48238-2949,Private      ,8,28,36,176,,629,805
04138400,SCHOOL OF DESIGNING ARTS                ,MI,49015-2853,Proprietary  ,2,17,19,71,,145,216
04140900,INTERNATIONAL COSMETOLOGY ACADEMY       ,MI,49508-1308,Proprietary  ,5,17,22,67,,203,270
04141100,FRENCH ACADEMY OF COSMETOLOGY           ,MI,49456-3207,Proprietary  ,5,7,12,42,,87,129
04158400,L'ESPRIT ACADEMY                        ,MI,48150-0000,Proprietary  ,11,19,30,125,,240,365
04159300,MARKETTI ACADEMY OF COSMETOLOGY         ,MI,48329-3506,Proprietary  ,3,7,10,63,,100,163
04163300,COMPASS COLLEGE OF CINEMATIC ARTS       ,MI,49503-4227,Private      ,1,5,6,147,,93,240
04164700,KEWEENAW BAY OJIBWA COMMUNITY COLLEGE   ,MI,49908-0000,Public       ,4,17,21,25,,112,137
04169300,SCHOLARS COSMETOLOGY UNIVERSITY         ,MI,48108-0000,Proprietary  ,3,4,7,46,,119,165
04183300,ABCOTT INSTITUTE                        ,MI,48075-5227,Proprietary  ,4,36,40,67,,335,402
04184700,PROTEGE ACADEMY                         ,MI,48823-8660,Proprietary  ,3,13,16,63,,145,208
04207000,SCHOOL OF MISSIONARY AVIATION TECHNOLOGY,MI,48846-7412,Private      ,0,0,0,35,,42,77
04211200,BRIGHTON INSTITUTE OF COSMETOLOGY       ,MI,48116-8360,Proprietary  ,3,8,11,42,,76,118
04222300,MANTHANO CHRISTIAN COLLEGE              ,MI,48185-1919,Private      ,0,4,4,0,,5,5
04230200,EXCEL ACADEMIES OF COSMETOLOGY          ,MI,48085-1300,Proprietary  ,1,3,4,1,,3,4
04230400,EXCEL ACADEMIES OF COSMETOLOGY          ,MI,48912-4686,Proprietary  ,2,6,8,2,,6,8
04230500,EXCEL ACADEMIES OF COSMETOLOGY          ,MI,49512-1781,Proprietary  ,2,3,5,2,,3,5
00233200,ANOKA-RAMSEY CC-CAMBRIDGE/COONRAPID     ,MN,55433-3499,Public       ,121,225,346,4076,,5422,9498
00233400,AUGSBURG COLLEGE                        ,MN,55454-1351,Private      ,27,86,113,3425,,2614,6039
00233500,RIVERLAND COMMUNITY COLLEGE             ,MN,55912-1473,Public       ,20,79,99,1069,,1966,3035
00233600,BEMIDJI STATE UNIVERSITY                ,MN,56601-2699,Public       ,27,66,93,3983,,2320,6303
00233700,BETHANY LUTHERAN COLLEGE INC            ,MN,56001-6163,Private      ,1,2,3,717,,90,807
00233900,CENTRAL LAKES COLG-BRAINERD/STAPLES     ,MN,56401-3900,Public       ,41,93,134,1517,,2101,3618
00234000,CARLETON COLLEGE                        ,MN,55057-4001,Private      ,15,4,19,3748,,111,3859
00234100,COLLEGE OF ST BENEDICT                  ,MN,56374-2099,Private      ,10,3,13,2254,,101,2355
00234200,ST. CATHERINE UNIVERSITY                ,MN,55105-1789,Private      ,29,154,183,2982,,3833,6815
00234300,COLLEGE OF ST SCHOLASTICA               ,MN,55811-4199,Private      ,18,136,154,2464,,2678,5142
00234500,UNIVERSITY OF ST THOMAS                 ,MN,55105-1096,Private      ,48,176,224,7344,,3813,11157
00234600,CONCORDIA COLLEGE-MOORHEAD              ,MN,56562-0001,Private      ,12,9,21,3107,,234,3341
00234700,"CONCORDIA UNIVERSITY, ST PAUL, MN       ",MN,55104-5494,Private      ,21,293,314,1793,,3679,5472
00235000,VERMILION COMMUNITY COLLEGE             ,MN,55731-1996,Public       ,4,4,8,547,,207,754
00235300,GUSTAVUS ADOLPHUS COLLEGE               ,MN,56082-1498,Private      ,9,2,11,3601,,134,3735
00235400,HAMLINE UNIVERSITY                      ,MN,55104-1284,Private      ,26,164,190,3567,,3087,6654
00235500,HIBBING COMMUNITY COLLEGE               ,MN,55746-3300,Public       ,20,50,70,706,,1085,1791
00235600,ITASCA COMMUNITY COLLEGE                ,MN,55744-3397,Public       ,14,30,44,856,,718,1574
00235700,LUTHER SEMINARY                         ,MN,55108-0000,Private      ,0,5,5,7,,396,403
00235800,MACALESTER COLLEGE                      ,MN,55105-1899,Private      ,19,5,24,3823,,261,4084
00236000,"MINNESOTA STATE UNIVERSITY, MANKATO     ",MN,56002-0000,Public       ,115,156,271,12712,,5011,17723
00236100,MARTIN LUTHER COLLEGE                   ,MN,56073-3965,Private      ,1,0,1,694,,72,766
00236200,MINNEAPOLIS COMM AND TECH COLLEGE       ,MN,55403-1779,Public       ,95,360,455,4492,,11610,16102
00236500,MINNEAPOLIS COLLEGE OF ART & DESIGN     ,MN,55404-4343,Private      ,6,12,18,1037,,622,1659
00236600,CROSSROADS COLLEGE                      ,MN,55902-2382,Private      ,1,3,4,94,,104,198
00236700,MINNESOTA STATE UNIVERSITY MOORHEAD     ,MN,56563-0001,Public       ,42,93,135,5496,,2808,8304
00236900,NORTH CENTRAL UNIVERSITY                ,MN,55404-1391,Private      ,3,21,24,1359,,525,1884
00237000,NORTH HENNEPIN COMMUNITY COLLEGE        ,MN,55445-2299,Public       ,99,236,335,3356,,6460,9816
00237100,UNIVERSITY OF NORTHWESTERN- ST PAUL     ,MN,55113-1598,Private      ,9,43,52,2473,,1075,3548
00237300,ROCHESTER COMMUNITY/TECH COLLEGE        ,MN,55904-4999,Public       ,53,158,211,2938,,4239,7177
00237500,SOUTHWEST MINNESOTA STATE UNIVERSITY    ,MN,56258-1598,Public       ,20,33,53,2209,,1299,3508
00237700,ST CLOUD STATE UNIVERSITY               ,MN,56301-4498,Public       ,85,174,259,10433,,5629,16062
00237900,SAINT JOHNS UNIVERSITY                  ,MN,56321-0000,Private      ,6,2,8,2054,,102,2156
00238000,SAINT MARY'S UNIVERSITY                 ,MN,55987-1399,Private      ,20,207,227,1760,,3778,5538
00238200,ST OLAF COLLEGE                         ,MN,55057-1098,Private      ,24,4,28,3941,,137,4078
00238300,CROWN COLLEGE                           ,MN,55375-9001,Private      ,8,105,113,949,,1054,2003
00238500,NORTHLAND COMMUNITY & TECHNICAL CLG     ,MN,56701-2598,Public       ,28,65,93,1614,,2024,3638
00238600,UNITED THEOLGCL SEMINRY TWIN CITIES     ,MN,55112-0000,Private      ,0,4,4,8,,106,114
00238800,"UNIVERSITY OF MINNESOTA, DULUTH         ",MN,55812-2496,Public       ,69,71,140,10811,,2574,13385
00238900,"UNIVERSITY OF MINNESOTA, MORRIS         ",MN,56267-2113,Public       ,20,4,24,2432,,354,2786
00239100,WILLIAM MITCHELL COLLEGE OF LAW         ,MN,55105-0000,Private      ,0,15,15,11,,1055,1066
00239300,MINNESOTA STATE COLLEGE-SE TECH         ,MN,55987-0409,Public       ,33,88,121,923,,1677,2600
00239400,WINONA STATE UNIVERSITY                 ,MN,55987-5838,Public       ,65,66,131,7877,,1918,9795
00396900,UNIVERSITY OF MINNESOTA-TWIN CITIES     ,MN,55455-0422,Public       ,294,524,818,34942,,18893,53835
00400900,MESABI RANGE CMNTY & TECH COLLEGE       ,MN,55792-0000,Public       ,14,29,43,642,,758,1400
00405708,NATIONAL AMERICAN UNIVERSITY            ,MN,55113-0000,Proprietary  ,2,12,14,35,,359,394
00405715,NATIONAL AMERICAN UNIVERSITY - BLOOMINGT,MN,55425-5550,Proprietary  ,1,18,19,37,,515,552
00406900,UNIVERSITY OF MINNESOTA-CROOKSTON       ,MN,56716-5001,Public       ,10,36,46,1182,,1069,2251
00438600,VETERAN'S MEDICAL CTR- SCH RAD TECH     ,MN,55417-2399,Public       ,0,1,1,7,,32,39
00464100,DUNWOODY COLLEGE OF TECHNOLOGY          ,MN,55403-1192,Private      ,12,57,69,720,,1476,2196
00464200,GLOBE UNIVERSITY                        ,MN,55125-5408,Proprietary  ,54,270,324,1173,,3943,5116
00464500,MINNEAPOLIS BUSINESS COLLEGE            ,MN,55113-4036,Proprietary  ,2,6,8,347,,190,537
00464600,MINNESOTA SCHOOL OF BUSINESS            ,MN,55423-0000,Proprietary  ,49,241,290,1136,,3742,4878
00525200,RIDGEWATER COLLEGE                      ,MN,56201-2098,Public       ,29,75,104,2013,,2127,4140
00526300,MINNESOTA WEST CMNTY & TECH COLG        ,MN,56241-1096,Public       ,26,63,89,889,,1610,2499
00553300,"SAINT PAUL COLLEGE, COMMUNITY/TECHNICAL ",MN,55102-1800,Public       ,81,314,395,3728,,8674,12402
00553400,SAINT CLOUD TECHNICAL COLLEGE AND COMMUN,MN,56303-1240,Public       ,56,123,179,3086,,3409,6495
00553500,PINE TECHNICAL COLLEGE                  ,MN,55063-2198,Public       ,10,33,43,288,,936,1224
00553700,SOUTH CENTRAL COLLEGE                   ,MN,56003-0000,Public       ,33,71,104,1813,,2435,4248
00554100,MINNESOTA STATE COMMUNITY AND TECHNICAL ,MN,56573-1405,Public       ,49,119,168,2391,,3582,5973
00554400,ALEXANDRIA TECHNICAL COLLEGE            ,MN,56308-3799,Public       ,14,32,46,1388,,1019,2407
00575700,LAKE SUPERIOR COLLEGE                   ,MN,55811-3399,Public       ,54,167,221,2266,,3452,5718
00575900,NORTHWEST TECHNICAL COLLEGE - BEMIDJI   ,MN,56601-4907,Public       ,8,57,65,424,,1011,1435
00677500,RAINY RIVER COMMUNITY COLLEGE           ,MN,56649-2187,Public       ,4,7,11,171,,141,312
00735000,ANOKA-HENNEPIN TECHNICAL COLLEGE        ,MN,55303-1590,Public       ,23,108,131,1117,,2905,4022
00735100,BROWN COLLEGE                           ,MN,55120-1004,Proprietary  ,8,62,70,226,,750,976
00746200,COLLEGE OF VISUAL ARTS                  ,MN,55102-2199,Private      ,0,0,0,65,,67,132
00795400,NORMANDALE COMMUNITY COLLEGE            ,MN,55431-4399,Public       ,113,200,313,4994,,6148,11142
00826700,NORTHWEST TECHNICAL INSTITUTE           ,MN,55121-5001,Proprietary  ,0,2,2,17,,48,65
00869400,RASMUSSEN COLLEGE - ST. CLOUD           ,MN,56301-3713,Proprietary  ,28,133,161,282,,1497,1779
00869401,RASMUSSEN COLLEGE - BROOKLYN PARK       ,MN,55445-1512,Proprietary  ,17,118,135,267,,1542,1809
00869406,RASMUSSEN COLLEGE - EAGAN               ,MN,55122-1346,Proprietary  ,16,106,122,217,,1340,1557
00869407,RASMUSSEN COLLEGE - BLOOMINGTON         ,MN,55435-5444,Proprietary  ,10,135,145,203,,1672,1875
00869409,RASMUSSEN COLLEGE - MANKATO             ,MN,56001-8658,Proprietary  ,13,86,99,247,,1132,1379
00869412,RASMUSSEN COLLEGE - LAKE ELMO           ,MN,55042-8624,Proprietary  ,16,86,102,182,,1040,1222
00869416,RASMUSSEN COLLEGE - MOORHEAD            ,MN,56560-4513,Proprietary  ,5,89,94,209,,882,1091
00869417,RASMUSSEN COLLEGE - BLAINE              ,MN,55014-0000,Proprietary  ,10,105,115,183,,984,1167
00905800,BETHEL UNIVERSITY                       ,MN,55112-6999,Private      ,15,159,174,3419,,2711,6130
00945911,EMPIRE BEAUTY SCHOOL - ST. PAUL         ,MN,55119-7003,Proprietary  ,0,0,0,81,,211,292
00960000,COSMETOLOGY CAREERS UNLTD-DULUTH        ,MN,55802-2031,Proprietary  ,0,2,2,19,,59,78
00974000,INVER HILLS COMMUNITY COLLEGE           ,MN,55076-3224,Public       ,56,155,211,2749,,4183,6932
00983100,MODEL COLLEGE OF HAIR DESIGN            ,MN,56301-4280,Proprietary  ,5,8,13,143,,132,275
00987000,EMPIRE BEAUTY SCHOOL                    ,MN,55420-2919,Proprietary  ,0,0,0,111,,199,310
00989200,"DULUTH BUSINESS UNIV, INC.              ",MN,55807-0000,Proprietary  ,6,30,36,121,,375,496
00999200,OAK HILLS CHRISTIAN COLLEGE             ,MN,56601-0000,Private      ,2,4,6,130,,78,208
01024800,ART INSTITUTES INTL MINNESOTA           ,MN,55402-3137,Proprietary  ,36,56,92,1316,,1300,2616
01035602,EVEREST INSTITUTE - EAGAN               ,MN,55121-1696,Proprietary  ,14,99,113,96,,643,739
01037400,METROPOLITAN STATE UNIVERSITY           ,MN,55106-5000,Public       ,36,257,293,2410,,9764,12174
01040200,DAKOTA COUNTY TECHNICAL COLLEGE         ,MN,55068-2999,Public       ,23,100,123,1312,,2457,3769
01049000,REGENCY BEAUTY INSTITUTE                ,MN,55428-0000,Proprietary  ,413,844,1257,4098,,7683,11781
01049100,HENNEPIN TECHNICAL COLLEGE              ,MN,55445-2399,Public       ,60,245,305,2177,,6617,8794
01054600,CENTURY COLLEGE                         ,MN,55110-1894,Public       ,109,309,418,5379,,8551,13930
01173200,"MAYO CLINIC, COLLEGE OF MEDICINE        ",MN,55905-0000,Private      ,1,3,4,84,,412,496
01173201,MAYO SCHOOL OF HEALTH-RELATED SCIEN     ,MN,55905-0000,Private      ,1,4,5,89,,239,328
01173206,MAYO GRAD SCHOOL                        ,MN,55901-0000,Private      ,0,1,1,8,,58,66
01173207,MAYO MEDICAL SCHOOL                     ,MN,55901-0000,Private      ,1,1,2,34,,210,244
01232800,NORTHWESTERN HEALTH SCIENCES UNIV       ,MN,55431-1599,Private      ,2,19,21,86,,942,1028
02050300,ACADEMY COLLEGE                         ,MN,55420-1554,Proprietary  ,2,17,19,44,,222,266
02097300,HASTINGS BEAUTY SCHOOL                  ,MN,55033-1205,Proprietary  ,0,4,4,13,,50,63
02123200,AVEDA INSTITUTE                         ,MN,55414-0000,Proprietary  ,18,44,62,488,,581,1069
02159800,COSMETOLOGY CAREERS UNLTD - HIBBING     ,MN,55746-0000,Proprietary  ,1,4,5,21,,49,70
02160901,PCI ACADEMY - PCI ACADEMY               ,MN,55446-4928,Proprietary  ,4,7,11,40,,63,103
02238100,MINNESOTA SCHOOL OF COSMETOLOGY         ,MN,55125-0000,Proprietary  ,8,24,32,164,,258,422
02260500,SUMMIT ACAD OPPORTUNITIES IND CTR       ,MN,55405-0000,Private      ,26,193,219,124,,834,958
02263102,ANTHEM COLLEGE - ST. LOUIS PARK         ,MN,55416-2467,Proprietary  ,0,2,2,27,,193,220
02504200,WALDEN UNIVERSITY                       ,MN,55401-2511,Proprietary  ,32,5068,5100,417,,62880,63297
02514100,AMERICAN INDIAN OPPORTUNITIES CTR       ,MN,55404-0000,Private      ,1,38,39,25,,328,353
03001200,MCNALLY SMITH COLLEGE OF MUSIC          ,MN,55101-2220,Proprietary  ,9,10,19,755,,318,1073
03051900,ALFRED ADLER GRADUATE SCHOOL            ,MN,55305-0000,Private      ,0,22,22,1,,374,375
03096400,LEECH LAKE TRIBAL COLLEGE               ,MN,56633-0000,Public       ,0,19,19,77,,404,481
03129100,FOND DU LAC TRIBAL & COMMUNITY CLG      ,MN,55720-2984,Public       ,13,50,63,507,,1021,1528
03267300,CAPELLA UNIVERSITY                      ,MN,55402-3389,Proprietary  ,29,3427,3456,330,,55572,55902
03833300,AMERICAN ACADEMY OF ACUPUNCTURE AND ORIE,MN,55113-0000,Proprietary  ,0,3,3,1,,80,81
03921400,WHITE EARTH TRIBAL AND COMMUNITY COLLEGE,MN,56557-0478,Private      ,1,10,11,18,,107,125
04044300,HAZELDEN GRADUATE SCHOOL OF ADDICTION ST,MN,55012-0000,Private      ,0,6,6,7,,171,178
04130200,INST. OF PRODUCTION AND RECORDING       ,MN,55401-1315,Proprietary  ,9,15,24,347,,411,758
04148800,CENTERPOINT MASSAGE & SHIATSU THERAPY SC,MN,55414-4525,Proprietary  ,5,15,20,34,,210,244
04157600,NOVA ACADEMY OF COSMETOLOGY             ,MN,55906-4103,Proprietary  ,4,16,20,60,,123,183
04160500,AVALON SCHOOL OF COSMETOLOGY            ,MN,56187-1930,Proprietary  ,0,4,4,16,,49,65
04174400,ROCHESTER SCHOOL OF HAIR DESIGN         ,MN,55901-4310,Proprietary  ,2,5,7,39,,62,101
04175600,PARK AVENUE SCHOOL OF COSMETOLOGY       ,MN,56470-3361,Proprietary  ,4,12,16,23,,95,118
00239600,ALCORN STATE UNIVERSITY                 ,MS,39096-7500,Public       ,137,141,278,4554,,4156,8710
00239700,BELHAVEN UNIVERSITY                     ,MS,39202-1789,Private      ,48,308,356,1902,,5612,7514
00239800,BLUE MOUNTAIN COLLEGE                   ,MS,38610-9370,Private      ,6,19,25,606,,380,986
00240100,COAHOMA COMMUNITY COLLEGE               ,MS,38614-9799,Public       ,91,144,235,1785,,2347,4132
00240200,COPIAH-LINCOLN COMMUNITY COLLEGE        ,MS,39191-0649,Public       ,101,114,215,2467,,2485,4952
00240300,DELTA STATE UNIVERSITY                  ,MS,38733-0000,Public       ,82,141,223,3724,,3418,7142
00240400,EAST CENTRAL COMMUNITY COLLEGE          ,MS,39327-0129,Public       ,67,94,161,2135,,2258,4393
00240500,EAST MISSISSIPPI COMM COLLEGE           ,MS,39358-0000,Public       ,159,214,373,3747,,4032,7779
00240700,HINDS COMMUNITY COLLEGE                 ,MS,39154-9799,Public       ,324,542,866,8739,,11738,20477
00240800,HOLMES COMMUNITY COLLEGE                ,MS,39079-0000,Public       ,181,294,475,4756,,6655,11411
00240900,ITAWAMBA COMMUNITY COLLEGE              ,MS,38843-1099,Public       ,129,232,361,4613,,4569,9182
00241000,JACKSON STATE UNIVERSITY                ,MS,39217-0001,Public       ,238,422,660,9209,,11513,20722
00241100,JONES COUNTY JUNIOR COLLEGE             ,MS,39437-3999,Public       ,139,151,290,4443,,2917,7360
00241300,MERIDIAN COMMUNITY COLLEGE              ,MS,39307-5890,Public       ,80,182,262,2474,,3372,5846
00241400,MILLSAPS COLLEGE                        ,MS,39201-0000,Private      ,35,34,69,1514,,930,2444
00241500,MISSISSIPPI COLLEGE                     ,MS,39058-0001,Private      ,56,121,177,3175,,3825,7000
00241501,MISSISSIPPI COLLEGE - SCHOOL OF LAW     ,MS,39201-1391,Private      ,7,15,22,142,,951,1093
00241600,MISSISSIPPI DELTA CMTY COLLEGE          ,MS,38761-0000,Public       ,107,124,231,2565,,2540,5105
00241700,MISSISSIPPI GULF CST CLG-PERKINSTON     ,MS,39573-0000,Public       ,158,355,513,2586,,2352,4938
00241701,MISSISSIPPI GULF COAST COMMUNITY COLLEGE,MS,39507-3894,Public       ,0,0,0,2367,,4499,6866
00241702,MISSISSIPPI GULF COAST COMMUNITY COLLEGE,MS,39553-0100,Public       ,0,0,0,1932,,2857,4789
00242200,MISSISSIPPI UNIV FOR WOMEN              ,MS,39701-5818,Public       ,38,90,128,2026,,2881,4907
00242300,MISSISSIPPI STATE UNIVERSITY            ,MS,39762-9698,Public       ,350,315,665,18811,,8611,27422
00242400,MISSISSIPPI VALLEY STATE UNIVERSITY     ,MS,38941-1400,Public       ,151,121,272,3587,,3193,6780
00242600,NORTHEAST MS CMNTY COLLEGE              ,MS,38829-1731,Public       ,53,86,139,3085,,2336,5421
00242700,NORTHWEST MISSISSIPPI COMMUNITY CLG     ,MS,38668-1703,Public       ,203,292,495,6535,,5968,12503
00243000,PEARL RIVER COMMUNITY COLLEGE           ,MS,39470-2201,Public       ,132,191,323,3718,,3887,7605
00243300,RUST COLLEGE                            ,MS,38635-2328,Private      ,45,24,69,1586,,777,2363
00243500,SOUTHEASTERN BAPTIST COLLEGE            ,MS,39440-0000,Private      ,3,8,11,29,,114,143
00243600,SOUTHWEST MISSISSIPPI CMNTY CLG         ,MS,39666-8099,Public       ,62,66,128,1710,,1567,3277
00243900,TOUGALOO COLLEGE                        ,MS,39174-9799,Private      ,37,39,76,1759,,871,2630
00244000,UNIVERSITY OF MISSISSIPPI               ,MS,38677-1848,Public       ,270,240,510,17297,,7948,25245
00244001,UNIVERSITY OF MISSISSIPPI - MED CTR     ,MS,39216-0000,Public       ,14,68,82,875,,2782,3657
00244100,UNIVERSITY OF SOUTHERN MISSISSIPPI      ,MS,39406-0001,Public       ,296,428,724,13961,,11181,25142
00244700,WILLIAM CAREY UNIVERSITY                ,MS,39401-5499,Private      ,67,238,305,2128,,5073,7201
00489809,MCCANN SCHOOL OF BUSINESS & TECHNOLOGY -,MS,39503-3167,Proprietary  ,1,17,18,28,,203,231
01289101,ANTONELLI COLLEGE - JACKSON             ,MS,39232-9514,Proprietary  ,8,129,137,214,,1596,1810
01289102,ANTONELLI COLLEGE - HATTIESBURG         ,MS,39401-3056,Proprietary  ,16,80,96,207,,903,1110
02074900,CHRIS' BEAUTY COLLEGE                   ,MS,39501-0000,Proprietary  ,6,21,27,73,,222,295
02160500,NORTH MISSISSIPPI MED CTR MED TECH      ,MS,38801-0000,Private      ,4,6,10,55,,201,256
02235900,ACADEMY OF HAIR DESIGN #4               ,MS,39208-0000,Proprietary  ,3,23,26,89,,223,312
02244300,ACADEMY OF HAIR DESIGN #1               ,MS,39204-5008,Proprietary  ,14,37,51,130,,319,449
02244305,ACADEMY OF HAIR DESIGN #1-ACADEMY OF HAI,MS,38901-5108,Proprietary  ,2,6,8,4,,17,21
02249900,DELTA BEAUTY COLLEGE                    ,MS,38701-0000,Proprietary  ,3,11,14,62,,141,203
02251600,ACADEMY OF HAIR DESIGN #6               ,MS,39401-7581,Proprietary  ,10,36,46,111,,337,448
02251700,FOSTER'S COSMETOLOGY COLLEGE            ,MS,38663-0000,Proprietary  ,4,6,10,16,,51,67
02302800,MISSISSIPPI COLLEGE OF BEAUTY CULT      ,MS,39440-0000,Proprietary  ,4,8,12,50,,112,162
02320800,MAGNOLIA COLLEGE OF COSMETOLOGY         ,MS,39206-0000,Proprietary  ,5,37,42,136,,464,600
02502100,CREATIONS COLLEGE OF COSMETOLOGY        ,MS,38803-0000,Proprietary  ,4,8,12,52,,156,208
02516200,WESLEY BIBLICAL SEMINARY                ,MS,39206-0000,Private      ,0,6,6,13,,159,172
02586000,J & J HAIR DESIGN COLLEGE               ,MS,39051-3716,Proprietary  ,6,20,26,58,,138,196
03004000,FINAL TOUCH BEAUTY SCHOOL               ,MS,39307-2934,Proprietary  ,0,0,0,2,,7,9
03010603,VIRGINIA COLLEGE - JACKSON              ,MS,39206-5602,Proprietary  ,8,46,54,219,,1240,1459
03010610,VIRGINIA COLLEGE - BILOXI               ,MS,39532-2124,Proprietary  ,7,36,43,131,,532,663
03032400,KC'S SCHOOL OF HAIR DESIGN              ,MS,38863-0000,Proprietary  ,5,13,18,46,,162,208
03263300,TRAXLER'S SCHOOL OF HAIR                ,MS,39212-2529,Proprietary  ,2,7,9,41,,138,179
03294305,BLUE CLIFF COLLEGE - GULFPORT           ,MS,39503-0000,Proprietary  ,5,23,28,134,,565,699
03464300,ACADEMY OF HAIR DESIGN                  ,MS,39562-0000,Proprietary  ,0,5,5,19,,81,100
03848300,DAY SPA CAREER COLLEGE                  ,MS,39564-0000,Proprietary  ,3,10,13,20,,114,134
03963300,HEALING TOUCH SCHOOL OF MASSAGE THERAPY ,MS,39402-1300,Proprietary  ,5,40,45,82,,376,458
04131300,CORINTH ACADEMY OF COSMETOLOGY          ,MS,38834-4813,Proprietary  ,7,17,24,71,,194,265
04140200,"MISSISSIPPI INSTITUTE OF AESTHETICS, NAI",MS,39056-5628,Proprietary  ,6,16,22,59,,198,257
00252600,CARROLL COLLEGE                         ,MT,59625-0002,Private      ,15,10,25,2393,,324,2717
00252700,UNIVERSITY OF GREAT FALLS               ,MT,59405-4996,Private      ,17,26,43,880,,777,1657
00252800,MILES COMMUNITY COLLEGE                 ,MT,59301-4799,Public       ,8,13,21,275,,217,492
00252900,DAWSON COMMUNITY COLLEGE                ,MT,59330-1405,Public       ,7,10,17,244,,181,425
00253000,MONTANA STATE UNIVERSITY - BILLINGS     ,MT,59101-0298,Public       ,37,119,156,2991,,3949,6940
00253100,MONTANA TECH OF THE UNIV OF MONTANA     ,MT,59701-8997,Public       ,29,41,70,1750,,1673,3423
00253200,MONTANA STATE UNIVERSITY - BOZEMAN      ,MT,59717-4160,Public       ,137,175,312,13298,,5483,18781
00253300,MONTANA STATE UNIVERSITY-NORTHERN       ,MT,59501-3148,Public       ,17,29,46,934,,944,1878
00253400,ROCKY MOUNTAIN COLLEGE                  ,MT,59102-1796,Private      ,13,9,22,1384,,565,1949
00253600,UNIVERSITY OF MONTANA (THE)             ,MT,59812-0001,Public       ,141,265,406,8841,,8412,17253
00253700,UNIVERSITY OF MONTANA WESTERN (THE)     ,MT,59725-3598,Public       ,13,15,28,1463,,643,2106
00677700,FLATHEAD VALLEY COMMUNITY COLLEGE       ,MT,59901-2699,Public       ,34,99,133,1005,,1911,2916
00757000,HELENA COLLEGE OF TECHNOLOGY            ,MT,59601-3098,Public       ,13,35,48,562,,1251,1813
00790000,BUTTE ACADEMY OF BEAUTY CULTURE         ,MT,59701-9197,Proprietary  ,1,9,10,31,,84,115
00894700,"DAHL'S COLLEGE OF BEAUTY,INC            ",MT,59401-3731,Proprietary  ,0,0,0,13,,23,36
00931400,GREAT FALLS COLLEGE MONTANA STATE UNIVER,MT,59405-4907,Public       ,20,73,93,743,,1898,2641
02143400,SALISH KOOTENAI COLLEGE                 ,MT,59855-0000,Public       ,14,68,82,331,,1065,1396
02286600,LITTLE BIG HORN COLLEGE                 ,MT,59022-0000,Public       ,8,31,39,109,,257,366
02343000,FT PECK COMMUNITY COLLEGE               ,MT,59255-0000,Public       ,9,31,40,93,,239,332
02510600,BLACKFEET COMMUNITY COLLEGE             ,MT,59417-0000,Private      ,15,101,116,186,,509,695
02517500,FORT BELKNAP COLLEGE                    ,MT,59526-0000,Public       ,4,24,28,59,,186,245
02545200,CHIEF DULL KNIFE COLLEGE                ,MT,59043-0098,Public       ,5,31,36,59,,176,235
02610900,STONE CHILD COLLEGE                     ,MT,59521-9796,Public       ,10,68,78,103,,277,380
02621300,ACADEMY OF COSMETOLOGY                  ,MT,59715-3544,Proprietary  ,2,3,5,46,,70,116
03205300,MODERN BEAUTY SCHOOL                    ,MT,59801-8386,Proprietary  ,5,8,13,73,,132,205
03763400,"ACADEMY OF NAIL, SKIN & HAIR            ",MT,59101-0000,Proprietary  ,8,20,28,83,,210,293
03778300,HEALTH WORKS INSTITUTE                  ,MT,59715-0000,Proprietary  ,3,2,5,51,,122,173
04163700,BITTERROOT SCHOOL OF COSMETOLOGY        ,MT,59840-3118,Proprietary  ,1,6,7,18,,62,80
04164100,SALON PROFESSIONAL ACADEMY (THE)        ,MT,59405-0000,Proprietary  ,2,10,12,79,,141,220
04187700,CREVIER'S SCHOOL OF COSMETOLOGY         ,MT,59901-4402,Proprietary  ,4,15,19,69,,184,253
00253900,CHADRON STATE COLLEGE                   ,NE,69337-2690,Public       ,20,55,75,2062,,1361,3423
00254000,COLLEGE OF ST MARY                      ,NE,68106-2606,Private      ,3,30,33,610,,1269,1879
00254100,CONCORDIA UNIVERSITY                    ,NE,68434-1594,Private      ,10,76,86,1445,,839,2284
00254200,CREIGHTON UNIVERSITY                    ,NE,68178-0001,Private      ,56,129,185,5567,,5631,11198
00254400,DOANE COLLEGE                           ,NE,68333-2421,Private      ,14,79,93,1814,,1347,3161
00254700,GRACE UNIVERSITY                        ,NE,68108-3629,Private      ,4,13,17,436,,378,814
00254800,HASTINGS COLLEGE                        ,NE,68901-7621,Private      ,8,12,20,1489,,204,1693
00255100,UNIVERSITY OF NEBRASKA AT KEARNEY       ,NE,68849-0001,Public       ,50,92,142,4966,,2490,7456
00255300,MIDLAND UNIVERSITY                      ,NE,68025-4254,Private      ,12,15,27,1627,,431,2058
00255400,UNIVERSITY OF NEBRASKA-OMAHA            ,NE,68182-0001,Public       ,140,303,443,10112,,8017,18129
00255500,NEBRASKA WESLEYAN UNIVERSITY            ,NE,68504-2796,Private      ,18,34,52,2216,,908,3124
00255700,MID-PLAINS COMM COLLEGE - NORTH PLATTE  ,NE,69101-9420,Public       ,18,47,65,561,,853,1414
00255701,MID-PLAINS COMMUNITY COLLEGE - MCCOOK   ,NE,69001-2631,Public       ,4,13,17,257,,234,491
00255900,PERU STATE COLLEGE                      ,NE,68421-0010,Public       ,14,64,78,1214,,1199,2413
00256000,WESTERN NEBRASKA COMMUNITY COLLEGE      ,NE,69361-1815,Public       ,26,65,91,812,,1087,1899
00256300,UNION COLLEGE                           ,NE,68506-4387,Private      ,13,15,28,899,,481,1380
00256500,UNIVERSITY OF NEBRASKA-LINCOLN          ,NE,68588-0419,Public       ,160,161,321,17194,,5791,22985
00256596,UNIVERSITY OF NEBRASKA - CURTIS         ,NE,69025-9522,Public       ,3,4,7,236,,57,293
00256600,WAYNE STATE COLLEGE                     ,NE,68787-1172,Public       ,25,32,57,3325,,1078,4403
00256700,YORK COLLEGE                            ,NE,68467-2699,Private      ,1,5,6,547,,157,704
00443600,REGNL WST MEDCL CTR SCHL RAD            ,NE,69361-0000,Private      ,0,0,0,22,,31,53
00458608,KAPLAN UNIVERSITY - OMAHA               ,NE,68134-1002,Proprietary  ,17,170,187,222,,1911,2133
00458609,KAPLAN UNIVERSITY - LINCOLN             ,NE,68508-2668,Proprietary  ,15,133,148,168,,1280,1448
00639900,BRYANLGH COLLEGE OF HEALTH SCIENCES     ,NE,68506-1398,Private      ,8,15,23,458,,487,945
00640400,NEBR METHODIST CLG OF NURS ALLD HLTH    ,NE,68114-2852,Private      ,12,31,43,544,,1157,1701
00689500,UNIVERSITY OF NEBRASKA-MED CTR          ,NE,68198-4265,Public       ,13,43,56,749,,2667,3416
00750100,VATTEROTT COLLEGE                       ,NE,68137-1237,Proprietary  ,5,30,35,213,,923,1136
00849200,ALEGENT HEALTH SCHOOLS                  ,NE,68114-2767,Private      ,5,12,17,114,,310,424
00952300,BAHNER COLLEGE OF HAIRSTYLING           ,NE,68025-3297,Proprietary  ,4,8,12,29,,55,84
00961700,CAPITOL BEAUTY SCHOOL                   ,NE,68144-0000,Proprietary  ,14,23,37,165,,242,407
00974300,BELLEVUE UNIVERSITY                     ,NE,68005-0000,Private      ,26,764,790,967,,9858,10825
00986200,CLARKSON COLLEGE                        ,NE,68131-2739,Private      ,8,51,59,586,,1576,2162
01151900,JOSEPH'S COLLEGE OF BEAUTY/ALL CAMPUSES ,NE,68510-2226,Proprietary  ,17,35,52,172,,404,576
01166700,NORTHEAST COMMUNITY COLLEGE             ,NE,68702-0000,Public       ,31,68,99,2038,,1598,3636
01258600,METROPOLITAN COMMUNITY COLLEGE          ,NE,68103-0000,Public       ,221,883,1104,5839,,13473,19312
01297600,NEBRASKA CHRISTIAN COLLEGE              ,NE,68046-4256,Private      ,1,4,5,165,,72,237
02079700,COLLEGE OF HAIR DESIGN                  ,NE,68508-0000,Proprietary  ,6,30,36,226,,250,476
02099500,CENTRAL COMMUNITY COLLEGE               ,NE,68801-7299,Public       ,27,112,139,816,,1652,2468
02099501,CENTRAL COMMUNITY COLLEGE - HASTINGS CAM,NE,68902-7712,Public       ,16,46,62,1079,,925,2004
02099502,CENTRAL COMMUNITY COLLEGE - COLUMBUS CAM,NE,68602-8031,Public       ,17,24,41,579,,611,1190
02508300,SOUTHEAST COMM. COLLEGE-ALL CAMPUSES    ,NE,68520-0000,Public       ,163,423,586,5233,,6929,12162
02550800,NEBRASKA INDIAN COMMUNITY COLLEGE       ,NE,68039-0000,Public       ,1,21,22,34,,181,215
02610500,XENON INTERNATIONAL ACADEMY II          ,NE,68127-3522,Proprietary  ,11,29,40,232,,343,575
03164300,THE CREATIVE CENTER                     ,NE,68164-2911,Proprietary  ,0,5,5,157,,106,263
03279300,MYOTHERAPY INSTITUTE                    ,NE,68516-0000,Proprietary  ,0,5,5,37,,51,88
03323300,LITTLE PRIEST TRIBAL COLLEGE            ,NE,68071-0000,Private      ,1,30,31,31,,174,205
03821400,UNIVERSAL COLLEGE OF HEALING ARTS       ,NE,68112-1810,Proprietary  ,1,9,10,25,,147,172
00256800,UNIVERSITY OF NEVADA RENO               ,NV,89557-0002,Public       ,309,256,565,16114,,7752,23866
00256900,UNIVERSITY OF NEVADA-LAS VEGAS          ,NV,89154-1001,Public       ,419,718,1137,22214,,20050,42264
00697700,GREAT BASIN COLLEGE                     ,NV,89801-3348,Public       ,23,92,115,734,,1701,2435
00732954,ITT TECHNICAL INSTITUTE                 ,NV,89014-6712,Proprietary  ,41,131,172,395,,1130,1525
00736700,MARINELLO SCHOOLS OF BEAUTY             ,NV,89110-3563,Proprietary  ,34,84,118,252,,551,803
00736701,MARINELLO SCHOOLS OF BEAUTY -           ,NV,89014-2244,Proprietary  ,13,36,49,99,,270,369
00737100,MARINELLO SCHOOL OF BEAUTY              ,NV,89502-6530,Proprietary  ,9,61,70,171,,398,569
00844103,ANTHEM INSTITUTE - MORRISON UNIVERSITY  ,NV,89521-4826,Proprietary  ,18,86,104,127,,719,846
00919200,SIERRA NEVADA COLLEGE                   ,NV,89451-0000,Private      ,11,51,62,609,,770,1379
01036200,COLLEGE OF SOUTHERN NEVADA              ,NV,89146-1139,Public       ,582,1433,2015,17635,,29395,47030
01036300,WESTERN NEVADA COLLEGE                  ,NV,89703-0000,Public       ,58,163,221,1389,,3303,4692
01246110,LINCOLN TECHNICAL INSTITUTE-EUPH INST OF,NV,89117-8803,Proprietary  ,13,31,44,159,,363,522
01246111,LINCOLN TECHNICAL INSTITUTE-EUPH INS OFB,NV,89052-4964,Proprietary  ,5,15,20,101,,225,326
01246112,LINCOLN TECHNICAL INSTITUTE- EUPH INST O,NV,89131-1036,Proprietary  ,12,31,43,175,,315,490
01323200,ACADEMY OF HAIR DESIGN                  ,NV,89146-1617,Proprietary  ,19,51,70,227,,572,799
02107700,TRUCKEE MEADOWS COMMUNITY CLG           ,NV,89512-0000,Public       ,202,445,647,4945,,8375,13320
02237500,EVEREST COLLEGE                         ,NV,89103-0000,Proprietary  ,72,244,316,956,,2624,3580
02338512,GLENDALE CAREER COLLEGE - NEVADA CAREER ,NV,89131-3268,Proprietary  ,2,19,21,85,,327,412
02616703,SCOTTSDALE CULINARY INSTITUTE - LE CORDO,NV,89144-7047,Proprietary  ,5,34,39,166,,499,665
02621500,CAREER COLLEGE OF NORTHERN NEVADA       ,NV,89434-7905,Proprietary  ,31,134,165,293,,975,1268
03030603,UTAH CLG OF MASSAGE THERAPY-NSMT        ,NV,89123-0000,Proprietary  ,16,60,76,166,,484,650
03031405,INTERNATIONAL ACADEMY OF DESIGN AND TECH,NV,89074-7750,Proprietary  ,23,50,73,353,,638,991
03043200,KAPLAN COLLEGE                          ,NV,89102-8618,Proprietary  ,67,262,329,852,,3033,3885
03076404,BRYMAN SCHOOL OF ARIZONA (THE) - ANTHEM ,NV,89102-4514,Proprietary  ,20,87,107,220,,569,789
03088200,CARSON CITY BEAUTY ACADEMY              ,NV,89706-0000,Proprietary  ,3,15,18,54,,199,253
03787300,EXPERTISE SCHOOL OF BEAUTY              ,NV,89106-2516,Private      ,11,50,61,105,,383,488
03838500,NORTHWEST HEALTH CAREERS                ,NV,89128-0255,Proprietary  ,26,75,101,284,,886,1170
03975300,INSTITUTE OF PROFESSIONAL CAREERS       ,NV,89119-7825,Proprietary  ,5,32,37,137,,480,617
04051303,ART INSTITUTE OF PHOENIX (THE) - ART INS,NV,89074-7737,Proprietary  ,12,31,43,473,,459,932
04065300,ROSEMAN UNIVERSITY OF HEALTH SCIENCES   ,NV,89014-2333,Private      ,25,57,82,666,,2432,3098
04114300,NEVADA STATE COLLEGE                    ,NV,89002-9455,Public       ,70,169,239,2256,,4204,6460
04142601,TOURO UNIVERSITY - NEVADA               ,NV,89014-8800,Private      ,6,34,40,113,,883,996
04144800,INTERNATIONAL ACADEMY OF STYLE          ,NV,89509-3450,Proprietary  ,10,24,34,88,,213,301
04147600,AVEDA INSTITUTE LAS VEGAS               ,NV,89119-6103,Proprietary  ,11,47,58,195,,494,689
04171000,ADVANCED TRAINING INSTITUTE             ,NV,89115-7504,Proprietary  ,27,138,165,210,,963,1173
04186300,PAUL MITCHELL THE SCHOOL LAS VEGAS      ,NV,89123-8014,Proprietary  ,37,45,82,337,,502,839
04190300,AMERICAN INSTITUTE OF MEDICAL SONOGRAPHY,NV,89146-6597,Proprietary  ,8,36,44,160,,641,801
04191100,DESTINATION ACADEMY FOR SPA AND SALON PR,NV,89147-8397,Proprietary  ,3,6,9,69,,216,285
04203100,PAUL MITCHELL THE SCHOOL RENO           ,NV,89501-3356,Proprietary  ,12,32,44,183,,281,464
04226200,HEALTHCARE PREPARATORY INSTITUTE        ,NV,89130-2580,Proprietary  ,6,32,38,6,,33,39
00257200,COLBY-SAWYER COLLEGE                    ,NH,03257-4648,Private      ,19,2,21,2838,,162,3000
00257300,DARTMOUTH COLLEGE                       ,NH,03755-3529,Private      ,71,31,102,12469,,1962,14431
00257500,FRANKLIN PIERCE UNIVERSITY              ,NH,03461-0060,Private      ,23,54,77,3742,,1287,5029
00257900,NEW ENGLAND COLLEGE                     ,NH,03242-3293,Private      ,48,249,297,2450,,2183,4633
00258000,SOUTHERN NEW HAMPSHIRE UNIVERSITY       ,NH,03106-1045,Private      ,369,4575,4944,8165,,35215,43380
00258100,NHTI  - CONCORD'S COMMUNITY COLLEGE     ,NH,03301-7412,Public       ,66,86,152,3061,,2281,5342
00258200,MANCHESTER COMMUNITY COLLEGE            ,NH,03102-8518,Public       ,54,122,176,1582,,2125,3707
00258300,GREAT BAY COMMUNITY COLLEGE             ,NH,03801-0000,Public       ,42,90,132,1192,,1538,2730
00258600,RIVIER UNIVERSITY                       ,NH,03060-5086,Private      ,7,55,62,1368,,1325,2693
00258700,SAINT ANSELM COLLEGE                    ,NH,03102-1310,Private      ,19,9,28,4088,,245,4333
00258900,UNIVERSITY OF NEW HAMPSHIRE             ,NH,03824-2511,Public       ,115,84,199,21758,,3817,25575
00259000,KEENE STATE COLLEGE                     ,NH,03431-0000,Public       ,58,24,82,8148,,828,8976
00259100,PLYMOUTH STATE UNIVERSITY               ,NH,03264-1595,Public       ,50,63,113,7009,,1694,8703
00301004,ANTIOCH UNIVERSITY                      ,NH,03431-0000,Private      ,0,11,11,10,,847,857
00472900,HESSER COLLEGE                          ,NH,03103-7230,Proprietary  ,19,112,131,393,,1316,1709
00472901,HESSER COLLEGE - NASHUA CAMPUS          ,NH,03063-1286,Proprietary  ,5,39,44,158,,475,633
00472904,HESSER COLLEGE - PORTSMOUTH CAMPUS      ,NH,03801-3245,Proprietary  ,0,7,7,109,,436,545
00472905,HESSER COLLEGE - SALEM CAMPUS           ,NH,03079-2842,Proprietary  ,7,36,43,196,,561,757
00472906,HESSER COLLEGE - CONCORD CAMPUS         ,NH,03301-3415,Proprietary  ,1,5,6,84,,334,418
00473100,DANIEL WEBSTER COLLEGE                  ,NH,03063-1300,Proprietary  ,8,40,48,815,,464,1279
00529100,WHITE MOUNTAINS COMMUNITY COLLEGE       ,NH,03570-3799,Public       ,10,25,35,392,,602,994
00702500,LEBANON COLLEGE                         ,NH,03766-0000,Private      ,1,5,6,47,,104,151
00755500,LAKES REGION COMMUNITY COLLEGE          ,NH,03246-1326,Public       ,15,36,51,718,,854,1572
00756000,RIVER VALLEY COMMUNITY COLLEGE          ,NH,03743-9707,Public       ,7,48,55,447,,941,1388
00864500,EMPIRE BEAUTY SCHOOL                    ,NH,03220-0000,Proprietary  ,12,29,41,155,,199,354
00923600,NASHUA COMMUNITY COLLEGE                ,NH,03063-2052,Public       ,29,47,76,1314,,1276,2590
01318900,CONTINENTAL ACADEMIE OF HAIR DESIGN     ,NH,03051-3754,Proprietary  ,4,7,11,77,,49,126
02097900,UNIVERSITY NEW HAMPSHIRE SCHOOL OF LAW  ,NH,03301-0000,Private      ,1,3,4,28,,549,577
02140400,ST JOSEPH SCH OF PRAC NRSG              ,NH,03060-0000,Private      ,0,19,19,72,,288,360
02174800,MICHAEL'S SCHOOL OF HAIR DESIGN & ESTHET,NH,03110-0000,Proprietary  ,5,17,22,124,,143,267
02179600,EMPIRE BEAUTY SCHOOL                    ,NH,03878-0000,Proprietary  ,9,17,26,118,,159,277
02211600,PORTSMOUTH BTY SCH OF HAIR DESIGN       ,NH,03801-4084,Proprietary  ,2,2,4,35,,40,75
02245400,KEENE BEAUTY ACADEMY                    ,NH,03431-0000,Proprietary  ,4,0,4,50,,56,106
02247000,NEW ENGLAND SCHOOL OF HAIR DESIGN       ,NH,03784-0000,Proprietary  ,6,7,13,55,,48,103
03043100,THOMAS MORE COLLEGE OF LIBERAL ARTS     ,NH,03054-4818,Private      ,0,0,0,112,,30,142
03101300,GRANITE STATE COLLEGE                   ,NH,03301-6400,Public       ,25,181,206,482,,2509,2991
03182300,NEW HAMPSHIRE INSTITUTE OF ART          ,NH,03104-4858,Private      ,7,11,18,744,,221,965
03437300,UPPER VALLEY TEACHER TRANING PROGRAM    ,NH,03766-1358,Private      ,0,1,1,3,,43,46
03729300,NH INSTITUTE FOR THERAPEUTIC ARTS       ,NH,03051-4906,Proprietary  ,0,3,3,11,,50,61
04162200,LAIRD INSTITUTE OF SPA THERAPY          ,NH,03102-5263,Proprietary  ,6,10,16,23,,95,118
00267000,BAPTIST BIBLE COLG OF PENNSYLVANIA      ,PA,18411-1297,Private      ,6,27,33,603,,509,1112
00322800,BRYN ATHYN COLLEGE OF THE NEW CHURCH    ,PA,19009-0717,Private      ,1,1,2,308,,50,358
00322900,ALBRIGHT COLLEGE                        ,PA,19612-5234,Private      ,56,63,119,4539,,1414,5953
00323000,ALLEGHENY COLLEGE                       ,PA,16335-3902,Private      ,20,5,25,3858,,148,4006
00323100,COMM CLG OF ALLEGHENY-ALLEGHENY CMP     ,PA,15212-0000,Public       ,87,323,410,3591,,7006,10597
00323101,"COMM CLG OF ALLEGHENY, BOYCE CAMPUS     ",PA,15146-0000,Public       ,53,142,195,1702,,2836,4538
00323102,"COMM CLG OF ALLEGHENY, NORTH CAMPUS     ",PA,15237-0000,Public       ,53,170,223,2047,,2900,4947
00323103,"COMM CLG OF ALLEGHENY, SOUTH CAMPUS     ",PA,15122-0000,Public       ,31,97,128,1987,,2587,4574
00323300,ALVERNIA UNIVERSITY                     ,PA,19607-1799,Private      ,22,71,93,2598,,1820,4418
00323500,ARCADIA UNIVERSITY                      ,PA,19038-3295,Private      ,65,62,127,6556,,2179,8735
00323700,BRYN MAWR COLLEGE                       ,PA,19010-2899,Private      ,9,13,22,1843,,628,2471
00323800,BUCKNELL UNIVERSITY                     ,PA,17837-2122,Private      ,40,4,44,5458,,225,5683
00323900,BUCKS COUNTY COMMUNITY COLLEGE          ,PA,18940-1320,Public       ,125,224,349,4624,,4425,9049
00324000,BUTLER COUNTY COMMUNITY COLLEGE         ,PA,16001-0000,Public       ,52,113,165,2147,,2166,4313
00324100,CABRINI COLLEGE                         ,PA,19087-3698,Private      ,20,66,86,2108,,1087,3195
00324200,CARNEGIE MELLON UNIVERSITY              ,PA,15213-3890,Private      ,69,32,101,13693,,1843,15536
00324201,CARNEGIE MELLON UNIV- THE HEINZ COLLEGE ,PA,15213-0000,Private      ,3,13,16,174,,712,886
00324202,CARNEGIE MELLON- TEPPER SCHOOL OF BUSINE,PA,15213-0000,Private      ,1,8,9,270,,586,856
00324300,CEDAR CREST COLLEGE                     ,PA,18104-6196,Private      ,14,51,65,1126,,1519,2645
00324400,CHATHAM UNIVERSITY                      ,PA,15232-2826,Private      ,6,37,43,766,,1932,2698
00324500,CHESTNUT HILL COLLEGE                   ,PA,19118-2693,Private      ,25,99,124,1842,,2541,4383
00324700,MISERICORDIA  UNIVERSITY                ,PA,18612-1008,Private      ,17,39,56,2808,,1548,4356
00324900,COMMUNITY COLLEGE OF PHILADELPHIA       ,PA,19130-3991,Public       ,252,887,1139,14091,,25136,39227
00325100,CURTIS INSTITUTE OF MUSIC               ,PA,19103-6187,Private      ,1,4,5,333,,147,480
00325200,DELAWARE VALLEY COLLEGE                 ,PA,18901-2697,Private      ,17,21,38,2405,,480,2885
00325300,DICKINSON COLLEGE                       ,PA,17013-2896,Private      ,16,6,22,3665,,174,3839
00325600,DREXEL UNIVERSITY                       ,PA,19104-2875,Private      ,329,680,1009,35426,,20081,55507
00325800,DUQUESNE UNIVERSITY                     ,PA,15282-0001,Private      ,36,100,136,8337,,4106,12443
00325900,EASTERN UNIVERSITY                      ,PA,19087-3696,Private      ,27,105,132,2447,,2860,5307
00326200,ELIZABETHTOWN COLLEGE                   ,PA,17022-2298,Private      ,17,30,47,3279,,825,4104
00326300,EVANGELICAL SCHOOL OF THEOLOGY          ,PA,17067-0000,Private      ,0,4,4,0,,89,89
00326500,FRANKLIN & MARSHALL COLLEGE             ,PA,17604-0000,Private      ,18,9,27,3640,,211,3851
00326600,GANNON UNIVERSITY                       ,PA,16541-0001,Private      ,25,40,65,3822,,1567,5389
00326700,GENEVA COLLEGE                          ,PA,15010-3599,Private      ,9,42,51,1914,,945,2859
00326800,GETTYSBURG COLLEGE                      ,PA,17325-1486,Private      ,27,9,36,4379,,206,4585
00326900,GROVE CITY COLLEGE                      ,PA,16127-2104,Private      ,12,0,12,1928,,71,1999
00327000,GWYNEDD-MERCY COLLEGE                   ,PA,19437-0901,Private      ,16,73,89,1654,,1821,3475
00327200,HARCUM COLLEGE                          ,PA,19010-3476,Private      ,15,42,57,1071,,1978,3049
00327300,HARRISBURG AREA COMMUNITY COLLEGE       ,PA,17110-2999,Public       ,197,686,883,10315,,16808,27123
00327400,HAVERFORD COLLEGE                       ,PA,19041-1392,Private      ,5,1,6,2204,,75,2279
00327500,HOLY FAMILY UNIVERSITY                  ,PA,19114-2094,Private      ,15,42,57,2284,,2181,4465
00327600,IMMACULATA UNIVERSITY                   ,PA,19345-0647,Private      ,11,72,83,1921,,1947,3868
00327700,INDIANA UNIVERSITY OF PENNSYLVANIA      ,PA,15705-1097,Public       ,181,131,312,15477,,4232,19709
00327900,JUNIATA COLLEGE                         ,PA,16652-2196,Private      ,16,3,19,2626,,133,2759
00328000,KEYSTONE COLLEGE                        ,PA,18440-0200,Private      ,12,19,31,1774,,800,2574
00328200,KINGS COLLEGE                           ,PA,18711-0801,Private      ,26,17,43,3305,,634,3939
00328300,LACKAWANNA COLLEGE                      ,PA,18509-9961,Private      ,40,48,88,1962,,1243,3205
00328400,LAFAYETTE COLLEGE                       ,PA,18042-1768,Private      ,31,5,36,4603,,155,4758
00328500,LANCASTER BIBLE COLLEGE                 ,PA,17601-5036,Private      ,6,83,89,846,,1248,2094
00328600,LANCASTER THEOLOGICAL SEMINARY          ,PA,17603-0000,Private      ,1,3,4,3,,135,138
00328700,LASALLE UNIVERSITY                      ,PA,19141-1199,Private      ,79,122,201,6848,,4651,11499
00328800,LEBANON VALLEY COLLEGE                  ,PA,17003-1400,Private      ,14,6,20,3124,,333,3457
00328900,LEHIGH UNIVERSITY                       ,PA,18015-1588,Private      ,52,21,73,9572,,1085,10657
00329000,LINCOLN UNIVERSITY                      ,PA,19352-0999,Public       ,46,33,79,3860,,1436,5296
00329100,LUTHERAN THEOLOG SEMINARY-GETTYSBRG     ,PA,17325-0000,Private      ,0,3,3,2,,93,95
00329200,LUTHERAN THEOLOGICAL SEMINARY           ,PA,19119-0000,Private      ,0,5,5,2,,207,209
00329300,LYCOMING COLLEGE                        ,PA,17701-5192,Private      ,9,3,12,2020,,195,2215
00329400,MANOR COLLEGE                           ,PA,19046-3399,Private      ,10,12,22,759,,647,1406
00329600,MARYWOOD UNIVERSITY                     ,PA,18509-1598,Private      ,20,25,45,3011,,1572,4583
00329700,MERCYHURST UNIVERSITY                   ,PA,16546-0001,Private      ,25,57,82,4325,,1932,6257
00329800,MESSIAH COLLEGE                         ,PA,17027-0000,Private      ,16,24,40,3585,,509,4094
00330000,MOORE COLLEGE OF ART & DESIGN           ,PA,19103-1179,Private      ,6,26,32,667,,425,1092
00330100,MORAVIAN COLLEGE                        ,PA,18018-6650,Private      ,10,13,23,2230,,428,2658
00330101,MORAVIAN THEOLOGICAL SEMINARY           ,PA,18018-0000,Private      ,0,3,3,19,,68,87
00330200,MOUNT ALOYSIUS COLLEGE                  ,PA,16630-1999,Private      ,13,22,35,1497,,971,2468
00330300,CARLOW UNIVERSITY                       ,PA,15213-3165,Private      ,9,46,55,1309,,2266,3575
00330400,MUHLENBERG COLLEGE                      ,PA,18104-5586,Private      ,25,15,40,4220,,471,4691
00330600,VALLEY FORGE CHRISTIAN COLLEGE          ,PA,19460-2399,Private      ,4,15,19,852,,315,1167
00330900,PEIRCE COLLEGE                          ,PA,19102-4699,Private      ,23,141,164,642,,3067,3709
00331100,SALUS UNIVERSITY                        ,PA,19027-1598,Private      ,0,5,5,8,,1165,1173
00331300,WIDENER UNIVERSITY                      ,PA,19013-5792,Private      ,33,67,100,5180,,2877,8057
00331302,WIDENER UNIV SCH OF LAW- HARRISBURG     ,PA,17106-9381,Private      ,2,8,10,40,,652,692
00331500,BLOOMSBURG UNIVERSITY OF PA             ,PA,17815-1301,Public       ,153,65,218,13350,,2334,15684
00331600,CALIFORNIA UNIV OF PENNSYLVANIA         ,PA,15419-1394,Public       ,50,140,190,6721,,4710,11431
00331700,CHEYNEY UNIVERSITY OF PENNSYLVANIA      ,PA,19319-0200,Public       ,27,18,45,2211,,1071,3282
00331800,CLARION UNIVERSITY OF PENNSYLVANIA      ,PA,16214-1232,Public       ,37,69,106,5215,,2521,7736
00332000,EAST STROUDSBURG UNIVERSITY             ,PA,18301-2999,Public       ,116,68,184,8021,,2140,10161
00332100,EDINBORO UNIVERSITY OF PENNSYLVANIA     ,PA,16444-0001,Public       ,46,121,167,6177,,3157,9334
00332200,KUTZTOWN UNIVERSITY OF PENNSYLVANIA     ,PA,19530-9339,Public       ,88,63,151,12015,,2450,14465
00332300,LOCK HAVEN UNIV OF PENNSYLVANIA         ,PA,17745-2439,Public       ,84,56,140,6205,,1558,7763
00332400,MANSFIELD UNIVERSITY                    ,PA,16933-1123,Public       ,58,27,85,3178,,970,4148
00332500,MILLERSVILLE UNIVERSITY OF PA           ,PA,17551-1800,Public       ,88,63,151,9151,,2719,11870
00332600,SHIPPENSBURG UNIVERSITY                 ,PA,17257-2299,Public       ,91,59,150,8930,,1905,10835
00332700,SLIPPERY ROCK UNIVERSITY                ,PA,16057-1326,Public       ,38,71,109,8917,,2310,11227
00332800,WEST CHESTER UNIVERSITY                 ,PA,19383-0001,Public       ,221,142,363,18847,,5364,24211
00332900,PENN STATE UNIVERSITY                   ,PA,16802-1503,Public       ,1306,1116,2422,73282,,29830,103112
00335000,UNIVERSITY OF THE ARTS (THE)            ,PA,19102-9493,Private      ,30,12,42,3331,,802,4133
00335100,CAIRN UNIVERSITY                        ,PA,19047-2942,Private      ,2,20,22,789,,532,1321
00335200,PHILADELPHIA CLG OSTEOPATHIC MED        ,PA,19131-0000,Private      ,5,27,32,54,,3499,3553
00335300,UNIVERSITY OF THE SCIENCES IN PHILADELPH,PA,19104-4495,Private      ,27,39,66,3699,,1631,5330
00335400,PHILADELPHIA UNIVERSITY                 ,PA,19144-5497,Private      ,45,88,133,4835,,2605,7440
00335600,PITTSBURGH THEOLOGICAL SEMINARY         ,PA,15206-0000,Private      ,0,1,1,6,,196,202
00335700,POINT PARK UNIVERSITY                   ,PA,15222-1912,Private      ,21,67,88,3705,,2502,6207
00335800,REFORMED PRESBYTERIAN THEOL SEMINAR     ,PA,15208-0000,Private      ,0,1,1,0,,26,26
00335900,ROBERT MORRIS UNIVERSITY                ,PA,15108-1189,Private      ,47,86,133,5565,,2367,7932
00336000,ROSEMONT COLLEGE                        ,PA,19010-1699,Private      ,12,28,40,786,,692,1478
00336200,SETON HILL UNIVERSITY                   ,PA,15601-1599,Private      ,18,22,40,2376,,974,3350
00336400,ST. CHARLES BORROMEO SEMINARY           ,PA,19096-0000,Private      ,0,4,4,45,,41,86
00336600,SAINT FRANCIS UNIVERSITY                ,PA,15940-0600,Private      ,20,36,56,2176,,830,3006
00336700,SAINT JOSEPH'S UNIVERSITY               ,PA,19131-1395,Private      ,68,243,311,7918,,4257,12175
00336800,ST VINCENT COLLEGE                      ,PA,15650-2690,Private      ,10,8,18,2183,,315,2498
00336900,SUSQUEHANNA UNIVERSITY                  ,PA,17870-1001,Private      ,20,5,25,3316,,139,3455
00337000,SWARTHMORE COLLEGE                      ,PA,19081-1397,Private      ,16,3,19,3928,,138,4066
00337100,TEMPLE UNIVERSITY                       ,PA,19122-6003,Private      ,392,433,825,36699,,21953,58652
00337600,THIEL COLLEGE                           ,PA,16125-2181,Private      ,13,5,18,1978,,177,2155
00337800,UNIVERSITY OF PENNSYLVANIA              ,PA,19104-6216,Private      ,157,265,422,22309,,13363,35672
00337900,UNIVERSITY OF PITTSBURGH                ,PA,15260-0000,Public       ,223,271,494,31411,,11182,42593
00337906,UNIVERSITY OF PITTSBURGH - SCHOOL OF MED,PA,15261-0001,Public       ,4,8,12,222,,1037,1259
00337907,UNIVERSITY OF PITTSBURGH - SCHOOL OF DEN,PA,15261-2523,Public       ,1,4,5,92,,412,504
00338400,UNIVERSITY OF SCRANTON                  ,PA,18510-4622,Private      ,56,79,135,8039,,1812,9851
00338500,URSINUS COLLEGE                         ,PA,19426-1000,Private      ,19,3,22,3151,,129,3280
00338600,VALLEY FORGE MILITARY COLLEGE           ,PA,19087-3695,Private      ,10,1,11,515,,68,583
00338800,VILLANOVA UNIVERSITY                    ,PA,19085-1699,Private      ,99,142,241,12714,,3270,15984
00338801,VILLANOVA UNIV SCH OF LAW               ,PA,19085-0000,Private      ,0,4,4,33,,1064,1097
00338900,WASHINGTON & JEFFERSON COLLEGE          ,PA,15301-4801,Private      ,25,3,28,2735,,111,2846
00339100,WAYNESBURG UNIVERSITY                   ,PA,15370-1222,Private      ,13,27,40,2151,,850,3001
00339200,WESTMINSTER COLLEGE                     ,PA,16172-0002,Private      ,13,13,26,2393,,180,2573
00339300,WESTMINSTER THEOLOGICAL SEMINARY        ,PA,19038-0000,Private      ,0,2,2,3,,326,329
00339400,WILKES UNIVERSITY                       ,PA,18766-0998,Private      ,23,72,95,3692,,1523,5215
00339500,PENNSYLVANIA COLLEGE OF TECHNOLOGY      ,PA,17701-5779,Public       ,34,44,78,5459,,2423,7882
00339600,WILSON COLLEGE                          ,PA,17201-1285,Private      ,3,18,21,418,,427,845
00339900,YORK COLLEGE OF PENNSYLVANIA            ,PA,17405-7199,Private      ,89,54,143,9234,,1585,10819
00398600,DESALES UNIVERSITY                      ,PA,18034-9568,Private      ,19,56,75,2862,,1733,4595
00398700,LA ROCHE COLLEGE                        ,PA,15237-5898,Private      ,3,21,24,1255,,666,1921
00398800,NEUMANN UNIVERSITY                      ,PA,19014-1298,Private      ,37,70,107,3354,,1507,4861
00405800,GRATZ COLLEGE                           ,PA,19027-3097,Private      ,0,6,6,4,,138,142
00445200,MONTGOMERY COUNTY COMMUNITY COLLEGE     ,PA,19422-6300,Public       ,113,287,400,5799,,6646,12445
00488900,CAMBRIA-ROWE BUSINESS COLLEGE           ,PA,15902-2494,Proprietary  ,6,22,28,145,,304,449
00488901,CAMBRIA ROWE BUSINESS COLLEGE - INDIANA ,PA,15701-2804,Proprietary  ,5,8,13,23,,59,82
00489000,CENTRAL PENNSYLVANIA COLLEGE            ,PA,17093-0309,Proprietary  ,32,84,116,1177,,1677,2854
00489300,DU BOIS BUSINESS COLLEGE                ,PA,15801-2401,Proprietary  ,7,26,33,160,,306,466
00489400,ERIE BUSINESS CENTER                    ,PA,16501-1305,Proprietary  ,2,28,30,94,,401,495
00489401,ERIE BUSINESS CENTER - NEW CASTLE CAMPUS,PA,16101-3950,Proprietary  ,3,7,10,38,,133,171
00489800,MCCANN SCHOOL OF BUSINESS & TECHNOL     ,PA,17901-1335,Proprietary  ,146,678,824,1812,,6575,8387
00489807,MCCANN SCHOOL OF BUSINESS & TECHNOLOGY -,PA,17013-3180,Proprietary  ,0,4,4,47,,129,176
00489900,MERCY HOSP SCH OF NURSING               ,PA,15219-5166,Private      ,0,7,7,171,,292,463
00490100,NEWPORT BUSINESS INSTITUTE              ,PA,15068-3929,Proprietary  ,0,0,0,24,,71,95
00490200,PENN COMMERCIAL BUSINESS/TECHNICAL SCHL ,PA,15301-2871,Proprietary  ,29,64,93,250,,457,707
00491000,KAPLAN CAREER INSTITUTE                 ,PA,17111-3571,Proprietary  ,19,81,100,286,,967,1253
00491001,THOMPSON INSTITUTE-PHILADEPHIA CAMPUS   ,PA,19104-3386,Proprietary  ,46,144,190,424,,1054,1478
00491400,NEWPORT BUSINESS INSTITUTE              ,PA,17701-5855,Proprietary  ,0,0,0,15,,103,118
00500701,WEST VIRGINIA CAREER INSTITUTE          ,PA,15456-0000,Proprietary  ,5,8,13,74,,131,205
00531000,PITTSBURGH INST OF AERONAUTICS          ,PA,15236-0000,Private      ,14,31,45,405,,339,744
00533000,FAYETTE CNTY AREA VOC TECH PRC NRSG     ,PA,15401-0000,Public       ,5,8,13,54,,127,181
00533500,CENTRAL PENN INST OF SCI & TECH PNP     ,PA,16823-0000,Public       ,6,19,25,169,,285,454
00536500,YORK CO AREA VOC-TECH SCH-PRAC NSG      ,PA,17402-0000,Public       ,6,31,37,75,,413,488
00653400,CITIZENS SCHOOL OF NURSING              ,PA,15068-6591,Private      ,0,3,3,110,,194,304
00653700,CONEMAUGH VLY MEM HOSP SCH NRSNG        ,PA,15905-4398,Private      ,2,1,3,123,,139,262
00653702,CONEMAUGH HOSP- SCH HISTOTECHNOLOGY     ,PA,15905-0000,Private      ,0,0,0,6,,9,15
00653704,CONEMAUGH VLY MEM HOSP SCH RAD TECH     ,PA,15905-0000,Private      ,0,0,0,35,,30,65
00653706,CONEMAUGH VLY MEM HOSP SCH  MED TECH    ,PA,15905-4398,Private      ,0,0,0,14,,17,31
00655100,ST MARGARET SCHL OF NURSING             ,PA,15238-3205,Private      ,1,7,8,112,,260,372
00656000,OHIO VALLEY HOSP SCH OF NURSING         ,PA,15136-1694,Private      ,0,2,2,31,,69,100
00656500,READING HOSPITAL SCHOOL OF HEALTH SCIENC,PA,19611-1744,Private      ,5,8,13,285,,533,818
00657400,"ST LUKE'S HOSPITAL OF BETHLEHEM, PA     ",PA,18015-1065,Private      ,4,13,17,103,,288,391
00657600,SEWICKLEY VALLEY HOSP SCH NRSNG         ,PA,15143-1498,Private      ,0,0,0,25,,59,84
00657700,UPMC SHADYSIDE SCHOOL OF NURSING        ,PA,15232-1381,Private      ,0,19,19,241,,537,778
00657800,SHARON REGIONAL SCHOOL OF NURSING       ,PA,16146-3395,Private      ,0,1,1,27,,64,91
00658200,WASHINGTON HOSP SCH OF NURSING          ,PA,15301-3398,Private      ,1,2,3,49,,123,172
00658202,WASHINGTON HOSP SCH OF RAD TECH         ,PA,15301-3398,Private      ,0,2,2,18,,27,45
00658300,WESTERN PENN HOSP-SCH OF NURSING        ,PA,15224-1790,Private      ,1,7,8,145,,249,394
00680700,COMMUNITY COLLEGE OF BEAVER COUNTY      ,PA,15061-2588,Public       ,17,67,84,1399,,1614,3013
00681000,LEHIGH CARBON COMMUNITY COLLEGE         ,PA,18078-2598,Public       ,59,131,190,3607,,4528,8135
00681100,LUZERNE COUNTY COMMUNITY COLLEGE        ,PA,18634-3899,Public       ,73,151,224,3481,,4191,7672
00708700,ABINGTON MEM HOSP SCHL OF NURSING       ,PA,19090-1284,Private      ,0,8,8,127,,407,534
00709100,EVEREST INSTITUTE                       ,PA,15222-1320,Proprietary  ,37,112,149,295,,1065,1360
00711000,DELAWARE COUNTY COMMUNITY COLLEGE       ,PA,19063-1094,Public       ,130,352,482,7156,,9918,17074
00719100,NORTHAMPTON COMMUNITY COLLEGE           ,PA,18020-7599,Public       ,108,272,380,7029,,7198,14227
00730305,LINCOLN TECHNICAL INSTITUTE - PHILADELPH,PA,19136-1530,Proprietary  ,33,42,75,376,,516,892
00732955,ITT TECHNICAL INSTITUTE                 ,PA,19406-1212,Proprietary  ,20,83,103,296,,763,1059
00743000,ANTONELLI INST OF ART & PHOTOGRAPHY     ,PA,19038-8242,Proprietary  ,2,1,3,243,,68,311
00743600,KAPLAN CAREER INSTITUTE - ICM CAMPUS    ,PA,15222-1977,Proprietary  ,19,107,126,278,,1099,1377
00743700,PITTSBURGH TECHNICAL INSTITUTE          ,PA,15071-3205,Proprietary  ,41,88,129,2326,,1274,3600
00746900,"HUSSIAN SCHOOL OF ART, INC.             ",PA,19106-0000,Proprietary  ,0,0,0,117,,39,156
00747000,"ART INSTITUTE OF PITTSBURGH, THE        ",PA,15219-1328,Proprietary  ,455,2561,3016,5083,,19373,24456
00752900,"CHESTER COUNTY INTERMEDIATE UNIT, PNP   ",PA,19335-3043,Public       ,1,0,1,46,,182,228
00757307,EMPIRE BEAUTY SCHOOL - WARMINSTER       ,PA,18974-4508,Proprietary  ,0,0,0,127,,295,422
00777900,LANSDALE SCHOOL OF BUSINESS             ,PA,19454-4114,Proprietary  ,5,39,44,117,,464,581
00778000,NEW CASTLE SCHOOL OF TRADES             ,PA,16143-0000,Proprietary  ,54,103,157,465,,923,1388
00778100,CHI INSTITUTE/RETS CAMPUS               ,PA,19008-3516,Proprietary  ,20,62,82,165,,585,750
00783900,TRIANGLE TECH                           ,PA,15214-3897,Proprietary  ,37,45,82,281,,444,725
00791200,THADDEUS STEVENS CLG OF TECHNOLOGY      ,PA,17602-0000,Public       ,12,17,29,1405,,645,2050
00791600,FRANKLIN CNTY CAREER & TECH CTR-PNP     ,PA,17201-0000,Public       ,0,7,7,34,,145,179
00793807,LINCOLN TECHNICAL INSITUTE - ALLENTOWN  ,PA,18104-3212,Proprietary  ,34,96,130,359,,864,1223
00817803,EMPIRE BEAUTY SCHOOL - HARRISBURG       ,PA,17109-2210,Proprietary  ,0,0,0,86,,193,279
00817804,EMPIRE BEAUTY SCHOOL - WILLIAMSPORT     ,PA,17701-3914,Proprietary  ,0,0,0,78,,140,218
00817806,EMPIRE BEAUTY SCHOOL - LEBANON          ,PA,17042-5209,Proprietary  ,0,0,0,27,,38,65
00817809,EMPIRE BEAUTY SCHOOL - CENTER CITY PHILA,PA,19102-2701,Proprietary  ,0,0,0,190,,429,619
00820000,JAMESON MEMORIAL HOSP SCH NURSING       ,PA,16105-2595,Private      ,0,1,1,45,,104,149
00835000,ART INSTITUTE OF PHILADELPHIA           ,PA,19103-5198,Proprietary  ,108,181,289,3362,,3104,6466
00844100,ANTHEM INSTITUTE                        ,PA,19064-1243,Proprietary  ,26,85,111,134,,486,620
00856800,VET TECH INSTITUTE                      ,PA,15222-3400,Proprietary  ,2,5,7,419,,225,644
00865300,JEFFERSON CO DUBOIS VOC TECH-PR NSG     ,PA,15851-0000,Public       ,0,1,1,22,,49,71
00895500,PRUONTOS HAIR DESIGN INSTITUTE          ,PA,16602-0000,Proprietary  ,5,10,15,35,,42,77
00915705,WYOMING TECHNICAL INSTITUTE - BLAIRSVILL,PA,15717-8060,Proprietary  ,98,92,190,1321,,1139,2460
00918600,DEAN INSTITUTE OF TECHNOLOGY            ,PA,15226-1197,Proprietary  ,6,37,43,63,,222,285
00944900,PENNCO TECH                             ,PA,19007-0000,Proprietary  ,45,104,149,330,,720,1050
00966400,EMPIRE BEAUTY SCHOOL                    ,PA,18052-5730,Proprietary  ,74,208,282,406,,985,1391
00966405,EMPIRE BEAUTY SCHOOL - MONROEVILLE      ,PA,15146-2229,Proprietary  ,0,0,0,116,,213,329
00966408,EMPIRE BEAUTY SCHOOL - LANCASTER        ,PA,17604-4335,Proprietary  ,0,0,0,131,,242,373
00966411,EMPIRE BEAUTY SCHOOL - SHAMOKIN DAM     ,PA,17876-0397,Proprietary  ,0,0,0,27,,33,60
00966412,EMPIRE BEAUTY SCHOOL - EXTON            ,PA,19341-2804,Proprietary  ,0,0,0,150,,237,387
00966600,EMPIRE BEAUTY SCHOOL                    ,PA,19605-2803,Proprietary  ,0,0,0,114,,227,341
00972100,BRADFORD SCHOOL                         ,PA,15219-2602,Proprietary  ,0,7,7,604,,221,825
00972300,ARIA HEALTH SCHOOL OF NURSING           ,PA,19053-6939,Private      ,0,2,2,160,,390,550
00978300,GORDON PHILLIPS SCH OF BEAUTY CULT      ,PA,19135-0000,Proprietary  ,0,0,0,166,,302,468
00986300,LANCASTER GENERAL COLLEGE OF NURSING AND,PA,17602-4955,Private      ,7,26,33,716,,1287,2003
01000600,GREATER JOHNSTOWN AREA VOC TECH SCH     ,PA,15904-0000,Public       ,4,27,31,100,,305,405
01005500,CRAWFORD CNTY AREA VO-TECH PRAC NUR     ,PA,16335-0000,Public       ,0,1,1,18,,42,60
01017600,WESTMORELAND COUNTY COMMUNITY CLG       ,PA,15697-1895,Public       ,76,228,304,3209,,3903,7112
01038800,READING AREA COMMUNITY COLLEGE          ,PA,19603-1706,Public       ,116,290,406,2502,,4661,7163
01054200,EMPIRE BEAUTY SCHOOL                    ,PA,18701-0000,Proprietary  ,82,228,310,391,,852,1243
01054205,EMPIRE BEAUTY SCHOOL - YORK             ,PA,17402-2862,Proprietary  ,0,0,0,126,,243,369
01081400,PITTSBURGH INST MORTUARY SCIENCE        ,PA,15206-3706,Private      ,1,18,19,128,,340,468
01086000,GREATER ALTOONA CAREER/TECH CENTER      ,PA,16602-0000,Public       ,2,9,11,134,,283,417
01096300,GREENE COUNTY VOC-TECH SCHOOL           ,PA,15370-0000,Public       ,1,1,2,15,,40,55
01099800,PENNSYLVANIA INSTITUTE OF TECH          ,PA,19063-4098,Private      ,24,76,100,497,,973,1470
01162100,AUTOMOTIVE TRAINING CENTER              ,PA,19341-1310,Proprietary  ,116,43,159,1049,,503,1552
01162200,WELDER TRAINING & TESTING INST          ,PA,18109-3253,Proprietary  ,4,18,22,49,,142,191
01171500,SCHUYLKILL HEALTH SCHOOL OF NURSING     ,PA,17901-3692,Private      ,1,0,1,70,,69,139
01191900,BEAVER FALLS BEAUTY ACADEMY             ,PA,15010-4208,Proprietary  ,6,11,17,24,,62,86
01205000,ROSEDALE TECHNICAL INSTITUTE            ,PA,15205-9791,Private      ,24,49,73,354,,410,764
01239300,THOMAS JEFF UNIV-CLG ALLIED HEALTH      ,PA,19107-0000,Private      ,7,29,36,361,,1565,1926
01239301,THOMAS JEFFERSON UNIVERSITY - JEFFERSON ,PA,19107-5001,Private      ,8,39,47,456,,2807,3263
01239303,THOMAS JEFFERSON UNIVERSITY - COLLEGE OF,PA,19107-6731,Private      ,6,27,33,255,,1065,1320
01246104,LINCOLN TECHNICAL INSTITUTE             ,PA,19104-0202,Proprietary  ,29,89,118,395,,853,1248
01246105,LINCOLN TECHNICAL INSTITUTE             ,PA,19116-4202,Proprietary  ,17,53,70,290,,637,927
01252300,TALMUDICAL YESHIVA OF PHILA             ,PA,19131-1296,Private      ,9,0,9,45,,6,51
01260500,EMPIRE BEAUTY SCHOOL                    ,PA,17331-2405,Proprietary  ,0,0,0,66,,182,248
01260600,EMPIRE BEAUTY SCHOOL                    ,PA,17901-3859,Proprietary  ,76,169,245,339,,917,1256
01260607,EMPIRE BEAUTY SCHOOL - STATE COLLEGE    ,PA,16801-5218,Proprietary  ,0,0,0,41,,40,81
01292900,SOUTH HILLS BEAUTY ACADEMY              ,PA,15216-2335,Proprietary  ,3,31,34,73,,171,244
01313400,YESHIVATH BETH MOSHE                    ,PA,18505-2196,Private      ,3,1,4,33,,12,45
01321400,ROXBOROUGH MEM HOSP SCH OF NURSING      ,PA,19128-0000,Proprietary  ,2,13,15,105,,382,487
01326300,SOUTH HILLS SCHOOL OF BUSINESS & TECHNOL,PA,16801-4516,Proprietary  ,3,8,11,571,,517,1088
02061000,VENUS BEAUTY ACADEMY                    ,PA,19079-0000,Proprietary  ,8,10,18,73,,96,169
02068300,DOUGLAS SCHOOL OF BUSINESS              ,PA,15062-0000,Proprietary  ,16,23,39,286,,258,544
02090200,TRIANGLE TECH                           ,PA,16502-0000,Proprietary  ,8,11,19,123,,121,244
02092500,LAUREL TECHNICAL INSTITUTE              ,PA,16146-0000,Proprietary  ,13,36,49,184,,356,540
02092502,BUSINESS INSTITUTE OF PENNSYLVANIA      ,PA,16335-0000,Proprietary  ,0,0,0,11,,32,43
02104003,HARRIS SCHOOL OF BUSINESS - UPPER DARBY ,PA,19082-2528,Proprietary  ,1,2,3,35,,53,88
02107300,PENNSYLVANIA ACADEMY OF FINE ARTS       ,PA,19102-1424,Private      ,6,6,12,318,,345,663
02112200,GREAT LAKES INSTITUTE OF TECHNOLOGY     ,PA,16509-0000,Proprietary  ,26,55,81,428,,573,1001
02114200,JOHNSON COLLEGE                         ,PA,18508-0000,Private      ,0,9,9,522,,348,870
02116001,SANFORD-BROWN INSTITUTE - TREVOSE       ,PA,19053-4700,Proprietary  ,0,2,2,60,,139,199
02118000,LEVITTOWN BEAUTY ACADEMY LLC            ,PA,19054-1713,Proprietary  ,4,4,8,39,,51,90
02119300,PA ACAD OF COSMETOLOGY ARTS & SCI       ,PA,15904-0000,Proprietary  ,3,7,10,65,,91,156
02120800,"YORKTOWNE BUSINESS INSTITUTE, INC.      ",PA,17404-0000,Proprietary  ,9,28,37,120,,340,460
02127400,YORK TECHNICAL INSTITUTE                ,PA,17402-0000,Proprietary  ,59,166,225,1273,,1925,3198
02129000,TRIANGLE TECH                           ,PA,15601-0000,Proprietary  ,32,40,72,306,,310,616
02129001,TRIANGLE TECH - BUSINESS CAREERS INSTITU,PA,15601-3304,Proprietary  ,0,0,0,8,,21,29
02144000,"VISION ACADEMY, THE                     ",PA,18103-0000,Proprietary  ,1,20,21,37,,123,160
02151500,CENTRAL SUSQUEHANNA LPN CENTER          ,PA,17837-8818,Public       ,1,3,4,57,,175,232
02153500,OAKBRIDGE ACADEMY OF ARTS               ,PA,15068-0000,Proprietary  ,1,0,1,71,,15,86
02158300,JUNIATA-MIFFLIN CO AREA VOC TECH        ,PA,17044-0000,Public       ,1,11,12,17,,66,83
02161400,NORTHEASTERN HOSP SCH OF NRSG           ,PA,19134-0000,Private      ,5,15,20,94,,318,412
02169600,CLEARFIELD CTY CAREER AND TECH CNTR     ,PA,16830-0000,Public       ,2,4,6,52,,135,187
02174400,TRIANGLE TECH                           ,PA,15801-0000,Proprietary  ,33,29,62,358,,236,594
02178900,ACADEMY OF HAIR DESIGN                  ,PA,18202-1465,Proprietary  ,16,57,73,145,,298,443
02183000,ORLEANS TECHNICAL INSTITUTE             ,PA,19111-0000,Private      ,21,54,75,244,,743,987
02192800,WALNUT HILL COLLEGE                     ,PA,19104-0000,Proprietary  ,20,33,53,566,,460,1026
02202300,SANFORD-BROWN INSTITUTE                 ,PA,15219-1907,Proprietary  ,1,7,8,191,,667,858
02202301,SANFORD-BROWN INSTITUTE                 ,PA,15146-2141,Proprietary  ,0,3,3,42,,130,172
02203900,ERIE INSTITUTE OF TECHNOLOGY            ,PA,16565-1002,Proprietary  ,6,32,38,221,,305,526
02206200,"VISION ACADEMY, THE                     ",PA,19002-0000,Proprietary  ,11,26,37,95,,150,245
02206300,STROUDSBURG SCHOOL OF COSMETOLOGY       ,PA,18360-0000,Proprietary  ,11,10,21,68,,66,134
02212700,LANCASTER SCHOOL OF COSMETOLOGY         ,PA,17602-0000,Proprietary  ,10,19,29,74,,190,264
02234200,ACADEMY OF MEDICAL ARTS & BUSINESS      ,PA,17112-0000,Proprietary  ,19,54,73,270,,513,783
02251200,SCHUYLKILL COUNTY AREA VOC TECH SCH     ,PA,17931-0000,Public       ,4,12,16,24,,139,163
02251202,SCHUYLKILL COUNTY AREA VOC TECH SCH     ,PA,17931-0000,Public       ,0,1,1,6,,37,43
02253900,BERKS TECHNICAL INSTITUTE               ,PA,19610-1168,Proprietary  ,69,229,298,866,,1429,2295
02255200,PENNSYLVANIA SCHOOL OF BUSINESS         ,PA,18101-1604,Proprietary  ,0,2,2,83,,430,513
02269900,PENNSYLVANIA COLLEGE OF ART & DESIGN    ,PA,17603-3528,Private      ,5,3,8,445,,111,556
02270500,BUCKS COUNTY SCHOOL OF BEAUTY CULT      ,PA,19053-0000,Proprietary  ,4,3,7,50,,66,116
02273400,RECONSTRUCTIONIST RABBINICAL COLLEG     ,PA,19095-0000,Private      ,0,0,0,0,,37,37
02276600,HANOVER PUBLIC SCH DIST PRAC NURSG      ,PA,17331-0000,Public       ,0,3,3,12,,80,92
02282500,LENAPE SCHOOL OF PRACTICAL NURSING      ,PA,16226-0000,Public       ,5,21,26,53,,154,207
02289500,PACE INSTITUTE                          ,PA,19601-0000,Proprietary  ,2,3,5,46,,167,213
02289600,CONSOLIDATED SCHOOL OF BUSINESS         ,PA,17404-0000,Proprietary  ,3,22,25,57,,216,273
02289700,ACADEMY OF CREATIVE HAIR DESIGN         ,PA,18702-0000,Proprietary  ,15,53,68,113,,271,384
02289800,CHI INSTITUTE - FRANKLIN MILLS          ,PA,19154-0000,Proprietary  ,26,96,122,415,,978,1393
02290400,"ALTOONA BEAUTY SCHOOL, INC              ",PA,16602-0000,Proprietary  ,7,16,23,58,,107,165
02292700,LANSDALE SCHOOL OF COSMETOLOGY          ,PA,19446-0000,Proprietary  ,0,6,6,29,,52,81
02299300,TRINITY EPISCOPAL SCHOOL MINISTRY       ,PA,15003-0000,Private      ,0,3,3,2,,106,108
02301300,PRISM CAREER INSTITUTE                  ,PA,19082-2448,Proprietary  ,3,26,29,154,,593,747
02304400,YTI CAREER INSTITUTE - MECHANICSBURG    ,PA,17055-0000,Proprietary  ,1,4,5,109,,139,248
02306200,VENANGO COUNTY AREA VOC TECH SCHOOL     ,PA,16301-0000,Public       ,0,3,3,31,,92,123
02310800,LANCASTER COUNTY CAREER & TECH CTR      ,PA,17584-0000,Public       ,13,36,49,199,,619,818
02323000,BIBLICAL THEOLOGICAL SEMINARY           ,PA,19440-2421,Private      ,0,11,11,2,,123,125
02330300,LEBANON CO CAREER & TECHNOLOGY CTR      ,PA,17042-0000,Public       ,0,11,11,63,,276,339
02330600,PENNSYLVANIA GUNSMITH SCHOOL            ,PA,15202-0000,Proprietary  ,1,10,11,100,,129,229
02350100,WESTERN AREA CAREER & TECHNOLOGY CT     ,PA,15317-0000,Public       ,1,3,4,29,,109,138
02350200,INDIANA COUNTY TECH CTR SCH PR NSG      ,PA,15701-1465,Public       ,1,5,6,57,,143,200
02353100,NORTHERN TIER CAREER CENTER             ,PA,18848-0000,Public       ,1,3,4,31,,87,118
02362300,MERCER COUNTY AREA VOC TECH SCHOOL      ,PA,16137-0000,Public       ,0,3,3,21,,58,79
02492600,EASTERN CTR ARTS AND TECH PR NSG        ,PA,19090-0000,Public       ,3,12,15,38,,172,210
02495500,ALL-STATE CAREER SCHOOL                 ,PA,19029-0000,Proprietary  ,48,175,223,296,,1092,1388
02529800,WILKES BARRE AREA CAREER AND TECHNICAL C,PA,18705-0000,Public       ,17,25,42,107,,261,368
02536600,COMMONWEALTH TECH INSTIT @ HIRAM G      ,PA,15905-0000,Public       ,16,8,24,278,,121,399
02544300,BUTLER BEAUTY SCHOOL                    ,PA,16001-0000,Proprietary  ,7,20,27,59,,134,193
02545000,LAWRENCE COUNTY CAREER AND TECHNICAL CEN,PA,16101-0000,Public       ,1,2,3,26,,78,104
02546200,LAUREL BUSINESS INSTITUTE               ,PA,15401-0877,Proprietary  ,11,23,34,185,,212,397
02550000,CLARION CO AREA VOC-TECH PRAC NRSG      ,PA,16254-4637,Public       ,0,3,3,27,,92,119
02554500,HAZLETON AREA CAREER CENTER PRACTICAL NU,PA,18201-0000,Public       ,1,2,3,48,,102,150
02557800,ART INSTITUTE OF YORK (THE) - PENNSYLVAN,PA,17402-9012,Proprietary  ,20,14,34,683,,340,1023
02566400,ALBERT EINSTEIN MED CTR DEPT DNTL       ,PA,19141-3098,Private      ,0,10,10,36,,157,193
02574800,PENNSYLVANIA INSTITUTE OF TAXIDERMY     ,PA,15931-0000,Proprietary  ,1,8,9,17,,27,44
02609500,CAREER TRAINING ACADEMY                 ,PA,15068-6308,Proprietary  ,17,66,83,126,,367,493
02609501,CAREER TRAINING ACADEMY                 ,PA,15146-0000,Proprietary  ,0,1,1,23,,55,78
02616100,JEAN MADELINE ED CTR FOR COSM           ,PA,19147-1542,Proprietary  ,15,40,55,326,,433,759
02617507,EVEREST COLLEGE - EVEREST INSTITUTE - BE,PA,19020-2062,Proprietary  ,34,103,137,40,,121,161
03006800,LE CORDON BLEU INSTITUTE OF CULINARY ART,PA,15222-3511,Proprietary  ,0,0,0,29,,27,56
03010800,FORTIS INSTITUTE                        ,PA,16506-1013,Proprietary  ,69,191,260,830,,2355,3185
03011500,FORTIS INSTITUTE                        ,PA,18702-0000,Proprietary  ,12,45,57,109,,307,416
03011600,FORTIS INSTITUTE                        ,PA,18509-2903,Proprietary  ,16,49,65,225,,531,756
03029900,CONSOLIDATED SCHOOL OF BUSINESS         ,PA,17603-2389,Proprietary  ,5,17,22,76,,197,273
03067000,ANTONELLI MEDICAL & PROF INST           ,PA,19464-9244,Proprietary  ,4,24,28,47,,188,235
03072600,DCI CAREER INSTITUTE                    ,PA,15061-2307,Proprietary  ,8,23,31,53,,131,184
03081900,YTI CAREER INSTITUTE - ALTOONA          ,PA,16602-4457,Proprietary  ,18,38,56,277,,412,689
03090800,LAKE ERIE COLL OF OSTEOPATHIC MED       ,PA,16509-0000,Private      ,0,16,16,73,,3997,4070
03098600,CAREER TECH CTR OF LACKAWANNA CNTY      ,PA,18508-0000,Public       ,6,24,30,94,,254,348
03101400,FORBES ROAD CAREER & TECHNOLOGY CTR     ,PA,15146-1550,Public       ,0,0,0,13,,35,48
03101500,BIDWELL TRAINING CENTER                 ,PA,15233-2233,Private      ,8,26,34,40,,158,198
03103300,JNA INSTITUTE OF CULINARY ARTS          ,PA,19146-3119,Proprietary  ,6,21,27,124,,259,383
03109100,METROPOLITAN CAREER CENTER              ,PA,19144-0000,Private      ,3,17,20,45,,195,240
03110700,AVIATION INSTITUTE OF MAINTENANCE       ,PA,19114-1017,Proprietary  ,14,60,74,204,,602,806
03120400,REGIONAL CAREER & TECHNICAL CENTER      ,PA,16509-4699,Public       ,0,0,0,20,,31,51
03128400,DELAWARE COUNTY TECHNICAL SCHOOL        ,PA,19008-1928,Public       ,2,16,18,56,,240,296
03180400,PENNSYLVANIA HIGHLANDS COMMUNITY COLLEGE,PA,15904-2927,Public       ,20,57,77,1053,,985,2038
03236400,LT INTERNATIONAL BEAUTY SCHOOL          ,PA,19130-2235,Proprietary  ,5,20,25,41,,139,180
03353300,ACADEMY OF VOCAL ARTS                   ,PA,19103-6685,Private      ,1,8,9,54,,115,169
03380301,STAR CAREER ACADEMY - STAR PHILADELPHIA ,PA,19114-2204,Proprietary  ,66,177,243,513,,1494,2007
03380304,STAR CAREER ACADEMY - STAR NORRISTOWN   ,PA,19403-2422,Proprietary  ,16,44,60,74,,338,412
03493302,ALL-STATE CAREER - WEST MIFFLIN CAMPUS  ,PA,15122-0000,Proprietary  ,3,8,11,45,,192,237
03535300,HUNTINGDON COUNTY CAREER AND TECHNO     ,PA,17060-0905,Public       ,1,2,3,9,,46,55
03561400,SUSQUEHANNA COUNTY CAREER & TECHNOL     ,PA,18816-0100,Public       ,1,9,10,20,,94,114
03766300,PENNSYLVANIA SCHOOL OF MUSCLE THERAPY   ,PA,19406-3101,Proprietary  ,7,42,49,80,,241,321
03781300,PRINCETON INFORMATION TECHNOLOGY CENTER ,PA,19038-4535,Proprietary  ,2,51,53,45,,411,456
03899300,CALVARY BAPTIST THEOLOGICAL SEMINARY    ,PA,19446-4718,Private      ,0,0,0,2,,16,18
03923300,PRECISION MANUFACTURING INSTITUTE       ,PA,16335-8380,Private      ,3,30,33,23,,76,99
03948300,HARRISBURG UNIVERSITY OF SCIENCE AND TEC,PA,17101-2116,Private      ,11,19,30,856,,329,1185
03949300,WON INSTITUTE OF GRADUATE STUDIES       ,PA,19038-4535,Private      ,0,0,0,0,,69,69
03950500,NORTHWEST REGIONAL TECHNOLOGY INSTITUTE ,PA,16508-2820,Proprietary  ,0,23,23,24,,115,139
03952300,NATIONAL MASSAGE THERAPY INSTITUTE      ,PA,19116-3965,Proprietary  ,11,54,65,165,,738,903
04024300,EDUCATION AND TECHNOLOGY INSTITUTE      ,PA,15601-9214,Private      ,0,1,1,16,,49,65
04041300,BERKS CAREER & TECHNOLOGY CENTER        ,PA,19533-9112,Public       ,0,5,5,31,,67,98
04118000,BYZANTINE CATHOLIC SEMINARY OF SAINTS CY,PA,15214-2229,Private      ,0,0,0,1,,10,11
04127500,CAREER DEVELOPMENT & EMPLOYMENT         ,PA,18702-5253,Proprietary  ,0,13,13,9,,80,89
04145800,PULSE BEAUTY ACADEMY A PAUL MITCHELL PAR,PA,19335-0000,Proprietary  ,9,12,21,96,,113,209
04149800,SOMERSET COUNTY TECHNOLOGY CENTER       ,PA,15501-1444,Public       ,3,8,11,32,,131,163
04151700,BELLA CAPELLI ACADEMY                   ,PA,15146-2388,Proprietary  ,5,11,16,85,,84,169
04151701,BELLA CAPELLI ACADEMY -                 ,PA,15205-2388,Proprietary  ,7,10,17,94,,86,180
04155100,INSTITUTE OF MEDICAL CAREERS            ,PA,15235-3718,Proprietary  ,1,23,24,38,,177,215
04158000,METRO BEAUTY ACADEMY                    ,PA,18106-9693,Proprietary  ,14,20,34,123,,222,345
04164900,BARONE BEAUTY ACADEMY                   ,PA,17701-5316,Proprietary  ,2,9,11,58,,68,126
04167200,COMMONWEALTH MEDICAL COLLEGE (THE)      ,PA,18503-3251,Private      ,0,5,5,17,,713,730
04167500,WORLD A CUTS BARBER INSTITUTE           ,PA,17401-1105,Proprietary  ,3,17,20,21,,98,119
04175900,LEWISTOWN HOSPITAL SCHOOL OF NURSING    ,PA,17044-1167,Private      ,0,0,0,32,,54,86
04209700,NEWCOURTLAND EDUCATION CENTER SCHOOL OF ,PA,19119-2126,Private      ,0,0,0,12,,58,70
04215500,CHAMP'S BARBER SCHOOL                   ,PA,17603-3809,Proprietary  ,7,29,36,16,,74,90
04221300,PHILADELPHIA TECHNICIAN TRAINING        ,PA,19138-1324,Private      ,9,57,66,9,,57,66
04224600,BARBER SCHOOL OF PITTSBURGH             ,PA,15220-5537,Proprietary  ,5,24,29,20,,88,108
04226300,DIVINE CROWN ACADEMY OF COSMETOLOGY     ,PA,17104-2103,Proprietary  ,1,2,3,6,,11,17
00153410,EVEREST UNIVERSITY - EVEREST COLLEGE - M,WI,53212-4006,Proprietary  ,0,0,0,64,,224,288
00267813,BRYANT & STRATTON COLLEGE - MIL DOWNTOWN,WI,53203-2608,Proprietary  ,43,214,257,964,,3421,4385
00383200,ALVERNO COLLEGE                         ,WI,53234-3922,Private      ,16,75,91,1625,,2825,4450
00383500,BELOIT COLLEGE                          ,WI,53511-5595,Private      ,8,4,12,2108,,160,2268
00383700,CARDINAL STRITCH UNIVERSITY             ,WI,53217-9884,Private      ,19,261,280,1339,,4859,6198
00383800,CARROLL UNIVERSITY                      ,WI,53186-5593,Private      ,29,28,57,4079,,1037,5116
00383900,CARTHAGE COLLEGE                        ,WI,53141-0000,Private      ,51,44,95,5212,,1009,6221
00384000,WESTERN TECHNICAL COLLEGE               ,WI,54601-0908,Public       ,38,93,131,2360,,2747,5107
00384200,CONCORDIA UNIVERSITY WISCONSIN          ,WI,53097-2402,Private      ,34,284,318,3618,,5329,8947
00384800,EDGEWOOD COLLEGE                        ,WI,53711-1958,Private      ,17,58,75,1970,,1491,3461
00385000,SILVER LAKE COLLEGE                     ,WI,54220-9319,Private      ,3,18,21,237,,399,636
00385400,LAKELAND COLLEGE                        ,WI,53082-0000,Private      ,14,72,86,1388,,2193,3581
00385600,LAWRENCE UNIVERSITY                     ,WI,54912-0599,Private      ,15,6,21,2465,,177,2642
00386100,MARIAN UNIVERSITY                       ,WI,54935-4699,Private      ,23,44,67,1514,,1113,2627
00386300,MARQUETTE UNIVERSITY                    ,WI,53201-1881,Private      ,131,89,220,17034,,4731,21765
00386600,MILWAUKEE AREA TECH COLLEGE             ,WI,53233-1443,Public       ,226,727,953,8368,,20770,29138
00386800,MILWAUKEE SCHOOL OF ENGINEERING         ,WI,53202-3109,Private      ,18,26,44,2941,,999,3940
00386900,MOUNT MARY UNIVERSITY                   ,WI,53222-4597,Private      ,9,25,34,853,,1467,2320
00387400,NASHOTAH HOUSE                          ,WI,53058-0000,Private      ,0,1,1,1,,80,81
00387500,NORTHLAND COLLEGE                       ,WI,54806-3999,Private      ,3,3,6,885,,143,1028
00388400,RIPON COLLEGE                           ,WI,54971-0248,Private      ,13,1,14,1363,,89,1452
00389200,ST. NORBERT COLLEGE                     ,WI,54115-2099,Private      ,10,3,13,2781,,148,2929
00389500,UNIVERSITY OF WISCONSIN-MADISON         ,WI,53715-1382,Public       ,212,208,420,27906,,11340,39246
00389600,UNIVERSITY OF WISCONSIN-MILWAUKEE       ,WI,53201-3165,Public       ,221,427,648,19528,,14489,34017
00389700,UNIVERSITY OF WISCONSIN COLLEGES        ,WI,53708-8680,Public       ,46,110,156,3003,,2338,5341
00389701,UNIVERSITY OF WISCONSIN-BARABOO         ,WI,53913-1098,Public       ,7,13,20,423,,257,680
00389702,UNIVERSITY OF WISCONSIN-BARRON          ,WI,54868-2497,Public       ,9,8,17,415,,250,665
00389703,UNIVERSITY OF WISCONSIN-FOND DU LAC     ,WI,54935-2998,Public       ,18,21,39,635,,354,989
00389704,UNIVERSITY OF WISCONSIN-FOX VALLEY      ,WI,54952-1297,Public       ,21,24,45,1327,,664,1991
00389705,UNIVERSITY OF WISCONSIN-MANITOWOC       ,WI,54220-6699,Public       ,8,10,18,393,,196,589
00389706,UNIVERSITY OF WISCONSIN-MARATHON        ,WI,54401-5396,Public       ,18,23,41,1018,,488,1506
00389707,UNIVERSITY OF WISCONSIN-MARINETTE       ,WI,54143-4299,Public       ,11,7,18,329,,231,560
00389708,UNIVERSITY OF WISCONSIN-MARSHFIELD      ,WI,54449-3310,Public       ,7,12,19,391,,238,629
00389709,UNIVERSITY OF WISCONSIN-RICHLAND        ,WI,53581-1399,Public       ,1,3,4,358,,143,501
00389710,UNIVERSITY OF WISCONSIN COLLEGES - ROCK ,WI,53546-5699,Public       ,23,36,59,903,,683,1586
00389711,UNIVERSITY OF WISCONSIN-SHEBOYGAN       ,WI,53081-4789,Public       ,15,13,28,578,,379,957
00389712,UNIVERSITY OF WISCONSIN-WASHINGTON      ,WI,53095-3699,Public       ,16,17,33,754,,323,1077
00389713,UNIVERSITY OF WISCONSIN-WAUKESHA        ,WI,53188-2799,Public       ,45,38,83,1639,,753,2392
00389900,UNIVERSITY OF WISCONSIN-GREEN BAY       ,WI,54311-7001,Public       ,47,78,125,4989,,2917,7906
00391100,VITERBO UNIVERSITY                      ,WI,54601-4777,Private      ,13,57,70,1944,,1393,3337
00391500,UNIVERSITY OF WISCONSIN-STOUT           ,WI,54751-0790,Public       ,47,86,133,6579,,2439,9018
00391700,UNIVERSITY OF WISCONSIN-EAU CLAIRE      ,WI,54702-4004,Public       ,67,65,132,9834,,2140,11974
00391900,UNIVERSITY OF WISCONSIN-LA CROSSE       ,WI,54601-3742,Public       ,56,44,100,9422,,1906,11328
00392000,UNIVERSITY OF WISCONSIN-OSHKOSH         ,WI,54901-8604,Public       ,75,125,200,9681,,3933,13614
00392100,UNIVERSITY OF WISCONSIN-PLATTEVILLE     ,WI,53818-3099,Public       ,47,71,118,7591,,1987,9578
00392300,UNIVERSITY OF WISCONSIN-RIVER FALLS     ,WI,54022-5013,Public       ,40,62,102,5229,,1550,6779
00392400,UNIVERSITY OF WISCONSIN-STEVENS POINT   ,WI,54481-3871,Public       ,64,51,115,8610,,2298,10908
00392500,UNIVERSITY OF WISCONSIN-SUPERIOR        ,WI,54880-2898,Public       ,24,59,83,1799,,1594,3393
00392600,UNIVERSITY OF WISCONSIN-WHITEWATER      ,WI,53190-1792,Public       ,97,95,192,10801,,2966,13767
00400700,MADISON AREA TECHNICAL COLLEGE          ,WI,53704-2599,Public       ,122,272,394,5739,,9418,15157
00501500,UNIVERSITY OF WISCONSIN-PARKSIDE        ,WI,53141-2000,Public       ,54,98,152,4111,,2736,6847
00529400,WAUKESHA COUNTY TECHNICAL COLLEGE       ,WI,53072-4696,Public       ,29,135,164,1811,,3970,5781
00530100,NORTHEAST WISCONSIN TECHNICAL COLLEGE   ,WI,54307-9042,Public       ,98,311,409,3312,,6142,9454
00530400,CHIPPEWA VALLEY TECHNICAL COLLEGE       ,WI,54701-6162,Public       ,28,62,90,2596,,3793,6389
00538000,MID-STATE TECHNICAL COLLEGE             ,WI,54494-5512,Public       ,28,84,112,1029,,2080,3109
00538400,NICOLET AREA TECHNICAL COLLEGE          ,WI,54501-0000,Public       ,17,50,67,612,,1056,1668
00538700,NORTHCENTRAL TECHNICAL COLLEGE          ,WI,54401-1899,Public       ,50,170,220,1558,,3512,5070
00538900,GATEWAY TECHNICAL COLLEGE               ,WI,53144-1690,Public       ,63,214,277,2907,,8531,11438
00539000,BLACKHAWK TECHNICAL COLLEGE             ,WI,53547-5009,Public       ,26,112,138,1112,,3157,4269
00663900,BELLIN COLLEGE                          ,WI,54305-0000,Private      ,6,9,15,350,,249,599
00732934,ITT TECHNICAL INSTITUTE                 ,WI,53220-4612,Proprietary  ,48,285,333,442,,2258,2700
00766900,SOUTHWEST WISCONSIN TECH COLLEGE        ,WI,53809-0000,Public       ,5,20,25,818,,897,1715
00778103,CHI INSTITUTE/RETS CAMPUS - KAPLAN COLLE,WI,53212-3939,Proprietary  ,0,0,0,107,,538,645
00821700,PAUL MITCHELL THE SCHOOL GREEN BAY      ,WI,54324-0257,Proprietary  ,9,9,18,124,,154,278
00869405,RASMUSSEN COLLEGE - WAUSAU              ,WI,54401-7804,Proprietary  ,6,72,78,140,,935,1075
00869414,RASMUSSEN COLLEGE - GREEN BAY           ,WI,54303-2349,Proprietary  ,10,61,71,175,,997,1172
00869419,RASMUSSEN COLLEGE - APPLETON            ,WI,54915-7305,Proprietary  ,9,65,74,121,,728,849
00919400,LAKESHORE TECHNICAL COLLEGE             ,WI,53015-1412,Public       ,11,42,53,833,,1867,2700
00925600,MORAINE PARK TECHNICAL COLLEGE          ,WI,54936-0000,Public       ,19,69,88,1214,,2881,4095
00941900,STATE CLG OF BEAUTY CULT-WAUSAU         ,WI,54403-4667,Proprietary  ,2,7,9,49,,84,133
00962100,HERZING UNIVERSITY                      ,WI,53718-4236,Proprietary  ,77,927,1004,1267,,11399,12666
00974400,FOX VALLEY TECHNICAL COLLEGE            ,WI,54913-0000,Public       ,62,273,335,3636,,6438,10074
01091300,MADISON MEDIA INSTITUTE                 ,WI,53718-6787,Proprietary  ,31,38,69,690,,656,1346
01148400,ADVANCED INSTITUTE OF HAIR DESIGN       ,WI,53225-0000,Proprietary  ,21,20,41,315,,349,664
01182400,WISCONSIN INDIANHEAD TECH CLG WITC      ,WI,54871-9300,Public       ,18,69,87,1162,,2581,3743
01260610,EMPIRE BEAUTY SCHOOL - MADISON          ,WI,53717-1111,Proprietary  ,0,0,0,73,,155,228
01260611,EMPIRE BEAUTY SCHOOL - GREEN BAY        ,WI,54304-4838,Proprietary  ,0,0,0,77,,177,254
02077100,MILWAUKEE INST OF ART & DESIGN          ,WI,53202-0000,Private      ,10,19,29,1162,,452,1614
02078000,SACRED HEART SCHOOL OF THEOLOGY         ,WI,53130-0000,Private      ,0,0,0,1,,4,5
02136600,WISCONSIN LUTHERAN COLLEGE              ,WI,53226-0000,Private      ,5,16,21,1361,,425,1786
02173208,EMPIRE BEAUTY SCHOOL - MANITOWOC        ,WI,54220-5040,Proprietary  ,0,0,0,79,,199,278
02173209,EMPIRE BEAUTY SCHOOL - APPLETON         ,WI,54914-4644,Proprietary  ,0,0,0,23,,38,61
02239204,ANTHEM COLLEGE - BROOKFIELD             ,WI,53005-4207,Proprietary  ,11,44,55,93,,399,492
02271300,WI SCH OF PROFESSIONAL PSYCHOLOGY       ,WI,53225-0000,Private      ,1,6,7,33,,200,233
02317200,MARANATHA BAPTIST BIBLE COLLEGE         ,WI,53094-0000,Private      ,10,13,23,898,,219,1117
02453500,MEDICAL COLLEGE OF WISCONSIN            ,WI,53226-0000,Private      ,4,15,19,127,,1309,1436
02494300,GILL-TECH ACADEMY OF HAIR DESIGN        ,WI,54911-0000,Proprietary  ,9,10,19,61,,88,149
02532200,LAC COURTE OREILLES OJIBWA CMTY CLG     ,WI,54843-0000,Public       ,4,69,73,72,,492,564
03061200,MIDWEST COLLEGE OF ORIENTAL MEDICINE    ,WI,53403-9747,Proprietary  ,1,14,15,29,,293,322
03125100,COLLEGE OF MENOMINEE NATION             ,WI,54135-0000,Private      ,3,34,37,123,,547,670
03125102,COLLEGE OF  THE MENOMINEE NATION - GREEN,WI,54304-4964,Private      ,2,18,20,65,,295,360
03220300,"SALON PROFESSIONAL ACADEMY, THE         ",WI,54701-7633,Proprietary  ,1,12,13,76,,111,187
03309300,MONTESSORI INSTITUTE OF MILWAUKEE       ,WI,53207-0000,Private      ,0,3,3,7,,52,59
03808300,INSTITUTE OF BEAUTY AND WELLNESS (THE)  ,WI,53202-5715,Proprietary  ,12,30,42,176,,309,485
03822300,PAUL MITCHELL THE SCHOOL - MONROE       ,WI,53566-0000,Proprietary  ,5,1,6,40,,46,86
03872500,NORTHLAND INTERNATIONAL UNIVERSITY      ,WI,54119-9285,Private      ,2,3,5,354,,72,426
03925300,BLUE SKY SCHOOL OF PROFESSIONAL MASSAGE ,WI,53024-9699,Private      ,2,8,10,13,,71,84
03925301,BLUE SKY SCHOOL OF PROFESSIONAL MASSAGE ,WI,54115-7407,Private      ,1,5,6,12,,58,70
03925303,BLUE SKY SCHOOL OF PROFESSIONAL MASSAGE ,WI,53713-2366,Private      ,1,7,8,17,,65,82
04117400,MILWAUKEE CAREER COLLEGE                ,WI,53222-4305,Proprietary  ,17,54,71,297,,738,1035
04118600,ACADEMY OF COSMETOLOGY                  ,WI,53548-3307,Proprietary  ,0,12,12,44,,139,183
04124800,VISIONS IN HAIR DESIGN INSTITUTE OF COSM,WI,53210-1120,Proprietary  ,3,5,8,47,,107,154
04132600,WISCONSIN ACADEMY (THE)                 ,WI,54157-1726,Proprietary  ,0,3,3,18,,35,53
04137900,BRENSTEN EDUCATION                      ,WI,53186-0000,Proprietary  ,12,134,146,48,,561,609
04138200,SALON PROFESSIONAL ACADEMY (THE)        ,WI,54914-3921,Proprietary  ,3,9,12,71,,82,153
04157700,SALON PROFESSIONAL ACADEMY (THE)        ,WI,54650-8699,Proprietary  ,4,11,15,71,,105,176
04159400,COLUMBIA COLLEGE OF NURSING             ,WI,53211-2952,Private      ,9,5,14,176,,352,528
04165300,ACADEMY WAUKESHA (THE)                  ,WI,53072-5524,Proprietary  ,6,14,20,102,,148,250
04179200,ADVANCED COLLEGE OF COSMETOLOGY         ,WI,53963-0000,Proprietary  ,0,2,2,42,,36,78
04182100,FIRST CLASS COSMETOLOGY SCHOOL          ,WI,52511-0000,Proprietary  ,2,10,12,48,,100,148
04183600,SALON PROFESSIONAL ACADEMY OF KENOSHA (T,WI,53142-4950,Proprietary  ,12,14,26,99,,200,299
04193800,SHEPHERDS COLLEGE                       ,WI,53182-1527,Private      ,0,0,0,27,,19,46
04202800,PANACHE ACADEMY OF BEAUTY               ,WI,53913-2596,Proprietary  ,0,8,8,30,,69,99
04219300,EAST-WEST HEALING ARTS INSTITUTE        ,WI,53719-1133,Proprietary  ,0,3,3,2,,7,9
00290500,NORTH CAROLINA A&T STATE UNIV           ,NC,27411-0001,Public       ,182,195,377,16784,,8262,25046
00290600,APPALACHIAN STATE UNIVERSITY            ,NC,28608-2059,Public       ,176,127,303,18799,,5416,24215
00290700,UNIVERSITY OF NC AT ASHEVILLE           ,NC,28804-3299,Public       ,56,44,100,4885,,2326,7211
00290800,BARTON COLLEGE                          ,NC,27893-3104,Private      ,16,26,42,1746,,952,2698
00291000,BELMONT ABBEY COLLEGE                   ,NC,28012-1802,Private      ,19,29,48,1537,,1371,2908
00291100,BENNETT COLLEGE                         ,NC,27401-3239,Private      ,17,11,28,1370,,659,2029
00291200,BREVARD COLLEGE                         ,NC,28712-3306,Private      ,15,3,18,1352,,262,1614
00291300,CAMPBELL UNIVERSITY                     ,NC,27506-0036,Private      ,57,160,217,6164,,4561,10725
00291400,CATAWBA COLLEGE                         ,NC,28144-2488,Private      ,22,24,46,2046,,792,2838
00291500,CENTRAL PIEDMONT COMMUNITY COLLEGE      ,NC,28204-2297,Public       ,297,1015,1312,12112,,23258,35370
00291600,CHOWAN UNIVERSITY                       ,NC,27855-1850,Private      ,28,13,41,2230,,489,2719
00291700,COLLEGE OF THE ALBEMARLE                ,NC,27909-2327,Public       ,36,92,128,1163,,2061,3224
00291800,DAVIDSON COLLEGE                        ,NC,28035-7157,Private      ,23,13,36,3471,,311,3782
00291900,DAVIDSON COUNTY COMMUNITY COLLEGE       ,NC,27293-0000,Public       ,47,188,235,2152,,5448,7600
00292000,DUKE UNIVERSITY                         ,NC,27708-0397,Private      ,167,63,230,19911,,2471,22382
00292001,DUKE UNIV - SCHOOL OF MEDICINE          ,NC,27710-0000,Private      ,2,6,8,268,,1163,1431
00292002,DUKE UNIV - SCHOOL OF LAW               ,NC,27708-0000,Private      ,1,12,13,101,,2132,2233
00292003,DUKE UNIV - GRAD SCH ARTS & SCIENCE     ,NC,27708-0000,Private      ,8,16,24,172,,871,1043
00292004,DUKE UNIV - FUQUA SCH OF BUSINESS       ,NC,27708-0000,Private      ,5,20,25,120,,1196,1316
00292005,DUKE UNIV/NICHOLAS SCH OF ENVIRON.      ,NC,27708-0000,Private      ,1,4,5,51,,401,452
00292006,DUKE UNIV - DIVINITY SCHOOL             ,NC,27708-0000,Private      ,6,15,21,381,,849,1230
00292007,DUKE UNIV - SCHOOL OF NURSING           ,NC,27710-0000,Private      ,4,25,29,274,,1546,1820
00292010,DUKE UNIVERSITY - SCHOOL OF PUBLIC POLIC,NC,27708-0239,Private      ,2,2,4,62,,277,339
00292300,EAST CAROLINA UNIVERSITY                ,NC,27858-1818,Public       ,206,370,576,25130,,13988,39118
00292600,ELIZABETH CITY STATE UNIVERSITY         ,NC,27909-7806,Public       ,33,40,73,3773,,1749,5522
00292700,ELON UNIVERSITY                         ,NC,27244-2010,Private      ,70,28,98,8067,,1459,9526
00292800,FAYETTEVILLE STATE UNIVERSITY           ,NC,28301-4298,Public       ,92,294,386,5836,,8973,14809
00292900,GARDNER-WEBB UNIVERSITY                 ,NC,28017-0000,Private      ,48,141,189,3425,,4260,7685
00293000,GREENSBORO COLLEGE                      ,NC,27401-1875,Private      ,25,39,64,2125,,1592,3717
00293100,GUILFORD COLLEGE                        ,NC,27410-4171,Private      ,28,88,116,3342,,3599,6941
00293300,HIGH POINT UNIVERSITY                   ,NC,27262-4221,Private      ,57,35,92,5716,,1038,6754
00293400,ISOTHERMAL COMMUNITY COLLEGE            ,NC,28160-0804,Public       ,23,67,90,1046,,1876,2922
00293500,LAUREL UNIVERSITY                       ,NC,27265-3197,Private      ,0,10,10,65,,362,427
00293600,JOHNSON C SMITH UNIVERSITY              ,NC,28216-5398,Private      ,48,87,135,3357,,2232,5589
00293700,KING'S COLLEGE-CHARLOTTE                ,NC,28204-2435,Proprietary  ,26,59,85,1020,,1112,2132
00293900,LEES MCRAE COLLEGE                      ,NC,28604-0000,Private      ,14,6,20,1351,,434,1785
00294000,LENOIR COMMUNITY COLLEGE                ,NC,28502-0188,Public       ,32,135,167,1221,,3000,4221
00294100,LENOIR-RHYNE UNIVERSITY                 ,NC,28603-0000,Private      ,28,41,69,3237,,1317,4554
00294200,LIVINGSTONE COLLEGE                     ,NC,28144-5298,Private      ,21,21,42,1719,,666,2385
00294300,LOUISBURG COLLEGE                       ,NC,27549-2398,Private      ,22,10,32,1425,,312,1737
00294400,MARS HILL COLLEGE                       ,NC,28754-0000,Private      ,31,19,50,2386,,577,2963
00294500,MEREDITH COLLEGE                        ,NC,27607-5298,Private      ,22,39,61,2234,,1263,3497
00294600,METHODIST UNIVERSITY                    ,NC,28311-1420,Private      ,47,105,152,3011,,2574,5585
00294700,MITCHELL COMMUNITY COLLEGE              ,NC,28677-5264,Public       ,26,98,124,1496,,2777,4273
00294800,MONTREAT COLLEGE                        ,NC,28757-1267,Private      ,5,27,32,579,,811,1390
00294900,UNIVERSITY OF MOUNT OLIVE               ,NC,28365-1299,Private      ,22,234,256,1543,,4560,6103
00295000,NORTH CAROLINA CENTRAL UNIVERSITY       ,NC,27707-3198,Public       ,134,181,315,10039,,8312,18351
00295100,NORTH CAROLINA WESLEYAN COLLEGE         ,NC,27804-8699,Private      ,24,92,116,1242,,1813,3055
00295300,PEACE COLLEGE                           ,NC,27604-1194,Private      ,16,31,47,1497,,1004,2501
00295400,UNIV OF NORTH CAROLINA AT PEMBROKE      ,NC,28372-1510,Public       ,88,127,215,7047,,4847,11894
00295500,PFEIFFER UNIVERSITY                     ,NC,28109-0000,Private      ,10,59,69,1212,,1569,2781
00295600,PIEDMONT INTERNATIONAL UNIVERSITY       ,NC,27101-5025,Private      ,4,7,11,193,,250,443
00295700,QUEENS UNIVERSITY OF CHARLOTTE          ,NC,28274-0001,Private      ,39,138,177,2619,,2858,5477
00295800,ROCKINGHAM COMMUNITY COLLEGE            ,NC,27375-0000,Public       ,21,73,94,1063,,1818,2881
00296000,SALEM COLLEGE                           ,NC,27108-0000,Private      ,13,35,48,1050,,1107,2157
00296100,SANDHILLS COMMUNITY COLLEGE             ,NC,28374-8283,Public       ,49,156,205,1944,,3897,5841
00296200,SHAW UNIVERSITY                         ,NC,27601-2393,Private      ,54,76,130,3578,,2652,6230
00296300,SOUTHEASTERN BAPTIST THEOL SEMINARY     ,NC,27588-0000,Private      ,2,15,17,52,,121,173
00296400,SOUTHEASTERN COMMUNITY COLLEGE          ,NC,28472-5422,Public       ,33,75,108,779,,1597,2376
00296800,ST AUGUSTINES COLLEGE                   ,NC,27610-2298,Private      ,22,29,51,2587,,1202,3789
00297000,SURRY COMMUNITY COLLEGE                 ,NC,27017-0304,Public       ,21,79,100,1457,,2183,3640
00297200,NORTH CAROLINA STATE UNIV-RALEIGH       ,NC,27695-7001,Public       ,243,305,548,30069,,12899,42968
00297300,GASTON COLLEGE                          ,NC,28034-1499,Public       ,50,200,250,2586,,5668,8254
00297400,UNIVERSITY OF N C-CHAPEL HILL           ,NC,27514-0000,Public       ,244,330,574,28600,,14359,42959
00297500,UNIVERSITY OF NC AT CHARLOTTE           ,NC,28223-0001,Public       ,263,458,721,27330,,16104,43434
00297600,UNIVERSITY OF N C - GREENSBORO          ,NC,27412-0001,Public       ,154,250,404,18745,,12268,31013
00297800,WAKE FOREST UNIV - UNDERGRADUATE        ,NC,27109-7246,Private      ,78,18,96,7935,,593,8528
00297801,WAKE FOREST UNIV - SCH OF MEDICINE      ,NC,27157-1090,Private      ,2,12,14,174,,1189,1363
00297803,WAKE FOREST GRAD SCHOOLS OF BUSINESS    ,NC,27109-7659,Private      ,2,26,28,68,,927,995
00297805,WAKE FOREST UNIV - SCH OF LAW           ,NC,27109-7206,Private      ,0,7,7,55,,1384,1439
00297806,WAKE FOREST UNIV - GRAD A&S/DIVINITY    ,NC,27109-7246,Private      ,0,23,23,49,,804,853
00297900,WARREN WILSON COLLEGE                   ,NC,28815-0000,Private      ,10,20,30,1401,,543,1944
00298000,WAYNE COMMUNITY COLLEGE                 ,NC,27533-0000,Public       ,40,173,213,1701,,3992,5693
00298100,WESTERN CAROLINA UNIVERSITY             ,NC,28723-9731,Public       ,185,97,282,10906,,4722,15628
00298200,WESTERN PIEDMONT COMMUNITY COLLEGE      ,NC,28655-4504,Public       ,22,61,83,1236,,2180,3416
00298300,WILKES COMMUNITY COLLEGE                ,NC,28697-2100,Public       ,28,68,96,1351,,1842,3193
00298400,UNIVERSITY OF N C-WILMINGTON            ,NC,28403-3297,Public       ,138,222,360,16804,,6794,23598
00298500,WINGATE UNIVERSITY                      ,NC,28174-0159,Private      ,55,26,81,4504,,1443,5947
00298600,WINSTON-SALEM STATE UNIVERSITY          ,NC,27102-0000,Public       ,89,168,257,7938,,6264,14202
00398100,UNC SCHOOL OF THE ARTS                  ,NC,27127-2188,Public       ,19,10,29,1549,,578,2127
00403300,ASHEVILLE BUNCOMBE TECH CMTY CLG        ,NC,28801-4897,Public       ,84,267,351,3088,,7013,10101
00406200,PITT COMMUNITY COLLEGE                  ,NC,28590-0000,Public       ,80,292,372,5201,,8786,13987
00483500,CALDWELL COMMUNITY CLG & TECH INST      ,NC,28638-2626,Public       ,33,91,124,1799,,3043,4842
00483800,GUILFORD TECHNICAL COMMUNITY CLG        ,NC,27282-0309,Public       ,89,358,447,7527,,16625,24152
00484400,WAKE TECHNICAL COMMUNITY COLLEGE        ,NC,27603-5696,Public       ,190,650,840,10486,,19631,30117
00484500,WILSON COMMUNITY COLLEGE                ,NC,27893-3310,Public       ,17,99,116,813,,2482,3295
00499201,MILLER-MOTTE TECHNICAL COLLEGE - MILLER-,NC,27511-9209,Proprietary  ,15,73,88,173,,847,1020
00499202,MILLER-MOTTE TECHNICAL COLLEGE - MILLER-,NC,27604-6072,Proprietary  ,29,143,172,472,,1921,2393
00499203,MILLER-MOTTE TECHNICAL COLLEGE - FAYETTE,NC,28311-7651,Proprietary  ,29,226,255,464,,2622,3086
00499205,MILLER-MOTTE TECHNICAL COLLEGE - MILLER-,NC,28540-5901,Proprietary  ,18,177,195,167,,1356,1523
00531600,COASTAL CAROLINA COMMUNITY COLLEGE      ,NC,28546-6816,Public       ,58,361,419,1783,,6014,7797
00531700,FORSYTH TECHNICAL COMMUNITY COLLEGE     ,NC,27103-5197,Public       ,67,330,397,4828,,10908,15736
00531800,CATAWBA VALLEY COMMUNITY COLLEGE        ,NC,28602-8302,Public       ,33,123,156,2656,,4342,6998
00532000,CAPE FEAR COMMUNITY COLLEGE             ,NC,28401-3910,Public       ,116,311,427,5095,,7891,12986
00544700,RANDOLPH COMMUNITY COLLEGE              ,NC,27204-1009,Public       ,23,109,132,1355,,2883,4238
00544800,DURHAM TECHNICAL CMNTY COLLEGE          ,NC,27703-5023,Public       ,59,277,336,2425,,7287,9712
00544900,CENTRAL CAROLINA COMMUNITY COLLEGE      ,NC,27330-9000,Public       ,65,197,262,1905,,4774,6679
00546300,ALAMANCE COMMUNITY COLLEGE              ,NC,27253-0000,Public       ,40,129,169,2115,,4341,6456
00546400,RICHMOND COMMUNITY COLLEGE              ,NC,28345-4522,Public       ,25,92,117,961,,2451,3412
00575400,ROWAN-CABARRUS COMMUNITY COLLEGE        ,NC,28146-8357,Public       ,77,273,350,2674,,6383,9057
00647700,CABARRUS COLLEGE OF HEALTH SCIENCES     ,NC,28025-0000,Private      ,6,28,34,429,,1011,1440
00647800,MERCY HOSP SCH OF NURSING               ,NC,28207-0000,Public       ,5,42,47,237,,1126,1363
00648300,WATTS SCHOOL OF NURSING                 ,NC,27704-0000,Private      ,2,15,17,114,,454,568
00679900,CRAVEN COMMUNITY COLLEGE                ,NC,28562-0000,Public       ,39,196,235,1093,,4023,5116
00703100,PAMLICO COMMUNITY COLLEGE               ,NC,28529-0000,Public       ,10,27,37,105,,412,517
00764000,FAYETTEVILLE TECHNICAL CMTY COLLEGE     ,NC,28303-0236,Public       ,134,844,978,4612,,18046,22658
00768700,JAMES SPRUNT COMMUNITY COLLEGE          ,NC,28349-0398,Public       ,15,47,62,452,,1503,1955
00781400,BROOKSTONE COLLEGE OF BUSINESS          ,NC,28262-1294,Proprietary  ,5,57,62,157,,757,914
00781401,BROOKSTONE COLLEGE OF BUSINESS          ,NC,27409-0000,Proprietary  ,5,30,35,111,,582,693
00789200,SAMPSON COMMUNITY COLLEGE               ,NC,28328-0000,Public       ,13,38,51,583,,1445,2028
00798500,SOUTH PIEDMONT COMMUNITY COLLEGE        ,NC,28135-9703,Public       ,36,125,161,1025,,2350,3375
00798600,HALIFAX COMMUNITY COLLEGE               ,NC,27890-0089,Public       ,20,75,95,647,,1445,2092
00798700,BLADEN COMMUNITY COLLEGE                ,NC,28332-0266,Public       ,29,82,111,622,,1727,2349
00798800,MARTIN COMMUNITY COLLEGE                ,NC,27892-8307,Public       ,8,18,26,365,,920,1285
00808100,CARTERET COMMUNITY COLLEGE              ,NC,28557-2989,Public       ,28,82,110,744,,1932,2676
00808200,CLEVELAND COMMUNITY COLLEGE             ,NC,28150-0000,Public       ,44,130,174,1188,,2910,4098
00808300,HAYWOOD COMMUNITY COLLEGE               ,NC,28721-0000,Public       ,19,71,90,725,,1845,2570
00808500,MCDOWELL TECHNICAL COMMUNITY CLG        ,NC,28752-8728,Public       ,17,43,60,396,,1056,1452
00808700,MONTGOMERY COMMUNITY COLLEGE            ,NC,27371-0787,Public       ,7,34,41,368,,818,1186
00846600,SOUTHWESTERN COMMUNITY COLLEGE          ,NC,28779-8581,Public       ,13,72,85,957,,1918,2875
00855700,NASH COMMUNITY COLLEGE                  ,NC,27804-0488,Public       ,48,173,221,1546,,3747,5293
00855800,BEAUFORT COUNTY COMMUNITY COLLEGE       ,NC,27889-7889,Public       ,17,94,111,789,,2267,3056
00861200,ROBESON COMMUNITY COLLEGE               ,NC,28359-2151,Public       ,33,114,147,1342,,3570,4912
00861300,ROANOKE-CHOWAN COMMUNITY COLLEGE        ,NC,27910-9522,Public       ,15,34,49,375,,915,1290
00885500,EDGECOMBE COMMUNITY COLLEGE             ,NC,27886-9399,Public       ,34,177,211,940,,3852,4792
00902500,EMPIRE BEAUTY SCHOOL                    ,NC,28105-2508,Proprietary  ,0,0,0,179,,384,563
00933600,JOHNSTON COMMUNITY COLLEGE              ,NC,27577-0000,Public       ,23,122,145,1889,,4159,6048
00943000,TRI-COUNTY COMMUNITY COLLEGE            ,NC,28906-7919,Public       ,21,62,83,453,,1028,1481
00964600,PIEDMONT COMMUNITY COLLEGE              ,NC,27573-1197,Public       ,10,55,65,566,,1364,1930
00968400,BLUE RIDGE COMMUNITY COLLEGE            ,NC,28731-9624,Public       ,28,76,104,855,,1885,2740
00974701,GORDON-CONWELL THEO SEM - CHARLOTTE     ,NC,28273-0000,Private      ,0,24,24,16,,348,364
00990300,VANCE-GRANVILLE CMTY COLLEGE            ,NC,27536-0917,Public       ,36,143,179,1464,,3579,5043
01019804,ECPI UNIVERSITY - GREENSBORO            ,NC,27409-9048,Proprietary  ,3,46,49,18,,195,213
01019805,ECPI UNIVERSITY - CHARLOTTE             ,NC,28208-5886,Proprietary  ,22,162,184,66,,437,503
01019810,ECPI UNIVERSITY - RALEIGH               ,NC,27613-7387,Proprietary  ,14,92,106,37,,246,283
01019812,ECPI UNIVERSITY - CONCORD               ,NC,28262-0000,Proprietary  ,5,53,58,20,,175,195
01026400,SOUTH COLLEGE                           ,NC,28803-3152,Proprietary  ,20,54,74,170,,821,991
01119400,STANLY COMMUNITY COLLEGE                ,NC,28001-7458,Public       ,31,137,168,1000,,2755,3755
01119700,MAYLAND COMMUNITY COLLEGE               ,NC,28777-2777,Public       ,15,21,36,451,,698,1149
01179900,PAUL MITCHELL THE SCHOOL FAYETTEVILLE   ,NC,28303-5364,Proprietary  ,15,50,65,229,,683,912
01192600,LEON'S BEAUTY SCHOOL                    ,NC,27403-2812,Proprietary  ,9,14,23,219,,399,618
01303918,SOUTH UNIVERSITY - THE ART INSTITUTE OF ,NC,28217-4536,Proprietary  ,105,120,225,2092,,1734,3826
02056500,MITCHELL'S HAIR STYLING ACADEMY         ,NC,27893-0000,Proprietary  ,0,5,5,34,,101,135
02056501,MITCHELL'S HAIR STYLING ACADEMY - MITCHE,NC,27606-3326,Proprietary  ,5,28,33,118,,345,463
02158414,HARRISON COLLEGE - THE CHEF'S ACADEMY - ,NC,27560-0000,Proprietary  ,7,32,39,93,,294,387
02170700,BRUNSWICK COMMUNITY COLLEGE             ,NC,28422-0000,Public       ,10,45,55,697,,1297,1994
02205000,COLLEGE OF WILMINGTON                   ,NC,28403-0000,Proprietary  ,6,83,89,273,,749,1022
02210400,FAYETTEVILLE BEAUTY COLLEGE             ,NC,28303-0000,Proprietary  ,10,23,33,137,,510,647
02227800,MITCHELL'S HAIR STYLING ACADEMY         ,NC,27534-0000,Proprietary  ,0,2,2,27,,93,120
02227900,MITCHELL'S HAIR STYLING ACADEMY         ,NC,27858-0000,Proprietary  ,3,4,7,57,,112,169
02280900,MID-ATLANTIC CHRISTIAN UNIVERSITY       ,NC,27909-0000,Private      ,1,21,22,172,,208,380
02326203,KAPLAN CAREER INSTITUTE - KAPLAN COLLEGE,NC,28212-6830,Proprietary  ,32,186,218,367,,2133,2500
02558900,CHEVEUX SCHOOL OF HAIR DESIGN           ,NC,28540-0000,Proprietary  ,0,12,12,15,,118,133
02560600,PINNACLE INSTITUTE OF COSMETOLOGY       ,NC,28115-8020,Proprietary  ,5,9,14,74,,138,212
02614201,MILLER-MOTTE BUSINESS COLLEGE           ,NC,28403-0000,Proprietary  ,67,512,579,563,,4554,5117
02614205,MILLER - MOTTE TECHNICAL COLLEGE - MILLE,NC,27834-5052,Proprietary  ,17,79,96,334,,1265,1599
03009500,WINSTON-SALEM BARBER SCHOOL             ,NC,27107-0000,Proprietary  ,2,17,19,77,,230,307
03064400,REGENCY BEAUTY INSTITUTE                ,NC,27127-0000,Proprietary  ,13,28,41,159,,375,534
03089300,HERITAGE BIBLE COLLEGE                  ,NC,28335-0000,Private      ,0,8,8,32,,80,112
03104200,CAROLINAS COLLEGE OF HEALTH SCIENCE     ,NC,28232-2861,Public       ,17,64,81,563,,1873,2436
03109000,LIVING ARTS COLLEGE                     ,NC,27614-7076,Proprietary  ,30,62,92,673,,878,1551
03361300,MEDICAL ARTS MASSAGE SCHOOL             ,NC,27616-6453,Proprietary  ,13,32,45,110,,472,582
03513400,APEX SCHOOL OF THEOLOGY                 ,NC,27703-8024,Private      ,6,75,81,26,,1221,1247
03555300,SOUTHEASTERN INSTITUTE                  ,NC,28217-0000,Proprietary  ,20,90,110,175,,840,1015
03555400,SOUTHEASTERN SCHOOL OF NEUROMUSCULAR  MA,NC,29406-0000,Proprietary  ,5,20,25,73,,228,301
03570300,CAROLINA CHRISTIAN COLLEGE              ,NC,27105-3241,Private      ,1,3,4,34,,182,216
03663300,HOOD THEOLOGICAL SEMINARY               ,NC,28144-5768,Private      ,0,2,2,3,,234,237
03748500,LA SHE'S BEAUTY ACADEMY                 ,NC,27707-3569,Proprietary  ,6,25,31,42,,204,246
03777300,PAUL MITCHELL THE SCHOOL GASTONIA       ,NC,28054-0460,Proprietary  ,18,51,69,231,,536,767
03827300,NEW LIFE THEOLOGICAL SEMINARY           ,NC,28205-1648,Private      ,1,16,17,25,,317,342
04073300,JUNG TAO SCHOOL OF CLASSICAL CHINESE MED,NC,28679-9657,Private      ,0,0,0,2,,63,65
04101300,CAROLINA SCHOOL OF BROADCASTING         ,NC,28214-8085,Proprietary  ,7,20,27,165,,466,631
04115700,REGINA'S COLLEGE OF BEAUTY              ,NC,28110-2831,Proprietary  ,6,24,30,49,,265,314
04120300,HEALTH AND STYLE INSTITUTE              ,NC,27265-3114,Proprietary  ,11,50,61,67,,326,393
04129400,CENTER FOR MASSAGE & NATURAL HEALTH     ,NC,28787-8331,Proprietary  ,3,7,10,32,,140,172
04140700,AVEDA INSTITUTE CHAPEL HILL             ,NC,27516-2559,Proprietary  ,12,36,48,203,,314,517
04143500,CHARLOTTE SCHOOL OF LAW                 ,NC,28208-2816,Proprietary  ,3,48,51,120,,2813,2933
04146400,DAOIST TRADITIONS COLLEGE OF CHINESE MED,NC,28801-1060,Proprietary  ,2,0,2,7,,132,139
04149300,PARK WEST BARBER SCHOOL                 ,NC,27701-4022,Proprietary  ,18,89,107,192,,839,1031
04154200,CAROLINA COLLEGE OF BIBLICAL STUDIES    ,NC,29303-5157,Private      ,2,28,30,33,,348,381
04172800,BODY THERAPY INSTITUTE                  ,NC,27344-6728,Proprietary  ,1,13,14,24,,134,158
04173000,SHEPHERDS THEOLOGICAL SEMINARY          ,NC,27518-9316,Private      ,0,6,6,0,,51,51
04173700,GRACE COLLEGE OF DIVINITY               ,NC,28314-2343,Private      ,1,16,17,32,,165,197
04178100,CAROLINA COLLEGE OF HAIR DESIGN         ,NC,28802-1232,Proprietary  ,6,11,17,64,,156,220
04204700,PAUL MITCHELL THE SCHOOL RALEIGH        ,NC,27612-7358,Proprietary  ,10,19,29,156,,298,454
04206500,MYCOMPUTERCAREER.COM                    ,NC,27606-3365,Proprietary  ,6,112,118,83,,982,1065
04214600,GRACE COLLEGE OF BARBERING              ,NC,28513-7178,Private      ,4,10,14,14,,81,95
04219100,ALEXANDER PAUL INSTITUTE OF HAIR DESIGN ,NC,27858-3344,Proprietary  ,4,5,9,15,,33,48
04228400,BEYOND MEASURE BARBERING INSTITUTE      ,NC,27302-2323,Proprietary  ,5,18,23,5,,18,23
00298800,BISMARCK STATE COLLEGE                  ,ND,58501-1299,Public       ,54,95,149,2024,,1675,3699
00298900,DICKINSON STATE UNIVERSITY              ,ND,58601-4896,Public       ,10,22,32,856,,629,1485
00299000,JAMESTOWN COLLEGE                       ,ND,58405-3401,Private      ,6,3,9,1043,,224,1267
00299100,LAKE REGION STATE COLLEGE               ,ND,58301-1598,Public       ,10,27,37,409,,534,943
00299200,UNIVERSITY OF MARY                      ,ND,58504-9652,Private      ,11,51,62,1729,,1698,3427
00299300,MAYVILLE STATE UNIVERSITY               ,ND,58257-1299,Public       ,6,19,25,682,,362,1044
00299400,MINOT STATE UNIVERSITY                  ,ND,58707-0001,Public       ,24,69,93,1609,,1510,3119
00299500,DAKOTA COLLEGE AT BOTTINEAU             ,ND,58318-1159,Public       ,11,16,27,329,,282,611
00299600,NORTH DAKOTA STATE CLG OF SCIENCE       ,ND,58076-0002,Public       ,21,24,45,1701,,829,2530
00299700,NORTH DAKOTA STATE UNIVERSITY           ,ND,58108-6050,Public       ,98,104,202,10699,,3515,14214
00300500,UNIVERSITY OF NORTH DAKOTA              ,ND,58202-8193,Public       ,81,228,309,8926,,6135,15061
00300700,WILLISTON STATE COLLEGE                 ,ND,58802-1326,Public       ,13,23,36,340,,387,727
00300800,VALLEY CITY STATE UNIVERSITY            ,ND,58072-0000,Public       ,3,23,26,765,,400,1165
00775600,JOSEF'S SCHOOL OF HAIR DESIGN INC       ,ND,58102-4977,Proprietary  ,2,14,16,67,,108,175
00869408,RASMUSSEN COLLEGE - FARGO               ,ND,58103-7196,Proprietary  ,11,75,86,198,,853,1051
00869415,RASMUSSEN COLLEGE - BISMARCK            ,ND,58503-0000,Proprietary  ,4,34,38,73,,418,491
00935400,MEDCENTER ONE COLLEGE OF NURSING        ,ND,58501-4494,Private      ,1,3,4,116,,124,240
01040600,JOSEF'S SCHOOL OF HAIR DESIGN           ,ND,58201-6394,Proprietary  ,7,13,20,71,,120,191
01205900,TRINITY BIBLE COLLEGE                   ,ND,58436-7150,Private      ,3,3,6,203,,95,298
01229500,JZ TREND ACADEMY PAUL MITCHELL PARTNER S,ND,58501-0000,Proprietary  ,1,5,6,52,,56,108
02188200,SITTING BULL COLLEGE                    ,ND,58538-9701,Public       ,7,66,73,100,,382,482
02236500,LITTLE HOOP COMMUNITY COLLEGE           ,ND,58335-0000,Public       ,10,45,55,57,,255,312
02242900,UNITED TRIBES TECHNICAL COLLEGE         ,ND,58504-0000,Private      ,5,35,40,281,,834,1115
02298200,HEADQUARTERS ACADEMY OF HAIR DESIGN     ,ND,58701-0000,Proprietary  ,3,12,15,47,,86,133
02301100,TURTLE MTN CMNTY COLG-FIN AID OFC       ,ND,58316-0000,Private      ,16,60,76,236,,595,831
02553700,FORT BERTHOLD COMMUNITY COLLEGE         ,ND,58763-0000,Public       ,3,34,37,51,,171,222
03087200,MOLER BARBER CLG OF HAIRSTYLING         ,ND,58103-0000,Proprietary  ,0,1,1,4,,19,23
04031300,SALON PROFESSIONAL ACADEMY (THE)        ,ND,58103-3337,Proprietary  ,6,8,14,102,,77,179
04139400,HAIR ACADEMY (THE)                      ,ND,58501-4929,Proprietary  ,2,3,5,39,,41,80
04223500,LYNNES WELDING TRAINING                 ,ND,58102-4018,Proprietary  ,3,7,10,3,,7,10
00301005,ANTIOCH UNIV/SEATTLE                    ,WA,98121-0000,Private      ,3,56,59,161,,1585,1746
00376900,BELLEVUE COLLEGE                        ,WA,98007-6484,Public       ,238,592,830,6503,,9715,16218
00377000,BIG BEND COMMUNITY COLLEGE              ,WA,98837-3299,Public       ,53,135,188,1351,,2096,3447
00377100,"CENTRAL WASHINGTON UNIV., FIN AID       ",WA,98926-7495,Public       ,234,268,502,13768,,7045,20813
00377200,CENTRALIA COLLEGE                       ,WA,98531-4099,Public       ,59,179,238,1523,,2720,4243
00377300,CLARK COLLEGE                           ,WA,98663-3598,Public       ,265,728,993,6463,,11832,18295
00377400,COLUMBIA BASIN COLLEGE                  ,WA,99301-3379,Public       ,142,390,532,4020,,5621,9641
00377500,EASTERN WASHINGTON UNIVERSITY           ,WA,99004-2447,Public       ,188,265,453,14029,,8667,22696
00377600,EVERETT COMMUNITY COLLEGE               ,WA,98201-1352,Public       ,174,538,712,4321,,8799,13120
00377700,HERITAGE UNIVERSITY                     ,WA,98948-9562,Private      ,13,83,96,693,,1736,2429
00377800,GONZAGA UNIVERSITY                      ,WA,99258-0083,Private      ,85,180,265,9314,,4411,13725
00377900,GRAYS HARBOR COLLEGE                    ,WA,98520-7599,Public       ,37,162,199,900,,2002,2902
00378000,GREEN RIVER COMMUNITY COLLEGE           ,WA,98092-3622,Public       ,191,511,702,4196,,7217,11413
00378100,HIGHLINE COMMUNITY COLLEGE              ,WA,98198-9800,Public       ,185,502,687,4416,,7709,12125
00378200,LOWER COLUMBIA COLLEGE                  ,WA,98632-0310,Public       ,75,274,349,1615,,4054,5669
00378300,NORTHWEST UNIVERSITY                    ,WA,98083-0000,Private      ,25,61,86,1715,,1381,3096
00378400,OLYMPIC COLLEGE                         ,WA,98337-1600,Public       ,127,514,641,2718,,7097,9815
00378500,PACIFIC LUTHERAN UNIVERSITY             ,WA,98447-0003,Private      ,56,111,167,5592,,2914,8506
00378600,PENINSULA COLLEGE                       ,WA,98362-6660,Public       ,43,154,197,767,,2370,3137
00378700,SEATTLE CENTRAL COMMUNITY COLLEGE       ,WA,98122-2413,Public       ,156,587,743,4459,,9759,14218
00378703,SEATTLE VOCATIONAL INSTITUTE            ,WA,98144-0000,Public       ,21,102,123,275,,1084,1359
00378800,SEATTLE PACIFIC UNIVERSITY              ,WA,98119-1997,Private      ,105,123,228,8387,,3660,12047
00379000,SEATTLE UNIVERSITY                      ,WA,98122-1090,Private      ,144,233,377,10855,,8022,18877
00379100,SHORELINE COMMUNITY COLLEGE             ,WA,98133-5696,Public       ,112,325,437,3232,,6313,9545
00379200,SKAGIT VALLEY COLLEGE                   ,WA,98273-5899,Public       ,88,285,373,2106,,4221,6327
00379300,SPOKANE COMMUNITY COLLEGE               ,WA,99207-5399,Public       ,158,686,844,5265,,12397,17662
00379400,ST MARTIN'S UNIVERSITY                  ,WA,98503-7500,Private      ,24,55,79,1695,,1579,3274
00379600,TACOMA COMMUNITY COLLEGE                ,WA,98466-6100,Public       ,238,864,1102,5439,,13370,18809
00379700,UNIVERSITY OF PUGET SOUND               ,WA,98416-1039,Private      ,65,106,171,5859,,2697,8556
00379800,UNIVERSITY OF WASHINGTON                ,WA,98195-5880,Public       ,562,921,1483,41569,,33870,75439
00379900,WALLA WALLA UNIVERSITY                  ,WA,99324-1198,Private      ,21,40,61,2052,,957,3009
00380000,WASHINGTON STATE UNIVERSITY             ,WA,99164-1035,Public       ,425,512,937,29441,,15912,45353
00380100,WENATCHEE VALLEY COLLEGE                ,WA,98801-1799,Public       ,74,252,326,2120,,3273,5393
00380200,WESTERN WASHINGTON UNIVERSITY           ,WA,98225-5946,Public       ,237,201,438,19653,,6012,25665
00380300,WHITMAN COLLEGE                         ,WA,99362-2067,Private      ,22,8,30,2765,,220,2985
00380400,WHITWORTH UNIVERSITY                    ,WA,99251-0001,Private      ,36,85,121,4687,,1795,6482
00380500,YAKIMA VALLEY COMMUNITY COLLEGE         ,WA,98907-2520,Public       ,88,310,398,3602,,5448,9050
00499900,BELLINGHAM TECHNICAL COLLEGE            ,WA,98225-0000,Public       ,55,272,327,1332,,3522,4854
00500000,PIERCE COLLEGE                          ,WA,98498-1919,Public       ,182,717,899,4565,,10666,15231
00500100,EDMONDS COMMUNITY COLLEGE               ,WA,98036-5999,Public       ,108,419,527,3325,,6431,9756
00500600,WALLA WALLA COMMUNITY COLLEGE           ,WA,99362-9267,Public       ,65,202,267,2150,,3287,5437
00530600,BATES TECHNICAL COLLEGE                 ,WA,98405-0000,Public       ,95,486,581,1561,,5644,7205
00537200,SOUTH PUGET SOUND COMMUNITY COLLEGE     ,WA,98512-6292,Public       ,126,374,500,2822,,6444,9266
00537300,LAKE WASHINGTON TECHNICAL COLLEGE       ,WA,98034-8505,Public       ,58,219,277,1153,,3471,4624
00575200,CLOVER PARK TECHNICAL COLLEGE           ,WA,98499-0000,Public       ,112,479,591,1968,,7499,9467
00815500,EVERGREEN STATE COLLEGE (THE)           ,WA,98505-0002,Public       ,86,188,274,4224,,5149,9373
00907901,EVEREST COLLEGE                         ,WA,98684-6950,Proprietary  ,17,107,124,296,,993,1289
00938700,PERRY TECHNICAL INSTITUTE               ,WA,98903-1239,Private      ,64,126,190,944,,1442,2386
00954400,SPOKANE FALLS COMMUNITY COLLEGE         ,WA,99224-5204,Public       ,160,535,695,5529,,8851,14380
00970400,NORTH SEATTLE COMMUNITY COLLEGE         ,WA,98103-3599,Public       ,91,466,557,2547,,7168,9715
00970600,SOUTH SEATTLE COMMUNITY COLLEGE         ,WA,98106-1499,Public       ,128,414,542,3060,,6317,9377
00973900,GLEN DOW ACAD OF HAIR DESIGN            ,WA,99201-0209,Proprietary  ,10,39,49,155,,399,554
01036400,WHATCOM COMMUNITY COLLEGE               ,WA,98226-8003,Public       ,83,276,359,2674,,4141,6815
01043400,RENTON TECHNICAL COLLEGE                ,WA,98056-0000,Public       ,103,302,405,1436,,4184,5620
01148100,DIVERS INSTITUTE OF TECHNOLOGY          ,WA,98107-0000,Proprietary  ,24,106,130,228,,780,1008
01231500,CORNISH COLLEGE OF THE ARTS             ,WA,98121-4604,Private      ,19,29,48,1875,,679,2554
01249600,TONI & GUY HAIRDRESSING ACADEMY         ,WA,98133-5615,Proprietary  ,6,10,16,61,,118,179
01302200,CITY UNIVERSITY OF SEATTLE              ,WA,98005-0000,Private      ,22,171,193,341,,2581,2922
01309400,BELLINGHAM BEAUTY SCHOOL                ,WA,98225-0000,Proprietary  ,1,1,2,62,,162,224
02105300,EVERGREEN BEAUTY AND BARBER COLLEGE     ,WA,98007-3722,Proprietary  ,11,33,44,112,,297,409
02106700,TRINITY LUTHERAN COLLEGE                ,WA,98201-3569,Private      ,8,10,18,295,,168,463
02180000,NORTHWEST INDIAN COLLEGE                ,WA,98226-9278,Public       ,21,106,127,241,,1038,1279
02184200,PAROBA COLLEGE OF COSMETOLOGY           ,WA,98208-0000,Proprietary  ,8,33,41,60,,285,345
02202200,STYLEMASTERS COLLEGE OF HAIR DESIGN     ,WA,98632-0000,Proprietary  ,3,19,22,55,,211,266
02203300,GENE JUAREZ BEAUTY SCHOOLS              ,WA,98043-5427,Proprietary  ,27,47,74,482,,779,1261
02222900,INTERNATIONAL AIR & HOSPITALITY ACADEMY ,WA,98661-4835,Proprietary  ,37,125,162,460,,928,1388
02236800,PROFESSIONAL BEAUTY SCHOOL              ,WA,98902-0000,Proprietary  ,3,20,23,68,,155,223
02242500,BASTYR UNIVERSITY                       ,WA,98028-0000,Private      ,4,46,50,263,,1867,2130
02291300,ART INSTITUTE OF SEATTLE                ,WA,98121-1622,Proprietary  ,88,168,256,2785,,2829,5614
02300100,EVEREST COLLEGE                         ,WA,98367-1835,Proprietary  ,13,80,93,166,,744,910
02300103,EVEREST COLLEGE - EVERETT               ,WA,98208-2610,Proprietary  ,35,157,192,368,,1231,1599
02300104,EVEREST COLLEGE - TACOMA                ,WA,98402-3004,Proprietary  ,56,358,414,690,,2695,3385
02326500,INTERFACE COLLEGE                       ,WA,99201-4326,Proprietary  ,3,36,39,74,,386,460
02331400,NORTHWEST HAIR ACADEMY                  ,WA,98273-0000,Proprietary  ,3,33,36,62,,159,221
02331402,NORTHWEST HAIR ACADEMY - EVERETT        ,WA,98204-0000,Proprietary  ,2,7,9,59,,160,219
02504900,ACADEMY OF HAIR DESIGN (THE)            ,WA,98801-0000,Proprietary  ,7,14,21,91,,178,269
02541900,BJ'S BEAUTY AND BARBER COLLEGE          ,WA,98409-0000,Proprietary  ,12,51,63,108,,474,582
02602100,NORTHWEST COLLEGE OF ART                ,WA,98370-8625,Proprietary  ,5,6,11,206,,108,314
02606200,EVEREST COLLEGE                         ,WA,98055-2990,Proprietary  ,32,140,172,344,,1085,1429
02617500,EVEREST COLLEGE                         ,WA,98133-9018,Proprietary  ,25,123,148,716,,2025,2741
03031406,INTERNATIONAL ACADEMY OF DESIGN & TECH  ,WA,98188-3319,Proprietary  ,18,49,67,336,,728,1064
03065000,CLARE'S BEAUTY COLLEGE                  ,WA,99301-0000,Proprietary  ,7,20,27,93,,188,281
03071800,ITT TECHNICAL INSTITUTE                 ,WA,99216-1589,Proprietary  ,38,236,274,548,,2291,2839
03071805,ITT TECHNICAL INSTITUTE - SEATTLE       ,WA,98168-3346,Proprietary  ,61,355,416,724,,2802,3526
03099000,CORTIVA INSTITUTE - SEATTLE             ,WA,98109-5474,Proprietary  ,14,84,98,188,,603,791
03110800,BAKKE GRADUATE UNIVERSITY               ,WA,98104-1222,Private      ,0,7,7,14,,101,115
03139500,MONTESSORI SCHOOLS OF WASHINGTON        ,WA,98203-6600,Private      ,1,3,4,3,,39,42
03280300,SEATTLE INST OF ORIENTAL MEDICINE       ,WA,98115-0000,Proprietary  ,3,3,6,58,,220,278
03283300,NORTHWEST HVAC/R ASSOCIATION & TRAINING ,WA,99202-0000,Private      ,0,8,8,50,,160,210
03466400,SEATTLE SCHOOL OF THEOLOGY AND PSYCHOLOG,WA,98121-1177,Private      ,4,16,20,116,,585,701
03483500,CASCADIA COMMUNITY COLLEGE              ,WA,98011-9510,Public       ,63,126,189,1709,,2012,3721
03490400,EMIL FRIES PIANO HOSPITAL & TRAININ     ,WA,98661-4323,Private      ,0,4,4,9,,39,48
03670301,TONI&GUY HAIRDRESSING ACADEMY -         ,WA,98225-4526,Proprietary  ,2,11,13,2,,14,16
03689400,FAITH EVANGELICAL COLLEGE & SEMINARY    ,WA,98407-2607,Private      ,4,31,35,43,,433,476
03724300,DIGIPEN INSTITUTE OF TECHNOLOGY         ,WA,98052-5170,Proprietary  ,23,9,32,1220,,587,1807
03917300,EVERGREEN BEAUTY AND BARBER COLLEGE     ,WA,98208-3759,Proprietary  ,19,67,86,163,,507,670
03932500,TOTAL COSMETOLOGY TRAINING CENTER       ,WA,99217-6231,Proprietary  ,6,27,33,92,,374,466
03953300,YAKIMA BEAUTY SCHOOL                    ,WA,98901-2202,Proprietary  ,0,0,0,58,,122,180
04120000,SUNNYSIDE BEAUTY ACADEMY                ,WA,98944-8711,Proprietary  ,1,2,3,22,,43,65
04127200,VICTORIA'S ACADEMY OF COSMETOLOGY       ,WA,99336-3826,Proprietary  ,7,28,35,94,,258,352
04130500,PACIFIC NORTHWEST UNIV OF HEALTH SCIENCE,WA,98901-1471,Private      ,0,10,10,78,,621,699
04130800,CASCADE BEAUTY COLLEGE                  ,WA,98002-5504,Proprietary  ,4,18,22,47,,157,204
04132800,INLAND MASSAGE INSTITUTE                ,WA,99218-5016,Proprietary  ,3,17,20,54,,237,291
04149400,GARY MANUEL AVEDA INSTITUTE             ,WA,98122-3807,Proprietary  ,16,56,72,238,,538,776
04149600,GP INSTITUTE OF COSMETOLOGY             ,WA,98118-2353,Proprietary  ,0,0,0,35,,91,126
04155000,NORTHWEST SCHOOL OF WOODEN BOAT BUILDING,WA,98339-8706,Private      ,0,8,8,11,,99,110
04161200,BAINBRIDGE GRADUATE INSTITUTE           ,WA,98110-2870,Private      ,0,7,7,5,,181,186
04170100,SALON PROFESSIONAL ACADEMY (THE)        ,WA,98409-7360,Proprietary  ,9,37,46,169,,456,625
04172900,ACADEMY OF COSMETOLOGY                  ,WA,99354-2651,Proprietary  ,3,17,20,69,,175,244
04188900,NORTHWEST INSTITUTE OF LITERARY ARTS    ,WA,98249-0000,Private      ,1,3,4,10,,50,60
04191900,PAUL MITCHELL THE SCHOOL SPOKANE        ,WA,99037-5041,Proprietary  ,12,32,44,258,,428,686
04223600,ACADEMY OF INTERACTIVE ENTERTAINMENT    ,WA,98109-4623,Private      ,5,12,17,31,,82,113
00340100,BROWN UNIVERSITY                        ,RI,02912-9127,Private      ,139,31,170,18816,,1039,19855
00340101,BROWN UNIVERSITY - GRADUATE SCHOOL      ,RI,02912-1827,Private      ,4,25,29,55,,1643,1698
00340102,BROWN MEDICAL SCHOOL                    ,RI,02912-0000,Private      ,2,9,11,70,,560,630
00340200,BRYANT UNIVERSITY                       ,RI,02917-1284,Private      ,35,20,55,5531,,608,6139
00340400,JOHNSON & WALES UNIVERSITY              ,RI,02903-3703,Private      ,226,203,429,21019,,5537,26556
00340600,PROVIDENCE COLLEGE                      ,RI,02918-0001,Private      ,51,40,91,8571,,1185,9756
00340700,RHODE ISLAND COLLEGE                    ,RI,02908-1991,Public       ,91,149,240,8749,,5265,14014
00340800,COMMUNITY COLLEGE OF RI - WARWICK       ,RI,02906-0000,Public       ,227,481,708,10598,,13435,24033
00340900,RHODE ISLAND SCHOOL OF DESIGN           ,RI,02903-2784,Private      ,33,34,67,3074,,1303,4377
00341000,ROGER WILLIAMS UNIVERSITY               ,RI,02809-2921,Private      ,89,40,129,8819,,1739,10558
00341100,SALVE REGINA UNIVERSITY                 ,RI,02840-4192,Private      ,28,25,53,4787,,619,5406
00341400,UNIVERSITY OF RHODE ISLAND              ,RI,02881-0000,Public       ,212,130,342,24618,,5022,29640
00659100,ST. JOSEPH HOSP SCH OF NURSING          ,RI,02904-5199,Private      ,0,12,12,110,,358,468
00784400,SANFORD-BROWN INSTITUTE                 ,RI,02920-7807,Proprietary  ,0,3,3,27,,136,163
00784500,NEW ENGLAND INSTITUTE OF TECHNOLOGY     ,RI,02886-0000,Private      ,105,206,311,2723,,3419,6142
00817811,EMPIRE BEAUTY SCHOOL - PROVIDENCE       ,RI,02903-3042,Proprietary  ,0,0,0,80,,160,240
01246116,LINCOLN TECHNICAL INSTITUTE - LINCOLN   ,RI,02865-4211,Proprietary  ,35,100,135,481,,1011,1492
01260608,EMPIRE BEAUTY SCHOOL - WARWICK          ,RI,02886-1534,Proprietary  ,0,0,0,77,,97,174
02531802,PAUL MITCHELL THE SCHOOL-CRANSTON       ,RI,02920-0000,Proprietary  ,16,10,26,107,,108,215
02584400,NEW ENGLAND TRACTOR TRAILER TRAINING SCH,RI,02860-1752,Proprietary  ,43,316,359,164,,1213,1377
03080000,NEWPORT SCHOOL OF HAIRDRESSING          ,RI,02860-4038,Proprietary  ,0,4,4,14,,81,95
03732300,INTERNATIONAL YACHT RESTORATION SCH     ,RI,02840-6720,Private      ,2,5,7,33,,67,100
04141200,TONI & GUY HAIRDRESSING ACADEMY         ,RI,02920-0000,Proprietary  ,9,17,26,130,,120,250
00341700,ALLEN UNIVERSITY                        ,SC,29204-1085,Private      ,14,33,47,1204,,735,1939
00341800,ANDERSON UNIVERSITY                     ,SC,29621-4035,Private      ,26,74,100,3328,,1618,4946
00341900,CHARLESTON SOUTHERN UNIVERSITY          ,SC,29406-2160,Private      ,60,105,165,5094,,3064,8158
00342000,BENEDICT COLLEGE                        ,SC,29204-1086,Private      ,67,59,126,3986,,1912,5898
00342100,BOB JONES UNIVERSITY                    ,SC,29614-1000,Proprietary  ,28,21,49,2825,,537,3362
00342200,SOUTHERN WESLEYAN UNIVERSITY            ,SC,29630-1020,Private      ,12,143,155,941,,1922,2863
00342300,THE CITADEL                             ,SC,29409-0002,Public       ,48,67,115,3607,,1596,5203
00342400,CLAFLIN UNIVERSITY                      ,SC,29115-4498,Private      ,50,39,89,2990,,1257,4247
00342500,CLEMSON UNIVERSITY                      ,SC,29634-0001,Public       ,203,142,345,21859,,4749,26608
00342600,UNIV OF SC AT SUMTER                    ,SC,29150-2498,Public       ,14,47,61,1028,,955,1983
00342700,COKER COLLEGE                           ,SC,29550-3797,Private      ,14,35,49,1285,,1081,2366
00342800,COLLEGE OF CHARLESTON                   ,SC,29424-0100,Public       ,112,119,231,13245,,3943,17188
00342900,COLUMBIA INTERNATIONAL UNIVERSITY       ,SC,29203-1599,Private      ,6,40,46,751,,946,1697
00343000,COLUMBIA COLLEGE                        ,SC,29203-5998,Private      ,14,88,102,1365,,1990,3355
00343100,CONVERSE COLLEGE                        ,SC,29302-1931,Private      ,12,23,35,1256,,854,2110
00343200,ERSKINE COLLEGE                         ,SC,29639-0000,Private      ,3,3,6,757,,72,829
00343201,ERSKINE THEOLOGICAL SEMINARY            ,SC,29639-0000,Private      ,0,3,3,6,,111,117
00343400,FURMAN UNIVERSITY                       ,SC,29613-5253,Private      ,35,28,63,4549,,690,5239
00343500,LANDER UNIVERSITY                       ,SC,29649-2099,Public       ,40,28,68,4387,,1096,5483
00343600,LIMESTONE COLLEGE                       ,SC,29340-3799,Private      ,24,153,177,2074,,3545,5619
00343700,LUTHERAN THEOLOGICAL SOUTHERN SEM       ,SC,29203-5898,Private      ,0,4,4,9,,153,162
00343800,MEDICAL UNIV OF SOUTH CAROLINA - FA     ,SC,29425-1760,Public       ,14,79,93,541,,3789,4330
00343900,MORRIS COLLEGE                          ,SC,29150-3599,Private      ,11,22,33,1467,,723,2190
00344000,NEWBERRY COLLEGE                        ,SC,29108-2197,Private      ,14,10,24,1790,,438,2228
00344100,NORTH GREENVILLE COLLEGE                ,SC,29688-1892,Private      ,14,18,32,2801,,555,3356
00344500,PRESBYTERIAN COLLEGE                    ,SC,29325-2503,Private      ,12,4,16,1847,,469,2316
00344600,SOUTH CAROLINA STATE UNIVERSITY         ,SC,29117-4427,Public       ,61,92,153,5326,,2950,8276
00344700,SPARTANBURG METHODIST COLLEGE           ,SC,29301-5899,Private      ,16,10,26,1646,,375,2021
00344800,UNIVERSITY OF SOUTH CAROLINA            ,SC,29208-3999,Public       ,264,389,653,31156,,13639,44795
00344900,UNIVERSITY OF SOUTH CAROLINA AIKEN      ,SC,29801-6399,Public       ,44,72,116,3734,,1971,5705
00345000,UNIV OF SC AT BEAUFORT                  ,SC,29902-0000,Public       ,27,67,94,2290,,1464,3754
00345100,COASTAL CAROLINA UNIVERSITY             ,SC,29528-0000,Public       ,160,107,267,14831,,3728,18559
00345300,UNIV OF SC AT LANCASTER                 ,SC,29721-0889,Public       ,15,40,55,1279,,963,2242
00345400,UNIV OF SC SYSTEM SALKEHATCHIE          ,SC,29810-0617,Public       ,23,41,64,770,,869,1639
00345500,VOORHEES COLLEGE                        ,SC,29042-0000,Private      ,12,10,22,858,,414,1272
00345600,WINTHROP UNIVERSITY                     ,SC,29733-0001,Public       ,56,68,124,7062,,2675,9737
00345700,WOFFORD COLLEGE                         ,SC,29303-3663,Private      ,16,9,25,2849,,308,3157
00399000,FLORENCE-DARLINGTON TECH COLLEGE        ,SC,29501-0548,Public       ,137,355,492,3696,,7325,11021
00399100,GREENVILLE TECHNICAL COLLEGE            ,SC,29607-2439,Public       ,163,586,749,8996,,13804,22800
00399200,PIEDMONT TECHNICAL COLLEGE              ,SC,29648-1467,Public       ,93,321,414,2997,,6406,9403
00399300,MIDLANDS TECHNICAL COLLEGE              ,SC,29202-0000,Public       ,137,543,680,8231,,13242,21473
00399400,SPARTANBURG COMMUNITY COLLEGE           ,SC,29305-4386,Public       ,67,231,298,3824,,6131,9955
00399500,CENTRAL CAROLINA TECHNICAL COLLEGE      ,SC,29150-2499,Public       ,75,329,404,2066,,5233,7299
00399600,YORK TECHNICAL COLLEGE                  ,SC,29730-3395,Public       ,90,313,403,3514,,6136,9650
00492000,TRIDENT TECHNICAL COLLEGE               ,SC,29423-8067,Public       ,242,828,1070,8209,,17935,26144
00492300,CLINTON JR COLLEGE                      ,SC,29730-5152,Private      ,2,9,11,224,,242,466
00492400,FORREST JUNIOR COLLEGE                  ,SC,29624-2405,Proprietary  ,5,37,42,60,,411,471
00492500,HORRY-GEORGETOWN TECH COLLEGE           ,SC,29526-9521,Public       ,121,317,438,4571,,8359,12930
00492600,TRI-COUNTY TECHNICAL COLLEGE            ,SC,29670-9133,Public       ,58,151,209,4679,,4730,9409
00492700,UNIV OF SC AT UNION                     ,SC,29379-0729,Public       ,4,11,15,313,,405,718
00499204,MILLER-MOTTE TECHNICAL COLLEGE - CONWAY ,SC,29526-9508,Proprietary  ,26,162,188,509,,1771,2280
00536300,DENMARK TECHNICAL COLLEGE               ,SC,29042-0000,Public       ,62,188,250,922,,2484,3406
00681500,ORANGEBURG-CALHOUN TECHNICAL COLG       ,SC,29118-8299,Public       ,52,124,176,2024,,3183,5207
00695100,UNIVERSITY OF SOUTH CAROLINA UPSTATE    ,SC,29303-9972,Public       ,53,105,158,6929,,4008,10937
00760200,NORTHEASTERN TECHNICAL COLLEGE          ,SC,29520-7015,Public       ,18,56,74,743,,1313,2056
00922600,FRANCIS MARION UNIVERSITY               ,SC,29501-0000,Public       ,61,70,131,5187,,2424,7611
00932200,WILLIAMSBURG TECHNICAL COLLEGE          ,SC,29556-4197,Public       ,20,41,61,346,,836,1182
00991000,TECHNICAL COLLEGE OF THE LOWCOUNTRY     ,SC,29902-5441,Public       ,37,186,223,1318,,3578,4896
00991100,UNIV OF SC-REGIONAL CAMPUSES ADMIN      ,SC,29208-0001,Public       ,3,13,16,267,,374,641
01005600,AIKEN TECHNICAL COLLEGE                 ,SC,29802-0696,Public       ,39,148,187,2040,,3941,5981
01019806,ECPI UNIVERSITY - GREENVILLE            ,SC,29615-4232,Proprietary  ,16,60,76,27,,169,196
01019809,ECPI UNIVERSITY - CHARLESTON            ,SC,29420-4264,Proprietary  ,10,75,85,21,,172,193
01019811,ECPI UNIVERSITY - COLUMBIA              ,SC,29210-6467,Proprietary  ,4,45,49,9,,119,128
01179901,PAUL MITCHELL THE SCHOOL COLUMBIA       ,SC,29201-3126,Proprietary  ,10,25,35,96,,229,325
01179902,PAUL MITCHELL THE SCHOOL CHARLESTON     ,SC,29418-6993,Proprietary  ,10,24,34,100,,236,336
01179903,PAUL MITCHELL THE SCHOOL FAYETTEVILLE - ,SC,29607-0000,Proprietary  ,2,4,6,2,,4,6
01209200,KENNETH SHULER SCHOOL OF COSMETOLOGY    ,SC,29732-2169,Proprietary  ,9,60,69,207,,525,732
01303907,SOUTH UNIVERSITY                        ,SC,29203-6400,Proprietary  ,29,301,330,609,,3429,4038
02063700,SHERMAN CLG STRAIGHT CHIROPRACTIC       ,SC,29316-0000,Private      ,1,8,9,19,,393,412
02338600,CHARZANNE BEAUTY COLLEGE                ,SC,29649-0000,Proprietary  ,1,14,15,30,,114,144
02341100,KENNETH SHULER SCHOOL OF COSMETOLOGY & N,SC,29210-0000,Proprietary  ,11,90,101,269,,820,1089
02356600,CHARLESTON COSMETOLOGY INSTITUTE        ,SC,29420-0000,Proprietary  ,5,29,34,71,,234,305
02359802,ITT TECHNICAL INSTITUTE -               ,SC,29615-4506,Proprietary  ,0,0,0,0,,1,1
02552400,ACADEMY OF HAIR TECHNOLOGY              ,SC,29615-2363,Proprietary  ,2,14,16,65,,248,313
02567600,SUMTER BEAUTY COLLEGE                   ,SC,29150-0000,Proprietary  ,0,7,7,36,,129,165
02614202,MILLER - MOTTE TECHNICAL COLLEGE - NORTH,SC,29406-9239,Proprietary  ,26,142,168,437,,1660,2097
03010614,VIRGINIA COLLEGE - GOLF ACADEMY OF AMERI,SC,29579-0000,Proprietary  ,5,12,17,129,,234,363
03010617,VIRGINIA COLLEGE - GREENVILLE           ,SC,29607-7200,Proprietary  ,6,36,42,211,,992,1203
03010620,VIRGINIA COLLEGE - CHARLESTON           ,SC,29406-4999,Proprietary  ,9,48,57,207,,893,1100
03010621,VIRGINIA COLLEGE - COLUMBIA             ,SC,29223-7527,Proprietary  ,5,52,57,215,,1042,1257
03052300,KENNETH SHULER SCH COSM & HAIR DESG     ,SC,29841-2013,Proprietary  ,10,42,52,154,,416,570
03088300,ACADEMY OF COSMETOLOGY                  ,SC,29418-5667,Proprietary  ,0,0,0,8,,15,23
03293300,STRAND COLLEGE OF HAIR DESIGN           ,SC,29572-4310,Proprietary  ,5,9,14,52,,147,199
03304300,CENTURA COLLEGE                         ,SC,29406-9235,Proprietary  ,11,88,99,138,,831,969
03513300,LACY COSMETOLOGY SCHOOL                 ,SC,29803-9084,Proprietary  ,0,3,3,31,,83,114
03513301,LACY COSMETOLOGY SCHOOL -               ,SC,29072-0000,Proprietary  ,0,4,4,22,,60,82
03513302,LACY COSMETOLOGY SCHOOL -               ,SC,29445-0000,Proprietary  ,2,9,11,20,,67,87
03513303,LACY COSMETOLOGY SCHOOL - WEST ASHLEY   ,SC,29407-4605,Proprietary  ,0,6,6,6,,38,44
03709301,EDWARD VIA VIRGINIA COLLEGE OF OSTEOPATH,SC,29303-3639,Private      ,2,5,7,23,,608,631
03746300,LEGRAND INSTITUTE OF COSMETOLOGY        ,SC,29020-0000,Proprietary  ,1,10,11,22,,77,99
03746400,SOUTHEASTERN INSTITUTE                  ,SC,29210-0000,Proprietary  ,8,50,58,91,,532,623
03768400,STYLETRENDS BARBER AND HAIRSTYLING ACADE,SC,29730-4511,Proprietary  ,1,11,12,26,,121,147
03856400,W. L. BONNER COLLEGE                    ,SC,29203-0000,Private      ,0,0,0,11,,94,105
04083300,MARION COUNTY TECHNICAL EDUCATION CENTER,SC,29571-0000,Public       ,0,5,5,32,,181,213
04096300,CHARLESTON SCHOOL OF LAW                ,SC,29402-0535,Proprietary  ,1,8,9,57,,1094,1151
04158100,AIKEN SCHOOL OF COSMETOLOGY             ,SC,29801-4026,Proprietary  ,0,8,8,44,,123,167
04166900,COSMETIC ARTS INSTITUTE                 ,SC,29488-2753,Proprietary  ,1,11,12,23,,73,96
04172600,SALON 496 BARBER ACADEMY                ,SC,29607-2548,Proprietary  ,0,10,10,19,,170,189
04192600,PALMETTO BEAUTY SCHOOL                  ,SC,29307-1424,Proprietary  ,4,15,19,53,,187,240
04202900,JOLEI'S HAIR INSTITUTE                  ,SC,29114-9337,Proprietary  ,1,9,10,10,,92,102
00345800,AUGUSTANA COLLEGE                       ,SD,57197-0001,Private      ,15,29,44,1744,,299,2043
00345900,BLACK HILLS STATE UNIVERSITY            ,SD,57799-9670,Public       ,23,58,81,2496,,1899,4395
00346100,DAKOTA WESLEYAN UNIVERSITY              ,SD,57301-4398,Private      ,7,9,16,831,,301,1132
00346300,DAKOTA STATE UNIVERSITY                 ,SD,57042-1799,Public       ,27,24,51,1415,,1014,2429
00346500,MOUNT MARTY COLLEGE                     ,SD,57078-3724,Private      ,6,9,15,543,,478,1021
00346600,NORTHERN STATE UNIVERSITY               ,SD,57401-7198,Public       ,24,40,64,1712,,876,2588
00346700,PRESENTATION COLLEGE                    ,SD,57401-1299,Private      ,6,9,15,647,,557,1204
00346900,UNIVERSITY OF SIOUX FALLS               ,SD,57105-1699,Private      ,11,26,37,1440,,746,2186
00347000,SOUTH DAKOTA SCH OF MINES & TECH        ,SD,57701-3995,Public       ,22,19,41,2133,,758,2891
00347100,SOUTH DAKOTA STATE UNIVERSITY           ,SD,57007-2298,Public       ,65,85,150,8779,,3463,12242
00347400,UNIVERSITY OF SOUTH DAKOTA              ,SD,57069-2390,Public       ,49,117,166,5717,,4798,10515
00405600,SIOUX FALLS SEMINARY                    ,SD,57105-2729,Private      ,0,3,3,4,,99,103
00405700,NATIONAL AMERICAN UNIVERSITY            ,SD,57701-3692,Proprietary  ,114,1736,1850,1068,,16579,17647
00405707,NATIONAL AMERICAN UNIVERSITY            ,SD,57105-0000,Proprietary  ,2,39,41,86,,897,983
00492900,MCKENNAN HOSP-RADOLOGICAL TECH          ,SD,57101-0000,Private      ,0,3,3,24,,42,66
00530900,LAKE AREA TECHNICAL INSTITUTE           ,SD,57201-0730,Public       ,15,16,31,1197,,651,1848
00598700,AVERA SACRED HEART HOSPITAL SCHOOL OF RA,SD,57078-3899,Private      ,0,1,1,8,,15,23
00776400,SOUTHEAST TECHNICAL INST                ,SD,57107-0000,Public       ,23,70,93,1501,,1903,3404
00828400,MITCHELL TECHNICAL INSTITUTE            ,SD,57301-9931,Public       ,6,6,12,807,,477,1284
01013800,STEWART SCHOOL                          ,SD,57104-0000,Proprietary  ,5,18,23,128,,126,254
01014804,COLORADO TECHNICAL UNIVERSITY           ,SD,57108-2272,Proprietary  ,1,14,15,85,,487,572
01017000,WESTERN DAKOTA TECHNICAL INSTITUTE      ,SD,57701-4018,Public       ,10,50,60,537,,1197,1734
01147701,SIOUX VALLEY HOSP-MEDICAL TECH          ,SD,57117-5039,Private      ,0,1,1,22,,34,56
01465900,OGLALA LAKOTA COLLEGE                   ,SD,57752-0490,Public       ,38,205,243,404,,1620,2024
02137100,BLACK HILLS BEAUTY COLLEGE              ,SD,57701-0000,Proprietary  ,7,19,26,116,,171,287
02143700,SINTE GLESKA UNIVERSITY                 ,SD,57570-0000,Public       ,18,133,151,143,,665,808
02144600,KILIAN COMMUNITY COLLEGE                ,SD,57103-7020,Private      ,6,35,41,116,,434,550
02277300,SISSETON WAHPETON COLLEGE               ,SD,57262-0000,Public       ,2,30,32,57,,209,266
02297800,HEADLINES ACADEMY                       ,SD,57701-0000,Proprietary  ,3,10,13,54,,163,217
00347700,AQUINAS COLLEGE                         ,TN,37205-2086,Private      ,5,32,37,376,,920,1296
00347800,AUSTIN PEAY STATE UNIVERSITY            ,TN,37044-0002,Public       ,137,416,553,9112,,9252,18364
00347900,BELMONT UNIVERSITY                      ,TN,37212-3757,Private      ,81,103,184,8538,,4201,12739
00348000,BETHEL UNIVERSITY                       ,TN,38201-1705,Private      ,42,603,645,2469,,8257,10726
00348100,CARSON - NEWMAN UNIVERSITY              ,TN,37760-2204,Private      ,53,49,102,3863,,942,4805
00348200,CHRISTIAN BROTHERS UNIVERSITY           ,TN,38104-5581,Private      ,50,95,145,2573,,2417,4990
00348300,COLUMBIA STATE COMMUNITY COLLEGE        ,TN,38401-5653,Public       ,89,145,234,3550,,3877,7427
00348500,CUMBERLAND UNIVERSITY                   ,TN,37087-3554,Private      ,14,65,79,1722,,1263,2985
00348600,LIPSCOMB UNIVERSITY                     ,TN,37204-3951,Private      ,37,96,133,4340,,2987,7327
00348700,EAST TENNESSEE STATE UNIV - MAIN CAMPUS ,TN,37614-2857,Public       ,175,256,431,13013,,9525,22538
00348701,EAST TENNESSEE STATE UNIV - MEDICINE    ,TN,37614-1708,Public       ,9,12,21,430,,701,1131
00348709,EAST TENNESSEE STATE UNIV - PHARMACY    ,TN,37614-1704,Public       ,2,7,9,167,,543,710
00349000,FISK UNIVERSITY                         ,TN,37208-3045,Private      ,38,31,69,1824,,887,2711
00349200,FREED-HARDEMAN UNIVERSITY               ,TN,38340-2399,Private      ,20,44,64,1887,,903,2790
00349400,HIWASSEE COLLEGE                        ,TN,37354-4001,Private      ,14,8,22,398,,209,607
00349500,JOHNSON UNIVERSITY                      ,TN,37998-9775,Private      ,7,33,40,1065,,689,1754
00349600,KING COLLEGE                            ,TN,37620-2699,Private      ,21,150,171,1607,,2850,4457
00349900,LANE COLLEGE                            ,TN,38301-4598,Private      ,32,35,67,2225,,1137,3362
00350000,LEE UNIVERSITY                          ,TN,37320-0000,Private      ,43,88,131,4501,,2122,6623
00350100,LEMOYNE-OWEN COLLEGE                    ,TN,38126-6510,Private      ,48,100,148,1985,,2944,4929
00350200,LINCOLN MEMORIAL UNIVERSITY             ,TN,37752-7920,Private      ,25,70,95,2018,,3937,5955
00350400,MARTIN METHODIST COLLEGE                ,TN,38478-2799,Private      ,12,27,39,1172,,509,1681
00350500,MARYVILLE COLLEGE                       ,TN,37804-5907,Private      ,35,10,45,2340,,415,2755
00350600,MEHARRY MEDICAL COLLEGE                 ,TN,37208-0000,Private      ,5,11,16,129,,1422,1551
00350700,MEMPHIS COLLEGE OF ART                  ,TN,38104-2764,Private      ,19,16,35,898,,540,1438
00350900,UNIVERSITY OF MEMPHIS (THE)             ,TN,38152-4611,Public       ,309,537,846,19464,,19902,39366
00351000,MIDDLE TENNESSEE STATE UNIV             ,TN,37130-0000,Public       ,311,420,731,25355,,15228,40583
00351100,MILLIGAN COLLEGE                        ,TN,37682-4001,Private      ,12,20,32,1344,,789,2133
00351700,SOUTHERN COLLEGE OF OPTOMETRY           ,TN,38104-2222,Private      ,2,11,13,82,,731,813
00351800,SOUTHERN ADVENTIST UNIVERSITY           ,TN,37315-0370,Private      ,37,40,77,3001,,1146,4147
00351900,RHODES COLLEGE                          ,TN,38112-1690,Private      ,41,38,79,3587,,857,4444
00352200,TENNESSEE STATE UNIVERSITY              ,TN,37209-1561,Public       ,217,328,545,11987,,11018,23005
00352300,TENNESSEE TECHNOLOGICAL UNIV            ,TN,38505-0001,Public       ,111,129,240,11881,,4279,16160
00352400,TENNESSEE TEMPLE UNIVERSITY             ,TN,37404-3587,Private      ,14,70,84,591,,1007,1598
00352500,TENNESSEE WESLEYAN COLLEGE              ,TN,37371-0040,Private      ,8,30,38,1232,,750,1982
00352600,TREVECCA NAZARENE UNIVERSITY            ,TN,37210-2877,Private      ,19,189,208,1748,,2329,4077
00352700,TUSCULUM COLLEGE                        ,TN,37743-0001,Private      ,39,75,114,2548,,2096,4644
00352800,UNION UNIVERSITY                        ,TN,38305-3697,Private      ,23,122,145,3124,,3543,6667
00352900,UNIVERSITY OF TENNESSEE-CHATTANOOGA     ,TN,37403-2598,Public       ,167,209,376,16755,,6368,23123
00353000,UNIVERSITY OF TENNESSEE-KNOXVILLE       ,TN,37996-0150,Public       ,300,299,599,29959,,11693,41652
00353006,UNIVERSITY OF TENNESSEE-HEALTH SCI CTR  ,TN,38103-0000,Public       ,21,79,100,742,,4197,4939
00353100,UNIVERSITY OF TENNESSEE-MARTIN          ,TN,38238-0002,Public       ,85,127,212,8499,,4124,12623
00353400,UNIVERSITY OF THE SOUTH                 ,TN,37383-1000,Private      ,20,6,26,2586,,159,2745
00353500,VANDERBILT UNIVERSITY                   ,TN,37240-0001,Private      ,158,118,276,20800,,7721,28521
00353501,VANDERBILT UNIV MED CTR ALLIEDHEAL      ,TN,37232-5510,Private      ,9,19,28,259,,795,1054
00353502,VANDERBILT UNIVERSITY - SCHOOL OF MEDICI,TN,37232-0000,Private      ,0,0,0,47,,27,74
00353600,BRYAN COLLEGE                           ,TN,37321-7000,Private      ,7,63,70,1337,,1028,2365
00399800,CHATTANOOGA STATE COMMUNITY COLLEGE     ,TN,37406-1097,Public       ,157,469,626,6687,,11170,17857
00399900,CLEVELAND STATE COMMUNITY COLLEGE       ,TN,37312-2858,Public       ,51,133,184,2369,,3084,5453
00402500,TN TECHNOLOGY CTR AT KNOXVILLE          ,TN,37919-2327,Public       ,23,115,138,828,,2199,3027
00402600,TENNESSEE TECH. CNTR AT CROSSVILLE      ,TN,38555-4142,Public       ,13,27,40,643,,738,1381
00461700,NATIONAL COLLEGE OF BUSINESS & TECH     ,TN,37211-6605,Proprietary  ,19,187,206,330,,2322,2652
00493400,DAYMAR INSTITUTE                        ,TN,37217-1056,Proprietary  ,3,53,56,158,,758,916
00493401,DAYMAR INSTITUTE - CLARKSVILLE          ,TN,37040-6718,Proprietary  ,15,101,116,239,,1153,1392
00493404,DAYMAR INSTITUTE - MURFREESBORO         ,TN,37128-5508,Proprietary  ,9,36,45,162,,643,805
00493700,JACKSON STATE COMMUNITY COLLEGE         ,TN,38301-3797,Public       ,56,146,202,3405,,4620,8025
00493800,SOUTH COLLEGE                           ,TN,37909-3323,Proprietary  ,22,192,214,599,,2602,3201
00494700,WEST TENNESSEE BUSINESS COLLEGE         ,TN,38301-3256,Proprietary  ,8,49,57,162,,738,900
00528000,TN TECHNOLOGY CTR AT COVINGTON          ,TN,38019-0249,Public       ,5,19,24,190,,440,630
00528100,TN TECHNOLOGY CTR AT ELIZABETHTON       ,TN,37643-0789,Public       ,16,86,102,403,,1131,1534
00528200,TN TECHNOLOGY CTR AT HARTSVILLE         ,TN,37074-0000,Public       ,6,27,33,261,,413,674
00528300,TN TECHNOLOGY CTR AT NEWBERN            ,TN,38059-1198,Public       ,5,21,26,155,,542,697
00530700,TENNESSEE COLLEGE OF APPLIED TECHNOLOGY-,TN,37110-1322,Public       ,4,18,22,230,,466,696
00535100,TENNESSEE TECHNOLOGY CENTER AT MORRISTOW,TN,37813-2094,Public       ,18,62,80,575,,1235,1810
00535200,TN TECHNOLOGY CENTER AT MCKENZIE        ,TN,38201-1620,Public       ,7,14,21,152,,374,526
00535300,TN TECHNOLOGY CENTER AT LIVINGSTON      ,TN,38570-1291,Public       ,20,33,53,309,,492,801
00535400,TN TECHNOLOGY CTR AT JACKSON            ,TN,38301-0000,Public       ,8,43,51,534,,1378,1912
00535600,TENNESSEE TECHNOLOGY CENTER AT HOHENWALD,TN,38462-0000,Public       ,11,29,40,266,,491,757
00535700,TENNESSEE TECHNOLOGY CENTER AT CRUMP    ,TN,38327-3402,Public       ,4,21,25,199,,465,664
00535800,TN TECHNOLOGY CENTER AT ATHENS          ,TN,37371-0848,Public       ,4,18,22,284,,478,762
00535900,TENNESSEE TECHNOLOGY CENTER AT NASHVILLE,TN,37209-0000,Public       ,34,129,163,879,,2485,3364
00536000,TENNESSEE TECHNOLOGY CENTER AT MEMPHIS  ,TN,38105-3604,Public       ,61,171,232,1422,,3396,4818
00537800,NORTHEAST STATE COMMUNITY COLLEGE       ,TN,37617-0246,Public       ,80,187,267,3786,,5357,9143
00537900,TN TECHNOLOGY CTR AT SHELBYVILLE        ,TN,37160-3697,Public       ,9,38,47,391,,807,1198
00683500,DYERSBURG STATE COMMUNITY COLLEGE       ,TN,38024-0000,Public       ,43,105,148,1935,,3188,5123
00683600,MOTLOW STATE COMMUNITY COLLEGE          ,TN,37388-7972,Public       ,82,172,254,3693,,3907,7600
00732941,ITT TECHNICAL INSTITUTE                 ,TN,37932-3343,Proprietary  ,116,541,657,1227,,4545,5772
00732958,ITT TECHNICAL INSTITUTE                 ,TN,37214-3717,Proprietary  ,69,342,411,831,,3286,4117
00743900,FOUNTAINHEAD COLLEGE OF TECHNOLOGY      ,TN,37918-0000,Proprietary  ,4,34,38,227,,705,932
00778200,TENNESSEE TECHNOLOGY CENTER AT DICKSON  ,TN,37055-0000,Public       ,11,46,57,413,,1020,1433
00778300,MIDDLE TENNESSEE SCH OF ANESTHESIA      ,TN,37116-0000,Private      ,0,4,4,17,,187,204
00793803,NASHVILLE AUTO DIESEL COLLEGE - NASHVILL,TN,37206-3210,Proprietary  ,336,123,459,3009,,1143,4152
00814500,NASHVILLE STATE TECH CMNTY COLLEGE      ,TN,37209-0000,Public       ,133,451,584,5636,,11878,17514
00865500,GENESIS CAREER COLLEGE OF COOKEVILLE    ,TN,38501-1959,Proprietary  ,21,65,86,223,,639,862
00885900,JOHN A GUPTON COLLEGE                   ,TN,37203-2934,Private      ,3,6,9,94,,239,333
00886300,WALTERS STATE COMMUNITY COLLEGE         ,TN,37813-6899,Public       ,77,150,227,4917,,5018,9935
00946400,TN TECHNOLOGY CTR AT PULASKI            ,TN,38478-4541,Public       ,7,19,26,184,,385,569
00956700,TENNESSEE SCHOOL OF BEAUTY              ,TN,37921-3303,Proprietary  ,8,53,61,244,,568,812
00971000,TENNESSEE TECHNOLOGY CENTER AT ONEIDA/HU,TN,37756-4149,Public       ,6,17,23,115,,258,373
00991200,VOLUNTEER STATE COMMUNITY COLLEGE       ,TN,37066-3188,Public       ,101,258,359,4851,,5973,10824
00991400,ROANE STATE COMMUNITY COLLEGE           ,TN,37748-8664,Public       ,89,184,273,4434,,5524,9958
00998200,VICTORY UNIVERSITY                      ,TN,38111-4745,Proprietary  ,37,176,213,951,,3602,4553
01032600,TN TECHNOLOGY CTR AT HARRIMAN           ,TN,37748-1109,Public       ,11,20,31,221,,404,625
01043900,SOUTHWEST TENNESSEE COMMUNITY COLLG     ,TN,38104-3322,Public       ,304,654,958,9955,,17207,27162
01044700,"PLAZA BEAUTY SCHOOL, INC.               ",TN,38117-4822,Proprietary  ,9,24,33,183,,409,592
01046000,AMERICAN BAPTIST THEOLOGICAL SEMINA     ,TN,37207-4994,Private      ,2,14,16,55,,289,344
01052900,MEMPHIS THEOLOGICAL SEMINARY            ,TN,38104-0000,Private      ,1,18,19,24,,426,450
01070000,TN TECHNOLOGY CENTER AT JACKSBORO       ,TN,37757-2461,Public       ,3,12,15,167,,318,485
01155300,WM R MOORE COLLEGE OF TECHNOLOGY        ,TN,38104-0000,Private      ,12,25,37,177,,518,695
01216400,TENNESSEE TECHNICAL CNTR AT RIPLEY      ,TN,38063-7359,Public       ,1,13,14,83,,344,427
01254700,EMMANUEL SCHOOL OF RELIGION             ,TN,37601-0000,Private      ,0,4,4,6,,72,78
01269300,PELLISSIPPI STATE COMMUNITY COLLEGE     ,TN,37933-0990,Public       ,147,311,458,7548,,8064,15612
02069303,VATTEROTT COLLEGE -                     ,TN,38016-5877,Proprietary  ,25,104,129,215,,723,938
02092800,TENNESSEE TECHNOLOGY CENTER AT WHITEVILL,TN,38075-0000,Public       ,11,16,27,135,,377,512
02103500,TENNESSEE COLLEGE OF APPLIED TECHNOLOGY ,TN,37129-3311,Public       ,19,41,60,470,,1063,1533
02106400,O'MORE COLLEGE OF DESIGN                ,TN,37064-0000,Private      ,4,6,10,203,,123,326
02125300,NASHVILLE CLG OF MEDICAL CAREERS        ,TN,37115-0000,Proprietary  ,3,29,32,62,,269,331
02153100,JON NAVE UNIVERSITY OF COSMETOLOGY      ,TN,37013-3347,Proprietary  ,15,27,42,263,,338,601
02157100,CONCORDE CAREER COLLEGE                 ,TN,38137-0000,Proprietary  ,56,277,333,982,,3580,4562
02160307,INTERNATIONAL ACADEMY OF DESIGN & TECH  ,TN,37212-0000,Proprietary  ,3,7,10,178,,356,534
02188300,PENTECOSTAL THEOLOGICAL SEMINARY        ,TN,37320-0000,Private      ,0,24,24,6,,297,303
02204200,"CHATTANOOGA COLLEGE - MEDICAL, DENTAL AN",TN,37411-0000,Proprietary  ,8,85,93,300,,1091,1391
02237900,TN TECHNOLOGY CENTER AT PARIS           ,TN,38242-0000,Public       ,6,32,38,174,,626,800
02255000,KNOXVILLE INSTITUTE OF HAIR DESIGN      ,TN,37917-0000,Proprietary  ,3,40,43,97,,332,429
02257400,ARNOLD'S BEAUTY SCHOOL                  ,TN,38358-0000,Proprietary  ,1,14,15,49,,105,154
02263104,ANTHEM COLLEGE - ANTHEM CAREER COLLEGE -,TN,37214-2531,Proprietary  ,18,76,94,245,,793,1038
02275500,REUBEN-ALLEN COLLEGE                    ,TN,37922-0000,Proprietary  ,8,30,38,155,,350,505
02278700,MR WAYNES SCH OF UNISEX HAIR DESIGN     ,TN,38501-0000,Proprietary  ,4,5,9,41,,81,122
02293900,VOLUNTEER BEAUTY ACADEMY-NASHVILLE      ,TN,37115-2112,Proprietary  ,2,8,10,26,,82,108
02294000,VOLUNTEER BEAUTY ACADEMY-DYERSBURG      ,TN,38024-1622,Proprietary  ,2,12,14,35,,135,170
02326200,KAPLAN CAREER INSTITUTE                 ,TN,37212-5318,Proprietary  ,24,123,147,258,,1303,1561
02326300,MEDVANCE INSTITUTE                      ,TN,38501-4305,Proprietary  ,15,43,58,175,,430,605
02335900,VOLUNTEER BEAUTY ACADEMY-NASHVILLE      ,TN,37209-3033,Proprietary  ,6,18,24,77,,173,250
02539800,QUEEN CITY COLLEGE                      ,TN,37042-0000,Proprietary  ,6,49,55,86,,431,517
02540000,TENNESSEE ACADEMY OF COSMETOLOGY        ,TN,38133-0000,Proprietary  ,6,39,45,226,,486,712
02578200,NOSSI COLLEGE OF ART                    ,TN,37115-5138,Proprietary  ,7,20,27,405,,379,784
02595000,FAYETTEVILLE BEAUTY SCHOOL              ,TN,37334-2909,Proprietary  ,8,11,19,36,,85,121
02599710,VATTEROTT COLLEGE - MEMPHIS             ,TN,38132-1714,Proprietary  ,33,202,235,562,,2160,2722
02609204,VATTEROTT COLLEGE - VATTEROTT CAREER COL,TN,38133-4727,Proprietary  ,19,101,120,384,,1262,1646
02614200,MILLER MOTTE BUSINESS COLLEGE           ,TN,37040-6023,Proprietary  ,22,111,133,288,,1210,1498
02614203,MILLER - MOTTE TECHNICAL COLLEGE - CHATT,TN,37421-7220,Proprietary  ,20,85,105,328,,1141,1469
02614204,MILLER - MOTTE TECHNICAL COLLEGE - MADIS,TN,37072-1870,Proprietary  ,18,116,134,206,,820,1026
03001800,FREE WILL BAPTIST BIBLE COLLEGE         ,TN,37205-2498,Private      ,2,12,14,265,,195,460
03008800,FRANKLIN ACADEMY                        ,TN,37312-3939,Private      ,3,22,25,39,,158,197
03010606,VIRGINIA COLLEGE - SCH OF BUSNSS & HLTH ,TN,37411-5600,Proprietary  ,21,116,137,259,,1157,1416
03024900,TENNESSEE ACADEMY OF COSMETOLOGY        ,TN,38125-3442,Proprietary  ,8,38,46,210,,471,681
03026517,REMINGTON COLLEGE - MEMPHIS             ,TN,38132-2107,Private      ,14,76,90,671,,1950,2621
03061100,GENESIS CAREER COLLEGE OF LEBANON       ,TN,37087-2718,Proprietary  ,8,25,33,104,,316,420
03076405,BRYMAN SCHOOL OF ARIZONA (THE) - ANTHEM ,TN,38134-7345,Proprietary  ,20,136,156,239,,1072,1311
03079100,NORTH CENTRAL INSTITUTE                 ,TN,37042-3116,Proprietary  ,3,24,27,54,,275,329
03088800,"WATKINS COLLEGE OF ART, DESIGN & FILM   ",TN,37228-1306,Private      ,9,17,26,621,,388,1009
03126900,STYLES & PROFILES BEAUTY COLLEGE        ,TN,38375-2109,Proprietary  ,1,4,5,25,,51,76
03253300,PAUL MITCHELL THE SCHOOL MEMPHIS        ,TN,38133-4067,Proprietary  ,8,27,35,82,,164,246
03355400,RICHMONT GRADUATE UNIVERSITY            ,TN,37404-0000,Private      ,0,6,6,10,,293,303
03440300,BAPTIST MEMORIAL COLLEGE OF HEALTH      ,TN,38104-3104,Private      ,24,67,91,1354,,2941,4295
03480303,MEDVANCE INSTITUTE - NASHVILLE          ,TN,37203-1536,Proprietary  ,12,57,69,123,,694,817
03513500,WILLIAMSON CHRISTIAN COLLEGE            ,TN,37067-8237,Private      ,3,3,6,28,,82,110
03647300,NEW CONCEPTS SCHOOL OF COSMETOLOGY      ,TN,37311-7373,Proprietary  ,5,9,14,29,,105,134
03683300,INTERNATIONAL BARBER & STYLE COLLEGE    ,TN,37209-2205,Proprietary  ,5,39,44,57,,259,316
03701300,MEMPHIS INSTITUTE OF BARBERING          ,TN,38107-4334,Proprietary  ,20,57,77,251,,624,875
03774400,SHEAR ACADEMY                           ,TN,38555-4177,Proprietary  ,3,7,10,23,,99,122
03830300,SAE INSTITUTE OF TECHNOLOGY             ,TN,37203-4310,Proprietary  ,31,49,80,171,,281,452
03840300,OXFORD GRADUATE SCHOOL                  ,TN,37321-6736,Private      ,0,2,2,4,,40,44
03841300,CAREER BEAUTY COLLEGE                   ,TN,38464-3634,Proprietary  ,2,5,7,20,,61,81
03920300,INSTITUTE OF HAIR DESIGN                ,TN,38310-1801,Proprietary  ,2,6,8,24,,76,100
03930300,BUCHANAN BEAUTY COLLEGE                 ,TN,37160-2741,Proprietary  ,3,9,12,46,,107,153
03982300,VISIBLE SCHOOL - MUSIC AND WORSHIPS ARTS,TN,38104-5814,Private      ,3,3,6,165,,133,298
04035300,TENNESSEE CAREER INSTITUTE              ,TN,38401-6335,Proprietary  ,6,32,38,100,,292,392
04124100,ELITE COLLEGE OF COSMETOLOGY            ,TN,38351-1431,Proprietary  ,3,7,10,33,,74,107
04157200,LOVE BEAUTY SCHOOL                      ,TN,37355-2950,Proprietary  ,3,13,16,31,,92,123
04165000,MERIDIAN INSTITUTE OF SURGICAL ASSISTING,TN,37080-0758,Proprietary  ,2,59,61,11,,446,457
04174600,NASHVILLE BARBER AND STYLE ACADEMY      ,TN,37208-2826,Proprietary  ,6,14,20,77,,210,287
04210200,MID-SOUTH CHRISTIAN COLLEGE             ,TN,38118-3151,Private      ,2,13,15,41,,169,210
04213800,SALON PROFESSIONAL ACADEMY (THE)        ,TN,37214-2163,Proprietary  ,7,12,19,101,,144,245
04215200,VIBE BARBER COLLEGE                     ,TN,38107-2538,Proprietary  ,0,9,9,0,,9,9
04223900,MIND BODY INSTITUTE                     ,TN,37214-1012,Proprietary  ,1,13,14,1,,13,14
00353700,ABILENE CHRISTIAN UNIVERSITY            ,TX,79699-3701,Private      ,72,65,137,6504,,1783,8287
00353900,ALVIN COMMUNITY COLLEGE                 ,TX,77511-4807,Public       ,39,186,225,1816,,3387,5203
00354000,AMARILLO COLLEGE                        ,TX,79109-2446,Public       ,108,372,480,3965,,7298,11263
00354100,ANGELO STATE UNIVERSITY                 ,TX,76909-5069,Public       ,86,141,227,6786,,3458,10244
00354300,AUSTIN COLLEGE                          ,TX,75090-4440,Private      ,18,16,34,2335,,333,2668
00354400,AUSTIN PRESBYTERIAN THEOLOGICAL SEM     ,TX,78705-5797,Private      ,0,4,4,5,,170,175
00354500,BAYLOR UNIVERSITY                       ,TX,76798-7048,Private      ,438,177,615,26659,,5652,32311
00354600,COASTAL BEND COLLEGE                    ,TX,78102-2197,Public       ,59,100,159,1677,,2110,3787
00354900,BLINN COLLEGE                           ,TX,77833-4098,Public       ,245,221,466,15385,,6672,22057
00355300,CISCO JUNIOR COLLEGE                    ,TX,76437-9803,Public       ,50,124,174,2185,,2877,5062
00355400,CLARENDON COLLEGE                       ,TX,79226-0000,Public       ,40,70,110,657,,659,1316
00355600,COMMONWEALTH INST OF FUNERAL SVC        ,TX,77090-5918,Private      ,5,35,40,111,,574,685
00355700,CONCORDIA UNIVERSITY TEXAS              ,TX,78726-4141,Private      ,28,146,174,1882,,3034,4916
00355800,NORTH CENTRAL TEXAS COLLEGE             ,TX,76240-4699,Public       ,112,234,346,4316,,6175,10491
00356000,DALLAS BAPTIST UNIVERSITY               ,TX,75211-9299,Private      ,68,263,331,3934,,5050,8984
00356100,CEDAR VALLEY COLLEGE                    ,TX,75134-0000,Public       ,80,299,379,2561,,5821,8382
00356200,DALLAS THEOLOGICAL SEM                  ,TX,75204-0000,Private      ,0,36,36,51,,987,1038
00356300,DEL MAR COLLEGE                         ,TX,78404-3897,Public       ,167,398,565,5729,,8851,14580
00356400,EAST TEXAS BAPTIST UNIVERSITY           ,TX,75670-1423,Private      ,21,24,45,1775,,532,2307
00356500,TEXAS A&M UNIVERSITY - COMMERCE         ,TX,75429-3011,Public       ,96,343,439,6756,,8939,15695
00356800,FRANK PHILLIPS COLLEGE                  ,TX,79008-0000,Public       ,17,46,63,427,,605,1032
00357000,GRAYSON COUNTY COLLEGE                  ,TX,75020-8299,Public       ,77,234,311,2001,,4322,6323
00357100,HARDIN-SIMMONS UNIVERSITY               ,TX,79698-6050,Private      ,23,27,50,2394,,1116,3510
00357200,TRINITY VALLEY COMMUNITY COLLEGE        ,TX,75751-2734,Public       ,84,209,293,2843,,5156,7999
00357300,HILL COLLEGE                            ,TX,76645-2711,Public       ,24,102,126,1121,,1845,2966
00357301,HILL COLLEGE                            ,TX,76031-0000,Public       ,38,149,187,1166,,2387,3553
00357400,HOWARD COUNTY JUNIOR COLLEGE DISTRICT   ,TX,79720-0213,Public       ,36,107,143,1562,,2414,3976
00357500,HOWARD PAYNE UNIVERSITY                 ,TX,76801-2715,Private      ,27,12,39,1627,,444,2071
00357600,HOUSTON BAPTIST UNIVERSITY              ,TX,77074-3298,Private      ,110,149,259,6096,,4103,10199
00357700,HUSTON - TILLOTSON UNIVERSITY           ,TX,78702-2795,Private      ,15,62,77,1467,,1204,2671
00357800,UNIVERSITY OF THE INCARNATE WORD        ,TX,78209-6398,Private      ,102,298,400,7814,,7932,15746
00357900,JACKSONVILLE COLLEGE                    ,TX,75766-4759,Private      ,6,7,13,328,,285,613
00358000,KILGORE COLLEGE                         ,TX,75662-3299,Public       ,61,162,223,3467,,5182,8649
00358100,LAMAR UNIVERSITY-BEAUMONT               ,TX,77710-0042,Public       ,165,816,981,9133,,12669,21802
00358200,LAREDO COMMUNITY COLLEGE                ,TX,78040-4395,Public       ,175,131,306,6657,,4188,10845
00358300,LEE COLLEGE                             ,TX,77520-4796,Public       ,71,183,254,2105,,4454,6559
00358400,LETOURNEAU UNIVERSITY                   ,TX,75607-0000,Private      ,12,118,130,1753,,2695,4448
00358600,LUBBOCK CHRISTIAN UNIVERSITY            ,TX,79407-2099,Private      ,13,61,74,1716,,1671,3387
00358800,UNIVERSITY OF MARY HARDIN-BAYLOR        ,TX,76513-2599,Private      ,81,71,152,5245,,2015,7260
00359000,MCLENNAN COMMUNITY COLLEGE              ,TX,76708-1498,Public       ,85,249,334,4913,,8213,13126
00359100,MCMURRY UNIVERSITY                      ,TX,79697-0001,Private      ,19,32,51,1764,,836,2600
00359200,MIDWESTERN STATE UNIVERSITY             ,TX,76308-2099,Public       ,90,103,193,5281,,3472,8753
00359300,NAVARRO COLLEGE                         ,TX,75110-4818,Public       ,170,330,500,5330,,7310,12640
00359400,UNIVERSITY OF NORTH TEXAS               ,TX,76203-5017,Public       ,448,736,1184,35681,,23340,59021
00359500,OBLATE SCHOOL OF THEOLOGY               ,TX,78216-0000,Private      ,0,2,2,10,,84,94
00359600,ODESSA COLLEGE                          ,TX,79764-7127,Public       ,49,181,230,1721,,3014,4735
00359800,OUR LADY OF THE LAKE UNIVERSITY         ,TX,78207-4689,Private      ,45,161,206,3350,,4265,7615
00359900,UNIVERSITY OF TEXAS - PAN AMERICAN      ,TX,78541-2999,Public       ,335,392,727,21425,,11789,33214
00360000,PANOLA COLLEGE                          ,TX,75633-2397,Public       ,37,97,134,1204,,2313,3517
00360100,PARIS JR COLLEGE                        ,TX,75460-6298,Public       ,99,224,323,2296,,3627,5923
00360200,PAUL QUINN COLLEGE                      ,TX,75241-4398,Private      ,17,40,57,471,,827,1298
00360300,RANGER COLLEGE                          ,TX,76470-3298,Public       ,25,46,71,810,,934,1744
00360305,RANGER COLLEGE-STEPHENVILE BEAUTY COLLEG,TX,76401-5136,Public       ,4,2,6,83,,108,191
00360400,RICE UNIVERSITY                         ,TX,77251-1892,Private      ,114,122,236,11575,,3587,15162
00360600,SAM HOUSTON STATE UNIVERSITY            ,TX,77340-0000,Public       ,306,367,673,22882,,11256,34138
00360700,ALAMO CMTY CLG DISTRICT PROGRAM         ,TX,78207-0000,Public       ,46,115,161,2535,,4333,6868
00360800,ST PHILLIPS COLLEGE                     ,TX,78203-2098,Public       ,141,534,675,6142,,12304,18446
00360900,SAN JACINTO CLG-CENTRAL-NORTH-SOUTH     ,TX,77501-0000,Public       ,365,907,1272,12053,,18614,30667
00361000,SCHREINER UNIVERSITY                    ,TX,78028-5697,Private      ,18,17,35,1635,,534,2169
00361100,SOUTH PLAINS COLLEGE                    ,TX,79336-6504,Public       ,127,241,368,5291,,5920,11211
00361200,UNIV OF HOUSTON-DOWNTOWN                ,TX,77002-1001,Public       ,265,718,983,14005,,20679,34684
00361300,SOUTHERN METHODIST UNIVERSITY           ,TX,75275-0181,Private      ,107,194,301,9555,,6015,15570
00361400,SOUTHWEST TEXAS JR COLLEGE              ,TX,78801-6221,Public       ,97,130,227,2950,,2781,5731
00361500,TEXAS STATE UNIVERSITY--SAN MARCOS      ,TX,78666-4602,Public       ,552,413,965,39906,,16754,56660
00361600,SOUTHWESTERN ASSEMBLIES OF GOD UNIV     ,TX,75165-2397,Private      ,19,48,67,1753,,1328,3081
00361800,SOUTHWESTERN CHRISTIAN COLLEGE          ,TX,75160-3400,Private      ,5,5,10,239,,183,422
00361900,SOUTHWESTERN ADVENTIST UNIVERSITY       ,TX,76059-1922,Private      ,15,11,26,813,,482,1295
00362000,SOUTHWESTERN UNIVERSITY                 ,TX,78626-6111,Private      ,22,10,32,2876,,382,3258
00362100,ST EDWARDS UNIVERSITY                   ,TX,78704-0000,Private      ,76,95,171,6152,,3139,9291
00362300,ST MARY'S UNIV OF SAN ANTONIO           ,TX,78228-8500,Private      ,65,82,147,5580,,3754,9334
00362400,STEPHEN F AUSTIN STATE UNIVERSITY       ,TX,75962-0001,Public       ,237,178,415,16948,,5998,22946
00362500,SUL ROSS STATE UNIVERSITY               ,TX,79832-0113,Public       ,43,98,141,1842,,2036,3878
00362600,TARRANT COUNTY COLLEGE                  ,TX,76102-6599,Public       ,579,1830,2409,21868,,38190,60058
00362700,TEMPLE COLLEGE                          ,TX,76504-7435,Public       ,86,328,414,2630,,6703,9333
00362800,TEXARKANA COLLEGE                       ,TX,75599-0001,Public       ,46,162,208,1664,,3939,5603
00363000,PRAIRIE VIEW A&M UNIVERSITY             ,TX,77446-2967,Public       ,172,213,385,12062,,6855,18917
00363100,TARLETON STATE UNIVERSITY               ,TX,76402-0000,Public       ,183,265,448,10328,,8685,19013
00363200,TEXAS A&M UNIVERSITY                    ,TX,77843-1246,Public       ,799,367,1166,50639,,12820,63459
00363208,TEXAS A&M UNIVERSITY - HEALTH SCIENCE CE,TX,77807-3260,Public       ,21,43,64,1815,,2710,4525
00363400,TEXAS STATE TECHNICAL CLG AT WACO       ,TX,76705-1695,Public       ,77,198,275,3292,,4425,7717
00363500,TEXAS CHIROPRACTIC COLLEGE              ,TX,77505-1699,Private      ,2,7,9,22,,341,363
00363600,TEXAS CHRISTIAN UNIVERSITY              ,TX,76129-0001,Private      ,177,135,312,14881,,5054,19935
00363700,JARVIS CHRISTIAN COLLEGE                ,TX,75765-1470,Private      ,11,33,44,685,,302,987
00363800,TEXAS COLLEGE                           ,TX,75702-4500,Private      ,21,42,63,1213,,1286,2499
00363900,TEXAS A&M UNIVERSITY-KINGSVILLE         ,TX,78363-8203,Public       ,163,199,362,11061,,8165,19226
00364100,TEXAS LUTHERAN UNIVERSITY               ,TX,78155-5999,Private      ,29,13,42,2194,,362,2556
00364200,TEXAS SOUTHERN UNIVERSITY               ,TX,77004-4598,Public       ,217,426,643,11816,,15022,26838
00364400,TEXAS TECH UNIVERSITY                   ,TX,79409-2011,Public       ,492,340,832,30706,,13128,43834
00364500,TEXAS WESLEYAN UNIVERSITY               ,TX,76105-1536,Private      ,27,98,125,2069,,4614,6683
00364600,TEXAS WOMAN'S UNIVERSITY                ,TX,76204-5587,Public       ,125,370,495,10367,,14963,25330
00364700,TRINITY UNIVERSITY                      ,TX,78212-7200,Private      ,50,32,82,3988,,1155,5143
00364800,TYLER JUNIOR COLLEGE                    ,TX,75701-3436,Public       ,153,277,430,8874,,8425,17299
00365100,UNIVERSITY OF DALLAS                    ,TX,75062-4799,Private      ,42,86,128,2620,,2067,4687
00365200,UNIVERSITY OF HOUSTON                   ,TX,77204-2010,Public       ,579,852,1431,37890,,32034,69924
00365400,UNIVERSITY OF ST THOMAS                 ,TX,77006-4626,Private      ,36,136,172,1968,,3311,5279
00365600,UNIVERSITY OF TEXAS-ARLINGTON           ,TX,76019-0000,Public       ,378,1445,1823,26647,,33670,60317
00365800,UNIVERSITY OF TEXAS-AUSTIN              ,TX,78713-7758,Public       ,548,578,1126,52026,,23166,75192
00365900,UT HEALTH CENTER-SAN ANTONIO            ,TX,78229-3900,Public       ,38,142,180,1706,,4806,6512
00366100,UNIVERSITY OF TEXAS-EL PASO             ,TX,79968-0629,Public       ,363,544,907,18960,,15813,34773
00366200,VICTORIA COLLEGE                        ,TX,77901-4494,Public       ,57,167,224,1995,,3346,5341
00366300,WAYLAND BAPTIST UNIVERSITY              ,TX,79072-6998,Private      ,31,310,341,1601,,4920,6521
00366400,WEATHERFORD COLLEGE                     ,TX,76086-5699,Public       ,48,143,191,2838,,4222,7060
00366500,WEST TEXAS A&M UNIVERSITY               ,TX,79016-0000,Public       ,92,157,249,6774,,4570,11344
00366800,WHARTON COUNTY JR COLLEGE               ,TX,77488-3298,Public       ,90,177,267,3748,,4010,7758
00366900,WILEY COLLEGE                           ,TX,75670-5199,Private      ,15,42,57,1363,,936,2299
00400300,CENTRAL TEXAS COLLEGE                   ,TX,76540-4199,Public       ,165,2046,2211,3662,,23388,27050
00407221,NORTHWOOD UNIVERSITY                    ,TX,75104-0000,Private      ,2,37,39,758,,901,1659
00445300,EL CENTRO COLLEGE                       ,TX,75202-3604,Public       ,140,741,881,5895,,14871,20766
00450303,EVEREST COLLEGE - FORT WORTH SOUTH      ,TX,76115-1407,Proprietary  ,27,161,188,318,,1433,1751
00481102,EVEREST INSTITUTE - EVEREST COLLEGE     ,TX,76011-6630,Proprietary  ,28,167,195,331,,1315,1646
00494900,BAYLOR COLLEGE OF MEDICINE              ,TX,77030-0000,Private      ,28,43,71,1125,,2388,3513
00495100,UNIV OF TEXAS HEALTH SCIENCE CENTER     ,TX,77225-0000,Public       ,28,126,154,1321,,5151,6472
00495200,UNIV OF TEXAS MEDICAL BRANCH            ,TX,77550-0000,Public       ,25,93,118,871,,3274,4145
00497200,GALVESTON COLLEGE                       ,TX,77550-7447,Public       ,36,87,123,1360,,2284,3644
00497700,SOUTH TEXAS COLLEGE OF LAW              ,TX,77002-0000,Private      ,5,34,39,117,,2007,2124
00520307,REMINGTON COLLEGE - DALLAS CAMPUS       ,TX,75041-9935,Proprietary  ,0,0,0,86,,266,352
00660600,BAPTIST HS SCHOOL OF HEALTH PROFESSIONS ,TX,78229-3234,Proprietary  ,5,56,61,283,,1543,1826
00661200,COVENANT SCH OF NSG & ALLIED HEALTH     ,TX,79410-0000,Private      ,4,11,15,242,,588,830
00666100,ANGELINA COLLEGE                        ,TX,75902-0000,Public       ,85,204,289,2737,,4481,7218
00694100,DALLAS CHRISTIAN COLLEGE                ,TX,75234-7229,Private      ,16,31,47,456,,748,1204
00709600,COLLEGE OF THE MAINLAND                 ,TX,77591-2499,Public       ,44,180,224,1534,,3810,5344
00728700,BRAZOSPORT COLLEGE                      ,TX,77566-3199,Public       ,64,110,174,1590,,2408,3998
00732907,ITT TECHNICAL INSTITUTE                 ,TX,77063-3751,Proprietary  ,36,154,190,636,,2046,2682
00732913,ITT TECHNICAL INSTITUTE                 ,TX,76011-3919,Proprietary  ,51,236,287,536,,1997,2533
00732975,ITT TECHNICAL INSTITUTE                 ,TX,78249-3303,Proprietary  ,32,140,172,456,,1528,1984
00754805,WESTWOOD COLLEGE OF TECHNOLOGY          ,TX,77074-0000,Proprietary  ,0,0,0,66,,287,353
00793804,LINCOLN COLLEGE OF TECHNOLOGY - GRAND PR,TX,75052-7605,Proprietary  ,216,115,331,1293,,877,2170
00849800,MIMS CLASSIC BEAUTY COLLEGE             ,TX,78216-0000,Proprietary  ,0,12,12,48,,142,190
00850300,MOUNTAIN VIEW COLLEGE                   ,TX,75211-6599,Public       ,129,402,531,4715,,8062,12777
00850400,RICHLAND COLLEGE                        ,TX,75243-2199,Public       ,196,598,794,6766,,11552,18318
00851000,EASTFIELD COLLEGE                       ,TX,75150-2099,Public       ,170,513,683,5537,,10451,15988
00907905,EVEREST COLLEGE                         ,TX,75206-5209,Proprietary  ,46,213,259,728,,2646,3374
00908200,INTERNATIONAL BUSINESS COLLEGE          ,TX,79903-0000,Proprietary  ,20,52,72,174,,565,739
00916300,SAN ANTONIO COLLEGE                     ,TX,78212-4299,Public       ,301,834,1135,14388,,21996,36384
00922500,TEXAS STATE TECHNICAL COLLEGE  HARLINGEN,TX,78550-3697,Public       ,119,231,350,4533,,4558,9091
00946600,KAPLAN COLLEGE                          ,TX,78216-1899,Proprietary  ,45,152,197,406,,1594,2000
00946607,KAPLAN COLLEGE - MCALLEN                ,TX,78503-1622,Proprietary  ,45,75,120,487,,702,1189
00946609,KAPLAN COLLEGE - CAREER CENTERS OF TEXAS,TX,78416-9900,Proprietary  ,19,104,123,262,,963,1225
00946610,KAPLAN COLLEGE - CAREER CENTERS OF TEXAS,TX,76103-2310,Proprietary  ,18,111,129,241,,1122,1363
00954900,WESTERN TEXAS COLLEGE                   ,TX,79549-9501,Public       ,7,33,40,688,,574,1262
00965100,TEXAS A&M INTERNATIONAL UNIVERSITY      ,TX,78041-1900,Public       ,117,139,256,6656,,3684,10340
00974100,UNIVERSITY OF TEXAS AT DALLAS           ,TX,75083-0000,Public       ,187,363,550,13260,,11988,25248
00976800,UNIVERSITY OF NORTH TEXAS HEALTH SCIENCE,TX,76107-2699,Public       ,10,61,71,792,,3390,4182
00979700,MIDLAND COLLEGE                         ,TX,79705-6397,Public       ,48,96,144,1818,,2803,4621
00982802,EVEREST INSTITUTE- AUSTIN               ,TX,78754-0000,Proprietary  ,47,175,222,457,,1433,1890
00993000,UNIVERSITY OF TEXAS-PERMIAN BASIN       ,TX,79762-0001,Public       ,50,179,229,2388,,3621,6009
00993200,TEXAS STATE TECH CLG-WEST TEXAS         ,TX,79556-4108,Public       ,21,48,69,492,,806,1298
00993201,TEXAS STATE TECH COLLEGE-ABILENE        ,TX,79601-0000,Public       ,7,36,43,377,,899,1276
00993204,TEXAS STATE TECH CLG-BRECKENRIDGE       ,TX,76424-0000,Public       ,2,6,8,72,,147,219
00993205,TEXAS STATE TECH COLLEGE-BROWNWOOD      ,TX,76801-0000,Public       ,4,11,15,119,,367,486
01001900,UNIV OF TEXAS SOUTHWESTERN MED CTR      ,TX,75390-9096,Public       ,20,80,100,472,,2720,3192
01005700,AMERICAN COMMERCIAL COLLEGE             ,TX,79602-1399,Proprietary  ,0,0,0,15,,60,75
01005900,AMERICAN COMMERCIAL COLLEGE             ,TX,79761-0000,Proprietary  ,3,20,23,42,,175,217
01005901,AMERICAN COMMERCIAL COLLEGE - AMERICAN C,TX,76310-2303,Proprietary  ,3,37,40,88,,402,490
01006000,VERNON COLLEGE                          ,TX,76384-4092,Public       ,35,122,157,1418,,2890,4308
01011500,UNIVERSITY OF TEXAS-SAN ANTONIO         ,TX,78249-0600,Public       ,502,525,1027,36830,,20455,57285
01013000,WADE COLLEGE                            ,TX,75207-3199,Proprietary  ,13,15,28,252,,444,696
01038700,EL PASO COMMUNITY COLLEGE               ,TX,79998-0000,Public       ,390,773,1163,17258,,18012,35270
01050900,HALLMARK COLLEGE OF AERONAUTICS         ,TX,78214-0000,Proprietary  ,30,141,171,333,,1403,1736
01062400,LIGHTHOUSE CAREER INSTITUTE             ,TX,75231-5033,Private      ,1,4,5,12,,70,82
01063300,HOUSTON COMMUNITY COLLEGE               ,TX,77002-0000,Public       ,852,3279,4131,28111,,61858,89969
01067400,TEXAS TECH U HEALTH SCIENCES CENTER     ,TX,79430-0000,Public       ,29,129,158,1700,,5935,7635
01076100,DALLAS INSTITUTE OF FUNERAL SERVICE     ,TX,75227-4314,Private      ,7,44,51,122,,542,664
01114500,LONE STAR COLLEGE SYSTEM                ,TX,77073-3499,Public       ,804,2454,3258,25847,,47134,72981
01116100,TEXAS A&M UNIV CORPUS CHRISTI           ,TX,78412-5599,Public       ,210,260,470,13134,,7296,20430
01116300,UNIVERSITY OF TEXAS AT TYLER            ,TX,75799-6699,Public       ,83,224,307,5887,,6765,12652
01171100,UNIVERSITY OF HOUSTON-CLEAR LAKE        ,TX,77058-1002,Public       ,71,275,346,2936,,9032,11968
01201500,AUSTIN COMMUNITY COLLEGE                ,TX,78752-4390,Public       ,471,1410,1881,18551,,27428,45979
01202000,VICTORIA BEAUTY COLLEGE                 ,TX,77901-6233,Proprietary  ,2,14,16,52,,181,233
01226800,BALDWIN BEAUTY SCHOOL #5                ,TX,78704-4785,Proprietary  ,17,53,70,193,,497,690
01229700,LAREDO BEAUTY COLLEGE                   ,TX,78040-1051,Proprietary  ,13,23,36,166,,287,453
01248300,COSMETOLOGY CAREER CENTER-A PAUL MITCHEL,TX,75006-2567,Proprietary  ,84,128,212,573,,817,1390
01248800,INTERNATIONAL BEAUTY COLLEGE NO 3       ,TX,75040-0000,Proprietary  ,1,12,13,20,,108,128
01276400,METROPLEX BEAUTY SCHOOL                 ,TX,75149-0000,Proprietary  ,0,17,17,36,,156,192
01293000,CHARLES & SUE'S SCH OF HAIR DESIGN      ,TX,77801-0000,Proprietary  ,3,10,13,97,,143,240
01293200,TINT SCHOOL OF MAKEUP & COSMETOLOGY     ,TX,75061-4235,Proprietary  ,6,18,24,54,,169,223
01300300,NEILSON BEAUTY COLLEGE                  ,TX,75208-4637,Proprietary  ,0,10,10,51,,143,194
01301600,OGLE SCHOOL HAIR SKIN NAILS             ,TX,76013-7400,Proprietary  ,50,116,166,467,,1043,1510
01303912,SOUTH UNIVERSITY - THE ART INSTITUTE OF ,TX,75231-5993,Proprietary  ,84,106,190,1855,,1676,3531
01303915,SOUTH UNIVERSITY - AUSTIN               ,TX,78729-8101,Proprietary  ,13,89,102,243,,779,1022
01323100,UNIVERSITY OF HOUSTON-VICTORIA          ,TX,77901-5731,Public       ,62,150,212,2751,,4689,7440
02058600,CONLEE'S COLLEGE OF COSMETOLOGY         ,TX,78028-0000,Proprietary  ,2,3,5,25,,65,90
02074100,CAPITOL CITY TRADE & TECHNICAL SCH      ,TX,78704-0000,Proprietary  ,18,56,74,179,,589,768
02077400,NORTH LAKE COLLEGE                      ,TX,75038-0000,Public       ,112,386,498,3483,,6794,10277
02081400,ARLINGTON BAPTIST COLLEGE               ,TX,76012-0000,Private      ,3,23,26,287,,421,708
02093600,SOUTHWEST SCHOOL OF ELECTRONIC          ,TX,78735-0000,Proprietary  ,0,7,7,41,,110,151
02098300,WESTERN TECHNICAL COLLEGE               ,TX,79927-2105,Proprietary  ,68,200,268,901,,1913,2814
02100200,BROOKHAVEN COLLEGE                      ,TX,75244-0000,Public       ,114,403,517,3365,,7650,11015
02113610,AMERICAN INTERCONTINENTAL UNIV - HOUSTON,TX,77042-4516,Proprietary  ,14,130,144,266,,1477,1743
02116008,SANFORD-BROWN COLLEGE - HOUSTON         ,TX,77042-8900,Proprietary  ,35,139,174,476,,1508,1984
02116012,SANFORD-BROWN COLLEGE - HOUSTON NORTH LO,TX,77008-1058,Proprietary  ,3,22,25,111,,461,572
02117100,ART INSTITUTE OF HOUSTON                ,TX,77056-0000,Proprietary  ,255,424,679,5511,,6081,11592
02119200,COURT REPORTING INSTITUTE OF DALLAS     ,TX,75247-6913,Proprietary  ,4,22,26,58,,532,590
02119202,COURT REPORTING INSTIUTE OF DALLAS - COU,TX,77040-6315,Proprietary  ,0,0,0,10,,73,83
02128302,INSTITUTE FOR BUSINESS & TECHNOLOGY - LA,TX,78230-2520,Proprietary  ,19,53,72,151,,463,614
02136800,AMERICAN COMMERCIAL COLLEGE             ,TX,76904-0000,Proprietary  ,7,17,24,71,,210,281
02144800,VET TECH INSTITUTE OF HOUSTON           ,TX,77027-9881,Proprietary  ,29,34,63,439,,474,913
02176100,PIPO ACADEMY OF HAIR DESIGN             ,TX,79903-0000,Proprietary  ,3,9,12,56,,146,202
02200800,AMERICAN COMMERCIAL COLLEGE             ,TX,79411-0000,Proprietary  ,0,0,0,6,,5,11
02218300,SOUTHWEST SCHOOL OF BUSINESS & TECHNICAL,TX,78221-0000,Proprietary  ,17,50,67,147,,481,628
02218305,SOUTHWEST SCHOOL OF BUSINESS AND TECHNIC,TX,78501-6053,Proprietary  ,9,15,24,62,,168,230
02218306,SOUTHWEST SCHOOL OF BUSINESS AND TECHNIC,TX,78413-2045,Proprietary  ,1,7,8,54,,194,248
02224600,TRI-STATE BEAUTY SCHOOL #1              ,TX,79915-0000,Proprietary  ,6,35,41,117,,388,505
02228400,TEXAS AERO TECHNOLOGY                   ,TX,75209-0000,Proprietary  ,0,0,0,0,,1,1
02230500,OGLE SCHOOL HAIR SKIN NAILS             ,TX,76132-3638,Proprietary  ,37,143,180,417,,1190,1607
02230600,OGLE SCHOOL HAIR SKIN NAILS             ,TX,76053-4650,Proprietary  ,28,57,85,239,,560,799
02239100,CENTRAL TEXAS BEAUTY COLLEGE #2         ,TX,78664-4204,Proprietary  ,16,45,61,117,,420,537
02248200,MILAN INSTITUTE OF COSMETOLOGY          ,TX,79103-0000,Proprietary  ,76,300,376,729,,2054,2783
02254800,TEXAS VOCATIONAL SCHOOLS                ,TX,77901-0000,Proprietary  ,6,22,28,63,,192,255
02259400,AMBERTON UNIVERSITY                     ,TX,75041-0000,Private      ,0,30,30,41,,503,544
02261300,EVEREST INSTITUTE                       ,TX,78213-3841,Proprietary  ,29,172,201,303,,1241,1544
02261302,EVEREST INSTITUTE - HOUSTON GREENSPOINT ,TX,77060-3249,Proprietary  ,32,183,215,388,,1547,1935
02261303,EVEREST INSTITUTE - HOUSTON HOBBY       ,TX,77087-2737,Proprietary  ,21,161,182,323,,1238,1561
02267100,EXPOSITO SCHOOL OF HAIR DESIGN          ,TX,79109-0000,Proprietary  ,4,18,22,48,,101,149
02276000,FRANKLIN BEAUTY SCHOOL #2               ,TX,77021-0000,Proprietary  ,2,20,22,135,,420,555
02285900,UNIVERSITY OF COSMETOLOGY ARTS&SCI      ,TX,78504-0000,Proprietary  ,29,69,98,270,,488,758
02294800,CAPITOL CITY CAREERS                    ,TX,78745-0000,Proprietary  ,3,36,39,48,,281,329
02298501,EVEREST COLLEGE- FORT WORTH             ,TX,76137-2472,Proprietary  ,24,123,147,314,,1386,1700
02305300,PARKER COLLEGE OF CHIROPRACTIC          ,TX,75229-0000,Private      ,5,46,51,121,,1395,1516
02306700,FORT WORTH BEAUTY SCHOOL                ,TX,76116-3299,Proprietary  ,3,52,55,119,,495,614
02312200,TEXAS SCHOOL OF BUSINESS                ,TX,77073-6032,Proprietary  ,22,137,159,379,,1427,1806
02312201,TEXAS SCHOOL OF BUSINESS - SOUTHWEST CAM,TX,77057-5914,Proprietary  ,0,0,0,28,,108,136
02312202,TEXAS SCHOOL OF BUSINESS - FRIENDSWOOD C,TX,77546-8938,Proprietary  ,10,47,57,109,,393,502
02312203,TEXAS SCHOOL OF BUSINESS - EAST CAMPUS  ,TX,77029-1916,Proprietary  ,0,0,0,29,,77,106
02313901,WESTWOOD COLLEGE - DALLAS               ,TX,75243-0000,Proprietary  ,5,42,47,159,,693,852
02315400,NORTHEAST TEXAS COMMUNITY COLLEGE       ,TX,75456-0000,Public       ,31,124,155,1867,,2675,4542
02318200,"KD STUDIO, ACTOR'S CONSERVATORY         ",TX,75207-2111,Proprietary  ,11,20,31,208,,345,553
02320200,HOUSTON GRADUATE SCHOOL OF THEOLOGY     ,TX,77092-0000,Private      ,0,13,13,20,,356,376
02326000,SAN ANTONIO BEAUTY COLLEGE NO 3         ,TX,78217-0000,Proprietary  ,5,18,23,100,,197,297
02331200,BAPTIST MISSIONARY ASSN THEOL SEM       ,TX,75766-0000,Private      ,0,5,5,10,,104,114
02331300,INTERACTIVE LEARNING SYSTEMS            ,TX,77502-1201,Proprietary  ,2,57,59,48,,353,401
02331301,INTERACTIVE LEARNING SYSTEMS            ,TX,77081-0000,Proprietary  ,35,191,226,153,,895,1048
02331304,INTERACTIVE LEARNING SYSTEMS            ,TX,77060-0000,Proprietary  ,5,51,56,37,,336,373
02341300,PALO ALTO COLLEGE                       ,TX,78224-0000,Public       ,135,334,469,6036,,8153,14189
02348500,LAMAR STATE COLLEGE-PORT ARTHUR         ,TX,77640-0000,Public       ,29,91,120,1316,,2534,3850
02357700,PAUL MITCHELL THE SCHOOL                ,TX,77043-3412,Proprietary  ,22,75,97,481,,990,1471
02358200,LAMAR STATE COLLEGE-ORANGE              ,TX,77630-0000,Public       ,23,90,113,1069,,2354,3423
02361400,COLLIN COUNTY COMMUNITY COLLEGE         ,TX,75071-0000,Public       ,312,724,1036,9471,,14830,24301
02362000,UNIVERSAL TECHNICAL INSTITUTE           ,TX,77073-0000,Proprietary  ,335,467,802,5614,,4738,10352
02362800,AUSTIN GRADUATE SCHOOL OF THEOLOGY      ,TX,78752-1333,Private      ,0,5,5,18,,134,152
02521200,ARLINGTON CAREER INSTITUTE              ,TX,75050-0000,Proprietary  ,7,46,53,75,,462,537
02521800,SEGUIN BEAUTY SCHOOL                    ,TX,78155-0000,Proprietary  ,8,10,18,63,,132,195
02527500,HOUSTON TRAINING SCHOOLS                ,TX,77029-0000,Proprietary  ,21,129,150,254,,1192,1446
02530700,SEBRING CAREER SCHOOLS                  ,TX,77083-1510,Proprietary  ,5,16,21,34,,136,170
02548800,SOUTH TEXAS VO-TECH INSTITUTE           ,TX,78596-0000,Proprietary  ,13,31,44,260,,383,643
02548802,SOUTH TEXAS VOCATIONAL TECHNICAL INSTITU,TX,78520-8710,Proprietary  ,17,22,39,258,,362,620
02549400,SOUTH TEXAS VO-TECH INSTITUTE           ,TX,78501-0000,Proprietary  ,34,46,80,353,,497,850
02549402,SOUTH TEXAS VOCATIONAL TECHNICAL INSTITU,TX,78416-1141,Proprietary  ,12,53,65,190,,605,795
02555400,UNIV OF TX MD ANDERSON CANCER CTR       ,TX,77030-0000,Public       ,3,24,27,275,,905,1180
02567200,OFFICE CAREER CENTER                    ,TX,76180-0000,Proprietary  ,0,0,0,0,,1,1
02568100,TEXAS BARBER COLLEGE                    ,TX,77063-3949,Proprietary  ,12,70,82,166,,713,879
02568101,TEXAS BARBER COLLEGES & HAIRSTYLING SCHO,TX,75228-3841,Proprietary  ,10,38,48,143,,514,657
02568106,TEXAS BARBER COLLEGES & HAIRSTYLING SCHO,TX,77009-0000,Proprietary  ,7,36,43,123,,421,544
02568107,TEXAS BARBER COLLEGES & HAIRSTYLING SCHO,TX,77063-3951,Proprietary  ,8,25,33,122,,443,565
02568108,TEXAS BARBER COLLEGES & HAIRSTYLING SCHO,TX,75241-1327,Proprietary  ,15,53,68,142,,583,725
02568109,TEXAS BARBER COLLEGES & HAIRSTYLING SCHO,TX,77301-4407,Proprietary  ,2,15,17,41,,135,176
02569300,LE CORDON BLEU COLLEGE OF CULINARY ARTS ,TX,78758-3647,Proprietary  ,108,366,474,1573,,3426,4999
02572000,COMPUTER CAREER CENTER                  ,TX,79925-2021,Proprietary  ,88,268,356,730,,2091,2821
02572004,COMPUTER CAREER CENTER - AMARILLO CAMPUS,TX,79101-2404,Proprietary  ,16,94,110,159,,578,737
02572005,COMPUTER CAREER CENTER - LUBBOCK CAMPUS ,TX,79414-3517,Proprietary  ,16,105,121,195,,780,975
02572008,VISTA COLLEGE - BEAUMONT                ,TX,77701-3717,Proprietary  ,21,130,151,133,,785,918
02572009,VISTA COLLEGE - LONGVIEW                ,TX,75604-1905,Proprietary  ,7,101,108,158,,966,1124
02572011,VISTA COLLEGE - KILLEEN                 ,TX,76541-7436,Proprietary  ,17,153,170,180,,1231,1411
02591100,CAREER POINT COLLEGE                    ,TX,78201-2027,Proprietary  ,47,426,473,372,,2848,3220
02591900,KAPLAN COLLEGE                          ,TX,79907-1525,Proprietary  ,45,150,195,514,,1476,1990
02591905,KAPLAN COLLEGE - BROWNSVILLE            ,TX,78521-9905,Proprietary  ,17,68,85,248,,649,897
02596400,REDSTONE COLLEGE - LOS ANGELES          ,TX,77061-0000,Proprietary  ,13,48,61,189,,455,644
02596600,ATI-CAREER TRAINING CENTER              ,TX,75220-4443,Proprietary  ,0,0,0,44,,160,204
02596601,ATI CAREER TRAINING CENTER - RICHARDSON ,TX,75081-1948,Proprietary  ,0,0,0,15,,52,67
02596602,ATI CAREER TRAINING CENTER - DALLAS (STE,TX,75247-6103,Proprietary  ,0,0,0,74,,200,274
02600200,OCEAN CORPORATION (THE)                 ,TX,77099-3479,Proprietary  ,23,94,117,243,,1093,1336
02604700,CENTER FOR ADVANCED LEGAL STUDIES       ,TX,77098-4151,Proprietary  ,5,73,78,54,,562,616
02606202,EVEREST COLLEGE - EVEREST INSTITUTE - BI,TX,77036-8014,Proprietary  ,49,262,311,476,,2069,2545
02615000,SANFORD-BROWN COLLEGE                   ,TX,75247-6931,Proprietary  ,37,163,200,438,,1796,2234
03009400,SW SCH BUS & TECH CAREERS               ,TX,78212-2840,Proprietary  ,10,28,38,60,,233,293
03010604,VIRGINIA COLLEGE - VIRGINIA COLLEGE AT A,TX,78723-0000,Proprietary  ,3,35,38,182,,816,998
03011800,UNIVERSITY OF COSMETOLOGY ARTS & SCIENCE,TX,78226-1160,Proprietary  ,4,13,17,110,,197,307
03019800,PCI HEALTH TRAINING CENTER              ,TX,75247-4720,Proprietary  ,19,84,103,332,,1011,1343
03019801,PCI HEALTH TRAINING CENTER - RICHARDSON ,TX,75081-2321,Proprietary  ,27,53,80,55,,126,181
03021500,SW SCH BUS & TECH CAREERS               ,TX,78852-4859,Proprietary  ,12,18,30,214,,271,485
03025000,TEXAS COLLEGE OF COSMETOLOGY            ,TX,79605-2001,Proprietary  ,12,46,58,98,,347,445
03025001,TEXAS COLLEGE OF COSMETOLOGY - SAN ANGEL,TX,76903-4708,Proprietary  ,2,6,8,55,,107,162
03026500,REMINGTON COLLEGE - HOUSTON CAMPUS      ,TX,77082-1849,Private      ,281,1091,1372,2110,,6776,8886
03026501,REMINGTON COLLEGE - NORTH HOUSTON CAMPUS,TX,77067-1849,Private      ,12,50,62,225,,885,1110
03026506,REMINGTON COLLEGE - FT. WORTH CAMPUS    ,TX,76112-1280,Private      ,32,115,147,357,,1212,1569
03028800,CIRCLE J BEAUTY SCHOOL                  ,TX,77587-3714,Proprietary  ,6,42,48,66,,244,310
03030608,UTAH COLLEGE OF MASSAGE THERAPY - TEXAS ,TX,75801-4848,Proprietary  ,24,47,71,171,,370,541
03030609,UTAH COLLEGE OF MASSAGE THERAPY - TEXAS ,TX,77040-6307,Proprietary  ,19,52,71,178,,540,718
03031408,INTERNATIONAL ACADEMY OF DESIGN & TECHNO,TX,78229-2263,Proprietary  ,11,41,52,273,,654,927
03032300,SCHOOL OF AUTOMOTIVE MACHINISTS         ,TX,77055-1803,Proprietary  ,12,23,35,199,,441,640
03035200,TINT SCHOOL OF MAKEUP & COSMETOLOGY     ,TX,75229-3734,Proprietary  ,15,53,68,160,,487,647
03035300,SOUTHERN CAREERS INSTITUTE              ,TX,78704-5252,Proprietary  ,226,854,1080,1150,,3896,5046
03035301,SOUTHERN CAREERS INSTITUTE-PHARR        ,TX,78577-2118,Proprietary  ,17,94,111,148,,417,565
03035302,SOUTHERN CAREERS INSTITUTE - CORPUS CHRI,TX,78414-2904,Proprietary  ,17,101,118,173,,690,863
03035303,SOUTHERN CAREERS INSTITUTE - SAN ANTONIO,TX,78221-4351,Proprietary  ,2,20,22,61,,272,333
03035305,SOUTHERN CAREERS INSTITUTE - BROWNSVILLE,TX,78520-8680,Proprietary  ,5,7,12,87,,138,225
03035306,SOUTHERN CAREERS INSTITUTE - HARLINGEN  ,TX,78550-7911,Proprietary  ,5,7,12,89,,160,249
03035307,SOUTHERN CAREERS INSTITUTE - CORPUS CHRI,TX,78410-1609,Proprietary  ,0,0,0,14,,44,58
03035308,SOUTHERN CAREERS INSTITUTE - SAN ANTONIO,TX,78238-4114,Proprietary  ,33,179,212,125,,609,734
03061800,STAR COLLEGE OF COSMETOLOGY             ,TX,75702-8214,Proprietary  ,11,16,27,161,,381,542
03064600,UNIVERSITY OF TEXAS AT BROWNSVILLE      ,TX,78520-4993,Public       ,132,216,348,9380,,8671,18051
03075400,ICC TECHNICAL INSTITUTE                 ,TX,77004-2930,Private      ,1,18,19,101,,315,416
03076403,BRYMAN SCHOOL OF ARIZONA (THE) - ANTHEM ,TX,75038-4201,Proprietary  ,17,41,58,107,,339,446
03079201,WESTWOOD COLLEGE OF TECHNOLOGY          ,TX,76180-0000,Proprietary  ,0,0,0,13,,32,45
03103400,SOUTH TEXAS COLLEGE                     ,TX,78501-6699,Public       ,547,710,1257,16528,,13764,30292
03108700,ROYAL BEAUTY CAREERS                    ,TX,77069-4611,Proprietary  ,7,49,56,151,,544,695
03115800,KAPLAN COLLEGE                          ,TX,78238-4203,Proprietary  ,34,140,174,346,,1387,1733
03115802,KAPLAN COLLEGE - LAREDO                 ,TX,78041-6181,Proprietary  ,19,67,86,258,,517,775
03115803,KAPLAN COLLEGE-BEAUMONT                 ,TX,77701-3706,Proprietary  ,15,80,95,170,,808,978
03115804,KAPLAN COLLEGE - LUBBOCK                ,TX,79401-2601,Proprietary  ,21,83,104,171,,636,807
03128100,COLLEGE OF HEALTH CARE PROFESSIONS (THE),TX,77092-8108,Proprietary  ,82,328,410,896,,3200,4096
03144300,NATIONAL BEAUTY COLLEGE                 ,TX,75043-4046,Proprietary  ,7,16,23,37,,116,153
03153300,AMER COLL OF ACUPUNCTURE & O.M.         ,TX,77063-4104,Proprietary  ,1,9,10,25,,189,214
03156400,ACADEMY OF ORIENTAL MEDICINE AT AUSTIN  ,TX,78757-1132,Proprietary  ,5,15,20,69,,380,449
03159300,ARLINGTON MEDICAL INSTITUTE             ,TX,76011-0000,Proprietary  ,10,34,44,220,,548,768
03170300,TEXAS A&M UNIVERSITY-TEXARKANA          ,TX,75501-0000,Public       ,24,86,110,1464,,2444,3908
03179500,TEXAS HEALTH AND SCIENCE UNIVERSITY     ,TX,78704-6748,Proprietary  ,11,36,47,36,,208,244
03237400,FARIS COMPUTER SCHOOL                   ,TX,77627-3829,Proprietary  ,0,4,4,9,,31,40
03272300,KAPLAN COLLEGE                          ,TX,75234-7288,Proprietary  ,37,160,197,379,,1750,2129
03272301,KAPLAN COLLEGE - MIDLAND                ,TX,79703-5531,Proprietary  ,0,2,2,57,,193,250
03272303,KAPLAN COLLEGE - ARLINGTON              ,TX,76010-8121,Proprietary  ,30,132,162,339,,1255,1594
03275300,TOUCH OF CLASS SCHOOL OF COSM           ,TX,75402-6314,Proprietary  ,11,42,53,67,,195,262
03276300,ACADEMY OF HAIR DESIGN                  ,TX,75901-4900,Proprietary  ,6,39,45,95,,344,439
03277300,ACADEMY OF HAIR DESIGN                  ,TX,77701-4650,Proprietary  ,1,21,22,59,,239,298
03303300,NORTHWEST EDUCATIONAL CENTER            ,TX,77092-7055,Proprietary  ,12,82,94,89,,441,530
03371300,TONI&GUY HAIRDRESSING ACADEMY           ,TX,75006-2351,Proprietary  ,11,20,31,163,,264,427
03372300,NORTHWEST VISTA COLLEGE                 ,TX,78251-4217,Public       ,206,414,620,10735,,11891,22626
03396500,TEXAS STATE TECHNICAL COLG/MARSHALL     ,TX,75672-7402,Public       ,16,49,65,472,,730,1202
03400300,CAREER QUEST                            ,TX,78229-3539,Proprietary  ,17,83,100,132,,731,863
03412300,ADVANCED BARBER COLLEGE & HAIR DESI     ,TX,78596-0000,Proprietary  ,8,30,38,117,,260,377
03416500,DALLAS NURSING INSTITUTE                ,TX,75243-5502,Proprietary  ,13,86,99,414,,1661,2075
03422300,MILAN INSTITUTE                         ,TX,78238-4103,Proprietary  ,103,334,437,890,,2335,3225
03422400,COLLEGE OF BIBLICAL STUDIES-HOUSTON     ,TX,77036-3211,Private      ,2,63,65,129,,1283,1412
03424400,MEDVANCE INSTITUTE                      ,TX,77057-7386,Proprietary  ,25,129,154,267,,1166,1433
03426300,COLLEGE OF HEALTH CARE PROFESSIONS (THE),TX,78752-3630,Proprietary  ,17,95,112,203,,805,1008
03480304,MEDVANCE INSTITUTE OF BATON ROUGE - GRAN,TX,75050-2342,Proprietary  ,10,39,49,103,,352,455
03520300,LUBBOCK HAIR ACADEMY                    ,TX,79410-3524,Proprietary  ,3,14,17,53,,149,202
03542300,CONCORDE CAREER INSTITUTE               ,TX,76011-4016,Proprietary  ,16,134,150,350,,1751,2101
03556400,KUSSAD INSTITUTE OF COURT REPORTING     ,TX,78704-5712,Proprietary  ,0,3,3,13,,51,64
03573300,AVIATION INSTITUTE OF MAINTENANCE       ,TX,75209-3017,Proprietary  ,13,69,82,201,,860,1061
03610300,MJ'S BEAUTY ACADEMY INC                 ,TX,75224-0000,Proprietary  ,8,31,39,74,,269,343
03612400,VALLEY GRANDE INSTITUTE FOR ACADEMI     ,TX,78596-0000,Private      ,14,57,71,167,,485,652
03627300,LAMAR INSTITUTE OF TECHNOLOGY           ,TX,77705-4142,Public       ,61,175,236,2145,,3709,5854
03676400,HEALTHY HAIR ACADEMY                    ,TX,75227-0000,Proprietary  ,0,0,0,26,,82,108
03680300,JAY'S TECHNICAL INSTITUTE               ,TX,77031-3509,Proprietary  ,6,28,34,36,,230,266
03682400,DALLAS BARBER & STYLIST COLLEGE         ,TX,75231-0000,Proprietary  ,10,80,90,215,,858,1073
03714300,TREND BARBER COLLEGE                    ,TX,77071-2104,Proprietary  ,11,50,61,115,,552,667
03723300,CULINARY INST ALAIN & MARIE LENOTRE     ,TX,77022-4322,Proprietary  ,19,62,81,301,,795,1096
03727600,CULINARY ACADEMY OF AUSTIN              ,TX,78752-0000,Proprietary  ,24,53,77,388,,558,946
03731300,INTERNATIONAL RENOWNED BEAUTY ACADE     ,TX,76103-2504,Proprietary  ,0,0,0,4,,12,16
03733300,BAPTIST UNIVERSITY OF THE AMERICAS      ,TX,78224-1336,Private      ,2,15,17,149,,406,555
03756300,ANAMARC COLLEGE                         ,TX,79930-6230,Proprietary  ,20,138,158,404,,1702,2106
03922300,SOUTH TEXAS BARBER COLLEGE              ,TX,78415-3463,Proprietary  ,6,7,13,49,,113,162
03944400,PROFESSIONAL CAREERS INSTITUTE          ,TX,77036-2252,Proprietary  ,7,14,21,36,,234,270
03944401,PROFESSIONAL CAREERS INSTITUTE          ,TX,77090-3914,Proprietary  ,2,25,27,47,,297,344
03970300,HANDS ON THERAPY                        ,TX,75149-2294,Proprietary  ,4,22,26,39,,165,204
03987300,TEXAS HEALTH SCHOOL                     ,TX,77079-2106,Proprietary  ,13,50,63,306,,823,1129
04036300,SOUTHEAST TEXAS CAREER INSTITUTE        ,TX,77656-8601,Proprietary  ,5,18,23,68,,161,229
04045300,NORTHWEST BEAUTY SCHOOL                 ,TX,77091-1208,Proprietary  ,3,12,15,67,,220,287
04045400,MAI-TRIX BEAUTY COLLEGE                 ,TX,77040-0000,Proprietary  ,2,21,23,65,,217,282
04082300,PROFESSIONAL CAREER TRAINING INSTITUTE  ,TX,77090-0000,Proprietary  ,2,37,39,66,,377,443
04089400,CCI TRAINING CENTER                     ,TX,76011-4857,Proprietary  ,2,68,70,53,,472,525
04117900,CHAMPION BEAUTY COLLEGE                 ,TX,77069-4611,Proprietary  ,3,28,31,94,,409,503
04121800,CRISWELL COLLEGE                        ,TX,75246-1537,Private      ,7,31,38,157,,489,646
04125400,ACADEMY AT AUSTIN (THE)                 ,TX,78660-3287,Proprietary  ,12,21,33,121,,242,363
04125500,MANUEL AND THERESA'S SCHOOL OF HAIR DESI,TX,77803-3236,Proprietary  ,6,11,17,54,,101,155
04129800,MEDIATECH INSTITUTE DALLAS              ,TX,75039-3105,Proprietary  ,12,28,40,165,,357,522
04129801,MEDIATECH INSTITUTE - AUSTIN            ,TX,78704-8933,Proprietary  ,3,23,26,89,,206,295
04129802,MEDIATECH INSTITUTE HOUSTON             ,TX,77042-4712,Proprietary  ,9,27,36,141,,326,467
04131700,SOUTHWEST CAREER COLLEGE                ,TX,79925-6230,Proprietary  ,112,208,320,1053,,2272,3325
04135600,CANNON INSTITUTE OF HIGHER LEARNING     ,TX,75247-9998,Proprietary  ,0,4,4,24,,132,156
04136500,PCCENTER                                ,TX,75115-4214,Proprietary  ,0,14,14,21,,104,125
04138500,CARDIOTECH ULTRASOUND SCHOOL            ,TX,77099-1440,Proprietary  ,4,34,38,130,,606,736
04142300,AVEDA INSTITUTE SAN ANTONIO             ,TX,78215-1260,Proprietary  ,23,66,89,346,,792,1138
04146700,AVIATION INSTITUTE OF MAINTENANCE       ,TX,77061-4004,Proprietary  ,17,55,72,219,,632,851
04146800,SOUTH TEXAS TRAINING CENTER             ,TX,78586-7721,Proprietary  ,7,29,36,66,,152,218
04152700,ASTRODOME CAREER CENTERS                ,TX,77054-2678,Proprietary  ,5,20,25,49,,258,307
04154800,DUVALL'S SCHOOL OF COSMETOLOGY          ,TX,76021-4159,Proprietary  ,7,10,17,55,,86,141
04155800,ADVANCED BEAUTY COLLEGE                 ,TX,75061-1918,Proprietary  ,0,12,12,35,,112,147
04158500,TEXAS BEAUTY COLLEGE                    ,TX,76117-3201,Proprietary  ,1,9,10,14,,74,88
04160700,AVENUE FIVE INSTITUTE                   ,TX,78757-7000,Proprietary  ,20,44,64,170,,481,651
04161100,CORPUS CHRISTI BEAUTY ACADEMY           ,TX,78412-3900,Proprietary  ,0,0,0,58,,123,181
04165800,SALON PROFESSIONAL ACADEMY (THE)        ,TX,75067-5390,Proprietary  ,7,22,29,59,,135,194
04168700,LAWYER'S ASSISTANT SCHOOL OF DALLAS     ,TX,75201-2829,Proprietary  ,6,42,48,79,,489,568
04168800,ABC BEAUTY ACADEMY                      ,TX,75042-8682,Proprietary  ,3,16,19,36,,139,175
04169000,SALON & SPA INSTITUTE                   ,TX,78521-1727,Proprietary  ,4,8,12,92,,162,254
04169100,DIAMONDS COSMETOLOGY COLLEGE            ,TX,75090-2657,Proprietary  ,4,24,28,31,,124,155
04177900,BUCKNER BARBER SCHOOL                   ,TX,75217-1775,Proprietary  ,6,20,26,80,,239,319
04178200,VOGUE COLLEGE - SAN ANTONIO             ,TX,78201-5035,Proprietary  ,2,36,38,69,,252,321
04178300,VOGUE BEAUTY ACADEMY                    ,TX,78238-4402,Proprietary  ,4,28,32,86,,266,352
04178400,VOGUE COLLEGE - MCALLEN                 ,TX,78501-1945,Proprietary  ,14,43,57,123,,273,396
04179500,NORTH AMERICAN COLLEGE                  ,TX,77038-0000,Private      ,8,21,29,281,,281,562
04184800,EXCEL LEARNING CENTER                   ,TX,79907-1400,Proprietary  ,8,53,61,47,,304,351
04187800,CYBERTEX INSTITUTE OF TECHNOLOGY        ,TX,78752-3825,Proprietary  ,7,53,60,65,,324,389
04193000,RGV CAREERS AN INSTITUTE FOR HIGHER LEAR,TX,78577-2106,Proprietary  ,11,60,71,56,,316,372
04205200,WADE GORDON HAIRDRESSING ACADEMY        ,TX,79121-0548,Proprietary  ,9,28,37,70,,169,239
04206501,MYCOMPUTERCAREER.COM - DALLAS           ,TX,75062-8173,Proprietary  ,3,105,108,7,,195,202
04206502,MYCOMPUTERCAREER.COM - HOUSTON          ,TX,77056-6764,Proprietary  ,6,114,120,16,,253,269
04207300,SCHOOL FOR ALLIED HEALTH PROFESSIONALS  ,TX,76018-4104,Proprietary  ,1,3,4,1,,3,4
04213300,SPA PROFESSIONALS ACADEMY (THE)         ,TX,78504-2569,Proprietary  ,5,15,20,56,,138,194
04215000,TOTAL TRANSFORMATION INSTITUTE OF COSMET,TX,78666-8115,Proprietary  ,4,11,15,21,,51,72
04215400,GRACE SCHOOL OF THEOLOGY                ,TX,77384-4894,Private      ,0,3,3,4,,34,38
04219700,GEMINI SCHOOL OF VISUAL ARTS & COMMUNICA,TX,78613-2642,Proprietary  ,0,2,2,9,,11,20
04224100,COSMETOLOGY ACADEMY OF TEXARKANA        ,TX,75503-4855,Proprietary  ,5,17,22,17,,95,112
04226400,MT TRAINING CENTER                      ,TX,75051-3542,Proprietary  ,5,26,31,8,,52,60
04229000,BARBER INSTITUTE OF TEXAS               ,TX,75602-3456,Proprietary  ,6,24,30,6,,28,34
04231200,NEECEE'S COLLEGE OF COSMETOLOGY         ,TX,79605-4735,Proprietary  ,5,13,18,9,,15,24
04231300,YAHWEH BEAUTY ACADEMY                   ,TX,76543-4153,Proprietary  ,2,11,13,2,,11,13
04231900,ALAMO CITY BARBER COLLEGE               ,TX,78250-3227,Proprietary  ,17,46,63,21,,59,80
04232900,PREPARING PEOPLE BARBER STYLING COLLEGE ,TX,75215-2415,Proprietary  ,2,15,17,2,,15,17
00367000,BRIGHAM YOUNG UNIVERSITY                ,UT,84602-8406,Private      ,628,674,1302,15836,,14688,30524
00367100,DIXIE STATE COLLEGE OF UTAH             ,UT,84770-3876,Public       ,170,156,326,5743,,5396,11139
00367200,LDS BUSINESS COLLEGE                    ,UT,84101-3500,Private      ,52,81,133,1386,,1476,2862
00367400,STEVENS HENAGER COLLEGE                 ,UT,84401-1420,Proprietary  ,312,2579,2891,2190,,17429,19619
00367500,UNIVERSITY OF UTAH                      ,UT,84112-9055,Public       ,351,673,1024,15680,,19849,35529
00367700,UTAH STATE UNIVERSITY                   ,UT,84322-1400,Public       ,295,496,791,13434,,14888,28322
00367800,SOUTHERN UTAH UNIVERSITY                ,UT,84720-2470,Public       ,111,146,257,5849,,4012,9861
00367900,SNOW COLLEGE                            ,UT,84627-1299,Public       ,79,70,149,3210,,1408,4618
00368000,WEBER STATE UNIVERSITY                  ,UT,84408-1136,Public       ,216,588,804,8513,,14898,23411
00368100,WESTMINSTER COLLEGE                     ,UT,84105-3697,Private      ,34,93,127,2901,,2255,5156
00402700,UTAH VALLEY UNIVERSITY                  ,UT,84058-5999,Public       ,387,686,1073,11082,,19626,30708
00522000,SALT LAKE COMMUNITY COLLEGE             ,UT,84123-0000,Public       ,486,1205,1691,10444,,22351,32795
00732953,ITT TECHNICAL INSTITUTE                 ,UT,84123-2500,Proprietary  ,52,250,302,477,,2207,2684
00943300,SHERMAN KENDALL'S ACADEMY OF BEAUTY     ,UT,84106-1836,Proprietary  ,2,15,17,36,,119,155
01009800,NEUMONT UNIVERSITY                      ,UT,84095-0000,Proprietary  ,13,7,20,850,,135,985
01116500,UINTAH BASIN APPLIED TECHNOLOGY CLG     ,UT,84066-0000,Public       ,2,18,20,29,,185,214
01116600,BROADVIEW UNIVERSITY                    ,UT,84088-4021,Proprietary  ,30,98,128,452,,1343,1795
02078800,SHERMAN KENDALL'S ACADEMY OF BEAUTY     ,UT,84047-0000,Proprietary  ,1,11,12,25,,60,85
02115400,BRIDGERLAND APPLIED TECHNOLOGY COLLEGE  ,UT,84321-0000,Public       ,19,75,94,450,,1220,1670
02156600,DAVIS APPLIED TECHNOLOGY COLLEGE        ,UT,84037-0000,Public       ,36,150,186,581,,1868,2449
02178500,EAGLE GATE COLLEGE                      ,UT,84123-0000,Proprietary  ,23,139,162,257,,1506,1763
02270800,AMERITECH COLLEGE                       ,UT,84604-6927,Proprietary  ,22,110,132,174,,1777,1951
02270802,AMERITECH COLLEGE - DRAPER              ,UT,84020-6545,Proprietary  ,5,39,44,98,,856,954
02298500,EVEREST COLLEGE                         ,UT,84119-2668,Proprietary  ,25,158,183,227,,1200,1427
02346500,OGDEN-WEBER APPLIED TECHNOLOGY COLG     ,UT,84404-0000,Public       ,40,252,292,684,,2568,3252
02360800,PROVO COLLEGE                           ,UT,84601-0000,Proprietary  ,21,73,94,271,,812,1083
02531800,PAUL MITCHELL THE SCHOOL - PROVO        ,UT,84606-0000,Proprietary  ,6,10,16,335,,429,764
02556800,PAUL MITCHELL THE SCHOOL                ,UT,84117-7204,Proprietary  ,36,52,88,262,,503,765
02556801,PAUL MITCHELL THE SCHOOL                ,UT,84780-0000,Proprietary  ,13,16,29,109,,160,269
02572700,EVANS HAIRSTYLING COLLEGE               ,UT,84770-0000,Proprietary  ,3,1,4,40,,50,90
02572800,VISTA COLLEGE                           ,UT,84015-0000,Proprietary  ,4,81,85,54,,576,630
02573100,EVANS HAIRSTYLING COLLEGE               ,UT,84720-0000,Proprietary  ,2,2,4,47,,57,104
02612200,MARINELLO SCHOOL OF BEAUTY              ,UT,84604-1585,Proprietary  ,7,9,16,81,,133,214
03030600,UTAH COLLEGE OF MASSAGE THERAPY         ,UT,84111-1606,Proprietary  ,29,69,98,246,,550,796
03030601,UTAH CLG OF MASSAGE THER-PROVO CMPS     ,UT,84042-0000,Proprietary  ,4,17,21,63,,145,208
03082100,MYOTHERAPY COLLEGE OF UTAH              ,UT,84115-2522,Proprietary  ,1,21,22,26,,136,162
03108200,ECHELON EDGE ACADEMY OF HAIR SKIN & NAIL,UT,84070-2004,Proprietary  ,1,7,8,26,,84,110
03110400,HAIRITAGE HAIR ACADEMY                  ,UT,84770-5233,Proprietary  ,2,4,6,36,,60,96
03339400,WESTERN GOVERNORS UNIVERSITY            ,UT,84107-2533,Private      ,155,5668,5823,1747,,62435,64182
03413300,MOUNTAINLAND APPLIED TECHNOLOGY COLLEGE ,UT,84058-5857,Public       ,25,79,104,372,,951,1323
03463300,CAREERS UNLIMITED                       ,UT,84058-0000,Proprietary  ,0,9,9,73,,198,271
03467308,MARINELLO SCHOOL OF BEAUTY - OGDEN      ,UT,84405-1501,Proprietary  ,5,29,34,76,,295,371
03467309,MARINELLO SCHOOL OF BEAUTY - LAYTON     ,UT,84041-3002,Proprietary  ,8,13,21,64,,164,228
03617300,HEALING MOUNTAIN MASSAGE SCHOOL         ,UT,84111-0000,Proprietary  ,6,28,34,55,,238,293
03829500,SKINWORKS SCHOOL OF ADVANCED SKINCARE   ,UT,84115-0000,Proprietary  ,2,18,20,45,,140,185
03838300,NIGHTINGALE COLL. SCH. OF NURSING SCH. O,UT,84403-0000,Proprietary  ,3,34,37,38,,308,346
03902300,RENAISSANCE SCHOOL OF THERAPEUTIC MASSAG,UT,84010-2835,Proprietary  ,0,0,0,5,,17,22
03909300,MAXIMUM STYLE TEC SCHOOL OF COSMETOLOGY ,UT,84323-4679,Proprietary  ,4,9,13,57,,107,164
03921300,CAMEO COLLEGE OF ESSENTIAL BEAUTY       ,UT,84115-0000,Proprietary  ,6,54,60,131,,480,611
04054300,SOUTHWEST APPLIED TECHNOLOGY COLLEGE    ,UT,84720-6608,Public       ,9,20,29,114,,283,397
04072300,AVEDA INSTITUTE PROVO                   ,UT,84604-1008,Proprietary  ,8,14,22,140,,172,312
04118100,IMAGEWORKS ACADEMY OF HAIR DESIGN       ,UT,84660-1210,Proprietary  ,0,0,0,2,,8,10
04121700,DIXIE APPLIED TECHNOLOGY COLLEGE        ,UT,84770-3025,Public       ,18,25,43,245,,417,662
04142100,SKIN INSTITUTE (THE)                    ,UT,84770-6452,Proprietary  ,0,0,0,31,,93,124
04145500,SKIN SCIENCE INSTITUTE (THE)            ,UT,84115-0000,Proprietary  ,5,24,29,50,,206,256
04153000,RENAISSANCE ACADEMIE                    ,UT,84604-0000,Proprietary  ,6,9,15,42,,105,147
04161900,MANDALYN ACADEMY                        ,UT,84003-2161,Proprietary  ,6,8,14,31,,87,118
04165500,ACAYDIA SCHOOL OF AESTHETICS            ,UT,84601-0000,Proprietary  ,6,9,15,42,,83,125
04169900,AMERICAN BEAUTY ACADEMY                 ,UT,84651-0000,Proprietary  ,2,10,12,22,,62,84
04173200,TAYLOR ANDREWS ACADEMY OF HAIR DESIGN   ,UT,84088-6577,Proprietary  ,14,20,34,114,,199,313
04173201,TAYLOR ANDREWS ACADEMY -  OREM          ,UT,84004-1872,Proprietary  ,9,9,18,9,,9,18
04183000,TOP NAILS & HAIR BEAUTY SCHOOL          ,UT,84118-0000,Proprietary  ,2,17,19,23,,121,144
04184200,TAYLOR ANDREWS ACADEMY-ST. GEORGE       ,UT,84790-2139,Proprietary  ,3,14,17,80,,137,217
04192700,BARBER SCHOOL (THE)                     ,UT,84047-3723,Proprietary  ,8,16,24,31,,158,189
04193200,ROCKY MOUNTAIN UNIVERSITY OF HEALTH PROF,UT,84606-7312,Proprietary  ,1,57,58,26,,450,476
04210300,MEDSPA ACADEMIES                        ,UT,84095-3519,Proprietary  ,3,29,32,48,,221,269
04211500,BEAUTIFUL YOU SCHOOL OF NAIL TECHNOLOGY ,UT,84720-8360,Proprietary  ,0,4,4,10,,24,34
04216800,BONNIE JOSEPH ACADEMY OF COSMETOLOGY & B,UT,84032-2044,Proprietary  ,1,8,9,4,,46,50
04218300,MIDWIVES COLLEGE OF UTAH                ,UT,84106-2671,Private      ,0,22,22,21,,283,304
00368200,BENNINGTON COLLEGE                      ,VT,05201-6001,Private      ,7,17,24,1140,,246,1386
00368300,CASTLETON STATE COLLEGE                 ,VT,05735-0000,Public       ,22,12,34,3420,,549,3969
00368400,CHAMPLAIN COLLEGE                       ,VT,05401-3950,Private      ,33,76,109,4487,,1475,5962
00368500,COLLEGE OF ST JOSEPH                    ,VT,05701-3899,Private      ,1,4,5,149,,224,373
00368600,GODDARD COLLEGE                         ,VT,05667-0000,Private      ,4,43,47,53,,945,998
00368700,GREEN MOUNTAIN COLLEGE                  ,VT,05764-1199,Private      ,14,19,33,898,,343,1241
00368800,JOHNSON STATE COLLEGE                   ,VT,05656-9898,Public       ,19,23,42,1436,,983,2419
00368900,LYNDON STATE COLLEGE                    ,VT,05851-0919,Public       ,25,18,43,2077,,419,2496
00369000,MARLBORO COLLEGE                        ,VT,05344-0300,Private      ,2,6,8,368,,150,518
00369100,MIDDLEBURY COLLEGE                      ,VT,05753-0000,Private      ,23,12,35,4704,,586,5290
00369200,NORWICH UNIVERSITY                      ,VT,05663-1035,Private      ,37,145,182,3337,,1756,5093
00369300,SOUTHERN VERMONT COLLEGE                ,VT,05201-6002,Private      ,5,3,8,655,,185,840
00369400,ST MICHAELS COLLEGE                     ,VT,05439-0001,Private      ,37,6,43,4050,,242,4292
00369600,UNIVERSITY OF VERMONT                   ,VT,05405-0160,Public       ,116,85,201,19292,,3438,22730
00369700,VERMONT COLLEGE OF FINE ARTS            ,VT,05602-3128,Private      ,0,30,30,28,,489,517
00369800,VERMONT TECHNICAL COLLEGE               ,VT,05061-0000,Public       ,12,20,32,1214,,923,2137
00857500,SALON PROFESSIONAL ACADEMY (THE)        ,VT,05495-4001,Proprietary  ,1,11,12,49,,86,135
00865800,O'BRIENS AVEDA INSTITUTE                ,VT,05403-7747,Proprietary  ,2,4,6,40,,98,138
00886000,SIT                                     ,VT,05301-4801,Private      ,2,12,14,216,,595,811
01116700,COMMUNITY COLLEGE OF VERMONT            ,VT,05676-0000,Public       ,95,303,398,2043,,4950,6993
01193400,VERMONT LAW SCHOOL                      ,VT,05068-0000,Private      ,0,16,16,4,,1045,1049
01218300,BURLINGTON COLLEGE                      ,VT,05401-8477,Private      ,5,8,13,308,,222,530
02143500,STERLING COLLEGE                        ,VT,05827-0000,Private      ,1,1,2,128,,65,193
02254000,NEW ENGLAND CULINARY INSTITUTE          ,VT,05602-0000,Proprietary  ,11,13,24,451,,252,703
02532600,LANDMARK COLLEGE                        ,VT,05346-0000,Private      ,13,0,13,587,,99,686
03708300,BURLINGTON TECHNICAL CENTER             ,VT,05401-2721,Public       ,0,0,0,12,,18,30
04146900,ADVANCED WELDING INSTITUTE              ,VT,05403-0000,Proprietary  ,6,9,15,50,,59,109
00392800,CASPER COLLEGE                          ,WY,82601-4612,Public       ,36,89,125,1535,,1951,3486
00392900,EASTERN WYOMING COLLEGE                 ,WY,82240-1603,Public       ,11,28,39,589,,466,1055
00393000,SHERIDAN COLLEGE                        ,WY,82801-9133,Public       ,24,59,83,1175,,1343,2518
00393100,NORTHWEST COLLEGE                       ,WY,82435-1895,Public       ,24,30,54,997,,676,1673
00393200,UNIVERSITY OF WYOMING                   ,WY,82071-2000,Public       ,98,164,262,7919,,5368,13287
00393300,WESTERN WYOMING COMMUNITY COLLEGE       ,WY,82902-0000,Public       ,25,68,93,1042,,1319,2361
00728900,CENTRAL WYOMING COLLEGE                 ,WY,82501-0000,Public       ,12,38,50,631,,929,1560
00915700,WYOMING TECHNICAL INSTITUTE             ,WY,82072-9519,Proprietary  ,180,133,313,1833,,1184,3017
00925900,LARAMIE COUNTY COMMUNITY CLG            ,WY,82007-3299,Public       ,41,133,174,1772,,2662,4434
02211900,CHEEKS INTERNATIONAL ACDMY              ,WY,82001-0000,Proprietary  ,5,23,28,56,,191,247
00393500,UNIV OF GUAM                            ,GU,96923-0000,Public       ,90,119,209,2788,,2112,4900
01536100,GUAM COMMUNITY COLLEGE                  ,GU,96921-0000,Public       ,46,197,243,1913,,1976,3889
03438300,PACIFIC ISLANDS UNIVERSITY              ,GU,96913-2619,Private      ,3,4,7,112,,141,253
00393600,PONTIFICAL CATHOLIC UNIV OF PR          ,PR,00717-0777,Private      ,103,307,410,6782,,5488,12270
00393700,UNIVERSITY OF THE SACRED HEART          ,PR,00914-0383,Private      ,55,133,188,3996,,2622,6618
00393800,INTER-AMER UNIV PR-CNTRL ADMN           ,PR,00936-0000,Private      ,129,445,574,3716,,6125,9841
00393801,INTER-AMER UNIV PR SCHL LAW             ,PR,00936-8351,Private      ,0,3,3,34,,328,362
00393802,INTER AMERICAN UNIVERSITY OF PUERTO RICO,PR,00926-0000,Private      ,15,29,44,1148,,1229,2377
00393803,INTER AMERICAN UNIVERSITY OF PR         ,PR,00683-0000,Private      ,101,139,240,3945,,2005,5950
00393804,INTER-AMER UNIV PR-RECINTO AGUADILA     ,PR,00605-2000,Private      ,129,147,276,3255,,2163,5418
00393805,INTER-AMER UNIV PR-ARECIBO CAMPUS       ,PR,00614-4050,Private      ,61,156,217,3187,,2615,5802
00393806,INTER-AMER UNIV PR-BARRANQUITAS REG     ,PR,00794-0517,Private      ,195,78,273,1819,,850,2669
00393807,INTER-AMER UNIV PR-FAJARDO REGIONAL     ,PR,00738-0000,Private      ,40,103,143,1575,,1177,2752
00393808,INTER-AMER UNIV PR - GUAYAMA CAMPUS     ,PR,00785-4004,Private      ,34,111,145,1304,,1318,2622
00393809,INTER-AMER UNIV PR-PONCE REGIONAL       ,PR,00715-0000,Private      ,126,182,308,3919,,3198,7117
00393811,INTER-AMER UNIV PR-BAYAMON REG CLG      ,PR,00959-0000,Private      ,77,81,158,4142,,1866,6008
00394100,COLEGIO UNIVERSITARIO DEL ESTE          ,PR,00983-0000,Private      ,273,833,1106,7716,,8759,16475
00394200,UNIVERSITY OF PR-CENTRAL ADMINISTRATION ,PR,00936-4984,Public       ,11,10,21,399,,285,684
00394300,UNIVERSITY OF PUERTO RICO - HUMACAO UNIV,PR,00791-4300,Public       ,15,13,28,3203,,477,3680
00394400,UNIVERSITY OF PUERTO RICO - MAYAGUEZ    ,PR,00680-0000,Public       ,91,79,170,9006,,2011,11017
00501900,UNIV ADVENTISTA DE LAS ANTILLAS         ,PR,00681-0118,Private      ,17,45,62,1032,,654,1686
00502200,BAYAMON CENTRAL UNIVERSITY              ,PR,00960-0000,Private      ,50,91,141,1176,,1310,2486
00710800,UNIVERSITY OF PUERTO RICO - RIO PIEDRAS ,PR,00931-3300,Public       ,87,153,240,9315,,3383,12698
00720600,UNIVERSITY OF PUERTO RICO - CAYEY UNIVER,PR,00736-5534,Public       ,16,10,26,3636,,451,4087
00722800,UNIVERSITY OF PUERTO RICO - ARECIBO     ,PR,00614-4010,Public       ,15,14,29,3770,,619,4389
00890200,COLUMBIA CENTRO UNIVERSITARIO           ,PR,00726-0000,Proprietary  ,63,129,192,1410,,1385,2795
00965200,"UNIVERSITY OF PUERTO RICO, PONCE TECH UN",PR,00716-0000,Public       ,24,16,40,3432,,478,3910
01056700,COLEGIO TECNOLOGICO DE SAN JUAN         ,PR,00918-2973,Public       ,33,51,84,809,,869,1678
01072400,CARLOS ALBIZU UNIVERSITY                ,PR,00902-3711,Private      ,6,15,21,116,,910,1026
01081900,CONSERVATORIO DE MUSICA DE PUERTO RICO  ,PR,00907-3373,Public       ,1,5,6,351,,137,488
01092200,UNIVERSITY OF PUERTO RICO - UTUADO      ,PR,00641-2500,Public       ,8,0,8,1604,,272,1876
01097500,UNIVERSITY OF PUERTO RICO BAYAMON TECHNI,PR,00959-1911,Public       ,20,22,42,4589,,703,5292
01120300,RYDER MEMORIAL HOSP SCH OF NURSING      ,PR,00792-0000,Private      ,0,0,0,19,,17,36
01171900,UNIVERSIDAD DEL TURABO                  ,PR,00778-0000,Private      ,264,961,1225,8960,,11480,20440
01194000,ICPR JUNIOR COLLEGE                     ,PR,00919-0000,Proprietary  ,174,254,428,1650,,2124,3774
01194100,AMERICAN UNIVERSITY OF PUERTO RICO      ,PR,00960-2037,Private      ,32,28,60,769,,594,1363
01194101,AMERICAN UNIVERSITY OF PUERTO RICO      ,PR,00674-0000,Private      ,42,52,94,778,,597,1375
01212300,"UNIVERSITY OF PUERTO RICO, AGUADILLA REG",PR,00604-0160,Public       ,27,8,35,2881,,541,3422
01252500,CARIBBEAN UNIVERSITY                    ,PR,00960-0493,Private      ,109,204,313,2605,,3234,5839
02063100,MBTI BUSINESS TRNG INSTITUTE            ,PR,00907-3917,Proprietary  ,302,924,1226,1627,,4701,6328
02100000,POLYTECHNIC UNIVERSITY OF PR            ,PR,00917-0000,Private      ,60,132,192,2379,,2389,4768
02163300,UNIVERSIDAD CENTRAL DEL CARIBE          ,PR,00960-0000,Private      ,3,13,16,204,,437,641
02165100,EDP COLLEGE OF PUERTO RICO              ,PR,00919-0000,Private      ,63,194,257,1054,,1904,2958
02166000,CENTER FOR ADVANCED STUDIES OF PUER     ,PR,00902-0000,Private      ,1,47,48,6,,277,283
02166400,INSTITUTO DE BANCA Y COMERCIO           ,PR,00925-0000,Proprietary  ,1089,1910,2999,9025,,10699,19724
02170300,INST EDUC TECNIA OCUP LA REINA          ,PR,00674-0000,Proprietary  ,33,37,70,282,,297,579
02189100,CENTRO DE ESTUDIOS MULTIDISCIPLIN       ,PR,00926-0000,Private      ,106,181,287,1664,,1931,3595
02189300,EMMA'S BEAUTY ACADEMY                   ,PR,00680-0000,Proprietary  ,14,24,38,241,,140,381
02195400,MODERN HAIRSTYLING INSTITUTE            ,PR,00961-0000,Proprietary  ,61,77,138,758,,508,1266
02195500,MODERN HAIRSTYLING INSTITUTE            ,PR,00612-0000,Proprietary  ,0,0,0,8,,12,20
02195800,LICEO E ARTE Y TECNOLGIA                ,PR,00919-0000,Proprietary  ,54,89,143,788,,867,1655
02195900,MODERN HAIRSTYLING INSTITUTE            ,PR,00980-0000,Proprietary  ,0,0,0,13,,11,24
02234900,ANTILLES SCHOOL OF TECH CAREERS         ,PR,00909-3006,Proprietary  ,35,93,128,313,,481,794
02241901,COMMONWEALTH OF PR DEPT OF EDUC - CARLOS,PR,00986-0000,Public       ,0,0,0,11,,15,26
02241902,COMMONWEALTH OF PR DEPT OF EDUC - TOMAS ,PR,00613-0000,Public       ,0,0,0,3,,4,7
02241904,COMMONWEALTH OF PR DEPT OF EDUC - ITPR R,PR,00655-0000,Public       ,13,11,24,569,,386,955
02241905,COMMONWEALTH OF PR DEPT OF EDUC - JOSE A,PR,00674-0000,Public       ,1,0,1,38,,21,59
02241907,COMMONWEALTH OF PR DEPT OF EDUC - ITPR R,PR,00928-0000,Public       ,6,3,9,303,,209,512
02241908,COMMONWEALTH OF PR DEPT OF EDUC - ITPR R,PR,00732-0000,Public       ,17,9,26,479,,282,761
02241909,COMMONWEALTH OF PR DEPT OF EDUC - TROQUE,PR,00959-0000,Public       ,0,0,0,60,,20,80
02241910,COMMONWEALTH OF PR DEPT OF EDUC - ITPR R,PR,00701-1091,Public       ,1,2,3,591,,226,817
02260600,NATIONAL COLLEGE OF BUSINESS & TECH     ,PR,00960-2036,Proprietary  ,271,1338,1609,5090,,10245,15335
02260800,HUERTAS COLLEGE                         ,PR,00726-0000,Proprietary  ,47,112,159,957,,1079,2036
02297700,AUTOMECA TECHNICAL COLLEGE              ,PR,00957-0000,Proprietary  ,134,171,305,1185,,798,1983
02303800,AMERICAN EDUCATIONAL COLLEGE            ,PR,00961-0000,Proprietary  ,36,80,116,323,,660,983
02335500,COLEGIO BIBLICO PENTECOSTAL DE PR       ,PR,00978-0000,Private      ,1,15,16,27,,222,249
02340600,HUMACAO COMMUNITY COLLEGE               ,PR,00792-0000,Private      ,29,55,84,443,,500,943
02343600,INSTITUTE OF BEAUTY CAREERS             ,PR,00613-0000,Proprietary  ,48,53,101,382,,288,670
02460000,UNIVERSITY OF PUERTO RICO - MEDICAL SCIE,PR,00936-0000,Public       ,3,32,35,688,,1513,2201
02482400,PONCE SCHOOL OF MEDICINE AND HEALTH SCIE,PR,00716-2347,Private      ,0,1,1,84,,740,824
02502400,SERBIA'S SCHOOL OF BEAUTY CULTURE       ,PR,00785-0000,Proprietary  ,36,65,101,183,,316,499
02504500,INSTITUCION CHAVIANO DE MAYAGUEZ        ,PR,00708-0000,Proprietary  ,8,10,18,38,,71,109
02505400,ATLANTIC COLLEGE                        ,PR,00970-0000,Private      ,35,38,73,1239,,471,1710
02534900,PONCE PARAMEDICAL COLLEGE (POPAC)       ,PR,00731-0000,Proprietary  ,103,178,281,1869,,1498,3367
02552300,COLEGIO MAYOR DE TECHNOLOGIA            ,PR,00714-0000,Proprietary  ,22,29,51,180,,220,400
02562500,INTERNATIONAL TECHNICAL COLLEGE         ,PR,00918-0000,Proprietary  ,3,17,20,63,,107,170
02563500,ROGIES SCHOOL OF BEAUTY CULTURE         ,PR,00910-0000,Proprietary  ,2,1,3,50,,61,111
02569400,ESCUELA DE ARTES PLASTICAS              ,PR,00902-1112,Public       ,2,1,3,425,,165,590
02570400,EDUCATIONAL TECHNICAL COLLEGE           ,PR,00925-3404,Proprietary  ,68,204,272,533,,1018,1551
02576100,ESCUELA TECNICA DE ELECTRICIDAD         ,PR,00731-0000,Proprietary  ,28,72,100,284,,338,622
02587500,UNIVERSIDAD METROPOLITANA               ,PR,00928-0000,Private      ,249,921,1170,7176,,9570,16746
02588600,SEMINARIO EVANGELICO DE PUERTO RICO     ,PR,00925-0000,Private      ,0,9,9,3,,75,78
02593700,HISPANIC AMERICAN COLLEGE               ,PR,00725-0000,Proprietary  ,29,48,77,225,,328,553
03016000,UNIVERSITY OF PUERTO RICO CAROLINA REGIO,PR,00985-0000,Public       ,22,21,43,3778,,764,4542
03021900,EDIC COLLEGE                            ,PR,00726-0000,Proprietary  ,73,141,214,1188,,1179,2367
03025500,MECH TECH COLLEGE                       ,PR,00725-6118,Proprietary  ,252,337,589,3106,,2121,5227
03025900,"LICEO DE ARTE, DISENOS Y COMERCIO       ",PR,00726-0000,Proprietary  ,18,53,71,245,,416,661
03029700,"UNIVERSAL TECHNOLOGY CLG OF PR, INC     ",PR,00605-1955,Private      ,44,98,142,561,,1008,1569
03061900,COLEGIO TECHNOLOGICO Y COMERCIAL        ,PR,00602-0960,Proprietary  ,6,16,22,46,,75,121
03068400,STAR BEAUTY ACADEMY                     ,PR,00961-6312,Proprietary  ,4,13,17,44,,64,108
03070500,D'MART INSTITUTE                        ,PR,00794-3517,Proprietary  ,91,170,261,629,,969,1598
03075600,EMMA'S BEAUTY ACADEMY                   ,PR,00795-0000,Proprietary  ,28,35,63,323,,208,531
03085700,PROFESSIONAL TECHNICAL INSTITUTION      ,PR,00960-7061,Proprietary  ,18,42,60,237,,275,512
03104400,PROFESSIONAL ELECTRIC SCHOOL            ,PR,00674-1797,Proprietary  ,0,1,1,40,,45,85
03106900,ESCUELA DE PERITOS ELECTRICITAS         ,PR,00662-0457,Proprietary  ,2,4,6,53,,52,105
03112100,JOHN DEWEY COLLEGE                      ,PR,00915-9538,Private      ,173,382,555,1785,,3684,5469
03112101,JOHN DEWEY COLLEGE                      ,PR,00986-0000,Private      ,33,73,106,415,,757,1172
03112102,JOHN DEWEY COLLEGE-BAYAMON CAMPUS       ,PR,00959-0000,Private      ,19,29,48,149,,303,452
03112104,JOHN DEWEY COLLEGE - YABUCOA LRNING SITE,PR,00767-0767,Private      ,0,0,0,23,,33,56
03112105,JOHN DEWEY COLLEGE - FAJARDO BRANCH     ,PR,00738-0738,Private      ,17,49,66,184,,333,517
03112106,JOHN DEWEY COLLEGE - ARROYO BRANCH      ,PR,00714-0714,Private      ,4,20,24,66,,128,194
03112107,JOHN DEWEY COLLEGE - JUANA DIAZ BRANCH  ,PR,00795-0000,Private      ,18,34,52,204,,291,495
03112108,JOHN DEWEY COLLEGE - HATILLO CAMPUS     ,PR,00659-0000,Private      ,14,22,36,124,,223,347
03112109,JOHN DEWEY COLLEGE - MANATI             ,PR,00674-0000,Private      ,44,79,123,379,,594,973
03115900,TRINITY COLLEGE OF PUERTO RICO          ,PR,00734-0000,Private      ,15,23,38,178,,248,426
03122500,ACADEMIA SERRANT INC.                   ,PR,00717-1568,Proprietary  ,38,54,92,245,,309,554
03123100,GLOBELLE TECHNICAL INSTITUTE            ,PR,00693-4218,Proprietary  ,12,7,19,87,,79,166
03124200,NOVA COLLEGE DE PUERTO RICO             ,PR,00960-4016,Proprietary  ,29,50,79,152,,291,443
03157600,"COLEGIO DE CINEMATOGRAFIA, ARTES Y TELEV",PR,00961-6345,Proprietary  ,63,50,113,789,,457,1246
03177300,SAN JUAN BAUTISTA SCH OF MEDICINE       ,PR,00726-0000,Private      ,0,2,2,24,,324,348
03336300,CENTURY COLLEGE                         ,PR,00603-0000,Proprietary  ,13,28,41,125,,200,325
03414300,MONTECLARO                              ,PR,00745-9612,Private      ,3,5,8,19,,28,47
03452300,INSTITUTO PRE-VOCACIONAL E INDUSTRI     ,PR,00613-1800,Private      ,18,51,69,97,,236,333
03469300,IVAEM COLLEGE                           ,PR,00725-0000,Proprietary  ,5,9,14,108,,66,174
03531300,UNIVERSIDAD PENTECOSTAL MIZPA           ,PR,00928-0966,Private      ,2,45,47,33,,361,394
03544300,ATENAS COLLEGE                          ,PR,00674-0000,Private      ,33,73,106,999,,879,1878
03552300,LESTON COLLEGE                          ,PR,00961-6309,Proprietary  ,26,19,45,144,,134,278
03585300,CENTRO DE CAPACITACION Y ASESORAMIE     ,PR,00612-0000,Private      ,0,0,0,1,,9,10
03608300,CARIBBEAN FORENSIC & TECHNICAL COLL     ,PR,00926-0000,Proprietary  ,5,13,18,48,,101,149
03638300,ROSSLYN TRAINING ACADEMY OF COSMETOLOGY ,PR,00602-3225,Proprietary  ,1,8,9,25,,62,87
03735400,"CHARLIES GUARD,DETECTIVE BUREAU&ACA     ",PR,00605-0000,Proprietary  ,11,16,27,69,,71,140
03751300,ESCUELA HOTELERA DE SAN JUAN            ,PR,00917-0091,Proprietary  ,39,48,87,750,,502,1252
03758300,BAYAMON COMMUNITY COLLEGE               ,PR,00960-0000,Proprietary  ,17,72,89,96,,302,398
03781400,INDUSTRIAL TECHNICAL COLLEGE            ,PR,00792-0000,Proprietary  ,21,43,64,157,,270,427
03785300,J.G. GUAYNABO TECHNICAL COLLEGE         ,PR,00960-0000,Proprietary  ,4,11,15,42,,97,139
03800300,COLEGIO TECNICO DE ELECTRICIDAD GALLOSA ,PR,00602-0000,Proprietary  ,1,13,14,23,,52,75
03800400,INSTITUTE OF BEAUTY OCCUPATIONS AND TECH,PR,00676-5071,Proprietary  ,31,54,85,123,,173,296
03843300,ADVANCED TECH COLLEGE                   ,PR,00961-6321,Proprietary  ,3,12,15,44,,111,155
03849300,AGUADILLA TECHNICAL COLLEGE             ,PR,00603-0000,Proprietary  ,4,11,15,40,,96,136
03965400,MYRANGEL BEAUTY INSTITUTE               ,PR,00754-3917,Proprietary  ,13,38,51,128,,207,335
04030300,"ASPIRA DE PUERTO RICO, ACADEMIA DE TECNO",PR,00987-0000,Private      ,0,0,0,2,,4,6
04107300,CARIB TECHNOLOGICAL INSTITUTE           ,PR,00960-0000,Proprietary  ,54,31,85,141,,225,366
04117200,INSTITUTO EDUCATIVO PREMIER             ,PR,00731-0000,Proprietary  ,34,40,74,186,,237,423
04131600,LIBERTY TECHNICAL COLLEGE               ,PR,00737-1298,Proprietary  ,14,24,38,97,,132,229
04164300,GLOBAL INSTITUTE                        ,PR,00725-6485,Proprietary  ,2,1,3,29,,29,58
04176000,AMERICAN TECHNICAL INSTITUTE            ,PR,00957-0000,Proprietary  ,1,3,4,21,,47,68
00394600,UNIVERSITY OF THE VIRGIN ISLANDS        ,VI,00802-9990,Public       ,16,31,47,1172,,887,2059
00394601,UNIV OF THE VIRGIN ISLANDS-ST CROIX     ,VI,00850-0000,Public       ,7,28,35,605,,698,1303
00667700,MCGILL UNIVERSITY                       ,CN,00000-0000,Public       ,7,11,18,1546,,455,2001
00667900,QUEEN'S UNIVERSITY AT KINGSTON          ,CN,00000-0000,Public       ,0,1,1,106,,42,148
00668100,ST FRANCIS XAVIER UNIVERSITY            ,CN,00000-0000,Public       ,2,1,3,28,,11,39
00668200,ST THOMAS UNIVERSITY                    ,CN,00000-0000,Public       ,0,0,0,47,,5,52
00668300,UNIVERSITY OF GUELPH                    ,CN,00000-0000,Public       ,0,0,0,48,,85,133
00668400,UNIVERSITY OF MANITOBA                  ,CN,00000-0000,Public       ,0,1,1,59,,49,108
00668500,UNIVERSITY OF NEW BRUNSWICK (THE)       ,CN,00000-0000,Public       ,0,0,0,29,,18,47
00668600,UNIVERSITY OF OTTAWA                    ,CN,00000-0000,Public       ,0,2,2,55,,81,136
00668800,UNIVERSITY OF TORONTO                   ,CN,00000-0000,Public       ,7,11,18,366,,404,770
00668900,UNIVERSITY OF WINDSOR                   ,CN,00000-0000,Public       ,1,1,2,29,,58,87
00683700,UNIVERSITE LAVAL                        ,CN,00000-0000,Public       ,0,0,0,11,,36,47
00683800,DALHOUSIE UNIVERSITY                    ,CN,00000-0000,Public       ,0,2,2,132,,67,199
00683805,DALHOUSIE UNIVERSITY - AGRICULTURAL CAMP,CN,00000-0000,Public       ,0,0,0,2,,4,6
00685200,BISHOP'S UNIVERSITY                     ,CN,00000-0000,Private      ,0,0,0,65,,7,72
00685300,MCMASTER UNIVERSITY                     ,CN,00000-0000,Public       ,0,0,0,24,,30,54
00767900,YORK UNIVERSITY                         ,CN,00000-0000,Public       ,2,3,5,90,,110,200
00787400,UNIVERSITY AT CALGARY (THE)             ,CN,00000-0000,Public       ,2,0,2,52,,71,123
00814800,UNIVERSITY OF WINNIPEG                  ,CN,00000-0000,Public       ,0,1,1,28,,17,45
00836200,UNIVERSITY OF ALBERTA (THE)             ,CN,00000-0000,Public       ,1,0,1,51,,46,97
00836300,MOUNT SAINT VINCENT UNIVERSITY          ,CN,00000-0000,Public       ,0,0,0,10,,7,17
00836400,SAINT MARY'S UNIVERSITY                 ,CN,00000-0000,Public       ,0,1,1,16,,16,32
00836500,CONCORDIA UNIVERSITY - SIR GEORGE W     ,CN,00000-0000,Public       ,5,4,9,282,,171,453
00836600,UNIVERSITE DE MONTREAL                  ,CN,00000-0000,Public       ,0,0,0,26,,65,91
00836800,CARLETON UNIVERSITY                     ,CN,00000-0000,Public       ,2,1,3,73,,44,117
00836900,UNIVERSITY OF BRITISH COLUMBIA          ,CN,00000-0000,Public       ,8,12,20,884,,577,1461
00837000,"SAFA, UNIVERSITY OF VICTORIA            ",CN,00000-0000,Public       ,2,0,2,142,,68,210
00844400,SIMON FRASER UNIVERSITY                 ,CN,00000-0000,Public       ,3,3,6,153,,113,266
00844600,UNIVERSITY OF WESTERN ONTARIO (THE)     ,CN,00000-0000,Public       ,2,3,5,57,,88,145
00844800,UNIVERSITY OF REGINA                    ,CN,00000-0000,Public       ,0,0,0,8,,10,18
00844900,ACADIA UNIVERSITY                       ,CN,00000-0000,Public       ,1,0,1,55,,16,71
00852600,UNIVERSITY OF WATERLOO                  ,CN,00000-0000,Public       ,2,1,3,58,,31,89
00858200,WILFRID LAURIER UNIVERSITY              ,CN,00000-0000,Public       ,0,0,0,11,,12,23
00891300,LAKEHEAD UNIVERSITY                     ,CN,00000-0000,Public       ,0,0,0,8,,8,16
00911900,UNIVERSITE DE MONCTON                   ,CN,00000-0000,Public       ,0,0,0,1,,1,2
00925200,BROCK UNIVERSITY                        ,CN,00000-0000,Public       ,0,0,0,12,,12,24
00936700,UNIVERSITY OF PRINCE EDWARD ISLAND      ,CN,00000-0000,Public       ,0,1,1,22,,107,129
00942100,BRANDON UNIVERSITY                      ,CN,00000-0000,Public       ,0,1,1,13,,14,27
00948600,TRINITY WESTERN UNIVERSITY              ,CN,00000-0000,Private      ,0,1,1,127,,65,192
00950000,MEMORIAL UNIVERSITY OF NEWFOUNDLAND     ,CN,00000-0000,Public       ,1,1,2,17,,31,48
00950100,UNIVERSITY OF KING'S COLLEGE            ,CN,00000-0000,Public       ,0,0,0,32,,5,37
00950300,MOUNT ALLISON UNIVERSITY                ,CN,00000-0000,Public       ,0,0,0,33,,3,36
00950500,TRENT UNIVERSITY                        ,CN,00000-0000,Public       ,0,0,0,10,,3,13
00969800,MEDICINE HAT COLLEGE                    ,CN,00000-0000,Public       ,0,0,0,5,,4,9
01012300,NOVA SCOTIA COLLEGE OF ART & DESIGN     ,CN,00000-0000,Public       ,1,0,1,16,,13,29
01022100,SAINT PAUL UNIVERSITY                   ,CN,00000-0000,Public       ,0,1,1,4,,20,24
01045800,SHERIDAN COLLEGE OF APPLIED ARTS AN     ,CN,00000-0000,Public       ,0,0,0,61,,28,89
01067500,REGENT COLLEGE                          ,CN,00000-0000,Private      ,1,2,3,8,,77,85
01070300,UNIVERSITY OF LETHBRIDGE                ,CN,00000-0000,Public       ,0,0,0,5,,7,12
01072000,RYERSON UNIVERSITY                      ,CN,00000-0000,Public       ,2,2,4,65,,71,136
01172200,BRIERCREST BIBLE COLLEGE                ,CN,00000-0000,Private      ,0,0,0,9,,6,15
01222800,HUMBER COLLEGE                          ,CN,00000-0000,Public       ,0,2,2,44,,54,98
01227400,PROVIDENCE COLLEGE                      ,CN,00000-0000,Private      ,1,0,1,33,,5,38
02102100,KINGSWOOD UNIVERSITY                    ,CN,00000-0000,Private      ,1,1,2,64,,19,83
02167000,PRAIRIE BIBLE INST                      ,CN,00000-0000,Private      ,0,1,1,13,,7,20
02184600,INSTITUTE FOR CHRISTIAN STUDIES         ,CN,00000-0000,Private      ,0,1,1,4,,3,7
02195700,TAYLOR UNIVERSITY COLLEGE AND SEMINARY  ,CN,00000-0000,Private      ,0,0,0,2,,4,6
02201100,COLUMBIA BIBLE COLLEGE                  ,CN,00000-0000,Private      ,1,0,1,15,,14,29
02216400,TYNDALE COLLEGE & SEMINARY              ,CN,00000-0000,Private      ,0,1,1,6,,16,22
02219200,UNIVERSITY OF SASKATCHEWAN              ,CN,00000-0000,Public       ,1,1,2,16,,31,47
02324900,EMMANUEL BIBLE COLLEGE                  ,CN,00000-0000,Private      ,0,1,1,1,,2,3
02338800,EMILY CARR UNIVERSITY OF ART AND DESIGN ,CN,00000-0000,Public       ,1,0,1,73,,53,126
02577200,SALVATION ARMY WM & CATHERINE BOOTH     ,CN,00000-0000,Private      ,0,0,0,3,,1,4
02593800,CONCORDIA UNIVERSITY COLLEGE            ,CN,00000-0000,Private      ,0,0,0,12,,14,26
02611900,THE KING'S UNIVERSITY COLLEGE           ,CN,00000-0000,Private      ,0,0,0,3,,7,10
03018300,ROCKY MOUNTAIN COLLEGE: CENTRE FOR BIBLI,CN,00000-0000,Private      ,0,0,0,2,,2,4
03033800,UNIVERSITY COLLEGE OF CAPE BRETON       ,CN,00000-0000,Public       ,0,0,0,6,,6,12
03078300,VANCOUVER SCHOOL OF THEOLOGY            ,CN,00000-0000,Private      ,0,0,0,2,,11,13
03273300,CANADIAN COLLEGE OF NATUROPATHIC ME     ,CN,00000-0000,Private      ,0,0,0,3,,21,24
03298300,ALBERTA COLLEGE OF ART & DESIGN         ,CN,00000-0000,Public       ,0,1,1,26,,29,55
03332500,KWANTLEN UNIVERSITY COLLEGE             ,CN,00000-0000,Public       ,0,1,1,5,,16,21
03335400,CANADIAN UNIVERSITY COLLEGE             ,CN,00000-0000,Private      ,0,0,0,47,,23,70
03339300,ST. STEPHENS UNIVERSITY                 ,CN,00000-0000,Private      ,0,0,0,3,,2,5
03348500,REDEEMER UNIVERSITY COLLEGE             ,CN,00000-0000,Private      ,0,1,1,14,,4,18
03420300,HOLLAND COLLEGE                         ,CN,00000-0000,Public       ,1,1,2,14,,11,25
03560400,NIAGARA COLLEGE-WELLAND CAMPUS          ,CN,00000-0000,Public       ,0,0,0,16,,13,29
03613300,UNIV OF NORTHERN BRITISH COLUMBIA       ,CN,00000-0000,Public       ,0,0,0,7,,18,25
03644400,CANADIAN MENNONITE UNIVERSITY           ,CN,00000-0000,Private      ,0,0,0,8,,4,12
03674400,CANADIAN SOUTHERN BAPTIST SEMINARY      ,CN,00000-0000,Private      ,0,1,1,1,,5,6
03711300,CAPILANO UNIVERSITY                     ,CN,00000-0000,Public       ,0,0,0,17,,23,40
03846300,PACIFIC LIFE BIBLE COLLEGE              ,CN,00000-0000,Private      ,0,0,0,12,,5,17
03847300,CRANDALL UNIVERSITY                     ,CN,00000-0000,Private      ,0,0,0,3,,3,6
04075300,QUEST UNIVERSITY CANADA                 ,CN,00000-0000,Private      ,5,0,5,150,,7,157
04123100,ATLANTIC SCHOOL OF THEOLOGY             ,CN,00000-0000,Public       ,0,1,1,1,,8,9
04156700,AMBROSE UNIVERSITY COLLEGE              ,CN,00000-0000,Private      ,0,0,0,11,,14,25
00814700,UNIVERSIDAD AUTONOMA DE GUADALAJARA     ,MX,00000-0000,Private      ,1,23,24,85,,1284,1369
01041800,INST TEC Y DE ESTSUPER DE MONTERRE      ,MX,00000-0000,Private      ,2,2,4,96,,75,171
01067600,UNIVERSIDAD DE MONTERREY                ,MX,00000-0000,Private      ,0,1,1,34,,40,74
01093800,UNIVERSIDAD DE GUANAJUATO               ,MX,00000-0000,Public       ,0,3,3,26,,46,72
01230100,UNIV AUTON DE TAMAULIPAS FAC DEMED      ,MX,00000-0000,Public       ,1,1,2,1,,6,7
02053300,CENTRO DE ESTUDIOS UNIVERSITARIOS D     ,MX,00000-0000,Private      ,1,7,8,54,,90,144
04183900,CETYS UNIVERSIDAD                       ,MX,00000-0000,Private      ,4,5,9,104,,72,176
01001000,AMERICAN SAMOA CMNTY COLLEGE            ,AS,96799-2609,Public       ,90,59,149,1296,,476,1772
01034300,COLLEGE OF MICRONESIA - FSM             ,FM,96941-0159,Public       ,139,117,256,2214,,1062,3276
01100900,PALAU COMMUNITY COLLEGE                 ,PW,96940-0009,Public       ,40,30,70,809,,336,1145
03022400,COLLEGE OF THE MARSHALL ISLANDS         ,MH,96960-1258,Public       ,133,65,198,946,,405,1351
03033000,NORTHERN MARIANAS COLLEGE               ,MP,96950-0000,Public       ,46,44,90,960,,523,1483
