OPE ID,School,State,Zip Code,School Type,20132014Qtr4_Dependent Students,20132014Qtr4_Independent Students,Quarterly Total,YTD_20132014Qtr4_Dependent Students,YTD_20132014Qtr4_nan,Independent Students,Award Year To Date Total
00100200,ALABAMA AGRCLTL & MECHL UNIV            ,AL,35762-1357,Public       ,175,246,421,6438,,3691,10129
00100300,FAULKNER UNIVERSITY                     ,AL,36109-3398,Private      ,116,342,458,2075,,4226,6301
00100400,UNIVERSITY OF MONTEVALLO                ,AL,35115-6000,Public       ,127,117,244,2592,,1564,4156
00100500,ALABAMA STATE UNIVERSITY                ,AL,36101-0000,Public       ,442,509,951,10261,,6228,16489
00100700,CENTRAL ALABAMA COMMUNITY COLLEGE       ,AL,35011-0000,Public       ,98,250,348,1469,,1988,3457
00100800,ATHENS STATE UNIVERSITY                 ,AL,35611-1999,Public       ,77,271,348,1004,,3421,4425
00100900,AUBURN UNIVERSITY                       ,AL,36849-5113,Public       ,956,492,1448,18672,,6842,25514
00101200,BIRMINGHAM SOUTHERN COLLEGE             ,AL,35254-0002,Private      ,111,112,223,2128,,887,3015
00101300,CALHOUN COMMUNITY COLLEGE               ,AL,35609-2216,Public       ,454,1031,1485,5552,,8435,13987
00101500,ENTERPRISE STATE COMMUNITY COLLEGE      ,AL,36331-1300,Public       ,89,206,295,1362,,1810,3172
00101600,UNIVERSITY OF NORTH ALABAMA             ,AL,35632-0001,Public       ,446,314,760,5813,,3080,8893
00101700,GADSDEN STATE COMMUNITY COLLEGE         ,AL,35903-2269,Public       ,247,741,988,3276,,6073,9349
00101800,GEORGE C WALLACE COMMUNITY COLLEGE      ,AL,36303-0943,Public       ,206,560,766,2528,,4532,7060
00101900,HUNTINGDON COLLEGE                      ,AL,36106-2148,Private      ,79,91,170,1619,,821,2440
00102000,JACKSONVILLE STATE UNIVERSITY           ,AL,36265-1602,Public       ,330,501,831,7291,,5830,13121
00102100,JEFFERSON DAVIS COMMUNITY COLLEGE       ,AL,36427-2790,Public       ,50,124,174,685,,921,1606
00102200,JEFFERSON STATE COMMUNITY COLLEGE       ,AL,35215-3098,Public       ,435,1153,1588,5239,,9201,14440
00102300,JUDSON COLLEGE                          ,AL,36756-2504,Private      ,19,12,31,367,,160,527
00102400,UNIVERSITY OF WEST ALABAMA              ,AL,35470-0000,Public       ,127,351,478,2704,,4778,7482
00102600,MARION MILITARY INSTITUTE               ,AL,36756-3214,Public       ,38,10,48,561,,103,664
00102800,MILES COLLEGE                           ,AL,35064-2697,Private      ,86,105,191,2640,,1410,4050
00102900,UNIVERSITY OF MOBILE                    ,AL,36613-0000,Private      ,127,222,349,1984,,2314,4298
00103000,BISHOP STATE COMMUNITY COLLEGE          ,AL,36603-5898,Public       ,275,723,998,2633,,5508,8141
00103100,NORTHEAST ALABAMA STATE CMNTY COLG      ,AL,35986-0159,Public       ,143,232,375,1494,,1955,3449
00103300,OAKWOOD COLLEGE                         ,AL,35896-0001,Private      ,60,107,167,1987,,1216,3203
00103400,ALABAMA SOUTHERN COMMUNITY COLLEGE      ,AL,36460-5698,Public       ,77,125,202,1247,,1077,2324
00103600,SAMFORD UNIVERSITY                      ,AL,35229-7000,Private      ,170,244,414,3994,,3089,7083
00103800,SNEAD STATE COMMUNITY COLLEGE           ,AL,35957-0734,Public       ,111,232,343,1666,,2002,3668
00104000,SOUTHERN UNION STATE COMMUNITY CLG      ,AL,36276-0000,Public       ,242,403,645,3671,,3489,7160
00104100,SPRING HILL COLLEGE                     ,AL,36608-1791,Private      ,106,129,235,2581,,1062,3643
00104400,STILLMAN COLLEGE                        ,AL,35403-0000,Private      ,83,92,175,1899,,776,2675
00104600,TALLADEGA COLLEGE                       ,AL,35160-2354,Private      ,49,44,93,1110,,570,1680
00104700,TROY UNIVERSITY                         ,AL,36082-0001,Public       ,502,1836,2338,9531,,21765,31296
00105000,TUSKEGEE UNIVERSITY                     ,AL,36088-1645,Private      ,152,76,228,5406,,1562,6968
00105100,UNIVERSITY OF ALABAMA (THE)             ,AL,35487-0120,Public       ,1292,965,2257,28750,,12141,40891
00105200,UNIVERSITY OF ALABAMA AT BIRMINGHAM     ,AL,35294-1150,Public       ,677,1099,1776,12579,,13780,26359
00105500,UNIVERSITY OF ALABAMA IN HUNTSVILLE     ,AL,35899-0001,Public       ,368,441,809,5479,,4849,10328
00105700,UNIVERSITY OF SOUTH ALABAMA             ,AL,36688-0002,Public       ,622,1006,1628,11114,,10999,22113
00105900,LAWSON STATE COMMUNITY COLLEGE          ,AL,35221-1798,Public       ,128,460,588,2354,,3965,6319
00105901,LAWSON STATE COMMUNITY COLLEGE - BESSEME,AL,35021-0308,Public       ,39,181,220,828,,1560,2388
00106000,FAULKNER STATE COMMUNITY COLLEGE        ,AL,36507-2698,Public       ,294,470,764,3575,,3908,7483
00526000,J.F. DRAKE STATE TECH COLLEGE           ,AL,35811-1584,Public       ,83,300,383,741,,2283,3024
00569100,SHELTON STATE COMMUNITY CLG             ,AL,35405-4017,Public       ,295,559,854,4545,,4237,8782
00569200,REID STATE TECHNICAL COLLEGE            ,AL,36401-0000,Public       ,18,90,108,257,,717,974
00569700,NORTHWEST- SHOALS COMMUNITY COLLEGE     ,AL,35661-0000,Public       ,590,436,1026,2692,,2660,5352
00569900,GEORGE C WALLACE STATE CMTY COLLEGE     ,AL,36703-0000,Public       ,79,206,285,1233,,1973,3206
00573300,BEVILL STATE CMTY COLLEGE-WALKER        ,AL,35148-0000,Public       ,162,427,589,2333,,3432,5765
00573400,H. COUNCILL TRENHOLM STATE TECH COLLEGE ,AL,36108-0020,Public       ,85,289,374,897,,2301,3198
00573401,H. C. TRENHOLM ST TECH COL-PATTERSON CAM,AL,36116-2612,Public       ,49,159,208,545,,1284,1829
00787100,GEORGE C WALLACE STATE CMTY CLG         ,AL,35077-2000,Public       ,292,514,806,3730,,4356,8086
00831000,AUBURN UNIVERSITY-MONTGOMERY            ,AL,36124-0000,Public       ,224,435,659,4800,,5013,9813
00898800,LURLEEN B WALLACE COMMUNITY COLLEGE     ,AL,36420-0418,Public       ,74,156,230,1130,,1332,2462
01055400,CONCORDIA COLLEGE                       ,AL,36701-3323,Private      ,33,32,65,812,,546,1358
01218200,CHATTAHOOCHEE VALLEY CMTY CLG           ,AL,36869-7917,Public       ,86,249,335,1244,,2250,3494
01303906,SOUTH UNIVERSITY - MONTGOMERY           ,AL,36116-1120,Proprietary  ,44,215,259,445,,1711,2156
02170600,UNITED STATES SPORTS ACADEMY            ,AL,36526-7055,Private      ,3,92,95,45,,753,798
02199700,HERITAGE CHRISTIAN UNIVERSITY           ,AL,35630-0000,Private      ,6,10,16,39,,98,137
02270400,SOUTHEASTERN BIBLE COLLEGE              ,AL,35244-2083,Private      ,13,35,48,148,,331,479
02285000,PAUL MITCHELL THE SCHOOL HUNTSVILLE     ,AL,35758-0000,Proprietary  ,15,27,42,97,,199,296
02296000,PRINCE INSTITUTE OF PROFESSIONAL STUDIES,AL,36117-0000,Proprietary  ,5,34,39,50,,356,406
02341000,FORTIS COLLEGE                          ,AL,36609-0000,Proprietary  ,77,284,361,767,,2528,3295
02503400,AMRIDGE UNIVERSITY                      ,AL,36124-0000,Private      ,11,122,133,91,,1251,1342
03010600,VIRGINIA COLLEGE                        ,AL,35209-5154,Proprietary  ,494,2558,3052,3730,,21925,25655
03010602,VIRGINIA COLLEGE - HUNTSVILLE           ,AL,35805-0000,Proprietary  ,27,138,165,269,,1079,1348
03010607,VIRGINIA COLLEGE - MOBILE               ,AL,36608-1626,Proprietary  ,35,204,239,419,,1586,2005
03010616,VIRGINIA COLLEGE - MONTGOMERY           ,AL,36117-2802,Proprietary  ,38,200,238,453,,1785,2238
03026516,REMINGTON COLLEGE - MOBILE              ,AL,36609-5593,Private      ,24,99,123,695,,1840,2535
03032500,ALABAMA STATE CLG BARBER STYLING        ,AL,35215-0000,Proprietary  ,13,35,48,100,,200,300
03361400,FORTIS COLLEGE                          ,AL,36535-0000,Proprietary  ,18,85,103,196,,695,891
03459300,SOUTHEASTERN SCHOOL OF COSMETOLOGY      ,AL,35228-0000,Private      ,3,30,33,45,,158,203
03783300,BLUE CLIFF CAREER COLLEGE               ,AL,63306-4749,Proprietary  ,10,61,71,129,,392,521
03894300,HUNTSVILLE BIBLE COLLEGE                ,AL,35811-0000,Private      ,2,22,24,34,,254,288
04066300,CARDIAC AND VASCULAR INSTITUTE OF ULTRAS,AL,36604-1411,Proprietary  ,8,44,52,68,,349,417
04067300,SELMA UNIVERSITY                        ,AL,36701-0000,Private      ,8,46,54,225,,647,872
04121500,COLUMBIA SOUTHERN UNIVERSITY            ,AL,36561-3815,Proprietary  ,67,1910,1977,567,,15527,16094
04149200,XCELL ACADEMY-A PAUL MITCHELL PARTNER SC,AL,35216-4990,Proprietary  ,12,48,60,113,,291,404
04187200,NEW BEGINNING COLLEGE OF COSMETOLOGY    ,AL,35950-2415,Proprietary  ,5,29,34,69,,169,238
04187300,HAIR ACADEMY (THE)                      ,AL,36111-2201,Proprietary  ,6,18,24,71,,173,244
04197500,UNIVERSITY ACADEMY OF HAIR DESIGN       ,AL,35476-3100,Proprietary  ,5,9,14,46,,102,148
04211000,SALON PROFESSIONAL ACADEMY (THE)        ,AL,35816-1849,Proprietary  ,9,26,35,72,,187,259
00111100,ALLAN HANCOCK COLLEGE                   ,CA,93454-6399,Public       ,345,779,1124,5228,,5809,11037
00111300,ANTELOPE VALLEY COLLEGE                 ,CA,93536-5426,Public       ,545,1497,2042,7630,,12555,20185
00111600,ART CENTER COLLEGE OF DESIGN            ,CA,91103-1999,Private      ,105,133,238,2005,,1663,3668
00111700,AZUSA PACIFIC UNIVERSITY                ,CA,91702-7000,Private      ,332,846,1178,10899,,9769,20668
00111800,BAKERSFIELD COLLEGE                     ,CA,93305-1299,Public       ,614,1310,1924,11373,,11932,23305
00111900,BARSTOW COMMUNITY COLLEGE               ,CA,92311-6608,Public       ,119,550,669,1551,,4528,6079
00112000,AMER BAPT SEM OF THE WEST-BERKELEY      ,CA,94704-0000,Private      ,2,7,9,13,,65,78
00112200,BIOLA UNIVERSITY                        ,CA,90639-0001,Private      ,176,156,332,6914,,2421,9335
00112300,BROOKS INSTITUTE                        ,CA,93103-1809,Proprietary  ,45,39,84,547,,456,1003
00112400,CABRILLO COLLEGE                        ,CA,95003-3194,Public       ,328,664,992,5392,,6034,11426
00112500,CALIFORNIA BAPTIST UNIVERSITY           ,CA,92504-3297,Private      ,233,506,739,7499,,6132,13631
00112700,CALIFORNIA COLLEGE OF THE ARTS          ,CA,94107-2206,Private      ,120,107,227,2445,,2058,4503
00113100,CALIFORNIA INSTITUTE OF TECHNOLOGY      ,CA,91125-0001,Private      ,189,56,245,3714,,759,4473
00113200,CALIFORNIA INSTITUTE OF THE ARTS        ,CA,91355-2397,Private      ,140,96,236,2766,,1682,4448
00113300,CALIFORNIA LUTHERAN UNIVERSITY          ,CA,91360-2787,Private      ,131,134,265,5337,,1965,7302
00113400,CALIFORNIA MARITIME ACADEMY             ,CA,94590-8181,Public       ,24,37,61,1131,,480,1611
00113700,CALIF STATE UNIV-FULLERTON              ,CA,92831-3599,Public       ,1242,1087,2329,50592,,24723,75315
00113800,"CALIFORNIA STATE UNIVERSITY, EAST BAY   ",CA,94542-3000,Public       ,437,756,1193,17632,,15072,32704
00113900,CALIF STATE UNIV-LONG BEACH             ,CA,90840-0006,Public       ,1715,1265,2980,59829,,26467,86296
00114000,CALIF STATE UNIV-LOS ANGELES            ,CA,90032-4226,Public       ,971,1077,2048,38193,,24361,62554
00114100,"CALIF STATE UNIV, DOMINGUEZ HILLS       ",CA,90747-0001,Public       ,452,740,1192,19059,,17075,36134
00114200,CALIF STATE UNIV SAN BERNARDINO         ,CA,92407-2397,Public       ,469,737,1206,22251,,15339,37590
00114300,CAL POLY STATE UNIVERSITY               ,CA,93407-0001,Public       ,976,250,1226,39370,,5110,44480
00114400,CALIF STATE POLYTECHNIC UNIV POMONA     ,CA,91768-2500,Public       ,787,508,1295,36357,,12549,48906
00114600,CALIF STATE UNIV - CHICO                ,CA,95929-0001,Public       ,740,462,1202,23014,,7707,30721
00114700,CALIF STATE UNIV - FRESNO               ,CA,93740-8026,Public       ,732,677,1409,26699,,13787,40486
00114900,HUMBOLDT STATE UNIVERSITY               ,CA,95521-8299,Public       ,377,238,615,13247,,4716,17963
00115000,CALIF STATE UNIV-SACRAMENTO             ,CA,95819-6044,Public       ,876,1096,1972,33313,,21517,54830
00115100,SAN DIEGO STATE UNIVERSITY              ,CA,92182-1690,Public       ,1754,1154,2908,59660,,23131,82791
00115300,CALIF STATE UNIV-NORTHRIDGE             ,CA,91330-8307,Public       ,983,1084,2067,43277,,23856,67133
00115400,SAN FRANCISCO STATE UNIVERSITY          ,CA,94132-1740,Public       ,1007,1020,2027,41259,,21184,62443
00115500,SAN JOSE STATE UNIVERSITY               ,CA,95192-0036,Public       ,928,907,1835,34138,,18422,52560
00115600,SONOMA STATE UNIVERSITY                 ,CA,94928-3609,Public       ,387,215,602,14007,,4113,18120
00115700,CALIF STATE UNIV-STANISLAUS             ,CA,95382-0299,Public       ,241,309,550,10255,,6646,16901
00116100,CERRITOS COLLEGE                        ,CA,90650-6296,Public       ,892,1500,2392,18725,,15395,34120
00116200,CHABOT COLLEGE                          ,CA,94545-2400,Public       ,366,895,1261,6896,,8104,15000
00116300,CHAFFEY COLLEGE                         ,CA,91737-9400,Public       ,856,1550,2406,16298,,16334,32632
00116400,CHAPMAN UNIVERSITY                      ,CA,92866-1099,Private      ,383,205,588,12154,,3638,15792
00116453,CHAPMAN UNIVERSITY SCHOOL OF LAW        ,CA,92866-0000,Private      ,5,34,39,79,,1471,1550
00116500,CHURCH DIV SCH OF THE PACIFIC           ,CA,94709-0000,Private      ,0,2,2,5,,70,75
00116600,CITRUS COLLEGE                          ,CA,91741-1899,Public       ,414,583,997,11043,,8171,19214
00116900,CLAREMONT GRADUATE UNIVERSITY           ,CA,91711-0000,Private      ,1,97,98,33,,1961,1994
00117000,CLAREMONT MCKENNA COLLEGE               ,CA,91711-6400,Private      ,124,19,143,3771,,213,3984
00117100,HARVEY MUDD COLLEGE                     ,CA,91711-5990,Private      ,83,8,91,2674,,131,2805
00117200,PITZER COLLEGE                          ,CA,91711-6101,Private      ,81,16,97,3021,,231,3252
00117300,POMONA COLLEGE                          ,CA,91711-6301,Private      ,129,27,156,5111,,288,5399
00117400,SCRIPPS COLLEGE                         ,CA,91711-3948,Private      ,44,20,64,1969,,180,2149
00117600,WEST HILLS COMMUNITY COLLEGE            ,CA,93210-1399,Public       ,62,188,250,1527,,1430,2957
00117700,COGSWELL POLYTECHNICAL COLLEGE          ,CA,94089-1210,Proprietary  ,42,26,68,443,,235,678
00117800,COLLEGE OF MARIN                        ,CA,94904-2590,Public       ,71,234,305,1290,,2513,3803
00117801,COLG OF MARIN-INDIAN VALLEY CMPS        ,CA,94949-0000,Public       ,23,77,100,315,,771,1086
00117900,NOTRE DAME DE NAMUR UNIVERSITY          ,CA,94002-1997,Private      ,52,110,162,1890,,1549,3439
00118100,COLLEGE OF SAN MATEO                    ,CA,94402-3784,Public       ,174,381,555,3644,,3398,7042
00118200,COLLEGE OF THE DESERT                   ,CA,92260-9305,Public       ,208,580,788,5936,,6487,12423
00118300,HOLY NAMES UNIVERSITY                   ,CA,94619-1699,Private      ,41,84,125,1119,,1346,2465
00118500,COLLEGE OF THE REDWOODS                 ,CA,95501-9300,Public       ,218,488,706,2759,,4225,6984
00118600,COLLEGE OF THE SEQUOIAS                 ,CA,93277-2234,Public       ,477,1047,1524,7253,,7718,14971
00118700,COLLEGE OF THE SISKIYOUS                ,CA,96094-2899,Public       ,39,131,170,1117,,1284,2401
00118701,COLLEGE OF THE SISKIYOUS - YREKA CENTER ,CA,96097-9538,Public       ,9,54,63,163,,430,593
00119000,CONTRA COSTA COLLEGE                    ,CA,94806-3195,Public       ,145,437,582,2746,,4241,6987
00119100,DIABLO VALLEY COLLEGE                   ,CA,94523-1544,Public       ,420,775,1195,6855,,6694,13549
00119200,CUESTA COLLEGE                          ,CA,93403-8106,Public       ,302,610,912,4865,,4407,9272
00119300,CYPRESS COLLEGE                         ,CA,90630-5897,Public       ,583,989,1572,12286,,10439,22725
00119600,DOMINICAN UNIVERSITY OF CALIFORNIA      ,CA,94901-2298,Private      ,66,76,142,3135,,1485,4620
00119700,EL CAMINO COLLEGE                       ,CA,90506-0002,Public       ,764,1389,2153,16258,,14763,31021
00119701,COMPTON COMMUNITY COLLEGE               ,CA,90221-5393,Public       ,191,542,733,3885,,5858,9743
00119900,FOOTHILL COLLEGE                        ,CA,94022-4597,Public       ,222,518,740,4156,,5207,9363
00120000,FULLER THEOLOGICAL SEMINARY             ,CA,91182-0000,Private      ,0,116,116,29,,2283,2312
00120100,FULLERTON COLLEGE                       ,CA,92832-2095,Public       ,693,1261,1954,15886,,11268,27154
00120200,GAVILAN COLLEGE                         ,CA,95020-9599,Public       ,154,194,348,2245,,2353,4598
00120300,GLENDALE COMMUNITY COLLEGE              ,CA,91208-2894,Public       ,391,714,1105,11417,,10007,21424
00120500,GOLDEN GATE UNIVERSITY                  ,CA,94105-2967,Private      ,18,245,263,255,,3486,3741
00120600,GOLDEN WEST COLLEGE                     ,CA,92647-2748,Public       ,462,829,1291,10160,,8636,18796
00120700,GRADUATE THEOLOGICAL UNION              ,CA,94709-0000,Private      ,0,6,6,1,,302,303
00120800,GROSSMONT COLLEGE                       ,CA,92020-1799,Public       ,636,1396,2032,10948,,12786,23734
00120900,HARTNELL COMMUNITY COLLEGE              ,CA,93901-1697,Public       ,250,389,639,4538,,3603,8141
00121200,HUMPHREYS COLLEGE                       ,CA,95207-3896,Private      ,20,125,145,398,,1330,1728
00121400,IMPERIAL VALLEY COLLEGE                 ,CA,92251-9787,Public       ,189,348,537,4935,,4129,9064
00121500,LA SIERRA UNIVERSITY                    ,CA,92515-3332,Private      ,105,125,230,3837,,1746,5583
00121600,UNIVERSITY OF LA VERNE                  ,CA,91750-4443,Private      ,178,514,692,6801,,7487,14288
00121700,LASSEN COLLEGE                          ,CA,96130-3000,Public       ,28,87,115,614,,746,1360
00121800,LOMA LINDA UNIVERSITY                   ,CA,92350-0001,Private      ,50,240,290,1438,,6432,7870
00121900,LONG BEACH CITY COLLEGE                 ,CA,90808-1780,Public       ,778,1535,2313,19560,,17748,37308
00122000,MASTER'S COLLEGE & SEMINARY (THE)       ,CA,91321-1200,Private      ,41,47,88,1504,,522,2026
00122300,LOS ANGELES CITY COLLEGE                ,CA,90029-3588,Public       ,616,1597,2213,12045,,18149,30194
00122400,LOS ANGELES HARBOR COLLEGE              ,CA,90744-2397,Public       ,317,528,845,5090,,5940,11030
00122600,LOS ANGELES PIERCE COLLEGE              ,CA,91371-0001,Public       ,711,1164,1875,14270,,12597,26867
00122700,LOS ANGELES TRADE TECH COLLEGE          ,CA,90015-4181,Public       ,614,2015,2629,8141,,16340,24481
00122800,LOS ANGELES VALLEY COLLEGE              ,CA,91401-4096,Public       ,537,1061,1598,10978,,12316,23294
00122900,SO CA UNIV  HEALTH SCIENCES             ,CA,90604-4051,Private      ,3,57,60,54,,807,861
00123000,SOUTHERN CA COLLEGE OF OPTOMETRY        ,CA,92831-1699,Private      ,0,8,8,23,,516,539
00123200,AMERICAN RIVER COLLEGE                  ,CA,95841-4286,Public       ,902,2487,3389,15496,,24202,39698
00123300,SACRAMENTO CITY COLLEGE                 ,CA,95822-1386,Public       ,811,1962,2773,16061,,19601,35662
00123600,MENLO COLLEGE                           ,CA,94027-4301,Private      ,55,12,67,1705,,266,1971
00123700,MERCED COMMUNITY COLLEGE                ,CA,95348-2898,Public       ,395,746,1141,7170,,6604,13774
00123800,MILLS COLLEGE                           ,CA,94613-1301,Private      ,60,152,212,1982,,2030,4012
00123900,MIRACOSTA COLLEGE                       ,CA,92056-3899,Public       ,386,942,1328,5658,,7948,13606
00124000,MODESTO JUNIOR COLLEGE                  ,CA,95350-5800,Public       ,623,1431,2054,11064,,13216,24280
00124200,MONTEREY PENINSULA COLLEGE              ,CA,93940-4799,Public       ,173,359,532,3344,,3127,6471
00124300,MOUNT ST MARYS COLLEGE                  ,CA,90049-1599,Private      ,73,217,290,3767,,2863,6630
00124500,MT. SAN ANTONIO COLLEGE                 ,CA,91789-1399,Public       ,693,1231,1924,21106,,17198,38304
00124600,MT SAN JACINTO COLLEGE                  ,CA,92583-2399,Public       ,694,1604,2298,9797,,13005,22802
00124700,NAPA VALLEY COLLEGE                     ,CA,94558-6236,Public       ,173,351,524,3316,,3310,6626
00124900,OCCIDENTAL COLLEGE                      ,CA,90041-3314,Private      ,141,39,180,5547,,472,6019
00125000,ORANGE COAST COLLEGE - FIN AID OFF      ,CA,92628-5005,Public       ,708,1110,1818,15113,,11619,26732
00125100,OTIS COLLEGE OF ART AND DESIGN          ,CA,90045-3505,Private      ,81,72,153,1771,,923,2694
00125200,HOPE INTERNATIONAL UNIVERSITY           ,CA,92631-0000,Private      ,38,90,128,894,,1244,2138
00125300,FRESNO PACIFIC UNIVERSITY               ,CA,93702-4798,Private      ,97,324,421,2931,,4404,7335
00125400,PACIFIC LUTHERAN THEOLOGICAL SEM        ,CA,94708-0000,Private      ,0,4,4,2,,70,72
00125500,PACIFIC OAKS COLLEGE                    ,CA,91103-3606,Private      ,3,131,134,88,,1615,1703
00125600,PACIFIC SCHOOL OF RELIGION              ,CA,94709-0000,Private      ,0,8,8,2,,207,209
00125800,PACIFIC UNION COLLEGE                   ,CA,94508-9797,Private      ,41,52,93,2043,,580,2623
00125900,PALO VERDE COLLEGE                      ,CA,92225-0000,Public       ,32,68,100,295,,547,842
00126000,PALOMAR COLLEGE                         ,CA,92069-1486,Public       ,644,1335,1979,11366,,10826,22192
00126100,PASADENA CITY COLLEGE                   ,CA,91106-2003,Public       ,884,1447,2331,20236,,15023,35259
00126200,POINT LOMA NAZARENE UNIVERSITY          ,CA,92106-2899,Private      ,161,144,305,5088,,1761,6849
00126600,LANEY COLLEGE                           ,CA,94607-4893,Public       ,226,1004,1230,4621,,9358,13979
00126700,MERRITT COLLEGE                         ,CA,94619-3196,Public       ,156,614,770,2923,,6063,8986
00126800,PORTERVILLE COLLEGE                     ,CA,93257-6059,Public       ,144,259,403,2591,,2561,5152
00126900,RIO HONDO COLLEGE                       ,CA,90601-1699,Public       ,468,801,1269,13994,,9905,23899
00127000,RIVERSIDE CITY COLLEGE                  ,CA,92506-1299,Public       ,928,1868,2796,21391,,20747,42138
00127200,SAN BERNARDINO VALLEY COLLEGE           ,CA,92410-2798,Public       ,557,1490,2047,10920,,15027,25947
00127300,SAN DIEGO CITY COLLEGE                  ,CA,92101-4787,Public       ,707,1866,2573,12204,,17498,29702
00127500,SAN DIEGO MESA COLLEGE                  ,CA,92111-4996,Public       ,795,1518,2313,13217,,15140,28357
00127800,SAN FRANCISCO CONSERVATORY OF MUSIC     ,CA,94122-4498,Private      ,19,28,47,344,,470,814
00127900,SAN FRANCISCO THEOLOGICAL SEMINARY      ,CA,94960-0000,Private      ,0,1,1,1,,65,66
00128000,SAN JOAQUIN DELTA COLLEGE               ,CA,95207-6370,Public       ,674,1453,2127,10709,,12742,23451
00128100,WILLIAM JESSUP UNIVERSITY               ,CA,95765-3707,Private      ,40,85,125,1216,,792,2008
00128200,SAN JOSE CITY COLLEGE                   ,CA,95128-2797,Public       ,285,719,1004,5340,,7590,12930
00128400,SANTA ANA COLLEGE                       ,CA,92706-3398,Public       ,411,722,1133,9732,,8586,18318
00128500,SANTA BARBARA CITY COLLEGE              ,CA,93109-2394,Public       ,466,687,1153,10252,,6732,16984
00128600,SANTA MONICA COLLEGE                    ,CA,90405-1644,Public       ,907,1282,2189,22074,,13662,35736
00128700,SANTA ROSA JUNIOR COLLEGE               ,CA,95401-4395,Public       ,461,918,1379,7214,,8424,15638
00128800,CLAREMONT SCHOOL OF THEOLOGY            ,CA,91711-0000,Private      ,1,18,19,8,,323,331
00128900,SHASTA COLLEGE                          ,CA,96049-7692,Public       ,247,744,991,4286,,6053,10339
00129000,SIERRA COLLEGE                          ,CA,95677-3397,Public       ,614,1222,1836,9497,,10860,20357
00129100,SIMPSON UNIVERSITY                      ,CA,96003-8606,Private      ,45,80,125,1442,,1312,2754
00129200,SOLANO COMMUNITY COLLEGE                ,CA,94534-3197,Public       ,251,821,1072,4192,,6544,10736
00129300,VANGUARD UNIVERSITY OF SOUTHERN CA      ,CA,92626-6597,Private      ,63,108,171,2676,,1456,4132
00129400,SOUTHWESTERN COLLEGE                    ,CA,91910-7299,Public       ,648,1122,1770,10944,,10259,21203
00129500,SOUTHWESTERN LAW SCHOOL                 ,CA,90010-1106,Private      ,6,44,50,77,,2300,2377
00129600,DOMINICAN SCH PHILOSOPHY & THEOLOGY     ,CA,94709-0000,Private      ,1,5,6,10,,75,85
00129900,ST JOHN'S SEMINARY COLLEGE              ,CA,93010-0000,Private      ,0,2,2,8,,10,18
00130200,SAINT MARY'S COLLEGE OF CALIFORNIA      ,CA,94556-2744,Private      ,127,137,264,5941,,1851,7792
00130500,STANFORD UNIVERSITY                     ,CA,94305-6106,Private      ,1108,303,1411,27503,,4272,31775
00130501,STANFORD UNIVERSITY - GRADUATE SCHOOL OF,CA,94305-5301,Private      ,8,79,87,89,,1645,1734
00130502,STANFORD UNIVERSITY - GRADUATE SCHOOL OF,CA,94305-5015,Private      ,10,112,122,104,,1999,2103
00130503,STANFORD UNIVERSITY - STANFORD LAW SCHOO,CA,94305-3096,Private      ,13,62,75,261,,2408,2669
00130700,FRESNO CITY COLLEGE                     ,CA,93741-0002,Public       ,945,2317,3262,18075,,19494,37569
00130800,REEDLEY COLLEGE                         ,CA,93654-2099,Public       ,363,734,1097,7866,,6095,13961
00130900,TAFT COLLEGE                            ,CA,93268-2317,Public       ,91,204,295,1976,,1858,3834
00131200,UNIVERSITY OF CALIFORNIA-BERKELEY       ,CA,94720-1520,Public       ,1399,960,2359,58971,,21126,80097
00131300,UNIVERSITY OF CALIFORNIA-DAVIS          ,CA,95616-8558,Public       ,956,471,1427,55915,,15788,71703
00131400,UNIVERSITY OF CALIFORNIA-IRVINE         ,CA,92697-2825,Public       ,1069,631,1700,61138,,15453,76591
00131500,UNIVERSITY OF CALIFORNIA (UCLA)         ,CA,90095-9000,Public       ,1965,1409,3374,76221,,29441,105662
00131502,UNIV OF CALIFORNIA LOS ANG SCH MED      ,CA,90095-0000,Public       ,23,37,60,386,,1239,1625
00131503,UNIV OF CALIFORNIA LOS ANG DENTAL       ,CA,90095-0000,Public       ,8,14,22,136,,245,381
00131600,UNIVERSITY OF CALIFORNIA-RIVERSIDE      ,CA,92521-0209,Public       ,666,528,1194,42016,,10742,52758
00131700,UNIVERSITY OF CALIFORNIA-SAN DIEGO      ,CA,92093-0013,Public       ,1069,515,1584,55076,,12001,67077
00131900,UNIVERSITY OF CALIFORNIA-SFRANCISCO     ,CA,94143-0246,Public       ,163,212,375,1998,,4956,6954
00132000,UNIVERSITY OF CALIFORNIA-SANTA BARB     ,CA,93106-3180,Public       ,991,289,1280,54807,,7980,62787
00132100,UNIVERSITY OF CALIFORNIA-SANTA CRUZ     ,CA,95064-0001,Public       ,704,254,958,38322,,5830,44152
00132200,UNIVERSITY OF REDLANDS                  ,CA,92373-0999,Private      ,154,376,530,6004,,3762,9766
00132500,UNIVERSITY OF SAN FRANCISCO             ,CA,94117-1080,Private      ,414,485,899,14186,,8823,23009
00132600,SANTA CLARA UNIVERSITY                  ,CA,95053-4956,Private      ,335,152,487,12406,,3801,16207
00132604,JESUIT SCHOOL OF THEOLOGY - BERKELEY    ,CA,94709-1193,Private      ,1,1,2,3,,58,61
00132800,UNIVERSITY OF SOUTHERN CALIFORNIA       ,CA,90089-0914,Private      ,1443,1640,3083,46643,,31477,78120
00132900,UNIVERSITY OF THE PACIFIC               ,CA,95211-0197,Private      ,207,176,383,12658,,3874,16532
00132901,UNIVERSITY OF THE PACIFIC - MCGEORGE SCH,CA,95817-2799,Private      ,17,49,66,218,,1580,1798
00132902,UNIV OF THE PACIFIC SCH OF DENT         ,CA,94115-0000,Private      ,7,10,17,87,,710,797
00133400,VENTURA COLLEGE                         ,CA,93003-3899,Public       ,393,748,1141,6963,,6480,13443
00133500,VICTOR VALLEY COLLEGE                   ,CA,92395-5849,Public       ,467,1153,1620,7593,,11150,18743
00133800,WEST VALLEY COLLEGE                     ,CA,95070-5697,Public       ,178,315,493,3494,,3240,6734
00134100,WESTMONT COLLEGE                        ,CA,93108-1099,Private      ,83,23,106,2716,,195,2911
00134200,WHITTIER COLLEGE                        ,CA,90601-4413,Private      ,128,55,183,4505,,761,5266
00134201,WHITTIER COLLEGE - COLLEGE OF LAW       ,CA,92626-1501,Private      ,3,13,16,42,,1329,1371
00134300,WOODBURY UNIVERSITY                     ,CA,91510-7846,Private      ,54,59,113,1358,,997,2355
00134400,YUBA COLLEGE                            ,CA,95901-7699,Public       ,251,708,959,3854,,5636,9490
00177212,TRINITY INTERNATIONAL UNIV-CA           ,CA,92705-0000,Private      ,0,32,32,19,,383,402
00188100,ASHFORD UNIVERSITY                      ,CA,92123-1406,Proprietary  ,216,9248,9464,2499,,99174,101673
00274100,AMERICAN JEWISH UNIVERSITY              ,CA,90077-1599,Private      ,3,4,7,111,,149,260
00301002,ANTIOCH UNIV/LOS ANGELES                ,CA,90230-7615,Private      ,5,84,89,65,,1141,1206
00301003,ANTIOCH  UNIV/SANTA BARBARA             ,CA,93101-0000,Private      ,46,39,85,795,,634,1429
00369110,MIDDLEBURY COLLEGE - MONTEREY INSTITUTE ,CA,93940-2691,Private      ,8,58,66,59,,934,993
00394700,UC-HASTINGS COLLEGE OF THE LAW          ,CA,94102-0000,Public       ,2,43,45,43,,2997,3040
00394800,SAN FRANCISCO ART INSTITUTE             ,CA,94133-2299,Private      ,131,122,253,2093,,1488,3581
00408000,STARR KING SCHOOL FOR THE MINISTRY      ,CA,94709-1299,Private      ,0,6,6,1,,93,94
00448000,DE ANZA COLLEGE                         ,CA,95014-5793,Public       ,560,786,1346,10357,,8061,18418
00448100,OHLONE COLLEGE                          ,CA,94539-5847,Public       ,242,397,639,4092,,3737,7829
00448400,JOHN F. KENNEDY UNIVERSITY              ,CA,94523-4817,Private      ,2,120,122,56,,1607,1663
00449000,PATTEN UNIVERSITY                       ,CA,94601-2699,Private      ,0,0,0,47,,89,136
00449400,EVEREST COLLEGE                         ,CA,92408-3752,Proprietary  ,49,188,237,573,,1196,1769
00450200,CITY COLLEGE OF SAN FRANCISCO           ,CA,94112-0000,Public       ,563,1859,2422,10491,,15621,26112
00450302,EVEREST COLLEGE - SANTA ANA             ,CA,92701-4559,Proprietary  ,42,87,129,465,,605,1070
00563800,DOWNEY ADULT SCHOOL                     ,CA,90241-5610,Public       ,31,105,136,315,,850,1165
00565500,HACIENDA LA PUENTE ADULT EDUC CTR       ,CA,91746-0000,Public       ,33,124,157,282,,790,1072
00616500,LA CNTY CLG OF NURSING & ALLD HLTH      ,CA,90033-1018,Public       ,14,66,80,230,,707,937
00672000,COLLEGE OF ALAMEDA                      ,CA,94501-2109,Public       ,136,427,563,3025,,4257,7282
00673100,CASA LOMA COLLEGE                       ,CA,91405-4523,Private      ,32,77,109,275,,676,951
00697300,CANADA COLLEGE                          ,CA,94061-1099,Public       ,101,244,345,1552,,2335,3887
00697500,LINCOLN UNIVERSITY                      ,CA,94612-2801,Private      ,2,19,21,40,,197,237
00701200,SAMUEL MERRITT COLLEGE                  ,CA,94609-3108,Private      ,28,204,232,484,,2800,3284
00704700,LOS ANGELES SOUTHWEST COLLEGE           ,CA,90047-4810,Public       ,201,805,1006,3904,,8667,12571
00705000,BELLUS ACADEMY                          ,CA,91950-3616,Proprietary  ,7,30,37,90,,210,300
00711500,MOORPARK COLLEGE                        ,CA,93021-1695,Public       ,405,599,1004,6871,,5113,11984
00713000,NEWBERRY SCHOOLS OF BEAUTY              ,CA,91344-7404,Proprietary  ,7,13,20,85,,101,186
00714200,LYLE'S COLLEGE OF BEAUTY                ,CA,93710-3948,Proprietary  ,5,28,33,122,,199,321
00716400,BRYAN COLLEGE                           ,CA,90057-0000,Proprietary  ,38,262,300,254,,1749,2003
00718700,NORTH ADRIAN'S COLLEGE OF BEAUTY        ,CA,95350-2381,Proprietary  ,13,59,72,139,,273,412
00719000,WYOTECH                                 ,CA,94539-7663,Proprietary  ,58,181,239,649,,1305,1954
00720300,SALON SUCCESS ACADEMY                   ,CA,91786-4060,Proprietary  ,9,20,29,137,,157,294
00720400,MODERN BEAUTY ACADEMY                   ,CA,93030-7016,Proprietary  ,3,9,12,68,,81,149
00722900,WESTERN BEAUTY INSTITUTE                ,CA,91402-3104,Proprietary  ,15,10,25,196,,324,520
00723400,HEALD COLLEGE                           ,CA,94105-2206,Proprietary  ,45,200,245,678,,1812,2490
00723404,HEALD COLLEGE - CONCORD                 ,CA,94520-0000,Proprietary  ,92,234,326,855,,2022,2877
00723405,HEALD COLLEGE - MILPITAS                ,CA,95035-8008,Proprietary  ,55,220,275,835,,2187,3022
00723406,HEALD COLLEGE - HAYWARD                 ,CA,94545-2352,Proprietary  ,62,197,259,769,,1901,2670
00723407,HEALD COLLEGE - MODESTO                 ,CA,95368-9095,Proprietary  ,41,132,173,774,,1419,2193
00723408,HEALD COLLEGE - ROSEVILLE               ,CA,95678-5303,Proprietary  ,50,206,256,726,,1954,2680
00723409,HEALD COLLEGE - SALINAS                 ,CA,93906-5100,Proprietary  ,34,127,161,781,,1525,2306
00723410,HEALD COLLEGE - STOCKTON                ,CA,95210-5667,Proprietary  ,69,218,287,1060,,2334,3394
00723411,HEALD COLLEGE - RANCHO CORDOVA          ,CA,95670-6005,Proprietary  ,49,165,214,585,,1679,2264
00723412,HEALD COLLEGE - FRESNO                  ,CA,93704-1706,Proprietary  ,76,281,357,1376,,2797,4173
00725300,FEDERICO BEAUTY INSTITUTE               ,CA,95834-1905,Proprietary  ,34,85,119,300,,501,801
00729600,COLEMAN COLLEGE                         ,CA,92123-0000,Private      ,31,145,176,281,,958,1239
00732909,ITT TECHNICAL INSTITUTE                 ,CA,92868-3506,Proprietary  ,86,370,456,652,,2518,3170
00732971,ITT TECHNICAL INSTITUTE                 ,CA,95670-6047,Proprietary  ,88,337,425,565,,2099,2664
00732976,ITT TECHNICAL INSTITUTE                 ,CA,92408-3519,Proprietary  ,129,376,505,1112,,2779,3891
00732981,ITT TECHNICAL INSTITUTE                 ,CA,92123-2662,Proprietary  ,102,504,606,791,,3086,3877
00732985,ITT TECHNICAL INSTITUTE                 ,CA,91773-2933,Proprietary  ,73,242,315,539,,1802,2341
00732989,ITT TECHNICAL INSTITUTE                 ,CA,90502-1356,Proprietary  ,65,354,419,503,,1936,2439
00732994,ITT TECHNICAL INSTITUTE                 ,CA,91342-3664,Proprietary  ,83,296,379,487,,1639,2126
00747600,MARINELLO SCHOOLS OF BEAUTY             ,CA,90023-2666,Proprietary  ,35,99,134,462,,641,1103
00747602,MARINELLO SCHOOLS OF BEAUTY - SPA ACADEM,CA,90048-5101,Proprietary  ,18,44,62,156,,281,437
00747603,MARINELLO SCHOOLS OF BEAUTY - INGLEWOOD ,CA,90301-2306,Proprietary  ,8,25,33,90,,158,248
00747604,MARINELLO SCHOOLS OF BEAUTY - RESEDA    ,CA,91335-4218,Proprietary  ,1,5,6,24,,43,67
00747606,MARINELLO SCHOOLS OF BEAUTY - WEST COVIN,CA,91790-2805,Proprietary  ,14,24,38,88,,89,177
00747607,MARINELLO SCHOOLS OF BEAUTY - SAN BERNAR,CA,92410-3261,Proprietary  ,8,20,28,166,,227,393
00747608,MARINELLO SCHOOLS OF BEAUTY - ONTARIO   ,CA,91762-2113,Proprietary  ,22,48,70,241,,326,567
00747609,MARINELLO SCHOOLS OF BEAUTY - WHITTIER  ,CA,90601-4107,Proprietary  ,8,15,23,130,,133,263
00747610,MARINELLO SCHOOLS OF BEAUTY - LOMITA    ,CA,90717-1460,Proprietary  ,8,20,28,75,,131,206
00747611,MARINELLO SCHOOLS OF BEAUTY - SAN DIEGO ,CA,92126-4217,Proprietary  ,19,67,86,228,,384,612
00747612,MARINELLO SCHOOLS OF BEAUTY - EL CAJON  ,CA,92020-2503,Proprietary  ,18,39,57,112,,241,353
00747613,MARINELLO SCHOOLS OF BEAUTY - VICTORVILL,CA,92392-5496,Proprietary  ,25,52,77,181,,341,522
00747614,MARINELLO SCHOOLS OF BEAUTY - ANAHEIM   ,CA,92801-4622,Proprietary  ,9,24,33,195,,216,411
00747615,MARINELLO SCHOOLS OF BEAUTY - SIMI VALLE,CA,93065-2801,Proprietary  ,10,18,28,92,,145,237
00753100,ACADEMY OF ART UNIVERSITY               ,CA,94105-3410,Proprietary  ,513,1086,1599,8440,,12856,21296
00753600,COSUMNES RIVER COLLEGE                  ,CA,95823-5799,Public       ,511,1256,1767,9974,,11817,21791
00754802,WESTWOOD COLLEGE OF TECHNOLOGY          ,CA,92801-0000,Proprietary  ,42,55,97,801,,684,1485
00754803,WESTWOOD COLLEGE OF TECHNOLOGY          ,CA,91786-0000,Proprietary  ,38,87,125,881,,922,1803
00760600,EVEREST COLLEGE                         ,CA,90010-2221,Proprietary  ,27,93,120,415,,686,1101
00760700,CONCORDE CAREER INSTITUTE               ,CA,91606-3134,Proprietary  ,52,119,171,377,,720,1097
00770700,COLUMBIA COLLEGE                        ,CA,95370-8580,Public       ,90,211,301,1394,,1638,3032
00771300,SKYLINE COLLEGE                         ,CA,94066-1698,Public       ,203,450,653,4043,,4179,8222
00793000,CONCORDE CAREER INSTITUTE               ,CA,92108-0000,Proprietary  ,45,201,246,443,,1426,1869
00799300,CALIF STATE UNIV BAKERSFIELD            ,CA,93311-1022,Public       ,272,399,671,11078,,7405,18483
00807100,CONCORDE CAREER INSTITUTE               ,CA,92840-9201,Proprietary  ,34,137,171,399,,937,1336
00807300,BUTTE COMMUNITY COLLEGE                 ,CA,95965-0000,Public       ,405,994,1399,7970,,9348,17318
00809000,EVEREST COLLEGE                         ,CA,91803-1310,Proprietary  ,29,107,136,333,,661,994
00853700,CONCORDE CAREER INSTITUTE               ,CA,92401-0000,Proprietary  ,35,153,188,444,,1196,1640
00859600,WEST LOS ANGELES COLLEGE                ,CA,90230-3500,Public       ,296,824,1120,5057,,8201,13258
00859700,FEATHER RIVER COLLEGE                   ,CA,95971-9124,Public       ,41,58,99,797,,584,1381
00884400,CALIFORNIA CHRISTIAN COLLEGE            ,CA,93703-3599,Private      ,12,24,36,114,,163,277
00884600,WRIGHT INSTITUTE                        ,CA,94704-0000,Private      ,0,17,17,6,,512,518
00890300,COLLEGE OF THE CANYONS                  ,CA,91355-1899,Public       ,374,576,950,8929,,6847,15776
00891800,SADDLEBACK COLLEGE                      ,CA,92692-3699,Public       ,516,895,1411,6703,,7578,14281
00902200,ASSOCIATED TECHNICAL COLLEGE            ,CA,90017-0000,Proprietary  ,19,109,128,183,,546,729
00903200,EMPIRE COLLEGE                          ,CA,95403-2122,Proprietary  ,19,89,108,211,,615,826
00915706,WYOMING TECHNICAL INSTITUTE - WEST SACRA,CA,95605-1507,Proprietary  ,8,32,40,321,,395,716
00927200,CRAFTON HILLS COLLEGE                   ,CA,92399-1799,Public       ,237,456,693,4511,,4514,9025
00950900,SKILLS & BUSINESS EDUCATION CENTER      ,CA,95824-1529,Public       ,26,147,173,352,,1053,1405
00974800,CARRINGTON COLLEGE CALIFORNIA           ,CA,95826-3203,Proprietary  ,104,294,398,1156,,2608,3764
00974801,CARRINGTON COLLEGE CALIFORNIA - SAN LEAN,CA,94578-3711,Proprietary  ,31,78,109,319,,598,917
00974802,CARRINGTON COLLEGE CALIFORNIA - PLEASANT,CA,94523-1984,Proprietary  ,39,113,152,292,,656,948
00974803,CARRINGTON COLLEGE CALIFORNIA - STOCKTON,CA,95207-5509,Proprietary  ,48,78,126,515,,764,1279
00974804,CARRINGTON COLLEGE CALIFORNIA - CITRUS H,CA,95621-5577,Proprietary  ,32,106,138,297,,667,964
00974806,CARRINGTON COLLEGE CALIFORNIA -  ANTIOCH,CA,94531-1604,Proprietary  ,5,22,27,173,,400,573
00974807,CARRINGTON COLLEGE CALIFORNIA - SAN JOSE,CA,95119-1325,Proprietary  ,54,144,198,561,,1122,1683
00974808,CARRINGTON COLLEGE CALIFORNIA - EMERYVIL,CA,94608-3006,Proprietary  ,0,0,0,84,,117,201
00974809,WESTERN CAREER COLLEGE -  EMERYVILLE SHE,CA,94608-3006,Proprietary  ,0,0,0,8,,17,25
00998900,SANTA BARBARA BUSINESS COLLEGE          ,CA,93111-0000,Proprietary  ,28,86,114,351,,661,1012
01011100,CERRO-COSO COMMUNITY COLLEGE            ,CA,93555-9571,Public       ,71,323,394,973,,2492,3465
01014900,PEPPERDINE UNIVERSITY                   ,CA,90263-0000,Private      ,347,377,724,9575,,6441,16016
01034000,LOS MEDANOS COLLEGE                     ,CA,94565-5197,Public       ,255,583,838,3876,,4907,8783
01036500,CHARLES R DREW UNIV OF MED & SCI        ,CA,90059-0000,Private      ,16,70,86,166,,1032,1198
01039500,UNIVERSITY OF SAN DIEGO                 ,CA,92110-2492,Private      ,731,484,1215,19191,,6981,26172
01039501,UNIVERSITY OF SAN DIEGO - SCHOOL OF LAW ,CA,92110-2492,Private      ,19,73,92,234,,2462,2696
01044100,PARDEE RAND GRADUATE SCHOOL             ,CA,90407-2138,Private      ,0,5,5,4,,33,37
01047400,MARYMOUNT COLLEGE OF PALOS VERDES       ,CA,90275-0000,Private      ,26,12,38,1327,,229,1556
01085400,THOMAS JEFFERSON SCHOOL OF LAW          ,CA,92110-0000,Private      ,1,87,88,49,,1948,1997
01102400,EVEREST COLLEGE                         ,CA,94103-2091,Proprietary  ,13,52,65,160,,419,579
01110700,EVEREST  COLLEGE                        ,CA,92801-5231,Proprietary  ,47,99,146,538,,790,1328
01110900,EVEREST COLLEGE                         ,CA,91335-4631,Proprietary  ,33,140,173,398,,693,1091
01111200,FIDM-FASHION INSTITUTE OF DESIGN        ,CA,90015-1421,Proprietary  ,324,218,542,6275,,2442,8717
01111700,ALLIANT INTERNATIONAL UNIVERSITY        ,CA,92131-1799,Private      ,10,124,134,203,,2261,2464
01111705,ALLIANT INTERNATIONAL UNIVERSITY - LOS A,CA,91803-1360,Private      ,1,19,20,23,,706,729
01111706,ALLIANT INTERNATIONAL UNIVERSITY - SAN F,CA,94133-1221,Private      ,2,43,45,33,,920,953
01111707,ALLIANT INTERNATIONAL UNIVERSITY - FRESN,CA,93727-2014,Private      ,6,26,32,81,,580,661
01112100,EVEREST COLLEGE                         ,CA,94541-4007,Proprietary  ,8,44,52,121,,363,484
01112300,EVEREST COLLEGE                         ,CA,90247-4163,Proprietary  ,34,112,146,246,,630,876
01146000,NATIONAL UNIVERSITY                     ,CA,92037-1011,Private      ,108,2446,2554,1140,,19996,21136
01162600,PRACTICAL SCHOOLS                       ,CA,92805-0000,Proprietary  ,18,45,63,306,,644,950
01164900,LOYOLA MARYMOUNT UNIVERSITY             ,CA,90045-0000,Private      ,350,207,557,13348,,4072,17420
01164901,LMU  - LOYOLA LAW SCHOOL                ,CA,90015-0019,Private      ,9,59,68,204,,3075,3279
01167200,MENDOCINO COLLEGE                       ,CA,95482-3000,Public       ,59,203,262,1441,,2168,3609
01170700,NORTH-WEST COLLEGE                      ,CA,91790-2097,Proprietary  ,35,87,122,287,,542,829
01179200,FRANCISCAN SCHOOL OF THEOLOGY           ,CA,94709-0000,Private      ,1,1,2,8,,44,52
01182000,SAN DIEGO MIRAMAR COLLEGE               ,CA,92126-0000,Public       ,315,994,1309,5913,,8976,14889
01186500,CALIFORNIA HAIR DESIGN ACADEMY          ,CA,92115-0000,Proprietary  ,22,49,71,209,,304,513
01186600,LU ROSS ACADEMY                         ,CA,93001-2927,Proprietary  ,35,67,102,190,,335,525
01202600,BELLUS ACADEMY                          ,CA,92021-6247,Proprietary  ,18,33,51,95,,193,288
01202700,GALEN COLLEGE OF CALIFORNIA             ,CA,93728-2381,Proprietary  ,0,0,0,55,,115,170
01203100,SAN DIEGO CHRISTIAN COLLEGE             ,CA,92019-1157,Private      ,35,58,93,989,,744,1733
01206100,EVEREST COLLEGE                         ,CA,95128-3908,Proprietary  ,17,68,85,263,,528,791
01215400,CALIFORNIA INSTITUTE OF INTEGRAL STUDIES,CA,94103-2557,Private      ,4,89,93,54,,1617,1671
01230002,PALMER COLLEGE OF CHIROPRACTIC - WEST CA,CA,95134-1617,Private      ,0,0,0,22,,209,231
01231600,MANCHESTER BEAUTY COLLEGE               ,CA,93726-5306,Proprietary  ,7,27,34,140,,173,313
01231700,TULARE BEAUTY COLLEGE                   ,CA,93274-3432,Proprietary  ,7,8,15,34,,48,82
01244600,UNIVERSAL COLLEGE OF BEAUTY             ,CA,90044-0044,Proprietary  ,2,19,21,96,,154,250
01245200,EVERGREEN VALLEY COLLEGE                ,CA,95135-1598,Public       ,259,500,759,5346,,6085,11431
01255000,LOS ANGELES MISSION COLLEGE             ,CA,91342-3200,Public       ,330,564,894,6691,,6237,12928
01265000,MARINELLO SCHOOL OF BEAUTY              ,CA,91502-2828,Proprietary  ,20,67,87,159,,310,469
01265001,MARINELLO SCHOOL OF BEAUTY - PALMDALE   ,CA,93550-4686,Proprietary  ,2,16,18,109,,164,273
01284200,OXNARD COLLEGE                          ,CA,93030-0000,Public       ,212,547,759,3799,,4452,8251
01287200,NORTH-WEST COLLEGE                      ,CA,91768-3199,Proprietary  ,31,104,135,326,,720,1046
01287300,WYOTECH                                 ,CA,90810-3800,Proprietary  ,98,329,427,994,,1884,2878
01287301,WYOTECH - EVEREST  COLLEGE              ,CA,90034-3158,Proprietary  ,25,95,120,275,,583,858
01287302,WYOTECH - EVEREST  COLLEGE              ,CA,91746-3412,Proprietary  ,42,144,186,465,,914,1379
01290700,LAKE TAHOE COMMUNITY COLLEGE            ,CA,96150-4524,Public       ,72,154,226,780,,1202,1982
01291200,MTI COLLEGE                             ,CA,95841-0000,Proprietary  ,55,191,246,615,,1660,2275
01294200,ROSEMEAD BEAUTY SCHOOL                  ,CA,91770-1639,Proprietary  ,4,55,59,48,,265,313
01298400,PROFESSIONAL INSTITUTE OF BEAUTY        ,CA,91731-2613,Proprietary  ,6,21,27,34,,104,138
01298500,HAIR CALIFORNIA BEAUTY ACADEMY          ,CA,92867-7127,Proprietary  ,2,5,7,33,,55,88
01298900,OCEANSIDE COLLEGE OF BEAUTY             ,CA,92054-5393,Proprietary  ,7,28,35,131,,211,342
01301000,LANCASTER BEAUTY SCHOOL                 ,CA,93534-3098,Proprietary  ,19,48,67,131,,270,401
01307400,AMERICAN BEAUTY COLLEGE                 ,CA,91790-2906,Proprietary  ,16,20,36,82,,118,200
01309500,SALON SUCCESS ACADEMY                   ,CA,92879-6561,Proprietary  ,30,41,71,223,,259,482
01310300,CALIFORNIA WESTERN SCHOOL OF LAW        ,CA,92101-0000,Private      ,8,81,89,133,,1777,1910
01324000,LYTLE'S REDWOOD EMPIRE BEAUTY CLG       ,CA,95403-0000,Proprietary  ,29,34,63,194,,258,452
02054900,MARINELLO SCHOOL OF BEAUTY              ,CA,92630-0000,Proprietary  ,21,46,67,149,,299,448
02054902,MARINELLO SCHOOL OF BEAUTY - BAKERSFIELD,CA,93309-5001,Proprietary  ,30,71,101,346,,430,776
02054903,MARINELLO SCHOOL OF BEAUTY - VISALIA    ,CA,93277-6228,Proprietary  ,2,14,16,103,,144,247
02059800,PARIS BEAUTY COLLEGE                    ,CA,94520-2611,Proprietary  ,5,25,30,51,,159,210
02061600,WAYNES COLLEGE OF BEAUTY                ,CA,93906-2830,Proprietary  ,0,11,11,58,,76,134
02063500,COASTLINE COMMUNITY COLLEGE             ,CA,92708-0000,Public       ,132,902,1034,2573,,7947,10520
02064300,SIERRA COLLEGE OF BEAUTY                ,CA,95340-0000,Proprietary  ,17,39,56,112,,184,296
02065700,CALIFORNIA BEAUTY COLLEGE               ,CA,95354-0000,Proprietary  ,12,34,46,176,,238,414
02070500,CONCORDIA UNIVERSITY                    ,CA,92612-0000,Private      ,102,265,367,3407,,3012,6419
02075800,SOUTHERN CA INST OF ARCHITECTURE        ,CA,90013-0000,Private      ,17,25,42,286,,561,847
02086400,MARINELLO SCHOOL OF BEAUTY              ,CA,95050-0000,Proprietary  ,16,31,47,120,,212,332
02086401,MARINELLO SCHOOL OF BEAUTY - SEASIDE    ,CA,93955-3615,Proprietary  ,12,19,31,104,,159,263
02086402,MARINELLO SCHOOL OF BEAUTY - SAN MATEO  ,CA,94401-3801,Proprietary  ,5,16,21,62,,109,171
02086403,MARINELLO SCHOOL OF BEAUTY - HAYWARD    ,CA,94541-5111,Proprietary  ,11,32,43,117,,197,314
02086404,MARINELLO SCHOOL OF BEAUTY - CASTRO VALL,CA,94546-5506,Proprietary  ,4,5,9,28,,54,82
02091200,ELEGANCE INTERNATIONAL                  ,CA,90028-0000,Proprietary  ,32,43,75,150,,208,358
02091700,KAPLAN COLLEGE                          ,CA,92123-1509,Proprietary  ,59,314,373,751,,2700,3451
02091702,KAPLAN COLLEGE - CHULA VISTA            ,CA,91910-5342,Proprietary  ,18,69,87,268,,535,803
02096100,FIELDING GRADUATE UNIVERSITY            ,CA,93105-0000,Private      ,0,187,187,3,,1028,1031
02099200,AMERICAN CONSERVATORY THEATER           ,CA,94108-0000,Private      ,13,14,27,104,,268,372
02110200,COLUMBIA COLLEGE                        ,CA,91356-0000,Private      ,21,11,32,391,,190,581
02110800,CALIFORNIA COLLEGE SAN DIEGO            ,CA,92108-3821,Proprietary  ,157,365,522,2368,,3440,5808
02111300,CUYAMACA COLLEGE                        ,CA,92019-0000,Public       ,334,858,1192,5045,,7589,12634
02119100,MISSION COLLEGE                         ,CA,95054-1897,Public       ,175,446,621,3702,,5364,9066
02120600,SAYBROOK GRADUATE SCHOOL                ,CA,94111-1920,Private      ,1,54,55,5,,744,749
02120700,SAN JOAQUIN VALLEY COLLEGE              ,CA,93291-0000,Proprietary  ,277,779,1056,2611,,5550,8161
02125000,CAREER ACADEMY OF BEAUTY                ,CA,92845-0000,Proprietary  ,16,36,52,100,,212,312
02128200,"VICTOR VALLEY BEAUTY COLLEGE, INC       ",CA,92392-0000,Proprietary  ,17,40,57,170,,261,431
02128300,INSTITUTE FOR BUSINESS & TECHNOLOGY     ,CA,95050-0000,Proprietary  ,19,112,131,127,,533,660
02128301,INSTITUTE FOR BUSINESS & TECHNOLOGY - NA,CA,95670-6351,Proprietary  ,6,48,54,39,,162,201
02138300,PALO ALTO UNIVERSITY                    ,CA,94304-1337,Private      ,5,38,43,84,,1067,1151
02161800,MUSICIANS INSTITUTE                     ,CA,90028-6157,Proprietary  ,99,101,200,1325,,1022,2347
02167800,ESTES INSTITUTE OF COSMETOLOGY          ,CA,93291-0000,Proprietary  ,4,16,20,116,,130,246
02178700,CITRUS HEIGHTS BEAUTY COLLEGE           ,CA,95610-1410,Proprietary  ,15,19,34,127,,156,283
02179916,ARGOSY UNIVERSITY - ORANGE COUNTY       ,CA,92868-4844,Proprietary  ,0,0,0,0,,1,1
02179937,WESTERN STATE COLLEGE OF LAW            ,CA,92831-3014,Proprietary  ,1,33,34,34,,980,1014
02179938,"ART INSTITUTE OF CALIFORNIA, HOLLYWOOD  ",CA,91601-3112,Proprietary  ,175,187,362,3005,,1942,4947
02179941,"ART INSTITUTE OF CALIFORNIA, LOS ANGELES",CA,90405-3035,Proprietary  ,254,167,421,4666,,3013,7679
02179947,"ART INSTITUTE OF CALIFORNIA, SAN DIEGO  ",CA,92108-4423,Proprietary  ,252,331,583,3196,,3034,6230
02185800,MOLER BARBER COLLEGE                    ,CA,94611-0000,Proprietary  ,9,34,43,62,,211,273
02188400,SIERRA VALLEY COLLEGE OF COURT REPORTING,CA,93726-0000,Proprietary  ,4,12,16,81,,187,268
02208600,MADERA BEAUTY COLLEGE                   ,CA,93637-3519,Proprietary  ,4,6,10,76,,81,157
02211000,SALON SUCCESS ACADEMY                   ,CA,92405-0000,Proprietary  ,11,21,32,110,,143,253
02220000,COLLEEN O'HARA BEAUTY ACADEMY           ,CA,92701-0000,Proprietary  ,15,34,49,80,,133,213
02220200,CALIFORNIA CULINARY ACADEMY             ,CA,94102-3336,Proprietary  ,45,98,143,534,,756,1290
02221300,MARINELLO SCHOOL OF BEAUTY              ,CA,92553-0000,Proprietary  ,22,48,70,177,,284,461
02221303,MARINELLO SCHOOL OF BEAUTY - SAN RAFAEL ,CA,94901-3224,Proprietary  ,2,15,17,37,,103,140
02222000,AMERICAN FILM INSTITUTE                 ,CA,90027-0000,Private      ,57,88,145,576,,1099,1675
02226000,EAST LOS ANGELES COLLEGE                ,CA,91754-0000,Public       ,736,1147,1883,17867,,15388,33255
02228500,LIFE CHIROPRACTIC COLLEGE WEST          ,CA,94545-0000,Private      ,0,42,42,24,,560,584
02230900,FREDRICK & CHARLES BEAUTY COLLEGE       ,CA,95501-0000,Proprietary  ,9,29,38,85,,151,236
02231900,GEMOLOGICAL INSTITUTE OF AMERICA        ,CA,92008-4698,Private      ,10,62,72,82,,349,431
02234300,FASHION CAREERS OF CALIFORNIA           ,CA,92110-0000,Proprietary  ,0,0,0,32,,27,59
02236400,"THANH LE COLG, SCH OF COSMETOLOGY       ",CA,92840-0000,Proprietary  ,3,6,9,13,,34,47
02237200,PHILLIPS GRADUATE INSTITUTE             ,CA,91316-0000,Private      ,1,28,29,7,,243,250
02241800,AMERICAN CAREER COLLEGE                 ,CA,90004-0000,Proprietary  ,244,577,821,1859,,3792,5651
02242700,BERKELEY CITY COLLEGE                   ,CA,94704-0000,Public       ,238,530,768,4360,,5624,9984
02250602,EVEREST COLLEGE                         ,CA,91761-8525,Proprietary  ,35,146,181,646,,1340,1986
02255400,INTERNATIONAL SCHOOL OF COSMETOLOGY     ,CA,90250-0000,Proprietary  ,28,33,61,200,,259,459
02258600,ALAMEDA BEAUTY COLLEGE                  ,CA,94501-0000,Proprietary  ,18,42,60,203,,317,520
02262400,YESHIVA OHR ELCHONON CHABAD             ,CA,90046-0000,Private      ,19,0,19,116,,5,121
02263101,ANTHEM COLLEGE - SACRAMENTO             ,CA,95827-3378,Proprietary  ,21,83,104,157,,439,596
02267600,INSTITUTE OF TRANSPERSONAL PSYCHLGY     ,CA,94303-4624,Private      ,3,40,43,25,,610,635
02270600,LIFE PACIFIC COLLEGE                    ,CA,91773-0000,Private      ,24,18,42,465,,258,723
02276800,WESTMINSTER SEMINARY CALIFORNIA         ,CA,92027-0000,Private      ,1,7,8,9,,163,172
02277400,SOUTH COAST COLLEGE                     ,CA,92868-2616,Proprietary  ,21,57,78,265,,528,793
02282300,ALHAMBRA BEAUTY COLLEGE                 ,CA,91802-0000,Proprietary  ,8,28,36,48,,132,180
02285100,HILLTOP BEAUTY SCHOOL                   ,CA,94014-0000,Proprietary  ,4,15,19,27,,119,146
02298000,DESIGN INSTITUTE OF SAN DIEGO           ,CA,92121-0000,Proprietary  ,16,35,51,261,,336,597
02304300,"PLATT COLLEGE, SAN DIEGO                ",CA,92115-0000,Proprietary  ,18,46,64,273,,467,740
02306300,KAPLAN COLLEGE                          ,CA,95368-0000,Proprietary  ,30,98,128,321,,702,1023
02306302,KAPLAN COLLEGE - FRESNO                 ,CA,93612-3802,Proprietary  ,20,78,98,227,,404,631
02309500,CLOVIS ADULT EDUC                       ,CA,93611-0000,Public       ,12,61,73,103,,411,514
02312400,LA COLLEGE INTERNATIONAL                ,CA,90010-0000,Proprietary  ,0,0,0,1,,3,4
02330500,LAGUNA COLLEGE OF ART AND DESIGN        ,CA,92651-0000,Private      ,38,23,61,750,,306,1056
02332800,CENTER FOR EMPLOYMENT TRAINING          ,CA,95110-0000,Private      ,113,490,603,556,,2141,2697
02338500,GLENDALE CAREER COLLEGE                 ,CA,91203-1207,Proprietary  ,49,120,169,290,,663,953
02338700,MARINELLO SCHOOL OF BEAUTY              ,CA,94103-0000,Proprietary  ,15,25,40,145,,222,367
02338701,MARINELLO SCHOOL OF BEAUTY - CHICO      ,CA,95928-7184,Proprietary  ,7,36,43,127,,207,334
02338702,MARINELLO SCHOOL OF BEAUTY - REDDING    ,CA,96001-1023,Proprietary  ,9,35,44,104,,225,329
02338703,MARINELLO SCHOOL OF BEAUTY - FRESNO     ,CA,93711-3246,Proprietary  ,24,68,92,239,,313,552
02342400,ACADEMY OF RADIO BROADCASTING           ,CA,92647-3809,Proprietary  ,13,54,67,110,,272,382
02343400,BELLUS ACADEMY                          ,CA,92064-4633,Proprietary  ,44,89,133,367,,579,946
02345800,MONTEBELLO BEAUTY COLLEGE               ,CA,90640-0000,Proprietary  ,0,0,0,15,,18,33
02351900,KAPLAN COLLEGE                          ,CA,95660-5512,Proprietary  ,46,233,279,531,,1754,2285
02351901,KAPLAN COLLEGE - BAKERSFIELD            ,CA,93304-0000,Proprietary  ,48,153,201,571,,975,1546
02358000,THOMAS AQUINAS COLLEGE                  ,CA,93060-9622,Private      ,4,2,6,398,,39,437
02359300,SHASTA BIBLE COLLEGE                    ,CA,96002-0000,Private      ,2,8,10,55,,103,158
02482700,WESTERN UNIVERSITY OF HEALTH S          ,CA,91766-1854,Private      ,13,93,106,197,,5827,6024
02494800,LOLA BEAUTY COLLEGE                     ,CA,92641-0000,Proprietary  ,7,11,18,34,,49,83
02497300,TRINITY COLLEGE                         ,CA,93277-8109,Proprietary  ,47,99,146,245,,724,969
02500000,SAN JOAQUIN COLLEGE OF LAW              ,CA,93612-0000,Private      ,0,10,10,26,,341,367
02518400,THE NATIONAL HISPANIC UNIVERSITY        ,CA,95127-0000,Proprietary  ,17,91,108,505,,1072,1577
02519800,AVANCE BEAUTY COLLEGE                   ,CA,92154-0000,Proprietary  ,6,33,39,164,,218,382
02520200,CALIFORNIA CAREER SCHOOLS               ,CA,92805-0000,Proprietary  ,8,33,41,100,,231,331
02520300,INTERIOR DESIGNERS INSTITUTE            ,CA,92660-0000,Proprietary  ,7,27,34,50,,193,243
02520400,ADRIAN'S BEAUTY COLLEGE OF TURLOCK      ,CA,95382-0000,Proprietary  ,16,31,47,142,,154,296
02531801,PAUL MITCHELL THE SCHOOL-COSTA MESA     ,CA,92626-3804,Proprietary  ,30,48,78,131,,215,346
02531804,PAUL MITCHELL THE SCHOOL - SAN DIEGO    ,CA,92101-0000,Proprietary  ,28,73,101,167,,350,517
02537200,PALOMAR INSTITUTE OF COSMETOLOGY        ,CA,92069-0000,Proprietary  ,18,48,66,223,,329,552
02539100,KAPLAN COLLEGE                          ,CA,91606-3231,Proprietary  ,35,121,156,417,,950,1367
02539102,KAPLAN COLLEGE -  RIVERSIDE             ,CA,92507-4223,Proprietary  ,38,116,154,485,,998,1483
02539500,IRVINE VALLEY COLLEGE                   ,CA,92620-0000,Public       ,371,570,941,7188,,5341,12529
02542300,NATIONAL HOLISTIC INSTITUTE             ,CA,94608-0000,Proprietary  ,28,179,207,236,,983,1219
02543400,BROWNSON TECHNICAL SCHOOL               ,CA,92805-0000,Proprietary  ,7,53,60,44,,226,270
02545900,HYPNOSIS MOTIVATION INSTITUTE           ,CA,91356-0000,Private      ,0,30,30,8,,115,123
02546400,MTI BUSINESS COLLEGE INC                ,CA,95207-0000,Proprietary  ,7,37,44,89,,283,372
02549000,KAPLAN COLLEGE                          ,CA,92083-7736,Proprietary  ,53,168,221,400,,1144,1544
02549005,KAPLAN COLLEGE -  PALM SPRINGS          ,CA,92262-7011,Proprietary  ,28,80,108,346,,530,876
02553500,ASSOCIATED TECHNICAL COLLEGE            ,CA,92101-0000,Proprietary  ,13,73,86,170,,409,579
02553600,DIVERSIFIED LANGUAGE INSTITUTE          ,CA,90017-0000,Proprietary  ,19,158,177,81,,769,850
02559300,UNITED EDUCATION INSTITUTE              ,CA,90020-0000,Proprietary  ,181,519,700,837,,2038,2875
02559400,INTERCOAST COLLEGES                     ,CA,92868-1656,Proprietary  ,59,523,582,303,,2295,2598
02565400,KAPLAN COLLEGE                          ,CA,95207-6216,Proprietary  ,0,0,0,208,,397,605
02570300,LOS ANGELES ORT COLLEGE                 ,CA,90048-0000,Private      ,25,173,198,157,,765,922
02577900,SANTA BARBARA BUSINESS COLLEGE          ,CA,93309-1664,Proprietary  ,42,134,176,478,,922,1400
02578000,SANTA BARBARA BUSINESS COLLEGE          ,CA,93454-6943,Proprietary  ,24,57,81,227,,466,693
02584200,NEWBRIDGE COLLEGE                       ,CA,92701-0000,Proprietary  ,0,0,0,174,,442,616
02591600,NORTH-WEST COLLEGE                      ,CA,91101-1744,Proprietary  ,10,38,48,115,,287,402
02595600,ASIAN AMERICAN INTERNATIONAL BTY CG     ,CA,92683-4043,Proprietary  ,4,35,39,14,,102,116
02597300,SOUTH BAYLO UNIVERSITY                  ,CA,92801-1701,Private      ,0,47,47,8,,339,347
02602300,CENTRAL COAST COLLEGE                   ,CA,93901-3301,Proprietary  ,17,42,59,268,,365,633
02608900,PINNACLE COLLEGE                        ,CA,91803-8842,Proprietary  ,6,9,15,76,,88,164
02608901,PINNACLE COLLEGE - SACRAMENTO           ,CA,95670-6386,Proprietary  ,6,21,27,76,,156,232
02609000,EMPERORS COLG OF TRAD ORIENTAL MED      ,CA,90403-5609,Proprietary  ,0,20,20,6,,223,229
03010611,VIRGINIA COLLEGE - GOLF ACADEMY OF AMERI,CA,92008-6512,Proprietary  ,1,18,19,41,,126,167
03011300,"CALIF STATE UNIV, SAN MARCOS            ",CA,92096-0001,Public       ,431,456,887,15030,,8060,23090
03019900,CAPSTONE COLLEGE                        ,CA,91402-4924,Proprietary  ,2,15,17,25,,82,107
03025600,DELL'ARTE SCH OF PHYSICAL THEATRE       ,CA,95525-0816,Private      ,1,3,4,9,,47,56
03027700,PACIFIC COLLEGE OF ORIENTAL MED         ,CA,92108-4408,Proprietary  ,10,79,89,91,,665,756
03029600,POMONA ADULT SCHOOL                     ,CA,91766-0000,Public       ,9,60,69,163,,401,564
03031409,INTERNATIONAL ACADEMY OF DESIGN AND TECH,CA,95834-9664,Proprietary  ,16,55,71,293,,530,823
03035700,LAS POSITAS COLLEGE                     ,CA,94551-6750,Public       ,229,329,558,3440,,3131,6571
03039900,FREMONT COLLEGE                         ,CA,90703-5342,Proprietary  ,33,80,113,403,,568,971
03043900,NEWSCHOOL OF ARCHITECTURE & DESIGN      ,CA,92101-6634,Proprietary  ,13,56,69,354,,598,952
03054100,ROYALE COLLEGE OF BEAUTY                ,CA,92590-2525,Proprietary  ,11,10,21,76,,101,177
03062300,WESTECH COLLEGE                         ,CA,91764-4988,Proprietary  ,41,129,170,273,,781,1054
03062400,MT DIABLO ADULT EDUC LOMA VISTA CTR     ,CA,94518-1122,Public       ,6,38,44,140,,306,446
03062700,PLATT COLLEGE                           ,CA,90041-0000,Proprietary  ,46,85,131,517,,813,1330
03062701,PLATT COLLEGE                           ,CA,91764-0000,Proprietary  ,24,67,91,480,,702,1182
03062702,PLATT COLLEGE - RIVERSIDE               ,CA,92507-0730,Proprietary  ,39,73,112,590,,713,1303
03063400,MODERN TECHNOLOGY SCHOOL                ,CA,92708-9821,Proprietary  ,9,24,33,92,,198,290
03067400,BALDWIN PARK ADULT SCHOOL               ,CA,91706-4897,Public       ,22,61,83,183,,402,585
03067500,INSTITUTE OF TECHNOLOGY                 ,CA,93612-3217,Proprietary  ,97,255,352,689,,1899,2588
03069500,SAGE COLLEGE                            ,CA,92557-6720,Proprietary  ,15,74,89,171,,737,908
03072300,EVEREST COLLEGE                         ,CA,91761-3222,Proprietary  ,43,122,165,480,,885,1365
03072700,WESTWOOD COLLEGE - LOS ANGELES          ,CA,90010-1577,Proprietary  ,82,528,610,1465,,4655,6120
03078200,AMERICAN CLG TRADITIONAL CHINESE MD     ,CA,94107-2813,Private      ,1,36,37,8,,308,316
03084700,VENTURA ADULT\CONTINUING EDUCATION      ,CA,93003-7313,Public       ,7,75,82,57,,337,394
03094400,ELITE PROGRESSIVE SCHOOL OF COSM        ,CA,95841-2909,Proprietary  ,13,50,63,135,,304,439
03094401,MARINELLO SCHOOL OF BEAUTY - CONCORD    ,CA,94520-2581,Proprietary  ,10,29,39,110,,206,316
03094402,MARINELLO SCHOOL OF BEAUTY- STOCKTON    ,CA,95203-3149,Proprietary  ,20,32,52,182,,269,451
03097700,CENTRAL CALIF SCH CONTINUING EDUC       ,CA,93401-6739,Proprietary  ,17,31,48,102,,227,329
03098200,YO SAN UNIV TRADITIONAL CHINESE MED     ,CA,90066-1103,Private      ,1,48,49,4,,214,218
03108100,SUMMIT CAREER COLLEGE                   ,CA,92324-3956,Proprietary  ,52,181,233,426,,1137,1563
03109500,DONGGUK  UNIVERSITY LOS ANGELES         ,CA,90020-1765,Private      ,2,14,16,35,,121,156
03113300,UEI COLLEGE                             ,CA,93727-1620,Proprietary  ,109,344,453,597,,1348,1945
03113600,SOUTHERN CALIFORNIA INST OF TECHNOL     ,CA,92805-3758,Proprietary  ,22,93,115,171,,545,716
03116600,EAST SAN GABRIEL VLY REG OCCUP PROG     ,CA,91790-2105,Public       ,24,133,157,271,,796,1067
03125300,JOHN WESLEY INTER. BARBER & BTY CLG     ,CA,90813-4321,Proprietary  ,7,33,40,107,,210,317
03125800,PREMIERE CAREER COLLEGE                 ,CA,91706-3746,Proprietary  ,20,63,83,177,,461,638
03126800,PACIFICA GRADUATE INSTITUTE             ,CA,93013-0000,Proprietary  ,0,82,82,3,,1014,1017
03128700,MT SIERRA COLLEGE                       ,CA,91016-3414,Proprietary  ,17,36,53,407,,427,834
03131300,FIVE BRANCHES UNIVERSITY                ,CA,95062-4669,Proprietary  ,0,26,26,24,,436,460
03144400,AMERICAN CLG OF HEALTH PROFESSIONS      ,CA,92505-3038,Proprietary  ,21,99,120,297,,650,947
03150500,VIRGINIA SEWING MACHINES & SCH CTR      ,CA,90015-3535,Proprietary  ,8,25,33,30,,69,99
03162300,FOUR-D SUCCESS ACADEMY                  ,CA,92324-4218,Proprietary  ,16,74,90,204,,692,896
03163300,PACIFIC STATES UNIVERSITY               ,CA,90006-0000,Private      ,9,15,24,88,,92,180
03195400,EVEREST COLLEGE                         ,CA,90501-2867,Proprietary  ,13,60,73,145,,329,474
03210300,LE CORDON BLEU COLLEGE OF CULINARY ARTS ,CA,91101-5221,Proprietary  ,180,350,530,2126,,3100,5226
03225300,AMERICAN UNIVERSITY OF HEALTH SCIENCES  ,CA,90755-3612,Proprietary  ,6,23,29,143,,357,500
03242300,CAREER NETWORK INSTITUTE                ,CA,92868-4710,Proprietary  ,24,108,132,171,,683,854
03250300,COMMUNITY BASED EDUCATION AND DEVEL     ,CA,90036-0000,Private      ,14,60,74,98,,275,373
03260300,CALIFORNIA STATE U-MONTEREY BAY         ,CA,93955-8001,Public       ,428,235,663,13473,,4420,17893
03266300,BETHESDA UNIVERSITY OF CALIFORNIA       ,CA,92801-4132,Private      ,4,18,22,150,,171,321
03278300,CLARITA CAREER COLLEGE                  ,CA,91351-5432,Proprietary  ,83,176,259,540,,1075,1615
03288300,ACAD CHINESE CULTURE & HEALTH SCIS      ,CA,94512-0000,Private      ,4,28,32,28,,218,246
03299300,PACIFIC COLLEGE                         ,CA,92626-3160,Proprietary  ,11,82,93,144,,418,562
03308300,BRISTOL UNIVERSITY                      ,CA,92806-6198,Proprietary  ,8,51,59,39,,148,187
03327400,ACUPUNCTURE AND INTEGRATIVE MEDICINE COL,CA,94704-2724,Private      ,4,38,42,46,,266,312
03332300,SOUTHERN CA BIBLE CLG & SEMINARY        ,CA,92019-1109,Private      ,2,24,26,18,,178,196
03359300,ST. FRANCIS CAREER COLLEGE              ,CA,90262-2659,Proprietary  ,6,38,44,45,,128,173
03367300,PROFESSIONAL GOLFERS CAREER COLLEGE     ,CA,92591-6013,Proprietary  ,10,37,47,109,,234,343
03395300,INTERNATIONAL CAREER DEVELOPMENT        ,CA,90027-5794,Proprietary  ,96,908,1004,686,,5246,5932
03399300,NORTHWESTERN TECHNICAL COLLEGE          ,CA,95670-4443,Proprietary  ,5,14,19,82,,344,426
03403300,EPIC BIBLE COLLEGE                      ,CA,95841-3546,Private      ,10,61,71,133,,545,678
03413400,ENGLISH CENTER  (THE)                   ,CA,94607-3734,Private      ,10,38,48,37,,159,196
03427400,CAREER COLLEGES OF AMERICA              ,CA,90280-7420,Proprietary  ,30,145,175,402,,1225,1627
03427500,UNIVERSITY OF ANTELOPE VALLEY           ,CA,93534-3324,Proprietary  ,71,196,267,692,,1261,1953
03440400,MARIAN HEALTH CAREERS CENTER            ,CA,90010-1728,Proprietary  ,18,35,53,108,,228,336
03441400,VALLEY CAREER COLLEGE                   ,CA,92020-3057,Proprietary  ,0,0,0,67,,195,262
03458300,MY LE'S BEAUTY COLLEGE                  ,CA,95824-3039,Proprietary  ,7,36,43,104,,260,364
03467300,MARINELLO SCHOOL OF BEAUTY              ,CA,92545-3661,Proprietary  ,14,41,55,130,,279,409
03467301,MARINELLO SCHOOL OF BEAUTY - CATHEDRAL C,CA,92234-6656,Proprietary  ,1,5,6,37,,34,71
03467302,MARINELLO SCHOOL OF BEAUTY - MURRIETA   ,CA,92563-5039,Proprietary  ,15,44,59,144,,263,407
03467303,MARINELLO SCHOOL OF BEAUTY - NAPA       ,CA,94559-1237,Proprietary  ,7,16,23,78,,124,202
03467304,MARINELLO SCHOOL OF BEAUTY - CITY OF IND,CA,91748-1674,Proprietary  ,7,27,34,56,,130,186
03467305,MARINELLO SCHOOL OF BEAUTY - BELL       ,CA,90201-1193,Proprietary  ,6,11,17,83,,98,181
03467306,MARINELLO SCHOOL OF BEAUTY - PARAMOUNT  ,CA,90723-5256,Proprietary  ,10,21,31,131,,166,297
03467307,MARINELLO SCHOOL OF BEAUTY - HUNTINGTON ,CA,92646-2552,Proprietary  ,8,26,34,124,,179,303
03479300,PROFESSIONAL CAREER INSTITUTE           ,CA,90703-2522,Proprietary  ,4,23,27,98,,154,252
03516300,KING'S UNIVERSITY (THE)                 ,CA,91405-2233,Private      ,16,57,73,160,,514,674
03532400,ADVANCED TRAINING ASSOCIATES            ,CA,92020-1236,Proprietary  ,10,34,44,36,,159,195
03542400,COPPER MOUNTAIN COLLEGE                 ,CA,92252-6102,Public       ,69,271,340,752,,2125,2877
03577300,COBA ACADEMY                            ,CA,92866-1407,Proprietary  ,2,5,7,35,,54,89
03590400,NTMA TRAINING CENTERS OF SOUTHERN C     ,CA,90650-0000,Private      ,35,105,140,179,,529,708
03592400,IRELL & MANELLA GRADUATE SCHOOL OF BIOLO,CA,91010-0000,Private      ,0,0,0,0,,22,22
03598300,AVALON BEAUTY COLLEGE                   ,CA,93103-3137,Proprietary  ,19,22,41,147,,123,270
03614300,DAVID'S ACADEMY OF BEAUTY               ,CA,91780-1089,Proprietary  ,7,46,53,37,,198,235
03639300,WEST COAST ULTRASOUND INSTITUTE         ,CA,90211-3312,Proprietary  ,40,154,194,433,,1418,1851
03646300,DESIGN'S SCHOOL OF COSMETOLOGY          ,CA,93446-9530,Proprietary  ,16,33,49,101,,196,297
03681300,CALIFORNIA HEALING ARTS COLLEGE         ,CA,90025-2589,Proprietary  ,10,45,55,105,,284,389
03695300,COMMUNITY ENHANCEMENT SERVICES          ,CA,91502-2750,Private      ,4,26,30,38,,175,213
03695700,SANTIAGO CANYON COLLEGE                 ,CA,92869-4512,Public       ,194,271,465,4672,,2939,7611
03696300,UNIVERSITY OF THE WEST                  ,CA,91770-3709,Private      ,1,11,12,52,,108,160
03698300,WEST COAST UNIVERSITY                   ,CA,91606-3206,Proprietary  ,267,748,1015,2491,,5722,8213
03698400,CA COLLEGE OF VOCATIONAL CAREER         ,CA,93301-1800,Proprietary  ,13,92,105,194,,523,717
03736300,ADVANCE BEAUTY COLLEGE                  ,CA,92843-4752,Proprietary  ,13,109,122,70,,431,501
03740400,ATI COLLEGE                             ,CA,90650-0000,Proprietary  ,3,26,29,88,,207,295
03752400,SCHOOL OF URBAN MISSIONS                ,CA,94603-0000,Private      ,21,27,48,185,,302,487
03759300,COMPUTER TUTOR BUSINESS & TECH INST     ,CA,95356-0000,Proprietary  ,12,42,54,117,,275,392
03786300,ADVANCED COLLEGE                        ,CA,90280-5255,Proprietary  ,12,50,62,87,,298,385
03797400,CAREER CARE INSTITUTE                   ,CA,93534-4766,Proprietary  ,57,160,217,276,,830,1106
03797401,CAREER CARE INSTITUTE - VENTURA         ,CA,93003-0000,Proprietary  ,7,33,40,64,,220,284
03797402,CAREER CARE INSTITUTE - MORENO VALLEY   ,CA,92553-7519,Proprietary  ,3,22,25,59,,169,228
03814400,SOKA UNIVERSITY OF AMERICA              ,CA,92656-8081,Private      ,23,9,32,595,,67,662
03853300,KECK GRADUATE INSTITUTE OF APPLIED LIFE ,CA,91711-4817,Private      ,0,11,11,4,,143,147
03868300,WORLD MISSION UNIVERSITY                ,CA,90020-1789,Private      ,3,8,11,15,,117,132
03868400,LOS ANGELES MUSIC ACADEMY               ,CA,91105-2540,Proprietary  ,18,21,39,246,,205,451
03871300,FOLSOM LAKE COLLEGE                     ,CA,95630-6798,Public       ,204,456,660,3812,,4594,8406
03874300,CAMBRIDGE JUNIOR COLLEGE                ,CA,95993-0000,Proprietary  ,26,55,81,237,,497,734
03874400,COMMMUNITY CHRISTIAN COLLEGE            ,CA,92373-4465,Private      ,7,15,22,156,,142,298
03889300,STANBRIDGE COLLEGE                      ,CA,92612-0000,Proprietary  ,45,133,178,380,,1313,1693
03901300,PACIFIC COAST TRADE SCHOOL              ,CA,93033-2441,Proprietary  ,16,60,76,113,,286,399
03910400,NATIONAL POLYTECHNIC COLLEGE            ,CA,90040-3066,Proprietary  ,10,20,30,138,,169,307
03933300,MUELLER COLLEGE OF HOLISTIC STUDIES     ,CA,92116-2630,Proprietary  ,10,46,56,47,,304,351
03935300,CALIFORNIA NURSES EDUCATIONAL INSTITUTE ,CA,92234-7248,Proprietary  ,11,42,53,107,,302,409
03962300,AMERICAN INSTITUTE OF MASSAGE THERAPY   ,CA,92705-5463,Proprietary  ,7,22,29,79,,117,196
03964400,INTERNATIONAL SCHOOL OF BEAUTY          ,CA,92260-2740,Proprietary  ,2,38,40,124,,308,432
03969600,AMERICAN AUTO INSTITUTE                 ,CA,90703-2637,Proprietary  ,81,210,291,513,,1019,1532
03971300,AMERICAN CAREER COLLEGE                 ,CA,91764-4906,Proprietary  ,111,241,352,943,,1866,2809
03973300,EX'PRESSION COLLEGE FOR DIGTAL ARTS     ,CA,94608-1021,Proprietary  ,68,59,127,610,,518,1128
03974500,CALIFORNIA CAREER COLLEGE               ,CA,91303-2006,Proprietary  ,2,17,19,45,,152,197
03980300,CALIFORNIA STATE UNIVERSITY CHANNEL ISLA,CA,93012-8599,Public       ,219,211,430,8574,,3621,12195
03995300,UNIVERSITY OF EAST-WEST MEDICINE        ,CA,94087-6106,Proprietary  ,1,8,9,17,,83,100
03999300,BEAUMONT ADULT SCHOOL                   ,CA,92223-1927,Public       ,12,42,54,50,,190,240
04001300,PALACE BEAUTY COLLEGE                   ,CA,90006-4233,Proprietary  ,4,32,36,90,,214,304
04003300,BLAKE AUSTIN COLLEGE                    ,CA,95687-3100,Proprietary  ,31,78,109,229,,541,770
04004300,THUY PRINCESS BEAUTY COLLEGE            ,CA,91766-0000,Proprietary  ,2,22,24,37,,94,131
04005300,UNITED STATES UNIVERSITY                ,CA,91911-1683,Proprietary  ,8,109,117,32,,411,443
04014400,PALLADIUM TECHNICAL ACADEMY             ,CA,91731-2429,Proprietary  ,2,11,13,23,,59,82
04023400,PROTEUS                                 ,CA,93291-3014,Private      ,0,0,0,17,,51,68
04037300,LOS ANGELES FILM SCHOOL (THE)           ,CA,90028-7300,Proprietary  ,195,253,448,1914,,2363,4277
04056300,CAREER COLLEGE OF CALIFORNIA            ,CA,92705-5805,Proprietary  ,8,50,58,140,,295,435
04057300,TECHSKILLS OF CALIFORNIA                ,CA,95815-4025,Proprietary  ,11,140,151,199,,988,1187
04076400,GNOMON SCHOOL OF VISUAL EFFECTS         ,CA,90038-2616,Proprietary  ,11,24,35,140,,217,357
04088300,WESTMED COLLEGE                         ,CA,95128-2541,Private      ,13,77,90,133,,437,570
04088301,WESTMED COLLEGE - MERCED                ,CA,95340-9165,Private      ,11,32,43,133,,287,420
04092300,COASTLINE BEAUTY COLLEGE                ,CA,92708-3847,Proprietary  ,4,41,45,71,,240,311
04092400,MAKE-UP DESIGNORY                       ,CA,91502-1322,Proprietary  ,28,69,97,310,,354,664
04100400,TAFT UNIVERSITY SYSTEM (THE)            ,CA,92704-6954,Proprietary  ,0,83,83,14,,530,544
04109300,ACADEMY OF BARBERING ARTS (THE)         ,CA,91324-3406,Proprietary  ,0,0,0,9,,22,31
04111300,WEST HILLS COLLEGE LEMOORE              ,CA,93245-9248,Public       ,116,373,489,2470,,3246,5716
04114500,VALLEY COLLEGE OF MEDICAL CAREERS       ,CA,91304-2354,Proprietary  ,9,25,34,78,,160,238
04115300,COACHELLA VALLEY BEAUTY COLLEGE         ,CA,92253-2051,Proprietary  ,5,15,20,105,,128,233
04115600,MAYFIELD COLLEGE                        ,CA,92234-7014,Proprietary  ,29,75,104,202,,438,640
04116000,VIDEO SYMPHONY ENTERTRAINING            ,CA,91502-3253,Proprietary  ,12,31,43,109,,389,498
04118800,NEW YORK FILM ACADEMY                   ,CA,91608-1002,Proprietary  ,86,148,234,851,,1109,1960
04119200,CAREER COLLEGE CONSULTANTS              ,CA,90041-2088,Proprietary  ,6,35,41,47,,171,218
04126400,CHAMPION INSTITUTE OF COSMETOLOGY       ,CA,92264-7458,Proprietary  ,3,8,11,36,,56,92
04126500,COAST CAREER INSTITUTE                  ,CA,90015-3040,Proprietary  ,16,81,97,92,,280,372
04127100,"UNIVERSITY OF CALIFORNIA, MERCED        ",CA,95343-5001,Public       ,213,71,284,15689,,2238,17927
04127900,TUI UNIVERSITY                          ,CA,90630-5023,Proprietary  ,8,599,607,57,,3333,3390
04129700,INTERNATIONAL POLYTECHNIC INSTITUTE     ,CA,92231-1737,Private      ,0,1,1,17,,15,32
04129803,MEDIATECH INSTITUTE - OCEANSIDE         ,CA,92054-5116,Proprietary  ,5,22,27,61,,126,187
04132400,ACADEMY OF ESTHETICS AND COSMETOLOGY    ,CA,91342-3373,Proprietary  ,7,9,16,66,,80,146
04132700,INFOTECH CAREER COLLEGE                 ,CA,90706-5579,Proprietary  ,6,29,35,50,,181,231
04133000,BIOHEALTH COLLEGE                       ,CA,95134-2033,Proprietary  ,9,50,59,81,,330,411
04133100,CALIFORNIA UNIVERSITY OF MANAGEMENT AND ,CA,92801-1702,Private      ,6,14,20,28,,102,130
04134500,CAREER COLLEGE OF SAN DIEGO             ,CA,92102-3348,Proprietary  ,16,131,147,250,,918,1168
04134700,INTERNATL PROFESSIONAL SCHL OF BODYWORK ,CA,92123-1520,Proprietary  ,7,36,43,61,,282,343
04137200,BORNER'S BARBER COLLEGE                 ,CA,90047-3856,Proprietary  ,6,20,26,72,,168,240
04138700,CAO INSTITUTE OF AESTHETICS (THE)       ,CA,91801-3903,Proprietary  ,20,29,49,97,,174,271
04140500,HORIZON UNIVERSITY                      ,CA,92111-2622,Private      ,1,24,25,61,,186,247
04141300,SAN FRANCISCO INSTITUTE OF ESTHETICS    ,CA,94103-4083,Proprietary  ,19,38,57,139,,224,363
04141400,LAURUS COLLEGE                          ,CA,93401-5405,Proprietary  ,29,160,189,190,,944,1134
04141700,HEALING HANDS SCHOOL OF HOLISTIC HEALTH ,CA,92025-1722,Proprietary  ,10,33,43,52,,204,256
04142500,TOURO COLLEGE LOS ANGELES               ,CA,90046-4506,Private      ,14,46,60,113,,200,313
04142600,TOURO UNIVERSITY                        ,CA,94592-1118,Private      ,1,66,67,41,,2920,2961
04143800,WOODLAND COMMUNITY COLLEGE              ,CA,95776-5156,Public       ,95,218,313,1539,,1859,3398
04144200,CAREER DEVELOPMENT INSTITUTE            ,CA,90035-4364,Proprietary  ,4,26,30,50,,212,262
04145000,SAN DIEGO CULINARY INSTITUTE            ,CA,91941-6435,Proprietary  ,25,86,111,394,,649,1043
04145600,INTERNATIONAL COLLEGE OF COSMETOLOGY    ,CA,94601-3525,Proprietary  ,7,43,50,65,,225,290
04146000,NATIONAL CAREER COLLEGE                 ,CA,91605-1400,Proprietary  ,7,27,34,33,,134,167
04148200,BEYOND 21ST CENTURY BEAUTY ACADEMY      ,CA,90670-6316,Proprietary  ,1,6,7,30,,42,72
04148900,N CALIF INSTITUTE OF COSMETOLOGY        ,CA,94577-2820,Proprietary  ,2,13,15,24,,84,108
04149700,HOMESTEAD SCHOOLS                       ,CA,90505-5945,Private      ,1,35,36,68,,210,278
04150000,CENTRAL NURSING COLLEGE                 ,CA,90010-2444,Proprietary  ,16,50,66,234,,339,573
04150100,GOLDEN STATE COLLEGE OF COURT REPORTING ,CA,94568-2948,Proprietary  ,2,8,10,14,,69,83
04150300,RWM FIBER OPTICS                        ,CA,90746-1051,Proprietary  ,3,54,57,18,,137,155
04150500,"PREFERRED COLLEGE OF NURSING, LOS ANGELE",CA,90010-2202,Proprietary  ,4,34,38,132,,391,523
04152800,CALIFORNIA ACADEMY (THE) - A PAUL MITCHE,CA,95825-2276,Proprietary  ,41,87,128,429,,576,1005
04153900,PROVIDENCE CHRISTIAN COLLEGE            ,CA,91104-2635,Private      ,3,3,6,94,,53,147
04154400,FRANKLIN CAREER COLLEGE                 ,CA,91761-1522,Proprietary  ,0,0,0,34,,124,158
04155500,"ACADEMY FOR JEWISH RELIGION, CALIFORNIA ",CA,90024-3234,Private      ,3,15,18,27,,99,126
04156100,DIOR SCHOOL OF COSMETOLOGY              ,CA,95355-9695,Proprietary  ,6,26,32,90,,170,260
04157800,GRACE MISSION UNIVERSITY                ,CA,92833-3860,Private      ,2,19,21,16,,80,96
04158200,PAUL MITCHELL THE SCHOOL SHERMAN OAKS   ,CA,91403-5882,Proprietary  ,30,54,84,246,,268,514
04158700,HOLLYWOOD BEAUTY COLLEGE                ,CA,95210-3514,Proprietary  ,13,39,52,129,,229,358
04158900,FLAIR BEAUTY COLLEGE                    ,CA,91351-3381,Proprietary  ,1,12,13,41,,72,113
04159600,GALAXY MEDICAL COLLEGE                  ,CA,91606-1593,Proprietary  ,10,17,27,39,,67,106
04159700,AMERICAN MEDICAL SCIENCES CENTER        ,CA,91204-5108,Proprietary  ,6,26,32,78,,164,242
04160100,TRINITY VOCATIONAL CENTER               ,CA,90248-4334,Proprietary  ,6,40,46,54,,221,275
04160400,ANGELES COLLEGE OF NURSING              ,CA,90010-2100,Proprietary  ,23,76,99,484,,662,1146
04161300,PREFERRED COLLEGE OF NURSING            ,CA,91401-1442,Proprietary  ,1,12,13,57,,168,225
04161700,SHASTA SCHOOL OF COSMETOLOGY            ,CA,96003-0000,Proprietary  ,12,18,30,111,,162,273
04161800,BRANDMAN UNIVERSITY                     ,CA,92618-3801,Private      ,49,1056,1105,518,,8933,9451
04162800,S.I.C.E PAUL MITCHELL PARTNER SCHOOL    ,CA,95350-1440,Proprietary  ,20,58,78,304,,389,693
04163400,COSMO BEAUTY ACADEMY                    ,CA,95605-1904,Proprietary  ,18,38,56,207,,331,538
04163900,L.A. BARBER COLLEGE                     ,CA,90013-1121,Proprietary  ,0,0,0,13,,29,42
04164400,ANGELES INSTITUTE                       ,CA,90712-2903,Proprietary  ,15,28,43,79,,191,270
04165900,PAUL MITCHELL THE SCHOOL FRESNO         ,CA,93710-7617,Proprietary  ,12,43,55,324,,370,694
04167000,PAUL MITCHELL THE SCHOOL TEMECULA       ,CA,92591-4663,Proprietary  ,37,46,83,236,,268,504
04169200,TRAMY BEAUTY SCHOOL                     ,CA,92115-6347,Proprietary  ,8,38,46,121,,329,450
04169700,UNITEK COLLEGE                          ,CA,94538-3185,Proprietary  ,47,295,342,448,,1961,2409
04169800,GURNICK ACADEMY OF MEDICAL ARTS         ,CA,94403-1849,Proprietary  ,33,161,194,309,,1428,1737
04172000,SOUTHERN CALIFORNIA UNIVERSITY SOMA     ,CA,90017-2211,Proprietary  ,21,37,58,226,,361,587
04173400,SANTA ANA BEAUTY ACADEMY                ,CA,92705-7820,Proprietary  ,4,6,10,64,,85,149
04173500,MORENO VALLEY COLLEGE                   ,CA,92551-2204,Public       ,248,570,818,5334,,6963,12297
04175200,PAUL MITCHELL THE SCHOOL EAST BAY       ,CA,94523-5515,Proprietary  ,21,38,59,237,,273,510
04175400,ELITE COSMETOLOGY SCHOOL                ,CA,92284-2860,Proprietary  ,3,22,25,44,,116,160
04176100,NORCO COLLEGE                           ,CA,92860-2600,Public       ,211,431,642,4978,,5032,10010
04176200,TWIN RIVERS ADULT SCHOOL                ,CA,95660-5523,Public       ,0,7,7,19,,105,124
04176300,BERGIN UNIVERSITY OF CANINE STUDIES     ,CA,95407-6834,Private      ,2,10,12,32,,103,135
04177200,REAL BARBERS COLLEGE (THE)              ,CA,92805-2533,Proprietary  ,17,39,56,90,,154,244
04178900,HANDS-ON MEDICAL MASSAGE SCHOOL         ,CA,92373-6271,Proprietary  ,6,8,14,28,,63,91
04180000,CINTA AVEDA INSTITUTE                   ,CA,94108-3204,Proprietary  ,26,67,93,174,,420,594
04181200,IPPT CAREER SCHOOL                      ,CA,91601-2028,Proprietary  ,19,97,116,60,,252,312
04181600,INTEGRITY COLLEGE OF HEALTH             ,CA,91104-2300,Proprietary  ,2,19,21,3,,29,32
04185200,SALINAS BEAUTY COLLEGE                  ,CA,93901-2405,Proprietary  ,2,15,17,60,,105,165
04185500,ACADEMY OF COUTURE ART                  ,CA,90069-5701,Proprietary  ,12,18,30,132,,141,273
04185600,MEDICAL ALLIED CAREER CENTER            ,CA,90670-4710,Proprietary  ,1,11,12,16,,97,113
04185700,ACADEMY FOR SALON PROFESSIONALS (THE)   ,CA,95050-4057,Proprietary  ,19,34,53,133,,212,345
04186900,"INTERNATIONAL COLLEGE OF BEAUTY, ARTS & ",CA,90039-1012,Proprietary  ,8,25,33,128,,205,333
04187900,JOE BLASCO MAKEUP ARTIST TRAINING CENTER,CA,90027-5580,Proprietary  ,14,51,65,194,,314,508
04189300,ALLIED AMERICAN UNIVERSITY              ,CA,92653-1337,Proprietary  ,32,452,484,124,,2292,2416
04189700,CALIFORNIA MIRAMAR UNIVERSITY           ,CA,92126-7501,Proprietary  ,43,88,131,534,,758,1292
04189800,ACADEMY FOR SALON PROFESSIONALS         ,CA,91304-2305,Proprietary  ,5,16,21,80,,149,229
04190800,SANTA ANA BEAUTY COLLEGE                ,CA,92706-2321,Proprietary  ,9,20,29,59,,101,160
04190900,SUTTER BEAUTY COLLEGE                   ,CA,95991-3624,Proprietary  ,4,15,19,9,,35,44
04191300,ANNENBERG SCHOOL OF NURSING             ,CA,91335-5426,Private      ,3,17,20,42,,83,125
04193500,LEMELANGE ACADEMY OF HAIR               ,CA,94558-2935,Proprietary  ,5,10,15,32,,69,101
04193700,JOHN PAUL THE GREAT CATHOLIC UNIVERSITY ,CA,92131-1652,Private      ,12,6,18,222,,114,336
04194300,COLTON-REDLANDS-YUCAIPA REGIONAL OCCUPAT,CA,92374-2896,Public       ,18,42,60,128,,218,346
04194600,BRAND COLLEGE                           ,CA,91203-3646,Proprietary  ,3,11,14,26,,58,84
04195200,DIAMOND BEAUTY COLLEGE                  ,CA,91733-2180,Proprietary  ,2,10,12,10,,37,47
04195400,NCP COLLEGE OF NURSING                  ,CA,94080-1005,Proprietary  ,6,29,35,115,,301,416
04195401,NCP COLLEGE OF NURSING - HAYWARD CAMPUS ,CA,94541-7026,Proprietary  ,9,46,55,155,,357,512
04205800,"SAE INSTITUTE OF TECHNOLOGY, LOS ANGELES",CA,90028-7219,Proprietary  ,33,60,93,244,,356,600
04206800,ADVANCE BEAUTY TECHS ACADEMY            ,CA,92583-6572,Proprietary  ,5,19,24,46,,108,154
04208100,UKIAH ADULT SCHOOL                      ,CA,95482-3865,Public       ,1,17,18,18,,123,141
04208400,RIVERSIDE COUNTY OFFICE OF EDUCATION    ,CA,92503-3504,Public       ,29,57,86,128,,307,435
04208900,ADVANCED CAREER INSTITUTE               ,CA,93291-9254,Proprietary  ,9,94,103,72,,408,480
04209800,HINTON BARBER COLLEGE                   ,CA,94590-4547,Proprietary  ,5,14,19,41,,100,141
04210600,ADVANCED COMPUTING INSTITUTE            ,CA,90010-3911,Proprietary  ,11,84,95,122,,269,391
04211900,XAVIER COLLEGE SCHOOL OF NURSING        ,CA,95202-1332,Proprietary  ,12,34,46,155,,328,483
04212000,LAWRENCE & COMPANY COLLEGE OF COSMETOLOG,CA,93230-4102,Proprietary  ,10,20,30,51,,92,143
04215100,CALIFORNIA CAREER INSTITUTE             ,CA,92840-2816,Proprietary  ,10,46,56,33,,182,215
04215300,COSMO FACTORY COSMETOLOGY ACADEMY (THE) ,CA,95060-4401,Proprietary  ,1,6,7,51,,85,136
04216300,UEI COLLEGE                             ,CA,95065-1520,Proprietary  ,36,146,182,123,,288,411
04217100,RUDOLF STEINER COLLEGE                  ,CA,95628-6811,Private      ,1,19,20,2,,54,56
04217500,W INSTITUTE OF COSMETOLOGY              ,CA,94521-5385,Proprietary  ,3,12,15,27,,76,103
04221800,TONI&GUY HAIRDRESSING ACADEMY           ,CA,95337-5703,Proprietary  ,12,16,28,36,,64,100
04221900,COMPUTER TRAINING ACADEMY               ,CA,92507-2122,Proprietary  ,7,36,43,7,,36,43
04222200,FAB SCHOOL (THE)                        ,CA,92507-3434,Proprietary  ,13,55,68,44,,131,175
04226100,LAWRENCE AND COMPANY COLLEGE OF COSMETOL,CA,93662-3509,Proprietary  ,0,3,3,0,,3,3
00184600,BRIAR CLIFF UNIVERSITY                  ,IA,51104-2100,Private      ,48,47,95,1298,,698,1996
00184700,BUENA VISTA UNIVERSITY                  ,IA,50588-9987,Private      ,34,148,182,1786,,2019,3805
00184800,SOUTHEASTERN COMMUNITY COLLEGE          ,IA,52655-0000,Public       ,61,201,262,1226,,1840,3066
00185000,CENTRAL COLLEGE                         ,IA,50219-1999,Private      ,48,7,55,2190,,150,2340
00185200,CLARKE UNIVERSITY                       ,IA,52001-3198,Private      ,29,41,70,1312,,591,1903
00185400,COE COLLEGE                             ,IA,52402-5092,Private      ,41,32,73,2535,,292,2827
00185500,DES MOINES UNIV-OSTEOPATHIC MED CTR     ,IA,50312-0000,Private      ,2,34,36,46,,1762,1808
00185600,CORNELL COLLEGE                         ,IA,52314-1098,Private      ,48,5,53,2079,,118,2197
00185700,SOUTHWESTERN COMMUNITY COLLEGE          ,IA,50801-1098,Public       ,24,60,84,687,,677,1364
00185800,DIVINE WORD COLLEGE                     ,IA,52045-0380,Private      ,1,1,2,31,,17,48
00185900,DORDT COLLEGE                           ,IA,51250-1697,Private      ,19,3,22,1544,,111,1655
00186000,DRAKE UNIVERSITY                        ,IA,50311-4505,Private      ,97,126,223,4946,,2233,7179
00186200,ELLSWORTH COMMUNITY COLLEGE             ,IA,50126-1199,Public       ,34,41,75,823,,413,1236
00186400,IOWA LAKES COMMUNITY COLLEGE            ,IA,51334-2234,Public       ,38,77,115,1166,,1032,2198
00186500,IOWA CENTRAL COMMUNITY COLLEGE          ,IA,50501-0000,Public       ,101,331,432,2900,,3103,6003
00186600,GRACELAND UNIVERSITY                    ,IA,50140-1699,Private      ,30,106,136,1374,,1524,2898
00186700,GRAND VIEW UNIVERSITY                   ,IA,50316-1599,Private      ,46,108,154,2177,,1553,3730
00186800,GRINNELL COLLEGE                        ,IA,50112-1690,Private      ,69,6,75,2894,,108,3002
00186900,IOWA STATE UNIV SCIENCE & TECHNOLOG     ,IA,50011-2028,Public       ,409,338,747,27338,,6583,33921
00187100,IOWA WESLEYAN COLLEGE                   ,IA,52641-1398,Private      ,15,24,39,820,,392,1212
00187300,LORAS COLLEGE                           ,IA,52004-0178,Private      ,21,19,40,2056,,238,2294
00187400,LUTHER COLLEGE                          ,IA,52101-1045,Private      ,28,9,37,3280,,143,3423
00187500,MARSHALLTOWN COMMUNITY COLLEGE          ,IA,50158-4760,Public       ,33,107,140,751,,940,1691
00187700,NORTH IOWA AREA COMMUNITY COLLEGE       ,IA,50401-7299,Public       ,59,118,177,1464,,1175,2639
00187900,MORNINGSIDE COLLEGE                     ,IA,51106-1751,Private      ,96,118,214,2162,,932,3094
00188000,MOUNT MERCY UNIVERSITY                  ,IA,52402-4797,Private      ,16,80,96,1027,,1156,2183
00188300,NORTHWESTERN COLLEGE                    ,IA,51041-1996,Private      ,25,15,40,1528,,157,1685
00188700,SIMPSON COLLEGE                         ,IA,50125-1297,Private      ,37,35,72,2222,,581,2803
00188900,ST AMBROSE UNIVERSITY                   ,IA,52803-2898,Private      ,77,87,164,3554,,1567,5121
00189000,UNIVERSITY OF NORTHERN IOWA             ,IA,50614-0002,Public       ,172,168,340,10218,,3061,13279
00189100,UNIVERSITY OF DUBUQUE                   ,IA,52001-5099,Private      ,36,52,88,2242,,769,3011
00189200,UNIVERSITY OF IOWA                      ,IA,52242-1316,Public       ,449,416,865,22058,,9414,31472
00189300,UPPER IOWA UNIVERSITY                   ,IA,52142-9206,Private      ,49,512,561,1545,,5751,7296
00189500,WALDORF COLLEGE                         ,IA,50436-1700,Proprietary  ,20,67,87,685,,750,1435
00189600,WARTBURG COLLEGE                        ,IA,50677-2200,Private      ,26,3,29,2270,,120,2390
00189700,WARTBURG THEOLOGICAL SEMINARY           ,IA,52004-5004,Private      ,0,3,3,13,,134,147
00190000,WILLIAM PENN UNIVERSITY                 ,IA,52577-1799,Private      ,19,89,108,1198,,1185,2383
00396300,AIB COLLEGE OF BUSINESS                 ,IA,50321-1799,Private      ,17,74,91,810,,870,1680
00407500,ESTRN IOWA COMMUNITY COLLEGE DIST       ,IA,52801-1221,Public       ,15,83,98,198,,628,826
00407501,CLINTON COMMUNITY COLLEGE               ,IA,52732-0000,Public       ,45,113,158,534,,940,1474
00407502,MUSCATINE COMMUNITY COLLEGE             ,IA,52761-0000,Public       ,30,87,117,604,,729,1333
00407503,SCOTT COMMUNITY COLLEGE                 ,IA,52722-0000,Public       ,115,314,429,1664,,3109,4773
00407600,KIRKWOOD COMMUNITY COLLEGE              ,IA,52406-2068,Public       ,280,717,997,7000,,7679,14679
00422009,HAMILTON COLLEGE -  COUNCIL BLUFFS      ,IA,51503-5289,Proprietary  ,0,0,0,25,,273,298
00423300,MERCY/ST. LUKE'S SCH RAD TECH           ,IA,52402-0000,Private      ,0,9,9,33,,65,98
00458600,KAPLAN UNIVERSITY                       ,IA,52807-2095,Proprietary  ,678,10067,10745,4150,,76334,80484
00458604,KAPLAN UNIVERSITY - CEDAR RAPIDS        ,IA,52404-2998,Proprietary  ,23,226,249,175,,1832,2007
00458605,KAPLAN UNIVERSITY - DES MOINES          ,IA,50323-5702,Proprietary  ,25,290,315,181,,2157,2338
00458606,KAPLAN UNIVERSITY - MASON CITY          ,IA,50401-4665,Proprietary  ,6,119,125,62,,881,943
00458607,KAPLAN UNIVERSITY - CEDAR FALLS         ,IA,50613-6309,Proprietary  ,15,154,169,143,,1488,1631
00458700,NORTHEAST IOWA COMMUNITY COLLEGE        ,IA,52132-0400,Public       ,36,67,103,730,,778,1508
00458701,NORTHEAST IOWA COMMUNITY COLLEGE        ,IA,52068-0000,Public       ,53,168,221,1138,,1451,2589
00459500,HAWKEYE COMMUNITY COLLEGE               ,IA,50701-0000,Public       ,136,365,501,3027,,2941,5968
00459800,IOWA WESTERN CMTY CLG-COUNCIL BLUFF     ,IA,51502-0000,Public       ,173,375,548,3817,,3742,7559
00460000,NORTHWEST IOWA COMMUNITY COLLEGE        ,IA,51201-1046,Public       ,20,38,58,585,,481,1066
00626700,IOWA METHODIST MEDICAL CENTER SCHOOLS   ,IA,50309-1499,Private      ,3,17,20,59,,131,190
00627300,MERCY COLLEGE OF HEALTH SCIENCES        ,IA,50309-1239,Private      ,20,88,108,506,,1126,1632
00712000,DES MOINES AREA CMTY COLLEGE            ,IA,50021-0000,Public       ,386,1304,1690,7782,,11001,18783
00712100,FAITH BAPTIST BIBLE CLG & THEOL SEM     ,IA,50021-0000,Private      ,8,8,16,284,,76,360
00729100,ST LUKE'S COLLEGE                       ,IA,51104-0263,Private      ,4,20,24,129,,215,344
00731600,WESTERN IOWA TECH COMMUNITY COLLEGE     ,IA,51106-0000,Public       ,110,331,441,2082,,3442,5524
00758800,CAPRI COLLEGE                           ,IA,52004-0873,Proprietary  ,2,14,16,83,,137,220
00761100,EQ SCHOOL OF HAIR DESIGN                ,IA,51503-0813,Proprietary  ,3,8,11,53,,67,120
00765600,AMERICAN COLLEGE OF HARISTYLING -CR     ,IA,52402-0000,Proprietary  ,2,13,15,12,,52,64
00765800,AMER COLL OF HAIRSTYLING-DES MOINES     ,IA,50309-5446,Proprietary  ,1,9,10,15,,58,73
00765900,LA JAMES COLLEGE OF HAIRSTYLING         ,IA,50401-3308,Proprietary  ,6,7,13,68,,67,135
00771700,CAPRI COLLEGE                           ,IA,52807-2622,Proprietary  ,8,25,33,127,,268,395
00794100,COLLEGE OF HAIR DESIGN                  ,IA,50703-1834,Proprietary  ,1,9,10,16,,71,87
00826000,IOWA SCHOOL OF BEAUTY INC               ,IA,50322-0000,Proprietary  ,8,35,43,92,,241,333
00840300,INDIAN HILLS COMMUNITY COLLEGE          ,IA,52501-1398,Public       ,124,319,443,2062,,2713,4775
00840301,INDIAN HILLS COMMUNITY COLLEGE          ,IA,52544-1223,Public       ,0,0,0,15,,16,31
00842400,LA JAMES INTERNATIONAL COLLEGE          ,IA,50501-5577,Proprietary  ,2,5,7,56,,70,126
00959300,LA'JAMES COLLEGE OF HAIRSTYLING         ,IA,52240-0000,Proprietary  ,6,12,18,55,,78,133
01111300,MAHARISHI UNIV OF MANAGEMENT            ,IA,52557-0001,Private      ,17,38,55,202,,520,722
01206400,HAMILTON TECHNICAL COLLEGE              ,IA,52807-2653,Proprietary  ,7,27,34,86,,279,365
01230000,PALMER COLLEGE OF CHIROPRACTIC          ,IA,52803-5287,Private      ,5,65,70,102,,2178,2280
01300600,LA' JAMES INTERNATIONAL COLLEGE-CF      ,IA,50613-5242,Proprietary  ,8,8,16,69,,100,169
02090300,CAPRI COLLEGE                           ,IA,52404-0000,Proprietary  ,22,25,47,151,,182,333
02134500,LA JAMES INTERNATIONAL COLLEGE - DAV    ,IA,52806-3952,Proprietary  ,2,9,11,32,,82,114
02160900,"SALON PROFESSIONAL ACADEMY, THE         ",IA,50010-0000,Proprietary  ,8,10,18,120,,100,220
02262500,FAUST INSTITUTE OF COSMETOLOGY          ,IA,50588-0000,Proprietary  ,1,0,1,33,,47,80
02274100,LA' JAMES INTERNATIONAL COLLEGE - DM    ,IA,50131-0000,Proprietary  ,10,25,35,83,,141,224
02289000,AMERICAN HAIR ACADEMY                   ,IA,52627-4530,Proprietary  ,3,6,9,26,,40,66
02306900,IOWA SCHOOL OF BEAUTY                   ,IA,52501-0000,Proprietary  ,5,14,19,45,,72,117
02328900,EMMAUS BIBLE COLLEGE                    ,IA,52001-0000,Private      ,7,4,11,258,,55,313
02330900,IOWA SCHOOL OF BEAUTY                   ,IA,50158-0000,Proprietary  ,0,6,6,16,,44,60
02609200,VATTEROTT COLLEGE                       ,IA,50321-4704,Proprietary  ,20,100,120,139,,637,776
03069100,ALLEN COLLEGE                           ,IA,50703-1916,Private      ,12,48,60,373,,652,1025
03441300,IOWA SCHOOL OF BEAUTY                   ,IA,51106-5111,Proprietary  ,1,8,9,39,,105,144
03607400,TOTAL LOOK SCHOOL OF COSMETOLOGY AND MAS,IA,52136-1053,Proprietary  ,1,4,5,9,,15,24
03720300,CARLSON COLLEGE OF MASSAGE THERAPY      ,IA,52205-7519,Proprietary  ,3,2,5,22,,43,65
04051313,ART INSTITUTE OF PHOENIX (THE) - BROWN M,IA,52722-3628,Proprietary  ,2,10,12,32,,81,113
04089300,BIO-CHI INSTITUTE OF MASSAGE THERAPY    ,IA,51103-2138,Proprietary  ,0,0,0,9,,24,33
04177800,SALON PROFESSIONAL ACADEMY (THE)        ,IA,52240-6083,Proprietary  ,5,8,13,39,,61,100
04203300,AVEDA INSTITUTE DES MOINES              ,IA,50266-8137,Proprietary  ,17,23,40,209,,175,384
00259600,ATLANTIC COMMUNITY COLLEGE              ,NJ,08330-2699,Public       ,312,669,981,4200,,5004,9204
00259700,BLOOMFIELD COLLEGE                      ,NJ,07003-3425,Private      ,108,119,227,2996,,1668,4664
00259800,CALDWELL COLLEGE                        ,NJ,07006-6195,Private      ,77,103,180,2525,,1258,3783
00259900,CENTENARY COLLEGE                       ,NJ,07840-2184,Private      ,44,84,128,1825,,969,2794
00260000,COLLEGE OF SAINT ELIZABETH              ,NJ,07960-6989,Private      ,23,61,84,1055,,793,1848
00260100,CUMBERLAND COUNTY COLLEGE               ,NJ,08362-9912,Public       ,151,402,553,2492,,3543,6035
00260300,DREW UNIVERSITY                         ,NJ,07940-4063,Private      ,79,43,122,3197,,716,3913
00260700,FAIRLEIGH DICKINSON UNIV-TEANECK        ,NJ,07666-1996,Private      ,143,278,421,4874,,3185,8059
00260701,FAIRLEIGH DICKINSON UNIV-FLORHAM        ,NJ,07940-0000,Private      ,100,67,167,3759,,1192,4951
00260702,FAIRLEIGH DICKINSON UNIV-ED WMS CLG     ,NJ,07601-0000,Private      ,23,58,81,571,,525,1096
00260703,FAIRLEIGH DICKINSON UNIVERSITY          ,NJ,07940-0000,Private      ,55,66,121,1845,,826,2671
00260800,GEORGIAN COURT UNIVERSITY               ,NJ,08701-2697,Private      ,45,104,149,1787,,1400,3187
00260900,ROWAN UNIVERSITY                        ,NJ,08028-1702,Public       ,434,438,872,15222,,5849,21071
00261000,FELICIAN COLLEGE                        ,NJ,07644-2198,Private      ,58,117,175,1958,,1458,3416
00261300,NEW JERSEY CITY UNIVERSITY              ,NJ,07305-1597,Public       ,202,535,737,5671,,6947,12618
00261500,MIDDLESEX COUNTY COLLEGE                ,NJ,08818-3050,Public       ,433,530,963,7471,,5584,13055
00261600,MONMOUTH UNIVERSITY                     ,NJ,07764-1898,Private      ,267,216,483,7767,,2632,10399
00261700,MONTCLAIR STATE UNIVERSITY              ,NJ,07043-9987,Public       ,596,616,1212,20053,,8684,28737
00261900,NEW BRUNSWICK THEOLOGICAL SEMINARY      ,NJ,08901-0000,Private      ,5,20,25,91,,213,304
00262100,NEW JERSEY INST OF TECHNOLOGY           ,NJ,07102-1982,Public       ,241,303,544,7237,,4022,11259
00262200,KEAN UNIVERSITY                         ,NJ,07083-7131,Public       ,418,685,1103,11916,,9455,21371
00262400,OCEAN COUNTY COLLEGE                    ,NJ,08754-2001,Public       ,262,551,813,5428,,4639,10067
00262500,WILLIAM PATERSON UNIVERSITY             ,NJ,07470-2152,Public       ,331,369,700,13285,,5668,18953
00262600,PRINCETON THEOLOGICAL SEMINARY          ,NJ,08542-0000,Private      ,3,20,23,15,,597,612
00262700,PRINCETON UNIVERSITY                    ,NJ,08544-0001,Private      ,573,166,739,16970,,1810,18780
00262800,RIDER UNIVERSITY                        ,NJ,08648-3099,Private      ,229,135,364,8235,,1848,10083
00262900,"RUTGERS, THE STATE UNIVERSITY OF NJ     ",NJ,08901-1281,Public       ,1515,1818,3333,51178,,27854,79032
00262923,"RUTGERS, THE STATE UNIVERSITY OF NEW JER",NJ,07101-1709,Public       ,0,0,0,769,,5876,6645
00263200,SETON HALL UNIVERSITY                   ,NJ,07079-2697,Private      ,280,285,565,11664,,4367,16031
00263201,SETON HALL UNIVERSITY - SCHOOL OF LAW   ,NJ,07079-5210,Private      ,26,66,92,305,,1753,2058
00263800,SAINT PETER'S UNIVERSITY                ,NJ,07306-5997,Private      ,96,191,287,4062,,2103,6165
00263900,STEVENS INSTITUTE OF TECHNOLOGY         ,NJ,07030-5370,Private      ,137,76,213,5022,,752,5774
00264200,COLLEGE OF NEW JERSEY (THE)             ,NJ,08628-0718,Public       ,322,120,442,12594,,1473,14067
00264300,UNION COUNTY COLLEGE                    ,NJ,07016-1598,Public       ,393,948,1341,6170,,8868,15038
00473600,BERGEN COMMUNITY COLLEGE                ,NJ,07652-1595,Public       ,496,616,1112,9212,,6218,15430
00474000,MERCER COUNTY COMMUNITY COLLEGE         ,NJ,08690-0000,Public       ,230,539,769,3743,,4619,8362
00539900,MONMOUTH COUNTY VOCATIONAL SCH DIST     ,NJ,07728-5033,Public       ,5,17,22,72,,146,218
00545200,TETERBORO SCH OF AERONAUTICS            ,NJ,07608-1083,Proprietary  ,31,28,59,129,,173,302
00546100,SALEM COMMUNITY COLLEGE                 ,NJ,08069-2799,Public       ,27,84,111,697,,863,1560
00641700,HOLY NAME HOSPITAL SCH OF NURSING       ,NJ,07666-4254,Private      ,3,16,19,93,,265,358
00642000,MOUNTAINSIDE HOSP SCH NRSG              ,NJ,07042-4898,Proprietary  ,4,22,26,46,,204,250
00642100,MUHLENBERG SNYDER SCHOOLS               ,NJ,07061-3399,Private      ,12,54,66,128,,541,669
00642900,ST FRANCIS MEDICAL CTR SCH NURSING      ,NJ,08629-1986,Private      ,1,27,28,51,,182,233
00642902,ST FRANCIS MED CTR RAD TECH             ,NJ,08629-0000,Private      ,1,12,13,18,,78,96
00686500,CAMDEN COUNTY COLLEGE                   ,NJ,08012-3240,Public       ,397,1060,1457,6784,,9327,16111
00690100,GLOUCESTER COUNTY COLLEGE               ,NJ,08080-4249,Public       ,180,372,552,4143,,3593,7736
00710700,ESSEX COUNTY COLLEGE                    ,NJ,07102-1798,Public       ,445,1079,1524,6629,,10176,16805
00750200,BERKELEY COLLEGE                        ,NJ,07424-3367,Proprietary  ,156,389,545,2643,,3642,6285
00750205,BERKELEY COLLEGE - CLIFTON              ,NJ,07011-2161,Proprietary  ,0,0,0,198,,580,778
00757302,NATURAL MOTION INST OF HAIR DESIGN      ,NJ,07306-5496,Proprietary  ,0,0,0,34,,90,124
00757309,EMPIRE BEAUTY SCHOOL - CHERRY HILL      ,NJ,08002-3711,Proprietary  ,0,0,0,88,,236,324
00759300,PARISIAN BEAUTY ACADEMY                 ,NJ,07601-5509,Proprietary  ,21,52,73,213,,281,494
00772900,COUNTY COLLEGE OF MORRIS                ,NJ,07869-0000,Public       ,225,252,477,4177,,2273,6450
00773000,BURLINGTON COUNTY COLLEGE               ,NJ,08068-1599,Public       ,295,702,997,4828,,5477,10305
00773100,RARITAN VALLEY COMMUNITY COLLEGE        ,NJ,08876-1265,Public       ,153,266,419,3112,,2502,5614
00780401,STAR CAREER ACADEMY - STAR LAKEWOOD     ,NJ,08701-5900,Proprietary  ,27,68,95,153,,460,613
00780402,STAR CAREER ACADEMY - STAR EGG HARBOR   ,NJ,08234-4863,Proprietary  ,11,50,61,98,,332,430
00793808,LINCOLN TECHNICAL INSTITUTE - SOUTH PLAI,NJ,07080-2424,Proprietary  ,18,34,52,197,,217,414
00793810,LINCOLN TECHNICAL INSTITUTE - MAHWAH    ,NJ,07430-2106,Proprietary  ,50,68,118,510,,345,855
00793811,LINCOLN TECHNICAL INSTITUTE - UNION     ,NJ,07083-5032,Proprietary  ,129,176,305,771,,885,1656
00794700,BETH MEDRASH GOVOHA OF AMERICA          ,NJ,08701-0000,Private      ,137,426,563,343,,1763,2106
00840400,BROOKDALE COMMUNITY COLLEGE             ,NJ,07738-1597,Public       ,285,559,844,6263,,4710,10973
00844101,ANTHEM INSTITUTE                        ,NJ,08002-0000,Proprietary  ,31,103,134,133,,391,524
00849400,HO HO KUS SCHL OF TRADE & TECH SCIENCES ,NJ,07513-1402,Proprietary  ,23,61,84,129,,247,376
00860900,RABBINICAL COLLEGE OF AMERICA           ,NJ,07960-3600,Private      ,15,3,18,63,,8,71
00907800,CAPRI INSTITUTE OF HAIR DESIGN          ,NJ,07011-2111,Proprietary  ,21,54,75,114,,257,371
00934400,RAMAPO COLLEGE OF NEW JERSEY            ,NJ,07430-1680,Public       ,221,119,340,8088,,1682,9770
00934500,RICHARD STOCKTON COLLEGE OF NJ          ,NJ,08240-0000,Public       ,257,255,512,9994,,3701,13695
00945916,EMPIRE BEAUTY SCHOOL - HAIR DESIGN SCHOO,NJ,07712-4003,Proprietary  ,0,0,0,100,,184,284
00945917,EMPIRE BEAUTY SCHOOL - HAIR DESIGN SCHOO,NJ,07003-2517,Proprietary  ,0,0,0,15,,45,60
00945919,EMPIRE BEAUTY SCHOOL - HAIR DESIGN SCHOO,NJ,07083-3306,Proprietary  ,0,0,0,48,,112,160
00982804,EVEREST INSTITUTE - SOUTH PLAINFIELD    ,NJ,07080-1125,Proprietary  ,45,124,169,325,,648,973
00999400,PASSAIC COUNTY COMMUNITY COLLEGE        ,NJ,07505-1179,Public       ,223,532,755,4679,,5679,10358
01062900,P B COSMETOLOGY EDUCATION CENTRE        ,NJ,08030-1750,Proprietary  ,8,16,24,110,,133,243
01085100,ANTHEM INSTITUTE                        ,NJ,07054-3409,Proprietary  ,70,150,220,354,,764,1118
01085101,ANTHEM INSTITUTE                        ,NJ,07306-0000,Proprietary  ,7,25,32,72,,189,261
01085102,ANTHEM INSTITUTE                        ,NJ,08902-0000,Proprietary  ,3,20,23,50,,118,168
01090300,RIZZIERI INSTITUTE                      ,NJ,08043-4600,Proprietary  ,13,37,50,142,,190,332
01152300,MORRIS COUNTY SCHOOL OF TECHNOLOGY      ,NJ,07834-0000,Public       ,0,16,16,49,,114,163
01198900,TALMUDICAL ACADEMY                      ,NJ,07710-0000,Private      ,4,4,8,58,,5,63
01209000,ROBERT FIANCE BEAUTY SCHOOLS            ,NJ,08861-4118,Proprietary  ,19,36,55,89,,145,234
01234602,DOVER BUSINESS COLLEGE                  ,NJ,07801-4643,Proprietary  ,0,0,0,81,,203,284
01246100,LINCOLN TECHNICAL INSTITUTE             ,NJ,08820-2896,Proprietary  ,38,97,135,353,,720,1073
01246102,LINCOLN TECHNICAL INSTITUTE             ,NJ,08057-3212,Proprietary  ,29,85,114,243,,706,949
01246103,LINCOLN TECHNICAL INSTITUTE             ,NJ,07652-2106,Proprietary  ,40,89,129,421,,742,1163
01246200,HOHOKUS - HACKENSACK SCHOOL OF BUSINESS ,NJ,07601-7197,Proprietary  ,32,129,161,120,,479,599
01295400,HUDSON COUNTY COMMUNITY COLLEGE         ,NJ,07306-4012,Public       ,353,837,1190,5845,,7003,12848
02053700,EASTWICK COLLEGE                        ,NJ,07446-0000,Proprietary  ,30,158,188,348,,1453,1801
02061800,ROMAN ACADEMY OF BEAUTY CULTURE         ,NJ,07506-0000,Proprietary  ,3,2,5,29,,26,55
02079414,EMPIRE BEAUTY SCHOOL - LAUREL SPRINGS   ,NJ,08021-5602,Proprietary  ,0,0,0,100,,210,310
02079415,EMPIRE BEAUTY SCHOOL - BORDENTOWN       ,NJ,08505-1513,Proprietary  ,0,0,0,16,,48,64
02092300,HOHOKUS SCHOOL - RETS/NUTLEY            ,NJ,07110-0000,Proprietary  ,29,79,108,210,,460,670
02103700,CAPRI INSTITUTE OF HAIR DESIGN          ,NJ,07652-0000,Proprietary  ,10,17,27,81,,104,185
02104000,HARRIS SCHOOL OF BUSINESS               ,NJ,08002-2983,Proprietary  ,83,385,468,368,,1485,1853
02106601,AMERICAN INSTITUTE - CLIFTON            ,NJ,07011-2345,Proprietary  ,44,118,162,244,,557,801
02106605,AMERICAN INSTITUTE - TOMS RIVER         ,NJ,08755-1524,Proprietary  ,16,83,99,58,,260,318
02131100,DU CRET SCHOOL OF THE ARTS              ,NJ,07060-0000,Private      ,4,2,6,28,,19,47
02131600,PENNCO TECH                             ,NJ,08012-0000,Proprietary  ,62,147,209,452,,808,1260
02132300,BERDAN INSTITUTE                        ,NJ,07512-0000,Proprietary  ,53,110,163,372,,593,965
02146800,JOE KUBERT SCH OF CARTOON & GRAPHIC     ,NJ,07801-0000,Proprietary  ,7,4,11,120,,71,191
02154000,DIVERS ACAD OF EASTERN SEABOARD         ,NJ,08081-1139,Proprietary  ,18,56,74,99,,252,351
02183600,CAPRI INSTITUTE OF HAIR DESIGN          ,NJ,07033-0000,Proprietary  ,13,27,40,85,,141,226
02192200,THOMAS EDISON STATE COLLEGE             ,NJ,08608-0000,Public       ,92,1085,1177,729,,8987,9716
02219600,OMEGA INSTITUTE                         ,NJ,08109-0000,Proprietary  ,9,28,37,46,,188,234
02223700,ROBERT FIANCE BEAUTY SCHOOLS            ,NJ,07093-4623,Proprietary  ,16,57,73,50,,161,211
02223900,DRAKE COLLEGE OF BUSINESS               ,NJ,07201-0000,Proprietary  ,38,272,310,160,,1101,1261
02223902,DRAKE COLLEGE OF BUSINESS - NEWARK CAMPU,NJ,07112-2760,Proprietary  ,43,359,402,292,,1601,1893
02232500,UNION COUNTY VOCATIONAL TECH INST       ,NJ,07076-0000,Public       ,7,11,18,96,,134,230
02234600,SHORE BEAUTY SCHOOL                     ,NJ,08232-0000,Proprietary  ,11,34,45,73,,171,244
02246000,ROSS UNIVERSITY - MEDICAL SCHOOL        ,NJ,08837-0000,Proprietary  ,6,303,309,41,,3970,4011
02248600,COOPER HEALTH SYS-CTR ALLIED HEALTH     ,NJ,08103-0000,Private      ,4,43,47,153,,459,612
02265500,CAPRI INSTITUTE OF HAIR DESIGN          ,NJ,08724-0000,Proprietary  ,14,36,50,83,,149,232
02277900,ROSS UNIV - SCH OF VETERINARY MED       ,NJ,08837-0000,Proprietary  ,4,100,104,23,,1559,1582
02312000,BERGEN COUNTY TECHNICAL SCHOOLS         ,NJ,07601-6110,Public       ,14,45,59,112,,193,305
02503900,WARREN COUNTY COMMUNITY COLLEGE         ,NJ,07882-0000,Public       ,43,93,136,775,,764,1539
02523700,OCEAN COUNTY VOCATIONAL-TECH SCHOOL     ,NJ,08753-0000,Public       ,12,42,54,286,,513,799
02525900,ARTISTIC ACADEMY OF HAIR DESIGN         ,NJ,07950-1409,Proprietary  ,6,17,23,103,,124,227
02528200,ROBERT FIANCE BEAUTY SCHOOLS            ,NJ,07060-4840,Proprietary  ,14,37,51,57,,141,198
02558700,PRISM CAREER INSTITUTE                  ,NJ,08037-0000,Proprietary  ,12,68,80,106,,542,648
02568800,SUSSEX COUNTY COMMUNITY COLLEGE         ,NJ,07860-1149,Public       ,82,124,206,1636,,1140,2776
02586900,HARRIS SCHOOL OF BUSINESS               ,NJ,08043-2604,Proprietary  ,34,180,214,190,,801,991
02616402,SANFORD-BROWN INSTITUTE - ISELIN        ,NJ,08830-0000,Proprietary  ,41,93,134,296,,684,980
03077500,RABBI JACOB JOSEPH SCHOOL               ,NJ,08817-4494,Private      ,9,2,11,36,,9,45
03122600,EASTERN INTERNATIONAL COLLEGE           ,NJ,07306-3906,Proprietary  ,14,55,69,195,,527,722
03187300,STENOTECH CAREER INSTITUTE              ,NJ,07004-3490,Proprietary  ,4,12,16,23,,48,71
03197300,INSTITUTE FOR HEALTH EDUCATION(THE)     ,NJ,07306-2929,Proprietary  ,5,26,31,63,,209,272
03324300,CENTRAL CAREER SCHOOL                   ,NJ,07080-2408,Proprietary  ,6,58,64,44,,212,256
03380302,STAR CAREER ACADEMY - STAR NEWARK       ,NJ,07102-4510,Proprietary  ,25,142,167,236,,845,1081
03380303,STAR CAREER ACADEMY - STAR CLIFTON      ,NJ,07011-2248,Proprietary  ,11,84,95,68,,283,351
03389300,ACADEMY OF MASSAGE THERAPY              ,NJ,07631-0000,Proprietary  ,6,16,22,35,,112,147
03424500,NEW COMMUNITY WORKFORCE DEVELOPMENT     ,NJ,07103-2402,Private      ,1,6,7,61,,522,583
03536300,INSTITUTE FOR THERAPEUTIC MASSAGE       ,NJ,07420-1452,Proprietary  ,5,23,28,33,,126,159
03625300,PERFORMANCE TRAINING INSTITUTE          ,NJ,08753-0000,Proprietary  ,0,0,0,16,,50,66
03650600,PC AGE                                  ,NJ,07306-3936,Proprietary  ,9,50,59,59,,317,376
03650603,PC AGE                                  ,NJ,08817-2842,Proprietary  ,0,8,8,9,,58,67
03666300,PILLAR COLLEGE                          ,NJ,07102-5511,Private      ,10,82,92,92,,671,763
03803300,HEALTHCARE TRAINING INSTITUTE           ,NJ,07083-3504,Proprietary  ,11,45,56,98,,355,453
03811300,EASTERN SCHOOL OF ACUPUNCTURE AND TRADIT,NJ,07042-3562,Proprietary  ,1,13,14,5,,87,92
04081300,BAIS MEDRASH TORAS CHESED               ,NJ,08701-0000,Private      ,13,3,16,33,,19,52
04123400,YESHIVAS BE'ER YITZCHOK                 ,NJ,07208-2380,Private      ,6,5,11,24,,54,78
04125000,GENTLE HEALING SCHOOL OF MASSAGE        ,NJ,08512-3600,Proprietary  ,2,8,10,3,,41,44
04131100,YESHIVA TORAS CHAIM                     ,NJ,08701-2120,Private      ,12,1,13,184,,4,188
04131200,TOTAL IMAGE BEAUTY ACADEMY              ,NJ,07307-2943,Proprietary  ,8,21,29,28,,97,125
04134100,CENTER FOR ALLIED HEALTH & NURSING EDUCA,NJ,07601-5801,Proprietary  ,27,310,337,201,,2461,2662
04136400,AMERICAN INSTITUTE OF MEDICAL SCIENCES &,NJ,07080-1183,Proprietary  ,18,58,76,117,,306,423
04154500,STARTING POINTS FOR CHILDREN            ,NJ,07306-0001,Private      ,4,22,26,18,,121,139
04154900,NATIONAL CAREER INSTITUTE               ,NJ,07018-2011,Proprietary  ,8,44,52,25,,175,200
04154901,NATIONAL CAREER INSTITUTE - JERSEY CITY ,NJ,07306-4300,Proprietary  ,6,26,32,7,,29,36
04173100,LAB PAUL MITCHELL PARTNER SCHOOL (THE)  ,NJ,08628-2500,Proprietary  ,9,22,31,87,,123,210
04180300,MESIVTA KESER TORAH                     ,NJ,07719-2409,Private      ,13,0,13,15,,2,17
04181400,BEST CARE TRAINING INSTITUTE            ,NJ,07018-1703,Proprietary  ,1,18,19,19,,197,216
04184500,CHRISTINE VALMY INTERNATIONAL SCHOOL OF ,NJ,07058-9589,Proprietary  ,5,22,27,32,,70,102
04188700,ASI CAREER INSTITUTE                    ,NJ,08012-1043,Proprietary  ,3,35,38,21,,194,215
04191400,SCHOOL OF COURT REPORTING (THE)         ,NJ,08053-1533,Proprietary  ,0,0,0,6,,20,26
04192400,YESHIVA GEDOLAH ZICHRON LEYMA           ,NJ,07036-3905,Private      ,3,1,4,8,,5,13
04207500,MEDICAL CAREER INSTITUTE                ,NJ,07712-7202,Proprietary  ,0,28,28,30,,126,156
04216000,UNIVERSAL TRAINING INSTITUTE            ,NJ,08861-4106,Proprietary  ,4,39,43,27,,190,217
04216100,YESHIVA YESODEI HATORAH                 ,NJ,08701-4946,Private      ,0,0,0,3,,0,3
04216500,RIZZIERI INSTITUTE                      ,NJ,08043-1911,Proprietary  ,6,16,22,30,,74,104
04218200,PAUL MITCHELL THE SCHOOL - JERSEY SHORE ,NJ,08723-3413,Proprietary  ,23,28,51,80,,79,159
04218500,SALON PROFESSIONAL ACADEMY THE          ,NJ,07080-0000,Proprietary  ,12,25,37,16,,31,47
00266500,VAUGHN COLLEGE OF AERONAUTICS AND TECHNO,NY,11369-9997,Private      ,59,86,145,1354,,1058,2412
00266600,ADELPHI UNIVERSITY                      ,NY,11530-4299,Private      ,253,304,557,8873,,4609,13482
00266700,DOWLING COLLEGE                         ,NY,11769-1999,Private      ,56,84,140,2110,,1374,3484
00266800,ALFRED UNIVERSITY                       ,NY,14802-1205,Private      ,72,55,127,3912,,725,4637
00266900,BANK STREET COLLEGE OF EDUCATION        ,NY,10025-0000,Private      ,3,61,64,25,,817,842
00267100,BARD COLLEGE                            ,NY,12504-5000,Private      ,106,36,142,3084,,779,3863
00267400,NEW YORK THEOLOGICAL SEMINARY           ,NY,10115-0002,Private      ,0,24,24,4,,290,294
00267700,BROOKLYN LAW SCHOOL                     ,NY,11201-0000,Private      ,18,66,84,140,,2640,2780
00267800,BRYANT & STRATTON COLLEGE               ,NY,14203-1713,Proprietary  ,306,1693,1999,2943,,15289,18232
00267803,BRYANT & STRATTON COLLEGE - GREECE      ,NY,14606-4227,Proprietary  ,34,173,207,335,,1333,1668
00267805,BRYANT & STRATTON COLLEGE - SYRACUSE    ,NY,13203-2502,Proprietary  ,46,172,218,548,,1556,2104
00267807,BRYANT & STRATTON COLLEGE - ALBANY      ,NY,12205-5230,Proprietary  ,15,107,122,264,,1048,1312
00268100,CANISIUS COLLEGE                        ,NY,14208-1098,Private      ,84,118,202,4874,,1911,6785
00268500,CAZENOVIA COLLEGE                       ,NY,13035-1085,Private      ,24,16,40,2010,,241,2251
00268700,CUNY-BROOKLYN COLLEGE                   ,NY,11210-2814,Public       ,808,1051,1859,21316,,13663,34979
00268800,CITY COLLEGE-CUNY                       ,NY,10031-9198,Public       ,792,1094,1886,23067,,12812,35879
00268900,CUNY-HUNTER COLLEGE                     ,NY,10021-0000,Public       ,1064,1622,2686,32002,,18765,50767
00269000,QUEENS COLLEGE-CUNY                     ,NY,11367-1597,Public       ,705,786,1491,19446,,9883,29329
00269100,CUNY- BOROUGH OF MANHATTAN CMTY CLG     ,NY,10007-1047,Public       ,2050,2043,4093,31910,,19082,50992
00269200,CUNY BRONX COMMUNITY COLLEGE            ,NY,10453-3102,Public       ,992,1181,2173,13242,,11956,25198
00269300,CUNY-JOHN JAY CLG CRIMINAL JUSTICE      ,NY,10019-1093,Public       ,699,737,1436,18735,,9519,28254
00269400,KINGSBOROUGH COMMUNITY COLLEGE          ,NY,11235-2398,Public       ,923,907,1830,16287,,10186,26473
00269600,NY CITY COLLEGE OF TECHNOLOGY-CUNY      ,NY,11201-2983,Public       ,886,1068,1954,20312,,11294,31606
00269700,QUEENSBOROUGH COMMUNITY COLLEGE         ,NY,11364-1497,Public       ,934,750,1684,16011,,7467,23478
00269800,CUNY THE COLLEGE OF STATEN ISLAND       ,NY,10314-6600,Public       ,551,465,1016,13900,,5563,19463
00269900,CLARKSON UNIVERSITY                     ,NY,13699-5615,Private      ,110,36,146,6303,,535,6838
00270000,COLGATE ROCHESTER CROZER DIVINITY S     ,NY,14620-0000,Private      ,1,10,11,8,,84,92
00270100,COLGATE UNIVERSITY                      ,NY,13346-1386,Private      ,144,9,153,4427,,104,4531
00270300,COLLEGE OF MOUNT SAINT VINCENT          ,NY,10471-1093,Private      ,47,38,85,2762,,594,3356
00270400,COLLEGE OF NEW ROCHELLE                 ,NY,10805-2339,Private      ,60,357,417,1294,,4453,5747
00270500,COLLEGE OF SAINT ROSE                   ,NY,12203-1490,Private      ,107,152,259,4943,,1852,6795
00270700,COLUMBIA UNIVERSITY                     ,NY,10027-0000,Private      ,945,1098,2043,23811,,22643,46454
00270800,BARNARD COLLEGE-COLUMBIA UNIV           ,NY,10027-6598,Private      ,129,47,176,4567,,497,5064
00270900,CONCORDIA COLLEGE                       ,NY,10708-1998,Private      ,15,31,46,1046,,571,1617
00271000,COOPER UNION                            ,NY,10003-7120,Private      ,49,24,73,1815,,364,2179
00271100,CORNELL UNIVERSITY                      ,NY,14853-2801,Private      ,846,254,1100,29907,,6453,36360
00271101,WEILL CORNELL MEDICAL COLLEGE AND GRADUA,NY,10021-0000,Private      ,7,38,45,47,,771,818
00271200,D'YOUVILLE COLLEGE                      ,NY,14201-1084,Private      ,55,123,178,2092,,2391,4483
00271300,DOMINICAN COLLEGE                       ,NY,10962-1299,Private      ,61,79,140,1840,,1015,2855
00271800,ELMIRA COLLEGE                          ,NY,14901-2099,Private      ,52,25,77,2398,,395,2793
00272200,FORDHAM UNIVERSITY                      ,NY,10458-5157,Private      ,810,571,1381,26188,,9532,35720
00272600,GENERAL THEOLOGICAL SEMINARY            ,NY,10011-0000,Private      ,0,4,4,1,,80,81
00272800,HAMILTON COLLEGE                        ,NY,13323-1218,Private      ,85,4,89,3177,,96,3273
00272900,HARTWICK COLLEGE                        ,NY,13820-4020,Private      ,69,14,83,4320,,209,4529
00273100,HOBART & WILLIAM SMITH COLLEGES         ,NY,14456-3397,Private      ,86,10,96,3505,,106,3611
00273200,HOFSTRA UNIVERSITY                      ,NY,11549-1010,Private      ,434,240,674,18811,,5672,24483
00273400,HOUGHTON COLLEGE                        ,NY,14744-0128,Private      ,20,18,38,1366,,201,1567
00273500,HILBERT COLLEGE                         ,NY,14075-1597,Private      ,37,28,65,1152,,374,1526
00273700,IONA COLLEGE                            ,NY,10801-1890,Private      ,108,56,164,6866,,1205,8071
00273900,ITHACA COLLEGE                          ,NY,14850-7130,Private      ,352,39,391,14888,,1140,16028
00274000,JEWISH THEOLOGICAL SEMINARY OF AMER     ,NY,10027-4649,Private      ,0,2,2,109,,165,274
00274200,THE JUILLIARD SCHOOL                    ,NY,10023-6588,Private      ,92,44,136,1673,,838,2511
00274400,KEUKA COLLEGE                           ,NY,14478-0000,Private      ,34,128,162,1722,,1414,3136
00274800,LEMOYNE COLLEGE                         ,NY,13214-1399,Private      ,112,62,174,5021,,973,5994
00274900,NEW YORK COLLEGE OF PODIATRIC MED       ,NY,10035-1940,Private      ,5,28,33,53,,459,512
00275100,LONG ISLAND UNIVERSITY                  ,NY,11548-1326,Private      ,307,639,946,13060,,10916,23976
00275800,MANHATTAN COLLEGE                       ,NY,10471-4098,Private      ,158,75,233,6956,,845,7801
00275900,MANHATTAN SCHOOL OF MUSIC               ,NY,10027-4689,Private      ,44,26,70,728,,688,1416
00276000,MANHATTANVILLE COLLEGE                  ,NY,10577-2132,Private      ,84,74,158,3229,,825,4054
00276300,MARIA COLLEGE                           ,NY,12208-1798,Private      ,15,71,86,235,,904,1139
00276500,MARIST COLLEGE                          ,NY,12601-1387,Private      ,236,132,368,10369,,1628,11997
00276900,MARYMOUNT MANHATTAN COLLEGE             ,NY,10021-4597,Private      ,114,33,147,3964,,409,4373
00277200,MERCY COLLEGE                           ,NY,10522-1189,Private      ,259,653,912,6280,,8002,14282
00277500,MOLLOY COLLEGE                          ,NY,11570-1100,Private      ,112,237,349,4246,,2560,6806
00277700,MEDAILLE COLLEGE                        ,NY,14214-2695,Private      ,70,187,257,1837,,1721,3558
00277800,MOUNT SAINT MARY COLLEGE                ,NY,12550-3494,Private      ,85,109,194,3834,,1269,5103
00277900,NAZARETH COLLEGE OF ROCHESTER           ,NY,14618-3790,Private      ,70,85,155,3867,,1624,5491
00278200,NEW YORK INSTITUTE OF TECHNOLOGY        ,NY,11568-8000,Private      ,164,177,341,5918,,2754,8672
00278202,NY INSTITUTE OF TECHNOLOGY-OSTEOPATHIC M,NY,11568-0000,Private      ,2,10,12,39,,1145,1184
00278300,NEW YORK LAW SCHOOL                     ,NY,10013-0000,Private      ,10,54,64,104,,2543,2647
00278400,NEW YORK MEDICAL COLLEGE                ,NY,10595-0000,Private      ,7,59,66,52,,2039,2091
00278500,NEW YORK UNIVERSITY                     ,NY,10012-1091,Private      ,1672,1778,3450,42609,,29757,72366
00278800,NIAGARA UNIVERSITY                      ,NY,14109-2010,Private      ,85,72,157,4072,,944,5016
00279000,NYACK COLLEGE                           ,NY,10960-3698,Private      ,39,173,212,1527,,2016,3543
00279100,PACE UNIVERSITY - NEW YORK              ,NY,10038-1598,Private      ,421,416,837,12568,,4744,17312
00279101,PACE UNIVERSITY-PLEASANTVILLE           ,NY,10570-0000,Private      ,93,134,227,4227,,1453,5680
00279102,PACE UNIVERSITY - WHITE PLAINS          ,NY,10603-0000,Private      ,34,122,156,584,,1770,2354
00279500,PAUL SMITHS CLG OF ARTS & SCIENCES      ,NY,12970-0000,Private      ,28,13,41,1328,,177,1505
00279600,POLYTECHNIC INTSTITUTE OF NEW YORK UNIV ,NY,11201-3840,Private      ,98,109,207,3976,,1233,5209
00279800,PRATT INSTITUTE                         ,NY,11205-3899,Private      ,231,161,392,5301,,2548,7849
00280300,RENSSELAER POLYTECHNIC INSTITUTE        ,NY,12180-3590,Private      ,303,32,335,12192,,741,12933
00280500,ROBERTS WESLEYAN COLLEGE                ,NY,14624-1997,Private      ,40,128,168,1363,,1373,2736
00280600,ROCHESTER INSTITUTE OF TECHNOLOGY       ,NY,14623-5608,Private      ,373,167,540,16741,,3112,19853
00280700,ROCKEFELLER UNIVERSITY                  ,NY,10021-0000,Private      ,7,7,14,36,,57,93
00280800,DAEMEN COLLEGE                          ,NY,14226-3592,Private      ,58,97,155,2882,,1319,4201
00281000,THE SAGE COLLEGES                       ,NY,12180-4199,Private      ,43,142,185,2065,,1974,4039
00281200,TROCAIRE COLLEGE                        ,NY,14220-2094,Private      ,40,160,200,921,,1826,2747
00281300,SARAH LAWRENCE COLLEGE                  ,NY,10708-5999,Private      ,74,21,95,2178,,618,2796
00281400,SKIDMORE COLLEGE                        ,NY,12866-1632,Private      ,122,16,138,4982,,176,5158
00281500,ST BERNARDS SCH THEOLOGY & MINISTRY     ,NY,14618-3822,Private      ,1,3,4,3,,46,49
00281600,SIENA COLLEGE                           ,NY,12211-1462,Private      ,115,19,134,6637,,367,7004
00281700,ST BONAVENTURE UNIVERSITY               ,NY,14778-2284,Private      ,39,21,60,3023,,573,3596
00282000,ST FRANCIS COLLEGE                      ,NY,11201-4398,Private      ,162,96,258,3283,,884,4167
00282100,ST JOHN FISHER COLLEGE                  ,NY,14618-3597,Private      ,91,116,207,5030,,1959,6989
00282200,CHRIST THE KING SEMINARY                ,NY,14052-0607,Private      ,1,1,2,3,,9,12
00282300,ST JOHN'S UNIVERSITY                    ,NY,11439-1343,Private      ,486,337,823,27175,,7008,34183
00282500,ST JOSEPH'S COLLEGE                     ,NY,11205-3688,Private      ,60,87,147,1820,,966,2786
00282501,ST JOSEPH'S COLLEGE-SUFFOLK CAMPUS      ,NY,11772-0000,Private      ,105,151,256,3237,,1699,4936
00282900,ST LAWRENCE UNIVERSITY                  ,NY,13617-1455,Private      ,58,7,65,2890,,149,3039
00283200,ST THOMAS AQUINAS COLLEGE               ,NY,10976-1050,Private      ,79,32,111,2009,,313,2322
00283300,ST VLADIMIR ORTHODOX THEOL SEM          ,NY,10707-0000,Private      ,0,1,1,0,,48,48
00283400,EXCELSIOR COLLEGE                       ,NY,12203-5159,Private      ,69,1984,2053,479,,11467,11946
00283500,SUNY AT ALBANY                          ,NY,12222-0001,Public       ,586,333,919,22636,,5520,28156
00283600,BINGHAMTON UNIVERSITY (SUNY)            ,NY,13902-6000,Public       ,589,156,745,26554,,3237,29791
00283700,SUNY AT BUFFALO                         ,NY,14260-0001,Public       ,557,407,964,25954,,10142,36096
00283800,SUNY AT STONY BROOK                     ,NY,11794-0701,Public       ,835,475,1310,29998,,8763,38761
00283900,SUNY-DOWNSTATE MEDICAL CENTER           ,NY,11203-2098,Public       ,22,103,125,304,,2632,2936
00284000,SUNY UPSTATE MEDICAL UNIVERSITY         ,NY,13210-2375,Public       ,16,38,54,317,,1582,1899
00284100,SUNY BROCKPORT - FIN AID OFF            ,NY,14420-2914,Public       ,226,208,434,10370,,3067,13437
00284200,BUFFALO STATE COLLEGE - SUNY            ,NY,14222-1095,Public       ,473,427,900,14174,,5534,19708
00284300,SUNY COLLEGE-CORTLAND                   ,NY,13045-0900,Public       ,259,98,357,12377,,1510,13887
00284400,SUNY AT FREDONIA                        ,NY,14063-1145,Public       ,162,52,214,7678,,1068,8746
00284500,SUNY GENESEO                            ,NY,14454-1401,Public       ,209,44,253,9195,,679,9874
00284600,SUNY COLLEGE-NEW PALTZ                  ,NY,12561-2499,Public       ,334,185,519,12862,,2298,15160
00284700,SUNY COLLEGE-ONEONTA                    ,NY,13820-4015,Public       ,241,44,285,12058,,883,12941
00284800,SUNY OSWEGO                             ,NY,13126-3599,Public       ,281,122,403,11859,,2157,14016
00284900,SUNY COLLEGE AT PLATTSBURGH             ,NY,12901-2681,Public       ,170,101,271,8572,,1567,10139
00285000,SUNY COLLEGE-POTSDAM                    ,NY,13676-2294,Public       ,113,52,165,5870,,976,6846
00285100,SUNY COLLEGE OF ENVIRONMENT SCIENCE AND ,NY,13210-2778,Public       ,57,44,101,2304,,611,2915
00285300,SUNY MARITIME COLLEGE                   ,NY,10465-4198,Public       ,44,29,73,1916,,352,2268
00285400,SUNY COLLEGE OF TECHNOLOGY-ALFRED       ,NY,14802-9951,Public       ,118,80,198,4959,,1097,6056
00285500,SUNY CANTON COLG OF TECHNOLOGY          ,NY,13617-1098,Public       ,93,121,214,4042,,1707,5749
00285600,SUNY AG & TECH COLLEGE-COBLESKILL       ,NY,12043-9986,Public       ,76,64,140,3287,,663,3950
00285700,SUNY DELHI                              ,NY,13753-1190,Public       ,127,114,241,4246,,1240,5486
00285800,SUNY FARMINGDALE                        ,NY,11735-1021,Public       ,269,257,526,7795,,2970,10765
00285900,SUNY COLLEGE OF AG & TECH AT MORRISVILLE,NY,13408-0901,Public       ,100,64,164,4215,,1038,5253
00286000,ADIRONDACK COMMUNITY COLLEGE            ,NY,12804-2004,Public       ,137,213,350,2369,,1938,4307
00286100,CAYUGA COMMUNITY COLLEGE                ,NY,13021-3099,Public       ,127,280,407,2033,,2456,4489
00286200,BROOME COMMUNITY COLLEGE                ,NY,13902-0000,Public       ,143,289,432,3615,,3082,6697
00286300,CORNING COMMUNITY COLLEGE               ,NY,14830-3297,Public       ,115,180,295,2031,,2012,4043
00286400,DUTCHESS COMMUNITY COLLEGE              ,NY,12601-1595,Public       ,309,359,668,4758,,2718,7476
00286600,FASHION INSTITUTE OF TECHNOLOGY         ,NY,10001-5992,Public       ,435,395,830,9877,,4007,13884
00286700,SUNY FULTON MONTGOMERY COMM CLG         ,NY,12095-3790,Public       ,71,119,190,1951,,1250,3201
00286800,HUDSON VALLEY COMMUNITY COLLEGE         ,NY,12180-6096,Public       ,378,609,987,7007,,5256,12263
00286900,JAMESTOWN COMMUNITY COLLEGE             ,NY,14702-0020,Public       ,97,223,320,2660,,2050,4710
00287000,JEFFERSON COMMUNITY COLLEGE             ,NY,13601-1897,Public       ,96,376,472,1662,,3029,4691
00287100,"SUNY, MOHAWK VALLEY COMMUNITY CLG       ",NY,13501-5394,Public       ,207,404,611,4532,,3915,8447
00287200,MONROE COMMUNITY COLLEGE                ,NY,14623-5780,Public       ,675,1223,1898,10785,,10627,21412
00287300,NASSAU COMMUNITY COLLEGE                ,NY,11530-6793,Public       ,891,941,1832,13632,,8004,21636
00287400,NIAGARA COUNTY COMMUNITY COLLEGE        ,NY,14132-9460,Public       ,268,344,612,4236,,3052,7288
00287500,ONONDAGA COMMUNITY COLLEGE              ,NY,13215-4585,Public       ,438,629,1067,7620,,5001,12621
00287600,ORANGE COUNTY COMMUNITY COLLEGE         ,NY,10940-6441,Public       ,241,297,538,3412,,2682,6094
00287700,ROCKLAND COMMUNITY COLLEGE              ,NY,10901-3611,Public       ,209,262,471,2966,,2317,5283
00287800,SUFFOLK COMMUNITY COLLEGE               ,NY,11784-2899,Public       ,508,455,963,7970,,4085,12055
00287801,SUFFOLK COMMUNITY CLG-W. CAMPUS         ,NY,11717-0000,Public       ,397,451,848,5565,,3784,9349
00287803,SUFFOLK COMMUNITY CLG-EASTRN CAMPUS     ,NY,11901-0000,Public       ,158,179,337,2080,,1351,3431
00287900,SULLIVAN COUNTY COMMUNITY COLLEGE       ,NY,12759-5151,Public       ,69,93,162,1521,,817,2338
00288000,ULSTER COUNTY COMMUNITY COLLEGE         ,NY,12484-0557,Public       ,90,147,237,1356,,1208,2564
00288100,SUNY WESTCHESTER COMMUNITY COLLEGE      ,NY,10595-1698,Public       ,504,684,1188,7263,,5728,12991
00288200,SYRACUSE UNIVERSITY                     ,NY,13244-2130,Private      ,786,300,1086,27064,,6628,33692
00288300,UTICA COLLEGE- UTICA                    ,NY,13502-4892,Private      ,80,222,302,4046,,2384,6430
00288500,ALBANY COLLEGE OF PHARMACY AND HEALTH SC,NY,12208-3492,Private      ,42,28,70,1992,,914,2906
00288600,ALBANY LAW SCHOOL                       ,NY,12208-0000,Private      ,6,25,31,79,,1049,1128
00288700,ALBANY MEDICAL COLLEGE                  ,NY,12208-0000,Private      ,8,35,43,136,,1349,1485
00288900,UNION COLLEGE                           ,NY,12308-2311,Private      ,71,18,89,3973,,186,4159
00289000,UNION THEOLOGICAL SEMINARY              ,NY,10027-0000,Private      ,0,9,9,0,,308,308
00289200,UNITED STATES MERCHANT MARINE ACADEMY   ,NY,11024-1699,Public       ,17,3,20,460,,24,484
00289400,UNIVERSITY OF ROCHESTER                 ,NY,14627-9000,Private      ,231,148,379,10034,,2174,12208
00289401,EASTMAN SCH OF MUSIC/UNIV ROCHESTER     ,NY,14604-0000,Private      ,33,24,57,861,,476,1337
00289402,UNIV OF ROCHESTER SCHL OF MEDICINE      ,NY,14642-0000,Private      ,8,14,22,90,,758,848
00289500,VASSAR COLLEGE                          ,NY,12604-0008,Private      ,130,28,158,5043,,237,5280
00289600,VILLA MARIA COLLEGE-BUFFALO             ,NY,14225-3999,Private      ,28,47,75,485,,359,844
00289900,WAGNER COLLEGE                          ,NY,10301-4495,Private      ,90,49,139,3149,,654,3803
00290000,WEBB INSTITUTE                          ,NY,11542-1398,Private      ,2,1,3,91,,12,103
00290100,WELLS COLLEGE                           ,NY,13026-0500,Private      ,35,6,41,1417,,103,1520
00290300,YESHIVA UNIVERSITY                      ,NY,10033-3201,Private      ,107,91,198,2460,,2730,5190
00290302,YESHIVA UNIVERSITY - BRONX CAMPUS       ,NY,10461-1975,Private      ,11,28,39,106,,1380,1486
00397400,MESIVTHA TIFERETH JERUSALEM OF AMER     ,NY,10002-6382,Private      ,8,0,8,30,,1,31
00397600,RABBINICAL ACAD MESIVTA RABBI CHAIM     ,NY,11230-4715,Private      ,19,1,20,22,,1,23
00397700,RABBINICAL COLLEGE CH'SAN SOFER         ,NY,11204-1252,Private      ,1,28,29,3,,29,32
00397800,RABBINICAL SEMINARY OF AMERICA          ,NY,11375-0000,Private      ,8,11,19,66,,29,95
00397900,COLUMBIA UNIV TEACHERS COLLEGE          ,NY,10027-0000,Private      ,9,251,260,141,,5310,5451
00405400,HEBREW UNION COL-JEWISH INST OF REL     ,NY,10012-0000,Private      ,1,5,6,1,,238,239
00475900,"CUNY, YORK COLLEGE                      ",NY,11451-0001,Public       ,474,593,1067,13608,,6964,20572
00476500,CUNY GRADUATE SCH & UNIV CTR            ,NY,10016-4309,Public       ,8,290,298,158,,3321,3479
00477600,CENTRAL YESHIVA TOMCHEI TMIMIM LUBA     ,NY,11230-2798,Private      ,143,21,164,168,,31,199
00478800,HERKIMER COUNTY COMMUNITY COLLEGE       ,NY,13350-1598,Public       ,90,163,253,2287,,1546,3833
00479800,MIRRER YESHIVA CENTRAL INST             ,NY,11223-2010,Private      ,17,11,28,70,,26,96
00479900,MONROE COLLEGE                          ,NY,10468-4305,Proprietary  ,274,591,865,5115,,6472,11587
00481100,EVEREST INSTITUTE                       ,NY,14621-3007,Proprietary  ,15,125,140,169,,986,1155
00506400,SAINT JAMES MERCY HOSPITAL SCHOOL OF RAD,NY,14843-2197,Private      ,0,2,2,23,,28,51
00506600,FAXTON ST. LUKE'S SCHOOL OF RADIOGRAPHY ,NY,13502-4856,Private      ,1,0,1,24,,40,64
00520800,THE COLLEGE OF WESTCHESTER              ,NY,10602-0000,Proprietary  ,39,91,130,974,,973,1947
00587700,ROBERT J HOCHSTIM SCHOOL OF RADIOG      ,NY,11572-1151,Private      ,0,0,0,0,,14,14
00643501,ARNOT OGDEN MEDICAL CENTER              ,NY,14905-1676,Private      ,2,4,6,58,,84,142
00643800,PHILLIPS BETH ISRAEL SCH OF NURSING     ,NY,10001-6354,Private      ,1,16,17,107,,412,519
00644300,COCHRAN SCH NSG-ST JOHN RVSDE HOSP      ,NY,10701-1399,Private      ,6,20,26,39,,194,233
00644500,CROUSE HOSP SCH OF NURSING              ,NY,13210-1690,Private      ,21,69,90,242,,433,675
00644800,ELLIS HOSPITAL SCHOOL OF NURSING        ,NY,12308-0000,Private      ,4,21,25,81,,246,327
00646101,ST ELIZABETH COLLEGE OF NURSING         ,NY,13501-2998,Private      ,4,13,17,143,,196,339
00646102,ST ELIZABETH SCH OF RADIOGRAPHY         ,NY,13501-0000,Private      ,3,4,7,20,,32,52
00646700,SAINT JOSEPH'S COLLEGE OF NURSING       ,NY,13203-1806,Private      ,7,24,31,254,,350,604
00678200,GENESEE COMMUNITY COLLEGE               ,NY,14020-9704,Public       ,170,318,488,3160,,2901,6061
00678500,SCHENECTADY COUNTY COMMUNITY CLG        ,NY,12305-2294,Public       ,136,273,409,2629,,2636,5265
00678700,CLINTON COMMUNITY COLLEGE               ,NY,12901-5690,Public       ,46,95,141,1261,,745,2006
00678800,TOMPKINS CORTLAND COMMUNITY COLLEGE     ,NY,13053-8504,Public       ,124,211,335,2884,,1749,4633
00678900,COLUMBIA-GREENE COMMUNITY COLLEGE       ,NY,12534-9543,Public       ,62,84,146,985,,1022,2007
00679100,SUNY AT PURCHASE                        ,NY,10577-1400,Public       ,228,92,320,8029,,1225,9254
00702200,CUNY-LEHMAN COLLEGE                     ,NY,10468-1589,Public       ,596,1206,1802,15235,,13229,28464
00702600,MOUNT SINAI SCHOOL OF MEDICINE          ,NY,10029-0000,Private      ,6,28,34,43,,1073,1116
00710900,SUNY COLLEGE-OLD WESTBURY               ,NY,11568-0210,Public       ,173,175,348,6154,,2470,8624
00711100,NORTH COUNTRY COMMUNITY COLLEGE         ,NY,12983-2046,Public       ,34,57,91,710,,650,1360
00726400,MESIFTA TORAH VODAATH RABBINCAL SEM     ,NY,11218-5209,Private      ,11,40,51,17,,53,70
00727300,CUNY-BERNARD BARUCH COLLEGE             ,NY,10010-5518,Public       ,681,928,1609,20052,,10772,30824
00730400,CULINARY INSTITUTE OF AMERICA           ,NY,12538-1499,Private      ,277,233,510,3747,,1618,5365
00732916,ITT TECHNICAL INSTITUTE                 ,NY,12205-1003,Proprietary  ,34,119,153,181,,617,798
00737200,AUSTIN'S SCHOOL OF SPA TECHNOLOGY       ,NY,12206-1513,Proprietary  ,15,68,83,138,,427,565
00737500,ISLAND DRAFTING & TECHNICAL INST        ,NY,11701-2704,Proprietary  ,3,6,9,60,,68,128
00738700,LONG ISLAND BEAUTY SCHOOL               ,NY,11788-4346,Proprietary  ,36,62,98,188,,311,499
00738800,LONG ISLAND BEAUTY SCHOOL               ,NY,11550-3704,Proprietary  ,10,34,44,51,,156,207
00739100,BEAUTY SCHOOL OF MIDDLETOWN             ,NY,10940-6574,Proprietary  ,3,19,22,52,,90,142
00739400,BERKELEY COLLEGE                        ,NY,10017-0000,Proprietary  ,260,489,749,3435,,4531,7966
00740100,MANDL SCHOOL                            ,NY,10019-5516,Proprietary  ,38,119,157,318,,1003,1321
00740500,WOOD TOBE-COBURN SCHOOL                 ,NY,10016-0102,Proprietary  ,10,13,23,616,,159,775
00746500,AMERICAN ACADEMY OF DRAMATIC ARTS       ,NY,10016-7089,Private      ,72,43,115,1196,,441,1637
00746600,LIM COLLEGE                             ,NY,10022-5268,Proprietary  ,87,57,144,2502,,583,3085
00746800,SCHOOL OF VISUAL ARTS                   ,NY,10010-3994,Proprietary  ,139,118,257,4080,,1742,5822
00751800,APEX TECHNICAL SCHOOL                   ,NY,10011-0000,Proprietary  ,99,328,427,549,,1449,1998
00752200,CONTINENTAL SCH OF BEAUTY CULTURE       ,NY,14623-3231,Proprietary  ,48,129,177,215,,568,783
00752205,CONTINENTAL SCHOOL OF BEAUTY CULTURE - M,NY,13211-1003,Proprietary  ,0,5,5,29,,54,83
00753200,FINGER LAKES COMMUNITY COLLEGE          ,NY,14424-8395,Public       ,184,327,511,3594,,2905,6499
00757200,AMERICAN MUSICAL AND DRAMATIC ACAD      ,NY,10023-2106,Private      ,137,60,197,2715,,578,3293
00757300,EMPIRE BEAUTY SCHOOL                    ,NY,11103-4028,Proprietary  ,87,249,336,301,,674,975
00780400,STAR CAREER ACADEMY                     ,NY,10011-7307,Proprietary  ,37,165,202,189,,854,1043
00793809,LINCOLN TECHNICAL INSTITUTE - WHITESTONE,NY,11357-6092,Proprietary  ,65,46,111,615,,371,986
00818900,CONTINENTAL SCHOOL OF BEAUTY CULTURE - B,NY,14224-3402,Proprietary  ,8,28,36,47,,108,155
00818903,CONTINENTAL SCHOOL OF BEAUTY CULTURE - B,NY,14223-2911,Proprietary  ,16,42,58,101,,193,294
00843700,CHAMPLAIN VALLEY - TEC/PRN              ,NY,12901-0000,Public       ,1,11,12,31,,69,100
00849500,JAMESTOWN BUSINESS COLLEGE              ,NY,14702-0429,Proprietary  ,5,33,38,194,,282,476
00861100,"CUNY, HOSTOS CMTY COLLEGE               ",NY,10451-1499,Public       ,837,1138,1975,9954,,8773,18727
00861400,RABBINICAL CLG BOBOVER YESHIVA BNEI     ,NY,11219-3293,Private      ,71,35,106,112,,42,154
00861700,RABBINICAL SEM MKOR CHAIM-YESHIVA       ,NY,11219-4300,Private      ,0,0,0,0,,2,2
00878800,STATE UNIVERSITY OF NEW YORK STUDENT LOA,NY,12246-0000,Public       ,22,30,52,575,,361,936
00900300,OLEAN BUSINESS INSTITUTE INC            ,NY,14760-2691,Proprietary  ,0,4,4,21,,56,77
00902900,NEIGHBORHOOD PLAYHOUSE                  ,NY,10022-5017,Private      ,1,5,6,28,,54,82
00904300,ELMIRA BUSINESS INSTITUTE               ,NY,14901-2731,Proprietary  ,19,138,157,107,,752,859
00907700,UTICA SCHOOL OF COMMERCE                ,NY,13501-2280,Proprietary  ,5,38,43,116,,408,524
00924800,SAMARITAN HOSPITAL SCH NURSING          ,NY,12180-2475,Private      ,7,28,35,83,,268,351
00928300,MIDWAY-PARIS BEAUTY SCHOOL              ,NY,11385-3453,Proprietary  ,3,38,41,34,,126,160
00928400,BRITTANY BEAUTY SCHOOL                  ,NY,11756-1345,Proprietary  ,22,50,72,114,,252,366
00933500,MESIVTA EASTERN PKWY RABBINICAL CLG     ,NY,11218-5559,Private      ,11,2,13,25,,9,34
00947900,SAINT VINCENTS CMC SI NURSING SCHOOL    ,NY,10304-3850,Proprietary  ,30,98,128,352,,771,1123
00976900,METROPOLITAN COLLEGE OF NEW YORK        ,NY,10013-1919,Private      ,27,185,212,307,,2065,2372
00992900,SUNY COLLEGE OF OPTOMETRY               ,NY,10036-8003,Public       ,3,9,12,24,,380,404
01005100,LA GUARDIA CMTY COLLEGE - CUNY          ,NY,11101-3083,Public       ,1133,1151,2284,18810,,12336,31146
01005200,JEFFERSON-LEWIS BOCES PRAC NRSGPRG      ,NY,13601-9509,Public       ,3,21,24,44,,202,246
01009700,CUNY-MEDGAR W EVERS COLLEGE             ,NY,11225-2010,Public       ,360,594,954,8101,,6853,14954
01014200,TOURO COLLEGE                           ,NY,10010-4202,Private      ,295,643,938,3508,,9853,13361
01014700,WESTERN SUFFOLK BOCES                   ,NY,11768-3499,Public       ,23,48,71,165,,426,591
01015300,HELENE FULD COL OF NRSNG/N GEN HOSP     ,NY,10035-0000,Private      ,7,104,111,46,,770,816
01028600,EMPIRE STATE COLLEGE                    ,NY,12866-4391,Public       ,111,1257,1368,1126,,13030,14156
01037800,RABBINICAL COLLEGE OF LONG ISLAND       ,NY,11561-3244,Private      ,36,0,36,42,,3,45
01054900,KEHILATH YAKOV RABBINICAL SEMINARY      ,NY,10562-1001,Private      ,40,5,45,41,,6,47
01055100,NEW YORK SCH MED & DENTAL ASSISTANT     ,NY,11101-2327,Proprietary  ,26,69,95,145,,316,461
01064100,SOUTHERN WESTCHESTER BOCES              ,NY,10543-0000,Public       ,0,17,17,31,,204,235
01068400,ERIE COMMUNITY COLLEGE-ALL CAMPUSES     ,NY,14203-2698,Public       ,523,1007,1530,8604,,8436,17040
01081300,AMERICAN ACAD MCALLISTER INST           ,NY,10019-3604,Private      ,19,87,106,161,,640,801
01083700,SIMMONS INST OF FUNERAL SERVICE         ,NY,13207-2098,Proprietary  ,1,4,5,7,,45,52
01094300,RABBINICAL COLLEGE BETH SHRAGA          ,NY,10952-3033,Private      ,8,0,8,9,,0,9
01095200,PNW BOCES LPN PROGRAM                   ,NY,10598-0000,Public       ,0,6,6,18,,58,76
01103100,TECHNICAL CAREER INSTITUTE              ,NY,10001-2789,Proprietary  ,145,350,495,1287,,3202,4489
01118900,UNITED TALMUDICAL SEMINARY              ,NY,11211-7984,Private      ,557,288,845,597,,290,887
01119200,BETH HAMEDRASH SHAAREI YOSHER INST      ,NY,11204-1052,Private      ,2,12,14,8,,23,31
01161400,CHAMPLAIN VALLEY HOSP SCH RAD TECH      ,NY,12901-1490,Private      ,0,5,5,23,,27,50
01161700,NEW YORK METHODIST HOSPITAL             ,NY,11229-9023,Private      ,19,79,98,135,,500,635
01164700,SBI CAMPUS - AN AFFILIATE OF SANFORD-BRO,NY,11747-3785,Proprietary  ,32,54,86,166,,357,523
01167000,YESHIVA OF NITRA RABBINICAL COLLEGE -   ,NY,10549-4112,Private      ,62,0,62,62,,0,62
01167700,MEMORIAL SLOAN KETTERING CANCER CTR     ,NY,10021-6094,Private      ,1,3,4,9,,50,59
01167800,SUNY INST OF TECHNOLOGY UTICA ROME      ,NY,13504-3050,Public       ,56,97,153,2187,,1288,3475
01182100,YESHIVATH ZICHRON MOSHE                 ,NY,12779-0580,Private      ,36,1,37,109,,1,110
01183000,BERK TRADE AND BUSINESS SCHOOL          ,NY,11101-0000,Proprietary  ,20,58,78,92,,230,322
01185900,WORD OF LIFE BIBLE INSTITUTE            ,NY,12860-0129,Private      ,11,9,20,541,,91,632
01186000,MERCY MED CNTR SCHL OF RADIOGRAPHY      ,NY,11570-1098,Private      ,1,5,6,21,,37,58
01192100,WESTCHESTER SCH OF BEAUTY CULTURE       ,NY,10550-2295,Proprietary  ,7,22,29,51,,127,178
01192200,BETH HATALMUD RABBINICAL CLG            ,NY,11214-2594,Private      ,1,0,1,12,,9,21
01198400,OHR HAMEIR THEOLOGICAL SEMINARY         ,NY,10566-0990,Private      ,36,0,36,38,,1,39
01201100,TALMUDICAL SEM OHOLEI TORAH             ,NY,11213-3310,Private      ,144,0,144,152,,0,152
01210700,INSTITUTE OF DESIGN & CONSTRUCTION      ,NY,11201-5380,Private      ,8,33,41,59,,171,230
01220300,MEMORIAL HOSPITAL SCH OF NURSING        ,NY,12204-1083,Private      ,2,26,28,61,,229,290
01227700,NEW YORK CHIROPRACTIC COLLEGE           ,NY,13148-0800,Private      ,1,60,61,17,,876,893
01229300,VEEB NASSAU CNTY SCHL OF PRACT NURS     ,NY,11553-3040,Public       ,5,13,18,84,,264,348
01235800,PLAZA COLLEGE                           ,NY,11372-6300,Proprietary  ,20,87,107,245,,868,1113
01236400,SAINT VINCENTS CATHOLIC MEDICAL CENTERS ,NY,11354-0000,Proprietary  ,12,58,70,139,,667,806
01240700,SCHUYLER-CHEMUNG-TIOGA BOCES            ,NY,14903-1089,Public       ,0,14,14,24,,181,205
01240701,STEUBEN SCHUYLER CHEMUNG TIOGA ALLEGANY ,NY,14870-9518,Public       ,0,1,1,1,,9,10
01256100,FIVE TOWNS COLLEGE                      ,NY,11746-5871,Proprietary  ,39,26,65,990,,274,1264
01258900,ERIE 1 BOCES                            ,NY,14224-0000,Public       ,9,39,48,109,,390,499
01265200,ONONDAGA CORTLAND MADISON BOCES         ,NY,13090-4500,Public       ,40,130,170,209,,712,921
01278300,OSWEGO COUNTY BOCES ADULT CAREERS       ,NY,13114-4498,Public       ,1,7,8,38,,83,121
01292700,CENTRAL TECH NURSING PROGRAM            ,NY,13202-3092,Public       ,7,32,39,37,,146,183
01302600,MACHZIKEI HADATH RABBINICAL COLLEGE     ,NY,11204-1805,Private      ,0,1,1,1,,1,2
01302700,YESHIVATH VIZNITZ                       ,NY,10952-3021,Private      ,1,0,1,10,,3,13
01302900,BORICUA COLLEGE                         ,NY,10032-1599,Private      ,35,106,141,520,,1252,1772
02056400,CAPRI COSMETOLOGY LEARNING CENTER       ,NY,10954-0000,Proprietary  ,21,45,66,132,,219,351
02066200,THE NEW SCHOOL                          ,NY,10011-0000,Private      ,269,486,755,6108,,6006,12114
02069000,NEW YORK SCHOOL OF INTERIOR DESIGN      ,NY,10021-0000,Private      ,23,49,72,258,,443,701
02075700,BRIARCLIFFE COLLEGE                     ,NY,11714-0000,Proprietary  ,40,158,198,590,,1438,2028
02075702,BRIARCLIFFE COLLEGE - PATCHOGUE         ,NY,11772-3019,Proprietary  ,37,75,112,626,,837,1463
02092400,RIDLEY-LOWELL SCHOOL OF BUSINESS        ,NY,13905-0000,Proprietary  ,12,81,93,48,,295,343
02093700,LONG ISLAND BUSINESS INSTITUTE          ,NY,11725-0000,Proprietary  ,43,168,211,300,,988,1288
02093701,LONG ISLAND BUSINESS INSTITUTE - FLUSHIN,NY,11354-4429,Proprietary  ,2,11,13,15,,41,56
02098400,HERKIMER COUNTY BOCES                   ,NY,13350-0000,Public       ,1,3,4,39,,131,170
02104300,OTSEGO AREA SCHOOL OF PRAC NURSING      ,NY,12167-0000,Public       ,0,2,2,11,,33,44
02105900,HAIR DESIGN INSTITUTE AT FIFTH AVE      ,NY,11220-0000,Proprietary  ,35,70,105,159,,302,461
02106800,BRAMSON ORT COLLEGE                     ,NY,11375-0000,Private      ,91,149,240,303,,678,981
02110900,CATTARAUGUS/ALLEGANY BOCES              ,NY,14760-0000,Public       ,0,11,11,48,,173,221
02112301,RIDLEY - LOWELL BUSINESS & TECHNICAL INS,NY,12601-3328,Proprietary  ,29,144,173,187,,631,818
02116011,SANFORD-BROWN INSTITUTE - NEW YORK      ,NY,10003-2103,Proprietary  ,69,238,307,521,,1569,2090
02118700,LONG ISLAND COLLEGE HOSPITAL - SCHOOL OF,NY,11201-6001,Private      ,19,40,59,152,,332,484
02118702,LONG ISLAND COLLEGE HOSPITAL - SCHOOL OF,NY,11201-6001,Private      ,13,39,52,185,,335,520
02124000,ORANGE ULSTER BOCES SCH OF PRAC NRS     ,NY,10924-9401,Public       ,6,43,49,36,,221,257
02125500,CIRCLE IN THE SQUARE THEATRE SCHOOL     ,NY,10019-0000,Private      ,3,7,10,62,,78,140
02126300,MADISON-ONEIDA BOCES PRAC NRS           ,NY,13478-0000,Public       ,5,19,24,11,,84,95
02138500,BOCES RENSSELAER SCHOOL OF PN           ,NY,12033-3221,Public       ,2,2,4,23,,66,89
02145800,CAYUGA ONONDAGA BOCES                   ,NY,13021-9430,Public       ,4,10,14,46,,114,160
02146000,WAYNE-FINGER LAKES BOCES                ,NY,14513-0000,Public       ,0,8,8,56,,316,372
02152000,YESHIVA SHAAR HATORAH ITRI TORAH        ,NY,11418-0000,Private      ,0,0,0,5,,0,5
02153600,BROOME-TIOGA BOCES PN PROG              ,NY,13905-0000,Public       ,7,13,20,47,,156,203
02157900,ROCHESTER GENERAL HOSPITAL              ,NY,14621-3001,Private      ,3,10,13,49,,153,202
02158200,WSHNGTN-SARTGA-WARN-HMLTN-ESX BOCES     ,NY,12839-1051,Public       ,1,3,4,15,,66,81
02160100,GENEVA GENERAL HOSPITAL                 ,NY,14456-0000,Private      ,0,19,19,53,,199,252
02163400,NEW YORK CAREER INSTITUTE               ,NY,10007-2801,Proprietary  ,13,74,87,219,,741,960
02169100,DAVIS COLLEGE                           ,NY,13790-0000,Private      ,5,18,23,178,,146,324
02170000,SWEDISH INSTITUTE                       ,NY,10001-0000,Proprietary  ,22,131,153,218,,902,1120
02170200,ALBANY SCHOHARIE SCHENECTADY            ,NY,12205-0000,Public       ,10,25,35,58,,158,216
02171900,AILEY SCHOOL (THE)                      ,NY,10019-4402,Private      ,8,10,18,138,,108,246
02172100,HAMILTON-FULTON-MONTGOMERY BOCES        ,NY,12095-0665,Public       ,2,5,7,30,,95,125
02172800,DUTCHESS COUNTY BOCES SCH PRAC NURS     ,NY,12601-0000,Public       ,11,53,64,79,,221,300
02173200,EMPIRE BEAUTY SCHOOL                    ,NY,10001-0000,Proprietary  ,123,304,427,705,,1320,2025
02173900,ULSTER COUNTY BOCES PRACTICAL NRSG      ,NY,12466-0000,Public       ,1,8,9,41,,202,243
02176000,CHERYL FELL'S SCHOOL OF BUSINESS        ,NY,14304-0000,Proprietary  ,1,18,19,7,,93,100
02179400,EASTERN SUFFOLK BOCES                   ,NY,11713-0000,Public       ,14,23,37,192,,399,591
02182200,NEW SCHOOL OF RADIO & TELEVISION        ,NY,12206-1106,Proprietary  ,4,27,31,55,,103,158
02187300,DARKEI NOAM RABBINICAL COLLEGE          ,NY,11210-0000,Private      ,0,0,0,0,,1,1
02191600,TORAH TEMIMAH TALMUDICAL SEMINARY       ,NY,11218-0000,Private      ,32,1,33,41,,2,43
02192500,BELLEVUE HOSP CTR SCH RAD TECH          ,NY,10016-0000,Public       ,6,20,26,22,,139,161
02199300,ORLEANS-NIAGARA BOCES                   ,NY,14132-0000,Public       ,6,24,30,24,,89,113
02206000,HUNTER BUSINESS SCHOOL                  ,NY,11756-0000,Proprietary  ,53,164,217,281,,721,1002
02217800,D.HOPFER SCH NURSING AT MT.VRN HOSP     ,NY,10550-0000,Private      ,2,10,12,51,,281,332
02219500,MILDRED ELLEY                           ,NY,12206-1513,Proprietary  ,73,392,465,467,,2356,2823
02235600,ERIE 2-CHAUTAUQUA-CATTARAUGUS BOCES     ,NY,14006-0000,Public       ,10,8,18,35,,101,136
02265100,YESHIVA DERECH CHAIM                    ,NY,11218-0000,Private      ,16,4,20,43,,18,61
02265200,GLOBAL BUSINESS INSTITUTE               ,NY,11691-0000,Private      ,0,0,0,4,,45,49
02272900,ROCKLAND COUNTY BOCES PRAC NRSG SCH     ,NY,10994-0000,Public       ,0,9,9,53,,135,188
02275900,"MODERN WELDING SCHOOL, INC.             ",NY,12304-0000,Proprietary  ,7,17,24,67,,113,180
02287800,NATIONAL TRACTOR TRAILER SCHOOL         ,NY,13088-2505,Proprietary  ,14,143,157,42,,554,596
02294900,INSTITUTE OF AUDIO RESEARCH             ,NY,10003-0000,Proprietary  ,48,87,135,318,,434,752
02306500,PROFESSIONAL BUSINESS INSTITUTE         ,NY,10002-0000,Private      ,107,228,335,494,,1283,1777
02314200,NORTHERN WESTCHESTER SCH COSMETOL       ,NY,10566-0000,Proprietary  ,2,8,10,32,,38,70
02320100,OHR SOMAYACH TANENBAUM EDUCATIONAL CENTE,NY,10952-0000,Private      ,0,1,1,2,,3,5
02350600,YESHIVA AND KOLLEL HARBOTZAS TORAH      ,NY,11230-0000,Private      ,0,11,11,0,,19,19
02491400,SPANISH AMERICAN INSTITUTE              ,NY,10036-0000,Private      ,0,4,4,4,,14,18
02505800,YESHIVA KARLIN STOLIN RAB INSTITUTE     ,NY,11204-0000,Private      ,9,33,42,9,,34,43
02505900,SH-OR YOSHUV RABBINICAL COLLEGE         ,NY,11691-0000,Private      ,25,8,33,43,,19,62
02506000,ASSOCIATED BETH RIVKAH SCHOOLS          ,NY,11225-0000,Private      ,20,7,27,99,,19,118
02506100,CITY UNIV OF NEW YORK-CENTRAL           ,NY,10021-0000,Public       ,86,146,232,3029,,1630,4659
02506800,YESHIVAT MIKDASH MELECH                 ,NY,11230-0000,Private      ,32,9,41,61,,12,73
02511500,JOFFREY BALLET SCHOOL                   ,NY,10011-0000,Proprietary  ,3,1,4,121,,15,136
02513500,MAR JON SCHOOL OF BEAUTY CULTURE        ,NY,14150-0000,Proprietary  ,7,21,28,38,,90,128
02525600,ART INSTITUTE OF NEW YORK CITY (THE)    ,NY,10013-2429,Proprietary  ,194,212,406,2239,,1604,3843
02540800,"GLOBE INSTITUTE OF TECHNOLOGY, INC.     ",NY,10007-0000,Proprietary  ,44,59,103,404,,412,816
02546000,TRI-STATE COLLEGE OF ACUPUNCTURE        ,NY,10011-0000,Proprietary  ,0,7,7,2,,118,120
02546300,YESHIVA OF THE TELSHE ALUMNI            ,NY,10471-0000,Private      ,32,0,32,32,,1,33
02550600,TALMUDICAL INST OF UPSTATE NY           ,NY,14607-0000,Private      ,1,1,2,5,,5,10
02556700,SEMINAR L'MOROS BAIS YAAKOV             ,NY,11219-0000,Private      ,20,0,20,218,,3,221
02572900,BUSINESS INFORMATICS CENTER             ,NY,11580-0000,Proprietary  ,2,12,14,21,,68,89
02575400,FRENCH CULINARY INSTITUTE               ,NY,10013-2618,Proprietary  ,43,165,208,434,,954,1388
02587600,ORLO SCH HAIR DESIGN & COSMETOLOGY      ,NY,12206-1723,Proprietary  ,7,19,26,53,,105,158
02599400,NEW YORK COLLEGE OF HEALTH PROFESSIONS  ,NY,11791-4413,Private      ,19,121,140,216,,952,1168
02600100,NEW YORK ACADEMY OF ART (THE)           ,NY,10013-2911,Private      ,22,37,59,251,,371,622
02614900,SANFORD-BROWN INSTITUTE                 ,NY,10604-2910,Proprietary  ,6,20,26,145,,386,531
02615001,SANFORD-BROWN COLLEGE - SANFORD-BROWN IN,NY,11530-4734,Proprietary  ,47,111,158,343,,742,1085
02616600,SHEAR EGO INTERNATIONAL SCHOOL OF HAIR D,NY,14617-3501,Proprietary  ,20,36,56,89,,170,259
02617000,CONTINENTAL SCH OF BEAUTY CULTURE       ,NY,14020-0000,Proprietary  ,4,16,20,44,,93,137
02617002,CONTINENTAL SCHOOL OF BEAUTY CULTURE  - ,NY,14020-1908,Proprietary  ,2,1,3,10,,19,29
02622900,BAIS MEDRASH ELYON                      ,NY,10952-3013,Private      ,4,0,4,4,,1,5
03000100,YESHIVA GEDOLAH IMREI YOSEF DSPINKA     ,NY,11219-4696,Private      ,0,42,42,0,,44,44
03007200,DANCE THEATRE OF HARLEM                 ,NY,10031-0000,Private      ,3,10,13,45,,55,100
03027701,PACIFIC COLLEGE OF ORIENTAL MEDICINE - N,NY,10010-7108,Proprietary  ,4,65,69,46,,522,568
03081600,DELAWARE CHENANGO MADISON OT. BOCES     ,NY,13815-9554,Public       ,1,9,10,24,,66,90
03089700,COMPUTER CAREER CENTER                  ,NY,11530-3334,Proprietary  ,9,41,50,81,,283,364
03095500,ASA INST BUSINESS & COMPUTER TECH       ,NY,11201-5208,Proprietary  ,365,759,1124,2145,,4166,6311
03096200,CHARLES STUART SCHOOL                   ,NY,11229-2004,Proprietary  ,1,8,9,12,,55,67
03103700,ADIRONDACK BEAUTY SCHOOL                ,NY,12801-3158,Proprietary  ,2,12,14,25,,54,79
03104900,SULLIVAN COUNTY BOCES                   ,NY,12754-2116,Public       ,0,3,3,21,,53,74
03115300,GENESEE VALLEY BOCES                    ,NY,14020-1099,Public       ,7,37,44,64,,187,251
03120700,NEW YORK CONSERVATORY FOR DRAMATIC ARTS ,NY,10011-4225,Proprietary  ,29,23,52,575,,212,787
03127100,YESHIVAS NOVOMINSK                      ,NY,11219-0000,Private      ,14,1,15,48,,2,50
03129200,RABBINICAL CLG OHR SHIMAR YISROEL       ,NY,11211-8102,Private      ,14,96,110,16,,100,116
03147300,YESHIVA D'MONSEY                        ,NY,10952-3106,Private      ,0,0,0,1,,1,2
03169300,STUDIO JEWELERS                         ,NY,10016-4112,Proprietary  ,1,10,11,9,,45,54
03181400,MERKAZ BNOS                             ,NY,11214-4911,Private      ,2,47,49,8,,221,229
03191300,CUNY SCHOOL OF LAW @ QUEENS COLLEGE     ,NY,11367-0000,Public       ,26,54,80,409,,1189,1598
03193300,MANHATTAN SCHOOL OF COMPUTER TECH       ,NY,11230-1617,Private      ,50,142,192,242,,619,861
03203300,NEW YORK INSTITUTE OF MASSAGE           ,NY,14221-6021,Proprietary  ,4,28,32,44,,169,213
03216300,UNIFICATION THEOLOGICAL SEMINARY        ,NY,12507-5021,Private      ,2,2,4,19,,37,56
03328300,FRANKLIN CAREER INSTITUTE               ,NY,11550-3003,Private      ,8,49,57,54,,169,223
03328301,FRANKLIN CAREER INSTITUTE - BROOKLYN    ,NY,11220-3110,Private      ,22,81,103,133,,387,520
03342400,AMERICAN BARBER INSTITUTE               ,NY,10001-5271,Proprietary  ,0,0,0,18,,74,92
03358300,ALLEN SCHOOL                            ,NY,11432-4901,Proprietary  ,41,384,425,184,,1623,1807
03358301,ALLEN SCHOOL - BROOKLYN                 ,NY,11201-0000,Proprietary  ,39,181,220,204,,826,1030
03380300,STAR CAREER ACADEMY                     ,NY,11791-5311,Proprietary  ,14,48,62,85,,294,379
03419400,NORTHEASTERN SEMINARY                   ,NY,14624-1997,Private      ,1,15,16,27,,144,171
03426400,ANTHEM INSTITUTE                        ,NY,10018-0000,Proprietary  ,0,0,0,4,,8,12
03433500,LIA SCHORR INSTITUTE OF COSMETIC SK     ,NY,10022-2614,Proprietary  ,5,15,20,16,,65,81
03443300,NEW YORK COLLEGE OF TRADITIONAL CHINESE ,NY,11501-0000,Private      ,0,19,19,2,,91,93
03496300,YESHIVA SHAAREI TORAH OF ROCKLAND       ,NY,10901-4003,Private      ,11,18,29,13,,35,48
03537300,NEW YORK AUTOMOTIVE & DIESEL INSTIT     ,NY,11101-0000,Proprietary  ,36,62,98,155,,334,489
03568300,LEON STUDIO ONE SCHOOL OF HAIR DESI     ,NY,14221-5323,Proprietary  ,1,14,15,29,,72,101
03651300,SAINT JOSEPH'S MEDICAL CENTER SCHOO     ,NY,10701-4080,Private      ,2,4,6,19,,30,49
03652300,METROPOLITAN LEARNING INSTITUTE         ,NY,11374-2101,Private      ,8,200,208,69,,1090,1159
03665400,CHRISTIE'S EDUCATION                    ,NY,10036-8002,Proprietary  ,0,2,2,5,,56,61
03713300,BEIS MEDRASH HEICHAL DOVID              ,NY,11691-4433,Private      ,16,2,18,20,,2,22
03773300,CENTER FOR NATURAL WELLNESS SCHOOL OF MA,NY,12205-1601,Proprietary  ,9,41,50,47,,217,264
03802300,UTA MESIVTA OF KIRYAS JOEL              ,NY,10950-2169,Private      ,402,297,699,403,,306,709
03809400,MICROPOWER CAREER INSTITUTE             ,NY,10001-2812,Proprietary  ,22,160,182,88,,612,700
03839300,AVEDA INSTITUTE NEW YORK                ,NY,10013-1522,Proprietary  ,25,78,103,193,,425,618
03881300,UNION GRADUATE COLLEGE                  ,NY,12308-3131,Private      ,1,16,17,16,,185,201
03903400,AMERICAN BEAUTY SCHOOL                  ,NY,10462-8003,Proprietary  ,23,68,91,150,,385,535
03941400,ELITE ACADEMY OF BEAUTY ARTS            ,NY,11223-1630,Proprietary  ,2,13,15,23,,93,116
03983300,"SCHOOL OF PROFESSIONAL HORTICULTURE, AT ",NY,10458-5126,Private      ,1,7,8,11,,53,64
03988300,"SAE INSTITUTE OF TECHNOLOGY, NEW YORK   ",NY,10001-2915,Proprietary  ,40,74,114,340,,472,812
04043300,ACE COMPUTER TRAINING CENTER            ,NY,11375-5337,Proprietary  ,7,64,71,45,,264,309
04092401,MAKE-UP DESIGNORY -                     ,NY,10012-0041,Proprietary  ,31,74,105,315,,380,695
04095300,KING'S COLLEGE (THE)                    ,NY,10018-0110,Private      ,24,19,43,942,,154,1096
04102300,NEW AGE TRAINING                        ,NY,10001-4006,Proprietary  ,10,31,41,35,,148,183
04115500,TALMUDICAL SEMINARY OF BOBOV            ,NY,11219-3826,Private      ,64,68,132,64,,68,132
04117100,EDP SCHOOL OF COMPUTER PROGRAMMING      ,NY,11235-0000,Private      ,4,36,40,20,,126,146
04117700,"MONROE 2-ORLEANS BOCES, CENTER FOR WORK ",NY,14624-1119,Public       ,19,60,79,111,,325,436
04119600,YESHIVA OF FAR ROCKAWAY DERECH AYSON RAB,NY,11691-5219,Private      ,11,1,12,11,,1,12
04123200,INSTITUTE OF ALLIED MEDICAL PROFESSIONS ,NY,11373-5541,Private      ,3,13,16,22,,138,160
04123300,HUDSON VALLEY SCHOOL OF MASSAGE THERAPY ,NY,12493-0000,Proprietary  ,0,0,0,2,,2,4
04125600,CAREER SCHOOL OF NY                     ,NY,10301-2416,Private      ,7,22,29,73,,137,210
04131500,COLLECTIVE (THE)                        ,NY,10011-2026,Proprietary  ,1,2,3,11,,23,34
04133700,NEW YORK MEDICAL CAREER TRAINING CENTER ,NY,11354-6504,Proprietary  ,8,47,55,46,,199,245
04133701,NEW YORK MEDICAL CAREER TRAINING CENTER ,NY,10018-6504,Proprietary  ,9,45,54,11,,57,68
04134000,"JOHN PAOLO'S XTREME BEAUTY INSTITUTE, GO",NY,12020-1245,Proprietary  ,1,13,14,14,,77,91
04134001,"JOHN PAOLO'S XTREME BEAUTY INSTITUTE, GO",NY,13417-1319,Proprietary  ,6,18,24,42,,149,191
04137700,ANN MARIE'S WORLD OF BEAUTY SCHOOL      ,NY,13901-2308,Proprietary  ,0,6,6,14,,34,48
04138100,YESHIVA OF MACHZIKAI HADAS              ,NY,11219-1408,Private      ,17,105,122,17,,107,124
04144300,INSTITUTE OF CULINARY EDUCATION         ,NY,10010-5205,Proprietary  ,91,258,349,573,,1186,1759
04148000,NEW LIFE BUSINESS INSTITUTE             ,NY,11432-6149,Proprietary  ,4,53,57,43,,296,339
04151200,SALON PROFESSIONAL ACADEMY (THE)        ,NY,14150-9200,Proprietary  ,12,22,34,81,,122,203
04155300,ONONDAGA SCHOOL OF THERAPEUTIC MASSAGE  ,NY,13210-1533,Proprietary  ,10,56,66,79,,369,448
04156000,ACADEMY OF COSMETOLOGY & ESTHETICS NYC (,NY,10306-3003,Proprietary  ,20,49,69,173,,229,402
04157500,ACCESS CAREERS                          ,NY,11201-5826,Proprietary  ,8,43,51,53,,264,317
04165700,"JOHN PAOLO'S XTREME BEAUTY INSTITUTE, GO",NY,12110-3053,Proprietary  ,0,5,5,9,,42,51
04166000,MANHATTAN INSTITUTE (THE)               ,NY,10016-6516,Proprietary  ,22,61,83,146,,296,442
04167600,FINGER LAKES SCHOOL OF MASSAGE (THE)    ,NY,14850-1384,Proprietary  ,6,30,36,56,,175,231
04167601,FINGER LAKES SCHOOL OF MASSAGE (THE) -  ,NY,10549-1103,Proprietary  ,4,24,28,15,,111,126
04178700,ATELIER ESTHETIQUE INSTITUTE OF ESTHETIC,NY,10016-8804,Proprietary  ,4,54,58,41,,273,314
04179800,SOTHEBY'S INSTITUTE OF ART - NY         ,NY,10022-6717,Proprietary  ,2,9,11,29,,140,169
04180200,LONG ISLAND NAIL & SKIN CARE INSTITUTE  ,NY,11756-1316,Proprietary  ,5,22,27,22,,95,117
04189000,LONG ISLAND BARBER INSTITUTE (THE)      ,NY,11550-6317,Proprietary  ,2,13,15,18,,74,92
04190500,NEW YORK SCHOOL OF ESTHETICS & DAY SPA  ,NY,10591-3232,Proprietary  ,3,11,14,22,,80,102
04192800,BE'ER YAAKOV TALMUDIC SEMINARY          ,NY,10977-1912,Private      ,0,137,137,0,,163,163
04204300,AESTHETIC SCIENCE INSTITUTE (THE)       ,NY,12110-1095,Proprietary  ,0,12,12,27,,81,108
04206200,DIGITAL FILM ACADEMY                    ,NY,10036-3708,Proprietary  ,21,36,57,172,,254,426
04207600,AMERICAN ACADEMY OF PERSONAL TRAINING   ,NY,10011-7301,Proprietary  ,14,45,59,37,,140,177
04208600,RELAY SCHOOL OF EDUCATION               ,NY,10011-4233,Private      ,0,14,14,1,,207,208
04208800,GLORIA FRANCIS SCHOOL OF MAKE-UP ARTISTR,NY,11801-3873,Proprietary  ,2,7,9,7,,18,25
04210100,NEW COMMUNITY COLLEGE AT CUNY (THE)     ,NY,10018-2602,Public       ,68,76,144,840,,476,1316
04210700,NEW YORK INSTITUTE OF BEAUTY            ,NY,11749-1479,Proprietary  ,7,22,29,32,,82,114
04212500,CACTUS ACADEMY (THE)                    ,NY,11530-3402,Proprietary  ,10,22,32,61,,75,136
04213400,ACCESS CAREERS                          ,NY,11550-0000,Proprietary  ,0,2,2,0,,2,2
04213500,SHARP EDGEZ BARBER INSTITUTE            ,NY,14620-0000,Proprietary  ,7,24,31,13,,77,90
04215900,YESHIVA GEDOLAH KESSER TORAH            ,NY,10952-2127,Private      ,22,0,22,37,,1,38
04223100,ARROJO COSMETOLOGY SCHOOL               ,NY,10014-4960,Proprietary  ,12,39,51,30,,82,112
04223800,ELECTRICAL TRAINING CENTER (THE)        ,NY,11726-2701,Proprietary  ,3,5,8,3,,5,8
00267808,BRYANT & STRATTON COLLEGE - PARMA       ,OH,44130-0000,Proprietary  ,56,309,365,572,,3366,3938
00301000,ANTIOCH UNIVERSITY                      ,OH,45387-1608,Private      ,11,49,60,264,,758,1022
00301100,ART ACADEMY OF CINCINNATI               ,OH,45202-7106,Private      ,25,28,53,485,,261,746
00301200,ASHLAND UNIVERSITY                      ,OH,44805-3799,Private      ,75,334,409,3703,,2993,6696
00301300,ATHENAEUM OF OHIO                       ,OH,45230-2000,Private      ,0,3,3,6,,22,28
00301400,BALDWIN-WALLACE COLLEGE                 ,OH,44017-2088,Private      ,115,127,242,5103,,1831,6934
00301600,BLUFFTON UNIVERSITY                     ,OH,45817-2104,Private      ,27,24,51,1540,,391,1931
00301800,BOWLING GREEN STATE UNIVERSITY          ,OH,43403-0001,Public       ,417,440,857,20768,,6385,27153
00302300,CAPITAL UNIVERSITY                      ,OH,43209-2394,Private      ,122,246,368,4407,,3257,7664
00302400,CASE WESTERN RESERVE UNIV               ,OH,44106-0000,Private      ,255,179,434,10992,,2263,13255
00302401,CASE WESTERN RESERVE UNIV - MED         ,OH,44106-0000,Private      ,6,14,20,98,,1215,1313
00302402,CASE WESTERN RESERVE UNIV - DENTAL      ,OH,44106-0000,Private      ,5,9,14,50,,324,374
00302403,CASE WESTERN RESERVE UNIV - LAW         ,OH,44106-0000,Private      ,1,14,15,32,,828,860
00302404,CASE WESTERN RESERVE UNIV - UG          ,OH,44106-0000,Private      ,4,7,11,209,,55,264
00302405,CASE WESTERN RESERVE UNIV - MSASS       ,OH,44106-0000,Private      ,0,18,18,20,,555,575
00302406,CASE WESTERN RESERVE UNIV - NURS UG     ,OH,44106-0000,Private      ,8,26,34,275,,246,521
00302407,CASE WESTERN RESERVE UNIV - WSOM        ,OH,44106-0000,Private      ,1,7,8,34,,232,266
00302408,CASE WESTERN RESERVE UNIV -A&S GRAD     ,OH,44106-0000,Private      ,1,15,16,14,,331,345
00302409,CASE WESTERN RESERVE UNIV -ENG GRAD     ,OH,44106-0000,Private      ,2,7,9,46,,100,146
00302410,CASE WESTERN RESERVE UNIV -NURS GRD     ,OH,44106-0000,Private      ,2,21,23,14,,411,425
00302500,CEDARVILLE UNIVERSITY                   ,OH,45314-8564,Private      ,89,32,121,4253,,472,4725
00302600,CENTRAL STATE UNIVERSITY                ,OH,45384-1004,Public       ,92,104,196,3150,,1764,4914
00302900,CINCINNATI CHRISTIAN UNIVERSITY         ,OH,45204-3200,Private      ,23,66,89,607,,770,1377
00303000,OHIO CHRISTIAN UNIVERSITY               ,OH,43113-9487,Private      ,50,614,664,905,,4048,4953
00303100,CLEVELAND INSTITUTE OF MUSIC            ,OH,44106-1776,Private      ,16,17,33,409,,438,847
00303200,CLEVELAND STATE UNIVERSITY              ,OH,44115-2214,Public       ,406,1079,1485,11802,,14878,26680
00303300,COLLEGE OF MT ST JOSEPH                 ,OH,45233-1670,Private      ,39,107,146,2010,,1536,3546
00303500,OHIO DOMINICAN UNIVERSITY               ,OH,43219-2099,Private      ,71,232,303,2345,,2716,5061
00303600,FRANCISCAN UNIV OF STEUBENVILLE         ,OH,43952-1763,Private      ,65,40,105,2648,,696,3344
00303700,COLLEGE OF WOOSTER                      ,OH,44691-2363,Private      ,80,17,97,3569,,161,3730
00303900,COLUMBUS COLLEGE OF ART AND DESIGN      ,OH,43215-1758,Private      ,63,92,155,1791,,879,2670
00304000,CUYAHOGA COMMUNITY COLLEGE              ,OH,44115-2878,Public       ,917,3178,4095,12100,,26239,38339
00304100,"DEFIANCE COLLEGE, THE                   ",OH,43512-1695,Private      ,22,28,50,1436,,488,1924
00304200,DENISON UNIVERSITY                      ,OH,43023-1329,Private      ,69,13,82,3111,,138,3249
00304300,CHANCELLOR UNIVERSITY                   ,OH,44114-0000,Proprietary  ,1,12,13,33,,273,306
00304400,TRINITY LUTHERAN SEMINARY               ,OH,43209-0000,Private      ,2,5,7,5,,140,145
00304500,UNIVERSITY OF FINDLAY                   ,OH,45840-3695,Private      ,72,131,203,3686,,1750,5436
00304600,FRANKLIN UNIVERSITY                     ,OH,43215-5399,Private      ,94,863,957,1315,,10798,12113
00304800,HEIDELBERG UNIVERSITY                   ,OH,44883-2462,Private      ,30,26,56,1997,,435,2432
00304900,HIRAM COLLEGE                           ,OH,44234-1808,Private      ,30,34,64,1767,,463,2230
00305000,JOHN CARROLL UNIVERSITY                 ,OH,44118-4581,Private      ,78,51,129,4705,,1006,5711
00305100,KENT STATE UNIVERSITY                   ,OH,44242-0001,Public       ,566,836,1402,27046,,13248,40294
00305101,KENT STATE UNIVERSITY - GEAUGA CAMPUS   ,OH,44021-9500,Public       ,35,76,111,835,,1026,1861
00305102,KENT STATE UNIVERSITY - STARK CAMPUS    ,OH,44720-7599,Public       ,136,314,450,3518,,4114,7632
00305103,KENT STATE UNIVERSITY - TUSCARAWAS CAMPU,OH,44663-9403,Public       ,30,92,122,1051,,1517,2568
00305104,KENT STATE UNIVERSITY - TRUMBULL CAMPUS ,OH,44483-1998,Public       ,57,190,247,1250,,2342,3592
00305105,KENT STATE UNIVERSITY - ASHTABULA CAMPUS,OH,44004-2299,Public       ,50,158,208,972,,2111,3083
00305106,KENT STATE UNIVERSITY - EAST LIVERPOOL C,OH,43920-3497,Public       ,19,57,76,496,,876,1372
00305107,KENT STATE UNIVERSITY - SALEM CAMPUS    ,OH,44460-9412,Public       ,47,93,140,1054,,1257,2311
00305143,KENT STATE UNIVERSITY - COLLEGE OF PODIA,OH,44131-2330,Public       ,2,8,10,31,,313,344
00306500,KENYON COLLEGE                          ,OH,43022-9623,Private      ,112,13,125,2778,,81,2859
00306600,LAKE ERIE COLLEGE                       ,OH,44077-3389,Private      ,33,46,79,1364,,440,1804
00306800,LORAIN COUNTY COMMUNITY COLLEGE         ,OH,44035-1691,Public       ,237,741,978,4464,,8484,12948
00306900,LOURDES COLLEGE                         ,OH,43560-2898,Private      ,39,93,132,1325,,1859,3184
00307200,MALONE UNIVERSITY                       ,OH,44709-3897,Private      ,38,109,147,1938,,1489,3427
00307300,MARIETTA COLLEGE                        ,OH,45750-4033,Private      ,31,27,58,2557,,383,2940
00307500,METHODIST THEOLOGICAL SCH IN OHIO       ,OH,43015-0000,Private      ,0,14,14,2,,200,202
00307600,MIAMI-JACOBS COLLEGE                    ,OH,45401-0000,Proprietary  ,0,0,0,22,,74,96
00307700,MIAMI UNIVERSITY                        ,OH,45056-1831,Public       ,517,407,924,22903,,5964,28867
00307800,WRIGHT STATE UNIVERSITY                 ,OH,45435-0002,Public       ,362,736,1098,13549,,11221,24770
00308300,UNIVERSITY OF MOUNT UNION               ,OH,44601-3993,Private      ,60,23,83,3517,,351,3868
00308400,MUSKINGUM UNIVERSITY                    ,OH,43762-1199,Private      ,29,48,77,2283,,701,2984
00308500,NOTRE DAME COLLEGE OF OHIO              ,OH,44121-4293,Private      ,76,174,250,2524,,1794,4318
00308600,OBERLIN COLLEGE                         ,OH,44074-1090,Private      ,157,13,170,5073,,215,5288
00308900,OHIO NORTHERN UNIVERSITY                ,OH,45810-1555,Private      ,53,27,80,3728,,990,4718
00309000,OHIO STATE UNIVERSITY-ALL CAMPUSES      ,OH,43210-1358,Public       ,1458,1532,2990,56712,,26241,82953
00310000,OHIO UNIVERSITY                         ,OH,45701-2979,Public       ,515,1079,1594,24421,,12815,37236
00310002,"OHIO UNIVERSITY, ZANESVILLE CAMPUS      ",OH,43701-0000,Public       ,52,158,210,1359,,1749,3108
00310003,"OHIO UNIVERSITY, LANCASTER CAMPUS       ",OH,43130-0000,Public       ,51,200,251,1574,,2153,3727
00310004,"OHIO UNIVERSITY, SOUTHERN CAMPUS        ",OH,45638-0000,Public       ,52,154,206,895,,1945,2840
00310005,"OHIO UNIVERSITY, CHILLICOTHE CAMPUS     ",OH,45601-0000,Public       ,57,228,285,1297,,2327,3624
00310006,"OHIO UNIVERSITY, EASTERN CAMPUS         ",OH,43950-0000,Public       ,5,40,45,577,,462,1039
00310008,OHIO UNIV COLL OF OSTEOPATHIC MED       ,OH,45701-0000,Public       ,2,4,6,17,,600,617
00310900,OHIO WESLEYAN UNIVERSITY                ,OH,43015-2398,Private      ,60,23,83,3114,,210,3324
00311000,OTTERBEIN UNIVERSITY                    ,OH,43081-2006,Private      ,88,72,160,4081,,1099,5180
00311300,PONTIFICAL COLLEGE JOSEPHINUM           ,OH,43235-1498,Private      ,3,1,4,54,,23,77
00311400,FIRELANDS REGIONAL MEDICAL CENTER - SOUT,OH,44870-4788,Private      ,4,12,16,67,,169,236
00311500,RABBINICAL COLLEGE OF TELSHE            ,OH,44092-2584,Private      ,10,2,12,18,,25,43
00311600,UNIV OF RIO GRANDE                      ,OH,45674-3131,Private      ,60,201,261,1585,,2174,3759
00311900,SINCLAIR COMMUNITY COLLEGE              ,OH,45402-1460,Public       ,667,2181,2848,9431,,18269,27700
00312100,TIFFIN UNIVERSITY                       ,OH,44883-2161,Private      ,70,241,311,2886,,5814,8700
00312200,UNITED THEOLOGICAL SEMINARY             ,OH,45406-0000,Private      ,1,64,65,6,,714,720
00312300,UNIVERSITY OF AKRON                     ,OH,44325-6211,Public       ,494,937,1431,20402,,14550,34952
00312500,UNIVERSITY OF CINCINNATI                ,OH,45221-0125,Public       ,885,1924,2809,29693,,23773,53466
00312504,UNIVERSITY OF CINCINNATI - MEDICINE     ,OH,45267-0553,Public       ,32,70,102,420,,1704,2124
00312700,UNIVERSITY OF DAYTON                    ,OH,45469-0002,Private      ,216,245,461,12922,,3517,16439
00313100,UNIVERSITY OF TOLEDO                    ,OH,43606-3390,Public       ,400,714,1114,17731,,10956,28687
00313300,URBANA UNIVERSITY                       ,OH,43078-2091,Private      ,32,113,145,1055,,992,2047
00313400,URSULINE COLLEGE                        ,OH,44124-4398,Private      ,31,113,144,668,,1398,2066
00313500,WALSH UNIVERSITY                        ,OH,44720-3396,Private      ,52,107,159,2703,,1439,4142
00314100,WILBERFORCE UNIVERSITY                  ,OH,45384-1001,Private      ,16,28,44,639,,462,1101
00314200,WILMINGTON COLLEGE                      ,OH,45177-2499,Private      ,63,43,106,2137,,562,2699
00314300,WITTENBERG UNIVERSITY                   ,OH,45501-2199,Private      ,65,37,102,3857,,471,4328
00314400,XAVIER UNIVERSITY                       ,OH,45207-1035,Private      ,153,221,374,8432,,3368,11800
00314500,YOUNGSTOWN STATE UNIVERSITY             ,OH,44555-0001,Public       ,242,491,733,9520,,7327,16847
00398200,CLEVELAND INSTITUTE OF ART              ,OH,44106-1700,Private      ,39,37,76,1065,,348,1413
00406000,WINEBRENNER THEOLOGICAL SEMINARY        ,OH,45840-0000,Private      ,0,5,5,2,,58,60
00485200,CLARK STATE COMMUNITY COLLEGE           ,OH,45505-4795,Public       ,129,657,786,2100,,6271,8371
00485300,BRADFORD SCHOOL                         ,OH,43219-0000,Proprietary  ,40,85,125,743,,765,1508
00485500,DAVIS COLLEGE                           ,OH,43623-4307,Proprietary  ,11,75,86,141,,750,891
00486100,UNIVERSITY OF NORTHWESTERN OHIO         ,OH,45805-1498,Private      ,196,169,365,4974,,2081,7055
00486600,STAUTZENBERGER COLLEGE                  ,OH,43537-4007,Proprietary  ,47,180,227,462,,1592,2054
00489814,MCCANN SCHOOL OF BUSINESS & TECHNOLOGY -,OH,44131-2309,Proprietary  ,0,0,0,6,,37,43
00489817,MCCANN SCHOOL OF BUSINESS & TECHNOLOGY -,OH,45241-5428,Proprietary  ,0,0,0,4,,16,20
00510200,SCH OF DIAGNOSTIC IMAGING-CLEVELAND     ,OH,44119-0000,Private      ,0,2,2,16,,44,60
00531300,NORTH CENTRAL STATE COLLEGE             ,OH,44901-0000,Public       ,100,299,399,1413,,2634,4047
00575300,OWENS STATE COMMUNITY COLLEGE           ,OH,43699-0000,Public       ,331,1003,1334,5922,,10730,16652
00648700,AULTMAN COLLEGE OF NURSING AND HEALTH SC,OH,44710-1799,Private      ,11,42,53,202,,566,768
00648900,CHRIST COLLEGE OF NURSING AND HEALTH SCI,OH,45219-2906,Private      ,17,110,127,353,,894,1247
00649400,GOOD SAMARITAN COLG-NURSING/HEALTH      ,OH,45220-2489,Private      ,14,61,75,309,,764,1073
00650700,TRINIT HEALTH SYSTEM SCH OF NURSING     ,OH,43952-2667,Private      ,1,9,10,70,,182,252
00680400,LAKELAND COMMUNITY COLLEGE              ,OH,44094-5198,Public       ,188,717,905,3239,,6637,9876
00686700,COLUMBUS STATE COMMUNITY COLLEGE        ,OH,43215-1786,Public       ,1180,3045,4225,14386,,26028,40414
00703500,KETTERING COLLEGE OF MEDICAL ARTS       ,OH,45429-1299,Private      ,20,62,82,620,,974,1594
00708500,MOUNT VERNON NAZARENE UNIVERSITY        ,OH,43050-9500,Private      ,21,77,98,1585,,902,2487
00708501,MOUNT VERNON NAZARENE UNIV - AGS        ,OH,43050-0000,Private      ,3,68,71,94,,777,871
00727500,EASTERN GATEWAY COMMUNITY COLLEGE       ,OH,43952-3598,Public       ,81,288,369,1170,,2498,3668
00732920,ITT TECHNICAL INSTITUTE                 ,OH,45414-3456,Proprietary  ,53,263,316,474,,1832,2306
00732992,ITT TECHNICAL INSTITUTE                 ,OH,44509-4098,Proprietary  ,54,214,268,464,,1725,2189
00747300,CHOFFIN CAREER & TECHNICAL CENTER       ,OH,44503-1628,Public       ,6,31,37,123,,352,475
00759800,HOCKING TECHNICAL COLLEGE               ,OH,45764-9582,Public       ,121,263,384,3230,,3277,6507
00812900,ADULT AND COMMUNITY EDUCATION @ HUDSON  ,OH,43211-2017,Public       ,7,55,62,65,,553,618
00813200,TOLEDO SCHOOL OF PRACTICAL NURSING      ,OH,43613-5110,Public       ,16,51,67,144,,524,668
00813300,ZANE STATE COLLEGE                      ,OH,43701-2626,Public       ,88,214,302,1394,,2267,3661
00819400,AKRON SCHOOL OF PRACTICAL NRSG          ,OH,44311-0000,Public       ,12,39,51,177,,333,510
00827800,TERRA COMMUNITY COLLEGE                 ,OH,43420-9670,Public       ,60,226,286,985,,2166,3151
00867700,NORTHWEST STATE COMMUNITY COLLEGE       ,OH,43502-9542,Public       ,51,261,312,1050,,2324,3374
00888600,PORTAGE LAKES CAREER CENTER             ,OH,44685-9554,Public       ,0,3,3,26,,96,122
00908803,ITT TECHNICAL INSTITUTE                 ,OH,44136-1758,Proprietary  ,0,0,0,0,,2,2
00915600,WAYNE COUNTY SCHOOLS CAREER CENTER      ,OH,44677-9672,Public       ,6,32,38,58,,247,305
00941200,FORTIS COLLEGE                          ,OH,44221-2998,Proprietary  ,25,146,171,208,,1226,1434
00953000,GERBER AKRON BEAUTY SCHOOL              ,OH,44313-6995,Proprietary  ,3,25,28,39,,152,191
00953100,SPA SCHOOL (THE)                        ,OH,43214-1524,Proprietary  ,12,54,66,70,,372,442
00966000,TIFFIN ACADEMY OF HAIR DESIGN           ,OH,44883-2833,Proprietary  ,0,5,5,38,,56,94
00994100,BELMONT TECHNICAL COLLEGE               ,OH,43950-9766,Public       ,30,146,176,811,,1406,2217
00994200,SHAWNEE STATE UNIVERSITY                ,OH,45662-4344,Public       ,136,232,368,4610,,2653,7263
01001700,PAYNE THEOLOGICAL SEMINARY              ,OH,45384-0474,Private      ,0,11,11,0,,165,165
01002700,JAMES A. RHODES STATE COLLEGE           ,OH,45804-3597,Public       ,92,251,343,1673,,2828,4501
01016800,NATIONWIDE BEAUTY ACADEMY               ,OH,43228-1000,Proprietary  ,10,47,57,101,,285,386
01028000,OHIO STATE BEAUTY ACADEMY               ,OH,45801-0000,Proprietary  ,19,23,42,153,,203,356
01032300,HANNAH E MULLINS SCH-PRAC NRSG          ,OH,44460-2906,Public       ,2,15,17,25,,97,122
01034500,CINCINNATI STATE TECH & COMM CLG        ,OH,45223-2690,Public       ,448,1488,1936,5754,,12877,18631
01045300,WASHINGTON STATE CMTY COLLEGE           ,OH,45750-9225,Public       ,35,151,186,894,,1212,2106
01063000,NORTHERN INSTITUTE OF COSMETOLOGY       ,OH,44052-1803,Proprietary  ,2,14,16,22,,82,104
01073600,MARION TECHNICAL COLLEGE                ,OH,43302-5694,Public       ,50,221,271,947,,1986,2933
01088000,CHATFIELD COLLEGE                       ,OH,45118-9705,Private      ,9,44,53,97,,447,544
01088100,STARK STATE COLLEGE OF TECHNOLOGY       ,OH,44720-7299,Public       ,320,1335,1655,4623,,13703,18326
01090600,CINCINNATI CLG OF MORTUARY SCIENCE      ,OH,45224-1428,Private      ,4,26,30,80,,225,305
01092300,UNION INSTITUTE & UNIVERSITY            ,OH,45206-1925,Private      ,5,302,307,46,,2231,2277
01099300,HOBART INSTITUTE OF WELDING TECHNOLOGY  ,OH,45373-2400,Private      ,29,47,76,326,,292,618
01100500,KAPLAN COLLEGE                          ,OH,43232-4827,Proprietary  ,14,142,156,136,,939,1075
01104600,CENTRAL OHIO TECHNICAL COLLEGE          ,OH,43055-1767,Public       ,111,400,511,1741,,4537,6278
01170300,PENTA COUNTY JOINT VOCATIONAL SCH       ,OH,43551-0000,Public       ,1,11,12,26,,130,156
01174400,NATIONAL BEAUTY COLLEGE                 ,OH,44720-0000,Proprietary  ,1,22,23,50,,196,246
01174500,OHIO TECHNICAL COLLEGE                  ,OH,44103-1228,Proprietary  ,73,177,250,1524,,1132,2656
01182500,OHIO STATE SCHOOL OF COSMETOLOGY        ,OH,43224-1107,Proprietary  ,0,0,0,103,,259,362
01212800,SOUTHWESTERN COLLEGE                    ,OH,45402-3003,Proprietary  ,0,31,31,62,,368,430
01212802,SOUTHWESTERN COLLEGE                    ,OH,45005-2267,Proprietary  ,0,0,0,1,,7,8
01212803,SOUTHWESTERN COLLEGE                    ,OH,45202-4304,Proprietary  ,0,0,0,5,,41,46
01212804,SOUTHWESTERN COLLEGE                    ,OH,45246-3121,Proprietary  ,3,31,34,59,,362,421
01212806,LINCOLN COLLEGE OF TECHNOLOGY - TOLEDO  ,OH,43615-6800,Proprietary  ,6,28,34,92,,321,413
01212807,LINCOLN COLLEGE OF TECHNOLOGY - COLUMBUS,OH,43215-3602,Proprietary  ,0,0,0,17,,46,63
01212808,LINCOLN COLLEGE OF TECHNOLOGY - CLEVELAN,OH,44114-3266,Proprietary  ,5,34,39,99,,402,501
01216600,CAROUSEL BEAUTY COLLEGE                 ,OH,45402-8935,Proprietary  ,12,41,53,107,,319,426
01224800,CENTRAL SCHOOL OF PRACTICAL NURSING     ,OH,44103-0000,Private      ,7,60,67,99,,459,558
01267200,CAROUSEL BEAUTY COLLEGE                 ,OH,45044-5113,Proprietary  ,0,16,16,15,,54,69
01267400,CAROUSEL OF MIAMI VALLEY BEAUTY CLG     ,OH,45424-2063,Proprietary  ,1,5,6,11,,32,43
01275000,EDISON COMMUNITY COLLEGE                ,OH,45356-9239,Public       ,62,255,317,1084,,2438,3522
01283800,LAURA AND ALVIN SIEGAL COLLEGE OF JUDAIC,OH,44122-7197,Private      ,0,0,0,3,,9,12
01284800,MOLER-HOLLYWOOD BEAUTY COLLEGE          ,OH,45202-2577,Proprietary  ,7,39,46,41,,143,184
01287000,SOUTHERN STATE COMMUNITY COLLEGE        ,OH,45133-9406,Public       ,80,293,373,1183,,2411,3594
01289100,ANTONELLI COLLEGE                       ,OH,45202-2592,Proprietary  ,18,101,119,144,,703,847
01289600,VIRGINIA MARTI COLLEGE OF ART AND DESIGN,OH,44107-0778,Proprietary  ,9,19,28,154,,198,352
01303922,SOUTH UNIVERSITY - CLEVELAND            ,OH,44128-5919,Proprietary  ,6,113,119,66,,565,631
01313200,INTERNATIONAL CLG OF BROADCASTING       ,OH,45431-1898,Proprietary  ,10,26,36,96,,206,302
02052000,KAPLAN COLLEGE                          ,OH,45439-1984,Proprietary  ,31,218,249,234,,1430,1664
02054300,TRUMBULL BUSINESS COLLEGE               ,OH,44484-0000,Proprietary  ,10,45,55,41,,409,450
02056800,DAYMAR COLLEGE                          ,OH,45601-1038,Proprietary  ,2,29,31,34,,262,296
02056802,DAYMAR COLLEGE - LANCASTER              ,OH,43130-0000,Proprietary  ,7,33,40,37,,202,239
02056803,DAYMAR COLLEGE - NEW BOSTON             ,OH,45662-4900,Proprietary  ,1,24,25,31,,197,228
02056804,DAYMAR COLLEGE - JACKSON                ,OH,45640-1728,Proprietary  ,2,18,20,30,,154,184
02066100,OHIO STATE COLLEGE/BARBER STYLING       ,OH,43213-0000,Proprietary  ,17,68,85,139,,359,498
02073300,GALLIA-JACKSON-VINTON SCH ADULT ED      ,OH,45674-0000,Public       ,1,17,18,79,,220,299
02110700,CLEVELAND INST OF DENTAL-MED ASST       ,OH,44115-2285,Proprietary  ,21,108,129,152,,654,806
02116009,SANFORD-BROWN COLLEGE - MIDDLEBURG HEIGH,OH,44130-8362,Proprietary  ,5,46,51,116,,652,768
02116900,UPPER VALLEY JVS                        ,OH,45356-0000,Public       ,2,45,47,27,,229,256
02117300,GREAT OAKS INSTITUTE OF TECHNOLOGY      ,OH,45241-1581,Public       ,23,106,129,256,,955,1211
02128600,THE ART INSTITUTE OF CINCINNATI         ,OH,45246-0000,Proprietary  ,32,46,78,534,,389,923
02140700,COMMUNITY EDUCATIONAL SERVICES          ,OH,44702-1710,Public       ,2,16,18,33,,240,273
02158417,"HARRISON COLLEGE - COLUMBUS, OH         ",OH,43123-0000,Proprietary  ,14,56,70,87,,375,462
02158500,OHIO BUSINESS COLLEGE                   ,OH,44035-0701,Proprietary  ,22,60,82,100,,557,657
02158501,OHIO BUSINESS COLLEGE                   ,OH,44870-9953,Proprietary  ,3,45,48,44,,447,491
02158503,OHIO BUSINESS COLLEGE - COLUMBUS        ,OH,43229-3523,Proprietary  ,21,96,117,157,,549,706
02158504,OHIO BUSINESS COLLEGE - DAYTON          ,OH,45417-4094,Proprietary  ,4,40,44,34,,215,249
02168100,TRI-COUNTY JOINT VOCATIONAL SCHOOL      ,OH,45764-0000,Public       ,2,25,27,59,,208,267
02187900,ASHTABULA CO JOINT VOC SCH ADULT ED     ,OH,44047-0000,Public       ,4,15,19,59,,252,311
02189000,ADULT CENTER FOR EDUCATION              ,OH,43701-0000,Public       ,13,55,68,126,,467,593
02190700,FORTIS COLLEGE                          ,OH,45459-0000,Proprietary  ,51,505,556,494,,4081,4575
02192100,BUTLER TECHNOLOGY AND CAREER DEVELOPMENT,OH,45011-0000,Public       ,20,112,132,238,,677,915
02196300,COLLINS CAREER CENTER                   ,OH,45619-0000,Public       ,19,76,95,185,,603,788
02210800,MEDINA COUNTY CAREER CENTER             ,OH,44256-0000,Public       ,3,15,18,47,,173,220
02220500,GOD'S BIBLE SCHOOL & COLLEGE            ,OH,45210-0000,Private      ,7,10,17,192,,108,300
02220800,CAREER & TECHNOLOGY EDUCATION CENTERS OF,OH,43055-0000,Public       ,9,55,64,139,,394,533
02239800,PIONEER CAREER & TECHNOLOGY CENTER      ,OH,44875-0000,Public       ,0,11,11,8,,63,71
02245600,WARREN COUNTY CAREER CENTER             ,OH,45036-0000,Public       ,10,46,56,91,,349,440
02246300,INSTITUTE OF MEDICAL-DENTAL TECH        ,OH,45246-3317,Proprietary  ,28,117,145,130,,465,595
02263700,MIAMI VALLEY CAREER TECHNOLOGY CTR      ,OH,45315-0000,Public       ,14,103,117,159,,618,777
02269400,EASTERN HILLS ACAD OF HAIR DESIGN       ,OH,45255-0000,Proprietary  ,4,13,17,28,,82,110
02269500,WESTERN HILLS SCHOOL OF BEAUTY & HAIR DE,OH,45211-0000,Proprietary  ,5,55,60,59,,287,346
02270100,OHIO HI-POINT CAREER CENTER             ,OH,43311-0000,Public       ,1,7,8,16,,120,136
02272700,COLUMBIANA COUNTY CAREER CENTER         ,OH,44432-0000,Public       ,8,41,49,66,,302,368
02287900,RAPHAEL'S SCHOOL OF BEAUTY CULTURE      ,OH,44446-0000,Proprietary  ,10,46,56,75,,248,323
02289802,KAPLAN COLLEGE                          ,OH,45203-0000,Proprietary  ,10,61,71,83,,550,633
02301400,OHIO VALLEY COLLEGE OF TECHNOLOGY       ,OH,43920-9139,Proprietary  ,8,36,44,99,,257,356
02304700,TRI-RIVERS CAREER CENTER                ,OH,43302-0000,Public       ,5,39,44,78,,317,395
02311200,AMERICAN SCHOOL OF TECHNOLOGY           ,OH,43229-0000,Proprietary  ,12,102,114,122,,707,829
02315500,TOLEDO ACADEMY OF BEAUTY CULTURE - EAST ,OH,43616-0000,Proprietary  ,1,29,30,52,,184,236
02324400,ALLSTATE HAIRSTYLING & BARBER CLG       ,OH,44113-0000,Proprietary  ,16,47,63,90,,372,462
02328500,MOLER-PICKENS BEAUTY COLLEGE            ,OH,45014-0000,Proprietary  ,3,18,21,13,,70,83
02334300,INTERNATIONAL ACAD OF HAIR DESIGN       ,OH,45239-0000,Proprietary  ,8,35,43,88,,251,339
02336300,KNOX COUNTY CAREER CENTER               ,OH,43050-4298,Public       ,12,23,35,80,,300,380
02336700,CUYAHOGA VALLEY CAREER CENTER           ,OH,44141-1296,Public       ,7,22,29,62,,253,315
02337700,PROFESSIONAL SKILLS INSTITUTE           ,OH,43607-0000,Proprietary  ,10,50,60,159,,721,880
02342705,FORTIS COLLEGE -  RAVENNA CAMPUS        ,OH,44266-0000,Proprietary  ,4,19,23,77,,247,324
02351500,WILLOUGHBY EASTLAKE SCH OF PRAC NSG     ,OH,44094-0000,Public       ,5,25,30,27,,165,192
02352800,POLARIS CAREER CENTER-ADULT ED DEPT     ,OH,44130-0000,Public       ,9,60,69,143,,482,625
02354200,SCIOTO COUNTY JOINT VOCATIONAL SCH      ,OH,45648-0000,Public       ,7,45,52,126,,394,520
02359803,ITT TECHNICAL INSTITUTE -               ,OH,45212-2273,Proprietary  ,0,0,0,0,,1,1
02454400,NORTHEAST OHIO MEDICAL UNIVERSITY       ,OH,44272-9621,Public       ,7,6,13,149,,871,1020
02497800,GREENE COUNTY CAREER CENTER             ,OH,45385-0000,Public       ,10,27,37,43,,201,244
02512600,ADULT VOCATIONAL SERVICES               ,OH,44308-0000,Public       ,0,0,0,3,,11,14
02519300,OHIO STATE SCH COSMETOLOGY              ,OH,43110-2754,Proprietary  ,15,28,43,124,,224,348
02522700,EASTLAND-FAIRFIELD CAREER AND TECHNICAL ,OH,43125-0000,Public       ,6,49,55,68,,323,391
02528300,TDDS TECHNICAL INSTITUTE                ,OH,44429-0000,Proprietary  ,16,129,145,78,,501,579
02529500,HAMRICK SCHOOL                          ,OH,44256-0000,Proprietary  ,6,66,72,25,,285,310
02545800,INNER STATE BEAUTY SCHOOLS              ,OH,44124-0000,Proprietary  ,8,45,53,66,,266,332
02553000,SCHOOL OF ADVERTISING ART               ,OH,45440-0000,Proprietary  ,9,5,14,258,,61,319
02560000,CASAL AVEDA INSTITUTE                   ,OH,44515-0000,Proprietary  ,8,24,32,145,,207,352
02560700,PICKAWAY ROSS CO JOINT VOC TECH SCH     ,OH,45601-0000,Public       ,13,50,63,107,,440,547
02562300,APOLLO CAREER CENTER-ADULT EDUC         ,OH,45806-0000,Public       ,12,59,71,127,,563,690
02563000,RAPHAELS SCHOOL OF BEAUTY CULTURE       ,OH,44601-2847,Proprietary  ,5,24,29,33,,144,177
02568600,MAHONING COUNTY CAREER & TECH CENTR     ,OH,44406-0000,Public       ,0,10,10,34,,129,163
02582900,KAPLAN CAREER INSTITUTE                 ,OH,44129-6810,Proprietary  ,18,88,106,58,,602,660
02586400,TRUMBULL CAREER & TECH CENTER-ADULT     ,OH,44483-1997,Public       ,14,36,50,71,,340,411
02588500,OHIO STATE SCHOOL OF COSMETOLOGY        ,OH,43081-0000,Proprietary  ,9,37,46,132,,231,363
02599711,VATTEROTT COLLEGE - CLEVELAND           ,OH,44147-3502,Proprietary  ,8,67,75,58,,400,458
02603800,LORAIN COUNTY JVS ADULT CAREER CTR      ,OH,44074-9799,Public       ,2,21,23,67,,251,318
02611007,HERITAGE COLLEGE - COLUMBUS             ,OH,43213-4440,Proprietary  ,34,145,179,223,,928,1151
02620000,SANDUSKY CAREER CENTER                  ,OH,44870-4786,Public       ,2,30,32,23,,175,198
03007900,GALLIPOLIS CAREER COLLEGE               ,OH,45631-2600,Proprietary  ,0,26,26,24,,198,222
03015100,ALLIANCE HIGH SCH-CMTY SERVICES DIV     ,OH,44601-2899,Public       ,3,11,14,35,,124,159
03015300,EHOVE CAREER CENTER                     ,OH,44846-9500,Public       ,13,35,48,100,,430,530
03023700,MADISON ADULT CAREER CENTER             ,OH,44905-2718,Public       ,5,43,48,68,,356,424
03024300,VALLEY BEAUTY SCHOOL                    ,OH,43725-2332,Proprietary  ,3,3,6,9,,26,35
03026511,REMINGTON COLLEGE - CLEVELAND           ,OH,44125-1957,Private      ,22,116,138,370,,1411,1781
03026512,REMINGTON COLLEGE - CLEVELAND WEST      ,OH,44070-3129,Private      ,6,13,19,54,,190,244
03027100,FAIRVIEW ACADEMY                        ,OH,44126-2214,Proprietary  ,4,11,15,21,,75,96
03034200,WASHINGTON COUNTY CAREER CENTER ADULT TE,OH,45750-9290,Public       ,14,73,87,135,,394,529
03051400,AUBURN CAREER CENTER                    ,OH,44077-9723,Public       ,9,52,61,74,,282,356
03051500,US GRANT JOINT VOCATIONAL SCHOOL        ,OH,45106-9502,Public       ,1,1,2,6,,21,27
03065900,BUCKEYE CAREER CENTER                   ,OH,44663-9437,Public       ,0,13,13,60,,221,281
03067600,RAPHAEL'S SCHOOL OF BEAUTY CULTURE      ,OH,44512-2222,Proprietary  ,9,28,37,54,,150,204
03068200,OHIO CENTER FOR BROADCASTING            ,OH,44125-6273,Proprietary  ,7,39,46,60,,213,273
03068202,OHIO CENTER FOR BROADCASTING - COLUMBUS ,OH,43213-2571,Proprietary  ,4,48,52,80,,269,349
03071900,MOUNT CARMEL COLLEGE OF NURSING         ,OH,43222-1598,Private      ,44,120,164,892,,1319,2211
03072303,EVEREST INSTITUTE - COLUMBUS            ,OH,43230-6653,Proprietary  ,25,181,206,160,,878,1038
03078000,OHIO CENTER FOR BROADCASTING            ,OH,45227-1509,Proprietary  ,4,20,24,57,,225,282
03079000,ETI TECHNICAL COLLEGE                   ,OH,44446-4398,Proprietary  ,13,43,56,73,,316,389
03084800,DELAWARE AREA CAREER CENTER             ,OH,43015-8969,Public       ,3,15,18,26,,87,113
03084801,DELAWARE AREA CAREER CENTER -           ,OH,43015-9001,Public       ,1,10,11,15,,54,69
03095600,VANTAGE CAREER CENTER                   ,OH,45891-1378,Public       ,1,10,11,19,,116,135
03097000,MERCY COLLEGE OF NORTHWEST OHIO         ,OH,43604-1132,Private      ,21,108,129,677,,1450,2127
03100100,PARAMOUNT BEAUTY ACADEMY                ,OH,45662-4136,Proprietary  ,4,27,31,43,,148,191
03116200,DAYTON BARBER COLLEGE                   ,OH,45342-0000,Proprietary  ,2,20,22,25,,125,150
03116300,OHIO COLLEGE OF MASSOTHERAPY            ,OH,44321-1363,Private      ,2,35,37,41,,198,239
03116400,VANGUARD-SENTINELL VOC SCH DISTRICT     ,OH,43420-1197,Public       ,2,7,9,19,,82,101
03117000,ASHLAND COUNTY-W HOLMES CAREER CTR      ,OH,44805-0000,Public       ,1,22,23,33,,158,191
03319300,CREATIVE IMAGES-A CERTIFIED MATRIX      ,OH,45414-2557,Proprietary  ,7,42,49,112,,276,388
03319301,CREATIVE IMAGES-A CERTIFIED MATRIX      ,OH,45459-0000,Proprietary  ,12,26,38,103,,245,348
03416400,VALLEY BEAUTY SCHOOL                    ,OH,43701-3624,Proprietary  ,1,6,7,15,,53,68
03425300,ROSEDALE BIBLE COLLEGE                  ,OH,43029-9517,Private      ,4,1,5,58,,16,74
03457300,ALLEGHENY WESLEYAN COLLEGE              ,OH,44460-9598,Private      ,6,3,9,45,,18,63
03468400,NATIONAL INSTITUTE OF MASSOTHERAPY      ,OH,44319-2100,Proprietary  ,0,16,16,21,,113,134
03468500,ATS INSTITUTE OF TECHNOLOGY             ,OH,44143-2216,Proprietary  ,13,140,153,80,,944,1024
03475400,TRI-STATE BIBLE COLLEGE                 ,OH,45680-8402,Private      ,0,6,6,6,,80,86
03534400,AMERICAN INST OF ALTERNATIVE MEDICI     ,OH,43229-1113,Proprietary  ,8,98,106,78,,693,771
03626300,BROWN AVEDA INSTITUTE                   ,OH,44060-6212,Proprietary  ,26,64,90,199,,339,538
03700300,REGENCY BEAUTY INSTITUTE - CLEVELAND    ,OH,44094-0000,Proprietary  ,25,66,91,236,,479,715
03726300,TEMPLE BAPTIST COLLEGE                  ,OH,45240-0000,Private      ,10,9,19,88,,85,173
03747300,BEXLEY HALL SEMINARY                    ,OH,43209-2325,Private      ,1,5,6,6,,53,59
03776400,HEALING ARTS INSTITUTE                  ,OH,43551-3138,Proprietary  ,2,21,23,19,,68,87
03837300,AVEDA FREDRIC'S INSTITUTE               ,OH,45208-1304,Proprietary  ,22,29,51,172,,243,415
03882300,OREGON CAREER CENTER                    ,OH,43616-2631,Public       ,0,0,0,5,,8,13
04051307,ART INSTITUTE OF PHOENIX (THE) - BROWN M,OH,45215-1107,Proprietary  ,36,167,203,394,,1490,1884
04051308,ART INSTITUTE OF PHOENIX (THE) - BROWN M,OH,44320-4420,Proprietary  ,24,77,101,227,,911,1138
04051317,ART INSTITUTE OF PHOENIX (THE) - BROWN M,OH,45840-6848,Proprietary  ,62,300,362,582,,2561,3143
04051326,ART INSTITUTE OF PHOENIX (THE) - BROWN M,OH,44718-3674,Proprietary  ,19,83,102,149,,774,923
04068300,FOUR COUNTY CAREER CENTER               ,OH,43512-9541,Public       ,1,4,5,11,,52,63
04074300,HONDROS COLLEGE                         ,OH,43081-3855,Proprietary  ,45,368,413,492,,3534,4026
04117300,DAYTON SCHOOL OF MEDICAL MASSAGE        ,OH,45429-1111,Proprietary  ,28,116,144,167,,553,720
04118300,NORTHCOAST MEDICAL TRAINING ACADEMY     ,OH,44240-4174,Proprietary  ,8,34,42,75,,254,329
04124500,TECHSKILLS                              ,OH,43231-0000,Proprietary  ,14,143,157,57,,541,598
04125700,CUT BEAUTY SCHOOL (THE)                 ,OH,44118-2918,Proprietary  ,0,0,0,52,,236,288
04126000,OHIO ACADEMY PAUL MITCHELL PARTNER SCHOO,OH,44087-3107,Proprietary  ,17,30,47,144,,232,376
04137800,AVEDA INSTITUTE COLUMBUS                ,OH,43201-2333,Proprietary  ,36,81,117,317,,551,868
04138000,INSTITUTE OF THERAPEUTIC MASSAGE        ,OH,45875-0350,Proprietary  ,1,13,14,9,,65,74
04149100,CINCINNATI ACADEMY A PAUL MITCHELL PARTN,OH,45241-1702,Proprietary  ,34,50,84,191,,295,486
04151400,VANITY SCHOOL OF COSMETOLOGY            ,OH,44035-0000,Proprietary  ,3,11,14,33,,84,117
04152100,TOLEDO RESTAURANT TRAINING CENTER       ,OH,43604-6508,Private      ,4,15,19,22,,120,142
04152600,PIKE COUNTY CAREER TECHNOLOGY CENTER    ,OH,45661-9114,Public       ,5,23,28,23,,100,123
04153300,OHIO ACADEMY COLUMBUS (THE)             ,OH,43231-6038,Proprietary  ,21,53,74,127,,277,404
04154000,TOLLES CAREER & TECHNICAL CENTER        ,OH,43064-8854,Public       ,0,1,1,12,,25,37
04166800,SALON PROFESSIONAL ACADEMY (THE)        ,OH,45551-0000,Proprietary  ,4,6,10,55,,77,132
04167700,ARTISAN COLLEGE OF COSMETOLOGY (THE)    ,OH,45840-6848,Proprietary  ,1,4,5,28,,40,68
04185900,ELITE SCHOOL OF COSMETOLOGY             ,OH,44857-2714,Proprietary  ,2,10,12,21,,58,79
04189100,TONI & GUY HAIRDRESSING ACADEMY         ,OH,43615-1731,Proprietary  ,10,15,25,103,,148,251
04192200,ATHENA CAREER ACADEMY                   ,OH,43560-2796,Proprietary  ,11,42,53,40,,323,363
04220900,NATIONAL PERSONAL TRAINING INSTITUTE OF ,OH,43235-5739,Proprietary  ,5,31,36,32,,115,147
04225700,LABARBERIA INSTITUTE OF HAIR            ,OH,44106-1923,Proprietary  ,7,27,34,7,,28,35
        ,INVALID SCHOOL CODE                     ,  ,00000-0000,,126,1171,1297,1254,,5378,6632
00134500,ADAMS STATE COLLEGE                     ,CO,81102-2373,Public       ,205,204,409,3090,,2373,5463
00134600,ARAPAHOE COMMUNITY COLLEGE              ,CO,80160-9002,Public       ,297,897,1194,3567,,7499,11066
00134700,COLORADO COLLEGE                        ,CO,80903-3294,Private      ,279,151,430,3517,,1077,4594
00134800,COLORADO SCHOOL OF MINES                ,CO,80401-1887,Public       ,371,103,474,7020,,1544,8564
00134900,UNIVERSITY OF NORTHERN COLORADO         ,CO,80639-0001,Public       ,620,366,986,11476,,5600,17076
00135000,COLORADO STATE UNIVERSITY               ,CO,80523-0100,Public       ,1537,793,2330,27335,,11571,38906
00135200,DENVER  SEMINARY                        ,CO,80120-2192,Private      ,1,75,76,7,,790,797
00135300,FORT LEWIS COLLEGE                      ,CO,81301-3999,Public       ,298,146,444,5179,,1838,7017
00135400,ILIFF SCHOOL OF THEOLOGY                ,CO,80210-0000,Private      ,1,26,27,19,,369,388
00135500,LAMAR COMMUNITY COLLEGE                 ,CO,81052-3999,Public       ,35,45,80,482,,322,804
00135800,COLORADO MESA UNIVERSITY                ,CO,81501-3122,Public       ,455,387,842,8099,,4422,12521
00135900,COLORADO NORTHWESTERN COMMUNITY COLLEGE ,CO,81648-3598,Public       ,37,53,90,454,,482,936
00136000,METROPOLITAN STATE CLG OF DENVER        ,CO,80204-3362,Public       ,950,1633,2583,13532,,18876,32408
00136100,NORTHEASTERN JUNIOR COLLEGE             ,CO,80751-2399,Public       ,87,65,152,1282,,531,1813
00136200,OTERO JUNIOR COLLEGE                    ,CO,81050-3346,Public       ,60,77,137,718,,685,1403
00136300,REGIS UNIVERSITY                        ,CO,80221-1099,Private      ,185,706,891,3629,,9192,12821
00136500,COLORADO STATE UNIVERSITY-PUEBLO        ,CO,81001-4901,Public       ,322,275,597,5636,,3548,9184
00136800,TRINIDAD STATE JR COLLEGE               ,CO,81082-2396,Public       ,53,161,214,822,,1207,2029
00137000,UNIVERSITY OF COLORADO-BOULDER          ,CO,80309-0077,Public       ,1626,623,2249,27418,,10372,37790
00137100,UNIVERSITY OF DENVER                    ,CO,80208-2000,Private      ,682,618,1300,10978,,10698,21676
00137200,WESTERN STATE COLLEGE                   ,CO,81231-0000,Public       ,123,52,175,2458,,670,3128
00405702,NATIONAL AMERICAN UNIVERSITY - COLORADO ,CO,80920-4001,Proprietary  ,12,58,70,52,,520,572
00405703,NATIONAL AMERICAN UNIVERSITY            ,CO,80222-0000,Proprietary  ,4,28,32,33,,380,413
00450300,EVEREST COLLEGE                         ,CO,80916-3548,Proprietary  ,28,178,206,215,,1390,1605
00450600,COLORADO MOUNTAIN COLLEGE               ,CO,81602-0000,Public       ,137,240,377,1753,,2165,3918
00450700,EVEREST COLLEGE                         ,CO,80229-4339,Proprietary  ,20,122,142,144,,653,797
00450701,"EVEREST COLLEGE- EVEREST COLLEGE, AURORA",CO,80012-5692,Proprietary  ,28,132,160,188,,746,934
00450800,UNIVERSITY OF COLORADO DENVER           ,CO,80204-2029,Public       ,821,1164,1985,10363,,16704,27067
00450900,UNIV OF COLORADO AT COLO SPRINGS        ,CO,80918-3735,Public       ,658,604,1262,10154,,7302,17456
00559600,EMILY GRIFFITH OPPORTUNITY SCH          ,CO,80204-2197,Public       ,84,389,473,728,,2518,3246
00729700,REDSTONE COLLEGE                        ,CO,80020-9988,Proprietary  ,36,129,165,316,,878,1194
00732912,ITT TECHNICAL INSTITUTE                 ,CO,80229-5338,Proprietary  ,62,260,322,298,,1505,1803
00754800,WESTWOOD COLLEGE - DENVER NORTH         ,CO,80221-3653,Proprietary  ,26,142,168,283,,1284,1567
00754801,WESTWOOD COLLEGE - DENVER SOUTH         ,CO,80227-3653,Proprietary  ,19,102,121,158,,886,1044
00757306,EMPIRE BEAUTY SCHOOL - THORNTON         ,CO,80241-1659,Proprietary  ,0,0,0,77,,148,225
00758200,AIMS COMMUNITY COLLEGE                  ,CO,80632-0000,Public       ,215,498,713,2485,,4133,6618
00764900,ROCKY MOUNTAIN COLG OF ART & DESIGN     ,CO,80214-0000,Proprietary  ,69,149,218,858,,927,1785
00793300,FRONT RANGE COMMUNITY COLLEGE           ,CO,80031-2199,Public       ,670,1573,2243,8158,,14581,22739
00793806,LINCOLN COLLEGE OF TECHNOLOGY - DENVER  ,CO,80239-3006,Proprietary  ,187,182,369,1324,,1170,2494
00863500,INTELLITEC MEDICAL INSTITUTE            ,CO,80909-0000,Proprietary  ,27,108,135,149,,617,766
00887100,CONCORDE CAREER INSTITUTE               ,CO,80203-0000,Proprietary  ,60,212,272,492,,1835,2327
00889600,PIKES PEAK COMMUNITY COLLEGE            ,CO,80906-5498,Public       ,446,1805,2251,5422,,14257,19679
00940100,COLORADO CHRISTIAN UNIVERSITY           ,CO,80226-7449,Private      ,147,524,671,2219,,4658,6877
00945914,EMPIRE BEAUTY SCHOOL - ARVADA           ,CO,80003-4434,Proprietary  ,0,0,0,69,,156,225
00954200,COMMUNITY COLLEGE OF DENVER             ,CO,80217-2026,Public       ,527,1430,1957,6397,,12640,19037
00954300,RED ROCKS COMMUNITY COLLEGE             ,CO,80228-1255,Public       ,311,756,1067,3467,,6840,10307
00966407,EMPIRE BEAUTY SCHOOL - LAKEWOOD         ,CO,80266-5107,Proprietary  ,0,0,0,37,,104,141
00998100,MORGAN COMMUNITY COLLEGE                ,CO,80701-4399,Public       ,33,109,142,369,,1005,1374
01014800,COLORADO TECHNICAL UNIVERSITY           ,CO,80907-3896,Proprietary  ,65,567,632,475,,5218,5693
01014802,COLORADO TECHNICAL UNIV - DENVER        ,CO,80111-3201,Proprietary  ,16,127,143,149,,1089,1238
01014805,COLORADO TECH UNIV - ON LINE            ,CO,80907-0000,Proprietary  ,377,5616,5993,1998,,40073,42071
01014812,COLORADO TECHNICAL UNIVERSITY - WESTMINS,CO,80021-3498,Proprietary  ,11,92,103,107,,792,899
01014815,COLORADO TECHNCL UNIV PUEBLO            ,CO,81003-2315,Proprietary  ,10,57,67,99,,412,511
01157200,COLORADO SCHOOL OF TRADES               ,CO,80215-2996,Proprietary  ,14,61,75,97,,477,574
01267000,BEL-REA INST OF ANIMAL TECH             ,CO,80247-3048,Proprietary  ,33,72,105,464,,728,1192
01285000,INTERNATIONAL SALON AND SPA ACADEMY     ,CO,80918-3684,Proprietary  ,17,75,92,101,,363,464
01287500,PICKENS TECHNICAL COLLEGE               ,CO,80011-9307,Public       ,40,160,200,429,,1095,1524
01300700,NAZARENE BIBLE COLLEGE                  ,CO,80910-3717,Private      ,7,67,74,74,,704,778
02078900,ART INSTITUTE OF COLORADO (THE)         ,CO,80203-2983,Proprietary  ,299,302,601,2098,,2427,4525
02116300,PUEBLO COMMUNITY COLLEGE                ,CO,81004-0000,Public       ,201,733,934,2278,,6228,8506
02117500,NAROPA UNIVERSITY                       ,CO,80302-0000,Private      ,37,78,115,396,,1333,1729
02141100,EMPIRE BEAUTY SCHOOL-LITTLETON          ,CO,80030-0000,Proprietary  ,0,0,0,88,,185,273
02156200,DELTA - MONTROSE TECHNICAL COLLEGE      ,CO,81416-0000,Public       ,6,42,48,94,,292,386
02165200,SALON PROFESSIONAL ACADEMY (THE)        ,CO,81504-5309,Proprietary  ,6,14,20,80,,115,195
02167600,KAPLAN COLLEGE                          ,CO,80229-5309,Proprietary  ,0,0,0,10,,64,74
02211901,CHEEKS INTERNATIONAL ACADEMY OF BEAUTY C,CO,80525-3053,Proprietary  ,0,11,11,31,,95,126
02211902,CHEEKS INTERNATIONAL ACDMY BTY CULT     ,CO,80631-0000,Proprietary  ,2,11,13,26,,61,87
02253700,INTELLITEC COLLEGE                      ,CO,80909-0000,Proprietary  ,38,211,249,185,,911,1096
02267500,GLENWOOD BEAUTY ACADEMY                 ,CO,81601-0000,Proprietary  ,4,5,9,19,,51,70
02276900,COMMUNITY COLLEGE OF AURORA             ,CO,80011-9036,Public       ,298,931,1229,3237,,7728,10965
02296004,PRINCE INSTITUTE - SOUTHEAST - PRINCE IN,CO,80031-2943,Proprietary  ,0,3,3,6,,99,105
02518500,HAIR DYNAMICS EDUCATION CENTER          ,CO,80525-0000,Proprietary  ,13,35,48,98,,208,306
02594300,COLLEGE AMERICA - DENVER                ,CO,80222-3380,Proprietary  ,58,282,340,425,,2339,2764
02611000,HERITAGE COLLEGE                        ,CO,80212-7413,Proprietary  ,54,137,191,253,,734,987
03006300,INST OF BUSINESS & MEDICAL CAREERS      ,CO,80525-3044,Proprietary  ,50,197,247,409,,1474,1883
03010622,VIRGINIA COLLEGE - ECOTECH INSTITUTE - A,CO,80014-1405,Proprietary  ,10,33,43,81,,348,429
03012100,REMINGTON COLLEGE - COLORADO SPRINGS CAM,CO,80215-0000,Private      ,0,7,7,11,,40,51
03013100,BOULDER COLLEGE OF MASSAGE THERAPY      ,CO,80301-3295,Private      ,0,0,0,57,,135,192
03014900,PLATT COLLEGE                           ,CO,80014-3141,Proprietary  ,7,42,49,65,,338,403
03027400,XENON INTERNATIONAL ACADEMY III         ,CO,80014-1193,Proprietary  ,7,18,25,66,,142,208
03030606,UTAH COLLEGE OF MASSAGE THERAPY - DENVER,CO,80031-2921,Proprietary  ,10,31,41,54,,165,219
03030607,UTAH COLLEGE OF MASSAGE THERAPY - DENVER,CO,80012-2523,Proprietary  ,13,31,44,98,,210,308
03066900,INTELLITEC COLLEGE                      ,CO,81506-3994,Proprietary  ,38,125,163,208,,735,943
03068201,OHIO CENTER FOR BROADCASTING - COLORADO ,CO,80214-4129,Proprietary  ,10,37,47,48,,185,233
03076401,BRYMAN SCHOOL OF ARIZONA (THE) - ANTHEM ,CO,80014-2622,Proprietary  ,3,17,20,83,,197,280
03289300,COLORADO HEIGHTS UNIVERSITY             ,CO,80236-2711,Private      ,25,76,101,156,,487,643
03306300,MONTESSORI EDUC CRT OF THE ROCKIES      ,CO,80301-2587,Private      ,2,7,9,5,,65,70
03534300,JONES INTERNATIONAL UNIVERSITY          ,CO,80112-3446,Proprietary  ,38,935,973,173,,5275,5448
03545300,UNIVERSITY OF THE ROCKIES               ,CO,80903-3612,Proprietary  ,13,396,409,109,,2785,2894
03584400,COLORADO SCHOOL OF HEALING ARTS         ,CO,80226-4332,Proprietary  ,3,38,41,81,,321,402
03670300,TONI & GUY HAIRDRESSING ACADEMY         ,CO,80911-0000,Proprietary  ,16,53,69,141,,246,387
03686300,COLORADO SCHOOL OF TRADITIONAL CHINESE M,CO,80206-2127,Proprietary  ,2,33,35,18,,261,279
03776300,CULINARY SCHOOL OF THE ROCKIES          ,CO,80305-5961,Proprietary  ,32,57,89,297,,389,686
03976300,MASSAGE THERAPY INSTITUTE OF COLORADO   ,CO,80206-2127,Proprietary  ,8,46,54,81,,257,338
04080300,ASPEN UNIVERSITY                        ,CO,80246-1930,Proprietary  ,15,138,153,143,,918,1061
04093300,ACADEMY OF NATURAL THERAPY              ,CO,80631-3425,Proprietary  ,10,27,37,45,,134,179
04121200,INSTITUTE OF TAOIST EDUCATION AND ACUPUN,CO,80027-1028,Private      ,0,6,6,2,,60,62
04125100,MONTESSORI CASA INTERNATIONAL           ,CO,80111-5263,Private      ,0,4,4,1,,11,12
04127700,AMERICAN SENTINEL UNIVERSITY            ,CO,80014-6510,Proprietary  ,5,253,258,28,,1775,1803
04139300,NATIONAL BEAUTY COLLEGE                 ,CO,80221-0000,Proprietary  ,7,23,30,46,,175,221
04148300,DENVER SCHOOL OF NURSING                ,CO,80202-1213,Proprietary  ,50,190,240,414,,1453,1867
04151100,SUMMIT SALON & BEAUTY SCHOOL            ,CO,80866-4569,Proprietary  ,1,6,7,7,,18,25
04167100,AVEDA INSTITUTE DENVER                  ,CO,80202-0000,Proprietary  ,36,66,102,357,,568,925
04170200,PAUL MITCHELL THE SCHOOL COLORADO SPRING,CO,80903-0000,Proprietary  ,19,53,72,181,,357,538
04172500,ROLF INSTITUTE OF STRUCTURAL INTEGRATION,CO,80301-0000,Private      ,2,15,17,12,,112,124
04173800,SALON PROFESSIONAL ACADEMY (THE)        ,CO,80918-2932,Proprietary  ,7,29,36,74,,162,236
04177100,PIMA MEDICAL INSTITUTE-SOUTH DENVER     ,CO,80231-0000,Proprietary  ,34,125,159,291,,789,1080
04179700,UNITED BEAUTY COLLEGE                   ,CO,80223-2936,Proprietary  ,7,27,34,50,,127,177
04183700,HEALING ARTS INSTITUTE                  ,CO,80525-3479,Proprietary  ,3,21,24,50,,162,212
04184900,COLLEGE OF INTERNATIONAL ESTHETICS      ,CO,80002-3754,Proprietary  ,4,30,34,31,,167,198
04185000,COLORADO ACADEMY OF VETERINARY TECHNOLOG,CO,80906-4944,Proprietary  ,9,36,45,133,,246,379
04185400,NATIONAL PERSONAL TRAINING INSTITUTE OF ,CO,80401-3304,Proprietary  ,6,26,32,25,,137,162
04195300,LONGS PEAK ACADEMY                      ,CO,80501-6458,Proprietary  ,8,20,28,65,,147,212
04202600,NEW DIMENSIONS BEAUTY ACADEMY           ,CO,80138-9801,Proprietary  ,0,12,12,26,,64,90
04208700,COLORADO STATE UNIVERSITY - GLOBAL CAMPU,CO,80111-0000,Public       ,45,961,1006,445,,7134,7579
04218900,ROCKY VISTA UNIVERSITY COLLEGE OF OSTEOP,CO,80134-9498,Proprietary  ,0,4,4,4,,617,621
04221400,PAUL MITCHELL THE SCHOOL DENVER         ,CO,80226-7395,Proprietary  ,16,26,42,45,,59,104
00267811,BRYANT & STRATTON COLLEGE - VIRGINIA BEA,VA,23462-4417,Proprietary  ,84,465,549,784,,3815,4599
00370200,AVERETT UNIVERSITY                      ,VA,24541-3692,Private      ,38,219,257,1760,,1719,3479
00370300,BLUEFIELD COLLEGE                       ,VA,24605-1799,Private      ,32,60,92,923,,728,1651
00370400,BRIDGEWATER COLLEGE                     ,VA,22812-1599,Private      ,78,23,101,3597,,253,3850
00370500,COLLEGE OF WILLIAM & MARY               ,VA,23187-8795,Public       ,363,162,525,11496,,4605,16101
00370600,CHRISTOPHER NEWPORT UNIVERSITY          ,VA,23606-3072,Public       ,246,130,376,8719,,1589,10308
00370700,RICHARD BLAND COLLEGE                   ,VA,23805-7100,Public       ,56,57,113,1513,,731,2244
00370800,EASTERN MENNONITE UNIVERSITY            ,VA,22802-2462,Private      ,26,53,79,1329,,650,1979
00370900,EMORY & HENRY COLLEGE                   ,VA,24327-0010,Private      ,22,18,40,1567,,181,1748
00371100,FERRUM COLLEGE                          ,VA,24088-2612,Private      ,72,23,95,3167,,358,3525
00371200,TIDEWATER COMMUNITY COLLEGE             ,VA,23510-1910,Public       ,956,3424,4380,12424,,28141,40565
00371300,HAMPDEN-SYDNEY COLLEGE                  ,VA,23943-0128,Private      ,40,9,49,1610,,73,1683
00371400,HAMPTON UNIVERSITY                      ,VA,23668-0099,Private      ,318,249,567,9023,,3846,12869
00371500,HOLLINS UNIVERSITY                      ,VA,24020-0000,Private      ,21,46,67,800,,653,1453
00371900,LONGWOOD UNIVERSITY                     ,VA,23909-1899,Public       ,152,81,233,5962,,1051,7013
00372000,LYNCHBURG COLLEGE                       ,VA,24501-3199,Private      ,83,67,150,3990,,1249,5239
00372100,JAMES MADISON UNIVERSITY                ,VA,22807-3780,Public       ,696,212,908,26240,,3316,29556
00372300,MARY BALDWIN COLLEGE                    ,VA,24401-3610,Private      ,44,100,144,1788,,1233,3021
00372400,MARYMOUNT UNIVERSITY                    ,VA,22207-4224,Private      ,104,203,307,3176,,2701,5877
00372600,NATIONAL COLLEGE                        ,VA,24153-4524,Proprietary  ,58,529,587,549,,4867,5416
00372700,NORTHERN VA CMTY CLG                    ,VA,22003-3743,Public       ,1284,2813,4097,18350,,23496,41846
00372800,OLD DOMINION UNIVERSITY                 ,VA,23529-0052,Public       ,677,1326,2003,20551,,16885,37436
00373200,RADFORD UNIVERSITY                      ,VA,24142-6905,Public       ,293,155,448,11507,,3077,14584
00373300,RANDOLPH-MACON COLLEGE                  ,VA,23005-5505,Private      ,70,18,88,2758,,202,2960
00373400,RANDOLPH COLLEGE                        ,VA,24503-1526,Private      ,19,13,32,1083,,224,1307
00373500,VIRGINIA COMMONWEALTH UNIVERSITY        ,VA,23284-9004,Public       ,858,883,1741,26575,,15774,42349
00373600,ROANOKE COLLEGE                         ,VA,24153-3794,Private      ,68,28,96,3567,,333,3900
00373700,SHENANDOAH UNIVERSITY                   ,VA,22601-5195,Private      ,96,136,232,2990,,2421,5411
00373800,SOUTHERN VIRGINIA UNIVERSITY            ,VA,24416-3038,Private      ,75,27,102,1098,,382,1480
00373900,ST PAULS COLLEGE                        ,VA,23868-1299,Private      ,0,0,0,114,,123,237
00374200,SWEET BRIAR COLLEGE                     ,VA,24595-9998,Private      ,24,12,36,1065,,111,1176
00374300,UNION PRESBYTERIAN SEMINARY             ,VA,23227-0000,Private      ,1,9,10,6,,113,119
00374400,UNIVERSITY OF RICHMOND                  ,VA,23173-0001,Private      ,228,160,388,6803,,3192,9995
00374500,UNIVERSITY OF VIRGINIA - SFS            ,VA,22903-0000,Public       ,668,343,1011,22206,,8815,31021
00374600,UNIVERSITY OF MARY WASHINGTON           ,VA,22401-5358,Public       ,193,145,338,5537,,1632,7169
00374700,UNIV OF VIRGINIA'S COLLEGE AT WISE      ,VA,24293-4412,Public       ,37,48,85,2037,,650,2687
00374800,EASTERN SHORE COMMUNITY COLLEGE         ,VA,23410-3001,Public       ,47,109,156,405,,728,1133
00374900,GEORGE MASON UNIVERSITY                 ,VA,22030-4444,Public       ,773,1032,1805,24378,,16873,41251
00375100,PATRICK HENRY COMMUNITY COLLEGE         ,VA,24112-5311,Public       ,60,285,345,1264,,2351,3615
00375200,VIRGINIA INTERMONT COLLEGE              ,VA,24201-4298,Private      ,13,17,30,533,,275,808
00375300,VIRGINIA MILITARY INSTITUTE             ,VA,24450-2138,Public       ,88,18,106,2414,,137,2551
00375400,VIRGINIA POLYTECH INST & STATE UNIV     ,VA,24061-2000,Public       ,616,323,939,27093,,6075,33168
00375800,DANVILLE COMMUNITY COLLEGE              ,VA,24541-4004,Public       ,138,359,497,1655,,2914,4569
00375900,J. SARGEANT REYNOLDS COMMUNITY CLG      ,VA,23285-0000,Public       ,441,1430,1871,6096,,13004,19100
00376000,VIRGINIA WESTERN CMTY COLLEGE           ,VA,24038-0000,Public       ,195,630,825,3411,,4981,8392
00376100,WYTHEVILLE COMMUNITY COLLEGE            ,VA,24382-3308,Public       ,46,221,267,1304,,2002,3306
00376200,VIRGINIA UNIVERSITY OF LYNCHBURG        ,VA,24501-6400,Private      ,18,47,65,443,,750,1193
00376400,VIRGINIA STATE UNIVERSITY               ,VA,23806-0001,Public       ,248,256,504,10185,,4025,14210
00376500,NORFOLK STATE UNIVERSITY                ,VA,23504-8000,Public       ,258,574,832,9517,,8377,17894
00376600,VIRGINIA UNION UNIVERSITY               ,VA,23220-1711,Private      ,108,142,250,2869,,1699,4568
00376700,VIRGINIA WESLEYAN COLLEGE               ,VA,23502-5599,Private      ,82,96,178,3387,,1110,4497
00376800,WASHINGTON & LEE UNIVERSITY             ,VA,24450-0303,Private      ,98,17,115,3411,,1136,4547
00400400,JOHN TYLER COMMUNITY COLLEGE            ,VA,23831-5316,Public       ,282,762,1044,4392,,6681,11073
00450301,"EVEREST COLLEGE- EVEREST COLLEGE, MCLEAN",VA,22102-3000,Proprietary  ,12,64,76,82,,415,497
00450702,"EVEREST COLLEGE- EVEREST COLLEGE, ARLING",VA,22203-1905,Proprietary  ,0,0,0,42,,159,201
00498800,CENTRAL VIRGINIA COMMUNITY COLLEGE      ,VA,24502-2498,Public       ,134,325,459,1972,,2720,4692
00499200,MILLER-MOTTE TECHNICAL COLLEGE          ,VA,24505-0000,Proprietary  ,33,178,211,367,,1370,1737
00499600,DABNEY S LANCASTER COMMUNITY CLG        ,VA,24422-1000,Public       ,33,84,117,595,,659,1254
00522300,NEW RIVER COMMUNITY COLLEGE             ,VA,24084-1127,Public       ,90,270,360,1722,,2623,4345
00662200,COLLEGE OF HEALTH SCIENCES - CHRV       ,VA,24031-0000,Private      ,19,71,90,679,,1204,1883
00681900,BLUE RIDGE COMMUNITY COLLEGE            ,VA,24486-0080,Public       ,124,310,434,2329,,2768,5097
00687100,THOMAS NELSON COMMUNITY COLLEGE         ,VA,23670-0000,Public       ,409,1210,1619,4752,,10661,15413
00709900,VIRGINIA HIGHLANDS COMMUNITY CLG        ,VA,24210-4210,Public       ,51,198,249,1173,,1798,2971
00726000,SOUTHWEST VIRGINIA COMMUNITY CLG        ,VA,24641-0000,Public       ,39,174,213,1203,,1822,3025
00859200,LOUISE OBICI SCHOOL OF NURSING          ,VA,23434-8038,Private      ,0,0,0,4,,23,27
00865900,LORD FAIRFAX COMMUNITY COLLEGE          ,VA,22645-0047,Public       ,180,439,619,2506,,3521,6027
00866000,GERMANNA COMMUNITY COLLEGE              ,VA,22508-0339,Public       ,257,563,820,3186,,4571,7757
00866100,SOUTHSIDE VIRGINIA CMTY CLG             ,VA,23821-2930,Public       ,163,496,659,1805,,3108,4913
00915900,PAUL D CAMP COMMUNITY COLLEGE           ,VA,23851-0737,Public       ,40,161,201,555,,1367,1922
00916000,RAPPAHANNOCK COMMUNITY COLLEGE          ,VA,23149-2616,Public       ,52,183,235,960,,1592,2552
00926700,EVEREST COLLEGE                         ,VA,23606-4203,Proprietary  ,30,156,186,202,,1092,1294
00926701,EVEREST COLLEGE - CHESAPEAKE            ,VA,23320-2637,Proprietary  ,36,207,243,262,,1324,1586
00942000,SANFORD-BROWN COLLEGE                   ,VA,22182-3913,Proprietary  ,4,14,18,45,,273,318
00953500,STAUNTON SCHOOL OF COSMETOLOGY          ,VA,24401-4323,Proprietary  ,1,6,7,25,,73,98
00953700,VIRGINIA SCH OF HAIR DESIGN             ,VA,23669-0000,Proprietary  ,3,29,32,56,,231,287
00962900,MOUNTAIN EMPIRE COMMUNITY COLLEGE       ,VA,24219-0700,Public       ,45,190,235,1162,,1851,3013
00992800,PIEDMONT VIRGINIA COMMUNITY COLLEGE     ,VA,22902-7589,Public       ,119,398,517,1950,,3205,5155
01004300,BON SECOURS MEMORIAL COLLEGE OF NURSING ,VA,23227-4612,Private      ,23,109,132,375,,936,1311
01019800,ECPI UNIVERSITY                         ,VA,23462-6542,Proprietary  ,201,1063,1264,2549,,11068,13617
01019802,ECPI UNIVERSITY - NEWPORT NEWS          ,VA,23606-4298,Proprietary  ,25,177,202,25,,179,204
01019807,ECPI UNIVERSITY - MANASSAS              ,VA,20109-2665,Proprietary  ,24,101,125,24,,101,125
01019813,ECPI UNIVERSITY - CULINARY INSTITUTE OF ,VA,23513-2448,Proprietary  ,13,57,70,13,,59,72
01019814,ECPI UNIVERSITY - VIRGINIA BEACH HEALTH ,VA,23462-6540,Proprietary  ,27,103,130,27,,105,132
01019815,ECPI UNIVERSITY - RICHMOND SOUTH        ,VA,23236-3659,Proprietary  ,33,115,148,33,,115,148
01019816,ECPI UNIVERSITY - INNSBROOK             ,VA,23060-3359,Proprietary  ,15,37,52,15,,37,52
01019817,ECPI UNIVERSITY - RICHMOND WEST         ,VA,23294-3730,Proprietary  ,21,81,102,21,,82,103
01033800,EASTERN VIRGINIA MEDICAL SCHOOL         ,VA,23501-1980,Public       ,12,67,79,146,,1975,2121
01159600,SYLVAIN MELLOUL INTERNATIONAL HAIR ACADE,VA,24502-2652,Proprietary  ,5,13,18,49,,141,190
01162601,WESTWOOD COLLEGE - SOUTH BAY - ARLINGTON,VA,22203-4167,Proprietary  ,31,87,118,209,,704,913
01162602,WESTWOOD COLLEGE - SOUTH BAY - ANNANDALE,VA,22003-2602,Proprietary  ,22,89,111,136,,564,700
01274400,SOUTHSIDE REGIONAL MED CTR PROF SCHOOLS ,VA,23803-5133,Proprietary  ,9,34,43,109,,358,467
02053000,LIBERTY UNIVERSITY                      ,VA,24502-0000,Private      ,969,9584,10553,21483,,86824,108307
02083602,TESST COLLEGE OF TECHNOLOGY - KAPLAN COL,VA,23320-4422,Proprietary  ,0,0,0,8,,104,112
02108800,WARDS CORNER BEAUTY ACADEMY             ,VA,23505-0000,Proprietary  ,14,58,72,95,,449,544
02111600,DANVILLE REGIONAL MEDICAL CENTER SCHOOL ,VA,24541-0000,Proprietary  ,4,10,14,47,,125,172
02119203,COURT REPORTING INSTITUTE OF DALLAS - CO,VA,22203-4179,Proprietary  ,0,2,2,7,,41,48
02128700,CENTRAL SCHOOL OF PRACTICAL NURSING     ,VA,23502-2230,Public       ,8,37,45,121,,402,523
02140000,RIVERSIDE SCHOOL OF HEALTH CAREERS      ,VA,23608-3802,Private      ,16,62,78,231,,820,1051
02149901,PAUL MITCHELL THE SCHOOL-JACKSONVILLE - ,VA,22102-0000,Proprietary  ,12,18,30,73,,121,194
02149902,PAUL MITCHELL THE SCHOOL-JACKSONVILLE - ,VA,22192-0000,Proprietary  ,17,41,58,73,,176,249
02175800,LYNCHBURG GENERAL HOSP SCH OF NURSG     ,VA,24501-0000,Private      ,10,33,43,141,,364,505
02197600,WOODROW WILSON REHABILITATION CTR       ,VA,22939-0000,Public       ,14,11,25,54,,40,94
02242400,HENRICO CTY ST MARYS HOSP PRAC NRSG     ,VA,23075-0000,Public       ,3,5,8,29,,88,117
02320900,TIDEWATER TECH                          ,VA,23502-1747,Proprietary  ,36,179,215,342,,1245,1587
02334400,CENTURA COLLEGE                         ,VA,23452-0000,Proprietary  ,53,293,346,457,,2975,3432
02342700,FORTIS COLLEGE                          ,VA,23502-4101,Proprietary  ,29,164,193,220,,1064,1284
02342701,FORTIS COLLEGE - RICHMOND CAMPUS        ,VA,23236-3472,Proprietary  ,37,148,185,287,,953,1240
02358500,BON SECOURS SAINT MARY'S HOSPITAL SCHOOL,VA,23227-4612,Private      ,8,43,51,128,,446,574
02538800,SUFFOLK BEAUTY ACADEMY                  ,VA,23434-0000,Proprietary  ,6,19,25,32,,123,155
02541200,STRATFORD UNIVERSITY                    ,VA,22043-0000,Proprietary  ,66,341,407,591,,2557,3148
02541201,STRATFORD UNIVERSITY-WOODBRIDGE         ,VA,22192-0000,Proprietary  ,10,109,119,241,,1146,1387
02588900,MEDTECH INSTITUTE                       ,VA,22042-3013,Proprietary  ,64,289,353,366,,1427,1793
02610100,WASHINGTON COUNTY ADULT SKILL CTR       ,VA,24210-2346,Public       ,5,31,36,49,,188,237
02617508,EVEREST COLLEGE - WOODBRIDGE            ,VA,22192-6808,Proprietary  ,6,48,54,6,,48,54
03002400,GRAHAM WEBB INTERNATIONAL ACAD HAIR     ,VA,22209-2129,Proprietary  ,9,23,32,61,,143,204
03010700,BAR PALMA BEAUTY CAREERS  ACADEMY       ,VA,24014-2255,Proprietary  ,2,29,31,35,,187,222
03042800,"VIRGINIA BEACH CITY SCHOOLS, SCH.-PR.NSG",VA,23456-0038,Public       ,9,25,34,76,,238,314
03091300,REGENT UNIVERSITY                       ,VA,23464-9800,Private      ,80,649,729,1896,,7016,8912
03092700,SKYLINE COLLEGE                         ,VA,24012-1603,Proprietary  ,7,71,78,104,,476,580
03096500,SPRINGFIELD BEAUTY ACADEMY              ,VA,22003-3016,Proprietary  ,1,12,13,13,,114,127
03106500,SENTARA NORFOLK GENERAL HOSPITAL        ,VA,23320-2843,Private      ,15,106,121,191,,857,1048
03116900,BAPTIST THEOLOGICAL SEM.-RICHMOND       ,VA,23227-0000,Private      ,4,17,21,10,,173,183
03126300,AVIATION INSTITUTE OF MAINTENANCE       ,VA,23320-5987,Proprietary  ,17,80,97,108,,482,590
03126400,CENTURA COLLEGE                         ,VA,23235-5230,Proprietary  ,23,145,168,204,,1123,1327
03127500,ADVANCED TECHNOLOGY INSTITUTE           ,VA,23462-2409,Proprietary  ,53,149,202,573,,918,1491
03280400,VIRGINIA SCHOOL OF MASSAGE              ,VA,22903-0000,Proprietary  ,8,39,47,58,,196,254
03409500,RICHMOND SCHOOL OF HEALTH AND TECH      ,VA,23227-0000,Proprietary  ,11,65,76,136,,622,758
03455300,CRESCENT COSMETOLOGY UNIVERSITY         ,VA,23666-3115,Proprietary  ,2,6,8,18,,82,100
03559300,APPALACHIAN SCHOOL OF LAW               ,VA,24614-0000,Private      ,1,8,9,12,,440,452
03645400,RUDY & KELLY ACADEMY OF HAIR AND NA     ,VA,23464-6857,Proprietary  ,26,46,72,158,,388,546
03654300,CAREER TRAINING SOLUTIONS               ,VA,22406-1014,Proprietary  ,23,104,127,162,,799,961
03709300,EDWARD VIA VIRGINIA CLG OSTEOPATHIC MED ,VA,24060-6360,Private      ,0,4,4,14,,888,902
03862600,VIRGINIA BAPTIST COLLEGE                ,VA,22407-0000,Private      ,10,16,26,10,,17,27
03872400,INSTITUTE FOR THE PSYCHOLOGICAL SCIENCES,VA,22202-3609,Private      ,2,10,12,21,,170,191
03876300,CULPEPER COSMETOLOGY TRAINING CENTER    ,VA,22701-3155,Public       ,3,10,13,32,,76,108
03883400,AVIATION INSTITUTE OF MAINTENANCE       ,VA,20110-4156,Proprietary  ,4,57,61,86,,332,418
04038400,AVI CAREER INSTITUTE                    ,VA,22066-1839,Proprietary  ,2,20,22,8,,102,110
04110300,UNIVERSITY OF MANAGEMENT AND TECHNOLOGY ,VA,22209-1609,Proprietary  ,2,83,85,28,,479,507
04124000,DOMINION SCHOOL OF HAIR DESIGN          ,VA,23062-2221,Proprietary  ,4,8,12,19,,56,75
04127300,COLUMBIA COLLEGE                        ,VA,22031-4413,Proprietary  ,10,128,138,74,,538,612
04133400,CENTURA COLLEGE                         ,VA,22312-2670,Proprietary  ,17,83,100,98,,490,588
04133800,SOUTHEAST CULINARY & HOSPITALITY COLLEGE,VA,24201-4159,Proprietary  ,0,0,0,29,,36,65
04137300,CAYCE/REILLY SCHOOL OF MASSOTHERAPY     ,VA,23451-2061,Private      ,1,14,15,22,,103,125
04140000,GLOBAL HEALTH NURSE TRAINING SERVICES   ,VA,22314-4585,Proprietary  ,4,85,89,56,,646,702
04153800,BETHEL COLLEGE                          ,VA,23666-3122,Private      ,6,18,24,65,,154,219
04156200,INSTITUTE OF ADVANCED MEDICAL ESTHETICS ,VA,23294-4701,Proprietary  ,1,20,21,27,,146,173
04169400,NORTHERN VIRGINIA SCHOOL OF THERAPEUTIC ,VA,22046-4302,Proprietary  ,6,26,32,49,,161,210
04171500,COSMOPOLITAN BEAUTY & TECH SCHOOL       ,VA,22003-3204,Proprietary  ,2,34,36,27,,198,225
04179900,TOMORROW'S IMAGE BARBER ACADEMY OF VIRGI,VA,23602-5532,Proprietary  ,1,12,13,18,,88,106
04180600,APPALACHIAN COLLEGE OF PHARMACY         ,VA,24631-9210,Private      ,2,13,15,17,,315,332
04218600,VIRGINIA TECH CARILION SCHOOL OF MEDICIN,VA,24016-4950,Private      ,6,12,18,6,,12,18
04220400,CHRYSM INSTITUTE OF ESTHETICS (THE)     ,VA,23462-3650,Proprietary  ,2,21,23,18,,124,142
04221000,"STANDARD HEALTHCARE SERVICES, COLLEGE OF",VA,22046-4612,Proprietary  ,5,79,84,7,,110,117
00107000,THUNDERBIRD SCHOOL OF GLOBAL MANAGEMENT ,AZ,85306-6000,Private      ,5,76,81,42,,674,716
00107100,ARIZONA WESTERN COLLEGE                 ,AZ,85366-0000,Public       ,302,607,909,5035,,5204,10239
00107200,COCHISE COLLEGE                         ,AZ,85607-6190,Public       ,114,408,522,1712,,2956,4668
00107300,EASTERN ARIZONA COLLEGE                 ,AZ,85552-0769,Public       ,115,223,338,1658,,1723,3381
00107400,GRAND CANYON UNIVERSITY                 ,AZ,85017-3030,Proprietary  ,960,10150,11110,14239,,64358,78597
00107600,GLENDALE COMMUNITY COLLEGE              ,AZ,85302-3090,Public       ,879,1731,2610,11995,,16059,28054
00107700,MESA COMMUNITY COLLEGE                  ,AZ,85202-4866,Public       ,864,2201,3065,12058,,20128,32186
00107800,PHOENIX COLLEGE                         ,AZ,85013-4234,Public       ,458,2105,2563,6825,,16639,23464
00107900,YAVAPAI COLLEGE                         ,AZ,86301-3297,Public       ,215,633,848,2196,,4819,7015
00108100,ARIZONA STATE UNIV (ALL CAMPUSES)       ,AZ,85287-0412,Public       ,2407,3762,6169,59019,,47727,106746
00108200,NORTHERN ARIZONA UNIVERSITY             ,AZ,86011-0001,Public       ,1082,1080,2162,32302,,15646,47948
00108300,UNIVERSITY OF ARIZONA                   ,AZ,85721-0066,Public       ,1226,1144,2370,34498,,17436,51934
00165701,MIDWESTERN UNIVERSITY                   ,AZ,85308-0000,Private      ,11,94,105,207,,4224,4431
00446700,TUCSON COLLEGE                          ,AZ,85711-3781,Proprietary  ,46,159,205,325,,862,1187
00711300,ARIZONA CHRISTIAN UNIVERSITY            ,AZ,85032-7097,Private      ,55,67,122,1099,,639,1738
00726600,PIMA COUNTY COMMUNITY COLLEGE           ,AZ,85709-1110,Public       ,716,2047,2763,11362,,17601,28963
00728300,CENTRAL ARIZONA COLLEGE                 ,AZ,85228-9779,Public       ,234,598,832,3078,,5266,8344
00732911,ITT TECHNICAL INSTITUTE                 ,AZ,85282-9272,Proprietary  ,85,405,490,640,,2969,3609
00732990,ITT TECHNICAL INSTITUTE                 ,AZ,85704-5829,Proprietary  ,145,448,593,759,,2572,3331
00822100,UNIVERSAL TECHNICAL INSTITUTE           ,AZ,85323-7946,Proprietary  ,801,885,1686,8828,,7000,15828
00824600,DINÉ COLLEGE                            ,AZ,86556-0126,Public       ,77,165,242,852,,1406,2258
00830300,GATEWAY COMMUNITY COLLEGE               ,AZ,85034-1795,Public       ,254,1139,1393,3613,,9613,13226
00830302,MARICOPA SKILL CENTER                   ,AZ,85034-0000,Public       ,42,219,261,430,,1639,2069
00830400,SCOTTSDALE COMMUNITY COLLEGE            ,AZ,85250-0000,Public       ,268,678,946,4542,,5913,10455
00886400,ARIZONA ACADEMY OF BEAUTY               ,AZ,85712-5021,Proprietary  ,7,32,39,95,,189,284
00886500,ARTISTIC BEAUTY COLLEGES-TUCSON         ,AZ,85716-3999,Proprietary  ,0,0,0,107,,187,294
00945915,EMPIRE BEAUTY SCHOOL - NW PHOENIX       ,AZ,85051-8499,Proprietary  ,0,0,0,123,,319,442
01054207,EMPIRE BEAUTY SCHOOL - FLAGSTAFF        ,AZ,86004-5119,Proprietary  ,0,0,0,114,,210,324
01084700,ARIZONA AUTOMOTIVE INSTITUTE            ,AZ,85301-3503,Proprietary  ,81,278,359,384,,1041,1425
01085800,AVALON SCHOOL OF COSMETOLOGY            ,AZ,85210-4010,Proprietary  ,62,127,189,557,,899,1456
01168900,REFRIGERATION SCHOOL                    ,AZ,85034-0000,Proprietary  ,28,161,189,176,,935,1111
01180200,ARIZONA ACADEMY OF BEAUTY-NORTH         ,AZ,85705-2720,Proprietary  ,2,27,29,55,,127,182
01186200,NORTHLAND PIONEER COLLEGE               ,AZ,86025-0610,Public       ,68,273,341,706,,1940,2646
01186400,MOHAVE COMMUNITY COLLEGE                ,AZ,86409-1238,Public       ,143,556,699,1599,,4587,6186
01218400,INTERNATIONAL ACAD OF HAIR DESIGN       ,AZ,85225-7198,Proprietary  ,12,38,50,114,,263,377
01234300,ARTISTIC BEAUTY COLLEGES-PHOENIX        ,AZ,85304-0000,Proprietary  ,0,0,0,125,,260,385
01293700,ARTISTIC BEAUTY COLLEGES - PARADISE VALL,AZ,85257-0000,Proprietary  ,0,0,0,77,,219,296
02065300,PRESCOTT COLLEGE                        ,AZ,86301-0000,Private      ,30,116,146,632,,1207,1839
02071200,KAPLAN COLLEGE                          ,AZ,85029-4349,Proprietary  ,11,184,195,183,,1300,1483
02098800,UNIVERSITY OF PHOENIX                   ,AZ,85040-0000,Proprietary  ,2501,48782,51283,16532,,316680,333212
02100500,UNIVERSAL TECHNICAL INSTITUTE           ,AZ,85027-0000,Proprietary  ,577,1043,1620,6052,,8606,14658
02100600,CARRINGTON COLLEGE                      ,AZ,85015-4096,Proprietary  ,221,738,959,1784,,5257,7041
02113800,ROBERTO-VENN SCH OF LUTHIERY            ,AZ,85040-0000,Proprietary  ,3,5,8,30,,69,99
02146600,SOUTH MOUNTAIN COMMUNITY COLLEGE        ,AZ,85040-0000,Public       ,200,690,890,2843,,5969,8812
02160305,COLLINS COLLEGE                         ,AZ,85040-4000,Proprietary  ,11,64,75,262,,586,848
02160306,INTERNATIONAL ACADEMY OF DESIGN AND TECH,AZ,85281-6705,Proprietary  ,1,18,19,40,,90,130
02171500,WESTERN INTERNATIONAL UNIVERSITY        ,AZ,85021-0000,Proprietary  ,7,294,301,73,,1668,1741
02177500,RIO SALADO COMMUNITY COLLEGE            ,AZ,85281-6948,Public       ,250,2060,2310,3149,,18908,22057
02199900,AMERICAN INDIAN CLG-ASSEMBLIES GOD      ,AZ,85021-0000,Private      ,3,15,18,53,,152,205
02217100,PIMA MEDICAL INSTITUTE                  ,AZ,85716-0000,Proprietary  ,438,1362,1800,3164,,9122,12286
02218800,BROOKLINE COLLEGE                       ,AZ,85021-5815,Proprietary  ,73,402,475,402,,2065,2467
02218804,BROOKLINE COLLEGE - MESA                ,AZ,85204-4448,Proprietary  ,27,156,183,202,,786,988
02218805,BROOKLINE COLLEGE - TUCSON              ,AZ,85711-5444,Proprietary  ,53,175,228,286,,979,1265
02263100,ANTHEM COLLEGE                          ,AZ,85014-0000,Proprietary  ,139,702,841,704,,3671,4375
02280500,CHARLES OF ITALY BEAUTY COLLEGE         ,AZ,86403-0000,Proprietary  ,0,14,14,59,,114,173
02295000,EVEREST COLLEGE                         ,AZ,85021-1610,Proprietary  ,129,1022,1151,913,,5997,6910
02295002,EVEREST COLLEGE - MESA                  ,AZ,85206-4704,Proprietary  ,34,194,228,279,,1327,1606
02317800,AMERICAN INSTITUTE OF TECHNOLOGY        ,AZ,85043-0000,Proprietary  ,26,225,251,201,,1042,1243
02491500,THE ART CENTER DESIGN COLLEGE           ,AZ,85716-0000,Proprietary  ,16,40,56,221,,449,670
02533200,FRANK LLOYD WRIGHT SCHOOL OF ARCHITECTUR,AZ,85261-4430,Private      ,4,16,20,33,,82,115
02559000,UNIVERSITY OF ADVANCING TECHNOLOGY      ,AZ,85283-0000,Proprietary  ,69,94,163,1170,,940,2110
02561900,BRILLARE HAIRDRESSING ACADEMY           ,AZ,85254-3301,Proprietary  ,12,31,43,130,,193,323
02582700,CORTIVA INSTITUTE - TUCSON              ,AZ,85710-3503,Proprietary  ,19,53,72,130,,296,426
02616700,LE CORDON BLEU COLLEGE OF CULINARY ARTS ,AZ,85251-2729,Proprietary  ,114,515,629,1067,,3623,4690
02623600,PARADISE VALLEY COMMUNITY COLLEGE       ,AZ,85032-1210,Public       ,310,683,993,4064,,5997,10061
02623800,CORTIVA INSTITUTE - SCOTTSDALE          ,AZ,85257-4218,Proprietary  ,3,27,30,28,,142,170
03005000,SAFFORD COLLEGE OF BEAUTY CULTURE       ,AZ,85546-3309,Proprietary  ,2,20,22,8,,36,44
03010613,VIRGINIA COLLEGE - GOLF ACADEMY OF ARIZO,AZ,85225-6742,Proprietary  ,2,7,9,37,,93,130
03030604,UTAH COLLEGE OF MASSAGE THERAPY - ARIZON,AZ,85282-0000,Proprietary  ,13,48,61,111,,290,401
03030605,UTAH COLLEGE OF MASSAGE THERAPY - ARIZON,AZ,85051-3470,Proprietary  ,36,84,120,189,,403,592
03034400,CONSERVATORY RECORDING ARTS & SCIS      ,AZ,85282-1707,Proprietary  ,51,96,147,742,,784,1526
03072200,CHANDLER-GILBERT COMMUNITY COLLEGE      ,AZ,85225-2499,Public       ,441,808,1249,6267,,7553,13820
03076400,BRYMAN SCHOOL OF ARIZONA                ,AZ,85029-4919,Proprietary  ,57,164,221,346,,1159,1505
03097800,CARSTEN INSTITUTE OF HAIR & BEAUTY      ,AZ,85282-5404,Proprietary  ,13,51,64,102,,235,337
03100400,COCONINO COUNTY COMMUNITY COLLEGE       ,AZ,86001-2701,Public       ,138,282,420,1987,,2621,4608
03107000,SOUTHWEST CLG OF NATUROPATHIC MED       ,AZ,85282-0000,Private      ,2,28,30,26,,651,677
03115000,ARIZONA COLLEGE OF ALLIED HEALTH        ,AZ,85302-3843,Proprietary  ,51,259,310,417,,1397,1814
03120300,COLLEGE AMERICA                         ,AZ,86004-3936,Proprietary  ,46,202,248,322,,1428,1750
03156300,ESTRELLA MOUNTAIN COMMUNITY COLLEGE     ,AZ,85392-1010,Public       ,351,867,1218,5187,,8512,13699
03347300,INTERNATIONAL BAPTIST COLLEGE           ,AZ,85282-6799,Private      ,1,4,5,42,,30,72
03445300,HDS TRUCK DRIVING INSTITUTE             ,AZ,85731-0000,Proprietary  ,7,61,68,31,,261,292
03478400,PHOENIX SEMINARY                        ,AZ,85018-7611,Private      ,0,6,6,4,,194,198
03572300,EAST VALLEY INSTITUTE OF TECHNOLOGY     ,AZ,85201-6910,Public       ,37,136,173,467,,1073,1540
03593300,SOUTHWEST INSTITUTE OF HEALING ARTS     ,AZ,85281-3658,Proprietary  ,32,303,335,191,,1829,2020
03617500,PHOENIX INSTITUTE OF HERBAL MEDICINE & A,AZ,85012-0000,Proprietary  ,9,52,61,68,,471,539
03695500,ARIZONA SCHOOL OF ACUPUNCTURE AND ORIENT,AZ,85712-1100,Proprietary  ,1,15,16,22,,134,156
03784400,TOHONO O'ODHAM COMMUNITY COLLEGE        ,AZ,85634-3129,Public       ,2,14,16,93,,130,223
03813300,NORTHCENTRAL UNIVERSITY                 ,AZ,86314-2336,Proprietary  ,12,1256,1268,94,,7668,7762
03814300,TURNING POINT BEAUTY COLLEGE            ,AZ,85222-4229,Proprietary  ,6,19,25,26,,95,121
04051300,ART INSTITUTE OF PHOENIX (THE)          ,AZ,85021-2859,Proprietary  ,998,3141,4139,7969,,23818,31787
04051306,ART INSTITUTE OF PHOENIX (THE) - ART INS,AZ,85712-2732,Proprietary  ,59,75,134,558,,614,1172
04051325,ART INSTITUTE OF PHOENIX (THE) - BROWN M,AZ,85712-5300,Proprietary  ,36,158,194,258,,1009,1267
04051327,ART INSTITUTE OF PHOENIX (THE) - BROWN M,AZ,85029-1348,Proprietary  ,17,52,69,196,,441,637
04059300,TUCSON COLLEGE OF BEAUTY                ,AZ,85705-2451,Proprietary  ,6,38,44,78,,180,258
04120900,ARIZONA CULINARY INSTITUTE              ,AZ,85259-4939,Proprietary  ,24,56,80,271,,401,672
04131400,PHOENIX SCHOOL OF LAW                   ,AZ,85012-3330,Proprietary  ,9,75,84,101,,1650,1751
04139200,UNIVERSAL BARBER COLLEGE                ,AZ,85007-3914,Proprietary  ,12,45,57,89,,334,423
04148700,AMERICAN INSTITUTE OF INTERIOR DESIGN   ,AZ,85268-3827,Proprietary  ,6,17,23,34,,85,119
04152900,STUDIO ACADEMY OF BEAUTY (THE)          ,AZ,85224-3600,Proprietary  ,17,59,76,113,,277,390
04157400,NATIONAL PARALEGAL COLLEGE              ,AZ,85014-1262,Proprietary  ,9,255,264,85,,1777,1862
04172100,CCIC BEAUTY COLLEGE                     ,AZ,85345-2410,Proprietary  ,0,0,0,7,,21,28
04174100,PAUL MITCHELL THE SCHOOL PHOENIX        ,AZ,85017-1919,Proprietary  ,20,67,87,200,,418,618
04174200,ALL BEAUTY COLLEGE                      ,AZ,86426-8326,Proprietary  ,9,28,37,44,,152,196
04175300,PENROSE ACADEMY                         ,AZ,85254-4065,Proprietary  ,15,27,42,99,,160,259
04177500,PURE AESTHETICS                         ,AZ,85711-2328,Proprietary  ,5,15,20,28,,108,136
04191200,CLASSIC COOKING ACADEMY                 ,AZ,85255-8699,Private      ,3,19,22,49,,73,122
04194500,AVEDA INSTITUTE TUCSON                  ,AZ,85719-4876,Proprietary  ,27,52,79,188,,280,468
04217600,SESSIONS COLLEGE FOR PROFESSIONAL DESIGN,AZ,85281-2840,Proprietary  ,3,31,34,24,,153,177
00142800,DELAWARE STATE UNIVERSITY               ,DE,19901-2277,Public       ,257,236,493,8590,,2839,11429
00142900,GOLDEY BEACOM COLLEGE                   ,DE,19808-1993,Private      ,24,62,86,650,,587,1237
00143100,UNIVERSITY OF DELAWARE                  ,DE,19716-0099,Public       ,650,260,910,27250,,3562,30812
00143300,WESLEY COLLEGE                          ,DE,19901-3875,Private      ,66,69,135,2619,,797,3416
00143301,WESLEY COLLEGE-CTR FOR ADULT STUDIE     ,DE,19720-0000,Private      ,1,26,27,31,,228,259
00331301,WIDENER UNIV SCHOOL OF LAW - DE         ,DE,19803-0000,Private      ,5,43,48,96,,1326,1422
00705300,DELAWARE TECH & CMTY COLLEGE-OWENS      ,DE,19947-0000,Public       ,142,456,598,2736,,3590,6326
00794800,WILMINGTON UNIVERSITY                   ,DE,19720-6491,Private      ,192,1087,1279,3214,,10492,13706
01172700,DELAWARE TECH & CMTY CLG-TERRY          ,DE,19901-8736,Public       ,129,346,475,2283,,3061,5344
02125200,BEEBE SCHOOL OF NURSING                 ,DE,19958-1462,Private      ,2,14,16,64,,122,186
02144900,DELAWARE TECH & CMTY CLG-STANTN/WLM     ,DE,19801-0000,Public       ,225,645,870,4325,,5526,9851
02190400,SCHILLING DOUGLAS SCH OF HAIR DSGN      ,DE,19711-0000,Proprietary  ,15,18,33,110,,140,250
02586902,STAR TECHNICAL INSTITUTE -              ,DE,19901-4615,Proprietary  ,2,12,14,32,,109,141
03025800,DAWN TRAINING CENTRE                    ,DE,19805-1511,Proprietary  ,18,157,175,135,,857,992
03543300,HARRIS SCHOOL OF BUSINESS               ,DE,19803-5341,Proprietary  ,23,135,158,152,,528,680
03702300,DELAWARE LEARNING INSTITUTE OF COSMETOLO,DE,19939-9759,Proprietary  ,7,20,27,45,,81,126
04130700,ACADEMY OF MASSAGE AND BODYWORK         ,DE,19701-1321,Proprietary  ,3,11,14,22,,99,121
04139800,DELAWARE COLLEGE OF ART & DESIGN        ,DE,19801-3007,Private      ,21,23,44,473,,158,631
04171100,DELAWARE ACADEMY PAUL MITCHELL PARTNER S,DE,19702-5108,Proprietary  ,13,25,38,105,,146,251
        ,FEDERAL STUDENT AID USE ONLY            ,DC,20202-0000,,0,0,0,3,,4,7
        ,OFFICIAL USE ONLY                       ,DC,20202-0000,,0,1,1,0,,2,2
00143400,AMERICAN UNIVERSITY                     ,DC,20016-8020,Private      ,430,457,887,14913,,10314,25227
00143700,CATHOLIC UNIVERSITY OF AMERICA          ,DC,20064-0002,Private      ,153,212,365,5911,,2707,8618
00143711,"CATHOLIC UNIV AMERICA, LAW SCHOOL       ",DC,20064-0000,Private      ,4,27,31,77,,1236,1313
00144100,UNIV OF THE DISTRICT OF COLUMBIA        ,DC,20008-0000,Public       ,162,692,854,3337,,7709,11046
00144102,UNIV OF THE DIST OF COLU -SCHOOL OF LAW ,DC,20008-1173,Public       ,6,42,48,71,,924,995
00144300,GALLAUDET UNIVERSITY                    ,DC,20002-3695,Private      ,34,72,106,1059,,1316,2375
00144400,GEORGE WASHINGTON UNIVERSITY            ,DC,20052-2353,Private      ,503,858,1361,14974,,12120,27094
00144402,GEORGE WASHINGTON UNIV LAW SCHL         ,DC,20052-0000,Private      ,7,79,86,103,,4103,4206
00144403,GEORGE WASHINGTON UNIV SCH MED          ,DC,20052-0000,Private      ,16,65,81,123,,1842,1965
00144500,GEORGETOWN UNIVERSITY                   ,DC,20057-1252,Private      ,426,433,859,13594,,5525,19119
00144501,"GEORGETOWN UNIV, SCH OF MEDICINE        ",DC,20007-0000,Private      ,11,26,37,114,,1492,1606
00144502,GEORGETOWN UNIVERSITY - GRADUATE SCHOOL ,DC,20057-0004,Private      ,3,315,318,68,,4999,5067
00144503,GEORGETOWN UNIV LAW CENTER              ,DC,20001-0000,Private      ,6,102,108,77,,4869,4946
00144800,HOWARD UNIVERSITY                       ,DC,20059-0001,Private      ,458,463,921,15962,,10029,25991
00145900,STRAYER UNIVERSITY                      ,DC,20005-2603,Proprietary  ,246,5238,5484,2002,,50923,52925
00146000,TRINITY UNIVERSITY                      ,DC,20017-1004,Private      ,44,204,248,1593,,3257,4850
00146400,WESLEY THEOLOGICAL SEMINARY             ,DC,20016-0000,Private      ,0,24,24,7,,363,370
00207701,JOHNS HOPKINS UNIV SCH ADV INTL STU     ,DC,20036-0000,Private      ,10,85,95,79,,1563,1642
01006500,WASHINGTON THEOLOGICAL UNION            ,DC,20012-0000,Private      ,0,5,5,9,,46,55
01195000,THE CORCORAN COLLEGE OF ART & DESIG     ,DC,20006-4804,Private      ,15,36,51,361,,434,795
01280300,DOMINICAN HOUSE OF STUDIES              ,DC,20017-1584,Private      ,1,6,7,4,,45,49
02132800,NAT'L CONSERVATORY DRAMATIC ARTS        ,DC,20007-2758,Private      ,2,6,8,32,,66,98
03104300,CAREER BLAZERS LEARNING CENTER OF WASHIN,DC,20037-1881,Proprietary  ,20,221,241,86,,902,988
03218300,POTOMAC COLLEGE                         ,DC,20016-1860,Proprietary  ,14,107,121,83,,629,712
03409600,BENNETT CAREER INSTITUTE                ,DC,20017-1754,Proprietary  ,19,85,104,151,,449,600
03750300,TECHNICAL LEARNING CENTERS              ,DC,20006-3749,Proprietary  ,36,158,194,117,,609,726
04114400,INSTITUTE OF WORLD POLITICS (THE)       ,DC,20036-1464,Private      ,2,17,19,15,,224,239
04142700,PONTIFICAL JOHN PAUL II INSTITUTE FOR ST,DC,20064-0001,Private      ,0,3,3,2,,35,37
04190000,RADIANS COLLEGE                         ,DC,20005-3542,Proprietary  ,3,116,119,74,,760,834
00154100,ABRAHAM BALDWIN AGRICULTURAL CLG        ,GA,31794-0000,Public       ,141,187,328,3487,,2153,5640
00154200,AGNES SCOTT COLLEGE                     ,GA,30030-3770,Private      ,50,62,112,1545,,588,2133
00154300,DARTON COLLEGE                          ,GA,31707-3098,Public       ,226,636,862,4546,,7823,12369
00154400,ALBANY STATE UNIVERSITY                 ,GA,31705-2796,Public       ,283,421,704,7344,,5981,13325
00154500,ANDREW COLLEGE                          ,GA,39840-1395,Private      ,17,15,32,527,,111,638
00154600,ARMSTRONG ATLANTIC STATE UNIVERSITY     ,GA,31419-1997,Public       ,297,682,979,7202,,6964,14166
00154700,POINT UNIVERSITY                        ,GA,30344-1999,Private      ,51,134,185,1035,,1464,2499
00155400,BERRY COLLEGE                           ,GA,30149-5007,Private      ,139,58,197,4288,,427,4715
00155500,THOMAS UNIVERSITY                       ,GA,31792-7499,Private      ,26,142,168,548,,1468,2016
00155600,BRENAU UNIVERSITY                       ,GA,30501-3668,Private      ,99,345,444,1946,,3937,5883
00155700,BREWTON PARKER COLLEGE                  ,GA,30445-0000,Private      ,19,12,31,633,,274,907
00155800,COASTAL GEORGIA COMMUNITY COLLEGE       ,GA,31520-3644,Public       ,162,313,475,2487,,3117,5604
00155900,CLARK ATLANTA UNIVERSITY                ,GA,30314-4385,Private      ,493,566,1059,11557,,6712,18269
00156000,COLUMBIA THEOLOGICAL SEMINARY           ,GA,30031-0000,Private      ,1,17,18,13,,251,264
00156100,COLUMBUS STATE UNIVERSITY               ,GA,31907-5645,Public       ,300,717,1017,7639,,7535,15174
00156200,GEORGIA PERIMETER COLLEGE               ,GA,30021-0000,Public       ,1264,2618,3882,17617,,24709,42326
00156300,EMMANUEL COLLEGE                        ,GA,30639-0000,Private      ,29,13,42,904,,205,1109
00156400,EMORY UNIVERSITY                        ,GA,30322-1960,Private      ,480,553,1033,13892,,11146,25038
00156600,FORT VALLEY STATE UNIVERSITY            ,GA,31030-3298,Public       ,187,232,419,4904,,3137,8041
00156700,GAINESVILLE STATE COLLEGE               ,GA,30503-0000,Public       ,0,0,0,6116,,3678,9794
00156800,INTERDENOMINATIONAL THEOLOGY CENTER     ,GA,30314-0000,Private      ,2,35,37,12,,635,647
00156900,GEORGIA INSTITUTE OF TECHNOLOGY         ,GA,30332-0325,Public       ,711,615,1326,21622,,7062,28684
00157000,SOUTHERN POLYTECHNIC STATE UNIV         ,GA,30060-2896,Public       ,244,483,727,5665,,5319,10984
00157100,GEORGIA MILITARY COLLEGE                ,GA,31061-3398,Public       ,463,797,1260,5836,,7391,13227
00157200,GEORGIA SOUTHERN UNIVERSITY             ,GA,30460-8065,Public       ,905,677,1582,25436,,9154,34590
00157300,GEORGIA SOUTHWESTERN STATE UNIV         ,GA,31709-4693,Public       ,90,181,271,3060,,2566,5626
00157400,GEORGIA STATE UNIVERSITY                ,GA,30303-3010,Public       ,1409,2515,3924,35590,,32018,67608
00157500,GORDON COLLEGE                          ,GA,30204-1762,Public       ,212,294,506,4912,,3281,8193
00157700,KENNESAW STATE UNIVERSITY               ,GA,30144-5591,Public       ,1046,1458,2504,24939,,17527,42466
00157800,LAGRANGE COLLEGE                        ,GA,30240-2999,Private      ,52,49,101,1661,,658,2319
00157900,MEDICAL COLLEGE OF GEORGIA              ,GA,30912-0004,Public       ,41,146,187,1354,,3874,5228
00157913,GEORGIA REGENTS UNIVERSITY - AUGUSTA STA,GA,30904-2200,Public       ,196,421,617,5746,,5804,11550
00158000,MERCER UNIVERSITY                       ,GA,31207-0003,Private      ,258,654,912,5991,,9740,15731
00158100,MIDDLE GEORGIA COLLEGE                  ,GA,31014-1599,Public       ,156,204,360,3803,,3069,6872
00158103,MIDDLE GEORGIA STATE COLLEGE - MACON CAM,GA,31206-5145,Public       ,229,543,772,4410,,5769,10179
00158200,MOREHOUSE COLLEGE                       ,GA,30314-3773,Private      ,159,153,312,4884,,1638,6522
00158500,UNIVERSITY OF NORTH GEORGIA             ,GA,30597-0001,Public       ,637,504,1141,10473,,4489,14962
00158600,OGLETHORPE UNIVERSITY                   ,GA,30319-2737,Private      ,83,71,154,2306,,828,3134
00158700,PAINE COLLEGE                           ,GA,30901-3182,Private      ,67,105,172,1458,,1037,2495
00158800,PIEDMONT COLLEGE                        ,GA,30535-5644,Private      ,46,206,252,1321,,2024,3345
00158900,REINHARDT UNIVERSITY                    ,GA,30183-2981,Private      ,47,55,102,1729,,698,2427
00159000,SAVANNAH STATE UNIVERSITY               ,GA,31404-5298,Public       ,396,412,808,9019,,4517,13536
00159100,SHORTER UNIVERSITY                      ,GA,30165-4298,Private      ,62,219,281,2187,,2869,5056
00159200,SOUTH GEORGIA COLLEGE                   ,GA,31533-8104,Public       ,90,170,260,2203,,1605,3808
00159203,SOUTH GEORGIA STATE COLLEGE - WAYCROSS C,GA,31503-0110,Public       ,53,95,148,712,,777,1489
00159400,SPELMAN COLLEGE                         ,GA,30314-4399,Private      ,249,179,428,6972,,2069,9041
00159600,TOCCOA FALLS COLLEGE                    ,GA,30598-0001,Private      ,28,35,63,987,,307,1294
00159700,TRUETT MCCONNELL COLLEGE                ,GA,30528-1264,Private      ,25,29,54,872,,272,1144
00159800,UNIVERSITY OF GEORGIA                   ,GA,30602-6114,Public       ,1158,736,1894,34738,,13095,47833
00159900,VALDOSTA STATE UNIVERSITY               ,GA,31698-0001,Public       ,568,647,1215,14323,,7651,21974
00160000,WESLEYAN COLLEGE                        ,GA,31210-4407,Private      ,24,79,103,612,,782,1394
00160100,UNIV OF WEST GEORGIA                    ,GA,30118-0002,Public       ,540,678,1218,14435,,7691,22126
00160200,GEORGIA COLLEGE & STATE UNIVERSITY      ,GA,31061-0490,Public       ,249,231,480,8408,,2774,11182
00160400,YOUNG HARRIS COLLEGE                    ,GA,30582-4137,Private      ,64,14,78,1671,,198,1869
00348400,COVENANT COLLEGE                        ,GA,30750-4164,Private      ,59,18,77,1441,,185,1626
00395600,DALTON STATE COLLEGE                    ,GA,30720-3797,Public       ,220,342,562,4550,,3845,8395
00402400,GEORGIA NORTHWESTERN TECHNICAL COLLEGE  ,GA,30161-6757,Public       ,338,872,1210,3162,,7291,10453
00411700,GRADY HEALTH SYSTEM                     ,GA,30303-3050,Public       ,18,129,147,196,,1110,1306
00489808,MCCANN SCHOOL OF BUSINESS & TECHNOLOGY -,GA,31210-0246,Proprietary  ,3,17,20,34,,164,198
00525400,LANIER TECHNICAL COLLEGE                ,GA,30566-3499,Public       ,254,600,854,2001,,4556,6557
00525500,MOULTRIE TECHNICAL COLLEGE              ,GA,31768-0000,Public       ,78,295,373,709,,2237,2946
00525600,WIREGRASS GEORGIA TECHNICAL COLLEGE     ,GA,31602-0929,Public       ,184,731,915,2063,,5664,7727
00551100,OKEFENOKEE TECHNICAL COLLEGE            ,GA,31501-4016,Public       ,75,235,310,604,,1592,2196
00559900,AUGUSTA TECHNICAL COLLEGE               ,GA,30906-3399,Public       ,273,894,1167,2790,,7453,10243
00560000,ATHENS TECHNICAL COLLEGE                ,GA,30601-1579,Public       ,264,706,970,3202,,5784,8986
00560100,ALBANY TECHNICAL COLLEGE                ,GA,31701-2648,Public       ,222,730,952,1931,,6747,8678
00561500,SOUTHWEST GEORGIA TECHNICAL COLLEGE     ,GA,31792-2622,Public       ,217,265,482,1156,,2271,3427
00561700,SOUTH GEORGIA TECHNICAL COLLEGE         ,GA,31709-8167,Public       ,64,189,253,1068,,1938,3006
00561800,SAVANNAH TECHNICAL COLLEGE              ,GA,31405-5594,Public       ,351,1420,1771,3051,,9478,12529
00561900,NORTH GEORGIA TECHNICAL COLLEGE         ,GA,30523-0000,Public       ,183,389,572,1809,,2776,4585
00562000,CHATTAHOOCHEE TECHNICAL COLLEGE         ,GA,30060-3398,Public       ,810,1867,2677,7146,,13583,20729
00562100,SOUTHERN CRESCENT TECHNICAL COLLEGE     ,GA,30223-2097,Public       ,293,921,1214,2748,,7503,10251
00562200,DEKALB TECHNICAL COLLEGE                ,GA,30021-0000,Public       ,203,936,1139,1999,,8235,10234
00562400,COLUMBUS TECHNICAL COLLEGE              ,GA,31904-6572,Public       ,192,650,842,2447,,6239,8686
00576300,CENTRAL GEORGIA TECHNICAL COLLEGE       ,GA,31206-3628,Public       ,354,1316,1670,2582,,8452,11034
00576304,CENTRAL GEORGIA TECHNICAL COLLEGE -     ,GA,31088-2729,Public       ,0,0,0,1198,,2903,4101
00854300,ATLANTA TECHNICAL COLLEGE               ,GA,30310-4499,Public       ,439,1767,2206,3599,,14441,18040
00897600,CLAYTON STATE UNIVERSITY                ,GA,30260-0285,Public       ,309,952,1261,7094,,11764,18858
00927000,ART INSTITUTE OF ATLANTA (THE)          ,GA,30328-1649,Proprietary  ,767,944,1711,8920,,7958,16878
00950700,GEORGIA HIGHLANDS COLLEGE               ,GA,30162-0000,Public       ,375,531,906,5452,,4807,10259
01031903,MEDIX SCHOOL                            ,GA,30080-7630,Proprietary  ,28,91,119,182,,785,967
01035601,EVEREST INSTITUTE - DEKALB              ,GA,30035-3420,Proprietary  ,3,44,47,106,,473,579
01048700,WEST GEORGIA TECHNICAL COLLEGE          ,GA,30182-6476,Public       ,485,1207,1692,4281,,8625,12906
01054212,EMPIRE BEAUTY SCHOOL - DUNWOODY         ,GA,30338-3020,Proprietary  ,0,0,0,107,,253,360
01077100,GUPTON JONES COLLEGE                    ,GA,30035-4022,Private      ,12,38,50,149,,384,533
01099700,EAST GEORGIA COLLEGE                    ,GA,30401-2699,Public       ,159,151,310,3535,,1695,5230
01107400,BAINBRIDGE COLLEGE                      ,GA,39819-8400,Public       ,85,301,386,1284,,3618,4902
01110901,EVEREST COLLEGE - EVEREST INSTITUTE     ,GA,30067-8340,Proprietary  ,27,172,199,212,,1034,1246
01110902,EVEREST COLLEGE - ATLANTA               ,GA,30331-2620,Proprietary  ,57,389,446,511,,2138,2649
01112301,EVEREST COLLEGE - EVEREST INSTITUTE- NOR,GA,30093-2813,Proprietary  ,35,209,244,252,,1212,1464
01157400,BAUDER COLLEGE                          ,GA,30313-2439,Proprietary  ,57,292,349,565,,2160,2725
01205100,PRO WAY HAIR SCHOOL                     ,GA,30083-2884,Proprietary  ,7,59,66,82,,412,494
01216500,ATLANTA METROPOLITAN COLLEGE            ,GA,30310-4498,Public       ,362,1040,1402,4260,,8895,13155
01246109,LINCOLN COLLEGE OF TECHNOLOGY - MARIETTA,GA,30067-8638,Proprietary  ,20,76,96,128,,542,670
01303900,SOUTH UNIVERSITY                        ,GA,31406-4881,Proprietary  ,584,4832,5416,3684,,23753,27437
02060900,BROWN CLG OF COURT REPORTING & M.T.     ,GA,30318-2570,Proprietary  ,7,72,79,51,,572,623
02074800,LIFE UNIVERSITY                         ,GA,30060-0000,Private      ,53,173,226,720,,3287,4007
02113613,AMERICAN INTERCONTINENTAL UNIVERSITY    ,GA,30328-1649,Proprietary  ,79,435,514,990,,3550,4540
02116000,SANFORD-BROWN COLLEGE                   ,GA,30328-4803,Proprietary  ,34,183,217,271,,1334,1605
02141500,SAVANNAH COLLEGE OF ART & DESIGN        ,GA,31402-3146,Private      ,537,423,960,11956,,5328,17284
02202800,AUGUSTA AREA DIET INTERN UNIV HOSP      ,GA,30901-0000,Private      ,5,16,21,20,,109,129
02217200,PORTFOLIO CENTER                        ,GA,30309-0000,Proprietary  ,4,24,28,60,,259,319
02266200,AMERICAN PROFESSIONAL INSTITUTE         ,GA,31201-3185,Proprietary  ,3,34,37,102,,557,659
02279500,HEART OF GEORGIA TECHNICAL COLLEGE      ,GA,31021-8896,Public       ,0,0,0,256,,724,980
02284300,INTERACTIVE COLLEGE OF TECHNOLOGY       ,GA,30341-0000,Proprietary  ,48,337,385,246,,1719,1965
02284308,INTERACTIVE LEARNING SYSTEMS            ,GA,30260-0000,Proprietary  ,17,56,73,54,,287,341
02284309,INTERACTIVE COLLEGE OF TECHNOLOGY       ,GA,30501-0000,Proprietary  ,16,62,78,106,,345,451
02285500,"CREATIVE CIRCUS, THE                    ",GA,30324-0000,Proprietary  ,9,38,47,111,,357,468
02288400,GWINNETT TECHNICAL COLLEGE              ,GA,30043-5702,Public       ,490,1307,1797,4543,,11426,15969
02313902,WESTWOOD COLLEGE - O'HARE AIRPORT - ATLA,GA,30345-2807,Proprietary  ,28,110,138,215,,911,1126
02321400,ROFFLER-MOLER HAIRSTYLING COLLEGE       ,GA,30062-0000,Proprietary  ,12,23,35,86,,159,245
02354500,SOUTHEASTERN BEAUTY SCHOOLS             ,GA,31906-0000,Proprietary  ,0,0,0,25,,62,87
02482100,MOREHOUSE SCHOOL OF MEDICINE            ,GA,30310-0000,Private      ,22,38,60,217,,850,1067
02520000,INTERNATIONAL SCH SKIN & NAILCARE       ,GA,30342-1119,Proprietary  ,16,81,97,98,,488,586
02559315,(UNITED EDUCATION INSTITUTE) - UEI MORRO,GA,30260-2941,Proprietary  ,5,42,47,46,,289,335
02577000,PAUL MITCHELL THE SCHOOL - ESANI        ,GA,30076-1507,Proprietary  ,13,28,41,94,,195,289
02577700,BEAUTY COLLEGE OF AMERICA               ,GA,30297-0000,Proprietary  ,10,27,37,76,,165,241
02580100,IVERSON INSTITUTE                       ,GA,30341-3662,Proprietary  ,8,36,44,55,,238,293
02580200,ATLANTA SCHOOL OF MASSAGE               ,GA,30338-0000,Proprietary  ,30,127,157,176,,763,939
02583000,GWINNETT COLLEGE OF BUSINESS            ,GA,30047-3447,Proprietary  ,14,98,112,144,,807,951
02614206,MILLER - MOTTE TECHNICAL COLLEGE - COLUM,GA,31907-3222,Proprietary  ,26,185,211,244,,1545,1789
02614207,MILLER - MOTTE TECHNICAL COLLEGE - AUGUS,GA,30907-0921,Proprietary  ,32,201,233,241,,1338,1579
03005400,GEORGIA CAREER INSTITUTE                ,GA,30013-2076,Proprietary  ,31,166,197,266,,849,1115
03010619,VIRGINIA COLLEGE - AUGUSTA              ,GA,30909-5515,Proprietary  ,28,166,194,285,,1327,1612
03010623,VIRGINIA COLLEGE - MACON                ,GA,31206-3180,Proprietary  ,21,98,119,166,,865,1031
03022601,WESTERN CULINARY INSTITUTE - LE CORDON B,GA,30084-5893,Proprietary  ,40,174,214,438,,1107,1545
03030000,OGEECHEE TECHNICAL COLLEGE              ,GA,30458-8049,Public       ,180,407,587,1740,,3413,5153
03032100,ALTAMAHA TECHNICAL COLLEGE              ,GA,31545-4465,Public       ,145,332,477,877,,2048,2925
03042700,LAURUSTECHNICAL INSTITUTE               ,GA,30030-1506,Proprietary  ,17,129,146,80,,665,745
03066500,SOUTHEASTERN TECHNICAL COLLEGE          ,GA,30474-8817,Public       ,44,224,268,686,,2019,2705
03072304,EVEREST COLLEGE - EVEREST INSTITUTE     ,GA,30236-0000,Proprietary  ,19,146,165,158,,955,1113
03076300,BEULAH HEIGHTS BIBLE COLLEGE            ,GA,30316-1873,Private      ,4,81,85,41,,988,1029
03079202,WESTWOOD COLLEGE - ATLANTA MIDTOWN      ,GA,30309-2848,Proprietary  ,73,266,339,600,,1855,2455
03081500,SOUTHEASTERN BEAUTY SCHOOL              ,GA,31917-0000,Proprietary  ,9,32,41,79,,245,324
03089100,GEORGIA INSTITUTE OF COSMETOLOGY        ,GA,30606-3152,Proprietary  ,25,72,97,239,,597,836
03090600,COBB BEAUTY COLLEGE                     ,GA,30144-2828,Proprietary  ,8,34,42,82,,210,292
03100900,LUTHER RICE UNIVERSITY                  ,GA,30038-2454,Private      ,5,91,96,57,,1330,1387
03102000,RIVERTOWN SCHOOL OF BEAUTY              ,GA,31904-4747,Proprietary  ,9,62,71,100,,391,491
03104500,ATLANTA INSTITUTE OF MUSIC              ,GA,30096-4988,Proprietary  ,55,95,150,489,,570,1059
03116100,VOGUE BEAUTY AND BARBER SCHOOL          ,GA,30141-2226,Proprietary  ,11,42,53,84,,301,385
03155500,OCONEE FALL LINE TECHNICAL COLLEGE      ,GA,31082-6179,Public       ,74,253,327,472,,1695,2167
03173300,ATLANTA'S JOHN MARSHALL LAW SCHOOL      ,GA,30309-0000,Proprietary  ,9,74,83,75,,1505,1580
03418300,GWINNETT COLLEGE-SANDY SPRINGS          ,GA,30328-3161,Proprietary  ,10,64,74,126,,465,591
03445500,FAYETTE BEAUTY ACADEMY                  ,GA,30214-1191,Proprietary  ,5,32,37,38,,161,199
03523300,AVIATION INSTITUTE OF MAINTENANCE       ,GA,30045-0000,Proprietary  ,56,203,259,297,,993,1290
03635300,CARVER BIBLE COLLEGE                    ,GA,30331-1300,Private      ,4,46,50,48,,296,344
03748300,KEVOSNIK SCHOOL OF HAIR DESIGN          ,GA,31021-0000,Proprietary  ,1,7,8,7,,59,66
03753400,MICHAEL'S SCHOOL OF BEAUTY              ,GA,30909-0000,Proprietary  ,0,0,0,49,,132,181
03804400,MEDTECH INSTITUTE                       ,GA,30339-6040,Proprietary  ,35,189,224,228,,1015,1243
03812300,OMNITECH INSTITUTE                      ,GA,30035-1206,Proprietary  ,5,61,66,39,,368,407
04021300,AUGUSTA SCHOOL OF MASSAGE               ,GA,30809-0000,Proprietary  ,7,14,21,33,,107,140
04051331,ART INSTITUTE OF PHOENIX (THE) - BROWN M,GA,30319-3054,Proprietary  ,28,94,122,246,,579,825
04091300,SAVANNAH SCHOOL OF MASSAGE THERAPY      ,GA,31406-2711,Private      ,0,0,0,9,,18,27
04126800,ACADEMY OF SOMATIC HEALING ARTS (ASHA)  ,GA,30071-1024,Proprietary  ,0,0,0,6,,47,53
04142900,GEORGIA GWINNETT COLLEGE                ,GA,30043-7409,Public       ,788,750,1538,11512,,7531,19043
04147000,PAUL MITCHELL THE SCHOOL ATLANTA        ,GA,30318-5241,Proprietary  ,47,114,161,438,,770,1208
04147700,LAKE LANIER SCHOOL OF MASSAGE           ,GA,30501-4546,Proprietary  ,8,37,45,51,,211,262
04149900,PROFILE INSTITUTE OF BARBER-STYLING     ,GA,30315-8459,Proprietary  ,10,52,62,63,,323,386
04150900,PROCESS INSTITUTE OF COSMETOLOGY (THE)  ,GA,30043-7344,Proprietary  ,10,26,36,129,,199,328
04152300,GEORGIA BEAUTY ACADEMY                  ,GA,30721-3952,Proprietary  ,14,21,35,100,,210,310
04156500,GEORGIA CHRISTIAN UNIVERSITY            ,GA,30047-3778,Private      ,4,22,26,43,,142,185
04160200,ATLANTA BEAUTY ACADEMY                  ,GA,30340-1334,Proprietary  ,18,110,128,111,,552,663
04203800,WOODRUFF MEDICAL TRAINING AND TESTING   ,GA,30033-6103,Proprietary  ,8,41,49,35,,234,269
04204500,ELAINE STERLING INSTITUTE(THE)          ,GA,30342-2633,Proprietary  ,5,42,47,46,,199,245
04206400,HELMS COLLEGE                           ,GA,31206-5309,Private      ,19,38,57,95,,301,396
04206600,SAE INSTITUTE OF TECHNOLOGY - ATLANTA   ,GA,30303-1736,Proprietary  ,34,95,129,280,,593,873
04208000,TECHNOLOGY CENTER                       ,GA,30071-3519,Proprietary  ,4,48,52,21,,227,248
04218000,UNITED MEDICAL AND BUSINESS INSTITUTE   ,GA,30344-6977,Proprietary  ,4,26,30,21,,136,157
04221100,NEW HORIZONS MEDICAL INSTITUTE          ,GA,30071-2965,Proprietary  ,9,101,110,9,,101,110
00162800,AMERICAN ACADEMY OF ART                 ,IL,60604-4302,Proprietary  ,45,50,95,1029,,446,1475
00163300,AUGUSTANA COLLEGE                       ,IL,61201-2296,Private      ,78,30,108,4984,,321,5305
00163400,AURORA UNIVERSITY                       ,IL,60506-4892,Private      ,96,321,417,4573,,3833,8406
00163600,SOUTHWESTERN ILLINOIS COLLEGE           ,IL,62221-5899,Public       ,373,916,1289,4977,,7645,12622
00163800,BLACK HAWK COLLEGE                      ,IL,61265-5899,Public       ,170,407,577,2859,,3376,6235
00163900,BLACKBURN COLLEGE                       ,IL,62626-1498,Private      ,18,18,36,798,,174,972
00164000,PRAIRIE STATE COLLEGE                   ,IL,60411-8226,Public       ,209,632,841,3821,,6237,10058
00164100,BRADLEY UNIVERSITY                      ,IL,61625-0002,Private      ,145,78,223,8958,,1430,10388
00164300,SPOON RIVER COLLEGE                     ,IL,61520-8907,Public       ,43,122,165,910,,1038,1948
00164700,CITY COLLEGES OF CHICAGO                ,IL,60606-6998,Public       ,160,600,760,3629,,6055,9684
00164800,TRUMAN COLLEGE                          ,IL,60640-5691,Public       ,213,735,948,4102,,7492,11594
00164900,RICHARD J DALEY COLLEGE                 ,IL,60652-1299,Public       ,183,591,774,4565,,6607,11172
00165000,CITY COLLEGES OF CHICAGO-MALCOLM X      ,IL,60612-3197,Public       ,264,1076,1340,5250,,10854,16104
00165200,HAROLD WASHINGTON COLLEGE               ,IL,60601-2403,Public       ,466,1173,1639,10307,,11706,22013
00165400,KENNEDY KING COLLEGE                    ,IL,60621-3798,Public       ,185,1084,1269,3750,,10364,14114
00165500,WRIGHT COLLEGE                          ,IL,60634-1591,Public       ,299,802,1101,6932,,8446,15378
00165700,MIDWESTERN UNIVERSITY                   ,IL,60515-1200,Private      ,9,42,51,174,,3734,3908
00165900,ROSALIND FRANKLIN UNIVERSITY OF MEDICINE,IL,60064-3095,Private      ,7,57,64,66,,2845,2911
00166100,CHICAGO THEOLOGICAL SEMINARY            ,IL,60637-0000,Private      ,0,22,22,18,,283,301
00166300,SPERTUS COLLEGE                         ,IL,60605-1995,Private      ,1,9,10,5,,96,101
00166400,UNIVERSITY OF ST FRANCIS                ,IL,60435-6188,Private      ,60,260,320,2322,,2570,4892
00166500,COLUMBIA COLLEGE                        ,IL,60605-1996,Private      ,478,482,960,15733,,6434,22167
00166600,CONCORDIA UNIVERSITY                    ,IL,60305-1499,Private      ,63,395,458,3159,,4156,7315
00166900,DANVILLE AREA COMMUNITY COLLEGE         ,IL,61832-5199,Public       ,77,232,309,1146,,1858,3004
00167100,DEPAUL UNIVERSITY                       ,IL,60604-2287,Private      ,587,1097,1684,25609,,18080,43689
00167400,EASTERN ILLINOIS UNIVERSITY             ,IL,61920-3099,Public       ,286,227,513,12036,,4146,16182
00167500,ELGIN COMMUNITY COLLEGE                 ,IL,60123-7193,Public       ,318,551,869,4921,,5150,10071
00167600,ELMHURST COLLEGE                        ,IL,60126-3296,Private      ,83,96,179,4527,,1537,6064
00167800,EUREKA COLLEGE                          ,IL,61530-9976,Private      ,27,11,38,1074,,249,1323
00168100,HIGHLAND COMMUNITY COLLEGE              ,IL,61032-9341,Public       ,55,151,206,1043,,1293,2336
00168200,GARRETT-EVANGELICAL THEOLOGICAL SEM     ,IL,60201-0000,Private      ,0,14,14,3,,260,263
00168400,GREENVILLE COLLEGE                      ,IL,62246-1199,Private      ,37,56,93,1775,,723,2498
00168500,HEBREW THEOLOGICAL COLLEGE              ,IL,60077-3263,Private      ,16,3,19,517,,33,550
00168800,ILLINOIS COLLEGE                        ,IL,62650-2299,Private      ,37,17,54,2052,,257,2309
00168900,ILLINOIS COLLEGE OF OPTOMETRY           ,IL,60616-3878,Private      ,2,23,25,43,,728,771
00169100,ILLINOIS INSTITUTE OF TECHNOLOGY        ,IL,60616-0000,Private      ,96,218,314,3900,,3006,6906
00169103,CHICAGO KENT COLLEGE OF LAW             ,IL,60661-0000,Private      ,10,46,56,90,,1994,2084
00169200,ILLINOIS STATE UNIVERSITY               ,IL,61790-1000,Public       ,538,317,855,24954,,5629,30583
00169300,NORTHEASTERN ILLINOIS UNIV              ,IL,60625-4699,Public       ,236,601,837,8814,,9523,18337
00169400,CHICAGO STATE UNIVERSITY                ,IL,60628-1598,Public       ,260,853,1113,7214,,13537,20751
00169600,ILLINOIS WESLEYAN UNIVERSITY            ,IL,61701-0000,Private      ,55,19,74,3594,,242,3836
00169800,JOHN MARSHALL LAW SCHOOL                ,IL,60604-0000,Private      ,9,89,98,94,,2557,2651
00169900,JOLIET JUNIOR COLLEGE                   ,IL,60431-8938,Public       ,465,913,1378,8328,,8186,16514
00170000,JUDSON UNIVERSITY                       ,IL,60123-1498,Private      ,26,95,121,1227,,908,2135
00170100,KASKASKIA COLLEGE                       ,IL,62801-7878,Public       ,109,309,418,1814,,2573,4387
00170300,KENDALL COLLEGE                         ,IL,60622-4278,Proprietary  ,60,198,258,1263,,2361,3624
00170400,KNOX COLLEGE                            ,IL,61401-4999,Private      ,50,15,65,2605,,170,2775
00170500,ILLINOIS VALLEY COMMUNITY COLLEGE       ,IL,61348-9692,Public       ,96,225,321,1693,,1898,3591
00170600,LAKE FOREST COLLEGE                     ,IL,60045-2399,Private      ,59,18,77,2785,,264,3049
00170700,LEWIS UNIVERSITY                        ,IL,60446-2200,Private      ,137,373,510,6185,,4200,10385
00170800,LINCOLN CHRISTIAN UNIVERSITY            ,IL,62656-2167,Private      ,9,43,52,480,,704,1184
00170900,LINCOLN COLLEGE                         ,IL,62656-1699,Private      ,38,57,95,1361,,788,2149
00171000,LOYOLA UNIVERSITY CHICAGO               ,IL,60626-0000,Private      ,487,717,1204,18739,,13036,31775
00171200,LUTHERAN SCHOOL OF THEOL AT CHICAGO     ,IL,60615-0000,Private      ,1,6,7,8,,127,135
00171600,MACCORMAC COLLEGE                       ,IL,60602-4405,Private      ,3,30,33,90,,291,381
00171700,MACMURRAY COLLEGE                       ,IL,62650-2590,Private      ,18,20,38,1006,,326,1332
00172100,MCCORMICK THEOLOGICAL SEMINARY          ,IL,60615-5108,Private      ,0,7,7,7,,167,174
00172200,MCKENDREE UNIVERSITY                    ,IL,62254-1299,Private      ,50,124,174,1981,,1637,3618
00172300,MEADVILLE LOMBARD THEOLOGICAL SCHOOL    ,IL,60637-1602,Private      ,0,0,0,7,,77,84
00172400,MILLIKIN UNIVERSITY                     ,IL,62522-2084,Private      ,79,81,160,3468,,1061,4529
00172500,MONMOUTH COLLEGE                        ,IL,61462-1963,Private      ,23,8,31,2516,,238,2754
00172700,MOODY BIBLE INSTITUTE                   ,IL,60610-3214,Private      ,99,196,295,2515,,2144,4659
00172800,MORTON COLLEGE                          ,IL,60804-4398,Public       ,153,259,412,3159,,2538,5697
00173200,NATIONAL UNIV OF HEALTH SCIENCES        ,IL,60148-4583,Private      ,6,55,61,71,,980,1051
00173300,NATIONAL-LOUIS UNIVERSITY               ,IL,60603-3032,Private      ,24,477,501,562,,6426,6988
00173400,NORTH CENTRAL COLLEGE                   ,IL,60540-4690,Private      ,78,74,152,4608,,1147,5755
00173500,NORTH PARK UNIVERSITY                   ,IL,60625-4895,Private      ,81,205,286,3497,,2266,5763
00173600,NORTHERN BAPTIST THEOL SEMINARY         ,IL,60148-0000,Private      ,0,4,4,1,,96,97
00173700,NORTHERN ILLINOIS UNIVERSITY            ,IL,60115-2854,Public       ,630,641,1271,26074,,11864,37938
00173900,NORTHWESTERN UNIV                       ,IL,60208-0001,Private      ,510,668,1178,21668,,11176,32844
00174100,OLIVET NAZARENE UNIVERSITY              ,IL,60914-2271,Private      ,89,279,368,4083,,2982,7065
00174200,IL EASTERN COMM COLGS-OLNEY CENTRAL     ,IL,62450-1099,Public       ,23,80,103,618,,777,1395
00174500,QUINCY UNIVERSITY                       ,IL,62301-2699,Private      ,23,35,58,1778,,733,2511
00174600,ROBERT MORRIS UNIVERSITY ILLINOIS       ,IL,60605-1225,Private      ,171,426,597,6436,,6120,12556
00174700,ROCK VALLEY COLLEGE                     ,IL,61114-5699,Public       ,270,695,965,4075,,5725,9800
00174800,ROCKFORD COLLEGE                        ,IL,61108-2393,Private      ,53,161,214,1418,,1531,2949
00174900,ROOSEVELT UNIVERSITY                    ,IL,60605-1394,Private      ,188,554,742,6405,,8301,14706
00175000,DOMINICAN UNIVERSITY                    ,IL,60305-1066,Private      ,63,115,178,3850,,1975,5825
00175200,SAUK VALLEY COMMUNITY COLLEGE           ,IL,61021-9112,Public       ,72,176,248,1208,,1284,2492
00175300,SCHOOL OF ART INSTITUTE OF CHICAGO      ,IL,60603-3013,Private      ,212,182,394,4934,,2756,7690
00175600,SHIMER COLLEGE                          ,IL,60616-3893,Private      ,9,6,15,112,,81,193
00175700,SOUTHEASTERN ILLINOIS COLLEGE           ,IL,62946-4925,Public       ,40,91,131,807,,903,1710
00175800,SOUTHERN ILL UNIV-CARBONDALE            ,IL,62901-0000,Public       ,501,530,1031,19370,,9814,29184
00175900,SOUTHERN ILL UNIV-EDWARDSVILLE          ,IL,62026-1060,Public       ,437,388,825,14898,,6770,21668
00175924,SO IL UNIV-SCHL OF DENTAL MEDICINE      ,IL,62002-0000,Public       ,0,5,5,13,,218,231
00176500,UNIVERSITY OF ST MARY OF THE LAKE       ,IL,60060-0000,Private      ,0,3,3,6,,21,27
00176700,BENEDICTINE UNIVERSITY                  ,IL,60532-0900,Private      ,86,305,391,4184,,4652,8836
00176800,ST XAVIER UNIVERSITY                    ,IL,60655-3199,Private      ,156,242,398,6639,,4066,10705
00176900,SOUTH SUBURBAN COLLEGE                  ,IL,60473-9978,Public       ,184,650,834,3561,,6862,10423
00177100,TRINITY CHRISTIAN COLLEGE               ,IL,60463-0929,Private      ,29,62,91,1444,,1047,2491
00177200,TRINITY INTERNATIONAL UNIVERSITY        ,IL,60015-1283,Private      ,30,84,114,1030,,1189,2219
00177300,TRITON COLLEGE                          ,IL,60171-1995,Public       ,246,540,786,5154,,5817,10971
00177400,UNIVERSITY OF CHICAGO                   ,IL,60637-1476,Private      ,801,343,1144,22431,,4964,27395
00177401,UNIV OF CHICAGO PRITZKER SCH OF MED     ,IL,60637-0000,Private      ,7,10,17,100,,670,770
00177403,"UNIV OF CHICAGO, BOOTH SCH OF BUS       ",IL,60637-0000,Private      ,5,125,130,176,,1548,1724
00177405,UNIVERSITY OF CHICAGO GRADUATE          ,IL,60637-0000,Private      ,12,205,217,153,,5012,5165
00177500,UNIV OF ILLINOIS @ URBANA-CHAMPAIGN     ,IL,61820-5796,Public       ,749,436,1185,34757,,9805,44562
00177600,UNIV OF ILLINOIS AT CHICAGO             ,IL,60607-0000,Public       ,708,1129,1837,29906,,21922,51828
00177800,VANDERCOOK COLLEGE OF MUSIC             ,IL,60616-3731,Private      ,3,11,14,206,,131,337
00177900,IL EASTERN COMM COLGS-WABASH VALLEY     ,IL,62863-2699,Public       ,23,51,74,510,,449,959
00178000,WESTERN ILLINOIS UNIVERSITY             ,IL,61455-1390,Public       ,305,286,591,14407,,5264,19671
00178100,WHEATON COLLEGE                         ,IL,60187-5535,Private      ,70,38,108,3072,,669,3741
00178300,WORSHAM COLLEGE OF MORTUARY SCIENCE     ,IL,60090-2646,Proprietary  ,2,15,17,76,,178,254
00396100,HARPER COLLEGE                          ,IL,60067-7398,Public       ,332,638,970,6348,,5611,11959
00456000,GEM CITY COLLEGE                        ,IL,62301-4949,Proprietary  ,1,8,9,21,,66,87
00456800,MIDSTATE COLLEGE                        ,IL,61614-3558,Proprietary  ,12,94,106,140,,1025,1165
00621400,BLESSING RIEMAN COLLEGE OF NURSING      ,IL,62301-0000,Private      ,2,14,16,182,,231,413
00621401,BLESSING HOSPITAL - SCHOOL OF MEDICAL LA,IL,62305-7005,Private      ,1,6,7,20,,44,64
00621402,BLESSING HOSPITAL - SCHOOL OF RADIOLOGIC,IL,62305-7005,Private      ,2,6,8,33,,51,84
00622500,TRINITY COLLEGE OF NURSING AND HEALTH SC,IL,61201-5317,Private      ,6,13,19,138,,296,434
00622800,METHODIST MED CTR OF ILL SCH NRSNG      ,IL,61636-0000,Private      ,18,80,98,364,,729,1093
00624000,ST FRANCIS MED CLG OF NRSG              ,IL,61603-3783,Private      ,10,42,52,409,,693,1102
00638500,CHAMBERLAIN COLLEGE OF NURSING          ,IL,60101-0000,Proprietary  ,155,2888,3043,2609,,21332,23941
00665600,COLLEGE OF DUPAGE                       ,IL,60137-6599,Public       ,695,1219,1914,13069,,11753,24822
00675300,ILLINOIS CENTRAL COLLEGE                ,IL,61635-0001,Public       ,236,664,900,4898,,5933,10831
00693100,WAUBONSEE COMMUNITY COLLEGE             ,IL,60554-0000,Public       ,243,499,742,4069,,4723,8792
00711800,PARKLAND COLLEGE                        ,IL,61821-1899,Public       ,234,510,744,5255,,4545,9800
00711900,REND LAKE COLLEGE                       ,IL,62846-9801,Public       ,62,204,266,1331,,1743,3074
00717000,LINCOLN LAND COMMUNITY COLLEGE          ,IL,62794-9256,Public       ,193,601,794,3257,,4863,8120
00726500,CARL SANDBURG COLLEGE                   ,IL,61401-9576,Public       ,71,211,282,1166,,1718,2884
00730307,LINCOLN COLLEGE OF TECHNOLOGY - MELROSE ,IL,60160-1605,Proprietary  ,42,87,129,734,,695,1429
00750103,VATTEROTT COLLEGE - FAIRVIEW HEIGHTS    ,IL,62208-2029,Proprietary  ,35,155,190,192,,753,945
00754900,COYNE AMERICAN INSTITUTE                ,IL,60607-1300,Proprietary  ,41,204,245,467,,1496,1963
00764400,LAKE LAND COLLEGE                       ,IL,61938-9366,Public       ,120,289,409,2562,,2541,5103
00768400,KISHWAUKEE COLLEGE                      ,IL,60150-9699,Public       ,147,235,382,2639,,2506,5145
00769000,KANKAKEE COMMUNITY COLLEGE              ,IL,60901-6505,Public       ,110,313,423,1784,,3014,4798
00769100,MCHENRY COUNTY COLLEGE                  ,IL,60012-2761,Public       ,198,299,497,2792,,2739,5531
00769200,MORAINE VALLEY COMMUNITY COLLEGE        ,IL,60465-0937,Public       ,448,692,1140,8301,,6864,15165
00769300,SHAWNEE COMMUNITY COLLEGE               ,IL,62992-9725,Public       ,31,119,150,746,,1133,1879
00769400,COLLEGE OF LAKE COUNTY                  ,IL,60030-1198,Public       ,330,709,1039,5476,,6216,11692
00793700,MS ROBERTS ACADEMY OF BEAUTY CULT       ,IL,60181-2930,Proprietary  ,7,11,18,24,,68,92
00807600,JOHN A LOGAN COLLEGE                    ,IL,62918-2500,Public       ,143,291,434,2220,,2809,5029
00809003,EVEREST COLLEGE - BEDFORD PARK          ,IL,60629-5819,Proprietary  ,25,139,164,245,,966,1211
00814604,EVEREST UNIVERSITY - EVEREST  COLLEGE   ,IL,60803-4517,Proprietary  ,26,114,140,179,,638,817
00825900,EDUCATORS OF BEAUTY                     ,IL,61081-3611,Proprietary  ,7,18,25,68,,112,180
00825901,EDUCATORS OF BEAUTY                     ,IL,61104-0000,Proprietary  ,10,19,29,71,,140,211
00832800,ALVAREITA'S COLLEGE OF COSMETOLOGY      ,IL,62025-2041,Proprietary  ,2,21,23,59,,117,176
00869402,RASMUSSEN COLLEGE - ROCKFORD            ,IL,61108-2513,Proprietary  ,21,196,217,296,,1602,1898
00869403,RASMUSSEN COLLEGE - AURORA              ,IL,60506-6219,Proprietary  ,8,75,83,149,,750,899
00869404,RASMUSSEN COLLEGE - ROMEOVILLE          ,IL,60446-0000,Proprietary  ,13,112,125,226,,926,1152
00869418,RASMUSSEN COLLEGE -  MOKENA             ,IL,60448-0000,Proprietary  ,9,71,80,80,,539,619
00888000,MORRISON INSTITUTE OF TECHNOLOGY        ,IL,61270-2959,Private      ,1,5,6,146,,39,185
00893800,GRAHAM HOSPITAL SCH OF NURSING          ,IL,61520-2497,Private      ,2,7,9,34,,133,167
00893900,CANNELLA SCHOOL OF HAIR DESIGN          ,IL,60406-2130,Proprietary  ,3,7,10,33,,98,131
00914500,GOVERNORS STATE UNIVERSITY              ,IL,60466-0975,Public       ,66,478,544,1712,,7921,9633
00923200,CATHOLIC THEOLOGICAL UNION              ,IL,60615-0000,Private      ,0,2,2,5,,76,81
00933300,UNIV OF ILLINOIS AT SPRINGFIELD         ,IL,62703-5407,Public       ,98,253,351,3039,,3878,6917
00945918,EMPIRE BEAUTY SCHOOL - HANOVER PARK     ,IL,60133-5421,Proprietary  ,0,0,0,34,,68,102
00947500,EDUCATORS OF BEAUTY                     ,IL,61301-2404,Proprietary  ,0,7,7,32,,35,67
00959500,CANNELLA SCHOOL OF HAIR DESIGN          ,IL,60617-4303,Proprietary  ,6,22,28,97,,216,313
00976700,OLIVE-HARVEY COLLEGE                    ,IL,60628-1696,Public       ,151,569,720,2603,,6226,8829
00978600,IL EASTERN COMM COLGS-LINCOLN TRAIL     ,IL,62454-5708,Public       ,16,55,71,355,,445,800
00980000,RUSH UNIVERSITY                         ,IL,60612-3806,Private      ,24,211,235,475,,3782,4257
00989600,OAKTON COMMUNITY COLLEGE                ,IL,60016-1268,Public       ,229,464,693,4460,,3979,8439
00998700,SAINT ANTHONY COLLEGE OF NURSING        ,IL,61108-2468,Private      ,12,46,58,218,,529,747
01002000,LEWIS AND CLARK COMMUNITY COLLEGE       ,IL,62035-2466,Public       ,172,397,569,2555,,3206,5761
01050100,LAKEVIEW  COLLEGE OF NURSING            ,IL,61832-3781,Private      ,8,27,35,244,,343,587
01069500,TRI-COUNTY BEAUTY ACADEMY               ,IL,62056-2036,Proprietary  ,2,5,7,22,,33,55
01071000,CAPITAL AREA SCH OF PRAC NRSG           ,IL,62707-0000,Public       ,9,59,68,122,,664,786
01072700,DEVRY UNIVERSITY                        ,IL,60618-5994,Proprietary  ,1040,8398,9438,13658,,85427,99085
01083600,PIVOT POINT INTNL CSMTLGY RSRCH CTR     ,IL,60626-0000,Proprietary  ,21,81,102,383,,604,987
01087900,RICHLAND COMMUNITY COLLEGE              ,IL,62521-8513,Public       ,111,315,426,1210,,2591,3801
01091303,ROCKFORD CAREER COLLEGE                 ,IL,61108-3900,Proprietary  ,21,124,145,334,,1184,1518
01151002,EVEREST INSTITUTE - EVEREST COLLEGE     ,IL,60542-1610,Proprietary  ,21,104,125,196,,629,825
01181000,TAYLOR BUSINESS INSTITUTE               ,IL,60606-5111,Proprietary  ,5,40,45,43,,267,310
01185800,EVEREST COLLEGE                         ,IL,60077-1074,Proprietary  ,28,134,162,206,,593,799
01185802,EVEREST COLLEGE - BURR RIDGE            ,IL,60527-7826,Proprietary  ,23,72,95,147,,379,526
01185803,EVEREST COLLEGE - MELROSE PARK          ,IL,60160-1526,Proprietary  ,29,153,182,266,,817,1083
01236200,NORTHWESTERN COLLEGE                    ,IL,60630-2298,Proprietary  ,90,339,429,2207,,3861,6068
01238500,BLOOMINGTON-NORMAL SCH RADIOGRAPHY      ,IL,61761-4604,Private      ,2,6,8,36,,68,104
01258400,ILLINOIS INSTITUTE OF ART (THE)         ,IL,60654-1593,Proprietary  ,479,423,902,5958,,4523,10481
01281300,JOHN WOOD COMMUNITY COLLEGE             ,IL,62305-0401,Public       ,47,168,215,1183,,1439,2622
01308700,CAPRI GARFIELD RIDGE SCH OF BTY CLR     ,IL,60629-1613,Proprietary  ,3,20,23,94,,232,326
01308800,CAPRI OAK FOREST COLLEGE OF BEAUTY      ,IL,60452-2798,Proprietary  ,13,15,28,143,,174,317
02055200,HARRINGTON COLLEGE OF DESIGN            ,IL,60606-3433,Proprietary  ,18,78,96,370,,609,979
02068100,ADLER SCH OF PROFESSIONAL PSYCHLGY      ,IL,60601-0000,Private      ,9,82,91,154,,1827,1981
02069300,VATTEROTT COLLEGE                       ,IL,62305-5938,Proprietary  ,7,44,51,106,,388,494
02073200,TELSHE YESHIVA-CHICAGO                  ,IL,60625-0000,Private      ,0,1,1,33,,12,45
02074400,IL EASTERN COMM COLGS-FRONTIER          ,IL,62837-0000,Public       ,13,46,59,200,,370,570
02075400,KELLER GRADUATE SCHOOL OF MGMT.         ,IL,60515-5683,Proprietary  ,4,1304,1308,69,,16116,16185
02113600,AMERICAN INTERCONTINENTAL UNIVERSITY    ,IL,60192-3713,Proprietary  ,323,4473,4796,1554,,27121,28675
02117400,BECK AREA CAREER CENTER                 ,IL,62278-0000,Public       ,9,22,31,36,,187,223
02124400,UNIVERSITY OF SPA & COSMETOLOGY ART     ,IL,62704-0000,Proprietary  ,8,40,48,140,,238,378
02150600,COSMETOLOGY AND SPA INSTITUTE (THE)     ,IL,60014-4003,Proprietary  ,18,20,38,114,,204,318
02155300,THE CHICAGO SCHOOL OF PROF PSYCHOLOGY   ,IL,60610-4705,Private      ,3,335,338,117,,5888,6005
02160300,INTERNATIONAL ACAD OF DESIGN & TECH     ,IL,60602-3319,Proprietary  ,22,69,91,386,,635,1021
02160304,INTERNATIONAL ACADEMY OF DESIGN AND TECH,IL,60173-5160,Proprietary  ,5,44,49,134,,281,415
02168600,EAST WEST UNIVERSITY                    ,IL,60605-0000,Private      ,41,115,156,976,,1611,2587
02179900,ARGOSY UNIVERSITY                       ,IL,60601-7757,Proprietary  ,1193,6305,7498,9285,,40472,49757
02185400,ST AUGUSTINE COLLEGE                    ,IL,60640-0000,Private      ,34,170,204,743,,2295,3038
02192400,MR JOHNS SCHOOL OF COSMETOLOGY          ,IL,62521-0000,Proprietary  ,3,19,22,27,,125,152
02202600,CANNELLA SCHOOL OF HAIR DESIGN          ,IL,60181-1321,Proprietary  ,1,4,5,15,,81,96
02214100,RESURRECTION UNIVERSITY                 ,IL,60302-2519,Private      ,7,42,49,250,,909,1159
02228100,MAC DANIEL'S BEAUTY SCHOOL              ,IL,60640-0000,Proprietary  ,4,17,21,56,,118,174
02261200,HAIR PROFESSIONALS ACAD COSMETOLOGY     ,IL,60118-0000,Proprietary  ,6,42,48,46,,201,247
02261201,HAIR PROFESSIONALS ACADEMY OF COSMETOLOG,IL,60118-9333,Proprietary  ,1,2,3,8,,20,28
02262100,HAIR PROFESSIONALS SCH COSMETOLOGY      ,IL,60543-0000,Proprietary  ,4,14,18,37,,85,122
02291200,CANNELLA SCHOOL OF HAIR DESIGN          ,IL,60639-0000,Proprietary  ,7,31,38,121,,209,330
02295500,CANNELLA SCHOOL OF HAIR DESIGN          ,IL,60120-0000,Proprietary  ,0,11,11,35,,89,124
02297500,OEHRLEIN SCHOOL OF COSMETOLOGY          ,IL,61611-0000,Proprietary  ,7,15,22,74,,113,187
02312300,LA' JAMES COLLEGE HAIRSTYLING           ,IL,61244-0000,Proprietary  ,1,9,10,24,,65,89
02313900,WESTWOOD COLLEGE - O'HARE AIRPORT       ,IL,60631-2801,Proprietary  ,28,99,127,309,,793,1102
02317300,CONCEPT COLLEGE OF COSMETOLOGY          ,IL,61832-0000,Proprietary  ,6,26,32,64,,152,216
02319200,LAKE FOREST GRAD SCHL OF MGMT           ,IL,60045-4824,Private      ,0,48,48,2,,297,299
02323300,PROFESSIONAL'S CHOICE HAIR DSN ACAD     ,IL,60435-0000,Proprietary  ,1,25,26,49,,135,184
02332200,HAIR PROFESSIONALS CAREER COLLEGE       ,IL,60178-0000,Proprietary  ,1,5,6,29,,75,104
02349400,ALVAREITA'S COLLEGE OF COSMETOLOGY      ,IL,62035-0000,Proprietary  ,3,22,25,40,,104,144
02349500,CANNELLA SCHOOL OF HAIR DESIGN          ,IL,60632-0000,Proprietary  ,9,42,51,135,,288,423
02352200,LE CORDON BLEU COLLEGE OF CULINARY ARTS ,IL,60610-3050,Proprietary  ,81,266,347,938,,1846,2784
02498200,G SKIN & BEAUTY INSTITUTE               ,IL,60523-1805,Proprietary  ,13,63,76,114,,317,431
02498201,HAIR PROFESSIONALS ACADEMY OF COSMETOLOG,IL,60563-0000,Proprietary  ,1,6,7,22,,56,78
02522800,FOX COLLEGE                             ,IL,60453-0000,Proprietary  ,29,42,71,525,,567,1092
02527600,LEXINGTON COLLEGE                       ,IL,60607-0000,Private      ,5,12,17,94,,108,202
02536700,BELL MAR BEAUTY COLLEGE                 ,IL,60650-0000,Proprietary  ,7,13,20,40,,82,122
02556100,ENVIRONMENTAL TECHNICAL INSTITUTE       ,IL,60143-0000,Proprietary  ,29,100,129,113,,388,501
02556600,NILES SCHOOL OF COSMETOLOGY             ,IL,60714-0000,Proprietary  ,2,9,11,19,,50,69
02573700,INSTITUTE FOR CLINICAL SOCIAL WORK      ,IL,60605-1229,Private      ,2,29,31,51,,321,372
02579200,INGALLS MEMORIAL HOSPITAL               ,IL,60426-0000,Private      ,0,0,0,2,,20,22
02584900,"FIRST INSTITUTE, INC.                   ",IL,60014-7489,Proprietary  ,16,36,52,117,,316,433
02587700,HAIR PROFESSIONALS CAREER COLLEGE       ,IL,60465-1929,Proprietary  ,4,8,12,42,,115,157
02622700,KNOWLEDGE SYSTEMS INSTITUTE             ,IL,60076-0000,Private      ,0,2,2,1,,10,11
03002000,HAIRMASTERS INST OF COSMETOLOGY         ,IL,61701-5547,Proprietary  ,8,17,25,55,,98,153
03027702,PACIFIC COLLEGE OF ORIENTAL MEDICINE - C,IL,60613-4418,Proprietary  ,6,35,41,53,,329,382
03065300,TREND SETTERS COLL OF COSMETOLOGY       ,IL,60915-0000,Proprietary  ,39,40,79,215,,254,469
03072701,WESTWOOD COLLEGE OF TECHNOLOGY          ,IL,60409-0000,Proprietary  ,15,83,98,202,,702,904
03072702,WESTWOOD COLLEGE OF TECHNOLOGY          ,IL,60602-0000,Proprietary  ,29,150,179,389,,1240,1629
03078400,CAMEO BEAUTY ACADEMY                    ,IL,60453-3196,Proprietary  ,5,16,21,54,,96,150
03079200,WESTWOOD COLLEGE - DUPAGE               ,IL,60517-2321,Proprietary  ,16,58,74,243,,650,893
03082900,ROSEL SCHOOL OF COSMETOLOGY             ,IL,60659-1913,Proprietary  ,4,29,33,56,,133,189
03083800,HEARTLAND COMMUNITY COLLEGE             ,IL,61761-9446,Public       ,147,296,443,2685,,2634,5319
03098000,ST JOHN'S COLLEGE OF NURSING            ,IL,62702-5321,Private      ,5,33,38,207,,308,515
03098002,ST JOHN'S HOSP SCH MED TECH             ,IL,62769-5324,Private      ,3,16,19,37,,125,162
03099700,CAIN'S BARBER COLLEGE                   ,IL,60615-3510,Proprietary  ,12,92,104,163,,499,662
03099800,ILLINOIS SCHOOL OF HEALTH CAREERS       ,IL,60604-0000,Proprietary  ,50,195,245,549,,1499,2048
03101800,ILLINOIS CENTER FOR BROADCASTING        ,IL,60148-7015,Proprietary  ,19,63,82,168,,398,566
03128500,NATIONAL LATINO EDUCATION INSTITUTE     ,IL,60609-2205,Private      ,4,17,21,72,,145,217
03199300,CHRISTIAN LIFE COLLEGE                  ,IL,60056-2522,Private      ,0,2,2,22,,23,45
03368300,MIDWEST TECHNICAL INSTITUTE             ,IL,62707-8805,Proprietary  ,152,623,775,1021,,3278,4299
03416300,COMPUTER SYSTEMS INSTITUTE              ,IL,60077-0000,Proprietary  ,58,297,355,354,,1356,1710
03448300,BUSINESS INDUSTRIAL RESOURCES           ,IL,60659-1298,Proprietary  ,72,621,693,432,,3829,4261
03455700,CORTIVA INSTITUTE - CHICAGO             ,IL,60602-3315,Proprietary  ,38,99,137,225,,494,719
03455701,CORTIVA INSTITUTE - CHICAGO             ,IL,60014-6285,Proprietary  ,0,11,11,15,,53,68
03490301,PAUL MITCHELL THE SCHOOL CHICAGO        ,IL,60607-0000,Proprietary  ,46,99,145,285,,422,707
03510300,ERIKSON INSTITUTE                       ,IL,60654-4510,Private      ,1,28,29,9,,369,378
03643300,"MR. JOHN'S SCHOOL OF JACKSONVILLE,  INC,",IL,62650-3488,Proprietary  ,2,5,7,26,,39,65
03655300,ILLINOIS CAREERPATH INSTITUTE           ,IL,60610-4705,Private      ,1,40,41,44,,197,241
03684300,NORTHSHORE UNIVERSITY HEALTHSYSTEM SCHOO,IL,60201-9872,Private      ,1,7,8,10,,59,69
03881400,EUROPEAN MASSAGE THERAPY SCHOOL         ,IL,60077-2269,Proprietary  ,1,26,27,19,,151,170
03891300,SOMA INSTITUTE - THE NATIONAL SCHOOL OF ,IL,60604-4466,Proprietary  ,11,37,48,66,,199,265
03914300,"CALC, INSTITUTE OF TECHNOLOGY           ",IL,62002-5931,Proprietary  ,8,44,52,57,,248,305
04117500,SOLEX MEDICAL ACADEMY                   ,IL,60090-3104,Proprietary  ,2,7,9,8,,43,51
04117600,LARRY'S BARBER COLLEGE                  ,IL,60628-2322,Proprietary  ,22,82,104,183,,563,746
04118400,ZAREM /GOLDE ORT TECHNICAL INSTITUTE    ,IL,60077-3210,Private      ,7,57,64,33,,253,286
04124700,AMBRIA COLLEGE OF NURSING               ,IL,60192-3712,Proprietary  ,12,153,165,79,,556,635
04136900,UNIVERSITY OF AESTHETICS (THE)          ,IL,60622-2151,Proprietary  ,5,11,16,26,,92,118
04137000,UNIVERSITY OF AESTHETICS (THE)          ,IL,60515-5602,Proprietary  ,2,4,6,19,,43,62
04137500,TRICOCI UNIVERSITY OF BEAUTY CULTURE    ,IL,60656-1805,Proprietary  ,16,55,71,289,,404,693
04139000,MIDWESTERN CAREER COLLEGE               ,IL,60606-3103,Proprietary  ,21,97,118,127,,736,863
04141000,AVEDA INSTITUTE CHICAGO                 ,IL,60647-0000,Proprietary  ,15,65,80,263,,469,732
04147100,TRICOCI UNIVERSITY OF BEAUTY CULTURE    ,IL,60048-2906,Proprietary  ,4,18,22,106,,122,228
04147200,TRICOCI UNIVERSITY OF BEAUTY CULTURE    ,IL,60455-1824,Proprietary  ,9,29,38,118,,193,311
04147300,TRICOCI UNIVERSITY OF BEAUTY CULTURE    ,IL,60139-3119,Proprietary  ,22,18,40,147,,144,291
04147400,TRICOCI UNIVERSITY OF BEAUTY CULTURE    ,IL,61614-4831,Proprietary  ,9,17,26,86,,155,241
04147500,TRICOCI UNIVERSITY OF BEAUTY CULTURE    ,IL,61108-2337,Proprietary  ,9,26,35,114,,207,321
04160600,PAUL MITCHELL THE SCHOOL NORMAL         ,IL,61761-0000,Proprietary  ,13,13,26,181,,173,354
04167800,INNOVATIONS DESIGN ACADEMY              ,IL,61520-2625,Proprietary  ,2,7,9,28,,76,104
04168500,SOLEX COLLEGE                           ,IL,60090-3192,Proprietary  ,3,98,101,20,,274,294
04170800,UNITY COSMETOLOGY COLLEGE               ,IL,61764-9652,Proprietary  ,2,7,9,25,,58,83
04171600,SALON PROFESSIONAL ACADEMY OF ELGIN (THE,IL,60123-2319,Proprietary  ,3,18,21,27,,82,109
04172200,NORTHWESTERN INSTITUTE OF HEALTH AND TEC,IL,60640-4785,Private      ,0,0,0,219,,604,823
04174900,SKIN CARE AND SPA INSTITUTE             ,IL,60077-2200,Proprietary  ,2,21,23,16,,129,145
04175000,UNIVERSAL SPA TRAINING ACADEMY          ,IL,60515-0000,Proprietary  ,3,24,27,26,,121,147
04175800,J RENEE CAREER FACILITATION             ,IL,60014-7986,Proprietary  ,1,26,27,17,,133,150
04179100,PCCTI  IT & HEALTHCARE                  ,IL,60523-0000,Proprietary  ,2,62,64,40,,507,547
04179101,PCCTI  IT & HEALTHCARE -                ,IL,60606-0000,Proprietary  ,2,25,27,29,,238,267
04186000,CHICAGO SCHOOL FOR PIANO TECHNOLOGY (THE,IL,60612-1630,Private      ,2,4,6,19,,57,76
04187400,COSMETOLOGY CONCEPTS                    ,IL,60452-2501,Proprietary  ,14,39,53,122,,264,386
04189200,SALON PROFESSIONAL ACADEMY (THE)        ,IL,60404-8789,Proprietary  ,5,7,12,37,,83,120
04189400,SHEAR LEARNING ACADEMY OF COSMETOLOGY   ,IL,62523-1208,Proprietary  ,3,6,9,28,,47,75
04189600,STATE CAREER SCHOOL                     ,IL,60085-5129,Proprietary  ,3,22,25,53,,174,227
04192000,CURVE METRIC SCHOOL OF HAIR DESIGN      ,IL,60707-1118,Proprietary  ,2,6,8,14,,36,50
04195600,TRIBECA FLASHPOINT MEDIA ARTS ACADEMY   ,IL,60602-2716,Proprietary  ,35,41,76,337,,249,586
04224400,NETWORKS BARBER COLLEGE                 ,IL,60409-3401,Proprietary  ,3,6,9,4,,23,27
04224500,TRENZ BEAUTY ACADEMY                    ,IL,60409-0000,Proprietary  ,1,14,15,6,,40,46
04225300,CREATIVE TOUCH COSMETOLOGY SCHOOL       ,IL,62298-1609,Proprietary  ,0,1,1,0,,1,1
04227900,MORTHLAND COLLEGE                       ,IL,62896-2742,Private      ,9,2,11,9,,2,11
04229900,DEBUTANTES SCHOOL OF COSMETOLOGY AND NAI,IL,60115-3301,Proprietary  ,3,2,5,3,,2,5
00195100,ALICE LLOYD COLLEGE                     ,KY,41844-9703,Private      ,24,13,37,1312,,274,1586
00195200,ASBURY COLLEGE                          ,KY,40390-1198,Private      ,47,61,108,1796,,794,2590
00195300,ASBURY THEOLOGICAL SEMINARY             ,KY,40390-0000,Private      ,1,52,53,34,,1424,1458
00195400,BELLARMINE UNIVERSITY                   ,KY,40205-1877,Private      ,148,203,351,5363,,2402,7765
00195500,BEREA COLLEGE                           ,KY,40403-0000,Private      ,107,64,171,3326,,979,4305
00195800,BRESCIA UNIVERSITY                      ,KY,42301-3023,Private      ,40,88,128,1151,,1036,2187
00195900,CAMPBELLSVILLE UNIVERSITY               ,KY,42718-2799,Private      ,81,152,233,2998,,1942,4940
00196000,SPALDING UNIVERSITY                     ,KY,40203-2188,Private      ,51,227,278,1545,,3353,4898
00196100,CENTRE COLLEGE                          ,KY,40422-1394,Private      ,59,18,77,2715,,164,2879
00196200,UNIVERSITY OF THE CUMBERLANDS           ,KY,40769-1372,Private      ,72,268,340,2911,,3364,6275
00196300,EASTERN KENTUCKY UNIVERSITY             ,KY,40475-3102,Public       ,469,797,1266,14426,,11362,25788
00196400,GEORGETOWN COLLEGE                      ,KY,40324-1628,Private      ,58,71,129,2282,,807,3089
00196500,KENTUCKY CHRISTIAN UNIVERSITY           ,KY,41143-2205,Private      ,29,37,66,909,,288,1197
00196800,KENTUCKY STATE UNIVERSITY               ,KY,40601-2355,Public       ,113,159,272,3841,,2312,6153
00196900,KENTUCKY WESLEYAN COLLEGE               ,KY,42301-6057,Private      ,28,38,66,1305,,450,1755
00197100,LEXINGTON THEOLOGICAL SEMINARY          ,KY,40508-0000,Private      ,0,12,12,8,,121,129
00197200,LINDSEY WILSON COLLEGE                  ,KY,42728-1223,Private      ,62,129,191,3244,,1971,5215
00197400,LOUISVILLE PRESBYTERIAN THEOL SEM       ,KY,40205-0000,Private      ,1,7,8,9,,207,216
00197500,MIDWAY COLLEGE                          ,KY,40347-1120,Private      ,23,97,120,682,,1983,2665
00197600,MOREHEAD STATE UNIVERSITY               ,KY,40351-1689,Public       ,188,403,591,8985,,5803,14788
00197700,MURRAY STATE UNIVERSITY                 ,KY,42071-0009,Public       ,255,331,586,8693,,4816,13509
00197900,WEST KENTUCKY CMNTY & TECHNICAL COLG    ,KY,42002-7380,Public       ,144,479,623,2305,,4824,7129
00198000,UNIVERSITY OF PIKEVILLE                 ,KY,41501-1194,Private      ,69,72,141,2488,,1484,3972
00198300,ST. CATHARINE COLLEGE                   ,KY,40061-9499,Private      ,18,23,41,815,,487,1302
00198700,TRANSYLVANIA UNIVERSITY                 ,KY,40508-1797,Private      ,39,42,81,2162,,357,2519
00198800,UNION COLLEGE                           ,KY,40906-1499,Private      ,33,76,109,1443,,929,2372
00198900,UNIVERSITY OF KENTUCKY                  ,KY,40506-0054,Public       ,705,623,1328,25808,,11203,37011
00198901,UNIV OF KY-COLLEGE OF DENTISTRY         ,KY,40536-0000,Public       ,4,14,18,52,,306,358
00198902,UNIV OF KY-COLLEGE OF MEDICINE          ,KY,40536-0000,Public       ,9,22,31,155,,647,802
00199000,ASHLAND COMMUNITY AND TECHNICAL COLLEGE ,KY,41101-3683,Public       ,91,403,494,1618,,3350,4968
00199100,ELIZABETHTOWN COMMUNITY  AND TECHNICAL C,KY,42701-3081,Public       ,158,594,752,2825,,6152,8977
00199300,HENDERSON COMMUNITY COLLEGE             ,KY,42420-4699,Public       ,45,192,237,646,,1681,2327
00199400,HOPKINSVILLE COMMUNITY COLLEGE          ,KY,42241-2621,Public       ,74,482,556,1195,,4416,5611
00199600,BIG SANDY COMMUNITY AND TECHNICAL COLG  ,KY,41653-1815,Public       ,97,411,508,2290,,3454,5744
00199700,SOMERSET COMMUNITY COLLEGE              ,KY,42501-2973,Public       ,179,773,952,3403,,7727,11130
00199800,SOUTHEAST KENTUCKY COMMUNITY AND TECHNIC,KY,40823-1099,Public       ,60,211,271,1467,,2502,3969
00199900,UNIVERSITY OF LOUISVILLE                ,KY,40292-0000,Public       ,548,880,1428,17725,,14530,32255
00200100,THOMAS MORE COLLEGE                     ,KY,41017-3495,Private      ,39,100,139,1607,,820,2427
00200200,WESTERN KENTUCKY UNIVERSITY             ,KY,42101-3576,Public       ,517,689,1206,17588,,10786,28374
00461800,SPENCERIAN COLLEGE                      ,KY,40216-2605,Proprietary  ,52,191,243,690,,1834,2524
00461900,SULLIVAN UNIVERSITY                     ,KY,40205-3000,Proprietary  ,170,594,764,2271,,6589,8860
00493402,DAYMAR COLLEGE - BOWLING GREEN          ,KY,42101-4063,Proprietary  ,7,49,56,138,,510,648
00493403,DAYMAR COLLEGE - CLINTON                ,KY,42031-9998,Proprietary  ,0,4,4,1,,41,42
00493406,DAYMAR COLLEGE - RUSSELLVILLE           ,KY,42276-1622,Proprietary  ,3,12,15,23,,115,138
00524400,BLUEGRASS COMMUNITY & TECHNICAL COLLEGE ,KY,40506-0235,Public       ,331,1192,1523,6430,,11542,17972
00527100,BOWLING GREEN TECHNICAL COLLEGE         ,KY,42101-3601,Public       ,137,418,555,2080,,4282,6362
00527300,GATEWAY COMMUNITY & TECHNOLOGY COLL     ,KY,41011-0000,Public       ,100,474,574,1662,,4677,6339
00696000,MAYSVILLE CMNTY & TECHNCL COLG          ,KY,41056-8910,Public       ,78,419,497,1421,,3557,4978
00696100,JEFFERSON COMMUNITY AND TECHNICAL COLLEG,KY,40202-2005,Public       ,502,1753,2255,7610,,15854,23464
00696200,HAZARD COMMUNITY COLLEGE                ,KY,41701-2402,Public       ,70,288,358,1580,,2844,4424
00696203,KY TECH-KNOTT CO. TECHNOLOGY CTR        ,KY,41822-0000,Public       ,1,3,4,12,,21,33
00696204,KY TECH-LESLIE COUNTY AREA TECH CTR     ,KY,41749-0000,Public       ,0,3,3,6,,23,29
00696205,KY TECH-LEE COUNTY AREA TECH CTR        ,KY,41311-0000,Public       ,0,1,1,5,,17,22
00696206,KY TECH-LETCHER CNTY AREA TECH CTR      ,KY,41858-0000,Public       ,1,11,12,31,,84,115
00696207,KY TECH-BREATHITT COUNTY VOC ED CTR     ,KY,41339-0000,Public       ,2,11,13,38,,85,123
00736205,MEDTECH COLLEGE - LEXINGTON             ,KY,40511-1200,Proprietary  ,13,126,139,141,,816,957
00757303,EMPIRE BEAUTY SCHOOL - HURSTBOURNE      ,KY,40291-1931,Proprietary  ,0,0,0,119,,344,463
00757305,EMPIRE BEAUTY SCHOOL - DIXIE            ,KY,40216-4212,Proprietary  ,0,0,0,72,,182,254
00842500,DAYMAR COLLEGE                          ,KY,42001-0000,Proprietary  ,9,54,63,57,,352,409
00901000,MADISONVILLE COMMUNITY COLLEGE          ,KY,42431-9199,Public       ,60,292,352,1238,,2658,3896
00927500,NORTHERN KENTUCKY UNIVERSITY            ,KY,41099-0001,Public       ,287,547,834,11379,,8335,19714
00931300,DAYMAR COLLEGE                          ,KY,42301-5830,Proprietary  ,15,130,145,147,,1455,1602
00931302,DAYMAR COLLEGE - LOUISVILLE             ,KY,40219-1973,Proprietary  ,14,65,79,133,,645,778
00931304,DAYMAR COLLEGE - ALBANY                 ,KY,42602-1235,Proprietary  ,1,2,3,7,,15,22
00931305,DAYMAR COLLEGE - BELLEVUE               ,KY,41073-2416,Proprietary  ,0,3,3,20,,76,96
00931308,DAYMAR COLLEGE -  SCOTTSVILLE           ,KY,42164-1505,Proprietary  ,0,3,3,9,,61,70
00931309,DAYMAR COLLEGE - LOUISVILLE EAST        ,KY,40245-1629,Proprietary  ,5,35,40,56,,304,360
00931310,DAYMAR COLLEGE -  MADISONVILLE          ,KY,42431-0000,Proprietary  ,4,27,31,24,,179,203
00945913,EMPIRE BEAUTY SCHOOL - FLORENCE         ,KY,41042-5113,Proprietary  ,0,0,0,81,,204,285
01042400,SALON PROFESSIONAL ACADEMY THE          ,KY,40502-0000,Proprietary  ,19,45,64,143,,356,499
01048901,NATIONAL COLLEGE - FLORENCE CAMPUS      ,KY,41042-1812,Proprietary  ,3,30,33,33,,335,368
01048902,NATIONAL COLLEGE - PIKEVILLE CAMPUS     ,KY,41501-1518,Proprietary  ,7,58,65,179,,556,735
01048903,NATIONAL COLLEGE - DANVILLE CAMPUS      ,KY,40422-1517,Proprietary  ,1,28,29,60,,369,429
01048904,NATIONAL COLLEGE - RICHMOND CAMPUS      ,KY,40475-2309,Proprietary  ,7,35,42,71,,463,534
01048906,NATIONAL COLLEGE - LOUISVILLE CAMPUS    ,KY,40216-4147,Proprietary  ,10,111,121,117,,961,1078
01048907,NATIONAL COLLEGE - LEXINGTON CAMPUS     ,KY,40509-2256,Proprietary  ,10,76,86,118,,870,988
01054210,EMPIRE BEAUTY SCHOOL - CHENOWETH        ,KY,40207-2695,Proprietary  ,0,0,0,69,,151,220
01172500,COLLINS SCHOOL OF COSMETOLOGY           ,KY,40965-2809,Proprietary  ,2,13,15,30,,90,120
01208800,SULLIVAN COLLEGE OF TECHNOLOGY AND DESIG,KY,40218-4528,Proprietary  ,43,128,171,589,,1001,1590
01212801,SOUTHWESTERN COLLEGE                    ,KY,41042-1466,Proprietary  ,1,19,20,73,,291,364
01260609,EMPIRE BEAUTY SCHOOL - HIGHLAND         ,KY,40204-1317,Proprietary  ,0,0,0,60,,170,230
01272300,KY TECH-WAYNE COUNTY AREA TECH CTR      ,KY,42633-1088,Public       ,0,1,1,2,,7,9
01291700,EMPIRE BEAUTY SCHOOL                    ,KY,42701-2949,Proprietary  ,0,0,0,75,,175,250
02159100,"APPALACHIAN BEAUTY SCHOOL, INC.         ",KY,41503-0000,Proprietary  ,1,7,8,37,,59,96
02251500,TREND SETTERS ACAD OF BEAUTY CULT       ,KY,40258-0000,Proprietary  ,9,48,57,71,,270,341
02275000,JENNY LEA ACADEMY OF COSMETOLOGY        ,KY,40831-0000,Proprietary  ,9,43,52,89,,298,387
02284306,INTERACTIVE LEARNING SYSTEMS            ,KY,41042-0000,Proprietary  ,4,21,25,18,,93,111
02323700,PAT WILSON'S BEAUTY COLLEGE             ,KY,42420-0000,Proprietary  ,2,14,16,15,,96,111
02337200,PJ'S COLLEGE OF COSMETOLOGY             ,KY,42101-0000,Proprietary  ,13,51,64,126,,501,627
02340800,PAUL MITCHELL THE SCHOOL LEXINGTON      ,KY,40514-1545,Proprietary  ,16,41,57,229,,381,610
02351700,PAUL MITCHELL THE SCHOOL - LOUISVILLE   ,KY,40222-0000,Proprietary  ,22,38,60,233,,371,604
02491100,BECKFIELD COLLEGE                       ,KY,41042-0000,Proprietary  ,43,309,352,320,,2464,2784
02518900,BARRETT & COMPANY SCH HAIR DESIGN       ,KY,40356-0000,Proprietary  ,2,17,19,44,,182,226
02526100,JENNY LEA ACADEMY OF COSMETOLOGY        ,KY,41858-0000,Proprietary  ,5,14,19,30,,73,103
02535600,CLEAR CREEK BAPTIST BIBLE COLLEGE       ,KY,40977-0000,Private      ,3,13,16,47,,144,191
02551100,PJ'S COLLEGE OF COSMETOLOGY             ,KY,42141-2434,Proprietary  ,6,21,27,38,,119,157
02560800,SOUTHEAST SCHOOL OF COSMETOLOGY         ,KY,40962-0000,Proprietary  ,1,12,13,17,,91,108
02576200,MID-CONTINENT UNIVERSITY                ,KY,42066-9007,Private      ,18,238,256,465,,3764,4229
03002100,KENTUCKY MOUNTAIN BIBLE COLLEGE         ,KY,41385-0010,Private      ,3,7,10,55,,45,100
03007000,FRONTIER SCH OF MIDWIFERY&FAMILY NU     ,KY,41749-0000,Private      ,0,306,306,10,,1976,1986
03026200,HEAD'S WEST KENTUCKY BEAUTY COLLEGE     ,KY,42431-0000,Proprietary  ,2,12,14,23,,89,112
03029200,NU-TEK ACADEMY OF BEAUTY                ,KY,40353-9767,Proprietary  ,3,8,11,25,,64,89
03034500,OWENSBORO COMMUNITY & TECHNICAL COLLEGE ,KY,42303-1899,Public       ,120,394,514,1877,,3423,5300
03083700,GALEN HEALTH INSTITUTES                 ,KY,40207-1047,Proprietary  ,80,601,681,953,,5949,6902
03103500,MR JIM'S BEAUTY COLLEGE                 ,KY,42301-2646,Proprietary  ,0,0,0,20,,40,60
03516500,EZELL'S COSMETOLOGY SCHOOL              ,KY,42071-2530,Proprietary  ,6,5,11,39,,88,127
03611300,BRIGHTON CENTER'S CENTER FOR EMPLOY     ,KY,41071-1968,Private      ,1,22,23,9,,97,106
03804300,BELLEFONTE ACADEMY OF BEAUTY            ,KY,41169-2015,Proprietary  ,6,38,44,32,,200,232
03885300,EMPLOYMENT SOLUTIONS                    ,KY,40517-3260,Private      ,7,75,82,82,,479,561
03886300,REGENCY SCHOOL OF HAIR DESIGN           ,KY,41653-1278,Proprietary  ,4,14,18,28,,105,133
04038300,ATA CAREER EDUCATION                    ,KY,40223-3832,Proprietary  ,27,141,168,251,,1156,1407
04051316,ART INSTITUTE OF PHOENIX (THE) - ATS - (,KY,41017-2136,Proprietary  ,11,52,63,135,,618,753
04051319,ART INSTITUTE OF PHOENIX (THE) - BROWN M,KY,40219-1916,Proprietary  ,12,67,79,198,,695,893
04051320,ART INSTITUTE OF PHOENIX (THE) - BROWN M,KY,42240-3579,Proprietary  ,1,19,20,50,,236,286
04123900,LEXINGTON HEALING ARTS ACADEMY          ,KY,40503-1932,Proprietary  ,5,42,47,68,,220,288
04177600,LINDSEY INSTITUTE OF COSMETOLOGY        ,KY,42103-8036,Proprietary  ,5,22,27,80,,150,230
04177700,TRI-STATE INSTITUTE OF HAIR DESIGN      ,KY,40744-5234,Proprietary  ,2,20,22,35,,116,151
04178000,SIMMONS COLLEGE OF KENTUCKY             ,KY,40203-3322,Private      ,2,27,29,40,,201,241
00200300,CENTENARY COLLEGE OF LOUISIANA          ,LA,71104-3396,Private      ,31,40,71,987,,376,1363
00200400,DILLARD UNIVERSITY                      ,LA,70122-3097,Private      ,112,144,256,2788,,1551,4339
00200500,NICHOLLS STATE UNIVERSITY               ,LA,70310-0001,Public       ,186,276,462,6386,,3285,9671
00200600,GRAMBLING STATE UNIVERSITY              ,LA,71245-2215,Public       ,174,298,472,6395,,4548,10943
00200700,LOUISIANA COLLEGE                       ,LA,71359-0000,Private      ,31,48,79,1381,,816,2197
00200800,LOUISIANA TECH UNIVERSITY               ,LA,71272-0001,Public       ,245,300,545,8180,,3566,11746
00201000,LOUISIANA STATE UNIV & A&M COLG         ,LA,70803-5710,Public       ,942,582,1524,28296,,9727,38023
00201100,LOUISIANA STATE UNIV-ALEXANDRIA         ,LA,71302-9121,Public       ,105,222,327,2092,,2188,4280
00201200,LOUISIANA STATE UNIV-EUNICE             ,LA,70535-6726,Public       ,128,198,326,2360,,2020,4380
00201300,LOUISIANA STATE UNIV-SHREVEPORT         ,LA,71115-2399,Public       ,127,454,581,3231,,4233,7464
00201400,LA STATE UNIV HEALTH SCIENCES CTR       ,LA,70112-2223,Public       ,22,148,170,733,,2803,3536
00201500,(THE) UNIVERSITY OF NEW ORLEANS         ,LA,70148-0001,Public       ,355,729,1084,7643,,8187,15830
00201600,LOYOLA UNIVERSITY NEW ORLEANS           ,LA,70118-6195,Private      ,178,240,418,5455,,3419,8874
00201700,MCNEESE STATE UNIVERSITY                ,LA,70609-4510,Public       ,215,353,568,6061,,4288,10349
00201900,NEW ORLEANS BAPTIST THEOL SEMINARY      ,LA,70126-0000,Private      ,2,34,36,59,,310,369
00202000,UNIVERSITY OF LOUISIANA AT MONROE       ,LA,71209-9001,Public       ,269,422,691,7536,,5361,12897
00202100,NORTHWESTERN STATE UNIVERSITY           ,LA,71497-0001,Public       ,207,578,785,6517,,6455,12972
00202200,NOTRE DAME SEMINARY                     ,LA,70118-0000,Private      ,0,1,1,17,,38,55
00202300,OUR LADY OF HOLY CROSS COLLEGE          ,LA,70131-7399,Private      ,29,153,182,661,,1582,2243
00202400,SOUTHEASTERN LOUISIANA UNIV             ,LA,70402-0001,Public       ,399,502,901,12337,,6352,18689
00202500,SOUTHERN UNIVERSITY A & M COLLEGE       ,LA,70813-9374,Public       ,242,531,773,8247,,7738,15985
00202600,SOUTHERN UNIV NEW ORLEANS               ,LA,70126-0002,Public       ,117,452,569,2674,,5357,8031
00202700,ST JOSEPH SEMINARY COLLEGE              ,LA,70457-9990,Private      ,8,3,11,61,,21,82
00202900,TULANE UNIVERSITY                       ,LA,70118-5698,Private      ,470,425,895,12603,,8050,20653
00203100,UNIV OF LOUISIANA AT LAFAYETTE          ,LA,70504-0001,Public       ,490,572,1062,15251,,7003,22254
00203200,XAVIER UNIVERSITY OF LOUISIANA          ,LA,70125-1098,Private      ,162,137,299,5263,,2231,7494
00462100,AYERS CAREER COLLEGE                    ,LA,71108-5845,Proprietary  ,18,107,125,99,,568,667
00462500,DELGADO COMMUNITY COLLEGE               ,LA,70119-0000,Public       ,728,2107,2835,9647,,19691,29338
00546700,SOWELA TECHNICAL COMMUNITY COLLEGE      ,LA,70616-6950,Public       ,129,364,493,1623,,2442,4065
00546702,SOWELA TECHNICAL COMMUNITY COLLEGE - MOR,LA,70546-1327,Public       ,8,19,27,91,,153,244
00547100,NORTHEAST LOUISIANA TECHNICAL COLLEGE   ,LA,71292-9064,Public       ,5,21,26,287,,740,1027
00547101,NORTHEAST LOUISIANA TECHNICAL COLLEGE   ,LA,71241-0000,Public       ,0,0,0,9,,14,23
00547102,NORTHEAST LOUISIANA TECHNICAL COLLEGE   ,LA,71270-0000,Public       ,4,15,19,165,,343,508
00547103,NORTHEAST LOUISIANA TECHNICAL COLLEGE   ,LA,71295-0000,Public       ,1,4,5,78,,186,264
00547104,NORTHEAST LOUISIANA TECHNICAL COLLEGE   ,LA,71220-0000,Public       ,1,7,8,62,,161,223
00548800,LOUISIANA TECH COLG-BATON ROUGE         ,LA,70807-0000,Public       ,45,144,189,656,,1419,2075
00548812,LOUISIANA TECH COLG-FOLKES CAMPUS       ,LA,70748-0000,Public       ,6,10,16,37,,70,107
00548817,LOUISIANA TEC CLG-JUMONVILLE MEM CP     ,LA,70760-0000,Public       ,1,5,6,33,,62,95
00548838,LOUISIANA TECHNICAL COLG - TALLULAH     ,LA,71284-0000,Public       ,0,4,4,50,,90,140
00548842,LOUISIANA TECHNICAL COLLEGE - WESTSIDE C,LA,70765-0733,Public       ,3,8,11,39,,100,139
00548900,CENTRAL LOUISIANA TECHNICAL COLLEGE     ,LA,71302-3137,Public       ,28,119,147,262,,710,972
00548901,CENTRAL LOUISIANA TECHNICAL COLLEGE     ,LA,71327-3743,Public       ,11,60,71,86,,215,301
00548902,CENTRAL LOUISIANA TECHNICAL COLLEGE     ,LA,71483-3563,Public       ,9,18,27,127,,242,369
00548903,CENTRAL LOUISIANA TECHNICAL COLLEGE     ,LA,71302-6511,Public       ,8,47,55,94,,357,451
00548904,CENTRAL LOUISIANA TECHNICAL COLLEGE     ,LA,71463-3536,Public       ,4,16,20,79,,118,197
00548905,CENTRAL LOUISIANA TECHNICAL COLLEGE     ,LA,71334-2232,Public       ,4,20,24,95,,248,343
00552600,SOUTH CENTRAL LOUISIANA TECHNICAL COLG  ,LA,70381-2148,Public       ,16,46,62,141,,383,524
00552602,SOUTH CENTRAL LOUISIANA TECHNICAL COLG  ,LA,70302-4336,Public       ,8,28,36,120,,247,367
00552603,SOUTH CENTRAL LOUISIANA TECHNICAL COLG  ,LA,70084-6632,Public       ,27,102,129,407,,653,1060
00576100,L. E. FLETCHER TECHNICAL COMMUNITY COLLE,LA,70360-2863,Public       ,67,165,232,1237,,1573,2810
00675600,NORTHSHORE TECHNICAL COLLEGE            ,LA,70427-5866,Public       ,40,121,161,336,,771,1107
00675603,NORTHSHORE TECHNICAL COLLEGE - HAMMOND  ,LA,70401-0000,Public       ,15,58,73,558,,957,1515
00675604,NORTHSHORE TECHNICAL COLLEGE - FLORIDA  ,LA,70441-0000,Public       ,6,17,23,200,,285,485
00768600,SOUTHERN UNIV AT SHREVEPORT/BOSSIER     ,LA,71107-4795,Public       ,74,291,365,1851,,3699,5550
00806700,LSU HEALTH SCIENCES CENTR-SHREVEPOR     ,LA,71130-3932,Public       ,28,55,83,360,,1182,1542
00989800,DEMMON SCHOOL OF BEAUTY                 ,LA,70607-2128,Proprietary  ,3,11,14,32,,120,152
00997500,NORTHWEST LOUISIANA TECHNICAL COLLEGE   ,LA,71055-2422,Public       ,12,61,73,217,,547,764
00997503,NORTHWEST LOUISIANA TECHNICAL COLLEGE   ,LA,71137-8527,Public       ,32,161,193,355,,1310,1665
00997504,NORTHWEST LOUISIANA TECHNICAL COLLEGE   ,LA,71052-1236,Public       ,4,23,27,67,,175,242
00997505,NORTHWEST LOUISIANA TECHNICAL COLLEGE   ,LA,71449-0790,Public       ,5,8,13,34,,122,156
00997506,NORTHWEST LOUISIANA TECHNICAL COLLEGE   ,LA,71458-0657,Public       ,11,44,55,200,,402,602
01005701,AMERICAN COMMERCIAL COLLEGE             ,LA,71105-2502,Proprietary  ,0,0,0,6,,22,28
01109700,CLOYD'S BEAUTY SCHOOL #1                ,LA,71291-3131,Proprietary  ,6,23,29,44,,129,173
01163100,"D-JAY'S SCHL OF BEAUTY, ARTS & SCI      ",LA,70806-0000,Proprietary  ,9,27,36,73,,190,263
01184100,JOHN JAY BEAUTY COLLEGE                 ,LA,70124-2592,Proprietary  ,9,37,46,135,,291,426
01282300,PAT GOINS RUSTON BEAUTY SCHOOL          ,LA,71270-4301,Proprietary  ,3,12,15,30,,63,93
01287900,PAT GOINS BENTON ROAD BEAUTY SCHOOL     ,LA,71111-4838,Proprietary  ,4,28,32,27,,125,152
01288000,CELEBRITY STYLIST BEAUTY SCHOOL         ,LA,71201-5167,Proprietary  ,3,12,15,35,,81,116
02055400,BOSSIER PARISH COMMUNITY COLLEGE        ,LA,71111-0000,Public       ,214,685,899,3916,,7020,10936
02055500,DELTA SCH OF BUSINESS & TECHNOLOGY      ,LA,70601-0000,Proprietary  ,5,65,70,124,,455,579
02117800,AVEDA INSTITUTE LAFAYETTE               ,LA,70503-3246,Proprietary  ,9,33,42,179,,227,406
02166100,NUNEZ COMMUNITY COLLEGE                 ,LA,70043-0000,Public       ,56,237,293,832,,2162,2994
02166200,ITI TECHNICAL COLLEGE                   ,LA,70817-0000,Proprietary  ,70,173,243,560,,1034,1594
02197500,BATON ROUGE SCHOOL OF COMPUTERS         ,LA,70809-8188,Proprietary  ,8,22,30,66,,176,242
02214800,ACADIANA TECHNICAL COLLEGE              ,LA,70506-4109,Public       ,24,86,110,473,,977,1450
02214802,ACADIANA TECHNICAL COLLEGE - ACADIAN    ,LA,70526-4109,Public       ,3,19,22,92,,223,315
02214803,ACADIANA TECHNICAL COLLEGE - C.B. COREIL,LA,70586-0000,Public       ,7,12,19,91,,159,250
02214804,ACADIANA TECHNICAL COLLEGE - EVANGELINE ,LA,70582-0000,Public       ,2,19,21,39,,169,208
02214805,ACADIANA TECHNICAL COLLEGE - GULF AREA  ,LA,70510-0000,Public       ,3,22,25,124,,271,395
02214806,ACADIANA TECHNICAL COLLEGE - T.H. HARRIS,LA,70570-0000,Public       ,22,45,67,284,,505,789
02214807,ACADIANA TECHNICAL COLLEGE - TECHE AREA ,LA,70562-0000,Public       ,18,35,53,222,,371,593
02234000,CAMERON COLLEGE                         ,LA,70119-0000,Proprietary  ,9,92,101,101,,421,522
02253901,BERKS TECHNICAL INSTITUTE - CAREER TECHN,LA,71021-6126,Proprietary  ,0,0,0,224,,800,1024
02253902,BERKS TECHNICAL INSTITUTE - CAREER TECHN,LA,71105-2405,Proprietary  ,0,0,0,192,,669,861
02258400,AVEDA INSTITUTE BATON ROUGE             ,LA,70816-2246,Proprietary  ,12,45,57,273,,378,651
02260200,DIESEL DRIVING ACADEMY                  ,LA,71109-5617,Proprietary  ,11,83,94,65,,409,474
02265600,JOHN JAY KENNER ACADEMY                 ,LA,70062-0000,Proprietary  ,4,17,21,30,,116,146
02269300,STEVENSON'S ACADEMY OF HAIR DESIGN      ,LA,70116-0000,Proprietary  ,8,38,46,88,,276,364
02327800,PINEVILLE BEAUTY SCHOOL                 ,LA,71360-0000,Proprietary  ,3,19,22,48,,122,170
02335700,BATON ROUGE GENERAL MEDICAL CENTER      ,LA,70806-3889,Private      ,9,27,36,99,,221,320
02335701,BATON ROUGE GEN MED CTR SCH NSG         ,LA,70821-0000,Private      ,9,40,49,102,,369,471
02335702,BATON ROUGE GEN MED CTR-RAD TECH        ,LA,70806-0000,Private      ,12,21,33,77,,171,248
02338000,"CLOYD'S BEAUTY SCHOOL #2, INC           ",LA,71202-3539,Proprietary  ,5,13,18,49,,129,178
02352500,"CLOYD'S BEAUTY SCHOOL #3, INC           ",LA,71201-3211,Proprietary  ,5,18,23,49,,142,191
02358600,"STAGE ONE THE HAIR SCHOOL, INC.         ",LA,70605-0000,Proprietary  ,4,22,26,110,,180,290
02518300,SOUTH LOUISIANA BEAUTY COLLEGE          ,LA,70363-0000,Proprietary  ,4,7,11,49,,75,124
02536400,LOUISIANA ACADEMY OF BEAUTY             ,LA,70535-0000,Proprietary  ,6,7,13,39,,71,110
02538300,DELTA COLLEGE OF ARTS & TECH INC        ,LA,70806-1529,Proprietary  ,31,107,138,273,,858,1131
02538301,DELTA COLLEGE OF ARTS & TECHNOLOGY - LAF,LA,70508-6831,Proprietary  ,16,62,78,144,,460,604
02548500,COSMETOLOGY TRAINING CENTER             ,LA,70503-0000,Proprietary  ,12,27,39,113,,169,282
02554800,VANGUARD COLLEGE OF COSMETOLOGY         ,LA,70458-8823,Proprietary  ,25,33,58,252,,277,529
02582200,"GUY'S ACADEMY HAIR, SKIN & NAILS        ",LA,71105-2404,Proprietary  ,7,39,46,49,,221,270
02600900,AVEDA INSTITUTE                         ,LA,70433-2922,Proprietary  ,188,341,529,1267,,2054,3321
02601000,AMERICAN SCHOOL OF BUSINESS             ,LA,71105-5646,Proprietary  ,9,27,36,43,,193,236
02601100,OPELOUSAS SCHOOL OF COSMETOLOGY         ,LA,70570-6156,Proprietary  ,2,4,6,22,,59,81
02617100,BATON ROUGE COLLEGE                     ,LA,70806-1725,Proprietary  ,0,0,0,163,,219,382
02619200,DENHAM SPRINGS BEAUTY COLLEGE           ,LA,70726-3829,Proprietary  ,8,14,22,69,,98,167
03010400,CRESCENT CITY SCH GAMING & BARTENDG     ,LA,70119-5507,Proprietary  ,23,208,231,106,,861,967
03010624,VIRGINIA COLLEGE - BATON ROUGE          ,LA,70815-8604,Proprietary  ,19,60,79,151,,561,712
03023500,CAMELOT CAREER COLLEGE                  ,LA,70805-7539,Proprietary  ,19,64,83,114,,345,459
03026514,REMINGTON COLLEGE - LAFAYETTE           ,LA,70508-5760,Private      ,9,43,52,129,,301,430
03026515,REMINGTON COLLEGE - BATON ROUGE         ,LA,70816-4040,Private      ,11,68,79,197,,522,719
03030900,DIESEL DRIVING ACADEMY                  ,LA,70815-8109,Proprietary  ,13,189,202,66,,663,729
03095100,GRETNA CAREER COLLEGE                   ,LA,70053-2436,Proprietary  ,0,0,0,6,,13,19
03106200,OUR LADY OF THE LAKE COLLEGE            ,LA,70808-4345,Private      ,46,215,261,1227,,2182,3409
03294300,BLUE CLIFF SCH THERAPEUTIC MASSAGE      ,LA,70002-3458,Proprietary  ,121,498,619,565,,2153,2718
03294303,BLUE CLIFF COLLEGE - LAFAYETTE          ,LA,70508-3256,Proprietary  ,9,41,50,235,,686,921
03294306,BLUE CLIFF COLLEGE - SHREVEPORT         ,LA,71105-6520,Proprietary  ,10,48,58,143,,684,827
03332600,DELTA COLLEGE                           ,LA,70433-9042,Proprietary  ,19,52,71,184,,509,693
03332601,DELTA COLLEGE - SLIDELL                 ,LA,70460-2624,Proprietary  ,17,82,99,179,,572,751
03356300,MEDICAL TRAINING COLLEGE                ,LA,70816-5820,Proprietary  ,19,86,105,162,,533,695
03480300,MEDVANCE INSTITUTE                      ,LA,70809-1908,Proprietary  ,16,81,97,174,,558,732
03498400,OMEGA INSTITUTE OF COSMETOLOGY          ,LA,70360-0000,Proprietary  ,6,10,16,73,,78,151
03727500,MOORE CAREER COLLEGE                    ,LA,70808-4191,Proprietary  ,2,25,27,15,,100,115
03730300,BATON ROUGE COMMUNITY COLLEGE           ,LA,78806-4129,Public       ,399,836,1235,6238,,7342,13580
03789300,UNITECH TRAINING ACADEMY                ,LA,70503-5132,Proprietary  ,30,130,160,227,,645,872
03789301,UNITECH TRAINING ACADEMY - WEST MONROE  ,LA,71291-2913,Proprietary  ,11,79,90,102,,500,602
03789302,UNITECH TRAINING ACADEMY - HOUMA        ,LA,70363-5556,Proprietary  ,13,53,66,103,,243,346
03789303,UNITECH TRAINING ACADEMY -  ALEXANDRIA  ,LA,71303-3625,Proprietary  ,16,67,83,95,,355,450
03789304,UNITECH TRAINING ACADEMY - LAKE CHARLES ,LA,70601-7887,Proprietary  ,11,60,71,135,,339,474
03789400,RIVER PARISHES COMMUNITY COLLEGE        ,LA,70778-0310,Public       ,73,149,222,1035,,1322,2357
03795300,CASSIA BEAUTY COLLEGE                   ,LA,70126-0000,Proprietary  ,4,17,21,17,,38,55
03810500,COURT REPORTING INSTITUTE OF LOUISI     ,LA,70816-0000,Proprietary  ,1,13,14,10,,103,113
03956300,SOUTH LOUISIANA COMMUNITY COLLEGE       ,LA,70506-0000,Public       ,246,501,747,3113,,3762,6875
04040300,COMPASS CAREER COLLEGE                  ,LA,70403-0653,Proprietary  ,24,62,86,166,,350,516
04112300,LOUISIANA CULINARY INSTITUTE            ,LA,70816-4109,Proprietary  ,32,42,74,292,,372,664
04120700,ALDEN'S SCHOOL OF COSMETOLOGY           ,LA,70714-1502,Proprietary  ,0,0,0,1,,0,1
04130100,LOUISIANA DELTA COMMUNITY COLLEGE       ,LA,71203-3618,Public       ,144,455,599,2039,,3386,5425
04149500,A & W HEALTHCARE EDUCATORS              ,LA,70122-3146,Proprietary  ,5,56,61,70,,423,493
04151600,MY-LE'S BEAUTY COLLEGE                  ,LA,70056-3150,Proprietary  ,2,45,47,14,,143,157
04217000,HEALTHCARE TRAINING INSTITUTE           ,LA,70062-7630,Proprietary  ,4,30,34,28,,168,196
04225900,SETTING THE STANDARD BARBERING AND NATUR,LA,71109-4124,Proprietary  ,2,7,9,4,,18,22
04226000,BOS-MAN'S BARBER COLLEGE                ,LA,71106-2653,Proprietary  ,2,32,34,8,,58,66
00143600,CAPITOL COLLEGE                         ,MD,20708-9759,Private      ,15,71,86,502,,688,1190
00146200,WASHINGTON BIBLE COLLEGE                ,MD,20706-3599,Private      ,0,0,0,14,,65,79
00205700,ALLEGANY COLLEGE OF MARYLAND            ,MD,21502-2596,Public       ,105,206,311,2690,,2235,4925
00205800,ANNE ARUNDEL COMMUNITY COLLEGE          ,MD,21012-1895,Public       ,308,956,1264,5679,,9711,15390
00206100,BALTIMORE CITY COMMUNITY COLLEGE        ,MD,21215-7893,Public       ,217,1058,1275,4366,,10977,15343
00206200,BOWIE STATE UNIVERSITY                  ,MD,20715-9465,Public       ,221,405,626,7945,,6665,14610
00206300,COMMUNITY COLLEGE OF BALTIMORE COUNTY   ,MD,21228-5381,Public       ,468,1574,2042,10819,,18762,29581
00206400,COLLEGE OF SOUTHERN MARYLAND            ,MD,20646-0910,Public       ,229,619,848,4192,,5675,9867
00206500,NOTRE DAME OF MARYLAND UNIVERSITY       ,MD,21210-2476,Private      ,35,140,175,1212,,2410,3622
00206700,WASHINGTON ADVENTIST UNIVERSITY         ,MD,20912-7796,Private      ,25,94,119,1012,,1332,2344
00206800,COPPIN STATE UNIVERSITY                 ,MD,21216-3698,Public       ,158,401,559,4812,,6443,11255
00207100,FREDERICK COMMUNITY COLLEGE             ,MD,21702-9745,Public       ,151,365,516,2420,,3219,5639
00207200,FROSTBURG STATE UNIVERSITY              ,MD,21532-1099,Public       ,205,113,318,6890,,1975,8865
00207300,GOUCHER COLLEGE                         ,MD,21204-2794,Private      ,84,77,161,3290,,1090,4380
00207400,HAGERSTOWN COMMUNITY COLLEGE            ,MD,21742-6514,Public       ,146,450,596,2301,,3569,5870
00207500,HARFORD COMMUNITY COLLEGE               ,MD,21015-1696,Public       ,163,342,505,2600,,3433,6033
00207600,HOOD COLLEGE                            ,MD,21701-8575,Private      ,59,74,133,2382,,1026,3408
00207700,JOHNS HOPKINS UNIVERSITY                ,MD,21218-2693,Private      ,376,244,620,9845,,2795,12640
00207702,JOHNS HOPKINS UNIV SCH ARTS/SCI/ENG     ,MD,21218-0000,Private      ,83,257,340,4334,,2407,6741
00207703,JOHNS HOPKINS UNIV SCH OF BUS/ED        ,MD,21046-0000,Private      ,15,132,147,94,,1731,1825
00207705,JOHNS HOPKINS BLOOMBERG SCH OF PH       ,MD,21205-0000,Private      ,7,84,91,93,,1714,1807
00207706,JOHNS HOPKINS UNIV SCH OF MEDICINE      ,MD,21205-0000,Private      ,35,40,75,390,,1212,1602
00207707,JOHNS HOPKINS UNIV SCH OF NURSING       ,MD,21205-0000,Private      ,33,117,150,449,,1778,2227
00207708,JOHNS HOPKINS UNIV PEABODY CONSERV      ,MD,21202-2397,Private      ,21,16,37,601,,508,1109
00207800,LOYOLA UNIVERSITY MARYLAND              ,MD,21210-2699,Private      ,249,178,427,10222,,3024,13246
00208000,MARYLAND INST COLLEGE OF ART            ,MD,21217-4191,Private      ,117,59,176,3214,,1131,4345
00208300,MORGAN STATE UNIVERSITY                 ,MD,21251-0002,Public       ,318,480,798,11037,,8045,19082
00208600,MOUNT SAINT MARY'S UNIVERSITY           ,MD,21727-7799,Private      ,72,41,113,3428,,556,3984
00208700,NER ISRAEL RABBINICAL COLLEGE           ,MD,21208-1198,Private      ,5,12,17,98,,51,149
00208900,PRINCE GEORGES COMMUNITY COLLEGE        ,MD,20774-2199,Public       ,400,1348,1748,7888,,13817,21705
00209100,SALISBURY UNIVERSITY                    ,MD,21801-6862,Public       ,306,182,488,12602,,2739,15341
00209200,ST JOHN'S COLLEGE                       ,MD,21404-0000,Private      ,10,22,32,552,,236,788
00209500,ST. MARY'S COLLEGE OF MARYLAND          ,MD,20686-3001,Public       ,68,29,97,2930,,389,3319
00209600,ST MARY'S SEMINARY & UNIV               ,MD,21210-1994,Private      ,2,8,10,37,,85,122
00209900,TOWSON UNIVERSITY                       ,MD,21252-0002,Public       ,732,602,1334,27059,,10031,37090
00210200,UNIVERSITY OF BALTIMORE                 ,MD,21201-5779,Public       ,119,462,581,2572,,8152,10724
00210300,"UNIVERSITY OF MARYLAND, COLLEGE PARK    ",MD,20742-5145,Public       ,1056,1102,2158,35101,,15789,50890
00210400,"UNIVERSITY OF MARYLAND, BALTIMORE       ",MD,21201-1691,Public       ,238,638,876,5274,,12483,17757
00210500,UMBC                                    ,MD,21250-0002,Public       ,294,431,725,12114,,7105,19219
00210600,UNIVERSITY MARYLAND EASTERN SHORE       ,MD,21853-4053,Public       ,171,144,315,6479,,2643,9122
00210700,STEVENSON UNIVERSITY                    ,MD,21153-0641,Private      ,147,186,333,6810,,2432,9242
00210800,WASHINGTON COLLEGE                      ,MD,21620-1197,Private      ,55,12,67,2888,,189,3077
00210900,MCDANIEL COLLEGE                        ,MD,21157-4390,Private      ,80,59,139,3315,,818,4133
00458612,KAPLAN COLLEGE                          ,MD,21742-2797,Proprietary  ,24,292,316,252,,1988,2240
00458614,KAPLAN COLLEGE - FREDERICK              ,MD,21704-8307,Proprietary  ,0,0,0,38,,255,293
00465000,CHESAPEAKE COLLEGE                      ,MD,21679-0008,Public       ,70,203,273,1349,,1755,3104
00691100,MONTGOMERY COLLEGE                      ,MD,20850-1195,Public       ,603,1171,1774,12494,,13325,25819
00734100,INTERNATIONAL BEAUTY SCHOOL             ,MD,21502-2370,Proprietary  ,8,88,96,76,,440,516
00744700,DEL-MAR-VA BEAUTY ACADEMY               ,MD,21804-0000,Proprietary  ,17,27,44,81,,192,273
00749100,TESST COLLEGE OF TECHNOLOGY             ,MD,21227-1063,Proprietary  ,36,195,231,487,,1572,2059
00793600,LINCOLN TECHNICAL INSTITUTE             ,MD,21046-1544,Proprietary  ,58,130,188,618,,952,1570
00817500,HOWARD COMMUNITY COLLEGE                ,MD,21044-3197,Public       ,200,577,777,4374,,5465,9839
00826300,AWARD BEAUTY SCHOOL                     ,MD,21740-5624,Proprietary  ,11,50,61,61,,252,313
00830800,CECIL COLLEGE                           ,MD,21901-1999,Public       ,79,172,251,1281,,1677,2958
00907906,EVEREST COLLEGE- EVEREST INSTITUTE      ,MD,20910-3737,Proprietary  ,33,163,196,301,,996,1297
01001400,GARRETT COMMUNITY COLLEGE               ,MD,21541-1265,Public       ,21,37,58,1086,,411,1497
01031900,MEDIX SCHOOL                            ,MD,21204-2538,Proprietary  ,83,308,391,683,,2852,3535
01041000,TESST COLLEGE OF TECHNOLOGY             ,MD,21286-2201,Proprietary  ,18,81,99,185,,675,860
01164400,UNIV OF MARYLAND UNIVERSITY COLLEGE     ,MD,20783-8078,Public       ,240,4726,4966,3178,,41182,44360
01164402,U OF MD UNIVERSITY COLLEGE - EUROPE     ,MD,20832-0000,Public       ,17,122,139,425,,1026,1451
01164404,U OF MD UNIVERSITY COLLEGE - ASIA       ,MD,31207-0000,Public       ,10,164,174,113,,1189,1302
02073900,WOR-WIC COMMUNITY COLLEGE               ,MD,21804-0000,Public       ,95,320,415,1719,,2996,4715
02083600,TESST COLLEGE OF TECHNOLOGY             ,MD,20705-2698,Proprietary  ,32,133,165,240,,775,1015
02116005,SANFORD-BROWN INSTITUTE - LANDOVER      ,MD,20785-2287,Proprietary  ,0,15,15,47,,247,294
02127900,SOJOURNER DOUGLASS COLLEGE              ,MD,21205-0000,Private      ,28,317,345,298,,3418,3716
02155100,MARYLAND COLLEGE OF ART AND DESIGN      ,MD,20902-0000,Private      ,12,23,35,183,,221,404
02269700,"COLORLAB ACADEMY OF HAIR, THE           ",MD,21014-3639,Proprietary  ,8,19,27,54,,113,167
02331000,MARYLAND BEAUTY ACADEMY OF ESSEX        ,MD,21221-0000,Proprietary  ,8,40,48,92,,274,366
02333000,HAIR ACADEMY                            ,MD,20784-0000,Proprietary  ,29,114,143,173,,492,665
02343800,MONTGOMERY BEAUTY SCHOOL                ,MD,20901-0000,Proprietary  ,11,49,60,113,,265,378
02494700,BALTIMORE STUDIO OF HAIR DESIGN         ,MD,21201-0000,Proprietary  ,10,41,51,138,,360,498
02495000,ROBERT PAUL ACAD COSMTGY ARTS & SCI     ,MD,21093-0000,Proprietary  ,6,8,14,76,,77,153
02495100,MARYLAND BEAUTY ACADEMY                 ,MD,21136-0000,Proprietary  ,1,16,17,33,,81,114
02545400,NORTH AMERICAN TRADE SCHOOLS            ,MD,21244-0069,Proprietary  ,33,216,249,269,,1321,1590
02573800,"L' ACADEMIE DE CUISINE, INC.            ",MD,20877-0000,Proprietary  ,7,28,35,84,,244,328
02578400,TAI SOPHIA INSTITUTE                    ,MD,20723-6010,Private      ,1,160,161,5,,581,586
03027200,BLADES SCHOOL OF HAIR DESIGN            ,MD,20619-0226,Proprietary  ,12,25,37,49,,137,186
03064900,AARON'S ACADEMY OF BEAUTY               ,MD,20602-2715,Proprietary  ,5,16,21,53,,113,166
03097200,AESTHETICS INSTITUTE OF COSMETOLOGY     ,MD,20877-1305,Proprietary  ,6,22,28,30,,106,136
03100700,CARROLL COMMUNITY COLLEGE               ,MD,21157-6913,Public       ,76,155,231,1413,,1548,2961
03148300,AMERICAN BEAUTY ACADEMY                 ,MD,20902-1911,Proprietary  ,56,157,213,294,,787,1081
03296300,BALTIMORE SCHOOL OF MASSAGE             ,MD,21090-2261,Proprietary  ,29,147,176,169,,597,766
03327300,NEW CREATIONS ACADEMY OF HAIR DSN       ,MD,20746-0000,Proprietary  ,9,31,40,73,,200,273
03455500,NATIONAL LABOR COLLEGE                  ,MD,20903-1790,Private      ,2,51,53,16,,497,513
03493300,ALL-STATE CAREER SCHOOL                 ,MD,21224-6658,Proprietary  ,88,447,535,590,,2505,3095
03667300,FAITH THEOLOGICAL SEMINARY              ,MD,21212-2624,Private      ,1,18,19,11,,148,159
03771300,AMERICAN CAREER INSTITUTE               ,MD,20902-4637,Proprietary  ,0,0,0,2,,15,17
03822400,MAPLE SPRINGS BAPTIST BIBLE COLLEGE & SE,MD,20743-5711,Private      ,0,7,7,1,,83,84
03937300,YESHIVA COLLEGE OF THE NATION'S CAPITAL ,MD,20902-1700,Private      ,0,3,3,10,,26,36
03965500,HAIR EXPRESSIONS ACADEMY                ,MD,20852-1729,Proprietary  ,26,40,66,137,,238,375
04121600,FILA ACADEMY (THE)                      ,MD,21061-1634,Proprietary  ,1,12,13,6,,43,49
04139700,FREDERICK SCHOOL OF COSMETOLOGY         ,MD,21701-0000,Proprietary  ,3,15,18,51,,92,143
04141600,OMEGA STUDIOS' SCHOOL OF APPLIED RECORDI,MD,20852-1731,Proprietary  ,9,20,29,79,,164,243
04151800,TEMPLE (THE): A PAUL MITCHELL PARTNER SC,MD,21701-5409,Proprietary  ,18,21,39,172,,194,366
04167602,FINGER LAKES SCHOOL OF MASSAGE (THE)    ,MD,21701-3030,Proprietary  ,6,17,23,12,,57,69
04168900,HOLISTIC MASSAGE TRAINING INSTITUTE     ,MD,21218-2407,Proprietary  ,2,28,30,36,,179,215
04171501,COSMOPOLITAN BEAUTY & TECH SCHOOL -     ,MD,20143-3370,Proprietary  ,0,1,1,0,,1,1
04188400,BAIS HAMEDRASH AND MESIVTA OF BALTIMORE ,MD,21209-1613,Private      ,0,5,5,44,,26,70
04204000,ASPEN BEAUTY ACADEMY - LAUREL           ,MD,20724-2013,Proprietary  ,9,31,40,47,,159,206
04209600,INSTITUTE OF HEALTH SCIENCES            ,MD,21031-1408,Proprietary  ,1,33,34,35,,175,210
04211700,HARMON'S BEAUTY SCHOOL                  ,MD,20785-2135,Proprietary  ,3,5,8,32,,66,98
00211400,AMERICAN INTERNATIONAL COLLEGE          ,MA,01109-3189,Private      ,50,296,346,2218,,3298,5516
00211500,AMHERST COLLEGE                         ,MA,01002-5000,Private      ,119,39,158,4586,,369,4955
00211600,ANDOVER NEWTON THEOLOGICAL SCHOOL       ,MA,02459-0000,Private      ,1,9,10,4,,193,197
00211700,ANNA MARIA COLLEGE                      ,MA,01612-1198,Private      ,26,68,94,2008,,742,2750
00211800,ASSUMPTION COLLEGE                      ,MA,01615-1294,Private      ,84,66,150,5011,,980,5991
00212000,MERRIMACK COLLEGE                       ,MA,01845-5800,Private      ,131,35,166,5989,,643,6632
00212100,BABSON COLLEGE                          ,MA,02457-0310,Private      ,126,52,178,2949,,755,3704
00212200,BAY PATH COLLEGE                        ,MA,01106-2212,Private      ,29,216,245,956,,2575,3531
00212300,BECKER COLLEGE-WORCESTER                ,MA,01615-0071,Private      ,102,93,195,3219,,1255,4474
00212400,BENTLEY UNIVERSITY                      ,MA,02452-4705,Private      ,152,59,211,6167,,866,7033
00212600,BERKLEE COLLEGE OF MUSIC                ,MA,02215-3693,Private      ,217,164,381,5172,,1599,6771
00212800,BOSTON COLLEGE                          ,MA,02467-3800,Private      ,504,235,739,17900,,6040,23940
00212900,BOSTON CONSERVATORY OF MUSIC            ,MA,02215-9830,Private      ,36,11,47,1201,,370,1571
00213000,BOSTON UNIVERSITY                       ,MA,02215-1789,Private      ,1276,923,2199,39997,,18452,58449
00213300,BRANDEIS UNIVERSITY                     ,MA,02453-2700,Private      ,139,79,218,6105,,1533,7638
00213900,CLARK UNIVERSITY                        ,MA,01610-1473,Private      ,123,62,185,4536,,919,5455
00214000,ELMS COLLEGE                            ,MA,01013-2839,Private      ,34,58,92,1486,,1152,2638
00214100,COLLEGE OF THE HOLY CROSS               ,MA,01610-2395,Private      ,99,12,111,5954,,212,6166
00214300,CURRY COLLEGE                           ,MA,02186-2395,Private      ,114,134,248,5278,,1615,6893
00214400,DEAN COLLEGE                            ,MA,02038-1994,Private      ,37,23,60,1996,,341,2337
00214500,EASTERN NAZARENE COLLEGE                ,MA,02170-2999,Private      ,11,44,55,905,,883,1788
00214507,EASTERN NAZARENE CLG - LEAD PROGRAM     ,MA,02170-0000,Private      ,2,15,17,36,,432,468
00214600,EMERSON COLLEGE                         ,MA,02116-4624,Private      ,191,76,267,7588,,1635,9223
00214700,EMMANUEL COLLEGE                        ,MA,02115-5798,Private      ,94,48,142,5547,,592,6139
00214800,ENDICOTT COLLEGE                        ,MA,01915-2098,Private      ,107,109,216,4866,,958,5824
00214900,EPISCOPAL DIVINITY SCHOOL               ,MA,02138-0000,Private      ,0,3,3,0,,74,74
00215000,FISHER COLLEGE                          ,MA,02116-1500,Private      ,54,170,224,1724,,1679,3403
00215100,BENJAMIN FRANKLIN INSTITUTE OF TECH     ,MA,02116-6296,Public       ,36,54,90,598,,439,1037
00215300,GORDON COLLEGE                          ,MA,01984-1899,Private      ,36,12,48,2482,,227,2709
00215400,HELLENIC COLLEGE                        ,MA,02445-7496,Private      ,3,0,3,88,,122,210
00215500,HARVARD UNIVERSITY                      ,MA,02138-3800,Private      ,164,76,240,4523,,974,5497
00215501,AMRCN REPERTORY THTR INST ADV THTR      ,MA,02138-0000,Private      ,0,3,3,3,,134,137
00215502,HARVARD BUSINESS SCHOOL                 ,MA,02163-0000,Private      ,19,83,102,234,,1729,1963
00215503,HARVARD EXTENSION SCHOOL                ,MA,02138-0000,Private      ,17,174,191,164,,1563,1727
00215504,HARVARD SCH OF DENTAL MEDICINE          ,MA,02115-0000,Private      ,2,6,8,27,,216,243
00215505,HARVARD UNIV GRAD SCH DESIGN            ,MA,02138-0000,Private      ,0,14,14,14,,949,963
00215506,HARVARD DIVINITY SCHOOL                 ,MA,02138-0000,Private      ,0,14,14,9,,503,512
00215507,HARVARD UNIV GRAD SCH ED                ,MA,02138-0000,Private      ,1,45,46,8,,1570,1578
00215508,HARVARD UNIV GRAD S OF ARTS & SCIEN     ,MA,02138-0000,Private      ,10,77,87,79,,890,969
00215509,HARVARD KENNEDY SCHOOL                  ,MA,02138-0000,Private      ,1,43,44,18,,1338,1356
00215510,HARVARD LAW SCHOOL                      ,MA,02138-0000,Private      ,13,77,90,138,,3379,3517
00215511,HARVARD UNIV MEDICAL SCHOOL             ,MA,02115-0000,Private      ,40,24,64,227,,1156,1383
00215512,HARVARD UNIV SCH PUBLIC HEALTH          ,MA,02115-0000,Private      ,4,30,34,41,,1057,1098
00215513,HARVARD UNIVERSITY-HARVARD COLLEGE      ,MA,02138-0000,Private      ,529,101,630,20156,,1439,21595
00215700,HEBREW COLLEGE                          ,MA,02459-2237,Private      ,0,7,7,0,,108,108
00215800,LASELL COLLEGE                          ,MA,02466-2716,Private      ,46,58,104,3408,,619,4027
00216000,LESLEY UNIVERSITY                       ,MA,02138-2790,Private      ,69,236,305,2969,,3737,6706
00216100,UMASS LOWELL                            ,MA,01854-3089,Public       ,450,573,1023,14617,,7179,21796
00216400,NEW ENGLAND COLLEGE OF OPTOMETRY        ,MA,02115-1129,Private      ,0,11,11,12,,434,446
00216500,MASS. COLLEGE OF PHARMACY  & HEALTH SCIE,MA,02115-5804,Private      ,103,145,248,6191,,4379,10570
00216700,BERKSHIRE COMMUNITY COLLEGE             ,MA,01201-5786,Public       ,37,158,195,1036,,1643,2679
00216800,CAPE COD COMMUNITY COLLEGE              ,MA,02668-1599,Public       ,109,338,447,1797,,2602,4399
00216900,GREENFIELD COMMUNITY COLLEGE            ,MA,01301-9739,Public       ,65,179,244,1024,,1697,2721
00217000,HOLYOKE COMMUNITY COLLEGE               ,MA,01040-1099,Public       ,200,531,731,4150,,5248,9398
00217100,MASSACHUSETTS BAY COMMUNITY COLLEGE     ,MA,02181-0000,Public       ,151,272,423,2552,,3061,5613
00217200,MOUNT WACHUSETT COMMUNITY COLLEGE       ,MA,01440-1000,Public       ,122,365,487,2248,,3654,5902
00217300,NORTH SHORE COMMUNITY COLLEGE           ,MA,01923-4093,Public       ,239,598,837,3757,,5411,9168
00217400,NORTHERN ESSEX COMMUNITY COLLEGE        ,MA,01830-2399,Public       ,179,492,671,3700,,4984,8684
00217500,QUINSIGAMOND COMMUNITY COLLEGE          ,MA,01606-2092,Public       ,285,660,945,4635,,6506,11141
00217600,BRISTOL COMMUNITY COLLEGE               ,MA,02720-7399,Public       ,245,630,875,4920,,6359,11279
00217700,MASSASOIT COMMUNITY COLLEGE             ,MA,02302-3996,Public       ,243,537,780,4107,,5207,9314
00217800,MASSACHUSETTS INST OF TECHNOLOGY        ,MA,02139-4307,Private      ,476,273,749,13034,,3316,16350
00218000,MASSACHUSETTS COLLEGE OF ART AND DESIGN ,MA,02115-5803,Public       ,81,66,147,2647,,997,3644
00218100,MASSACHUSETTS MARITIME ACADEMY          ,MA,02532-3400,Public       ,23,14,37,1645,,172,1817
00218300,BRIDGEWATER STATE COLLEGE               ,MA,02325-0001,Public       ,287,267,554,12475,,4265,16740
00218400,FITCHBURG STATE UNIVERSITY              ,MA,01420-2697,Public       ,151,122,273,6442,,1904,8346
00218500,FRAMINGHAM STATE COLLEGE                ,MA,01702-2471,Public       ,157,137,294,7808,,1878,9686
00218700,MASSACHUSETTS CLG OF LIBERAL ARTS       ,MA,01247-4100,Public       ,104,48,152,2521,,648,3169
00218800,SALEM STATE UNIVERSITY                  ,MA,01970-5353,Public       ,249,299,548,9691,,4634,14325
00218900,WESTFIELD STATE COLLEGE                 ,MA,01086-1630,Public       ,169,150,319,8501,,2208,10709
00219000,WORCESTER STATE COLLEGE                 ,MA,01602-2597,Public       ,155,195,350,6943,,2851,9794
00219200,MOUNT HOLYOKE COLLEGE                   ,MA,01075-1492,Private      ,69,22,91,2832,,392,3224
00219300,MOUNT IDA COLLEGE                       ,MA,02459-3323,Private      ,35,34,69,1947,,455,2402
00219400,NEW ENGLAND CONSERVATORY OF MUSIC       ,MA,02115-5018,Private      ,33,13,46,749,,631,1380
00219700,NICHOLS COLLEGE                         ,MA,01571-6346,Private      ,37,41,78,2239,,420,2659
00219900,NORTHEASTERN UNIVERSITY                 ,MA,02115-5000,Private      ,950,1045,1995,36075,,13783,49858
00220100,PINE MANOR COLLEGE                      ,MA,02167-0000,Private      ,6,6,12,279,,129,408
00220200,BLESSED JOHN XXIII NATIONAL SEMINARY    ,MA,02493-0000,Private      ,0,0,0,0,,3,3
00220500,QUINCY COLLEGE                          ,MA,02169-4501,Public       ,135,416,551,1968,,4223,6191
00220600,REGIS COLLEGE                           ,MA,02193-0000,Private      ,40,48,88,2218,,1061,3279
00220800,SIMMONS COLLEGE                         ,MA,02115-5898,Private      ,71,286,357,3462,,3879,7341
00220900,SMITH COLLEGE                           ,MA,01063-2936,Private      ,91,36,127,3601,,558,4159
00220901,"SMITH COLLEGE, SCH FOR SOCIAL WORK      ",MA,01063-0000,Private      ,0,24,24,15,,547,562
00221000,UNIV OF MASSACHUSETTS-DARTMOUTH         ,MA,02747-2300,Public       ,267,192,459,13218,,4130,17348
00221100,SPRINGFIELD COLLEGE                     ,MA,01109-3797,Private      ,95,370,465,4157,,4661,8818
00221400,ST JOHN'S SEMINARY                      ,MA,02135-8839,Private      ,2,3,5,11,,33,44
00221700,STONEHILL COLLEGE                       ,MA,02357-6110,Private      ,118,7,125,6274,,196,6470
00221800,SUFFOLK UNIVERSITY                      ,MA,02108-2770,Private      ,177,185,362,9290,,4841,14131
00221900,TUFTS UNIVERSITY                        ,MA,02155-5808,Private      ,302,116,418,11434,,2560,13994
00221901,TUFTS UNIV SCH OF DENTAL MEDICINE       ,MA,02111-0000,Private      ,1,27,28,34,,969,1003
00221902,TUFTS UNIVERSITY - CUMMINGS SCHOOL OF VE,MA,01536-0000,Private      ,4,6,10,39,,492,531
00221904,TUFTS UNIV SCHOOL OF MEDICINE           ,MA,02111-0000,Private      ,9,55,64,99,,2113,2212
00222100,UNIV OF MASSACHUSETTS-AMHERST           ,MA,01003-0000,Public       ,964,546,1510,41013,,8465,49478
00222200,UNIV OF MASSACHUSETTS-BOSTON            ,MA,02125-3393,Public       ,480,858,1338,14250,,12495,26745
00222400,WELLESLEY COLLEGE                       ,MA,02481-8203,Private      ,88,15,103,3701,,247,3948
00222500,WENTWORTH INSTITUTE OF TECHNOLOGY       ,MA,02115-5998,Private      ,117,94,211,6118,,1027,7145
00222600,WESTERN NEW ENGLAND UNIVERSITY          ,MA,01119-2654,Private      ,145,84,229,6463,,1821,8284
00222700,WHEATON COLLEGE                         ,MA,02766-2322,Private      ,57,6,63,2719,,116,2835
00222800,WHEELOCK COLLEGE                        ,MA,02215-4176,Private      ,32,36,68,1755,,921,2676
00222900,WILLIAMS COLLEGE                        ,MA,01267-2600,Private      ,79,8,87,4284,,153,4437
00223300,WORCESTER POLYTECHNIC INSTITUTE         ,MA,01609-2280,Private      ,190,46,236,7872,,748,8620
00267104,BARD COLLEGE - LONGY SCHOOL OF MUSIC    ,MA,02138-3599,Private      ,2,1,3,42,,177,219
00396500,BAY STATE COLLEGE                       ,MA,02116-2901,Proprietary  ,83,124,207,1575,,1517,3092
00396600,BOSTON ARCHITECTURAL COLLEGE            ,MA,02115-2795,Private      ,22,58,80,341,,886,1227
00466100,HAMPSHIRE COLLEGE                       ,MA,01002-3359,Private      ,105,19,124,2687,,258,2945
00466600,SALTER COLLEGE                          ,MA,01583-1700,Proprietary  ,85,374,459,484,,2489,2973
00466700,SCHOOL OF MUSEUM OF FINE ARTS           ,MA,02115-5534,Private      ,25,28,53,686,,352,1038
00466900,UPPER CAPE COD REGIONAL VOC TECH        ,MA,02532-3310,Public       ,3,26,29,33,,161,194
00527900,GREATER LOWELL REGNL VOC TECH SCH       ,MA,01879-0000,Public       ,2,14,16,36,,140,176
00551900,DIMAN REGIONAL VOC TECH INST            ,MA,02723-3519,Public       ,1,15,16,58,,205,263
00552300,BLUE HILLS REGIONAL VOC TECH            ,MA,02021-1398,Public       ,2,7,9,45,,169,214
00555700,MCCANN TECHNICAL SCHOOL                 ,MA,01247-0000,Public       ,0,8,8,31,,98,129
00613600,NATIONAL AVIATION ACADEMY - NEW ENGLAND ,MA,01730-2620,Proprietary  ,19,26,45,149,,238,387
00632200,BROCKTON HOSPITAL SCH OF NURSING        ,MA,02302-0000,Private      ,3,38,41,164,,656,820
00632400,LABOURE COLLEGE                         ,MA,02124-5698,Private      ,10,69,79,193,,906,1099
00633100,LAWRENCE MEM HOSPITAL SCH OF NRSNG      ,MA,02155-1643,Private      ,6,17,23,63,,405,468
00635200,BAYSTATE MEDICAL CENTER                 ,MA,01199-0001,Private      ,3,21,24,29,,126,155
00687300,MARIAN COURT COLLEGE                    ,MA,01907-2896,Private      ,4,16,20,113,,129,242
00748100,GIBBS COLLEGE                           ,MA,02116-2904,Proprietary  ,2,8,10,33,,126,159
00748400,NEWBURY COLLEGE                         ,MA,02445-5796,Private      ,39,21,60,2515,,359,2874
00748600,THE NEW ENGLAND INSTITUTE OF ART        ,MA,02445-7295,Proprietary  ,83,48,131,1217,,547,1764
00748800,KAPLAN CAREER INSTITUTE                 ,MA,02129-1644,Proprietary  ,3,22,25,28,,143,171
00748801,KAPLAN CAREER INSTITUTE -               ,MA,02215-2606,Proprietary  ,0,0,0,15,,82,97
00807800,SPRINGFIELD TECHNICAL COMMUNITY CLG     ,MA,01105-0000,Public       ,225,599,824,3902,,6337,10239
00809002,EVEREST COLLEGE - EVEREST INSTITUTE     ,MA,02150-2333,Proprietary  ,16,83,99,162,,456,618
00817807,EMPIRE BEAUTY SCHOOL - BOSTON           ,MA,02111-1204,Proprietary  ,0,0,0,158,,309,467
00891600,NEW ENGLAND SCHOOL OF LAW               ,MA,02116-0000,Private      ,4,18,22,31,,1785,1816
00964500,BARD COLLEGE AT SIMON'S ROCK            ,MA,01230-9702,Private      ,19,2,21,393,,21,414
00974700,GORDON-CONWELL THEOLOGICAL SEMINARY     ,MA,01982-0000,Private      ,0,25,25,7,,557,564
00975600,UNIVERSITY OF MASS MEDICAL CENTER       ,MA,01655-0000,Public       ,6,25,31,62,,975,1037
00987700,HENRI'S SCHOOL OF HAIR DESIGN           ,MA,01420-5675,Proprietary  ,4,8,12,25,,48,73
00989900,LOWELL ACADEMY HAIRSTYLING INST         ,MA,01852-1909,Proprietary  ,8,24,32,49,,106,155
00993600,MIDDLESEX COMMUNITY COLLEGE             ,MA,01730-1197,Public       ,113,185,298,2023,,2094,4117
00993602,"MIDDLESEX COMMUNITY COLLEGE, LOWELL     ",MA,01852-0000,Public       ,158,348,506,3320,,3601,6921
01054211,EMPIRE BEAUTY SCHOOL - MALDEN           ,MA,02148-5103,Proprietary  ,0,0,0,72,,150,222
01121000,BUNKER HILL COMMUNITY COLLEGE           ,MA,02129-2991,Public       ,551,1246,1797,7435,,12288,19723
01151000,EVEREST INSTITUTE                       ,MA,02135-7638,Proprietary  ,13,47,60,131,,374,505
01193000,ROXBURY COMMUNITY COLLEGE               ,MA,02120-3400,Public       ,83,366,449,1151,,3476,4627
01204200,MANSFIELD BEAUTY SCHOOLS                ,MA,02169-5061,Proprietary  ,4,12,16,18,,90,108
01206800,MANSFIELD BEAUTY SCHOOL                 ,MA,01103-1410,Proprietary  ,1,12,13,15,,64,79
01218700,BLACKSTONE VALLEY VOCATIONAL REGIONAL SC,MA,01568-1499,Public       ,0,2,2,10,,65,75
01238600,SOUTHEASTERN TECHNICAL INSTITUTE        ,MA,02375-1780,Public       ,2,26,28,48,,206,254
01246108,LINCOLN TECHNICAL INSTITUTE - BROCKTON  ,MA,02401-1818,Proprietary  ,12,55,67,148,,434,582
01246114,LINCOLN TECHNICAL INSTITUTE - LOWELL    ,MA,01852-5119,Proprietary  ,19,62,81,208,,433,641
01246115,LINCOLN TECHNICAL INSTITUTE - SOMERVILLE,MA,02145-1102,Proprietary  ,17,66,83,124,,342,466
01288100,MONTACHUSETT REG VOC TECH SCH           ,MA,01420-4649,Public       ,3,11,14,25,,113,138
01294800,ROB ROY ACADEMY                         ,MA,02721-5330,Proprietary  ,3,21,24,36,,87,123
02063000,MONTSERRAT COLLEGE OF ART               ,MA,01915-0000,Private      ,30,7,37,672,,83,755
02079400,EMPIRE BEAUTY SCHOOL                    ,MA,01702-5232,Proprietary  ,101,267,368,396,,866,1262
02079412,EMPIRE BEAUTY SCHOOL - LOWELL           ,MA,01852-2214,Proprietary  ,0,0,0,106,,192,298
02092100,MASSACHUSETTS SCHOOL OF BARBERING       ,MA,02169-5058,Proprietary  ,5,29,34,24,,153,177
02122000,NEW ENGLAND HAIR ACADEMY                ,MA,02148-0000,Proprietary  ,10,34,44,71,,177,248
02137000,ROB ROY ACADEMY                         ,MA,02780-0000,Proprietary  ,2,8,10,13,,39,52
02137200,MASS GEN HOSP DIETETIC INTERNSHIP       ,MA,02114-0000,Private      ,3,3,6,10,,59,69
02163500,NEW ENGLAND SCHOOL OF PHOTOGRAPHY       ,MA,02215-0000,Proprietary  ,8,18,26,101,,140,241
02163600,MASS SCH OF PROFESSIONAL PSYCHOLOGY     ,MA,02132-0000,Private      ,3,29,32,41,,894,935
02169900,ASSABET VALLEY REGIONAL VOC SCHOOL      ,MA,01752-0000,Public       ,2,8,10,20,,118,138
02181600,ROB ROY ACADEMY                         ,MA,01609-0000,Proprietary  ,14,34,48,62,,148,210
02182900,CAMBRIDGE COLLEGE                       ,MA,02138-5304,Private      ,40,367,407,397,,3266,3663
02197900,NORTH BENNET STREET SCHOOL              ,MA,02113-0000,Private      ,4,14,18,59,,170,229
02215100,HALLMARK INSTITUTE OF PHOTOGRAPHY       ,MA,01376-0000,Proprietary  ,16,31,47,128,,144,272
02219501,MILDRED ELLEY - PITTSFIELD              ,MA,01201-5300,Proprietary  ,1,6,7,21,,79,100
02220400,CATHERINE HINDS INST OF ESTHETICS       ,MA,01801-0000,Proprietary  ,4,40,44,66,,211,277
02231600,MGH INSTITUTE OF HEALTH PROFESSION      ,MA,02129-0000,Private      ,10,91,101,98,,1545,1643
02274300,CONWAY SCHOOL OF LANDSCAPE DESIGN       ,MA,01341-0179,Private      ,0,2,2,0,,17,17
02325700,LABARON HAIRDRESSING ACADEMY            ,MA,02740-0000,Proprietary  ,4,4,8,22,,59,81
02325800,LABARON HAIRDRESSING ACAD-BROCKTON      ,MA,02301-0000,Proprietary  ,6,6,12,23,,47,70
02337400,BANCROFT SCHOOL OF MASSAGE THERAPY      ,MA,01604-4614,Proprietary  ,4,14,18,27,,89,116
02338200,BAY STATE SCHOOL OF TECHNOLOGY          ,MA,02021-0000,Proprietary  ,4,37,41,70,,232,302
02339400,ROB ROY ACADEMY                         ,MA,02746-0000,Proprietary  ,2,4,6,11,,37,48
02491700,CORTIVA INSTITUTE -  BOSTON             ,MA,02472-2577,Proprietary  ,8,19,27,31,,121,152
02523900,ELIZABETH GRADY SCHOOL OF ESTHETICS     ,MA,02155-0000,Proprietary  ,6,28,34,57,,169,226
02579800,NEW ENGLAND SCHOOL OF ACUPUNCTURE       ,MA,02458-0000,Private      ,0,5,5,1,,140,141
02616704,LE CORDON BLEU COLLEGE OF CULINARY ARTS ,MA,02142-1221,Proprietary  ,20,33,53,188,,262,450
03066700,AILANO SCHOOL OF COSMETOLOGY            ,MA,02303-4740,Proprietary  ,3,17,20,27,,78,105
03104000,SHAWSHEEN ADULT TECHNICAL INSTITUTE     ,MA,01821-5499,Public       ,0,4,4,14,,77,91
03115200,MOTORING TECHNICAL TRAINING INST        ,MA,02771-5933,Proprietary  ,20,53,73,157,,333,490
03120800,KAY HARVEY HAIRDRESSING ACADEMY         ,MA,01089-2701,Proprietary  ,2,11,13,21,,58,79
03130500,URBAN COLLEGE OF BOSTON                 ,MA,02111-1093,Private      ,5,70,75,68,,841,909
03194300,BOSTON GRAD SCH OF PSYCHOANALYSIS       ,MA,02446-4602,Private      ,0,5,5,3,,83,86
03205400,JOLIE HAIR & BEAUTY ACADEMY             ,MA,01056-2769,Proprietary  ,8,22,30,32,,116,148
03235300,MASSACHUSETTS SCHOOL OF LAW             ,MA,01810-1094,Private      ,2,37,39,16,,572,588
03240300,TONI & GUY HAIRDRESSING ACADEMY         ,MA,01605-2213,Proprietary  ,12,18,30,129,,133,262
03240301,TONI & GUY HAIRDRESSING ACADEMY - BRAINT,MA,02184-2807,Proprietary  ,8,12,20,13,,14,27
03248300,BOSTON BAPTIST COLLEGE                  ,MA,02136-4030,Private      ,5,8,13,96,,66,162
03316400,FUNERAL INSTITUTE OF THE NORTHEAST      ,MA,02062-4766,Proprietary  ,1,10,11,46,,114,160
03504300,NATL GRAD SCH OF QUALITY SYSTM MGMT     ,MA,02540-0000,Private      ,0,22,22,0,,76,76
03570500,NORTHPOINT BIBLE COLLEGE                ,MA,01835-0000,Private      ,8,16,24,220,,173,393
03763300,MEDICAL PROFESSIONAL INSTITUTE          ,MA,02148-8143,Proprietary  ,11,44,55,73,,394,467
03859300,E.I.N.E.                                ,MA,01876-4709,Proprietary  ,2,5,7,11,,42,53
03927303,BRIO ACADEMY OF COSMETOLOGY - NORTHHAMPT,MA,01060-3947,Proprietary  ,7,17,24,30,,83,113
03946300,FRANKLIN W. OLIN COLLEGE OF ENGINEERING ,MA,02492-1200,Private      ,23,1,24,609,,14,623
03965300,NEW ENGLAND COLLEGE OF FINANCE          ,MA,02110-1605,Proprietary  ,4,122,126,86,,894,980
04039300,SULLIVAN AND COGLIANO TRAINING CENTER   ,MA,02301-4921,Proprietary  ,10,339,349,83,,1373,1456
04116900,DIGRIGOLI SCHOOL OF COSMETOLOGY         ,MA,01089-4623,Proprietary  ,7,19,26,63,,95,158
04122000,TRI COUNTY REGIONAL VOCATIONAL TECHNICAL,MA,02038-0000,Public       ,2,3,5,13,,96,109
04128000,MILLENNIUM TRAINING INSTITUTE           ,MA,01801-6386,Proprietary  ,2,50,52,6,,186,192
04128900,CENTRAL MASS SCHOOL OF MASSAGE AND THERA,MA,01562-1712,Proprietary  ,0,6,6,2,,24,26
04143200,HULT INTERNATIONAL BUSINESS SCHOOL      ,MA,02141-1805,Private      ,1,19,20,47,,262,309
04153200,SOUTHERN WORCESTER COUNTY REGIONAL VOC S,MA,01507-1331,Public       ,2,3,5,13,,46,59
04193100,ALEXANDER ACADEMY                       ,MA,01420-0000,Proprietary  ,5,11,16,22,,71,93
00401200,HEBREW UNIVERSITY OF JERUSALEM (THE)    ,FC,00000-0000,Public       ,0,6,6,31,,102,133
00403000,UNIVERSITY OF CAMBRIDGE                 ,FC,00000-0000,Public       ,1,4,5,7,,90,97
00503400,AMERICAN UNIVERSITY OF CAIRO            ,FC,00000-0000,Private      ,7,8,15,68,,140,208
00667100,KATHOLIEKE UNIVERSITEIT LEUVEN          ,FC,00000-0000,Private      ,0,0,0,3,,28,31
00669000,UNIVERSITY OF COPENHAGEN                ,FC,00000-0000,Public       ,1,3,4,1,,10,11
00669100,UNIVERSITY OF CAMBRIDGE - PEMBROKE      ,FC,00000-0000,Public       ,0,0,0,1,,17,18
00669200,UNIVERSITY OF LEEDS                     ,FC,00000-0000,Public       ,2,5,7,22,,94,116
00669300,UNIV OF LONDON-LONDON SCHOOL ECON       ,FC,00000-0000,Public       ,1,15,16,25,,436,461
00669400,UNIVERSITY OF LONDON - SCHOOL OF ORIENTA,FC,00000-0000,Public       ,0,7,7,12,,168,180
00669500,UNIV OF LONDON-UNIVERSITY COLLEGE       ,FC,00000-0000,Public       ,4,14,18,87,,454,541
00669600,UNIV OF LONDON-SCH ADVANCED STUDY       ,FC,00000-0000,Public       ,0,1,1,0,,11,11
00669700,"QUEEN MARY, UNIVERSITY OF LONDON        ",FC,00000-0000,Public       ,1,6,7,45,,156,201
00669900,UNIVERSITY OF SUSSEX                    ,FC,00000-0000,Public       ,0,2,2,31,,98,129
00670000,"UNIVERSITY OF YORK, THE                 ",FC,00000-0000,Public       ,1,4,5,21,,165,186
00670400,UNIVERSITY COLLEGE CORK                 ,FC,00000-0000,Public       ,0,4,4,13,,79,92
00671300,UPPSALA UNIVERSITY                      ,FC,00000-0000,Public       ,0,3,3,4,,49,53
00671500,UNIVERSITY OF GENEVA                    ,FC,00000-0000,Public       ,1,5,6,8,,98,106
00683900,UNIVERSITY OF EDINBURGH                 ,FC,00000-0000,Public       ,9,27,36,245,,784,1029
00684200,UNIVERSITY OF DUBLIN TRINITY COLLEG     ,FC,00000-0000,Public       ,3,5,8,68,,228,296
00685000,UNIVERSITY OF CAMBRIDGE - DOWNING C     ,FC,00000-0000,Public       ,0,0,0,1,,5,6
00763200,UNIVERSITY OF BRISTOL                   ,FC,00000-0000,Public       ,0,1,1,20,,84,104
00768100,COLLEGE OF EUROPE                       ,FC,00000-0000,Private      ,0,1,1,1,,10,11
00770500,ROYAL COLLEGE OF SURGEONS IN IRELAN     ,FC,00000-0000,Private      ,0,1,1,7,,61,68
00788100,AMERICAN UNIVERSITY OF PARIS            ,FC,00000-0000,Private      ,37,20,57,480,,281,761
00837100,AMERICAN UNIVERSITY OF BEIRUT           ,FC,00000-0000,Private      ,6,2,8,109,,75,184
00837300,TEL-AVIV UNIVERSITY                     ,FC,00000-0000,Public       ,1,7,8,34,,112,146
00837600,VRIJE UNIVERSITEIT AMSTERDAM            ,FC,00000-0000,Public       ,0,2,2,1,,32,33
00837700,UNIVERSITEIT VAN AMSTERDAM(UNIVERSI     ,FC,00000-0000,Public       ,1,8,9,16,,118,134
00838000,UNIVERSITY OF WARWICK                   ,FC,00000-0000,Public       ,0,5,5,18,,72,90
00838300,UNIVERSITY OF GLASGOW                   ,FC,00000-0000,Public       ,3,9,12,64,,400,464
00839300,UNIVERSITY OF OSLO                      ,FC,00000-0000,Public       ,1,3,4,3,,32,35
00839400,UNIVERSITY OF OXFORD                    ,FC,00000-0000,Public       ,4,11,15,27,,400,427
00839800,UNIVERSITY OF SHEFFIELD (THE)           ,FC,00000-0000,Public       ,0,0,0,12,,91,103
00839900,UNIVERSITY OF SOUTHAMPTON               ,FC,00000-0000,Public       ,0,6,6,17,,73,90
00845200,ABERYSTWYTH UNIVERSITY                  ,FC,00000-0000,Public       ,0,6,6,29,,64,93
00845800,LOUGHBOROUGH UNIVERSITY                 ,FC,00000-0000,Public       ,1,3,4,6,,19,25
00846000,UNIVERSITY OF NEWCASTLE UPON TYNE       ,FC,00000-0000,Public       ,1,5,6,17,,112,129
00846100,UNIVERSITY OF SAINT ANDREWS             ,FC,00000-0000,Private      ,11,9,20,318,,190,508
00850500,UNIVERSITY OF MELBOURNE                 ,FC,00000-0000,Public       ,2,37,39,25,,202,227
00858600,SWANSEA UNIVERSITY                      ,FC,00000-0000,Public       ,0,2,2,13,,63,76
00858700,UNIVERSITY OF DURHAM                    ,FC,00000-0000,Public       ,1,7,8,32,,212,244
00866500,UNIVERSITY OF KENT AT CANTERBURY (THE)  ,FC,00000-0000,Public       ,1,3,4,42,,179,221
00867000,UNIVERSITY OF NEW SOUTH WALES           ,FC,00000-0000,Public       ,2,14,16,26,,87,113
00868700,UNIVERSITY OF ESSEX                     ,FC,00000-0000,Public       ,0,3,3,36,,157,193
00869300,CITY UNIVERSITY                         ,FC,00000-0000,Public       ,1,11,12,25,,196,221
00890800,THE UNIVERSITY OF BIRMINGHAM            ,FC,00000-0000,Public       ,1,16,17,15,,134,149
00891000,UNIVERSITY OF HULL                      ,FC,00000-0000,Public       ,0,0,0,8,,9,17
00892000,UNIVERSITY OF NOTTINGHAM                ,FC,00000-0000,Public       ,0,6,6,22,,112,134
00900600,UNIVERSITY OF SALFORD (THE)             ,FC,00000-0000,Public       ,0,4,4,5,,20,25
00908400,"UNIV OF LONDON, BIRKBECK                ",FC,00000-0000,Public       ,0,7,7,8,,108,116
00908500,UNIV OF LONDON KING'S COLLEGE           ,FC,00000-0000,Public       ,4,22,26,68,,457,525
00908600,UNIVERSITY OF LONDON - ROYAL HOLLOWAY   ,FC,00000-0000,Public       ,2,3,5,37,,85,122
00914300,BAR-ILAN UNIVERSITY                     ,FC,00000-0000,Private      ,0,5,5,23,,31,54
00924900,UNIVERSITY OF LIVERPOOL                 ,FC,00000-0000,Public       ,2,9,11,32,,106,138
00936800,UNIVERSITY OF ABERDEEN                  ,FC,00000-0000,Public       ,2,10,12,44,,139,183
00942300,ROYAL COLLEGE OF ART                    ,FC,00000-0000,Public       ,1,1,2,4,,67,71
00942800,TECHNION-ISRAEL INST OF TECHLGY         ,FC,00000-0000,Public       ,0,8,8,5,,60,65
00944200,UNIVERSITY OF EXETER                    ,FC,00000-0000,Public       ,0,4,4,21,,102,123
00944400,UNIVERSITY OF LANCASTER                 ,FC,00000-0000,Public       ,0,1,1,15,,58,73
00963400,UNIVERSITY OF OXFORD ST CATHERINE'S     ,FC,00000-0000,Public       ,0,0,0,5,,9,14
00980800,UNIVERSITY OF STRATHCLYDE               ,FC,00000-0000,Public       ,2,2,4,15,,46,61
00986000,UNIVERSITY OF SURREY                    ,FC,00000-0000,Public       ,1,5,6,11,,42,53
00988800,KAROLINSKA INSTITUTET                   ,FC,00000-0000,Public       ,0,1,1,0,,1,1
00990600,PONTIFICAL NORTH AMERICAN COLLEGE       ,FC,00000-0000,Private      ,0,0,0,1,,7,8
00992700,UNIVERSITY OF CAMBRIDGE - FITZWILLI     ,FC,00000-0000,Public       ,0,0,0,1,,11,12
01006700,LUND UNIVERSITY                         ,FC,00000-0000,Public       ,0,4,4,4,,71,75
01008400,UNIVERSITY OF CAPE TOWN                 ,FC,00000-0000,Public       ,2,12,14,10,,77,87
01008700,UNIVERSITY OF OXFORD ST PETER'S COL     ,FC,00000-0000,Public       ,0,0,0,1,,5,6
01008800,UNIVERSITY OF OXFORD - CORPUS CHRIS     ,FC,00000-0000,Public       ,0,0,0,1,,1,2
01008900,CENTRAL SCHOOL OF SPEECH AND DRAMA      ,FC,00000-0000,Private      ,3,2,5,16,,64,80
01009000,UNIVERSITY OF OXFORD - BALLIOL COLL     ,FC,00000-0000,Public       ,0,0,0,4,,4,8
01014300,UNIVERSITY OF READING                   ,FC,00000-0000,Public       ,0,4,4,17,,64,81
01015700,CARDIFF UNIVERSITY                      ,FC,00000-0000,Public       ,0,2,2,19,,61,80
01015900,PONTIFICIA UNIVERSITA GREGORIANA        ,FC,00000-0000,Private      ,0,0,0,2,,5,7
01016000,CG JUNG INST                            ,FC,00000-0000,Private      ,0,1,1,0,,5,5
01018800,UNIVERSITY COLLEGE DUBLIN               ,FC,00000-0000,Public       ,1,9,10,52,,274,326
01019000,UNIVERSITY OF CAMBRIDGE CHURCHILL C     ,FC,00000-0000,Public       ,0,0,0,0,,4,4
01022800,UNIVERSITY OF STIRLING                  ,FC,00000-0000,Public       ,1,4,5,34,,64,98
01033200,UNIVERSITY OF CAMBRIDGE - CLARE COL     ,FC,00000-0000,Public       ,0,0,0,0,,7,7
01045600,UNIVERSITY OF HAIFA                     ,FC,00000-0000,Public       ,0,1,1,5,,36,41
01047200,INST EUROPEEN OPEEN D'ADMINISTRATIO     ,FC,00000-0000,Private      ,1,9,10,1,,61,62
01049300,CRANFIELD UNIVERSITY                    ,FC,00000-0000,Public       ,0,2,2,1,,21,22
01052000,TRINITY LABAN CONSERVATOIRE OF MUSIC AND,FC,00000-0000,Public       ,0,0,0,4,,12,16
01052500,UNIVERSITY OF HERTFORDSHIRE             ,FC,00000-0000,Public       ,1,2,3,14,,21,35
01057400,LONDON INTRNTL FILM SCHOOL              ,FC,00000-0000,Private      ,2,3,5,6,,24,30
01058800,AUSTRALIAN NATIONAL UNIVERSITY          ,FC,00000-0000,Public       ,3,4,7,21,,46,67
01058900,BANGOR UNIVERSITY                       ,FC,00000-0000,Public       ,0,1,1,14,,18,32
01059400,"RICHMOND, THE AMERICAN INT UNI IN LONDON",FC,00000-0000,Private      ,6,5,11,390,,94,484
01059900,INST D'ETUDES POLITIQUES DE PARIS       ,FC,00000-0000,Public       ,1,4,5,17,,144,161
01068100,MACQUARIE UNIVERSITY                    ,FC,00000-0000,Public       ,2,8,10,10,,51,61
01069200,UNIVERSITY OF QUEENSLAND (THE)          ,FC,00000-0000,Public       ,4,181,185,15,,388,403
01078900,UNIVERSITY OF OXFORD - WORCESTER CO     ,FC,00000-0000,Public       ,0,0,0,0,,1,1
01079200,CITY AND GUILDS OF LONDON INSTITUTE     ,FC,00000-0000,Private      ,0,0,0,2,,3,5
01079700,"NATIONAL UNIVERSITY OF IRELAND, MAY     ",FC,00000-0000,Public       ,0,0,0,18,,20,38
01081600,KINGSTON UNIVERSITY                     ,FC,00000-0000,Public       ,4,12,16,66,,235,301
01083800,UNIVERSITITY OF BERGEN (UOB)            ,FC,00000-0000,Public       ,0,1,1,1,,7,8
01086400,UNIV OF DUNDEE                          ,FC,00000-0000,Public       ,1,1,2,8,,53,61
01086600,UNIVERSITY OF OXFORD - MAGDALEN COLLEGE ,FC,00000-0000,Public       ,0,0,0,1,,11,12
01086700,UNIVERSITY OF OXFORD ST JOHN'S COLL     ,FC,00000-0000,Public       ,0,0,0,2,,8,10
01091400,MONASH UNIVERSITY                       ,FC,00000-0000,Public       ,3,2,5,12,,42,54
01091500,UNIV OF EAST ANGLIA                     ,FC,00000-0000,Public       ,0,5,5,26,,103,129
01094200,UNIVERSITY OF OXFORD - ST HUGH'S CO     ,FC,00000-0000,Public       ,0,0,0,0,,11,11
01097700,UNIVERSIDAD CENTRAL DEL ESTE            ,FC,00000-0000,Private      ,5,8,13,96,,833,929
01098000,SOMERVILLE COLLEGE                      ,FC,00000-0000,Public       ,0,1,1,4,,4,8
01099900,UNIV OF OXFORD - WADHAM COLLEGE         ,FC,00000-0000,Public       ,0,0,0,0,,3,3
01104400,PONTIFICIA UNIVERSITA SAN TOMMASO       ,FC,00000-0000,Private      ,1,2,3,1,,10,11
01105300,UNIVERSITY OF OXFORD - ST HILDA'S C     ,FC,00000-0000,Public       ,0,0,0,1,,5,6
01105400,UNIVERSITY OF OXFORD - ST ANNE'S CO     ,FC,00000-0000,Public       ,1,0,1,1,,6,7
01105500,UNIV OF OXFORD - LADY MARGARET HALL     ,FC,00000-0000,Public       ,1,0,1,1,,7,8
01105600,UNIVERSITY OF OXFORD - UNIVERSITY C     ,FC,00000-0000,Public       ,1,4,5,10,,32,42
01105700,UNIVERSITY OF OXFORD - TRINITY COLL     ,FC,00000-0000,Public       ,0,0,0,3,,10,13
01105800,UNIVERSITY OF OXFORD-ST EDMUND HALL     ,FC,00000-0000,Public       ,0,1,1,1,,9,10
01105900,UNIVERSITY OF OXFORD ST ANTONY'S CO     ,FC,00000-0000,Public       ,0,2,2,0,,37,37
01106000,UNIVERSITY OF OXFORD - QUEEN'S COLL     ,FC,00000-0000,Public       ,0,1,1,1,,6,7
01106100,UNIVERSITY OF OXFORD - PEMBROKE COL     ,FC,00000-0000,Public       ,0,1,1,3,,11,14
01106200,UNIVERSITY OF OXFORD - ORIEL COLLEG     ,FC,00000-0000,Public       ,0,0,0,0,,10,10
01106300,UNIVERSITY OF OXFORD - NUFFIELD COL     ,FC,00000-0000,Public       ,0,0,0,0,,2,2
01106400,UNIVERSITY OF OXFORD - NEW COLLEGE      ,FC,00000-0000,Public       ,0,0,0,2,,8,10
01106500,UNIVERSITY OF OXFORD MERTON COLLEGE     ,FC,00000-0000,Public       ,0,0,0,1,,9,10
01106600,UNIVERSITY OF OXFORD - LINCOLN COLL     ,FC,00000-0000,Public       ,0,0,0,0,,6,6
01106700,UNIVERSITY OF OXFORD - KEBLE COLLEG     ,FC,00000-0000,Public       ,0,1,1,0,,6,6
01106800,UNIVERSITY OF OXFORD - JESUS COLLEG     ,FC,00000-0000,Public       ,0,0,0,0,,5,5
01106900,UNIVERSITY OF OXFORD - HERTFORD COL     ,FC,00000-0000,Public       ,0,0,0,0,,7,7
01107000,UNIVERSITY OF OXFORD EXETER COLLEGE     ,FC,00000-0000,Public       ,0,0,0,2,,4,6
01107100,UNIV OF OXFORD - CHRIST CHURCH          ,FC,00000-0000,Public       ,2,0,2,2,,11,13
01107200,UNIVERSITY OF OXFORD - BRASENOSE CO     ,FC,00000-0000,Public       ,0,0,0,0,,3,3
01109100,FLINDERS UNIVERSITY OF S AUSTRALIA      ,FC,00000-0000,Public       ,0,7,7,2,,31,33
01109400,UNIVERSITY OF WESTERN AUSTRALIA (THE)   ,FC,00000-0000,Public       ,2,5,7,10,,25,35
01121400,UNIVERSITY OF THE WITWATERSRAND         ,FC,00000-0000,Public       ,0,1,1,5,,23,28
01122600,AARHUS UNIVERSITY                       ,FC,00000-0000,Public       ,0,2,2,3,,28,31
01156700,"IMPERIAL COLLEGE OF SCIENCE, TECHNOLOGY ",FC,00000-0000,Public       ,2,5,7,25,,106,131
01167900,UNIVERSITY OF BATH                      ,FC,00000-0000,Public       ,0,1,1,20,,51,71
01168300,FRANKLIN COLLEGE  SWITZERLAND           ,FC,00000-0000,Private      ,14,2,16,334,,20,354
01175800,UNIV OF CAMBRIDGE - PETERHOUSE          ,FC,00000-0000,Public       ,0,0,0,0,,6,6
01176400,ROYAL ACADEMY OF MUSIC                  ,FC,00000-0000,Public       ,1,1,2,8,,24,32
01176500,GOLDSMITHS' COLLEGE-UNIV OF LONDON      ,FC,00000-0000,Public       ,2,9,11,50,,158,208
01176600,UNIV OF LONDON - INST OF EDUC           ,FC,00000-0000,Public       ,0,7,7,3,,49,52
01178000,BRUNEL UNIVERSITY                       ,FC,00000-0000,Public       ,0,4,4,10,,56,66
01183800,UNIVERSITY OF OXFORD - MANSFIELD CO     ,FC,00000-0000,Public       ,0,0,0,1,,7,8
01207500,UNIVERSITY CAMBRIDGE - TRINITY COLL     ,FC,00000-0000,Public       ,0,2,2,2,,20,22
01207800,VICTORIA UNIV OF WELLINGTON             ,FC,00000-0000,Public       ,3,13,16,22,,52,74
01209600,ECOLE HÔTELIERE DE LAUSANNE             ,FC,00000-0000,Private      ,0,1,1,6,,9,15
01210100,UNIVERSITY OF CAMBRIDGE - GIRTON CO     ,FC,00000-0000,Public       ,0,0,0,0,,8,8
01213600,VICTORIA UNIV OF MANCHESTER (THE)       ,FC,00000-0000,Public       ,6,5,11,38,,151,189
01219800,UNIVERSITY OF BRADFORD                  ,FC,00000-0000,Public       ,0,2,2,2,,25,27
01220100,UNIVERSITY OF OXFORD - REGENT'S PAR     ,FC,00000-0000,Public       ,0,0,0,1,,5,6
01220600,JAMES COOK UNIVERSITY                   ,FC,00000-0000,Public       ,2,8,10,24,,72,96
01221500,BIRMINGHAM CITY UNIVERSITY              ,FC,00000-0000,Public       ,0,0,0,12,,33,45
01222300,JAGIELLONIAN UNIVERSITY COLLEGIUM M     ,FC,00000-0000,Public       ,0,0,0,3,,24,27
01222500,UNIVERSITY OF SZEGED FACULTY OF MEDICINE,FC,00000-0000,Public       ,0,0,0,1,,10,11
01225800,ASTON UNIVERSITY                        ,FC,00000-0000,Public       ,1,1,2,5,,20,25
01227500,UNIVERSITY OF OXFORD - WOLFSON COLL     ,FC,00000-0000,Public       ,0,0,0,0,,26,26
01230200,GONVILLE & CAIUS COLLEGE                ,FC,00000-0000,Public       ,0,0,0,2,,3,5
01233300,UNIVERSITY OF THE ARTS LONDON IDO - CAMB,FC,00000-0000,Public       ,0,0,0,15,,12,27
01233500,ROYAL COLLEGE OF MUSIC                  ,FC,00000-0000,Public       ,0,1,1,11,,26,37
01234100,UNIVERSITY OF WALES - ST DAVID'S UN     ,FC,00000-0000,Public       ,0,3,3,5,,25,30
01242100,UNIV OF AUCKLAND                        ,FC,00000-0000,Public       ,1,14,15,28,,93,121
01253900,UNIVERSITY OF THE ARTS LONDON IDO - CENT,FC,00000-0000,Public       ,0,0,0,23,,31,54
01254000,UNIVERSIDAD DE NAVARRA                  ,FC,00000-0000,Private      ,0,2,2,17,,24,41
01276500,UNIVERSITY OF OXFORD - LINACRE COLL     ,FC,00000-0000,Public       ,0,1,1,0,,11,11
01276600,"NATIONAL UNIVERSITY IRELAND, GALWAY     ",FC,00000-0000,Public       ,0,4,4,32,,94,126
01280200,PONTIFICIA UNIV CATOLICA MAD Y MAES     ,FC,00000-0000,Private      ,12,11,23,177,,107,284
01281100,INST TECNOLOGICO DE SANTO DOMINGO       ,FC,00000-0000,Private      ,3,7,10,46,,65,111
01283900,UNIVERSITY OF CAMBRIDGE - SAINT JOH     ,FC,00000-0000,Public       ,0,0,0,0,,11,11
01297800,UNIVERSITY OF HUDDERSFIELD (THE)        ,FC,00000-0000,Public       ,0,1,1,8,,20,28
01315300,MASSEY UNIVERSITY                       ,FC,00000-0000,Public       ,0,24,24,6,,63,69
01322500,COLLEGE OF LAW                          ,FC,00000-0000,Private      ,0,0,0,0,,2,2
02052400,DARWIN COLLEGE                          ,FC,00000-0000,Public       ,0,1,1,0,,10,10
02082400,UNIVERSITY OF CAMBRIDGE - QUEEN'S C     ,FC,00000-0000,Public       ,0,1,1,1,,25,26
02083400,UNIVERSITY OF CAMBRIDGE - WOLFSON C     ,FC,00000-0000,Public       ,0,0,0,0,,17,17
02087400,UNIVERSITY OF CAMBRIDGE - NEWNHAM C     ,FC,00000-0000,Public       ,0,0,0,1,,8,9
02087900,OXFORD BROOKES UNIVERSITY               ,FC,00000-0000,Public       ,1,4,5,28,,92,120
02094100,BEN-GURION UNIV                         ,FC,00000-0000,Public       ,0,5,5,0,,131,131
02094400,UNIV OF CAMBRIDGE - ST EDMUND'S HOU     ,FC,00000-0000,Public       ,0,3,3,2,,18,20
02095500,LONDON BUS SCHOOL                       ,FC,00000-0000,Public       ,0,11,11,6,,123,129
02101900,ROEHAMPTON UNIVERSITY                   ,FC,00000-0000,Public       ,1,5,6,18,,102,120
02108600,LONDON ACADEMY OF MUSIC & DRAMATIC      ,FC,00000-0000,Private      ,3,3,6,16,,35,51
02115900,UNIVERSITY OF PORTSMOUTH                ,FC,00000-0000,Public       ,0,1,1,10,,22,32
02116700,UNIVERSITY OF CAMBRIDGE - LUCY CAVE     ,FC,00000-0000,Public       ,0,0,0,1,,3,4
02120000,UNIV OF LONDON - COURTALD INST OF A     ,FC,00000-0000,Public       ,0,1,1,3,,38,41
02133400,UNIVERSITY OF CAMBRIDGE - SIDNEY SU     ,FC,00000-0000,Public       ,1,0,1,1,,8,9
02142000,UNIVERSITY OF CAMBRIDGE - HOMERTON      ,FC,00000-0000,Public       ,0,0,0,0,,7,7
02149700,UNIVERSITY OF WINCHESTER (THE)          ,FC,00000-0000,Public       ,0,2,2,19,,14,33
02156800,UNIV OF OTAGO                           ,FC,00000-0000,Public       ,0,12,12,11,,38,49
02162300,"IESE BUSINESS SCH, UNIV OF NAVARRA      ",FC,00000-0000,Private      ,0,3,3,8,,67,75
02167400,UNIVERSITY OF CAMBRIDGE - CORPUS CH     ,FC,00000-0000,Public       ,0,0,0,0,,11,11
02177700,KING'S COLLEGE- UNIV OF CAMBRIDGE       ,FC,00000-0000,Public       ,2,0,2,6,,28,34
02180500,MIDDLESEX UNIVERSITY                    ,FC,00000-0000,Public       ,1,13,14,40,,106,146
02181000,UNIVERSITY OF SOUTH AUSTRALIA           ,FC,00000-0000,Public       ,2,2,4,8,,11,19
02183500,UNIV OF OXFORD - WYCLIFFE HALL          ,FC,00000-0000,Public       ,0,1,1,1,,10,11
02186000,UNIVERSITY OF CAMBRIDGE - MAGDALENE     ,FC,00000-0000,Public       ,0,0,0,1,,5,6
02186100,UNIVERSITY OF CAMBRIDGE - EMMANUEL      ,FC,00000-0000,Public       ,0,0,0,0,,6,6
02189600,UNIVERSITY OF GRONINGEN                 ,FC,00000-0000,Public       ,0,1,1,4,,28,32
02194800,UNIVERSITY OF THE WEST OF ENGLAND -     ,FC,00000-0000,Public       ,0,3,3,9,,13,22
02195100,UNIV OF WESTMINSTER                     ,FC,00000-0000,Public       ,3,12,15,57,,135,192
02196700,GUILDHALL SCHOOL OF MUSIC & DRAMA       ,FC,00000-0000,Public       ,2,1,3,16,,22,38
02207300,UNIVERSITY OF CAMBRIDGE - CHRIST'S      ,FC,00000-0000,Public       ,0,0,0,1,,5,6
02207400,CHINESE UNIVERSITY OF HONG KONG (THE)   ,FC,00000-0000,Public       ,0,5,5,18,,53,71
02209500,UNIVERSITEIT UTRECHT                    ,FC,00000-0000,Public       ,0,2,2,14,,52,66
02210000,UNIV OF LONDON - LONDON SCHOOL OF H     ,FC,00000-0000,Public       ,0,2,2,3,,88,91
02212300,UNIVERSITY OF CAMBRIDGE - ROBINSON      ,FC,00000-0000,Public       ,0,0,0,0,,1,1
02225300,UNIV OF CANTERBURY                      ,FC,00000-0000,Public       ,2,6,8,6,,44,50
02229100,UNIVERSITY OF LEICESTER                 ,FC,00000-0000,Public       ,1,8,9,18,,115,133
02229600,SACKLER SCHOOL OF MEDICINE              ,FC,00000-0000,Public       ,0,0,0,1,,152,153
02232100,UNIVERSITY OF CAMBRIDGE                 ,FC,00000-0000,Public       ,0,3,3,2,,26,28
02233300,"ST GEORGE'S UNIVERSITY, SCHOOL OF MEDICI",FC,00000-0000,Proprietary  ,3,242,245,23,,3691,3714
02235300,LONDON METROPOLITAN UNIVERSITY          ,FC,00000-0000,Public       ,0,10,10,25,,87,112
02244400,AMERICAN UNIV OF THE CARIBBEAN          ,FC,00000-0000,Proprietary  ,0,106,106,14,,1716,1730
02266600,UNIVERSITY OF LONDON - SAINT GEORGE     ,FC,00000-0000,Public       ,0,2,2,2,,27,29
02271700,UNIVERSITY OF CAMBRIDGE - CLARE HAL     ,FC,00000-0000,Public       ,0,0,0,0,,4,4
02271900,UNIVERSITY OF OXFORD - BLACKFRIARS      ,FC,00000-0000,Public       ,0,0,0,0,,5,5
02272200,UNIV OF CAMBRIDGE - NEW HALL            ,FC,00000-0000,Public       ,0,1,1,0,,5,5
02273600,QUEEN'S UNIV OF BELFAST (THE)           ,FC,00000-0000,Public       ,0,6,6,12,,77,89
02273900,HERIOT WATT UNIVERSITY                  ,FC,00000-0000,Public       ,0,6,6,9,,48,57
02276700,NYENRODE BUSINESS UNIVERSITEIT          ,FC,00000-0000,Private      ,0,1,1,0,,3,3
02293400,ECOLE DES HAUTES ETUDES COMERCIALS      ,FC,00000-0000,Public       ,1,5,6,1,,29,30
02296300,UNIVERSITY OF CAMBRIDGE - JESUS COL     ,FC,00000-0000,Public       ,0,0,0,0,,7,7
02310500,DE MONTFORT UNIVERSITY                  ,FC,00000-0000,Public       ,0,2,2,3,,9,12
02320500,ROYAL NORTHERN COLLEGE OF MUSIC         ,FC,00000-0000,Public       ,0,0,0,0,,12,12
02335100,UNIV OF CAMBRIDGE - TRINITY HALL        ,FC,00000-0000,Public       ,0,0,0,2,,16,18
02338900,UNIVERSITY  FOR THE CREATIVE ARTS       ,FC,00000-0000,Public       ,0,1,1,8,,13,21
02351800,UNIVERSIDAD IBEROAMERICANA (UNIBE       ,FC,00000-0000,Private      ,8,42,50,110,,510,620
02352100,UNIVERSITY OF PLYMOUTH                  ,FC,00000-0000,Public       ,0,2,2,5,,21,26
02355200,ECOLE SUPERIEURE DE CUISINE FRANCAISE-FE,FC,00000-0000,Public       ,0,0,0,4,,17,21
02493000,ESCUELA SUPERIOR ADMINISTRACION Y D     ,FC,00000-0000,Private      ,0,0,0,5,,25,30
02496700,NATIONAL FILM & TV SCHOOL               ,FC,00000-0000,Public       ,0,2,2,0,,10,10
02502600,PECSI ORVOSTUDOMANYI EGYETEM (PECS      ,FC,00000-0000,Public       ,0,0,0,0,,2,2
02545700,GLASGOW SCHOOL OF ART                   ,FC,00000-0000,Public       ,1,0,1,9,,27,36
02561600,SOUTHAMPTON SOLENT UNIVERSITY           ,FC,00000-0000,Public       ,0,0,0,8,,8,16
02579600,MURDOCH UNIVERSITY                      ,FC,00000-0000,Public       ,0,6,6,1,,54,55
02588000,UNIVERSITY OF ULSTER                    ,FC,00000-0000,Public       ,0,2,2,5,,19,24
02591800,CURTIN UNIVERSITY OF TECHNOLOGY         ,FC,00000-0000,Public       ,0,5,5,3,,16,19
02611700,DUBLIN CITY UNIVERSITY                  ,FC,00000-0000,Public       ,0,0,0,10,,36,46
02623200,UNIVERSITY OF NEWCASTLE (THE)           ,FC,00000-0000,Public       ,0,0,0,11,,15,26
03012700,UNIVERSITY OF BUCKINGHAM                ,FC,00000-0000,Private      ,0,3,3,5,,10,15
03029400,KEELE UNIVERSITY                        ,FC,00000-0000,Public       ,1,0,1,20,,21,41
03029500,NORTHUMBRIA UNIVERSITY                  ,FC,00000-0000,Public       ,0,1,1,7,,28,35
03029800,NORGES HANDELSHOYSKOLE                  ,FC,00000-0000,Public       ,0,0,0,1,,3,4
03033300,MANCHESTER METROPOLITAN UNIV            ,FC,00000-0000,Public       ,3,3,6,27,,49,76
03045000,UNIVERSITY OF EAST LONDON               ,FC,00000-0000,Public       ,2,8,10,36,,86,122
03050100,STUDIO ART CENTERS INTERNATIONAL        ,FC,00000-0000,Private      ,1,2,3,21,,44,65
03066800,PONTIFICIO ATENEO DELLA SANTA CROCE     ,FC,00000-0000,Private      ,0,0,0,0,,6,6
03067200,UNIVERSITY OF SYDNEY                    ,FC,00000-0000,Public       ,1,32,33,26,,227,253
03073800,UNIV OF DEBRECEN MED & HEALTH SCI       ,FC,00000-0000,Public       ,0,1,1,5,,20,25
03080300,SHEFFIELD HALLAM UNIVERSITY             ,FC,00000-0000,Public       ,0,1,1,2,,16,18
03084300,UNIVERSITY OF LIMERICK                  ,FC,00000-0000,Public       ,1,2,3,24,,59,83
03088700,ROYAL SCOTTISH ACAD MUSIC & DRAMA       ,FC,00000-0000,Public       ,1,1,2,26,,23,49
03091400,UNIVERSITY OF WOLLONGONG                ,FC,00000-0000,Public       ,1,2,3,5,,22,27
03091500,UNIVERSITY OF CANBERRA                  ,FC,00000-0000,Public       ,2,1,3,4,,11,15
03091700,POZNAN UNIVERSITY OF MEDICAL SCIENCES   ,FC,00000-0000,Public       ,1,2,3,8,,75,83
03092500,NOTTINGHAM TRENT UNIVERSITY             ,FC,00000-0000,Public       ,0,1,1,11,,29,40
03095000,RMIT UNIVERSITY                         ,FC,00000-0000,Public       ,3,8,11,15,,45,60
03095400,BOND UNIVERSITY                         ,FC,00000-0000,Private      ,2,13,15,13,,53,66
03095900,ESSEC BUSINESS SCHOOL                   ,FC,00000-0000,Private      ,0,1,1,0,,14,14
03096100,LA TROBE UNIVERSITY                     ,FC,00000-0000,Public       ,5,4,9,12,,29,41
03096900,DEAKIN UNIVERSITY                       ,FC,00000-0000,Public       ,1,1,2,5,,7,12
03097100,UNIVERSITY OF WESTERN SYDNEY            ,FC,00000-0000,Public       ,0,1,1,3,,6,9
03097300,VICTORIA UNIVERSITY OF TECHNOLOGY       ,FC,00000-0000,Public       ,0,0,0,4,,11,15
03097500,CENTRAL QUEENSLAND UNIVERSITY           ,FC,00000-0000,Public       ,0,1,1,1,,10,11
03100000,UNIVERSITY OF ADELAIDE (THE)            ,FC,00000-0000,Public       ,0,4,4,4,,19,23
03101600,ASIAN INSTITUTE OF MANAGEMENT           ,FC,00000-0000,Private      ,0,4,4,3,,29,32
03102500,AMERICAN UNIVERSITY OF ROME             ,FC,00000-0000,Private      ,8,5,13,157,,75,232
03102800,ROBERT GORDON UNIVERSITY (THE)          ,FC,00000-0000,Public       ,0,6,6,3,,47,50
03104800,GRIFFITH UNIVERSITY                     ,FC,00000-0000,Public       ,2,6,8,12,,39,51
03136300,AUSTRALIAN CATHOLIC UNIVERSITY          ,FC,00000-0000,Public       ,0,4,4,4,,11,15
03140300,EDITH COWAN UNIVERSITY                  ,FC,00000-0000,Public       ,0,2,2,3,,5,8
03140400,NORTHERN TERRITORY UNIVERSITY           ,FC,00000-0000,Public       ,0,1,1,0,,2,2
03140500,QUEENSLAND UNIVERSITY OF TECHNOLOGY     ,FC,00000-0000,Public       ,1,3,4,6,,23,29
03140600,SOUTHERN CROSS UNIVERSITY               ,FC,00000-0000,Public       ,0,3,3,2,,21,23
03140700,SWINBURNE UNIVERSITY OF TECHNOLOGY      ,FC,00000-0000,Public       ,2,3,5,2,,12,14
03140900,UNIVERSITY OF BALLARAT                  ,FC,00000-0000,Public       ,0,0,0,0,,2,2
03150400,"UNIVERSITY OF TECHNOLOGY, SYDNEY        ",FC,00000-0000,Public       ,2,11,13,6,,41,47
03287300,LIVERPOOL INSTITUTE FOR PERFORMING ARTS ,FC,00000-0000,Public       ,0,0,0,13,,0,13
03300300,"2ND SCHOOL OF MEDICINE, CHARLES UNI     ",FC,00000-0000,Public       ,0,3,3,2,,17,19
03300400,"FIRST FACULTY OF MEDICINE, CHARLES UNIV.",FC,00000-0000,Public       ,0,1,1,3,,36,39
03329300,JOHN CABOT UNIVERSITY                   ,FC,00000-0000,Private      ,9,1,10,170,,35,205
03333300,MEDICAL UNIVERSITY SCHOOL OF LUBLIN     ,FC,00000-0000,Public       ,1,13,14,6,,173,179
03334300,UNIVERSIDAD NORDESTANA                  ,FC,00000-0000,Private      ,1,2,3,14,,72,86
03335300,MEDICAL UNIVERSITY OF SILESIA           ,FC,00000-0000,Public       ,0,7,7,4,,40,44
03342300,GLASGOW CALEDONIAN UNIVERSITY           ,FC,00000-0000,Public       ,0,1,1,6,,20,26
03349400,"QUEEN MARGARET UNIVERSITY, EDINBURGH    ",FC,00000-0000,Public       ,0,0,0,3,,32,35
03350300,BOURNEMOUTH UNIVERSITY                  ,FC,00000-0000,Public       ,0,2,2,7,,27,34
03352300,LONDON SOUTH BANK UNIVERSITY            ,FC,00000-0000,Private      ,1,7,8,14,,49,63
03363300,THE ARTS EDUCATIONAL SCHOOLS LONDON     ,FC,00000-0000,Private      ,0,0,0,0,,2,2
03364300,"FACULTY OF MEDICINE, PALACKY UNIVER     ",FC,00000-0000,Public       ,0,0,0,0,,4,4
03365400,AUCKLAND INSTITUTE OF TECHNOLOGY        ,FC,00000-0000,Public       ,0,3,3,8,,17,25
03366300,TROPICAL AGRICULTURE RESEARCH AND H     ,FC,00000-0000,Private      ,0,1,1,0,,4,4
03378300,"THE 3RD FACULTY OF MEDICINE, CHARLE     ",FC,00000-0000,Public       ,0,0,0,1,,8,9
03406300,"THE SCHOOL OF PHARMACY, UNIVERSITY      ",FC,00000-0000,Public       ,0,0,0,0,,3,3
03418400,NAPIER UNIVERSITY                       ,FC,00000-0000,Public       ,1,4,5,12,,54,66
03435300,ANGLIA  RUSKIN UNIVERSITY               ,FC,00000-0000,Private      ,1,6,7,15,,35,50
03460300,INTERNATIONALES THEOLOGISCHES INSTI     ,FC,00000-0000,Private      ,0,3,3,2,,21,23
03462400,UNIV OF ARTS LONDON - LON COLL OF COMMUN,FC,00000-0000,Public       ,0,0,0,14,,14,28
03466300,INSTITUTO CENTROAMERICANO DE ADMINI     ,FC,00000-0000,Private      ,0,0,0,1,,0,1
03473300,UNIV OF ARTS LONDON - LON COLL FASHION  ,FC,00000-0000,Public       ,2,9,11,127,,144,271
03473305,UNIVERSITY OF THE ARTS LONDON - CHELSEA ,FC,00000-0000,Public       ,0,0,0,12,,6,18
03473311,UNIVERSITY OF THE ARTS LONDON - WIMBLEDO,FC,00000-0000,Public       ,0,0,0,2,,5,7
03474301,AVE MARIA COLLEGE                       ,FC,00000-0000,Private      ,2,0,2,110,,38,148
03478300,ROYAL WELSH COLLEGE OF MUSIC AND DRAMA  ,FC,00000-0000,Public       ,0,1,1,15,,18,33
03492300,UNIVERSITY OF OXFORD - GREEN TEMPLETON C,FC,00000-0000,Public       ,0,1,1,0,,18,18
03492400,UNIV OF CAMBRIDGE-ST CATHERINE'S CG     ,FC,00000-0000,Public       ,0,1,1,0,,6,6
03494400,UNIV OF CAMBRIDGE-SELWYN COLLEGE        ,FC,00000-0000,Public       ,0,0,0,0,,7,7
03494600,UNIV OF OXFORD-HARRIS MANCHESTER        ,FC,00000-0000,Public       ,0,1,1,1,,4,5
03501400,LEEDS METROPOLITAN UNIVERSITY           ,FC,00000-0000,Public       ,1,3,4,17,,40,57
03507300,UNIVERSITY OF SUNDERLAND                ,FC,00000-0000,Public       ,0,1,1,5,,13,18
03515300,UNIVERSITY OF CENTRAL LANCASHIRE        ,FC,00000-0000,Public       ,0,0,0,3,,18,21
03517300,UNIVERSITY OF BRIGHTON                  ,FC,00000-0000,Public       ,1,1,2,11,,33,44
03518300,EUROPEAN GRADUATE SCHOOL                ,FC,00000-0000,Private      ,0,11,11,0,,99,99
03527300,SOFIA UNIVERSITY ST. KLIMENT OHRIDSKI   ,FC,00000-0000,Public       ,0,1,1,1,,10,11
03533300,BATH SPA UNIVERSITY                     ,FC,00000-0000,Public       ,2,2,4,14,,34,48
03547300,UNIVERSITY OF GLAMORGAN                 ,FC,00000-0000,Public       ,0,0,0,5,,13,18
03580300,LIVERPOOL JOHN MOORES UNIVERSITY        ,FC,00000-0000,Public       ,1,1,2,7,,8,15
03589400,ARTS INSTITUTE AT BOURNEMOUTH (THE)     ,FC,00000-0000,Public       ,0,2,2,10,,10,20
03590300,AVONDALE COLLEGE LIMITED                ,FC,00000-0000,Private      ,1,0,1,4,,4,8
03594300,GROUP ESC GRENOBLE GRAD SCH OF BUS.     ,FC,00000-0000,Private      ,0,0,0,0,,22,22
03597300,JAGIELLONIAN UNIVERSITY                 ,FC,00000-0000,Public       ,0,0,0,1,,27,28
03601300,UNIVERSITAT JAUME I DE CASTELLO/UJI     ,FC,00000-0000,Public       ,0,3,3,1,,16,17
03619300,UNIVERSITY OF GREENWICH                 ,FC,00000-0000,Public       ,1,1,2,32,,49,81
03653400,UNIVERSIDAD DE IBEROAMERICA - UNIBE     ,FC,00000-0000,Private      ,1,0,1,4,,33,37
03674300,UNIVERSITY OF ABERTAY DUNDEE            ,FC,00000-0000,Public       ,0,0,0,1,,6,7
03684400,UNIVERSITY OF LINCOLN                   ,FC,00000-0000,Public       ,0,2,2,16,,33,49
03684500,MEDICAL UNIVERSITY OF GDANSK            ,FC,00000-0000,Public       ,0,2,2,0,,15,15
03694300,UNIVERSITY OF CHICHESTER                ,FC,00000-0000,Public       ,0,0,0,5,,1,6
03716300,"UNIVERSITY OF WALES, NEWPORT            ",FC,00000-0000,Public       ,0,1,1,3,,11,14
03727400,UNIVERSITY OF WAIKATO (THE)             ,FC,00000-0000,Public       ,4,2,6,8,,14,22
03738300,LONDON SCHOOL OF THEOLOGY               ,FC,00000-0000,Private      ,0,1,1,1,,8,9
03741300,ALRA (ACADEMY OF LIVE AND RECORDED ARTS),FC,00000-0000,Private      ,1,4,5,10,,16,26
03770300,NAZARENE THEOLOGICAL COLLEGE            ,FC,00000-0000,Private      ,0,0,0,0,,4,4
03780300,SABA UNIVERSITY SCHOOL OF MEDICINE      ,FC,00000-0000,Proprietary  ,1,48,49,2,,154,156
03794400,ANGLO EUROPEAN COLLEGE OF CHIROPRACTIC  ,FC,00000-0000,Private      ,0,0,0,1,,3,4
03807300,ROSE BRUFORD COLLEGE                    ,FC,00000-0000,Public       ,0,0,0,5,,11,16
03816400,AMERICAN GRAD SCH OF INTERNTL REL & DIPL,FC,00000-0000,Private      ,0,7,7,8,,75,83
03818300,LEIPZIG GRADUATE SCHOOL OF MANAGEMENT   ,FC,00000-0000,Private      ,0,2,2,2,,22,24
03824300,"ROYAL VETERINARY COLLEGE (THE), UNIVERSI",FC,00000-0000,Public       ,0,1,1,4,,146,150
03829300,INTERNATIONAL CHRISTIAN COLLEGE         ,FC,00000-0000,Private      ,0,0,0,0,,1,1
03850500,MEDICAL UNIVERSITY OF LODZ              ,FC,00000-0000,Public       ,0,0,0,3,,17,20
03859400,UNIVERSITY COLLEGE FALMOUTH             ,FC,00000-0000,Public       ,0,0,0,12,,8,20
03873300,COPENHAGEN BUSINESS SCHOOL              ,FC,00000-0000,Public       ,0,1,1,2,,13,15
03880300,UNIVERSITY OF GLOUCESTERSHIRE (THE)     ,FC,00000-0000,Public       ,0,0,0,2,,9,11
03897400,INTERNATIONAL SPACE UNIVERSITY          ,FC,00000-0000,Private      ,0,1,1,0,,6,6
03974300,"ST. GEORGE'S UNIVERSITY, SCHOOL OF VETER",FC,00000-0000,Proprietary  ,0,26,26,8,,616,624
04021400,"AMERICAN COLLEGE, DUBLIN LIMITED (THE)  ",FC,00000-0000,Private      ,2,4,6,30,,35,65
04021500,CENTRAL EUROPEAN UNIVERSITY             ,FC,00000-0000,Private      ,0,2,2,3,,97,100
04032300,YORK ST JOHN UNIVERSITY                 ,FC,00000-0000,Public       ,0,0,0,6,,3,9
04046300,HK UNIVERSITY OF SCI & TECH (HKUST)     ,FC,00000-0000,Public       ,0,1,1,4,,18,22
04070300,"RAPHAEL RECANATI INTERNATIONAL SCHOOL, T",FC,00000-0000,Private      ,6,6,12,87,,66,153
04076300,NEWCASTLE COLLEGE                       ,FC,00000-0000,Public       ,0,0,0,1,,2,3
04085400,NEW ZEALAND COLLEGE OF CHIROPRACTIC     ,FC,00000-0000,Private      ,0,0,0,0,,4,4
04113300,LEBANESE AMERICAN UNIVERSITY            ,FC,00000-0000,Private      ,5,1,6,63,,26,89
04115900,LIVERPOOL HOPE UNIVERSITY               ,FC,00000-0000,Public       ,0,1,1,5,,10,15
04116300,EDHEC BUSINESS SCHOOL                   ,FC,00000-0000,Private      ,0,2,2,0,,21,21
04128600,UNIVERSITY OF WORCESTER                 ,FC,00000-0000,Public       ,0,0,0,4,,5,9
04128700,HERTIE SCHOOL OF GOVERNANCE             ,FC,00000-0000,Private      ,0,1,1,4,,33,37
04134200,LONDON CONTEMPORARY DANCE SCHOOL        ,FC,00000-0000,Private      ,0,0,0,3,,4,7
04139100,UNIVERSITA DEGLI STUDI DI SCIENZE GASTRO,FC,00000-0000,Private      ,0,6,6,1,,34,35
04143700,ST MARY'S UNIVERSITY COLLEGE TWICKENHAM ,FC,00000-0000,Public       ,0,2,2,14,,38,52
04168200,EUROPEAN UNIVERSITY AT ST. PETERSBURG   ,FC,00000-0000,Private      ,0,5,5,4,,38,42
04171800,"INTERNATIONAL UNIVERSITY OF NURSING, ST.",FC,00000-0000,Proprietary  ,0,0,0,2,,4,6
04176500,ESMT EUROPEAN SCHOOL OF MANAGEMENT AND T,FC,00000-0000,Private      ,0,2,2,4,,21,25
00380600,ALDERSON-BROADDUS COLLEGE               ,WV,26416-1051,Private      ,17,33,50,1978,,456,2434
00380700,MOUNTAIN STATE UNIVERSITY               ,WV,25801-5624,Private      ,6,36,42,48,,197,245
00380800,BETHANY COLLEGE                         ,WV,26032-0417,Private      ,24,11,35,1224,,141,1365
00380900,BLUEFIELD STATE COLLEGE                 ,WV,24701-2198,Public       ,38,163,201,1423,,1970,3393
00381000,CONCORD UNIVERSITY                      ,WV,24712-0000,Public       ,58,99,157,2973,,1618,4591
00381100,DAVIS & ELKINS COLLEGE                  ,WV,26241-3996,Private      ,26,32,58,1108,,367,1475
00381200,FAIRMONT STATE UNIVERSITY               ,WV,26554-2470,Public       ,100,277,377,5185,,3561,8746
00381300,GLENVILLE STATE COLLEGE                 ,WV,26351-1292,Public       ,34,58,92,1536,,656,2192
00381500,MARSHALL UNIVERSITY                     ,WV,25755-3300,Public       ,188,538,726,10636,,7773,18409
00381600,SOUTHERN WV COMMUNITY COLLEGE           ,WV,25637-2900,Public       ,61,194,255,1317,,1653,2970
00381800,UNIVERSITY OF CHARLESTON                ,WV,25304-1099,Private      ,48,204,252,1970,,2207,4177
00381900,OHIO VALLEY COLLEGE                     ,WV,26105-8000,Private      ,12,17,29,505,,198,703
00382000,SALEM INTERNATIONAL UNIVERSITY          ,WV,26426-0500,Proprietary  ,19,94,113,415,,893,1308
00382200,SHEPHERD UNIVERSITY                     ,WV,25443-5000,Public       ,106,135,241,4148,,1806,5954
00382300,WEST LIBERTY UNIVERSITY                 ,WV,26074-0295,Public       ,38,75,113,3128,,1124,4252
00382600,WEST VIRGINIA STATE UNIVERSITY          ,WV,25112-0000,Public       ,79,197,276,2530,,2267,4797
00382700,WEST VIRGINIA UNIVERSITY                ,WV,26506-6201,Public       ,464,542,1006,26855,,10261,37116
00382711,WEST VIRGINIA UNIVERSITY - POTOMAC STATE,WV,26726-3000,Public       ,42,74,116,1977,,731,2708
00382721,WEST VIRGINIA UNIV INST OF TECH         ,WV,25136-2436,Public       ,33,69,102,1471,,737,2208
00382800,WEST VIRGINIA UNIV AT PARKERSBURG       ,WV,26101-9577,Public       ,70,347,417,1892,,3091,4983
00383000,WEST VIRGINIA WESLEYAN COLLEGE          ,WV,26201-2600,Private      ,32,21,53,2091,,358,2449
00383100,WHEELING JESUIT UNIVERSITY              ,WV,26003-6243,Private      ,23,82,105,1351,,1072,2423
00500700,WEST VIRGINIA JUNIOR COLLEGE            ,WV,26505-5596,Proprietary  ,29,59,88,325,,481,806
00500800,MOUNTAIN STATE COLLEGE                  ,WV,26101-3993,Proprietary  ,5,55,60,64,,398,462
00754400,APPALACHIAN BIBLE COLLEGE               ,WV,25818-1353,Private      ,3,5,8,292,,73,365
00757800,HUNTINGTON SCHOOL OF BEAUTY CULTURE     ,WV,25705-2030,Proprietary  ,10,31,41,110,,217,327
00760000,INTERNATIONAL BEAUTY SCHOOL             ,WV,25401-3231,Proprietary  ,6,18,24,39,,117,156
00835500,JAMES RUMSEY TECHNICAL INSTITUTE        ,WV,25403-0259,Public       ,5,75,80,123,,416,539
00895900,CLARKSBURG BEAUTY ACADEMY               ,WV,26301-2903,Proprietary  ,6,22,28,74,,129,203
00904700,HUNTINGTON JUNIOR COLLEGE               ,WV,25701-2004,Proprietary  ,20,112,132,212,,1262,1474
00905400,WEST VIRGINIA NORTHERN CMTY COLLEGE     ,WV,26003-0000,Public       ,47,239,286,1092,,2131,3223
01014000,MINERAL COUNTY VOCATIONAL TECH CTR      ,WV,26726-0000,Public       ,1,9,10,15,,78,93
01035600,EVEREST INSTITUTE                       ,WV,25313-1304,Proprietary  ,11,61,72,85,,444,529
01057300,WEST VIRGINIA JUNIOR COLLEGE            ,WV,25322-0000,Proprietary  ,31,81,112,208,,469,677
01057302,WEST VIRGINIA JUNIOR COLLEGE            ,WV,26330-0000,Proprietary  ,39,36,75,200,,298,498
01086100,WEST VIRGINIA BUSINESS COLLEGE          ,WV,26301-0000,Proprietary  ,1,19,20,40,,210,250
01124500,WEST VIRGINIA SCH OSTEOPATHIC MED       ,WV,24901-1128,Public       ,0,12,12,34,,870,904
01174900,WOOD COUNTY SCH OF PRAC NURSING         ,WV,26101-6424,Public       ,3,18,21,46,,144,190
01235900,B M SPURR SCHOOL OF PRAC NURSING        ,WV,26038-1660,Private      ,0,7,7,15,,45,60
01257300,WEST VIRGINIA UNIV-HOSP-RAD TECH        ,WV,26506-8062,Private      ,9,11,20,205,,149,354
01274300,BENJAMIN FRANKLIN CAREER&TECH           ,WV,25064-0000,Public       ,4,38,42,97,,262,359
01290400,MONONGALIA CNTY TECH ED CTR             ,WV,26501-6841,Public       ,0,12,12,94,,193,287
01290500,ACADEMY OF CAREERS AND TECHNOLOGY       ,WV,25801-0000,Public       ,7,65,72,122,,416,538
02057400,ROANE-JACKSON TECHNICAL CENTER          ,WV,25252-0000,Public       ,2,7,9,24,,90,114
02068000,UNITED TECHNICAL CENTER                 ,WV,26301-0000,Public       ,3,21,24,41,,163,204
02073400,CARVER CAREER TECH ED CTR               ,WV,25306-6397,Public       ,12,85,97,220,,496,716
02145100,SCOTT COLLEGE OF COSMETOLOGY            ,WV,26003-0000,Proprietary  ,8,15,23,81,,91,172
02178200,CHARLESTON SCHOOL OF BEAUTY CULTURE     ,WV,25301-0000,Proprietary  ,12,43,55,106,,230,336
02218200,GARNET CAREER CENTER                    ,WV,25301-0000,Public       ,6,72,78,112,,459,571
02275300,CABELL COUNTY CAREER TECHNOLOGY CTR     ,WV,25705-0000,Public       ,8,36,44,149,,348,497
02524500,RALPH R WILLIS VOCATIONAL CENTER        ,WV,25601-0000,Public       ,1,10,11,33,,96,129
02534800,FRED W EBERLE TECHNICAL CENTER          ,WV,26201-0000,Public       ,10,36,46,80,,183,263
02535500,MERCER COUNTY TECH EDUC CNTR            ,WV,24740-0000,Public       ,6,36,42,113,,328,441
02579900,NORTH CENTRAL OPPORTUNITIES INDUSTRIALIZ,WV,26554-2936,Private      ,4,19,23,47,,143,190
02609400,VALLEY COLLEGE                          ,WV,25404-5711,Proprietary  ,2,46,48,42,,243,285
03052000,MEREDITH MANOR EQUESTRIAN CENTRE        ,WV,26184-9707,Proprietary  ,27,19,46,265,,130,395
03076500,FAYETTE INSTITUTE OF TECHNOLOGY         ,WV,25901-2174,Public       ,3,17,20,30,,97,127
03084200,VALLEY COLLEGE                          ,WV,24740-3141,Proprietary  ,1,25,26,38,,180,218
03084400,VALLEY COLLEGE                          ,WV,25801-2643,Proprietary  ,5,90,95,68,,445,513
03098300,PUTNAM CAREER & TECHNICAL CENTER        ,WV,25070-0000,Public       ,4,16,20,98,,154,252
03099200,"MOUNTAINEER BEAUTY COLLEGE, INC         ",WV,25177-2917,Proprietary  ,0,0,0,4,,3,7
03102100,MORGANTOWN BEAUTY COLLEGE               ,WV,26505-5430,Proprietary  ,5,20,25,98,,147,245
03123200,STANLEY TECHNICAL INSTITUTE             ,WV,26505-3751,Private      ,0,3,3,15,,48,63
03327500,SOUTH BRANCH VOCATIONAL TECH CENTER     ,WV,26847-1698,Public       ,2,2,4,14,,23,37
03734300,JOHN D. ROCKEFELLER IV CAREER CENTER    ,WV,26047-9424,Public       ,0,4,4,12,,31,43
03819300,AMERICAN PUBLIC UNIVERSITY SYSTEM       ,WV,25414-1621,Proprietary  ,415,11312,11727,2547,,65767,68314
03957300,BLUE RIDGE COMMUNITY AND TECHNICAL COLLE,WV,25401-3244,Public       ,81,287,368,1047,,2566,3613
03960300,NEW RIVER COMMUNITY AND TECHNICAL COLLEG,WV,25801-2636,Public       ,66,353,419,1234,,2867,4101
04028300,MOUNTAIN STATE SCHOOL OF MASSAGE        ,WV,25304-2025,Proprietary  ,2,13,15,19,,77,96
04038500,PIERPONT COMMUNITY & TECHNICAL COLLEGE  ,WV,26554-2451,Public       ,62,188,250,1828,,2135,3963
04038600,KANAWHA VALLEY COMMUNITY & TECH COLLEGE ,WV,25112-1000,Public       ,43,201,244,770,,2004,2774
04041400,MOUNTWEST COMMUNITY AND TECHNICAL COLLEG,WV,25755-3300,Public       ,63,219,282,1131,,2302,3433
04047300,BRIDGEMONT COMMUNITY & TECHNICAL COLLEGE,WV,25136-2435,Public       ,17,45,62,510,,451,961
04119000,EASTERN WEST VIRGINIA COMMUNITY & TECHNI,WV,26836-0000,Public       ,15,79,94,238,,709,947
04139900,FUTURE GENERATIONS GRADUATE SCHOOL      ,WV,26807-0000,Private      ,0,1,1,0,,2,2
00106100,ALASKA PACIFIC UNIVERSITY               ,AK,99508-4672,Private      ,31,124,155,555,,1056,1611
00106300,UNIVERSITY OF ALASKA FAIRBANKS          ,AK,99775-7500,Public       ,131,444,575,3637,,4499,8136
00106500,UNIVERSITY OF ALASKA SOUTHEAST          ,AK,99801-8680,Public       ,53,149,202,917,,1550,2467
00884300,ALASKA BIBLE COLLEGE                    ,AK,99588-0000,Private      ,4,1,5,40,,40,80
01146200,UNIVERSITY OF ALASKA ANCHORAGE          ,AK,99514-1608,Public       ,421,1000,1421,7180,,9719,16899
02541000,ALASKA CAREER COLLEGE                   ,AK,99507-1033,Proprietary  ,43,176,219,293,,1048,1341
02576900,CHARTER COLLEGE                         ,AK,99508-0000,Proprietary  ,163,610,773,988,,3468,4456
03160300,AVTEC                                   ,AK,99664-0889,Public       ,19,66,85,279,,478,757
03461300,ILISAGVIK COLLEGE                       ,AK,99723-0749,Public       ,4,14,18,39,,89,128
04138600,ALASKA CHRISTIAN COLLEGE                ,AK,99669-9755,Private      ,5,5,10,41,,65,106
00108500,UNIV ARKANSAS MONTICELLO                ,AR,71656-0000,Public       ,118,253,371,2610,,2474,5084
00108600,UNIV OF ARKANSAS AT PINE BLUFF          ,AR,71601-2790,Public       ,95,177,272,3702,,2040,5742
00108700,ARKANSAS BAPTIST COLLEGE                ,AR,72202-6099,Private      ,39,131,170,1283,,1674,2957
00108800,LYON COLLEGE                            ,AR,72501-3699,Private      ,66,13,79,957,,165,1122
00108900,ARKANSAS TECH UNIVERSITY                ,AR,72801-2222,Public       ,271,551,822,7227,,6052,13279
00109000,ARKANSAS STATE UNIVERSITY               ,AR,72467-0000,Public       ,411,918,1329,10339,,12014,22353
00109002,ARKANSAS STATE UNIVERSITY - NEWPORT     ,AR,72112-1120,Public       ,0,0,0,818,,1408,2226
00109006,DELTA TECHNICAL INSTITUTE               ,AR,72365-9558,Public       ,0,0,0,63,,130,193
00109100,ARKANSAS STATE UNIVERSITY - BEEBE       ,AR,72012-1000,Public       ,129,353,482,2457,,3265,5722
00109200,UNIVERSITY OF CENTRAL ARKANSAS          ,AR,72035-0001,Public       ,419,480,899,10792,,5600,16392
00109300,CENTRAL BAPTIST COLLEGE                 ,AR,72034-6470,Private      ,32,78,110,698,,702,1400
00109400,UNIVERSITY OF THE OZARKS                ,AR,72830-2880,Private      ,25,18,43,765,,183,948
00109500,CROWLEYS RIDGE COLLEGE                  ,AR,72450-9775,Private      ,18,16,34,237,,192,429
00109700,HARDING UNIVERSITY                      ,AR,72149-0001,Private      ,145,130,275,4272,,1962,6234
00109800,HENDERSON STATE UNIVERSITY              ,AR,71999-0001,Public       ,170,150,320,4058,,2051,6109
00109900,HENDRIX COLLEGE                         ,AR,72032-3080,Private      ,67,42,109,2379,,353,2732
00110000,JOHN BROWN UNIVERSITY                   ,AR,72761-2747,Private      ,58,129,187,1680,,1419,3099
00110100,UNIV ARKANSAS LITTLE ROCK               ,AR,72204-1099,Public       ,274,866,1140,5992,,11144,17136
00110200,OUACHITA BAPTIST UNIVERSITY             ,AR,71998-0001,Private      ,80,18,98,1997,,245,2242
00110300,PHILANDER SMITH COLLEGE                 ,AR,72202-3718,Private      ,27,78,105,1138,,942,2080
00110400,PHILLIPS COUNTY COMMUNITY COLLEGE       ,AR,72342-0000,Public       ,25,88,113,555,,912,1467
00110500,SHORTER COLLEGE                         ,AR,72114-4885,Private      ,14,90,104,96,,662,758
00110600,WILLIAMS BAPTIST COLLEGE                ,AR,72476-4661,Private      ,24,11,35,653,,176,829
00110700,SOUTHERN ARKANSAS UNIVERSITY            ,AR,71754-0000,Public       ,117,153,270,3148,,2002,5150
00110800,UNIV ARKANSAS FAYETTEVILLE              ,AR,72701-0000,Public       ,742,578,1320,19024,,7801,26825
00110900,UNIVERSITY OF ARKANSAS FOR MEDICAL SCIEN,AR,72205-7102,Public       ,31,178,209,774,,3334,4108
00111000,UNIVERSITY OF ARKANSAS-FORT SMITH       ,AR,72904-7397,Public       ,218,393,611,4764,,4587,9351
00524500,U OF A COMM COLLEGE AT MORRILTON        ,AR,72110-9601,Public       ,95,246,341,1463,,2250,3713
00570700,SEARK COLLEGE                           ,AR,71603-0000,Public       ,61,244,305,781,,2129,2910
00573200,UNIV AR COMMUNITY COLLEGE AT HOPE       ,AR,71801-0000,Public       ,37,156,193,671,,1307,1978
00704400,CROWLEYS RIDGE TECHNICAL INSTITUTE      ,AR,72336-0000,Public       ,11,44,55,188,,407,595
00732967,ITT TECHNICAL INSTITUTE                 ,AR,72204-7739,Proprietary  ,39,184,223,309,,967,1276
00773800,SOUTHERN ARKANSAS UNIVERSITY TECH       ,AR,71701-1900,Public       ,37,105,142,658,,960,1618
00792100,PAUL MITCHELL THE SCHOOL ARKANSAS       ,AR,72701-0000,Proprietary  ,10,23,33,102,,153,255
00997600,OUACHITA TECHNICAL COLLEGE              ,AR,72104-0816,Public       ,32,123,155,432,,1254,1686
01074100,MELLIE'S BEAUTY COLLEGE                 ,AR,72901-3886,Proprietary  ,10,32,42,76,,236,312
01210500,NATIONAL PARK COMMUNITY COLLEGE         ,AR,71913-9174,Public       ,78,321,399,1175,,2816,3991
01226000,EAST ARKANSAS COMMUNITY COLLEGE         ,AR,72335-2204,Public       ,25,74,99,599,,902,1501
01226100,NORTH ARKANSAS COLLEGE                  ,AR,72601-5508,Public       ,72,233,305,1167,,1993,3160
01286000,ARKANSAS NORTHEASTERN COLLEGE           ,AR,72316-1109,Public       ,40,142,182,782,,1374,2156
02052200,BLACK RIVER TECHNICAL COLLEGE           ,AR,72455-0000,Public       ,75,251,326,925,,2272,3197
02073500,UNIVERSITY OF ARKANSAS COMMUNITY COLLEGE,AR,72503-0000,Public       ,38,150,188,694,,1179,1873
02073700,NORTHWEST TECHNICAL INSTITUTE           ,AR,72765-0000,Public       ,27,100,127,265,,610,875
02074600,SOUTH ARKANSAS COMMUNITY COLLEGE        ,AR,71731-0000,Public       ,50,233,283,780,,1936,2716
02075300,PULASKI TECHNICAL COLLEGE               ,AR,72118-0000,Public       ,329,1446,1775,4451,,14448,18899
02087000,OZARKA COLLEGE                          ,AR,72556-0000,Public       ,38,148,186,484,,1342,1826
02111100,RICH MOUNTAIN COMMUNITY COLLEGE         ,AR,71953-0000,Public       ,27,91,118,379,,593,972
02202400,PROFESSIONAL COSMETOLOGY EDUC CTR       ,AR,71730-5828,Proprietary  ,1,4,5,29,,76,105
02220900,COSSATOT COMMUNITY COLLEGE              ,AR,71832-0000,Public       ,33,116,149,586,,1059,1645
02272400,EASTERN COLLEGE OF HEALTH VOCATIONS     ,AR,72205-3535,Proprietary  ,33,136,169,223,,755,978
02284200,NEW TYLER BARBER COLLEGE INC            ,AR,72114-0000,Proprietary  ,4,34,38,59,,226,285
02287400,MARSHA KAY BEAUTY COLLEGE               ,AR,72653-0000,Proprietary  ,1,7,8,24,,50,74
02330800,JEFFERSON SCHOOL OF NURSING             ,AR,71603-0000,Private      ,14,24,38,105,,262,367
02339800,SOUTHERN INSTITUTE OF COSMETOLOGY       ,AR,72301-0000,Proprietary  ,6,14,20,24,,75,99
02341700,CAREER ACADEMY OF HAIR DESIGN           ,AR,72764-4304,Proprietary  ,7,30,37,49,,176,225
02341701,CAREER ACADEMY OF HAIR DESIGN - ROGERS  ,AR,72756-2102,Proprietary  ,11,22,33,41,,144,185
02341702,CAREER ACADEMY OF HAIR DESIGN - SILOAM  ,AR,72761-4217,Proprietary  ,8,7,15,29,,54,83
02348200,MID-SOUTH COMMUNITY COLLEGE             ,AR,72301-0000,Public       ,29,137,166,843,,1818,2661
02363500,ARTHUR'S BEAUTY COLLEGE                 ,AR,72901-0000,Proprietary  ,7,28,35,69,,204,273
02525800,LEE'S SCHOOL OF COSMETOLOGY             ,AR,72114-0000,Proprietary  ,3,20,23,46,,137,183
02538500,ARTHUR'S BEAUTY COLLEGE                 ,AR,72076-0000,Proprietary  ,3,32,35,80,,245,325
02569600,SEARCY BEAUTY COLLEGE                   ,AR,72143-0000,Proprietary  ,0,18,18,36,,132,168
03005100,ARKANSAS BEAUTY SCHOOL                  ,AR,72209-5116,Proprietary  ,10,37,47,95,,250,345
03007100,HOT SPRINGS BEAUTY COLLEGE              ,AR,71901-5432,Proprietary  ,2,29,31,38,,149,187
03007600,ARKANSAS BEAUTY SCHOOL-CONWAY           ,AR,72032-4354,Proprietary  ,8,28,36,70,,175,245
03023400,ARKANSAS COLLEGE OF BARBERING           ,AR,72114-5615,Proprietary  ,6,40,46,74,,262,336
03063300,NORTHWEST ARKANSAS COMMUNITY COLLEG     ,AR,72712-5190,Public       ,252,640,892,3869,,5924,9793
03065100,ABC BEAUTY COLLEGE                      ,AR,71923-4206,Proprietary  ,4,16,20,26,,100,126
03066302,BRYAN COLLEGE -                         ,AR,72756-1825,Proprietary  ,14,44,58,85,,313,398
03105200,BAPTIST HEALTH SCHOOLS LITTLE ROCK      ,AR,72210-2820,Private      ,34,182,216,613,,2004,2617
03115102,HERITAGE COLLEGE - LITTLE ROCK          ,AR,72227-5544,Proprietary  ,35,126,161,214,,860,1074
03124900,IMAGINE -  PAUL MITCHELL PARTNER SCHOOL ,AR,72117-2516,Proprietary  ,28,61,89,255,,456,711
03214300,VELVATEX COLLEGE OF BEAUTY CULTURE      ,AR,72202-5452,Proprietary  ,3,11,14,27,,76,103
03254300,MARGARET'S HAIR ACADEMY                 ,AR,71655-4905,Proprietary  ,2,12,14,42,,89,131
03519400,LYNNDALE FUNDAMENTALS OF BEAUTY SCH     ,AR,71730-4804,Proprietary  ,1,5,6,8,,32,40
03855300,ECCLESIA COLLEGE                        ,AR,72762-8159,Private      ,6,10,16,165,,134,299
03912300,CROSSETT SCHOOL OF COSMETOLOGY          ,AR,71635-0000,Proprietary  ,2,9,11,19,,45,64
03997300,ARKANSAS BEAUTY COLLEGE                 ,AR,72801-3741,Proprietary  ,1,12,13,31,,107,138
04183100,WASHINGTON BARBER COLLEGE               ,AR,72209-3820,Proprietary  ,7,33,40,56,,192,248
04183400,SALON PROFESSIONAL ACADEMY (THE)        ,AR,72116-7310,Proprietary  ,11,15,26,74,,157,231
04203400,ARKANSAS STATE UNIVERSITY - NEWPORT     ,AR,72112-9073,Public       ,55,228,283,90,,321,411
04220000,DESIGNER BARBER & STYLIST SCHOOL        ,AR,72903-3753,Proprietary  ,4,14,18,12,,65,77
00133900,CORBAN UNIVERSITY                       ,OR,97301-9392,Private      ,69,77,146,2040,,825,2865
00318600,BLUE MOUNTAIN COMMUNITY COLLEGE         ,OR,97801-0000,Public       ,61,229,290,1254,,2168,3422
00318800,CENTRAL OREGON COMMUNITY COLLEGE        ,OR,97701-5998,Public       ,236,595,831,3365,,6606,9971
00318900,CLATSOP COMMUNITY COLLEGE               ,OR,97103-3698,Public       ,44,138,182,653,,1467,2120
00319100,CONCORDIA UNIVERSITY                    ,OR,97211-6099,Private      ,71,1197,1268,2335,,8440,10775
00319300,EASTERN OREGON UNIVERSITY               ,OR,97850-2899,Public       ,116,213,329,3222,,3611,6833
00319400,GEORGE FOX UNIVERSITY                   ,OR,97132-2697,Private      ,127,170,297,3794,,2436,6230
00319600,LANE COMMUNITY COLLEGE                  ,OR,97405-0640,Public       ,388,978,1366,7378,,13370,20748
00319700,LEWIS & CLARK COLLEGE                   ,OR,97219-7899,Private      ,187,148,335,6095,,3599,9694
00319800,LINFIELD COLLEGE                        ,OR,97128-6894,Private      ,105,63,168,3892,,1336,5228
00319801,LINFIELD COLLEGE - PORTLAND CAMPUS      ,OR,97210-0000,Private      ,36,66,102,849,,1396,2245
00319900,MARYLHURST UNIVERSITY                   ,OR,97036-7036,Private      ,8,149,157,166,,1812,1978
00320300,MOUNT ANGEL SEMINARY                    ,OR,97373-0505,Private      ,2,1,3,9,,20,29
00320400,MOUNT HOOD COMMUNITY COLLEGE            ,OR,97030-3300,Public       ,340,882,1222,5625,,10297,15922
00320600,MULTNOMAH BIBLE COLLEGE/SEMINARY        ,OR,97220-5898,Private      ,13,64,77,500,,956,1456
00320700,PACIFIC NORTHWEST COLLEGE OF ART        ,OR,97209-3023,Private      ,45,65,110,818,,931,1749
00320800,NORTHWEST CHRISTIAN UNIVERSITY          ,OR,97401-3727,Private      ,23,67,90,781,,999,1780
00320900,WESTERN OREGON UNIVERSITY               ,OR,97361-1394,Public       ,217,172,389,7972,,3547,11519
00321000,OREGON STATE UNIVERSITY                 ,OR,97331-8507,Public       ,1040,939,1979,28137,,15781,43918
00321100,OREGON INSTITUTE OF TECHNOLOGY          ,OR,97601-8801,Public       ,93,193,286,3291,,2989,6280
00321200,PACIFIC UNIVERSITY                      ,OR,97116-1797,Private      ,125,122,247,4270,,3419,7689
00321300,PORTLAND COMMUNITY COLLEGE              ,OR,97219-7198,Public       ,1018,3332,4350,16272,,38625,54897
00321311,PORTLAND COMMUNITY COLLEGE - TILLAMOOK B,OR,97141-2599,Public       ,12,32,44,251,,461,712
00321600,PORTLAND STATE UNIVERSITY               ,OR,97207-0000,Public       ,812,1617,2429,17952,,27028,44980
00321700,REED COLLEGE                            ,OR,97202-8199,Private      ,133,75,208,2887,,905,3792
00321800,CHEMEKETA COMMUNITY COLLEGE             ,OR,97309-1500,Public       ,423,1052,1475,7244,,14034,21278
00321900,SOUTHERN OREGON UNIVERSITY              ,OR,97520-5010,Public       ,206,245,451,6079,,4201,10280
00322000,SOUTHWESTERN OREGON COMMUNITY CLG       ,OR,97420-2956,Public       ,77,149,226,1792,,1938,3730
00322100,TREASURE VALLEY COMMUNITY COLLEGE       ,OR,97914-3423,Public       ,104,263,367,1695,,2754,4449
00322200,UMPQUA COMMUNITY COLLEGE                ,OR,97470-0226,Public       ,65,238,303,1354,,2742,4096
00322300,UNIVERSITY OF OREGON                    ,OR,97403-1226,Public       ,1077,651,1728,29237,,11858,41095
00322400,UNIVERSITY OF PORTLAND                  ,OR,97203-5798,Private      ,394,264,658,11394,,3670,15064
00322500,WARNER PACIFIC COLLEGE                  ,OR,97215-4099,Private      ,57,174,231,1183,,2184,3367
00322700,WILLAMETTE UNIVERSITY                   ,OR,97301-3930,Private      ,175,97,272,5868,,1751,7619
00487800,CLACKAMAS COMMUNITY COLLEGE             ,OR,97045-7998,Public       ,276,651,927,4431,,6904,11335
00488200,OREGON HEALTH & SCIENCE UNIVERSITY      ,OR,97239-0000,Public       ,70,197,267,1287,,4867,6154
00693800,LINN BENTON COMMUNITY COLLEGE           ,OR,97321-3774,Public       ,210,441,651,4304,,6018,10322
00717800,WESTERN SEMINARY                        ,OR,97215-0000,Private      ,4,65,69,23,,637,660
00723402,HEALD COLLEGE - PORTLAND                ,OR,97205-3432,Proprietary  ,50,203,253,390,,1522,1912
00732969,ITT TECHNICAL INSTITUTE                 ,OR,97220-6819,Proprietary  ,46,280,326,606,,2349,2955
00737101,MARINELLO SCHOOL OF BEAUTY - PORTLAND   ,OR,97212-3732,Proprietary  ,13,53,66,131,,337,468
00781900,ART INSTITUTE OF PORTLAND (THE)         ,OR,97209-2911,Proprietary  ,164,222,386,1991,,2294,4285
00888700,CONCORDE CAREER INSTITUTE               ,OR,97232-2242,Proprietary  ,66,186,252,470,,1378,1848
00907900,EVEREST COLLEGE                         ,OR,97204-2296,Proprietary  ,26,135,161,308,,1080,1388
00958100,SPRINGFIELD COLLEGE OF BEAUTY           ,OR,97477-5474,Proprietary  ,5,22,27,92,,190,282
01012200,PHAGANS' MEDFORD BEAUTY SCHOOL          ,OR,97504-5297,Proprietary  ,10,36,46,83,,259,342
01018200,ROGUE COMMUNITY COLLEGE                 ,OR,97527-0000,Public       ,238,701,939,3129,,7416,10545
01050700,ACADEMY OF HAIR DESIGN                  ,OR,97301-3526,Proprietary  ,9,34,43,101,,260,361
01230900,UNIVERSITY OF WESTERN STATES            ,OR,97230-3099,Private      ,6,51,57,103,,804,907
01234700,PHAGANS CENTRAL OREGON BEAUTY CLG       ,OR,97701-5175,Proprietary  ,19,49,68,126,,301,427
01234800,PHAGANS BEAUTY COLLEGE                  ,OR,97333-4716,Proprietary  ,8,13,21,82,,142,224
01235000,PHAGANS SCHOOL OF HAIR DESIGN           ,OR,97267-0000,Proprietary  ,9,24,33,92,,195,287
01235100,PHAGANS SCHOOL OF BEAUTY                ,OR,97301-4732,Proprietary  ,14,37,51,92,,312,404
01300800,PHAGANS TIGARD BEAUTY SCHOOL            ,OR,97223-0000,Proprietary  ,6,7,13,38,,95,133
02101000,NORTHWEST COLLEGE OF HAIR DESIGN        ,OR,97086-7702,Proprietary  ,37,59,96,298,,696,994
02101002,NORTHWEST COLLEGE                       ,OR,97007-3954,Proprietary  ,2,13,15,55,,119,174
02104900,COLLEGE OF LEGAL ARTS                   ,OR,97219-9998,Proprietary  ,12,62,74,100,,556,656
02106100,COLLEGE OF COSMETOLOGY                  ,OR,97601-0000,Proprietary  ,4,12,16,63,,145,208
02154400,BEAU MONDE CLG OF HAIR DESIGN           ,OR,97205-0000,Proprietary  ,18,51,69,184,,395,579
02159700,NEW HOPE CHRISTIAN COLLEGE              ,OR,97405-1194,Private      ,18,35,53,333,,333,666
02201900,PHAGANS' SCHOOL OF HAIR DESIGN          ,OR,97232-0000,Proprietary  ,17,56,73,174,,484,658
02239203,ANTHEM COLLEGE - BEAVERTON              ,OR,97005-0000,Proprietary  ,29,97,126,166,,423,589
02311000,PAUL MITCHELL THE SCHOOL                ,OR,97205-3724,Proprietary  ,25,60,85,56,,101,157
02330100,PIONEER PACIFIC COLLEGE                 ,OR,97070-0000,Proprietary  ,28,125,153,322,,1139,1461
02330102,PIONEER PACIFIC COLLEGE                 ,OR,97403-0000,Proprietary  ,25,128,153,294,,1152,1446
02337900,COLLEGE OF HAIR DESIGN CAREERS          ,OR,97301-0000,Proprietary  ,9,25,34,103,,241,344
02344100,ROSEBURG BEAUTY COLLEGE                 ,OR,97470-0000,Proprietary  ,2,18,20,55,,157,212
02534000,NATIONAL COLLEGE OF NATURAL MEDICINE    ,OR,97201-0000,Private      ,11,69,80,100,,1089,1189
02578800,NORTHWEST NANNIES INSTITUTE             ,OR,97035-0000,Proprietary  ,4,2,6,31,,24,55
02603700,OREGON COL OF ORIENTAL MEDICINE         ,OR,97216-0000,Private      ,3,30,33,45,,542,587
02617506,EVEREST COLLEGE - EVEREST INSTITUTE     ,OR,97223-6581,Proprietary  ,12,84,96,139,,508,647
03007300,OREGON COLLEGE OF ART & CRAFT           ,OR,97225-6399,Private      ,23,47,70,329,,577,906
03022600,LE CORDON BLEU COLLEGE OF CULINARY ARTS ,OR,97205-2793,Proprietary  ,82,240,322,978,,1886,2864
03042500,CARRINGTON COLLEGE                      ,OR,97232-1302,Proprietary  ,29,117,146,368,,1243,1611
03074400,PHAGANS NEWPORT ACAD CSMTLGY CAREER     ,OR,97365-4963,Proprietary  ,1,10,11,29,,83,112
03074500,EAST-WEST COLLEGE OF THE HEALING ARTS   ,OR,97232-2765,Proprietary  ,20,81,101,140,,584,724
03185300,PHAGANS GRANTS PASS COLLEGE OF BTY      ,OR,97527-3039,Proprietary  ,4,21,25,49,,151,200
03428300,KLAMATH COMMUNITY COLLEGE               ,OR,97603-7121,Public       ,65,196,261,712,,1678,2390
03642300,VALLEY MEDICAL COLLEGE                  ,OR,97305-1373,Proprietary  ,23,86,109,197,,674,871
03668300,BIRTHINGWAY COLLEGE OF MIDWIFERY        ,OR,97266-4042,Private      ,3,31,34,46,,336,382
03783400,ABDILL CAREER COLLEGE                   ,OR,97504-7137,Proprietary  ,8,62,70,113,,460,573
04146500,PORTLAND ACTORS CONSERVATORY            ,OR,97201-2557,Private      ,3,16,19,78,,166,244
04151900,COLUMBIA GORGE COMMUNITY COLLEGE        ,OR,97058-3434,Public       ,29,112,141,516,,1051,1567
04167400,SAGE SCHOOL OF MASSAGE & HEALING ARTS   ,OR,97701-4082,Proprietary  ,5,24,29,44,,166,210
04171400,AVEDA INSTITUTE PORTLAND                ,OR,97209-3144,Proprietary  ,36,91,127,398,,641,1039
04194400,AMERICAN COLLEGE OF HEALTHCARE SCIENCES ,OR,97239-3719,Proprietary  ,24,201,225,217,,1029,1246
04194900,TILLAMOOK BAY COMMUNITY COLLEGE         ,OR,97141-2807,Public       ,7,36,43,51,,157,208
00137400,ALBERTUS MAGNUS COLLEGE                 ,CT,06511-1189,Private      ,35,174,209,1120,,1457,2577
00137403,ALBERTUS MAGNUS CLG-NEW DIMENSIONS      ,CT,06511-0000,Private      ,2,36,38,86,,816,902
00137800,CENTRAL CONNECTICUT STATE UNIV          ,CT,06050-2490,Public       ,309,400,709,10687,,5532,16219
00137900,CONNECTICUT COLLEGE                     ,CT,06320-4196,Private      ,83,23,106,3191,,240,3431
00138000,WESTERN CONNECTICUT STATE UNIV          ,CT,06810-6826,Public       ,177,168,345,6514,,2089,8603
00138500,FAIRFIELD UNIVERSITY                    ,CT,06430-0000,Private      ,191,90,281,7785,,1267,9052
00138700,HARTFORD SEMINARY                       ,CT,06105-0000,Private      ,1,10,11,22,,112,134
00138900,HOLY APOSTLES COLLEGE & SEMINARY        ,CT,06416-2027,Private      ,2,6,8,12,,80,92
00139200,MANCHESTER COMMUNITY COLLEGE            ,CT,06045-1046,Public       ,262,457,719,4353,,4650,9003
00139300,MITCHELL COLLEGE                        ,CT,06320-4498,Private      ,33,28,61,1053,,340,1393
00139700,UNIVERSITY OF NEW HAVEN                 ,CT,06516-1999,Private      ,192,174,366,10305,,2480,12785
00139800,NORTHWESTERN CT COMMUNITY COLLEGE       ,CT,06098-1747,Public       ,44,78,122,627,,834,1461
00139900,NORWALK COMMUNITY TECHNICAL COLLEGE     ,CT,06854-1655,Public       ,194,363,557,2783,,3394,6177
00140100,POST UNIVERSITY                         ,CT,06723-3240,Proprietary  ,170,1942,2112,2177,,11552,13729
00140200,QUINNIPIAC UNIVERSITY                   ,CT,06518-1908,Private      ,375,180,555,16801,,2866,19667
00140201,QUINNIPIAC UNIVERSITY SCHOOL OF LAW     ,CT,06518-0000,Private      ,2,15,17,75,,748,823
00140300,SACRED HEART UNIVERSITY                 ,CT,06825-1000,Private      ,194,283,477,8180,,3056,11236
00140600,SOUTHERN CONNECTICUT STATE UNIV         ,CT,06515-1355,Public       ,254,386,640,10162,,5949,16111
00140900,SAINT JOSEPH COLLEGE                    ,CT,06117-2791,Private      ,29,172,201,1295,,2048,3343
00141400,TRINITY COLLEGE                         ,CT,06106-3100,Private      ,104,45,149,3754,,424,4178
00141600,UNIVERSITY OF BRIDGEPORT                ,CT,06601-5650,Private      ,110,309,419,3749,,3824,7573
00141700,UNIVERSITY OF CONNECTICUT-STORRS        ,CT,06269-2151,Public       ,682,328,1010,31959,,6508,38467
00141702,UNIV CONN STAMFORD                      ,CT,06901-0000,Public       ,44,62,106,1110,,758,1868
00141703,UNIV OF CONNECTICUT - TORINGTON         ,CT,06790-0000,Public       ,11,18,29,302,,163,465
00141706,UNIV OF CONNECTICUT SCH LAW             ,CT,06105-0000,Public       ,7,24,31,76,,1095,1171
00141707,UNIV OF CT - SCH OF SOCIAL WORK         ,CT,06117-0000,Public       ,10,39,49,195,,809,1004
00141708,UNIVERSITY OF CONNECTICUT - SCHOOL OF ME,CT,06030-1920,Public       ,18,14,32,180,,666,846
00141709,UNIVERSITY OF CONNECTICUT - SCHOOL OF DE,CT,06030-1920,Public       ,24,16,40,325,,403,728
00142200,UNIVERSITY OF HARTFORD                  ,CT,06117-1599,Private      ,193,159,352,10952,,2614,13566
00142400,WESLEYAN UNIVERSITY                     ,CT,06459-3208,Private      ,135,30,165,5969,,319,6288
00142500,EASTERN CONNECTICUT STATE UNIV          ,CT,06226-2295,Public       ,192,125,317,7417,,1619,9036
00142600,YALE UNIVERSITY                         ,CT,06520-8288,Private      ,629,308,937,19273,,8688,27961
00280301,RENSSELAER POLYTECHNIC INSTITUTE-RENSSEL,CT,06120-2991,Private      ,1,11,12,34,,46,80
00451300,HOUSATONIC COMMUNITY COLLEGE            ,CT,06604-4704,Public       ,228,571,799,3206,,5022,8228
00618100,BRIDGEPORT HOSP SCHL OF NURSING         ,CT,06610-2896,Private      ,9,55,64,216,,686,902
00619100,ST. VINCENT'S COLLEGE                   ,CT,06606-9966,Private      ,24,111,135,431,,1145,1576
00698200,NAUGATUCK VALLEY COMM-TECH COLG         ,CT,06708-3089,Public       ,225,519,744,3661,,4585,8246
00730000,ELI WHITNEY TECHNICAL HIGH SCHOOL       ,CT,06514-0000,Public       ,1,17,18,15,,102,117
00730300,LINCOLN TECHNICAL INSTITUTE             ,CT,06051-0000,Proprietary  ,68,171,239,579,,1280,1859
00730306,LINCOLN TECHNICAL INSTITUTE - EAST WINDS,CT,06088-9631,Proprietary  ,72,71,143,961,,524,1485
00730500,PORTER AND CHESTER INSTITUTE OF BRANFORD,CT,06405-4022,Proprietary  ,23,78,101,257,,555,812
00731100,WINDHAM TECHNICAL HIGH SCHOOL           ,CT,06226-2100,Public       ,0,0,0,7,,15,22
00745900,PAIER COLLEGE OF ART                    ,CT,06514-3902,Proprietary  ,14,11,25,153,,83,236
00763500,CAPITAL COMMUNITY COLLEGE               ,CT,06103-1207,Public       ,156,485,641,2049,,4948,6997
00803700,GATEWAY COMMUNITY-TECHNICAL COLLEGE     ,CT,06511-0000,Public       ,291,692,983,4120,,6730,10850
00803800,MIDDLESEX COMMUNITY CLG                 ,CT,06457-4889,Public       ,122,256,378,1470,,1919,3389
00887300,PAUL MITCHELL THE SCHOOL                ,CT,06810-6716,Proprietary  ,13,25,38,120,,131,251
00887400,BRIO ACADEMY OF COSMETOLOGY             ,CT,06450-4836,Proprietary  ,11,39,50,45,,109,154
00887401,BRIO ACADEMY OF COSMETOLOGY - HAMDEN    ,CT,06514-4132,Proprietary  ,4,23,27,26,,107,133
00887402,BRIO ACADEMY OF COSMETOLOGY - FAIRFIELD ,CT,06824-6690,Proprietary  ,15,58,73,76,,191,267
00887403,BRIO ACADEMY OF COSMETOLOGY - WILLIMANTI,CT,06226-1940,Proprietary  ,8,23,31,36,,104,140
00887404,BRIO ACADEMY OF COSMETOLOGY -           ,CT,06605-4114,Proprietary  ,0,0,0,4,,19,23
00927700,E C GOODWIN TECHNICAL HIGH SCHOOL       ,CT,06053-0000,Public       ,1,12,13,30,,76,106
00940700,LINCOLN COLLEGE OF NEW ENGLAND          ,CT,06489-1057,Proprietary  ,31,70,101,619,,840,1459
00940701,CLEMENS COLLEGE                         ,CT,06078-0000,Proprietary  ,0,0,0,2,,1,3
00976400,TUNXIS COMMUNITY COLLEGE                ,CT,06032-3187,Public       ,140,263,403,2411,,2613,5024
00976500,THREE RIVERS COMMUNITY COLLEGE          ,CT,06360-6598,Public       ,163,315,478,2257,,3401,5658
00982200,ALBERT I PRINCE TECHNICAL HIGH SCHOOL   ,CT,06106-3799,Public       ,2,30,32,20,,153,173
01041700,BRIO ACADEMY OF EAST HARTFORD           ,CT,06108-2220,Proprietary  ,18,40,58,75,,199,274
01053000,QUINEBAUG VALLEY COMMUNITY COLLEGE      ,CT,06239-1440,Public       ,66,174,240,922,,1512,2434
01077900,PORTER AND CHESTER INSTITUTE-ALLCAMPUSES,CT,06615-7158,Proprietary  ,229,541,770,1602,,3606,5208
01115000,ASNUNTUCK COMMUNITY COLLEGE             ,CT,06082-3800,Public       ,45,115,160,698,,985,1683
01149600,BULLARD HAVENS VOC TECH SCHOOL          ,CT,06610-3499,Public       ,2,26,28,33,,146,179
01169700,VINAL REGIONAL VOC TECH SCHOOL          ,CT,06457-4918,Public       ,0,13,13,12,,63,75
01184300,NORWICH TECHNICAL HIGH SCHOOL           ,CT,06360-7097,Public       ,2,8,10,15,,87,102
01242500,STONE ACADEMY                           ,CT,06516-4049,Proprietary  ,24,123,147,206,,837,1043
01242503,STONE ACADEMY -WATERBURY                ,CT,06705-3823,Proprietary  ,3,32,35,45,,163,208
01242504,STONE ACADEMY -  EAST HARTFORD          ,CT,06118-0000,Proprietary  ,10,41,51,66,,255,321
01287700,SANFORD-BROWN COLLEGE                   ,CT,06855-1436,Proprietary  ,6,10,16,46,,133,179
01291300,LEON INSTITUTE OF HAIR DESIGN           ,CT,06604-4226,Proprietary  ,0,7,7,9,,39,48
02074000,BRANFORD HALL CAREER INSTITUTE          ,CT,06405-0000,Proprietary  ,232,810,1042,940,,3577,4517
02106600,AMERICAN INSTITUTE                      ,CT,06110-1922,Proprietary  ,19,102,121,85,,488,573
02112300,RIDLEY LOWELL BUSINESS & TECH INST      ,CT,06320-0000,Proprietary  ,19,140,159,147,,784,931
02112700,NORTH HAVEN ACADEMY                     ,CT,06473-3108,Proprietary  ,16,23,39,133,,109,242
02115100,BUTLER BUSINESS SCHOOL                  ,CT,06604-0000,Proprietary  ,0,0,0,1,,0,1
02148700,CONNECTICUT INST OF HAIR DESIGN         ,CT,06716-0000,Proprietary  ,5,6,11,27,,46,73
02202500,NEW ENGLAND TRACTOR TRAILER SCH         ,CT,06071-2036,Proprietary  ,36,386,422,125,,1167,1292
02244900,GOODWIN COLLEGE                         ,CT,06118-9980,Private      ,105,542,647,1297,,5262,6559
02245300,HOWELL CHENEY TECHNICAL HIGH SCHOOL     ,CT,06040-0000,Public       ,2,6,8,9,,20,29
02265900,WINDHAM COMMUNITY MEM HOSP-RAD TECH     ,CT,06226-0000,Private      ,0,3,3,13,,28,41
02296100,YALE-NEW HAVEN HOSP DIETETIC INTERN     ,CT,06510-8900,Private      ,3,9,12,34,,45,79
02300000,W F KAYNOR TECHNICAL HIGH SCHOOL        ,CT,06708-0000,Public       ,3,29,32,25,,121,146
02316600,CONNECTICUT CTR FOR MASSAGE THERAPY     ,CT,06111-3975,Proprietary  ,11,31,42,62,,182,244
02316601,CONNECTICUT CENTER FOR MASSAGE THERAPY -,CT,06880-4619,Proprietary  ,7,36,43,43,,160,203
02316603,CONNECTICUT CENTER FOR MASSAGE THERAPY -,CT,06340-4619,Proprietary  ,5,34,39,38,,126,164
02565000,PLATT TECHNICAL HIGH SCHOOL             ,CT,06460-2105,Public       ,1,11,12,14,,43,57
03079400,LYME ACADEMY COLLEGE OF FINE ARTS       ,CT,06371-2333,Private      ,2,2,4,99,,32,131
03094800,INDUSTRIAL MANAGEMENT & TRAINING        ,CT,06706-1211,Proprietary  ,10,34,44,64,,167,231
03234300,CHARTER OAK STATE COLLEGE               ,CT,06053-2150,Public       ,23,262,285,158,,2018,2176
03316300,LINCOLN TECHNICAL INSTITUTE - HARTFORD  ,CT,06105-3630,Proprietary  ,35,89,124,537,,613,1150
03381300,CONNECTICUT TRAINING CENTER             ,CT,06108-2705,Private      ,0,0,0,1,,20,21
03927300,ALBERT SCHOOL (THE)                     ,CT,06357-2447,Proprietary  ,6,24,30,31,,94,125
03927301,BRIO ACADEMY OF COSMETOLOGY - TORRINGTON,CT,06790-5425,Proprietary  ,5,8,13,24,,47,71
03927302,BRIO ACADEMY OF COSMETOLOGY  -  ENFIELD ,CT,06082-2946,Proprietary  ,5,4,9,35,,60,95
04104300,ACADEMY DI CAPELLI - SCHOOL OF COSMETOLO,CT,06492-0000,Proprietary  ,11,27,38,61,,97,158
04128800,BRANFORD ACADEMY OF HAIR & COSMETOLOGY  ,CT,06405-0000,Proprietary  ,3,14,17,26,,75,101
04145400,OXFORD ACADEMY OF HAIR DESIGN           ,CT,06483-2911,Proprietary  ,5,8,13,50,,69,119
04148400,EUROPEAN ACADEMY OF COSMETOLOGY AND HAIR,CT,06437-0000,Proprietary  ,2,9,11,21,,23,44
04152400,INTERNATIONAL INSTITUTE OF COSMETOLOGY  ,CT,06109-0000,Proprietary  ,16,14,30,121,,89,210
04162900,TONSORIAL ACADEMY OF COSMETOLOGY AND BAR,CT,06516-0000,Proprietary  ,0,0,0,4,,7,11
04219200,ACE COSMETOLOGY & BARBERING TRAINING CEN,CT,06716-0000,Proprietary  ,3,10,13,10,,26,36
04224200,BELLE ACADEMY OF COSMETOLOGY            ,CT,06704-0135,Proprietary  ,4,12,16,14,,43,57
04230900,RICCI'S ACADEMY OF COSMETOLOGY          ,CT,06470-0000,Proprietary  ,9,12,21,9,,12,21
00146600,BARRY UNIVERSITY                        ,FL,33161-6695,Private      ,255,742,997,6462,,10138,16600
00146601,BARRY UNIVERSITY - ORLANDO              ,FL,32807-3673,Private      ,33,147,180,466,,2299,2765
00146700,BETHUNE COOKMAN UNIVERSITY              ,FL,32114-3099,Private      ,342,210,552,8317,,2423,10740
00146800,ST THOMAS UNIVERSITY                    ,FL,33054-0000,Private      ,94,214,308,1910,,3116,5026
00146900,FLORIDA INSTITUTE OF TECHNOLOGY         ,FL,32901-6988,Private      ,204,1017,1221,5138,,9109,14247
00147000,BREVARD COMMUNITY COLLEGE               ,FL,32922-6503,Public       ,445,1236,1681,6989,,11432,18421
00147100,COLLEGE OF CENTRAL FLORIDA              ,FL,34474-4415,Public       ,354,851,1205,5084,,8650,13734
00147200,CHIPOLA  COLLEGE                        ,FL,32446-2053,Public       ,63,151,214,1194,,1606,2800
00147300,CLEARWATER CHRISTIAN COLLEGE            ,FL,33759-0000,Private      ,34,27,61,830,,235,1065
00147500,DAYTONA STATE COLLEGE                   ,FL,32114-2800,Public       ,684,1627,2311,9105,,14498,23603
00147700,EDISON STATE COLLEGE                    ,FL,33906-6210,Public       ,619,1084,1703,9028,,11408,20436
00147800,EDWARD WATERS COLLEGE                   ,FL,32209-6199,Private      ,65,117,182,1479,,1160,2639
00147900,EMBRY-RIDDLE AERONAUTICAL UNIV          ,FL,32114-3900,Private      ,278,1317,1595,7841,,9860,17701
00148000,FLORIDA A & M UNIVERSITY                ,FL,32307-3100,Public       ,780,480,1260,16584,,9189,25773
00148100,FLORIDA ATLANTIC UNIVERSITY             ,FL,33431-6498,Public       ,1454,1326,2780,30883,,19738,50621
00148101,FLORIDA ATLANTIC UNIVERSITY/DAVIE       ,FL,33314-0000,Public       ,156,423,579,3256,,5762,9018
00148103,FLORIDA ATLANTIC UNIV-JUPITER/PSL       ,FL,33458-0000,Public       ,80,121,201,1626,,1657,3283
00148200,FLORIDA COLLEGE                         ,FL,33617-5578,Private      ,19,11,30,613,,134,747
00148400,FLORIDA STATE COLLEGE AT JACKSONVILLE   ,FL,32202-4030,Public       ,1181,3234,4415,15167,,29691,44858
00148500,FLORIDA KEYS COMMUNITY COLLEGE          ,FL,33040-4397,Public       ,49,113,162,772,,945,1717
00148600,FLORIDA MEMORIAL UNIVERSITY             ,FL,33054-6199,Private      ,114,133,247,3282,,1768,5050
00148700,ECKERD COLLEGE                          ,FL,33711-4744,Private      ,123,146,269,3392,,1270,4662
00148800,FLORIDA SOUTHERN COLLEGE                ,FL,33801-5698,Private      ,147,184,331,4601,,1686,6287
00148900,FLORIDA STATE UNIVERSITY                ,FL,32306-2430,Public       ,2637,1228,3865,55995,,20454,76449
00149000,GULF COAST STATE COLLEGE                ,FL,32401-1058,Public       ,226,676,902,2969,,5739,8708
00149300,INDIAN RIVER STATE COLLEGE              ,FL,34981-5596,Public       ,603,1425,2028,7948,,11802,19750
00149500,JACKSONVILLE UNIVERSITY                 ,FL,32211-3394,Private      ,214,567,781,4365,,5017,9382
00149700,JONES COLLEGE                           ,FL,32211-5588,Private      ,18,118,136,156,,1059,1215
00149900,EVEREST UNIVERSITY                      ,FL,32810-5601,Proprietary  ,59,412,471,717,,4259,4976
00149901,EVEREST UNIVERSITY - ORLANDO SOUTH      ,FL,32819-7666,Proprietary  ,592,5531,6123,3850,,42472,46322
00149902,EVEREST UNIVERSITY - MELBOURNE          ,FL,32905-6609,Proprietary  ,28,161,189,199,,1327,1526
00150000,BROWARD COLLEGE- DOWNTOWN CTR           ,FL,33301-2298,Public       ,703,1854,2557,8422,,15499,23921
00150001,BROWARD COLLEGE - DAVIE CAMPUS          ,FL,33314-0000,Public       ,786,1391,2177,12793,,14559,27352
00150002,BROWARD COLLEGE- NORTH CAMPUS           ,FL,33066-0000,Public       ,492,1173,1665,7945,,12316,20261
00150003,BROWARD COLLEGE- SOUTH CAMPUS           ,FL,33024-0000,Public       ,571,1203,1774,9079,,11899,20978
00150100,FLORIDA GATEWAY COLLEGE                 ,FL,32025-2007,Public       ,115,356,471,1454,,2921,4375
00150200,LAKE SUMTER COMMUNITY COLLEGE           ,FL,34788-8751,Public       ,216,389,605,2828,,3324,6152
00150400,"STATE COLLEGE OF FLORIDA, MANATEE-SARASO",FL,34207-3596,Public       ,406,764,1170,5913,,8078,13991
00150500,LYNN UNIVERSITY                         ,FL,33431-5598,Private      ,147,153,300,2710,,1261,3971
00150600,MIAMI DADE COLLEGE ADMINISTRATION ONLY  ,FL,33176-3393,Public       ,45,120,165,726,,1002,1728
00150601,MIAMI DADE COLLEGE - NORTH CAMPUS       ,FL,33167-3495,Public       ,965,1898,2863,15466,,18562,34028
00150602,MIAMI DADE COLLEGE - KENDALL CAMPUS     ,FL,33176-3393,Public       ,1394,1922,3316,21585,,17914,39499
00150603,MIAMI DADE COLLEGE - WOLFSON CAMPUS     ,FL,33132-2297,Public       ,785,1395,2180,12413,,13170,25583
00150604,MIAMI DADE COLLEGE - MEDICAL CAMPUS     ,FL,33127-4693,Public       ,267,851,1118,4107,,8125,12232
00150605,MIAMI DADE COLLEGE - HOMESTEAD CAMPUS   ,FL,33030-6009,Public       ,220,462,682,3373,,4263,7636
00150606,MIAMI DADE COLLEGE -INTERAMERICAN CAMPUS,FL,33135-0000,Public       ,362,829,1191,4686,,8169,12855
00150607,MIAMI DADE COLLEGE - HIALEAH CAMPUS     ,FL,33012-2918,Public       ,323,575,898,4600,,5547,10147
00150800,NORTH FLORIDA COMMUNITY COLLEGE         ,FL,32340-1699,Public       ,45,124,169,644,,999,1643
00150900,NOVA SOUTHEASTERN UNIVERSITY            ,FL,33314-7796,Private      ,409,2061,2470,7798,,32422,40220
00151000,NORTHWEST FLORIDA STATE COLLEGE         ,FL,32578-1295,Public       ,207,619,826,2570,,5549,8119
00151200,PALM BEACH COMMUNITY COLLEGE            ,FL,33461-4796,Public       ,1102,2015,3117,16289,,18539,34828
00151300,PENSACOLA STATE COLLEGE                 ,FL,32504-8998,Public       ,425,1264,1689,5485,,10686,16171
00151400,POLK STATE COLLEGE                      ,FL,33881-4256,Public       ,369,945,1314,5909,,9434,15343
00151500,ROLLINS COLLEGE                         ,FL,32789-4499,Private      ,162,142,304,3665,,1562,5227
00151900,SANTA FE COLLEGE                        ,FL,32606-6200,Public       ,603,1040,1643,11163,,10641,21804
00152000,SEMINOLE STATE COLLEGE OF FLORIDA       ,FL,32773-6199,Public       ,801,1755,2556,11153,,16260,27413
00152100,SOUTHEASTERN UNIVERSITY                 ,FL,33801-6099,Private      ,191,191,382,3788,,1951,5739
00152200,SOUTH FLORIDA COMMUNITY COLLEGE         ,FL,33825-9399,Public       ,105,282,387,1566,,2337,3903
00152300,SAINT JOHNS RIVER STATE COLLEGE         ,FL,32177-3897,Public       ,239,563,802,3335,,5128,8463
00152600,SAINT LEO UNIVERSITY                    ,FL,33574-6665,Private      ,173,1724,1897,4352,,17316,21668
00152800,ST. PETERSBURG COLLEGE                  ,FL,33760-3768,Public       ,870,2628,3498,11960,,26780,38740
00153100,STETSON UNIVERSITY                      ,FL,32723-3761,Private      ,267,112,379,7026,,1132,8158
00153101,STETSON UNIVERSITY - COLLEGE OF LAW     ,FL,33707-3299,Private      ,12,64,76,146,,1823,1969
00153300,TALLAHASSEE COMMUNITY COLLEGE           ,FL,32304-2895,Public       ,750,1046,1796,11864,,10584,22448
00153400,EVEREST UNIVERSITY                      ,FL,33614-5801,Proprietary  ,76,500,576,632,,4621,5253
00153408,EVEREST UNIVERSITY - TAMPA BRANDON CAMPU,FL,33619-1354,Proprietary  ,65,544,609,614,,7597,8211
00153409,EVEREST UNIVERSITY - ORANGE PARK        ,FL,32073-1111,Proprietary  ,15,148,163,156,,1206,1362
00153500,UNIVERSITY OF FLORIDA                   ,FL,32611-3150,Public       ,2091,1463,3554,53929,,22810,76739
00153600,UNIVERSITY OF MIAMI                     ,FL,33146-6531,Private      ,1046,573,1619,24334,,7292,31626
00153601,UNIV OF MIAMI SCHOOL OF LAW             ,FL,33124-0000,Private      ,22,52,74,204,,2377,2581
00153602,UNIV OF MIAMI-SCH OF MEDICINE           ,FL,33136-0000,Private      ,105,108,213,1188,,2125,3313
00153700,UNIVERSITY OF SOUTH FLORIDA             ,FL,33620-6960,Public       ,1994,1899,3893,47028,,28395,75423
00153701,UNIV OF SOUTH FLORIDA-ST PETERSBURG     ,FL,33701-0000,Public       ,262,428,690,5682,,4633,10315
00153702,UNIV OF SOUTH FLORIDA-SARASOTA          ,FL,34243-2025,Public       ,68,161,229,1439,,2295,3734
00153705,UNIV OF SOUTH FLORIDA                   ,FL,33803-0000,Public       ,89,138,227,1386,,1661,3047
00153706,UNIV OF SOUTH FLORIDA- MEDICINE         ,FL,33612-0000,Public       ,145,165,310,1954,,2627,4581
00153800,UNIVERSITY OF TAMPA                     ,FL,33606-1490,Private      ,571,373,944,13646,,4275,17921
00154000,WEBBER INTERNATIONAL UNIVERSITY         ,FL,33827-0096,Private      ,35,38,73,1496,,447,1943
00173308,NATIONAL-LOUIS UNIVERSITY               ,FL,33609-0000,Private      ,0,21,21,21,,141,162
00177201,TRINITY INTERNATIONAL UNIVERSITY - SOUTH,FL,33324-4611,Private      ,7,62,69,106,,612,718
00395400,UNIV OF CENTRAL FLORIDA                 ,FL,32816-0001,Public       ,3188,2416,5604,72577,,36411,108988
00395500,UNIVERSITY OF WEST FLORIDA              ,FL,32514-5750,Public       ,524,841,1365,11665,,9100,20765
00407215,NORTHWOOD UNIVERSITY                    ,FL,33409-0000,Private      ,36,81,117,730,,604,1334
00491004,KAPLAN CAREER INSTITUTE - KAPLAN COLLEGE,FL,33026-3978,Proprietary  ,0,0,0,54,,473,527
00491005,KAPLAN COLLEGE JACKSONVILLE             ,FL,32216-3216,Proprietary  ,36,467,503,247,,3322,3569
00558500,LIVELY TECHNICAL CENTER                 ,FL,32304-0000,Public       ,96,348,444,791,,2469,3260
00558600,LINDSEY HOPKINS TECHNICAL ED CENTER     ,FL,33127-4692,Public       ,34,179,213,350,,1208,1558
00559400,D G ERWIN TECHNICAL CENTER              ,FL,33610-8255,Public       ,95,381,476,736,,2586,3322
00560500,PINELLAS TECH ED CTR-CLEARWATER         ,FL,33760-2194,Public       ,64,242,306,428,,1710,2138
00560700,SARASOTA COUNTY TECHNICAL INSTITUTE     ,FL,34233-0000,Public       ,41,131,172,394,,1089,1483
00560800,MAYNARD A. TRAVISS CAREER CENTER        ,FL,33803-9709,Public       ,53,187,240,447,,1430,1877
00561200,MANATEE TECHNICAL INSTITUTE             ,FL,34210-0000,Public       ,69,230,299,599,,1622,2221
00561201,MANATEE TECHNICAL INSTITUTE-EAST        ,FL,34211-0000,Public       ,34,121,155,373,,1086,1459
00675000,VALENCIA COMMUNITY COLLEGE              ,FL,32802-3028,Public       ,2543,3672,6215,34326,,33464,67790
00732910,ITT TECHNICAL INSTITUTE                 ,FL,33634-7515,Proprietary  ,171,694,865,1048,,4364,5412
00732947,ITT TECHNICAL INSTITUTE                 ,FL,32746-1607,Proprietary  ,104,392,496,690,,2807,3497
00736206,MEDTECH COLLEGE - MEDTECH INSTITUTE - OR,FL,32826-4906,Proprietary  ,32,188,220,191,,849,1040
00752500,SUWANNEE-HAMILTON AREA VOC TECH CTR     ,FL,32060-0000,Public       ,8,36,44,94,,338,432
00752600,WASHINGTON HOLMES TECHNICAL CENTER      ,FL,32428-1699,Public       ,24,83,107,206,,551,757
00755800,LEE COUNTY HIGH TECH CENTER CENTRAL     ,FL,33916-2299,Public       ,57,191,248,538,,1416,1954
00787000,HILLSBOROUGH COMMUNITY COLLEGE          ,FL,33606-3572,Public       ,1395,3035,4430,17934,,25824,43758
00789300,FLAGLER COLLEGE                         ,FL,32085-1027,Private      ,234,90,324,5183,,1146,6329
00789301,FLAGLER COLLEGE - TALLAHASSEE COMMUNITY ,FL,32304-2895,Private      ,35,93,128,544,,1066,1610
00807500,ST JOHN VIANNEY COLLEGE SEMINARY        ,FL,33165-3244,Private      ,5,1,6,41,,29,70
00814600,EVEREST UNIVERSITY - POMPANO BEACH      ,FL,33062-2522,Proprietary  ,46,426,472,435,,4205,4640
00822300,ST VINCENT DE PAUL REGIONL SEMINARY     ,FL,33436-0000,Private      ,0,4,4,6,,25,31
00841700,STENOTYPE INST OF JACKSONVILLE          ,FL,32207-0000,Proprietary  ,4,66,70,46,,435,481
00869410,RASMUSSEN COLLEGE - OCALA               ,FL,34471-7051,Proprietary  ,85,722,807,825,,6912,7737
00869411,RASMUSSEN COLLEGE - NEW PORT RICHEY     ,FL,34690-4554,Proprietary  ,24,139,163,242,,1394,1636
00869413,RASMUSSEN COLLEGE - FORT MYERS          ,FL,33905-7805,Proprietary  ,39,174,213,446,,1787,2233
00869420,RASMUSSEN COLLEGE - TAMPA               ,FL,33610-9558,Proprietary  ,26,160,186,236,,1309,1545
00869422,RASMUSSEN COLLEGE - PASCO               ,FL,33558-0000,Proprietary  ,14,49,63,103,,472,575
00884800,WARNER UNIVERSITY                       ,FL,33859-8725,Private      ,61,107,168,1045,,983,2028
00884900,PALM BEACH ATLANTIC UNIVERSITY          ,FL,33401-6505,Private      ,183,295,478,3865,,3116,6981
00887800,MIAMI INTERNATIONAL UNIV ART&DESIGN     ,FL,33132-1418,Proprietary  ,255,271,526,3001,,2889,5890
00910400,TONI & GUY HAIRDRESSING ACADEMY         ,FL,32256-3810,Proprietary  ,9,22,31,54,,141,195
00963500,FLORIDA INTERNATIONAL UNIVERSITY        ,FL,33199-0001,Public       ,1948,2393,4341,43794,,34808,78602
00984100,UNIVERSITY OF NORTH FLORIDA             ,FL,32224-2645,Public       ,913,930,1843,18114,,11527,29641
00990200,SHERIDAN TECHNICAL CENTER               ,FL,33021-3399,Public       ,109,430,539,886,,2802,3688
01016100,"LORAINE'S ACADEMY, INC                  ",FL,33710-0000,Proprietary  ,6,78,84,57,,318,375
01019500,ART INSTITUTE OF FT LAUDERDALE          ,FL,33316-3000,Proprietary  ,144,267,411,2172,,2442,4614
01065200,PASCO-HERNANDO COMMUNITY CLG            ,FL,34654-5199,Public       ,450,968,1418,5682,,8310,13992
01072401,CARLOS ALBIZU UNIVERSITY                ,FL,33172-0000,Private      ,11,162,173,143,,1333,1476
01082600,TOM P. HANEY TECHNICAL CENTER           ,FL,32405-5099,Public       ,33,210,243,306,,1420,1726
01112700,GOODING INST OF NUR ANES BAY MED CT     ,FL,32401-0000,Proprietary  ,2,19,21,35,,168,203
01226300,ATLANTIC TECHNICAL CENTER               ,FL,33063-3902,Public       ,92,318,410,670,,1896,2566
01246117,LINCOLN COLLEGE OF TECHNOLOGY - WEST PAL,FL,33407-3105,Proprietary  ,41,125,166,409,,846,1255
01254400,FIRST COAST TECHNICAL COLLEGE           ,FL,32084-1921,Public       ,65,185,250,457,,1306,1763
01257400,RINGLING SCHOOL OF ART AND DESIGN       ,FL,34234-5895,Private      ,89,33,122,2206,,465,2671
01303904,SOUTH UNIVERSITY - WEST PALM BEACH CAMPU,FL,33409-5149,Proprietary  ,69,279,348,625,,2276,2901
01323400,LORENZO WALKER INST OF TECHNOLOGY       ,FL,34104-4405,Public       ,49,116,165,369,,793,1162
02089600,CONCORDE CAREER INSTITUTE               ,FL,32211-0000,Proprietary  ,34,265,299,334,,1899,2233
02106602,AMERICAN INSTITUTE - AMERICAN INSTITUTE ,FL,34747-5161,Proprietary  ,0,0,0,2,,17,19
02113609,AMERICAN INTERCONTINENTAL UNIV - WESTON ,FL,33326-3233,Proprietary  ,5,44,49,99,,504,603
02115300,PINELLAS TECHNICAL EDUCATION CENTERS - S,FL,33711-0000,Public       ,69,407,476,527,,2475,3002
02116006,SANFORD-BROWN INSTITUTE - FT. LAUDERDALE,FL,33309-1906,Proprietary  ,25,117,142,256,,825,1081
02121800,EVEREST INSTITUTE                       ,FL,33169-4759,Proprietary  ,33,208,241,321,,1336,1657
02121801,EVEREST INSTITUTE  - HIALEAH            ,FL,33012-7193,Proprietary  ,0,0,0,46,,99,145
02148200,FASHION FOCUS HAIR ACADEMY              ,FL,34231-0000,Proprietary  ,4,13,17,44,,118,162
02148300,MANHATTAN BEAUTY SCHOOL                 ,FL,33611-0000,Proprietary  ,14,73,87,144,,537,681
02149900,PAUL MITCHELL THE SCHOOL-JACKSONVILLE   ,FL,32205-0000,Proprietary  ,16,58,74,218,,462,680
02151100,ATI COLLEGE OF HEALTH                   ,FL,33169-0000,Proprietary  ,0,0,0,9,,20,29
02151900,KEISER  UNIVERSITY                      ,FL,33309-0000,Private      ,554,2724,3278,5305,,21940,27245
02156700,FLORIDA CHRISTIAN COLLEGE               ,FL,34744-0000,Private      ,14,37,51,450,,357,807
02159600,BAPTIST COLLEGE OF FLORIDA (THE)        ,FL,32440-0000,Private      ,9,24,33,343,,345,688
02172700,CONCORDE CAREER INSTITUTE               ,FL,33607-0000,Proprietary  ,31,165,196,235,,1099,1334
02188900,HOBE SOUND BIBLE COLLEGE                ,FL,33475-0000,Private      ,4,12,16,75,,120,195
02200100,BRADENTON BEAUTY & BARBER ACADEMY       ,FL,34209-0000,Proprietary  ,9,25,34,58,,198,256
02218700,FLORIDA TECHNICAL COLLEGE               ,FL,32826-2707,Proprietary  ,207,757,964,1301,,4172,5473
02218707,FLORIDA TECHNICAL COLLEGE - LAKELAND    ,FL,33813-2101,Proprietary  ,22,94,116,159,,636,795
02218709,FLORIDA TECHNICAL COLLEGE - DELAND      ,FL,32720-7415,Proprietary  ,34,214,248,225,,1152,1377
02228300,LAKE TECHNICAL CENTER                   ,FL,32726-0000,Public       ,71,226,297,520,,1615,2135
02245500,FORTIS COLLEGE                          ,FL,32789-4679,Proprietary  ,11,84,95,116,,798,914
02257900,INTERNATIONAL ACADEMY                   ,FL,32119-3541,Proprietary  ,10,53,63,88,,353,441
02275100,CONCORDE CAREER INSTITUTE               ,FL,33025-0000,Proprietary  ,20,99,119,183,,654,837
02278800,SOUTHWEST FLORIDA COLLEGE               ,FL,33907-0000,Proprietary  ,76,245,321,574,,2032,2606
02278801,SOUTHWEST FLORIDA COLLEGE - TAMPA       ,FL,33619-1344,Proprietary  ,61,152,213,489,,1198,1687
02278802,SOUTHWEST FLORIDA COLLEGE - INSTITUTUE O,FL,33928-9469,Proprietary  ,11,18,29,52,,148,200
02278803,SOUTHWEST FLORIDA COLLEGE - PORT CHARLOT,FL,33953-3100,Proprietary  ,20,87,107,164,,745,909
02279600,CORTIVA INSTITUTE - FLORIDA             ,FL,33781-0000,Proprietary  ,8,36,44,50,,181,231
02283800,BEAUTY SCHOOLS OF AMERICA               ,FL,33012-3322,Proprietary  ,87,550,637,528,,2796,3324
02287100,LA BELLE BEAUTY SCHOOL                  ,FL,33012-3224,Proprietary  ,15,89,104,42,,201,243
02293200,ATI CAREER TRAINING CENTER              ,FL,33309-5916,Proprietary  ,0,0,0,4,,7,11
02293201,ATI CAREER TRAINING CENTER - MIAMI      ,FL,33122-1707,Proprietary  ,0,0,0,7,,18,25
02293600,ADVANCED TECHNICAL CENTERS              ,FL,33266-1597,Private      ,7,20,27,60,,138,198
02297000,CHARLOTTE TECHNICAL CENTER              ,FL,33948-0000,Public       ,25,78,103,231,,602,833
02300900,WITHLACOOCHEE TECHNICAL INSTITUTE       ,FL,34450-0000,Public       ,32,134,166,260,,770,1030
02305700,FORTIS COLLEGE                          ,FL,33619-1283,Proprietary  ,8,51,59,88,,448,536
02305800,FLORIDA CAREER COLLEGE                  ,FL,33012-7028,Proprietary  ,294,1365,1659,1554,,6439,7993
02305810,FLORIDA CAREER COLLEGE - CLEARWATER     ,FL,33759-3924,Proprietary  ,13,75,88,113,,398,511
02307400,GEORGE STONE AREA VOCATIONAL TECHNICAL  ,FL,32526-0000,Public       ,49,239,288,374,,1626,2000
02314100,SCHILLER INTERNATIONAL UNIVERSITY       ,FL,33770-0000,Proprietary  ,8,57,65,82,,383,465
02316200,MIAMI LAKES TECHNICAL EDUCATION CTR     ,FL,33014-0000,Public       ,56,234,290,461,,1469,1930
02321200,ORANGE TECH EDUC CTR- WESTSIDE TECH     ,FL,34787-0000,Public       ,47,135,182,327,,851,1178
02325100,KEY COLLEGE                             ,FL,33004-3046,Proprietary  ,0,15,15,18,,79,97
02326303,MEDVANCE INSTITUTE - WEST PALM          ,FL,33461-2171,Proprietary  ,14,47,61,139,,430,569
02326306,MEDVANCE INSTITUTE - MIAMI              ,FL,33173-3431,Proprietary  ,5,16,21,82,,299,381
02326800,MERIDIAN COLLEGE                        ,FL,34240-8478,Proprietary  ,14,51,65,80,,314,394
02326900,SUNSTATE ACADEMY OF HAIR DESIGN         ,FL,33907-1415,Proprietary  ,25,72,97,202,,506,708
02329900,FLORIDA INSTITUTE OF ULTRASOUND         ,FL,32514-0000,Proprietary  ,7,70,77,121,,505,626
02338400,FT PIERCE BEAUTY ACADEMY                ,FL,34982-0000,Proprietary  ,21,90,111,88,,355,443
02346200,WYOTECH                                 ,FL,32174-1010,Proprietary  ,37,129,166,409,,938,1347
02362100,FULL SAIL UNIVERSITY                    ,FL,32792-0000,Proprietary  ,1352,2971,4323,15305,,26962,42267
02499000,ACADEMY OF COSMETOLOGY                  ,FL,32953-3311,Proprietary  ,10,33,43,82,,230,312
02501500,"O*TEC, MID-FLORIDA TECH                 ",FL,32809-0000,Public       ,61,295,356,621,,1813,2434
02502702,ADVANCED CAREER TRAINING-JACKSONVIL     ,FL,32256-0000,Proprietary  ,0,0,0,104,,419,523
02504600,WINTER PARK TECH                        ,FL,32789-0000,Public       ,16,126,142,188,,802,990
02508900,TALMUDIC COLLEGE OF FLORIDA             ,FL,33139-0000,Private      ,3,4,7,38,,22,60
02511700,RIDGE TECHNICAL CENTER                  ,FL,33881-0000,Public       ,38,154,192,446,,1234,1680
02513200,ORLANDO TECHNICAL CENTER                ,FL,32801-0000,Public       ,49,273,322,618,,1867,2485
02515400,CITY COLLEGE                            ,FL,33309-3073,Private      ,75,302,377,527,,2419,2946
02517100,SARASOTA SCHOOL OF MASSAGE THERAPY      ,FL,34243-6130,Proprietary  ,11,18,29,34,,179,213
02524000,SUNSTATE ACADEMY OF HAIR DESIGN         ,FL,34624-0000,Proprietary  ,18,60,78,95,,282,377
02524200,ROBERT MORGAN EDUCATIONAL CENTER        ,FL,33177-0000,Public       ,57,173,230,530,,1181,1711
02531803,PAUL MITCHELL THE SCHOOL - ORLANDO      ,FL,32765-6444,Proprietary  ,35,56,91,123,,198,321
02531805,PAUL MITCHELL THE SCHOOL -TAMPA         ,FL,33613-0000,Proprietary  ,23,57,80,154,,246,400
02547600,FLORIDA NATIONAL COLLEGE                ,FL,33012-0000,Proprietary  ,72,303,375,778,,2726,3504
02547601,FLORIDA NATIONAL UNIVERSITY - SOUTH CAMP,FL,33175-2478,Proprietary  ,59,198,257,59,,198,257
02547602,FLORIDA NATIONAL UNIVERSITY - TRAINING A,FL,33012-4108,Proprietary  ,17,51,68,17,,51,68
02554200,RADFORD LOCKLIN TECH CENTER             ,FL,32570-0000,Public       ,12,51,63,105,,353,458
02559316,(UNITED EDUCATION INSTITUTE) - UEI JACKS,FL,32207-5627,Proprietary  ,13,56,69,145,,619,764
02573200,LA BELLE BEAUTY ACADEMY                 ,FL,33135-0000,Proprietary  ,16,61,77,90,,348,438
02597100,HERITAGE INSTITUTE                      ,FL,33912-7132,Proprietary  ,54,182,236,384,,1057,1441
02598200,SOUTHERN CAREER COLLEGE                 ,FL,32211-0000,Proprietary  ,11,55,66,72,,360,432
02599800,EVEREST UNIVERSITY                      ,FL,33770-2556,Proprietary  ,27,111,138,149,,932,1081
02599801,EVEREST UNIVERSITY - TAMPA LAKELAND CAMP,FL,33801-3801,Proprietary  ,24,181,205,204,,1334,1538
02599805,EVEREST UNIVERSITY - JACKSONVILLE       ,FL,32256-0000,Proprietary  ,37,273,310,343,,2043,2386
02601600,HENRY W BREWSTER TECHNICAL CENTER       ,FL,33602-0000,Public       ,26,107,133,186,,869,1055
02612700,"SALON PROFESSIONAL ACADEMY - MELBOURNE, ",FL,32904-3919,Proprietary  ,8,34,42,70,,214,284
02616400,SANFORD-BROWN INSTITUTE                 ,FL,32256-3520,Proprietary  ,22,101,123,199,,877,1076
02616401,SANFORD-BROWN INSTITUTE - TAMPA         ,FL,33610-8304,Proprietary  ,23,93,116,172,,704,876
02616705,LE CORDON BLEU COLLEGE OF CULINARY ARTS ,FL,33025-3929,Proprietary  ,33,92,125,410,,591,1001
03003200,EVEREST INSTITUTE                       ,FL,33186-1410,Proprietary  ,22,127,149,330,,1006,1336
03003600,MCFATTER TECHNICAL CENTER               ,FL,33317-7499,Public       ,72,210,282,638,,1547,2185
03008600,FLORIDA COLLEGE OF NATURAL HEALTH       ,FL,33064-1342,Proprietary  ,60,192,252,254,,846,1100
03010608,VIRGINIA COLLEGE - PENSACOLA            ,FL,32501-5650,Proprietary  ,18,133,151,201,,1286,1487
03010612,VIRGINIA COLLEGE - GOLF ACADEMY OF AMERI,FL,32701-0000,Proprietary  ,6,4,10,63,,110,173
03010618,VIRGINIA COLLEGE - JACKSONVILLE         ,FL,32207-5167,Proprietary  ,16,121,137,186,,936,1122
03012300,ASM BEAUTY WORLD ACADEMY                ,FL,33021-0000,Proprietary  ,5,28,33,45,,182,227
03018500,BENE'S INTERNATIONAL SCHOOL OF BEAUTY   ,FL,34652-1637,Proprietary  ,20,59,79,105,,358,463
03026508,REMINGTON COLLEGE - TAMPA               ,FL,33619-1177,Private      ,21,82,103,180,,1040,1220
03028200,TRINITY COLLEGE OF FLORIDA              ,FL,34655-4401,Private      ,5,24,29,167,,205,372
03031400,INTERNATIONAL ACADEMY OF DESIGN AND TECH,FL,33634-6313,Proprietary  ,135,540,675,1055,,3831,4886
03031402,INTERNATIONAL ACADEMY OF DESIGN AND TECH,FL,32809-4613,Proprietary  ,38,111,149,469,,852,1321
03031403,IADT - ORLANDO CULINARY ACADEMY         ,FL,32819-0000,Proprietary  ,19,49,68,238,,457,695
03035800,HERITAGE INSTITUTE                      ,FL,32216-0948,Proprietary  ,25,141,166,115,,675,790
03035900,NATIONAL AVIATION ACADEMY               ,FL,33760-3931,Proprietary  ,51,116,167,389,,861,1250
03037500,HODGES UNIVERSITY                       ,FL,34119-7932,Private      ,93,357,450,840,,3795,4635
03054200,FORTIS COLLEGE                          ,FL,33144-2373,Proprietary  ,6,21,27,90,,225,315
03071600,COLLEGE OF BUSINESS & TECHNOLOGY        ,FL,33176-0000,Proprietary  ,44,243,287,363,,1471,1834
03076402,BRYMAN SCHOOL OF ARIZONA (THE) - ANTHEM ,FL,32803-3509,Proprietary  ,33,97,130,193,,567,760
03078003,OHIO CENTER FOR BROADCASTING - MIAMI MED,FL,33130-3042,Proprietary  ,9,51,60,14,,60,74
03079800,GEORGE T BAKER AVIATION                 ,FL,33142-5687,Public       ,33,68,101,390,,573,963
03079900,CITY COLLEGE                            ,FL,32707-0000,Private      ,15,81,96,103,,612,715
03089200,NOUVELLE INSTITUTE                      ,FL,33125-4141,Proprietary  ,2,71,73,32,,426,458
03096300,FORTIS INSTITUTE                        ,FL,33860-0000,Proprietary  ,3,23,26,43,,206,249
03100800,TAYLOR TECHNICAL INSTITUTE              ,FL,32348-0894,Public       ,4,27,31,51,,198,249
03101900,TRINITY BAPTIST COLLEGE                 ,FL,32221-1398,Private      ,13,46,59,293,,314,607
03103900,MARION COUNTY COMMUNITY TECH & ADUL     ,FL,34474-3172,Public       ,46,210,256,457,,1678,2135
03108500,EVERGLADES UNIVERSITY                   ,FL,33431-0000,Private      ,23,229,252,239,,1871,2110
03108600,COM-PU-MED VOCATIONAL CAREERS           ,FL,33012-4861,Proprietary  ,10,50,60,64,,343,407
03113400,ACADEMY OF HEALING ARTS                 ,FL,33463-2113,Proprietary  ,5,29,34,43,,168,211
03114700,PRAXIS INSTITUTE                        ,FL,33135-2657,Proprietary  ,6,49,55,25,,287,312
03115500,ADVENTIST UNIVERSITY OF HEALTH SCIENCES ,FL,32803-1237,Private      ,87,258,345,1472,,2918,4390
03123900,KEISER CAREER COLLEGE                   ,FL,33413-0000,Proprietary  ,45,229,274,375,,1611,1986
03125600,MIAMI AD SCHOOL                         ,FL,33139-5203,Proprietary  ,11,55,66,121,,400,521
03127900,TECHNICAL EDUCATION CTR OSCEOLA         ,FL,34744-4459,Public       ,40,168,208,425,,1281,1706
03158300,LEE COUNTY HIGH TECH CENTER NORTH       ,FL,33993-2479,Public       ,21,79,100,219,,606,825
03171300,UNIVERSITY OF ST. AUGUSTINE FOR HEALTH S,FL,32084-4215,Proprietary  ,12,299,311,148,,1827,1975
03178400,CORAL RIDGE NURSES ASST TRAINING        ,FL,33306-0000,Proprietary  ,0,0,0,22,,68,90
03224300,NEW PROFESSIONS TECHNICAL INSTITUTE     ,FL,33134-1640,Proprietary  ,19,125,144,75,,642,717
03230300,CHOICE HIGH SCHOOL AND TECHNICAL CENTER ,FL,32547-1299,Public       ,17,93,110,149,,671,820
03238300,FLORIDA COLLEGE OF INTEGRATIVE MED      ,FL,32809-5721,Proprietary  ,11,82,93,144,,514,658
03255300,FLORIDA GULF COAST UNIVERSITY           ,FL,33965-6565,Public       ,1050,543,1593,18894,,6910,25804
03256300,YESHIVA GEDOLAH RABBINICAL COLLEGE      ,FL,33139-4708,Private      ,13,3,16,34,,18,52
03264300,SOUTH FLORIDA BIBLE COLLEGE AND THEOLOGI,FL,33441-5768,Private      ,1,15,16,20,,142,162
03346300,ACAD FOR PRAC NURSING & HEALTH OCCP     ,FL,33417-4574,Private      ,32,175,207,307,,1273,1580
03348400,PROFESSIONAL TRAINING CENTERS           ,FL,33184-0000,Proprietary  ,16,117,133,150,,762,912
03373300,BEACON COLLEGE                          ,FL,34748-5224,Private      ,16,26,42,193,,133,326
03374300,FLORIDA COASTAL SCHOOL OF LAW           ,FL,32256-0000,Proprietary  ,10,108,118,95,,2519,2614
03382300,BRADFORD-UNION AREA CAREERTECHNICAL CENT,FL,32091-2434,Public       ,9,57,66,66,,332,398
03390300,LINCOLN TECHNICAL INSTITUTE             ,FL,32730-2351,Proprietary  ,17,56,73,183,,446,629
03411400,INTERNATIONAL TRAINING CAREERS          ,FL,33155-1462,Private      ,5,78,83,55,,373,428
03414500,ACUPUNCTURE AND MASSAGE COLLEGE         ,FL,33176-1509,Proprietary  ,7,53,60,93,,388,481
03425400,CENTRAL FLORIDA INSTITUTE               ,FL,34684-4436,Proprietary  ,2,24,26,154,,560,714
03429600,ATLANTIC INST OF ORIENTAL MEDICINE      ,FL,33316-0000,Private      ,3,44,47,42,,259,301
03429700,EAST WEST COLLG OF NATURAL MEDICINE     ,FL,34236-4959,Proprietary  ,4,28,32,25,,252,277
03433400,NEW CONCEPT MASSAGE AND BEAUTY SCHO     ,FL,33135-0000,Proprietary  ,3,18,21,41,,106,147
03434300,FORTIS COLLEGE                          ,FL,32073-2999,Proprietary  ,15,72,87,138,,590,728
03480301,MEDVANCE INSTITUTE - FORT LAUDERDALE    ,FL,33313-7261,Proprietary  ,7,16,23,74,,269,343
03480302,MEDVANCE INSTITUTE - STUART             ,FL,34994-3000,Proprietary  ,16,90,106,146,,628,774
03491400,AMERICAN ADVANCED TECHNICIANS INST      ,FL,33014-4430,Proprietary  ,12,31,43,64,,145,209
03549300,ULTIMATE MEDICAL ACADEMY                ,FL,33756-4917,Proprietary  ,291,2807,3098,1575,,16719,18294
03553300,KEISER CAREER COLLEGE                   ,FL,32216-0000,Proprietary  ,51,250,301,369,,1548,1917
03557300,NORTH FLORIDA COSMETOLOGY INSTITUTE     ,FL,32312-0000,Proprietary  ,15,53,68,162,,451,613
03564300,"INTERNATIONAL SCHOOL OF HEALTH, BEAUTY &",FL,33311-1141,Proprietary  ,6,23,29,52,,213,265
03570400,ENGLISH CENTER (THE)                    ,FL,33133-2703,Public       ,3,56,59,31,,346,377
03611400,FLORIDA BARBER ACADEMY                  ,FL,33441-0000,Proprietary  ,9,73,82,50,,340,390
03618300,FLORIDA INSTITUTE OF ANIMAL ARTS        ,FL,32792-0000,Proprietary  ,24,36,60,185,,237,422
03627400,JACKSONVILLE BEAUTY INSTITUTE           ,FL,32208-1885,Proprietary  ,19,81,100,112,,398,510
03627600,FLORIDA EDUCATION INSTITUTE             ,FL,33144-5036,Proprietary  ,15,87,102,94,,452,546
03661400,SOUTH FLORIDA INSTITUTE OF TECHNOLO     ,FL,33135-0000,Proprietary  ,26,178,204,187,,1099,1286
03691400,AVE MARIA SCHOOL OF LAW                 ,FL,34119-1376,Private      ,10,17,27,91,,627,718
03696400,SABER                                   ,FL,33134-1604,Private      ,8,57,65,70,,615,685
03706300,AMERICAN INSTITUTE                      ,FL,33319-0000,Proprietary  ,8,50,58,76,,304,380
03757300,ADVANCE SCIENCE INSTITUTE               ,FL,33012-0000,Proprietary  ,9,17,26,33,,72,105
03801400,BEAUTY INSTITUTE (THE)                  ,FL,33409-2972,Proprietary  ,6,27,33,68,,182,250
03801401,BEAUTY INSTITUTE (THE) - MARGATE        ,FL,33068-5704,Proprietary  ,6,9,15,29,,81,110
03816300,ARTISTIC NAILS & BEAUTY ACADEMY         ,FL,33605-5919,Proprietary  ,36,117,153,177,,530,707
03823300,FLORIDA ACADEMY OF HEALTH & BEAUTY      ,FL,33311-0000,Proprietary  ,2,6,8,15,,56,71
03832300,DADE MEDICAL COLLEGE                    ,FL,33126-5534,Proprietary  ,104,552,656,1094,,4495,5589
03842500,CAMBRIDGE INSTITUTE OF ALLIED HEALTH    ,FL,32750-0000,Proprietary  ,11,35,46,50,,327,377
03856300,UNIVERSAL BEAUTY SCHOOL                 ,FL,33174-4406,Proprietary  ,9,31,40,30,,165,195
03856500,FLORIDA SCHOOL OF TRADITIONAL MIDWIFERY ,FL,32601-5507,Private      ,1,12,13,25,,182,207
03875300,MCI INSTITUTE OF TECHNOLOGY             ,FL,33409-4937,Proprietary  ,25,88,113,138,,447,585
03888300,DRAGON RISES COLLEGE OF ORIENTAL MEDICIN,FL,32601-5089,Proprietary  ,1,10,11,16,,94,110
03903500,SOUTHERN TECHNICAL COLLEGE              ,FL,32809-0000,Proprietary  ,46,376,422,316,,2132,2448
03906300,CAREER INSTITUTE OF FLORIDA             ,FL,33773-3434,Proprietary  ,0,0,0,5,,29,34
03907301,PAUL MITCHELL THE SCHOOL FT MYERS       ,FL,33907-0000,Proprietary  ,13,32,45,86,,163,249
03911300,TOTAL INTERNATIONAL CAREER INSTITUTE    ,FL,33012-0000,Proprietary  ,3,41,44,10,,168,178
03939300,WOLFORD COLLEGE                         ,FL,34108-1931,Proprietary  ,9,44,53,39,,340,379
03939400,CENTURA INSTITUTE                       ,FL,32807-3566,Proprietary  ,6,64,70,109,,507,616
03939600,DAYTONA COLLEGE                         ,FL,32174-8445,Proprietary  ,15,65,80,145,,524,669
03941300,AVE MARIA UNIVERSITY                    ,FL,34142-9505,Private      ,46,12,58,1406,,235,1641
03957400,NEW COLLEGE OF FLORIDA                  ,FL,34243-2109,Public       ,80,55,135,2059,,535,2594
03985300,COMMERCIAL DIVING ACADEMY               ,FL,32208-0000,Proprietary  ,68,163,231,380,,980,1360
03986300,AVIATOR COLLEGE OF AERONAUTICAL SCIENCE ,FL,34946-9022,Proprietary  ,12,30,42,88,,251,339
04016500,AMERICAN INSTITUTE OF BEAUTY            ,FL,33773-0000,Proprietary  ,13,74,87,95,,352,447
04029300,TRENDSETTERS OF FLORIDA SCHOOL OF BEAUTY,FL,32205-4737,Proprietary  ,5,23,28,30,,163,193
04038302,ATA COLLEGE-ATA CAREER EDUCATION        ,FL,34606-4300,Proprietary  ,14,66,80,102,,483,585
04083400,CAMBRIDGE INSTITUTE OF ALLIED HEALTH & T,FL,33484-6543,Proprietary  ,6,53,59,74,,366,440
04105400,PENSACOLA SCHOOL OF MASSAGE THERAPY & HE,FL,32504-7337,Proprietary  ,9,58,67,70,,354,424
04106300,PALM BEACH ACADEMY OF HEALTH & BEAUTY   ,FL,33403-2130,Proprietary  ,15,50,65,54,,157,211
04116400,FUTURE-TECH INSTITUTE                   ,FL,33135-4142,Proprietary  ,7,52,59,32,,235,267
04116600,TAYLOR COLLEGE                          ,FL,34420-8714,Proprietary  ,6,62,68,89,,873,962
04119400,AVEDA INSTITUTE - SAINT PETERSBURG      ,FL,33701-4242,Proprietary  ,58,137,195,444,,873,1317
04120400,HI-TECH SCHOOL OF COSMETOLOGY           ,FL,33174-0000,Proprietary  ,10,16,26,97,,151,248
04126900,ACADEMY OF CAREER TRAINING              ,FL,34741-4644,Proprietary  ,19,86,105,174,,475,649
04127400,DIGITAL MEDIA ARTS COLLEGE              ,FL,33431-5919,Proprietary  ,27,27,54,373,,298,671
04128400,MANAGEMENT RESOURCES INSTITUTE          ,FL,33126-5473,Proprietary  ,11,165,176,61,,990,1051
04129900,FLORIDA SCHOOL OF MASSAGE               ,FL,32608-5419,Proprietary  ,9,50,59,77,,286,363
04130400,SHEAR EXCELLENCE INTERNATIONAL HAIR ACAD,FL,33614-2783,Proprietary  ,6,34,40,46,,152,198
04133500,ACADEMY FOR FIVE ELEMENT ACUPUNCTURE    ,FL,32601-6811,Private      ,0,23,23,24,,140,164
04133900,FUTURA CAREER INSTITUTE                 ,FL,33012-3325,Proprietary  ,7,26,33,35,,156,191
04134800,AVEDA INSTITUTE - TALLAHASSEE           ,FL,32304-3186,Proprietary  ,61,113,174,449,,718,1167
04134900,ORANGE PARK BEAUTY ACADEMY              ,FL,32073-5524,Proprietary  ,0,0,0,8,,16,24
04135000,COZMO THE SCHOOL                        ,FL,34135-4810,Proprietary  ,5,15,20,20,,86,106
04135900,ALLIED HEALTH INSTITUTE                 ,FL,33068-0000,Proprietary  ,9,145,154,96,,1320,1416
04140800,NORTH FLORIDA ACADEMY                   ,FL,32065-7758,Proprietary  ,6,13,19,35,,104,139
04143000,VOCATIONAL INSTITUTE OF FLORIDA         ,FL,33135-1939,Proprietary  ,0,0,0,17,,42,59
04143100,PROFESSIONAL HANDS INSTITUTE            ,FL,33135-1939,Proprietary  ,1,11,12,12,,55,67
04145900,CELEBRITY SCHOOL OF BEAUTY              ,FL,33144-4153,Proprietary  ,20,33,53,98,,250,348
04146200,WALTON CAREER DEVELOPMENT CENTER        ,FL,32433-1557,Public       ,11,33,44,79,,262,341
04146300,MARCHMAN TECHNICAL EDUCATION CENTER     ,FL,34653-1211,Public       ,25,80,105,225,,420,645
04148500,MEDICAL INSTITUTE OF PALM BEACH         ,FL,33460-5042,Proprietary  ,10,44,54,93,,280,373
04150800,IMMOKALEE TECHNICAL CENTER              ,FL,34142-3146,Public       ,26,36,62,178,,227,405
04151500,AMERICAN ACADEMY OF COSMETOLOGY         ,FL,32065-8026,Proprietary  ,9,24,33,69,,183,252
04156300,UNIVERSITY OF FORT LAUDERDALE           ,FL,33313-5809,Private      ,5,11,16,79,,148,227
04156400,AVIATION INSTITUTE OF MAINTENANCE       ,FL,32803-6487,Proprietary  ,30,124,154,259,,709,968
04157100,AEROSIM FLIGHT ACADEMY                  ,FL,32773-9683,Proprietary  ,13,40,53,125,,251,376
04158300,FLAGLER TECHNICAL INSTITUTE             ,FL,32137-4714,Public       ,17,80,97,130,,448,578
04162000,JOSE MARIA VARGAS UNIVERSITY            ,FL,33025-4534,Proprietary  ,1,14,15,22,,120,142
04162500,HOLLYWOOD INSTITUTE OF BEAUTY CAREERS   ,FL,33020-4807,Proprietary  ,32,179,211,156,,777,933
04163000,SALON PROFESSIONAL ACADEMY (THE)        ,FL,33624-6321,Proprietary  ,12,25,37,103,,235,338
04163100,SALON PROFESSIONAL ACADEMY (THE)        ,FL,32607-1672,Proprietary  ,6,40,46,99,,251,350
04163200,SALON PROFESSIONAL ACADEMY (THE)        ,FL,32162-9311,Proprietary  ,16,32,48,86,,194,280
04164500,EUREKA INSTITUTE OF HEALTH AND BEAUTY   ,FL,33174-4205,Proprietary  ,1,23,24,29,,112,141
04164600,D. A. DORSEY EDUCATIONAL CENTER         ,FL,33147-6304,Public       ,3,29,32,55,,253,308
04167300,SALON PROFESSIONAL ACADEMY (THE)        ,FL,33904-4824,Proprietary  ,3,17,20,55,,136,191
04170300,BEAUTY ACADEMY OF SOUTH FLORIDA         ,FL,33012-3221,Proprietary  ,9,52,61,37,,227,264
04172300,ETERNITY COSMETOLOGY SCHOOL             ,FL,33415-5719,Proprietary  ,9,59,68,58,,222,280
04176800,PROGRESSIVE TRAINING CENTERS            ,FL,33060-9238,Proprietary  ,0,0,0,0,,4,4
04176900,AMERICAN HEALTH INSTITUTE               ,FL,34654-3743,Proprietary  ,4,21,25,46,,162,208
04182500,MILLENNIA ATLANTIC UNIVERSITY           ,FL,33178-2369,Proprietary  ,0,4,4,17,,68,85
04188300,FLORIDA ACADEMY                         ,FL,33966-1155,Proprietary  ,11,62,73,102,,363,465
04192100,AMERICAN MEDICAL ACADEMY                ,FL,33186-4830,Proprietary  ,18,46,64,178,,345,523
04195100,AMBIANCE BEAUTY & BARBER ACADEMY        ,FL,32935-8771,Proprietary  ,6,31,37,44,,160,204
04197600,"FLORIDA INSTITUTE OF RECORDING, SOUND AN",FL,32804-3309,Proprietary  ,24,61,85,245,,383,628
04204600,BEAUTY AND HEALTH INSTITUTE             ,FL,33626-2610,Proprietary  ,8,77,85,12,,127,139
04206300,FLORIDA VOCATIONAL INSTITUTE            ,FL,33155-3762,Proprietary  ,6,41,47,53,,227,280
04207900,SAE INSTITUTE OF TECHNOLOGY - MIAMI     ,FL,33160-4307,Proprietary  ,18,35,53,144,,261,405
04209500,SHEAR FINESSE HAIRSTYLING ACADEMY       ,FL,32208-5005,Proprietary  ,3,14,17,27,,100,127
04210800,ULTRASOUND MEDICAL INSTITUTE            ,FL,33462-4221,Proprietary  ,1,9,10,16,,65,81
04212600,COSMIX SCHOOL OF MAKEUP ARTISTRY        ,FL,33306-1640,Proprietary  ,6,19,25,6,,19,25
04213200,KAIZEN BEAUTY ACADEMY                   ,FL,33024-6609,Proprietary  ,1,5,6,17,,49,66
04214500,PRESTIGE HEALTH & BEAUTY SCIENCES ACADEM,FL,33160-4102,Proprietary  ,1,16,17,2,,50,52
04216600,AZURE COLLEGE                           ,FL,33169-5345,Proprietary  ,11,182,193,11,,182,193
04217800,BOCA BEAUTY ACADEMY                     ,FL,33434-4178,Proprietary  ,9,28,37,66,,206,272
04220200,MORE TECH INSTITUTE                     ,FL,33012-2165,Proprietary  ,3,21,24,5,,27,32
04221200,BLY'S SCHOOL OF COSMETOLOGY             ,FL,32601-4021,Proprietary  ,3,35,38,22,,148,170
04222100,ANTON AESTHETICS ACADEMY                ,FL,33416-4629,Proprietary  ,0,12,12,0,,15,15
04227500,MERRYFIELD SCHOOL OF PET GROOMING       ,FL,33334-4925,Proprietary  ,2,20,22,2,,20,22
04228900,BEAUTY ANATOMY INSTITUTE OF COSMETOLOGY ,FL,33069-4313,Proprietary  ,0,1,1,0,,1,1
00160500,CHAMINADE UNIV OF HONOLULU              ,HI,96816-1578,Private      ,99,204,303,2373,,2507,4880
00160600,BRIGHAM YOUNG UNIV-HAWAII CAMPUS        ,HI,96762-1294,Private      ,209,90,299,2132,,1082,3214
00161000,UNIVERSITY OF HAWAII AT MANOA           ,HI,96822-2399,Public       ,576,546,1122,15442,,9991,25433
00161100,UNIVERSITY OF HAWAII AT HILO            ,HI,96720-4091,Public       ,148,179,327,4174,,3240,7414
00161200,HONOLULU COMMUNITY COLLEGE              ,HI,96817-4598,Public       ,211,402,613,2806,,3613,6419
00161300,KAPIOLANI COMMUNITY COLLEGE             ,HI,96816-4421,Public       ,235,453,688,3898,,4254,8152
00161400,KAUAI COMMUNITY COLLEGE                 ,HI,96766-9591,Public       ,30,88,118,679,,870,1549
00161500,UNIVERSITY OF HAWAII MAUI COLLEGE       ,HI,96732-1644,Public       ,133,353,486,1903,,3199,5102
00454900,LEEWARD COMMUNITY COLLEGE               ,HI,96782-3393,Public       ,183,433,616,3121,,4117,7238
00525800,HAWAII COMMUNITY COLLEGE                ,HI,96720-4075,Public       ,116,242,358,1878,,2874,4752
00723401,HEALD COLLEGE - HONOLULU                ,HI,96814-0000,Proprietary  ,112,289,401,1050,,2406,3456
00727900,HAWAII PACIFIC UNIVERSITY               ,HI,96813-2882,Private      ,207,396,603,5320,,4409,9729
01122000,WINDWARD COMMUNITY COLLEGE              ,HI,96744-0000,Public       ,96,176,272,1151,,1802,2953
02100300,MED-ASSIST SCHOOL OF HAWAII             ,HI,96813-0000,Proprietary  ,18,44,62,157,,355,512
02107800,UNIVERSITY OF HAWAII - WEST OAHU        ,HI,96782-0000,Public       ,97,190,287,2278,,2574,4852
02139500,HAWAII INSTITUTE OF HAIR DESIGN         ,HI,96817-5195,Proprietary  ,19,34,53,118,,246,364
02159701,NEW HOPE CHRISTIAN COLLEGE - HAWAII     ,HI,96819-2228,Private      ,0,0,0,80,,97,177
03017800,TRAVEL INSTITUTE OF THE PACIFIC         ,HI,96814-1946,Proprietary  ,4,34,38,73,,228,301
03072500,WORLD MEDICINE INSTITUTE                ,HI,96826-0000,Private      ,5,21,26,52,,216,268
03735300,INST OF CLINICAL ACUPUNCTURE & ORIENT MD,HI,96813-2307,Proprietary  ,3,9,12,17,,132,149
03999400,TRADITIONAL CHINESE MEDICAL COLLEGE OF H,HI,96743-8324,Private      ,1,6,7,4,,55,59
04165200,MAUNA LOA HELICOPTERS                   ,HI,96740-2650,Proprietary  ,2,6,8,20,,79,99
04175100,PAUL MITCHELL THE SCHOOL HONOLULU       ,HI,96816-2433,Proprietary  ,15,34,49,154,,268,422
04182200,HAWAII MEDICAL INSTITUTE                ,HI,96814-3518,Proprietary  ,38,126,164,272,,728,1000
00161600,BOISE STATE UNIVERSITY                  ,ID,83725-1000,Public       ,626,934,1560,14880,,13094,27974
00161700,"COLLEGE OF IDAHO, THE                   ",ID,83605-4432,Private      ,81,85,166,1970,,700,2670
00161900,COLLEGE OF SOUTHERN IDAHO               ,ID,83301-0000,Public       ,216,461,677,3475,,4261,7736
00162000,IDAHO STATE UNIVERSITY                  ,ID,83209-5377,Public       ,393,663,1056,6224,,9055,15279
00162100,LEWIS-CLARK STATE COLLEGE               ,ID,83501-2698,Public       ,85,168,253,2600,,2742,5342
00162300,NORTH IDAHO COLLEGE                     ,ID,83814-2199,Public       ,198,530,728,3178,,5050,8228
00162400,NORTHWEST NAZARENE UNIVERSITY           ,ID,83686-5897,Private      ,56,138,194,1731,,1728,3459
00162500,BRIGHAM YOUNG UNIVERSITY-IDAHO          ,ID,83460-1650,Private      ,1523,1467,2990,13022,,11676,24698
00162600,UNIVERSITY OF IDAHO                     ,ID,83844-4291,Public       ,359,266,625,10911,,4905,15816
00732915,ITT TECHNICAL INSTITUTE                 ,ID,83713-1529,Proprietary  ,74,342,416,459,,1895,2354
00987300,MR JUAN'S CLG OF HAIR DESIGN            ,ID,83301-4154,Proprietary  ,2,17,19,41,,100,141
01113300,EASTERN IDAHO TECHNICAL COLLEGE         ,ID,83404-5788,Public       ,46,162,208,453,,1247,1700
02218000,CARRINGTON COLLEGE                      ,ID,83704-0000,Proprietary  ,55,243,298,488,,1837,2325
02234500,BOISE BIBLE COLLEGE                     ,ID,83714-1220,Private      ,11,12,23,214,,155,369
02275800,MR LEONS SCHOOL OF HAIR DESIGN          ,ID,83843-8384,Proprietary  ,1,8,9,17,,59,76
02275801,MR. LEON'S SCHOOL OF HAIR DESIGN        ,ID,83501-1910,Proprietary  ,2,1,3,12,,22,34
02314000,SCHOOL OF HAIRSTYLING (THE)             ,ID,83202-0000,Proprietary  ,1,5,6,22,,58,80
02319800,TONI&GUY HAIRDRESSING ACADEMY           ,ID,83814-2822,Proprietary  ,8,27,35,108,,184,292
02319801,TONI&GUY HAIRDRESSING ACADEMY - BOISE   ,ID,83705-2636,Proprietary  ,16,26,42,52,,111,163
02349200,HEADMASTERS SCHOOL OF HAIR DESIGN       ,ID,83501-0000,Proprietary  ,2,8,10,30,,69,99
02559500,RAZZLE DAZZLE CLG OF HAIR DESIGN        ,ID,83686-5104,Proprietary  ,13,33,46,102,,209,311
02607100,PAUL MITCHELL THE SCHOOL BOISE          ,ID,83709-1662,Proprietary  ,24,30,54,187,,261,448
03098700,ACADEMY OF COURT REPORTING              ,ID,83704-8320,Proprietary  ,24,70,94,147,,414,561
03832400,COSMETOLOGY SCHOOL OF ARTS & SCIENCES   ,ID,83318-1327,Proprietary  ,4,5,9,19,,72,91
04051323,ART INSTITUTE OF PHOENIX (THE) - BROWN M,ID,83709-2746,Proprietary  ,8,29,37,81,,197,278
04134300,EVANS HAIRSTYLING COLLEGE               ,ID,83440-5277,Proprietary  ,13,6,19,83,,50,133
04144500,HAIR ACDMY PAUL MITCHELL PARTNER SCHOOL ,ID,83440-2600,Proprietary  ,13,12,25,118,,141,259
04150600,D & L ACADEMY OF HAIR DESIGN            ,ID,83301-6229,Proprietary  ,4,10,14,24,,71,95
04155200,OLIVER FINLEY ACADEMY OF COSMETOLOGY    ,ID,83704-8011,Proprietary  ,26,47,73,157,,330,487
04163800,MASTER EDUCATORS BEAUTY SCHOOL          ,ID,83301-4118,Proprietary  ,3,11,14,39,,62,101
04168600,COLLEGE OF MASSAGE THERAPY              ,ID,83221-1758,Proprietary  ,3,13,16,27,,65,92
04176700,D'SHAW INSTITUTE OF COSMETOLOGY         ,ID,83704-4406,Proprietary  ,13,19,32,49,,108,157
04194800,VELVET TOUCH ACADEMY OF COSMETOLOGY     ,ID,83687-5020,Proprietary  ,12,24,36,64,,121,185
04203200,BOISE BARBER COLLEGE                    ,ID,83704-5919,Proprietary  ,3,18,21,34,,97,131
04203500,AUSTIN KADE ACADEMY                     ,ID,83404-5540,Proprietary  ,9,52,61,91,,273,364
04207200,ACADEMY DI FIRENZE                      ,ID,83338-2329,Proprietary  ,2,4,6,13,,43,56
04211800,COLLEGE OF WESTERN IDAHO                ,ID,83687-5505,Public       ,420,1053,1473,5060,,9564,14624
00163200,AQUINAS INSTITUTE OF THEOLOGY           ,MO,63108-3323,Private      ,0,15,15,4,,100,104
00244900,AVILA COLLEGE                           ,MO,64145-1698,Private      ,60,148,208,1599,,1915,3514
00245000,CALVARY BIBLE COLLEGE                   ,MO,64147-1341,Private      ,9,21,30,193,,237,430
00245200,CENTRAL BIBLE COLLEGE                   ,MO,65803-1096,Private      ,0,0,0,188,,148,336
00245300,CENTRAL METHODIST UNIVERSITY            ,MO,65248-1198,Private      ,59,164,223,1909,,2423,4332
00245400,UNIVERSITY OF CENTRAL MISSOURI          ,MO,64093-5178,Public       ,303,390,693,9885,,5347,15232
00245600,COLUMBIA COLLEGE                        ,MO,65216-4581,Private      ,224,2039,2263,3553,,23026,26579
00245700,CONCORDIA SEMINARY                      ,MO,63105-3199,Private      ,0,4,4,6,,436,442
00245800,COTTEY COLLEGE                          ,MO,64772-2790,Private      ,12,6,18,370,,96,466
00245900,CROWDER COLLEGE                         ,MO,64850-9165,Public       ,127,358,485,2754,,3451,6205
00246000,CULVER STOCKTON COLLEGE                 ,MO,63435-1299,Private      ,30,18,48,1276,,235,1511
00246100,DRURY UNIVERSITY                        ,MO,65802-3791,Private      ,116,343,459,2806,,4317,7123
00246200,EDEN THEOLOGICAL SEMINARY               ,MO,63119-0000,Private      ,0,4,4,3,,172,175
00246300,EVANGEL UNIVERSITY                      ,MO,65802-2125,Private      ,74,95,169,2652,,1202,3854
00246302,EVANGEL UNIVERSITY - ASSEMBLIES OF GOD T,MO,65802-2131,Private      ,7,21,28,22,,259,281
00246400,FONTBONNE UNIVERSITY                    ,MO,63105-3098,Private      ,38,210,248,1397,,2571,3968
00246600,HARRIS-STOWE STATE COLLEGE              ,MO,63103-2199,Public       ,63,200,263,1567,,2200,3767
00246700,CONCEPTION SEMINARY COLLEGE             ,MO,64433-0502,Private      ,2,2,4,61,,16,77
00246800,JEFFERSON COLLEGE                       ,MO,63050-2441,Public       ,127,336,463,2909,,3365,6274
00247100,ST LOUIS COMMUNITY COLLEGE              ,MO,63102-0000,Public       ,734,1994,2728,12479,,18840,31319
00247300,KANSAS CITY ART INSTITUTE               ,MO,64111-1874,Private      ,49,56,105,1400,,527,1927
00247400,KANSAS CITY UNIV OF MED AND BIOSCIENCES ,MO,64106-0000,Private      ,7,36,43,117,,1235,1352
00247600,KENRICK-GLENNON SEMINARY                ,MO,63119-4330,Private      ,2,2,4,28,,10,38
00247700,A.T. STILL UNIV OF HEALTH SCIENCES      ,MO,63501-0000,Private      ,2,76,78,27,,2808,2835
00247900,LINCOLN UNIVERSITY                      ,MO,65101-3500,Public       ,68,147,215,2409,,1964,4373
00248000,LINDENWOOD UNIVERSITY                   ,MO,63301-1695,Private      ,265,591,856,7406,,8027,15433
00248200,MARYVILLE UNIVERSITY                    ,MO,63141-7299,Private      ,81,533,614,2759,,4683,7442
00248400,METROPOLITAN COMMUNITY COLLEGE          ,MO,64111-2408,Public       ,728,2012,2740,10730,,16630,27360
00248500,MIDWESTERN BAPTIST THEOL SEMINARY       ,MO,64118-4697,Private      ,5,58,63,100,,414,514
00248600,MINERAL AREA COLLEGE                    ,MO,63601-1000,Public       ,127,339,466,2305,,2780,5085
00248800,MISSOURI SOUTHERN STATE UNIVERSITY      ,MO,64801-1595,Public       ,146,255,401,4545,,4057,8602
00248900,MISSOURI VALLEY COLLEGE                 ,MO,65340-3197,Private      ,51,36,87,1815,,517,2332
00249000,MISSOURI WESTERN STATE UNIVERSITY       ,MO,64507-2294,Public       ,160,213,373,4841,,3053,7894
00249100,MOBERLY AREA COMMUNITY COLLEGE          ,MO,65270-1304,Public       ,184,400,584,3401,,3793,7194
00249400,NAZARENE THEOLOGICAL SEMINARY           ,MO,64131-1246,Private      ,1,10,11,7,,200,207
00249500,TRUMAN STATE UNIVERSITY                 ,MO,63501-4221,Public       ,150,45,195,6123,,675,6798
00249600,NORTHWEST MISSOURI STATE UNIV           ,MO,64468-6001,Public       ,148,110,258,6684,,1533,8217
00249800,PARK UNIVERSITY                         ,MO,64152-3795,Private      ,73,1108,1181,1739,,9780,11519
00249900,ROCKHURST UNIVERSITY                    ,MO,64110-2561,Private      ,75,114,189,2507,,1582,4089
00250000,COLLEGE OF THE OZARKS                   ,MO,65726-2502,Private      ,141,37,178,3620,,445,4065
00250100,SOUTHEAST MISSOURI STATE UNIV           ,MO,63701-4799,Public       ,289,370,659,9236,,4948,14184
00250200,SOUTHWEST BAPTIST UNIVERSITY            ,MO,65613-2597,Private      ,66,116,182,2290,,1893,4183
00250300,MISSOURI STATE UNIVERSITY               ,MO,65897-0094,Public       ,612,668,1280,17005,,9402,26407
00250400,ST LOUIS COLLEGE OF PHARMACY            ,MO,63110-1088,Private      ,23,39,62,917,,833,1750
00250600,SAINT LOUIS UNIVERSITY                  ,MO,63103-2097,Private      ,277,462,739,11056,,8511,19567
00250900,SAINT PAUL SCHOOL OF THEOLOGY           ,MO,64127-2499,Private      ,1,16,17,7,,129,136
00251200,STEPHENS COLLEGE                        ,MO,65215-0001,Private      ,22,54,76,960,,718,1678
00251400,NORTH CENTRAL MISSOURI COLLEGE          ,MO,64683-1824,Public       ,34,108,142,988,,1081,2069
00251600,UNIVERSITY OF MISSOURI-COLUMBIA         ,MO,65211-1600,Public       ,890,556,1446,28966,,9660,38626
00251700,MISSOURI UNIVERSITY OF SCIENCE & TECHNOL,MO,65409-0250,Public       ,189,113,302,6249,,1566,7815
00251800,UNIVERSITY OF MISSOURI-KANSAS CITY      ,MO,64110-2497,Public       ,317,723,1040,8994,,10919,19913
00251900,UNIVERSITY OF MISSOURI-ST LOUIS         ,MO,63121-4499,Public       ,288,791,1079,7910,,11779,19689
00252000,WASHINGTON UNIVERSITY                   ,MO,63130-4899,Private      ,437,304,741,15152,,5717,20869
00252001,WASHINGTON UNIV-SCHOOL OF MEDICINE      ,MO,63110-0000,Private      ,8,35,43,230,,1514,1744
00252100,WEBSTER UNIVERSITY                      ,MO,63119-3194,Private      ,122,1050,1172,3807,,13632,17439
00252200,WENTWORTH MILITARY ACADEMY              ,MO,64067-1799,Private      ,17,21,38,392,,267,659
00252300,WESTMINSTER COLLEGE                     ,MO,65251-1299,Private      ,33,12,45,1330,,214,1544
00252400,WILLIAM JEWELL COLLEGE                  ,MO,64068-1896,Private      ,35,27,62,1371,,353,1724
00252500,WILLIAM WOODS UNIVERSITY                ,MO,65251-2388,Private      ,30,203,233,1200,,1397,2597
00405704,NATIONAL AMERICAN UNIVERSITY            ,MO,64057-1791,Proprietary  ,6,65,71,66,,788,854
00439800,COX HEALTH SYSTEM SCHOOL OF RADIOLOGIC T,MO,65802-0000,Private      ,0,0,0,4,,31,35
00441300,MERCY HOSPITAL SPRINGFIELD SCHOOL OF RAD,MO,65804-2263,Private      ,8,38,46,134,,295,429
00470300,LOGAN COLLEGE OF CHIROPRACTIC           ,MO,63006-1065,Private      ,6,76,82,73,,1028,1101
00470700,COVENANT THEOLOGICAL SEMINARY           ,MO,63141-8697,Private      ,1,17,18,3,,514,517
00471100,LINN STATE TECHNICAL COLLEGE            ,MO,65051-9607,Public       ,38,62,100,1577,,619,2196
00471300,THREE RIVERS COMMUNITY COLLEGE          ,MO,63901-2393,Public       ,137,418,555,2201,,4114,6315
00528800,KIRKSVILLE AREA TECHNICAL CENTER        ,MO,63501-0000,Public       ,2,10,12,41,,95,136
00528900,WAYNESVILLE CAREER CENTER               ,MO,65583-2131,Public       ,4,22,26,63,,184,247
00542400,SOUTH CENTRAL CAREER CENTER             ,MO,65775-3334,Public       ,3,32,35,52,,175,227
00542600,SIKESTON CAREER AND TECHNOLOGY CTR      ,MO,63801-0000,Public       ,6,43,49,85,,344,429
00542900,ROLLA TECHNICAL INSTITUTE               ,MO,65401-3601,Public       ,26,51,77,335,,444,779
00543000,POPLAR BLUFF TECHNICAL CAREER CNTR      ,MO,63901-0000,Public       ,5,30,35,75,,274,349
00543800,SALINE COUNTY CAREER CENTER             ,MO,65340-0000,Public       ,0,4,4,17,,61,78
00544500,TRUMAN MEDICAL CENTER SCHOOL OF NURSE AN,MO,64108-2677,Private      ,7,29,36,74,,272,346
00553100,GRAND RIVER TECHNICAL SCHOOL            ,MO,64601-1299,Public       ,1,5,6,77,,68,145
00553200,CAPE GIRARDEAU CAREER & TECHNOLOGY CENTE,MO,63703-7511,Public       ,11,59,70,325,,690,1015
00638900,BARNES JEWISH COLLEGE OF NURSING AND ALL,MO,63110-1091,Private      ,37,93,130,717,,1374,2091
00639200,RESEARCH COLLEGE OF NURSING             ,MO,64132-1199,Proprietary  ,1,49,50,147,,424,571
00639201,RESEARCH MEDICAL CENTER - COLLEGE OF NUR,MO,64132-1199,Proprietary  ,2,22,24,67,,219,286
00639202,RESEARCH MED CTR SCHL OF RAD TECH       ,MO,64132-0000,Proprietary  ,2,14,16,30,,116,146
00666600,LUTHERAN  SCHOOL OF NURSING             ,MO,63118-3909,Proprietary  ,12,51,63,164,,653,817
00732923,ITT TECHNICAL INSTITUTE                 ,MO,63045-1122,Proprietary  ,136,526,662,774,,3705,4479
00754000,MISSOURI BAPTIST UNIVERSITY             ,MO,63141-8698,Private      ,79,252,331,1952,,2912,4864
00808000,STATE FAIR COMMUNITY COLLEGE            ,MO,65301-0000,Public       ,145,454,599,2735,,3881,6616
00826900,HILLYARD TECHNICAL CENTER               ,MO,64506-0000,Public       ,3,37,40,184,,363,547
00855200,STEVENS INSTITUTE OF BUSINESS & ARTS    ,MO,63103-0000,Proprietary  ,7,24,31,133,,300,433
00860600,TRI-COUNTY TECHNICAL SCHOOL             ,MO,65026-0000,Public       ,1,7,8,17,,56,73
00886200,EAST CENTRAL COLLEGE                    ,MO,63084-0529,Public       ,139,281,420,2307,,2701,5008
00908900,HANNIBAL-LAGRANGE COLLEGE               ,MO,63401-1999,Private      ,21,46,67,919,,612,1531
00952000,NATIONAL ACADEMY OF BEAUTY ARTS         ,MO,63128-1307,Proprietary  ,26,43,69,160,,360,520
00959000,INDEPENDENCE COLLEGE OF COSMETOLOGY     ,MO,64055-1105,Proprietary  ,7,24,31,60,,156,216
00960700,HOUSE OF HEAVILIN BEAUTY COLLEGE        ,MO,64110-2826,Proprietary  ,3,26,29,43,,181,224
00978200,SAINT LUKE'S COLLEGE OF HEALTH SCIENCES ,MO,64114-3237,Private      ,16,52,68,274,,668,942
00979500,MISSOURI COLLEGE                        ,MO,63144-2901,Proprietary  ,31,105,136,246,,680,926
01014814,COLORADO TECHNL UNIV NORTH KANSAS CITY  ,MO,64116-3614,Proprietary  ,7,65,72,61,,452,513
01027900,HICKEY COLLEGE                          ,MO,63146-0000,Proprietary  ,29,44,73,584,,463,1047
01040500,PINNACLE CAREER INSTITUTE               ,MO,64131-3367,Proprietary  ,31,268,299,198,,1534,1732
01040501,PINNACLE CAREER INSTITUTE - NORTH KANSAS,MO,64153-1151,Proprietary  ,12,52,64,82,,422,504
01050303,WICHITA TECHNICAL INSTITUTE - WTI JOPLIN,MO,64801-2970,Proprietary  ,11,43,54,62,,374,436
01102600,WARRENSBURG AREA VOC TECH SCH           ,MO,64093-0000,Public       ,2,21,23,56,,123,179
01173500,PIKE/LINCOLN TECHNICAL CENTER           ,MO,63344-0000,Public       ,2,3,5,42,,75,117
01250000,RANKEN TECHNICAL COLLEGE                ,MO,63113-2811,Private      ,122,291,413,1823,,2432,4255
01258000,ST LOUIS CHRISTIAN COLLEGE              ,MO,63033-6499,Private      ,14,16,30,178,,202,380
01320800,BAPTIST BIBLE COLLEGE                   ,MO,65803-3498,Private      ,8,25,33,277,,265,542
02056100,FOUR RIVERS CAREER CENTER               ,MO,63090-0000,Public       ,1,11,12,29,,75,104
02066900,NICHOLS CAREER CENTER                   ,MO,65101-2814,Public       ,0,0,0,74,,144,218
02068200,COX HEALTH - COX COLLEGE                ,MO,65802-0000,Private      ,32,129,161,440,,1338,1778
02090400,BOONSLICK TECHNICAL EDUCATION CTR       ,MO,65233-0000,Public       ,0,0,0,12,,40,52
02119204,COURT REPORTING INSTITUTE OF DALLAS - CO,MO,63105-3329,Proprietary  ,4,39,43,17,,224,241
02121100,MIDWEST INSTITUTE                       ,MO,63122-0000,Proprietary  ,8,32,40,62,,211,273
02124500,FRANKLIN TECHNOLOGY CENTER              ,MO,64801-0000,Public       ,2,31,33,137,,475,612
02142200,LEX LA RAY TECHNICAL CENTER             ,MO,64067-0000,Public       ,2,8,10,34,,78,112
02154900,MISSOURI SCH OF BARB & HAIR             ,MO,63031-0000,Proprietary  ,2,19,21,28,,96,124
02164200,FOREST INST PROFESSIONAL PSYCHOLOGY     ,MO,65807-0000,Private      ,4,26,30,26,,370,396
02165900,CHILLICOTHE BEAUTY ACADEMY              ,MO,64601-0000,Proprietary  ,2,3,5,14,,40,54
02180200,METRO BUSINESS COLLEGE                  ,MO,63701-0000,Proprietary  ,13,106,119,155,,788,943
02188000,NORTHWEST TECHNICAL SCHOOL              ,MO,64468-0000,Public       ,4,9,13,54,,74,128
02188100,NORTHLAND CAREER CENTER                 ,MO,64079-8333,Public       ,0,2,2,29,,71,100
02202700,OZARK CHRISTIAN COLLEGE                 ,MO,64801-0000,Private      ,17,19,36,762,,248,1010
02203400,NEVADA REGIONAL TECHNICAL CENTER        ,MO,64772-0000,Public       ,1,9,10,53,,85,138
02205200,SANFORD-BROWN COLLEGE                   ,MO,63026-7305,Proprietary  ,5,24,29,78,,315,393
02205203,SANFORD BROWN COLLEGE-ST. PETERS        ,MO,63376-5950,Proprietary  ,4,25,29,50,,204,254
02214500,SALEM COLLEGE OF HAIRSTYLING            ,MO,65401-0000,Proprietary  ,4,7,11,21,,50,71
02239200,ANTHEM COLLEGE                          ,MO,63043-0000,Proprietary  ,13,45,58,144,,448,592
02239202,ANTHEM COLLEGE - METRO SOUTH            ,MO,63026-0000,Proprietary  ,21,54,75,107,,334,441
02250600,EVEREST COLLEGE                         ,MO,65807-2446,Proprietary  ,23,124,147,173,,831,1004
02263106,ANTHEM COLLEGE - ANTHEM COLLEGE - KANSAS,MO,64114-3232,Proprietary  ,4,18,22,69,,201,270
02263400,LAKE CAREER AND TECHNICAL CENTER        ,MO,65020-0000,Public       ,1,13,14,25,,56,81
02266400,CENTRAL CHRISTIAN CLG OF THE BIBLE      ,MO,65270-0000,Private      ,7,14,21,242,,192,434
02277500,HOUSE OF HEAVILIN OF BLUE SPRINGS       ,MO,64014-3953,Proprietary  ,4,21,25,53,,142,195
02289200,COLUMBIA AREA CAREER CENTER             ,MO,65203-0000,Public       ,12,45,57,212,,576,788
02295700,MISSOURI BEAUTY ACADEMY                 ,MO,63640-1827,Proprietary  ,4,16,20,56,,134,190
02300105,EVEREST COLLEGE - EARTH CITY            ,MO,63045-1100,Proprietary  ,30,120,150,200,,771,971
02304000,MISSOURI TECH                           ,MO,63303-3887,Proprietary  ,9,37,46,95,,240,335
02309100,AMERICAN COLLEGE OF HAIR DESIGN         ,MO,65301-2144,Proprietary  ,2,12,14,25,,79,104
02313000,CASS CAREER CENTER                      ,MO,64701-0000,Public       ,0,6,6,21,,80,101
02340500,ST LOUIS COLLEGE OF HEALTH CAREERS      ,MO,63110-0000,Proprietary  ,49,200,249,394,,1384,1778
02342100,CAREER & TECHNOLOGY CTR AT FT OSAGE     ,MO,64058-0000,Public       ,2,20,22,26,,85,111
02361600,CONCORDE CAREER COLLEGE                 ,MO,64111-0000,Proprietary  ,59,281,340,455,,1845,2300
02497500,CLINTON TECHNICAL SCHOOL                ,MO,64735-2966,Public       ,3,16,19,26,,94,120
02520800,MERRELL UNIV OF BTY ARTS & SCIENCES     ,MO,65109-0000,Proprietary  ,12,27,39,91,,212,303
02530600,SAINT CHARLES COMMUNITY COLLEGE         ,MO,63376-0975,Public       ,282,422,704,4741,,3618,8359
02543800,PARIS II EDUCATIONAL CENTER (THE)       ,MO,64118-0000,Proprietary  ,4,19,23,56,,143,199
02564700,ELAINE STEVEN BEAUTY COLLEGE            ,MO,63136-0000,Proprietary  ,15,40,55,105,,284,389
02564701,ELAINE STEVEN BEAUTY COLLEGE - ADVANCE B,MO,63383-2006,Proprietary  ,0,2,2,10,,9,19
02564702,ELAINE STEVEN BEAUTY COLLEGE - ADVANCE B,MO,63401-2269,Proprietary  ,1,2,3,17,,32,49
02568500,GRABBER SCHOOL OF HAIR DESIGN           ,MO,63011-0000,Proprietary  ,12,28,40,96,,167,263
02599700,VATTEROTT COLLEGE                       ,MO,63134-2900,Proprietary  ,64,282,346,473,,1945,2418
02599701,VATTEROTT COLLEGE - KANSAS CITY         ,MO,64117-0000,Proprietary  ,18,213,231,187,,1332,1519
02599702,VATTEROTT COLLEGE - SPRINGFIELD LOCATION,MO,65807-5340,Proprietary  ,17,125,142,140,,802,942
02599703,VATTEROTT COLLEGE - JOPLIN              ,MO,64801-5033,Proprietary  ,11,87,98,78,,587,665
02599705,VATTEROTT COLLEGE - SUNSET HILLS        ,MO,63127-1516,Proprietary  ,14,101,115,161,,839,1000
02599712,VATTEROTT COLLEGE - O'FALLON            ,MO,63366-2748,Proprietary  ,22,112,134,119,,515,634
02599714,VATTEROTT COLLEGE - EX'TREME INSTITUTE B,MO,63102-2115,Proprietary  ,59,110,169,374,,734,1108
02599715,VATTEROTT COLLEGE - PERSONAL FITNESS AND,MO,63132-3251,Proprietary  ,0,1,1,8,,13,21
02608000,NEOSHO BEAUTY COLLEGE                   ,MO,64850-1525,Proprietary  ,4,11,15,25,,54,79
02609202,VATTEROTT COLLEGE-ST JOSEPH             ,MO,64501-2911,Proprietary  ,7,94,101,122,,490,612
02609203,VATTEROTT COLLEGE - L'ECOLE CULINAIRE   ,MO,63124-1103,Proprietary  ,13,83,96,172,,567,739
02609206,VATTEROTT COLLEGE - L'ECOLE CULINAIRE   ,MO,64112-2110,Proprietary  ,14,79,93,31,,206,237
02611004,HERITAGE COLLEGE-KANSAS CITY            ,MO,64131-4203,Proprietary  ,28,140,168,254,,972,1226
03042400,LEBANON TECHNOLOGY & CAREER CENTER      ,MO,65536-3296,Public       ,9,28,37,103,,217,320
03066300,BRYAN CAREER COLLEGE                    ,MO,65806-2507,Proprietary  ,23,186,209,119,,898,1017
03066303,BRYAN COLLEGE - COLUMBIA                ,MO,65201-8248,Proprietary  ,12,61,73,120,,480,600
03068600,SPECIAL SCHOOL DISTRICT OF ST. LOUIS CO.,MO,63127-0000,Public       ,8,59,67,56,,569,625
03070200,CENTRAL COLLEGE OF COSMETOLOGY          ,MO,65583-0000,Proprietary  ,8,16,24,43,,115,158
03070900,SE MO HOSP CLG NURSING & HEALTH SCI     ,MO,63703-4507,Private      ,12,34,46,191,,500,691
03072800,DALLAS COUNTY CAREER CENTER             ,MO,65685-9152,Public       ,0,0,0,1,,9,10
03077200,COSMETOLOGY CONCEPTS INSTITUTE          ,MO,65202-1972,Proprietary  ,5,17,22,63,,129,192
03083000,OZARKS TECHNICAL COMMUNITY COLLEGE      ,MO,65802-3601,Public       ,575,1501,2076,8773,,13257,22030
03092600,MESSENGER COLLEGE                       ,MO,64804-0000,Private      ,0,25,25,38,,82,120
03097600,ST LOUIS HAIR ACADEMY                   ,MO,63107-1737,Proprietary  ,6,25,31,46,,147,193
03101000,NEW DIMENSION SCHOOL OF HAIR DESIGN     ,MO,64801-5017,Proprietary  ,4,18,22,27,,95,122
03106000,MISSOURI STATE UNIVERSITY - WEST PLAINS ,MO,65775-2715,Public       ,67,191,258,1349,,1501,2850
03110900,HOUSE OF HEAVILIN BEAUTY COLLEGE        ,MO,64083-9195,Proprietary  ,1,8,9,25,,64,89
03174300,HERNDON CAREER CENTER                   ,MO,64138-2695,Public       ,2,5,7,25,,20,45
03519300,MISSOURI COLLEGE OF COSMETOLOGY NORTH   ,MO,65803-0000,Proprietary  ,10,36,46,81,,213,294
03579300,TEXAS COUNTY TECHNICAL INSTITUTE        ,MO,65483-2700,Private      ,3,31,34,44,,273,317
03616300,AVIATION INSTITUTE OF MAINTENANCE       ,MO,64129-1811,Proprietary  ,3,20,23,44,,245,289
03878300,PROFESSIONAL MASSAGE TRAINING CENTER    ,MO,65803-2939,Proprietary  ,1,17,18,35,,140,175
03916300,ECLIPS SCHOOL OF COSMETOLOGY AND BARBERI,MO,63703-5809,Proprietary  ,9,42,51,58,,264,322
03924300,HAIR ACADEMY 110 (THE)                  ,MO,63501-2915,Proprietary  ,1,4,5,20,,23,43
03970400,WELLSPRING SCHOOL OF ALLIED HEALTH      ,MO,64114-3313,Proprietary  ,14,57,71,60,,232,292
04037500,ACADEMY OF HAIR DESIGN                  ,MO,65804-2303,Proprietary  ,12,39,51,102,,262,364
04051329,ART INSTITUTE OF PHOENIX (THE) - BROWN M,MO,63026-2564,Proprietary  ,4,22,26,90,,178,268
04118700,AMERICAN COLLEGE OF TECHNOLOGY          ,MO,64506-2006,Proprietary  ,4,91,95,28,,763,791
04119100,CITY VISION COLLEGE                     ,MO,64141-3188,Private      ,1,15,16,14,,118,132
04122300,GRANTHAM UNIVERSITY                     ,MO,64153-2262,Proprietary  ,103,1969,2072,503,,11098,11601
04130300,VICTORY TRADE SCHOOL                    ,MO,65803-2754,Private      ,0,13,13,19,,108,127
04130600,"CENTER FOR HEALING ARTS (THE), LLC      ",MO,63143-2103,Proprietary  ,6,28,34,35,,173,208
04133300,TREND SETTERS SCHOOL OF COSMETOLOGY     ,MO,63702-7607,Proprietary  ,9,22,31,65,,151,216
04145200,TRANSFORMED BARBER AND COSMETOLOGY ACADE,MO,64137-1207,Proprietary  ,8,36,44,70,,223,293
04145700,THE SYSTEM A PAUL MITCHELL PARTNER SCHL ,MO,65807-5969,Proprietary  ,12,23,35,144,,206,350
04146100,URSHAN GRADUATE SCHOOL OF THEOLOGY      ,MO,63031-7526,Private      ,2,5,7,41,,61,102
04152200,CARTHAGE R-9 SCHOOL DISTRICT/CARTHAGE TE,MO,64836-1332,Public       ,1,6,7,16,,52,68
04170600,SALON PROFESSIONAL ACADEMY (THE)        ,MO,63301-1021,Proprietary  ,14,23,37,57,,132,189
04170700,PAUL MITCHELL THE SCHOOL ST LOUIS       ,MO,63108-1554,Proprietary  ,21,55,76,214,,311,525
04173900,COSMETOLOGY COLLEGE OF FRANKLIN COUNTY  ,MO,63077-3448,Proprietary  ,3,10,13,22,,38,60
04174000,SKIN INSTITUTE                          ,MO,63128-1307,Proprietary  ,4,28,32,24,,119,143
04174800,AMERICAN TRADE SCHOOL                   ,MO,63074-1807,Proprietary  ,2,36,38,32,,199,231
04179000,"SALON PROFESSIONAL ACADEMY, THE         ",MO,65616-7216,Proprietary  ,4,10,14,8,,21,29
04184400,SEYMOUR BEAUTY ACADEMY                  ,MO,65746-8743,Proprietary  ,2,7,9,8,,45,53
04187000,DONNA'S ACADEMY OF HAIR DESIGN          ,MO,64089-9042,Proprietary  ,3,1,4,22,,30,52
04212100,ACADEMY OF SALON PROFESSIONALS          ,MO,65301-6910,Proprietary  ,4,8,12,27,,66,93
04218400,CITY POINTE BEAUTY ACADEMY              ,MO,64870-2502,Proprietary  ,8,7,15,35,,53,88
00314600,WESTERN OKLAHOMA STATE COLLEGE          ,OK,73521-1397,Public       ,26,100,126,739,,1127,1866
00314700,BACONE COLLEGE                          ,OK,74403-1597,Private      ,41,74,115,1237,,831,2068
00314900,SOUTHERN NAZARENE UNIVERSITY            ,OK,73008-2694,Private      ,42,182,224,1230,,2073,3303
00315000,CAMERON UNIVERSITY                      ,OK,73505-6377,Public       ,136,415,551,2508,,4589,7097
00315100,OKLAHOMA WESLEYAN UNIVERSITY            ,OK,74006-6299,Private      ,42,105,147,1061,,1215,2276
00315200,UNIV OF CENTRAL OKLAHOMA                ,OK,73034-5209,Public       ,461,708,1169,10703,,8809,19512
00315300,CONNORS STATE COLLEGE                   ,OK,74469-9700,Public       ,64,137,201,1409,,1825,3234
00315400,EAST CENTRAL UNIVERSITY                 ,OK,74820-6999,Public       ,150,221,371,2978,,2913,5891
00315500,EASTERN OKLAHOMA STATE COLLEGE          ,OK,74578-4999,Public       ,46,108,154,917,,1294,2211
00315600,REDLANDS COMMUNITY COLLEGE              ,OK,73036-5304,Public       ,60,136,196,846,,1249,2095
00315700,LANGSTON UNIVERSITY                     ,OK,73050-0000,Public       ,137,163,300,2508,,2272,4780
00315800,MURRAY STATE COLLEGE                    ,OK,73460-3137,Public       ,61,165,226,1260,,1735,2995
00316000,NORTHEASTERN OKLAHOMA A & M COLLEGE     ,OK,74354-6497,Public       ,90,134,224,1921,,1451,3372
00316100,NORTHEASTERN STATE UNIVERSITY           ,OK,74464-2399,Public       ,181,411,592,5519,,6647,12166
00316200,NORTHERN OKLAHOMA COLLEGE               ,OK,74653-0310,Public       ,120,195,315,2195,,2259,4454
00316300,NORTHWESTERN OKLAHOMA STATE UNIV        ,OK,73717-2799,Public       ,76,79,155,1734,,1111,2845
00316400,OKLAHOMA BAPTIST UNIVERSITY             ,OK,74801-2590,Private      ,136,48,184,3065,,602,3667
00316500,OKLAHOMA CHRISTIAN UNIVERSITY           ,OK,73131-0000,Private      ,96,130,226,2596,,1128,3724
00316600,OKLAHOMA CITY UNIVERSITY                ,OK,73106-1493,Private      ,123,259,382,2962,,3038,6000
00316700,UNIV OF SCIENCE & ARTS OF OKLAHOMA      ,OK,73018-5322,Public       ,41,45,86,828,,543,1371
00316800,ROGERS STATE UNIVERSITY                 ,OK,74017-3252,Public       ,120,232,352,2959,,3331,6290
00317000,OKLAHOMA STATE UNIVERSITY               ,OK,74078-1026,Public       ,834,620,1454,19984,,9097,29081
00317200,OKLAHOMA STATE UNIVERSITY-OKMULGEE      ,OK,74447-3901,Public       ,143,218,361,2192,,2201,4393
00317400,OKLAHOMA PANHANDLE STATE UNIVERSITY     ,OK,73939-0000,Public       ,59,52,111,1010,,529,1539
00317600,CARL ALBERT STATE COLLEGE               ,OK,74953-5208,Public       ,70,195,265,1449,,2048,3497
00317800,SEMINOLE STATE COLLEGE                  ,OK,74818-0351,Public       ,55,124,179,1071,,1297,2368
00317900,SOUTHEASTERN OKLAHOMA STATE UNIV        ,OK,74701-0609,Public       ,126,256,382,2590,,2587,5177
00318000,SOUTHWESTERN CHRISTIAN UNIVERSITY       ,OK,73008-2335,Private      ,10,89,99,526,,785,1311
00318100,SOUTHWESTERN OKLAHOMA STATE UNIV        ,OK,73096-3098,Public       ,141,189,330,3397,,2159,5556
00318101,SOUTHWESTERN OK STATE UNIV AT SAYRE     ,OK,73662-0000,Public       ,10,22,32,160,,226,386
00318300,ST GREGORY'S UNIVERSITY                 ,OK,74804-2499,Private      ,21,39,60,486,,411,897
00318308,SAINT GREGORY'S UNIVERSITY - IPD TULSA  ,OK,74135-2499,Private      ,3,30,33,55,,283,338
00318400,UNIVERSITY OF OKLAHOMA                  ,OK,73019-4078,Public       ,787,819,1606,19696,,11464,31160
00318401,UNIVERSITY OF OKLAHOMA-HLTH SCI CTR     ,OK,73190-0000,Public       ,33,155,188,940,,3829,4769
00318500,UNIVERSITY OF TULSA                     ,OK,74104-3189,Private      ,159,227,386,4060,,2490,6550
00398500,ORAL ROBERTS UNIVERSITY                 ,OK,74171-0001,Private      ,94,147,241,3309,,1978,5287
00531100,TULSA COUNTY AREA VOC TECH SCHOOL       ,OK,74145-0000,Public       ,45,226,271,633,,1959,2592
00531200,RED RIVER TECHNOLOGY CENTER             ,OK,73533-2700,Public       ,5,24,29,62,,193,255
00533900,METRO TECHNOLOGY CENTERS SCH DIST22     ,OK,73111-0000,Public       ,28,166,194,265,,1414,1679
00533903,METRO TECHNOLOGY CENTERS SCH DIST22     ,OK,73129-0000,Public       ,15,98,113,149,,782,931
00694200,MID-AMERICA CHRISTIAN UNIVERSITY        ,OK,73170-4504,Private      ,28,322,350,588,,3477,4065
00767800,SPARTAN COLLEGE OF AERONAUTICS AND TECHN,OK,74115-5800,Proprietary  ,64,103,167,889,,875,1764
00791100,VIRGILS BEAUTY COLLEGE                  ,OK,74401-6802,Proprietary  ,3,11,14,24,,81,105
00834300,AUTRY TECHNOLOGY CENTER                 ,OK,73703-2598,Public       ,11,29,40,125,,312,437
00861900,TRI COUNTY TECHNOLOGY CENTER            ,OK,74006-6029,Public       ,2,31,33,79,,276,355
00918500,ROSE STATE COLLEGE                      ,OK,73110-2799,Public       ,143,576,719,2975,,5967,8942
00920400,KIAMICHI TECHNOLOGY CENTER              ,OK,74578-0548,Public       ,30,110,140,299,,965,1264
00920408,KIAMICHI TECHNOLOGY CENTER - POTEAU CAMP,OK,74953-0825,Public       ,0,0,0,12,,51,63
00961800,TULSA WELDING SCHOOL                    ,OK,74104-0000,Proprietary  ,176,530,706,1572,,2346,3918
00964700,"OKLAHOMA STATE UNIV, OKLA CITY          ",OK,73107-6159,Public       ,222,758,980,3320,,7491,10811
00970800,EVES COLLEGE OF HAIRSTYLING             ,OK,73501-4359,Proprietary  ,8,25,33,45,,164,209
00976300,TULSA COMMUNITY COLLEGE                 ,OK,74135-6198,Public       ,501,1343,1844,8821,,14024,22845
00996300,CADDO KIOWA VOC TECH CENTER             ,OK,73038-0000,Public       ,13,47,60,74,,316,390
00996400,CENTRAL OKLAHOMA AREA VOC TECH SCH      ,OK,74030-9613,Public       ,12,30,42,118,,334,452
00996500,CANADIAN VALLEY TECHNOLOGY CENTER       ,OK,73036-9117,Public       ,12,42,54,90,,420,510
00996800,GORDON COOPER TECHNOLOGY CENTER         ,OK,74804-9913,Public       ,14,40,54,149,,463,612
01005300,INDIAN CAPITAL TECHNOLGY CENTER #4      ,OK,74403-9907,Public       ,18,73,91,267,,776,1043
01026600,HILLSDALE FREE WILL BAPTIST COLLEGE     ,OK,73153-0000,Private      ,7,12,19,220,,116,336
01034200,SOUTHERN OKLAHOMA TECHNOLOGY CENTER     ,OK,73401-2100,Public       ,9,44,53,144,,377,521
01039100,OKLAHOMA CITY COMMUNITY COLLEGE         ,OK,73159-4444,Public       ,358,1039,1397,5509,,10046,15555
01050304,WTI TULSA CAMPUS                        ,OK,74112-3140,Proprietary  ,7,54,61,58,,317,375
01071700,GREAT PLAINS TECHNOLOGY CENTER SCHOOL DI,OK,73505-8399,Public       ,26,87,113,210,,813,1023
01076200,WESTERN OK AREA VOC TECH SCH DIST12     ,OK,73624-1469,Public       ,5,14,19,58,,122,180
01120600,PIONEER TECHNOLOGY CENTER               ,OK,74601-1106,Public       ,2,35,37,36,,244,280
01128200,OKLAHOMA STATE UNV CLG OSTEOPTHC MD     ,OK,74107-0000,Public       ,15,33,48,149,,781,930
01153700,MID-AMERICA TECHNOLOGY CENTER           ,OK,73095-0210,Public       ,4,9,13,55,,149,204
01227200,MOORE-NORMAN TECHNOLOGY CENTER          ,OK,73069-8399,Public       ,21,107,128,279,,995,1274
02052700,NORTHEAST TECHNOLOGY CENTER             ,OK,74361-0487,Public       ,13,57,70,203,,587,790
02060800,MERIDIAN TECHNOLOGY CENTER              ,OK,74074-0000,Public       ,15,37,52,181,,409,590
02126500,ENID BEAUTY COLLEGE                     ,OK,73701-0000,Proprietary  ,3,12,15,30,,66,96
02184400,SAND SPRINGS BEAUTY COLLEGE             ,OK,74063-0000,Proprietary  ,3,18,21,37,,127,164
02197300,HOLLYWOOD COSMETOLOGY CENTER            ,OK,73189-0000,Proprietary  ,2,13,15,28,,89,117
02222700,FRANCIS TUTTLE TECHNOLOGY CENTER        ,OK,73142-0000,Public       ,46,219,265,374,,1692,2066
02238500,CENTRAL STATE BEAUTY ACADEMY            ,OK,73162-6007,Proprietary  ,12,69,81,92,,380,472
02250900,E OK COUNTY AREA VO-TECH                ,OK,73020-0000,Public       ,3,17,20,44,,121,165
02256200,"BROKEN ARROW BEAUTY COLLEGE, INC        ",OK,74012-0000,Proprietary  ,11,29,40,95,,251,346
02282100,HIGH PLAINS AREA VOC-TECH               ,OK,73801-0000,Public       ,3,9,12,32,,90,122
02306800,PLATT COLLEGE                           ,OK,74145-0000,Proprietary  ,33,210,243,342,,1613,1955
02510300,BEAUTY TECHNICAL COLLEGE                ,OK,74465-0000,Proprietary  ,1,3,4,19,,59,78
02531200,WOODWARD BEAUTY COLLEGE                 ,OK,73801-0000,Proprietary  ,4,4,8,11,,40,51
02554300,AMERICAN BEAUTY INSTITUTE               ,OK,74501-0000,Proprietary  ,2,9,11,15,,72,87
02556500,YUKON BEAUTY COLLEGE                    ,OK,73099-4108,Proprietary  ,1,3,4,3,,33,36
02560200,PHILLIPS THEOLOGICAL SEMINARY -         ,OK,74116-5612,Private      ,0,9,9,5,,99,104
02581100,CLAREMORE BEAUTY COLLEGE                ,OK,74017-7034,Proprietary  ,0,2,2,8,,38,46
02581200,CC'S COSMETOLOGY COLLEGE                ,OK,74129-0000,Proprietary  ,4,35,39,73,,229,302
02591101,CAREER POINT INSTITUTE                  ,OK,74146-0000,Proprietary  ,3,47,50,74,,432,506
02597400,PONTOTOC TECHNOLOGY CENTER SCHOOL       ,OK,74820-8621,Public       ,2,33,35,73,,234,307
02599706,VATTEROTT COLLEGE - TULSA               ,OK,74146-2205,Proprietary  ,6,64,70,72,,483,555
02600000,NORTHWEST TECHNOLOG CTR SCH DIST 10     ,OK,73717-9600,Public       ,3,8,11,30,,68,98
02600500,WES WATKINS TECHNOLOGY CENTER           ,OK,74883-9660,Public       ,3,14,17,40,,149,189
02609205,VATTEROTT COLLEGE - OKLAHOMA CITY       ,OK,73127-2103,Proprietary  ,6,134,140,85,,788,873
03008700,SOUTHWEST TECHNOLOGY CENTER             ,OK,73521-1527,Public       ,4,26,30,53,,192,245
03024700,STILLWATER BEAUTY ACADEMY               ,OK,74075-3467,Proprietary  ,2,6,8,27,,60,87
03030700,OKLAHOMA SCHOOL OF PHOTOGRAPHY          ,OK,73160-3320,Proprietary  ,2,16,18,41,,148,189
03030800,AMERICAN BROADCASTING SCHOOL            ,OK,73115-3334,Proprietary  ,9,58,67,59,,319,378
03051100,CHISHOLM TRAIL TECHNOLOGY CENTER        ,OK,73764-6335,Public       ,0,14,14,5,,72,77
03078500,TECH INST OF COSMETOLOGY ARTS & SCI     ,OK,74120-3610,Proprietary  ,2,21,23,47,,151,198
03103800,SOUTHERN SCHOOL OF BEAUTY               ,OK,74701-5008,Proprietary  ,1,9,10,25,,72,97
03109800,PONCA CITY BEAUTY COLLEGE               ,OK,74601-4201,Proprietary  ,1,1,2,3,,34,37
03109801,BARTLESVILLE BEAUTY COLLEGE             ,OK,74003-2835,Proprietary  ,0,0,0,6,,31,37
03115100,HERITAGE COLLEGE                        ,OK,73119-0000,Proprietary  ,38,199,237,240,,1086,1326
03124800,PLATT COLLEGE                           ,OK,73501-3808,Proprietary  ,16,72,88,75,,511,586
03124901,IMAGINE -  PAUL MITCHELL PARTNER SCHOOL ,OK,73072-4831,Proprietary  ,13,36,49,146,,247,393
03126200,GREEN COUNTRY AREA VOC TECH SCHOOL      ,OK,74447-1217,Public       ,3,30,33,60,,178,238
03198400,MID-DEL AREA VOCATIONAL & TECH SCH      ,OK,73110-4825,Public       ,3,20,23,55,,171,226
03329400,PRYOR BEAUTY COLLEGE                    ,OK,74361-0000,Proprietary  ,1,5,6,11,,48,59
03329401,PRYOR BEAUTY COLLEGE - GROVE BEAUTY COLL,OK,74345-0009,Proprietary  ,1,8,9,7,,29,36
03329402,PRYOR BEAUTY COLLEGE - NORTH EAST OKLAHO,OK,74338-0000,Proprietary  ,0,4,4,1,,5,6
03367400,COMMUNITY CARE COLLEGE                  ,OK,74145-6420,Proprietary  ,59,277,336,515,,1780,2295
03396400,OKLAHOMA HEALTH ACADEMY                 ,OK,73160-3667,Proprietary  ,0,0,0,3,,3,6
03453400,SHAWNEE BEAUTY COLLEGE                  ,OK,74801-7014,Proprietary  ,2,9,11,16,,55,71
03676300,FAMILY OF FAITH COLLEGE                 ,OK,74802-1805,Private      ,1,4,5,15,,33,48
03831300,INSTITUTE OF HAIR DESIGN                ,OK,74804-0000,Proprietary  ,0,8,8,7,,45,52
03928300,CENTRAL STATE MASSAGE ACADEMY           ,OK,73162-6007,Proprietary  ,5,20,25,36,,141,177
04051324,ART INSTITUTE OF PHOENIX (THE) - BROWN M,OK,74146-5234,Proprietary  ,7,60,67,113,,405,518
04060300,AMERICAN INSTITUTE OF MEDICAL TECHNOLOGY,OK,74146-5201,Proprietary  ,5,41,46,115,,347,462
04062300,BROOKLINE COLLEGE                       ,OK,73114-6318,Proprietary  ,3,11,14,26,,126,152
04133600,CUTTER'S EDGE SCHOOL OF COSMETOLOGY     ,OK,74023-2905,Proprietary  ,2,1,3,8,,13,21
04144400,ACADEMY OF HAIR DESIGN (THE)            ,OK,73120-6808,Proprietary  ,2,33,35,53,,205,258
04184300,PAUL MITCHELL THE SCHOOL ARDMORE        ,OK,73401-3912,Proprietary  ,0,9,9,1,,15,16
04213600,RIVER VALLEY COSMETOLOGY INSTITUTE      ,OK,74953-5260,Proprietary  ,1,5,6,1,,5,6
04224700,JB'S HAIR DESIGN AND BARBER COLLEGE     ,OK,73139-1602,Proprietary  ,7,25,32,7,,34,41
04224900,COLLEGE OF THE MUSCOGEE NATION          ,OK,74447-0917,Public       ,5,21,26,5,,21,26
00163700,BETHANY THEOLOGICAL SEMINARY            ,IN,47374-0000,Private      ,0,2,2,2,,67,69
00178400,ANCILLA COLLEGE-FINANCIAL AID OFFC      ,IN,46513-0001,Private      ,9,28,37,467,,479,946
00178500,ANDERSON UNIVERSITY                     ,IN,46012-3495,Private      ,51,82,133,2815,,1299,4114
00178600,BALL STATE UNIVERSITY                   ,IN,47306-0880,Public       ,412,564,976,24103,,9486,33589
00178700,BETHEL COLLEGE INC                      ,IN,46545-5591,Private      ,23,82,105,1767,,1597,3364
00178800,BUTLER UNIVERSITY                       ,IN,46208-3487,Private      ,160,155,315,9074,,2679,11753
00178900,CHRISTIAN THEOLOGICAL SEMINARY          ,IN,46208-0000,Private      ,0,22,22,23,,355,378
00179200,DEPAUW UNIVERSITY                       ,IN,46135-0037,Private      ,58,18,76,3351,,201,3552
00179300,EARLHAM COLLEGE                         ,IN,47374-4095,Private      ,39,11,50,1595,,210,1805
00179301,EARLHAM SCHOOL OF RELIGION              ,IN,47374-0000,Private      ,0,5,5,13,,54,67
00179500,UNIVERSITY OF EVANSVILLE                ,IN,47722-0002,Private      ,59,99,158,3876,,1093,4969
00179800,FRANKLIN COLLEGE OF INDIANA             ,IN,46131-2623,Private      ,36,24,60,2087,,397,2484
00179900,GOSHEN COLLEGE                          ,IN,46526-4794,Private      ,16,44,60,994,,546,1540
00180000,GRACE COLLEGE & THEO SEMINARY           ,IN,46590-1224,Private      ,39,36,75,2145,,644,2789
00180100,HANOVER COLLEGE                         ,IN,47243-0108,Private      ,41,8,49,2575,,151,2726
00180300,HUNTINGTON UNIVERSITY                   ,IN,46750-1299,Private      ,14,36,50,1379,,483,1862
00180400,UNIVERSITY OF INDIANAPOLIS              ,IN,46227-3697,Private      ,128,309,437,7045,,6165,13210
00180500,INDIANA INSTITUTE OF TECHNOLOGY         ,IN,46803-1297,Private      ,66,602,668,2575,,7153,9728
00180700,INDIANA STATE UNIVERSITY                ,IN,47809-2501,Public       ,253,502,755,15073,,8004,23077
00180800,UNIVERSITY OF SOUTHERN INDIANA          ,IN,47712-3596,Public       ,174,308,482,9619,,4630,14249
00180900,INDIANA UNIVERSITY-BLOOMINGTON          ,IN,47405-7000,Public       ,741,538,1279,36899,,12363,49262
00181100,INDIANA UNIV-EAST                       ,IN,47374-1289,Public       ,47,200,247,2151,,3190,5341
00181300,INDIANA UNIV-PURDUE UNIV INDPLS         ,IN,46202-5145,Public       ,533,1213,1746,24438,,25872,50310
00181301,INDIANA UNIVERSITY - PURDUE UNIVERSITY I,IN,47203-1769,Public       ,55,156,211,2159,,2381,4540
00181400,INDIANA UNIV KOKOMO                     ,IN,46902-3557,Public       ,63,208,271,2543,,3243,5786
00181500,INDIANA UNIV-NORTHWEST                  ,IN,46408-1197,Public       ,157,439,596,4502,,6631,11133
00181600,INDIANA UNIVERSITY - SOUTH BEND         ,IN,46615-0000,Public       ,129,387,516,5488,,6281,11769
00181700,INDIANA UNIVERSITY-SOUTHEAST            ,IN,47150-6405,Public       ,135,318,453,4721,,4462,9183
00182000,MANCHESTER COLLEGE                      ,IN,46962-1276,Private      ,29,13,42,2315,,462,2777
00182100,MARIAN UNIVERSITY                       ,IN,46222-1997,Private      ,54,183,237,2533,,3299,5832
00182200,INDIANA WESLEYAN UNIVERSITY             ,IN,46953-4974,Private      ,105,1566,1671,4770,,16739,21509
00182300,ASSOCIATED MENNONITE BIBLICAL SEM       ,IN,46517-1999,Private      ,1,12,13,12,,113,125
00182400,OAKLAND CITY UNIVERSITY                 ,IN,47660-1099,Private      ,10,44,54,593,,696,1289
00182500,PURDUE UNIVERSITY                       ,IN,47907-2050,Public       ,574,431,1005,32972,,8902,41874
00182600,PURDUE UNIV NORTH CENTRAL CAMPUS        ,IN,46391-9542,Public       ,63,156,219,3317,,2745,6062
00182700,PURDUE UNIV CALUMET                     ,IN,46323-2094,Public       ,186,544,730,5957,,7230,13187
00182800,INDIANA UNIV-PURDUE UNIV FORT WAYNE     ,IN,46805-1499,Public       ,225,482,707,10509,,8784,19293
00183000,ROSE HULMAN INSTITUTE OF TECHNOLOGY     ,IN,47803-3999,Private      ,54,14,68,3852,,212,4064
00183200,UNIVERSITY OF SAINT FRANCIS             ,IN,46808-3994,Private      ,50,137,187,2541,,2372,4913
00183300,ST JOSEPH'S COLLEGE                     ,IN,47978-0000,Private      ,21,8,29,1596,,245,1841
00183400,CALUMET COLLEGE OF SAINT JOSEPH         ,IN,46394-2195,Private      ,30,69,99,673,,951,1624
00183500,SAINT MARY-OF-THE-WOODS COLLEGE         ,IN,47876-0067,Private      ,8,69,77,424,,1129,1553
00183600,ST MARY'S COLLEGE                       ,IN,46556-5007,Private      ,12,10,22,1866,,161,2027
00183800,TAYLOR UNIVERSITY                       ,IN,46989-1001,Private      ,52,23,75,2569,,348,2917
00183900,TRINE UNIVERSITY                        ,IN,46703-1764,Private      ,46,62,108,3040,,1112,4152
00184000,UNIVERSITY OF NOTRE DAME                ,IN,46556-5602,Private      ,307,174,481,13743,,3335,17078
00184200,VALPARAISO UNIVERSITY                   ,IN,46383-6493,Private      ,115,112,227,5772,,2449,8221
00184300,VINCENNES UNIVERSITY                    ,IN,47591-1523,Public       ,213,496,709,7404,,5373,12777
00184400,WABASH COLLEGE                          ,IN,47933-0352,Private      ,32,4,36,1403,,80,1483
00420300,GOOD SAMARITAN HOSP RADIOGRAPHY PRG     ,IN,47591-0000,Public       ,0,0,0,0,,1,1
00457900,INTERNATIONAL BUSINESS COLLEGE          ,IN,46804-0000,Proprietary  ,15,42,57,678,,530,1208
00457901,INTERNATIONAL BUSINESS COLLEGE          ,IN,46256-0000,Proprietary  ,15,48,63,845,,690,1535
00625700,SAINT ELIZABETH SCHOOL OF NURSING       ,IN,47904-2198,Private      ,7,36,43,242,,557,799
00638510,CHAMBERLAIN COLLEGE OF NURSING - INDIANA,IN,46240-2158,Proprietary  ,10,58,68,15,,109,124
00726300,HOLY CROSS COLLEGE                      ,IN,46556-0308,Private      ,15,10,25,743,,166,909
00727600,SAINT MEINRAD SCHOOL OF THEOLOGY        ,IN,47577-1002,Private      ,0,7,7,1,,125,126
00732900,ITT TECHNICAL INSTITUTE                 ,IN,46268-1119,Proprietary  ,578,3505,4083,3676,,19046,22722
00732933,ITT TECHNICAL INSTITUTE                 ,IN,46635-1512,Proprietary  ,30,165,195,432,,1395,1827
00732962,ITT TECHNICAL INSTITUTE                 ,IN,47630-7430,Proprietary  ,121,633,754,835,,4216,5051
00732968,ITT TECHNICAL INSTITUTE                 ,IN,46410-0000,Proprietary  ,16,99,115,307,,971,1278
00732993,ITT TECHNICAL INSTITUTE                 ,IN,46825-2393,Proprietary  ,101,481,582,963,,3149,4112
00736200,MEDTECH COLLEGE                         ,IN,46250-3970,Proprietary  ,22,182,204,399,,2494,2893
00736202,MEDTECH COLLEGE - GREENWOOD             ,IN,46143-6478,Proprietary  ,12,85,97,229,,1140,1369
00736204,MEDTECH COLLEGE - FORT WAYNE            ,IN,46804-2209,Proprietary  ,18,104,122,243,,1211,1454
00757311,EMPIRE BEAUTY SCHOOL - INDIANAPOLIS     ,IN,46237-3249,Proprietary  ,0,0,0,252,,712,964
00793800,LINCOLN COLLEGE OF TECHNOLOGY           ,IN,46202-0000,Proprietary  ,243,185,428,2078,,1310,3388
00931306,DAYMAR COLLEGE - ROCKPORT               ,IN,47635-1506,Proprietary  ,1,3,4,10,,35,45
00951500,J MICHAEL HARROLD BEAUTY ACADEMY        ,IN,47807-3390,Proprietary  ,8,24,32,81,,209,290
00961200,"APEX SCHOOL OF BEAUTY CULTURE, INC      ",IN,46016-0000,Proprietary  ,0,11,11,29,,76,105
00961300,MERRILLVILLE BEAUTY COLLEGE             ,IN,46410-3401,Proprietary  ,2,32,34,62,,183,245
00967300,RUDAE'S SCHOOL OF BEAUTY CULTURE        ,IN,46825-5444,Proprietary  ,11,35,46,148,,316,464
00977700,KAPLAN COLLEGE                          ,IN,46278-1736,Proprietary  ,21,196,217,372,,1718,2090
00977702,KAPLAN COLLEGE - TEMPORARY FACILITY EXPA,IN,46268-4111,Proprietary  ,1,23,24,22,,139,161
00991700,IVY TECH COMMUNITY COLLEGE OF INDIANA   ,IN,46208-1763,Public       ,2289,9683,11972,45746,,105560,151306
01015100,VINCENNES BEAUTY COLLEGE                ,IN,47591-1297,Proprietary  ,3,14,17,102,,140,242
01040900,LAFAYETTE BEAUTY ACADEMY                ,IN,47901-1149,Proprietary  ,8,28,36,103,,206,309
01048900,NATIONAL COLLEGE                        ,IN,46250-1930,Proprietary  ,8,38,46,68,,524,592
01048910,NATIONAL COLLEGE - SOUTH BEND           ,IN,46617-3123,Proprietary  ,2,62,64,115,,581,696
01048911,NATIONAL COLLEGE - FORT WAYNE           ,IN,46826-4905,Proprietary  ,6,31,37,80,,385,465
01061800,MID-AMERICA CLG FUNERAL SERVICE         ,IN,47130-9990,Private      ,4,12,16,86,,138,224
01150500,CREATIVE HAIR STYLING ACADEMY           ,IN,46322-1554,Proprietary  ,14,37,51,130,,248,378
02084800,RAVENSCROFT BEAUTY COLLEGE              ,IN,46815-0000,Proprietary  ,5,46,51,108,,334,442
02087600,CONCORDIA THEOLOGICAL SEMINARY          ,IN,46825-0000,Private      ,1,13,14,15,,274,289
02100402,EVEREST INSTITUTE - EVEREST COLLEGE     ,IN,46410-7064,Proprietary  ,32,214,246,320,,1421,1741
02140800,MARTIN UNIVERSITY                       ,IN,46218-0000,Private      ,10,86,96,224,,1493,1717
02158400,HARRISON COLLEGE                        ,IN,46204-2611,Proprietary  ,56,368,424,690,,3846,4536
02158401,HARRISON COLLEGE - COLUMBUS             ,IN,47203-1843,Proprietary  ,10,74,84,173,,639,812
02158402,HARRISON COLLEGE - LAFAYETTE            ,IN,47905-4859,Proprietary  ,13,100,113,189,,818,1007
02158405,HARRISON COLLEGE - TERRE HAUTE          ,IN,47802-0000,Proprietary  ,12,74,86,150,,732,882
02158407,HARRISON COLLEGE - ANDERSON             ,IN,46013-0000,Proprietary  ,9,70,79,147,,679,826
02158409,HARRISON COLLEGE - EVANSVILLE           ,IN,47715-3901,Proprietary  ,19,87,106,200,,653,853
02158410,HARRISON COLLEGE - EAST                 ,IN,46239-8903,Proprietary  ,17,138,155,286,,1271,1557
02158412,HARRISON COLLEGE - FORT WAYNE           ,IN,46825-0000,Proprietary  ,10,79,89,173,,766,939
02158413,HARRISON COLLEGE - NORTHWEST            ,IN,46278-0000,Proprietary  ,14,50,64,220,,528,748
02158415,HARRISON COLLEGE - MUNCIE               ,IN,47303-0000,Proprietary  ,5,37,42,130,,482,612
02158416,HARRISON COLLEGE - ELKHART              ,IN,46516-0000,Proprietary  ,8,50,58,85,,393,478
02158800,DON ROBERTS BEAUTY SCHOOLS              ,IN,46383-0000,Proprietary  ,3,12,15,48,,119,167
02164300,DON ROBERTS SCHOOL OF HAIR DESIGN       ,IN,46375-9999,Proprietary  ,4,12,16,49,,86,135
02180108,ROSS MEDICAL EDUCATION CENTER -         ,IN,46530-4479,Proprietary  ,1,19,20,38,,176,214
02201800,KAPLAN COLLEGE                          ,IN,46324-3347,Proprietary  ,26,111,137,257,,927,1184
02201806,KAPLAN COLLEGE - SOUTHEAST INDIANAPOLIS ,IN,46227-1493,Proprietary  ,34,143,177,239,,1055,1294
02241700,PJ'S COLLEGE OF COSMETOLOGY             ,IN,47129-0000,Proprietary  ,7,23,30,74,,225,299
02245505,FORTIS COLLEGE - INDIANAPOLIS CAMPUS    ,IN,46268-0000,Proprietary  ,9,58,67,96,,508,604
02302700,J EVERETT LIGHT CAREER CENTER           ,IN,46240-0000,Public       ,4,27,31,116,,561,677
02304800,PJ'S COLLEGE OF COSMETOLOGY             ,IN,47374-0000,Proprietary  ,4,19,23,46,,158,204
02308900,MASTER'S OF COSMETOLOGY COLLEGE         ,IN,46809-0000,Proprietary  ,7,22,29,141,,226,367
02339600,ROGER'S ACADEMY OF HAIR DESIGN          ,IN,47712-0000,Proprietary  ,7,38,45,97,,227,324
02351300,KNOX BEAUTY COLLEGE                     ,IN,46534-0000,Proprietary  ,0,6,6,25,,43,68
02490500,HAIR FASHIONS BY KAYE BEAUTY CLG        ,IN,46250-0000,Proprietary  ,5,38,43,100,,409,509
02490800,HAIR FASHIONS BY KAYE BEAUTY CLG        ,IN,46060-0000,Proprietary  ,5,14,19,40,,93,133
02607000,HAIR ARTS ACADEMY                       ,IN,47404-2419,Proprietary  ,3,23,26,61,,158,219
02615800,COLLEGE OF COURT REPORTING              ,IN,46342-5969,Proprietary  ,6,42,48,36,,353,389
03100600,MARION COMM TUCKER AREA VOC SCHOOL      ,IN,46952-3831,Public       ,6,14,20,73,,176,249
03176300,AVIATION INSTITUTE OF MAINTENANCE       ,IN,46241-1445,Proprietary  ,12,52,64,131,,434,565
03262300,DAVID DEMUTH INSTITUTE OF COSM          ,IN,47374-4101,Proprietary  ,0,0,0,16,,31,47
03456700,CROSSROADS BIBLE COLLEGE                ,IN,46219-4912,Private      ,1,46,47,87,,465,552
03538300,ALEXANDRIA SCH OF SCIENTIFIC THERAP     ,IN,46001-0287,Proprietary  ,1,9,10,18,,83,101
04038700,IDEAL BEAUTY ACADEMY                    ,IN,47130-4215,Proprietary  ,4,17,21,21,,87,108
04051304,ART INSTITUTE OF PHOENIX (THE) - ART  IN,IN,46268-1170,Proprietary  ,64,129,193,1207,,1275,2482
04051311,ART INSTITUTE OF PHOENIX (THE) - BROWN M,IN,46410-5608,Proprietary  ,18,97,115,206,,950,1156
04051312,ART INSTITUTE OF PHOENIX (THE) - BROWN M,IN,46360-7362,Proprietary  ,9,47,56,129,,472,601
04051318,ART INSTITUTE OF PHOENIX (THE) - BROWN M,IN,46204-1017,Proprietary  ,32,169,201,370,,1918,2288
04051321,ART INSTITUTE OF PHOENIX (THE) - BROWN M,IN,46635-1176,Proprietary  ,14,76,90,221,,855,1076
04051322,ART INSTITUTE OF PHOENIX (THE) - BROWN M,IN,46805-0000,Proprietary  ,19,95,114,254,,1184,1438
04100300,SUCCESS SCHOOLS                         ,IN,46410-5310,Proprietary  ,11,49,60,93,,298,391
04121000,TECHSKILLS - INDIANAPOLIS               ,IN,46240-4302,Proprietary  ,8,110,118,120,,558,678
04130900,HONORS BEAUTY COLLEGE                   ,IN,46256-3317,Proprietary  ,8,41,49,109,,335,444
04155900,AVEDA FREDRIC'S INSTITUTE               ,IN,46250-4746,Proprietary  ,13,24,37,181,,306,487
04166700,REM SPA INC                             ,IN,46013-3136,Proprietary  ,8,17,25,63,,150,213
04171700,AVANT GARD THE SCHOOL                   ,IN,46214-6500,Proprietary  ,4,9,13,39,,81,120
04172700,SALON PROFESSIONAL ACADEMY (THE)        ,IN,47715-7822,Proprietary  ,6,22,28,129,,199,328
04184000,PAUL MITCHELL THE SCHOOL INDIANAPOLIS   ,IN,46227-6252,Proprietary  ,13,35,48,189,,350,539
04186600,SALON PROFESSIONAL ACADEMY (THE)        ,IN,46901-6248,Proprietary  ,5,27,32,80,,189,269
04205500,LIL LOU'S BARBER COLLEGE                ,IN,46409-2645,Proprietary  ,3,41,44,37,,196,233
00190100,ALLEN COUNTY COMMUNITY COLLEGE          ,KS,66749-1607,Public       ,69,184,253,1153,,1666,2819
00190200,COWLEY COUNTY COMMUNITY COLLEGE & AREA V,KS,67005-2662,Public       ,102,292,394,1787,,2923,4710
00190300,BAKER UNIVERSITY                        ,KS,66006-0065,Private      ,79,294,373,1467,,2248,3715
00190400,BETHANY COLLEGE                         ,KS,67456-1897,Private      ,24,14,38,832,,151,983
00190500,BETHEL COLLEGE                          ,KS,67117-8061,Private      ,31,11,42,781,,174,955
00190600,BUTLER COUNTY COMMUNITY COLLEGE         ,KS,67042-3280,Public       ,306,545,851,4762,,5598,10360
00190700,CENTRAL BAPTIST THEOLOGY SEMINARY       ,KS,66226-3513,Private      ,0,4,4,0,,69,69
00190800,CENTRAL CHRISTIAN COLLEGE OF KANSAS     ,KS,67460-5799,Private      ,19,185,204,482,,761,1243
00190900,CLOUD COUNTY COMMUNITY COLLEGE          ,KS,66901-1002,Public       ,48,117,165,893,,1076,1969
00191000,COFFEYVILLE COMMUNITY COLLEGE           ,KS,67337-5064,Public       ,39,62,101,1133,,567,1700
00191100,COLBY COMMUNITY COLLEGE                 ,KS,67701-4099,Public       ,40,49,89,694,,575,1269
00191300,DODGE CITY COMMUNITY COLLEGE            ,KS,67801-2399,Public       ,54,89,143,998,,755,1753
00191400,DONNELLY COLLEGE                        ,KS,66102-4298,Private      ,18,80,98,334,,742,1076
00191500,FORT HAYS STATE UNIVERSITY              ,KS,67601-4099,Public       ,167,571,738,4513,,6593,11106
00191600,FORT SCOTT COMMUNITY COLLEGE            ,KS,66701-3199,Public       ,54,146,200,1197,,1084,2281
00191700,BARCLAY COLLEGE                         ,KS,67059-0288,Private      ,10,15,25,162,,142,304
00191800,FRIENDS UNIVERSITY                      ,KS,67213-3397,Private      ,52,188,240,1450,,2595,4045
00191900,GARDEN CITY COMMUNITY COLLEGE           ,KS,67846-6398,Public       ,92,91,183,1026,,762,1788
00192000,HESSTON COLLEGE                         ,KS,67062-2093,Private      ,18,11,29,505,,186,691
00192100,HIGHLAND COMMUNITY COLLEGE              ,KS,66035-4062,Public       ,66,166,232,1327,,1510,2837
00192300,HUTCHINSON COMMUNITY COLLEGE            ,KS,67501-5894,Public       ,109,291,400,2434,,2874,5308
00192400,INDEPENDENCE COMMUNITY COLLEGE          ,KS,67301-0708,Public       ,27,58,85,644,,509,1153
00192500,KANSAS CITY KANSAS COMMUNITY CLG        ,KS,66112-9978,Public       ,163,601,764,2423,,5702,8125
00192600,PITTSBURG STATE UNIVERSITY              ,KS,66762-7500,Public       ,168,197,365,5831,,3129,8960
00192700,EMPORIA STATE UNIVERSITY                ,KS,66801-5087,Public       ,123,214,337,3658,,3084,6742
00192800,KANSAS STATE UNIVERSITY                 ,KS,66506-1104,Public       ,551,538,1089,17768,,7554,25322
00192900,KANSAS WESLEYAN UNIVERSITY              ,KS,67401-6196,Private      ,26,40,66,1061,,375,1436
00193000,LABETTE COMMUNITY COLLEGE               ,KS,67357-4299,Public       ,28,96,124,626,,902,1528
00193100,MANHATTAN CHRISTIAN COLLEGE             ,KS,66502-4081,Private      ,12,10,22,370,,137,507
00193300,MCPHERSON COLLEGE                       ,KS,67460-3899,Private      ,20,8,28,911,,191,1102
00193600,NEOSHO COUNTY COMMUNITY COLLEGE         ,KS,66720-2699,Public       ,39,112,151,978,,1304,2282
00193700,OTTAWA UNIVERSITY                       ,KS,66067-3399,Private      ,40,319,359,973,,2919,3892
00193800,PRATT COMMUNITY COLLEGE                 ,KS,67124-8432,Public       ,26,70,96,679,,838,1517
00193900,NEWMAN UNIVERSITY                       ,KS,67213-2084,Private      ,68,138,206,1475,,1803,3278
00194000,SOUTHWESTERN COLLEGE                    ,KS,67156-2499,Private      ,23,120,143,906,,1492,2398
00194300,UNIVERSITY OF ST MARY                   ,KS,66048-5023,Private      ,15,107,122,755,,943,1698
00194500,STERLING COLLEGE                        ,KS,67579-1533,Private      ,40,16,56,873,,196,1069
00194600,TABOR COLLEGE                           ,KS,67063-1799,Private      ,33,30,63,934,,293,1227
00194800,UNIVERSITY OF KANSAS                    ,KS,66045-7535,Public       ,587,572,1159,18321,,10858,29179
00194900,WASHBURN UNIVERSITY                     ,KS,66621-1110,Public       ,140,305,445,3802,,4416,8218
00194901,WASHBURN INSTITUTE OF TECHNOLOGY        ,KS,66604-2199,Public       ,39,144,183,442,,1053,1495
00195000,WICHITA STATE UNIVERSITY                ,KS,67208-0000,Public       ,315,561,876,8120,,8910,17030
00460800,BARTON COUNTY COMMUNITY COLLEGE         ,KS,67530-9283,Public       ,57,337,394,1078,,2499,3577
00526400,FLINT HILLS TECHNICAL COLLEGE           ,KS,66801-5999,Public       ,13,57,70,345,,587,932
00526500,NORTH CENTRAL KANSAS TECH COLG          ,KS,67420-0000,Public       ,20,34,54,402,,369,771
00526700,NORTHWEST KANSAS TECHNICAL SCHOOL       ,KS,67735-3441,Public       ,16,20,36,350,,186,536
00549800,WICHITA AREA TECHNICAL COLLEGE          ,KS,67211-2099,Public       ,103,393,496,872,,3335,4207
00549900,SALINA AREA TECHNICAL COLLEGE           ,KS,67401-8195,Public       ,13,43,56,240,,306,546
00550000,MANHATTAN AREA TECHNICAL COLLEGE        ,KS,66503-2499,Public       ,32,85,117,509,,926,1435
00675500,BROWN MACKIE COLLEGE (THE)              ,KS,67401-7307,Proprietary  ,60,260,320,535,,1886,2421
00703200,MID AMERICA NAZARENE UNIVERSITY         ,KS,66062-1899,Private      ,31,145,176,1138,,1384,2522
00822800,SEWARD CO COMM CO/AREA TECHNICAL SCHOOL ,KS,67905-0000,Public       ,37,50,87,591,,522,1113
00824400,JOHNSON COUNTY COMMUNITY COLLEGE        ,KS,66210-1299,Public       ,434,1020,1454,6554,,8753,15307
00833200,B-STREET DESIGN SCHOOL OF INTERNATIONAL ,KS,66502-6082,Proprietary  ,2,17,19,39,,112,151
00833201,B-STREET DESIGN SCHOOL OF INTERNATIONAL ,KS,66046-2743,Proprietary  ,10,14,24,40,,80,120
00869423,RASMUSSEN COLLEGE - OVERLAND PARK       ,KS,66210-2786,Proprietary  ,2,38,40,12,,96,108
00869424,RASMUSSEN COLLEGE - TOPEKA              ,KS,66606-2339,Proprietary  ,16,65,81,55,,250,305
01025600,BENEDICTINE COLLEGE                     ,KS,66002-1499,Private      ,69,16,85,2518,,212,2730
01043800,HASKELL INDIAN NATIONS UNIVERSITY       ,KS,66046-4800,Public       ,68,73,141,1236,,766,2002
01050300,WICHITA TECHNICAL INSTITUTE             ,KS,67213-1927,Proprietary  ,33,157,190,233,,1114,1347
01050302,WICHITA TECHNICAL INSTITUTE - WTI TOPEKA,KS,66609-1217,Proprietary  ,10,71,81,78,,454,532
01050305,WICHITA TECHNICAL INSTITUTE - EAST CAMPU,KS,67208-4243,Proprietary  ,8,73,81,94,,451,545
02090700,CLEVELAND CHIROPRACTIC COLLEGE          ,KS,66210-1613,Private      ,2,28,30,53,,612,665
02134800,OLD TOWN BARBER AND BEAUTY COLLEGE      ,KS,67211-0000,Proprietary  ,5,24,29,43,,167,210
02257700,HAYS ACADEMY OF HAIR DESIGN             ,KS,67601-3685,Proprietary  ,4,14,18,90,,121,211
02257702,HAYS ACADEMY OF HAIR DESIGN -           ,KS,67401-0000,Proprietary  ,4,12,16,6,,20,26
02340700,LABARON HAIRDRESSING ACADEMY            ,KS,66204-0000,Proprietary  ,0,10,10,22,,52,74
02590900,WRIGHT CAREER COLLEGE                   ,KS,66212-0000,Private      ,57,438,495,409,,3225,3634
02599709,VATTEROTT COLLEGE - WICHITA             ,KS,67226-1304,Proprietary  ,11,82,93,110,,591,701
02603100,XENON INTERNATIONAL ACADEMY             ,KS,67203-5428,Proprietary  ,9,41,50,142,,278,420
02606300,PAUL MITCHELL THE SCHOOL WICHITA        ,KS,67226-2803,Proprietary  ,11,38,49,110,,228,338
02611005,HERITAGE COLLEGE - WICHITA              ,KS,67210-1879,Proprietary  ,33,112,145,201,,687,888
02613000,PINNACLE CAREER INSTITUTE               ,KS,66046-2703,Proprietary  ,9,80,89,73,,423,496
03031300,XENON INTERNATIONAL ACADEMY IV          ,KS,66061-3765,Proprietary  ,2,9,11,38,,82,120
03066200,BRYAN COLLEGE                           ,KS,66604-2496,Proprietary  ,12,43,55,50,,285,335
03450300,B-STREET DESIGN SCHOOL OF INTERNATIONAL ,KS,66611-2373,Proprietary  ,5,26,31,57,,165,222
03450301,B-STREET DESIGN SCHOOL OF INTERNATIONAL ,KS,67207-5148,Proprietary  ,3,29,32,42,,133,175
03450302,B-STREET DESIGN SCHOOL OF INTERNATIONAL ,KS,66212-5451,Proprietary  ,9,35,44,68,,172,240
03529300,SIDNEY'S HAIRDRESSING COLLEGE           ,KS,67501-7094,Proprietary  ,0,10,10,25,,62,87
04132900,Z HAIR ACADEMY                          ,KS,66046-4040,Proprietary  ,6,17,23,58,,76,134
04162700,ERIC FISHER ACADEMY                     ,KS,67212-3376,Proprietary  ,15,33,48,146,,219,365
04175700,ACADEMY OF AESTHETIC ARTS               ,KS,66203-3502,Proprietary  ,2,10,12,17,,59,76
04179600,ENTOURAGE INSTITUTE OF BEAUTY AND ESTHET,KS,66215-3803,Proprietary  ,5,22,27,24,,93,117
04205300,MITSU SATO HAIR ACADEMY                 ,KS,66212-1457,Proprietary  ,2,11,13,28,,49,77
04209300,PAUL MITCHELL THE SCHOOL - OVERLAND PARK,KS,66212-4050,Proprietary  ,12,26,38,131,,186,317
00203300,UNIVERSITY OF MAINE-PRESQUE ISLE        ,ME,04769-2888,Public       ,20,36,56,879,,639,1518
00203500,BANGOR THEOLOGICAL SEMINARY             ,ME,04402-0411,Private      ,0,0,0,3,,24,27
00203600,BATES COLLEGE                           ,ME,04240-6028,Private      ,73,12,85,3125,,133,3258
00203800,BOWDOIN COLLEGE                         ,ME,04011-8451,Private      ,111,8,119,4146,,147,4293
00203900,COLBY COLLEGE                           ,ME,04901-8841,Private      ,76,8,84,3143,,124,3267
00204000,UNIVERSITY OF MAINE-FARMINGTON          ,ME,04938-1990,Public       ,49,41,90,2882,,627,3509
00204100,UNIVERSITY OF MAINE-FORT KENT           ,ME,04743-1292,Public       ,14,47,61,730,,572,1302
00204300,HUSSON UNIVERSITY                       ,ME,04401-2999,Private      ,42,67,109,2823,,1620,4443
00204400,MAINE MARITIME ACADEMY                  ,ME,04420-0001,Public       ,11,6,17,1239,,167,1406
00205000,UNIVERSITY OF NEW ENGLAND               ,ME,04005-9599,Private      ,73,245,318,4833,,4774,9607
00205100,SAINT JOSEPH'S COLLEGE                  ,ME,04084-5236,Private      ,24,168,192,1874,,1755,3629
00205200,THOMAS COLLEGE                          ,ME,04901-5097,Private      ,16,23,39,1210,,335,1545
00205300,UNIVERSITY OF MAINE                     ,ME,04469-0001,Public       ,275,144,419,12636,,3197,15833
00205400,UNIVERSITY OF SOUTHERN MAINE            ,ME,04104-0000,Public       ,156,326,482,6882,,6031,12913
00205500,UNIVERSITY OF MAINE-MACHIAS             ,ME,04654-1397,Public       ,15,23,38,603,,447,1050
00458615,KAPLAN UNIVERSITY - PORTLAND            ,ME,04106-2415,Proprietary  ,14,109,123,169,,1037,1206
00458616,KAPLAN UNIVERSITY - LEWISTON            ,ME,04240-0000,Proprietary  ,12,126,138,148,,1160,1308
00458617,KAPLAN UNIVERSITY - AUGUSTA             ,ME,04330-8038,Proprietary  ,15,120,135,18,,159,177
00520400,BEAL COLLEGE                            ,ME,04401-6896,Proprietary  ,23,93,116,341,,763,1104
00527600,CENTRAL MAINE COMMUNITY COLLEGE         ,ME,04210-6498,Public       ,57,187,244,1637,,2266,3903
00527700,EASTERN MAINE COMMUNITY COLLEGE         ,ME,04401-4280,Public       ,99,186,285,1884,,1966,3850
00552500,SOUTHERN MAINE COMMUNITY  COLLEGE       ,ME,04106-1698,Public       ,214,459,673,4301,,4909,9210
00576000,NORTHERN MAINE COMMUNITY COLLEGE        ,ME,04769-2016,Public       ,23,70,93,549,,643,1192
00630500,CENTRAL MAINE MEDICAL CENTER COLLEGE OF ,ME,04243-9986,Private      ,7,30,37,125,,361,486
00676000,UNIVERSITY OF MAINE-AUGUSTA             ,ME,04330-9410,Public       ,87,347,434,1803,,5423,7226
00685800,UNITY COLLEGE                           ,ME,04988-9502,Private      ,26,13,39,896,,144,1040
00903800,MR BERNARD'S SCH HAIR FASHION INC       ,ME,04243-1163,Proprietary  ,4,18,22,45,,150,195
00923100,WASHINGTON COUNTY COMMUNITY COLLEGE     ,ME,04619-9704,Public       ,13,31,44,275,,325,600
00945900,EMPIRE BEAUTY SCHOOL                    ,ME,04101-3348,Proprietary  ,88,258,346,352,,717,1069
00982600,KENNEBEC VALLEY  COMMUNITY  COLLEGE     ,ME,04937-1367,Public       ,40,170,210,959,,2026,2985
01138500,COLLEGE OF THE ATLANTIC                 ,ME,04609-1105,Private      ,16,6,22,621,,110,731
01167300,MAINE COLLEGE OF ART                    ,ME,04101-3987,Private      ,27,21,48,723,,253,976
02104400,SPA TECH INSTITUTE                      ,ME,04093-0000,Proprietary  ,27,66,93,172,,453,625
02347100,NEW ENGLAND SCHOOL OF COMMUNICATIONS    ,ME,04401-0000,Private      ,16,17,33,592,,195,787
02361300,LANDING SCHOOL OF BOATBUILDING & DESIGN ,ME,04046-1490,Private      ,0,4,4,39,,49,88
03122900,YORK COUNTY COMMUNITY COLLEGE           ,ME,04090-0529,Public       ,53,109,162,760,,1114,1874
03429300,SEACOAST CAREER SCHOOLS                 ,ME,04073-0000,Proprietary  ,30,120,150,123,,505,628
03612300,BIRTHWISE MIDWIFERY SCHOOL              ,ME,04009-1110,Proprietary  ,1,3,4,12,,90,102
04177400,CAPILO SCHOOL OF HAIR DESIGN            ,ME,04330-0000,Proprietary  ,9,29,38,93,,156,249
04185100,NORTHEAST TECHNICAL INSTITUTE           ,ME,04074-0000,Proprietary  ,16,115,131,121,,699,820
04188800,INSTITUTE FOR DOCTORAL STUDIES IN THE VI,ME,04102-0000,Private      ,1,20,21,2,,71,73
04214100,COSMOTECH SCHOOL OF COSMETOLOGY         ,ME,04092-2878,Proprietary  ,4,7,11,20,,39,59
00209300,ST JOHN'S COLLEGE                       ,NM,87505-4599,Private      ,17,14,31,377,,219,596
00264900,SANTA FE UNIVERSITY OF ART AND DESIGN   ,NM,87505-7634,Proprietary  ,59,46,105,1073,,339,1412
00265000,UNIVERSITY OF THE SOUTHWEST             ,NM,88240-9129,Private      ,15,133,148,358,,1097,1455
00265100,EASTERN NEW MEXICO UNIV PORTALES        ,NM,88130-6000,Public       ,188,257,445,3527,,3126,6653
00265101,EASTERN NEW MEXICO UNIV-ROSWELL CAM     ,NM,88202-0000,Public       ,98,192,290,1299,,1689,2988
00265300,NEW MEXICO HIGHLANDS UNIVERSITY         ,NM,87701-4436,Public       ,90,207,297,2328,,2776,5104
00265400,NEW MEXICO INST OF MINING & TECH        ,NM,87801-4796,Public       ,75,36,111,1451,,565,2016
00265500,NEW MEXICO JUNIOR COLLEGE               ,NM,88240-9123,Public       ,56,129,185,851,,1018,1869
00265600,NEW MEXICO MILITARY INSTITUTE           ,NM,88201-5173,Public       ,51,13,64,528,,87,615
00265700,NEW MEXICO STATE UNIVERSITY             ,NM,88003-8001,Public       ,639,526,1165,12684,,8789,21473
00265701,NEW MEXICO STATE UNIV-ALAMOGORDO        ,NM,88311-0000,Public       ,49,140,189,624,,1486,2110
00265702,NEW MEXICO STATE UNIV.-DONA ANA CLG     ,NM,88003-0000,Public       ,224,430,654,3528,,4974,8502
00265703,NEW MEXICO STATE UNIV-CARLSBAD          ,NM,88220-0000,Public       ,29,60,89,429,,687,1116
00265704,NEW MEXICO STATE UNIV-GRANTS            ,NM,87020-0000,Public       ,16,48,64,285,,604,889
00266000,SAN JUAN COLLEGE                        ,NM,87402-4699,Public       ,243,755,998,2353,,5401,7754
00266300,THE UNIVERSITY OF NEW MEXICO            ,NM,87131-0001,Public       ,1040,1318,2358,20469,,20736,41205
00266400,WESTERN NEW MEXICO UNIVERSITY           ,NM,88061-5417,Public       ,69,174,243,1650,,2272,3922
00405701,NATIONAL AMERICAN UNIVERSITY            ,NM,87110-0000,Proprietary  ,15,77,92,115,,716,831
00474200,CENTRAL NEW MEXICO COMMUNITY COLLEGE    ,NM,87106-4096,Public       ,664,2211,2875,9792,,19299,29091
00474300,CLOVIS COMMUNITY COLLEGE                ,NM,88101-8381,Public       ,60,203,263,737,,1895,2632
00996200,LUNA COMMUNITY COLLEGE                  ,NM,87701-0000,Public       ,26,48,74,565,,679,1244
01063200,DEWOLFF CLG HAIRSTYLING/COSMETOLOGY     ,NM,87112-4113,Proprietary  ,12,41,53,100,,243,343
01300500,OLYMPIAN UNIVERSITY OF COSMETOLOGY      ,NM,88310-5051,Proprietary  ,53,172,225,380,,1157,1537
02083900,NORTHERN NEW MEXICO COLLEGE             ,NM,87530-0000,Public       ,44,98,142,682,,954,1636
02146400,INSTITUTE OF AMERICAN INDIAN ARTS       ,NM,87508-0000,Public       ,18,25,43,202,,315,517
02151102,ATI COLLEGE OF HEALTH - ATI CAREER TRAIN,NM,87109-2016,Proprietary  ,0,0,0,5,,20,25
02218808,BROOKLINE COLLEGE - ALBUQUERQUE         ,NM,87105-1649,Proprietary  ,35,142,177,258,,905,1163
02278100,SANTA FE COMMUNITY COLLEGE              ,NM,87507-0000,Public       ,99,303,402,1214,,2915,4129
02357600,NAVAJO TECHNICAL COLLEGE                ,NM,87313-0000,Public       ,52,159,211,667,,1526,2193
02511000,SOUTHWESTERN INDIAN POLYTECH INST       ,NM,87184-0000,Public       ,37,58,95,383,,610,993
02572003,COMPUTER CAREER CENTER - LAS CRUCES CAMP,NM,88011-8220,Proprietary  ,23,85,108,171,,610,781
02622000,SOUTHWEST ACUPUNCTURE COLLEGE           ,NM,87505-0000,Proprietary  ,1,38,39,4,,294,298
03076100,SOUTHWESTERN COLLEGE                    ,NM,87507-0000,Private      ,1,19,20,31,,283,314
03206300,MESALANDS COMMUNITY COLLEGE             ,NM,88401-3352,Public       ,6,15,21,151,,178,329
03430300,UNIVERSAL THERAPEUTIC MASSAGE INSTITUTE ,NM,87107-4403,Proprietary  ,3,33,36,49,,210,259
03678300,PIMA MEDICAL INSTITUTE                  ,NM,87110-0000,Proprietary  ,31,125,156,387,,942,1329
03944300,MASSAGE THERAPY TRAINING INSTITUTE      ,NM,88007-0000,Proprietary  ,5,16,21,54,,121,175
04162400,TONI AND GUY HAIR ACADEMY               ,NM,87106-4404,Proprietary  ,12,28,40,99,,216,315
04174500,AVEDA INSTITUTE OF NEW MEXICO (THE)     ,NM,87110-3640,Proprietary  ,13,61,74,208,,423,631
04178500,VOGUE COLLEGE OF COSMETOLOGY            ,NM,87505-7636,Proprietary  ,7,21,28,64,,152,216
00223400,ADRIAN COLLEGE                          ,MI,49221-2575,Private      ,63,39,102,3081,,466,3547
00223500,ALBION COLLEGE                          ,MI,49224-1831,Private      ,68,15,83,2792,,192,2984
00223600,ALMA COLLEGE                            ,MI,48801-1599,Private      ,52,24,76,2869,,231,3100
00223700,ALPENA COMMUNITY COLLEGE                ,MI,49707-1495,Public       ,41,139,180,1126,,1185,2311
00223800,ANDREWS UNIVERSITY                      ,MI,49104-0750,Private      ,46,95,141,2064,,1530,3594
00223900,AQUINAS COLLEGE                         ,MI,49506-1799,Private      ,70,79,149,3125,,885,4010
00224000,BAY DE NOC COMMUNITY COLLEGE            ,MI,49829-2524,Public       ,55,152,207,1237,,1603,2840
00224100,CALVIN COLLEGE                          ,MI,49546-4388,Private      ,86,65,151,4891,,715,5606
00224200,CALVIN THEOLOGICAL SEMINARY             ,MI,49546-4387,Private      ,1,7,8,26,,216,242
00224300,CENTRAL MICHIGAN UNIVERSITY             ,MI,48859-0001,Public       ,561,835,1396,24474,,11755,36229
00224600,CLEARY UNIVERSITY                       ,MI,48105-2659,Private      ,10,84,94,234,,835,1069
00224700,CONCORDIA UNIVERSITY-ANN ARBOR          ,MI,48105-2797,Private      ,20,50,70,1078,,460,1538
00224800,CRANBROOK ACADEMY OF ART                ,MI,48303-0000,Private      ,4,10,14,39,,275,314
00224900,DAVENPORT UNIVERSITY                    ,MI,49503-0000,Private      ,196,1157,1353,3982,,12958,16940
00225100,DELTA COLLEGE                           ,MI,48710-0001,Public       ,397,971,1368,6974,,8534,15508
00225400,MICHIGAN STATE UNIVERSITY COLLEGE OF LAW,MI,48824-1300,Private      ,19,48,67,395,,2140,2535
00225900,EASTERN MICHIGAN UNIVERSITY             ,MI,48197-2214,Public       ,570,1091,1661,20465,,15813,36278
00226000,FERRIS STATE UNIVERSITY                 ,MI,49307-2251,Public       ,384,502,886,16488,,8714,25202
00226100,CHARLES STEWART MOTT COMMUNITY CLG      ,MI,48503-2089,Public       ,464,1226,1690,6690,,11088,17778
00226200,KETTERING UNIVERSITY                    ,MI,48504-4898,Private      ,69,60,129,2390,,571,2961
00226300,GLEN OAKS COMMUNITY COLLEGE             ,MI,49032-9784,Public       ,46,100,146,740,,935,1675
00226400,GOGEBIC COMMUNITY COLLEGE               ,MI,49938-1365,Public       ,19,56,75,759,,598,1357
00226500,GRACE BIBLE COLLEGE                     ,MI,49509-1998,Private      ,17,73,90,563,,612,1175
00226600,CORNERSTONE UNIVERSITY                  ,MI,49525-5897,Private      ,56,238,294,2501,,2225,4726
00226700,GRAND RAPIDS COMMUNITY COLLEGE          ,MI,49503-3295,Public       ,711,1520,2231,12446,,13214,25660
00226800,GRAND VALLEY STATE UNIVERSITY           ,MI,49401-9403,Public       ,571,605,1176,27776,,9482,37258
00226900,GREAT LAKES CHRISTIAN COLLEGE           ,MI,48917-1299,Private      ,15,24,39,233,,235,468
00227000,HENRY FORD COMMUNITY COLLEGE            ,MI,48128-1495,Public       ,796,1887,2683,11931,,18790,30721
00227300,HOPE COLLEGE                            ,MI,49423-3607,Private      ,75,29,104,5146,,318,5464
00227400,JACKSON COMMUNITY COLLEGE               ,MI,49201-8399,Public       ,165,534,699,3911,,5338,9249
00227500,KALAMAZOO COLLEGE                       ,MI,49006-3295,Private      ,55,44,99,2456,,371,2827
00227600,KELLOGG COMMUNITY COLLEGE               ,MI,49017-3397,Public       ,176,644,820,3146,,6154,9300
00227700,LAKE MICHIGAN COLLEGE                   ,MI,49022-1899,Public       ,119,422,541,2112,,3470,5582
00227800,LANSING COMMUNITY COLLEGE               ,MI,48933-1293,Public       ,618,1430,2048,10883,,13030,23913
00227900,LAWRENCE TECHNOLOGICAL UNIVERSITY       ,MI,48075-1058,Private      ,63,139,202,2219,,1610,3829
00228200,MADONNA UNIVERSITY                      ,MI,48150-1173,Private      ,71,257,328,2110,,3837,5947
00228400,MARYGROVE COLLEGE                       ,MI,48221-2599,Private      ,83,366,449,1467,,3800,5267
00228800,ROCHESTER COLLEGE                       ,MI,48307-2764,Private      ,21,71,92,944,,960,1904
00229000,MICHIGAN STATE UNIVERSITY               ,MI,48824-1113,Public       ,1065,925,1990,42148,,15825,57973
00229200,MICHIGAN TECHNOLOGICAL UNIV             ,MI,49931-1295,Public       ,112,59,171,6650,,1074,7724
00229300,LAKE SUPERIOR STATE UNIVERSITY          ,MI,49783-1691,Public       ,61,79,140,2783,,1023,3806
00229400,MONROE COUNTY COMMUNITY CLG             ,MI,48161-9746,Public       ,160,341,501,2086,,2813,4899
00229500,MONTCALM COMMUNITY COLLEGE              ,MI,48885-9723,Public       ,56,181,237,1113,,1711,2824
00229700,MUSKEGON COMMUNITY COLLEGE              ,MI,49442-1432,Public       ,188,455,643,3429,,3864,7293
00229900,NORTH CENTRAL MICHIGAN COLLEGE          ,MI,49770-8740,Public       ,61,204,265,1319,,1613,2932
00230100,NORTHERN MICHIGAN UNIVERSITY            ,MI,49855-5316,Public       ,231,235,466,8888,,3184,12072
00230200,NORTHWESTERN MICHIGAN COLLEGE           ,MI,49686-3061,Public       ,164,337,501,2943,,3405,6348
00230301,OAKLAND COMMUNITY COLLEGE - ORCHARD RIDG,MI,48334-4579,Public       ,289,656,945,4347,,6344,10691
00230302,OAKLAND COMMUNITY COLLEGE - ROYAL OAK CA,MI,48067-3898,Public       ,430,1001,1431,5409,,9120,14529
00230303,OAKLAND COMMUNITY COLLEGE - SOUTHFIELD C,MI,48075-4793,Public       ,373,1453,1826,4626,,11432,16058
00230304,OAKLAND COMMUNITY COLLEGE - AUBURN HILLS,MI,48323-2845,Public       ,394,793,1187,5768,,7448,13216
00230305,OAKLAND COMMUNITY COLLEGE - HIGHLAND LAK,MI,48327-4187,Public       ,209,434,643,2903,,4373,7276
00230700,OAKLAND UNIVERSITY                      ,MI,48309-4401,Public       ,538,827,1365,18048,,11677,29725
00230800,OLIVET COLLEGE                          ,MI,49076-9902,Private      ,30,21,51,1773,,311,2084
00231000,ST. CLAIR COUNTY COMMUNITY COLLEGE      ,MI,48061-0000,Public       ,142,324,466,2457,,2809,5266
00231100,KUYPER COLLEGE                          ,MI,49525-9749,Private      ,13,18,31,426,,231,657
00231300,SACRED HEART MAJOR SEMINARY             ,MI,48206-1799,Private      ,2,19,21,42,,203,245
00231400,SAGINAW VALLEY STATE UNIV               ,MI,48710-0001,Public       ,267,326,593,10916,,4587,15503
00231500,SCHOOLCRAFT COLLEGE                     ,MI,48152-2696,Public       ,544,1229,1773,7881,,11185,19066
00231600,SIENA HEIGHTS UNIVERSITY                ,MI,49221-1796,Private      ,44,206,250,1942,,2488,4430
00231700,SOUTHWESTERN MICHIGAN COLLEGE           ,MI,49047-9793,Public       ,109,200,309,2397,,2135,4532
00231800,SPRING ARBOR UNIVERSITY                 ,MI,49283-9984,Private      ,43,263,306,2464,,3550,6014
00232200,FINLANDIA UNIVERSITY                    ,MI,49930-1882,Private      ,14,17,31,718,,290,1008
00232300,UNIVERSITY OF DETROIT MERCY             ,MI,48221-3038,Private      ,113,354,467,4001,,4541,8542
00232303,UNIV OF DETROIT MERCY - LAW SCHOOL      ,MI,48226-0000,Private      ,2,38,40,78,,823,901
00232330,UNIV OF DETROIT MERCY - DENTAL SCHOOL   ,MI,48208-2576,Private      ,10,36,46,230,,779,1009
00232500,UNIVERSITY OF MICHIGAN - ANN ARBOR      ,MI,48109-1316,Public       ,1043,697,1740,39341,,14245,53586
00232501,UNIVERSITY OF MICHIGAN-MEDICAL SCH      ,MI,48109-0000,Public       ,18,35,53,378,,1200,1578
00232503,UNIVERSITY OF MICHIGAN LAW SCHOOL       ,MI,48109-0000,Public       ,2,39,41,146,,2567,2713
00232600,UNIVERSITY OF MICHIGAN-DEARBORN         ,MI,48128-2406,Public       ,280,543,823,8190,,6952,15142
00232700,UNIVERSITY OF MICHIGAN-FLINT            ,MI,48502-1950,Public       ,200,555,755,5812,,7467,13279
00232800,WASHTENAW COMMUNITY COLLEGE             ,MI,48106-0000,Public       ,440,1068,1508,5912,,8722,14634
00232900,WAYNE STATE UNIVERSITY                  ,MI,48202-0000,Public       ,748,1572,2320,21374,,23426,44800
00232901,WAYNE STATE UNIV SCH OF MEDICINE        ,MI,48201-3359,Public       ,56,100,156,1024,,2333,3357
00232902,WAYNE STATE UNIVERSITY - LAW SCHOOL     ,MI,48202-3424,Public       ,8,62,70,248,,1234,1482
00233000,WESTERN MICHIGAN UNIVERSITY             ,MI,49008-3899,Public       ,601,688,1289,23815,,11552,35367
00233100,WESTERN THEOLOGICAL SEMINARY            ,MI,49423-0000,Private      ,1,7,8,6,,180,186
00407100,WALSH COLLEGE OF ACCT & BUS ADMN        ,MI,48007-7006,Private      ,31,295,326,435,,2722,3157
00407200,NORTHWOOD UNIVERSITY                    ,MI,48640-2398,Private      ,42,174,216,2217,,2077,4294
00467300,BAKER COLLEGE - FLINT                   ,MI,48507-5508,Private      ,198,626,824,3054,,7518,10572
00467301,BAKER COLLEGE OF CADILLAC               ,MI,49601-0000,Private      ,46,193,239,683,,1934,2617
00467302,BAKER COLLEGE OF CLINTON TOWNSHIP       ,MI,48035-0000,Private      ,137,449,586,1921,,5379,7300
00467303,BAKER COLLEGE OF MUSKEGON               ,MI,49442-0000,Private      ,136,381,517,2756,,4190,6946
00467304,BAKER COLLEGE OF OWOSSO                 ,MI,48867-0000,Private      ,103,177,280,1860,,2280,4140
00467305,BAKER COLLEGE OF AUBURN HILLS           ,MI,48326-0000,Private      ,102,352,454,1261,,3925,5186
00467306,BAKER COLLEGE OF PORT HURON             ,MI,48060-0000,Private      ,30,114,144,596,,1227,1823
00467309,BAKER COLLEGE OF JACKSON                ,MI,49202-0000,Private      ,58,287,345,964,,2828,3792
00467311,BAKER COLLEGE-CASS CITY                 ,MI,48726-0000,Private      ,9,27,36,189,,368,557
00467313,BAKER COLLEGE - GRADUATE ON-LINE        ,MI,48507-0000,Private      ,40,587,627,578,,6879,7457
00467317,BAKER COLLEGE-ALLEN PARK                ,MI,48101-0000,Private      ,130,452,582,1613,,5123,6736
00469200,DORSEY SCHOOL OF BUSINESS               ,MI,48195-2334,Proprietary  ,17,63,80,104,,426,530
00469201,DORSEY SCHOOL OF BUSINESS               ,MI,48184-0000,Proprietary  ,23,78,101,108,,422,530
00469202,DORSEY SCHOOL OF BUSINESS               ,MI,48071-0000,Proprietary  ,14,79,93,118,,452,570
00469204,DORSEY SCHOOL OF BUSINESS               ,MI,48066-0000,Proprietary  ,52,122,174,284,,777,1061
00469205,DORSEY BUSINESS SCHOOL - FARMINGTON HILL,MI,48334-3385,Proprietary  ,7,31,38,63,,250,313
00469206,DORSEY BUSINESS SCHOOL - ROSEVILLE CULIN,MI,48066-4555,Proprietary  ,29,79,108,154,,441,595
00469207,DORSEY BUSINESS SCHOOL - WATERFORD/PONTI,MI,48341-1037,Proprietary  ,22,92,114,100,,438,538
00469208,DORSEY BUSINESS SCHOOL - SAGINAW CAMPUS ,MI,48603-5201,Proprietary  ,29,128,157,111,,494,605
00469209,DORSEY SCHOOL OF BUSINESS - LANSING     ,MI,48911-5744,Proprietary  ,15,71,86,81,,381,462
00469210,DORSEY SCHOOL OF BUSINESS - DEARBORN    ,MI,48228-3858,Proprietary  ,19,144,163,32,,200,232
00491003,KAPLAN CAREER INSTITUTE - DEARBORN      ,MI,48228-0000,Proprietary  ,11,119,130,143,,773,916
00676800,MID MICHIGAN COMMUNITY COLLEGE          ,MI,48625-9447,Public       ,146,351,497,2757,,3168,5925
00677100,COLLEGE FOR CREATIVE STUDIES            ,MI,48202-4034,Private      ,79,91,170,1951,,1073,3024
00694900,KALAMAZOO VALLEY COMMUNITY COLLEGE      ,MI,49003-4070,Public       ,379,937,1316,6408,,8197,14605
00717100,KIRTLAND COMMUNITY COLLEGE              ,MI,48653-0000,Public       ,69,227,296,1000,,1833,2833
00732991,ITT TECHNICAL INSTITUTE                 ,MI,49519-1851,Proprietary  ,88,423,511,780,,2951,3731
00761700,CARNEGIE INSTITUTE                      ,MI,48083-1159,Proprietary  ,14,46,60,80,,419,499
00795000,WEST SHORE COMMUNITY COLLEGE            ,MI,49454-0000,Public       ,50,101,151,660,,997,1657
00817800,EMPIRE BEAUTY SCHOOL                    ,MI,49525-2440,Proprietary  ,96,234,330,393,,774,1167
00832903,ITT TECHNICAL INSTITUTE                 ,MI,48083-2008,Proprietary  ,0,1,1,0,,2,2
00890600,MACOMB COMMUNITY COLLEGE                ,MI,48088-3896,Public       ,1092,2047,3139,14689,,17080,31769
00894600,PORT HURON COSMETOLOGY COLLEGE          ,MI,48329-1618,Proprietary  ,2,17,19,30,,83,113
00923000,WAYNE COUNTY COMMUNITY CLG-DISTRICT     ,MI,48226-3010,Public       ,778,3324,4102,9777,,28095,37872
00982800,EVEREST INSTITUTE                       ,MI,48033-4400,Proprietary  ,43,225,268,332,,1686,2018
00982801,EVEREST INSTITUTE- DEARBORN             ,MI,48124-1927,Proprietary  ,31,195,226,333,,1193,1526
00982803,EVEREST INSTITUTE - DETROIT             ,MI,48207-4291,Proprietary  ,38,209,247,398,,1363,1761
01047000,KALAMAZOO BEAUTY ACADEMY                ,MI,49002-5220,Proprietary  ,3,10,13,36,,80,116
01082700,DAVID PRESSLEY PROF SCH OF COSMTLGY     ,MI,48067-3219,Proprietary  ,19,51,70,200,,324,524
01109800,FLINT INSTITUTE OF BARBERING            ,MI,48504-4395,Proprietary  ,13,31,44,71,,201,272
01229100,WRIGHT BEAUTY ACADEMY                   ,MI,49015-2696,Proprietary  ,5,18,23,47,,131,178
01262700,THOMAS M. COOLEY LAW SCHOOL             ,MI,48901-1586,Private      ,4,129,133,47,,3272,3319
01321800,M J MURPHY BTY CLG MT PLEASANT          ,MI,48858-2502,Proprietary  ,6,31,37,61,,133,194
02060300,MICHIGAN INSTITUTE OF AERONAUTICS       ,MI,48188-2533,Proprietary  ,56,111,167,653,,761,1414
02099700,ROSS MEDICAL EDUCATION CENTER           ,MI,48532-0000,Proprietary  ,85,211,296,442,,1337,1779
02099701,ROSS MEDICAL EDUCATION CENTER-SAGINAW   ,MI,48603-5227,Proprietary  ,2,31,33,68,,177,245
02099702,ROSS MEDICAL EDUCATION CENTER-PORT HURON,MI,48060-1958,Proprietary  ,1,9,10,23,,89,112
02099703,ROSS MEDICAL EDUCATION CENTER-ROOSEVELT ,MI,49441-4156,Proprietary  ,4,7,11,14,,47,61
02100400,EVEREST INSTITUTE                       ,MI,49525-2301,Proprietary  ,26,148,174,273,,1100,1373
02100401,EVEREST INSTITUTE - KALAMAZOO           ,MI,49009-3307,Proprietary  ,16,107,123,158,,647,805
02125600,MICHIGAN COLLEGE OF BEAUTY              ,MI,48083-0000,Proprietary  ,25,60,85,173,,392,565
02158600,MR BELA'S SCHOOL OF COSMETOLOGY         ,MI,48092-4637,Proprietary  ,9,32,41,63,,187,250
02160303,INTERNATIONAL ACADEMY OF DESIGN AND TECH,MI,48083-2160,Proprietary  ,8,34,42,362,,582,944
02180100,ROSS MEDICAL EDUCATION CENTER           ,MI,48092-0000,Proprietary  ,52,154,206,291,,863,1154
02180105,ROSS MEDICAL EDUCATION CENTER-REDFORD   ,MI,48239-1260,Proprietary  ,4,14,18,36,,128,164
02198900,MICHIGAN SCHOOL OF PROFESSIONAL PSYCHOLO,MI,48334-4512,Private      ,5,24,29,38,,320,358
02209200,TAYLORTOWN SCHOOL OF BEAUTY             ,MI,48180-0000,Proprietary  ,34,57,91,123,,298,421
02237800,SPECS HOWARD SCHOOL OF MEDIA ARTS       ,MI,48075-0000,Proprietary  ,71,136,207,751,,1005,1756
02285700,BAYSHIRE BEAUTY ACADEMY                 ,MI,48708-5614,Proprietary  ,7,24,31,50,,156,206
02289801,KAPLAN INSTITUTE - DETROIT CAMPUS       ,MI,48202-0000,Proprietary  ,0,0,0,59,,245,304
02324500,MICHIGAN COLLEGE OF BEAUTY              ,MI,48161-3901,Proprietary  ,10,28,38,99,,225,324
02339700,ROSS MEDICAL EDUCATION CENTER           ,MI,48116-0000,Proprietary  ,56,212,268,243,,1163,1406
02339701,ROSS MEDICAL EDUCATION CENTER-ANN ARBOR ,MI,48108-1411,Proprietary  ,4,22,26,49,,167,216
02339703,ROSS MEDICAL EDUCATION CENTER - DAVISON ,MI,48423-1751,Proprietary  ,4,9,13,26,,86,112
02361500,MICHIGAN BARBER COLLEGE                 ,MI,48204-2244,Private      ,13,101,114,168,,603,771
02363800,YESHIVA GEDOLAH OF GREATER DETROIT      ,MI,48237-0000,Private      ,19,0,19,30,,8,38
02491000,WEST MI COLG OF BARBERING & BEAUTY      ,MI,49008-0000,Proprietary  ,6,29,35,55,,161,216
02531806,PAUL MITCHELL THE SCHOOL -MICHIGAN      ,MI,48313-0000,Proprietary  ,25,44,69,128,,199,327
02533600,ROSS MEDICAL EDUCATION CENTER           ,MI,48917-2108,Proprietary  ,49,132,181,252,,836,1088
02533601,ROSS MEDICAL EDUCATION CENTER - GRAND RA,MI,49546-2430,Proprietary  ,10,50,60,96,,339,435
02588200,DOUGLAS J AVEDA INSTITUTE               ,MI,48823-4351,Proprietary  ,73,107,180,730,,863,1593
02588201,DOUGLAS J AVEDA INSTITUTE - ANN ARBOR   ,MI,48104-2211,Proprietary  ,7,21,28,186,,205,391
02595700,HILLSDALE BEAUTY COLLEGE                ,MI,49242-0000,Proprietary  ,5,6,11,81,,50,131
02618400,MICHIGAN CAREER & TECHNICAL INST        ,MI,49080-9254,Public       ,75,31,106,316,,122,438
03005700,DETROIT BUSINESS INST. DOWNRIVER        ,MI,48193-6761,Proprietary  ,4,30,34,35,,222,257
03028500,LAWTON SCHOOL                           ,MI,48075-0000,Proprietary  ,0,0,0,13,,79,92
03066600,BAY MILLS COMMUNITY COLLEGE             ,MI,49715-9750,Public       ,20,49,69,230,,500,730
03075200,TWIN CITY BEAUTY COLLEGE                ,MI,49085-3305,Proprietary  ,12,37,49,142,,244,386
03075201,TWIN CITY BEAUTY COLLEGE - TRAVERSE CITY,MI,49686-5119,Proprietary  ,2,9,11,43,,74,117
03090000,SHARP'S ACADEMY OF HAIRSTYLING          ,MI,48439-1838,Proprietary  ,2,4,6,33,,48,81
03109700,HOUGHTON LAKE INST OF COSMETOLOGY       ,MI,48629-0669,Proprietary  ,6,15,21,41,,80,121
03110300,THE SCHOOL OF CREATIVE HAIR DESIGN      ,MI,49036-1139,Proprietary  ,4,11,15,30,,76,106
03124000,NORTHWESTERN TECHNOLOGICAL INST         ,MI,48075-2412,Proprietary  ,15,112,127,123,,544,667
03284300,MICHIGAN JEWISH INSTITUTE               ,MI,48237-0000,Private      ,447,466,913,1332,,822,2154
03490300,PAUL MITCHELL THE SCHOOL ESCANABA       ,MI,49829-0000,Proprietary  ,12,13,25,174,,152,326
03588300,IRENE'S MYOMASSOLOGY INSTITUTE          ,MI,48033-2404,Proprietary  ,5,59,64,101,,416,517
03704300,BLUE WATER COLLEGE OF COSMETOLOGY       ,MI,48040-2093,Proprietary  ,3,8,11,26,,43,69
03772300,SAGINAW CHIPPEWA TRIBAL COLLEGE         ,MI,48858-0000,Public       ,4,12,16,28,,100,128
03815300,IN SESSION-ARTS OF COSMETOLOGY BEAU     ,MI,48609-0000,Proprietary  ,10,21,31,78,,159,237
03907300,PAUL MITCHELL THE SCHOOL GREAT LAKES    ,MI,48060-0000,Proprietary  ,9,18,27,123,,162,285
03915300,CAREER QUEST LEARNING CENTER            ,MI,48910-4732,Proprietary  ,28,169,197,176,,996,1172
03915301,CAREER QUEST LEARNING CENTER - JACKSON  ,MI,49201-2475,Proprietary  ,10,68,78,50,,281,331
03915302,CAREER QUEST LEARNING CENTER - KALAMAZOO,MI,49002-1711,Proprietary  ,7,25,32,55,,266,321
03968300,LAKEWOOD SCHOOL OF THERAPEUTIC MASSAGE  ,MI,48060-0000,Proprietary  ,2,10,12,20,,72,92
03976500,ANN ARBOR INSTITUTE OF MASSAGE THERAPY  ,MI,48103-0000,Proprietary  ,1,29,30,59,,177,236
04002400,ECUMENICAL THEOLOGICAL SEMINARY         ,MI,48201-3035,Private      ,0,20,20,13,,177,190
04006300,NUVO COLLEGE OF COSMETOLOGY             ,MI,49441-3822,Proprietary  ,7,17,24,30,,104,134
04014300,P&A SCHOLARS BEAUTY SCHOOL              ,MI,48204-0000,Proprietary  ,17,102,119,222,,709,931
04094300,ROBERT B. MILLER COLLEGE (THE)          ,MI,49017-3306,Private      ,2,42,44,120,,571,691
04121100,GALLERY COLLEGE OF BEAUTY (THE)         ,MI,48036-3591,Proprietary  ,4,34,38,74,,254,328
04136300,FOCUS:  HOPE INFORMATION TECHNOLOGIES CE,MI,48238-2949,Private      ,7,91,98,168,,601,769
04138400,SCHOOL OF DESIGNING ARTS                ,MI,49015-2853,Proprietary  ,8,23,31,69,,128,197
04140900,INTERNATIONAL COSMETOLOGY ACADEMY       ,MI,49508-1308,Proprietary  ,9,23,32,62,,186,248
04141100,FRENCH ACADEMY OF COSMETOLOGY           ,MI,49456-3207,Proprietary  ,9,10,19,37,,80,117
04158400,L'ESPRIT ACADEMY                        ,MI,48150-0000,Proprietary  ,15,37,52,114,,221,335
04159300,MARKETTI ACADEMY OF COSMETOLOGY         ,MI,48329-3506,Proprietary  ,5,17,22,60,,93,153
04163300,COMPASS COLLEGE OF CINEMATIC ARTS       ,MI,49503-4227,Private      ,6,10,16,146,,88,234
04164700,KEWEENAW BAY OJIBWA COMMUNITY COLLEGE   ,MI,49908-0000,Public       ,1,8,9,21,,95,116
04169300,SCHOLARS COSMETOLOGY UNIVERSITY         ,MI,48108-0000,Proprietary  ,5,9,14,43,,115,158
04183300,ABCOTT INSTITUTE                        ,MI,48075-5227,Proprietary  ,9,54,63,63,,299,362
04184700,PROTEGE ACADEMY                         ,MI,48823-8660,Proprietary  ,9,17,26,60,,132,192
04207000,SCHOOL OF MISSIONARY AVIATION TECHNOLOGY,MI,48846-7412,Private      ,0,2,2,35,,42,77
04211200,BRIGHTON INSTITUTE OF COSMETOLOGY       ,MI,48116-8360,Proprietary  ,3,10,13,39,,68,107
04222300,MANTHANO CHRISTIAN COLLEGE              ,MI,48185-1919,Private      ,0,1,1,0,,1,1
00233200,ANOKA-RAMSEY CC-CAMBRIDGE/COONRAPID     ,MN,55433-3499,Public       ,324,563,887,3955,,5197,9152
00233400,AUGSBURG COLLEGE                        ,MN,55454-1351,Private      ,92,207,299,3398,,2528,5926
00233500,RIVERLAND COMMUNITY COLLEGE             ,MN,55912-1473,Public       ,86,251,337,1049,,1887,2936
00233600,BEMIDJI STATE UNIVERSITY                ,MN,56601-2699,Public       ,103,211,314,3956,,2254,6210
00233700,BETHANY LUTHERAN COLLEGE INC            ,MN,56001-6163,Private      ,4,6,10,716,,88,804
00233900,CENTRAL LAKES COLG-BRAINERD/STAPLES     ,MN,56401-3900,Public       ,71,234,305,1476,,2008,3484
00234000,CARLETON COLLEGE                        ,MN,55057-4001,Private      ,63,8,71,3733,,107,3840
00234100,COLLEGE OF ST BENEDICT                  ,MN,56374-2099,Private      ,35,8,43,2244,,98,2342
00234200,ST. CATHERINE UNIVERSITY                ,MN,55105-1789,Private      ,79,245,324,2953,,3679,6632
00234300,COLLEGE OF ST SCHOLASTICA               ,MN,55811-4199,Private      ,57,261,318,2446,,2542,4988
00234500,UNIVERSITY OF ST THOMAS                 ,MN,55105-1096,Private      ,141,283,424,7296,,3637,10933
00234600,CONCORDIA COLLEGE-MOORHEAD              ,MN,56562-0001,Private      ,47,21,68,3095,,225,3320
00234700,"CONCORDIA UNIVERSITY, ST PAUL, MN       ",MN,55104-5494,Private      ,91,489,580,1772,,3386,5158
00235000,VERMILION COMMUNITY COLLEGE             ,MN,55731-1996,Public       ,22,17,39,543,,203,746
00235300,GUSTAVUS ADOLPHUS COLLEGE               ,MN,56082-1498,Private      ,70,11,81,3592,,132,3724
00235400,HAMLINE UNIVERSITY                      ,MN,55104-1284,Private      ,111,255,366,3541,,2923,6464
00235500,HIBBING COMMUNITY COLLEGE               ,MN,55746-3300,Public       ,32,89,121,686,,1035,1721
00235600,ITASCA COMMUNITY COLLEGE                ,MN,55744-3397,Public       ,31,82,113,842,,688,1530
00235700,LUTHER SEMINARY                         ,MN,55108-0000,Private      ,1,15,16,7,,391,398
00235800,MACALESTER COLLEGE                      ,MN,55105-1899,Private      ,92,22,114,3804,,256,4060
00236000,"MINNESOTA STATE UNIVERSITY, MANKATO     ",MN,56002-0000,Public       ,317,360,677,12597,,4855,17452
00236100,MARTIN LUTHER COLLEGE                   ,MN,56073-3965,Private      ,8,5,13,693,,72,765
00236200,MINNEAPOLIS COMM AND TECH COLLEGE       ,MN,55403-1779,Public       ,409,1415,1824,4397,,11250,15647
00236500,MINNEAPOLIS COLLEGE OF ART & DESIGN     ,MN,55404-4343,Private      ,32,63,95,1031,,610,1641
00236600,CROSSROADS COLLEGE                      ,MN,55902-2382,Private      ,3,15,18,93,,101,194
00236700,MINNESOTA STATE UNIVERSITY MOORHEAD     ,MN,56563-0001,Public       ,127,225,352,5454,,2715,8169
00236900,NORTH CENTRAL UNIVERSITY                ,MN,55404-1391,Private      ,29,37,66,1356,,504,1860
00237000,NORTH HENNEPIN COMMUNITY COLLEGE        ,MN,55445-2299,Public       ,241,664,905,3257,,6224,9481
00237100,NORTHWESTERN COLLEGE                    ,MN,55113-1598,Private      ,52,113,165,2464,,1032,3496
00237300,ROCHESTER COMMUNITY/TECH COLLEGE        ,MN,55904-4999,Public       ,158,544,702,2885,,4081,6966
00237500,SOUTHWEST MINNESOTA STATE UNIVERSITY    ,MN,56258-1598,Public       ,42,96,138,2189,,1266,3455
00237700,ST CLOUD STATE UNIVERSITY               ,MN,56301-4498,Public       ,302,445,747,10348,,5455,15803
00237900,SAINT JOHNS UNIVERSITY                  ,MN,56321-0000,Private      ,31,4,35,2048,,100,2148
00238000,SAINT MARY'S UNIVERSITY                 ,MN,55987-1399,Private      ,41,400,441,1740,,3571,5311
00238200,ST OLAF COLLEGE                         ,MN,55057-1098,Private      ,68,12,80,3917,,133,4050
00238300,CROWN COLLEGE                           ,MN,55375-9001,Private      ,26,131,157,941,,949,1890
00238500,NORTHLAND COMMUNITY & TECHNICAL CLG     ,MN,56701-2598,Public       ,105,199,304,1586,,1959,3545
00238600,UNITED THEOLGCL SEMINRY TWIN CITIES     ,MN,55112-0000,Private      ,0,6,6,8,,102,110
00238800,"UNIVERSITY OF MINNESOTA, DULUTH         ",MN,55812-2496,Public       ,285,135,420,10742,,2503,13245
00238900,"UNIVERSITY OF MINNESOTA, MORRIS         ",MN,56267-2113,Public       ,44,18,62,2412,,350,2762
00239100,WILLIAM MITCHELL COLLEGE OF LAW         ,MN,55105-0000,Private      ,1,26,27,11,,1040,1051
00239300,MINNESOTA STATE COLLEGE-SE TECH         ,MN,55987-0409,Public       ,51,181,232,890,,1589,2479
00239400,WINONA STATE UNIVERSITY                 ,MN,55987-5838,Public       ,152,142,294,7812,,1852,9664
00396900,UNIVERSITY OF MINNESOTA-TWIN CITIES     ,MN,55455-0422,Public       ,857,1031,1888,34648,,18369,53017
00400900,MESABI RANGE CMNTY & TECH COLLEGE       ,MN,55792-0000,Public       ,32,73,105,628,,729,1357
00405708,NATIONAL AMERICAN UNIVERSITY            ,MN,55113-0000,Proprietary  ,2,29,31,33,,347,380
00405715,NATIONAL AMERICAN UNIVERSITY - BLOOMINGT,MN,55425-5550,Proprietary  ,4,45,49,36,,497,533
00406900,UNIVERSITY OF MINNESOTA-CROOKSTON       ,MN,56716-5001,Public       ,21,109,130,1172,,1033,2205
00438600,VETERAN'S MEDICAL CTR- SCH RAD TECH     ,MN,55417-2399,Public       ,0,5,5,7,,31,38
00464100,DUNWOODY COLLEGE OF TECHNOLOGY          ,MN,55403-1192,Private      ,70,192,262,708,,1419,2127
00464200,GLOBE UNIVERSITY                        ,MN,55125-5408,Proprietary  ,105,373,478,1119,,3673,4792
00464500,MINNEAPOLIS BUSINESS COLLEGE            ,MN,55113-4036,Proprietary  ,7,13,20,345,,184,529
00464600,MINNESOTA SCHOOL OF BUSINESS            ,MN,55423-0000,Proprietary  ,81,311,392,1087,,3501,4588
00525200,RIDGEWATER COLLEGE                      ,MN,56201-2098,Public       ,92,255,347,1984,,2052,4036
00526300,MINNESOTA WEST CMNTY & TECH COLG        ,MN,56241-1096,Public       ,40,150,190,863,,1547,2410
00553300,"SAINT PAUL COLLEGE, COMMUNITY/TECHNICAL ",MN,55102-1800,Public       ,316,1177,1493,3647,,8360,12007
00553400,SAINT CLOUD TECHNICAL COLLEGE AND COMMUN,MN,56303-1240,Public       ,204,337,541,3030,,3286,6316
00553500,PINE TECHNICAL COLLEGE                  ,MN,55063-2198,Public       ,17,98,115,278,,903,1181
00553700,SOUTH CENTRAL COLLEGE                   ,MN,56003-0000,Public       ,105,257,362,1780,,2364,4144
00554100,MINNESOTA STATE COMMUNITY AND TECHNICAL ,MN,56573-1405,Public       ,129,337,466,2342,,3463,5805
00554400,ALEXANDRIA TECHNICAL COLLEGE            ,MN,56308-3799,Public       ,46,96,142,1374,,987,2361
00575700,LAKE SUPERIOR COLLEGE                   ,MN,55811-3399,Public       ,114,361,475,2212,,3285,5497
00575900,NORTHWEST TECHNICAL COLLEGE - BEMIDJI   ,MN,56601-4907,Public       ,17,107,124,416,,954,1370
00677500,RAINY RIVER COMMUNITY COLLEGE           ,MN,56649-2187,Public       ,9,16,25,167,,134,301
00735000,ANOKA-HENNEPIN TECHNICAL COLLEGE        ,MN,55303-1590,Public       ,87,312,399,1094,,2797,3891
00735100,BROWN COLLEGE                           ,MN,55120-1004,Proprietary  ,19,92,111,218,,688,906
00746200,COLLEGE OF VISUAL ARTS                  ,MN,55102-2199,Private      ,0,0,0,65,,67,132
00795400,NORMANDALE COMMUNITY COLLEGE            ,MN,55431-4399,Public       ,353,745,1098,4881,,5948,10829
00826700,NORTHWEST TECHNICAL INSTITUTE           ,MN,55121-5001,Proprietary  ,2,8,10,17,,46,63
00869400,RASMUSSEN COLLEGE - ST. CLOUD           ,MN,56301-3713,Proprietary  ,26,153,179,254,,1364,1618
00869401,RASMUSSEN COLLEGE - BROOKLYN PARK       ,MN,55445-1512,Proprietary  ,23,171,194,250,,1424,1674
00869406,RASMUSSEN COLLEGE - EAGAN               ,MN,55122-1346,Proprietary  ,19,118,137,201,,1234,1435
00869407,RASMUSSEN COLLEGE - BLOOMINGTON         ,MN,55435-5444,Proprietary  ,22,162,184,193,,1537,1730
00869409,RASMUSSEN COLLEGE - MANKATO             ,MN,56001-8658,Proprietary  ,16,114,130,234,,1046,1280
00869412,RASMUSSEN COLLEGE - LAKE ELMO           ,MN,55042-8624,Proprietary  ,19,114,133,166,,954,1120
00869416,RASMUSSEN COLLEGE - MOORHEAD            ,MN,56560-4513,Proprietary  ,17,96,113,204,,793,997
00869417,RASMUSSEN COLLEGE - BLAINE              ,MN,55014-0000,Proprietary  ,23,127,150,173,,879,1052
00905800,BETHEL UNIVERSITY                       ,MN,55112-6999,Private      ,75,252,327,3404,,2552,5956
00945911,EMPIRE BEAUTY SCHOOL - ST. PAUL         ,MN,55119-7003,Proprietary  ,0,0,0,81,,211,292
00960000,COSMETOLOGY CAREERS UNLTD-DULUTH        ,MN,55802-2031,Proprietary  ,2,6,8,19,,57,76
00974000,INVER HILLS COMMUNITY COLLEGE           ,MN,55076-3224,Public       ,208,501,709,2693,,4028,6721
00983100,MODEL COLLEGE OF HAIR DESIGN            ,MN,56301-4280,Proprietary  ,8,15,23,138,,124,262
00987000,EMPIRE BEAUTY SCHOOL                    ,MN,55420-2919,Proprietary  ,0,0,0,111,,199,310
00989200,"DULUTH BUSINESS UNIV, INC.              ",MN,55807-0000,Proprietary  ,9,36,45,115,,345,460
00999200,OAK HILLS CHRISTIAN COLLEGE             ,MN,56601-0000,Private      ,3,9,12,128,,74,202
01024800,ART INSTITUTES INTL MINNESOTA           ,MN,55402-3137,Proprietary  ,112,128,240,1280,,1244,2524
01035602,EVEREST INSTITUTE - EAGAN               ,MN,55121-1696,Proprietary  ,15,95,110,82,,544,626
01037400,METROPOLITAN STATE UNIVERSITY           ,MN,55106-5000,Public       ,160,840,1000,2374,,9507,11881
01040200,DAKOTA COUNTY TECHNICAL COLLEGE         ,MN,55068-2999,Public       ,89,270,359,1289,,2357,3646
01049000,REGENCY BEAUTY INSTITUTE                ,MN,55428-0000,Proprietary  ,408,877,1285,3685,,6839,10524
01049100,HENNEPIN TECHNICAL COLLEGE              ,MN,55445-2399,Public       ,219,813,1032,2117,,6372,8489
01054600,CENTURY COLLEGE                         ,MN,55110-1894,Public       ,409,897,1306,5270,,8242,13512
01173200,"MAYO CLINIC, COLLEGE OF MEDICINE        ",MN,55905-0000,Private      ,5,20,25,83,,409,492
01173201,MAYO SCHOOL OF HEALTH-RELATED SCIEN     ,MN,55905-0000,Private      ,3,19,22,88,,235,323
01173206,MAYO GRAD SCHOOL                        ,MN,55901-0000,Private      ,1,3,4,8,,57,65
01173207,MAYO MEDICAL SCHOOL                     ,MN,55901-0000,Private      ,2,9,11,33,,209,242
01232800,NORTHWESTERN HEALTH SCIENCES UNIV       ,MN,55431-1599,Private      ,8,63,71,84,,923,1007
02050300,ACADEMY COLLEGE                         ,MN,55420-1554,Proprietary  ,8,31,39,42,,205,247
02097300,HASTINGS BEAUTY SCHOOL                  ,MN,55033-1205,Proprietary  ,0,4,4,13,,46,59
02123200,AVEDA INSTITUTE                         ,MN,55414-0000,Proprietary  ,43,91,134,470,,537,1007
02159800,COSMETOLOGY CAREERS UNLTD - HIBBING     ,MN,55746-0000,Proprietary  ,0,3,3,20,,45,65
02160901,"SALON PROFESSIONAL ACADEMY, THE - THE SA",MN,55428-4928,Proprietary  ,11,7,18,36,,56,92
02238100,MINNESOTA SCHOOL OF COSMETOLOGY         ,MN,55125-0000,Proprietary  ,14,27,41,156,,234,390
02260500,SUMMIT ACAD OPPORTUNITIES IND CTR       ,MN,55405-0000,Private      ,19,136,155,98,,641,739
02263102,ANTHEM COLLEGE - ST. LOUIS PARK         ,MN,55416-2467,Proprietary  ,3,13,16,27,,191,218
02504200,WALDEN UNIVERSITY                       ,MN,55401-2511,Proprietary  ,55,8094,8149,385,,57812,58197
02514100,AMERICAN INDIAN OPPORTUNITIES CTR       ,MN,55404-0000,Private      ,4,58,62,24,,290,314
03001200,MCNALLY SMITH COLLEGE OF MUSIC          ,MN,55101-2220,Proprietary  ,45,33,78,746,,308,1054
03051900,ALFRED ADLER GRADUATE SCHOOL            ,MN,55305-0000,Private      ,0,53,53,1,,352,353
03096400,LEECH LAKE TRIBAL COLLEGE               ,MN,56633-0000,Public       ,7,48,55,77,,385,462
03129100,FOND DU LAC TRIBAL & COMMUNITY CLG      ,MN,55720-2984,Public       ,29,96,125,494,,971,1465
03267300,CAPELLA UNIVERSITY                      ,MN,55402-3389,Proprietary  ,33,4348,4381,301,,52145,52446
03833300,AMERICAN ACADEMY OF ACUPUNCTURE AND ORIE,MN,55113-0000,Proprietary  ,0,16,16,1,,77,78
03921400,WHITE EARTH TRIBAL AND COMMUNITY COLLEGE,MN,56557-0478,Private      ,2,11,13,17,,97,114
04044300,HAZELDEN GRADUATE SCHOOL OF ADDICTION ST,MN,55012-0000,Private      ,1,26,27,7,,165,172
04130200,INST. OF PRODUCTION AND RECORDING       ,MN,55401-1315,Proprietary  ,18,59,77,338,,396,734
04148800,CENTERPOINT MASSAGE & SHIATSU THERAPY SC,MN,55414-4525,Proprietary  ,5,57,62,29,,195,224
04157600,NOVA ACADEMY OF COSMETOLOGY             ,MN,55906-4103,Proprietary  ,6,12,18,56,,107,163
04160500,AVALON SCHOOL OF COSMETOLOGY            ,MN,56187-1930,Proprietary  ,0,3,3,16,,45,61
04174400,ROCHESTER SCHOOL OF HAIR DESIGN         ,MN,55901-4310,Proprietary  ,5,5,10,37,,57,94
04175600,PARK AVENUE SCHOOL OF COSMETOLOGY       ,MN,56470-3361,Proprietary  ,2,19,21,19,,83,102
00239600,ALCORN STATE UNIVERSITY                 ,MS,39096-7500,Public       ,116,251,367,4417,,4015,8432
00239700,BELHAVEN UNIVERSITY                     ,MS,39202-1789,Private      ,93,534,627,1854,,5304,7158
00239800,BLUE MOUNTAIN COLLEGE                   ,MS,38610-9370,Private      ,20,26,46,600,,361,961
00240100,COAHOMA COMMUNITY COLLEGE               ,MS,38614-9799,Public       ,85,188,273,1694,,2203,3897
00240200,COPIAH-LINCOLN COMMUNITY COLLEGE        ,MS,39191-0649,Public       ,116,234,350,2366,,2371,4737
00240300,DELTA STATE UNIVERSITY                  ,MS,38733-0000,Public       ,130,217,347,3642,,3277,6919
00240400,EAST CENTRAL COMMUNITY COLLEGE          ,MS,39327-0129,Public       ,81,235,316,2068,,2164,4232
00240500,EAST MISSISSIPPI COMM COLLEGE           ,MS,39358-0000,Public       ,176,351,527,3588,,3818,7406
00240700,HINDS COMMUNITY COLLEGE                 ,MS,39154-9799,Public       ,430,1162,1592,8415,,11196,19611
00240800,HOLMES COMMUNITY COLLEGE                ,MS,39079-0000,Public       ,250,579,829,4575,,6361,10936
00240900,ITAWAMBA COMMUNITY COLLEGE              ,MS,38843-1099,Public       ,191,416,607,4484,,4337,8821
00241000,JACKSON STATE UNIVERSITY                ,MS,39217-0001,Public       ,289,699,988,8971,,11091,20062
00241100,JONES COUNTY JUNIOR COLLEGE             ,MS,39437-3999,Public       ,246,326,572,4304,,2766,7070
00241300,MERIDIAN COMMUNITY COLLEGE              ,MS,39307-5890,Public       ,124,358,482,2394,,3190,5584
00241400,MILLSAPS COLLEGE                        ,MS,39201-0000,Private      ,83,80,163,1479,,896,2375
00241500,MISSISSIPPI COLLEGE                     ,MS,39058-0001,Private      ,126,236,362,3119,,3704,6823
00241501,MISSISSIPPI COLLEGE - SCHOOL OF LAW     ,MS,39201-1391,Private      ,15,41,56,135,,936,1071
00241600,MISSISSIPPI DELTA CMTY COLLEGE          ,MS,38761-0000,Public       ,94,194,288,2458,,2416,4874
00241700,MISSISSIPPI GULF CST CLG-PERKINSTON     ,MS,39573-0000,Public       ,285,707,992,2428,,1997,4425
00241701,MISSISSIPPI GULF COAST COMMUNITY COLLEGE,MS,39507-3894,Public       ,54,211,265,2367,,4499,6866
00241702,MISSISSIPPI GULF COAST COMMUNITY COLLEGE,MS,39553-0100,Public       ,41,140,181,1932,,2857,4789
00242200,MISSISSIPPI UNIV FOR WOMEN              ,MS,39701-5818,Public       ,82,194,276,1988,,2791,4779
00242300,MISSISSIPPI STATE UNIVERSITY            ,MS,39762-9698,Public       ,743,585,1328,18461,,8296,26757
00242400,MISSISSIPPI VALLEY STATE UNIVERSITY     ,MS,38941-1400,Public       ,110,177,287,3436,,3072,6508
00242600,NORTHEAST MS CMNTY COLLEGE              ,MS,38829-1731,Public       ,117,273,390,3032,,2250,5282
00242700,NORTHWEST MISSISSIPPI COMMUNITY CLG     ,MS,38668-1703,Public       ,250,554,804,6332,,5676,12008
00243000,PEARL RIVER COMMUNITY COLLEGE           ,MS,39470-2201,Public       ,186,374,560,3586,,3696,7282
00243300,RUST COLLEGE                            ,MS,38635-2328,Private      ,45,38,83,1541,,753,2294
00243500,SOUTHEASTERN BAPTIST COLLEGE            ,MS,39440-0000,Private      ,3,13,16,26,,106,132
00243600,SOUTHWEST MISSISSIPPI CMNTY CLG         ,MS,39666-8099,Public       ,85,162,247,1648,,1501,3149
00243900,TOUGALOO COLLEGE                        ,MS,39174-9799,Private      ,43,47,90,1722,,832,2554
00244000,UNIVERSITY OF MISSISSIPPI               ,MS,38677-1848,Public       ,673,453,1126,17027,,7708,24735
00244001,UNIVERSITY OF MISSISSIPPI - MED CTR     ,MS,39216-0000,Public       ,46,157,203,861,,2714,3575
00244100,UNIVERSITY OF SOUTHERN MISSISSIPPI      ,MS,39406-0001,Public       ,496,724,1220,13665,,10753,24418
00244700,WILLIAM CAREY UNIVERSITY                ,MS,39401-5499,Private      ,99,315,414,2061,,4835,6896
00489809,MCCANN SCHOOL OF BUSINESS & TECHNOLOGY -,MS,39503-3167,Proprietary  ,7,26,33,27,,186,213
01289101,ANTONELLI COLLEGE - JACKSON             ,MS,39232-9514,Proprietary  ,17,210,227,206,,1467,1673
01289102,ANTONELLI COLLEGE - HATTIESBURG         ,MS,39401-3056,Proprietary  ,30,114,144,191,,823,1014
02074900,CHRIS' BEAUTY COLLEGE                   ,MS,39501-0000,Proprietary  ,9,27,36,67,,201,268
02160500,NORTH MISSISSIPPI MED CTR MED TECH      ,MS,38801-0000,Private      ,5,28,33,51,,195,246
02235900,ACADEMY OF HAIR DESIGN #4               ,MS,39208-0000,Proprietary  ,6,17,23,86,,200,286
02244300,ACADEMY OF HAIR DESIGN #1               ,MS,39204-5008,Proprietary  ,16,44,60,116,,282,398
02244305,ACADEMY OF HAIR DESIGN #1-ACADEMY OF HAI,MS,38901-5108,Proprietary  ,2,11,13,2,,11,13
02249900,DELTA BEAUTY COLLEGE                    ,MS,38701-0000,Proprietary  ,4,16,20,59,,130,189
02251600,ACADEMY OF HAIR DESIGN #6               ,MS,39401-7581,Proprietary  ,11,40,51,101,,301,402
02251700,FOSTER'S COSMETOLOGY COLLEGE            ,MS,38663-0000,Proprietary  ,1,8,9,12,,45,57
02302800,MISSISSIPPI COLLEGE OF BEAUTY CULT      ,MS,39440-0000,Proprietary  ,4,16,20,46,,104,150
02320800,MAGNOLIA COLLEGE OF COSMETOLOGY         ,MS,39206-0000,Proprietary  ,14,57,71,131,,427,558
02502100,CREATIONS COLLEGE OF COSMETOLOGY        ,MS,38803-0000,Proprietary  ,5,23,28,48,,148,196
02516200,WESLEY BIBLICAL SEMINARY                ,MS,39206-0000,Private      ,3,17,20,13,,153,166
02586000,J & J HAIR DESIGN COLLEGE               ,MS,39051-3716,Proprietary  ,8,19,27,52,,118,170
03004000,FINAL TOUCH BEAUTY SCHOOL               ,MS,39307-2934,Proprietary  ,0,0,0,2,,7,9
03010603,VIRGINIA COLLEGE - JACKSON              ,MS,39206-5602,Proprietary  ,9,91,100,211,,1194,1405
03010610,VIRGINIA COLLEGE - BILOXI               ,MS,39532-2124,Proprietary  ,11,49,60,124,,496,620
03032400,KC'S SCHOOL OF HAIR DESIGN              ,MS,38863-0000,Proprietary  ,6,15,21,41,,149,190
03263300,TRAXLER'S SCHOOL OF HAIR                ,MS,39212-2529,Proprietary  ,2,14,16,39,,131,170
03294305,BLUE CLIFF COLLEGE - GULFPORT           ,MS,39503-0000,Proprietary  ,14,56,70,129,,542,671
03464300,ACADEMY OF HAIR DESIGN                  ,MS,39562-0000,Proprietary  ,5,19,24,19,,76,95
03848300,DAY SPA CAREER COLLEGE                  ,MS,39564-0000,Proprietary  ,1,19,20,17,,104,121
03963300,HEALING TOUCH SCHOOL OF MASSAGE THERAPY ,MS,39402-1300,Proprietary  ,4,41,45,77,,336,413
04131300,CORINTH ACADEMY OF COSMETOLOGY          ,MS,38834-4813,Proprietary  ,8,30,38,64,,177,241
04140200,"MISSISSIPPI INSTITUTE OF AESTHETICS, NAI",MS,39056-5628,Proprietary  ,8,29,37,53,,182,235
00252600,CARROLL COLLEGE                         ,MT,59625-0002,Private      ,66,24,90,2378,,314,2692
00252700,UNIVERSITY OF GREAT FALLS               ,MT,59405-4996,Private      ,37,49,86,863,,751,1614
00252800,MILES COMMUNITY COLLEGE                 ,MT,59301-4799,Public       ,14,20,34,267,,204,471
00252900,DAWSON COMMUNITY COLLEGE                ,MT,59330-1405,Public       ,6,23,29,237,,171,408
00253000,MONTANA STATE UNIVERSITY - BILLINGS     ,MT,59101-0298,Public       ,151,375,526,2954,,3830,6784
00253100,MONTANA TECH OF THE UNIV OF MONTANA     ,MT,59701-8997,Public       ,70,166,236,1721,,1632,3353
00253200,MONTANA STATE UNIVERSITY - BOZEMAN      ,MT,59717-4160,Public       ,473,366,839,13161,,5308,18469
00253300,MONTANA STATE UNIVERSITY-NORTHERN       ,MT,59501-3148,Public       ,29,57,86,917,,915,1832
00253400,ROCKY MOUNTAIN COLLEGE                  ,MT,59102-1796,Private      ,50,59,109,1371,,556,1927
00253600,UNIVERSITY OF MONTANA (THE)             ,MT,59812-0001,Public       ,332,468,800,8700,,8147,16847
00253700,UNIVERSITY OF MONTANA WESTERN (THE)     ,MT,59725-3598,Public       ,53,42,95,1450,,628,2078
00677700,FLATHEAD VALLEY COMMUNITY COLLEGE       ,MT,59901-2699,Public       ,70,195,265,971,,1812,2783
00757000,HELENA COLLEGE OF TECHNOLOGY            ,MT,59601-3098,Public       ,43,123,166,549,,1216,1765
00790000,BUTTE ACADEMY OF BEAUTY CULTURE         ,MT,59701-9197,Proprietary  ,3,16,19,30,,75,105
00894700,"DAHL'S COLLEGE OF BEAUTY,INC            ",MT,59401-3731,Proprietary  ,0,0,0,13,,23,36
00931400,GREAT FALLS COLLEGE MONTANA STATE UNIVER,MT,59405-4907,Public       ,49,216,265,723,,1825,2548
02143400,SALISH KOOTENAI COLLEGE                 ,MT,59855-0000,Public       ,19,102,121,317,,997,1314
02286600,LITTLE BIG HORN COLLEGE                 ,MT,59022-0000,Public       ,10,29,39,101,,226,327
02343000,FT PECK COMMUNITY COLLEGE               ,MT,59255-0000,Public       ,12,37,49,84,,208,292
02510600,BLACKFEET COMMUNITY COLLEGE             ,MT,59417-0000,Private      ,8,38,46,171,,408,579
02517500,FORT BELKNAP COLLEGE                    ,MT,59526-0000,Public       ,4,13,17,55,,162,217
02545200,CHIEF DULL KNIFE COLLEGE                ,MT,59043-0098,Public       ,7,24,31,54,,145,199
02610900,STONE CHILD COLLEGE                     ,MT,59521-9796,Public       ,4,15,19,93,,209,302
02621300,ACADEMY OF COSMETOLOGY                  ,MT,59715-3544,Proprietary  ,0,7,7,44,,67,111
03205300,MODERN BEAUTY SCHOOL                    ,MT,59801-8386,Proprietary  ,4,13,17,68,,124,192
03763400,"ACADEMY OF NAIL, SKIN & HAIR            ",MT,59101-0000,Proprietary  ,8,36,44,75,,190,265
03778300,HEALTH WORKS INSTITUTE                  ,MT,59715-0000,Proprietary  ,2,13,15,48,,120,168
04163700,BITTERROOT SCHOOL OF COSMETOLOGY        ,MT,59840-3118,Proprietary  ,3,9,12,17,,56,73
04164100,SALON PROFESSIONAL ACADEMY (THE)        ,MT,59405-0000,Proprietary  ,9,15,24,77,,131,208
04187700,CREVIER'S SCHOOL OF COSMETOLOGY         ,MT,59901-4402,Proprietary  ,6,25,31,65,,169,234
00253900,CHADRON STATE COLLEGE                   ,NE,69337-2690,Public       ,72,114,186,2042,,1306,3348
00254000,COLLEGE OF ST MARY                      ,NE,68106-2606,Private      ,25,76,101,607,,1239,1846
00254100,CONCORDIA UNIVERSITY                    ,NE,68434-1594,Private      ,31,78,109,1435,,763,2198
00254200,CREIGHTON UNIVERSITY                    ,NE,68178-0001,Private      ,163,256,419,5511,,5502,11013
00254400,DOANE COLLEGE                           ,NE,68333-2421,Private      ,62,94,156,1800,,1268,3068
00254700,GRACE UNIVERSITY                        ,NE,68108-3629,Private      ,15,37,52,432,,365,797
00254800,HASTINGS COLLEGE                        ,NE,68901-7621,Private      ,68,15,83,1481,,192,1673
00255100,UNIVERSITY OF NEBRASKA AT KEARNEY       ,NE,68849-0001,Public       ,153,206,359,4916,,2398,7314
00255300,MIDLAND UNIVERSITY                      ,NE,68025-4254,Private      ,51,23,74,1615,,416,2031
00255400,UNIVERSITY OF NEBRASKA-OMAHA            ,NE,68182-0001,Public       ,331,590,921,9972,,7714,17686
00255500,NEBRASKA WESLEYAN UNIVERSITY            ,NE,68504-2796,Private      ,103,96,199,2198,,874,3072
00255700,MID-PLAINS COMM COLLEGE - NORTH PLATTE  ,NE,69101-9420,Public       ,27,85,112,543,,806,1349
00255701,MID-PLAINS COMMUNITY COLLEGE - MCCOOK   ,NE,69001-2631,Public       ,4,27,31,253,,221,474
00255900,PERU STATE COLLEGE                      ,NE,68421-0010,Public       ,56,90,146,1200,,1135,2335
00256000,WESTERN NEBRASKA COMMUNITY COLLEGE      ,NE,69361-1815,Public       ,52,136,188,786,,1022,1808
00256300,UNION COLLEGE                           ,NE,68506-4387,Private      ,21,28,49,886,,466,1352
00256500,UNIVERSITY OF NEBRASKA-LINCOLN          ,NE,68588-0419,Public       ,488,330,818,17034,,5630,22664
00256596,UNIVERSITY OF NEBRASKA - CURTIS         ,NE,69025-9522,Public       ,9,3,12,233,,53,286
00256600,WAYNE STATE COLLEGE                     ,NE,68787-1172,Public       ,100,78,178,3300,,1046,4346
00256700,YORK COLLEGE                            ,NE,68467-2699,Private      ,8,8,16,546,,152,698
00443600,REGNL WST MEDCL CTR SCHL RAD            ,NE,69361-0000,Private      ,1,7,8,22,,31,53
00458608,KAPLAN UNIVERSITY - OMAHA               ,NE,68134-1002,Proprietary  ,26,225,251,205,,1741,1946
00458609,KAPLAN UNIVERSITY - LINCOLN             ,NE,68508-2668,Proprietary  ,22,133,155,153,,1147,1300
00639900,BRYANLGH COLLEGE OF HEALTH SCIENCES     ,NE,68506-1398,Private      ,14,38,52,450,,472,922
00640400,NEBR METHODIST CLG OF NURS ALLD HLTH    ,NE,68114-2852,Private      ,12,115,127,532,,1126,1658
00689500,UNIVERSITY OF NEBRASKA-MED CTR          ,NE,68198-4265,Public       ,29,101,130,736,,2624,3360
00750100,VATTEROTT COLLEGE                       ,NE,68137-1237,Proprietary  ,19,134,153,208,,893,1101
00849200,ALEGENT HEALTH SCHOOLS                  ,NE,68114-2767,Private      ,7,48,55,109,,298,407
00952300,BAHNER COLLEGE OF HAIRSTYLING           ,NE,68025-3297,Proprietary  ,2,4,6,25,,47,72
00961700,CAPITOL BEAUTY SCHOOL                   ,NE,68144-0000,Proprietary  ,11,38,49,151,,219,370
00974300,BELLEVUE UNIVERSITY                     ,NE,68005-0000,Private      ,72,953,1025,941,,9094,10035
00986200,CLARKSON COLLEGE                        ,NE,68131-2739,Private      ,13,144,157,578,,1525,2103
01151900,JOSEPH'S COLLEGE OF BEAUTY/ALL CAMPUSES ,NE,68510-2226,Proprietary  ,12,43,55,155,,369,524
01166700,NORTHEAST COMMUNITY COLLEGE             ,NE,68702-0000,Public       ,66,176,242,2007,,1530,3537
01258600,METROPOLITAN COMMUNITY COLLEGE          ,NE,68103-0000,Public       ,376,1355,1731,5618,,12590,18208
01297600,NEBRASKA CHRISTIAN COLLEGE              ,NE,68046-4256,Private      ,7,5,12,164,,68,232
02079700,COLLEGE OF HAIR DESIGN                  ,NE,68508-0000,Proprietary  ,17,28,45,220,,220,440
02099500,CENTRAL COMMUNITY COLLEGE- GI           ,NE,68801-0000,Public       ,51,225,276,789,,1540,2329
02099501,CENTRAL COMMUNITY COLLEGE - HASTINGS    ,NE,68902-0000,Public       ,50,121,171,1063,,879,1942
02099502,CENTRAL COMMUNITY COLLEGE - COLUMBUS    ,NE,68602-0000,Public       ,20,50,70,562,,587,1149
02508300,SOUTHEAST COMM. COLLEGE-ALL CAMPUSES    ,NE,68520-0000,Public       ,300,669,969,5070,,6506,11576
02550800,NEBRASKA INDIAN COMMUNITY COLLEGE       ,NE,68039-0000,Public       ,5,21,26,33,,160,193
02610500,XENON INTERNATIONAL ACADEMY II          ,NE,68127-3522,Proprietary  ,25,42,67,221,,314,535
03164300,THE CREATIVE CENTER                     ,NE,68164-2911,Proprietary  ,1,14,15,157,,101,258
03279300,MYOTHERAPY INSTITUTE                    ,NE,68516-0000,Proprietary  ,2,8,10,37,,46,83
03323300,LITTLE PRIEST TRIBAL COLLEGE            ,NE,68071-0000,Private      ,3,14,17,30,,144,174
03821400,UNIVERSAL COLLEGE OF HEALING ARTS       ,NE,68112-1810,Proprietary  ,0,10,10,24,,138,162
00256800,UNIVERSITY OF NEVADA RENO               ,NV,89557-0002,Public       ,579,573,1152,15805,,7496,23301
00256900,UNIVERSITY OF NEVADA-LAS VEGAS          ,NV,89154-1001,Public       ,868,1469,2337,21795,,19332,41127
00697700,GREAT BASIN COLLEGE                     ,NV,89801-3348,Public       ,44,197,241,711,,1609,2320
00732954,ITT TECHNICAL INSTITUTE                 ,NV,89014-6712,Proprietary  ,47,169,216,354,,999,1353
00736700,MARINELLO SCHOOLS OF BEAUTY             ,NV,89110-3563,Proprietary  ,27,79,106,218,,467,685
00736701,MARINELLO SCHOOLS OF BEAUTY -           ,NV,89014-2244,Proprietary  ,13,39,52,86,,234,320
00737100,MARINELLO SCHOOL OF BEAUTY              ,NV,89502-6530,Proprietary  ,13,43,56,162,,337,499
00844103,ANTHEM INSTITUTE - MORRISON UNIVERSITY  ,NV,89521-4826,Proprietary  ,14,112,126,109,,633,742
00919200,SIERRA NEVADA COLLEGE                   ,NV,89451-0000,Private      ,45,65,110,598,,719,1317
01036200,COLLEGE OF SOUTHERN NEVADA              ,NV,89146-1139,Public       ,1395,3618,5013,17053,,27962,45015
01036300,WESTERN NEVADA COLLEGE                  ,NV,89703-0000,Public       ,96,380,476,1331,,3140,4471
01246110,LINCOLN TECHNICAL INSTITUTE-EUPH INST OF,NV,89117-8803,Proprietary  ,13,50,63,146,,332,478
01246111,LINCOLN TECHNICAL INSTITUTE-EUPH INS OFB,NV,89052-4964,Proprietary  ,12,24,36,96,,210,306
01246112,LINCOLN TECHNICAL INSTITUTE- EUPH INST O,NV,89131-1036,Proprietary  ,13,37,50,163,,284,447
01323200,ACADEMY OF HAIR DESIGN                  ,NV,89146-1617,Proprietary  ,27,76,103,208,,521,729
02107700,TRUCKEE MEADOWS COMMUNITY CLG           ,NV,89512-0000,Public       ,367,951,1318,4743,,7930,12673
02237500,EVEREST COLLEGE                         ,NV,89103-0000,Proprietary  ,118,371,489,884,,2380,3264
02338512,GLENDALE CAREER COLLEGE - NEVADA CAREER ,NV,89131-3268,Proprietary  ,9,35,44,83,,308,391
02616703,SCOTTSDALE CULINARY INSTITUTE - LE CORDO,NV,89144-7047,Proprietary  ,12,51,63,161,,465,626
02621500,CAREER COLLEGE OF NORTHERN NEVADA       ,NV,89434-7905,Proprietary  ,36,132,168,262,,841,1103
03030603,UTAH CLG OF MASSAGE THERAPY-NSMT        ,NV,89123-0000,Proprietary  ,22,86,108,150,,424,574
03031405,INTERNATIONAL ACADEMY OF DESIGN AND TECH,NV,89074-7750,Proprietary  ,33,75,108,330,,588,918
03043200,KAPLAN COLLEGE                          ,NV,89102-8618,Proprietary  ,83,384,467,785,,2771,3556
03076404,BRYMAN SCHOOL OF ARIZONA (THE) - ANTHEM ,NV,89102-4514,Proprietary  ,36,89,125,200,,482,682
03088200,CARSON CITY BEAUTY ACADEMY              ,NV,89706-0000,Proprietary  ,8,23,31,51,,184,235
03787300,EXPERTISE SCHOOL OF BEAUTY              ,NV,89106-2516,Private      ,15,49,64,94,,333,427
03838500,NORTHWEST HEALTH CAREERS                ,NV,89128-0255,Proprietary  ,33,142,175,258,,811,1069
03975300,INSTITUTE OF PROFESSIONAL CAREERS       ,NV,89119-7825,Proprietary  ,8,64,72,132,,448,580
04051303,ART INSTITUTE OF PHOENIX (THE) - ART INS,NV,89074-7737,Proprietary  ,27,51,78,461,,428,889
04065300,UNIVERSITY OF SOUTHERN NEVADA           ,NV,89014-2333,Private      ,44,162,206,641,,2375,3016
04114300,NEVADA STATE COLLEGE                    ,NV,89002-9455,Public       ,124,385,509,2186,,4035,6221
04142601,TOURO UNIVERSITY - NEVADA               ,NV,89014-8800,Private      ,12,49,61,107,,849,956
04144800,INTERNATIONAL ACADEMY OF STYLE          ,NV,89509-3450,Proprietary  ,5,34,39,78,,189,267
04147600,AVEDA INSTITUTE LAS VEGAS               ,NV,89119-6103,Proprietary  ,16,68,84,184,,447,631
04171000,ADVANCED TRAINING INSTITUTE             ,NV,89115-7504,Proprietary  ,23,161,184,183,,825,1008
04186300,PAUL MITCHELL THE SCHOOL LAS VEGAS      ,NV,89123-8014,Proprietary  ,37,67,104,300,,457,757
04190300,AMERICAN INSTITUTE OF MEDICAL SONOGRAPHY,NV,89146-6597,Proprietary  ,14,84,98,152,,605,757
04191100,DESTINATION ACADEMY FOR SPA AND SALON PR,NV,89147-8397,Proprietary  ,6,34,40,66,,210,276
04203100,PAUL MITCHELL THE SCHOOL RENO           ,NV,89501-3356,Proprietary  ,22,26,48,171,,249,420
04226200,HEALTHCARE PREPARATORY INSTITUTE        ,NV,89130-2580,Proprietary  ,0,1,1,0,,1,1
00257200,COLBY-SAWYER COLLEGE                    ,NH,03257-4648,Private      ,32,14,46,2819,,160,2979
00257300,DARTMOUTH COLLEGE                       ,NH,03755-3529,Private      ,231,74,305,12398,,1931,14329
00257500,FRANKLIN PIERCE UNIVERSITY              ,NH,03461-0060,Private      ,59,89,148,3719,,1233,4952
00257900,NEW ENGLAND COLLEGE                     ,NH,03242-3293,Private      ,57,270,327,2402,,1934,4336
00258000,SOUTHERN NEW HAMPSHIRE UNIVERSITY       ,NH,03106-1045,Private      ,430,4709,5139,7796,,30640,38436
00258100,NHTI  - CONCORD'S COMMUNITY COLLEGE     ,NH,03301-7412,Public       ,138,211,349,2995,,2195,5190
00258200,MANCHESTER COMMUNITY COLLEGE            ,NH,03102-8518,Public       ,90,216,306,1528,,2003,3531
00258300,GREAT BAY COMMUNITY COLLEGE             ,NH,03801-0000,Public       ,66,149,215,1150,,1448,2598
00258600,RIVIER COLLEGE                          ,NH,03060-5086,Private      ,32,102,134,1361,,1270,2631
00258700,SAINT ANSELM COLLEGE                    ,NH,03102-1310,Private      ,77,20,97,4069,,236,4305
00258900,UNIVERSITY OF NEW HAMPSHIRE             ,NH,03824-2511,Public       ,415,193,608,21643,,3733,25376
00259000,KEENE STATE COLLEGE                     ,NH,03431-0000,Public       ,150,49,199,8090,,804,8894
00259100,PLYMOUTH STATE UNIVERSITY               ,NH,03264-1595,Public       ,131,98,229,6959,,1631,8590
00301004,ANTIOCH UNIVERSITY                      ,NH,03431-0000,Private      ,0,29,29,10,,836,846
00472900,HESSER COLLEGE                          ,NH,03103-7230,Proprietary  ,30,160,190,374,,1204,1578
00472901,HESSER COLLEGE - NASHUA CAMPUS          ,NH,03063-1286,Proprietary  ,13,47,60,153,,436,589
00472904,HESSER COLLEGE - PORTSMOUTH CAMPUS      ,NH,03801-3245,Proprietary  ,4,23,27,109,,429,538
00472905,HESSER COLLEGE - SALEM CAMPUS           ,NH,03079-2842,Proprietary  ,14,59,73,189,,525,714
00472906,HESSER COLLEGE - CONCORD CAMPUS         ,NH,03301-3415,Proprietary  ,5,12,17,83,,329,412
00473100,DANIEL WEBSTER COLLEGE                  ,NH,03063-1300,Proprietary  ,23,60,83,807,,424,1231
00529100,WHITE MOUNTAINS COMMUNITY COLLEGE       ,NH,03570-3799,Public       ,22,52,74,382,,577,959
00702500,LEBANON COLLEGE                         ,NH,03766-0000,Private      ,3,14,17,46,,99,145
00755500,LAKES REGION COMMUNITY COLLEGE          ,NH,03246-1326,Public       ,38,96,134,703,,818,1521
00756000,RIVER VALLEY COMMUNITY COLLEGE          ,NH,03743-9707,Public       ,22,58,80,440,,893,1333
00864500,EMPIRE BEAUTY SCHOOL                    ,NH,03220-0000,Proprietary  ,18,17,35,143,,170,313
00923600,NASHUA COMMUNITY COLLEGE                ,NH,03063-2052,Public       ,92,119,211,1285,,1229,2514
01318900,CONTINENTAL ACADEMIE OF HAIR DESIGN     ,NH,03051-3754,Proprietary  ,9,5,14,73,,42,115
02097900,UNIVERSITY NEW HAMPSHIRE SCHOOL OF LAW  ,NH,03301-0000,Private      ,6,14,20,27,,546,573
02140400,ST JOSEPH SCH OF PRAC NRSG              ,NH,03060-0000,Private      ,1,25,26,72,,269,341
02174800,MICHAEL'S SCHOOL OF HAIR DESIGN & ESTHET,NH,03110-0000,Proprietary  ,12,23,35,119,,126,245
02179600,EMPIRE BEAUTY SCHOOL                    ,NH,03878-0000,Proprietary  ,19,19,38,109,,142,251
02211600,PORTSMOUTH BTY SCH OF HAIR DESIGN       ,NH,03801-4084,Proprietary  ,6,7,13,33,,38,71
02245400,KEENE BEAUTY ACADEMY                    ,NH,03431-0000,Proprietary  ,2,9,11,46,,56,102
02247000,NEW ENGLAND SCHOOL OF HAIR DESIGN       ,NH,03784-0000,Proprietary  ,4,3,7,49,,41,90
03043100,THOMAS MORE COLLEGE OF LIBERAL ARTS     ,NH,03054-4818,Private      ,3,3,6,112,,30,142
03101300,GRANITE STATE COLLEGE                   ,NH,03301-6400,Public       ,47,233,280,457,,2328,2785
03182300,NEW HAMPSHIRE INSTITUTE OF ART          ,NH,03104-4858,Private      ,23,32,55,737,,210,947
03437300,UPPER VALLEY TEACHER TRANING PROGRAM    ,NH,03766-1358,Private      ,0,1,1,3,,42,45
03729300,NH INSTITUTE FOR THERAPEUTIC ARTS       ,NH,03051-4906,Proprietary  ,0,16,16,11,,47,58
04162200,LAIRD INSTITUTE OF SPA THERAPY          ,NH,03102-5263,Proprietary  ,1,14,15,17,,85,102
00267000,BAPTIST BIBLE COLG OF PENNSYLVANIA      ,PA,18411-1297,Private      ,13,46,59,597,,482,1079
00322800,BRYN ATHYN COLLEGE OF THE NEW CHURCH    ,PA,19009-0717,Private      ,10,4,14,307,,49,356
00322900,ALBRIGHT COLLEGE                        ,PA,19612-5234,Private      ,94,90,184,4483,,1351,5834
00323000,ALLEGHENY COLLEGE                       ,PA,16335-3902,Private      ,59,7,66,3838,,143,3981
00323100,COMM CLG OF ALLEGHENY-ALLEGHENY CMP     ,PA,15212-0000,Public       ,280,757,1037,3504,,6683,10187
00323101,"COMM CLG OF ALLEGHENY, BOYCE CAMPUS     ",PA,15146-0000,Public       ,131,271,402,1649,,2694,4343
00323102,"COMM CLG OF ALLEGHENY, NORTH CAMPUS     ",PA,15237-0000,Public       ,176,337,513,1994,,2730,4724
00323103,"COMM CLG OF ALLEGHENY, SOUTH CAMPUS     ",PA,15122-0000,Public       ,134,276,410,1956,,2490,4446
00323300,ALVERNIA UNIVERSITY                     ,PA,19607-1799,Private      ,44,125,169,2576,,1749,4325
00323500,ARCADIA UNIVERSITY                      ,PA,19038-3295,Private      ,139,121,260,6491,,2117,8608
00323700,BRYN MAWR COLLEGE                       ,PA,19010-2899,Private      ,47,23,70,1834,,615,2449
00323800,BUCKNELL UNIVERSITY                     ,PA,17837-2122,Private      ,155,13,168,5418,,221,5639
00323900,BUCKS COUNTY COMMUNITY COLLEGE          ,PA,18940-1320,Public       ,266,446,712,4499,,4201,8700
00324000,BUTLER COUNTY COMMUNITY COLLEGE         ,PA,16001-0000,Public       ,118,207,325,2095,,2053,4148
00324100,CABRINI COLLEGE                         ,PA,19087-3698,Private      ,41,98,139,2088,,1021,3109
00324200,CARNEGIE MELLON UNIVERSITY              ,PA,15213-3890,Private      ,360,101,461,13624,,1811,15435
00324201,CARNEGIE MELLON UNIV- THE HEINZ COLLEGE ,PA,15213-0000,Private      ,7,38,45,171,,699,870
00324202,CARNEGIE MELLON- TEPPER SCHOOL OF BUSINE,PA,15213-0000,Private      ,16,23,39,269,,578,847
00324300,CEDAR CREST COLLEGE                     ,PA,18104-6196,Private      ,34,106,140,1112,,1468,2580
00324400,CHATHAM UNIVERSITY                      ,PA,15232-2826,Private      ,29,153,182,760,,1895,2655
00324500,CHESTNUT HILL COLLEGE                   ,PA,19118-2693,Private      ,51,177,228,1817,,2442,4259
00324700,MISERICORDIA  UNIVERSITY                ,PA,18612-1008,Private      ,34,80,114,2791,,1509,4300
00324900,COMMUNITY COLLEGE OF PHILADELPHIA       ,PA,19130-3991,Public       ,951,2839,3790,13839,,24249,38088
00325100,CURTIS INSTITUTE OF MUSIC               ,PA,19103-6187,Private      ,13,8,21,332,,143,475
00325200,DELAWARE VALLEY COLLEGE                 ,PA,18901-2697,Private      ,42,34,76,2388,,459,2847
00325300,DICKINSON COLLEGE                       ,PA,17013-2896,Private      ,90,13,103,3649,,168,3817
00325600,DREXEL UNIVERSITY                       ,PA,19104-2875,Private      ,874,1207,2081,35097,,19401,54498
00325800,DUQUESNE UNIVERSITY                     ,PA,15282-0001,Private      ,125,177,302,8301,,4006,12307
00325900,EASTERN UNIVERSITY                      ,PA,19087-3696,Private      ,59,147,206,2420,,2755,5175
00326200,ELIZABETHTOWN COLLEGE                   ,PA,17022-2298,Private      ,26,67,93,3262,,795,4057
00326300,EVANGELICAL SCHOOL OF THEOLOGY          ,PA,17067-0000,Private      ,0,1,1,0,,85,85
00326500,FRANKLIN & MARSHALL COLLEGE             ,PA,17604-0000,Private      ,92,28,120,3622,,202,3824
00326600,GANNON UNIVERSITY                       ,PA,16541-0001,Private      ,71,115,186,3797,,1527,5324
00326700,GENEVA COLLEGE                          ,PA,15010-3599,Private      ,24,86,110,1905,,903,2808
00326800,GETTYSBURG COLLEGE                      ,PA,17325-1486,Private      ,95,13,108,4352,,197,4549
00326900,GROVE CITY COLLEGE                      ,PA,16127-2104,Private      ,25,4,29,1916,,71,1987
00327000,GWYNEDD-MERCY COLLEGE                   ,PA,19437-0901,Private      ,29,124,153,1638,,1748,3386
00327200,HARCUM COLLEGE                          ,PA,19010-3476,Private      ,49,209,258,1056,,1936,2992
00327300,HARRISBURG AREA COMMUNITY COLLEGE       ,PA,17110-2999,Public       ,669,1720,2389,10118,,16122,26240
00327400,HAVERFORD COLLEGE                       ,PA,19041-1392,Private      ,56,6,62,2199,,74,2273
00327500,HOLY FAMILY UNIVERSITY                  ,PA,19114-2094,Private      ,57,138,195,2269,,2139,4408
00327600,IMMACULATA UNIVERSITY                   ,PA,19345-0647,Private      ,29,138,167,1910,,1875,3785
00327700,INDIANA UNIVERSITY OF PENNSYLVANIA      ,PA,15705-1097,Public       ,316,237,553,15296,,4101,19397
00327900,JUNIATA COLLEGE                         ,PA,16652-2196,Private      ,39,7,46,2610,,130,2740
00328000,KEYSTONE COLLEGE                        ,PA,18440-0200,Private      ,37,55,92,1762,,781,2543
00328200,KINGS COLLEGE                           ,PA,18711-0801,Private      ,50,39,89,3279,,617,3896
00328300,LACKAWANNA COLLEGE                      ,PA,18509-9961,Private      ,71,129,200,1922,,1195,3117
00328400,LAFAYETTE COLLEGE                       ,PA,18042-1768,Private      ,145,8,153,4572,,150,4722
00328500,LANCASTER BIBLE COLLEGE                 ,PA,17601-5036,Private      ,25,88,113,840,,1165,2005
00328600,LANCASTER THEOLOGICAL SEMINARY          ,PA,17603-0000,Private      ,0,10,10,2,,132,134
00328700,LASALLE UNIVERSITY                      ,PA,19141-1199,Private      ,173,299,472,6769,,4529,11298
00328800,LEBANON VALLEY COLLEGE                  ,PA,17003-1400,Private      ,48,19,67,3110,,327,3437
00328900,LEHIGH UNIVERSITY                       ,PA,18015-1588,Private      ,239,68,307,9520,,1064,10584
00329000,LINCOLN UNIVERSITY                      ,PA,19352-0999,Public       ,84,102,186,3814,,1403,5217
00329100,LUTHERAN THEOLOG SEMINARY-GETTYSBRG     ,PA,17325-0000,Private      ,0,4,4,2,,90,92
00329200,LUTHERAN THEOLOGICAL SEMINARY           ,PA,19119-0000,Private      ,0,15,15,2,,202,204
00329300,LYCOMING COLLEGE                        ,PA,17701-5192,Private      ,32,17,49,2011,,192,2203
00329400,MANOR COLLEGE                           ,PA,19046-3399,Private      ,22,32,54,749,,635,1384
00329600,MARYWOOD UNIVERSITY                     ,PA,18509-1598,Private      ,49,83,132,2991,,1547,4538
00329700,MERCYHURST COLLEGE                      ,PA,16546-0001,Private      ,77,110,187,4300,,1875,6175
00329800,MESSIAH COLLEGE                         ,PA,17027-0000,Private      ,46,39,85,3569,,485,4054
00330000,MOORE COLLEGE OF ART & DESIGN           ,PA,19103-1179,Private      ,21,42,63,661,,399,1060
00330100,MORAVIAN COLLEGE                        ,PA,18018-6650,Private      ,37,29,66,2220,,415,2635
00330101,MORAVIAN THEOLOGICAL SEMINARY           ,PA,18018-0000,Private      ,1,6,7,19,,65,84
00330200,MOUNT ALOYSIUS COLLEGE                  ,PA,16630-1999,Private      ,25,78,103,1484,,949,2433
00330300,CARLOW UNIVERSITY                       ,PA,15213-3165,Private      ,26,156,182,1300,,2220,3520
00330400,MUHLENBERG COLLEGE                      ,PA,18104-5586,Private      ,79,39,118,4195,,456,4651
00330600,VALLEY FORGE CHRISTIAN COLLEGE          ,PA,19460-2399,Private      ,26,19,45,848,,300,1148
00330900,PEIRCE COLLEGE                          ,PA,19102-4699,Private      ,38,231,269,619,,2926,3545
00331100,SALUS UNIVERSITY                        ,PA,19027-1598,Private      ,0,16,16,8,,1160,1168
00331300,WIDENER UNIVERSITY                      ,PA,19013-5792,Private      ,101,112,213,5147,,2810,7957
00331302,WIDENER UNIV SCH OF LAW- HARRISBURG     ,PA,17106-9381,Private      ,3,18,21,38,,644,682
00331500,BLOOMSBURG UNIVERSITY OF PA             ,PA,17815-1301,Public       ,259,145,404,13197,,2269,15466
00331600,CALIFORNIA UNIV OF PENNSYLVANIA         ,PA,15419-1394,Public       ,131,356,487,6671,,4570,11241
00331700,CHEYNEY UNIVERSITY OF PENNSYLVANIA      ,PA,19319-0200,Public       ,61,73,134,2184,,1053,3237
00331800,CLARION UNIVERSITY OF PENNSYLVANIA      ,PA,16214-1232,Public       ,77,161,238,5178,,2452,7630
00332000,EAST STROUDSBURG UNIVERSITY             ,PA,18301-2999,Public       ,174,118,292,7905,,2072,9977
00332100,EDINBORO UNIVERSITY OF PENNSYLVANIA     ,PA,16444-0001,Public       ,117,175,292,6131,,3036,9167
00332200,KUTZTOWN UNIVERSITY OF PENNSYLVANIA     ,PA,19530-9339,Public       ,212,145,357,11927,,2387,14314
00332300,LOCK HAVEN UNIV OF PENNSYLVANIA         ,PA,17745-2439,Public       ,96,100,196,6121,,1502,7623
00332400,MANSFIELD UNIVERSITY                    ,PA,16933-1123,Public       ,63,63,126,3120,,943,4063
00332500,MILLERSVILLE UNIVERSITY OF PA           ,PA,17551-1800,Public       ,160,164,324,9063,,2656,11719
00332600,SHIPPENSBURG UNIVERSITY                 ,PA,17257-2299,Public       ,175,139,314,8839,,1846,10685
00332700,SLIPPERY ROCK UNIVERSITY                ,PA,16057-1326,Public       ,124,177,301,8879,,2239,11118
00332800,WEST CHESTER UNIVERSITY                 ,PA,19383-0001,Public       ,357,333,690,18626,,5222,23848
00332900,PENN STATE UNIVERSITY                   ,PA,16802-1503,Public       ,1633,2199,3832,71976,,28714,100690
00335000,UNIVERSITY OF THE ARTS (THE)            ,PA,19102-9493,Private      ,108,56,164,3301,,790,4091
00335100,CAIRN UNIVERSITY                        ,PA,19047-2942,Private      ,16,22,38,787,,512,1299
00335200,PHILADELPHIA CLG OSTEOPATHIC MED        ,PA,19131-0000,Private      ,2,43,45,49,,3472,3521
00335300,UNIVERSITY OF THE SCIENCES IN PHILADELPH,PA,19104-4495,Private      ,57,59,116,3672,,1592,5264
00335400,PHILADELPHIA UNIVERSITY                 ,PA,19144-5497,Private      ,122,224,346,4790,,2517,7307
00335600,PITTSBURGH THEOLOGICAL SEMINARY         ,PA,15206-0000,Private      ,0,10,10,6,,195,201
00335700,POINT PARK UNIVERSITY                   ,PA,15222-1912,Private      ,79,194,273,3684,,2435,6119
00335800,REFORMED PRESBYTERIAN THEOL SEMINAR     ,PA,15208-0000,Private      ,0,1,1,0,,25,25
00335900,ROBERT MORRIS UNIVERSITY                ,PA,15108-1189,Private      ,125,183,308,5518,,2281,7799
00336000,ROSEMONT COLLEGE                        ,PA,19010-1699,Private      ,18,56,74,774,,664,1438
00336200,SETON HILL UNIVERSITY                   ,PA,15601-1599,Private      ,59,57,116,2358,,952,3310
00336400,ST. CHARLES BORROMEO SEMINARY           ,PA,19096-0000,Private      ,2,3,5,45,,37,82
00336600,SAINT FRANCIS UNIVERSITY                ,PA,15940-0600,Private      ,36,56,92,2156,,794,2950
00336700,SAINT JOSEPH'S UNIVERSITY               ,PA,19131-1395,Private      ,190,468,658,7850,,4014,11864
00336800,ST VINCENT COLLEGE                      ,PA,15650-2690,Private      ,27,19,46,2173,,307,2480
00336900,SUSQUEHANNA UNIVERSITY                  ,PA,17870-1001,Private      ,42,10,52,3296,,134,3430
00337000,SWARTHMORE COLLEGE                      ,PA,19081-1397,Private      ,77,9,86,3912,,135,4047
00337100,TEMPLE UNIVERSITY                       ,PA,19122-6003,Private      ,891,967,1858,36307,,21520,57827
00337600,THIEL COLLEGE                           ,PA,16125-2181,Private      ,22,16,38,1965,,172,2137
00337800,UNIVERSITY OF PENNSYLVANIA              ,PA,19104-6216,Private      ,769,559,1328,22152,,13098,35250
00337900,UNIVERSITY OF PITTSBURGH                ,PA,15260-0000,Public       ,647,633,1280,31188,,10911,42099
00337906,UNIVERSITY OF PITTSBURGH - SCHOOL OF MED,PA,15261-0001,Public       ,16,15,31,218,,1029,1247
00337907,UNIVERSITY OF PITTSBURGH - SCHOOL OF DEN,PA,15261-2523,Public       ,6,3,9,91,,408,499
00338400,UNIVERSITY OF SCRANTON                  ,PA,18510-4622,Private      ,164,144,308,7983,,1733,9716
00338500,URSINUS COLLEGE                         ,PA,19426-1000,Private      ,60,11,71,3132,,126,3258
00338600,VALLEY FORGE MILITARY COLLEGE           ,PA,19087-3695,Private      ,28,5,33,505,,67,572
00338800,VILLANOVA UNIVERSITY                    ,PA,19085-1699,Private      ,296,290,586,12615,,3128,15743
00338801,VILLANOVA UNIV SCH OF LAW               ,PA,19085-0000,Private      ,3,13,16,33,,1060,1093
00338900,WASHINGTON & JEFFERSON COLLEGE          ,PA,15301-4801,Private      ,53,10,63,2710,,108,2818
00339100,WAYNESBURG UNIVERSITY                   ,PA,15370-1222,Private      ,28,61,89,2138,,823,2961
00339200,WESTMINSTER COLLEGE                     ,PA,16172-0002,Private      ,25,54,79,2380,,167,2547
00339300,WESTMINSTER THEOLOGICAL SEMINARY        ,PA,19038-0000,Private      ,0,10,10,3,,324,327
00339400,WILKES UNIVERSITY                       ,PA,18766-0998,Private      ,70,134,204,3669,,1451,5120
00339500,PENNSYLVANIA COLLEGE OF TECHNOLOGY      ,PA,17701-5779,Public       ,159,201,360,5425,,2379,7804
00339600,WILSON COLLEGE                          ,PA,17201-1285,Private      ,11,38,49,415,,409,824
00339900,YORK COLLEGE OF PENNSYLVANIA            ,PA,17405-7199,Private      ,181,118,299,9145,,1531,10676
00398600,DESALES UNIVERSITY                      ,PA,18034-9568,Private      ,51,113,164,2843,,1677,4520
00398700,LA ROCHE COLLEGE                        ,PA,15237-5898,Private      ,21,49,70,1252,,645,1897
00398800,NEUMANN UNIVERSITY                      ,PA,19014-1298,Private      ,69,93,162,3317,,1437,4754
00405800,GRATZ COLLEGE                           ,PA,19027-3097,Private      ,1,12,13,4,,132,136
00445200,MONTGOMERY COUNTY COMMUNITY COLLEGE     ,PA,19422-6300,Public       ,304,653,957,5686,,6359,12045
00488900,CAMBRIA-ROWE BUSINESS COLLEGE           ,PA,15902-2494,Proprietary  ,6,21,27,139,,282,421
00488901,CAMBRIA ROWE BUSINESS COLLEGE - INDIANA ,PA,15701-2804,Proprietary  ,3,17,20,18,,51,69
00489000,CENTRAL PENNSYLVANIA COLLEGE            ,PA,17093-0309,Proprietary  ,37,112,149,1145,,1593,2738
00489300,DU BOIS BUSINESS COLLEGE                ,PA,15801-2401,Proprietary  ,7,38,45,153,,280,433
00489400,ERIE BUSINESS CENTER                    ,PA,16501-1305,Proprietary  ,4,32,36,92,,373,465
00489401,ERIE BUSINESS CENTER - NEW CASTLE CAMPUS,PA,16101-3950,Proprietary  ,2,14,16,35,,126,161
00489800,MCCANN SCHOOL OF BUSINESS & TECHNOL     ,PA,17901-1335,Proprietary  ,154,593,747,1666,,5897,7563
00489807,MCCANN SCHOOL OF BUSINESS & TECHNOLOGY -,PA,17013-3180,Proprietary  ,3,12,15,47,,125,172
00489900,MERCY HOSP SCH OF NURSING               ,PA,15219-5166,Private      ,7,16,23,171,,285,456
00490100,NEWPORT BUSINESS INSTITUTE              ,PA,15068-3929,Proprietary  ,0,1,1,24,,71,95
00490200,PENN COMMERCIAL BUSINESS/TECHNICAL SCHL ,PA,15301-2871,Proprietary  ,14,57,71,221,,393,614
00491000,KAPLAN CAREER INSTITUTE                 ,PA,17111-3571,Proprietary  ,33,135,168,267,,886,1153
00491001,THOMPSON INSTITUTE-PHILADEPHIA CAMPUS   ,PA,19104-3386,Proprietary  ,49,140,189,378,,910,1288
00491400,NEWPORT BUSINESS INSTITUTE              ,PA,17701-5855,Proprietary  ,3,8,11,15,,103,118
00500701,WEST VIRGINIA CAREER INSTITUTE          ,PA,15456-0000,Proprietary  ,7,13,20,69,,123,192
00531000,PITTSBURGH INST OF AERONAUTICS          ,PA,15236-0000,Private      ,25,38,63,391,,308,699
00533000,FAYETTE CNTY AREA VOC TECH PRC NRSG     ,PA,15401-0000,Public       ,6,5,11,49,,119,168
00533500,CENTRAL PENN INST OF SCI & TECH PNP     ,PA,16823-0000,Public       ,8,41,49,163,,266,429
00536500,YORK CO AREA VOC-TECH SCH-PRAC NSG      ,PA,17402-0000,Public       ,11,80,91,69,,382,451
00653400,CITIZENS SCHOOL OF NURSING              ,PA,15068-6591,Private      ,5,9,14,110,,191,301
00653700,CONEMAUGH VLY MEM HOSP SCH NRSNG        ,PA,15905-4398,Private      ,0,5,5,121,,138,259
00653702,CONEMAUGH HOSP- SCH HISTOTECHNOLOGY     ,PA,15905-0000,Private      ,0,1,1,6,,9,15
00653704,CONEMAUGH VLY MEM HOSP SCH RAD TECH     ,PA,15905-0000,Private      ,1,4,5,35,,30,65
00653706,CONEMAUGH VLY MEM HOSP SCH  MED TECH    ,PA,15905-4398,Private      ,0,2,2,14,,17,31
00655100,ST MARGARET SCHL OF NURSING             ,PA,15238-3205,Private      ,2,13,15,111,,253,364
00656000,OHIO VALLEY HOSP SCH OF NURSING         ,PA,15136-1694,Private      ,0,6,6,31,,67,98
00656500,READING HOSPITAL SCHOOL OF HEALTH SCIENC,PA,19611-1744,Private      ,12,31,43,280,,525,805
00657400,"ST LUKE'S HOSPITAL OF BETHLEHEM, PA     ",PA,18015-1065,Private      ,7,15,22,99,,275,374
00657600,SEWICKLEY VALLEY HOSP SCH NRSNG         ,PA,15143-1498,Private      ,0,0,0,25,,59,84
00657700,UPMC SHADYSIDE SCHOOL OF NURSING        ,PA,15232-1381,Private      ,19,46,65,241,,518,759
00657800,SHARON REGIONAL SCHOOL OF NURSING       ,PA,16146-3395,Private      ,3,8,11,27,,63,90
00658200,WASHINGTON HOSP SCH OF NURSING          ,PA,15301-3398,Private      ,4,11,15,48,,121,169
00658202,WASHINGTON HOSP SCH OF RAD TECH         ,PA,15301-3398,Private      ,0,3,3,18,,25,43
00658300,WESTERN PENN HOSP-SCH OF NURSING        ,PA,15224-1790,Private      ,7,17,24,144,,242,386
00680700,COMMUNITY COLLEGE OF BEAVER COUNTY      ,PA,15061-2588,Public       ,78,186,264,1382,,1547,2929
00681000,LEHIGH CARBON COMMUNITY COLLEGE         ,PA,18078-2598,Public       ,255,563,818,3548,,4397,7945
00681100,LUZERNE COUNTY COMMUNITY COLLEGE        ,PA,18634-3899,Public       ,170,363,533,3408,,4040,7448
00708700,ABINGTON MEM HOSP SCHL OF NURSING       ,PA,19090-1284,Private      ,5,24,29,127,,399,526
00709100,EVEREST INSTITUTE                       ,PA,15222-1320,Proprietary  ,38,163,201,258,,953,1211
00711000,DELAWARE COUNTY COMMUNITY COLLEGE       ,PA,19063-1094,Public       ,455,1140,1595,7026,,9566,16592
00719100,NORTHAMPTON COMMUNITY COLLEGE           ,PA,18020-7599,Public       ,351,714,1065,6921,,6926,13847
00730305,LINCOLN TECHNICAL INSTITUTE - PHILADELPH,PA,19136-1530,Proprietary  ,41,67,108,343,,474,817
00732955,ITT TECHNICAL INSTITUTE                 ,PA,19406-1212,Proprietary  ,37,103,140,276,,680,956
00743000,ANTONELLI INST OF ART & PHOTOGRAPHY     ,PA,19038-8242,Proprietary  ,6,6,12,241,,67,308
00743600,KAPLAN CAREER INSTITUTE - ICM CAMPUS    ,PA,15222-1977,Proprietary  ,26,135,161,259,,992,1251
00743700,PITTSBURGH TECHNICAL INSTITUTE          ,PA,15071-3205,Proprietary  ,89,104,193,2285,,1186,3471
00746900,"HUSSIAN SCHOOL OF ART, INC.             ",PA,19106-0000,Proprietary  ,6,7,13,117,,39,156
00747000,"ART INSTITUTE OF PITTSBURGH, THE        ",PA,15219-1328,Proprietary  ,584,2694,3278,4628,,16812,21440
00752900,"CHESTER COUNTY INTERMEDIATE UNIT, PNP   ",PA,19335-3043,Public       ,12,31,43,45,,182,227
00757307,EMPIRE BEAUTY SCHOOL - WARMINSTER       ,PA,18974-4508,Proprietary  ,0,0,0,127,,295,422
00777900,LANSDALE SCHOOL OF BUSINESS             ,PA,19454-4114,Proprietary  ,11,48,59,112,,425,537
00778000,NEW CASTLE SCHOOL OF TRADES             ,PA,16143-0000,Proprietary  ,65,142,207,411,,820,1231
00778100,CHI INSTITUTE/RETS CAMPUS               ,PA,19008-3516,Proprietary  ,26,84,110,145,,523,668
00783900,TRIANGLE TECH                           ,PA,15214-3897,Proprietary  ,30,60,90,244,,399,643
00791200,THADDEUS STEVENS CLG OF TECHNOLOGY      ,PA,17602-0000,Public       ,41,54,95,1393,,628,2021
00791600,FRANKLIN CNTY CAREER & TECH CTR-PNP     ,PA,17201-0000,Public       ,6,25,31,34,,138,172
00793807,LINCOLN TECHNICAL INSITUTE - ALLENTOWN  ,PA,18104-3212,Proprietary  ,37,121,158,325,,768,1093
00817803,EMPIRE BEAUTY SCHOOL - HARRISBURG       ,PA,17109-2210,Proprietary  ,0,0,0,86,,193,279
00817804,EMPIRE BEAUTY SCHOOL - WILLIAMSPORT     ,PA,17701-3914,Proprietary  ,0,0,0,78,,140,218
00817806,EMPIRE BEAUTY SCHOOL - LEBANON          ,PA,17042-5209,Proprietary  ,0,0,0,27,,38,65
00817809,EMPIRE BEAUTY SCHOOL - CENTER CITY PHILA,PA,19102-2701,Proprietary  ,0,0,0,190,,429,619
00820000,JAMESON MEMORIAL HOSP SCH NURSING       ,PA,16105-2595,Private      ,1,10,11,45,,103,148
00835000,ART INSTITUTE OF PHILADELPHIA           ,PA,19103-5198,Proprietary  ,328,339,667,3254,,2923,6177
00844100,ANTHEM INSTITUTE                        ,PA,19064-1243,Proprietary  ,15,104,119,108,,401,509
00856800,VET TECH INSTITUTE                      ,PA,15222-3400,Proprietary  ,23,20,43,417,,220,637
00865300,JEFFERSON CO DUBOIS VOC TECH-PR NSG     ,PA,15851-0000,Public       ,0,3,3,22,,48,70
00895500,PRUONTOS HAIR DESIGN INSTITUTE          ,PA,16602-0000,Proprietary  ,2,8,10,30,,32,62
00915705,WYOMING TECHNICAL INSTITUTE - BLAIRSVILL,PA,15717-8060,Proprietary  ,132,156,288,1223,,1047,2270
00918600,DEAN INSTITUTE OF TECHNOLOGY            ,PA,15226-1197,Proprietary  ,5,26,31,57,,185,242
00944900,PENNCO TECH                             ,PA,19007-0000,Proprietary  ,62,147,209,285,,616,901
00966400,EMPIRE BEAUTY SCHOOL                    ,PA,18052-5730,Proprietary  ,100,254,354,332,,777,1109
00966405,EMPIRE BEAUTY SCHOOL - MONROEVILLE      ,PA,15146-2229,Proprietary  ,0,0,0,116,,213,329
00966408,EMPIRE BEAUTY SCHOOL - LANCASTER        ,PA,17604-4335,Proprietary  ,0,0,0,131,,242,373
00966411,EMPIRE BEAUTY SCHOOL - SHAMOKIN DAM     ,PA,17876-0397,Proprietary  ,0,0,0,27,,33,60
00966412,EMPIRE BEAUTY SCHOOL - EXTON            ,PA,19341-2804,Proprietary  ,0,0,0,150,,237,387
00966600,EMPIRE BEAUTY SCHOOL                    ,PA,19605-2803,Proprietary  ,0,0,0,114,,227,341
00972100,BRADFORD SCHOOL                         ,PA,15219-2602,Proprietary  ,12,14,26,604,,214,818
00972300,ARIA HEALTH SCHOOL OF NURSING           ,PA,19053-6939,Private      ,8,30,38,160,,388,548
00978300,GORDON PHILLIPS SCH OF BEAUTY CULT      ,PA,19135-0000,Proprietary  ,0,0,0,166,,302,468
00986300,LANCASTER GENERAL COLLEGE OF NURSING AND,PA,17602-4955,Private      ,25,89,114,709,,1261,1970
01000600,GREATER JOHNSTOWN AREA VOC TECH SCH     ,PA,15904-0000,Public       ,5,33,38,96,,278,374
01005500,CRAWFORD CNTY AREA VO-TECH PRAC NUR     ,PA,16335-0000,Public       ,0,2,2,18,,41,59
01017600,WESTMORELAND COUNTY COMMUNITY CLG       ,PA,15697-1895,Public       ,141,385,526,3133,,3675,6808
01038800,READING AREA COMMUNITY COLLEGE          ,PA,19603-1706,Public       ,155,463,618,2386,,4371,6757
01054200,EMPIRE BEAUTY SCHOOL                    ,PA,18701-0000,Proprietary  ,89,249,338,309,,624,933
01054205,EMPIRE BEAUTY SCHOOL - YORK             ,PA,17402-2862,Proprietary  ,0,0,0,126,,243,369
01081400,PITTSBURGH INST MORTUARY SCIENCE        ,PA,15206-3706,Private      ,13,57,70,127,,322,449
01086000,GREATER ALTOONA CAREER/TECH CENTER      ,PA,16602-0000,Public       ,2,21,23,132,,274,406
01096300,GREENE COUNTY VOC-TECH SCHOOL           ,PA,15370-0000,Public       ,0,2,2,14,,39,53
01099800,PENNSYLVANIA INSTITUTE OF TECH          ,PA,19063-4098,Private      ,40,149,189,473,,897,1370
01162100,AUTOMOTIVE TRAINING CENTER              ,PA,19341-1310,Proprietary  ,83,64,147,933,,460,1393
01162200,WELDER TRAINING & TESTING INST          ,PA,18109-3253,Proprietary  ,7,22,29,45,,124,169
01171500,SCHUYLKILL HEALTH SCHOOL OF NURSING     ,PA,17901-3692,Private      ,0,5,5,69,,69,138
01191900,BEAVER FALLS BEAUTY ACADEMY             ,PA,15010-4208,Proprietary  ,1,9,10,18,,51,69
01205000,ROSEDALE TECHNICAL INSTITUTE            ,PA,15205-9791,Private      ,34,38,72,330,,361,691
01239300,THOMAS JEFF UNIV-CLG ALLIED HEALTH      ,PA,19107-0000,Private      ,10,89,99,354,,1536,1890
01239301,THOMAS JEFFERSON UNIVERSITY - JEFFERSON ,PA,19107-5001,Private      ,16,92,108,448,,2768,3216
01239303,THOMAS JEFFERSON UNIVERSITY - COLLEGE OF,PA,19107-6731,Private      ,9,55,64,249,,1038,1287
01246104,LINCOLN TECHNICAL INSTITUTE             ,PA,19104-0202,Proprietary  ,51,138,189,366,,764,1130
01246105,LINCOLN TECHNICAL INSTITUTE             ,PA,19116-4202,Proprietary  ,28,67,95,273,,584,857
01252300,TALMUDICAL YESHIVA OF PHILA             ,PA,19131-1296,Private      ,15,1,16,36,,6,42
01260500,EMPIRE BEAUTY SCHOOL                    ,PA,17331-2405,Proprietary  ,0,0,0,66,,182,248
01260600,EMPIRE BEAUTY SCHOOL                    ,PA,17901-3859,Proprietary  ,72,211,283,263,,748,1011
01260607,EMPIRE BEAUTY SCHOOL - STATE COLLEGE    ,PA,16801-5218,Proprietary  ,0,0,0,41,,40,81
01292900,SOUTH HILLS BEAUTY ACADEMY              ,PA,15216-2335,Proprietary  ,12,25,37,70,,140,210
01313400,YESHIVATH BETH MOSHE                    ,PA,18505-2196,Private      ,23,1,24,30,,11,41
01321400,ROXBOROUGH MEM HOSP SCH OF NURSING      ,PA,19128-0000,Proprietary  ,6,25,31,103,,369,472
01326300,SOUTH HILLS SCHOOL OF BUSINESS & TECHNOL,PA,16801-4516,Proprietary  ,15,39,54,568,,509,1077
02061000,VENUS BEAUTY ACADEMY                    ,PA,19079-0000,Proprietary  ,16,20,36,65,,86,151
02068300,DOUGLAS SCHOOL OF BUSINESS              ,PA,15062-0000,Proprietary  ,14,23,37,270,,235,505
02090200,TRIANGLE TECH                           ,PA,16502-0000,Proprietary  ,5,16,21,115,,110,225
02092500,LAUREL TECHNICAL INSTITUTE              ,PA,16146-0000,Proprietary  ,8,27,35,171,,320,491
02092502,BUSINESS INSTITUTE OF PENNSYLVANIA      ,PA,16335-0000,Proprietary  ,2,5,7,11,,32,43
02104003,HARRIS SCHOOL OF BUSINESS - UPPER DARBY ,PA,19082-2528,Proprietary  ,2,11,13,34,,51,85
02107300,PENNSYLVANIA ACADEMY OF FINE ARTS       ,PA,19102-1424,Private      ,14,23,37,312,,339,651
02112200,GREAT LAKES INSTITUTE OF TECHNOLOGY     ,PA,16509-0000,Proprietary  ,28,79,107,402,,518,920
02114200,JOHNSON COLLEGE                         ,PA,18508-0000,Private      ,16,35,51,522,,339,861
02116001,SANFORD-BROWN INSTITUTE - TREVOSE       ,PA,19053-4700,Proprietary  ,1,8,9,60,,137,197
02118000,LEVITTOWN BEAUTY ACADEMY LLC            ,PA,19054-1713,Proprietary  ,6,17,23,35,,47,82
02119300,PA ACAD OF COSMETOLOGY ARTS & SCI       ,PA,15904-0000,Proprietary  ,5,15,20,62,,84,146
02120800,"YORKTOWNE BUSINESS INSTITUTE, INC.      ",PA,17404-0000,Proprietary  ,8,37,45,111,,312,423
02127400,YORK TECHNICAL INSTITUTE                ,PA,17402-0000,Proprietary  ,81,214,295,1214,,1759,2973
02129000,TRIANGLE TECH                           ,PA,15601-0000,Proprietary  ,36,45,81,274,,270,544
02129001,TRIANGLE TECH - BUSINESS CAREERS INSTITU,PA,15601-3304,Proprietary  ,0,5,5,8,,21,29
02144000,"VISION ACADEMY, THE                     ",PA,18103-0000,Proprietary  ,4,14,18,36,,103,139
02151500,CENTRAL SUSQUEHANNA LPN CENTER          ,PA,17837-8818,Public       ,3,22,25,56,,172,228
02153500,OAKBRIDGE ACADEMY OF ARTS               ,PA,15068-0000,Proprietary  ,1,2,3,70,,15,85
02158300,JUNIATA-MIFFLIN CO AREA VOC TECH        ,PA,17044-0000,Public       ,0,0,0,16,,55,71
02161400,NORTHEASTERN HOSP SCH OF NRSG           ,PA,19134-0000,Private      ,5,27,32,89,,303,392
02169600,CLEARFIELD CTY CAREER AND TECH CNTR     ,PA,16830-0000,Public       ,1,12,13,50,,131,181
02174400,TRIANGLE TECH                           ,PA,15801-0000,Proprietary  ,30,17,47,325,,207,532
02178900,ACADEMY OF HAIR DESIGN                  ,PA,18202-1465,Proprietary  ,25,38,63,129,,241,370
02183000,ORLEANS TECHNICAL INSTITUTE             ,PA,19111-0000,Private      ,31,93,124,223,,689,912
02192800,WALNUT HILL COLLEGE                     ,PA,19104-0000,Proprietary  ,27,46,73,546,,427,973
02202300,SANFORD-BROWN INSTITUTE                 ,PA,15219-1907,Proprietary  ,5,41,46,190,,660,850
02202301,SANFORD-BROWN INSTITUTE                 ,PA,15146-2141,Proprietary  ,2,11,13,42,,127,169
02203900,ERIE INSTITUTE OF TECHNOLOGY            ,PA,16565-1002,Proprietary  ,13,38,51,215,,273,488
02206200,"VISION ACADEMY, THE                     ",PA,19002-0000,Proprietary  ,21,28,49,84,,124,208
02206300,STROUDSBURG SCHOOL OF COSMETOLOGY       ,PA,18360-0000,Proprietary  ,8,9,17,57,,56,113
02212700,LANCASTER SCHOOL OF COSMETOLOGY         ,PA,17602-0000,Proprietary  ,14,39,53,64,,171,235
02234200,ACADEMY OF MEDICAL ARTS & BUSINESS      ,PA,17112-0000,Proprietary  ,22,61,83,251,,459,710
02251200,SCHUYLKILL COUNTY AREA VOC TECH SCH     ,PA,17931-0000,Public       ,6,20,26,20,,127,147
02251202,SCHUYLKILL COUNTY AREA VOC TECH SCH     ,PA,17931-0000,Public       ,1,7,8,6,,36,42
02253900,BERKS TECHNICAL INSTITUTE               ,PA,19610-1168,Proprietary  ,55,229,284,797,,1200,1997
02255200,PENNSYLVANIA SCHOOL OF BUSINESS         ,PA,18101-1604,Proprietary  ,5,20,25,83,,428,511
02269900,PENNSYLVANIA COLLEGE OF ART & DESIGN    ,PA,17603-3528,Private      ,16,7,23,440,,108,548
02270500,BUCKS COUNTY SCHOOL OF BEAUTY CULT      ,PA,19053-0000,Proprietary  ,9,10,19,46,,63,109
02273400,RECONSTRUCTIONIST RABBINICAL COLLEG     ,PA,19095-0000,Private      ,0,0,0,0,,37,37
02276600,HANOVER PUBLIC SCH DIST PRAC NURSG      ,PA,17331-0000,Public       ,1,14,15,12,,77,89
02282500,LENAPE SCHOOL OF PRACTICAL NURSING      ,PA,16226-0000,Public       ,7,17,24,48,,133,181
02289500,PACE INSTITUTE                          ,PA,19601-0000,Proprietary  ,1,12,13,44,,164,208
02289600,CONSOLIDATED SCHOOL OF BUSINESS         ,PA,17404-0000,Proprietary  ,4,33,37,54,,194,248
02289700,ACADEMY OF CREATIVE HAIR DESIGN         ,PA,18702-0000,Proprietary  ,22,56,78,98,,218,316
02289800,CHI INSTITUTE - FRANKLIN MILLS          ,PA,19154-0000,Proprietary  ,47,127,174,389,,882,1271
02290400,"ALTOONA BEAUTY SCHOOL, INC              ",PA,16602-0000,Proprietary  ,7,13,20,51,,91,142
02292700,LANSDALE SCHOOL OF COSMETOLOGY          ,PA,19446-0000,Proprietary  ,2,6,8,29,,46,75
02299300,TRINITY EPISCOPAL SCHOOL MINISTRY       ,PA,15003-0000,Private      ,1,4,5,2,,103,105
02301300,PRISM CAREER INSTITUTE                  ,PA,19082-2448,Proprietary  ,16,59,75,151,,567,718
02304400,YTI CAREER INSTITUTE - MECHANICSBURG    ,PA,17055-0000,Proprietary  ,6,11,17,108,,135,243
02306200,VENANGO COUNTY AREA VOC TECH SCHOOL     ,PA,16301-0000,Public       ,1,3,4,31,,89,120
02310800,LANCASTER COUNTY CAREER & TECH CTR      ,PA,17584-0000,Public       ,21,77,98,186,,583,769
02323000,BIBLICAL THEOLOGICAL SEMINARY           ,PA,19440-2421,Private      ,0,8,8,2,,112,114
02330300,LEBANON CO CAREER & TECHNOLOGY CTR      ,PA,17042-0000,Public       ,5,34,39,63,,265,328
02330600,PENNSYLVANIA GUNSMITH SCHOOL            ,PA,15202-0000,Proprietary  ,6,19,25,99,,119,218
02350100,WESTERN AREA CAREER & TECHNOLOGY CT     ,PA,15317-0000,Public       ,2,5,7,28,,106,134
02350200,INDIANA COUNTY TECH CTR SCH PR NSG      ,PA,15701-1465,Public       ,1,9,10,56,,138,194
02353100,NORTHERN TIER CAREER CENTER             ,PA,18848-0000,Public       ,0,4,4,30,,84,114
02362300,MERCER COUNTY AREA VOC TECH SCHOOL      ,PA,16137-0000,Public       ,2,8,10,21,,55,76
02492600,EASTERN CTR ARTS AND TECH PR NSG        ,PA,19090-0000,Public       ,2,10,12,35,,160,195
02495500,ALL-STATE CAREER SCHOOL                 ,PA,19029-0000,Proprietary  ,31,196,227,248,,917,1165
02529800,WILKES BARRE AREA CAREER AND TECHNICAL C,PA,18705-0000,Public       ,9,22,31,90,,236,326
02536600,COMMONWEALTH TECH INSTIT @ HIRAM G      ,PA,15905-0000,Public       ,29,8,37,262,,113,375
02544300,BUTLER BEAUTY SCHOOL                    ,PA,16001-0000,Proprietary  ,9,16,25,52,,114,166
02545000,LAWRENCE COUNTY CAREER AND TECHNICAL CEN,PA,16101-0000,Public       ,3,4,7,25,,76,101
02546200,LAUREL BUSINESS INSTITUTE               ,PA,15401-0877,Proprietary  ,12,11,23,174,,189,363
02550000,CLARION CO AREA VOC-TECH PRAC NRSG      ,PA,16254-4637,Public       ,6,9,15,27,,89,116
02554500,HAZLETON AREA CAREER CENTER PRACTICAL NU,PA,18201-0000,Public       ,10,15,25,47,,100,147
02557800,ART INSTITUTE OF YORK (THE) - PENNSYLVAN,PA,17402-9012,Proprietary  ,41,24,65,663,,326,989
02566400,ALBERT EINSTEIN MED CTR DEPT DNTL       ,PA,19141-3098,Private      ,3,17,20,36,,147,183
02574800,PENNSYLVANIA INSTITUTE OF TAXIDERMY     ,PA,15931-0000,Proprietary  ,2,5,7,16,,19,35
02609500,CAREER TRAINING ACADEMY                 ,PA,15068-6308,Proprietary  ,18,65,83,109,,301,410
02609501,CAREER TRAINING ACADEMY                 ,PA,15146-0000,Proprietary  ,5,4,9,23,,54,77
02616100,JEAN MADELINE ED CTR FOR COSM           ,PA,19147-1542,Proprietary  ,26,43,69,311,,393,704
02617507,EVEREST COLLEGE - EVEREST INSTITUTE - BE,PA,19020-2062,Proprietary  ,6,18,24,6,,18,24
03006800,LE CORDON BLEU INSTITUTE OF CULINARY ART,PA,15222-3511,Proprietary  ,0,0,0,29,,27,56
03010800,FORTIS INSTITUTE                        ,PA,16506-1013,Proprietary  ,63,226,289,761,,2164,2925
03011500,FORTIS INSTITUTE                        ,PA,18702-0000,Proprietary  ,11,46,57,97,,262,359
03011600,FORTIS INSTITUTE                        ,PA,18509-2903,Proprietary  ,11,55,66,209,,482,691
03029900,CONSOLIDATED SCHOOL OF BUSINESS         ,PA,17603-2389,Proprietary  ,4,34,38,71,,180,251
03067000,ANTONELLI MEDICAL & PROF INST           ,PA,19464-9244,Proprietary  ,4,36,40,43,,164,207
03072600,DCI CAREER INSTITUTE                    ,PA,15061-2307,Proprietary  ,3,22,25,45,,108,153
03081900,YTI CAREER INSTITUTE - ALTOONA          ,PA,16602-4457,Proprietary  ,14,39,53,259,,374,633
03090800,LAKE ERIE COLL OF OSTEOPATHIC MED       ,PA,16509-0000,Private      ,3,22,25,73,,3981,4054
03098600,CAREER TECH CTR OF LACKAWANNA CNTY      ,PA,18508-0000,Public       ,6,22,28,88,,230,318
03101400,FORBES ROAD CAREER & TECHNOLOGY CTR     ,PA,15146-1550,Public       ,3,6,9,13,,35,48
03101500,BIDWELL TRAINING CENTER                 ,PA,15233-2233,Private      ,0,28,28,32,,132,164
03103300,JNA INSTITUTE OF CULINARY ARTS          ,PA,19146-3119,Proprietary  ,19,36,55,118,,238,356
03109100,METROPOLITAN CAREER CENTER              ,PA,19144-0000,Private      ,4,22,26,42,,178,220
03110700,AVIATION INSTITUTE OF MAINTENANCE       ,PA,19114-1017,Proprietary  ,40,112,152,190,,542,732
03120400,REGIONAL CAREER & TECHNICAL CENTER      ,PA,16509-4699,Public       ,4,5,9,20,,31,51
03128400,DELAWARE COUNTY TECHNICAL SCHOOL        ,PA,19008-1928,Public       ,5,26,31,54,,224,278
03180400,PENNSYLVANIA HIGHLANDS COMMUNITY COLLEGE,PA,15904-2927,Public       ,70,96,166,1033,,928,1961
03236400,LT INTERNATIONAL BEAUTY SCHOOL          ,PA,19130-2235,Proprietary  ,7,39,46,36,,119,155
03353300,ACADEMY OF VOCAL ARTS                   ,PA,19103-6685,Private      ,6,18,24,53,,107,160
03380301,STAR CAREER ACADEMY - STAR PHILADELPHIA ,PA,19114-2204,Proprietary  ,86,235,321,447,,1317,1764
03380304,STAR CAREER ACADEMY - STAR NORRISTOWN   ,PA,19403-2422,Proprietary  ,9,53,62,58,,294,352
03493302,ALL-STATE CAREER - WEST MIFFLIN CAMPUS  ,PA,15122-0000,Proprietary  ,1,14,15,42,,184,226
03535300,HUNTINGDON COUNTY CAREER AND TECHNO     ,PA,17060-0905,Public       ,1,5,6,8,,44,52
03561400,SUSQUEHANNA COUNTY CAREER & TECHNOL     ,PA,18816-0100,Public       ,2,9,11,19,,85,104
03766300,PENNSYLVANIA SCHOOL OF MUSCLE THERAPY   ,PA,19406-3101,Proprietary  ,18,47,65,73,,199,272
03781300,PRINCETON INFORMATION TECHNOLOGY CENTER ,PA,19038-4535,Proprietary  ,8,41,49,43,,360,403
03899300,CALVARY BAPTIST THEOLOGICAL SEMINARY    ,PA,19446-4718,Private      ,0,0,0,2,,16,18
03923300,PRECISION MANUFACTURING INSTITUTE       ,PA,16335-8380,Private      ,2,17,19,20,,46,66
03948300,HARRISBURG UNIVERSITY OF SCIENCE AND TEC,PA,17101-2116,Private      ,10,36,46,845,,310,1155
03949300,WON INSTITUTE OF GRADUATE STUDIES       ,PA,19038-4535,Private      ,0,1,1,0,,69,69
03950500,NORTHWEST REGIONAL TECHNOLOGY INSTITUTE ,PA,16508-2820,Proprietary  ,2,21,23,24,,92,116
03952300,NATIONAL MASSAGE THERAPY INSTITUTE      ,PA,19116-3965,Proprietary  ,32,136,168,154,,684,838
04024300,EDUCATION AND TECHNOLOGY INSTITUTE      ,PA,15601-9214,Private      ,1,11,12,16,,48,64
04041300,BERKS CAREER & TECHNOLOGY CENTER        ,PA,19533-9112,Public       ,5,17,22,31,,62,93
04118000,BYZANTINE CATHOLIC SEMINARY OF SAINTS CY,PA,15214-2229,Private      ,0,1,1,1,,10,11
04127500,CAREER DEVELOPMENT & EMPLOYMENT         ,PA,18702-5253,Proprietary  ,1,13,14,9,,67,76
04145800,PULSE BEAUTY ACADEMY A PAUL MITCHELL PAR,PA,19335-0000,Proprietary  ,16,7,23,87,,101,188
04149800,SOMERSET COUNTY TECHNOLOGY CENTER       ,PA,15501-1444,Public       ,2,15,17,29,,123,152
04151700,BELLA CAPELLI ACADEMY                   ,PA,15146-2388,Proprietary  ,6,11,17,80,,73,153
04151701,BELLA CAPELLI ACADEMY -                 ,PA,15205-2388,Proprietary  ,9,12,21,87,,76,163
04155100,INSTITUTE OF MEDICAL CAREERS            ,PA,15235-3718,Proprietary  ,2,34,36,37,,154,191
04158000,METRO BEAUTY ACADEMY                    ,PA,18106-9693,Proprietary  ,14,30,44,109,,202,311
04164900,BARONE BEAUTY ACADEMY                   ,PA,17701-5316,Proprietary  ,6,11,17,56,,59,115
04167200,COMMONWEALTH MEDICAL COLLEGE (THE)      ,PA,18503-3251,Private      ,0,8,8,17,,708,725
04167500,WORLD A CUTS BARBER INSTITUTE           ,PA,17401-1105,Proprietary  ,5,17,22,18,,81,99
04175900,LEWISTOWN HOSPITAL SCHOOL OF NURSING    ,PA,17044-1167,Private      ,0,2,2,32,,54,86
04209700,NEWCOURTLAND EDUCATION CENTER SCHOOL OF ,PA,19119-2126,Private      ,0,0,0,12,,58,70
04215500,CHAMP'S BARBER SCHOOL                   ,PA,17603-3809,Proprietary  ,7,28,35,9,,45,54
04224600,BARBER SCHOOL OF PITTSBURGH             ,PA,15220-5537,Proprietary  ,10,41,51,15,,64,79
04226300,DIVINE CROWN ACADEMY OF COSMETOLOGY     ,PA,17104-2103,Proprietary  ,3,8,11,5,,9,14
00153410,EVEREST UNIVERSITY - EVEREST COLLEGE - M,WI,53212-4006,Proprietary  ,0,0,0,64,,224,288
00267813,BRYANT & STRATTON COLLEGE - MIL DOWNTOWN,WI,53203-2608,Proprietary  ,74,310,384,921,,3207,4128
00383200,ALVERNO COLLEGE                         ,WI,53234-3922,Private      ,43,217,260,1609,,2750,4359
00383500,BELOIT COLLEGE                          ,WI,53511-5595,Private      ,43,18,61,2100,,156,2256
00383700,CARDINAL STRITCH UNIVERSITY             ,WI,53217-9884,Private      ,46,445,491,1320,,4598,5918
00383800,CARROLL UNIVERSITY                      ,WI,53186-5593,Private      ,45,57,102,4050,,1009,5059
00383900,CARTHAGE COLLEGE                        ,WI,53141-0000,Private      ,112,106,218,5161,,965,6126
00384000,WESTERN TECHNICAL COLLEGE               ,WI,54601-0908,Public       ,140,322,462,2322,,2654,4976
00384200,CONCORDIA UNIVERSITY WISCONSIN          ,WI,53097-2402,Private      ,66,423,489,3584,,5045,8629
00384800,EDGEWOOD COLLEGE                        ,WI,53711-1958,Private      ,39,123,162,1953,,1433,3386
00385000,SILVER LAKE COLLEGE                     ,WI,54220-9319,Private      ,4,40,44,234,,381,615
00385400,LAKELAND COLLEGE                        ,WI,53082-0000,Private      ,28,179,207,1374,,2121,3495
00385600,LAWRENCE UNIVERSITY                     ,WI,54912-0599,Private      ,44,6,50,2450,,171,2621
00386100,MARIAN UNIVERSITY                       ,WI,54935-4699,Private      ,22,67,89,1491,,1069,2560
00386300,MARQUETTE UNIVERSITY                    ,WI,53201-1881,Private      ,300,186,486,16903,,4642,21545
00386600,MILWAUKEE AREA TECH COLLEGE             ,WI,53233-1443,Public       ,725,2493,3218,8142,,20043,28185
00386800,MILWAUKEE SCHOOL OF ENGINEERING         ,WI,53202-3109,Private      ,65,81,146,2923,,973,3896
00386900,MOUNT MARY COLLEGE                      ,WI,53222-4597,Private      ,32,102,134,844,,1442,2286
00387400,NASHOTAH HOUSE                          ,WI,53058-0000,Private      ,0,6,6,1,,79,80
00387500,NORTHLAND COLLEGE                       ,WI,54806-3999,Private      ,22,9,31,882,,140,1022
00388400,RIPON COLLEGE                           ,WI,54971-0248,Private      ,13,4,17,1350,,88,1438
00389200,ST. NORBERT COLLEGE                     ,WI,54115-2099,Private      ,32,9,41,2771,,145,2916
00389500,UNIVERSITY OF WISCONSIN-MADISON         ,WI,53715-1382,Public       ,578,488,1066,27694,,11132,38826
00389600,UNIVERSITY OF WISCONSIN-MILWAUKEE       ,WI,53201-3165,Public       ,520,907,1427,19307,,14062,33369
00389700,UNIVERSITY OF WISCONSIN COLLEGES        ,WI,53708-8680,Public       ,127,217,344,2957,,2228,5185
00389701,UNIVERSITY OF WISCONSIN-BARABOO         ,WI,53913-1098,Public       ,13,31,44,416,,244,660
00389702,UNIVERSITY OF WISCONSIN-BARRON          ,WI,54868-2497,Public       ,14,26,40,406,,242,648
00389703,UNIVERSITY OF WISCONSIN-FOND DU LAC     ,WI,54935-2998,Public       ,24,34,58,617,,333,950
00389704,UNIVERSITY OF WISCONSIN-FOX VALLEY      ,WI,54952-1297,Public       ,48,58,106,1306,,640,1946
00389705,UNIVERSITY OF WISCONSIN-MANITOWOC       ,WI,54220-6699,Public       ,10,17,27,385,,186,571
00389706,UNIVERSITY OF WISCONSIN-MARATHON        ,WI,54401-5396,Public       ,27,45,72,1000,,465,1465
00389707,UNIVERSITY OF WISCONSIN-MARINETTE       ,WI,54143-4299,Public       ,10,32,42,318,,224,542
00389708,UNIVERSITY OF WISCONSIN-MARSHFIELD      ,WI,54449-3310,Public       ,9,20,29,384,,226,610
00389709,UNIVERSITY OF WISCONSIN-RICHLAND        ,WI,53581-1399,Public       ,5,12,17,357,,140,497
00389710,UNIVERSITY OF WISCONSIN COLLEGES - ROCK ,WI,53546-5699,Public       ,40,50,90,880,,647,1527
00389711,UNIVERSITY OF WISCONSIN-SHEBOYGAN       ,WI,53081-4789,Public       ,21,38,59,563,,366,929
00389712,UNIVERSITY OF WISCONSIN-WASHINGTON      ,WI,53095-3699,Public       ,23,29,52,738,,306,1044
00389713,UNIVERSITY OF WISCONSIN-WAUKESHA        ,WI,53188-2799,Public       ,66,59,125,1594,,715,2309
00389900,UNIVERSITY OF WISCONSIN-GREEN BAY       ,WI,54311-7001,Public       ,100,199,299,4942,,2839,7781
00391100,VITERBO UNIVERSITY                      ,WI,54601-4777,Private      ,39,68,107,1931,,1336,3267
00391500,UNIVERSITY OF WISCONSIN-STOUT           ,WI,54751-0790,Public       ,118,168,286,6532,,2353,8885
00391700,UNIVERSITY OF WISCONSIN-EAU CLAIRE      ,WI,54702-4004,Public       ,181,163,344,9767,,2075,11842
00391900,UNIVERSITY OF WISCONSIN-LA CROSSE       ,WI,54601-3742,Public       ,163,105,268,9366,,1862,11228
00392000,UNIVERSITY OF WISCONSIN-OSHKOSH         ,WI,54901-8604,Public       ,181,224,405,9606,,3808,13414
00392100,UNIVERSITY OF WISCONSIN-PLATTEVILLE     ,WI,53818-3099,Public       ,123,151,274,7544,,1916,9460
00392300,UNIVERSITY OF WISCONSIN-RIVER FALLS     ,WI,54022-5013,Public       ,107,92,199,5189,,1488,6677
00392400,UNIVERSITY OF WISCONSIN-STEVENS POINT   ,WI,54481-3871,Public       ,142,107,249,8546,,2247,10793
00392500,UNIVERSITY OF WISCONSIN-SUPERIOR        ,WI,54880-2898,Public       ,49,118,167,1775,,1535,3310
00392600,UNIVERSITY OF WISCONSIN-WHITEWATER      ,WI,53190-1792,Public       ,234,185,419,10704,,2871,13575
00400700,MADISON AREA TECHNICAL COLLEGE          ,WI,53704-2599,Public       ,371,1048,1419,5617,,9146,14763
00501500,UNIVERSITY OF WISCONSIN-PARKSIDE        ,WI,53141-2000,Public       ,128,217,345,4057,,2638,6695
00529400,WAUKESHA COUNTY TECHNICAL COLLEGE       ,WI,53072-4696,Public       ,142,364,506,1782,,3835,5617
00530100,NORTHEAST WISCONSIN TECHNICAL COLLEGE   ,WI,54307-9042,Public       ,198,581,779,3214,,5831,9045
00530400,CHIPPEWA VALLEY TECHNICAL COLLEGE       ,WI,54701-6162,Public       ,180,410,590,2568,,3731,6299
00538000,MID-STATE TECHNICAL COLLEGE             ,WI,54494-5512,Public       ,72,208,280,1001,,1996,2997
00538400,NICOLET AREA TECHNICAL COLLEGE          ,WI,54501-0000,Public       ,30,115,145,595,,1006,1601
00538700,NORTHCENTRAL TECHNICAL COLLEGE          ,WI,54401-1899,Public       ,92,334,426,1508,,3342,4850
00538900,GATEWAY TECHNICAL COLLEGE               ,WI,53144-1690,Public       ,227,843,1070,2844,,8317,11161
00539000,BLACKHAWK TECHNICAL COLLEGE             ,WI,53547-5009,Public       ,109,363,472,1086,,3045,4131
00663900,BELLIN COLLEGE                          ,WI,54305-0000,Private      ,15,16,31,344,,240,584
00732934,ITT TECHNICAL INSTITUTE                 ,WI,53220-4612,Proprietary  ,54,314,368,394,,1973,2367
00766900,SOUTHWEST WISCONSIN TECH COLLEGE        ,WI,53809-0000,Public       ,31,70,101,813,,877,1690
00778103,CHI INSTITUTE/RETS CAMPUS - KAPLAN COLLE,WI,53212-3939,Proprietary  ,0,0,0,107,,538,645
00821700,PAUL MITCHELL THE SCHOOL GREEN BAY      ,WI,54324-0257,Proprietary  ,12,18,30,115,,145,260
00869405,RASMUSSEN COLLEGE - WAUSAU              ,WI,54401-7804,Proprietary  ,10,83,93,134,,863,997
00869414,RASMUSSEN COLLEGE - GREEN BAY           ,WI,54303-2349,Proprietary  ,9,110,119,165,,936,1101
00869419,RASMUSSEN COLLEGE - APPLETON            ,WI,54915-7305,Proprietary  ,8,79,87,112,,663,775
00919400,LAKESHORE TECHNICAL COLLEGE             ,WI,53015-1412,Public       ,47,214,261,822,,1825,2647
00925600,MORAINE PARK TECHNICAL COLLEGE          ,WI,54936-0000,Public       ,102,288,390,1195,,2812,4007
00941900,STATE CLG OF BEAUTY CULT-WAUSAU         ,WI,54403-4667,Proprietary  ,5,15,20,47,,77,124
00962100,HERZING UNIVERSITY                      ,WI,53718-4236,Proprietary  ,112,1189,1301,1190,,10472,11662
00974400,FOX VALLEY TECHNICAL COLLEGE            ,WI,54913-0000,Public       ,271,749,1020,3574,,6165,9739
01091300,MADISON MEDIA INSTITUTE                 ,WI,53718-6787,Proprietary  ,32,69,101,659,,618,1277
01148400,ADVANCED INSTITUTE OF HAIR DESIGN       ,WI,53225-0000,Proprietary  ,26,38,64,294,,329,623
01182400,WISCONSIN INDIANHEAD TECH CLG WITC      ,WI,54871-9300,Public       ,86,237,323,1144,,2512,3656
01260610,EMPIRE BEAUTY SCHOOL - MADISON          ,WI,53717-1111,Proprietary  ,0,0,0,73,,155,228
01260611,EMPIRE BEAUTY SCHOOL - GREEN BAY        ,WI,54304-4838,Proprietary  ,0,0,0,77,,177,254
02077100,MILWAUKEE INST OF ART & DESIGN          ,WI,53202-0000,Private      ,48,51,99,1152,,433,1585
02078000,SACRED HEART SCHOOL OF THEOLOGY         ,WI,53130-0000,Private      ,1,0,1,1,,4,5
02136600,WISCONSIN LUTHERAN COLLEGE              ,WI,53226-0000,Private      ,25,45,70,1356,,409,1765
02173208,EMPIRE BEAUTY SCHOOL - MANITOWOC        ,WI,54220-5040,Proprietary  ,0,0,0,79,,199,278
02173209,EMPIRE BEAUTY SCHOOL - APPLETON         ,WI,54914-4644,Proprietary  ,0,0,0,23,,38,61
02239204,ANTHEM COLLEGE - BROOKFIELD             ,WI,53005-4207,Proprietary  ,13,60,73,82,,355,437
02271300,WI SCH OF PROFESSIONAL PSYCHOLOGY       ,WI,53225-0000,Private      ,5,17,22,32,,194,226
02317200,MARANATHA BAPTIST BIBLE COLLEGE         ,WI,53094-0000,Private      ,34,26,60,888,,206,1094
02453500,MEDICAL COLLEGE OF WISCONSIN            ,WI,53226-0000,Private      ,15,34,49,123,,1294,1417
02494300,GILL-TECH ACADEMY OF HAIR DESIGN        ,WI,54911-0000,Proprietary  ,9,15,24,52,,78,130
02532200,LAC COURTE OREILLES OJIBWA CMTY CLG     ,WI,54843-0000,Public       ,4,38,42,68,,423,491
03061200,MIDWEST COLLEGE OF ORIENTAL MEDICINE    ,WI,53403-9747,Proprietary  ,6,43,49,28,,279,307
03125100,COLLEGE OF MENOMINEE NATION             ,WI,54135-0000,Private      ,8,58,66,120,,513,633
03125102,COLLEGE OF  THE MENOMINEE NATION - GREEN,WI,54304-4964,Private      ,7,47,54,63,,277,340
03220300,"SALON PROFESSIONAL ACADEMY, THE         ",WI,54701-7633,Proprietary  ,7,17,24,75,,99,174
03309300,MONTESSORI INSTITUTE OF MILWAUKEE       ,WI,53207-0000,Private      ,2,8,10,7,,49,56
03808300,INSTITUTE OF BEAUTY AND WELLNESS (THE)  ,WI,53202-5715,Proprietary  ,11,50,61,164,,279,443
03822300,PAUL MITCHELL THE SCHOOL - MONROE       ,WI,53566-0000,Proprietary  ,3,4,7,35,,45,80
03872500,NORTHLAND INTERNATIONAL UNIVERSITY      ,WI,54119-9285,Private      ,6,2,8,352,,69,421
03925300,BLUE SKY SCHOOL OF PROFESSIONAL MASSAGE ,WI,53024-9699,Private      ,1,4,5,11,,63,74
03925301,BLUE SKY SCHOOL OF PROFESSIONAL MASSAGE ,WI,54115-7407,Private      ,2,7,9,11,,53,64
03925303,BLUE SKY SCHOOL OF PROFESSIONAL MASSAGE ,WI,53713-2366,Private      ,7,10,17,16,,58,74
04117400,MILWAUKEE CAREER COLLEGE                ,WI,53222-4305,Proprietary  ,32,118,150,280,,684,964
04118600,ACADEMY OF COSMETOLOGY                  ,WI,53548-3307,Proprietary  ,1,19,20,44,,127,171
04124800,VISIONS IN HAIR DESIGN INSTITUTE OF COSM,WI,53210-1120,Proprietary  ,4,16,20,44,,102,146
04132600,WISCONSIN ACADEMY (THE)                 ,WI,54157-1726,Proprietary  ,3,9,12,18,,32,50
04137900,BRENSTEN EDUCATION                      ,WI,53186-0000,Proprietary  ,5,122,127,36,,427,463
04138200,SALON PROFESSIONAL ACADEMY (THE)        ,WI,54914-3921,Proprietary  ,11,14,25,68,,73,141
04157700,SALON PROFESSIONAL ACADEMY (THE)        ,WI,54650-8699,Proprietary  ,8,15,23,67,,94,161
04159400,COLUMBIA COLLEGE OF NURSING             ,WI,53211-2952,Private      ,3,33,36,167,,347,514
04165300,ACADEMY WAUKESHA (THE)                  ,WI,53072-5524,Proprietary  ,20,19,39,96,,134,230
04179200,ADVANCED COLLEGE OF COSMETOLOGY         ,WI,53963-0000,Proprietary  ,8,2,10,42,,34,76
04182100,FIRST CLASS COSMETOLOGY SCHOOL          ,WI,52511-0000,Proprietary  ,7,19,26,46,,90,136
04183600,SALON PROFESSIONAL ACADEMY OF KENOSHA (T,WI,53142-4950,Proprietary  ,13,29,42,87,,186,273
04193800,SHEPHERDS COLLEGE                       ,WI,53182-1527,Private      ,2,0,2,27,,19,46
04202800,PANACHE ACADEMY OF BEAUTY               ,WI,53913-2596,Proprietary  ,6,11,17,30,,61,91
04219300,EAST-WEST HEALING ARTS INSTITUTE        ,WI,53719-1133,Proprietary  ,2,4,6,2,,4,6
00290500,NORTH CAROLINA A&T STATE UNIV           ,NC,27411-0001,Public       ,516,586,1102,16602,,8067,24669
00290600,APPALACHIAN STATE UNIVERSITY            ,NC,28608-2059,Public       ,647,365,1012,18623,,5289,23912
00290700,UNIVERSITY OF NC AT ASHEVILLE           ,NC,28804-3299,Public       ,215,187,402,4829,,2282,7111
00290800,BARTON COLLEGE                          ,NC,27893-3104,Private      ,63,60,123,1730,,926,2656
00291000,BELMONT ABBEY COLLEGE                   ,NC,28012-1802,Private      ,43,114,157,1518,,1342,2860
00291100,BENNETT COLLEGE                         ,NC,27401-3239,Private      ,26,67,93,1353,,648,2001
00291200,BREVARD COLLEGE                         ,NC,28712-3306,Private      ,52,26,78,1337,,259,1596
00291300,CAMPBELL UNIVERSITY                     ,NC,27506-0036,Private      ,147,312,459,6107,,4401,10508
00291400,CATAWBA COLLEGE                         ,NC,28144-2488,Private      ,69,62,131,2024,,768,2792
00291500,CENTRAL PIEDMONT COMMUNITY COLLEGE      ,NC,28204-2297,Public       ,1047,2964,4011,11815,,22243,34058
00291600,CHOWAN UNIVERSITY                       ,NC,27855-1850,Private      ,53,35,88,2202,,476,2678
00291700,COLLEGE OF THE ALBEMARLE                ,NC,27909-2327,Public       ,88,308,396,1127,,1969,3096
00291800,DAVIDSON COLLEGE                        ,NC,28035-7157,Private      ,120,36,156,3448,,298,3746
00291900,DAVIDSON COUNTY COMMUNITY COLLEGE       ,NC,27293-0000,Public       ,217,655,872,2105,,5260,7365
00292000,DUKE UNIVERSITY                         ,NC,27708-0397,Private      ,595,148,743,19744,,2408,22152
00292001,DUKE UNIV - SCHOOL OF MEDICINE          ,NC,27710-0000,Private      ,29,35,64,266,,1157,1423
00292002,DUKE UNIV - SCHOOL OF LAW               ,NC,27708-0000,Private      ,14,43,57,100,,2120,2220
00292003,DUKE UNIV - GRAD SCH ARTS & SCIENCE     ,NC,27708-0000,Private      ,13,52,65,164,,855,1019
00292004,DUKE UNIV - FUQUA SCH OF BUSINESS       ,NC,27708-0000,Private      ,9,61,70,115,,1176,1291
00292005,DUKE UNIV/NICHOLAS SCH OF ENVIRON.      ,NC,27708-0000,Private      ,2,13,15,50,,397,447
00292006,DUKE UNIV - DIVINITY SCHOOL             ,NC,27708-0000,Private      ,24,30,54,375,,834,1209
00292007,DUKE UNIV - SCHOOL OF NURSING           ,NC,27710-0000,Private      ,21,109,130,270,,1521,1791
00292010,DUKE UNIVERSITY - SCHOOL OF PUBLIC POLIC,NC,27708-0239,Private      ,6,12,18,60,,275,335
00292300,EAST CAROLINA UNIVERSITY                ,NC,27858-1818,Public       ,846,965,1811,24924,,13618,38542
00292600,ELIZABETH CITY STATE UNIVERSITY         ,NC,27909-7806,Public       ,65,113,178,3740,,1709,5449
00292700,ELON UNIVERSITY                         ,NC,27244-2010,Private      ,240,82,322,7997,,1431,9428
00292800,FAYETTEVILLE STATE UNIVERSITY           ,NC,28301-4298,Public       ,215,700,915,5744,,8679,14423
00292900,GARDNER-WEBB UNIVERSITY                 ,NC,28017-0000,Private      ,117,394,511,3377,,4119,7496
00293000,GREENSBORO COLLEGE                      ,NC,27401-1875,Private      ,78,157,235,2100,,1553,3653
00293100,GUILFORD COLLEGE                        ,NC,27410-4171,Private      ,127,336,463,3314,,3511,6825
00293300,HIGH POINT UNIVERSITY                   ,NC,27262-4221,Private      ,197,105,302,5659,,1003,6662
00293400,ISOTHERMAL COMMUNITY COLLEGE            ,NC,28160-0804,Public       ,95,243,338,1023,,1809,2832
00293500,LAUREL UNIVERSITY                       ,NC,27265-3197,Private      ,3,26,29,65,,352,417
00293600,JOHNSON C SMITH UNIVERSITY              ,NC,28216-5398,Private      ,99,188,287,3309,,2145,5454
00293700,KING'S COLLEGE-CHARLOTTE                ,NC,28204-2435,Proprietary  ,42,120,162,994,,1053,2047
00293900,LEES MCRAE COLLEGE                      ,NC,28604-0000,Private      ,42,23,65,1337,,428,1765
00294000,LENOIR COMMUNITY COLLEGE                ,NC,28502-0188,Public       ,69,388,457,1189,,2865,4054
00294100,LENOIR-RHYNE UNIVERSITY                 ,NC,28603-0000,Private      ,123,108,231,3209,,1276,4485
00294200,LIVINGSTONE COLLEGE                     ,NC,28144-5298,Private      ,53,54,107,1698,,645,2343
00294300,LOUISBURG COLLEGE                       ,NC,27549-2398,Private      ,66,30,96,1403,,302,1705
00294400,MARS HILL COLLEGE                       ,NC,28754-0000,Private      ,68,43,111,2355,,558,2913
00294500,MEREDITH COLLEGE                        ,NC,27607-5298,Private      ,70,109,179,2212,,1224,3436
00294600,METHODIST UNIVERSITY                    ,NC,28311-1420,Private      ,98,252,350,2964,,2469,5433
00294700,MITCHELL COMMUNITY COLLEGE              ,NC,28677-5264,Public       ,133,306,439,1470,,2679,4149
00294800,MONTREAT COLLEGE                        ,NC,28757-1267,Private      ,20,70,90,574,,784,1358
00294900,MOUNT OLIVE COLLEGE                     ,NC,28365-1299,Private      ,77,402,479,1521,,4326,5847
00295000,NORTH CAROLINA CENTRAL UNIVERSITY       ,NC,27707-3198,Public       ,340,497,837,9905,,8131,18036
00295100,NORTH CAROLINA WESLEYAN COLLEGE         ,NC,27804-8699,Private      ,42,165,207,1218,,1721,2939
00295300,PEACE COLLEGE                           ,NC,27604-1194,Private      ,49,99,148,1481,,973,2454
00295400,UNIV OF NORTH CAROLINA AT PEMBROKE      ,NC,28372-1510,Public       ,229,323,552,6959,,4720,11679
00295500,PFEIFFER UNIVERSITY                     ,NC,28109-0000,Private      ,31,112,143,1202,,1510,2712
00295600,PIEDMONT BAPTIST COLLEGE AND GRADUATE SC,NC,27101-5025,Private      ,11,22,33,189,,243,432
00295700,QUEENS UNIVERSITY OF CHARLOTTE          ,NC,28274-0001,Private      ,117,310,427,2580,,2720,5300
00295800,ROCKINGHAM COMMUNITY COLLEGE            ,NC,27375-0000,Public       ,84,207,291,1042,,1745,2787
00296000,SALEM COLLEGE                           ,NC,27108-0000,Private      ,34,91,125,1037,,1072,2109
00296100,SANDHILLS COMMUNITY COLLEGE             ,NC,28374-8283,Public       ,174,427,601,1895,,3741,5636
00296200,SHAW UNIVERSITY                         ,NC,27601-2393,Private      ,99,183,282,3524,,2576,6100
00296300,SOUTHEASTERN BAPTIST THEOL SEMINARY     ,NC,27588-0000,Private      ,6,20,26,50,,106,156
00296400,SOUTHEASTERN COMMUNITY COLLEGE          ,NC,28472-5422,Public       ,48,153,201,746,,1522,2268
00296800,ST AUGUSTINES COLLEGE                   ,NC,27610-2298,Private      ,68,92,160,2565,,1173,3738
00297000,SURRY COMMUNITY COLLEGE                 ,NC,27017-0304,Public       ,107,222,329,1436,,2104,3540
00297200,NORTH CAROLINA STATE UNIV-RALEIGH       ,NC,27695-7001,Public       ,812,922,1734,29826,,12594,42420
00297300,GASTON COLLEGE                          ,NC,28034-1499,Public       ,227,726,953,2536,,5468,8004
00297400,UNIVERSITY OF N C-CHAPEL HILL           ,NC,27514-0000,Public       ,871,743,1614,28356,,14029,42385
00297500,UNIVERSITY OF NC AT CHARLOTTE           ,NC,28223-0001,Public       ,870,1146,2016,27067,,15646,42713
00297600,UNIVERSITY OF N C - GREENSBORO          ,NC,27412-0001,Public       ,610,821,1431,18591,,12018,30609
00297800,WAKE FOREST UNIV - UNDERGRADUATE        ,NC,27109-7246,Private      ,235,36,271,7857,,575,8432
00297801,WAKE FOREST UNIV - SCH OF MEDICINE      ,NC,27157-1090,Private      ,22,31,53,172,,1177,1349
00297803,WAKE FOREST GRAD SCHOOLS OF BUSINESS    ,NC,27109-7659,Private      ,2,79,81,66,,901,967
00297805,WAKE FOREST UNIV - SCH OF LAW           ,NC,27109-7206,Private      ,11,21,32,55,,1377,1432
00297806,WAKE FOREST UNIV - GRAD A&S/DIVINITY    ,NC,27109-7246,Private      ,3,51,54,49,,781,830
00297900,WARREN WILSON COLLEGE                   ,NC,28815-0000,Private      ,57,45,102,1391,,523,1914
00298000,WAYNE COMMUNITY COLLEGE                 ,NC,27533-0000,Public       ,135,484,619,1661,,3819,5480
00298100,WESTERN CAROLINA UNIVERSITY             ,NC,28723-9731,Public       ,341,340,681,10721,,4625,15346
00298200,WESTERN PIEDMONT COMMUNITY COLLEGE      ,NC,28655-4504,Public       ,55,210,265,1214,,2119,3333
00298300,WILKES COMMUNITY COLLEGE                ,NC,28697-2100,Public       ,109,229,338,1323,,1774,3097
00298400,UNIVERSITY OF N C-WILMINGTON            ,NC,28403-3297,Public       ,598,493,1091,16666,,6572,23238
00298500,WINGATE UNIVERSITY                      ,NC,28174-0159,Private      ,161,73,234,4449,,1417,5866
00298600,WINSTON-SALEM STATE UNIVERSITY          ,NC,27102-0000,Public       ,253,500,753,7849,,6096,13945
00398100,UNC SCHOOL OF THE ARTS                  ,NC,27127-2188,Public       ,62,45,107,1530,,568,2098
00403300,ASHEVILLE BUNCOMBE TECH CMTY CLG        ,NC,28801-4897,Public       ,275,798,1073,3004,,6746,9750
00406200,PITT COMMUNITY COLLEGE                  ,NC,28590-0000,Public       ,359,936,1295,5121,,8494,13615
00483500,CALDWELL COMMUNITY CLG & TECH INST      ,NC,28638-2626,Public       ,147,300,447,1766,,2952,4718
00483800,GUILFORD TECHNICAL COMMUNITY CLG        ,NC,27282-0309,Public       ,595,1587,2182,7438,,16267,23705
00484400,WAKE TECHNICAL COMMUNITY COLLEGE        ,NC,27603-5696,Public       ,825,2145,2970,10296,,18981,29277
00484500,WILSON COMMUNITY COLLEGE                ,NC,27893-3310,Public       ,72,311,383,796,,2383,3179
00499201,MILLER-MOTTE TECHNICAL COLLEGE - MILLER-,NC,27511-9209,Proprietary  ,22,125,147,158,,774,932
00499202,MILLER-MOTTE TECHNICAL COLLEGE - MILLER-,NC,27604-6072,Proprietary  ,36,234,270,443,,1778,2221
00499203,MILLER-MOTTE TECHNICAL COLLEGE - FAYETTE,NC,28311-7651,Proprietary  ,42,308,350,435,,2396,2831
00499205,MILLER-MOTTE TECHNICAL COLLEGE - MILLER-,NC,28540-5901,Proprietary  ,26,185,211,149,,1179,1328
00531600,COASTAL CAROLINA COMMUNITY COLLEGE      ,NC,28546-6816,Public       ,151,805,956,1725,,5653,7378
00531700,FORSYTH TECHNICAL COMMUNITY COLLEGE     ,NC,27103-5197,Public       ,418,1225,1643,4761,,10578,15339
00531800,CATAWBA VALLEY COMMUNITY COLLEGE        ,NC,28602-8302,Public       ,166,454,620,2623,,4219,6842
00532000,CAPE FEAR COMMUNITY COLLEGE             ,NC,28401-3910,Public       ,395,989,1384,4979,,7580,12559
00544700,RANDOLPH COMMUNITY COLLEGE              ,NC,27204-1009,Public       ,128,358,486,1332,,2774,4106
00544800,DURHAM TECHNICAL CMNTY COLLEGE          ,NC,27703-5023,Public       ,214,780,994,2366,,7010,9376
00544900,CENTRAL CAROLINA COMMUNITY COLLEGE      ,NC,27330-9000,Public       ,187,550,737,1840,,4577,6417
00546300,ALAMANCE COMMUNITY COLLEGE              ,NC,27253-0000,Public       ,193,543,736,2075,,4212,6287
00546400,RICHMOND COMMUNITY COLLEGE              ,NC,28345-4522,Public       ,69,242,311,936,,2359,3295
00575400,ROWAN-CABARRUS COMMUNITY COLLEGE        ,NC,28146-8357,Public       ,220,687,907,2597,,6110,8707
00647700,CABARRUS COLLEGE OF HEALTH SCIENCES     ,NC,28025-0000,Private      ,33,104,137,423,,983,1406
00647800,MERCY HOSP SCH OF NURSING               ,NC,28207-0000,Public       ,21,121,142,232,,1084,1316
00648300,WATTS SCHOOL OF NURSING                 ,NC,27704-0000,Private      ,9,36,45,112,,439,551
00679900,CRAVEN COMMUNITY COLLEGE                ,NC,28562-0000,Public       ,100,505,605,1054,,3827,4881
00703100,PAMLICO COMMUNITY COLLEGE               ,NC,28529-0000,Public       ,11,40,51,95,,385,480
00764000,FAYETTEVILLE TECHNICAL CMTY COLLEGE     ,NC,28303-0236,Public       ,414,2045,2459,4478,,17202,21680
00768700,JAMES SPRUNT COMMUNITY COLLEGE          ,NC,28349-0398,Public       ,23,130,153,437,,1456,1893
00781400,BROOKSTONE COLLEGE OF BUSINESS          ,NC,28262-1294,Proprietary  ,7,103,110,152,,700,852
00781401,BROOKSTONE COLLEGE OF BUSINESS          ,NC,27409-0000,Proprietary  ,14,89,103,106,,552,658
00789200,SAMPSON COMMUNITY COLLEGE               ,NC,28328-0000,Public       ,51,137,188,570,,1407,1977
00798500,SOUTH PIEDMONT COMMUNITY COLLEGE        ,NC,28135-9703,Public       ,82,268,350,989,,2225,3214
00798600,HALIFAX COMMUNITY COLLEGE               ,NC,27890-0089,Public       ,38,143,181,627,,1370,1997
00798700,BLADEN COMMUNITY COLLEGE                ,NC,28332-0266,Public       ,47,196,243,593,,1645,2238
00798800,MARTIN COMMUNITY COLLEGE                ,NC,27892-8307,Public       ,23,114,137,357,,902,1259
00808100,CARTERET COMMUNITY COLLEGE              ,NC,28557-2989,Public       ,71,226,297,716,,1850,2566
00808200,CLEVELAND COMMUNITY COLLEGE             ,NC,28150-0000,Public       ,73,282,355,1144,,2780,3924
00808300,HAYWOOD COMMUNITY COLLEGE               ,NC,28721-0000,Public       ,67,201,268,706,,1774,2480
00808500,MCDOWELL TECHNICAL COMMUNITY CLG        ,NC,28752-8728,Public       ,24,127,151,379,,1013,1392
00808700,MONTGOMERY COMMUNITY COLLEGE            ,NC,27371-0787,Public       ,24,112,136,361,,784,1145
00846600,SOUTHWESTERN COMMUNITY COLLEGE          ,NC,28779-8581,Public       ,79,194,273,944,,1846,2790
00855700,NASH COMMUNITY COLLEGE                  ,NC,27804-0488,Public       ,129,458,587,1498,,3574,5072
00855800,BEAUFORT COUNTY COMMUNITY COLLEGE       ,NC,27889-7889,Public       ,85,285,370,772,,2173,2945
00861200,ROBESON COMMUNITY COLLEGE               ,NC,28359-2151,Public       ,85,348,433,1309,,3456,4765
00861300,ROANOKE-CHOWAN COMMUNITY COLLEGE        ,NC,27910-9522,Public       ,23,95,118,360,,881,1241
00885500,EDGECOMBE COMMUNITY COLLEGE             ,NC,27886-9399,Public       ,79,388,467,906,,3675,4581
00902500,EMPIRE BEAUTY SCHOOL                    ,NC,28105-2508,Proprietary  ,0,0,0,179,,384,563
00933600,JOHNSTON COMMUNITY COLLEGE              ,NC,27577-0000,Public       ,173,458,631,1866,,4037,5903
00943000,TRI-COUNTY COMMUNITY COLLEGE            ,NC,28906-7919,Public       ,41,121,162,432,,966,1398
00964600,PIEDMONT COMMUNITY COLLEGE              ,NC,27573-1197,Public       ,51,176,227,556,,1309,1865
00968400,BLUE RIDGE COMMUNITY COLLEGE            ,NC,28731-9624,Public       ,74,239,313,827,,1809,2636
00974701,GORDON-CONWELL THEO SEM - CHARLOTTE     ,NC,28273-0000,Private      ,1,41,42,16,,324,340
00990300,VANCE-GRANVILLE CMTY COLLEGE            ,NC,27536-0917,Public       ,126,432,558,1428,,3436,4864
01019804,ECPI UNIVERSITY - GREENSBORO            ,NC,27409-9048,Proprietary  ,14,146,160,15,,149,164
01019805,ECPI UNIVERSITY - CHARLOTTE             ,NC,28208-5886,Proprietary  ,44,273,317,44,,275,319
01019810,ECPI UNIVERSITY - RALEIGH               ,NC,27613-7387,Proprietary  ,23,154,177,23,,154,177
01019812,ECPI UNIVERSITY - CONCORD               ,NC,28262-0000,Proprietary  ,15,122,137,15,,122,137
01026400,SOUTH COLLEGE                           ,NC,28803-3152,Proprietary  ,20,101,121,150,,767,917
01119400,STANLY COMMUNITY COLLEGE                ,NC,28001-7458,Public       ,68,269,337,969,,2618,3587
01119700,MAYLAND COMMUNITY COLLEGE               ,NC,28777-2777,Public       ,36,94,130,436,,677,1113
01179900,PAUL MITCHELL THE SCHOOL FAYETTEVILLE   ,NC,28303-5364,Proprietary  ,40,106,146,214,,633,847
01192600,LEON'S BEAUTY SCHOOL                    ,NC,27403-2812,Proprietary  ,21,43,64,210,,385,595
01303918,SOUTH UNIVERSITY - THE ART INSTITUTE OF ,NC,28217-4536,Proprietary  ,226,192,418,1987,,1614,3601
02056500,MITCHELL'S HAIR STYLING ACADEMY         ,NC,27893-0000,Proprietary  ,4,16,20,34,,96,130
02056501,MITCHELL'S HAIR STYLING ACADEMY - MITCHE,NC,27606-3326,Proprietary  ,15,45,60,113,,317,430
02158414,HARRISON COLLEGE - THE CHEF'S ACADEMY - ,NC,27560-0000,Proprietary  ,9,31,40,86,,262,348
02170700,BRUNSWICK COMMUNITY COLLEGE             ,NC,28422-0000,Public       ,42,168,210,687,,1252,1939
02205000,COLLEGE OF WILMINGTON                   ,NC,28403-0000,Proprietary  ,35,108,143,267,,666,933
02210400,FAYETTEVILLE BEAUTY COLLEGE             ,NC,28303-0000,Proprietary  ,15,72,87,127,,487,614
02227800,MITCHELL'S HAIR STYLING ACADEMY         ,NC,27534-0000,Proprietary  ,6,10,16,27,,91,118
02227900,MITCHELL'S HAIR STYLING ACADEMY         ,NC,27858-0000,Proprietary  ,4,12,16,54,,108,162
02280900,MID-ATLANTIC CHRISTIAN UNIVERSITY       ,NC,27909-0000,Private      ,14,30,44,171,,187,358
02326203,KAPLAN CAREER INSTITUTE - KAPLAN COLLEGE,NC,28212-6830,Proprietary  ,37,288,325,335,,1947,2282
02558900,CHEVEUX SCHOOL OF HAIR DESIGN           ,NC,28540-0000,Proprietary  ,1,16,17,15,,106,121
02560600,PINNACLE INSTITUTE OF COSMETOLOGY       ,NC,28115-8020,Proprietary  ,6,25,31,69,,129,198
02614201,MILLER-MOTTE BUSINESS COLLEGE           ,NC,28403-0000,Proprietary  ,56,465,521,496,,4042,4538
02614205,MILLER - MOTTE TECHNICAL COLLEGE - MILLE,NC,27834-5052,Proprietary  ,28,134,162,317,,1186,1503
03009500,WINSTON-SALEM BARBER SCHOOL             ,NC,27107-0000,Proprietary  ,7,29,36,75,,213,288
03064400,REGENCY BEAUTY INSTITUTE                ,NC,27127-0000,Proprietary  ,14,44,58,146,,347,493
03089300,HERITAGE BIBLE COLLEGE                  ,NC,28335-0000,Private      ,5,9,14,32,,72,104
03104200,CAROLINAS COLLEGE OF HEALTH SCIENCE     ,NC,28232-2861,Public       ,45,222,267,546,,1809,2355
03109000,LIVING ARTS COLLEGE                     ,NC,27614-7076,Proprietary  ,59,98,157,643,,816,1459
03361300,MEDICAL ARTS MASSAGE SCHOOL             ,NC,27616-6453,Proprietary  ,17,61,78,97,,440,537
03513400,APEX SCHOOL OF THEOLOGY                 ,NC,27703-8024,Private      ,0,109,109,20,,1146,1166
03555300,SOUTHEASTERN INSTITUTE                  ,NC,28217-0000,Proprietary  ,15,105,120,155,,750,905
03555400,SOUTHEASTERN SCHOOL OF NEUROMUSCULAR  MA,NC,29406-0000,Proprietary  ,9,25,34,68,,208,276
03570300,CAROLINA CHRISTIAN COLLEGE              ,NC,27105-3241,Private      ,4,17,21,33,,179,212
03663300,HOOD THEOLOGICAL SEMINARY               ,NC,28144-5768,Private      ,0,19,19,3,,232,235
03748500,LA SHE'S BEAUTY ACADEMY                 ,NC,27707-3569,Proprietary  ,6,29,35,36,,179,215
03777300,PAUL MITCHELL THE SCHOOL GASTONIA       ,NC,28054-0460,Proprietary  ,33,75,108,213,,485,698
03827300,NEW LIFE THEOLOGICAL SEMINARY           ,NC,28205-1648,Private      ,0,29,29,24,,301,325
04073300,JUNG TAO SCHOOL OF CLASSICAL CHINESE MED,NC,28679-9657,Private      ,0,1,1,2,,63,65
04101300,CAROLINA SCHOOL OF BROADCASTING         ,NC,28214-8085,Proprietary  ,16,63,79,158,,446,604
04115700,REGINA'S COLLEGE OF BEAUTY              ,NC,28110-2831,Proprietary  ,7,48,55,43,,241,284
04120300,HEALTH AND STYLE INSTITUTE              ,NC,27265-3114,Proprietary  ,12,59,71,56,,276,332
04129400,CENTER FOR MASSAGE & NATURAL HEALTH     ,NC,28787-8331,Proprietary  ,2,22,24,29,,133,162
04140700,AVEDA INSTITUTE CHAPEL HILL             ,NC,27516-2559,Proprietary  ,18,43,61,191,,278,469
04143500,CHARLOTTE SCHOOL OF LAW                 ,NC,28208-2816,Proprietary  ,9,104,113,117,,2765,2882
04146400,DAOIST TRADITIONS COLLEGE OF CHINESE MED,NC,28801-1060,Proprietary  ,0,10,10,5,,132,137
04149300,PARK WEST BARBER SCHOOL                 ,NC,27701-4022,Proprietary  ,14,77,91,174,,750,924
04154200,CAROLINA COLLEGE OF BIBLICAL STUDIES    ,NC,29303-5157,Private      ,2,40,42,31,,320,351
04172800,BODY THERAPY INSTITUTE                  ,NC,27344-6728,Proprietary  ,0,19,19,23,,121,144
04173000,SHEPHERDS THEOLOGICAL SEMINARY          ,NC,27518-9316,Private      ,0,4,4,0,,45,45
04173700,GRACE COLLEGE OF DIVINITY               ,NC,28314-2343,Private      ,3,25,28,31,,149,180
04178100,CAROLINA COLLEGE OF HAIR DESIGN         ,NC,28802-1232,Proprietary  ,6,22,28,58,,145,203
04204700,PAUL MITCHELL THE SCHOOL RALEIGH        ,NC,27612-7358,Proprietary  ,15,49,64,146,,279,425
04206500,MYCOMPUTERCAREER.COM                    ,NC,27606-3365,Proprietary  ,17,176,193,77,,870,947
04214600,GRACE COLLEGE OF BARBERING              ,NC,28513-7178,Private      ,1,20,21,10,,71,81
04219100,ALEXANDER PAUL INSTITUTE OF HAIR DESIGN ,NC,27858-3344,Proprietary  ,7,15,22,11,,28,39
00298800,BISMARCK STATE COLLEGE                  ,ND,58501-1299,Public       ,87,190,277,1970,,1580,3550
00298900,DICKINSON STATE UNIVERSITY              ,ND,58601-4896,Public       ,25,51,76,846,,607,1453
00299000,JAMESTOWN COLLEGE                       ,ND,58405-3401,Private      ,23,15,38,1037,,221,1258
00299100,LAKE REGION STATE COLLEGE               ,ND,58301-1598,Public       ,12,50,62,399,,507,906
00299200,UNIVERSITY OF MARY                      ,ND,58504-9652,Private      ,29,149,178,1718,,1647,3365
00299300,MAYVILLE STATE UNIVERSITY               ,ND,58257-1299,Public       ,21,22,43,676,,343,1019
00299400,MINOT STATE UNIVERSITY                  ,ND,58707-0001,Public       ,43,125,168,1585,,1441,3026
00299500,DAKOTA COLLEGE AT BOTTINEAU             ,ND,58318-1159,Public       ,15,28,43,318,,266,584
00299600,NORTH DAKOTA STATE CLG OF SCIENCE       ,ND,58076-0002,Public       ,53,76,129,1680,,805,2485
00299700,NORTH DAKOTA STATE UNIVERSITY           ,ND,58108-6050,Public       ,208,238,446,10601,,3411,14012
00300500,UNIVERSITY OF NORTH DAKOTA              ,ND,58202-8193,Public       ,193,416,609,8845,,5907,14752
00300700,WILLISTON STATE COLLEGE                 ,ND,58802-1326,Public       ,20,49,69,327,,364,691
00300800,VALLEY CITY STATE UNIVERSITY            ,ND,58072-0000,Public       ,16,29,45,762,,377,1139
00775600,JOSEF'S SCHOOL OF HAIR DESIGN INC       ,ND,58102-4977,Proprietary  ,6,16,22,65,,94,159
00869408,RASMUSSEN COLLEGE - FARGO               ,ND,58103-7196,Proprietary  ,23,80,103,187,,778,965
00869415,RASMUSSEN COLLEGE - BISMARCK            ,ND,58503-0000,Proprietary  ,6,47,53,69,,384,453
00935400,MEDCENTER ONE COLLEGE OF NURSING        ,ND,58501-4494,Private      ,9,15,24,115,,121,236
01040600,JOSEF'S SCHOOL OF HAIR DESIGN           ,ND,58201-6394,Proprietary  ,10,17,27,64,,107,171
01205900,TRINITY BIBLE COLLEGE                   ,ND,58436-7150,Private      ,6,7,13,200,,92,292
01229500,JZ TREND ACADEMY PAUL MITCHELL PARTNER S,ND,58501-0000,Proprietary  ,3,12,15,51,,51,102
02188200,SITTING BULL COLLEGE                    ,ND,58538-9701,Public       ,7,56,63,93,,316,409
02236500,LITTLE HOOP COMMUNITY COLLEGE           ,ND,58335-0000,Public       ,3,17,20,47,,210,257
02242900,UNITED TRIBES TECHNICAL COLLEGE         ,ND,58504-0000,Private      ,26,110,136,276,,799,1075
02298200,HEADQUARTERS ACADEMY OF HAIR DESIGN     ,ND,58701-0000,Proprietary  ,7,10,17,44,,74,118
02301100,TURTLE MTN CMNTY COLG-FIN AID OFC       ,ND,58316-0000,Private      ,17,61,78,220,,535,755
02553700,FORT BERTHOLD COMMUNITY COLLEGE         ,ND,58763-0000,Public       ,4,6,10,48,,137,185
03087200,MOLER BARBER CLG OF HAIRSTYLING         ,ND,58103-0000,Proprietary  ,1,4,5,4,,18,22
04031300,SALON PROFESSIONAL ACADEMY (THE)        ,ND,58103-3337,Proprietary  ,8,9,17,96,,69,165
04139400,HAIR ACADEMY (THE)                      ,ND,58501-4929,Proprietary  ,4,8,12,37,,38,75
00301005,ANTIOCH UNIV/SEATTLE                    ,WA,98121-0000,Private      ,9,123,132,158,,1529,1687
00376900,BELLEVUE COLLEGE                        ,WA,98007-6484,Public       ,397,922,1319,6265,,9123,15388
00377000,BIG BEND COMMUNITY COLLEGE              ,WA,98837-3299,Public       ,102,231,333,1298,,1961,3259
00377100,"CENTRAL WASHINGTON UNIV., FIN AID       ",WA,98926-7495,Public       ,558,449,1007,13534,,6777,20311
00377200,CENTRALIA COLLEGE                       ,WA,98531-4099,Public       ,80,256,336,1464,,2541,4005
00377300,CLARK COLLEGE                           ,WA,98663-3598,Public       ,505,1187,1692,6198,,11104,17302
00377400,COLUMBIA BASIN COLLEGE                  ,WA,99301-3379,Public       ,221,600,821,3878,,5231,9109
00377500,EASTERN WASHINGTON UNIVERSITY           ,WA,99004-2447,Public       ,438,416,854,13841,,8402,22243
00377600,EVERETT COMMUNITY COLLEGE               ,WA,98201-1352,Public       ,296,963,1259,4147,,8261,12408
00377700,HERITAGE UNIVERSITY                     ,WA,98948-9562,Private      ,23,109,132,680,,1653,2333
00377800,GONZAGA UNIVERSITY                      ,WA,99258-0083,Private      ,291,307,598,9229,,4231,13460
00377900,GRAYS HARBOR COLLEGE                    ,WA,98520-7599,Public       ,55,233,288,863,,1840,2703
00378000,GREEN RIVER COMMUNITY COLLEGE           ,WA,98092-3622,Public       ,322,861,1183,4005,,6706,10711
00378100,HIGHLINE COMMUNITY COLLEGE              ,WA,98198-9800,Public       ,297,802,1099,4231,,7207,11438
00378200,LOWER COLUMBIA COLLEGE                  ,WA,98632-0310,Public       ,120,447,567,1540,,3780,5320
00378300,NORTHWEST UNIVERSITY                    ,WA,98083-0000,Private      ,76,112,188,1690,,1320,3010
00378400,OLYMPIC COLLEGE                         ,WA,98337-1600,Public       ,218,769,987,2591,,6583,9174
00378500,PACIFIC LUTHERAN UNIVERSITY             ,WA,98447-0003,Private      ,193,206,399,5536,,2803,8339
00378600,PENINSULA COLLEGE                       ,WA,98362-6660,Public       ,67,251,318,724,,2216,2940
00378700,SEATTLE CENTRAL COMMUNITY COLLEGE       ,WA,98122-2413,Public       ,290,970,1260,4303,,9172,13475
00378703,SEATTLE VOCATIONAL INSTITUTE            ,WA,98144-0000,Public       ,25,142,167,254,,982,1236
00378800,SEATTLE PACIFIC UNIVERSITY              ,WA,98119-1997,Private      ,280,226,506,8282,,3537,11819
00379000,SEATTLE UNIVERSITY                      ,WA,98122-1090,Private      ,414,440,854,10711,,7789,18500
00379100,SHORELINE COMMUNITY COLLEGE             ,WA,98133-5696,Public       ,200,592,792,3120,,5988,9108
00379200,SKAGIT VALLEY COLLEGE                   ,WA,98273-5899,Public       ,144,485,629,2018,,3936,5954
00379300,SPOKANE COMMUNITY COLLEGE               ,WA,99207-5399,Public       ,330,1215,1545,5107,,11711,16818
00379400,ST MARTIN'S UNIVERSITY                  ,WA,98503-7500,Private      ,54,107,161,1671,,1524,3195
00379600,TACOMA COMMUNITY COLLEGE                ,WA,98466-6100,Public       ,379,1263,1642,5201,,12506,17707
00379700,UNIVERSITY OF PUGET SOUND               ,WA,98416-1039,Private      ,225,235,460,5794,,2591,8385
00379800,UNIVERSITY OF WASHINGTON                ,WA,98195-5880,Public       ,1549,1706,3255,41007,,32949,73956
00379900,WALLA WALLA UNIVERSITY                  ,WA,99324-1198,Private      ,45,53,98,2031,,917,2948
00380000,WASHINGTON STATE UNIVERSITY             ,WA,99164-1035,Public       ,968,921,1889,29016,,15400,44416
00380100,WENATCHEE VALLEY COLLEGE                ,WA,98801-1799,Public       ,137,368,505,2046,,3021,5067
00380200,WESTERN WASHINGTON UNIVERSITY           ,WA,98225-5946,Public       ,626,349,975,19416,,5811,25227
00380300,WHITMAN COLLEGE                         ,WA,99362-2067,Private      ,82,18,100,2743,,212,2955
00380400,WHITWORTH UNIVERSITY                    ,WA,99251-0001,Private      ,145,144,289,4651,,1710,6361
00380500,YAKIMA VALLEY COMMUNITY COLLEGE         ,WA,98907-2520,Public       ,180,465,645,3514,,5138,8652
00499900,BELLINGHAM TECHNICAL COLLEGE            ,WA,98225-0000,Public       ,87,401,488,1277,,3250,4527
00500000,PIERCE COLLEGE                          ,WA,98498-1919,Public       ,337,1127,1464,4383,,9949,14332
00500100,EDMONDS COMMUNITY COLLEGE               ,WA,98036-5999,Public       ,236,669,905,3217,,6012,9229
00500600,WALLA WALLA COMMUNITY COLLEGE           ,WA,99362-9267,Public       ,107,322,429,2085,,3085,5170
00530600,BATES TECHNICAL COLLEGE                 ,WA,98405-0000,Public       ,143,682,825,1466,,5158,6624
00537200,SOUTH PUGET SOUND COMMUNITY COLLEGE     ,WA,98512-6292,Public       ,239,603,842,2696,,6070,8766
00537300,LAKE WASHINGTON TECHNICAL COLLEGE       ,WA,98034-8505,Public       ,106,361,467,1095,,3252,4347
00575200,CLOVER PARK TECHNICAL COLLEGE           ,WA,98499-0000,Public       ,172,796,968,1856,,7020,8876
00815500,EVERGREEN STATE COLLEGE (THE)           ,WA,98505-0002,Public       ,189,313,502,4138,,4961,9099
00907901,EVEREST COLLEGE                         ,WA,98684-6950,Proprietary  ,26,126,152,279,,886,1165
00938700,PERRY TECHNICAL INSTITUTE               ,WA,98903-1239,Private      ,76,131,207,880,,1316,2196
00954400,SPOKANE FALLS COMMUNITY COLLEGE         ,WA,99224-5204,Public       ,322,838,1160,5369,,8316,13685
00970400,NORTH SEATTLE COMMUNITY COLLEGE         ,WA,98103-3599,Public       ,158,740,898,2456,,6702,9158
00970600,SOUTH SEATTLE COMMUNITY COLLEGE         ,WA,98106-1499,Public       ,178,669,847,2932,,5903,8835
00973900,GLEN DOW ACAD OF HAIR DESIGN            ,WA,99201-0209,Proprietary  ,5,48,53,145,,360,505
01036400,WHATCOM COMMUNITY COLLEGE               ,WA,98226-8003,Public       ,159,422,581,2591,,3865,6456
01043400,RENTON TECHNICAL COLLEGE                ,WA,98056-0000,Public       ,131,501,632,1333,,3882,5215
01148100,DIVERS INSTITUTE OF TECHNOLOGY          ,WA,98107-0000,Proprietary  ,29,132,161,204,,674,878
01231500,CORNISH COLLEGE OF THE ARTS             ,WA,98121-4604,Private      ,62,65,127,1856,,650,2506
01249600,TONI & GUY HAIRDRESSING ACADEMY         ,WA,98133-5615,Proprietary  ,5,18,23,55,,108,163
01302200,CITY UNIVERSITY OF SEATTLE              ,WA,98005-0000,Private      ,20,242,262,319,,2410,2729
01309400,BELLINGHAM BEAUTY SCHOOL                ,WA,98225-0000,Proprietary  ,7,37,44,61,,161,222
02105300,EVERGREEN BEAUTY AND BARBER COLLEGE     ,WA,98007-3722,Proprietary  ,6,42,48,101,,264,365
02106700,TRINITY LUTHERAN COLLEGE                ,WA,98201-3569,Private      ,12,11,23,287,,158,445
02180000,NORTHWEST INDIAN COLLEGE                ,WA,98226-9278,Public       ,20,86,106,220,,932,1152
02184200,PAROBA COLLEGE OF COSMETOLOGY           ,WA,98208-0000,Proprietary  ,6,46,52,52,,252,304
02202200,STYLEMASTERS COLLEGE OF HAIR DESIGN     ,WA,98632-0000,Proprietary  ,5,30,35,52,,192,244
02203300,GENE JUAREZ BEAUTY SCHOOLS              ,WA,98043-5427,Proprietary  ,29,91,120,455,,732,1187
02222900,INTERNATIONAL AIR & HOSPITALITY ACADEMY ,WA,98661-4835,Proprietary  ,65,168,233,423,,803,1226
02236800,PROFESSIONAL BEAUTY SCHOOL              ,WA,98902-0000,Proprietary  ,1,23,24,65,,135,200
02242500,BASTYR UNIVERSITY                       ,WA,98028-0000,Private      ,16,97,113,259,,1821,2080
02291300,ART INSTITUTE OF SEATTLE                ,WA,98121-1622,Proprietary  ,258,316,574,2697,,2661,5358
02300100,EVEREST COLLEGE                         ,WA,98367-1835,Proprietary  ,16,115,131,153,,664,817
02300103,EVEREST COLLEGE - EVERETT               ,WA,98208-2610,Proprietary  ,48,172,220,333,,1074,1407
02300104,EVEREST COLLEGE - TACOMA                ,WA,98402-3004,Proprietary  ,76,395,471,634,,2337,2971
02326500,INTERFACE COLLEGE                       ,WA,99201-4326,Proprietary  ,2,49,51,71,,350,421
02331400,NORTHWEST HAIR ACADEMY                  ,WA,98273-0000,Proprietary  ,4,23,27,59,,126,185
02331402,NORTHWEST HAIR ACADEMY - EVERETT        ,WA,98204-0000,Proprietary  ,7,18,25,57,,153,210
02504900,ACADEMY OF HAIR DESIGN (THE)            ,WA,98801-0000,Proprietary  ,12,26,38,84,,164,248
02541900,BJ'S BEAUTY AND BARBER COLLEGE          ,WA,98409-0000,Proprietary  ,12,65,77,96,,423,519
02602100,NORTHWEST COLLEGE OF ART                ,WA,98370-8625,Proprietary  ,10,12,22,201,,102,303
02606200,EVEREST COLLEGE                         ,WA,98055-2990,Proprietary  ,26,161,187,312,,945,1257
02617500,EVEREST COLLEGE                         ,WA,98133-9018,Proprietary  ,77,300,377,691,,1902,2593
03031406,INTERNATIONAL ACADEMY OF DESIGN & TECH  ,WA,98188-3319,Proprietary  ,29,80,109,318,,679,997
03065000,CLARE'S BEAUTY COLLEGE                  ,WA,99301-0000,Proprietary  ,9,28,37,86,,168,254
03071800,ITT TECHNICAL INSTITUTE                 ,WA,99216-1589,Proprietary  ,52,269,321,510,,2055,2565
03071805,ITT TECHNICAL INSTITUTE - SEATTLE       ,WA,98168-3346,Proprietary  ,65,348,413,663,,2447,3110
03099000,CORTIVA INSTITUTE - SEATTLE             ,WA,98109-5474,Proprietary  ,26,95,121,174,,519,693
03110800,BAKKE GRADUATE UNIVERSITY               ,WA,98104-1222,Private      ,2,16,18,14,,94,108
03139500,MONTESSORI SCHOOLS OF WASHINGTON        ,WA,98203-6600,Private      ,0,2,2,2,,36,38
03280300,SEATTLE INST OF ORIENTAL MEDICINE       ,WA,98115-0000,Proprietary  ,2,18,20,55,,217,272
03283300,NORTHWEST HVAC/R ASSOCIATION & TRAINING ,WA,99202-0000,Private      ,4,23,27,50,,152,202
03466400,SEATTLE SCHOOL OF THEOLOGY AND PSYCHOLOG,WA,98121-1177,Private      ,11,51,62,112,,569,681
03483500,CASCADIA COMMUNITY COLLEGE              ,WA,98011-9510,Public       ,121,230,351,1646,,1886,3532
03490400,EMIL FRIES PIANO HOSPITAL & TRAININ     ,WA,98661-4323,Private      ,2,3,5,9,,35,44
03670301,TONI&GUY HAIRDRESSING ACADEMY -         ,WA,98225-4526,Proprietary  ,0,3,3,0,,3,3
03689400,FAITH EVANGELICAL COLLEGE & SEMINARY    ,WA,98407-2607,Private      ,2,33,35,39,,402,441
03724300,DIGIPEN INSTITUTE OF TECHNOLOGY         ,WA,98052-5170,Proprietary  ,53,36,89,1197,,578,1775
03917300,EVERGREEN BEAUTY AND BARBER COLLEGE     ,WA,98208-3759,Proprietary  ,18,83,101,144,,440,584
03932500,TOTAL COSMETOLOGY TRAINING CENTER       ,WA,99217-6231,Proprietary  ,9,50,59,86,,347,433
03953300,YAKIMA BEAUTY SCHOOL                    ,WA,98901-2202,Proprietary  ,2,12,14,58,,122,180
04120000,SUNNYSIDE BEAUTY ACADEMY                ,WA,98944-8711,Proprietary  ,1,5,6,21,,41,62
04127200,VICTORIA'S ACADEMY OF COSMETOLOGY       ,WA,99336-3826,Proprietary  ,7,34,41,87,,230,317
04130500,PACIFIC NORTHWEST UNIV OF HEALTH SCIENCE,WA,98901-1471,Private      ,8,20,28,78,,611,689
04130800,CASCADE BEAUTY COLLEGE                  ,WA,98002-5504,Proprietary  ,7,19,26,43,,139,182
04132800,INLAND MASSAGE INSTITUTE                ,WA,99218-5016,Proprietary  ,3,23,26,51,,220,271
04149400,GARY MANUEL AVEDA INSTITUTE             ,WA,98122-3807,Proprietary  ,25,61,86,222,,482,704
04149600,GP INSTITUTE OF COSMETOLOGY             ,WA,98118-2353,Proprietary  ,0,0,0,35,,91,126
04155000,NORTHWEST SCHOOL OF WOODEN BOAT BUILDING,WA,98339-8706,Private      ,2,5,7,11,,91,102
04161200,BAINBRIDGE GRADUATE INSTITUTE           ,WA,98110-2870,Private      ,1,13,14,5,,174,179
04170100,SALON PROFESSIONAL ACADEMY (THE)        ,WA,98409-7360,Proprietary  ,21,73,94,160,,419,579
04172900,ACADEMY OF COSMETOLOGY                  ,WA,99354-2651,Proprietary  ,3,16,19,66,,158,224
04188900,NORTHWEST INSTITUTE OF LITERARY ARTS    ,WA,98249-0000,Private      ,0,5,5,9,,47,56
04191900,PAUL MITCHELL THE SCHOOL SPOKANE        ,WA,99037-5041,Proprietary  ,27,48,75,246,,396,642
04223600,ACADEMY OF INTERACTIVE ENTERTAINMENT    ,WA,98109-4623,Private      ,10,38,48,26,,70,96
00340100,BROWN UNIVERSITY                        ,RI,02912-9127,Private      ,516,71,587,18677,,1008,19685
00340101,BROWN UNIVERSITY - GRADUATE SCHOOL      ,RI,02912-1827,Private      ,3,243,246,51,,1618,1669
00340102,BROWN MEDICAL SCHOOL                    ,RI,02912-0000,Private      ,11,15,26,68,,551,619
00340200,BRYANT UNIVERSITY                       ,RI,02917-1284,Private      ,144,36,180,5496,,588,6084
00340400,JOHNSON & WALES UNIVERSITY              ,RI,02903-3703,Private      ,534,370,904,20793,,5334,26127
00340600,PROVIDENCE COLLEGE                      ,RI,02918-0001,Private      ,201,95,296,8520,,1145,9665
00340700,RHODE ISLAND COLLEGE                    ,RI,02908-1991,Public       ,164,314,478,8658,,5116,13774
00340800,COMMUNITY COLLEGE OF RI - WARWICK       ,RI,02906-0000,Public       ,619,1260,1879,10371,,12954,23325
00340900,RHODE ISLAND SCHOOL OF DESIGN           ,RI,02903-2784,Private      ,115,61,176,3041,,1269,4310
00341000,ROGER WILLIAMS UNIVERSITY               ,RI,02809-2921,Private      ,178,87,265,8730,,1699,10429
00341100,SALVE REGINA UNIVERSITY                 ,RI,02840-4192,Private      ,84,42,126,4759,,594,5353
00341400,UNIVERSITY OF RHODE ISLAND              ,RI,02881-0000,Public       ,530,300,830,24406,,4892,29298
00659100,ST. JOSEPH HOSP SCH OF NURSING          ,RI,02904-5199,Private      ,5,22,27,110,,346,456
00784500,NEW ENGLAND INSTITUTE OF TECHNOLOGY     ,RI,02886-0000,Private      ,132,324,456,2618,,3213,5831
00817811,EMPIRE BEAUTY SCHOOL - PROVIDENCE       ,RI,02903-3042,Proprietary  ,0,0,0,80,,160,240
01164702,SBI CAMPUS - AN AFFILIATE OF SANFORD-BRO,RI,02920-7807,Proprietary  ,1,4,5,27,,133,160
01246116,LINCOLN TECHNICAL INSTITUTE - LINCOLN   ,RI,02865-4211,Proprietary  ,34,152,186,446,,911,1357
01260608,EMPIRE BEAUTY SCHOOL - WARWICK          ,RI,02886-1534,Proprietary  ,0,0,0,77,,97,174
02531802,PAUL MITCHELL THE SCHOOL-CRANSTON       ,RI,02920-0000,Proprietary  ,30,31,61,91,,98,189
02584400,NEW ENGLAND TRACTOR TRAILER TRAINING SCH,RI,02860-1752,Proprietary  ,28,268,296,121,,897,1018
03080000,NEWPORT SCHOOL OF HAIRDRESSING          ,RI,02860-4038,Proprietary  ,0,14,14,14,,77,91
03732300,INTERNATIONAL YACHT RESTORATION SCH     ,RI,02840-6720,Private      ,0,8,8,31,,62,93
04141200,TONI & GUY HAIRDRESSING ACADEMY         ,RI,02920-0000,Proprietary  ,12,18,30,121,,103,224
00341700,ALLEN UNIVERSITY                        ,SC,29204-1085,Private      ,52,59,111,1190,,702,1892
00341800,ANDERSON UNIVERSITY                     ,SC,29621-4035,Private      ,86,119,205,3302,,1544,4846
00341900,CHARLESTON SOUTHERN UNIVERSITY          ,SC,29406-2160,Private      ,185,258,443,5034,,2959,7993
00342000,BENEDICT COLLEGE                        ,SC,29204-1086,Private      ,121,131,252,3919,,1853,5772
00342100,BOB JONES UNIVERSITY                    ,SC,29614-1000,Proprietary  ,63,53,116,2797,,516,3313
00342200,SOUTHERN WESLEYAN UNIVERSITY            ,SC,29630-1020,Private      ,19,138,157,929,,1779,2708
00342300,THE CITADEL                             ,SC,29409-0002,Public       ,146,123,269,3559,,1529,5088
00342400,CLAFLIN UNIVERSITY                      ,SC,29115-4498,Private      ,65,67,132,2940,,1218,4158
00342500,CLEMSON UNIVERSITY                      ,SC,29634-0001,Public       ,622,327,949,21656,,4607,26263
00342600,UNIV OF SC AT SUMTER                    ,SC,29150-2498,Public       ,38,72,110,1014,,908,1922
00342700,COKER COLLEGE                           ,SC,29550-3797,Private      ,24,79,103,1271,,1046,2317
00342800,COLLEGE OF CHARLESTON                   ,SC,29424-0100,Public       ,426,290,716,13133,,3824,16957
00342900,COLUMBIA INTERNATIONAL UNIVERSITY       ,SC,29203-1599,Private      ,22,72,94,745,,906,1651
00343000,COLUMBIA COLLEGE                        ,SC,29203-5998,Private      ,54,144,198,1351,,1902,3253
00343100,CONVERSE COLLEGE                        ,SC,29302-1931,Private      ,47,56,103,1244,,831,2075
00343200,ERSKINE COLLEGE                         ,SC,29639-0000,Private      ,20,6,26,754,,69,823
00343201,ERSKINE THEOLOGICAL SEMINARY            ,SC,29639-0000,Private      ,0,5,5,6,,108,114
00343400,FURMAN UNIVERSITY                       ,SC,29613-5253,Private      ,159,69,228,4514,,662,5176
00343500,LANDER UNIVERSITY                       ,SC,29649-2099,Public       ,112,80,192,4347,,1068,5415
00343600,LIMESTONE COLLEGE                       ,SC,29340-3799,Private      ,84,264,348,2050,,3392,5442
00343700,LUTHERAN THEOLOGICAL SOUTHERN SEM       ,SC,29203-5898,Private      ,1,10,11,9,,149,158
00343800,MEDICAL UNIV OF SOUTH CAROLINA - FA     ,SC,29425-1760,Public       ,31,132,163,527,,3710,4237
00343900,MORRIS COLLEGE                          ,SC,29150-3599,Private      ,45,60,105,1456,,701,2157
00344000,NEWBERRY COLLEGE                        ,SC,29108-2197,Private      ,56,30,86,1776,,428,2204
00344100,NORTH GREENVILLE COLLEGE                ,SC,29688-1892,Private      ,46,34,80,2787,,537,3324
00344500,PRESBYTERIAN COLLEGE                    ,SC,29325-2503,Private      ,45,5,50,1835,,465,2300
00344600,SOUTH CAROLINA STATE UNIVERSITY         ,SC,29117-4427,Public       ,186,199,385,5265,,2858,8123
00344700,SPARTANBURG METHODIST COLLEGE           ,SC,29301-5899,Private      ,40,30,70,1630,,365,1995
00344800,UNIVERSITY OF SOUTH CAROLINA            ,SC,29208-3999,Public       ,870,764,1634,30892,,13250,44142
00344900,UNIVERSITY OF SOUTH CAROLINA AIKEN      ,SC,29801-6399,Public       ,118,145,263,3690,,1899,5589
00345000,UNIV OF SC AT BEAUFORT                  ,SC,29902-0000,Public       ,86,155,241,2263,,1397,3660
00345100,COASTAL CAROLINA UNIVERSITY             ,SC,29528-0000,Public       ,443,289,732,14671,,3621,18292
00345300,UNIV OF SC AT LANCASTER                 ,SC,29721-0889,Public       ,49,88,137,1264,,923,2187
00345400,UNIV OF SC SYSTEM SALKEHATCHIE          ,SC,29810-0617,Public       ,26,82,108,747,,828,1575
00345500,VOORHEES COLLEGE                        ,SC,29042-0000,Private      ,23,26,49,846,,404,1250
00345600,WINTHROP UNIVERSITY                     ,SC,29733-0001,Public       ,155,184,339,7006,,2607,9613
00345700,WOFFORD COLLEGE                         ,SC,29303-3663,Private      ,79,41,120,2833,,299,3132
00399000,FLORENCE-DARLINGTON TECH COLLEGE        ,SC,29501-0548,Public       ,243,791,1034,3559,,6970,10529
00399100,GREENVILLE TECHNICAL COLLEGE            ,SC,29607-2439,Public       ,560,1348,1908,8833,,13218,22051
00399200,PIEDMONT TECHNICAL COLLEGE              ,SC,29648-1467,Public       ,185,503,688,2904,,6085,8989
00399300,MIDLANDS TECHNICAL COLLEGE              ,SC,29202-0000,Public       ,522,1275,1797,8094,,12699,20793
00399400,SPARTANBURG COMMUNITY COLLEGE           ,SC,29305-4386,Public       ,237,648,885,3757,,5900,9657
00399500,CENTRAL CAROLINA TECHNICAL COLLEGE      ,SC,29150-2499,Public       ,109,499,608,1991,,4904,6895
00399600,YORK TECHNICAL COLLEGE                  ,SC,29730-3395,Public       ,289,710,999,3424,,5823,9247
00492000,TRIDENT TECHNICAL COLLEGE               ,SC,29423-8067,Public       ,631,1741,2372,7967,,17107,25074
00492300,CLINTON JR COLLEGE                      ,SC,29730-5152,Private      ,14,25,39,222,,233,455
00492400,FORREST JUNIOR COLLEGE                  ,SC,29624-2405,Proprietary  ,3,45,48,55,,374,429
00492500,HORRY-GEORGETOWN TECH COLLEGE           ,SC,29526-9521,Public       ,362,866,1228,4450,,8042,12492
00492600,TRI-COUNTY TECHNICAL COLLEGE            ,SC,29670-9133,Public       ,235,498,733,4621,,4579,9200
00492700,UNIV OF SC AT UNION                     ,SC,29379-0729,Public       ,12,29,41,309,,394,703
00499204,MILLER-MOTTE TECHNICAL COLLEGE - CONWAY ,SC,29526-9508,Proprietary  ,43,224,267,483,,1609,2092
00536300,DENMARK TECHNICAL COLLEGE               ,SC,29042-0000,Public       ,39,105,144,860,,2296,3156
00681500,ORANGEBURG-CALHOUN TECHNICAL COLG       ,SC,29118-8299,Public       ,116,317,433,1972,,3059,5031
00695100,UNIVERSITY OF SOUTH CAROLINA UPSTATE    ,SC,29303-9972,Public       ,195,292,487,6876,,3903,10779
00760200,NORTHEASTERN TECHNICAL COLLEGE          ,SC,29520-7015,Public       ,34,135,169,725,,1257,1982
00922600,FRANCIS MARION UNIVERSITY               ,SC,29501-0000,Public       ,145,203,348,5126,,2354,7480
00932200,WILLIAMSBURG TECHNICAL COLLEGE          ,SC,29556-4197,Public       ,19,77,96,326,,795,1121
00991000,TECHNICAL COLLEGE OF THE LOWCOUNTRY     ,SC,29902-5441,Public       ,135,417,552,1281,,3392,4673
00991100,UNIV OF SC-REGIONAL CAMPUSES ADMIN      ,SC,29208-0001,Public       ,13,40,53,264,,361,625
01005600,AIKEN TECHNICAL COLLEGE                 ,SC,29802-0696,Public       ,153,439,592,2001,,3793,5794
01019806,ECPI UNIVERSITY - GREENVILLE            ,SC,29615-4232,Proprietary  ,11,108,119,11,,109,120
01019809,ECPI UNIVERSITY - CHARLESTON            ,SC,29420-4264,Proprietary  ,11,97,108,11,,97,108
01019811,ECPI UNIVERSITY - COLUMBIA              ,SC,29210-6467,Proprietary  ,5,74,79,5,,74,79
01179901,PAUL MITCHELL THE SCHOOL COLUMBIA       ,SC,29201-3126,Proprietary  ,15,44,59,86,,204,290
01179902,PAUL MITCHELL THE SCHOOL CHARLESTON     ,SC,29418-6993,Proprietary  ,12,33,45,90,,212,302
01209200,KENNETH SHULER SCHOOL OF COSMETOLOGY    ,SC,29732-2169,Proprietary  ,27,56,83,198,,465,663
01303907,SOUTH UNIVERSITY                        ,SC,29203-6400,Proprietary  ,67,410,477,580,,3128,3708
02063700,SHERMAN CLG STRAIGHT CHIROPRACTIC       ,SC,29316-0000,Private      ,2,12,14,18,,385,403
02338600,CHARZANNE BEAUTY COLLEGE                ,SC,29649-0000,Proprietary  ,3,12,15,29,,100,129
02341100,KENNETH SHULER SCHOOL OF COSMETOLOGY & N,SC,29210-0000,Proprietary  ,21,91,112,258,,730,988
02356600,CHARLESTON COSMETOLOGY INSTITUTE        ,SC,29420-0000,Proprietary  ,7,31,38,66,,205,271
02359802,ITT TECHNICAL INSTITUTE -               ,SC,29615-4506,Proprietary  ,0,0,0,0,,1,1
02552400,ACADEMY OF HAIR TECHNOLOGY              ,SC,29615-2363,Proprietary  ,9,36,45,63,,234,297
02567600,SUMTER BEAUTY COLLEGE                   ,SC,29150-0000,Proprietary  ,0,6,6,36,,122,158
02614202,MILLER - MOTTE TECHNICAL COLLEGE - NORTH,SC,29406-9239,Proprietary  ,39,199,238,411,,1518,1929
03010614,VIRGINIA COLLEGE - GOLF ACADEMY OF AMERI,SC,29579-0000,Proprietary  ,7,21,28,124,,222,346
03010617,VIRGINIA COLLEGE - GREENVILLE           ,SC,29607-7200,Proprietary  ,26,116,142,205,,956,1161
03010620,VIRGINIA COLLEGE - CHARLESTON           ,SC,29406-4999,Proprietary  ,13,89,102,198,,845,1043
03010621,VIRGINIA COLLEGE - COLUMBIA             ,SC,29223-7527,Proprietary  ,17,123,140,210,,990,1200
03052300,KENNETH SHULER SCH COSM & HAIR DESG     ,SC,29841-2013,Proprietary  ,20,52,72,144,,374,518
03088300,ACADEMY OF COSMETOLOGY                  ,SC,29418-5667,Proprietary  ,0,0,0,8,,15,23
03293300,STRAND COLLEGE OF HAIR DESIGN           ,SC,29572-4310,Proprietary  ,6,23,29,47,,138,185
03304300,CENTURA COLLEGE                         ,SC,29406-9235,Proprietary  ,20,78,98,127,,743,870
03513300,LACY COSMETOLOGY SCHOOL                 ,SC,29803-9084,Proprietary  ,5,14,19,31,,80,111
03513301,LACY COSMETOLOGY SCHOOL -               ,SC,29072-0000,Proprietary  ,2,4,6,22,,56,78
03513302,LACY COSMETOLOGY SCHOOL -               ,SC,29445-0000,Proprietary  ,7,14,21,18,,58,76
03513303,LACY COSMETOLOGY SCHOOL - WEST ASHLEY   ,SC,29407-4605,Proprietary  ,1,6,7,6,,32,38
03709301,EDWARD VIA VIRGINIA COLLEGE OF OSTEOPATH,SC,29303-3639,Private      ,1,13,14,21,,603,624
03746300,LEGRAND INSTITUTE OF COSMETOLOGY        ,SC,29020-0000,Proprietary  ,3,7,10,21,,67,88
03746400,SOUTHEASTERN INSTITUTE                  ,SC,29210-0000,Proprietary  ,10,99,109,83,,482,565
03768400,STYLETRENDS BARBER AND HAIRSTYLING ACADE,SC,29730-4511,Proprietary  ,6,17,23,25,,110,135
03856400,W. L. BONNER COLLEGE                    ,SC,29203-0000,Private      ,0,0,0,11,,94,105
04083300,MARION COUNTY TECHNICAL EDUCATION CENTER,SC,29571-0000,Public       ,3,17,20,32,,176,208
04096300,CHARLESTON SCHOOL OF LAW                ,SC,29402-0535,Proprietary  ,2,23,25,56,,1086,1142
04158100,AIKEN SCHOOL OF COSMETOLOGY             ,SC,29801-4026,Proprietary  ,6,25,31,44,,115,159
04166900,COSMETIC ARTS INSTITUTE                 ,SC,29488-2753,Proprietary  ,1,17,18,22,,62,84
04172600,SALON 496 BARBER ACADEMY                ,SC,29607-2548,Proprietary  ,1,25,26,19,,160,179
04192600,PALMETTO BEAUTY SCHOOL                  ,SC,29307-1424,Proprietary  ,9,26,35,49,,172,221
04202900,JOLEI'S HAIR INSTITUTE                  ,SC,29114-9337,Proprietary  ,0,9,9,9,,83,92
00345800,AUGUSTANA COLLEGE                       ,SD,57197-0001,Private      ,32,20,52,1729,,270,1999
00345900,BLACK HILLS STATE UNIVERSITY            ,SD,57799-9670,Public       ,80,129,209,2473,,1841,4314
00346100,DAKOTA WESLEYAN UNIVERSITY              ,SD,57301-4398,Private      ,19,23,42,824,,292,1116
00346300,DAKOTA STATE UNIVERSITY                 ,SD,57042-1799,Public       ,42,70,112,1388,,990,2378
00346500,MOUNT MARTY COLLEGE                     ,SD,57078-3724,Private      ,10,31,41,537,,469,1006
00346600,NORTHERN STATE UNIVERSITY               ,SD,57401-7198,Public       ,36,54,90,1688,,836,2524
00346700,PRESENTATION COLLEGE                    ,SD,57401-1299,Private      ,13,53,66,641,,548,1189
00346900,UNIVERSITY OF SIOUX FALLS               ,SD,57105-1699,Private      ,49,52,101,1429,,720,2149
00347000,SOUTH DAKOTA SCH OF MINES & TECH        ,SD,57701-3995,Public       ,63,45,108,2111,,739,2850
00347100,SOUTH DAKOTA STATE UNIVERSITY           ,SD,57007-2298,Public       ,157,238,395,8714,,3378,12092
00347400,UNIVERSITY OF SOUTH DAKOTA              ,SD,57069-2390,Public       ,131,328,459,5668,,4681,10349
00405600,SIOUX FALLS SEMINARY                    ,SD,57105-2729,Private      ,0,4,4,4,,96,100
00405700,NATIONAL AMERICAN UNIVERSITY            ,SD,57701-3692,Proprietary  ,145,2125,2270,954,,14843,15797
00405707,NATIONAL AMERICAN UNIVERSITY            ,SD,57105-0000,Proprietary  ,8,48,56,84,,858,942
00492900,MCKENNAN HOSP-RADOLOGICAL TECH          ,SD,57101-0000,Private      ,1,2,3,24,,39,63
00530900,LAKE AREA TECHNICAL INSTITUTE           ,SD,57201-0730,Public       ,42,59,101,1182,,635,1817
00598700,AVERA SACRED HEART HOSPITAL SCHOOL OF RA,SD,57078-3899,Private      ,0,4,4,8,,14,22
00776400,SOUTHEAST TECHNICAL INST                ,SD,57107-0000,Public       ,74,156,230,1478,,1833,3311
00828400,MITCHELL TECHNICAL INSTITUTE            ,SD,57301-9931,Public       ,12,30,42,801,,471,1272
01013800,STEWART SCHOOL                          ,SD,57104-0000,Proprietary  ,13,11,24,123,,108,231
01014804,COLORADO TECHNICAL UNIVERSITY           ,SD,57108-2272,Proprietary  ,6,35,41,84,,473,557
01017000,WESTERN DAKOTA TECHNICAL INSTITUTE      ,SD,57701-4018,Public       ,37,138,175,527,,1147,1674
01147701,SIOUX VALLEY HOSP-MEDICAL TECH          ,SD,57117-5039,Private      ,2,3,5,22,,33,55
01465900,OGLALA LAKOTA COLLEGE                   ,SD,57752-0490,Public       ,34,160,194,366,,1415,1781
02137100,BLACK HILLS BEAUTY COLLEGE              ,SD,57701-0000,Proprietary  ,10,23,33,109,,152,261
02143700,SINTE GLESKA UNIVERSITY                 ,SD,57570-0000,Public       ,8,36,44,125,,532,657
02144600,KILIAN COMMUNITY COLLEGE                ,SD,57103-7020,Private      ,13,49,62,110,,399,509
02277300,SISSETON WAHPETON COLLEGE               ,SD,57262-0000,Public       ,2,10,12,55,,179,234
02297800,HEADLINES ACADEMY                       ,SD,57701-0000,Proprietary  ,6,31,37,51,,153,204
00347700,AQUINAS COLLEGE                         ,TN,37205-2086,Private      ,14,51,65,371,,888,1259
00347800,AUSTIN PEAY STATE UNIVERSITY            ,TN,37044-0002,Public       ,317,764,1081,8975,,8836,17811
00347900,BELMONT UNIVERSITY                      ,TN,37212-3757,Private      ,295,242,537,8457,,4098,12555
00348000,BETHEL UNIVERSITY                       ,TN,38201-1705,Private      ,74,638,712,2427,,7654,10081
00348100,CARSON-NEWMAN COLLEGE                   ,TN,37760-2204,Private      ,121,87,208,3810,,893,4703
00348200,CHRISTIAN BROTHERS UNIVERSITY           ,TN,38104-5581,Private      ,97,200,297,2523,,2322,4845
00348300,COLUMBIA STATE COMMUNITY COLLEGE        ,TN,38401-5653,Public       ,157,377,534,3461,,3732,7193
00348500,CUMBERLAND UNIVERSITY                   ,TN,37087-3554,Private      ,65,115,180,1708,,1198,2906
00348600,LIPSCOMB UNIVERSITY                     ,TN,37204-3951,Private      ,133,217,350,4303,,2891,7194
00348700,EAST TENNESSEE STATE UNIV - MAIN CAMPUS ,TN,37614-2857,Public       ,373,610,983,12838,,9269,22107
00348701,EAST TENNESSEE STATE UNIV - MEDICINE    ,TN,37614-1708,Public       ,26,29,55,421,,689,1110
00348709,EAST TENNESSEE STATE UNIV - PHARMACY    ,TN,37614-1704,Public       ,9,20,29,165,,536,701
00349000,FISK UNIVERSITY                         ,TN,37208-3045,Private      ,68,78,146,1786,,856,2642
00349200,FREED-HARDEMAN UNIVERSITY               ,TN,38340-2399,Private      ,46,63,109,1867,,859,2726
00349400,HIWASSEE COLLEGE                        ,TN,37354-4001,Private      ,10,34,44,384,,201,585
00349500,JOHNSON UNIVERSITY                      ,TN,37998-9775,Private      ,24,74,98,1058,,656,1714
00349600,KING COLLEGE                            ,TN,37620-2699,Private      ,53,220,273,1586,,2700,4286
00349900,LANE COLLEGE                            ,TN,38301-4598,Private      ,56,70,126,2193,,1102,3295
00350000,LEE UNIVERSITY                          ,TN,37320-0000,Private      ,113,128,241,4458,,2034,6492
00350100,LEMOYNE-OWEN COLLEGE                    ,TN,38126-6510,Private      ,82,201,283,1937,,2844,4781
00350200,LINCOLN MEMORIAL UNIVERSITY             ,TN,37752-7920,Private      ,65,144,209,1993,,3867,5860
00350400,MARTIN METHODIST COLLEGE                ,TN,38478-2799,Private      ,26,28,54,1160,,482,1642
00350500,MARYVILLE COLLEGE                       ,TN,37804-5907,Private      ,66,40,106,2305,,405,2710
00350600,MEHARRY MEDICAL COLLEGE                 ,TN,37208-0000,Private      ,10,33,43,124,,1411,1535
00350700,MEMPHIS COLLEGE OF ART                  ,TN,38104-2764,Private      ,39,49,88,879,,524,1403
00350900,UNIVERSITY OF MEMPHIS (THE)             ,TN,38152-4611,Public       ,553,1199,1752,19155,,19365,38520
00351000,MIDDLE TENNESSEE STATE UNIV             ,TN,37130-0000,Public       ,800,1048,1848,25044,,14808,39852
00351100,MILLIGAN COLLEGE                        ,TN,37682-4001,Private      ,31,39,70,1332,,769,2101
00351700,SOUTHERN COLLEGE OF OPTOMETRY           ,TN,38104-2222,Private      ,2,19,21,80,,720,800
00351800,SOUTHERN ADVENTIST UNIVERSITY           ,TN,37315-0370,Private      ,77,81,158,2964,,1106,4070
00351900,RHODES COLLEGE                          ,TN,38112-1690,Private      ,142,83,225,3546,,819,4365
00352200,TENNESSEE STATE UNIVERSITY              ,TN,37209-1561,Public       ,400,838,1238,11770,,10690,22460
00352300,TENNESSEE TECHNOLOGICAL UNIV            ,TN,38505-0001,Public       ,332,273,605,11770,,4150,15920
00352400,TENNESSEE TEMPLE UNIVERSITY             ,TN,37404-3587,Private      ,23,122,145,577,,937,1514
00352500,TENNESSEE WESLEYAN COLLEGE              ,TN,37371-0040,Private      ,33,49,82,1224,,720,1944
00352600,TREVECCA NAZARENE UNIVERSITY            ,TN,37210-2877,Private      ,44,191,235,1729,,2140,3869
00352700,TUSCULUM COLLEGE                        ,TN,37743-0001,Private      ,92,135,227,2509,,2021,4530
00352800,UNION UNIVERSITY                        ,TN,38305-3697,Private      ,95,256,351,3101,,3421,6522
00352900,UNIVERSITY OF TENNESSEE-CHATTANOOGA     ,TN,37403-2598,Public       ,558,431,989,16588,,6159,22747
00353000,UNIVERSITY OF TENNESSEE-KNOXVILLE       ,TN,37996-0150,Public       ,815,664,1479,29659,,11394,41053
00353006,UNIVERSITY OF TENNESSEE-HEALTH SCI CTR  ,TN,38103-0000,Public       ,39,174,213,721,,4118,4839
00353100,UNIVERSITY OF TENNESSEE-MARTIN          ,TN,38238-0002,Public       ,236,265,501,8414,,3997,12411
00353400,UNIVERSITY OF THE SOUTH                 ,TN,37383-1000,Private      ,67,13,80,2566,,153,2719
00353500,VANDERBILT UNIVERSITY                   ,TN,37240-0001,Private      ,658,296,954,20642,,7603,28245
00353501,VANDERBILT UNIV MED CTR ALLIEDHEAL      ,TN,37232-5510,Private      ,25,43,68,250,,776,1026
00353502,VANDERBILT UNIVERSITY - SCHOOL OF MEDICI,TN,37232-0000,Private      ,0,0,0,47,,27,74
00353600,BRYAN COLLEGE                           ,TN,37321-7000,Private      ,44,86,130,1330,,965,2295
00399800,CHATTANOOGA STATE COMMUNITY COLLEGE     ,TN,37406-1097,Public       ,417,1124,1541,6530,,10701,17231
00399900,CLEVELAND STATE COMMUNITY COLLEGE       ,TN,37312-2858,Public       ,93,312,405,2318,,2951,5269
00402500,TN TECHNOLOGY CTR AT KNOXVILLE          ,TN,37919-2327,Public       ,59,236,295,805,,2084,2889
00402600,TENNESSEE TECH. CNTR AT CROSSVILLE      ,TN,38555-4142,Public       ,53,64,117,630,,711,1341
00461700,NATIONAL COLLEGE OF BUSINESS & TECH     ,TN,37211-6605,Proprietary  ,23,207,230,311,,2135,2446
00493400,DAYMAR INSTITUTE                        ,TN,37217-1056,Proprietary  ,14,82,96,155,,705,860
00493401,DAYMAR INSTITUTE - CLARKSVILLE          ,TN,37040-6718,Proprietary  ,27,141,168,224,,1052,1276
00493404,DAYMAR INSTITUTE - MURFREESBORO         ,TN,37128-5508,Proprietary  ,13,66,79,153,,607,760
00493700,JACKSON STATE COMMUNITY COLLEGE         ,TN,38301-3797,Public       ,140,411,551,3349,,4474,7823
00493800,SOUTH COLLEGE                           ,TN,37909-3323,Proprietary  ,36,227,263,577,,2410,2987
00494700,WEST TENNESSEE BUSINESS COLLEGE         ,TN,38301-3256,Proprietary  ,9,91,100,154,,689,843
00528000,TN TECHNOLOGY CTR AT COVINGTON          ,TN,38019-0249,Public       ,18,44,62,185,,421,606
00528100,TN TECHNOLOGY CTR AT ELIZABETHTON       ,TN,37643-0789,Public       ,23,116,139,387,,1045,1432
00528200,TN TECHNOLOGY CTR AT HARTSVILLE         ,TN,37074-0000,Public       ,16,30,46,255,,386,641
00528300,TN TECHNOLOGY CTR AT NEWBERN            ,TN,38059-1198,Public       ,7,46,53,150,,521,671
00530700,TN TECHNOLOGY CTR AT MCMINNVILLE        ,TN,37110-1322,Public       ,15,42,57,226,,448,674
00535100,TENNESSEE TECHNOLOGY CENTER AT MORRISTOW,TN,37813-2094,Public       ,34,131,165,557,,1173,1730
00535200,TN TECHNOLOGY CENTER AT MCKENZIE        ,TN,38201-1620,Public       ,10,34,44,145,,360,505
00535300,TN TECHNOLOGY CENTER AT LIVINGSTON      ,TN,38570-1291,Public       ,23,46,69,289,,459,748
00535400,TN TECHNOLOGY CTR AT JACKSON            ,TN,38301-0000,Public       ,24,139,163,526,,1335,1861
00535600,TENNESSEE TECHNOLOGY CENTER AT HOHENWALD,TN,38462-0000,Public       ,10,42,52,255,,462,717
00535700,TENNESSEE TECHNOLOGY CENTER AT CRUMP    ,TN,38327-3402,Public       ,10,50,60,195,,444,639
00535800,TN TECHNOLOGY CENTER AT ATHENS          ,TN,37371-0848,Public       ,18,34,52,280,,460,740
00535900,TENNESSEE TECHNOLOGY CENTER AT NASHVILLE,TN,37209-0000,Public       ,55,300,355,845,,2356,3201
00536000,TENNESSEE TECHNOLOGY CENTER AT MEMPHIS  ,TN,38105-3604,Public       ,82,328,410,1361,,3225,4586
00537800,NORTHEAST STATE COMMUNITY COLLEGE       ,TN,37617-0246,Public       ,168,458,626,3706,,5170,8876
00537900,TN TECHNOLOGY CTR AT SHELBYVILLE        ,TN,37160-3697,Public       ,29,93,122,382,,769,1151
00683500,DYERSBURG STATE COMMUNITY COLLEGE       ,TN,38024-0000,Public       ,82,264,346,1892,,3083,4975
00683600,MOTLOW STATE COMMUNITY COLLEGE          ,TN,37388-7972,Public       ,192,427,619,3611,,3735,7346
00732941,ITT TECHNICAL INSTITUTE                 ,TN,37932-3343,Proprietary  ,129,576,705,1111,,4004,5115
00732958,ITT TECHNICAL INSTITUTE                 ,TN,37214-3717,Proprietary  ,84,462,546,762,,2944,3706
00743900,FOUNTAINHEAD COLLEGE OF TECHNOLOGY      ,TN,37918-0000,Proprietary  ,16,88,104,223,,671,894
00778200,TENNESSEE TECHNOLOGY CENTER AT DICKSON  ,TN,37055-0000,Public       ,25,96,121,402,,974,1376
00778300,MIDDLE TENNESSEE SCH OF ANESTHESIA      ,TN,37116-0000,Private      ,0,7,7,17,,183,200
00793803,NASHVILLE AUTO DIESEL COLLEGE - NASHVILL,TN,37206-3210,Proprietary  ,372,138,510,2673,,1020,3693
00814500,NASHVILLE STATE TECH CMNTY COLLEGE      ,TN,37209-0000,Public       ,361,1208,1569,5503,,11427,16930
00865500,GENESIS CAREER COLLEGE OF COOKEVILLE    ,TN,38501-1959,Proprietary  ,27,88,115,202,,574,776
00885900,JOHN A GUPTON COLLEGE                   ,TN,37203-2934,Private      ,3,19,22,91,,233,324
00886300,WALTERS STATE COMMUNITY COLLEGE         ,TN,37813-6899,Public       ,190,456,646,4840,,4868,9708
00946400,TN TECHNOLOGY CTR AT PULASKI            ,TN,38478-4541,Public       ,14,41,55,177,,366,543
00956700,TENNESSEE SCHOOL OF BEAUTY              ,TN,37921-3303,Proprietary  ,26,68,94,236,,515,751
00971000,TENNESSEE TECHNOLOGY CENTER AT ONEIDA/HU,TN,37756-4149,Public       ,11,48,59,109,,241,350
00991200,VOLUNTEER STATE COMMUNITY COLLEGE       ,TN,37066-3188,Public       ,256,599,855,4750,,5715,10465
00991400,ROANE STATE COMMUNITY COLLEGE           ,TN,37748-8664,Public       ,182,511,693,4345,,5340,9685
00998200,VICTORY UNIVERSITY                      ,TN,38111-4745,Proprietary  ,65,316,381,914,,3426,4340
01032600,TN TECHNOLOGY CTR AT HARRIMAN           ,TN,37748-1109,Public       ,20,52,72,210,,384,594
01043900,SOUTHWEST TENNESSEE COMMUNITY COLLG     ,TN,38104-3322,Public       ,445,1570,2015,9651,,16553,26204
01044700,"PLAZA BEAUTY SCHOOL, INC.               ",TN,38117-4822,Proprietary  ,10,38,48,174,,385,559
01046000,AMERICAN BAPTIST THEOLOGICAL SEMINA     ,TN,37207-4994,Private      ,2,26,28,53,,275,328
01052900,MEMPHIS THEOLOGICAL SEMINARY            ,TN,38104-0000,Private      ,1,44,45,23,,408,431
01070000,TN TECHNOLOGY CENTER AT JACKSBORO       ,TN,37757-2461,Public       ,12,26,38,164,,306,470
01155300,WM R MOORE COLLEGE OF TECHNOLOGY        ,TN,38104-0000,Private      ,14,56,70,165,,493,658
01216400,TENNESSEE TECHNICAL CNTR AT RIPLEY      ,TN,38063-7359,Public       ,9,33,42,82,,331,413
01254700,EMMANUEL SCHOOL OF RELIGION             ,TN,37601-0000,Private      ,0,4,4,6,,68,74
01269300,PELLISSIPPI STATE COMMUNITY COLLEGE     ,TN,37933-0990,Public       ,339,832,1171,7401,,7753,15154
02069303,VATTEROTT COLLEGE -                     ,TN,38016-5877,Proprietary  ,14,85,99,190,,619,809
02092800,TENNESSEE TECHNOLOGY CENTER AT WHITEVILL,TN,38075-0000,Public       ,8,41,49,124,,361,485
02103500,TENNESSEE COLLEGE OF APPLIED TECHNOLOGY ,TN,37129-3311,Public       ,51,135,186,451,,1022,1473
02106400,O'MORE COLLEGE OF DESIGN                ,TN,37064-0000,Private      ,4,11,15,199,,117,316
02125300,NASHVILLE CLG OF MEDICAL CAREERS        ,TN,37115-0000,Proprietary  ,4,36,40,59,,240,299
02153100,JON NAVE UNIVERSITY OF COSMETOLOGY      ,TN,37013-3347,Proprietary  ,18,34,52,248,,311,559
02157100,CONCORDE CAREER COLLEGE                 ,TN,38137-0000,Proprietary  ,84,415,499,926,,3303,4229
02160307,INTERNATIONAL ACADEMY OF DESIGN & TECH  ,TN,37212-0000,Proprietary  ,6,39,45,175,,349,524
02188300,PENTECOSTAL THEOLOGICAL SEMINARY        ,TN,37320-0000,Private      ,1,26,27,6,,273,279
02204200,"CHATTANOOGA COLLEGE - MEDICAL, DENTAL AN",TN,37411-0000,Proprietary  ,25,113,138,292,,1006,1298
02237900,TN TECHNOLOGY CENTER AT PARIS           ,TN,38242-0000,Public       ,9,85,94,168,,594,762
02255000,KNOXVILLE INSTITUTE OF HAIR DESIGN      ,TN,37917-0000,Proprietary  ,6,33,39,94,,292,386
02257400,ARNOLD'S BEAUTY SCHOOL                  ,TN,38358-0000,Proprietary  ,0,12,12,48,,91,139
02263104,ANTHEM COLLEGE - ANTHEM CAREER COLLEGE -,TN,37214-2531,Proprietary  ,27,97,124,227,,717,944
02275500,REUBEN-ALLEN COLLEGE                    ,TN,37922-0000,Proprietary  ,10,39,49,147,,320,467
02278700,MR WAYNES SCH OF UNISEX HAIR DESIGN     ,TN,38501-0000,Proprietary  ,4,11,15,37,,76,113
02293900,VOLUNTEER BEAUTY ACADEMY-NASHVILLE      ,TN,37115-2112,Proprietary  ,0,12,12,24,,74,98
02294000,VOLUNTEER BEAUTY ACADEMY-DYERSBURG      ,TN,38024-1622,Proprietary  ,4,18,22,33,,123,156
02326200,KAPLAN CAREER INSTITUTE                 ,TN,37212-5318,Proprietary  ,25,184,209,234,,1180,1414
02326300,MEDVANCE INSTITUTE                      ,TN,38501-4305,Proprietary  ,18,55,73,160,,387,547
02335900,VOLUNTEER BEAUTY ACADEMY-NASHVILLE      ,TN,37209-3033,Proprietary  ,3,25,28,71,,155,226
02539800,QUEEN CITY COLLEGE                      ,TN,37042-0000,Proprietary  ,9,59,68,80,,382,462
02540000,TENNESSEE ACADEMY OF COSMETOLOGY        ,TN,38133-0000,Proprietary  ,20,55,75,220,,447,667
02578200,NOSSI COLLEGE OF ART                    ,TN,37115-5138,Proprietary  ,22,37,59,398,,359,757
02595000,FAYETTEVILLE BEAUTY SCHOOL              ,TN,37334-2909,Proprietary  ,6,14,20,28,,74,102
02599710,VATTEROTT COLLEGE - MEMPHIS             ,TN,38132-1714,Proprietary  ,28,199,227,529,,1958,2487
02609204,VATTEROTT COLLEGE - VATTEROTT CAREER COL,TN,38133-4727,Proprietary  ,16,153,169,365,,1161,1526
02614200,MILLER MOTTE BUSINESS COLLEGE           ,TN,37040-6023,Proprietary  ,22,142,164,266,,1099,1365
02614203,MILLER - MOTTE TECHNICAL COLLEGE - CHATT,TN,37421-7220,Proprietary  ,25,109,134,308,,1056,1364
02614204,MILLER - MOTTE TECHNICAL COLLEGE - MADIS,TN,37072-1870,Proprietary  ,16,109,125,188,,704,892
03001800,FREE WILL BAPTIST BIBLE COLLEGE         ,TN,37205-2498,Private      ,12,22,34,263,,183,446
03008800,FRANKLIN ACADEMY                        ,TN,37312-3939,Private      ,5,20,25,36,,136,172
03010606,VIRGINIA COLLEGE - SCH OF BUSNSS & HLTH ,TN,37411-5600,Proprietary  ,28,123,151,238,,1041,1279
03024900,TENNESSEE ACADEMY OF COSMETOLOGY        ,TN,38125-3442,Proprietary  ,10,60,70,202,,433,635
03026517,REMINGTON COLLEGE - MEMPHIS             ,TN,38132-2107,Private      ,30,151,181,657,,1874,2531
03061100,GENESIS CAREER COLLEGE OF LEBANON       ,TN,37087-2718,Proprietary  ,17,26,43,96,,291,387
03076405,BRYMAN SCHOOL OF ARIZONA (THE) - ANTHEM ,TN,38134-7345,Proprietary  ,38,201,239,219,,936,1155
03079100,NORTH CENTRAL INSTITUTE                 ,TN,37042-3116,Proprietary  ,7,37,44,51,,251,302
03088800,"WATKINS COLLEGE OF ART, DESIGN & FILM   ",TN,37228-1306,Private      ,17,40,57,612,,371,983
03126900,STYLES & PROFILES BEAUTY COLLEGE        ,TN,38375-2109,Proprietary  ,2,9,11,24,,47,71
03253300,PAUL MITCHELL THE SCHOOL MEMPHIS        ,TN,38133-4067,Proprietary  ,10,27,37,74,,137,211
03355400,RICHMONT GRADUATE UNIVERSITY            ,TN,37404-0000,Private      ,1,15,16,10,,287,297
03440300,BAPTIST MEMORIAL COLLEGE OF HEALTH      ,TN,38104-3104,Private      ,48,202,250,1330,,2874,4204
03480303,MEDVANCE INSTITUTE - NASHVILLE          ,TN,37203-1536,Proprietary  ,16,83,99,111,,637,748
03513500,WILLIAMSON CHRISTIAN COLLEGE            ,TN,37067-8237,Private      ,3,8,11,25,,79,104
03647300,NEW CONCEPTS SCHOOL OF COSMETOLOGY      ,TN,37311-7373,Proprietary  ,1,12,13,24,,96,120
03683300,INTERNATIONAL BARBER & STYLE COLLEGE    ,TN,37209-2205,Proprietary  ,6,40,46,52,,220,272
03701300,MEMPHIS INSTITUTE OF BARBERING          ,TN,38107-4334,Proprietary  ,25,114,139,231,,567,798
03774400,SHEAR ACADEMY                           ,TN,38555-4177,Proprietary  ,3,13,16,20,,92,112
03830300,SAE INSTITUTE OF TECHNOLOGY             ,TN,37203-4310,Proprietary  ,15,38,53,140,,232,372
03840300,OXFORD GRADUATE SCHOOL                  ,TN,37321-6736,Private      ,0,5,5,4,,38,42
03841300,CAREER BEAUTY COLLEGE                   ,TN,38464-3634,Proprietary  ,2,7,9,18,,56,74
03920300,INSTITUTE OF HAIR DESIGN                ,TN,38310-1801,Proprietary  ,1,14,15,22,,70,92
03930300,BUCHANAN BEAUTY COLLEGE                 ,TN,37160-2741,Proprietary  ,6,14,20,43,,98,141
03982300,VISIBLE SCHOOL - MUSIC AND WORSHIPS ARTS,TN,38104-5814,Private      ,6,13,19,162,,130,292
04035300,TENNESSEE CAREER INSTITUTE              ,TN,38401-6335,Proprietary  ,10,35,45,94,,260,354
04124100,ELITE COLLEGE OF COSMETOLOGY            ,TN,38351-1431,Proprietary  ,3,10,13,30,,67,97
04157200,LOVE BEAUTY SCHOOL                      ,TN,37355-2950,Proprietary  ,5,10,15,28,,79,107
04165000,MERIDIAN INSTITUTE OF SURGICAL ASSISTING,TN,37080-0758,Proprietary  ,1,65,66,9,,387,396
04174600,NASHVILLE BARBER AND STYLE ACADEMY      ,TN,37208-2826,Proprietary  ,6,34,40,71,,196,267
04210200,MID-SOUTH CHRISTIAN COLLEGE             ,TN,38118-3151,Private      ,2,26,28,39,,156,195
04213800,SALON PROFESSIONAL ACADEMY (THE)        ,TN,37214-2163,Proprietary  ,3,21,24,94,,132,226
00353700,ABILENE CHRISTIAN UNIVERSITY            ,TX,79699-3701,Private      ,248,112,360,6432,,1718,8150
00353900,ALVIN COMMUNITY COLLEGE                 ,TX,77511-4807,Public       ,119,332,451,1777,,3201,4978
00354000,AMARILLO COLLEGE                        ,TX,79109-2446,Public       ,311,873,1184,3857,,6926,10783
00354100,ANGELO STATE UNIVERSITY                 ,TX,76909-5069,Public       ,269,228,497,6700,,3317,10017
00354300,AUSTIN COLLEGE                          ,TX,75090-4440,Private      ,69,38,107,2317,,317,2634
00354400,AUSTIN PRESBYTERIAN THEOLOGICAL SEM     ,TX,78705-5797,Private      ,0,9,9,5,,166,171
00354500,BAYLOR UNIVERSITY                       ,TX,76798-7048,Private      ,1324,354,1678,26221,,5475,31696
00354600,COASTAL BEND COLLEGE                    ,TX,78102-2197,Public       ,103,219,322,1618,,2010,3628
00354900,BLINN COLLEGE                           ,TX,77833-4098,Public       ,825,676,1501,15140,,6451,21591
00355300,CISCO JUNIOR COLLEGE                    ,TX,76437-9803,Public       ,125,314,439,2135,,2753,4888
00355400,CLARENDON COLLEGE                       ,TX,79226-0000,Public       ,39,81,120,617,,589,1206
00355600,COMMONWEALTH INST OF FUNERAL SVC        ,TX,77090-5918,Private      ,13,64,77,106,,539,645
00355700,CONCORDIA UNIVERSITY TEXAS              ,TX,78726-4141,Private      ,70,328,398,1854,,2888,4742
00355800,NORTH CENTRAL TEXAS COLLEGE             ,TX,76240-4699,Public       ,318,638,956,4204,,5941,10145
00356000,DALLAS BAPTIST UNIVERSITY               ,TX,75211-9299,Private      ,200,446,646,3866,,4787,8653
00356100,CEDAR VALLEY COLLEGE                    ,TX,75134-0000,Public       ,140,589,729,2481,,5522,8003
00356200,DALLAS THEOLOGICAL SEM                  ,TX,75204-0000,Private      ,4,107,111,51,,951,1002
00356300,DEL MAR COLLEGE                         ,TX,78404-3897,Public       ,398,980,1378,5562,,8453,14015
00356400,EAST TEXAS BAPTIST UNIVERSITY           ,TX,75670-1423,Private      ,63,42,105,1754,,508,2262
00356500,TEXAS A&M UNIVERSITY - COMMERCE         ,TX,75429-3011,Public       ,255,640,895,6660,,8596,15256
00356800,FRANK PHILLIPS COLLEGE                  ,TX,79008-0000,Public       ,29,69,98,410,,559,969
00357000,GRAYSON COUNTY COLLEGE                  ,TX,75020-8299,Public       ,125,419,544,1924,,4088,6012
00357100,HARDIN-SIMMONS UNIVERSITY               ,TX,79698-6050,Private      ,75,73,148,2371,,1089,3460
00357200,TRINITY VALLEY COMMUNITY COLLEGE        ,TX,75751-2734,Public       ,192,561,753,2759,,4947,7706
00357300,HILL COLLEGE                            ,TX,76645-2711,Public       ,72,209,281,1097,,1743,2840
00357301,HILL COLLEGE                            ,TX,76031-0000,Public       ,94,274,368,1128,,2238,3366
00357400,HOWARD COLLEGE                          ,TX,79720-0213,Public       ,84,255,339,1526,,2307,3833
00357500,HOWARD PAYNE UNIVERSITY                 ,TX,76801-2715,Private      ,57,50,107,1600,,432,2032
00357600,HOUSTON BAPTIST UNIVERSITY              ,TX,77074-3298,Private      ,273,338,611,5986,,3954,9940
00357700,HUSTON - TILLOTSON UNIVERSITY           ,TX,78702-2795,Private      ,54,105,159,1452,,1142,2594
00357800,UNIVERSITY OF THE INCARNATE WORD        ,TX,78209-6398,Private      ,285,570,855,7712,,7634,15346
00357900,JACKSONVILLE COLLEGE                    ,TX,75766-4759,Private      ,16,29,45,322,,278,600
00358000,KILGORE COLLEGE                         ,TX,75662-3299,Public       ,198,584,782,3406,,5020,8426
00358100,LAMAR UNIVERSITY-BEAUMONT               ,TX,77710-0042,Public       ,396,1270,1666,8968,,11853,20821
00358200,LAREDO COMMUNITY COLLEGE                ,TX,78040-4395,Public       ,448,446,894,6482,,4057,10539
00358300,LEE COLLEGE                             ,TX,77520-4796,Public       ,181,535,716,2034,,4271,6305
00358400,LETOURNEAU UNIVERSITY                   ,TX,75607-0000,Private      ,55,199,254,1741,,2577,4318
00358600,LUBBOCK CHRISTIAN UNIVERSITY            ,TX,79407-2099,Private      ,77,135,212,1703,,1610,3313
00358800,UNIVERSITY OF MARY HARDIN-BAYLOR        ,TX,76513-2599,Private      ,252,138,390,5164,,1944,7108
00359000,MCLENNAN COMMUNITY COLLEGE              ,TX,76708-1498,Public       ,274,823,1097,4828,,7964,12792
00359100,MCMURRY UNIVERSITY                      ,TX,79697-0001,Private      ,59,69,128,1745,,804,2549
00359200,MIDWESTERN STATE UNIVERSITY             ,TX,76308-2099,Public       ,208,298,506,5191,,3369,8560
00359300,NAVARRO COLLEGE                         ,TX,75110-4818,Public       ,321,726,1047,5160,,6980,12140
00359400,UNIVERSITY OF NORTH TEXAS               ,TX,76203-5017,Public       ,1468,1621,3089,35233,,22604,57837
00359500,OBLATE SCHOOL OF THEOLOGY               ,TX,78216-0000,Private      ,3,10,13,10,,82,92
00359600,ODESSA COLLEGE                          ,TX,79764-7127,Public       ,104,355,459,1672,,2833,4505
00359800,OUR LADY OF THE LAKE UNIVERSITY         ,TX,78207-4689,Private      ,106,305,411,3305,,4104,7409
00359900,UNIVERSITY OF TEXAS - PAN AMERICAN      ,TX,78541-2999,Public       ,1525,831,2356,21090,,11397,32487
00360000,PANOLA COLLEGE                          ,TX,75633-2397,Public       ,64,269,333,1167,,2216,3383
00360100,PARIS JR COLLEGE                        ,TX,75460-6298,Public       ,120,305,425,2197,,3403,5600
00360200,PAUL QUINN COLLEGE                      ,TX,75241-4398,Private      ,13,79,92,454,,787,1241
00360300,RANGER COLLEGE                          ,TX,76470-3298,Public       ,40,111,151,785,,888,1673
00360305,RANGER COLLEGE-STEPHENVILE BEAUTY COLLEG,TX,76401-5136,Public       ,4,17,21,79,,106,185
00360400,RICE UNIVERSITY                         ,TX,77251-1892,Private      ,564,291,855,11461,,3465,14926
00360600,SAM HOUSTON STATE UNIVERSITY            ,TX,77340-0000,Public       ,1050,814,1864,22576,,10889,33465
00360700,ALAMO CMTY CLG DISTRICT PROGRAM         ,TX,78207-0000,Public       ,140,452,592,2489,,4218,6707
00360800,ST PHILLIPS COLLEGE                     ,TX,78203-2098,Public       ,386,1378,1764,6001,,11770,17771
00360900,SAN JACINTO CLG-CENTRAL-NORTH-SOUTH     ,TX,77501-0000,Public       ,871,2125,2996,11688,,17707,29395
00361000,SCHREINER UNIVERSITY                    ,TX,78028-5697,Private      ,53,45,98,1617,,517,2134
00361100,SOUTH PLAINS COLLEGE                    ,TX,79336-6504,Public       ,349,693,1042,5164,,5679,10843
00361200,UNIV OF HOUSTON-DOWNTOWN                ,TX,77002-1001,Public       ,681,1614,2295,13740,,19961,33701
00361300,SOUTHERN METHODIST UNIVERSITY           ,TX,75275-0181,Private      ,416,382,798,9448,,5821,15269
00361400,SOUTHWEST TEXAS JR COLLEGE              ,TX,78801-6221,Public       ,175,325,500,2853,,2651,5504
00361500,TEXAS STATE UNIVERSITY--SAN MARCOS      ,TX,78666-4602,Public       ,1689,994,2683,39354,,16341,55695
00361600,SOUTHWESTERN ASSEMBLIES OF GOD UNIV     ,TX,75165-2397,Private      ,69,95,164,1734,,1280,3014
00361800,SOUTHWESTERN CHRISTIAN COLLEGE          ,TX,75160-3400,Private      ,7,21,28,234,,178,412
00361900,SOUTHWESTERN ADVENTIST UNIVERSITY       ,TX,76059-1922,Private      ,27,34,61,798,,471,1269
00362000,SOUTHWESTERN UNIVERSITY                 ,TX,78626-6111,Private      ,103,32,135,2854,,372,3226
00362100,ST EDWARDS UNIVERSITY                   ,TX,78704-0000,Private      ,233,213,446,6076,,3044,9120
00362300,ST MARY'S UNIV OF SAN ANTONIO           ,TX,78228-8500,Private      ,187,213,400,5515,,3672,9187
00362400,STEPHEN F AUSTIN STATE UNIVERSITY       ,TX,75962-0001,Public       ,643,422,1065,16711,,5820,22531
00362500,SUL ROSS STATE UNIVERSITY               ,TX,79832-0113,Public       ,64,145,209,1799,,1938,3737
00362600,TARRANT COUNTY COLLEGE                  ,TX,76102-6599,Public       ,1426,4096,5522,21289,,36360,57649
00362700,TEMPLE COLLEGE                          ,TX,76504-7435,Public       ,205,706,911,2544,,6375,8919
00362800,TEXARKANA COLLEGE                       ,TX,75599-0001,Public       ,117,481,598,1618,,3777,5395
00363000,PRAIRIE VIEW A&M UNIVERSITY             ,TX,77446-2967,Public       ,399,479,878,11890,,6642,18532
00363100,TARLETON STATE UNIVERSITY               ,TX,76402-0000,Public       ,480,607,1087,10145,,8420,18565
00363200,TEXAS A&M UNIVERSITY                    ,TX,77843-1246,Public       ,2306,839,3145,49840,,12453,62293
00363208,TEXAS A&M UNIVERSITY - HEALTH SCIENCE CE,TX,77807-3260,Public       ,64,77,141,1794,,2667,4461
00363400,TEXAS STATE TECHNICAL CLG AT WACO       ,TX,76705-1695,Public       ,246,502,748,3215,,4227,7442
00363500,TEXAS CHIROPRACTIC COLLEGE              ,TX,77505-1699,Private      ,2,22,24,20,,334,354
00363600,TEXAS CHRISTIAN UNIVERSITY              ,TX,76129-0001,Private      ,671,446,1117,14704,,4919,19623
00363700,JARVIS CHRISTIAN COLLEGE                ,TX,75765-1470,Private      ,34,20,54,674,,269,943
00363800,TEXAS COLLEGE                           ,TX,75702-4500,Private      ,46,121,167,1192,,1244,2436
00363900,TEXAS A&M UNIVERSITY-KINGSVILLE         ,TX,78363-8203,Public       ,403,433,836,10898,,7966,18864
00364100,TEXAS LUTHERAN UNIVERSITY               ,TX,78155-5999,Private      ,48,26,74,2165,,349,2514
00364200,TEXAS SOUTHERN UNIVERSITY               ,TX,77004-4598,Public       ,494,1049,1543,11599,,14596,26195
00364400,TEXAS TECH UNIVERSITY                   ,TX,79409-2011,Public       ,1501,857,2358,30214,,12788,43002
00364500,TEXAS WESLEYAN UNIVERSITY               ,TX,76105-1536,Private      ,98,280,378,2042,,4516,6558
00364600,TEXAS WOMAN'S UNIVERSITY                ,TX,76204-5587,Public       ,365,993,1358,10242,,14593,24835
00364700,TRINITY UNIVERSITY                      ,TX,78212-7200,Private      ,168,102,270,3938,,1123,5061
00364800,TYLER JUNIOR COLLEGE                    ,TX,75701-3436,Public       ,431,899,1330,8721,,8148,16869
00365100,UNIVERSITY OF DALLAS                    ,TX,75062-4799,Private      ,114,193,307,2578,,1981,4559
00365200,UNIVERSITY OF HOUSTON                   ,TX,77204-2010,Public       ,1679,2214,3893,37311,,31182,68493
00365400,UNIVERSITY OF ST THOMAS                 ,TX,77006-4626,Private      ,77,318,395,1932,,3175,5107
00365600,UNIVERSITY OF TEXAS-ARLINGTON           ,TX,76019-0000,Public       ,1067,2731,3798,26269,,32225,58494
00365800,UNIVERSITY OF TEXAS-AUSTIN              ,TX,78713-7758,Public       ,2235,1310,3545,51478,,22588,74066
00365900,UT HEALTH CENTER-SAN ANTONIO            ,TX,78229-3900,Public       ,105,257,362,1668,,4664,6332
00366100,UNIVERSITY OF TEXAS-EL PASO             ,TX,79968-0629,Public       ,670,1089,1759,18597,,15269,33866
00366200,VICTORIA COLLEGE                        ,TX,77901-4494,Public       ,173,393,566,1938,,3179,5117
00366300,WAYLAND BAPTIST UNIVERSITY              ,TX,79072-6998,Private      ,65,459,524,1570,,4610,6180
00366400,WEATHERFORD COLLEGE                     ,TX,76086-5699,Public       ,195,454,649,2790,,4079,6869
00366500,WEST TEXAS A&M UNIVERSITY               ,TX,79016-0000,Public       ,309,367,676,6682,,4413,11095
00366800,WHARTON COUNTY JR COLLEGE               ,TX,77488-3298,Public       ,212,424,636,3658,,3833,7491
00366900,WILEY COLLEGE                           ,TX,75670-5199,Private      ,46,54,100,1348,,894,2242
00400300,CENTRAL TEXAS COLLEGE                   ,TX,76540-4199,Public       ,286,2876,3162,3497,,21342,24839
00407221,NORTHWOOD UNIVERSITY                    ,TX,75104-0000,Private      ,22,84,106,756,,864,1620
00445300,EL CENTRO COLLEGE                       ,TX,75202-3604,Public       ,344,1626,1970,5755,,14130,19885
00450303,EVEREST COLLEGE - FORT WORTH SOUTH      ,TX,76115-1407,Proprietary  ,39,227,266,291,,1272,1563
00481102,EVEREST INSTITUTE - EVEREST COLLEGE     ,TX,76011-6630,Proprietary  ,40,184,224,303,,1148,1451
00494900,BAYLOR COLLEGE OF MEDICINE              ,TX,77030-0000,Private      ,133,149,282,1097,,2345,3442
00495100,UNIV OF TEXAS HEALTH SCIENCE CENTER     ,TX,77225-0000,Public       ,75,270,345,1293,,5025,6318
00495200,UNIV OF TEXAS MEDICAL BRANCH            ,TX,77550-0000,Public       ,50,165,215,846,,3181,4027
00497200,GALVESTON COLLEGE                       ,TX,77550-7447,Public       ,96,261,357,1324,,2197,3521
00497700,SOUTH TEXAS COLLEGE OF LAW              ,TX,77002-0000,Private      ,7,107,114,112,,1973,2085
00520307,REMINGTON COLLEGE - DALLAS CAMPUS       ,TX,75041-9935,Proprietary  ,0,0,0,86,,266,352
00660600,BAPTIST HS SCHOOL OF HEALTH PROFESSIONS ,TX,78229-3234,Proprietary  ,28,146,174,278,,1487,1765
00661200,COVENANT SCH OF NSG & ALLIED HEALTH     ,TX,79410-0000,Private      ,13,64,77,238,,577,815
00666100,ANGELINA COLLEGE                        ,TX,75902-0000,Public       ,176,506,682,2652,,4277,6929
00694100,DALLAS CHRISTIAN COLLEGE                ,TX,75234-7229,Private      ,31,89,120,440,,717,1157
00709600,COLLEGE OF THE MAINLAND                 ,TX,77591-2499,Public       ,131,479,610,1490,,3630,5120
00728700,BRAZOSPORT COLLEGE                      ,TX,77566-3199,Public       ,167,356,523,1526,,2298,3824
00732907,ITT TECHNICAL INSTITUTE                 ,TX,77063-3751,Proprietary  ,50,265,315,600,,1892,2492
00732913,ITT TECHNICAL INSTITUTE                 ,TX,76011-3919,Proprietary  ,77,290,367,485,,1761,2246
00732975,ITT TECHNICAL INSTITUTE                 ,TX,78249-3303,Proprietary  ,46,193,239,424,,1388,1812
00754805,WESTWOOD COLLEGE OF TECHNOLOGY          ,TX,77074-0000,Proprietary  ,0,0,0,66,,287,353
00793804,LINCOLN COLLEGE OF TECHNOLOGY - GRAND PR,TX,75052-7605,Proprietary  ,203,130,333,1077,,762,1839
00849800,MIMS CLASSIC BEAUTY COLLEGE             ,TX,78216-0000,Proprietary  ,6,21,27,48,,130,178
00850300,MOUNTAIN VIEW COLLEGE                   ,TX,75211-6599,Public       ,240,820,1060,4586,,7660,12246
00850400,RICHLAND COLLEGE                        ,TX,75243-2199,Public       ,398,1206,1604,6570,,10954,17524
00851000,EASTFIELD COLLEGE                       ,TX,75150-2099,Public       ,294,1016,1310,5367,,9938,15305
00907905,EVEREST COLLEGE                         ,TX,75206-5209,Proprietary  ,69,357,426,682,,2433,3115
00908200,INTERNATIONAL BUSINESS COLLEGE          ,TX,79903-0000,Proprietary  ,26,92,118,154,,513,667
00916300,SAN ANTONIO COLLEGE                     ,TX,78212-4299,Public       ,887,2291,3178,14087,,21162,35249
00922500,TEXAS STATE TECHNICAL COLLEGE  HARLINGEN,TX,78550-3697,Public       ,274,477,751,4414,,4327,8741
00946600,KAPLAN COLLEGE                          ,TX,78216-1899,Proprietary  ,42,201,243,361,,1442,1803
00946607,KAPLAN COLLEGE - MCALLEN                ,TX,78503-1622,Proprietary  ,42,90,132,442,,627,1069
00946609,KAPLAN COLLEGE - CAREER CENTERS OF TEXAS,TX,78416-9900,Proprietary  ,33,150,183,243,,859,1102
00946610,KAPLAN COLLEGE - CAREER CENTERS OF TEXAS,TX,76103-2310,Proprietary  ,22,164,186,223,,1011,1234
00954900,WESTERN TEXAS COLLEGE                   ,TX,79549-9501,Public       ,31,50,81,681,,541,1222
00965100,TEXAS A&M INTERNATIONAL UNIVERSITY      ,TX,78041-1900,Public       ,259,245,504,6539,,3545,10084
00974100,UNIVERSITY OF TEXAS AT DALLAS           ,TX,75083-0000,Public       ,595,875,1470,13073,,11625,24698
00976800,UNIVERSITY OF NORTH TEXAS HEALTH SCIENCE,TX,76107-2699,Public       ,55,162,217,782,,3329,4111
00979700,MIDLAND COLLEGE                         ,TX,79705-6397,Public       ,137,350,487,1770,,2707,4477
00982802,EVEREST INSTITUTE- AUSTIN               ,TX,78754-0000,Proprietary  ,57,205,262,410,,1258,1668
00993000,UNIVERSITY OF TEXAS-PERMIAN BASIN       ,TX,79762-0001,Public       ,98,349,447,2338,,3442,5780
00993200,TEXAS STATE TECH CLG-WEST TEXAS         ,TX,79556-4108,Public       ,35,106,141,471,,758,1229
00993201,TEXAS STATE TECH COLLEGE-ABILENE        ,TX,79601-0000,Public       ,37,106,143,370,,863,1233
00993204,TEXAS STATE TECH CLG-BRECKENRIDGE       ,TX,76424-0000,Public       ,2,22,24,70,,141,211
00993205,TEXAS STATE TECH COLLEGE-BROWNWOOD      ,TX,76801-0000,Public       ,10,47,57,115,,356,471
01001900,UNIV OF TEXAS SOUTHWESTERN MED CTR      ,TX,75390-9096,Public       ,29,148,177,452,,2640,3092
01005700,AMERICAN COMMERCIAL COLLEGE             ,TX,79602-1399,Proprietary  ,0,0,0,15,,60,75
01005900,AMERICAN COMMERCIAL COLLEGE             ,TX,79761-0000,Proprietary  ,5,21,26,39,,155,194
01005901,AMERICAN COMMERCIAL COLLEGE - AMERICAN C,TX,76310-2303,Proprietary  ,13,57,70,85,,365,450
01006000,VERNON COLLEGE                          ,TX,76384-4092,Public       ,115,307,422,1383,,2768,4151
01011500,UNIVERSITY OF TEXAS-SAN ANTONIO         ,TX,78249-0600,Public       ,1558,1421,2979,36328,,19930,56258
01013000,WADE COLLEGE                            ,TX,75207-3199,Proprietary  ,20,36,56,239,,429,668
01038700,EL PASO COMMUNITY COLLEGE               ,TX,79998-0000,Public       ,956,1905,2861,16868,,17239,34107
01050900,HALLMARK COLLEGE OF AERONAUTICS         ,TX,78214-0000,Proprietary  ,59,207,266,303,,1262,1565
01062400,LIGHTHOUSE CAREER INSTITUTE             ,TX,75231-5033,Private      ,3,24,27,11,,66,77
01063300,HOUSTON COMMUNITY COLLEGE               ,TX,77002-0000,Public       ,1714,6506,8220,27259,,58579,85838
01067400,TEXAS TECH U HEALTH SCIENCES CENTER     ,TX,79430-0000,Public       ,112,430,542,1671,,5806,7477
01076100,DALLAS INSTITUTE OF FUNERAL SERVICE     ,TX,75227-4314,Private      ,9,63,72,115,,498,613
01114500,LONE STAR COLLEGE SYSTEM                ,TX,77073-3499,Public       ,1872,5064,6936,25043,,44680,69723
01116100,TEXAS A&M UNIV CORPUS CHRISTI           ,TX,78412-5599,Public       ,580,564,1144,12924,,7036,19960
01116300,UNIVERSITY OF TEXAS AT TYLER            ,TX,75799-6699,Public       ,249,602,851,5804,,6541,12345
01171100,UNIVERSITY OF HOUSTON-CLEAR LAKE        ,TX,77058-1002,Public       ,223,650,873,2865,,8757,11622
01201500,AUSTIN COMMUNITY COLLEGE                ,TX,78752-4390,Public       ,1157,2907,4064,18080,,26018,44098
01202000,VICTORIA BEAUTY COLLEGE                 ,TX,77901-6233,Proprietary  ,5,24,29,50,,167,217
01226800,BALDWIN BEAUTY SCHOOL #5                ,TX,78704-4785,Proprietary  ,13,63,76,176,,444,620
01229700,LAREDO BEAUTY COLLEGE                   ,TX,78040-1051,Proprietary  ,11,23,34,153,,264,417
01248300,COSMETOLOGY CAREER CENTER-A PAUL MITCHEL,TX,75006-2567,Proprietary  ,101,136,237,489,,689,1178
01248800,INTERNATIONAL BEAUTY COLLEGE NO 3       ,TX,75040-0000,Proprietary  ,2,13,15,19,,96,115
01276400,METROPLEX BEAUTY SCHOOL                 ,TX,75149-0000,Proprietary  ,6,26,32,36,,139,175
01293000,CHARLES & SUE'S SCH OF HAIR DESIGN      ,TX,77801-0000,Proprietary  ,4,24,28,94,,133,227
01293200,TINT SCHOOL OF MAKEUP & COSMETOLOGY     ,TX,75061-4235,Proprietary  ,6,17,23,48,,151,199
01300300,NEILSON BEAUTY COLLEGE                  ,TX,75208-4637,Proprietary  ,4,22,26,51,,133,184
01301600,OGLE SCHOOL HAIR SKIN NAILS             ,TX,76013-7400,Proprietary  ,53,121,174,417,,927,1344
01303912,SOUTH UNIVERSITY - THE ART INSTITUTE OF ,TX,75231-5993,Proprietary  ,147,188,335,1771,,1570,3341
01303915,SOUTH UNIVERSITY - AUSTIN               ,TX,78729-8101,Proprietary  ,23,109,132,230,,690,920
01323100,UNIVERSITY OF HOUSTON-VICTORIA          ,TX,77901-5731,Public       ,136,377,513,2689,,4539,7228
02058600,CONLEE'S COLLEGE OF COSMETOLOGY         ,TX,78028-0000,Proprietary  ,3,16,19,23,,62,85
02074100,CAPITOL CITY TRADE & TECHNICAL SCH      ,TX,78704-0000,Proprietary  ,18,82,100,161,,533,694
02077400,NORTH LAKE COLLEGE                      ,TX,75038-0000,Public       ,233,705,938,3371,,6408,9779
02081400,ARLINGTON BAPTIST COLLEGE               ,TX,76012-0000,Private      ,11,40,51,284,,398,682
02093600,SOUTHWEST SCHOOL OF ELECTRONIC          ,TX,78735-0000,Proprietary  ,3,13,16,41,,103,144
02098300,WESTERN TECHNICAL COLLEGE               ,TX,79927-2105,Proprietary  ,82,235,317,833,,1713,2546
02100200,BROOKHAVEN COLLEGE                      ,TX,75244-0000,Public       ,195,762,957,3251,,7247,10498
02113610,AMERICAN INTERCONTINENTAL UNIV - HOUSTON,TX,77042-4516,Proprietary  ,33,201,234,252,,1347,1599
02116008,SANFORD-BROWN COLLEGE - HOUSTON         ,TX,77042-8900,Proprietary  ,55,176,231,441,,1369,1810
02116012,SANFORD-BROWN COLLEGE - HOUSTON NORTH LO,TX,77008-1058,Proprietary  ,8,44,52,108,,439,547
02117100,ART INSTITUTE OF HOUSTON                ,TX,77056-0000,Proprietary  ,573,678,1251,5256,,5657,10913
02119200,COURT REPORTING INSTITUTE OF DALLAS     ,TX,75247-6913,Proprietary  ,7,50,57,54,,510,564
02119202,COURT REPORTING INSTIUTE OF DALLAS - COU,TX,77040-6315,Proprietary  ,0,0,0,10,,73,83
02128302,INSTITUTE FOR BUSINESS & TECHNOLOGY - LA,TX,78230-2520,Proprietary  ,17,84,101,132,,410,542
02136800,AMERICAN COMMERCIAL COLLEGE             ,TX,76904-0000,Proprietary  ,15,34,49,64,,193,257
02144800,VET TECH INSTITUTE OF HOUSTON           ,TX,77027-9881,Proprietary  ,42,56,98,410,,440,850
02176100,PIPO ACADEMY OF HAIR DESIGN             ,TX,79903-0000,Proprietary  ,3,19,22,53,,137,190
02200800,AMERICAN COMMERCIAL COLLEGE             ,TX,79411-0000,Proprietary  ,0,0,0,6,,5,11
02218300,SOUTHWEST SCHOOL OF BUSINESS & TECHNICAL,TX,78221-0000,Proprietary  ,14,59,73,130,,431,561
02218305,SOUTHWEST SCHOOL OF BUSINESS AND TECHNIC,TX,78501-6053,Proprietary  ,6,15,21,53,,153,206
02218306,SOUTHWEST SCHOOL OF BUSINESS AND TECHNIC,TX,78413-2045,Proprietary  ,5,32,37,53,,187,240
02224600,TRI-STATE BEAUTY SCHOOL #1              ,TX,79915-0000,Proprietary  ,13,53,66,111,,353,464
02228400,TEXAS AERO TECHNOLOGY                   ,TX,75209-0000,Proprietary  ,0,0,0,0,,1,1
02230500,OGLE SCHOOL HAIR SKIN NAILS             ,TX,76132-3638,Proprietary  ,40,141,181,380,,1047,1427
02230600,OGLE SCHOOL HAIR SKIN NAILS             ,TX,76053-4650,Proprietary  ,18,72,90,211,,503,714
02239100,CENTRAL TEXAS BEAUTY COLLEGE #2         ,TX,78664-4204,Proprietary  ,18,56,74,101,,375,476
02248200,MILAN INSTITUTE OF COSMETOLOGY          ,TX,79103-0000,Proprietary  ,109,343,452,653,,1754,2407
02254800,TEXAS VOCATIONAL SCHOOLS                ,TX,77901-0000,Proprietary  ,5,34,39,57,,170,227
02259400,AMBERTON UNIVERSITY                     ,TX,75041-0000,Private      ,8,62,70,41,,473,514
02261300,EVEREST INSTITUTE                       ,TX,78213-3841,Proprietary  ,46,200,246,274,,1069,1343
02261302,EVEREST INSTITUTE - HOUSTON GREENSPOINT ,TX,77060-3249,Proprietary  ,42,233,275,356,,1364,1720
02261303,EVEREST INSTITUTE - HOUSTON HOBBY       ,TX,77087-2737,Proprietary  ,47,176,223,302,,1077,1379
02267100,EXPOSITO SCHOOL OF HAIR DESIGN          ,TX,79109-0000,Proprietary  ,4,14,18,44,,83,127
02276000,FRANKLIN BEAUTY SCHOOL #2               ,TX,77021-0000,Proprietary  ,10,64,74,133,,400,533
02285900,UNIVERSITY OF COSMETOLOGY ARTS&SCI      ,TX,78504-0000,Proprietary  ,35,62,97,241,,419,660
02294800,CAPITOL CITY CAREERS                    ,TX,78745-0000,Proprietary  ,5,37,42,45,,245,290
02298501,EVEREST COLLEGE- FORT WORTH             ,TX,76137-2472,Proprietary  ,34,202,236,290,,1263,1553
02305300,PARKER COLLEGE OF CHIROPRACTIC          ,TX,75229-0000,Private      ,11,105,116,116,,1349,1465
02306700,FORT WORTH BEAUTY SCHOOL                ,TX,76116-3299,Proprietary  ,9,66,75,116,,443,559
02312200,TEXAS SCHOOL OF BUSINESS                ,TX,77073-6032,Proprietary  ,36,206,242,357,,1290,1647
02312201,TEXAS SCHOOL OF BUSINESS - SOUTHWEST CAM,TX,77057-5914,Proprietary  ,0,0,0,28,,108,136
02312202,TEXAS SCHOOL OF BUSINESS - FRIENDSWOOD C,TX,77546-8938,Proprietary  ,13,60,73,99,,346,445
02312203,TEXAS SCHOOL OF BUSINESS - EAST CAMPUS  ,TX,77029-1916,Proprietary  ,0,0,0,29,,77,106
02313901,WESTWOOD COLLEGE - DALLAS               ,TX,75243-0000,Proprietary  ,16,85,101,154,,651,805
02315400,NORTHEAST TEXAS COMMUNITY COLLEGE       ,TX,75456-0000,Public       ,90,295,385,1836,,2551,4387
02318200,"KD STUDIO, ACTOR'S CONSERVATORY         ",TX,75207-2111,Proprietary  ,20,47,67,197,,325,522
02320200,HOUSTON GRADUATE SCHOOL OF THEOLOGY     ,TX,77092-0000,Private      ,0,36,36,20,,343,363
02326000,SAN ANTONIO BEAUTY COLLEGE NO 3         ,TX,78217-0000,Proprietary  ,9,25,34,95,,179,274
02331200,BAPTIST MISSIONARY ASSN THEOL SEM       ,TX,75766-0000,Private      ,0,4,4,10,,99,109
02331300,INTERACTIVE LEARNING SYSTEMS            ,TX,77502-1201,Proprietary  ,10,59,69,46,,296,342
02331301,INTERACTIVE LEARNING SYSTEMS            ,TX,77081-0000,Proprietary  ,21,169,190,118,,704,822
02331304,INTERACTIVE LEARNING SYSTEMS            ,TX,77060-0000,Proprietary  ,10,49,59,32,,285,317
02341300,PALO ALTO COLLEGE                       ,TX,78224-0000,Public       ,373,836,1209,5901,,7819,13720
02348500,LAMAR STATE COLLEGE-PORT ARTHUR         ,TX,77640-0000,Public       ,97,305,402,1287,,2443,3730
02357700,PAUL MITCHELL THE SCHOOL                ,TX,77043-3412,Proprietary  ,59,124,183,459,,915,1374
02358200,LAMAR STATE COLLEGE-ORANGE              ,TX,77630-0000,Public       ,79,260,339,1046,,2264,3310
02361400,COLLIN COUNTY COMMUNITY COLLEGE         ,TX,75071-0000,Public       ,660,1582,2242,9159,,14106,23265
02362000,UNIVERSAL TECHNICAL INSTITUTE           ,TX,77073-0000,Proprietary  ,467,599,1066,5279,,4271,9550
02362800,AUSTIN GRADUATE SCHOOL OF THEOLOGY      ,TX,78752-1333,Private      ,4,14,18,18,,129,147
02521200,ARLINGTON CAREER INSTITUTE              ,TX,75050-0000,Proprietary  ,7,51,58,68,,416,484
02521800,SEGUIN BEAUTY SCHOOL                    ,TX,78155-0000,Proprietary  ,9,12,21,55,,122,177
02527500,HOUSTON TRAINING SCHOOLS                ,TX,77029-0000,Proprietary  ,26,168,194,233,,1063,1296
02530700,SEBRING CAREER SCHOOLS                  ,TX,77083-1510,Proprietary  ,6,16,22,29,,120,149
02548800,SOUTH TEXAS VO-TECH INSTITUTE           ,TX,78596-0000,Proprietary  ,28,49,77,247,,352,599
02548802,SOUTH TEXAS VOCATIONAL TECHNICAL INSTITU,TX,78520-8710,Proprietary  ,21,64,85,241,,340,581
02549400,SOUTH TEXAS VO-TECH INSTITUTE           ,TX,78501-0000,Proprietary  ,37,90,127,319,,451,770
02549402,SOUTH TEXAS VOCATIONAL TECHNICAL INSTITU,TX,78416-1141,Proprietary  ,19,110,129,178,,552,730
02555400,UNIV OF TX MD ANDERSON CANCER CTR       ,TX,77030-0000,Public       ,15,69,84,272,,881,1153
02567200,OFFICE CAREER CENTER                    ,TX,76180-0000,Proprietary  ,0,0,0,0,,1,1
02568100,TEXAS BARBER COLLEGE                    ,TX,77063-3949,Proprietary  ,21,111,132,154,,643,797
02568101,TEXAS BARBER COLLEGES & HAIRSTYLING SCHO,TX,75228-3841,Proprietary  ,13,86,99,133,,476,609
02568106,TEXAS BARBER COLLEGES & HAIRSTYLING SCHO,TX,77009-0000,Proprietary  ,10,71,81,116,,385,501
02568107,TEXAS BARBER COLLEGES & HAIRSTYLING SCHO,TX,77063-3951,Proprietary  ,8,67,75,114,,418,532
02568108,TEXAS BARBER COLLEGES & HAIRSTYLING SCHO,TX,75241-1327,Proprietary  ,16,95,111,127,,530,657
02568109,TEXAS BARBER COLLEGES & HAIRSTYLING SCHO,TX,77301-4407,Proprietary  ,4,17,21,39,,120,159
02569300,LE CORDON BLEU COLLEGE OF CULINARY ARTS ,TX,78758-3647,Proprietary  ,184,461,645,1465,,3060,4525
02572000,COMPUTER CAREER CENTER                  ,TX,79925-2021,Proprietary  ,81,240,321,642,,1823,2465
02572004,COMPUTER CAREER CENTER - AMARILLO CAMPUS,TX,79101-2404,Proprietary  ,22,83,105,143,,484,627
02572005,COMPUTER CAREER CENTER - LUBBOCK CAMPUS ,TX,79414-3517,Proprietary  ,28,111,139,179,,675,854
02572008,VISTA COLLEGE - BEAUMONT                ,TX,77701-3717,Proprietary  ,23,148,171,112,,655,767
02572009,VISTA COLLEGE - LONGVIEW                ,TX,75604-1905,Proprietary  ,22,178,200,151,,865,1016
02572011,VISTA COLLEGE - KILLEEN                 ,TX,76541-7436,Proprietary  ,31,176,207,163,,1078,1241
02591100,CAREER POINT COLLEGE                    ,TX,78201-2027,Proprietary  ,50,420,470,325,,2422,2747
02591900,KAPLAN COLLEGE                          ,TX,79907-1525,Proprietary  ,59,178,237,469,,1326,1795
02591905,KAPLAN COLLEGE - BROWNSVILLE            ,TX,78521-9905,Proprietary  ,28,92,120,231,,581,812
02596400,REDSTONE COLLEGE - LOS ANGELES          ,TX,77061-0000,Proprietary  ,10,52,62,176,,407,583
02596600,ATI-CAREER TRAINING CENTER              ,TX,75220-4443,Proprietary  ,0,0,0,44,,160,204
02596601,ATI CAREER TRAINING CENTER - RICHARDSON ,TX,75081-1948,Proprietary  ,0,0,0,15,,52,67
02596602,ATI CAREER TRAINING CENTER - DALLAS (STE,TX,75247-6103,Proprietary  ,0,0,0,74,,200,274
02600200,OCEAN CORPORATION (THE)                 ,TX,77099-3479,Proprietary  ,28,163,191,220,,999,1219
02604700,CENTER FOR ADVANCED LEGAL STUDIES       ,TX,77098-4151,Proprietary  ,5,70,75,49,,489,538
02606202,EVEREST COLLEGE - EVEREST INSTITUTE - BI,TX,77036-8014,Proprietary  ,60,333,393,427,,1807,2234
02615000,SANFORD-BROWN COLLEGE                   ,TX,75247-6931,Proprietary  ,42,241,283,401,,1633,2034
03009400,SW SCH BUS & TECH CAREERS               ,TX,78212-2840,Proprietary  ,5,39,44,50,,205,255
03010604,VIRGINIA COLLEGE - VIRGINIA COLLEGE AT A,TX,78723-0000,Proprietary  ,10,68,78,179,,781,960
03011800,UNIVERSITY OF COSMETOLOGY ARTS & SCIENCE,TX,78226-1160,Proprietary  ,14,25,39,106,,184,290
03019800,PCI HEALTH TRAINING CENTER              ,TX,75247-4720,Proprietary  ,29,122,151,313,,927,1240
03019801,PCI HEALTH TRAINING CENTER - RICHARDSON ,TX,75081-2321,Proprietary  ,24,56,80,28,,73,101
03021500,SW SCH BUS & TECH CAREERS               ,TX,78852-4859,Proprietary  ,15,30,45,202,,253,455
03025000,TEXAS COLLEGE OF COSMETOLOGY            ,TX,79605-2001,Proprietary  ,10,44,54,86,,301,387
03025001,TEXAS COLLEGE OF COSMETOLOGY - SAN ANGEL,TX,76903-4708,Proprietary  ,4,12,16,53,,101,154
03026500,REMINGTON COLLEGE - HOUSTON CAMPUS      ,TX,77082-1849,Private      ,274,1166,1440,1829,,5685,7514
03026501,REMINGTON COLLEGE - NORTH HOUSTON CAMPUS,TX,77067-1849,Private      ,15,117,132,213,,835,1048
03026506,REMINGTON COLLEGE - FT. WORTH CAMPUS    ,TX,76112-1280,Private      ,41,177,218,325,,1097,1422
03028800,CIRCLE J BEAUTY SCHOOL                  ,TX,77587-3714,Proprietary  ,10,45,55,60,,202,262
03030608,UTAH COLLEGE OF MASSAGE THERAPY - TEXAS ,TX,75801-4848,Proprietary  ,23,58,81,147,,323,470
03030609,UTAH COLLEGE OF MASSAGE THERAPY - TEXAS ,TX,77040-6307,Proprietary  ,20,83,103,159,,488,647
03031408,INTERNATIONAL ACADEMY OF DESIGN & TECHNO,TX,78229-2263,Proprietary  ,28,67,95,262,,613,875
03032300,SCHOOL OF AUTOMOTIVE MACHINISTS         ,TX,77055-1803,Proprietary  ,27,68,95,187,,418,605
03035200,TINT SCHOOL OF MAKEUP & COSMETOLOGY     ,TX,75229-3734,Proprietary  ,18,73,91,145,,434,579
03035300,SOUTHERN CAREERS INSTITUTE              ,TX,78704-5252,Proprietary  ,202,749,951,924,,3042,3966
03035301,SOUTHERN CAREERS INSTITUTE-PHARR        ,TX,78577-2118,Proprietary  ,15,82,97,131,,323,454
03035302,SOUTHERN CAREERS INSTITUTE - CORPUS CHRI,TX,78414-2904,Proprietary  ,28,126,154,156,,589,745
03035303,SOUTHERN CAREERS INSTITUTE - SAN ANTONIO,TX,78221-4351,Proprietary  ,5,28,33,59,,252,311
03035305,SOUTHERN CAREERS INSTITUTE - BROWNSVILLE,TX,78520-8680,Proprietary  ,5,29,34,82,,131,213
03035306,SOUTHERN CAREERS INSTITUTE - HARLINGEN  ,TX,78550-7911,Proprietary  ,7,27,34,84,,153,237
03035307,SOUTHERN CAREERS INSTITUTE - CORPUS CHRI,TX,78410-1609,Proprietary  ,0,0,0,14,,44,58
03035308,SOUTHERN CAREERS INSTITUTE - SAN ANTONIO,TX,78238-4114,Proprietary  ,31,181,212,92,,430,522
03061800,STAR COLLEGE OF COSMETOLOGY             ,TX,75702-8214,Proprietary  ,8,47,55,150,,365,515
03064600,UNIVERSITY OF TEXAS AT BROWNSVILLE      ,TX,78520-4993,Public       ,414,729,1143,9248,,8455,17703
03075400,ICC TECHNICAL INSTITUTE                 ,TX,77004-2930,Private      ,14,47,61,100,,297,397
03076403,BRYMAN SCHOOL OF ARIZONA (THE) - ANTHEM ,TX,75038-4201,Proprietary  ,15,34,49,90,,298,388
03079201,WESTWOOD COLLEGE OF TECHNOLOGY          ,TX,76180-0000,Proprietary  ,0,0,0,13,,32,45
03103400,SOUTH TEXAS COLLEGE                     ,TX,78501-6699,Public       ,1828,1363,3191,15981,,13054,29035
03108700,ROYAL BEAUTY CAREERS                    ,TX,77069-4611,Proprietary  ,17,85,102,144,,495,639
03115800,KAPLAN COLLEGE                          ,TX,78238-4203,Proprietary  ,50,210,260,312,,1247,1559
03115802,KAPLAN COLLEGE - LAREDO                 ,TX,78041-6181,Proprietary  ,32,68,100,239,,450,689
03115803,KAPLAN COLLEGE-BEAUMONT                 ,TX,77701-3706,Proprietary  ,15,105,120,155,,728,883
03115804,KAPLAN COLLEGE - LUBBOCK                ,TX,79401-2601,Proprietary  ,22,102,124,150,,553,703
03128100,COLLEGE OF HEALTH CARE PROFESSIONS (THE),TX,77092-8108,Proprietary  ,100,443,543,814,,2872,3686
03144300,NATIONAL BEAUTY COLLEGE                 ,TX,75043-4046,Proprietary  ,7,24,31,30,,100,130
03153300,AMER COLL OF ACUPUNCTURE & O.M.         ,TX,77063-4104,Proprietary  ,3,22,25,24,,180,204
03156400,ACADEMY OF ORIENTAL MEDICINE AT AUSTIN  ,TX,78757-1132,Proprietary  ,4,56,60,64,,365,429
03159300,ARLINGTON MEDICAL INSTITUTE             ,TX,76011-0000,Proprietary  ,26,63,89,210,,514,724
03170300,TEXAS A&M UNIVERSITY-TEXARKANA          ,TX,75501-0000,Public       ,55,230,285,1440,,2358,3798
03179500,TEXAS HEALTH AND SCIENCE UNIVERSITY     ,TX,78704-6748,Proprietary  ,14,59,73,25,,172,197
03237400,FARIS COMPUTER SCHOOL                   ,TX,77627-3829,Proprietary  ,1,4,5,9,,27,36
03272300,KAPLAN COLLEGE                          ,TX,75234-7288,Proprietary  ,55,272,327,342,,1590,1932
03272301,KAPLAN COLLEGE - MIDLAND                ,TX,79703-5531,Proprietary  ,3,26,29,57,,191,248
03272303,KAPLAN COLLEGE - ARLINGTON              ,TX,76010-8121,Proprietary  ,37,170,207,309,,1123,1432
03275300,TOUCH OF CLASS SCHOOL OF COSM           ,TX,75402-6314,Proprietary  ,12,28,40,56,,153,209
03276300,ACADEMY OF HAIR DESIGN                  ,TX,75901-4900,Proprietary  ,13,51,64,89,,305,394
03277300,ACADEMY OF HAIR DESIGN                  ,TX,77701-4650,Proprietary  ,8,30,38,58,,218,276
03303300,NORTHWEST EDUCATIONAL CENTER            ,TX,77092-7055,Proprietary  ,14,66,80,77,,359,436
03371300,TONI&GUY HAIRDRESSING ACADEMY           ,TX,75006-2351,Proprietary  ,17,36,53,152,,244,396
03372300,NORTHWEST VISTA COLLEGE                 ,TX,78251-4217,Public       ,717,1257,1974,10529,,11477,22006
03396500,TEXAS STATE TECHNICAL COLG/MARSHALL     ,TX,75672-7402,Public       ,33,84,117,456,,681,1137
03400300,CAREER QUEST                            ,TX,78229-3539,Proprietary  ,20,131,151,115,,648,763
03412300,ADVANCED BARBER COLLEGE & HAIR DESI     ,TX,78596-0000,Proprietary  ,20,38,58,109,,230,339
03416500,DALLAS NURSING INSTITUTE                ,TX,75243-5502,Proprietary  ,35,196,231,401,,1575,1976
03422300,MILAN INSTITUTE                         ,TX,78238-4103,Proprietary  ,120,392,512,787,,2001,2788
03422400,COLLEGE OF BIBLICAL STUDIES-HOUSTON     ,TX,77036-3211,Private      ,16,164,180,127,,1220,1347
03424400,MEDVANCE INSTITUTE                      ,TX,77057-7386,Proprietary  ,30,150,180,242,,1037,1279
03426300,COLLEGE OF HEALTH CARE PROFESSIONS (THE),TX,78752-3630,Proprietary  ,25,141,166,186,,710,896
03480304,MEDVANCE INSTITUTE OF BATON ROUGE - GRAN,TX,75050-2342,Proprietary  ,14,48,62,93,,313,406
03520300,LUBBOCK HAIR ACADEMY                    ,TX,79410-3524,Proprietary  ,2,17,19,50,,135,185
03542300,CONCORDE CAREER INSTITUTE               ,TX,76011-4016,Proprietary  ,32,180,212,334,,1617,1951
03556400,KUSSAD INSTITUTE OF COURT REPORTING     ,TX,78704-5712,Proprietary  ,4,5,9,13,,48,61
03573300,AVIATION INSTITUTE OF MAINTENANCE       ,TX,75209-3017,Proprietary  ,28,115,143,188,,791,979
03610300,MJ'S BEAUTY ACADEMY INC                 ,TX,75224-4425,Proprietary  ,6,41,47,66,,238,304
03612400,VALLEY GRANDE INSTITUTE FOR ACADEMI     ,TX,78596-0000,Private      ,18,44,62,153,,428,581
03627300,LAMAR INSTITUTE OF TECHNOLOGY           ,TX,77705-4142,Public       ,196,478,674,2084,,3534,5618
03676400,HEALTHY HAIR ACADEMY                    ,TX,75227-0000,Proprietary  ,0,0,0,26,,82,108
03680300,JAY'S TECHNICAL INSTITUTE               ,TX,77031-3509,Proprietary  ,3,34,37,30,,202,232
03682400,DALLAS BARBER & STYLIST COLLEGE         ,TX,75231-0000,Proprietary  ,22,127,149,205,,778,983
03714300,TREND BARBER COLLEGE                    ,TX,77071-2104,Proprietary  ,12,75,87,104,,502,606
03723300,CULINARY INST ALAIN & MARIE LENOTRE     ,TX,77022-4322,Proprietary  ,28,113,141,282,,733,1015
03727600,CULINARY ACADEMY OF AUSTIN              ,TX,78752-0000,Proprietary  ,32,76,108,364,,505,869
03731300,INTERNATIONAL RENOWNED BEAUTY ACADE     ,TX,76103-2504,Proprietary  ,0,0,0,4,,12,16
03733300,BAPTIST UNIVERSITY OF THE AMERICAS      ,TX,78224-1336,Private      ,9,35,44,147,,391,538
03756300,ANAMARC COLLEGE                         ,TX,79930-6230,Proprietary  ,31,178,209,384,,1564,1948
03922300,SOUTH TEXAS BARBER COLLEGE              ,TX,78415-3463,Proprietary  ,6,22,28,43,,106,149
03944400,PROFESSIONAL CAREERS INSTITUTE          ,TX,77036-2252,Proprietary  ,3,31,34,29,,220,249
03944401,PROFESSIONAL CAREERS INSTITUTE          ,TX,77090-3914,Proprietary  ,6,39,45,45,,272,317
03970300,HANDS ON THERAPY                        ,TX,75149-2294,Proprietary  ,6,25,31,35,,143,178
03987300,TEXAS HEALTH SCHOOL                     ,TX,77079-2106,Proprietary  ,30,94,124,293,,773,1066
04036300,SOUTHEAST TEXAS CAREER INSTITUTE        ,TX,77656-8601,Proprietary  ,8,18,26,63,,143,206
04045300,NORTHWEST BEAUTY SCHOOL                 ,TX,77091-1208,Proprietary  ,4,39,43,64,,208,272
04045400,MAI-TRIX BEAUTY COLLEGE                 ,TX,77040-0000,Proprietary  ,7,33,40,63,,196,259
04082300,PROFESSIONAL CAREER TRAINING INSTITUTE  ,TX,77090-0000,Proprietary  ,8,52,60,64,,340,404
04089400,CCI TRAINING CENTER                     ,TX,76011-4857,Proprietary  ,4,69,73,51,,404,455
04117900,CHAMPION BEAUTY COLLEGE                 ,TX,77069-4611,Proprietary  ,8,57,65,91,,381,472
04121800,CRISWELL COLLEGE                        ,TX,75246-1537,Private      ,8,57,65,150,,458,608
04125400,ACADEMY AT AUSTIN (THE)                 ,TX,78660-3287,Proprietary  ,11,33,44,109,,221,330
04125500,MANUEL AND THERESA'S SCHOOL OF HAIR DESI,TX,77803-3236,Proprietary  ,5,15,20,48,,90,138
04129800,MEDIATECH INSTITUTE DALLAS              ,TX,75039-3105,Proprietary  ,22,54,76,153,,329,482
04129801,MEDIATECH INSTITUTE - AUSTIN            ,TX,78704-8933,Proprietary  ,12,29,41,86,,183,269
04129802,MEDIATECH INSTITUTE HOUSTON             ,TX,77042-4712,Proprietary  ,15,46,61,132,,299,431
04131700,SOUTHWEST CAREER COLLEGE                ,TX,79925-6230,Proprietary  ,77,271,348,941,,2064,3005
04135600,CANNON INSTITUTE OF HIGHER LEARNING     ,TX,75247-9998,Proprietary  ,4,19,23,24,,128,152
04136500,PCCENTER                                ,TX,75115-4214,Proprietary  ,3,14,17,21,,90,111
04138500,CARDIOTECH ULTRASOUND SCHOOL            ,TX,77099-1440,Proprietary  ,14,95,109,126,,572,698
04142300,AVEDA INSTITUTE SAN ANTONIO             ,TX,78215-1260,Proprietary  ,35,107,142,323,,726,1049
04146700,AVIATION INSTITUTE OF MAINTENANCE       ,TX,77061-4004,Proprietary  ,31,111,142,202,,577,779
04146800,SOUTH TEXAS TRAINING CENTER             ,TX,78586-7721,Proprietary  ,15,29,44,59,,123,182
04152700,ASTRODOME CAREER CENTERS                ,TX,77054-2678,Proprietary  ,3,43,46,44,,238,282
04154800,DUVALL'S SCHOOL OF COSMETOLOGY          ,TX,76021-4159,Proprietary  ,5,10,15,48,,76,124
04155800,ADVANCED BEAUTY COLLEGE                 ,TX,75061-1918,Proprietary  ,2,7,9,35,,100,135
04158500,TEXAS BEAUTY COLLEGE                    ,TX,76117-3201,Proprietary  ,1,11,12,13,,65,78
04160700,AVENUE FIVE INSTITUTE                   ,TX,78757-7000,Proprietary  ,19,62,81,150,,437,587
04161100,CORPUS CHRISTI BEAUTY ACADEMY           ,TX,78412-3900,Proprietary  ,2,4,6,58,,123,181
04165800,SALON PROFESSIONAL ACADEMY (THE)        ,TX,75067-5390,Proprietary  ,5,12,17,52,,113,165
04168700,LAWYER'S ASSISTANT SCHOOL OF DALLAS     ,TX,75201-2829,Proprietary  ,8,85,93,73,,447,520
04168800,ABC BEAUTY ACADEMY                      ,TX,75042-8682,Proprietary  ,6,28,34,33,,123,156
04169000,SALON & SPA INSTITUTE                   ,TX,78521-1727,Proprietary  ,11,24,35,88,,154,242
04169100,DIAMONDS COSMETOLOGY COLLEGE            ,TX,75090-2657,Proprietary  ,1,14,15,27,,100,127
04177900,BUCKNER BARBER SCHOOL                   ,TX,75217-1775,Proprietary  ,7,44,51,74,,219,293
04178200,VOGUE COLLEGE - SAN ANTONIO             ,TX,78201-5035,Proprietary  ,8,45,53,67,,216,283
04178300,VOGUE BEAUTY ACADEMY                    ,TX,78238-4402,Proprietary  ,8,38,46,82,,238,320
04178400,VOGUE COLLEGE - MCALLEN                 ,TX,78501-1945,Proprietary  ,18,50,68,109,,230,339
04179500,NORTH AMERICAN COLLEGE                  ,TX,77038-0000,Private      ,12,27,39,273,,260,533
04184800,EXCEL LEARNING CENTER                   ,TX,79907-1400,Proprietary  ,8,68,76,39,,251,290
04187800,CYBERTEX INSTITUTE OF TECHNOLOGY        ,TX,78752-3825,Proprietary  ,10,59,69,58,,271,329
04193000,RGV CAREERS AN INSTITUTE FOR HIGHER LEAR,TX,78577-2106,Proprietary  ,7,56,63,45,,256,301
04205200,WADE GORDON HAIRDRESSING ACADEMY        ,TX,79121-0548,Proprietary  ,8,37,45,61,,141,202
04206501,MYCOMPUTERCAREER.COM - DALLAS           ,TX,75062-8173,Proprietary  ,4,87,91,4,,90,94
04206502,MYCOMPUTERCAREER.COM - HOUSTON          ,TX,77056-6764,Proprietary  ,10,130,140,10,,139,149
04213300,SPA PROFESSIONALS ACADEMY (THE)         ,TX,78504-2569,Proprietary  ,4,16,20,51,,123,174
04215000,TOTAL TRANSFORMATION INSTITUTE OF COSMET,TX,78666-8115,Proprietary  ,7,16,23,17,,40,57
04215400,GRACE SCHOOL OF THEOLOGY                ,TX,77384-4894,Private      ,3,17,20,4,,31,35
04219700,GEMINI SCHOOL OF VISUAL ARTS & COMMUNICA,TX,78613-2642,Proprietary  ,3,1,4,9,,9,18
04224100,COSMETOLOGY ACADEMY OF TEXARKANA        ,TX,75503-4855,Proprietary  ,6,43,49,12,,78,90
04226400,MT TRAINING CENTER                      ,TX,75051-3542,Proprietary  ,1,24,25,3,,26,29
04229000,BARBER INSTITUTE OF TEXAS               ,TX,75602-3456,Proprietary  ,0,4,4,0,,4,4
04231200,NEECEE'S COLLEGE OF COSMETOLOGY         ,TX,79605-4735,Proprietary  ,4,2,6,4,,2,6
04231900,ALAMO CITY BARBER COLLEGE               ,TX,78250-3227,Proprietary  ,4,13,17,4,,13,17
00367000,BRIGHAM YOUNG UNIVERSITY                ,UT,84602-8406,Private      ,1420,999,2419,15208,,14014,29222
00367100,DIXIE STATE COLLEGE OF UTAH             ,UT,84770-3876,Public       ,561,534,1095,5573,,5240,10813
00367200,LDS BUSINESS COLLEGE                    ,UT,84101-3500,Private      ,183,177,360,1334,,1395,2729
00367400,STEVENS HENAGER COLLEGE                 ,UT,84401-1420,Proprietary  ,380,2918,3298,1878,,14850,16728
00367500,UNIVERSITY OF UTAH                      ,UT,84112-9055,Public       ,1275,1408,2683,15329,,19176,34505
00367700,UTAH STATE UNIVERSITY                   ,UT,84322-1400,Public       ,1368,1220,2588,13139,,14392,27531
00367800,SOUTHERN UTAH UNIVERSITY                ,UT,84720-2470,Public       ,540,373,913,5738,,3866,9604
00367900,SNOW COLLEGE                            ,UT,84627-1299,Public       ,349,178,527,3131,,1338,4469
00368000,WEBER STATE UNIVERSITY                  ,UT,84408-1136,Public       ,889,1385,2274,8297,,14310,22607
00368100,WESTMINSTER COLLEGE                     ,UT,84105-3697,Private      ,198,253,451,2867,,2162,5029
00402700,UTAH VALLEY UNIVERSITY                  ,UT,84058-5999,Public       ,1382,1941,3323,10695,,18940,29635
00522000,SALT LAKE COMMUNITY COLLEGE             ,UT,84123-0000,Public       ,1243,2580,3823,9958,,21146,31104
00732953,ITT TECHNICAL INSTITUTE                 ,UT,84123-2500,Proprietary  ,61,323,384,425,,1957,2382
00943300,SHERMAN KENDALL'S ACADEMY OF BEAUTY     ,UT,84106-1836,Proprietary  ,3,24,27,34,,104,138
01009800,NEUMONT UNIVERSITY                      ,UT,84095-0000,Proprietary  ,48,10,58,837,,128,965
01116500,UINTAH BASIN APPLIED TECHNOLOGY CLG     ,UT,84066-0000,Public       ,4,19,23,27,,167,194
01116600,BROADVIEW UNIVERSITY                    ,UT,84088-4021,Proprietary  ,44,149,193,422,,1245,1667
02078800,SHERMAN KENDALL'S ACADEMY OF BEAUTY     ,UT,84047-0000,Proprietary  ,4,14,18,24,,49,73
02115400,BRIDGERLAND APPLIED TECHNOLOGY COLLEGE  ,UT,84321-0000,Public       ,45,112,157,431,,1145,1576
02156600,DAVIS APPLIED TECHNOLOGY COLLEGE        ,UT,84037-0000,Public       ,85,245,330,545,,1718,2263
02178500,EAGLE GATE COLLEGE                      ,UT,84123-0000,Proprietary  ,29,163,192,234,,1367,1601
02270800,AMERITECH COLLEGE                       ,UT,84604-6927,Proprietary  ,25,180,205,152,,1667,1819
02270802,AMERITECH COLLEGE - DRAPER              ,UT,84020-6545,Proprietary  ,10,78,88,93,,817,910
02298500,EVEREST COLLEGE                         ,UT,84119-2668,Proprietary  ,21,186,207,202,,1042,1244
02346500,OGDEN-WEBER APPLIED TECHNOLOGY COLG     ,UT,84404-0000,Public       ,85,349,434,644,,2316,2960
02360800,PROVO COLLEGE                           ,UT,84601-0000,Proprietary  ,40,131,171,250,,739,989
02531800,PAUL MITCHELL THE SCHOOL - PROVO        ,UT,84606-0000,Proprietary  ,11,23,34,329,,419,748
02556800,PAUL MITCHELL THE SCHOOL                ,UT,84117-7204,Proprietary  ,28,76,104,226,,451,677
02556801,PAUL MITCHELL THE SCHOOL                ,UT,84780-0000,Proprietary  ,15,18,33,96,,144,240
02572700,EVANS HAIRSTYLING COLLEGE               ,UT,84770-0000,Proprietary  ,4,4,8,37,,49,86
02572800,VISTA COLLEGE                           ,UT,84015-0000,Proprietary  ,9,60,69,50,,495,545
02573100,EVANS HAIRSTYLING COLLEGE               ,UT,84720-0000,Proprietary  ,9,12,21,45,,55,100
02612200,MARINELLO SCHOOL OF BEAUTY              ,UT,84604-1585,Proprietary  ,7,16,23,74,,124,198
03030600,UTAH COLLEGE OF MASSAGE THERAPY         ,UT,84111-1606,Proprietary  ,35,89,124,217,,481,698
03030601,UTAH CLG OF MASSAGE THER-PROVO CMPS     ,UT,84042-0000,Proprietary  ,10,20,30,59,,128,187
03082100,MYOTHERAPY COLLEGE OF UTAH              ,UT,84115-2522,Proprietary  ,6,24,30,25,,115,140
03108200,ECHELON EDGE ACADEMY OF HAIR SKIN & NAIL,UT,84070-2004,Proprietary  ,4,16,20,25,,77,102
03110400,HAIRITAGE HAIR ACADEMY                  ,UT,84770-5233,Proprietary  ,2,5,7,34,,56,90
03339400,WESTERN GOVERNORS UNIVERSITY            ,UT,84107-2533,Private      ,223,7409,7632,1592,,56767,58359
03413300,MOUNTAINLAND APPLIED TECHNOLOGY COLLEGE ,UT,84058-5857,Public       ,39,137,176,347,,872,1219
03463300,CAREERS UNLIMITED                       ,UT,84058-0000,Proprietary  ,6,16,22,73,,189,262
03467308,MARINELLO SCHOOL OF BEAUTY - OGDEN      ,UT,84405-1501,Proprietary  ,8,38,46,71,,266,337
03467309,MARINELLO SCHOOL OF BEAUTY - LAYTON     ,UT,84041-3002,Proprietary  ,6,17,23,56,,151,207
03617300,HEALING MOUNTAIN MASSAGE SCHOOL         ,UT,84111-0000,Proprietary  ,6,34,40,49,,210,259
03829500,SKINWORKS SCHOOL OF ADVANCED SKINCARE   ,UT,84115-0000,Proprietary  ,3,20,23,43,,122,165
03838300,NIGHTINGALE COLL. SCH. OF NURSING SCH. O,UT,84403-0000,Proprietary  ,5,47,52,35,,274,309
03902300,RENAISSANCE SCHOOL OF THERAPEUTIC MASSAG,UT,84010-2835,Proprietary  ,0,0,0,5,,17,22
03909300,MAXIMUM STYLE TEC SCHOOL OF COSMETOLOGY ,UT,84323-4679,Proprietary  ,4,7,11,53,,98,151
03921300,CAMEO COLLEGE OF ESSENTIAL BEAUTY       ,UT,84115-0000,Proprietary  ,13,62,75,125,,426,551
04054300,SOUTHWEST APPLIED TECHNOLOGY COLLEGE    ,UT,84720-6608,Public       ,12,48,60,105,,263,368
04072300,AVEDA INSTITUTE PROVO                   ,UT,84604-1008,Proprietary  ,18,18,36,132,,158,290
04118100,IMAGEWORKS ACADEMY OF HAIR DESIGN       ,UT,84660-1210,Proprietary  ,0,0,0,2,,8,10
04121700,DIXIE APPLIED TECHNOLOGY COLLEGE        ,UT,84770-3025,Public       ,25,59,84,227,,392,619
04142100,SKIN INSTITUTE (THE)                    ,UT,84770-6452,Proprietary  ,3,14,17,31,,93,124
04145500,SKIN SCIENCE INSTITUTE (THE)            ,UT,84115-0000,Proprietary  ,2,26,28,45,,182,227
04153000,RENAISSANCE ACADEMIE                    ,UT,84604-0000,Proprietary  ,7,17,24,36,,96,132
04161900,MANDALYN ACADEMY                        ,UT,84003-2161,Proprietary  ,5,13,18,25,,79,104
04165500,ACAYDIA SCHOOL OF AESTHETICS            ,UT,84601-0000,Proprietary  ,3,10,13,36,,74,110
04169900,AMERICAN BEAUTY ACADEMY                 ,UT,84651-0000,Proprietary  ,1,10,11,20,,52,72
04173200,TAYLOR ANDREWS ACADEMY OF HAIR DESIGN   ,UT,84088-6577,Proprietary  ,23,38,61,100,,179,279
04183000,TOP NAILS & HAIR BEAUTY SCHOOL          ,UT,84118-0000,Proprietary  ,5,15,20,21,,104,125
04184200,TAYLOR ANDREWS ACADEMY-ST. GEORGE       ,UT,84790-2139,Proprietary  ,10,19,29,77,,123,200
04192700,BARBER SCHOOL (THE)                     ,UT,84047-3723,Proprietary  ,4,36,40,23,,142,165
04193200,ROCKY MOUNTAIN UNIVERSITY OF HEALTH PROF,UT,84606-7312,Proprietary  ,5,29,34,25,,393,418
04210300,MEDSPA ACADEMIES                        ,UT,84095-3519,Proprietary  ,7,24,31,45,,192,237
04211500,BEAUTIFUL YOU SCHOOL OF NAIL TECHNOLOGY ,UT,84720-8360,Proprietary  ,0,3,3,10,,20,30
04216800,BONNIE JOSEPH ACADEMY OF COSMETOLOGY & B,UT,84032-2044,Proprietary  ,1,6,7,3,,38,41
04218300,MIDWIVES COLLEGE OF UTAH                ,UT,84106-2671,Private      ,3,44,47,21,,261,282
00368200,BENNINGTON COLLEGE                      ,VT,05201-6001,Private      ,34,17,51,1133,,229,1362
00368300,CASTLETON STATE COLLEGE                 ,VT,05735-0000,Public       ,58,29,87,3398,,537,3935
00368400,CHAMPLAIN COLLEGE                       ,VT,05401-3950,Private      ,278,139,417,4454,,1399,5853
00368500,COLLEGE OF ST JOSEPH                    ,VT,05701-3899,Private      ,1,15,16,148,,220,368
00368600,GODDARD COLLEGE                         ,VT,05667-0000,Private      ,1,61,62,49,,902,951
00368700,GREEN MOUNTAIN COLLEGE                  ,VT,05764-1199,Private      ,32,42,74,884,,324,1208
00368800,JOHNSON STATE COLLEGE                   ,VT,05656-9898,Public       ,29,53,82,1417,,960,2377
00368900,LYNDON STATE COLLEGE                    ,VT,05851-0919,Public       ,38,16,54,2052,,401,2453
00369000,MARLBORO COLLEGE                        ,VT,05344-0300,Private      ,12,18,30,366,,144,510
00369100,MIDDLEBURY COLLEGE                      ,VT,05753-0000,Private      ,90,42,132,4681,,574,5255
00369200,NORWICH UNIVERSITY                      ,VT,05663-1035,Private      ,78,208,286,3300,,1611,4911
00369300,SOUTHERN VERMONT COLLEGE                ,VT,05201-6002,Private      ,17,4,21,650,,182,832
00369400,ST MICHAELS COLLEGE                     ,VT,05439-0001,Private      ,74,19,93,4013,,236,4249
00369600,UNIVERSITY OF VERMONT                   ,VT,05405-0160,Public       ,450,160,610,19176,,3353,22529
00369700,VERMONT COLLEGE OF FINE ARTS            ,VT,05602-3128,Private      ,1,57,58,28,,459,487
00369800,VERMONT TECHNICAL COLLEGE               ,VT,05061-0000,Public       ,37,51,88,1202,,903,2105
00857500,SALON PROFESSIONAL ACADEMY (THE)        ,VT,05495-4001,Proprietary  ,7,8,15,48,,75,123
00865800,O'BRIENS AVEDA INSTITUTE                ,VT,05403-7747,Proprietary  ,4,15,19,38,,94,132
00886000,SIT                                     ,VT,05301-4801,Private      ,10,36,46,214,,583,797
01116700,COMMUNITY COLLEGE OF VERMONT            ,VT,05676-0000,Public       ,161,484,645,1948,,4647,6595
01193400,VERMONT LAW SCHOOL                      ,VT,05068-0000,Private      ,1,33,34,4,,1029,1033
01218300,BURLINGTON COLLEGE                      ,VT,05401-8477,Private      ,16,24,40,303,,214,517
02143500,STERLING COLLEGE                        ,VT,05827-0000,Private      ,10,7,17,127,,64,191
02254000,NEW ENGLAND CULINARY INSTITUTE          ,VT,05602-0000,Proprietary  ,13,18,31,440,,239,679
02532600,LANDMARK COLLEGE                        ,VT,05346-0000,Private      ,40,7,47,574,,99,673
03708300,BURLINGTON TECHNICAL CENTER             ,VT,05401-2721,Public       ,0,0,0,12,,18,30
04146900,ADVANCED WELDING INSTITUTE              ,VT,05403-0000,Proprietary  ,3,13,16,44,,50,94
00392800,CASPER COLLEGE                          ,WY,82601-4612,Public       ,101,198,299,1499,,1862,3361
00392900,EASTERN WYOMING COLLEGE                 ,WY,82240-1603,Public       ,35,50,85,578,,438,1016
00393000,SHERIDAN COLLEGE                        ,WY,82801-9133,Public       ,93,137,230,1151,,1284,2435
00393100,NORTHWEST COLLEGE                       ,WY,82435-1895,Public       ,77,81,158,973,,646,1619
00393200,UNIVERSITY OF WYOMING                   ,WY,82071-2000,Public       ,475,324,799,7821,,5204,13025
00393300,WESTERN WYOMING COMMUNITY COLLEGE       ,WY,82902-0000,Public       ,65,145,210,1017,,1251,2268
00728900,CENTRAL WYOMING COLLEGE                 ,WY,82501-0000,Public       ,45,92,137,619,,891,1510
00915700,WYOMING TECHNICAL INSTITUTE             ,WY,82072-9519,Proprietary  ,211,152,363,1653,,1051,2704
00925900,LARAMIE COUNTY COMMUNITY CLG            ,WY,82007-3299,Public       ,130,312,442,1731,,2529,4260
02211900,CHEEKS INTERNATIONAL ACDMY              ,WY,82001-0000,Proprietary  ,1,29,30,51,,168,219
00393500,UNIV OF GUAM                            ,GU,96923-0000,Public       ,166,198,364,2698,,1993,4691
01536100,GUAM COMMUNITY COLLEGE                  ,GU,96921-0000,Public       ,164,225,389,1867,,1779,3646
03438300,PACIFIC ISLANDS UNIVERSITY              ,GU,96913-2619,Private      ,9,19,28,109,,137,246
00393600,PONTIFICAL CATHOLIC UNIV OF PR          ,PR,00717-0777,Private      ,94,219,313,6679,,5181,11860
00393700,UNIVERSITY OF THE SACRED HEART          ,PR,00914-0383,Private      ,58,177,235,3941,,2489,6430
00393800,INTER-AMER UNIV PR-CNTRL ADMN           ,PR,00936-0000,Private      ,126,460,586,3587,,5680,9267
00393801,INTER-AMER UNIV PR SCHL LAW             ,PR,00936-8351,Private      ,0,14,14,34,,325,359
00393802,INTER AMERICAN UNIVERSITY OF PUERTO RICO,PR,00926-0000,Private      ,17,83,100,1133,,1200,2333
00393803,INTER AMERICAN UNIVERSITY OF PR         ,PR,00683-0000,Private      ,70,108,178,3844,,1866,5710
00393804,INTER-AMER UNIV PR-RECINTO AGUADILA     ,PR,00605-2000,Private      ,65,118,183,3126,,2016,5142
00393805,INTER-AMER UNIV PR-ARECIBO CAMPUS       ,PR,00614-4050,Private      ,48,158,206,3126,,2459,5585
00393806,INTER-AMER UNIV PR-BARRANQUITAS REG     ,PR,00794-0517,Private      ,30,44,74,1624,,772,2396
00393807,INTER-AMER UNIV PR-FAJARDO REGIONAL     ,PR,00738-0000,Private      ,40,77,117,1535,,1074,2609
00393808,INTER-AMER UNIV PR - GUAYAMA CAMPUS     ,PR,00785-4004,Private      ,25,75,100,1270,,1207,2477
00393809,INTER-AMER UNIV PR-PONCE REGIONAL       ,PR,00715-0000,Private      ,65,160,225,3793,,3016,6809
00393811,INTER-AMER UNIV PR-BAYAMON REG CLG      ,PR,00959-0000,Private      ,84,103,187,4065,,1785,5850
00394100,COLEGIO UNIVERSITARIO DEL ESTE          ,PR,00983-0000,Private      ,205,620,825,7443,,7926,15369
00394200,UNIVERSITY OF PR-CENTRAL ADMINISTRATION ,PR,00936-4984,Public       ,10,27,37,388,,275,663
00394300,UNIVERSITY OF PUERTO RICO - HUMACAO UNIV,PR,00791-4300,Public       ,26,26,52,3188,,464,3652
00394400,UNIVERSITY OF PUERTO RICO - MAYAGUEZ    ,PR,00680-0000,Public       ,124,95,219,8915,,1932,10847
00501900,UNIV ADVENTISTA DE LAS ANTILLAS         ,PR,00681-0118,Private      ,16,31,47,1015,,609,1624
00502200,BAYAMON CENTRAL UNIVERSITY              ,PR,00960-0000,Private      ,24,84,108,1126,,1219,2345
00710800,UNIVERSITY OF PUERTO RICO - RIO PIEDRAS ,PR,00931-3300,Public       ,142,164,306,9228,,3230,12458
00720600,UNIVERSITY OF PUERTO RICO - CAYEY UNIVER,PR,00736-5534,Public       ,31,14,45,3620,,441,4061
00722800,UNIVERSITY OF PUERTO RICO - ARECIBO     ,PR,00614-4010,Public       ,40,29,69,3755,,605,4360
00890200,COLUMBIA CENTRO UNIVERSITARIO           ,PR,00726-0000,Proprietary  ,103,154,257,1347,,1256,2603
00965200,"UNIVERSITY OF PUERTO RICO, PONCE TECH UN",PR,00716-0000,Public       ,38,29,67,3408,,462,3870
01056700,COLEGIO TECNOLOGICO DE SAN JUAN         ,PR,00918-2973,Public       ,21,58,79,776,,818,1594
01072400,CARLOS ALBIZU UNIVERSITY                ,PR,00902-3711,Private      ,5,43,48,110,,895,1005
01081900,CONSERVATORIO DE MUSICA DE PUERTO RICO  ,PR,00907-3373,Public       ,2,4,6,350,,132,482
01092200,UNIVERSITY OF PUERTO RICO - UTUADO      ,PR,00641-2500,Public       ,19,6,25,1596,,272,1868
01097500,UNIVERSITY OF PUERTO RICO BAYAMON TECHNI,PR,00959-1911,Public       ,43,33,76,4569,,681,5250
01120300,RYDER MEMORIAL HOSP SCH OF NURSING      ,PR,00792-0000,Private      ,5,0,5,19,,17,36
01171900,UNIVERSIDAD DEL TURABO                  ,PR,00778-0000,Private      ,176,799,975,8696,,10519,19215
01194000,ICPR JUNIOR COLLEGE                     ,PR,00919-0000,Proprietary  ,95,134,229,1476,,1870,3346
01194100,AMERICAN UNIVERSITY OF PUERTO RICO      ,PR,00960-2037,Private      ,28,69,97,737,,566,1303
01194101,AMERICAN UNIVERSITY OF PUERTO RICO      ,PR,00674-0000,Private      ,47,66,113,736,,545,1281
01212300,"UNIVERSITY OF PUERTO RICO, AGUADILLA REG",PR,00604-0160,Public       ,38,22,60,2854,,533,3387
01252500,CARIBBEAN UNIVERSITY                    ,PR,00960-0493,Private      ,72,177,249,2496,,3030,5526
02063100,MBTI BUSINESS TRNG INSTITUTE            ,PR,00907-3917,Proprietary  ,268,835,1103,1325,,3777,5102
02100000,POLYTECHNIC UNIVERSITY OF PR            ,PR,00917-0000,Private      ,53,186,239,2319,,2257,4576
02163300,UNIVERSIDAD CENTRAL DEL CARIBE          ,PR,00960-0000,Private      ,2,21,23,201,,424,625
02165100,EDP COLLEGE OF PUERTO RICO              ,PR,00919-0000,Private      ,49,234,283,991,,1710,2701
02166000,CENTER FOR ADVANCED STUDIES OF PUER     ,PR,00902-0000,Private      ,0,27,27,5,,230,235
02166400,INSTITUTO DE BANCA Y COMERCIO           ,PR,00925-0000,Proprietary  ,1209,1563,2772,7936,,8789,16725
02170300,INST EDUC TECNIA OCUP LA REINA          ,PR,00674-0000,Proprietary  ,30,34,64,249,,260,509
02189100,CENTRO DE ESTUDIOS MULTIDISCIPLIN       ,PR,00926-0000,Private      ,87,136,223,1558,,1750,3308
02189300,EMMA'S BEAUTY ACADEMY                   ,PR,00680-0000,Proprietary  ,18,19,37,227,,116,343
02195400,MODERN HAIRSTYLING INSTITUTE            ,PR,00961-0000,Proprietary  ,52,50,102,697,,431,1128
02195500,MODERN HAIRSTYLING INSTITUTE            ,PR,00612-0000,Proprietary  ,0,2,2,8,,12,20
02195800,LICEO E ARTE Y TECNOLGIA                ,PR,00919-0000,Proprietary  ,76,121,197,734,,778,1512
02195900,MODERN HAIRSTYLING INSTITUTE            ,PR,00980-0000,Proprietary  ,0,2,2,13,,11,24
02234900,ANTILLES SCHOOL OF TECH CAREERS         ,PR,00909-3006,Proprietary  ,52,114,166,278,,388,666
02241901,COMMONWEALTH OF PR DEPT OF EDUC - CARLOS,PR,00986-0000,Public       ,0,1,1,11,,15,26
02241902,COMMONWEALTH OF PR DEPT OF EDUC - TOMAS ,PR,00613-0000,Public       ,0,1,1,3,,4,7
02241904,COMMONWEALTH OF PR DEPT OF EDUC - ITPR R,PR,00655-0000,Public       ,22,29,51,556,,375,931
02241905,COMMONWEALTH OF PR DEPT OF EDUC - JOSE A,PR,00674-0000,Public       ,0,1,1,37,,21,58
02241907,COMMONWEALTH OF PR DEPT OF EDUC - ITPR R,PR,00928-0000,Public       ,3,9,12,297,,206,503
02241908,COMMONWEALTH OF PR DEPT OF EDUC - ITPR R,PR,00732-0000,Public       ,8,19,27,462,,273,735
02241909,COMMONWEALTH OF PR DEPT OF EDUC - TROQUE,PR,00959-0000,Public       ,0,2,2,60,,20,80
02241910,COMMONWEALTH OF PR DEPT OF EDUC - ITPR R,PR,00701-1091,Public       ,5,7,12,590,,224,814
02260600,NATIONAL COLLEGE OF BUSINESS & TECH     ,PR,00960-2036,Proprietary  ,287,1224,1511,4819,,8907,13726
02260800,HUERTAS JUNIOR COLLEGE                  ,PR,00726-0000,Proprietary  ,38,55,93,910,,967,1877
02297700,AUTOMECA TECHNICAL COLLEGE              ,PR,00957-0000,Proprietary  ,61,98,159,1051,,627,1678
02303800,AMERICAN EDUCATIONAL COLLEGE            ,PR,00961-0000,Proprietary  ,51,123,174,287,,580,867
02335500,COLEGIO BIBLICO PENTECOSTAL DE PR       ,PR,00978-0000,Private      ,1,9,10,26,,207,233
02340600,HUMACAO COMMUNITY COLLEGE               ,PR,00792-0000,Private      ,10,22,32,414,,445,859
02343600,INSTITUTE OF BEAUTY CAREERS             ,PR,00613-0000,Proprietary  ,29,35,64,334,,235,569
02460000,UNIVERSITY OF PUERTO RICO - MEDICAL SCIE,PR,00936-0000,Public       ,11,34,45,685,,1481,2166
02482400,PONCE SCHOOL OF MEDICINE AND HEALTH SCIE,PR,00716-2347,Private      ,5,15,20,84,,739,823
02502400,SERBIA'S SCHOOL OF BEAUTY CULTURE       ,PR,00785-0000,Proprietary  ,25,59,84,147,,251,398
02504500,INSTITUCION CHAVIANO DE MAYAGUEZ        ,PR,00708-0000,Proprietary  ,10,15,25,30,,61,91
02505400,ATLANTIC COLLEGE                        ,PR,00970-0000,Private      ,39,37,76,1204,,433,1637
02534900,PONCE PARAMEDICAL COLLEGE (POPAC)       ,PR,00731-0000,Proprietary  ,98,125,223,1766,,1320,3086
02552300,COLEGIO MAYOR DE TECHNOLOGIA            ,PR,00714-0000,Proprietary  ,12,21,33,158,,191,349
02562500,INTERNATIONAL TECHNICAL COLLEGE         ,PR,00918-0000,Proprietary  ,7,17,24,60,,90,150
02563500,ROGIES SCHOOL OF BEAUTY CULTURE         ,PR,00910-0000,Proprietary  ,4,4,8,48,,60,108
02569400,ESCUELA DE ARTES PLASTICAS              ,PR,00902-1112,Public       ,12,18,30,423,,164,587
02570400,EDUCATIONAL TECHNICAL COLLEGE           ,PR,00925-3404,Proprietary  ,37,113,150,465,,814,1279
02576100,ESCUELA TECNICA DE ELECTRICIDAD         ,PR,00731-0000,Proprietary  ,15,29,44,256,,266,522
02587500,UNIVERSIDAD METROPOLITANA               ,PR,00928-0000,Private      ,192,659,851,6927,,8649,15576
02588600,SEMINARIO EVANGELICO DE PUERTO RICO     ,PR,00925-0000,Private      ,0,14,14,3,,66,69
02593700,HISPANIC AMERICAN COLLEGE               ,PR,00725-0000,Proprietary  ,36,50,86,196,,280,476
03016000,UNIVERSITY OF PUERTO RICO CAROLINA REGIO,PR,00985-0000,Public       ,51,58,109,3756,,743,4499
03021900,EDIC COLLEGE                            ,PR,00726-0000,Proprietary  ,51,94,145,1115,,1038,2153
03025500,MECH TECH COLLEGE                       ,PR,00725-6118,Proprietary  ,201,223,424,2854,,1784,4638
03025900,"LICEO DE ARTE, DISENOS Y COMERCIO       ",PR,00726-0000,Proprietary  ,26,46,72,227,,363,590
03029700,"UNIVERSAL TECHNOLOGY CLG OF PR, INC     ",PR,00605-1955,Private      ,18,51,69,517,,910,1427
03061900,COLEGIO TECHNOLOGICO Y COMERCIAL        ,PR,00602-0960,Proprietary  ,6,5,11,40,,59,99
03068400,STAR BEAUTY ACADEMY                     ,PR,00961-6312,Proprietary  ,9,15,24,40,,51,91
03070500,D'MART INSTITUTE                        ,PR,00794-3517,Proprietary  ,45,105,150,538,,799,1337
03075600,EMMA'S BEAUTY ACADEMY                   ,PR,00795-0000,Proprietary  ,24,39,63,295,,173,468
03085700,PROFESSIONAL TECHNICAL INSTITUTION      ,PR,00960-7061,Proprietary  ,20,28,48,219,,233,452
03104400,PROFESSIONAL ELECTRIC SCHOOL            ,PR,00674-1797,Proprietary  ,2,9,11,40,,44,84
03106900,ESCUELA DE PERITOS ELECTRICITAS         ,PR,00662-0457,Proprietary  ,1,11,12,51,,48,99
03112100,JOHN DEWEY COLLEGE                      ,PR,00915-9538,Private      ,119,275,394,1612,,3302,4914
03112101,JOHN DEWEY COLLEGE                      ,PR,00986-0000,Private      ,33,64,97,382,,684,1066
03112102,JOHN DEWEY COLLEGE-BAYAMON CAMPUS       ,PR,00959-0000,Private      ,5,16,21,130,,274,404
03112104,JOHN DEWEY COLLEGE - YABUCOA LRNING SITE,PR,00767-0767,Private      ,0,0,0,23,,33,56
03112105,JOHN DEWEY COLLEGE - FAJARDO BRANCH     ,PR,00738-0738,Private      ,12,38,50,167,,284,451
03112106,JOHN DEWEY COLLEGE - ARROYO BRANCH      ,PR,00714-0714,Private      ,6,14,20,62,,108,170
03112107,JOHN DEWEY COLLEGE - JUANA DIAZ BRANCH  ,PR,00795-0000,Private      ,10,32,42,186,,257,443
03112108,JOHN DEWEY COLLEGE - HATILLO CAMPUS     ,PR,00659-0000,Private      ,12,21,33,110,,201,311
03112109,JOHN DEWEY COLLEGE - MANATI             ,PR,00674-0000,Private      ,27,48,75,335,,515,850
03115900,TRINITY COLLEGE OF PUERTO RICO          ,PR,00734-0000,Private      ,10,24,34,163,,225,388
03122500,ACADEMIA SERRANT INC.                   ,PR,00717-1568,Proprietary  ,46,81,127,207,,255,462
03123100,GLOBELLE TECHNICAL INSTITUTE            ,PR,00693-4218,Proprietary  ,14,11,25,75,,72,147
03124200,NOVA COLLEGE DE PUERTO RICO             ,PR,00960-4016,Proprietary  ,19,44,63,123,,241,364
03157600,"COLEGIO DE CINEMATOGRAFIA, ARTES Y TELEV",PR,00961-6345,Proprietary  ,37,41,78,726,,407,1133
03177300,SAN JUAN BAUTISTA SCH OF MEDICINE       ,PR,00726-0000,Private      ,1,8,9,24,,322,346
03336300,CENTURY COLLEGE                         ,PR,00603-0000,Proprietary  ,10,25,35,112,,172,284
03414300,MONTECLARO                              ,PR,00745-9612,Private      ,0,4,4,16,,23,39
03452300,INSTITUTO PRE-VOCACIONAL E INDUSTRI     ,PR,00613-1800,Private      ,5,36,41,79,,185,264
03469300,IVAEM COLLEGE                           ,PR,00725-0000,Proprietary  ,0,3,3,103,,57,160
03531300,UNIVERSIDAD PENTECOSTAL MIZPA           ,PR,00928-0966,Private      ,2,5,7,31,,316,347
03544300,ATENAS COLLEGE                          ,PR,00674-0000,Private      ,33,73,106,966,,806,1772
03552300,LESTON COLLEGE                          ,PR,00961-6309,Proprietary  ,29,33,62,118,,115,233
03585300,CENTRO DE CAPACITACION Y ASESORAMIE     ,PR,00612-0000,Private      ,0,0,0,1,,9,10
03608300,CARIBBEAN FORENSIC & TECHNICAL COLL     ,PR,00926-0000,Proprietary  ,6,14,20,43,,88,131
03638300,ROSSLYN TRAINING ACADEMY OF COSMETOLOGY ,PR,00602-3225,Proprietary  ,1,13,14,24,,54,78
03735400,"CHARLIES GUARD,DETECTIVE BUREAU&ACA     ",PR,00605-0000,Proprietary  ,18,11,29,58,,55,113
03751300,ESCUELA HOTELERA DE SAN JUAN            ,PR,00917-0091,Proprietary  ,65,71,136,711,,454,1165
03758300,BAYAMON COMMUNITY COLLEGE               ,PR,00960-0000,Proprietary  ,10,45,55,79,,230,309
03781400,INDUSTRIAL TECHNICAL COLLEGE            ,PR,00792-0000,Proprietary  ,15,27,42,136,,227,363
03785300,J.G. GUAYNABO TECHNICAL COLLEGE         ,PR,00960-0000,Proprietary  ,5,12,17,38,,86,124
03800300,COLEGIO TECNICO DE ELECTRICIDAD GALLOSA ,PR,00602-0000,Proprietary  ,3,4,7,22,,39,61
03800400,INSTITUTE OF BEAUTY OCCUPATIONS AND TECH,PR,00676-5071,Proprietary  ,29,48,77,92,,119,211
03843300,ADVANCED TECH COLLEGE                   ,PR,00961-6321,Proprietary  ,5,15,20,41,,99,140
03849300,AGUADILLA TECHNICAL COLLEGE             ,PR,00603-0000,Proprietary  ,4,20,24,36,,85,121
03965400,MYRANGEL BEAUTY INSTITUTE               ,PR,00754-3917,Proprietary  ,29,62,91,115,,169,284
04030300,"ASPIRA DE PUERTO RICO, ACADEMIA DE TECNO",PR,00987-0000,Private      ,0,0,0,2,,4,6
04107300,CARIB TECHNOLOGICAL INSTITUTE           ,PR,00960-0000,Proprietary  ,24,32,56,87,,194,281
04117200,INSTITUTO EDUCATIVO PREMIER             ,PR,00731-0000,Proprietary  ,34,44,78,152,,197,349
04131600,LIBERTY TECHNICAL COLLEGE               ,PR,00737-1298,Proprietary  ,10,10,20,83,,108,191
04164300,GLOBAL INSTITUTE                        ,PR,00725-6485,Proprietary  ,9,11,20,27,,28,55
04176000,AMERICAN TECHNICAL INSTITUTE            ,PR,00957-0000,Proprietary  ,2,5,7,20,,44,64
00394600,UNIVERSITY OF THE VIRGIN ISLANDS        ,VI,00802-9990,Public       ,60,65,125,1156,,856,2012
00394601,UNIV OF THE VIRGIN ISLANDS-ST CROIX     ,VI,00850-0000,Public       ,26,45,71,598,,670,1268
00667700,MCGILL UNIVERSITY                       ,CN,00000-0000,Public       ,45,19,64,1539,,444,1983
00667900,QUEEN'S UNIVERSITY AT KINGSTON          ,CN,00000-0000,Public       ,1,3,4,106,,41,147
00668100,ST FRANCIS XAVIER UNIVERSITY            ,CN,00000-0000,Public       ,1,0,1,26,,10,36
00668200,ST THOMAS UNIVERSITY                    ,CN,00000-0000,Public       ,1,0,1,47,,5,52
00668300,UNIVERSITY OF GUELPH                    ,CN,00000-0000,Public       ,1,3,4,48,,85,133
00668400,UNIVERSITY OF MANITOBA                  ,CN,00000-0000,Public       ,2,0,2,59,,48,107
00668500,UNIVERSITY OF NEW BRUNSWICK (THE)       ,CN,00000-0000,Public       ,0,1,1,29,,18,47
00668600,UNIVERSITY OF OTTAWA                    ,CN,00000-0000,Public       ,3,4,7,55,,79,134
00668800,UNIVERSITY OF TORONTO                   ,CN,00000-0000,Public       ,18,23,41,359,,393,752
00668900,UNIVERSITY OF WINDSOR                   ,CN,00000-0000,Public       ,2,8,10,28,,57,85
00683700,UNIVERSITE LAVAL                        ,CN,00000-0000,Public       ,1,4,5,11,,36,47
00683800,DALHOUSIE UNIVERSITY                    ,CN,00000-0000,Public       ,4,3,7,132,,65,197
00683805,DALHOUSIE UNIVERSITY - AGRICULTURAL CAMP,CN,00000-0000,Public       ,0,0,0,2,,4,6
00685200,BISHOP'S UNIVERSITY                     ,CN,00000-0000,Private      ,0,1,1,65,,7,72
00685300,MCMASTER UNIVERSITY                     ,CN,00000-0000,Public       ,2,2,4,24,,30,54
00767900,YORK UNIVERSITY                         ,CN,00000-0000,Public       ,6,9,15,88,,107,195
00787400,UNIVERSITY AT CALGARY (THE)             ,CN,00000-0000,Public       ,3,7,10,50,,71,121
00814800,UNIVERSITY OF WINNIPEG                  ,CN,00000-0000,Public       ,2,0,2,28,,16,44
00836200,UNIVERSITY OF ALBERTA (THE)             ,CN,00000-0000,Public       ,3,7,10,50,,46,96
00836300,MOUNT SAINT VINCENT UNIVERSITY          ,CN,00000-0000,Public       ,0,0,0,10,,7,17
00836400,SAINT MARY'S UNIVERSITY                 ,CN,00000-0000,Public       ,1,0,1,16,,15,31
00836500,CONCORDIA UNIVERSITY - SIR GEORGE W     ,CN,00000-0000,Public       ,16,12,28,277,,167,444
00836600,UNIVERSITE DE MONTREAL                  ,CN,00000-0000,Public       ,2,5,7,26,,65,91
00836800,CARLETON UNIVERSITY                     ,CN,00000-0000,Public       ,9,4,13,71,,43,114
00836900,UNIVERSITY OF BRITISH COLUMBIA          ,CN,00000-0000,Public       ,38,36,74,876,,565,1441
00837000,"SAFA, UNIVERSITY OF VICTORIA            ",CN,00000-0000,Public       ,3,9,12,140,,68,208
00844400,SIMON FRASER UNIVERSITY                 ,CN,00000-0000,Public       ,5,9,14,150,,110,260
00844600,UNIVERSITY OF WESTERN ONTARIO (THE)     ,CN,00000-0000,Public       ,2,8,10,55,,85,140
00844800,UNIVERSITY OF REGINA                    ,CN,00000-0000,Public       ,0,0,0,8,,10,18
00844900,ACADIA UNIVERSITY                       ,CN,00000-0000,Public       ,1,4,5,54,,16,70
00852600,UNIVERSITY OF WATERLOO                  ,CN,00000-0000,Public       ,2,0,2,56,,30,86
00858200,WILFRID LAURIER UNIVERSITY              ,CN,00000-0000,Public       ,1,2,3,11,,12,23
00891300,LAKEHEAD UNIVERSITY                     ,CN,00000-0000,Public       ,0,1,1,8,,8,16
00911900,UNIVERSITE DE MONCTON                   ,CN,00000-0000,Public       ,0,0,0,1,,1,2
00925200,BROCK UNIVERSITY                        ,CN,00000-0000,Public       ,0,0,0,12,,12,24
00936700,UNIVERSITY OF PRINCE EDWARD ISLAND      ,CN,00000-0000,Public       ,0,0,0,22,,106,128
00942100,BRANDON UNIVERSITY                      ,CN,00000-0000,Public       ,0,1,1,13,,13,26
00948600,TRINITY WESTERN UNIVERSITY              ,CN,00000-0000,Private      ,4,5,9,127,,64,191
00950000,MEMORIAL UNIVERSITY OF NEWFOUNDLAND     ,CN,00000-0000,Public       ,0,2,2,16,,30,46
00950100,UNIVERSITY OF KING'S COLLEGE            ,CN,00000-0000,Public       ,0,0,0,32,,5,37
00950300,MOUNT ALLISON UNIVERSITY                ,CN,00000-0000,Public       ,2,0,2,33,,3,36
00950500,TRENT UNIVERSITY                        ,CN,00000-0000,Public       ,2,0,2,10,,3,13
00969800,MEDICINE HAT COLLEGE                    ,CN,00000-0000,Public       ,1,0,1,5,,4,9
01012300,NOVA SCOTIA COLLEGE OF ART & DESIGN     ,CN,00000-0000,Public       ,1,3,4,15,,13,28
01022100,SAINT PAUL UNIVERSITY                   ,CN,00000-0000,Public       ,0,1,1,4,,19,23
01045800,SHERIDAN COLLEGE OF APPLIED ARTS AN     ,CN,00000-0000,Public       ,8,2,10,61,,28,89
01067500,REGENT COLLEGE                          ,CN,00000-0000,Private      ,0,1,1,7,,75,82
01070300,UNIVERSITY OF LETHBRIDGE                ,CN,00000-0000,Public       ,0,0,0,5,,7,12
01072000,RYERSON UNIVERSITY                      ,CN,00000-0000,Public       ,5,10,15,63,,69,132
01172200,BRIERCREST BIBLE COLLEGE                ,CN,00000-0000,Private      ,0,0,0,9,,6,15
01222800,HUMBER COLLEGE                          ,CN,00000-0000,Public       ,6,2,8,44,,52,96
01227400,PROVIDENCE COLLEGE                      ,CN,00000-0000,Private      ,0,0,0,32,,5,37
02102100,KINGSWOOD UNIVERSITY                    ,CN,00000-0000,Private      ,0,0,0,63,,18,81
02167000,PRAIRIE BIBLE INST                      ,CN,00000-0000,Private      ,0,0,0,13,,6,19
02184600,INSTITUTE FOR CHRISTIAN STUDIES         ,CN,00000-0000,Private      ,0,1,1,4,,2,6
02195700,TAYLOR UNIVERSITY COLLEGE AND SEMINARY  ,CN,00000-0000,Private      ,1,0,1,2,,4,6
02201100,COLUMBIA BIBLE COLLEGE                  ,CN,00000-0000,Private      ,0,2,2,14,,14,28
02216400,TYNDALE COLLEGE & SEMINARY              ,CN,00000-0000,Private      ,0,1,1,6,,15,21
02219200,UNIVERSITY OF SASKATCHEWAN              ,CN,00000-0000,Public       ,2,2,4,15,,30,45
02324900,EMMANUEL BIBLE COLLEGE                  ,CN,00000-0000,Private      ,0,0,0,1,,1,2
02338800,EMILY CARR UNIVERSITY OF ART AND DESIGN ,CN,00000-0000,Public       ,2,4,6,72,,53,125
02577200,SALVATION ARMY WM & CATHERINE BOOTH     ,CN,00000-0000,Private      ,0,1,1,3,,1,4
02593800,CONCORDIA UNIVERSITY COLLEGE            ,CN,00000-0000,Private      ,2,4,6,12,,14,26
02611900,THE KING'S UNIVERSITY COLLEGE           ,CN,00000-0000,Private      ,0,1,1,3,,7,10
03018300,ROCKY MOUNTAIN COLLEGE: CENTRE FOR BIBLI,CN,00000-0000,Private      ,0,1,1,2,,2,4
03033800,UNIVERSITY COLLEGE OF CAPE BRETON       ,CN,00000-0000,Public       ,0,0,0,6,,6,12
03078300,VANCOUVER SCHOOL OF THEOLOGY            ,CN,00000-0000,Private      ,1,2,3,2,,11,13
03273300,CANADIAN COLLEGE OF NATUROPATHIC ME     ,CN,00000-0000,Private      ,1,4,5,3,,21,24
03298300,ALBERTA COLLEGE OF ART & DESIGN         ,CN,00000-0000,Public       ,3,8,11,26,,28,54
03332500,KWANTLEN UNIVERSITY COLLEGE             ,CN,00000-0000,Public       ,1,1,2,5,,15,20
03335400,CANADIAN UNIVERSITY COLLEGE             ,CN,00000-0000,Private      ,2,5,7,47,,23,70
03339300,ST. STEPHENS UNIVERSITY                 ,CN,00000-0000,Private      ,0,0,0,3,,2,5
03348500,REDEEMER UNIVERSITY COLLEGE             ,CN,00000-0000,Private      ,0,0,0,14,,3,17
03420300,HOLLAND COLLEGE                         ,CN,00000-0000,Public       ,0,2,2,13,,10,23
03560400,NIAGARA COLLEGE-WELLAND CAMPUS          ,CN,00000-0000,Public       ,1,1,2,16,,13,29
03613300,UNIV OF NORTHERN BRITISH COLUMBIA       ,CN,00000-0000,Public       ,0,4,4,7,,18,25
03644400,CANADIAN MENNONITE UNIVERSITY           ,CN,00000-0000,Private      ,1,3,4,8,,4,12
03674400,CANADIAN SOUTHERN BAPTIST SEMINARY      ,CN,00000-0000,Private      ,0,2,2,1,,4,5
03711300,CAPILANO UNIVERSITY                     ,CN,00000-0000,Public       ,1,5,6,17,,23,40
03846300,PACIFIC LIFE BIBLE COLLEGE              ,CN,00000-0000,Private      ,1,1,2,12,,5,17
03847300,CRANDALL UNIVERSITY                     ,CN,00000-0000,Private      ,0,0,0,3,,3,6
04075300,QUEST UNIVERSITY CANADA                 ,CN,00000-0000,Private      ,5,0,5,145,,7,152
04123100,ATLANTIC SCHOOL OF THEOLOGY             ,CN,00000-0000,Public       ,0,2,2,1,,7,8
04156700,AMBROSE UNIVERSITY COLLEGE              ,CN,00000-0000,Private      ,1,5,6,11,,14,25
00814700,UNIVERSIDAD AUTONOMA DE GUADALAJARA     ,MX,00000-0000,Private      ,3,262,265,84,,1261,1345
01041800,INST TEC Y DE ESTSUPER DE MONTERRE      ,MX,00000-0000,Private      ,10,8,18,94,,73,167
01067600,UNIVERSIDAD DE MONTERREY                ,MX,00000-0000,Private      ,2,4,6,34,,39,73
01093800,UNIVERSIDAD DE GUANAJUATO               ,MX,00000-0000,Public       ,2,2,4,26,,43,69
01230100,UNIV AUTON DE TAMAULIPAS FAC DEMED      ,MX,00000-0000,Public       ,0,2,2,0,,5,5
02053300,CENTRO DE ESTUDIOS UNIVERSITARIOS D     ,MX,00000-0000,Private      ,4,7,11,53,,83,136
04183900,CETYS UNIVERSIDAD                       ,MX,00000-0000,Private      ,5,9,14,100,,67,167
01001000,AMERICAN SAMOA CMNTY COLLEGE            ,AS,96799-2609,Public       ,34,32,66,1206,,417,1623
01034300,COLLEGE OF MICRONESIA - FSM             ,FM,96941-0159,Public       ,319,153,472,2075,,945,3020
01100900,PALAU COMMUNITY COLLEGE                 ,PW,96940-0009,Public       ,46,22,68,769,,306,1075
03022400,COLLEGE OF THE MARSHALL ISLANDS         ,MH,96960-1258,Public       ,267,48,315,813,,340,1153
03033000,NORTHERN MARIANAS COLLEGE               ,MP,96950-0000,Public       ,63,41,104,914,,479,1393
