OPE ID,School,State,Zip Code,School Type,20142015Qtr2_Dependent Students,20142015Qtr2_Independent Students,Quarterly Total,YTD_20142015Qtr2_Dependent Students,YTD_20142015Qtr2_Independent Students,Award Year To Date Total
00100200,ALABAMA AGRCLTL & MECHL UNIV            ,AL,35762-1357,Public       ,1789,1220,3009,5422,2435,7857
00100300,FAULKNER UNIVERSITY                     ,AL,36109-3398,Private      ,532,1446,1978,1863,2617,4480
00100400,UNIVERSITY OF MONTEVALLO                ,AL,35115-6000,Public       ,709,508,1217,2200,1054,3254
00100500,ALABAMA STATE UNIVERSITY                ,AL,36101-0000,Public       ,2568,1775,4343,7976,3777,11753
00100700,CENTRAL ALABAMA COMMUNITY COLLEGE       ,AL,35011-0000,Public       ,331,534,865,1024,960,1984
00100800,ATHENS STATE UNIVERSITY                 ,AL,35611-1999,Public       ,346,1232,1578,708,2249,2957
00100900,AUBURN UNIVERSITY                       ,AL,36849-5113,Public       ,3496,2172,5668,17062,5219,22281
00101200,BIRMINGHAM SOUTHERN COLLEGE             ,AL,35254-0002,Private      ,294,216,510,1843,496,2339
00101300,CALHOUN COMMUNITY COLLEGE               ,AL,35609-0000,Public       ,1745,2722,4467,3621,4735,8356
00101500,ENTERPRISE STATE COMMUNITY COLLEGE      ,AL,36331-1300,Public       ,366,510,876,950,930,1880
00101600,UNIVERSITY OF NORTH ALABAMA             ,AL,35632-0001,Public       ,1675,1005,2680,4204,1933,6137
00101700,GADSDEN STATE COMMUNITY COLLEGE         ,AL,35903-2269,Public       ,999,1670,2669,2262,3046,5308
00101800,GEORGE C WALLACE COMMUNITY COLLEGE      ,AL,36303-0943,Public       ,810,1429,2239,1708,2437,4145
00101900,HUNTINGDON COLLEGE                      ,AL,36106-2148,Private      ,452,283,735,1276,538,1814
00102000,JACKSONVILLE STATE UNIVERSITY           ,AL,36265-1602,Public       ,2289,2208,4497,6106,3892,9998
00102100,JEFFERSON DAVIS COMMUNITY COLLEGE       ,AL,36427-2790,Public       ,194,301,495,383,537,920
00102200,JEFFERSON STATE COMMUNITY COLLEGE       ,AL,35215-3098,Public       ,1884,2912,4796,3580,5284,8864
00102300,JUDSON COLLEGE                          ,AL,36756-2504,Private      ,92,56,148,287,120,407
00102400,UNIVERSITY OF WEST ALABAMA              ,AL,35470-0000,Public       ,804,1450,2254,2115,2574,4689
00102600,MARION MILITARY INSTITUTE               ,AL,36756-3214,Public       ,191,35,226,473,66,539
00102800,MILES COLLEGE                           ,AL,35064-2697,Private      ,830,459,1289,2120,918,3038
00102900,UNIVERSITY OF MOBILE                    ,AL,36613-0000,Private      ,677,776,1453,1635,1359,2994
00103000,BISHOP STATE COMMUNITY COLLEGE          ,AL,36603-5898,Public       ,948,1662,2610,1666,2860,4526
00103100,NORTHEAST ALABAMA STATE CMNTY COLG      ,AL,35986-0159,Public       ,391,495,886,822,842,1664
00103300,OAKWOOD COLLEGE                         ,AL,35896-0001,Private      ,550,379,929,1477,757,2234
00103400,ALABAMA SOUTHERN COMMUNITY COLLEGE      ,AL,36460-5698,Public       ,437,321,758,844,570,1414
00103600,SAMFORD UNIVERSITY                      ,AL,35229-7000,Private      ,596,985,1581,3455,2195,5650
00103800,SNEAD STATE COMMUNITY COLLEGE           ,AL,35957-0734,Public       ,487,628,1115,1331,1132,2463
00104000,SOUTHERN UNION STATE COMMUNITY CLG      ,AL,36276-0000,Public       ,1163,1131,2294,2771,2136,4907
00104100,SPRING HILL COLLEGE                     ,AL,36608-1791,Private      ,528,321,849,2319,640,2959
00104400,STILLMAN COLLEGE                        ,AL,35403-0000,Private      ,648,240,888,1634,519,2153
00104600,TALLADEGA COLLEGE                       ,AL,35160-2354,Private      ,350,169,519,1004,369,1373
00104700,TROY UNIVERSITY                         ,AL,36082-0001,Public       ,2731,6599,9330,7190,11919,19109
00105000,TUSKEGEE UNIVERSITY                     ,AL,36088-1645,Private      ,1050,392,1442,4565,1196,5761
00105100,UNIVERSITY OF ALABAMA (THE)             ,AL,35487-0120,Public       ,5564,3684,9248,25293,8676,33969
00105200,UNIVERSITY OF ALABAMA AT BIRMINGHAM     ,AL,35294-1150,Public       ,3275,4863,8138,10193,9599,19792
00105500,UNIVERSITY OF ALABAMA IN HUNTSVILLE     ,AL,35899-0001,Public       ,1453,1702,3155,4179,3195,7374
00105700,UNIVERSITY OF SOUTH ALABAMA             ,AL,36688-0002,Public       ,3889,4222,8111,9230,7639,16869
00105900,LAWSON STATE COMMUNITY COLLEGE          ,AL,35221-1798,Public       ,814,1164,1978,1550,2051,3601
00105901,LAWSON STATE COMMUNITY COLLEGE - BESSEME,AL,35021-0308,Public       ,271,501,772,545,901,1446
00106000,FAULKNER STATE COMMUNITY COLLEGE        ,AL,36507-2698,Public       ,1420,1380,2800,2637,2411,5048
00526000,J.F. DRAKE STATE TECH COLLEGE           ,AL,35811-1584,Public       ,227,707,934,415,1212,1627
00569100,SHELTON STATE COMMUNITY CLG             ,AL,35405-4017,Public       ,1476,1282,2758,2991,2393,5384
00569200,REID STATE TECHNICAL COLLEGE            ,AL,36401-0000,Public       ,82,184,266,151,338,489
00569700,NORTHWEST- SHOALS COMMUNITY COLLEGE     ,AL,35661-0000,Public       ,672,709,1381,1461,1233,2694
00569900,GEORGE C WALLACE STATE CMTY COLLEGE     ,AL,36703-0000,Public       ,462,525,987,820,914,1734
00573300,BEVILL STATE CMTY COLLEGE-WALKER        ,AL,35148-0000,Public       ,615,988,1603,1644,1808,3452
00573400,H. COUNCILL TRENHOLM STATE TECH COLLEGE ,AL,36108-0020,Public       ,303,634,937,538,1126,1664
00573401,H. C. TRENHOLM ST TECH COL-PATTERSON CAM,AL,36116-2612,Public       ,201,394,595,357,715,1072
00787100,GEORGE C WALLACE STATE CMTY CLG         ,AL,35077-2000,Public       ,1437,1614,3051,2703,2669,5372
00831000,AUBURN UNIVERSITY-MONTGOMERY            ,AL,36124-0000,Public       ,1234,1474,2708,3918,3352,7270
00898800,LURLEEN B WALLACE COMMUNITY COLLEGE     ,AL,36420-0418,Public       ,290,358,648,846,695,1541
01055400,CONCORDIA COLLEGE                       ,AL,36701-3323,Private      ,389,176,565,606,299,905
01218200,CHATTAHOOCHEE VALLEY CMTY CLG           ,AL,36869-7917,Public       ,396,762,1158,806,1359,2165
01303906,SOUTH UNIVERSITY - MONTGOMERY           ,AL,36116-1120,Proprietary  ,139,576,715,259,971,1230
02170600,UNITED STATES SPORTS ACADEMY            ,AL,36526-7055,Private      ,13,230,243,29,452,481
02199700,HERITAGE CHRISTIAN UNIVERSITY           ,AL,35630-0000,Private      ,10,31,41,21,47,68
02270400,SOUTHEASTERN BIBLE COLLEGE              ,AL,35244-2083,Private      ,39,97,136,88,189,277
02285000,PAUL MITCHELL THE SCHOOL HUNTSVILLE     ,AL,35758-0000,Proprietary  ,40,56,96,69,111,180
02296000,PRINCE INSTITUTE OF PROFESSIONAL STUDIES,AL,36117-0000,Proprietary  ,22,144,166,37,221,258
02341000,FORTIS COLLEGE                          ,AL,36609-0000,Proprietary  ,297,947,1244,449,1573,2022
02503400,AMRIDGE UNIVERSITY                      ,AL,36124-0000,Private      ,50,330,380,77,605,682
03010600,VIRGINIA COLLEGE                        ,AL,35209-5154,Proprietary  ,1869,9889,11758,2441,14054,16495
03010602,VIRGINIA COLLEGE - HUNTSVILLE           ,AL,35805-0000,Proprietary  ,68,303,371,134,570,704
03010607,VIRGINIA COLLEGE - MOBILE               ,AL,36608-1626,Proprietary  ,81,295,376,176,573,749
03010616,VIRGINIA COLLEGE - MONTGOMERY           ,AL,36117-2802,Proprietary  ,160,445,605,269,964,1233
03026516,REMINGTON COLLEGE - MOBILE              ,AL,36609-5593,Private      ,94,225,319,186,418,604
03032500,ALABAMA STATE CLG BARBER STYLING        ,AL,35215-0000,Proprietary  ,23,38,61,78,87,165
03361400,FORTIS COLLEGE                          ,AL,36535-0000,Proprietary  ,45,217,262,78,340,418
03459300,SOUTHEASTERN SCHOOL OF COSMETOLOGY      ,AL,35228-0000,Private      ,15,29,44,30,66,96
03783300,BLUE CLIFF CAREER COLLEGE               ,AL,63306-4749,Proprietary  ,43,130,173,63,210,273
03894300,HUNTSVILLE BIBLE COLLEGE                ,AL,35811-0000,Private      ,7,78,85,17,135,152
04066300,CARDIAC AND VASCULAR INSTITUTE OF ULTRAS,AL,36604-1411,Proprietary  ,27,130,157,47,206,253
04067300,SELMA UNIVERSITY                        ,AL,36701-0000,Private      ,62,110,172,136,281,417
04121500,COLUMBIA SOUTHERN UNIVERSITY            ,AL,36561-3815,Proprietary  ,185,5836,6021,377,11284,11661
04149200,XCELL ACADEMY-A PAUL MITCHELL PARTNER SC,AL,35216-4990,Proprietary  ,45,86,131,78,164,242
04187200,NEW BEGINNING COLLEGE OF COSMETOLOGY    ,AL,35950-2415,Proprietary  ,46,57,103,77,93,170
04187300,HAIR ACADEMY (THE)                      ,AL,36111-2201,Proprietary  ,25,34,59,39,68,107
04197500,UNIVERSITY ACADEMY OF HAIR DESIGN       ,AL,35476-3100,Proprietary  ,19,26,45,35,43,78
04211000,SALON PROFESSIONAL ACADEMY (THE)        ,AL,35816-1849,Proprietary  ,21,43,64,42,97,139
04217900,NUNATION SCHOOL OF COSMETOLOGY          ,AL,35064-2222,Proprietary  ,4,14,18,4,19,23
04226700,ALABAMA COLLEGE OF OSTEOPATHIC MEDICINE ,AL,36303-2251,Private      ,9,199,208,9,199,208
00111100,ALLAN HANCOCK COLLEGE                   ,CA,93454-6399,Public       ,1071,1810,2881,4075,3845,7920
00111300,ANTELOPE VALLEY COLLEGE                 ,CA,93536-5426,Public       ,1994,4035,6029,6427,8844,15271
00111600,ART CENTER COLLEGE OF DESIGN            ,CA,91103-1999,Private      ,252,333,585,1756,1261,3017
00111700,AZUSA PACIFIC UNIVERSITY                ,CA,91702-7000,Private      ,834,2229,3063,9639,7078,16717
00111800,BAKERSFIELD COLLEGE                     ,CA,93305-1299,Public       ,2054,3347,5401,10269,8655,18924
00111900,BARSTOW COMMUNITY COLLEGE               ,CA,92311-6608,Public       ,335,1105,1440,1024,2378,3402
00112000,AMER BAPT SEM OF THE WEST-BERKELEY      ,CA,94704-0000,Private      ,1,25,26,10,45,55
00112200,BIOLA UNIVERSITY                        ,CA,90639-0001,Private      ,631,582,1213,6157,1963,8120
00112300,BROOKS INSTITUTE                        ,CA,93103-1809,Proprietary  ,77,84,161,441,270,711
00112400,CABRILLO COLLEGE                        ,CA,95003-3194,Public       ,919,1501,2420,4372,3842,8214
00112500,CALIFORNIA BAPTIST UNIVERSITY           ,CA,92504-3297,Private      ,587,1309,1896,7366,4828,12194
00112700,CALIFORNIA COLLEGE OF THE ARTS          ,CA,94107-2206,Private      ,336,396,732,2261,1520,3781
00113100,CALIFORNIA INSTITUTE OF TECHNOLOGY      ,CA,91125-0001,Private      ,194,109,303,3719,602,4321
00113200,CALIFORNIA INSTITUTE OF THE ARTS        ,CA,91355-2397,Private      ,238,184,422,2545,1488,4033
00113300,CALIFORNIA LUTHERAN UNIVERSITY          ,CA,91360-2787,Private      ,313,497,810,5059,1427,6486
00113400,CALIFORNIA MARITIME ACADEMY             ,CA,94590-8181,Public       ,49,46,95,1175,376,1551
00113700,CALIF STATE UNIV-FULLERTON              ,CA,92831-3599,Public       ,2046,3439,5485,49250,21431,70681
00113800,"CALIFORNIA STATE UNIVERSITY, EAST BAY   ",CA,94542-3000,Public       ,834,2518,3352,17273,12622,29895
00113900,CALIF STATE UNIV-LONG BEACH             ,CA,90840-0006,Public       ,2299,3445,5744,58052,23930,81982
00114000,CALIF STATE UNIV-LOS ANGELES            ,CA,90032-4226,Public       ,1672,3573,5245,37180,21166,58346
00114100,"CALIF STATE UNIV, DOMINGUEZ HILLS       ",CA,90747-0001,Public       ,808,2573,3381,19042,14722,33764
00114200,CALIF STATE UNIV SAN BERNARDINO         ,CA,92407-2397,Public       ,1219,2537,3756,21585,12765,34350
00114300,CAL POLY STATE UNIVERSITY               ,CA,93407-0001,Public       ,1149,604,1753,39938,4486,44424
00114400,CALIF STATE POLYTECHNIC UNIV POMONA     ,CA,91768-2500,Public       ,1314,1608,2922,36402,11215,47617
00114600,CALIF STATE UNIV - CHICO                ,CA,95929-0001,Public       ,1270,1260,2530,23775,6740,30515
00114700,CALIF STATE UNIV - FRESNO               ,CA,93740-8026,Public       ,1554,2514,4068,26937,11986,38923
00114900,HUMBOLDT STATE UNIVERSITY               ,CA,95521-8299,Public       ,591,660,1251,13364,4259,17623
00115000,CALIF STATE UNIV-SACRAMENTO             ,CA,95819-6044,Public       ,2081,3601,5682,33620,18778,52398
00115100,SAN DIEGO STATE UNIVERSITY              ,CA,92182-1690,Public       ,2908,4076,6984,57241,19599,76840
00115300,CALIF STATE UNIV-NORTHRIDGE             ,CA,91330-8307,Public       ,2497,4033,6530,45656,21207,66863
00115400,SAN FRANCISCO STATE UNIVERSITY          ,CA,94132-1740,Public       ,1783,3103,4886,36577,16704,53281
00115500,SAN JOSE STATE UNIVERSITY               ,CA,95192-0036,Public       ,1890,3344,5234,34231,15906,50137
00115600,SONOMA STATE UNIVERSITY                 ,CA,94928-3609,Public       ,715,655,1370,13755,3425,17180
00115700,CALIF STATE UNIV-STANISLAUS             ,CA,95382-0299,Public       ,498,990,1488,10330,5708,16038
00116100,CERRITOS COLLEGE                        ,CA,90650-6296,Public       ,2517,3428,5945,15275,10277,25552
00116200,CHABOT COLLEGE                          ,CA,94545-2400,Public       ,1340,2289,3629,5756,5441,11197
00116300,CHAFFEY COLLEGE                         ,CA,91737-9400,Public       ,3009,4510,7519,13161,11202,24363
00116400,CHAPMAN UNIVERSITY                      ,CA,92866-1099,Private      ,540,618,1158,11664,3102,14766
00116453,CHAPMAN UNIVERSITY DALE E. FOWLER SCHOOL,CA,92866-0000,Private      ,8,205,213,69,1143,1212
00116500,CHURCH DIV SCH OF THE PACIFIC           ,CA,94709-0000,Private      ,2,12,14,4,55,59
00116600,CITRUS COLLEGE                          ,CA,91741-1899,Public       ,1473,1826,3299,8999,5641,14640
00116900,CLAREMONT GRADUATE UNIVERSITY           ,CA,91711-0000,Private      ,5,359,364,34,1518,1552
00117000,CLAREMONT MCKENNA COLLEGE               ,CA,91711-6400,Private      ,126,34,160,3447,183,3630
00117100,HARVEY MUDD COLLEGE                     ,CA,91711-5990,Private      ,25,14,39,2585,93,2678
00117200,PITZER COLLEGE                          ,CA,91711-6101,Private      ,154,44,198,2835,177,3012
00117300,POMONA COLLEGE                          ,CA,91711-6301,Private      ,320,48,368,4906,235,5141
00117400,SCRIPPS COLLEGE                         ,CA,91711-3948,Private      ,125,21,146,2093,159,2252
00117600,WEST HILLS COMMUNITY COLLEGE            ,CA,93210-1399,Public       ,258,416,674,1323,981,2304
00117700,COGSWELL POLYTECHNICAL COLLEGE          ,CA,94089-1210,Proprietary  ,67,52,119,516,217,733
00117800,COLLEGE OF MARIN                        ,CA,94904-2590,Public       ,165,442,607,988,1478,2466
00117801,COLG OF MARIN-INDIAN VALLEY CMPS        ,CA,94949-0000,Public       ,54,145,199,293,453,746
00117900,NOTRE DAME DE NAMUR UNIVERSITY          ,CA,94002-1997,Private      ,126,326,452,1693,1133,2826
00118100,COLLEGE OF SAN MATEO                    ,CA,94402-3784,Public       ,675,863,1538,3327,2237,5564
00118200,COLLEGE OF THE DESERT                   ,CA,92260-9305,Public       ,885,1591,2476,4921,4313,9234
00118300,HOLY NAMES UNIVERSITY                   ,CA,94619-1699,Private      ,82,254,336,895,895,1790
00118500,COLLEGE OF THE REDWOODS                 ,CA,95501-9300,Public       ,594,1091,1685,2306,2662,4968
00118600,COLLEGE OF THE SEQUOIAS                 ,CA,93277-2234,Public       ,1521,2263,3784,6144,5297,11441
00118700,COLLEGE OF THE SISKIYOUS                ,CA,96094-2899,Public       ,199,312,511,908,797,1705
00118701,COLLEGE OF THE SISKIYOUS - YREKA CENTER ,CA,96097-9538,Public       ,24,100,124,119,285,404
00119000,CONTRA COSTA COLLEGE                    ,CA,94806-3195,Public       ,436,913,1349,2146,2592,4738
00119100,DIABLO VALLEY COLLEGE                   ,CA,94523-1544,Public       ,1105,1687,2792,5745,4519,10264
00119200,CUESTA COLLEGE                          ,CA,93403-8106,Public       ,771,1089,1860,4132,2920,7052
00119300,CYPRESS COLLEGE                         ,CA,90630-5897,Public       ,1501,2107,3608,10268,6515,16783
00119600,DOMINICAN UNIVERSITY OF CALIFORNIA      ,CA,94901-2298,Private      ,90,227,317,2688,1102,3790
00119700,EL CAMINO COLLEGE                       ,CA,90506-0002,Public       ,2846,3762,6608,13850,9971,23821
00119701,COMPTON COMMUNITY COLLEGE               ,CA,90221-5393,Public       ,663,1547,2210,3242,4029,7271
00119900,FOOTHILL COLLEGE                        ,CA,94022-4597,Public       ,649,1292,1941,3521,3522,7043
00120000,FULLER THEOLOGICAL SEMINARY             ,CA,91182-0000,Private      ,3,384,387,14,1772,1786
00120100,FULLERTON COLLEGE                       ,CA,92832-2095,Public       ,2123,2439,4562,13803,7565,21368
00120200,GAVILAN COLLEGE                         ,CA,95020-9599,Public       ,605,688,1293,1765,1422,3187
00120300,GLENDALE COMMUNITY COLLEGE              ,CA,91208-2894,Public       ,1519,2446,3965,8934,6933,15867
00120500,GOLDEN GATE UNIVERSITY                  ,CA,94105-2967,Private      ,39,727,766,181,2318,2499
00120600,GOLDEN WEST COLLEGE                     ,CA,92647-2748,Public       ,1279,1956,3235,8404,5994,14398
00120700,GRADUATE THEOLOGICAL UNION              ,CA,94709-0000,Private      ,0,38,38,3,230,233
00120800,GROSSMONT COLLEGE                       ,CA,92020-1799,Public       ,1615,2555,4170,8380,7770,16150
00120900,HARTNELL COMMUNITY COLLEGE              ,CA,93901-1697,Public       ,963,1021,1984,3722,2466,6188
00121200,HUMPHREYS COLLEGE                       ,CA,95207-3896,Private      ,56,235,291,288,825,1113
00121400,IMPERIAL VALLEY COLLEGE                 ,CA,92251-9787,Public       ,1044,1257,2301,3681,2414,6095
00121500,LA SIERRA UNIVERSITY                    ,CA,92515-3332,Private      ,328,325,653,3587,1284,4871
00121600,UNIVERSITY OF LA VERNE                  ,CA,91750-4443,Private      ,359,1554,1913,5930,5348,11278
00121700,LASSEN COLLEGE                          ,CA,96130-3000,Public       ,140,203,343,469,440,909
00121800,LOMA LINDA UNIVERSITY                   ,CA,92350-0001,Private      ,167,1100,1267,1231,5507,6738
00121900,LONG BEACH CITY COLLEGE                 ,CA,90808-1780,Public       ,2209,3355,5564,16130,11393,27523
00122000,MASTER'S COLLEGE & SEMINARY (THE)       ,CA,91321-1200,Private      ,85,112,197,1277,373,1650
00122300,LOS ANGELES CITY COLLEGE                ,CA,90029-3588,Public       ,1805,4341,6146,9391,12471,21862
00122400,LOS ANGELES HARBOR COLLEGE              ,CA,90744-2397,Public       ,791,1393,2184,4040,4158,8198
00122600,LOS ANGELES PIERCE COLLEGE              ,CA,91371-0001,Public       ,2118,3190,5308,11882,9379,21261
00122700,LOS ANGELES TRADE TECH COLLEGE          ,CA,90015-4181,Public       ,1406,4083,5489,6260,10866,17126
00122800,LOS ANGELES VALLEY COLLEGE              ,CA,91401-4096,Public       ,1653,2896,4549,8672,8891,17563
00122900,SO CA UNIV  HEALTH SCIENCES             ,CA,90604-4051,Private      ,7,332,339,48,617,665
00123000,MARSHALL B. KETCHUM UNIVERSITY          ,CA,92831-1699,Private      ,4,209,213,17,554,571
00123200,AMERICAN RIVER COLLEGE                  ,CA,95841-4286,Public       ,2872,6814,9686,12925,16927,29852
00123300,SACRAMENTO CITY COLLEGE                 ,CA,95822-1386,Public       ,2271,4712,6983,13233,13716,26949
00123600,MENLO COLLEGE                           ,CA,94027-4301,Private      ,131,47,178,1657,192,1849
00123700,MERCED COMMUNITY COLLEGE                ,CA,95348-2898,Public       ,1190,1820,3010,5990,4592,10582
00123800,MILLS COLLEGE                           ,CA,94613-1301,Private      ,86,284,370,1902,1797,3699
00123900,MIRACOSTA COLLEGE                       ,CA,92056-3899,Public       ,1025,2210,3235,4617,5360,9977
00124000,MODESTO JUNIOR COLLEGE                  ,CA,95350-5800,Public       ,2174,3416,5590,9543,9291,18834
00124200,MONTEREY PENINSULA COLLEGE              ,CA,93940-4799,Public       ,590,947,1537,2858,2174,5032
00124300,MOUNT ST MARYS COLLEGE                  ,CA,90049-1599,Private      ,211,602,813,3543,2220,5763
00124500,MT. SAN ANTONIO COLLEGE                 ,CA,91789-1399,Public       ,2807,3806,6613,17594,12115,29709
00124600,MT SAN JACINTO COLLEGE                  ,CA,92583-2399,Public       ,2156,3743,5899,7798,9156,16954
00124700,NAPA VALLEY COLLEGE                     ,CA,94558-6236,Public       ,622,879,1501,2619,2127,4746
00124900,OCCIDENTAL COLLEGE                      ,CA,90041-3314,Private      ,97,70,167,4984,339,5323
00125000,ORANGE COAST COLLEGE - FIN AID OFF      ,CA,92628-5005,Public       ,2009,2682,4691,12720,8313,21033
00125100,OTIS COLLEGE OF ART AND DESIGN          ,CA,90045-3505,Private      ,214,204,418,1744,765,2509
00125200,HOPE INTERNATIONAL UNIVERSITY           ,CA,92631-0000,Private      ,104,286,390,788,915,1703
00125300,FRESNO PACIFIC UNIVERSITY               ,CA,93702-4798,Private      ,257,1066,1323,2466,3409,5875
00125400,PACIFIC LUTHERAN THEOLOGICAL SEM        ,CA,94708-0000,Private      ,0,5,5,5,61,66
00125500,PACIFIC OAKS COLLEGE                    ,CA,91103-3606,Private      ,11,441,452,53,1189,1242
00125600,PACIFIC SCHOOL OF RELIGION              ,CA,94709-0000,Private      ,0,30,30,3,172,175
00125800,PACIFIC UNION COLLEGE                   ,CA,94508-9797,Private      ,272,138,410,1851,447,2298
00125900,PALO VERDE COLLEGE                      ,CA,92225-0000,Public       ,80,164,244,189,313,502
00126000,PALOMAR COLLEGE                         ,CA,92069-1486,Public       ,1977,2935,4912,8885,7201,16086
00126100,PASADENA CITY COLLEGE                   ,CA,91106-2003,Public       ,3401,4592,7993,17605,11388,28993
00126200,POINT LOMA NAZARENE UNIVERSITY          ,CA,92106-2899,Private      ,358,401,759,4394,1186,5580
00126600,LANEY COLLEGE                           ,CA,94607-4893,Public       ,823,2498,3321,3682,6028,9710
00126700,MERRITT COLLEGE                         ,CA,94619-3196,Public       ,476,1637,2113,2239,4031,6270
00126800,PORTERVILLE COLLEGE                     ,CA,93257-6059,Public       ,601,734,1335,2175,1695,3870
00126900,RIO HONDO COLLEGE                       ,CA,90601-1699,Public       ,1623,2189,3812,10582,6454,17036
00127000,RIVERSIDE CITY COLLEGE                  ,CA,92506-1299,Public       ,3083,4829,7912,17286,14382,31668
00127200,SAN BERNARDINO VALLEY COLLEGE           ,CA,92410-2798,Public       ,1748,3808,5556,8457,10238,18695
00127300,SAN DIEGO CITY COLLEGE                  ,CA,92101-4787,Public       ,1903,4059,5962,9202,10804,20006
00127500,SAN DIEGO MESA COLLEGE                  ,CA,92111-4996,Public       ,2045,3367,5412,10087,9380,19467
00127800,SAN FRANCISCO CONSERVATORY OF MUSIC     ,CA,94122-4498,Private      ,46,71,117,294,378,672
00127900,SAN FRANCISCO THEOLOGICAL SEMINARY      ,CA,94960-0000,Private      ,0,22,22,8,50,58
00128000,SAN JOAQUIN DELTA COLLEGE               ,CA,95207-6370,Public       ,1652,3033,4685,9296,8243,17539
00128100,WILLIAM JESSUP UNIVERSITY               ,CA,95765-3707,Private      ,159,169,328,1261,615,1876
00128200,SAN JOSE CITY COLLEGE                   ,CA,95128-2797,Public       ,843,1744,2587,4457,4792,9249
00128400,SANTA ANA COLLEGE                       ,CA,92706-3398,Public       ,1271,2052,3323,8603,5996,14599
00128500,SANTA BARBARA CITY COLLEGE              ,CA,93109-2394,Public       ,2105,2064,4169,9289,4834,14123
00128600,SANTA MONICA COLLEGE                    ,CA,90405-1644,Public       ,3596,3736,7332,19090,9902,28992
00128700,SANTA ROSA JUNIOR COLLEGE               ,CA,95401-4395,Public       ,1036,1824,2860,5686,5135,10821
00128800,CLAREMONT SCHOOL OF THEOLOGY            ,CA,91711-0000,Private      ,1,106,107,6,267,273
00128900,SHASTA COLLEGE                          ,CA,96049-7692,Public       ,667,1468,2135,3361,3855,7216
00129000,SIERRA COLLEGE                          ,CA,95677-3397,Public       ,2211,3395,5606,8268,7887,16155
00129100,SIMPSON UNIVERSITY                      ,CA,96003-8606,Private      ,104,259,363,1252,949,2201
00129200,SOLANO COMMUNITY COLLEGE                ,CA,94534-3197,Public       ,786,1801,2587,3320,4346,7666
00129300,VANGUARD UNIVERSITY OF SOUTHERN CA      ,CA,92626-6597,Private      ,167,254,421,2184,1012,3196
00129400,SOUTHWESTERN COLLEGE                    ,CA,91910-7299,Public       ,1572,2144,3716,8914,6940,15854
00129500,SOUTHWESTERN LAW SCHOOL                 ,CA,90010-1106,Private      ,8,502,510,50,2008,2058
00129600,DOMINICAN SCH PHILOSOPHY & THEOLOGY     ,CA,94709-0000,Private      ,0,13,13,4,41,45
00129900,ST JOHN'S SEMINARY COLLEGE              ,CA,93010-0000,Private      ,0,4,4,8,7,15
00130200,SAINT MARY'S COLLEGE OF CALIFORNIA      ,CA,94556-2744,Private      ,237,384,621,5240,1347,6587
00130500,STANFORD UNIVERSITY                     ,CA,94305-6106,Private      ,1666,526,2192,26410,3198,29608
00130501,STANFORD UNIVERSITY - SCHOOL OF MEDICINE,CA,94305-5404,Private      ,42,183,225,156,1127,1283
00130502,STANFORD UNIVERSITY - GRADUATE SCHOOL OF,CA,94305-7298,Private      ,24,459,483,94,1711,1805
00130503,STANFORD UNIVERSITY - STANFORD LAW SCHOO,CA,94305-8610,Private      ,22,242,264,207,2340,2547
00130700,FRESNO CITY COLLEGE                     ,CA,93741-0002,Public       ,2570,5302,7872,15417,13654,29071
00130800,REEDLEY COLLEGE                         ,CA,93654-2099,Public       ,1483,1808,3291,7093,4451,11544
00130900,TAFT COLLEGE                            ,CA,93268-2317,Public       ,352,565,917,1769,1286,3055
00131200,"UNIVERSITY OF CALIFORNIA, BERKELEY      ",CA,94720-1520,Public       ,1853,2671,4524,58670,18174,76844
00131300,UNIVERSITY OF CALIFORNIA-DAVIS          ,CA,95616-8558,Public       ,1377,1763,3140,55710,14465,70175
00131400,UNIVERSITY OF CALIFORNIA-IRVINE         ,CA,92697-2825,Public       ,1133,1645,2778,62514,13522,76036
00131500,UNIVERSITY OF CALIFORNIA (UCLA)         ,CA,90095-9000,Public       ,2589,3793,6382,74808,24740,99548
00131502,UNIV OF CALIFORNIA LOS ANG SCH MED      ,CA,90095-0000,Public       ,29,121,150,315,1122,1437
00131503,UNIV OF CALIFORNIA LOS ANG DENTAL       ,CA,90095-0000,Public       ,18,59,77,116,194,310
00131600,UNIVERSITY OF CALIFORNIA-RIVERSIDE      ,CA,92521-0209,Public       ,1072,1438,2510,41376,9352,50728
00131700,UNIVERSITY OF CALIFORNIA-SAN DIEGO      ,CA,92093-0013,Public       ,1330,1518,2848,56001,10512,66513
00131900,UNIVERSITY OF CALIFORNIA-SFRANCISCO     ,CA,94143-0246,Public       ,184,703,887,1580,4389,5969
00132000,UNIVERSITY OF CALIFORNIA-SANTA BARB     ,CA,93106-3180,Public       ,1313,792,2105,54015,7247,61262
00132100,UNIVERSITY OF CALIFORNIA-SANTA CRUZ     ,CA,95064-0001,Public       ,979,612,1591,37526,5142,42668
00132200,UNIVERSITY OF REDLANDS                  ,CA,92373-0999,Private      ,287,895,1182,5429,3007,8436
00132500,UNIVERSITY OF SAN FRANCISCO             ,CA,94117-1080,Private      ,475,1694,2169,13270,7388,20658
00132600,SANTA CLARA UNIVERSITY                  ,CA,95053-4956,Private      ,426,659,1085,11330,2836,14166
00132604,JESUIT SCHOOL OF THEOLOGY - BERKELEY    ,CA,94709-1193,Private      ,1,8,9,4,56,60
00132800,UNIVERSITY OF SOUTHERN CALIFORNIA       ,CA,90089-0914,Private      ,1590,6789,8379,44212,26252,70464
00132900,UNIVERSITY OF THE PACIFIC               ,CA,95211-0197,Private      ,337,592,929,10154,3170,13324
00132901,UNIVERSITY OF THE PACIFIC - MCGEORGE SCH,CA,95817-2799,Private      ,23,212,235,182,1256,1438
00132902,UNIV OF THE PACIFIC SCH OF DENT         ,CA,94115-0000,Private      ,6,83,89,72,631,703
00133400,VENTURA COLLEGE                         ,CA,93003-3899,Public       ,1252,1552,2804,5288,3770,9058
00133500,VICTOR VALLEY COLLEGE                   ,CA,92395-5849,Public       ,1562,2912,4474,5785,7134,12919
00133800,WEST VALLEY COLLEGE                     ,CA,95070-5697,Public       ,679,961,1640,2672,2128,4800
00134100,WESTMONT COLLEGE                        ,CA,93108-1099,Private      ,214,37,251,2403,168,2571
00134200,WHITTIER COLLEGE                        ,CA,90601-4413,Private      ,238,112,350,4143,514,4657
00134201,WHITTIER COLLEGE - COLLEGE OF LAW       ,CA,92626-1501,Private      ,2,381,383,21,1036,1057
00134300,WOODBURY UNIVERSITY                     ,CA,91510-7846,Private      ,102,166,268,1196,754,1950
00134400,YUBA COLLEGE                            ,CA,95901-7699,Public       ,832,1613,2445,3132,3571,6703
00177212,TRINITY INTERNATIONAL UNIV-CA           ,CA,92705-0000,Private      ,2,70,72,7,195,202
00188100,ASHFORD UNIVERSITY                      ,CA,92123-1406,Proprietary  ,559,29131,29690,1268,57887,59155
00274100,AMERICAN JEWISH UNIVERSITY              ,CA,90077-1599,Private      ,10,23,33,67,119,186
00301002,ANTIOCH UNIV/LOS ANGELES                ,CA,90230-7615,Private      ,12,327,339,55,827,882
00301003,ANTIOCH  UNIV/SANTA BARBARA             ,CA,93101-0000,Private      ,33,163,196,714,511,1225
00369110,MIDDLEBURY COLLEGE - MONTEREY INSTITUTE ,CA,93940-2691,Private      ,6,146,152,41,743,784
00394700,UC-HASTINGS COLLEGE OF THE LAW          ,CA,94102-0000,Public       ,1,167,168,32,2498,2530
00394800,SAN FRANCISCO ART INSTITUTE             ,CA,94133-2299,Private      ,242,261,503,1735,1014,2749
00408000,STARR KING SCHOOL FOR THE MINISTRY      ,CA,94709-1299,Private      ,0,24,24,3,89,92
00448000,DE ANZA COLLEGE                         ,CA,95014-5793,Public       ,1503,1922,3425,8504,5321,13825
00448100,OHLONE COLLEGE                          ,CA,94539-5847,Public       ,797,997,1794,3389,2588,5977
00448400,JOHN F. KENNEDY UNIVERSITY              ,CA,94523-4817,Private      ,15,350,365,54,1027,1081
00449400,EVEREST COLLEGE                         ,CA,92408-3752,Proprietary  ,117,332,449,416,660,1076
00450200,CITY COLLEGE OF SAN FRANCISCO           ,CA,94112-0000,Public       ,1459,3833,5292,7231,8806,16037
00450302,EVEREST COLLEGE - SANTA ANA             ,CA,92701-4559,Proprietary  ,64,134,198,262,380,642
00563800,DOWNEY ADULT SCHOOL                     ,CA,90241-5610,Public       ,69,205,274,204,518,722
00565500,HACIENDA LA PUENTE ADULT EDUC CTR       ,CA,91746-0000,Public       ,59,201,260,151,421,572
00616500,LA CNTY CLG OF NURSING & ALLD HLTH      ,CA,90033-1018,Public       ,26,166,192,192,572,764
00672000,COLLEGE OF ALAMEDA                      ,CA,94501-2109,Public       ,508,1134,1642,2465,2944,5409
00673100,CASA LOMA COLLEGE                       ,CA,91405-4523,Private      ,77,216,293,182,450,632
00697300,CANADA COLLEGE                          ,CA,94061-1099,Public       ,309,617,926,1233,1477,2710
00697500,LINCOLN UNIVERSITY                      ,CA,94612-2801,Private      ,11,27,38,41,102,143
00701200,SAMUEL MERRITT COLLEGE                  ,CA,94609-3108,Private      ,53,632,685,413,2435,2848
00704700,LOS ANGELES SOUTHWEST COLLEGE           ,CA,90047-4810,Public       ,578,1937,2515,3078,5853,8931
00705000,BELLUS ACADEMY                          ,CA,91950-3616,Proprietary  ,38,83,121,111,154,265
00711500,MOORPARK COLLEGE                        ,CA,93021-1695,Public       ,1281,1363,2644,5404,3392,8796
00713000,NEWBERRY SCHOOLS OF BEAUTY              ,CA,91344-7404,Proprietary  ,17,38,55,44,58,102
00714200,LYLE'S COLLEGE OF BEAUTY                ,CA,93710-3948,Proprietary  ,23,46,69,101,96,197
00716400,BRYAN COLLEGE                           ,CA,90057-0000,Proprietary  ,74,560,634,136,980,1116
00718700,NORTH ADRIAN'S COLLEGE OF BEAUTY        ,CA,95350-2381,Proprietary  ,24,66,90,79,128,207
00719000,WYOTECH                                 ,CA,94539-7663,Proprietary  ,150,398,548,414,700,1114
00720300,SALON SUCCESS ACADEMY                   ,CA,91786-4060,Proprietary  ,32,37,69,67,86,153
00720400,MODERN BEAUTY ACADEMY                   ,CA,93030-7016,Proprietary  ,15,29,44,49,45,94
00720900,REDONDO BEACH BEAUTY COLLEGE            ,CA,90278-3111,Proprietary  ,0,12,12,4,21,25
00723400,HEALD COLLEGE                           ,CA,94105-2206,Proprietary  ,91,261,352,403,974,1377
00723404,HEALD COLLEGE - CONCORD                 ,CA,94520-0000,Proprietary  ,148,381,529,577,1351,1928
00723405,HEALD COLLEGE - MILPITAS                ,CA,95035-8008,Proprietary  ,142,416,558,519,1366,1885
00723406,HEALD COLLEGE - HAYWARD                 ,CA,94545-2352,Proprietary  ,84,303,387,595,1247,1842
00723407,HEALD COLLEGE - MODESTO                 ,CA,95368-9095,Proprietary  ,114,248,362,564,950,1514
00723408,HEALD COLLEGE - ROSEVILLE               ,CA,95678-5303,Proprietary  ,86,285,371,472,1313,1785
00723409,HEALD COLLEGE - SALINAS                 ,CA,93906-5100,Proprietary  ,77,178,255,473,847,1320
00723410,HEALD COLLEGE - STOCKTON                ,CA,95210-5667,Proprietary  ,146,347,493,766,1331,2097
00723411,HEALD COLLEGE - RANCHO CORDOVA          ,CA,95670-6005,Proprietary  ,80,281,361,384,1092,1476
00723412,HEALD COLLEGE - FRESNO                  ,CA,93704-1706,Proprietary  ,187,439,626,1016,1651,2667
00725300,FEDERICO BEAUTY INSTITUTE               ,CA,95834-1905,Proprietary  ,44,136,180,197,288,485
00729600,COLEMAN COLLEGE                         ,CA,92123-0000,Private      ,40,214,254,199,513,712
00732909,ITT TECHNICAL INSTITUTE                 ,CA,92868-3506,Proprietary  ,157,783,940,346,1430,1776
00732971,ITT TECHNICAL INSTITUTE                 ,CA,95670-6047,Proprietary  ,126,766,892,305,1229,1534
00732976,ITT TECHNICAL INSTITUTE                 ,CA,92408-3519,Proprietary  ,286,915,1201,700,1766,2466
00732981,ITT TECHNICAL INSTITUTE                 ,CA,92123-2662,Proprietary  ,188,988,1176,496,1752,2248
00732985,ITT TECHNICAL INSTITUTE                 ,CA,91773-2933,Proprietary  ,153,717,870,313,1142,1455
00732989,ITT TECHNICAL INSTITUTE                 ,CA,90502-1356,Proprietary  ,142,693,835,261,1138,1399
00732994,ITT TECHNICAL INSTITUTE                 ,CA,91342-3664,Proprietary  ,128,604,732,234,929,1163
00747600,MARINELLO SCHOOLS OF BEAUTY             ,CA,90023-2666,Proprietary  ,124,234,358,268,378,646
00747602,MARINELLO SCHOOLS OF BEAUTY - SPA ACADEM,CA,90048-5101,Proprietary  ,39,94,133,82,158,240
00747603,MARINELLO SCHOOLS OF BEAUTY - INGLEWOOD ,CA,90301-2306,Proprietary  ,49,91,140,108,151,259
00747604,MARINELLO SCHOOLS OF BEAUTY - RESEDA    ,CA,91335-4218,Proprietary  ,7,14,21,32,39,71
00747606,MARINELLO SCHOOLS OF BEAUTY - WEST COVIN,CA,91790-2805,Proprietary  ,35,47,82,79,98,177
00747607,MARINELLO SCHOOLS OF BEAUTY - SAN BERNAR,CA,92410-3261,Proprietary  ,16,52,68,96,138,234
00747608,MARINELLO SCHOOLS OF BEAUTY - ONTARIO   ,CA,91762-2113,Proprietary  ,59,115,174,144,196,340
00747609,MARINELLO SCHOOLS OF BEAUTY - WHITTIER  ,CA,90601-4107,Proprietary  ,23,50,73,80,90,170
00747610,MARINELLO SCHOOLS OF BEAUTY - LOMITA    ,CA,90717-1460,Proprietary  ,19,43,62,41,77,118
00747611,MARINELLO SCHOOLS OF BEAUTY - SAN DIEGO ,CA,92126-4217,Proprietary  ,48,170,218,164,290,454
00747612,MARINELLO SCHOOLS OF BEAUTY - EL CAJON  ,CA,92020-2503,Proprietary  ,42,92,134,76,131,207
00747613,MARINELLO SCHOOLS OF BEAUTY - VICTORVILL,CA,92392-5496,Proprietary  ,44,87,131,107,184,291
00747614,MARINELLO SCHOOLS OF BEAUTY - ANAHEIM   ,CA,92801-4622,Proprietary  ,55,91,146,121,133,254
00747615,MARINELLO SCHOOLS OF BEAUTY - SIMI VALLE,CA,93065-2801,Proprietary  ,34,46,80,53,75,128
00753100,ACADEMY OF ART UNIVERSITY               ,CA,94105-3410,Proprietary  ,1406,3073,4479,5930,7410,13340
00753600,COSUMNES RIVER COLLEGE                  ,CA,95823-5799,Public       ,1411,2958,4369,8549,8542,17091
00754802,WESTWOOD COLLEGE OF TECHNOLOGY          ,CA,92801-0000,Proprietary  ,145,182,327,524,512,1036
00754803,WESTWOOD COLLEGE OF TECHNOLOGY          ,CA,91786-0000,Proprietary  ,174,221,395,614,668,1282
00760600,EVEREST COLLEGE                         ,CA,90010-2221,Proprietary  ,51,145,196,237,337,574
00760700,CONCORDE CAREER INSTITUTE               ,CA,91606-3134,Proprietary  ,108,232,340,271,524,795
00770700,COLUMBIA COLLEGE                        ,CA,95370-8580,Public       ,282,398,680,1151,991,2142
00771300,SKYLINE COLLEGE                         ,CA,94066-1698,Public       ,728,1178,1906,3457,2770,6227
00793000,CONCORDE CAREER INSTITUTE               ,CA,92108-0000,Proprietary  ,82,321,403,242,769,1011
00799300,CALIF STATE UNIV BAKERSFIELD            ,CA,93311-1022,Public       ,711,1418,2129,10920,6110,17030
00807100,CONCORDE CAREER INSTITUTE               ,CA,92840-9201,Proprietary  ,107,258,365,258,573,831
00807300,BUTTE COMMUNITY COLLEGE                 ,CA,95965-0000,Public       ,1509,2453,3962,6743,6241,12984
00809000,EVEREST COLLEGE                         ,CA,91803-1310,Proprietary  ,85,141,226,169,344,513
00853700,CONCORDE CAREER INSTITUTE               ,CA,92401-0000,Proprietary  ,125,366,491,314,781,1095
00859600,WEST LOS ANGELES COLLEGE                ,CA,90230-3500,Public       ,977,2288,3265,4613,6489,11102
00859700,FEATHER RIVER COLLEGE                   ,CA,95971-9124,Public       ,138,128,266,677,337,1014
00884400,CALIFORNIA CHRISTIAN COLLEGE            ,CA,93703-3599,Private      ,10,38,48,83,136,219
00884600,WRIGHT INSTITUTE                        ,CA,94704-0000,Private      ,1,218,219,5,427,432
00890300,COLLEGE OF THE CANYONS                  ,CA,91355-1899,Public       ,1412,1683,3095,7369,4681,12050
00891800,SADDLEBACK COLLEGE                      ,CA,92692-3699,Public       ,1074,1762,2836,5239,5108,10347
00902200,ASSOCIATED TECHNICAL COLLEGE            ,CA,90017-0000,Proprietary  ,35,142,177,136,257,393
00903200,EMPIRE COLLEGE                          ,CA,95403-2122,Proprietary  ,46,180,226,134,330,464
00915706,WYOMING TECHNICAL INSTITUTE - WEST SACRA,CA,95605-1507,Proprietary  ,0,0,0,16,23,39
00927200,CRAFTON HILLS COLLEGE                   ,CA,92399-1799,Public       ,723,1122,1845,3610,3059,6669
00950900,SKILLS & BUSINESS EDUCATION CENTER      ,CA,95824-1529,Public       ,55,273,328,230,657,887
00974800,CARRINGTON COLLEGE CALIFORNIA           ,CA,95826-3203,Proprietary  ,320,830,1150,977,1946,2923
00974801,CARRINGTON COLLEGE CALIFORNIA - SAN LEAN,CA,94578-3711,Proprietary  ,90,181,271,230,462,692
00974802,CARRINGTON COLLEGE CALIFORNIA - PLEASANT,CA,94523-1984,Proprietary  ,115,251,366,284,588,872
00974803,CARRINGTON COLLEGE CALIFORNIA - STOCKTON,CA,95207-5509,Proprietary  ,131,232,363,377,504,881
00974804,CARRINGTON COLLEGE CALIFORNIA - CITRUS H,CA,95621-5577,Proprietary  ,81,243,324,209,467,676
00974807,CARRINGTON COLLEGE CALIFORNIA - SAN JOSE,CA,95119-1325,Proprietary  ,156,292,448,534,863,1397
00998900,SANTA BARBARA BUSINESS COLLEGE          ,CA,93111-0000,Proprietary  ,62,178,240,255,414,669
01011100,CERRO-COSO COMMUNITY COLLEGE            ,CA,93555-9571,Public       ,246,874,1120,703,1691,2394
01014900,PEPPERDINE UNIVERSITY                   ,CA,90263-0000,Private      ,314,1482,1796,8287,4995,13282
01034000,LOS MEDANOS COLLEGE                     ,CA,94565-5197,Public       ,702,1140,1842,2853,3069,5922
01036500,CHARLES R DREW UNIV OF MED & SCI        ,CA,90059-0000,Private      ,15,239,254,108,804,912
01039500,UNIVERSITY OF SAN DIEGO                 ,CA,92110-2492,Private      ,753,1167,1920,17257,5323,22580
01039501,UNIVERSITY OF SAN DIEGO - SCHOOL OF LAW ,CA,92110-2492,Private      ,27,390,417,222,2044,2266
01044100,PARDEE RAND GRADUATE SCHOOL             ,CA,90407-2138,Private      ,0,2,2,3,19,22
01047400,MARYMOUNT COLLEGE OF PALOS VERDES       ,CA,90275-0000,Private      ,74,43,117,1063,213,1276
01085400,THOMAS JEFFERSON SCHOOL OF LAW          ,CA,92110-0000,Private      ,3,460,463,33,1374,1407
01102400,EVEREST COLLEGE                         ,CA,94103-2091,Proprietary  ,24,75,99,96,174,270
01110700,EVEREST  COLLEGE                        ,CA,92801-5231,Proprietary  ,110,234,344,282,439,721
01110900,EVEREST COLLEGE                         ,CA,91335-4631,Proprietary  ,85,170,255,223,384,607
01111200,FIDM-FASHION INSTITUTE OF DESIGN        ,CA,90015-1421,Proprietary  ,813,561,1374,4520,1692,6212
01111700,ALLIANT INTERNATIONAL UNIVERSITY        ,CA,92131-1799,Private      ,34,374,408,177,1611,1788
01111705,ALLIANT INTERNATIONAL UNIVERSITY - LOS A,CA,91803-1360,Private      ,5,127,132,14,581,595
01111706,ALLIANT INTERNATIONAL UNIVERSITY - SAN F,CA,94133-1221,Private      ,8,130,138,34,656,690
01111707,ALLIANT INTERNATIONAL UNIVERSITY - FRESN,CA,93727-2014,Private      ,14,101,115,62,451,513
01112100,EVEREST COLLEGE                         ,CA,94541-4007,Proprietary  ,15,57,72,85,145,230
01112300,EVEREST COLLEGE                         ,CA,90247-4163,Proprietary  ,47,179,226,101,337,438
01146000,NATIONAL UNIVERSITY                     ,CA,92037-1011,Private      ,207,4856,5063,759,12461,13220
01162600,PRACTICAL SCHOOLS                       ,CA,92805-0000,Proprietary  ,57,137,194,217,408,625
01164900,LOYOLA MARYMOUNT UNIVERSITY             ,CA,90045-0000,Private      ,511,830,1341,12233,3233,15466
01164901,LMU  - LOYOLA LAW SCHOOL                ,CA,90015-0019,Private      ,13,359,372,166,2417,2583
01167200,MENDOCINO COLLEGE                       ,CA,95482-3000,Public       ,300,630,930,1112,1395,2507
01170700,NORTH-WEST COLLEGE                      ,CA,91790-2097,Proprietary  ,65,145,210,196,340,536
01179200,FRANCISCAN SCHOOL OF THEOLOGY           ,CA,94709-0000,Private      ,0,13,13,5,22,27
01182000,SAN DIEGO MIRAMAR COLLEGE               ,CA,92126-0000,Public       ,1013,2161,3174,4785,5709,10494
01186500,CALIFORNIA HAIR DESIGN ACADEMY          ,CA,92115-0000,Proprietary  ,33,59,92,98,125,223
01186600,LU ROSS ACADEMY                         ,CA,93001-2927,Proprietary  ,39,78,117,110,156,266
01202600,BELLUS ACADEMY                          ,CA,92021-6247,Proprietary  ,37,71,108,77,128,205
01203100,SAN DIEGO CHRISTIAN COLLEGE             ,CA,92019-1157,Private      ,140,129,269,728,441,1169
01206100,EVEREST COLLEGE                         ,CA,95128-3908,Proprietary  ,33,100,133,173,278,451
01215400,CALIFORNIA INSTITUTE OF INTEGRAL STUDIES,CA,94103-2557,Private      ,7,497,504,47,1121,1168
01231600,MANCHESTER BEAUTY COLLEGE               ,CA,93726-5306,Proprietary  ,16,39,55,89,105,194
01231700,TULARE BEAUTY COLLEGE                   ,CA,93274-3432,Proprietary  ,13,20,33,29,31,60
01244600,UNIVERSAL COLLEGE OF BEAUTY             ,CA,90044-0044,Proprietary  ,15,33,48,63,79,142
01245200,EVERGREEN VALLEY COLLEGE                ,CA,95135-1598,Public       ,855,1559,2414,4384,4191,8575
01255000,LOS ANGELES MISSION COLLEGE             ,CA,91342-3200,Public       ,848,1486,2334,5250,4626,9876
01265000,MARINELLO SCHOOL OF BEAUTY              ,CA,91502-2828,Proprietary  ,74,145,219,127,217,344
01265001,MARINELLO SCHOOL OF BEAUTY - PALMDALE   ,CA,93550-4686,Proprietary  ,19,34,53,52,76,128
01284200,OXNARD COLLEGE                          ,CA,93030-0000,Public       ,634,1053,1687,2864,2655,5519
01287200,NORTH-WEST COLLEGE                      ,CA,91768-3199,Proprietary  ,129,254,383,311,533,844
01287300,WYOTECH                                 ,CA,90810-3800,Proprietary  ,165,450,615,532,906,1438
01287301,WYOTECH - EVEREST  COLLEGE              ,CA,90034-3158,Proprietary  ,38,128,166,185,316,501
01287302,WYOTECH - EVEREST  COLLEGE              ,CA,91746-3412,Proprietary  ,110,252,362,231,449,680
01290700,LAKE TAHOE COMMUNITY COLLEGE            ,CA,96150-4524,Public       ,127,214,341,508,594,1102
01291200,MTI COLLEGE                             ,CA,95841-0000,Proprietary  ,96,320,416,390,1069,1459
01294200,ROSEMEAD BEAUTY SCHOOL                  ,CA,91770-1639,Proprietary  ,7,88,95,11,101,112
01298400,PROFESSIONAL INSTITUTE OF BEAUTY        ,CA,91731-2613,Proprietary  ,5,29,34,15,36,51
01298500,HAIR CALIFORNIA BEAUTY ACADEMY          ,CA,92867-7127,Proprietary  ,0,0,0,12,22,34
01298900,OCEANSIDE COLLEGE OF BEAUTY             ,CA,92054-5393,Proprietary  ,23,53,76,83,116,199
01301000,LANCASTER BEAUTY SCHOOL                 ,CA,93534-3098,Proprietary  ,50,96,146,93,167,260
01307400,AMERICAN BEAUTY COLLEGE                 ,CA,91790-2906,Proprietary  ,15,30,45,35,56,91
01309500,SALON SUCCESS ACADEMY                   ,CA,92879-0000,Proprietary  ,64,90,154,103,148,251
01310300,CALIFORNIA WESTERN SCHOOL OF LAW        ,CA,92101-0000,Private      ,16,335,351,99,1479,1578
01324000,LYTLE'S REDWOOD EMPIRE BEAUTY CLG       ,CA,95403-0000,Proprietary  ,49,65,114,122,137,259
02054900,MARINELLO SCHOOL OF BEAUTY              ,CA,92630-0000,Proprietary  ,65,128,193,78,154,232
02054902,MARINELLO SCHOOL OF BEAUTY - BAKERSFIELD,CA,93309-5001,Proprietary  ,55,134,189,297,291,588
02054903,MARINELLO SCHOOL OF BEAUTY - VISALIA    ,CA,93277-6228,Proprietary  ,15,37,52,99,81,180
02059800,PARIS BEAUTY COLLEGE                    ,CA,94520-2611,Proprietary  ,10,40,50,36,81,117
02061600,WAYNES COLLEGE OF BEAUTY                ,CA,93906-2830,Proprietary  ,20,36,56,46,61,107
02063500,COASTLINE COMMUNITY COLLEGE             ,CA,92708-0000,Public       ,383,2252,2635,2131,5689,7820
02064300,SIERRA COLLEGE OF BEAUTY                ,CA,95340-0000,Proprietary  ,9,34,43,63,68,131
02065700,CALIFORNIA BEAUTY COLLEGE               ,CA,95354-0000,Proprietary  ,25,42,67,124,150,274
02070500,CONCORDIA UNIVERSITY                    ,CA,92612-0000,Private      ,326,1026,1352,3151,2485,5636
02075800,SOUTHERN CA INST OF ARCHITECTURE        ,CA,90013-0000,Private      ,24,108,132,210,440,650
02086400,MARINELLO SCHOOL OF BEAUTY              ,CA,95050-0000,Proprietary  ,39,83,122,74,115,189
02086401,MARINELLO SCHOOL OF BEAUTY - SEASIDE    ,CA,93955-3615,Proprietary  ,39,82,121,60,120,180
02086402,MARINELLO SCHOOL OF BEAUTY - SAN MATEO  ,CA,94401-3801,Proprietary  ,24,49,73,45,70,115
02086403,MARINELLO SCHOOL OF BEAUTY - HAYWARD    ,CA,94541-5111,Proprietary  ,21,63,84,70,144,214
02086404,MARINELLO SCHOOL OF BEAUTY - CASTRO VALL,CA,94546-5506,Proprietary  ,16,18,34,34,49,83
02091200,ELEGANCE INTERNATIONAL                  ,CA,90028-0000,Proprietary  ,49,74,123,146,155,301
02091700,KAPLAN COLLEGE                          ,CA,92123-1509,Proprietary  ,119,512,631,565,1562,2127
02091702,KAPLAN COLLEGE - CHULA VISTA            ,CA,91910-5342,Proprietary  ,65,114,179,199,322,521
02096100,FIELDING GRADUATE UNIVERSITY            ,CA,93105-0000,Private      ,0,275,275,2,644,646
02099200,AMERICAN CONSERVATORY THEATER           ,CA,94108-0000,Private      ,21,50,71,83,219,302
02110200,COLUMBIA COLLEGE                        ,CA,91356-0000,Private      ,63,41,104,366,131,497
02110800,CALIFORNIA COLLEGE SAN DIEGO            ,CA,92108-3821,Proprietary  ,399,1156,1555,1987,2269,4256
02111300,CUYAMACA COLLEGE                        ,CA,92019-0000,Public       ,822,1433,2255,3789,4751,8540
02119100,MISSION COLLEGE                         ,CA,95054-1897,Public       ,631,1349,1980,2979,3586,6565
02120600,SAYBROOK GRADUATE SCHOOL                ,CA,94111-1920,Private      ,0,235,235,2,472,474
02120700,SAN JOAQUIN VALLEY COLLEGE              ,CA,93291-0000,Proprietary  ,628,1511,2139,1700,3242,4942
02125000,CAREER ACADEMY OF BEAUTY                ,CA,92845-0000,Proprietary  ,21,69,90,48,121,169
02128200,"VICTOR VALLEY BEAUTY COLLEGE, INC       ",CA,92392-0000,Proprietary  ,53,68,121,122,137,259
02128300,INSTITUTE FOR BUSINESS & TECHNOLOGY     ,CA,95050-0000,Proprietary  ,36,145,181,92,274,366
02128301,INSTITUTE FOR BUSINESS & TECHNOLOGY - NA,CA,95670-6351,Proprietary  ,16,89,105,47,172,219
02138300,PALO ALTO UNIVERSITY                    ,CA,94304-1337,Private      ,3,304,307,73,881,954
02161800,MUSICIANS INSTITUTE                     ,CA,90028-6157,Proprietary  ,255,279,534,869,645,1514
02167800,ESTES INSTITUTE OF COSMETOLOGY          ,CA,93291-0000,Proprietary  ,23,30,53,78,69,147
02178700,CITRUS HEIGHTS BEAUTY COLLEGE           ,CA,95610-1410,Proprietary  ,27,34,61,96,84,180
02179937,WESTERN STATE COLLEGE OF LAW            ,CA,92831-3014,Proprietary  ,5,264,269,33,745,778
02179938,"ART INSTITUTE OF CALIFORNIA, HOLLYWOOD  ",CA,91601-3112,Proprietary  ,468,490,958,2119,1343,3462
02179941,"ART INSTITUTE OF CALIFORNIA, LOS ANGELES",CA,90405-3035,Proprietary  ,502,481,983,2822,1629,4451
02179947,"ART INSTITUTE OF CALIFORNIA, SAN DIEGO  ",CA,92108-4423,Proprietary  ,440,751,1191,2208,1973,4181
02185800,MOLER BARBER COLLEGE                    ,CA,94611-0000,Proprietary  ,10,49,59,43,107,150
02188400,SIERRA VALLEY COLLEGE OF COURT REPORTING,CA,93726-0000,Proprietary  ,23,69,92,69,132,201
02208600,MADERA BEAUTY COLLEGE                   ,CA,93637-3519,Proprietary  ,7,17,24,46,42,88
02211000,SALON SUCCESS ACADEMY                   ,CA,92405-0000,Proprietary  ,20,35,55,69,90,159
02220000,COLLEEN O'HARA BEAUTY ACADEMY           ,CA,92701-0000,Proprietary  ,16,20,36,35,32,67
02220200,CALIFORNIA CULINARY ACADEMY             ,CA,94102-3336,Proprietary  ,93,148,241,392,371,763
02221300,MARINELLO SCHOOL OF BEAUTY              ,CA,92553-0000,Proprietary  ,69,107,176,143,190,333
02221303,MARINELLO SCHOOL OF BEAUTY - SAN RAFAEL ,CA,94901-3224,Proprietary  ,14,44,58,28,69,97
02222000,AMERICAN FILM INSTITUTE                 ,CA,90027-0000,Private      ,95,247,342,420,791,1211
02226000,EAST LOS ANGELES COLLEGE                ,CA,91754-0000,Public       ,2415,3533,5948,14325,11203,25528
02228500,LIFE CHIROPRACTIC COLLEGE WEST          ,CA,94545-0000,Private      ,5,288,293,30,505,535
02230900,FREDRICK & CHARLES BEAUTY COLLEGE       ,CA,95501-0000,Proprietary  ,16,28,44,60,87,147
02231900,GEMOLOGICAL INSTITUTE OF AMERICA        ,CA,92008-4698,Private      ,19,113,132,51,254,305
02236400,"THANH LE COLG, SCH OF COSMETOLOGY       ",CA,92840-0000,Proprietary  ,3,14,17,9,23,32
02237200,PHILLIPS GRADUATE INSTITUTE             ,CA,91316-0000,Private      ,4,44,48,7,126,133
02241800,AMERICAN CAREER COLLEGE                 ,CA,90004-0000,Proprietary  ,445,1060,1505,1171,2365,3536
02242700,BERKELEY CITY COLLEGE                   ,CA,94704-0000,Public       ,711,1392,2103,3540,3776,7316
02250602,EVEREST COLLEGE                         ,CA,91761-8525,Proprietary  ,116,286,402,392,810,1202
02255400,INTERNATIONAL SCHOOL OF COSMETOLOGY     ,CA,90250-0000,Proprietary  ,75,96,171,113,138,251
02258600,ALAMEDA BEAUTY COLLEGE                  ,CA,94501-0000,Proprietary  ,28,87,115,96,176,272
02262400,YESHIVA OHR ELCHONON CHABAD             ,CA,90046-0000,Private      ,1,2,3,45,2,47
02263101,ANTHEM COLLEGE - SACRAMENTO             ,CA,95827-3378,Proprietary  ,38,185,223,82,322,404
02267600,INSTITUTE OF TRANSPERSONAL PSYCHLGY     ,CA,94303-4624,Private      ,3,154,157,8,292,300
02270600,LIFE PACIFIC COLLEGE                    ,CA,91773-0000,Private      ,93,81,174,408,206,614
02276800,WESTMINSTER SEMINARY CALIFORNIA         ,CA,92027-0000,Private      ,2,22,24,9,137,146
02277400,SOUTH COAST COLLEGE                     ,CA,92868-2616,Proprietary  ,46,120,166,179,298,477
02282300,ALHAMBRA BEAUTY COLLEGE                 ,CA,91802-0000,Proprietary  ,9,34,43,27,61,88
02285100,HILLTOP BEAUTY SCHOOL                   ,CA,94014-0000,Proprietary  ,3,16,19,10,35,45
02298000,DESIGN INSTITUTE OF SAN DIEGO           ,CA,92121-0000,Proprietary  ,42,89,131,194,221,415
02304300,"PLATT COLLEGE, SAN DIEGO                ",CA,92115-0000,Proprietary  ,30,105,135,165,242,407
02306300,KAPLAN COLLEGE                          ,CA,95368-0000,Proprietary  ,73,188,261,203,394,597
02306302,KAPLAN COLLEGE - FRESNO                 ,CA,93612-3802,Proprietary  ,48,125,173,129,238,367
02309500,CLOVIS ADULT EDUC                       ,CA,93611-0000,Public       ,15,99,114,75,255,330
02327601,ART INSTITUTE OF CALIFORNIA - SAN DIEGO ,CA,92408-2800,Proprietary  ,0,1,1,0,1,1
02330500,LAGUNA COLLEGE OF ART AND DESIGN        ,CA,92651-0000,Private      ,92,50,142,709,263,972
02332800,CENTER FOR EMPLOYMENT TRAINING          ,CA,95110-0000,Private      ,154,698,852,274,1032,1306
02338500,GLENDALE CAREER COLLEGE                 ,CA,91203-1207,Proprietary  ,68,209,277,176,344,520
02338700,MARINELLO SCHOOL OF BEAUTY              ,CA,94103-0000,Proprietary  ,22,56,78,85,114,199
02338701,MARINELLO SCHOOL OF BEAUTY - CHICO      ,CA,95928-7184,Proprietary  ,15,46,61,80,121,201
02338702,MARINELLO SCHOOL OF BEAUTY - REDDING    ,CA,96001-1023,Proprietary  ,16,77,93,60,153,213
02338703,MARINELLO SCHOOL OF BEAUTY - FRESNO     ,CA,93711-3246,Proprietary  ,37,93,130,174,175,349
02342400,ACADEMY OF RADIO BROADCASTING           ,CA,92647-3809,Proprietary  ,16,52,68,57,139,196
02343400,BELLUS ACADEMY                          ,CA,92064-4633,Proprietary  ,72,188,260,162,303,465
02351900,KAPLAN COLLEGE                          ,CA,95660-5512,Proprietary  ,104,422,526,437,1053,1490
02351901,KAPLAN COLLEGE - BAKERSFIELD            ,CA,93304-0000,Proprietary  ,121,238,359,514,610,1124
02358000,THOMAS AQUINAS COLLEGE                  ,CA,93060-9622,Private      ,31,3,34,394,27,421
02359300,SHASTA BIBLE COLLEGE                    ,CA,96002-0000,Private      ,8,28,36,52,57,109
02482700,WESTERN UNIVERSITY OF HEALTH S          ,CA,91766-1854,Private      ,17,731,748,166,5382,5548
02494800,LOLA BEAUTY COLLEGE                     ,CA,92641-0000,Proprietary  ,5,15,20,10,27,37
02497300,TRINITY COLLEGE                         ,CA,93277-8109,Proprietary  ,63,157,220,131,313,444
02500000,SAN JOAQUIN COLLEGE OF LAW              ,CA,93612-0000,Private      ,5,104,109,26,237,263
02518400,THE NATIONAL HISPANIC UNIVERSITY        ,CA,95127-0000,Proprietary  ,22,109,131,223,430,653
02519800,AVANCE BEAUTY COLLEGE                   ,CA,92154-0000,Proprietary  ,16,46,62,86,107,193
02520200,CALIFORNIA CAREER SCHOOLS               ,CA,92805-0000,Proprietary  ,14,53,67,54,150,204
02520300,INTERIOR DESIGNERS INSTITUTE            ,CA,92660-0000,Proprietary  ,10,51,61,29,105,134
02520400,ADRIAN'S BEAUTY COLLEGE OF TURLOCK      ,CA,95382-0000,Proprietary  ,27,42,69,90,71,161
02531801,PAUL MITCHELL THE SCHOOL-COSTA MESA     ,CA,92626-3804,Proprietary  ,49,71,120,152,147,299
02531804,PAUL MITCHELL THE SCHOOL - SAN DIEGO    ,CA,92101-0000,Proprietary  ,74,133,207,265,300,565
02537200,PALOMAR INSTITUTE OF COSMETOLOGY        ,CA,92069-0000,Proprietary  ,37,87,124,161,192,353
02539100,KAPLAN COLLEGE                          ,CA,91606-3231,Proprietary  ,142,381,523,328,693,1021
02539102,KAPLAN COLLEGE -  RIVERSIDE             ,CA,92507-4223,Proprietary  ,73,229,302,291,550,841
02539500,IRVINE VALLEY COLLEGE                   ,CA,92620-0000,Public       ,952,1199,2151,6338,3687,10025
02542300,NATIONAL HOLISTIC INSTITUTE             ,CA,94608-0000,Proprietary  ,49,282,331,130,591,721
02543400,BROWNSON TECHNICAL SCHOOL               ,CA,92805-0000,Proprietary  ,8,45,53,31,76,107
02545900,HYPNOSIS MOTIVATION INSTITUTE           ,CA,91356-0000,Private      ,0,24,24,1,44,45
02546400,MTI BUSINESS COLLEGE INC                ,CA,95207-0000,Proprietary  ,11,51,62,51,122,173
02549000,KAPLAN COLLEGE                          ,CA,92083-7736,Proprietary  ,83,246,329,268,655,923
02549005,KAPLAN COLLEGE -  PALM SPRINGS          ,CA,92262-7011,Proprietary  ,67,129,196,209,328,537
02553500,ASSOCIATED TECHNICAL COLLEGE            ,CA,92101-0000,Proprietary  ,30,131,161,103,220,323
02553600,DIVERSIFIED LANGUAGE INSTITUTE          ,CA,90017-0000,Proprietary  ,30,225,255,40,329,369
02559300,UNITED EDUCATION INSTITUTE              ,CA,90020-0000,Proprietary  ,368,869,1237,549,1282,1831
02559400,INTERCOAST COLLEGES                     ,CA,92868-1656,Proprietary  ,98,751,849,154,1106,1260
02570300,LOS ANGELES ORT TECHNICAL INSTITUTE     ,CA,90048-4904,Private      ,40,229,269,111,366,477
02577900,SANTA BARBARA BUSINESS COLLEGE          ,CA,93309-1664,Proprietary  ,141,249,390,446,654,1100
02578000,SANTA BARBARA BUSINESS COLLEGE          ,CA,93454-6943,Proprietary  ,79,170,249,175,300,475
02591600,NORTH-WEST COLLEGE                      ,CA,91101-1744,Proprietary  ,32,99,131,86,184,270
02595600,ASIAN AMERICAN INTERNATIONAL BTY CG     ,CA,92683-4043,Proprietary  ,5,24,29,10,33,43
02597300,SOUTH BAYLO UNIVERSITY                  ,CA,92801-1701,Private      ,0,75,75,2,178,180
02602300,CENTRAL COAST COLLEGE                   ,CA,93901-3301,Proprietary  ,55,85,140,194,251,445
02608900,PINNACLE COLLEGE                        ,CA,91803-8842,Proprietary  ,15,29,44,52,60,112
02608901,PINNACLE COLLEGE - SACRAMENTO           ,CA,95670-6386,Proprietary  ,20,51,71,64,97,161
02609000,EMPERORS COLG OF TRAD ORIENTAL MED      ,CA,90403-5609,Proprietary  ,2,59,61,9,141,150
03010611,VIRGINIA COLLEGE - GOLF ACADEMY OF AMERI,CA,92008-6512,Proprietary  ,9,24,33,25,55,80
03011300,"CALIF STATE UNIV, SAN MARCOS            ",CA,92096-0001,Public       ,995,1496,2491,15894,7010,22904
03019900,CAPSTONE COLLEGE                        ,CA,91402-0000,Proprietary  ,7,34,41,23,47,70
03025600,DELL'ARTE SCH OF PHYSICAL THEATRE       ,CA,95525-0816,Private      ,2,13,15,6,26,32
03027700,PACIFIC COLLEGE OF ORIENTAL MED         ,CA,92108-4408,Proprietary  ,12,212,224,56,452,508
03029600,POMONA ADULT SCHOOL                     ,CA,91766-0000,Public       ,53,115,168,96,221,317
03031409,INTERNATIONAL ACADEMY OF DESIGN AND TECH,CA,95834-9664,Proprietary  ,31,94,125,175,236,411
03035700,LAS POSITAS COLLEGE                     ,CA,94551-6750,Public       ,776,914,1690,2918,2087,5005
03039900,FREMONT COLLEGE                         ,CA,90703-5342,Proprietary  ,61,218,279,259,358,617
03043900,NEWSCHOOL OF ARCHITECTURE & DESIGN      ,CA,92101-6634,Proprietary  ,41,129,170,264,368,632
03054100,ROYALE COLLEGE OF BEAUTY                ,CA,92590-2525,Proprietary  ,16,28,44,51,60,111
03062300,WESTECH COLLEGE                         ,CA,91764-4988,Proprietary  ,83,183,266,205,397,602
03062400,MT DIABLO ADULT EDUC LOMA VISTA CTR     ,CA,94518-1122,Public       ,25,65,90,98,172,270
03062700,PLATT COLLEGE                           ,CA,90041-0000,Proprietary  ,163,301,464,399,643,1042
03062701,PLATT COLLEGE                           ,CA,91764-0000,Proprietary  ,128,204,332,361,454,815
03062702,PLATT COLLEGE - RIVERSIDE               ,CA,92507-0730,Proprietary  ,130,237,367,451,528,979
03063400,MODERN TECHNOLOGY SCHOOL                ,CA,92708-9821,Proprietary  ,20,46,66,47,118,165
03067400,BALDWIN PARK ADULT SCHOOL               ,CA,91706-4897,Public       ,53,94,147,125,199,324
03067500,INSTITUTE OF TECHNOLOGY                 ,CA,93612-3217,Proprietary  ,156,459,615,370,896,1266
03069500,SAGE COLLEGE                            ,CA,92557-6720,Proprietary  ,37,241,278,109,476,585
03072300,EVEREST COLLEGE                         ,CA,91761-3222,Proprietary  ,112,265,377,281,493,774
03072700,WESTWOOD COLLEGE - LOS ANGELES          ,CA,90010-1577,Proprietary  ,214,1300,1514,862,2478,3340
03078200,AMERICAN CLG TRADITIONAL CHINESE MD     ,CA,94107-2813,Private      ,2,82,84,5,176,181
03084700,VENTURA ADULT\CONTINUING EDUCATION      ,CA,93003-7313,Public       ,11,86,97,37,178,215
03094400,MARINELLO SCHOOL OF BEAUTY              ,CA,95841-2909,Proprietary  ,50,96,146,99,204,303
03094401,MARINELLO SCHOOL OF BEAUTY - CONCORD    ,CA,94520-2581,Proprietary  ,37,71,108,69,117,186
03094402,MARINELLO SCHOOL OF BEAUTY- STOCKTON    ,CA,95203-3149,Proprietary  ,26,79,105,108,170,278
03097700,CENTRAL CALIF SCH CONTINUING EDUC       ,CA,93401-6739,Proprietary  ,21,63,84,59,142,201
03098200,YO SAN UNIV TRADITIONAL CHINESE MED     ,CA,90066-1103,Private      ,1,61,62,4,112,116
03108100,SUMMIT CAREER COLLEGE                   ,CA,92324-3956,Proprietary  ,71,222,293,225,453,678
03109500,DONGGUK  UNIVERSITY LOS ANGELES         ,CA,90020-1765,Private      ,8,31,39,35,71,106
03113300,UEI COLLEGE                             ,CA,93727-1620,Proprietary  ,149,364,513,377,745,1122
03113600,SOUTHERN CALIFORNIA INST OF TECHNOL     ,CA,92805-3758,Proprietary  ,38,172,210,114,349,463
03116600,EAST SAN GABRIEL VLY REG OCCUP PROG     ,CA,91790-2105,Public       ,59,134,193,230,215,445
03125300,JOHN WESLEY INTER. BARBER & BTY CLG     ,CA,90813-4321,Proprietary  ,17,59,76,57,146,203
03125800,PREMIERE CAREER COLLEGE                 ,CA,91706-3746,Proprietary  ,39,128,167,60,189,249
03126800,PACIFICA GRADUATE INSTITUTE             ,CA,93013-0000,Proprietary  ,0,284,284,0,585,585
03128700,MT SIERRA COLLEGE                       ,CA,91016-3414,Proprietary  ,65,133,198,269,316,585
03131300,FIVE BRANCHES UNIVERSITY                ,CA,95062-4669,Proprietary  ,3,131,134,15,268,283
03144400,AMERICAN CLG OF HEALTH PROFESSIONS      ,CA,92505-3038,Proprietary  ,66,220,286,201,432,633
03150500,VIRGINIA SEWING MACHINES & SCH CTR      ,CA,90015-3535,Proprietary  ,12,40,52,20,58,78
03162300,FOUR-D SUCCESS ACADEMY                  ,CA,92324-4218,Proprietary  ,85,300,385,124,401,525
03163300,PACIFIC STATES UNIVERSITY               ,CA,90006-0000,Private      ,10,21,31,59,61,120
03195400,EVEREST COLLEGE                         ,CA,90501-2867,Proprietary  ,27,78,105,82,171,253
03210300,LE CORDON BLEU COLLEGE OF CULINARY ARTS ,CA,91101-5221,Proprietary  ,427,826,1253,1366,1745,3111
03225300,AMERICAN UNIVERSITY OF HEALTH SCIENCES  ,CA,90755-3612,Proprietary  ,32,109,141,97,268,365
03242300,CAREER NETWORK INSTITUTE                ,CA,92868-4710,Proprietary  ,59,294,353,96,443,539
03250300,COMMUNITY BASED EDUCATION AND DEVELOPMEN,CA,90010-2722,Private      ,37,92,129,86,196,282
03260300,CALIFORNIA STATE U-MONTEREY BAY         ,CA,93955-8001,Public       ,500,778,1278,13716,3748,17464
03266300,BETHESDA UNIVERSITY OF CALIFORNIA       ,CA,92801-4132,Private      ,27,34,61,105,68,173
03278300,CLARITA CAREER COLLEGE                  ,CA,91351-5432,Proprietary  ,225,539,764,275,658,933
03288300,ACAD CHINESE CULTURE & HEALTH SCIS      ,CA,94512-0000,Private      ,0,72,72,18,141,159
03299300,PACIFIC COLLEGE                         ,CA,92626-3160,Proprietary  ,18,122,140,76,235,311
03308300,BRISTOL UNIVERSITY                      ,CA,92806-6198,Proprietary  ,23,101,124,55,175,230
03327400,ACUPUNCTURE AND INTEGRATIVE MEDICINE COL,CA,94704-2724,Private      ,1,64,65,16,140,156
03332300,SOUTHERN CA BIBLE CLG & SEMINARY        ,CA,92019-1109,Private      ,5,59,64,12,130,142
03359300,ST. FRANCIS CAREER COLLEGE              ,CA,90262-2659,Proprietary  ,29,64,93,71,151,222
03367300,PROFESSIONAL GOLFERS CAREER COLLEGE     ,CA,92591-6013,Proprietary  ,21,39,60,69,110,179
03395300,INTERNATIONAL CAREER DEVELOPMENT        ,CA,90027-5794,Proprietary  ,178,1457,1635,294,2588,2882
03399300,NORTHWESTERN TECHNICAL COLLEGE          ,CA,95670-4443,Proprietary  ,12,49,61,35,126,161
03403300,EPIC BIBLE COLLEGE                      ,CA,95841-3546,Private      ,15,110,125,87,265,352
03413400,ENGLISH CENTER  (THE)                   ,CA,94607-3734,Private      ,2,30,32,14,65,79
03427400,CAREER COLLEGES OF AMERICA              ,CA,90280-7420,Proprietary  ,0,0,0,20,24,44
03427500,UNIVERSITY OF ANTELOPE VALLEY           ,CA,93534-3324,Proprietary  ,149,330,479,449,774,1223
03440400,MARIAN HEALTH CAREERS CENTER            ,CA,90010-1728,Proprietary  ,13,53,66,37,110,147
03458300,MY LE'S BEAUTY COLLEGE                  ,CA,95824-3039,Proprietary  ,24,85,109,64,174,238
03467300,MARINELLO SCHOOL OF BEAUTY              ,CA,92545-3661,Proprietary  ,39,146,185,73,194,267
03467301,MARINELLO SCHOOL OF BEAUTY - CATHEDRAL C,CA,92234-6656,Proprietary  ,4,8,12,21,20,41
03467302,MARINELLO SCHOOL OF BEAUTY - MURRIETA   ,CA,92563-5039,Proprietary  ,34,85,119,75,125,200
03467303,MARINELLO SCHOOL OF BEAUTY - NAPA       ,CA,94559-1237,Proprietary  ,27,54,81,54,82,136
03467304,MARINELLO SCHOOL OF BEAUTY - CITY OF IND,CA,91748-1674,Proprietary  ,8,19,27,18,30,48
03467305,MARINELLO SCHOOL OF BEAUTY - BELL       ,CA,90201-1193,Proprietary  ,32,47,79,52,61,113
03467306,MARINELLO SCHOOL OF BEAUTY - PARAMOUNT  ,CA,90723-5256,Proprietary  ,29,48,77,78,104,182
03467307,MARINELLO SCHOOL OF BEAUTY - HUNTINGTON ,CA,92646-2552,Proprietary  ,34,68,102,81,99,180
03479300,PROFESSIONAL CAREER INSTITUTE           ,CA,90703-2522,Proprietary  ,21,57,78,78,99,177
03516300,KING'S UNIVERSITY (THE)                 ,CA,91405-2233,Private      ,51,158,209,105,289,394
03532400,ADVANCED TRAINING ASSOCIATES            ,CA,92020-1236,Proprietary  ,11,38,49,24,78,102
03542400,COPPER MOUNTAIN COLLEGE                 ,CA,92252-6102,Public       ,199,646,845,520,1269,1789
03577300,COBA ACADEMY                            ,CA,92866-1407,Proprietary  ,6,12,18,25,25,50
03590400,NTMA TRAINING CENTERS OF SOUTHERN C     ,CA,90650-0000,Private      ,36,152,188,62,260,322
03592400,IRELL & MANELLA GRADUATE SCHOOL OF BIOLO,CA,91010-0000,Private      ,1,0,1,1,7,8
03598300,AVALON BEAUTY COLLEGE                   ,CA,93103-3137,Proprietary  ,33,29,62,82,67,149
03614300,DAVID'S ACADEMY OF BEAUTY               ,CA,91780-1089,Proprietary  ,11,33,44,17,39,56
03639300,WEST COAST ULTRASOUND INSTITUTE         ,CA,90211-3312,Proprietary  ,131,440,571,358,983,1341
03646300,DESIGN'S SCHOOL OF COSMETOLOGY          ,CA,93446-9530,Proprietary  ,24,42,66,45,69,114
03681300,CALIFORNIA HEALING ARTS COLLEGE         ,CA,90025-0000,Proprietary  ,17,72,89,93,200,293
03695300,COMMUNITY ENHANCEMENT SERVICES          ,CA,91502-2750,Private      ,6,80,86,11,102,113
03695700,SANTIAGO CANYON COLLEGE                 ,CA,92869-4512,Public       ,727,741,1468,3945,2028,5973
03696300,UNIVERSITY OF THE WEST                  ,CA,91770-3709,Private      ,4,24,28,55,93,148
03698300,WEST COAST UNIVERSITY                   ,CA,91606-3206,Proprietary  ,413,1176,1589,1968,4682,6650
03698400,CA COLLEGE OF VOCATIONAL CAREER         ,CA,93301-1800,Proprietary  ,35,141,176,220,378,598
03736300,ADVANCE BEAUTY COLLEGE                  ,CA,92843-4752,Proprietary  ,25,161,186,51,204,255
03736301,ADVANCE BEAUTY COLLEGE - LAGUNA HILLS   ,CA,92653-1980,Proprietary  ,8,16,24,17,23,40
03740400,ATI COLLEGE                             ,CA,90650-0000,Proprietary  ,17,57,74,45,106,151
03752400,SCHOOL OF URBAN MISSIONS                ,CA,94603-0000,Private      ,76,139,215,122,216,338
03759300,COMPUTER TUTOR BUSINESS & TECH INST     ,CA,95356-0000,Proprietary  ,25,56,81,69,138,207
03786300,ADVANCED COLLEGE                        ,CA,90280-5255,Proprietary  ,31,71,102,75,129,204
03797400,CAREER CARE INSTITUTE                   ,CA,93534-4766,Proprietary  ,110,347,457,210,596,806
03797401,CAREER CARE INSTITUTE - VENTURA         ,CA,93003-0000,Proprietary  ,11,53,64,62,131,193
03797402,CAREER CARE INSTITUTE - MORENO VALLEY   ,CA,92553-7519,Proprietary  ,9,41,50,52,118,170
03814400,SOKA UNIVERSITY OF AMERICA              ,CA,92656-8081,Private      ,9,9,18,526,54,580
03853300,KECK GRADUATE INSTITUTE OF APPLIED LIFE ,CA,91711-4817,Private      ,0,98,98,11,235,246
03868300,WORLD MISSION UNIVERSITY                ,CA,90020-1789,Private      ,1,43,44,10,68,78
03868400,LOS ANGELES MUSIC ACADEMY               ,CA,91105-2540,Proprietary  ,43,53,96,184,146,330
03871300,FOLSOM LAKE COLLEGE                     ,CA,95630-6798,Public       ,776,1356,2132,3411,3202,6613
03874300,CAMBRIDGE JUNIOR COLLEGE                ,CA,95993-0000,Proprietary  ,39,106,145,159,338,497
03874400,COMMMUNITY CHRISTIAN COLLEGE            ,CA,92373-4465,Private      ,10,25,35,80,76,156
03889300,STANBRIDGE COLLEGE                      ,CA,92612-0000,Proprietary  ,145,384,529,329,947,1276
03901300,PACIFIC COAST TRADE SCHOOL              ,CA,93033-2441,Proprietary  ,3,19,22,51,74,125
03910400,NATIONAL POLYTECHNIC COLLEGE            ,CA,90040-3066,Proprietary  ,44,75,119,66,91,157
03933300,MUELLER COLLEGE OF HOLISTIC STUDIES     ,CA,92116-2630,Proprietary  ,19,78,97,45,139,184
03935300,CALIFORNIA NURSES EDUCATIONAL INSTITUTE ,CA,92234-7248,Proprietary  ,31,101,132,93,166,259
03962300,AMERICAN INSTITUTE OF MASSAGE THERAPY   ,CA,92705-5463,Proprietary  ,10,32,42,41,65,106
03964400,INTERNATIONAL SCHOOL OF BEAUTY          ,CA,92260-2740,Proprietary  ,26,90,116,98,166,264
03969600,AMERICAN AUTO INSTITUTE                 ,CA,90703-2637,Proprietary  ,169,381,550,292,591,883
03971300,AMERICAN CAREER COLLEGE                 ,CA,91764-4906,Proprietary  ,203,472,675,607,1194,1801
03973300,EX'PRESSION COLLEGE FOR DIGTAL ARTS     ,CA,94608-1021,Proprietary  ,106,118,224,441,343,784
03974500,CALIFORNIA CAREER COLLEGE               ,CA,91303-2006,Proprietary  ,8,52,60,27,93,120
03980300,CALIFORNIA STATE UNIVERSITY CHANNEL ISLA,CA,93012-8599,Public       ,385,579,964,9450,3594,13044
03995300,UNIVERSITY OF EAST-WEST MEDICINE        ,CA,94087-6106,Proprietary  ,2,19,21,6,49,55
03999300,BEAUMONT ADULT SCHOOL                   ,CA,92223-1927,Public       ,18,73,91,25,107,132
04001300,PALACE BEAUTY COLLEGE                   ,CA,90006-4233,Proprietary  ,15,48,63,61,110,171
04003300,BLAKE AUSTIN COLLEGE                    ,CA,95687-3100,Proprietary  ,76,167,243,169,348,517
04004300,THUY PRINCESS BEAUTY COLLEGE            ,CA,91766-0000,Proprietary  ,6,16,22,19,36,55
04005300,UNITED STATES UNIVERSITY                ,CA,91911-1683,Proprietary  ,18,163,181,53,315,368
04014400,PALLADIUM TECHNICAL ACADEMY             ,CA,91731-2429,Proprietary  ,10,12,22,23,20,43
04037300,LOS ANGELES FILM SCHOOL (THE)           ,CA,90028-7300,Proprietary  ,500,784,1284,1380,1604,2984
04056300,CAREER COLLEGE OF CALIFORNIA            ,CA,92705-5805,Proprietary  ,26,44,70,96,108,204
04057300,TECHSKILLS OF CALIFORNIA                ,CA,95815-4025,Proprietary  ,43,338,381,158,547,705
04076400,GNOMON SCHOOL OF VISUAL EFFECTS         ,CA,90038-2616,Proprietary  ,29,88,117,135,190,325
04088300,WESTMED COLLEGE                         ,CA,95128-2541,Private      ,24,110,134,112,276,388
04088301,WESTMED COLLEGE - MERCED                ,CA,95340-9165,Private      ,15,85,100,106,233,339
04092300,COASTLINE BEAUTY COLLEGE                ,CA,92708-3847,Proprietary  ,8,32,40,56,79,135
04092400,MAKE-UP DESIGNORY                       ,CA,91502-1322,Proprietary  ,85,99,184,214,229,443
04100400,TAFT UNIVERSITY SYSTEM (THE)            ,CA,92704-6954,Proprietary  ,3,107,110,8,287,295
04111300,WEST HILLS COLLEGE LEMOORE              ,CA,93245-9248,Public       ,456,971,1427,2190,2456,4646
04114500,VALLEY COLLEGE OF MEDICAL CAREERS       ,CA,91304-2354,Proprietary  ,11,32,43,56,69,125
04115300,COACHELLA VALLEY BEAUTY COLLEGE         ,CA,92253-2051,Proprietary  ,30,46,76,80,75,155
04115600,MAYFIELD COLLEGE                        ,CA,92234-7014,Proprietary  ,66,168,234,139,270,409
04116000,VIDEO SYMPHONY ENTERTRAINING            ,CA,91502-3253,Proprietary  ,16,51,67,59,134,193
04118800,NEW YORK FILM ACADEMY                   ,CA,91608-1002,Proprietary  ,238,310,548,677,731,1408
04119200,CAREER COLLEGE CONSULTANTS              ,CA,90041-2088,Proprietary  ,6,43,49,28,69,97
04126400,CHAMPION INSTITUTE OF COSMETOLOGY       ,CA,92264-7458,Proprietary  ,7,18,25,27,41,68
04126500,COAST CAREER INSTITUTE                  ,CA,90015-3040,Proprietary  ,24,104,128,48,147,195
04127100,"UNIVERSITY OF CALIFORNIA, MERCED        ",CA,95343-5001,Public       ,237,179,416,15472,2020,17492
04127900,TUI UNIVERSITY                          ,CA,90630-5023,Proprietary  ,16,1038,1054,38,2009,2047
04129700,INTERNATIONAL POLYTECHNIC INSTITUTE     ,CA,92231-1737,Private      ,4,6,10,16,13,29
04129803,MEDIATECH INSTITUTE - OCEANSIDE         ,CA,92054-5116,Proprietary  ,17,49,66,43,93,136
04132400,ACADEMY OF ESTHETICS AND COSMETOLOGY    ,CA,91342-3373,Proprietary  ,9,19,28,44,48,92
04132700,INFOTECH CAREER COLLEGE                 ,CA,90706-5579,Proprietary  ,15,50,65,39,98,137
04133000,BIOHEALTH COLLEGE                       ,CA,95134-2033,Proprietary  ,16,57,73,60,145,205
04133100,CALIFORNIA UNIVERSITY OF MANAGEMENT AND ,CA,92801-1702,Private      ,2,13,15,20,60,80
04134500,CAREER COLLEGE OF SAN DIEGO             ,CA,92102-3348,Proprietary  ,48,198,246,220,422,642
04134700,INTERNATL PROFESSIONAL SCHL OF BODYWORK ,CA,92123-1520,Proprietary  ,9,69,78,34,165,199
04137200,BORNER'S BARBER COLLEGE                 ,CA,90047-3856,Proprietary  ,20,74,94,69,139,208
04138700,CAO INSTITUTE OF AESTHETICS (THE)       ,CA,91801-3903,Proprietary  ,24,36,60,48,65,113
04140500,HORIZON UNIVERSITY                      ,CA,92111-2622,Private      ,7,25,32,32,67,99
04141300,SAN FRANCISCO INSTITUTE OF ESTHETICS    ,CA,94103-4083,Proprietary  ,39,79,118,90,139,229
04141400,LAURUS COLLEGE                          ,CA,93401-5405,Proprietary  ,80,410,490,136,600,736
04141700,HEALING HANDS SCHOOL OF HOLISTIC HEALTH ,CA,92025-1722,Proprietary  ,11,63,74,34,136,170
04142500,TOURO COLLEGE LOS ANGELES               ,CA,90046-4506,Private      ,22,119,141,94,221,315
04142600,TOURO UNIVERSITY                        ,CA,94592-1118,Private      ,6,1080,1086,29,2587,2616
04143800,WOODLAND COMMUNITY COLLEGE              ,CA,95776-5156,Public       ,295,513,808,1276,1320,2596
04144200,CAREER DEVELOPMENT INSTITUTE            ,CA,90035-4364,Proprietary  ,11,76,87,35,127,162
04145000,SAN DIEGO CULINARY INSTITUTE            ,CA,91941-6435,Proprietary  ,48,137,185,278,374,652
04145600,INTERNATIONAL COLLEGE OF COSMETOLOGY    ,CA,94601-3525,Proprietary  ,15,43,58,55,108,163
04146000,NATIONAL CAREER COLLEGE                 ,CA,91605-1400,Proprietary  ,9,47,56,30,90,120
04148200,BEYOND 21ST CENTURY BEAUTY ACADEMY      ,CA,90670-6316,Proprietary  ,15,11,26,23,23,46
04148900,N CALIF INSTITUTE OF COSMETOLOGY        ,CA,94577-2820,Proprietary  ,1,11,12,17,26,43
04149700,HOMESTEAD SCHOOLS                       ,CA,90505-5945,Private      ,12,87,99,31,127,158
04150000,CENTRAL NURSING COLLEGE                 ,CA,90010-2444,Proprietary  ,32,91,123,179,237,416
04150100,GOLDEN STATE COLLEGE OF COURT REPORTING ,CA,94568-2948,Proprietary  ,0,14,14,6,33,39
04150300,RWM FIBER OPTICS                        ,CA,90746-1051,Proprietary  ,3,6,9,7,21,28
04150500,"PREFERRED COLLEGE OF NURSING, LOS ANGELE",CA,90010-2202,Proprietary  ,11,52,63,78,131,209
04152800,CALIFORNIA ACADEMY (THE) - A PAUL MITCHE,CA,95825-2276,Proprietary  ,77,158,235,278,366,644
04153900,PROVIDENCE CHRISTIAN COLLEGE            ,CA,91104-2635,Private      ,10,12,22,88,32,120
04155500,"ACADEMY FOR JEWISH RELIGION, CALIFORNIA ",CA,90024-3234,Private      ,7,18,25,26,49,75
04156100,TONI & GUY HAIRDRESSING ACADEMY         ,CA,95356-9695,Proprietary  ,25,40,65,68,99,167
04157800,GRACE MISSION UNIVERSITY                ,CA,92833-3860,Private      ,2,3,5,14,28,42
04158200,PAUL MITCHELL THE SCHOOL SHERMAN OAKS   ,CA,91403-5882,Proprietary  ,57,64,121,121,143,264
04158700,HOLLYWOOD BEAUTY COLLEGE                ,CA,95210-3514,Proprietary  ,6,31,37,56,92,148
04158900,FLAIR BEAUTY COLLEGE                    ,CA,91351-3381,Proprietary  ,11,26,37,20,37,57
04159600,GALAXY MEDICAL COLLEGE                  ,CA,91606-1593,Proprietary  ,8,16,24,39,41,80
04159700,AMERICAN MEDICAL SCIENCES CENTER        ,CA,91204-5108,Proprietary  ,16,28,44,62,69,131
04160100,TRINITY VOCATIONAL CENTER               ,CA,90248-4334,Proprietary  ,4,45,49,16,88,104
04160400,ANGELES COLLEGE OF NURSING              ,CA,90010-2100,Proprietary  ,59,148,207,380,442,822
04161300,PREFERRED COLLEGE OF NURSING            ,CA,91401-1442,Proprietary  ,6,35,41,22,63,85
04161700,SHASTA SCHOOL OF COSMETOLOGY            ,CA,96003-0000,Proprietary  ,18,45,63,81,101,182
04161800,BRANDMAN UNIVERSITY                     ,CA,92618-3801,Private      ,109,2406,2515,406,5909,6315
04162800,S.I.C.E PAUL MITCHELL PARTNER SCHOOL    ,CA,95350-1440,Proprietary  ,58,90,148,210,202,412
04163400,COSMO BEAUTY ACADEMY                    ,CA,95605-1904,Proprietary  ,34,80,114,143,223,366
04164400,ANGELES INSTITUTE                       ,CA,90712-2903,Proprietary  ,27,79,106,60,120,180
04165900,PAUL MITCHELL THE SCHOOL FRESNO         ,CA,93710-7617,Proprietary  ,80,91,171,300,188,488
04167000,PAUL MITCHELL THE SCHOOL TEMECULA       ,CA,92591-4663,Proprietary  ,74,108,182,209,199,408
04169200,TRAMY BEAUTY SCHOOL                     ,CA,92115-6347,Proprietary  ,24,87,111,78,134,212
04169700,UNITEK COLLEGE                          ,CA,94538-3185,Proprietary  ,146,647,793,333,1320,1653
04169800,GURNICK ACADEMY OF MEDICAL ARTS         ,CA,94403-1849,Proprietary  ,79,425,504,242,1154,1396
04172000,SOUTHERN CALIFORNIA UNIVERSITY SOMA     ,CA,90017-2211,Proprietary  ,30,111,141,200,281,481
04173400,SANTA ANA BEAUTY ACADEMY                ,CA,92705-7820,Proprietary  ,7,14,21,35,36,71
04173500,MORENO VALLEY COLLEGE                   ,CA,92551-2204,Public       ,944,1726,2670,4512,5130,9642
04175200,PAUL MITCHELL THE SCHOOL EAST BAY       ,CA,94523-5515,Proprietary  ,55,81,136,138,160,298
04175400,ELITE COSMETOLOGY SCHOOL                ,CA,92284-2860,Proprietary  ,7,44,51,13,76,89
04176100,NORCO COLLEGE                           ,CA,92860-2600,Public       ,844,1223,2067,4301,3712,8013
04176200,TWIN RIVERS ADULT SCHOOL                ,CA,95660-5523,Public       ,3,10,13,7,20,27
04176300,BERGIN UNIVERSITY OF CANINE STUDIES     ,CA,95407-6834,Private      ,10,20,30,32,54,86
04177200,REAL BARBERS COLLEGE (THE)              ,CA,92805-2533,Proprietary  ,21,48,69,48,83,131
04178900,HANDS-ON MEDICAL MASSAGE SCHOOL         ,CA,92373-6271,Proprietary  ,6,5,11,19,34,53
04180000,CINTA AVEDA INSTITUTE                   ,CA,94108-3204,Proprietary  ,41,130,171,118,276,394
04181200,IPPT CAREER SCHOOL                      ,CA,91601-2028,Proprietary  ,12,81,93,22,98,120
04181600,INTEGRITY COLLEGE OF HEALTH             ,CA,91104-2300,Proprietary  ,6,37,43,19,57,76
04185200,SALINAS BEAUTY COLLEGE                  ,CA,93901-2405,Proprietary  ,17,45,62,52,73,125
04185500,ACADEMY OF COUTURE ART                  ,CA,90069-5701,Proprietary  ,29,44,73,124,110,234
04185600,MEDICAL ALLIED CAREER CENTER            ,CA,90670-4710,Proprietary  ,2,29,31,14,59,73
04185700,ACADEMY FOR SALON PROFESSIONALS (THE)   ,CA,95050-4057,Proprietary  ,20,54,74,56,95,151
04186900,"INTERNATIONAL COLLEGE OF BEAUTY, ARTS & ",CA,90039-1012,Proprietary  ,18,63,81,105,136,241
04187900,JOE BLASCO MAKEUP ARTIST TRAINING CENTER,CA,90027-5580,Proprietary  ,0,0,0,4,7,11
04189300,ALLIED AMERICAN UNIVERSITY              ,CA,92653-1337,Proprietary  ,31,624,655,67,1234,1301
04189700,CALIFORNIA MIRAMAR UNIVERSITY           ,CA,92126-7501,Proprietary  ,80,181,261,404,471,875
04189800,ACADEMY FOR SALON PROFESSIONALS         ,CA,91304-2305,Proprietary  ,8,27,35,32,60,92
04190800,SANTA ANA BEAUTY COLLEGE                ,CA,92706-2321,Proprietary  ,22,51,73,67,80,147
04190900,SUTTER BEAUTY COLLEGE                   ,CA,95991-3624,Proprietary  ,23,29,52,66,89,155
04191300,ANNENBERG SCHOOL OF NURSING             ,CA,91335-5426,Private      ,9,23,32,43,54,97
04193500,LEMELANGE ACADEMY OF HAIR               ,CA,94558-2935,Proprietary  ,2,15,17,15,32,47
04193700,JOHN PAUL THE GREAT CATHOLIC UNIVERSITY ,CA,92131-1652,Private      ,55,42,97,218,80,298
04194300,COLTON-REDLANDS-YUCAIPA REGIONAL OCCUPAT,CA,92374-2896,Public       ,18,64,82,77,134,211
04194600,BRAND COLLEGE                           ,CA,91203-3646,Proprietary  ,3,16,19,24,37,61
04195200,DIAMOND BEAUTY COLLEGE                  ,CA,91733-2180,Proprietary  ,1,10,11,11,19,30
04195400,NCP COLLEGE OF NURSING                  ,CA,94080-1005,Proprietary  ,24,72,96,69,164,233
04195401,NCP COLLEGE OF NURSING - HAYWARD CAMPUS ,CA,94541-7026,Proprietary  ,27,101,128,100,251,351
04205800,"SAE INSTITUTE OF TECHNOLOGY, LOS ANGELES",CA,90028-7219,Proprietary  ,71,100,171,216,263,479
04206800,ADVANCE BEAUTY TECHS ACADEMY            ,CA,92583-6572,Proprietary  ,12,28,40,32,54,86
04208100,UKIAH ADULT SCHOOL                      ,CA,95482-3865,Public       ,6,21,27,17,54,71
04208400,RIVERSIDE COUNTY OFFICE OF EDUCATION    ,CA,92503-3504,Public       ,48,130,178,265,349,614
04208900,ADVANCED CAREER INSTITUTE               ,CA,93291-9254,Proprietary  ,23,113,136,63,176,239
04209800,HINTON BARBER COLLEGE                   ,CA,94590-4547,Proprietary  ,8,27,35,20,54,74
04210600,ADVANCED COMPUTING INSTITUTE            ,CA,90010-3911,Proprietary  ,19,46,65,117,111,228
04211900,XAVIER COLLEGE SCHOOL OF NURSING        ,CA,95202-1332,Proprietary  ,26,97,123,133,249,382
04212000,LAWRENCE & COMPANY COLLEGE OF COSMETOLOG,CA,93230-4102,Proprietary  ,25,38,63,67,66,133
04215100,CALIFORNIA CAREER INSTITUTE             ,CA,92840-2816,Proprietary  ,9,84,93,32,157,189
04215300,COSMO FACTORY COSMETOLOGY ACADEMY (THE) ,CA,95060-4401,Proprietary  ,2,17,19,35,51,86
04216300,UEI COLLEGE                             ,CA,95065-1520,Proprietary  ,17,44,61,89,100,189
04217100,RUDOLF STEINER COLLEGE                  ,CA,95628-6811,Private      ,1,22,23,4,54,58
04217500,W INSTITUTE OF COSMETOLOGY              ,CA,94521-5385,Proprietary  ,5,12,17,25,39,64
04221800,TONI&GUY HAIRDRESSING ACADEMY           ,CA,95337-5703,Proprietary  ,19,32,51,52,62,114
04221900,COMPUTER TRAINING ACADEMY               ,CA,92507-2122,Proprietary  ,17,116,133,90,239,329
04222200,FAB SCHOOL (THE)                        ,CA,92507-3434,Proprietary  ,34,100,134,92,167,259
04223700,BAY AREA MEDICAL ACADEMY                ,CA,94102-2844,Proprietary  ,41,71,112,166,201,367
04226100,LAWRENCE AND COMPANY COLLEGE OF COSMETOL,CA,93662-3509,Proprietary  ,9,16,25,19,30,49
04228100,HIGH DESERT MEDICAL COLLEGE             ,CA,93534-1134,Proprietary  ,61,150,211,83,238,321
04228800,BAY AREA COLLEGE OF NURSING             ,CA,94303-4617,Proprietary  ,1,11,12,1,11,12
04237100,SALON PROFESSIONAL ACADEMY (THE)        ,CA,95129-5101,Proprietary  ,21,58,79,21,58,79
04237800,CALIFORNIA BARBER AND BEAUTY COLLEGE    ,CA,92115-4730,Proprietary  ,1,3,4,1,3,4
00184600,BRIAR CLIFF UNIVERSITY                  ,IA,51104-2100,Private      ,222,240,462,1105,493,1598
00184700,BUENA VISTA UNIVERSITY                  ,IA,50588-9987,Private      ,432,838,1270,1404,1417,2821
00184800,SOUTHEASTERN COMMUNITY COLLEGE          ,IA,52655-0000,Public       ,275,480,755,849,966,1815
00185000,CENTRAL COLLEGE                         ,IA,50219-1999,Private      ,387,33,420,2152,88,2240
00185200,CLARKE UNIVERSITY                       ,IA,52001-3198,Private      ,235,181,416,1154,424,1578
00185400,COE COLLEGE                             ,IA,52402-5092,Private      ,159,63,222,2428,212,2640
00185500,DES MOINES UNIV-OSTEOPATHIC MED CTR     ,IA,50312-0000,Private      ,7,756,763,47,1499,1546
00185600,CORNELL COLLEGE                         ,IA,52314-1098,Private      ,228,29,257,1849,106,1955
00185700,SOUTHWESTERN COMMUNITY COLLEGE          ,IA,50801-1098,Public       ,207,182,389,551,334,885
00185800,DIVINE WORD COLLEGE                     ,IA,52045-0380,Private      ,2,1,3,7,4,11
00185900,DORDT COLLEGE                           ,IA,51250-1697,Private      ,280,36,316,1439,84,1523
00186000,DRAKE UNIVERSITY                        ,IA,50311-4505,Private      ,419,567,986,4790,1642,6432
00186200,ELLSWORTH COMMUNITY COLLEGE             ,IA,50126-1199,Public       ,236,110,346,694,213,907
00186400,IOWA LAKES COMMUNITY COLLEGE            ,IA,51334-2234,Public       ,289,266,555,873,502,1375
00186500,IOWA CENTRAL COMMUNITY COLLEGE          ,IA,50501-0000,Public       ,731,910,1641,2438,1920,4358
00186600,GRACELAND UNIVERSITY                    ,IA,50140-1699,Private      ,466,617,1083,1267,1157,2424
00186700,GRAND VIEW UNIVERSITY                   ,IA,50316-1599,Private      ,545,446,991,1963,1051,3014
00186800,GRINNELL COLLEGE                        ,IA,50112-1690,Private      ,345,22,367,3203,111,3314
00186900,IOWA STATE UNIV SCIENCE & TECHNOLOG     ,IA,50011-2028,Public       ,2067,1187,3254,27594,5269,32863
00187100,IOWA WESLEYAN COLLEGE                   ,IA,52641-1398,Private      ,142,102,244,555,221,776
00187300,LORAS COLLEGE                           ,IA,52004-0178,Private      ,417,78,495,1918,158,2076
00187400,LUTHER COLLEGE                          ,IA,52101-1045,Private      ,393,30,423,3063,111,3174
00187500,MARSHALLTOWN COMMUNITY COLLEGE          ,IA,50158-4760,Public       ,215,292,507,626,514,1140
00187700,NORTH IOWA AREA COMMUNITY COLLEGE       ,IA,50401-7299,Public       ,326,310,636,1111,621,1732
00187900,MORNINGSIDE COLLEGE                     ,IA,51106-1751,Private      ,253,261,514,1999,544,2543
00188000,MOUNT MERCY UNIVERSITY                  ,IA,52402-4797,Private      ,323,470,793,949,825,1774
00188300,NORTHWESTERN COLLEGE                    ,IA,51041-1996,Private      ,405,72,477,1356,138,1494
00188700,SIMPSON COLLEGE                         ,IA,50125-1297,Private      ,477,190,667,2065,381,2446
00188900,ST AMBROSE UNIVERSITY                   ,IA,52803-2898,Private      ,530,443,973,3047,1083,4130
00189000,UNIVERSITY OF NORTHERN IOWA             ,IA,50614-0002,Public       ,2115,894,3009,9113,2114,11227
00189100,UNIVERSITY OF DUBUQUE                   ,IA,52001-5099,Private      ,466,250,716,1991,531,2522
00189200,UNIVERSITY OF IOWA                      ,IA,52242-1316,Public       ,2634,2064,4698,20577,7642,28219
00189300,UPPER IOWA UNIVERSITY                   ,IA,52142-9206,Private      ,432,1766,2198,1545,3689,5234
00189500,WALDORF COLLEGE                         ,IA,50436-1700,Proprietary  ,217,345,562,602,699,1301
00189600,WARTBURG COLLEGE                        ,IA,50677-2200,Private      ,283,26,309,2165,95,2260
00189700,WARTBURG THEOLOGICAL SEMINARY           ,IA,52004-5004,Private      ,0,49,49,9,107,116
00190000,WILLIAM PENN UNIVERSITY                 ,IA,52577-1799,Private      ,444,402,846,1141,742,1883
00396300,AIB COLLEGE OF BUSINESS                 ,IA,50321-1799,Private      ,215,256,471,720,594,1314
00407500,ESTRN IOWA COMMUNITY COLLEGE DIST       ,IA,52801-1221,Public       ,68,198,266,179,410,589
00407501,CLINTON COMMUNITY COLLEGE               ,IA,52732-0000,Public       ,153,744,897,380,1657,2037
00407502,MUSCATINE COMMUNITY COLLEGE             ,IA,52761-0000,Public       ,186,232,418,464,437,901
00407503,SCOTT COMMUNITY COLLEGE                 ,IA,52722-0000,Public       ,521,915,1436,1154,1770,2924
00407600,KIRKWOOD COMMUNITY COLLEGE              ,IA,52406-2068,Public       ,1919,2141,4060,5041,4066,9107
00423300,MERCY/ST. LUKE'S SCH RAD TECH           ,IA,52402-0000,Private      ,16,21,37,37,35,72
00458600,KAPLAN UNIVERSITY                       ,IA,52807-2095,Proprietary  ,1132,25426,26558,2052,46723,48775
00458604,KAPLAN UNIVERSITY - CEDAR RAPIDS        ,IA,52404-2998,Proprietary  ,64,716,780,113,1275,1388
00458605,KAPLAN UNIVERSITY - DES MOINES          ,IA,50323-5702,Proprietary  ,69,857,926,133,1461,1594
00458606,KAPLAN UNIVERSITY - MASON CITY          ,IA,50401-4665,Proprietary  ,28,351,379,41,591,632
00458607,KAPLAN UNIVERSITY - CEDAR FALLS         ,IA,50613-6309,Proprietary  ,55,520,575,90,952,1042
00458700,NORTHEAST IOWA COMMUNITY COLLEGE        ,IA,52132-0400,Public       ,190,206,396,528,407,935
00458701,NORTHEAST IOWA COMMUNITY COLLEGE        ,IA,52068-0000,Public       ,288,388,676,751,756,1507
00459500,HAWKEYE COMMUNITY COLLEGE               ,IA,50701-0000,Public       ,856,811,1667,2041,1451,3492
00459800,IOWA WESTERN CMTY CLG-COUNCIL BLUFF     ,IA,51502-0000,Public       ,1073,1107,2180,2948,2468,5416
00460000,NORTHWEST IOWA COMMUNITY COLLEGE        ,IA,51201-1046,Public       ,199,173,372,481,297,778
00626700,IOWA METHODIST MEDICAL CENTER SCHOOLS   ,IA,50309-1499,Private      ,7,38,45,36,75,111
00627300,MERCY COLLEGE OF HEALTH SCIENCES        ,IA,50309-1239,Private      ,144,335,479,409,676,1085
00712000,DES MOINES AREA CMTY COLLEGE            ,IA,50021-0000,Public       ,2310,3298,5608,6189,6290,12479
00712100,FAITH BAPTIST BIBLE CLG & THEOL SEM     ,IA,50021-0000,Private      ,89,30,119,252,53,305
00729100,ST LUKE'S COLLEGE                       ,IA,51104-0263,Private      ,45,78,123,128,172,300
00731600,WESTERN IOWA TECH COMMUNITY COLLEGE     ,IA,51106-0000,Public       ,637,1011,1648,1584,1931,3515
00758800,CAPRI COLLEGE                           ,IA,52004-0873,Proprietary  ,41,63,104,91,109,200
00761100,EQ SCHOOL OF HAIR DESIGN                ,IA,51503-0813,Proprietary  ,15,31,46,29,41,70
00765600,AMERICAN COLLEGE OF HARISTYLING -CR     ,IA,52402-0000,Proprietary  ,5,15,20,8,27,35
00765800,AMER COLL OF HAIRSTYLING-DES MOINES     ,IA,50309-5446,Proprietary  ,4,16,20,17,31,48
00765900,LA JAMES COLLEGE OF HAIRSTYLING         ,IA,50401-3308,Proprietary  ,18,20,38,47,40,87
00771700,CAPRI COLLEGE                           ,IA,52807-2622,Proprietary  ,41,63,104,93,127,220
00794100,COLLEGE OF HAIR DESIGN                  ,IA,50703-1834,Proprietary  ,2,12,14,6,29,35
00826000,IOWA SCHOOL OF BEAUTY INC               ,IA,50322-0000,Proprietary  ,44,93,137,83,159,242
00840300,INDIAN HILLS COMMUNITY COLLEGE          ,IA,52501-1398,Public       ,589,775,1364,1499,1471,2970
00842400,LA JAMES INTERNATIONAL COLLEGE          ,IA,50501-5577,Proprietary  ,11,19,30,38,39,77
00959300,LA'JAMES COLLEGE OF HAIRSTYLING         ,IA,52240-0000,Proprietary  ,20,40,60,40,57,97
01111300,MAHARISHI UNIV OF MANAGEMENT            ,IA,52557-0001,Private      ,51,177,228,104,322,426
01206400,HAMILTON TECHNICAL COLLEGE              ,IA,52807-2653,Proprietary  ,30,97,127,61,160,221
01230000,PALMER COLLEGE OF CHIROPRACTIC          ,IA,52803-5287,Private      ,19,934,953,77,1935,2012
01300600,LA' JAMES INTERNATIONAL COLLEGE-CF      ,IA,50613-5242,Proprietary  ,15,19,34,25,38,63
02090300,CAPRI COLLEGE                           ,IA,52404-0000,Proprietary  ,49,60,109,95,111,206
02134500,LA JAMES INTERNATIONAL COLLEGE - DAV    ,IA,52806-3952,Proprietary  ,9,20,29,19,50,69
02160900,PCI ACADEMY                             ,IA,50010-6062,Proprietary  ,45,34,79,94,64,158
02262500,FAUST INSTITUTE OF COSMETOLOGY          ,IA,50588-0000,Proprietary  ,12,18,30,22,20,42
02274100,LA' JAMES INTERNATIONAL COLLEGE - DM    ,IA,50131-0000,Proprietary  ,16,26,42,37,53,90
02289000,AMERICAN HAIR ACADEMY                   ,IA,52627-4530,Proprietary  ,13,10,23,19,25,44
02306900,IOWA SCHOOL OF BEAUTY                   ,IA,52501-0000,Proprietary  ,16,22,38,31,42,73
02328900,EMMAUS BIBLE COLLEGE                    ,IA,52001-0000,Private      ,60,28,88,213,44,257
02330900,IOWA SCHOOL OF BEAUTY                   ,IA,50158-0000,Proprietary  ,8,14,22,15,26,41
02609200,VATTEROTT COLLEGE                       ,IA,50321-4704,Proprietary  ,35,170,205,74,348,422
03069100,ALLEN COLLEGE                           ,IA,50703-1916,Private      ,93,198,291,362,455,817
03441300,IOWA SCHOOL OF BEAUTY                   ,IA,51106-5111,Proprietary  ,11,32,43,25,57,82
03607400,TOTAL LOOK SCHOOL OF COSMETOLOGY AND MAS,IA,52136-1053,Proprietary  ,4,7,11,5,9,14
03720300,CARLSON COLLEGE OF MASSAGE THERAPY      ,IA,52205-7519,Proprietary  ,2,4,6,9,9,18
04051313,ART INSTITUTE OF PHOENIX (THE) - BROWN M,IA,52722-3628,Proprietary  ,4,34,38,14,71,85
04177800,SALON PROFESSIONAL ACADEMY (THE)        ,IA,52240-6083,Proprietary  ,17,20,37,33,34,67
04203300,AVEDA INSTITUTE DES MOINES              ,IA,50266-8137,Proprietary  ,78,58,136,142,108,250
00259600,ATLANTIC COMMUNITY COLLEGE              ,NJ,08330-2699,Public       ,1615,1818,3433,2882,2944,5826
00259700,BLOOMFIELD COLLEGE                      ,NJ,07003-3425,Private      ,916,588,1504,2820,1218,4038
00259800,CALDWELL COLLEGE                        ,NJ,07006-6195,Private      ,529,377,906,2383,819,3202
00259900,CENTENARY COLLEGE                       ,NJ,07840-2184,Private      ,283,354,637,1608,713,2321
00260000,COLLEGE OF SAINT ELIZABETH              ,NJ,07960-6989,Private      ,265,266,531,1110,528,1638
00260100,CUMBERLAND COUNTY COLLEGE               ,NJ,08362-9912,Public       ,1128,1448,2576,1753,2254,4007
00260300,DREW UNIVERSITY                         ,NJ,07940-4063,Private      ,366,197,563,2608,480,3088
00260700,FAIRLEIGH DICKINSON UNIV-TEANECK        ,NJ,07666-1996,Private      ,715,887,1602,3943,2153,6096
00260701,FAIRLEIGH DICKINSON UNIV-FLORHAM        ,NJ,07940-0000,Private      ,450,378,828,3607,909,4516
00260702,FAIRLEIGH DICKINSON UNIV-ED WMS CLG     ,NJ,07601-0000,Private      ,156,206,362,559,432,991
00260703,FAIRLEIGH DICKINSON UNIVERSITY          ,NJ,07940-0000,Private      ,239,276,515,1449,603,2052
00260800,GEORGIAN COURT UNIVERSITY               ,NJ,08701-2697,Private      ,580,477,1057,1567,956,2523
00260900,ROWAN UNIVERSITY                        ,NJ,08028-1702,Public       ,3818,2286,6104,14465,4766,19231
00261000,FELICIAN COLLEGE                        ,NJ,07644-2198,Private      ,560,543,1103,1793,1023,2816
00261300,NEW JERSEY CITY UNIVERSITY              ,NJ,07305-1597,Public       ,1595,2449,4044,4624,4665,9289
00261500,MIDDLESEX COUNTY COLLEGE                ,NJ,08818-3050,Public       ,2784,2055,4839,5311,3604,8915
00261600,MONMOUTH UNIVERSITY                     ,NJ,07764-1898,Private      ,1472,868,2340,7974,2069,10043
00261700,MONTCLAIR STATE UNIVERSITY              ,NJ,07043-9987,Public       ,4524,3113,7637,18795,6551,25346
00261900,NEW BRUNSWICK THEOLOGICAL SEMINARY      ,NJ,08901-0000,Private      ,29,82,111,81,130,211
00262100,NEW JERSEY INST OF TECHNOLOGY           ,NJ,07102-1982,Public       ,1543,1344,2887,6902,3126,10028
00262200,KEAN UNIVERSITY                         ,NJ,07083-7131,Public       ,3897,3866,7763,11034,7334,18368
00262400,OCEAN COUNTY COLLEGE                    ,NJ,08754-2001,Public       ,2052,1560,3612,3818,2760,6578
00262500,WILLIAM PATERSON UNIVERSITY             ,NJ,07470-2152,Public       ,3730,2519,6249,12382,4517,16899
00262600,PRINCETON THEOLOGICAL SEMINARY          ,NJ,08542-0000,Private      ,3,208,211,15,536,551
00262700,PRINCETON UNIVERSITY                    ,NJ,08544-0001,Private      ,1502,252,1754,16021,1407,17428
00262800,RIDER UNIVERSITY                        ,NJ,08648-3099,Private      ,1050,498,1548,8155,1357,9512
00262900,"RUTGERS, THE STATE UNIVERSITY OF NJ     ",NJ,08901-1281,Public       ,8973,9262,18235,46292,23590,69882
00263200,SETON HALL UNIVERSITY                   ,NJ,07079-2697,Private      ,1152,1146,2298,11602,3232,14834
00263201,SETON HALL UNIVERSITY - SCHOOL OF LAW   ,NJ,07079-5210,Private      ,63,388,451,226,1328,1554
00263800,SAINT PETER'S UNIVERSITY                ,NJ,07306-5997,Private      ,1075,759,1834,3814,1490,5304
00263900,STEVENS INSTITUTE OF TECHNOLOGY         ,NJ,07030-5370,Private      ,757,219,976,4851,479,5330
00264200,COLLEGE OF NEW JERSEY (THE)             ,NJ,08628-0718,Public       ,1439,483,1922,11496,1169,12665
00264300,UNION COUNTY COLLEGE                    ,NJ,07016-1598,Public       ,2307,3189,5496,3976,5266,9242
00473600,BERGEN COMMUNITY COLLEGE                ,NJ,07652-1595,Public       ,2960,2011,4971,6632,4081,10713
00474000,MERCER COUNTY COMMUNITY COLLEGE         ,NJ,08690-0000,Public       ,1455,1648,3103,2679,2834,5513
00539900,MONMOUTH COUNTY VOCATIONAL SCH DIST     ,NJ,07728-5033,Public       ,27,72,99,53,93,146
00545200,TETERBORO SCH OF AERONAUTICS            ,NJ,07608-1083,Proprietary  ,20,34,54,52,64,116
00546100,SALEM COMMUNITY COLLEGE                 ,NJ,08069-2799,Public       ,274,285,559,450,486,936
00641700,HOLY NAME HOSPITAL SCH OF NURSING       ,NJ,07666-4254,Private      ,26,117,143,71,230,301
00642000,MOUNTAINSIDE HOSP SCH NRSG              ,NJ,07042-4898,Proprietary  ,17,76,93,41,160,201
00642100,MUHLENBERG SNYDER SCHOOLS               ,NJ,07061-3399,Private      ,47,223,270,89,374,463
00642900,ST FRANCIS MEDICAL CTR SCH NURSING      ,NJ,08629-1986,Private      ,17,46,63,29,90,119
00642902,ST FRANCIS MED CTR RAD TECH             ,NJ,08629-0000,Private      ,8,15,23,11,34,45
00686500,CAMDEN COUNTY COLLEGE                   ,NJ,08012-3240,Public       ,2533,2920,5453,4577,5260,9837
00690100,GLOUCESTER COUNTY COLLEGE               ,NJ,08080-4249,Public       ,1597,1216,2813,3010,2210,5220
00710700,ESSEX COUNTY COLLEGE                    ,NJ,07102-1798,Public       ,2199,3312,5511,4299,6428,10727
00750200,BERKELEY COLLEGE                        ,NJ,07424-3367,Proprietary  ,1245,1811,3056,2105,2761,4866
00759300,PARISIAN BEAUTY ACADEMY                 ,NJ,07601-5509,Proprietary  ,94,110,204,131,152,283
00772900,COUNTY COLLEGE OF MORRIS                ,NJ,07869-0000,Public       ,1420,793,2213,2957,1377,4334
00773000,BURLINGTON COUNTY COLLEGE               ,NJ,08068-1599,Public       ,1715,1746,3461,3352,3294,6646
00773100,RARITAN VALLEY COMMUNITY COLLEGE        ,NJ,08876-1265,Public       ,1076,844,1920,2092,1463,3555
00780401,STAR CAREER ACADEMY - STAR LAKEWOOD     ,NJ,08701-5900,Proprietary  ,42,125,167,63,190,253
00780402,STAR CAREER ACADEMY - STAR EGG HARBOR   ,NJ,08234-4863,Proprietary  ,25,84,109,37,136,173
00793808,LINCOLN TECHNICAL INSTITUTE - SOUTH PLAI,NJ,07080-2424,Proprietary  ,103,121,224,140,156,296
00793810,LINCOLN TECHNICAL INSTITUTE - MAHWAH    ,NJ,07430-2106,Proprietary  ,270,195,465,355,238,593
00793811,LINCOLN TECHNICAL INSTITUTE - UNION     ,NJ,07083-5032,Proprietary  ,342,305,647,461,426,887
00794700,BETH MEDRASH GOVOHA OF AMERICA          ,NJ,08701-0000,Private      ,70,909,979,83,982,1065
00840400,BROOKDALE COMMUNITY COLLEGE             ,NJ,07738-1597,Public       ,2241,1599,3840,4277,2789,7066
00844101,ANTHEM INSTITUTE                        ,NJ,08002-0000,Proprietary  ,30,113,143,60,218,278
00849400,HO HO KUS SCHL OF TRADE & TECH SCIENCES ,NJ,07513-1402,Proprietary  ,36,72,108,63,115,178
00860900,RABBINICAL COLLEGE OF AMERICA           ,NJ,07960-3600,Private      ,13,3,16,18,5,23
00907800,CAPRI INSTITUTE OF HAIR DESIGN          ,NJ,07011-2111,Proprietary  ,35,79,114,45,107,152
00934400,RAMAPO COLLEGE OF NEW JERSEY            ,NJ,07430-1680,Public       ,1327,554,1881,7242,1272,8514
00934500,RICHARD STOCKTON COLLEGE OF NJ          ,NJ,08240-0000,Public       ,2241,1128,3369,8896,2772,11668
00982804,EVEREST INSTITUTE - SOUTH PLAINFIELD    ,NJ,07080-1125,Proprietary  ,82,193,275,122,304,426
00999400,PASSAIC COUNTY COMMUNITY COLLEGE        ,NJ,07505-1179,Public       ,1662,1873,3535,2929,3056,5985
01062900,P B COSMETOLOGY EDUCATION CENTRE        ,NJ,08030-1750,Proprietary  ,49,60,109,68,78,146
01085100,ANTHEM INSTITUTE                        ,NJ,07054-3409,Proprietary  ,100,311,411,128,451,579
01085101,ANTHEM INSTITUTE                        ,NJ,07306-0000,Proprietary  ,13,52,65,28,90,118
01085102,ANTHEM INSTITUTE                        ,NJ,08902-0000,Proprietary  ,11,32,43,29,67,96
01090300,RIZZIERI INSTITUTE                      ,NJ,08043-4600,Proprietary  ,52,51,103,82,95,177
01152300,MORRIS COUNTY SCHOOL OF TECHNOLOGY      ,NJ,07834-0000,Public       ,30,50,80,48,71,119
01198900,TALMUDICAL ACADEMY                      ,NJ,07710-0000,Private      ,28,2,30,28,2,30
01209000,ROBERT FIANCE BEAUTY SCHOOLS            ,NJ,08861-4118,Proprietary  ,37,55,92,45,70,115
01246100,LINCOLN TECHNICAL INSTITUTE             ,NJ,08820-2896,Proprietary  ,122,292,414,191,449,640
01246102,LINCOLN TECHNICAL INSTITUTE             ,NJ,08057-3212,Proprietary  ,115,356,471,165,482,647
01246103,LINCOLN TECHNICAL INSTITUTE             ,NJ,07652-2106,Proprietary  ,162,295,457,256,483,739
01246200,HOHOKUS - HACKENSACK SCHOOL OF BUSINESS ,NJ,07601-7197,Proprietary  ,58,179,237,74,275,349
01295400,HUDSON COUNTY COMMUNITY COLLEGE         ,NJ,07306-4012,Public       ,2016,2558,4574,3715,3978,7693
02053700,EASTWICK COLLEGE                        ,NJ,07446-0000,Proprietary  ,147,478,625,228,774,1002
02061800,ROMAN ACADEMY OF BEAUTY CULTURE         ,NJ,07506-0000,Proprietary  ,7,7,14,10,10,20
02092300,HOHOKUS SCHOOL - RETS/NUTLEY            ,NJ,07110-0000,Proprietary  ,67,137,204,91,187,278
02103700,CAPRI INSTITUTE OF HAIR DESIGN          ,NJ,07652-0000,Proprietary  ,25,31,56,38,54,92
02104000,HARRIS SCHOOL OF BUSINESS               ,NJ,08002-2983,Proprietary  ,109,615,724,146,763,909
02106601,AMERICAN INSTITUTE - CLIFTON            ,NJ,07011-2345,Proprietary  ,86,222,308,99,304,403
02106605,AMERICAN INSTITUTE - TOMS RIVER         ,NJ,08755-1524,Proprietary  ,38,175,213,45,230,275
02131100,DU CRET SCHOOL OF THE ARTS              ,NJ,07060-0000,Private      ,10,6,16,21,9,30
02131600,PENNCO TECH                             ,NJ,08012-0000,Proprietary  ,190,247,437,254,345,599
02132300,FORTIS INSTITUTE                        ,NJ,07470-7041,Proprietary  ,147,261,408,187,311,498
02146800,JOE KUBERT SCH OF CARTOON & GRAPHIC     ,NJ,07801-0000,Proprietary  ,43,27,70,80,51,131
02154000,DIVERS ACAD OF EASTERN SEABOARD         ,NJ,08081-1139,Proprietary  ,35,54,89,66,109,175
02183600,CAPRI INSTITUTE OF HAIR DESIGN          ,NJ,07033-0000,Proprietary  ,22,65,87,39,87,126
02192200,THOMAS EDISON STATE COLLEGE             ,NJ,08608-0000,Public       ,203,2845,3048,446,5491,5937
02219600,OMEGA INSTITUTE                         ,NJ,08109-0000,Proprietary  ,12,57,69,25,94,119
02223700,ROBERT FIANCE BEAUTY SCHOOLS            ,NJ,07093-4623,Proprietary  ,13,25,38,17,32,49
02223900,DRAKE COLLEGE OF BUSINESS               ,NJ,07201-0000,Proprietary  ,32,298,330,44,344,388
02223902,DRAKE COLLEGE OF BUSINESS - NEWARK CAMPU,NJ,07112-2760,Proprietary  ,67,429,496,108,541,649
02232500,UNION COUNTY VOCATIONAL TECH INST       ,NJ,07076-0000,Public       ,29,30,59,59,62,121
02234600,ATLANTIC BEAUTY & SPA ACADEMY           ,NJ,08234-2621,Proprietary  ,35,68,103,45,91,136
02246000,ROSS UNIVERSITY - MEDICAL SCHOOL        ,NJ,08837-0000,Proprietary  ,8,960,968,28,2423,2451
02248600,COOPER HEALTH SYS-CTR ALLIED HEALTH     ,NJ,08103-0000,Private      ,36,116,152,87,276,363
02265500,CAPRI INSTITUTE OF HAIR DESIGN          ,NJ,08724-0000,Proprietary  ,13,42,55,23,58,81
02277900,ROSS UNIV - SCH OF VETERINARY MED       ,NJ,08837-0000,Proprietary  ,3,242,245,14,1303,1317
02312000,BERGEN COUNTY TECHNICAL SCHOOLS         ,NJ,07601-6110,Public       ,37,49,86,80,92,172
02503900,WARREN COUNTY COMMUNITY COLLEGE         ,NJ,07882-0000,Public       ,288,247,535,501,462,963
02523700,OCEAN COUNTY VOCATIONAL-TECH SCHOOL     ,NJ,08753-0000,Public       ,121,219,340,204,347,551
02525900,ARTISTIC ACADEMY OF HAIR DESIGN         ,NJ,07950-1409,Proprietary  ,27,21,48,55,45,100
02528200,ROBERT FIANCE BEAUTY SCHOOLS            ,NJ,07060-4840,Proprietary  ,17,54,71,23,70,93
02558700,PRISM CAREER INSTITUTE                  ,NJ,08037-0000,Proprietary  ,61,292,353,95,493,588
02568800,SUSSEX COUNTY COMMUNITY COLLEGE         ,NJ,07860-1149,Public       ,613,390,1003,1188,702,1890
02586900,HARRIS SCHOOL OF BUSINESS               ,NJ,08043-2604,Proprietary  ,58,262,320,70,313,383
02616402,SANFORD-BROWN INSTITUTE - ISELIN        ,NJ,08830-0000,Proprietary  ,77,189,266,111,320,431
03077500,RABBI JACOB JOSEPH SCHOOL               ,NJ,08817-4494,Private      ,14,0,14,15,2,17
03122600,EASTERN INTERNATIONAL COLLEGE           ,NJ,07306-3906,Proprietary  ,100,240,340,126,316,442
03187300,STENOTECH CAREER INSTITUTE              ,NJ,07004-3490,Proprietary  ,6,12,18,11,22,33
03197300,INSTITUTE FOR HEALTH EDUCATION(THE)     ,NJ,07306-2929,Proprietary  ,15,41,56,26,79,105
03324300,CENTRAL CAREER SCHOOL                   ,NJ,07080-2408,Proprietary  ,6,33,39,8,45,53
03380302,STAR CAREER ACADEMY - STAR NEWARK       ,NJ,07102-4510,Proprietary  ,64,261,325,116,460,576
03380303,STAR CAREER ACADEMY - STAR CLIFTON      ,NJ,07011-2248,Proprietary  ,37,109,146,43,133,176
03389300,ACADEMY OF MASSAGE THERAPY              ,NJ,07631-0000,Proprietary  ,15,28,43,21,61,82
03536300,INSTITUTE FOR THERAPEUTIC MASSAGE       ,NJ,07420-1452,Proprietary  ,10,33,43,15,54,69
03650600,PC AGE                                  ,NJ,07306-3936,Proprietary  ,22,141,163,29,177,206
03650603,PC AGE                                  ,NJ,08817-2842,Proprietary  ,4,20,24,8,34,42
03666300,PILLAR COLLEGE                          ,NJ,07102-5511,Private      ,58,394,452,85,565,650
03803300,HEALTHCARE TRAINING INSTITUTE           ,NJ,07083-3504,Proprietary  ,27,134,161,40,216,256
03811300,EASTERN SCHOOL OF ACUPUNCTURE AND TRADIT,NJ,07042-3562,Proprietary  ,3,22,25,4,39,43
04081300,BAIS MEDRASH TORAS CHESED               ,NJ,08701-0000,Private      ,7,2,9,8,2,10
04123400,YESHIVAS BE'ER YITZCHOK                 ,NJ,07208-2380,Private      ,8,19,27,10,25,35
04125000,GENTLE HEALING SCHOOL OF MASSAGE        ,NJ,08512-3600,Proprietary  ,3,14,17,4,17,21
04131100,YESHIVA TORAS CHAIM                     ,NJ,08701-2120,Private      ,84,0,84,84,1,85
04131200,TOTAL IMAGE BEAUTY ACADEMY              ,NJ,07307-2943,Proprietary  ,8,30,38,15,55,70
04134100,JERSEY COLLEGE                          ,NJ,07608-1104,Proprietary  ,83,1129,1212,118,1596,1714
04136400,AMERICAN INSTITUTE OF MEDICAL SCIENCES &,NJ,07080-1183,Proprietary  ,33,105,138,53,177,230
04154500,STARTING POINTS FOR CHILDREN            ,NJ,07306-0001,Private      ,6,44,50,8,64,72
04154900,NATIONAL CAREER INSTITUTE               ,NJ,07018-2011,Proprietary  ,2,19,21,3,30,33
04154901,NATIONAL CAREER INSTITUTE - JERSEY CITY ,NJ,07306-4300,Proprietary  ,5,37,42,13,59,72
04173100,LAB PAUL MITCHELL PARTNER SCHOOL (THE)  ,NJ,08628-2500,Proprietary  ,41,42,83,54,61,115
04180300,MESIVTA KESER TORAH                     ,NJ,07719-2409,Private      ,0,0,0,0,1,1
04181400,BEST CARE TRAINING INSTITUTE            ,NJ,07018-1703,Proprietary  ,7,70,77,14,128,142
04184500,CHRISTINE VALMY INTERNATIONAL SCHOOL OF ,NJ,07058-9589,Proprietary  ,12,20,32,17,27,44
04188700,ASI CAREER INSTITUTE                    ,NJ,08012-1043,Proprietary  ,16,62,78,19,93,112
04192400,YESHIVA GEDOLAH ZICHRON LEYMA           ,NJ,07036-3905,Private      ,0,1,1,0,2,2
04207500,MEDICAL CAREER INSTITUTE                ,NJ,07712-7202,Proprietary  ,16,60,76,25,91,116
04216000,UNIVERSAL TRAINING INSTITUTE            ,NJ,08861-4106,Proprietary  ,12,43,55,18,70,88
04216100,YESHIVA YESODEI HATORAH                 ,NJ,08701-4946,Private      ,0,0,0,1,1,2
04216500,RIZZIERI INSTITUTE                      ,NJ,08043-1911,Proprietary  ,25,26,51,41,48,89
04218200,PAUL MITCHELL THE SCHOOL - JERSEY SHORE ,NJ,08723-3413,Proprietary  ,30,42,72,49,54,103
04218500,SALON PROFESSIONAL ACADEMY THE          ,NJ,07080-0000,Proprietary  ,10,46,56,28,80,108
00266500,VAUGHN COLLEGE OF AERONAUTICS AND TECHNO,NY,11369-9997,Private      ,376,281,657,1006,575,1581
00266600,ADELPHI UNIVERSITY                      ,NY,11530-4299,Private      ,1005,1291,2296,8267,3444,11711
00266700,DOWLING COLLEGE                         ,NY,11769-1999,Private      ,315,260,575,1663,747,2410
00266800,ALFRED UNIVERSITY                       ,NY,14802-1205,Private      ,386,182,568,3513,496,4009
00266900,BANK STREET COLLEGE OF EDUCATION        ,NY,10025-0000,Private      ,4,310,314,17,610,627
00267100,BARD COLLEGE                            ,NY,12504-5000,Private      ,239,114,353,3609,676,4285
00267400,NEW YORK THEOLOGICAL SEMINARY           ,NY,10115-0002,Private      ,0,102,102,2,171,173
00267700,BROOKLYN LAW SCHOOL                     ,NY,11201-0000,Private      ,19,653,672,71,2138,2209
00267800,BRYANT & STRATTON COLLEGE               ,NY,14203-1713,Proprietary  ,973,4960,5933,1811,10168,11979
00267803,BRYANT & STRATTON COLLEGE - GREECE      ,NY,14606-4227,Proprietary  ,118,443,561,241,850,1091
00267805,BRYANT & STRATTON COLLEGE - SYRACUSE    ,NY,13203-2502,Proprietary  ,192,438,630,421,991,1412
00267807,BRYANT & STRATTON COLLEGE - ALBANY      ,NY,12205-5230,Proprietary  ,100,285,385,195,651,846
00268100,CANISIUS COLLEGE                        ,NY,14208-1098,Private      ,759,570,1329,4207,1315,5522
00268500,CAZENOVIA COLLEGE                       ,NY,13035-1085,Private      ,221,49,270,1879,170,2049
00268700,CUNY-BROOKLYN COLLEGE                   ,NY,11210-2814,Public       ,4522,4370,8892,18801,9500,28301
00268800,CITY COLLEGE-CUNY                       ,NY,10031-9198,Public       ,4354,4046,8400,20319,9157,29476
00268900,CUNY-HUNTER COLLEGE                     ,NY,10021-0000,Public       ,5928,5431,11359,27233,13387,40620
00269000,QUEENS COLLEGE-CUNY                     ,NY,11367-1597,Public       ,4230,3319,7549,17293,7089,24382
00269100,CUNY- BOROUGH OF MANHATTAN CMTY CLG     ,NY,10007-1047,Public       ,9850,6429,16279,25174,12826,38000
00269200,CUNY BRONX COMMUNITY COLLEGE            ,NY,10453-3102,Public       ,3873,4002,7875,9694,7661,17355
00269300,CUNY-JOHN JAY CLG CRIMINAL JUSTICE      ,NY,10019-1093,Public       ,4351,3133,7484,16262,6882,23144
00269400,KINGSBOROUGH COMMUNITY COLLEGE          ,NY,11235-2398,Public       ,3974,2637,6611,11955,6062,18017
00269600,NY CITY COLLEGE OF TECHNOLOGY-CUNY      ,NY,11201-2983,Public       ,5050,3515,8565,17496,7546,25042
00269700,QUEENSBOROUGH COMMUNITY COLLEGE         ,NY,11364-1497,Public       ,5695,2919,8614,13020,5273,18293
00269800,CUNY THE COLLEGE OF STATEN ISLAND       ,NY,10314-6600,Public       ,3769,1820,5589,12935,3792,16727
00269900,CLARKSON UNIVERSITY                     ,NY,13699-5615,Private      ,957,170,1127,6300,482,6782
00270000,COLGATE ROCHESTER CROZER DIVINITY S     ,NY,14620-0000,Private      ,1,28,29,5,54,59
00270100,COLGATE UNIVERSITY                      ,NY,13346-1386,Private      ,248,20,268,4356,96,4452
00270300,COLLEGE OF MOUNT SAINT VINCENT          ,NY,10471-1093,Private      ,480,159,639,2543,401,2944
00270400,COLLEGE OF NEW ROCHELLE                 ,NY,10805-2339,Private      ,314,2055,2369,1221,2836,4057
00270500,COLLEGE OF SAINT ROSE                   ,NY,12203-1490,Private      ,726,568,1294,4558,1317,5875
00270700,COLUMBIA UNIVERSITY                     ,NY,10027-0000,Private      ,2063,4533,6596,21764,18750,40514
00270800,BARNARD COLLEGE-COLUMBIA UNIV           ,NY,10027-6598,Private      ,521,121,642,4369,370,4739
00270900,CONCORDIA COLLEGE                       ,NY,10708-1998,Private      ,218,226,444,883,429,1312
00271000,COOPER UNION                            ,NY,10003-7120,Private      ,152,96,248,1300,223,1523
00271100,CORNELL UNIVERSITY                      ,NY,14853-2801,Private      ,3395,1238,4633,29159,5549,34708
00271101,WEILL CORNELL MEDICAL COLLEGE AND GRADUA,NY,10021-0000,Private      ,10,145,155,30,557,587
00271200,D'YOUVILLE COLLEGE                      ,NY,14201-1084,Private      ,375,716,1091,1883,1788,3671
00271300,DOMINICAN COLLEGE                       ,NY,10962-1299,Private      ,420,347,767,1717,783,2500
00271800,ELMIRA COLLEGE                          ,NY,14901-2099,Private      ,382,105,487,2233,237,2470
00272200,FORDHAM UNIVERSITY                      ,NY,10458-5157,Private      ,2380,2435,4815,26066,7350,33416
00272600,GENERAL THEOLOGICAL SEMINARY            ,NY,10011-0000,Private      ,1,26,27,4,64,68
00272800,HAMILTON COLLEGE                        ,NY,13323-1218,Private      ,455,13,468,2964,68,3032
00272900,HARTWICK COLLEGE                        ,NY,13820-4020,Private      ,525,42,567,3815,181,3996
00273100,HOBART & WILLIAM SMITH COLLEGES         ,NY,14456-3397,Private      ,657,25,682,3503,90,3593
00273200,HOFSTRA UNIVERSITY                      ,NY,11549-1010,Private      ,1600,1524,3124,17203,4488,21691
00273400,HOUGHTON COLLEGE                        ,NY,14744-0128,Private      ,303,45,348,1277,115,1392
00273500,HILBERT COLLEGE                         ,NY,14075-1597,Private      ,222,101,323,923,224,1147
00273700,IONA COLLEGE                            ,NY,10801-1890,Private      ,1277,378,1655,7573,876,8449
00273900,ITHACA COLLEGE                          ,NY,14850-7130,Private      ,1060,215,1275,14755,932,15687
00274000,JEWISH THEOLOGICAL SEMINARY OF AMER     ,NY,10027-4649,Private      ,5,19,24,128,143,271
00274200,THE JUILLIARD SCHOOL                    ,NY,10023-6588,Private      ,207,145,352,1429,759,2188
00274400,KEUKA COLLEGE                           ,NY,14478-0000,Private      ,354,506,860,1531,999,2530
00274800,LEMOYNE COLLEGE                         ,NY,13214-1399,Private      ,732,336,1068,5281,777,6058
00274900,NEW YORK COLLEGE OF PODIATRIC MED       ,NY,10035-1940,Private      ,5,130,135,31,403,434
00275100,LONG ISLAND UNIVERSITY                  ,NY,11548-1326,Private      ,1949,3100,5049,11870,7543,19413
00275800,MANHATTAN COLLEGE                       ,NY,10471-4098,Private      ,965,238,1203,6803,624,7427
00275900,MANHATTAN SCHOOL OF MUSIC               ,NY,10027-4689,Private      ,89,158,247,587,554,1141
00276000,MANHATTANVILLE COLLEGE                  ,NY,10577-2132,Private      ,406,223,629,3036,546,3582
00276300,MARIA COLLEGE                           ,NY,12208-1798,Private      ,118,360,478,231,632,863
00276500,MARIST COLLEGE                          ,NY,12601-1387,Private      ,882,418,1300,9048,1022,10070
00276900,MARYMOUNT MANHATTAN COLLEGE             ,NY,10021-4597,Private      ,438,100,538,3580,300,3880
00277200,MERCY COLLEGE                           ,NY,10522-1189,Private      ,1227,2211,3438,5558,5077,10635
00277500,MOLLOY COLLEGE                          ,NY,11570-1100,Private      ,1042,853,1895,3972,1857,5829
00277700,MEDAILLE COLLEGE                        ,NY,14214-2695,Private      ,374,433,807,1459,1030,2489
00277800,MOUNT SAINT MARY COLLEGE                ,NY,12550-3494,Private      ,564,438,1002,3718,903,4621
00277900,NAZARETH COLLEGE OF ROCHESTER           ,NY,14618-3790,Private      ,649,565,1214,3741,1221,4962
00278200,NEW YORK INSTITUTE OF TECHNOLOGY        ,NY,11568-8000,Private      ,1102,805,1907,5781,1870,7651
00278202,NY INSTITUTE OF TECHNOLOGY-OSTEOPATHIC M,NY,11568-0000,Private      ,9,649,658,64,1110,1174
00278300,NEW YORK LAW SCHOOL                     ,NY,10013-0000,Private      ,16,676,692,58,1918,1976
00278400,NEW YORK MEDICAL COLLEGE                ,NY,10595-0000,Private      ,14,827,841,40,1762,1802
00278500,NEW YORK UNIVERSITY                     ,NY,10012-1091,Private      ,3949,5733,9682,40721,24148,64869
00278520,NEW YORK UNIVERSITY - BROOKLYN          ,NY,11201-3840,Private      ,0,0,0,751,163,914
00278800,NIAGARA UNIVERSITY                      ,NY,14109-2010,Private      ,851,343,1194,3579,703,4282
00279000,NYACK COLLEGE                           ,NY,10960-3698,Private      ,270,555,825,1134,1047,2181
00279100,PACE UNIVERSITY - NEW YORK              ,NY,10038-1598,Private      ,1148,1267,2415,12219,3369,15588
00279101,PACE UNIVERSITY-PLEASANTVILLE           ,NY,10570-0000,Private      ,468,390,858,3846,1069,4915
00279102,PACE UNIVERSITY - WHITE PLAINS          ,NY,10603-0000,Private      ,89,473,562,560,1364,1924
00279500,PAUL SMITHS CLG OF ARTS & SCIENCES      ,NY,12970-0000,Private      ,308,38,346,1086,110,1196
00279800,PRATT INSTITUTE                         ,NY,11205-3899,Private      ,653,524,1177,4918,1924,6842
00280300,RENSSELAER POLYTECHNIC INSTITUTE        ,NY,12180-3590,Private      ,1040,160,1200,12598,624,13222
00280500,ROBERTS WESLEYAN COLLEGE                ,NY,14624-1997,Private      ,272,465,737,1200,950,2150
00280600,ROCHESTER INSTITUTE OF TECHNOLOGY       ,NY,14623-5608,Private      ,2629,859,3488,15851,2170,18021
00280700,ROCKEFELLER UNIVERSITY                  ,NY,10021-0000,Private      ,5,18,23,26,51,77
00280800,DAEMEN COLLEGE                          ,NY,14226-3592,Private      ,449,422,871,2601,887,3488
00281000,THE SAGE COLLEGES                       ,NY,12180-4199,Private      ,459,608,1067,2009,1544,3553
00281200,TROCAIRE COLLEGE                        ,NY,14220-2094,Private      ,299,567,866,769,1185,1954
00281300,SARAH LAWRENCE COLLEGE                  ,NY,10708-5999,Private      ,178,109,287,2177,593,2770
00281400,SKIDMORE COLLEGE                        ,NY,12866-1632,Private      ,557,30,587,4619,121,4740
00281500,ST BERNARDS SCH THEOLOGY & MINISTRY     ,NY,14618-3822,Private      ,0,20,20,1,39,40
00281600,SIENA COLLEGE                           ,NY,12211-1462,Private      ,1017,96,1113,5972,257,6229
00281700,ST BONAVENTURE UNIVERSITY               ,NY,14778-2284,Private      ,348,177,525,2643,395,3038
00282000,ST FRANCIS COLLEGE                      ,NY,11201-4398,Private      ,617,229,846,2586,498,3084
00282100,ST JOHN FISHER COLLEGE                  ,NY,14618-3597,Private      ,701,714,1415,4500,1550,6050
00282200,CHRIST THE KING SEMINARY                ,NY,14052-0607,Private      ,0,6,6,0,8,8
00282300,ST JOHN'S UNIVERSITY                    ,NY,11439-1343,Private      ,3329,1918,5247,24302,5474,29776
00282500,ST JOSEPH'S COLLEGE                     ,NY,11205-3688,Private      ,340,293,633,1406,563,1969
00282501,ST JOSEPH'S COLLEGE-SUFFOLK CAMPUS      ,NY,11772-0000,Private      ,833,615,1448,2519,1143,3662
00282900,ST LAWRENCE UNIVERSITY                  ,NY,13617-1455,Private      ,528,51,579,2653,132,2785
00283200,ST THOMAS AQUINAS COLLEGE               ,NY,10976-1050,Private      ,371,85,456,1656,190,1846
00283300,ST VLADIMIR ORTHODOX THEOL SEM          ,NY,10707-0000,Private      ,0,24,24,0,49,49
00283400,EXCELSIOR COLLEGE                       ,NY,12203-5159,Private      ,212,3585,3797,425,7265,7690
00283500,SUNY AT ALBANY                          ,NY,12222-0001,Public       ,3351,1592,4943,20625,4076,24701
00283600,BINGHAMTON UNIVERSITY (SUNY)            ,NY,13902-6000,Public       ,2559,840,3399,24188,2545,26733
00283700,SUNY AT BUFFALO                         ,NY,14260-0001,Public       ,3342,2473,5815,24231,8203,32434
00283800,SUNY AT STONY BROOK                     ,NY,11794-0701,Public       ,3573,2696,6269,27888,6882,34770
00283900,SUNY-DOWNSTATE MEDICAL CENTER           ,NY,11203-2098,Public       ,82,865,947,216,2155,2371
00284000,SUNY UPSTATE MEDICAL UNIVERSITY         ,NY,13210-2375,Public       ,55,341,396,255,1347,1602
00284100,SUNY BROCKPORT - FIN AID OFF            ,NY,14420-2914,Public       ,1885,990,2875,9679,2235,11914
00284200,BUFFALO STATE COLLEGE - SUNY            ,NY,14222-1095,Public       ,2662,1542,4204,12793,3618,16411
00284300,SUNY COLLEGE-CORTLAND                   ,NY,13045-0900,Public       ,1725,448,2173,11231,1134,12365
00284400,SUNY AT FREDONIA                        ,NY,14063-1145,Public       ,1177,264,1441,7060,789,7849
00284500,SUNY GENESEO                            ,NY,14454-1401,Public       ,841,128,969,9062,492,9554
00284600,SUNY COLLEGE-NEW PALTZ                  ,NY,12561-2499,Public       ,1655,664,2319,12156,1832,13988
00284700,SUNY COLLEGE-ONEONTA                    ,NY,13820-4015,Public       ,1521,226,1747,10818,693,11511
00284800,SUNY OSWEGO                             ,NY,13126-3599,Public       ,1810,628,2438,11327,1564,12891
00284900,SUNY COLLEGE AT PLATTSBURGH             ,NY,12901-2681,Public       ,1534,478,2012,7743,1144,8887
00285000,SUNY COLLEGE-POTSDAM                    ,NY,13676-2294,Public       ,994,320,1314,5576,736,6312
00285100,SUNY COLLEGE OF ENVIRONMENT SCIENCE AND ,NY,13210-2778,Public       ,346,170,516,2214,482,2696
00285300,SUNY MARITIME COLLEGE                   ,NY,10465-4198,Public       ,314,117,431,1849,287,2136
00285400,SUNY COLLEGE OF TECHNOLOGY-ALFRED       ,NY,14802-9951,Public       ,1116,377,1493,4510,829,5339
00285500,SUNY CANTON COLG OF TECHNOLOGY          ,NY,13617-1098,Public       ,750,402,1152,3591,1141,4732
00285600,SUNY AG & TECH COLLEGE-COBLESKILL       ,NY,12043-9986,Public       ,766,219,985,3127,481,3608
00285700,SUNY DELHI                              ,NY,13753-1190,Public       ,1081,421,1502,4247,917,5164
00285800,SUNY FARMINGDALE                        ,NY,11735-1021,Public       ,1839,1001,2840,6589,2062,8651
00285900,SUNY COLLEGE OF AG & TECH AT MORRISVILLE,NY,13408-0901,Public       ,1046,354,1400,3889,781,4670
00286000,ADIRONDACK COMMUNITY COLLEGE            ,NY,12804-1445,Public       ,723,604,1327,1741,1107,2848
00286100,CAYUGA COMMUNITY COLLEGE                ,NY,13021-3099,Public       ,525,655,1180,1145,1241,2386
00286200,BROOME COMMUNITY COLLEGE                ,NY,13902-0000,Public       ,1137,879,2016,2956,1746,4702
00286300,CORNING COMMUNITY COLLEGE               ,NY,14830-3297,Public       ,681,608,1289,1424,1148,2572
00286400,DUTCHESS COMMUNITY COLLEGE              ,NY,12601-1595,Public       ,1413,697,2110,3460,1432,4892
00286600,FASHION INSTITUTE OF TECHNOLOGY         ,NY,10001-5992,Public       ,1322,857,2179,8780,2733,11513
00286700,SUNY FULTON MONTGOMERY COMM CLG         ,NY,12095-3790,Public       ,504,349,853,1367,718,2085
00286800,HUDSON VALLEY COMMUNITY COLLEGE         ,NY,12180-6096,Public       ,2377,1742,4119,4978,3055,8033
00286900,JAMESTOWN COMMUNITY COLLEGE             ,NY,14702-0020,Public       ,739,562,1301,1958,1125,3083
00287000,JEFFERSON COMMUNITY COLLEGE             ,NY,13601-1897,Public       ,498,860,1358,1222,1620,2842
00287100,"SUNY, MOHAWK VALLEY COMMUNITY CLG       ",NY,13501-5394,Public       ,1321,1247,2568,2881,2198,5079
00287200,MONROE COMMUNITY COLLEGE                ,NY,14623-5780,Public       ,3118,3289,6407,7135,6078,13213
00287300,NASSAU COMMUNITY COLLEGE                ,NY,11530-6793,Public       ,3970,2578,6548,8859,4503,13362
00287400,NIAGARA COUNTY COMMUNITY COLLEGE        ,NY,14132-9460,Public       ,1248,926,2174,2954,1886,4840
00287500,ONONDAGA COMMUNITY COLLEGE              ,NY,13215-4585,Public       ,2252,1588,3840,5975,3010,8985
00287600,ORANGE COUNTY COMMUNITY COLLEGE         ,NY,10940-6441,Public       ,1081,926,2007,2214,1640,3854
00287700,ROCKLAND COMMUNITY COLLEGE              ,NY,10901-3611,Public       ,803,770,1573,1597,1226,2823
00287800,SUFFOLK COMMUNITY COLLEGE               ,NY,11784-2899,Public       ,2650,1352,4002,5737,2462,8199
00287801,SUFFOLK COMMUNITY CLG-W. CAMPUS         ,NY,11717-0000,Public       ,1900,1336,3236,3916,2358,6274
00287803,SUFFOLK COMMUNITY CLG-EASTRN CAMPUS     ,NY,11901-0000,Public       ,674,456,1130,1478,789,2267
00287900,SULLIVAN COUNTY COMMUNITY COLLEGE       ,NY,12759-5151,Public       ,372,198,570,1034,408,1442
00288000,ULSTER COUNTY COMMUNITY COLLEGE         ,NY,12484-0557,Public       ,420,379,799,860,655,1515
00288100,SUNY WESTCHESTER COMMUNITY COLLEGE      ,NY,10595-1698,Public       ,2590,2141,4731,5015,3569,8584
00288200,SYRACUSE UNIVERSITY                     ,NY,13244-2130,Private      ,3242,1384,4626,25067,5537,30604
00288300,UTICA COLLEGE- UTICA                    ,NY,13502-4892,Private      ,685,792,1477,3660,1893,5553
00288500,ALBANY COLLEGE OF PHARMACY AND HEALTH SC,NY,12208-3492,Private      ,122,127,249,1871,817,2688
00288600,ALBANY LAW SCHOOL                       ,NY,12208-0000,Private      ,18,309,327,65,854,919
00288700,ALBANY MEDICAL COLLEGE                  ,NY,12208-0000,Private      ,25,215,240,94,1144,1238
00288900,UNION COLLEGE                           ,NY,12308-2311,Private      ,443,37,480,3626,117,3743
00289000,UNION THEOLOGICAL SEMINARY              ,NY,10027-0000,Private      ,0,50,50,1,235,236
00289200,UNITED STATES MERCHANT MARINE ACADEMY   ,NY,11024-1634,Public       ,72,12,84,369,19,388
00289400,UNIVERSITY OF ROCHESTER                 ,NY,14627-9000,Private      ,1115,661,1776,9063,1616,10679
00289401,EASTMAN SCH OF MUSIC/UNIV ROCHESTER     ,NY,14604-0000,Private      ,97,101,198,831,387,1218
00289402,UNIV OF ROCHESTER SCHL OF MEDICINE      ,NY,14642-0000,Private      ,11,259,270,72,633,705
00289500,VASSAR COLLEGE                          ,NY,12604-0008,Private      ,730,43,773,4787,163,4950
00289600,VILLA MARIA COLLEGE-BUFFALO             ,NY,14225-3999,Private      ,138,125,263,389,245,634
00289900,WAGNER COLLEGE                          ,NY,10301-4495,Private      ,426,197,623,2607,460,3067
00290000,WEBB INSTITUTE                          ,NY,11542-1398,Private      ,19,1,20,87,4,91
00290100,WELLS COLLEGE                           ,NY,13026-0500,Private      ,215,19,234,1348,91,1439
00290300,YESHIVA UNIVERSITY                      ,NY,10033-3201,Private      ,534,605,1139,2227,2227,4454
00290302,YESHIVA UNIVERSITY - BRONX CAMPUS       ,NY,10461-1975,Private      ,21,455,476,84,1099,1183
00397400,MESIVTHA TIFERETH JERUSALEM OF AMER     ,NY,10002-6382,Private      ,6,0,6,11,1,12
00397600,RABBINICAL ACAD MESIVTA RABBI CHAIM     ,NY,11230-4715,Private      ,1,1,2,3,1,4
00397700,RABBINICAL COLLEGE CH'SAN SOFER         ,NY,11204-1252,Private      ,1,0,1,1,1,2
00397800,RABBINICAL SEMINARY OF AMERICA          ,NY,11375-0000,Private      ,31,6,37,43,8,51
00397900,COLUMBIA UNIV TEACHERS COLLEGE          ,NY,10027-0000,Private      ,32,1214,1246,110,3964,4074
00405400,HEBREW UNION COL-JEWISH INST OF REL     ,NY,10012-0000,Private      ,0,143,143,2,218,220
00475900,"CUNY, YORK COLLEGE                      ",NY,11451-0001,Public       ,3056,2363,5419,11886,4837,16723
00476500,CUNY GRADUATE SCH & UNIV CTR            ,NY,10016-4309,Public       ,46,1084,1130,106,2405,2511
00477600,CENTRAL YESHIVA TOMCHEI TMIMIM LUBA     ,NY,11230-2798,Private      ,7,0,7,12,4,16
00478800,HERKIMER COUNTY COMMUNITY COLLEGE       ,NY,13350-1598,Public       ,575,458,1033,1610,903,2513
00479800,MIRRER YESHIVA CENTRAL INST             ,NY,11223-2010,Private      ,5,0,5,8,1,9
00479900,MONROE COLLEGE                          ,NY,10468-4305,Proprietary  ,1535,1912,3447,4122,4339,8461
00481100,EVEREST INSTITUTE                       ,NY,14621-3007,Proprietary  ,60,325,385,100,587,687
00506400,SAINT JAMES MERCY HOSPITAL SCHOOL OF RAD,NY,14843-2197,Private      ,6,5,11,7,11,18
00520800,THE COLLEGE OF WESTCHESTER              ,NY,10602-0000,Proprietary  ,355,357,712,744,595,1339
00587700,ROBERT J HOCHSTIM SCHOOL OF RADIOG      ,NY,11572-1151,Private      ,1,2,3,3,6,9
00643501,ARNOT OGDEN MEDICAL CENTER              ,NY,14905-1676,Private      ,24,20,44,34,33,67
00643800,PHILLIPS BETH ISRAEL SCH OF NURSING     ,NY,10001-6354,Private      ,26,189,215,55,314,369
00644300,COCHRAN SCH NSG-ST JOHN RVSDE HOSP      ,NY,10701-1399,Private      ,14,94,108,28,149,177
00644500,CROUSE HOSP SCH OF NURSING              ,NY,13210-1690,Private      ,77,177,254,227,323,550
00644800,ELLIS HOSPITAL SCHOOL OF NURSING        ,NY,12308-0000,Private      ,29,71,100,65,138,203
00646101,ST ELIZABETH COLLEGE OF NURSING         ,NY,13501-2998,Private      ,56,90,146,149,161,310
00646102,ST ELIZABETH SCH OF RADIOGRAPHY         ,NY,13501-0000,Private      ,1,12,13,2,22,24
00646700,SAINT JOSEPH'S COLLEGE OF NURSING       ,NY,13203-1806,Private      ,55,102,157,202,242,444
00678200,GENESEE COMMUNITY COLLEGE               ,NY,14020-9704,Public       ,930,890,1820,2291,1599,3890
00678500,SCHENECTADY COUNTY COMMUNITY CLG        ,NY,12305-2294,Public       ,849,878,1727,1750,1551,3301
00678700,CLINTON COMMUNITY COLLEGE               ,NY,12901-5690,Public       ,341,227,568,848,459,1307
00678800,TOMPKINS CORTLAND COMMUNITY COLLEGE     ,NY,13053-8504,Public       ,786,613,1399,2073,1087,3160
00678900,COLUMBIA-GREENE COMMUNITY COLLEGE       ,NY,12534-9543,Public       ,236,290,526,570,558,1128
00679100,SUNY AT PURCHASE                        ,NY,10577-1400,Public       ,1009,326,1335,7250,908,8158
00702200,CUNY-LEHMAN COLLEGE                     ,NY,10468-1589,Public       ,3082,4887,7969,13005,9617,22622
00702600,MOUNT SINAI SCHOOL OF MEDICINE          ,NY,10029-0000,Private      ,12,353,365,28,998,1026
00710900,SUNY COLLEGE-OLD WESTBURY               ,NY,11568-0210,Public       ,1275,870,2145,5338,1838,7176
00711100,NORTH COUNTRY COMMUNITY COLLEGE         ,NY,12983-2046,Public       ,225,224,449,539,383,922
00726400,MESIFTA TORAH VODAATH RABBINCAL SEM     ,NY,11218-5209,Private      ,1,15,16,1,17,18
00727300,CUNY-BERNARD BARUCH COLLEGE             ,NY,10010-5518,Public       ,4121,3880,8001,17902,7828,25730
00730400,CULINARY INSTITUTE OF AMERICA           ,NY,12538-1499,Private      ,845,408,1253,3223,1044,4267
00732916,ITT TECHNICAL INSTITUTE                 ,NY,12205-1003,Proprietary  ,61,198,259,123,319,442
00737200,AUSTIN'S SCHOOL OF SPA TECHNOLOGY       ,NY,12206-1513,Proprietary  ,42,139,181,51,189,240
00737500,ISLAND DRAFTING & TECHNICAL INST        ,NY,11701-2704,Proprietary  ,42,42,84,55,56,111
00738700,LONG ISLAND BEAUTY SCHOOL               ,NY,11788-4346,Proprietary  ,51,105,156,83,149,232
00738800,LONG ISLAND BEAUTY SCHOOL               ,NY,11550-3704,Proprietary  ,10,48,58,23,60,83
00739100,BEAUTY SCHOOL OF MIDDLETOWN             ,NY,10940-6574,Proprietary  ,13,11,24,28,32,60
00739400,BERKELEY COLLEGE                        ,NY,10017-0000,Proprietary  ,1236,1961,3197,2440,2976,5416
00740100,MANDL SCHOOL                            ,NY,10019-5516,Proprietary  ,117,362,479,192,654,846
00740500,WOOD TOBE-COBURN SCHOOL                 ,NY,10016-0102,Proprietary  ,225,64,289,437,127,564
00746500,AMERICAN ACADEMY OF DRAMATIC ARTS       ,NY,10016-7089,Private      ,200,114,314,1104,299,1403
00746600,LIM COLLEGE                             ,NY,10022-5268,Proprietary  ,337,151,488,2017,440,2457
00746800,SCHOOL OF VISUAL ARTS                   ,NY,10010-3994,Proprietary  ,583,379,962,3595,1349,4944
00751800,APEX TECHNICAL SCHOOL                   ,NY,10011-0000,Proprietary  ,160,503,663,262,741,1003
00752200,CONTINENTAL SCH OF BEAUTY CULTURE       ,NY,14623-3231,Proprietary  ,98,191,289,117,231,348
00752205,CONTINENTAL SCHOOL OF BEAUTY CULTURE - M,NY,13211-1003,Proprietary  ,7,12,19,11,24,35
00753200,FINGER LAKES COMMUNITY COLLEGE          ,NY,14424-8395,Public       ,980,781,1761,2808,1693,4501
00757200,AMERICAN MUSICAL AND DRAMATIC ACAD      ,NY,10023-2106,Private      ,626,149,775,2720,439,3159
00757300,EMPIRE BEAUTY SCHOOL                    ,NY,11103-4028,Proprietary  ,225,673,898,352,1020,1372
00780400,STAR CAREER ACADEMY                     ,NY,10011-7307,Proprietary  ,48,190,238,97,320,417
00793809,LINCOLN TECHNICAL INSTITUTE - WHITESTONE,NY,11357-6092,Proprietary  ,247,157,404,367,227,594
00818900,CONTINENTAL SCHOOL OF BEAUTY CULTURE - B,NY,14224-3402,Proprietary  ,21,30,51,28,40,68
00818903,CONTINENTAL SCHOOL OF BEAUTY CULTURE - B,NY,14223-2911,Proprietary  ,27,45,72,58,87,145
00843700,CHAMPLAIN VALLEY - TEC/PRN              ,NY,12901-0000,Public       ,10,22,32,27,46,73
00849500,JAMESTOWN BUSINESS COLLEGE              ,NY,14702-0429,Proprietary  ,86,107,193,169,181,350
00861100,"CUNY, HOSTOS CMTY COLLEGE               ",NY,10451-1499,Public       ,3002,2953,5955,7697,5793,13490
00861400,RABBINICAL CLG BOBOVER YESHIVA BNEI     ,NY,11219-3293,Private      ,2,4,6,3,7,10
00878800,STATE UNIVERSITY OF NEW YORK STUDENT LOA,NY,12246-0000,Public       ,94,97,191,434,266,700
00902900,NEIGHBORHOOD PLAYHOUSE                  ,NY,10022-5017,Private      ,9,16,25,25,37,62
00904300,ELMIRA BUSINESS INSTITUTE               ,NY,14901-2731,Proprietary  ,55,425,480,70,514,584
00907700,UTICA SCHOOL OF COMMERCE                ,NY,13501-2280,Proprietary  ,34,133,167,56,224,280
00924800,SAMARITAN HOSPITAL SCH NURSING          ,NY,12180-2475,Private      ,31,98,129,70,187,257
00928300,MIDWAY-PARIS BEAUTY SCHOOL              ,NY,11385-3453,Proprietary  ,5,20,25,7,28,35
00928400,BRITTANY BEAUTY SCHOOL                  ,NY,11756-1345,Proprietary  ,30,63,93,43,91,134
00933500,MESIVTA EASTERN PKWY RABBINICAL CLG     ,NY,11218-5559,Private      ,3,4,7,5,7,12
00947900,SAINT VINCENTS CMC SI NURSING SCHOOL    ,NY,10304-3850,Proprietary  ,97,245,342,160,401,561
00976900,METROPOLITAN COLLEGE OF NEW YORK        ,NY,10013-1919,Private      ,90,712,802,172,1338,1510
00992900,SUNY COLLEGE OF OPTOMETRY               ,NY,10036-8003,Public       ,8,158,166,25,345,370
01005100,LA GUARDIA CMTY COLLEGE - CUNY          ,NY,11101-3083,Public       ,5579,3941,9520,15483,8458,23941
01005200,JEFFERSON-LEWIS BOCES PRAC NRSGPRG      ,NY,13601-9509,Public       ,13,52,65,20,100,120
01009700,CUNY-MEDGAR W EVERS COLLEGE             ,NY,11225-2010,Public       ,2070,2261,4331,6544,4341,10885
01014200,TOURO COLLEGE                           ,NY,10010-4202,Private      ,1148,3717,4865,2076,6263,8339
01014700,WESTERN SUFFOLK BOCES                   ,NY,11768-3499,Public       ,63,112,175,121,239,360
01015300,HELENE FULD COL OF NRSNG/N GEN HOSP     ,NY,10035-0000,Private      ,12,248,260,21,408,429
01028600,EMPIRE STATE COLLEGE                    ,NY,12866-4391,Public       ,352,3673,4025,795,9172,9967
01037800,RABBINICAL COLLEGE OF LONG ISLAND       ,NY,11561-3244,Private      ,2,0,2,3,1,4
01055100,NEW YORK SCH MED & DENTAL ASSISTANT     ,NY,11101-2327,Proprietary  ,41,82,123,74,139,213
01064100,SOUTHERN WESTCHESTER BOCES              ,NY,10543-0000,Public       ,11,57,68,19,88,107
01068400,ERIE COMMUNITY COLLEGE-ALL CAMPUSES     ,NY,14203-2698,Public       ,2281,2534,4815,5320,4582,9902
01081300,AMERICAN ACAD MCALLISTER INST           ,NY,10019-3604,Private      ,37,150,187,100,457,557
01083700,SIMMONS INST OF FUNERAL SERVICE         ,NY,13207-2098,Proprietary  ,0,1,1,1,5,6
01095200,PNW BOCES LPN PROGRAM                   ,NY,10598-0000,Public       ,4,13,17,7,25,32
01103100,TECHNICAL CAREER INSTITUTE              ,NY,10001-2789,Proprietary  ,448,1313,1761,581,1762,2343
01118900,UNITED TALMUDICAL SEMINARY              ,NY,11211-7984,Private      ,0,0,0,2,1,3
01119200,BETH HAMEDRASH SHAAREI YOSHER INST      ,NY,11204-1052,Private      ,1,1,2,2,2,4
01161400,CHAMPLAIN VALLEY HOSP SCH RAD TECH      ,NY,12901-1490,Private      ,9,10,19,27,19,46
01161700,NEW YORK METHODIST HOSPITAL             ,NY,11229-9023,Private      ,38,150,188,76,266,342
01164700,SBI CAMPUS - AN AFFILIATE OF SANFORD-BRO,NY,11747-3785,Proprietary  ,69,106,175,94,172,266
01167700,MEMORIAL SLOAN KETTERING CANCER CTR     ,NY,10021-6094,Private      ,1,7,8,1,28,29
01167800,SUNY INST OF TECHNOLOGY UTICA ROME      ,NY,13504-3050,Public       ,477,485,962,2194,899,3093
01183000,BERK TRADE AND BUSINESS SCHOOL          ,NY,11101-0000,Proprietary  ,28,57,85,46,86,132
01185900,WORD OF LIFE BIBLE INSTITUTE            ,NY,12860-0129,Private      ,200,20,220,466,51,517
01186000,MERCY MED CNTR SCHL OF RADIOGRAPHY      ,NY,11570-1098,Private      ,5,8,13,16,20,36
01192100,WESTCHESTER SCH OF BEAUTY CULTURE       ,NY,10550-2295,Proprietary  ,10,45,55,20,69,89
01192200,BETH HATALMUD RABBINICAL CLG            ,NY,11214-2594,Private      ,1,3,4,3,7,10
01198400,OHR HAMEIR THEOLOGICAL SEMINARY         ,NY,10566-0990,Private      ,1,0,1,3,1,4
01201100,TALMUDICAL SEM OHOLEI TORAH             ,NY,11213-3310,Private      ,3,1,4,3,1,4
01210700,INSTITUTE OF DESIGN & CONSTRUCTION      ,NY,11201-5380,Private      ,14,25,39,34,65,99
01220300,MEMORIAL HOSPITAL SCH OF NURSING        ,NY,12204-1083,Private      ,21,63,84,56,136,192
01227700,NEW YORK CHIROPRACTIC COLLEGE           ,NY,13148-0800,Private      ,4,296,300,8,720,728
01229300,VEEB NASSAU CNTY SCHL OF PRACT NURS     ,NY,11553-3040,Public       ,32,148,180,53,234,287
01235800,PLAZA COLLEGE                           ,NY,11372-6300,Proprietary  ,39,136,175,56,217,273
01236400,SAINT VINCENTS CATHOLIC MEDICAL CENTERS ,NY,11354-0000,Proprietary  ,53,230,283,96,438,534
01240700,SCHUYLER-CHEMUNG-TIOGA BOCES            ,NY,14903-1089,Public       ,24,96,120,44,170,214
01240701,STEUBEN SCHUYLER CHEMUNG TIOGA ALLEGANY ,NY,14870-9518,Public       ,1,5,6,1,7,8
01256100,FIVE TOWNS COLLEGE                      ,NY,11746-5871,Proprietary  ,241,86,327,599,172,771
01258900,ERIE 1 BOCES                            ,NY,14224-0000,Public       ,23,83,106,66,251,317
01265200,ONONDAGA CORTLAND MADISON BOCES         ,NY,13090-4500,Public       ,52,188,240,94,334,428
01278300,OSWEGO COUNTY BOCES ADULT CAREERS       ,NY,13114-4498,Public       ,6,32,38,20,42,62
01292700,CENTRAL TECH NURSING PROGRAM            ,NY,13202-3092,Public       ,9,55,64,24,93,117
01302600,MACHZIKEI HADATH RABBINICAL COLLEGE     ,NY,11204-1805,Private      ,1,1,2,1,2,3
01302900,BORICUA COLLEGE                         ,NY,10032-1599,Private      ,132,387,519,231,639,870
02056400,CAPRI COSMETOLOGY LEARNING CENTER       ,NY,10954-0000,Proprietary  ,48,66,114,60,93,153
02066200,THE NEW SCHOOL                          ,NY,10011-0000,Private      ,922,1281,2203,5543,4099,9642
02069000,NEW YORK SCHOOL OF INTERIOR DESIGN      ,NY,10021-0000,Private      ,56,149,205,187,297,484
02075700,BRIARCLIFFE COLLEGE                     ,NY,11714-0000,Proprietary  ,163,290,453,433,1011,1444
02075702,BRIARCLIFFE COLLEGE - PATCHOGUE         ,NY,11772-3019,Proprietary  ,175,199,374,472,617,1089
02092400,RIDLEY-LOWELL SCHOOL OF BUSINESS        ,NY,13905-0000,Proprietary  ,7,44,51,18,59,77
02093700,LONG ISLAND BUSINESS INSTITUTE          ,NY,11725-0000,Proprietary  ,120,499,619,133,542,675
02093701,LONG ISLAND BUSINESS INSTITUTE - FLUSHIN,NY,11354-4429,Proprietary  ,1,8,9,11,24,35
02098400,HERKIMER COUNTY BOCES                   ,NY,13350-0000,Public       ,17,47,64,24,67,91
02104300,OTSEGO AREA SCHOOL OF PRAC NURSING      ,NY,12167-0000,Public       ,0,3,3,3,5,8
02105900,HAIR DESIGN INSTITUTE AT FIFTH AVE      ,NY,11220-0000,Proprietary  ,27,78,105,53,127,180
02106800,BRAMSON ORT COLLEGE                     ,NY,11375-0000,Private      ,113,329,442,140,355,495
02110900,CATTARAUGUS/ALLEGANY BOCES              ,NY,14760-0000,Public       ,19,47,66,44,68,112
02112301,RIDLEY - LOWELL BUSINESS & TECHNICAL INS,NY,12601-3328,Proprietary  ,66,252,318,83,324,407
02116011,SANFORD-BROWN INSTITUTE - NEW YORK      ,NY,10003-2103,Proprietary  ,153,424,577,268,801,1069
02118700,LONG ISLAND COLLEGE HOSPITAL - SCHOOL OF,NY,11201-6001,Private      ,25,70,95,98,178,276
02118702,LONG ISLAND COLLEGE HOSPITAL - SCHOOL OF,NY,11201-6001,Private      ,34,91,125,123,227,350
02124000,ORANGE ULSTER BOCES SCH OF PRAC NRS     ,NY,10924-9401,Public       ,15,79,94,26,133,159
02125500,CIRCLE IN THE SQUARE THEATRE SCHOOL     ,NY,10019-0000,Private      ,21,28,49,47,64,111
02126300,MADISON-ONEIDA BOCES PRAC NRS           ,NY,13478-0000,Public       ,6,19,25,11,26,37
02138500,BOCES RENSSELAER SCHOOL OF PN           ,NY,12033-3221,Public       ,6,25,31,10,33,43
02145800,CAYUGA ONONDAGA BOCES                   ,NY,13021-9430,Public       ,15,38,53,22,62,84
02146000,WAYNE-FINGER LAKES BOCES                ,NY,14513-0000,Public       ,32,169,201,41,209,250
02152000,YESHIVA SHAAR HATORAH ITRI TORAH        ,NY,11418-0000,Private      ,3,1,4,5,2,7
02153600,BROOME-TIOGA BOCES PN PROG              ,NY,13905-0000,Public       ,20,64,84,30,105,135
02157900,ROCHESTER GENERAL HOSPITAL              ,NY,14621-3001,Private      ,12,48,60,30,100,130
02158200,WSHNGTN-SARTGA-WARN-HMLTN-ESX BOCES     ,NY,12839-1051,Public       ,6,35,41,7,48,55
02160100,GENEVA GENERAL HOSPITAL                 ,NY,14456-0000,Private      ,16,98,114,37,142,179
02163400,NEW YORK CAREER INSTITUTE               ,NY,10007-2801,Proprietary  ,69,246,315,116,409,525
02169100,DAVIS COLLEGE                           ,NY,13790-0000,Private      ,92,52,144,151,90,241
02170000,SWEDISH INSTITUTE                       ,NY,10001-0000,Proprietary  ,87,399,486,134,631,765
02170200,ALBANY SCHOHARIE SCHENECTADY            ,NY,12205-0000,Public       ,5,33,38,17,50,67
02171900,AILEY SCHOOL (THE)                      ,NY,10019-4402,Private      ,34,37,71,131,67,198
02172100,HAMILTON-FULTON-MONTGOMERY BOCES        ,NY,12095-0665,Public       ,10,39,49,31,53,84
02172800,DUTCHESS COUNTY BOCES SCH PRAC NURS     ,NY,12601-0000,Public       ,23,61,84,41,106,147
02173200,EMPIRE BEAUTY SCHOOL                    ,NY,10001-0000,Proprietary  ,343,733,1076,548,1111,1659
02173900,ULSTER COUNTY BOCES PRACTICAL NRSG      ,NY,12466-0000,Public       ,16,53,69,26,111,137
02176000,CHERYL FELL'S SCHOOL OF BUSINESS        ,NY,14304-0000,Proprietary  ,1,58,59,4,66,70
02179400,EASTERN SUFFOLK BOCES                   ,NY,11713-0000,Public       ,74,152,226,115,249,364
02182200,NEW SCHOOL OF RADIO & TELEVISION        ,NY,12206-1106,Proprietary  ,26,26,52,49,53,102
02191600,TORAH TEMIMAH TALMUDICAL SEMINARY       ,NY,11218-0000,Private      ,3,1,4,3,1,4
02192500,BELLEVUE HOSP CTR SCH RAD TECH          ,NY,10016-0000,Public       ,2,25,27,13,60,73
02199300,ORLEANS-NIAGARA BOCES                   ,NY,14132-0000,Public       ,12,35,47,18,60,78
02206000,HUNTER BUSINESS SCHOOL                  ,NY,11756-0000,Proprietary  ,72,252,324,131,357,488
02217800,D.HOPFER SCH NURSING AT MT.VRN HOSP     ,NY,10550-0000,Private      ,0,0,0,1,1,2
02219500,MILDRED ELLEY                           ,NY,12206-1513,Proprietary  ,137,872,1009,200,1256,1456
02235600,ERIE 2-CHAUTAUQUA-CATTARAUGUS BOCES     ,NY,14006-0000,Public       ,15,53,68,21,68,89
02265100,YESHIVA DERECH CHAIM                    ,NY,11218-0000,Private      ,1,0,1,4,1,5
02272900,ROCKLAND COUNTY BOCES PRAC NRSG SCH     ,NY,10994-0000,Public       ,10,21,31,25,42,67
02275900,"MODERN WELDING SCHOOL, INC.             ",NY,12304-0000,Proprietary  ,16,36,52,32,68,100
02287800,NATIONAL TRACTOR TRAILER SCHOOL         ,NY,13088-2505,Proprietary  ,13,190,203,18,230,248
02294900,INSTITUTE OF AUDIO RESEARCH             ,NY,10003-0000,Proprietary  ,67,149,216,147,260,407
02306500,PROFESSIONAL BUSINESS COLLEGE           ,NY,10013-5049,Private      ,137,394,531,187,521,708
02314200,NORTHERN WESTCHESTER SCH COSMETOL       ,NY,10566-0000,Proprietary  ,12,9,21,15,11,26
02320100,OHR SOMAYACH TANENBAUM EDUCATIONAL CENTE,NY,10952-0000,Private      ,0,0,0,0,1,1
02350600,YESHIVA AND KOLLEL HARBOTZAS TORAH      ,NY,11230-0000,Private      ,0,1,1,0,2,2
02491400,SPANISH AMERICAN INSTITUTE              ,NY,10036-0000,Private      ,1,3,4,3,6,9
02505800,YESHIVA KARLIN STOLIN RAB INSTITUTE     ,NY,11204-0000,Private      ,0,0,0,1,1,2
02505900,SH-OR YOSHUV RABBINICAL COLLEGE         ,NY,11691-0000,Private      ,2,3,5,4,4,8
02506000,ASSOCIATED BETH RIVKAH SCHOOLS          ,NY,11225-0000,Private      ,35,0,35,44,4,48
02506100,CITY UNIV OF NEW YORK-CENTRAL           ,NY,10021-0000,Public       ,353,396,749,1910,1031,2941
02506800,YESHIVAT MIKDASH MELECH                 ,NY,11230-0000,Private      ,6,0,6,11,0,11
02511500,JOFFREY BALLET SCHOOL                   ,NY,10011-0000,Proprietary  ,43,6,49,125,14,139
02513500,MAR JON SCHOOL OF BEAUTY CULTURE        ,NY,14150-0000,Proprietary  ,15,27,42,26,41,67
02525600,ART INSTITUTE OF NEW YORK CITY (THE)    ,NY,10013-2429,Proprietary  ,463,408,871,1262,904,2166
02540800,"GLOBE INSTITUTE OF TECHNOLOGY, INC.     ",NY,10007-0000,Proprietary  ,137,179,316,251,259,510
02546000,TRI-STATE COLLEGE OF ACUPUNCTURE        ,NY,10011-0000,Proprietary  ,0,49,49,0,80,80
02546300,YESHIVA OF THE TELSHE ALUMNI            ,NY,10471-0000,Private      ,1,0,1,2,0,2
02550600,TALMUDICAL INST OF UPSTATE NY           ,NY,14607-0000,Private      ,1,2,3,2,2,4
02556700,SEMINAR L'MOROS BAIS YAAKOV             ,NY,11219-0000,Private      ,111,2,113,119,2,121
02572900,BUSINESS INFORMATICS CENTER             ,NY,11580-0000,Proprietary  ,3,11,14,7,21,28
02575400,FRENCH CULINARY INSTITUTE               ,NY,10013-2618,Proprietary  ,90,210,300,218,423,641
02587600,ORLO SCH HAIR DESIGN & COSMETOLOGY      ,NY,12206-1723,Proprietary  ,19,19,38,31,28,59
02599400,NEW YORK COLLEGE OF HEALTH PROFESSIONS  ,NY,11791-4413,Private      ,36,213,249,106,590,696
02600100,NEW YORK ACADEMY OF ART (THE)           ,NY,10013-2911,Private      ,52,95,147,183,249,432
02614900,SANFORD-BROWN INSTITUTE                 ,NY,10604-2910,Proprietary  ,2,36,38,15,71,86
02615001,SANFORD-BROWN COLLEGE - SANFORD-BROWN IN,NY,11530-4734,Proprietary  ,98,217,315,157,333,490
02616600,SHEAR EGO INTERNATIONAL SCHOOL OF HAIR D,NY,14617-3501,Proprietary  ,28,52,80,42,88,130
02617000,CONTINENTAL SCH OF BEAUTY CULTURE       ,NY,14020-0000,Proprietary  ,10,15,25,14,17,31
02617002,CONTINENTAL SCHOOL OF BEAUTY CULTURE  - ,NY,14020-1908,Proprietary  ,5,12,17,13,14,27
02622900,BAIS MEDRASH ELYON                      ,NY,10952-3013,Private      ,1,0,1,2,0,2
03000100,YESHIVA GEDOLAH IMREI YOSEF DSPINKA     ,NY,11219-4696,Private      ,0,0,0,0,2,2
03007200,DANCE THEATRE OF HARLEM                 ,NY,10031-0000,Private      ,9,16,25,38,32,70
03027701,PACIFIC COLLEGE OF ORIENTAL MEDICINE - N,NY,10010-7108,Proprietary  ,8,164,172,20,327,347
03081600,DELAWARE CHENANGO MADISON OT. BOCES     ,NY,13815-9554,Public       ,3,24,27,9,32,41
03095500,ASA INST BUSINESS & COMPUTER TECH       ,NY,11201-5208,Proprietary  ,819,1980,2799,990,2275,3265
03096200,CHARLES STUART SCHOOL                   ,NY,11229-2004,Proprietary  ,1,11,12,4,15,19
03103700,ADIRONDACK BEAUTY SCHOOL                ,NY,12801-3158,Proprietary  ,3,11,14,14,26,40
03104900,SULLIVAN COUNTY BOCES                   ,NY,12754-2116,Public       ,2,11,13,10,23,33
03115300,GENESEE VALLEY BOCES                    ,NY,14020-1099,Public       ,11,40,51,26,77,103
03120700,NEW YORK CONSERVATORY FOR DRAMATIC ARTS ,NY,10011-4225,Proprietary  ,119,63,182,398,147,545
03127100,YESHIVAS NOVOMINSK                      ,NY,11219-0000,Private      ,1,0,1,1,0,1
03129200,RABBINICAL CLG OHR SHIMAR YISROEL       ,NY,11211-8102,Private      ,1,2,3,2,5,7
03169300,STUDIO JEWELERS                         ,NY,10016-4112,Proprietary  ,1,8,9,1,24,25
03181400,MERKAZ BNOS                             ,NY,11214-4911,Private      ,4,98,102,4,100,104
03191300,CUNY SCHOOL OF LAW @ QUEENS COLLEGE     ,NY,11367-0000,Public       ,80,325,405,343,987,1330
03193300,MANHATTAN SCHOOL OF COMPUTER TECH       ,NY,11230-1617,Private      ,67,181,248,123,286,409
03203300,NEW YORK INSTITUTE OF MASSAGE           ,NY,14221-6021,Proprietary  ,10,45,55,19,73,92
03216300,UNIFICATION THEOLOGICAL SEMINARY        ,NY,12507-5021,Private      ,9,8,17,14,15,29
03328300,FRANKLIN CAREER INSTITUTE               ,NY,11550-3003,Private      ,28,74,102,44,101,145
03328301,FRANKLIN CAREER INSTITUTE - BROOKLYN    ,NY,11220-3110,Private      ,51,144,195,71,207,278
03358300,ALLEN SCHOOL                            ,NY,11432-4901,Proprietary  ,67,527,594,89,787,876
03358301,ALLEN SCHOOL - BROOKLYN                 ,NY,11201-0000,Proprietary  ,57,191,248,110,382,492
03380300,STAR CAREER ACADEMY                     ,NY,11791-5311,Proprietary  ,29,82,111,63,150,213
03419400,NORTHEASTERN SEMINARY                   ,NY,14624-1997,Private      ,0,58,58,24,97,121
03433500,LIA SCHORR INSTITUTE OF COSMETIC SK     ,NY,10022-2614,Proprietary  ,1,7,8,3,17,20
03443300,NEW YORK COLLEGE OF TRADITIONAL CHINESE ,NY,11501-0000,Private      ,2,26,28,3,45,48
03496300,YESHIVA SHAAREI TORAH OF ROCKLAND       ,NY,10901-4003,Private      ,1,0,1,1,1,2
03537300,NEW YORK AUTOMOTIVE & DIESEL INSTIT     ,NY,11101-0000,Proprietary  ,34,106,140,51,143,194
03568300,LEON STUDIO ONE SCHOOL OF HAIR DESI     ,NY,14221-5323,Proprietary  ,6,12,18,14,25,39
03651300,SAINT JOSEPH'S MEDICAL CENTER SCHOO     ,NY,10701-4080,Private      ,11,9,20,21,18,39
03652300,METROPOLITAN LEARNING INSTITUTE         ,NY,11374-2101,Private      ,31,437,468,41,644,685
03665400,CHRISTIE'S EDUCATION                    ,NY,10036-8002,Proprietary  ,0,12,12,3,30,33
03713300,BEIS MEDRASH HEICHAL DOVID              ,NY,11691-4433,Private      ,5,0,5,7,0,7
03773300,CENTER FOR NATURAL WELLNESS SCHOOL OF MA,NY,12205-1601,Proprietary  ,16,60,76,22,105,127
03809400,MICROPOWER CAREER INSTITUTE             ,NY,10001-2812,Proprietary  ,16,121,137,25,136,161
03839300,AVEDA INSTITUTE NEW YORK                ,NY,10013-1522,Proprietary  ,67,106,173,117,213,330
03881300,UNION GRADUATE COLLEGE                  ,NY,12308-3131,Private      ,3,63,66,9,127,136
03903400,AMERICAN BEAUTY SCHOOL                  ,NY,10462-8003,Proprietary  ,50,163,213,86,202,288
03941400,ELITE ACADEMY OF BEAUTY ARTS            ,NY,11223-1630,Proprietary  ,7,32,39,21,49,70
03983300,"SCHOOL OF PROFESSIONAL HORTICULTURE, AT ",NY,10458-5126,Private      ,4,10,14,9,32,41
03988300,"SAE INSTITUTE OF TECHNOLOGY, NEW YORK   ",NY,10001-2915,Proprietary  ,84,128,212,224,268,492
04043300,ACE COMPUTER TRAINING CENTER            ,NY,11375-5337,Proprietary  ,14,105,119,31,132,163
04092401,MAKE-UP DESIGNORY -                     ,NY,10012-0041,Proprietary  ,91,112,203,215,230,445
04095300,KING'S COLLEGE (THE)                    ,NY,10018-0110,Private      ,105,43,148,912,134,1046
04102300,NEW AGE TRAINING                        ,NY,10001-4006,Proprietary  ,12,95,107,19,129,148
04115500,TALMUDICAL SEMINARY OF BOBOV            ,NY,11219-3826,Private      ,0,1,1,2,3,5
04117100,EDP SCHOOL OF COMPUTER PROGRAMMING      ,NY,11235-0000,Private      ,2,29,31,10,59,69
04117700,"MONROE 2-ORLEANS BOCES, CENTER FOR WORK ",NY,14624-1119,Public       ,31,90,121,61,160,221
04119600,YESHIVA OF FAR ROCKAWAY DERECH AYSON RAB,NY,11691-5219,Private      ,4,0,4,4,0,4
04123200,INSTITUTE OF ALLIED MEDICAL PROFESSIONS ,NY,11373-5541,Private      ,7,13,20,12,28,40
04125600,CAREER SCHOOL OF NY                     ,NY,10301-2416,Private      ,19,45,64,38,61,99
04131500,COLLECTIVE (THE)                        ,NY,10011-2026,Proprietary  ,6,6,12,14,14,28
04133700,NEW YORK MEDICAL CAREER TRAINING CENTER ,NY,11354-6504,Proprietary  ,10,36,46,20,57,77
04133701,NEW YORK MEDICAL CAREER TRAINING CENTER ,NY,10018-6504,Proprietary  ,14,82,96,50,150,200
04134000,"JOHN PAOLO'S XTREME BEAUTY INSTITUTE, GO",NY,12020-1245,Proprietary  ,3,9,12,8,20,28
04134001,"JOHN PAOLO'S XTREME BEAUTY INSTITUTE, GO",NY,13417-1319,Proprietary  ,7,17,24,12,37,49
04137700,ANN MARIE'S WORLD OF BEAUTY SCHOOL      ,NY,13901-2308,Proprietary  ,2,7,9,5,11,16
04144300,INSTITUTE OF CULINARY EDUCATION         ,NY,10010-5205,Proprietary  ,153,331,484,409,659,1068
04148000,NEW LIFE BUSINESS INSTITUTE             ,NY,11432-6149,Proprietary  ,3,4,7,17,70,87
04151200,SALON PROFESSIONAL ACADEMY (THE)        ,NY,14150-9200,Proprietary  ,27,45,72,48,84,132
04155300,ONONDAGA SCHOOL OF THERAPEUTIC MASSAGE  ,NY,13210-1533,Proprietary  ,28,89,117,43,142,185
04156000,ACADEMY OF COSMETOLOGY & ESTHETICS NYC (,NY,10306-3003,Proprietary  ,32,42,74,84,84,168
04157500,ACCESS CAREERS                          ,NY,11201-5826,Proprietary  ,14,62,76,34,104,138
04165700,"JOHN PAOLO'S XTREME BEAUTY INSTITUTE, GO",NY,12110-3053,Proprietary  ,1,8,9,2,14,16
04166000,MANHATTAN INSTITUTE (THE)               ,NY,10016-6516,Proprietary  ,31,69,100,83,147,230
04167600,FINGER LAKES SCHOOL OF MASSAGE (THE)    ,NY,14850-1384,Proprietary  ,17,57,74,31,88,119
04167601,FINGER LAKES SCHOOL OF MASSAGE (THE) -  ,NY,10549-1103,Proprietary  ,2,23,25,8,45,53
04178700,ATELIER ESTHETIQUE INSTITUTE OF ESTHETIC,NY,10016-8804,Proprietary  ,14,75,89,18,122,140
04179800,SOTHEBY'S INSTITUTE OF ART - NY         ,NY,10022-6717,Proprietary  ,6,49,55,19,130,149
04180200,LONG ISLAND NAIL & SKIN CARE INSTITUTE  ,NY,11756-1316,Proprietary  ,6,30,36,9,48,57
04189000,LONG ISLAND BARBER INSTITUTE (THE)      ,NY,11550-6317,Proprietary  ,5,19,24,8,35,43
04190500,NEW YORK SCHOOL OF ESTHETICS & DAY SPA  ,NY,10591-3232,Proprietary  ,8,27,35,13,43,56
04192800,BE'ER YAAKOV TALMUDIC SEMINARY          ,NY,10977-1912,Private      ,0,0,0,1,0,1
04204300,AESTHETIC SCIENCE INSTITUTE (THE)       ,NY,12110-1095,Proprietary  ,10,21,31,15,39,54
04206200,DIGITAL FILM ACADEMY                    ,NY,10036-3708,Proprietary  ,27,62,89,98,147,245
04207600,AMERICAN ACADEMY OF PERSONAL TRAINING   ,NY,10011-7301,Proprietary  ,8,54,62,30,103,133
04208600,RELAY SCHOOL OF EDUCATION               ,NY,10011-4233,Private      ,1,102,103,1,188,189
04208800,GLORIA FRANCIS SCHOOL OF MAKE-UP ARTISTR,NY,11801-3873,Proprietary  ,1,14,15,5,24,29
04210100,NEW COMMUNITY COLLEGE AT CUNY (THE)     ,NY,10018-2602,Public       ,627,255,882,2769,634,3403
04210700,NEW YORK INSTITUTE OF BEAUTY            ,NY,11749-1479,Proprietary  ,12,40,52,17,54,71
04212500,CACTUS ACADEMY (THE)                    ,NY,11530-3402,Proprietary  ,21,24,45,34,43,77
04213400,ACCESS CAREERS                          ,NY,11550-0000,Proprietary  ,4,30,34,7,46,53
04213500,SHARP EDGEZ BARBER INSTITUTE            ,NY,14620-0000,Proprietary  ,1,16,17,6,22,28
04215900,YESHIVA GEDOLAH KESSER TORAH            ,NY,10952-2127,Private      ,14,1,15,15,1,16
04223100,ARROJO COSMETOLOGY SCHOOL               ,NY,10014-4960,Proprietary  ,38,54,92,59,107,166
04223200,GRACE INTERNATIONAL BEAUTY SCHOOL       ,NY,11355-2446,Proprietary  ,2,5,7,2,5,7
04223300,ALLIANCE COMPUTING SOLUTIONS            ,NY,11354-6507,Proprietary  ,1,9,10,1,9,10
04223800,ELECTRICAL TRAINING CENTER (THE)        ,NY,11726-2701,Proprietary  ,12,18,30,17,30,47
04225500,WESTCHESTER SCHOOL FOR DENTAL ASSISTANTS,NY,10606-1246,Proprietary  ,1,13,14,1,13,14
04228300,PAUL MITCHELL THE SCHOOL                ,NY,12305-2303,Proprietary  ,33,44,77,33,44,77
04233700,CHRISTINE VALMY INTERNATIONAL SCHOOL FOR,NY,10016-7701,Proprietary  ,12,61,73,12,61,73
00267808,BRYANT & STRATTON COLLEGE - PARMA       ,OH,44130-0000,Proprietary  ,160,973,1133,337,2186,2523
00301000,ANTIOCH UNIVERSITY                      ,OH,45387-1608,Private      ,34,239,273,212,523,735
00301100,ART ACADEMY OF CINCINNATI               ,OH,45202-7106,Private      ,126,83,209,368,167,535
00301200,ASHLAND UNIVERSITY                      ,OH,44805-3799,Private      ,569,829,1398,3608,1898,5506
00301300,ATHENAEUM OF OHIO                       ,OH,45230-2000,Private      ,2,5,7,7,10,17
00301400,BALDWIN-WALLACE COLLEGE                 ,OH,44017-2088,Private      ,979,547,1526,4536,1223,5759
00301600,BLUFFTON UNIVERSITY                     ,OH,45817-2104,Private      ,297,118,415,1461,276,1737
00301800,BOWLING GREEN STATE UNIVERSITY          ,OH,43403-0001,Public       ,3261,1717,4978,17772,4529,22301
00302300,CAPITAL UNIVERSITY                      ,OH,43209-2394,Private      ,622,856,1478,3924,2202,6126
00302400,CASE WESTERN RESERVE UNIV               ,OH,44106-0000,Private      ,1273,731,2004,10742,1746,12488
00302401,CASE WESTERN RESERVE UNIV - MED         ,OH,44106-0000,Private      ,13,412,425,80,1080,1160
00302402,CASE WESTERN RESERVE UNIV - DENTAL      ,OH,44106-0000,Private      ,5,126,131,33,273,306
00302403,CASE WESTERN RESERVE UNIV - LAW         ,OH,44106-0000,Private      ,6,239,245,26,741,767
00302404,CASE WESTERN RESERVE UNIV - UG          ,OH,44106-0000,Private      ,47,10,57,212,21,233
00302405,CASE WESTERN RESERVE UNIV - MSASS       ,OH,44106-0000,Private      ,4,162,166,17,528,545
00302406,CASE WESTERN RESERVE UNIV - NURS UG     ,OH,44106-0000,Private      ,58,74,132,231,177,408
00302407,CASE WESTERN RESERVE UNIV - WSOM        ,OH,44106-0000,Private      ,5,84,89,23,153,176
00302408,CASE WESTERN RESERVE UNIV -A&S GRAD     ,OH,44106-0000,Private      ,0,96,96,9,237,246
00302409,CASE WESTERN RESERVE UNIV -ENG GRAD     ,OH,44106-0000,Private      ,9,42,51,52,79,131
00302410,CASE WESTERN RESERVE UNIV -NURS GRD     ,OH,44106-0000,Private      ,1,149,150,12,336,348
00302500,CEDARVILLE UNIVERSITY                   ,OH,45314-8564,Private      ,648,163,811,3767,398,4165
00302600,CENTRAL STATE UNIVERSITY                ,OH,45384-1004,Public       ,522,396,918,2698,1138,3836
00302900,CINCINNATI CHRISTIAN UNIVERSITY         ,OH,45204-3200,Private      ,128,243,371,525,490,1015
00303000,OHIO CHRISTIAN UNIVERSITY               ,OH,43113-9487,Private      ,225,1071,1296,760,2544,3304
00303100,CLEVELAND INSTITUTE OF MUSIC            ,OH,44106-1776,Private      ,15,44,59,400,326,726
00303200,CLEVELAND STATE UNIVERSITY              ,OH,44115-2214,Public       ,2816,4480,7296,9825,9909,19734
00303300,COLLEGE OF MT ST JOSEPH                 ,OH,45233-1670,Private      ,311,410,721,1649,1139,2788
00303500,OHIO DOMINICAN UNIVERSITY               ,OH,43219-2099,Private      ,365,692,1057,1872,1777,3649
00303600,FRANCISCAN UNIV OF STEUBENVILLE         ,OH,43952-1763,Private      ,619,237,856,2221,494,2715
00303700,COLLEGE OF WOOSTER                      ,OH,44691-2363,Private      ,361,44,405,3231,117,3348
00303900,COLUMBUS COLLEGE OF ART AND DESIGN      ,OH,43215-1758,Private      ,262,187,449,1443,556,1999
00304000,CUYAHOGA COMMUNITY COLLEGE              ,OH,44115-2878,Public       ,3801,8608,12409,8091,16002,24093
00304100,"DEFIANCE COLLEGE, THE                   ",OH,43512-1695,Private      ,284,141,425,1394,312,1706
00304200,DENISON UNIVERSITY                      ,OH,43023-1329,Private      ,245,19,264,2929,98,3027
00304400,TRINITY LUTHERAN SEMINARY               ,OH,43209-0000,Private      ,2,44,46,2,86,88
00304500,UNIVERSITY OF FINDLAY                   ,OH,45840-3695,Private      ,612,516,1128,3170,1231,4401
00304600,FRANKLIN UNIVERSITY                     ,OH,43215-5399,Private      ,346,2840,3186,902,7332,8234
00304800,HEIDELBERG UNIVERSITY                   ,OH,44883-2462,Private      ,347,106,453,1788,237,2025
00304900,HIRAM COLLEGE                           ,OH,44234-1808,Private      ,253,119,372,1608,282,1890
00305000,JOHN CARROLL UNIVERSITY                 ,OH,44118-4581,Private      ,744,282,1026,4426,745,5171
00305100,KENT STATE UNIVERSITY                   ,OH,44242-0001,Public       ,5096,3727,8823,24857,10237,35094
00305101,KENT STATE UNIVERSITY - GEAUGA CAMPUS   ,OH,44021-9500,Public       ,291,329,620,756,797,1553
00305102,KENT STATE UNIVERSITY - STARK CAMPUS    ,OH,44720-7599,Public       ,905,1191,2096,2796,2779,5575
00305103,KENT STATE UNIVERSITY - TUSCARAWAS CAMPU,OH,44663-9403,Public       ,237,375,612,801,984,1785
00305104,KENT STATE UNIVERSITY - TRUMBULL CAMPUS ,OH,44483-1998,Public       ,331,661,992,988,1574,2562
00305105,KENT STATE UNIVERSITY - ASHTABULA CAMPUS,OH,44004-2299,Public       ,276,566,842,744,1439,2183
00305106,KENT STATE UNIVERSITY - EAST LIVERPOOL C,OH,43920-3497,Public       ,134,250,384,393,653,1046
00305107,KENT STATE UNIVERSITY - SALEM CAMPUS    ,OH,44460-9412,Public       ,273,377,650,822,912,1734
00306500,KENYON COLLEGE                          ,OH,43022-9623,Private      ,123,13,136,3631,66,3697
00306600,LAKE ERIE COLLEGE                       ,OH,44077-3389,Private      ,274,131,405,1085,286,1371
00306800,LORAIN COUNTY COMMUNITY COLLEGE         ,OH,44035-1691,Public       ,1234,2561,3795,2791,4807,7598
00306900,LOURDES COLLEGE                         ,OH,43560-2898,Private      ,293,472,765,992,1061,2053
00307200,MALONE UNIVERSITY                       ,OH,44709-3897,Private      ,221,404,625,1699,980,2679
00307300,MARIETTA COLLEGE                        ,OH,45750-4033,Private      ,330,102,432,2270,318,2588
00307500,METHODIST THEOLOGICAL SCH IN OHIO       ,OH,43015-0000,Private      ,0,74,74,0,146,146
00307700,MIAMI UNIVERSITY                        ,OH,45056-1831,Public       ,1822,1056,2878,21336,4107,25443
00307800,WRIGHT STATE UNIVERSITY                 ,OH,45435-0002,Public       ,2375,2880,5255,11617,8325,19942
00308300,UNIVERSITY OF MOUNT UNION               ,OH,44601-3993,Private      ,675,93,768,3219,299,3518
00308400,MUSKINGUM UNIVERSITY                    ,OH,43762-1199,Private      ,517,244,761,2041,464,2505
00308500,NOTRE DAME COLLEGE OF OHIO              ,OH,44121-4293,Private      ,549,540,1089,2076,1236,3312
00308600,OBERLIN COLLEGE                         ,OH,44074-1090,Private      ,591,51,642,4571,180,4751
00308900,OHIO NORTHERN UNIVERSITY                ,OH,45810-1555,Private      ,675,331,1006,3528,797,4325
00309000,OHIO STATE UNIVERSITY-ALL CAMPUSES      ,OH,43210-1358,Public       ,5324,5184,10508,53033,20621,73654
00310000,OHIO UNIVERSITY                         ,OH,45701-2979,Public       ,3094,3649,6743,22558,9771,32329
00310002,"OHIO UNIVERSITY, ZANESVILLE CAMPUS      ",OH,43701-0000,Public       ,289,449,738,1114,1195,2309
00310003,"OHIO UNIVERSITY, LANCASTER CAMPUS       ",OH,43130-0000,Public       ,382,567,949,1314,1409,2723
00310004,"OHIO UNIVERSITY, SOUTHERN CAMPUS        ",OH,45638-0000,Public       ,199,551,750,708,1292,2000
00310005,"OHIO UNIVERSITY, CHILLICOTHE CAMPUS     ",OH,45601-0000,Public       ,319,617,936,1000,1464,2464
00310006,"OHIO UNIVERSITY, EASTERN CAMPUS         ",OH,43950-0000,Public       ,131,154,285,416,312,728
00310008,OHIO UNIV COLL OF OSTEOPATHIC MED       ,OH,45701-0000,Public       ,2,378,380,21,638,659
00310900,OHIO WESLEYAN UNIVERSITY                ,OH,43015-2398,Private      ,281,59,340,2985,189,3174
00311000,OTTERBEIN UNIVERSITY                    ,OH,43081-2006,Private      ,438,292,730,3436,784,4220
00311300,PONTIFICAL COLLEGE JOSEPHINUM           ,OH,43235-1498,Private      ,10,4,14,42,12,54
00311400,FIRELANDS REGIONAL MEDICAL CENTER - SOUT,OH,44870-4788,Private      ,17,51,68,56,132,188
00311500,RABBINICAL COLLEGE OF TELSHE            ,OH,44092-2584,Private      ,3,0,3,3,0,3
00311600,UNIV OF RIO GRANDE                      ,OH,45674-3131,Private      ,387,618,1005,1243,1277,2520
00311900,SINCLAIR COMMUNITY COLLEGE              ,OH,45402-1460,Public       ,2753,5332,8085,6282,10435,16717
00312100,TIFFIN UNIVERSITY                       ,OH,44883-2161,Private      ,592,1102,1694,2309,2590,4899
00312200,UNITED THEOLOGICAL SEMINARY             ,OH,45406-0000,Private      ,0,219,219,1,485,486
00312300,UNIVERSITY OF AKRON                     ,OH,44325-6211,Public       ,3566,3315,6881,18796,10242,29038
00312500,UNIVERSITY OF CINCINNATI                ,OH,45221-0125,Public       ,5766,6807,12573,26798,16740,43538
00312504,UNIVERSITY OF CINCINNATI - MEDICINE     ,OH,45267-0553,Public       ,65,574,639,321,1505,1826
00312700,UNIVERSITY OF DAYTON                    ,OH,45469-0002,Private      ,1487,920,2407,12263,2547,14810
00313100,UNIVERSITY OF TOLEDO                    ,OH,43606-3390,Public       ,3427,3078,6505,14955,7677,22632
00313300,URBANA UNIVERSITY                       ,OH,43078-2091,Private      ,211,268,479,797,562,1359
00313400,URSULINE COLLEGE                        ,OH,44124-4398,Private      ,139,455,594,538,927,1465
00313500,WALSH UNIVERSITY                        ,OH,44720-3396,Private      ,269,381,650,2382,1104,3486
00314100,WILBERFORCE UNIVERSITY                  ,OH,45384-1001,Private      ,128,121,249,460,308,768
00314200,WILMINGTON COLLEGE                      ,OH,45177-2499,Private      ,328,131,459,2089,384,2473
00314300,WITTENBERG UNIVERSITY                   ,OH,45501-2199,Private      ,297,119,416,3695,316,4011
00314400,XAVIER UNIVERSITY                       ,OH,45207-1035,Private      ,745,867,1612,7942,2229,10171
00314500,YOUNGSTOWN STATE UNIVERSITY             ,OH,44555-0001,Public       ,1812,1829,3641,7670,4910,12580
00398200,CLEVELAND INSTITUTE OF ART              ,OH,44106-1700,Private      ,131,75,206,998,232,1230
00406000,WINEBRENNER THEOLOGICAL SEMINARY        ,OH,45840-0000,Private      ,2,14,16,2,28,30
00485200,CLARK STATE COMMUNITY COLLEGE           ,OH,45505-4795,Public       ,619,1820,2439,1359,3622,4981
00485300,BRADFORD SCHOOL                         ,OH,43219-0000,Proprietary  ,261,251,512,535,483,1018
00485500,DAVIS COLLEGE                           ,OH,43623-4307,Proprietary  ,38,182,220,87,357,444
00486100,UNIVERSITY OF NORTHWESTERN OHIO         ,OH,45805-1498,Private      ,1267,606,1873,4276,1420,5696
00486600,STAUTZENBERGER COLLEGE                  ,OH,43537-4007,Proprietary  ,169,515,684,275,785,1060
00510200,SCH OF DIAGNOSTIC IMAGING-CLEVELAND     ,OH,44119-0000,Private      ,8,25,33,13,37,50
00531300,NORTH CENTRAL STATE COLLEGE             ,OH,44901-0000,Public       ,417,743,1160,1043,1649,2692
00575300,OWENS STATE COMMUNITY COLLEGE           ,OH,43699-0000,Public       ,1534,2619,4153,3759,5680,9439
00648700,AULTMAN COLLEGE OF NURSING AND HEALTH SC,OH,44710-1799,Private      ,58,164,222,171,410,581
00648900,CHRIST COLLEGE OF NURSING AND HEALTH SCI,OH,45219-2906,Private      ,135,340,475,347,707,1054
00649400,GOOD SAMARITAN COLG-NURSING/HEALTH      ,OH,45220-2489,Private      ,84,244,328,273,511,784
00650700,TRINIT HEALTH SYSTEM SCH OF NURSING     ,OH,43952-2667,Private      ,37,69,106,70,125,195
00680400,LAKELAND COMMUNITY COLLEGE              ,OH,44094-5198,Public       ,927,2045,2972,2106,3928,6034
00686700,COLUMBUS STATE COMMUNITY COLLEGE        ,OH,43215-1786,Public       ,4084,7201,11285,10536,15272,25808
00703500,KETTERING COLLEGE OF MEDICAL ARTS       ,OH,45429-1299,Private      ,126,219,345,500,562,1062
00708500,MOUNT VERNON NAZARENE UNIVERSITY        ,OH,43050-9500,Private      ,340,237,577,1401,664,2065
00708501,MOUNT VERNON NAZARENE UNIV - AGS        ,OH,43050-0000,Private      ,13,113,126,70,336,406
00727500,EASTERN GATEWAY COMMUNITY COLLEGE       ,OH,43952-3598,Public       ,412,873,1285,879,1743,2622
00732920,ITT TECHNICAL INSTITUTE                 ,OH,45414-3456,Proprietary  ,135,645,780,254,1097,1351
00732992,ITT TECHNICAL INSTITUTE                 ,OH,44509-4098,Proprietary  ,143,442,585,315,1135,1450
00747300,CHOFFIN CAREER & TECHNICAL CENTER       ,OH,44503-1628,Public       ,36,102,138,72,204,276
00759800,HOCKING TECHNICAL COLLEGE               ,OH,45764-9582,Public       ,866,834,1700,2291,1766,4057
00812900,ADULT AND COMMUNITY EDUCATION @ HUDSON  ,OH,43211-2017,Public       ,20,175,195,49,337,386
00813200,TOLEDO SCHOOL OF PRACTICAL NURSING      ,OH,43613-5110,Public       ,25,142,167,83,308,391
00813300,ZANE STATE COLLEGE                      ,OH,43701-2626,Public       ,355,515,870,994,1225,2219
00819400,AKRON SCHOOL OF PRACTICAL NRSG          ,OH,44311-0000,Public       ,36,94,130,127,194,321
00827800,TERRA COMMUNITY COLLEGE                 ,OH,43420-9670,Public       ,258,465,723,563,941,1504
00867700,NORTHWEST STATE COMMUNITY COLLEGE       ,OH,43502-9542,Public       ,317,664,981,789,1303,2092
00888600,PORTAGE LAKES CAREER CENTER             ,OH,44685-9554,Public       ,12,43,55,19,68,87
00915600,WAYNE COUNTY SCHOOLS CAREER CENTER      ,OH,44677-9672,Public       ,13,98,111,45,180,225
00941200,FORTIS COLLEGE                          ,OH,44221-2998,Proprietary  ,122,503,625,155,742,897
00953000,GERBER AKRON BEAUTY SCHOOL              ,OH,44313-6995,Proprietary  ,10,45,55,23,92,115
00953100,SPA SCHOOL (THE)                        ,OH,43214-1524,Proprietary  ,20,83,103,39,180,219
00966000,TIFFIN ACADEMY OF HAIR DESIGN           ,OH,44883-2833,Proprietary  ,11,21,32,25,44,69
00994100,BELMONT TECHNICAL COLLEGE               ,OH,43950-9766,Public       ,218,418,636,481,745,1226
00994200,SHAWNEE STATE UNIVERSITY                ,OH,45662-4344,Public       ,937,733,1670,3653,1688,5341
01001700,PAYNE THEOLOGICAL SEMINARY              ,OH,45384-0474,Private      ,0,52,52,2,93,95
01002700,JAMES A. RHODES STATE COLLEGE           ,OH,45804-3597,Public       ,454,772,1226,1266,1629,2895
01016800,NATIONWIDE BEAUTY ACADEMY               ,OH,43228-1000,Proprietary  ,42,77,119,76,148,224
01028000,OHIO STATE BEAUTY ACADEMY               ,OH,45801-0000,Proprietary  ,45,64,109,97,121,218
01032300,HANNAH E MULLINS SCH-PRAC NRSG          ,OH,44460-2906,Public       ,10,34,44,25,64,89
01034500,CINCINNATI STATE TECH & COMM CLG        ,OH,45223-2690,Public       ,1211,2894,4105,3575,7141,10716
01045300,WASHINGTON STATE CMTY COLLEGE           ,OH,45750-9225,Public       ,293,370,663,684,736,1420
01063000,NORTHERN INSTITUTE OF COSMETOLOGY       ,OH,44052-1803,Proprietary  ,8,32,40,12,55,67
01073600,MARION TECHNICAL COLLEGE                ,OH,43302-5694,Public       ,221,479,700,672,1169,1841
01088000,CHATFIELD COLLEGE                       ,OH,45118-9705,Private      ,49,163,212,82,266,348
01088100,STARK STATE COLLEGE OF TECHNOLOGY       ,OH,44720-7299,Public       ,1386,4044,5430,2988,7777,10765
01090600,CINCINNATI CLG OF MORTUARY SCIENCE      ,OH,45224-1428,Private      ,23,76,99,71,160,231
01092300,UNION INSTITUTE & UNIVERSITY            ,OH,45206-1925,Private      ,17,549,566,49,1218,1267
01099300,HOBART INSTITUTE OF WELDING TECHNOLOGY  ,OH,45373-2400,Private      ,85,104,189,310,214,524
01100500,KAPLAN COLLEGE                          ,OH,43232-4827,Proprietary  ,0,0,0,12,81,93
01104600,CENTRAL OHIO TECHNICAL COLLEGE          ,OH,43055-1767,Public       ,415,960,1375,1345,3153,4498
01170300,PENTA COUNTY JOINT VOCATIONAL SCH       ,OH,43551-0000,Public       ,6,36,42,17,63,80
01174400,NATIONAL BEAUTY COLLEGE                 ,OH,44720-0000,Proprietary  ,16,34,50,25,70,95
01174500,OHIO TECHNICAL COLLEGE                  ,OH,44103-1228,Proprietary  ,420,319,739,1241,710,1951
01212800,SOUTHWESTERN COLLEGE                    ,OH,45402-3003,Proprietary  ,2,15,17,10,84,94
01212804,SOUTHWESTERN COLLEGE                    ,OH,45246-3121,Proprietary  ,3,13,16,21,62,83
01212806,LINCOLN COLLEGE OF TECHNOLOGY - TOLEDO  ,OH,43615-6800,Proprietary  ,5,7,12,20,45,65
01212808,LINCOLN COLLEGE OF TECHNOLOGY - CLEVELAN,OH,44114-3266,Proprietary  ,5,13,18,29,59,88
01216600,CAROUSEL BEAUTY COLLEGE                 ,OH,45402-8935,Proprietary  ,44,123,167,72,200,272
01224800,CENTRAL SCHOOL OF PRACTICAL NURSING     ,OH,44131-2155,Private      ,9,80,89,47,216,263
01267200,CAROUSEL BEAUTY COLLEGE                 ,OH,45044-5113,Proprietary  ,9,21,30,12,32,44
01267400,CAROUSEL OF MIAMI VALLEY BEAUTY CLG     ,OH,45424-2063,Proprietary  ,4,11,15,8,22,30
01275000,EDISON COMMUNITY COLLEGE                ,OH,45356-9239,Public       ,242,777,1019,660,1594,2254
01283800,LAURA AND ALVIN SIEGAL COLLEGE OF JUDAIC,OH,44122-7197,Private      ,1,2,3,1,2,3
01284800,MOLER-HOLLYWOOD BEAUTY COLLEGE          ,OH,45202-2577,Proprietary  ,3,22,25,13,59,72
01287000,SOUTHERN STATE COMMUNITY COLLEGE        ,OH,45133-9406,Public       ,337,668,1005,732,1291,2023
01289100,ANTONELLI COLLEGE                       ,OH,45202-2592,Proprietary  ,46,258,304,82,418,500
01289600,VIRGINIA MARTI COLLEGE OF ART AND DESIGN,OH,44107-0778,Proprietary  ,58,67,125,119,111,230
01303922,SOUTH UNIVERSITY - CLEVELAND            ,OH,44128-5919,Proprietary  ,25,268,293,43,420,463
01313200,INTERNATIONAL CLG OF BROADCASTING       ,OH,45431-1898,Proprietary  ,37,87,124,66,137,203
02052000,KAPLAN COLLEGE                          ,OH,45439-1984,Proprietary  ,70,475,545,139,879,1018
02054300,TRUMBULL BUSINESS COLLEGE               ,OH,44484-0000,Proprietary  ,12,149,161,26,255,281
02056800,DAYMAR COLLEGE                          ,OH,45601-1038,Proprietary  ,15,61,76,26,109,135
02056802,DAYMAR COLLEGE - LANCASTER              ,OH,43130-0000,Proprietary  ,14,66,80,21,111,132
02056803,DAYMAR COLLEGE - NEW BOSTON             ,OH,45662-4900,Proprietary  ,12,46,58,15,86,101
02056804,DAYMAR COLLEGE - JACKSON                ,OH,45640-1728,Proprietary  ,7,33,40,12,73,85
02066100,OHIO STATE COLLEGE/BARBER STYLING       ,OH,43213-0000,Proprietary  ,36,124,160,92,225,317
02073300,GALLIA-JACKSON-VINTON SCH ADULT ED      ,OH,45674-0000,Public       ,21,94,115,43,174,217
02110700,CLEVELAND INST OF DENTAL-MED ASST       ,OH,44115-2285,Proprietary  ,46,205,251,88,352,440
02116009,SANFORD-BROWN COLLEGE - MIDDLEBURG HEIGH,OH,44130-8362,Proprietary  ,3,46,49,11,99,110
02116900,UPPER VALLEY JVS                        ,OH,45356-0000,Public       ,10,96,106,28,173,201
02117300,GREAT OAKS INSTITUTE OF TECHNOLOGY      ,OH,45241-1581,Public       ,81,262,343,168,528,696
02128600,THE ART INSTITUTE OF CINCINNATI         ,OH,45246-0000,Proprietary  ,118,100,218,385,239,624
02140700,COMMUNITY EDUCATIONAL SERVICES          ,OH,44702-1710,Public       ,6,90,96,14,139,153
02158417,"HARRISON COLLEGE - COLUMBUS, OH         ",OH,43123-0000,Proprietary  ,24,164,188,52,323,375
02158500,OHIO BUSINESS COLLEGE                   ,OH,44035-0701,Proprietary  ,48,189,237,66,367,433
02158501,OHIO BUSINESS COLLEGE                   ,OH,44870-9953,Proprietary  ,17,141,158,30,245,275
02158503,OHIO BUSINESS COLLEGE - COLUMBUS        ,OH,43229-3523,Proprietary  ,49,205,254,119,360,479
02158504,OHIO BUSINESS COLLEGE - DAYTON          ,OH,45417-4094,Proprietary  ,7,59,66,21,126,147
02168100,TRI-COUNTY JOINT VOCATIONAL SCHOOL      ,OH,45764-0000,Public       ,23,42,65,46,90,136
02187900,ASHTABULA CO JOINT VOC SCH ADULT ED     ,OH,44047-0000,Public       ,15,61,76,27,110,137
02189000,MID-EAST CAREER & TECH CENTERS-ADULT ED ,OH,43701-4600,Public       ,51,141,192,101,244,345
02190700,FORTIS COLLEGE                          ,OH,45459-0000,Proprietary  ,140,1085,1225,254,2079,2333
02192100,BUTLER TECHNOLOGY AND CAREER DEVELOPMENT,OH,45011-0000,Public       ,47,205,252,135,387,522
02196300,COLLINS CAREER CENTER                   ,OH,45619-0000,Public       ,52,195,247,129,372,501
02210800,MEDINA COUNTY CAREER CENTER             ,OH,44256-0000,Public       ,15,37,52,21,71,92
02220500,GOD'S BIBLE SCHOOL & COLLEGE            ,OH,45210-0000,Private      ,83,37,120,119,65,184
02220800,CAREER & TECHNOLOGY EDUCATION CENTERS OF,OH,43055-0000,Public       ,33,114,147,86,228,314
02239800,PIONEER CAREER & TECHNOLOGY CENTER      ,OH,44875-0000,Public       ,2,15,17,3,38,41
02245600,WARREN COUNTY CAREER CENTER             ,OH,45036-0000,Public       ,21,83,104,48,167,215
02246300,INSTITUTE OF MEDICAL-DENTAL TECH        ,OH,45246-3317,Proprietary  ,39,244,283,83,473,556
02263700,MIAMI VALLEY CAREER TECHNOLOGY CTR      ,OH,45315-0000,Public       ,34,149,183,65,313,378
02269400,EASTERN HILLS ACAD OF HAIR DESIGN       ,OH,45255-0000,Proprietary  ,4,17,21,8,32,40
02269500,WESTERN HILLS SCHOOL OF BEAUTY & HAIR DE,OH,45211-0000,Proprietary  ,15,74,89,32,133,165
02270100,OHIO HI-POINT CAREER CENTER             ,OH,43311-0000,Public       ,3,20,23,7,35,42
02272700,COLUMBIANA COUNTY CAREER CENTER         ,OH,44432-0000,Public       ,14,58,72,26,110,136
02287900,RAPHAEL'S SCHOOL OF BEAUTY CULTURE      ,OH,44446-0000,Proprietary  ,14,63,77,22,94,116
02301400,OHIO VALLEY COLLEGE OF TECHNOLOGY       ,OH,43920-9139,Proprietary  ,35,105,140,64,159,223
02303600,FORTIS COLLEGE - RAVENNA CAMPUS         ,OH,44266-0000,Proprietary  ,0,0,0,15,85,100
02304700,TRI-RIVERS CAREER CENTER                ,OH,43302-0000,Public       ,23,110,133,55,197,252
02311200,AMERICAN SCHOOL OF TECHNOLOGY           ,OH,43229-0000,Proprietary  ,35,179,214,64,334,398
02315500,TOLEDO ACADEMY OF BEAUTY CULTURE - EAST ,OH,43616-0000,Proprietary  ,13,55,68,25,99,124
02324400,ALLSTATE HAIRSTYLING & BARBER CLG       ,OH,44113-0000,Proprietary  ,20,100,120,38,212,250
02328500,MOLER-PICKENS BEAUTY COLLEGE            ,OH,45014-0000,Proprietary  ,2,8,10,7,24,31
02334300,INTERNATIONAL ACAD OF HAIR DESIGN       ,OH,45239-0000,Proprietary  ,38,87,125,62,143,205
02336300,KNOX COUNTY CAREER CENTER               ,OH,43050-4298,Public       ,15,97,112,42,196,238
02336700,CUYAHOGA VALLEY CAREER CENTER           ,OH,44141-1296,Public       ,28,84,112,49,142,191
02337700,PROFESSIONAL SKILLS INSTITUTE           ,OH,43607-0000,Proprietary  ,47,184,231,83,363,446
02351500,WILLOUGHBY EASTLAKE SCH OF PRAC NSG     ,OH,44094-0000,Public       ,12,60,72,22,150,172
02352800,POLARIS CAREER CENTER-ADULT ED DEPT     ,OH,44130-0000,Public       ,48,142,190,84,257,341
02354200,SCIOTO COUNTY JOINT VOCATIONAL SCH      ,OH,45648-0000,Public       ,29,104,133,64,198,262
02454400,NORTHEAST OHIO MEDICAL UNIVERSITY       ,OH,44272-9621,Public       ,11,107,118,135,844,979
02497800,GREENE COUNTY CAREER CENTER             ,OH,45385-0000,Public       ,10,29,39,17,69,86
02519300,OHIO STATE SCH COSMETOLOGY              ,OH,43110-2754,Proprietary  ,52,84,136,81,145,226
02522700,EASTLAND-FAIRFIELD CAREER AND TECHNICAL ,OH,43125-0000,Public       ,16,85,101,33,159,192
02528300,TDDS TECHNICAL INSTITUTE                ,OH,44429-0000,Proprietary  ,20,104,124,42,200,242
02529500,HAMRICK SCHOOL                          ,OH,44256-0000,Proprietary  ,3,81,84,7,120,127
02545800,INNER STATE BEAUTY SCHOOLS              ,OH,44124-0000,Proprietary  ,18,72,90,32,117,149
02553000,SCHOOL OF ADVERTISING ART               ,OH,45440-0000,Proprietary  ,89,13,102,240,41,281
02560000,CASAL AVEDA INSTITUTE                   ,OH,44515-0000,Proprietary  ,46,68,114,89,123,212
02560700,PICKAWAY ROSS CO JOINT VOC TECH SCH     ,OH,45601-0000,Public       ,30,119,149,51,209,260
02562300,APOLLO CAREER CENTER-ADULT EDUC         ,OH,45806-0000,Public       ,23,164,187,65,305,370
02563000,RAPHAELS SCHOOL OF BEAUTY CULTURE       ,OH,44601-2847,Proprietary  ,21,64,85,30,97,127
02568600,MAHONING COUNTY CAREER & TECH CENTR     ,OH,44406-0000,Public       ,5,37,42,16,75,91
02582900,KAPLAN CAREER INSTITUTE                 ,OH,44129-6810,Proprietary  ,13,101,114,27,265,292
02586400,TRUMBULL CAREER & TECH CENTER-ADULT     ,OH,44483-1997,Public       ,10,64,74,28,139,167
02588500,OHIO STATE SCHOOL OF COSMETOLOGY        ,OH,43081-0000,Proprietary  ,68,93,161,120,159,279
02599711,VATTEROTT COLLEGE - CLEVELAND           ,OH,44147-3502,Proprietary  ,21,148,169,33,214,247
02603800,LORAIN COUNTY JVS ADULT CAREER CTR      ,OH,44074-9799,Public       ,23,56,79,39,109,148
02611007,HERITAGE COLLEGE - COLUMBUS             ,OH,43213-4440,Proprietary  ,89,270,359,156,511,667
02620000,SANDUSKY CAREER CENTER                  ,OH,44870-4786,Public       ,5,50,55,12,78,90
03007900,GALLIPOLIS CAREER COLLEGE               ,OH,45631-2600,Proprietary  ,4,78,82,10,105,115
03015100,ALLIANCE HIGH SCH-CMTY SERVICES DIV     ,OH,44601-2899,Public       ,8,27,35,14,43,57
03015300,EHOVE CAREER CENTER                     ,OH,44846-9500,Public       ,31,140,171,55,265,320
03023700,MADISON ADULT CAREER CENTER             ,OH,44905-2718,Public       ,22,105,127,40,201,241
03024300,VALLEY BEAUTY SCHOOL                    ,OH,43725-2332,Proprietary  ,8,22,30,14,26,40
03026511,REMINGTON COLLEGE - CLEVELAND           ,OH,44125-1957,Private      ,49,189,238,122,422,544
03026512,REMINGTON COLLEGE - CLEVELAND WEST      ,OH,44070-3129,Private      ,9,32,41,18,61,79
03027100,FAIRVIEW ACADEMY                        ,OH,44126-2214,Proprietary  ,2,23,25,7,45,52
03034200,WASHINGTON COUNTY CAREER CENTER ADULT TE,OH,45750-9290,Public       ,32,171,203,68,304,372
03051400,AUBURN CAREER CENTER                    ,OH,44077-9723,Public       ,22,59,81,51,138,189
03051500,US GRANT JOINT VOCATIONAL SCHOOL        ,OH,45106-9502,Public       ,0,4,4,2,8,10
03065900,BUCKEYE CAREER CENTER                   ,OH,44663-9437,Public       ,24,67,91,47,122,169
03067600,RAPHAEL'S SCHOOL OF BEAUTY CULTURE      ,OH,44512-2222,Proprietary  ,19,58,77,26,80,106
03068200,OHIO CENTER FOR BROADCASTING            ,OH,44125-6273,Proprietary  ,21,87,108,37,109,146
03068202,OHIO CENTER FOR BROADCASTING - COLUMBUS ,OH,43213-2571,Proprietary  ,22,69,91,40,146,186
03071900,MOUNT CARMEL COLLEGE OF NURSING         ,OH,43222-1598,Private      ,215,402,617,720,836,1556
03072303,EVEREST INSTITUTE - COLUMBUS            ,OH,43230-6653,Proprietary  ,22,88,110,37,230,267
03078000,OHIO CENTER FOR BROADCASTING            ,OH,45227-1509,Proprietary  ,16,41,57,29,85,114
03079000,ETI TECHNICAL COLLEGE                   ,OH,44446-4398,Proprietary  ,29,120,149,47,180,227
03084800,DELAWARE AREA CAREER CENTER             ,OH,43015-8969,Public       ,6,17,23,12,39,51
03084801,DELAWARE AREA CAREER CENTER -           ,OH,43015-9001,Public       ,4,13,17,8,32,40
03095600,VANTAGE CAREER CENTER                   ,OH,45891-1378,Public       ,6,27,33,14,57,71
03097000,MERCY COLLEGE OF NORTHWEST OHIO         ,OH,43604-1132,Private      ,198,467,665,536,1056,1592
03100100,PARAMOUNT BEAUTY ACADEMY                ,OH,45662-4136,Proprietary  ,7,45,52,20,79,99
03116200,DAYTON BARBER COLLEGE                   ,OH,45342-0000,Proprietary  ,4,30,34,11,50,61
03116300,OHIO COLLEGE OF MASSOTHERAPY            ,OH,44321-1363,Private      ,16,48,64,29,93,122
03116400,VANGUARD-SENTINELL VOC SCH DISTRICT     ,OH,43420-1197,Public       ,3,27,30,6,44,50
03117000,ASHLAND COUNTY-W HOLMES CAREER CTR      ,OH,44805-0000,Public       ,5,48,53,20,90,110
03319300,CREATIVE IMAGES-A CERTIFIED MATRIX      ,OH,45414-2557,Proprietary  ,50,124,174,81,218,299
03319301,CREATIVE IMAGES-A CERTIFIED MATRIX      ,OH,45459-0000,Proprietary  ,21,84,105,48,144,192
03416400,VALLEY BEAUTY SCHOOL                    ,OH,43701-3624,Proprietary  ,3,5,8,5,15,20
03425300,ROSEDALE BIBLE COLLEGE                  ,OH,43029-9517,Private      ,30,3,33,50,5,55
03457300,ALLEGHENY WESLEYAN COLLEGE              ,OH,44460-9598,Private      ,17,6,23,32,10,42
03468400,NATIONAL INSTITUTE OF MASSOTHERAPY      ,OH,44319-2100,Proprietary  ,11,24,35,15,61,76
03468500,ATS INSTITUTE OF TECHNOLOGY             ,OH,44143-2216,Proprietary  ,30,248,278,52,483,535
03475400,TRI-STATE BIBLE COLLEGE                 ,OH,45680-8402,Private      ,0,19,19,1,33,34
03534400,AMERICAN INST OF ALTERNATIVE MEDICI     ,OH,43229-1113,Proprietary  ,19,276,295,45,482,527
03583300,OHIO INSTITUTE OF ALLIED HEALTH         ,OH,45424-3646,Private      ,2,27,29,2,27,29
03626300,BROWN AVEDA INSTITUTE                   ,OH,44060-6212,Proprietary  ,77,115,192,136,213,349
03700300,REGENCY BEAUTY INSTITUTE - CLEVELAND    ,OH,44094-0000,Proprietary  ,52,146,198,105,264,369
03726300,TEMPLE BAPTIST COLLEGE                  ,OH,45240-0000,Private      ,5,17,22,11,29,40
03747300,BEXLEY HALL SEMINARY                    ,OH,43209-2325,Private      ,1,16,17,2,33,35
03776400,HEALING ARTS INSTITUTE                  ,OH,43551-3138,Proprietary  ,5,27,32,10,40,50
03837300,AVEDA FREDRIC'S INSTITUTE               ,OH,45208-1304,Proprietary  ,56,68,124,115,156,271
04051307,ART INSTITUTE OF PHOENIX (THE) - BROWN M,OH,45215-1107,Proprietary  ,103,546,649,174,904,1078
04051308,ART INSTITUTE OF PHOENIX (THE) - BROWN M,OH,44320-4420,Proprietary  ,56,240,296,112,494,606
04051317,ART INSTITUTE OF PHOENIX (THE) - BROWN M,OH,45840-6848,Proprietary  ,118,525,643,294,1416,1710
04051326,ART INSTITUTE OF PHOENIX (THE) - BROWN M,OH,44718-3674,Proprietary  ,70,318,388,85,469,554
04068300,FOUR COUNTY CAREER CENTER               ,OH,43512-9541,Public       ,4,8,12,7,23,30
04074300,HONDROS COLLEGE                         ,OH,43081-3855,Proprietary  ,190,1358,1548,332,2481,2813
04117300,DAYTON SCHOOL OF MEDICAL MASSAGE        ,OH,45429-1111,Proprietary  ,43,163,206,75,308,383
04118300,NORTHCOAST MEDICAL TRAINING ACADEMY     ,OH,44240-4174,Proprietary  ,25,61,86,38,108,146
04124500,TECHSKILLS                              ,OH,43231-0000,Proprietary  ,18,181,199,36,269,305
04126000,OHIO ACADEMY PAUL MITCHELL PARTNER SCHOO,OH,44087-3107,Proprietary  ,46,70,116,81,124,205
04137800,AVEDA INSTITUTE COLUMBUS                ,OH,43201-2333,Proprietary  ,105,172,277,192,305,497
04138000,INSTITUTE OF THERAPEUTIC MASSAGE        ,OH,45875-0350,Proprietary  ,12,13,25,16,19,35
04149100,PAUL MITCHELL THE SCHOOL CINCINNATI     ,OH,45241-1702,Proprietary  ,58,79,137,122,167,289
04149101,PAUL MITCHELL THE SCHOOL CINCINNATI - TO,OH,43560-2539,Proprietary  ,29,55,84,33,59,92
04151400,VANITY SCHOOL OF COSMETOLOGY            ,OH,44035-0000,Proprietary  ,16,34,50,18,55,73
04152100,TOLEDO RESTAURANT TRAINING CENTER       ,OH,43604-6508,Private      ,5,20,25,8,56,64
04152600,PIKE COUNTY CAREER TECHNOLOGY CENTER    ,OH,45661-9114,Public       ,7,45,52,16,73,89
04153300,OHIO ACADEMY COLUMBUS (THE)             ,OH,43231-6038,Proprietary  ,48,96,144,102,162,264
04166800,SALON PROFESSIONAL ACADEMY (THE)        ,OH,45551-0000,Proprietary  ,11,24,35,24,54,78
04167700,ARTISAN COLLEGE OF COSMETOLOGY (THE)    ,OH,45840-6848,Proprietary  ,7,16,23,12,21,33
04185900,ELITE SCHOOL OF COSMETOLOGY             ,OH,44857-2714,Proprietary  ,8,38,46,12,52,64
04189100,TONI & GUY HAIRDRESSING ACADEMY         ,OH,43615-1731,Proprietary  ,30,47,77,57,78,135
04192200,ATHENA CAREER ACADEMY                   ,OH,43560-2796,Proprietary  ,22,155,177,41,280,321
04206700,ELITE WELDING ACADEMY                   ,OH,45246-1013,Proprietary  ,21,51,72,21,54,75
04220900,NATIONAL PERSONAL TRAINING INSTITUTE OF ,OH,43235-5739,Proprietary  ,8,45,53,23,85,108
04225700,LABARBERIA INSTITUTE OF HAIR            ,OH,44106-1923,Proprietary  ,13,49,62,17,79,96
        ,INVALID SCHOOL CODE                     ,  ,00000-0000,,331,1412,1743,595,2351,2946
00134500,ADAMS STATE COLLEGE                     ,CO,81102-2373,Public       ,597,723,1320,2458,1426,3884
00134600,ARAPAHOE COMMUNITY COLLEGE              ,CO,80160-9002,Public       ,992,2189,3181,2355,4360,6715
00134700,COLORADO COLLEGE                        ,CO,80903-3294,Private      ,402,275,677,3312,696,4008
00134800,COLORADO SCHOOL OF MINES                ,CO,80401-1887,Public       ,491,308,799,6653,1121,7774
00134900,UNIVERSITY OF NORTHERN COLORADO         ,CO,80639-0001,Public       ,1290,1370,2660,9664,4135,13799
00135000,COLORADO STATE UNIVERSITY               ,CO,80523-0100,Public       ,3300,2776,6076,22860,8890,31750
00135200,DENVER  SEMINARY                        ,CO,80120-2192,Private      ,6,214,220,9,530,539
00135300,FORT LEWIS COLLEGE                      ,CO,81301-3999,Public       ,883,490,1373,4142,1298,5440
00135400,ILIFF SCHOOL OF THEOLOGY                ,CO,80210-0000,Private      ,4,85,89,6,258,264
00135500,LAMAR COMMUNITY COLLEGE                 ,CO,81052-3999,Public       ,114,84,198,321,173,494
00135800,COLORADO MESA UNIVERSITY                ,CO,81501-3122,Public       ,1823,1330,3153,6438,2655,9093
00135900,COLORADO NORTHWESTERN COMMUNITY COLLEGE ,CO,81648-3598,Public       ,150,148,298,386,270,656
00136000,METROPOLITAN STATE UNIVERSITY OF DENVER ,CO,80204-3362,Public       ,3413,5168,8581,10132,11590,21722
00136100,NORTHEASTERN JUNIOR COLLEGE             ,CO,80751-2399,Public       ,315,148,463,975,293,1268
00136200,OTERO JUNIOR COLLEGE                    ,CO,81050-3346,Public       ,195,206,401,490,361,851
00136300,REGIS UNIVERSITY                        ,CO,80221-1099,Private      ,629,2654,3283,3187,6323,9510
00136500,COLORADO STATE UNIVERSITY-PUEBLO        ,CO,81001-4901,Public       ,804,768,1572,4846,2360,7206
00136800,TRINIDAD STATE JR COLLEGE               ,CO,81082-2396,Public       ,239,355,594,565,602,1167
00137000,UNIVERSITY OF COLORADO-BOULDER          ,CO,80309-0077,Public       ,3056,2221,5277,25923,8132,34055
00137100,UNIVERSITY OF DENVER                    ,CO,80208-2000,Private      ,684,1693,2377,9731,8282,18013
00137200,WESTERN STATE COLLEGE                   ,CO,81231-0000,Public       ,463,220,683,2026,488,2514
00405702,NATIONAL AMERICAN UNIVERSITY - COLORADO ,CO,80920-4001,Proprietary  ,9,129,138,35,295,330
00405703,NATIONAL AMERICAN UNIVERSITY            ,CO,80222-0000,Proprietary  ,10,75,85,23,189,212
00450300,EVEREST COLLEGE                         ,CO,80916-3548,Proprietary  ,52,409,461,116,882,998
00450600,COLORADO MOUNTAIN COLLEGE               ,CO,81602-0000,Public       ,450,556,1006,1536,1334,2870
00450700,EVEREST COLLEGE                         ,CO,80229-4339,Proprietary  ,43,217,260,85,378,463
00450701,"EVEREST COLLEGE- EVEREST COLLEGE, AURORA",CO,80012-5692,Proprietary  ,52,222,274,103,390,493
00450800,UNIVERSITY OF COLORADO DENVER           ,CO,80204-2029,Public       ,2343,5145,7488,9659,12882,22541
00450900,UNIV OF COLORADO AT COLO SPRINGS        ,CO,80918-3735,Public       ,1431,1870,3301,8830,5375,14205
00559600,EMILY GRIFFITH OPPORTUNITY SCH          ,CO,80204-2197,Public       ,219,673,892,547,1368,1915
00729700,REDSTONE COLLEGE                        ,CO,80020-9988,Proprietary  ,135,284,419,219,466,685
00732912,ITT TECHNICAL INSTITUTE                 ,CO,80229-5338,Proprietary  ,103,615,718,162,839,1001
00754800,WESTWOOD COLLEGE - DENVER NORTH         ,CO,80221-3653,Proprietary  ,61,366,427,159,808,967
00754801,WESTWOOD COLLEGE - DENVER SOUTH         ,CO,80227-3653,Proprietary  ,44,201,245,94,541,635
00758200,AIMS COMMUNITY COLLEGE                  ,CO,80632-0000,Public       ,569,1093,1662,1636,2532,4168
00764900,ROCKY MOUNTAIN COLG OF ART & DESIGN     ,CO,80214-0000,Proprietary  ,225,383,608,676,891,1567
00793300,FRONT RANGE COMMUNITY COLLEGE           ,CO,80031-2199,Public       ,2331,4308,6639,5476,8725,14201
00793806,LINCOLN COLLEGE OF TECHNOLOGY - DENVER  ,CO,80239-3006,Proprietary  ,511,505,1016,916,767,1683
00863500,INTELLITEC MEDICAL INSTITUTE            ,CO,80909-0000,Proprietary  ,34,195,229,54,346,400
00887100,CONCORDE CAREER INSTITUTE               ,CO,80203-0000,Proprietary  ,169,676,845,260,1109,1369
00889600,PIKES PEAK COMMUNITY COLLEGE            ,CO,80906-5498,Public       ,1387,3764,5151,3403,7709,11112
00940100,COLORADO CHRISTIAN UNIVERSITY           ,CO,80226-7449,Private      ,471,1389,1860,1883,3049,4932
00954200,COMMUNITY COLLEGE OF DENVER             ,CO,80217-2026,Public       ,1839,3503,5342,4690,7480,12170
00954300,RED ROCKS COMMUNITY COLLEGE             ,CO,80228-1255,Public       ,977,1930,2907,2435,3823,6258
00998100,MORGAN COMMUNITY COLLEGE                ,CO,80701-4399,Public       ,101,266,367,294,495,789
01014800,COLORADO TECHNICAL UNIVERSITY           ,CO,80907-3896,Proprietary  ,122,1320,1442,308,3011,3319
01014802,COLORADO TECHNICAL UNIV - DENVER        ,CO,80111-3201,Proprietary  ,41,321,362,86,653,739
01014805,COLORADO TECH UNIV - ON LINE            ,CO,80907-0000,Proprietary  ,629,12727,13356,1240,25237,26477
01014812,COLORADO TECHNICAL UNIVERSITY - WESTMINS,CO,80021-3498,Proprietary  ,22,157,179,43,369,412
01014815,COLORADO TECHNCL UNIV PUEBLO            ,CO,81003-2315,Proprietary  ,23,71,94,64,153,217
01157200,COLORADO SCHOOL OF TRADES               ,CO,80215-2996,Proprietary  ,20,142,162,50,262,312
01267000,BEL-REA INST OF ANIMAL TECH             ,CO,80247-3048,Proprietary  ,171,244,415,324,452,776
01285000,INTERNATIONAL SALON AND SPA ACADEMY     ,CO,80918-3684,Proprietary  ,38,123,161,58,199,257
01287500,PICKENS TECHNICAL COLLEGE               ,CO,80011-9307,Public       ,138,311,449,290,564,854
01300700,NAZARENE BIBLE COLLEGE                  ,CO,80910-3717,Private      ,24,245,269,59,471,530
02078900,ART INSTITUTE OF COLORADO (THE)         ,CO,80203-2983,Proprietary  ,510,716,1226,1289,1326,2615
02116300,PUEBLO COMMUNITY COLLEGE                ,CO,81004-0000,Public       ,547,1710,2257,1394,3413,4807
02117500,NAROPA UNIVERSITY                       ,CO,80302-0000,Private      ,48,262,310,323,998,1321
02156200,DELTA - MONTROSE TECHNICAL COLLEGE      ,CO,81416-0000,Public       ,24,67,91,62,125,187
02165200,SALON PROFESSIONAL ACADEMY (THE)        ,CO,81504-5309,Proprietary  ,15,34,49,36,58,94
02211901,CHEEKS INTERNATIONAL ACADEMY OF BEAUTY C,CO,80525-3053,Proprietary  ,9,20,29,27,39,66
02211902,CHEEKS INTERNATIONAL ACDMY BTY CULT     ,CO,80631-0000,Proprietary  ,3,12,15,14,28,42
02253700,INTELLITEC COLLEGE                      ,CO,80909-0000,Proprietary  ,41,341,382,80,516,596
02267500,GLENWOOD BEAUTY ACADEMY                 ,CO,81601-0000,Proprietary  ,6,15,21,10,22,32
02276900,COMMUNITY COLLEGE OF AURORA             ,CO,80011-9036,Public       ,966,2350,3316,2165,4286,6451
02296004,PRINCE INSTITUTE - SOUTHEAST - PRINCE IN,CO,80031-2943,Proprietary  ,1,18,19,2,35,37
02518500,HAIR DYNAMICS EDUCATION CENTER          ,CO,80525-0000,Proprietary  ,31,52,83,73,95,168
02594300,COLLEGE AMERICA - DENVER                ,CO,80222-3380,Proprietary  ,131,764,895,212,1271,1483
02611000,HERITAGE COLLEGE                        ,CO,80212-7413,Proprietary  ,56,198,254,110,369,479
03006300,INST OF BUSINESS & MEDICAL CAREERS      ,CO,80525-3044,Proprietary  ,179,573,752,268,968,1236
03010622,VIRGINIA COLLEGE - ECOTECH INSTITUTE - A,CO,80014-1405,Proprietary  ,16,111,127,40,218,258
03012100,REMINGTON COLLEGE - COLORADO SPRINGS CAM,CO,80215-0000,Private      ,2,1,3,6,4,10
03014900,PLATT COLLEGE                           ,CO,80014-3141,Proprietary  ,21,118,139,47,225,272
03027400,XENON INTERNATIONAL ACADEMY III         ,CO,80014-1193,Proprietary  ,27,40,67,41,76,117
03030606,UTAH COLLEGE OF MASSAGE THERAPY - DENVER,CO,80031-2921,Proprietary  ,16,42,58,29,84,113
03030607,UTAH COLLEGE OF MASSAGE THERAPY - DENVER,CO,80012-2523,Proprietary  ,25,45,70,39,98,137
03066900,INTELLITEC COLLEGE                      ,CO,81506-3994,Proprietary  ,81,299,380,110,407,517
03068201,OHIO CENTER FOR BROADCASTING - COLORADO ,CO,80214-4129,Proprietary  ,17,56,73,27,79,106
03076401,BRYMAN SCHOOL OF ARIZONA (THE) - ANTHEM ,CO,80014-2622,Proprietary  ,3,4,7,6,19,25
03289300,COLORADO HEIGHTS UNIVERSITY             ,CO,80236-2711,Private      ,43,131,174,99,209,308
03306300,MONTESSORI EDUC CRT OF THE ROCKIES      ,CO,80301-2587,Private      ,5,23,28,7,53,60
03534300,JONES INTERNATIONAL UNIVERSITY          ,CO,80112-3446,Proprietary  ,40,1309,1349,71,2257,2328
03545300,UNIVERSITY OF THE ROCKIES               ,CO,80903-3612,Proprietary  ,39,928,967,91,1912,2003
03584400,COLORADO SCHOOL OF HEALING ARTS         ,CO,80226-4332,Proprietary  ,29,114,143,46,190,236
03670300,TONI & GUY HAIRDRESSING ACADEMY         ,CO,80911-0000,Proprietary  ,28,61,89,49,103,152
03686300,COLORADO SCHOOL OF TRADITIONAL CHINESE M,CO,80206-2127,Proprietary  ,4,52,56,10,114,124
03776300,AUGUSTE ESCOFFIER SCHOOL OF CULINARY ART,CO,80305-5961,Proprietary  ,83,134,217,204,248,452
03976300,MASSAGE THERAPY INSTITUTE OF COLORADO   ,CO,80206-2127,Proprietary  ,27,74,101,75,149,224
04080300,ASPEN UNIVERSITY                        ,CO,80246-1930,Proprietary  ,34,278,312,119,608,727
04093300,ACADEMY OF NATURAL THERAPY              ,CO,80631-3425,Proprietary  ,13,44,57,38,82,120
04121200,INSTITUTE OF TAOIST EDUCATION AND ACUPUN,CO,80027-1028,Private      ,0,24,24,0,35,35
04125100,MONTESSORI CASA INTERNATIONAL           ,CO,80111-5263,Private      ,0,4,4,1,7,8
04127700,AMERICAN SENTINEL UNIVERSITY            ,CO,80014-6510,Proprietary  ,4,487,491,11,981,992
04139300,NATIONAL BEAUTY COLLEGE                 ,CO,80221-0000,Proprietary  ,13,45,58,41,92,133
04148300,DENVER SCHOOL OF NURSING                ,CO,80202-1213,Proprietary  ,107,494,601,317,981,1298
04151100,SUMMIT SALON & BEAUTY SCHOOL            ,CO,80866-4569,Proprietary  ,0,0,0,1,0,1
04167100,AVEDA INSTITUTE DENVER                  ,CO,80202-0000,Proprietary  ,98,155,253,228,289,517
04170200,PAUL MITCHELL THE SCHOOL COLORADO SPRING,CO,80903-0000,Proprietary  ,44,103,147,78,205,283
04172500,ROLF INSTITUTE OF STRUCTURAL INTEGRATION,CO,80301-0000,Private      ,2,26,28,5,76,81
04173800,SALON PROFESSIONAL ACADEMY (THE)        ,CO,80918-2932,Proprietary  ,17,38,55,33,86,119
04177100,PIMA MEDICAL INSTITUTE-SOUTH DENVER     ,CO,80231-0000,Proprietary  ,102,254,356,209,502,711
04179700,UNITED BEAUTY COLLEGE                   ,CO,80223-2936,Proprietary  ,12,43,55,36,88,124
04183700,HEALING ARTS INSTITUTE                  ,CO,80525-3479,Proprietary  ,11,44,55,27,86,113
04184900,COLLEGE OF INTERNATIONAL ESTHETICS      ,CO,80002-3754,Proprietary  ,9,55,64,22,112,134
04185000,COLORADO ACADEMY OF VETERINARY TECHNOLOG,CO,80906-4944,Proprietary  ,39,83,122,102,191,293
04185400,NATIONAL PERSONAL TRAINING INSTITUTE OF ,CO,80401-3304,Proprietary  ,12,40,52,18,72,90
04195300,LONGS PEAK ACADEMY                      ,CO,80501-6458,Proprietary  ,15,43,58,29,74,103
04202600,NEW DIMENSIONS BEAUTY ACADEMY           ,CO,80138-9801,Proprietary  ,4,20,24,15,39,54
04208700,COLORADO STATE UNIVERSITY - GLOBAL CAMPU,CO,80111-0000,Public       ,126,2263,2389,390,5006,5396
04218900,ROCKY VISTA UNIVERSITY COLLEGE OF OSTEOP,CO,80134-9498,Proprietary  ,1,294,295,4,557,561
04221400,PAUL MITCHELL THE SCHOOL DENVER         ,CO,80226-7395,Proprietary  ,30,42,72,62,86,148
00267811,BRYANT & STRATTON COLLEGE - VIRGINIA BEA,VA,23462-4417,Proprietary  ,233,911,1144,501,2012,2513
00370200,AVERETT UNIVERSITY                      ,VA,24541-3692,Private      ,366,408,774,1373,921,2294
00370300,BLUEFIELD COLLEGE                       ,VA,24605-1799,Private      ,216,283,499,854,539,1393
00370400,BRIDGEWATER COLLEGE                     ,VA,22812-1599,Private      ,289,43,332,3305,188,3493
00370500,COLLEGE OF WILLIAM & MARY               ,VA,23187-8795,Public       ,640,580,1220,10860,3384,14244
00370600,CHRISTOPHER NEWPORT UNIVERSITY          ,VA,23606-3072,Public       ,763,349,1112,7891,1023,8914
00370700,RICHARD BLAND COLLEGE                   ,VA,23805-7100,Public       ,364,202,566,1181,465,1646
00370800,EASTERN MENNONITE UNIVERSITY            ,VA,22802-2462,Private      ,287,212,499,1381,504,1885
00370900,EMORY & HENRY COLLEGE                   ,VA,24327-0010,Private      ,281,57,338,1509,158,1667
00371100,FERRUM COLLEGE                          ,VA,24088-2612,Private      ,595,95,690,2803,297,3100
00371200,TIDEWATER COMMUNITY COLLEGE             ,VA,23510-1910,Public       ,3115,7854,10969,7971,16322,24293
00371300,HAMPDEN-SYDNEY COLLEGE                  ,VA,23943-0128,Private      ,326,20,346,1637,51,1688
00371400,HAMPTON UNIVERSITY                      ,VA,23668-0099,Private      ,1075,915,1990,8857,2660,11517
00371500,HOLLINS UNIVERSITY                      ,VA,24020-0000,Private      ,115,174,289,942,482,1424
00371900,LONGWOOD UNIVERSITY                     ,VA,23909-1899,Public       ,581,204,785,5698,813,6511
00372000,LYNCHBURG COLLEGE                       ,VA,24501-3199,Private      ,585,367,952,3381,899,4280
00372100,JAMES MADISON UNIVERSITY                ,VA,22807-3780,Public       ,2292,680,2972,24095,2724,26819
00372300,MARY BALDWIN COLLEGE                    ,VA,24401-3610,Private      ,307,350,657,1695,906,2601
00372400,MARYMOUNT UNIVERSITY                    ,VA,22207-4224,Private      ,466,768,1234,2599,1967,4566
00372600,NATIONAL COLLEGE                        ,VA,24153-4524,Proprietary  ,128,1100,1228,272,2759,3031
00372700,NORTHERN VA CMTY CLG                    ,VA,22003-3743,Public       ,6604,8422,15026,14103,15523,29626
00372800,OLD DOMINION UNIVERSITY                 ,VA,23529-0052,Public       ,3411,4975,8386,18012,12691,30703
00373200,RADFORD UNIVERSITY                      ,VA,24142-6905,Public       ,1711,729,2440,10359,2349,12708
00373300,RANDOLPH-MACON COLLEGE                  ,VA,23005-5505,Private      ,372,59,431,2574,162,2736
00373400,RANDOLPH COLLEGE                        ,VA,24503-1526,Private      ,219,70,289,1073,166,1239
00373500,VIRGINIA COMMONWEALTH UNIVERSITY        ,VA,23284-9004,Public       ,3905,4272,8177,23613,12394,36007
00373600,ROANOKE COLLEGE                         ,VA,24153-3794,Private      ,384,76,460,3486,267,3753
00373700,SHENANDOAH UNIVERSITY                   ,VA,22601-5195,Private      ,533,733,1266,2921,1952,4873
00373800,SOUTHERN VIRGINIA UNIVERSITY            ,VA,24416-3038,Private      ,296,110,406,872,228,1100
00374200,SWEET BRIAR COLLEGE                     ,VA,24595-9998,Private      ,237,23,260,964,74,1038
00374300,UNION PRESBYTERIAN SEMINARY             ,VA,23227-0000,Private      ,2,23,25,2,56,58
00374400,UNIVERSITY OF RICHMOND                  ,VA,23173-0001,Private      ,677,770,1447,6446,2233,8679
00374500,UNIVERSITY OF VIRGINIA - SFS            ,VA,22903-0000,Public       ,726,1924,2650,21754,7784,29538
00374600,UNIVERSITY OF MARY WASHINGTON           ,VA,22401-5358,Public       ,557,370,927,5445,1198,6643
00374700,UNIV OF VIRGINIA'S COLLEGE AT WISE      ,VA,24293-4412,Public       ,369,194,563,1721,482,2203
00374800,EASTERN SHORE COMMUNITY COLLEGE         ,VA,23410-3001,Public       ,121,211,332,253,379,632
00374900,GEORGE MASON UNIVERSITY                 ,VA,22030-4444,Public       ,2192,3478,5670,24026,12941,36967
00375100,PATRICK HENRY COMMUNITY COLLEGE         ,VA,24112-5311,Public       ,400,642,1042,890,1177,2067
00375200,VIRGINIA INTERMONT COLLEGE              ,VA,24201-4298,Private      ,45,30,75,236,96,332
00375300,VIRGINIA MILITARY INSTITUTE             ,VA,24450-2138,Public       ,265,30,295,2152,86,2238
00375400,VIRGINIA POLYTECH INST & STATE UNIV     ,VA,24061-2000,Public       ,1931,1023,2954,26408,4533,30941
00375800,DANVILLE COMMUNITY COLLEGE              ,VA,24541-4004,Public       ,463,819,1282,1052,1477,2529
00375900,J. SARGEANT REYNOLDS COMMUNITY CLG      ,VA,23285-0000,Public       ,1737,3818,5555,4166,8086,12252
00376000,VIRGINIA WESTERN CMTY COLLEGE           ,VA,24038-0000,Public       ,867,1585,2452,2801,3046,5847
00376100,WYTHEVILLE COMMUNITY COLLEGE            ,VA,24382-3308,Public       ,420,589,1009,1001,1110,2111
00376200,VIRGINIA UNIVERSITY OF LYNCHBURG        ,VA,24501-6400,Private      ,90,200,290,214,373,587
00376400,VIRGINIA STATE UNIVERSITY               ,VA,23806-0001,Public       ,1565,968,2533,8248,2732,10980
00376500,NORFOLK STATE UNIVERSITY                ,VA,23504-8000,Public       ,1467,2116,3583,6772,5368,12140
00376600,VIRGINIA UNION UNIVERSITY               ,VA,23220-1711,Private      ,738,548,1286,4119,1337,5456
00376700,VIRGINIA WESLEYAN COLLEGE               ,VA,23502-5599,Private      ,486,313,799,2347,731,3078
00376800,WASHINGTON & LEE UNIVERSITY             ,VA,24450-0303,Private      ,475,143,618,3092,964,4056
00400400,JOHN TYLER COMMUNITY COLLEGE            ,VA,23831-5316,Public       ,1271,2054,3325,2989,4149,7138
00450301,EVEREST COLLEGE -  MCLEAN               ,VA,22182-2214,Proprietary  ,17,124,141,31,213,244
00498800,CENTRAL VIRGINIA COMMUNITY COLLEGE      ,VA,24502-2498,Public       ,568,810,1378,1361,1553,2914
00499200,MILLER-MOTTE TECHNICAL COLLEGE          ,VA,24505-0000,Proprietary  ,145,520,665,224,735,959
00499600,DABNEY S LANCASTER COMMUNITY CLG        ,VA,24422-1000,Public       ,114,164,278,387,354,741
00522300,NEW RIVER COMMUNITY COLLEGE             ,VA,24084-1127,Public       ,498,768,1266,1306,1623,2929
00662200,COLLEGE OF HEALTH SCIENCES - CHRV       ,VA,24031-0000,Private      ,160,372,532,662,1009,1671
00681900,BLUE RIDGE COMMUNITY COLLEGE            ,VA,24486-0080,Public       ,536,712,1248,1857,1750,3607
00687100,THOMAS NELSON COMMUNITY COLLEGE         ,VA,23670-0000,Public       ,1434,3343,4777,3096,6551,9647
00709900,VIRGINIA HIGHLANDS COMMUNITY CLG        ,VA,24210-4210,Public       ,440,562,1002,905,1060,1965
00726000,SOUTHWEST VIRGINIA COMMUNITY CLG        ,VA,24641-0000,Public       ,423,577,1000,954,1045,1999
00865900,LORD FAIRFAX COMMUNITY COLLEGE          ,VA,22645-0047,Public       ,722,983,1705,1688,1946,3634
00866000,GERMANNA COMMUNITY COLLEGE              ,VA,22508-0339,Public       ,974,1339,2313,2253,2806,5059
00866100,SOUTHSIDE VIRGINIA CMTY CLG             ,VA,23821-2930,Public       ,509,986,1495,979,1578,2557
00915900,PAUL D CAMP COMMUNITY COLLEGE           ,VA,23851-0737,Public       ,153,426,579,340,768,1108
00916000,RAPPAHANNOCK COMMUNITY COLLEGE          ,VA,23149-2616,Public       ,242,475,717,680,917,1597
00926700,EVEREST COLLEGE                         ,VA,23606-4203,Proprietary  ,46,272,318,88,495,583
00926701,EVEREST COLLEGE - CHESAPEAKE            ,VA,23320-2637,Proprietary  ,55,351,406,101,587,688
00942000,SANFORD-BROWN COLLEGE                   ,VA,22182-3913,Proprietary  ,4,40,44,10,75,85
00953500,STAUNTON SCHOOL OF COSMETOLOGY          ,VA,24401-4323,Proprietary  ,5,27,32,12,44,56
00953700,VIRGINIA SCH OF HAIR DESIGN             ,VA,23669-0000,Proprietary  ,11,66,77,22,109,131
00962900,MOUNTAIN EMPIRE COMMUNITY COLLEGE       ,VA,24219-0700,Public       ,426,643,1069,840,1059,1899
00992800,PIEDMONT VIRGINIA COMMUNITY COLLEGE     ,VA,22902-7589,Public       ,576,945,1521,1402,1958,3360
01004300,BON SECOURS MEMORIAL COLLEGE OF NURSING ,VA,23227-4612,Private      ,102,388,490,305,736,1041
01019800,ECPI UNIVERSITY                         ,VA,23462-6542,Proprietary  ,393,1995,2388,700,3640,4340
01019802,ECPI UNIVERSITY - NEWPORT NEWS          ,VA,23606-4298,Proprietary  ,141,626,767,266,1218,1484
01019807,ECPI UNIVERSITY - MANASSAS              ,VA,20109-2665,Proprietary  ,77,292,369,113,495,608
01019813,ECPI UNIVERSITY - CULINARY INSTITUTE OF ,VA,23513-2448,Proprietary  ,53,130,183,152,280,432
01019814,ECPI UNIVERSITY - VIRGINIA BEACH HEALTH ,VA,23462-6540,Proprietary  ,49,263,312,107,588,695
01019815,ECPI UNIVERSITY - RICHMOND SOUTH        ,VA,23236-3659,Proprietary  ,131,336,467,230,589,819
01019816,ECPI UNIVERSITY - INNSBROOK             ,VA,23060-3359,Proprietary  ,59,156,215,92,241,333
01019817,ECPI UNIVERSITY - RICHMOND WEST         ,VA,23294-3730,Proprietary  ,71,238,309,151,499,650
01033800,EASTERN VIRGINIA MEDICAL SCHOOL         ,VA,23501-1980,Public       ,26,412,438,104,1723,1827
01159600,SYLVAIN MELLOUL INTERNATIONAL HAIR ACADE,VA,24502-2652,Proprietary  ,19,47,66,34,87,121
01162601,WESTWOOD COLLEGE - SOUTH BAY - ARLINGTON,VA,22203-4167,Proprietary  ,71,208,279,144,429,573
01162602,WESTWOOD COLLEGE - SOUTH BAY - ANNANDALE,VA,22003-2602,Proprietary  ,35,150,185,85,361,446
01274400,SOUTHSIDE REGIONAL MED CTR PROF SCHOOLS ,VA,23803-5133,Proprietary  ,32,135,167,95,259,354
02053000,LIBERTY UNIVERSITY                      ,VA,24502-0000,Private      ,5557,29910,35467,19543,56144,75687
02108800,WARDS CORNER BEAUTY ACADEMY             ,VA,23505-0000,Proprietary  ,27,122,149,55,207,262
02111600,DANVILLE REGIONAL MEDICAL CENTER SCHOOL ,VA,24541-0000,Proprietary  ,9,35,44,34,68,102
02128700,CENTRAL SCHOOL OF PRACTICAL NURSING     ,VA,23502-2230,Public       ,22,124,146,72,242,314
02140000,RIVERSIDE SCHOOL OF HEALTH CAREERS      ,VA,23608-3802,Private      ,54,249,303,149,518,667
02149901,PAUL MITCHELL THE SCHOOL-JACKSONVILLE - ,VA,22102-0000,Proprietary  ,28,68,96,48,99,147
02149902,PAUL MITCHELL THE SCHOOL-JACKSONVILLE - ,VA,22192-0000,Proprietary  ,33,72,105,57,135,192
02175800,LYNCHBURG GENERAL HOSP SCH OF NURSG     ,VA,24501-0000,Private      ,45,111,156,90,190,280
02197600,WOODROW WILSON REHABILITATION CTR       ,VA,22939-0000,Public       ,5,5,10,17,12,29
02242400,HENRICO CTY ST MARYS HOSP PRAC NRSG     ,VA,23075-0000,Public       ,5,25,30,12,59,71
02320900,TIDEWATER TECH                          ,VA,23502-1747,Proprietary  ,79,351,430,157,631,788
02334400,CENTURA COLLEGE                         ,VA,23452-0000,Proprietary  ,90,587,677,174,1071,1245
02342700,FORTIS COLLEGE                          ,VA,23502-4101,Proprietary  ,77,352,429,152,689,841
02342701,FORTIS COLLEGE - RICHMOND CAMPUS        ,VA,23236-3472,Proprietary  ,89,311,400,167,562,729
02358500,BON SECOURS SAINT MARY'S HOSPITAL SCHOOL,VA,23227-4612,Private      ,41,132,173,115,263,378
02538800,SUFFOLK BEAUTY ACADEMY                  ,VA,23434-0000,Proprietary  ,12,31,43,18,53,71
02541200,STRATFORD UNIVERSITY                    ,VA,22043-0000,Proprietary  ,171,1128,1299,376,1961,2337
02541201,STRATFORD UNIVERSITY-WOODBRIDGE         ,VA,22192-0000,Proprietary  ,62,256,318,129,558,687
02588900,MEDTECH INSTITUTE                       ,VA,22042-3013,Proprietary  ,132,520,652,195,782,977
02610100,WASHINGTON COUNTY ADULT SKILL CTR       ,VA,24210-2346,Public       ,24,52,76,51,98,149
02617508,EVEREST COLLEGE - WOODBRIDGE            ,VA,22192-6808,Proprietary  ,72,290,362,114,460,574
03002400,GRAHAM WEBB INTERNATIONAL ACAD HAIR     ,VA,22209-2129,Proprietary  ,12,45,57,28,84,112
03010700,BAR PALMA BEAUTY CAREERS  ACADEMY       ,VA,24014-2255,Proprietary  ,13,43,56,20,75,95
03042800,"VIRGINIA BEACH CITY SCHOOLS, SCH.-PR.NSG",VA,23456-0038,Public       ,15,73,88,39,152,191
03091300,REGENT UNIVERSITY                       ,VA,23464-9800,Private      ,432,2319,2751,1565,4748,6313
03092700,SKYLINE COLLEGE                         ,VA,24012-1603,Proprietary  ,23,142,165,64,266,330
03096500,SPRINGFIELD BEAUTY ACADEMY              ,VA,22003-3016,Proprietary  ,4,33,37,8,50,58
03106500,SENTARA NORFOLK GENERAL HOSPITAL        ,VA,23320-2843,Private      ,67,330,397,166,682,848
03116900,BAPTIST THEOLOGICAL SEM.-RICHMOND       ,VA,23227-0000,Private      ,3,77,80,12,113,125
03126300,AVIATION INSTITUTE OF MAINTENANCE       ,VA,23320-5987,Proprietary  ,22,133,155,50,270,320
03126400,CENTURA COLLEGE                         ,VA,23235-5230,Proprietary  ,55,283,338,111,560,671
03127500,ADVANCED TECHNOLOGY INSTITUTE           ,VA,23462-2409,Proprietary  ,205,250,455,391,503,894
03280400,VIRGINIA SCHOOL OF MASSAGE              ,VA,22903-0000,Proprietary  ,14,33,47,22,67,89
03409500,RICHMOND SCHOOL OF HEALTH AND TECH      ,VA,23227-0000,Proprietary  ,40,178,218,87,308,395
03455300,CRESCENT COSMETOLOGY UNIVERSITY         ,VA,23666-3115,Proprietary  ,4,9,13,6,31,37
03559300,APPALACHIAN SCHOOL OF LAW               ,VA,24614-0000,Private      ,4,95,99,6,286,292
03645400,RUDY & KELLY ACADEMY OF HAIR AND NA     ,VA,23464-6857,Proprietary  ,42,107,149,83,192,275
03654300,CAREER TRAINING SOLUTIONS               ,VA,22406-1014,Proprietary  ,34,219,253,79,474,553
03709300,EDWARD VIA VIRGINIA CLG OSTEOPATHIC MED ,VA,24060-6360,Private      ,2,431,433,13,863,876
03862600,VIRGINIA BAPTIST COLLEGE                ,VA,22407-0000,Private      ,16,34,50,26,66,92
03872400,INSTITUTE FOR THE PSYCHOLOGICAL SCIENCES,VA,22202-3609,Private      ,4,51,55,17,111,128
03876300,CULPEPER COSMETOLOGY TRAINING CENTER    ,VA,22701-3155,Public       ,10,16,26,16,37,53
03883400,AVIATION INSTITUTE OF MAINTENANCE       ,VA,20110-4156,Proprietary  ,19,60,79,42,128,170
04038400,AVI CAREER INSTITUTE                    ,VA,22066-1839,Proprietary  ,5,34,39,10,44,54
04110300,UNIVERSITY OF MANAGEMENT AND TECHNOLOGY ,VA,22209-1609,Proprietary  ,6,127,133,19,274,293
04124000,DOMINION SCHOOL OF HAIR DESIGN          ,VA,23062-2221,Proprietary  ,3,7,10,7,18,25
04127300,COLUMBIA COLLEGE                        ,VA,22031-4413,Proprietary  ,16,164,180,53,236,289
04133400,CENTURA COLLEGE                         ,VA,22312-2670,Proprietary  ,0,0,0,20,76,96
04137300,CAYCE/REILLY SCHOOL OF MASSOTHERAPY     ,VA,23451-2061,Private      ,4,22,26,12,62,74
04140000,GLOBAL HEALTH NURSE TRAINING SERVICES   ,VA,22314-4585,Proprietary  ,21,243,264,35,469,504
04153800,BETHEL COLLEGE                          ,VA,23666-3122,Private      ,13,46,59,30,92,122
04156200,INSTITUTE OF ADVANCED MEDICAL ESTHETICS ,VA,23294-4701,Proprietary  ,6,40,46,18,77,95
04169400,NORTHERN VIRGINIA SCHOOL OF THERAPEUTIC ,VA,22046-4302,Proprietary  ,6,30,36,20,81,101
04171500,COSMOPOLITAN BEAUTY & TECH SCHOOL       ,VA,22003-3204,Proprietary  ,9,85,94,13,109,122
04179900,TOMORROW'S IMAGE BARBER ACADEMY OF VIRGI,VA,23602-5532,Proprietary  ,1,15,16,7,35,42
04180600,APPALACHIAN COLLEGE OF PHARMACY         ,VA,24631-9210,Private      ,3,95,98,23,241,264
04214700,LUCKES BEAUTY ACADEMY                   ,VA,23601-1303,Proprietary  ,2,23,25,2,23,25
04218600,VIRGINIA TECH CARILION SCHOOL OF MEDICIN,VA,24016-4950,Private      ,36,127,163,172,378,550
04219000,IGLOBAL UNIVERSITY                      ,VA,22003-2400,Proprietary  ,1,7,8,2,23,25
04220100,NATIONAL PERSONAL TRAINING INSTITUTE    ,VA,22182-2412,Proprietary  ,4,24,28,4,25,29
04220400,CHRYSM INSTITUTE OF ESTHETICS (THE)     ,VA,23462-3650,Proprietary  ,9,51,60,15,102,117
04221000,"STANDARD HEALTHCARE SERVICES, COLLEGE OF",VA,22046-4612,Proprietary  ,4,103,107,10,197,207
00107000,THUNDERBIRD SCHOOL OF GLOBAL MANAGEMENT ,AZ,85306-6000,Private      ,8,177,185,23,377,400
00107100,ARIZONA WESTERN COLLEGE                 ,AZ,85366-0000,Public       ,1994,1977,3971,3926,3265,7191
00107200,COCHISE COLLEGE                         ,AZ,85607-6190,Public       ,684,1089,1773,1286,1842,3128
00107300,EASTERN ARIZONA COLLEGE                 ,AZ,85552-0769,Public       ,503,488,991,1204,903,2107
00107400,GRAND CANYON UNIVERSITY                 ,AZ,85017-3030,Proprietary  ,4807,18752,23559,16134,37037,53171
00107600,GLENDALE COMMUNITY COLLEGE              ,AZ,85302-3090,Public       ,4438,5472,9910,8883,10174,19057
00107700,MESA COMMUNITY COLLEGE                  ,AZ,85202-4866,Public       ,4021,6309,10330,8176,11438,19614
00107800,PHOENIX COLLEGE                         ,AZ,85013-4234,Public       ,2406,4806,7212,5174,9141,14315
00107900,YAVAPAI COLLEGE                         ,AZ,86301-3297,Public       ,702,1456,2158,1657,2953,4610
00108100,ARIZONA STATE UNIV (ALL CAMPUSES)       ,AZ,85287-0412,Public       ,11387,14687,26074,53776,38382,92158
00108200,NORTHERN ARIZONA UNIVERSITY             ,AZ,86011-0001,Public       ,4360,4603,8963,29791,12193,41984
00108300,UNIVERSITY OF ARIZONA                   ,AZ,85721-0066,Public       ,5376,4451,9827,32854,13866,46720
00165701,MIDWESTERN UNIVERSITY                   ,AZ,85308-0000,Private      ,63,1289,1352,205,3974,4179
00446700,TUCSON COLLEGE                          ,AZ,85711-3781,Proprietary  ,91,167,258,229,400,629
00711300,ARIZONA CHRISTIAN UNIVERSITY            ,AZ,85032-7097,Private      ,345,240,585,1164,497,1661
00726600,PIMA COUNTY COMMUNITY COLLEGE           ,AZ,85709-1110,Public       ,3429,5239,8668,7914,10472,18386
00728300,CENTRAL ARIZONA COLLEGE                 ,AZ,85228-9779,Public       ,1158,1781,2939,2172,3079,5251
00732911,ITT TECHNICAL INSTITUTE                 ,AZ,85282-9272,Proprietary  ,242,1198,1440,424,1711,2135
00732990,ITT TECHNICAL INSTITUTE                 ,AZ,85704-5829,Proprietary  ,260,968,1228,393,1270,1663
00822100,UNIVERSAL TECHNICAL INSTITUTE           ,AZ,85323-7946,Proprietary  ,2347,2151,4498,7260,5066,12326
00824600,DINÉ COLLEGE                            ,AZ,86556-0126,Public       ,373,467,840,536,765,1301
00830300,GATEWAY COMMUNITY COLLEGE               ,AZ,85034-1795,Public       ,1294,3171,4465,2809,5771,8580
00830302,MARICOPA SKILL CENTER                   ,AZ,85034-0000,Public       ,153,483,636,309,896,1205
00830400,SCOTTSDALE COMMUNITY COLLEGE            ,AZ,85250-0000,Public       ,1462,1806,3268,3328,3429,6757
00886400,ARIZONA ACADEMY OF BEAUTY               ,AZ,85712-5021,Proprietary  ,21,54,75,65,105,170
01084700,ARIZONA AUTOMOTIVE INSTITUTE            ,AZ,85301-3503,Proprietary  ,194,547,741,280,795,1075
01085800,AVALON SCHOOL OF COSMETOLOGY            ,AZ,85210-4010,Proprietary  ,198,360,558,314,546,860
01168900,REFRIGERATION SCHOOL                    ,AZ,85034-0000,Proprietary  ,72,324,396,96,526,622
01180200,ARIZONA ACADEMY OF BEAUTY-NORTH         ,AZ,85705-2720,Proprietary  ,9,37,46,32,63,95
01186200,NORTHLAND PIONEER COLLEGE               ,AZ,86025-0610,Public       ,250,668,918,425,1171,1596
01186400,MOHAVE COMMUNITY COLLEGE                ,AZ,86409-1238,Public       ,586,1556,2142,975,2602,3577
01218400,INTERNATIONAL ACAD OF HAIR DESIGN       ,AZ,85225-7198,Proprietary  ,30,90,120,43,125,168
02065300,PRESCOTT COLLEGE                        ,AZ,86301-0000,Private      ,105,355,460,510,731,1241
02071200,KAPLAN COLLEGE                          ,AZ,85029-4349,Proprietary  ,43,355,398,108,685,793
02098800,UNIVERSITY OF PHOENIX                   ,AZ,85040-0000,Proprietary  ,4053,79388,83441,8057,140695,148752
02100500,UNIVERSAL TECHNICAL INSTITUTE           ,AZ,85027-0000,Proprietary  ,1384,2173,3557,4572,5923,10495
02100600,CARRINGTON COLLEGE                      ,AZ,85015-4096,Proprietary  ,622,1792,2414,1179,3156,4335
02113800,ROBERTO-VENN SCH OF LUTHIERY            ,AZ,85040-0000,Proprietary  ,13,23,36,33,39,72
02146600,SOUTH MOUNTAIN COMMUNITY COLLEGE        ,AZ,85040-0000,Public       ,999,1682,2681,2032,2976,5008
02160305,COLLINS COLLEGE                         ,AZ,85040-4000,Proprietary  ,53,136,189,104,256,360
02160306,INTERNATIONAL ACADEMY OF DESIGN AND TECH,AZ,85281-6705,Proprietary  ,8,19,27,32,53,85
02171500,WESTERN INTERNATIONAL UNIVERSITY        ,AZ,85021-0000,Proprietary  ,22,366,388,71,660,731
02177500,RIO SALADO COMMUNITY COLLEGE            ,AZ,85281-6948,Public       ,934,5150,6084,2005,9930,11935
02199900,AMERICAN INDIAN CLG-ASSEMBLIES GOD      ,AZ,85021-0000,Private      ,20,52,72,48,93,141
02217100,PIMA MEDICAL INSTITUTE                  ,AZ,85716-0000,Proprietary  ,1063,2905,3968,1993,5356,7349
02218800,BROOKLINE COLLEGE                       ,AZ,85021-5815,Proprietary  ,146,718,864,263,1250,1513
02218804,BROOKLINE COLLEGE - MESA                ,AZ,85204-4448,Proprietary  ,66,254,320,116,438,554
02218805,BROOKLINE COLLEGE - TUCSON              ,AZ,85711-5444,Proprietary  ,82,294,376,155,529,684
02263100,ANTHEM COLLEGE                          ,AZ,85014-0000,Proprietary  ,225,983,1208,384,1544,1928
02280500,CHARLES OF ITALY BEAUTY COLLEGE         ,AZ,86403-0000,Proprietary  ,9,26,35,16,53,69
02295000,EVEREST COLLEGE                         ,AZ,85021-1610,Proprietary  ,379,3358,3737,602,5016,5618
02295002,EVEREST COLLEGE - MESA                  ,AZ,85206-4704,Proprietary  ,90,433,523,149,828,977
02317800,AMERICAN INSTITUTE OF TECHNOLOGY        ,AZ,85043-0000,Proprietary  ,51,376,427,123,556,679
02491500,THE ART CENTER DESIGN COLLEGE           ,AZ,85716-0000,Proprietary  ,51,98,149,120,185,305
02533200,FRANK LLOYD WRIGHT SCHOOL OF ARCHITECTUR,AZ,85261-4430,Private      ,9,20,29,18,44,62
02559000,UNIVERSITY OF ADVANCING TECHNOLOGY      ,AZ,85283-0000,Proprietary  ,214,250,464,798,554,1352
02561900,BRILLARE HAIRDRESSING ACADEMY           ,AZ,85254-3301,Proprietary  ,17,32,49,31,58,89
02582700,CORTIVA INSTITUTE - TUCSON              ,AZ,85710-3503,Proprietary  ,27,81,108,47,131,178
02616700,LE CORDON BLEU COLLEGE OF CULINARY ARTS ,AZ,85251-2729,Proprietary  ,322,1153,1475,609,2346,2955
02623600,PARADISE VALLEY COMMUNITY COLLEGE       ,AZ,85032-1210,Public       ,1294,1859,3153,2803,3432,6235
02623800,CORTIVA INSTITUTE - SCOTTSDALE          ,AZ,85257-4218,Proprietary  ,7,33,40,14,63,77
03005000,SAFFORD COLLEGE OF BEAUTY CULTURE       ,AZ,85546-3309,Proprietary  ,1,5,6,3,8,11
03010613,VIRGINIA COLLEGE - GOLF ACADEMY OF ARIZO,AZ,85225-6742,Proprietary  ,14,27,41,21,55,76
03030604,UTAH COLLEGE OF MASSAGE THERAPY - ARIZON,AZ,85282-0000,Proprietary  ,41,81,122,63,137,200
03030605,UTAH COLLEGE OF MASSAGE THERAPY - ARIZON,AZ,85051-3470,Proprietary  ,38,123,161,69,196,265
03034400,CONSERVATORY RECORDING ARTS & SCIS      ,AZ,85282-1707,Proprietary  ,236,218,454,499,487,986
03072200,CHANDLER-GILBERT COMMUNITY COLLEGE      ,AZ,85225-2499,Public       ,2096,2402,4498,4352,4374,8726
03076400,BRYMAN SCHOOL OF ARIZONA                ,AZ,85029-4919,Proprietary  ,77,266,343,129,458,587
03097800,CARSTEN INSTITUTE OF HAIR & BEAUTY      ,AZ,85282-5404,Proprietary  ,31,77,108,59,145,204
03100400,COCONINO COUNTY COMMUNITY COLLEGE       ,AZ,86001-0000,Public       ,651,749,1400,1532,1547,3079
03107000,SOUTHWEST CLG OF NATUROPATHIC MED       ,AZ,85282-0000,Private      ,7,265,272,17,495,512
03115000,ARIZONA COLLEGE OF ALLIED HEALTH        ,AZ,85302-3843,Proprietary  ,144,494,638,233,767,1000
03120300,COLLEGE AMERICA                         ,AZ,86004-3936,Proprietary  ,171,571,742,268,950,1218
03156300,ESTRELLA MOUNTAIN COMMUNITY COLLEGE     ,AZ,85392-1010,Public       ,1955,2753,4708,3890,5107,8997
03347300,INTERNATIONAL BAPTIST COLLEGE           ,AZ,85282-6799,Private      ,22,13,35,37,22,59
03445300,HDS TRUCK DRIVING INSTITUTE             ,AZ,85731-0000,Proprietary  ,5,77,82,14,113,127
03478400,PHOENIX SEMINARY                        ,AZ,85018-7611,Private      ,4,55,59,6,127,133
03572300,EAST VALLEY INSTITUTE OF TECHNOLOGY     ,AZ,85201-6910,Public       ,149,232,381,294,477,771
03593300,SOUTHWEST INSTITUTE OF HEALING ARTS     ,AZ,85281-3658,Proprietary  ,66,546,612,114,1092,1206
03617500,PHOENIX INSTITUTE OF HERBAL MEDICINE & A,AZ,85012-0000,Proprietary  ,21,124,145,50,267,317
03695500,ARIZONA SCHOOL OF ACUPUNCTURE AND ORIENT,AZ,85712-1100,Proprietary  ,3,43,46,8,85,93
03784400,TOHONO O'ODHAM COMMUNITY COLLEGE        ,AZ,85634-3129,Public       ,43,39,82,61,58,119
03813300,NORTHCENTRAL UNIVERSITY                 ,AZ,86314-2336,Proprietary  ,25,2081,2106,69,4753,4822
03814300,TURNING POINT BEAUTY COLLEGE            ,AZ,85222-4229,Proprietary  ,8,25,33,15,39,54
04051300,ART INSTITUTE OF PHOENIX (THE)          ,AZ,85021-2859,Proprietary  ,2330,7584,9914,4491,14151,18642
04051306,ART INSTITUTE OF PHOENIX (THE) - ART INS,AZ,85712-2732,Proprietary  ,135,171,306,358,392,750
04051325,ART INSTITUTE OF PHOENIX (THE) - BROWN M,AZ,85712-5300,Proprietary  ,76,307,383,136,581,717
04051327,ART INSTITUTE OF PHOENIX (THE) - BROWN M,AZ,85029-1348,Proprietary  ,64,153,217,146,306,452
04059300,TUCSON COLLEGE OF BEAUTY                ,AZ,85705-2451,Proprietary  ,31,64,95,58,116,174
04120900,ARIZONA CULINARY INSTITUTE              ,AZ,85259-4939,Proprietary  ,73,100,173,168,208,376
04131400,ARIZONA SUMMIT LAW SCHOOL               ,AZ,85004-4418,Proprietary  ,20,304,324,64,757,821
04139200,UNIVERSAL BARBER COLLEGE                ,AZ,85007-3914,Proprietary  ,0,0,0,1,1,2
04148700,AMERICAN INSTITUTE OF INTERIOR DESIGN   ,AZ,85268-3827,Proprietary  ,5,22,27,16,52,68
04152900,STUDIO ACADEMY OF BEAUTY (THE)          ,AZ,85224-3600,Proprietary  ,38,113,151,67,167,234
04157400,NATIONAL PARALEGAL COLLEGE              ,AZ,85014-1262,Proprietary  ,25,403,428,54,1020,1074
04174100,PAUL MITCHELL THE SCHOOL PHOENIX        ,AZ,85017-1919,Proprietary  ,53,128,181,122,246,368
04174200,ALL BEAUTY COLLEGE                      ,AZ,86426-8326,Proprietary  ,21,51,72,33,87,120
04175300,PENROSE ACADEMY                         ,AZ,85254-4065,Proprietary  ,42,64,106,69,116,185
04177500,PURE AESTHETICS                         ,AZ,85711-2328,Proprietary  ,16,55,71,29,89,118
04191200,CLASSIC COOKING ACADEMY                 ,AZ,85255-8699,Private      ,0,0,0,4,7,11
04194500,AVEDA INSTITUTE TUCSON                  ,AZ,85719-4876,Proprietary  ,77,160,237,143,264,407
04217600,SESSIONS COLLEGE FOR PROFESSIONAL DESIGN,AZ,85281-2840,Proprietary  ,7,46,53,17,86,103
04233100,ARIZONA SCHOOL OF INTEGRATIVE STUDIES   ,AZ,86324-3106,Proprietary  ,7,20,27,12,29,41
04233101,ARIZONA SCHOOL OF INTEGRATIVE STUDIES - ,AZ,86001-5510,Proprietary  ,5,28,33,6,33,39
04233102,ARIZONA SCHOOL OF INTEGRATIVE STUDIES - ,AZ,86303-4711,Proprietary  ,11,30,41,11,33,44
04233103,ARIZONA SCHOOL OF INTEGRATIVE STUDIES - ,AZ,85705-8330,Proprietary  ,10,37,47,11,40,51
00142800,DELAWARE STATE UNIVERSITY               ,DE,19901-2277,Public       ,1305,751,2056,7597,2099,9696
00142900,GOLDEY BEACOM COLLEGE                   ,DE,19808-1993,Private      ,194,188,382,554,361,915
00143100,UNIVERSITY OF DELAWARE                  ,DE,19716-0099,Public       ,4479,1056,5535,26006,2733,28739
00143300,WESLEY COLLEGE                          ,DE,19901-3875,Private      ,595,254,849,2336,606,2942
00143301,WESLEY COLLEGE-CTR FOR ADULT STUDIE     ,DE,19720-0000,Private      ,0,0,0,1,0,1
00331301,WIDENER UNIV SCHOOL OF LAW - DE         ,DE,19803-0000,Private      ,30,370,400,70,990,1060
00705300,DELAWARE TECH & CMTY COLLEGE-OWENS      ,DE,19947-0000,Public       ,1079,1355,2434,2093,2380,4473
00794800,WILMINGTON UNIVERSITY                   ,DE,19720-6491,Private      ,1112,3710,4822,2619,7032,9651
01172700,DELAWARE TECH & CMTY CLG-TERRY          ,DE,19901-8736,Public       ,910,1195,2105,1811,2091,3902
02125200,BEEBE SCHOOL OF NURSING                 ,DE,19958-1462,Private      ,17,52,69,53,93,146
02144900,DELAWARE TECH & CMTY CLG-STANTN/WLM     ,DE,19801-0000,Public       ,1771,2250,4021,3408,3712,7120
02190400,SCHILLING DOUGLAS SCH OF HAIR DSGN      ,DE,19711-0000,Proprietary  ,55,47,102,67,67,134
02586902,STAR TECHNICAL INSTITUTE -              ,DE,19901-4615,Proprietary  ,6,32,38,18,67,85
03025800,DAWN TRAINING CENTRE                    ,DE,19805-1511,Proprietary  ,42,208,250,64,364,428
03543300,HARRIS SCHOOL OF BUSINESS               ,DE,19803-5341,Proprietary  ,49,167,216,71,223,294
03702300,DELAWARE LEARNING INSTITUTE OF COSMETOLO,DE,19939-9759,Proprietary  ,19,23,42,35,48,83
04130700,ACADEMY OF MASSAGE AND BODYWORK         ,DE,19701-1321,Proprietary  ,9,26,35,14,40,54
04139800,DELAWARE COLLEGE OF ART & DESIGN        ,DE,19801-3007,Private      ,90,62,152,366,127,493
04171100,DELAWARE ACADEMY PAUL MITCHELL PARTNER S,DE,19702-5108,Proprietary  ,31,56,87,54,88,142
        ,FEDERAL STUDENT AID USE ONLY            ,DC,20202-0000,,0,1,1,0,2,2
00143400,AMERICAN UNIVERSITY                     ,DC,20016-8020,Private      ,1567,1795,3362,12945,8492,21437
00143700,CATHOLIC UNIVERSITY OF AMERICA          ,DC,20064-0002,Private      ,630,747,1377,5287,1995,7282
00143711,"CATHOLIC UNIV AMERICA, LAW SCHOOL       ",DC,20064-0000,Private      ,9,274,283,79,1010,1089
00144100,UNIV OF THE DISTRICT OF COLUMBIA        ,DC,20008-0000,Public       ,868,2297,3165,2350,5036,7386
00144102,UNIV OF THE DIST OF COLU -SCHOOL OF LAW ,DC,20008-1173,Public       ,11,203,214,43,683,726
00144300,GALLAUDET UNIVERSITY                    ,DC,20002-3695,Private      ,261,347,608,819,970,1789
00144400,GEORGE WASHINGTON UNIVERSITY            ,DC,20052-2353,Private      ,1542,2967,4509,13858,9536,23394
00144402,GEORGE WASHINGTON UNIV LAW SCHL         ,DC,20052-0000,Private      ,9,619,628,71,3567,3638
00144403,GEORGE WASHINGTON UNIV SCH MED          ,DC,20052-0000,Private      ,15,470,485,99,1543,1642
00144500,GEORGETOWN UNIVERSITY                   ,DC,20057-1252,Private      ,1302,1511,2813,12241,3958,16199
00144501,"GEORGETOWN UNIV, SCH OF MEDICINE        ",DC,20007-0000,Private      ,16,322,338,89,1320,1409
00144502,GEORGETOWN UNIVERSITY - GRADUATE SCHOOL ,DC,20057-0004,Private      ,20,1180,1200,67,3910,3977
00144503,GEORGETOWN UNIV LAW CENTER              ,DC,20001-0000,Private      ,4,976,980,54,4744,4798
00144800,HOWARD UNIVERSITY                       ,DC,20059-0001,Private      ,1659,2034,3693,14303,7917,22220
00145900,STRAYER UNIVERSITY                      ,DC,20005-2603,Proprietary  ,781,21632,22413,1193,30970,32163
00146000,TRINITY UNIVERSITY                      ,DC,20017-1004,Private      ,233,805,1038,1315,2141,3456
00146400,WESLEY THEOLOGICAL SEMINARY             ,DC,20016-0000,Private      ,1,120,121,2,267,269
00207701,JOHNS HOPKINS UNIV SCH ADV INTL STU     ,DC,20036-0000,Private      ,7,265,272,82,1432,1514
01006500,WASHINGTON THEOLOGICAL UNION            ,DC,20012-0000,Private      ,0,1,1,2,13,15
01195000,THE CORCORAN COLLEGE OF ART & DESIG     ,DC,20006-4804,Private      ,60,94,154,301,271,572
01280300,DOMINICAN HOUSE OF STUDIES              ,DC,20017-1584,Private      ,0,13,13,2,26,28
02132800,NAT'L CONSERVATORY DRAMATIC ARTS        ,DC,20007-2758,Private      ,5,16,21,17,40,57
03104300,CAREER BLAZERS LEARNING CENTER OF WASHIN,DC,20037-1881,Proprietary  ,20,234,254,29,285,314
03218300,POTOMAC COLLEGE                         ,DC,20016-1860,Proprietary  ,9,117,126,45,251,296
03409600,BENNETT CAREER INSTITUTE                ,DC,20017-1754,Proprietary  ,30,118,148,72,222,294
03750300,TECHNICAL LEARNING CENTERS              ,DC,20006-3749,Proprietary  ,35,139,174,51,198,249
04114400,INSTITUTE OF WORLD POLITICS (THE)       ,DC,20036-1464,Private      ,4,75,79,8,157,165
04142700,PONTIFICAL JOHN PAUL II INSTITUTE FOR ST,DC,20064-0001,Private      ,1,8,9,2,19,21
04190000,RADIANS COLLEGE                         ,DC,20005-3542,Proprietary  ,30,448,478,55,803,858
04202500,GRADUATE SCHOOL                         ,DC,20024-2520,Private      ,3,34,37,4,54,58
00154100,ABRAHAM BALDWIN AGRICULTURAL CLG        ,GA,31794-0000,Public       ,1696,750,2446,2891,1240,4131
00154200,AGNES SCOTT COLLEGE                     ,GA,30030-3770,Private      ,260,162,422,1401,405,1806
00154300,DARTON COLLEGE                          ,GA,31707-3098,Public       ,1910,2858,4768,3121,4552,7673
00154400,ALBANY STATE UNIVERSITY                 ,GA,31705-2796,Public       ,2509,2248,4757,5593,3869,9462
00154500,ANDREW COLLEGE                          ,GA,39840-1395,Private      ,191,35,226,388,74,462
00154600,ARMSTRONG ATLANTIC STATE UNIVERSITY     ,GA,31419-1997,Public       ,2155,2147,4302,5704,4883,10587
00154700,POINT UNIVERSITY                        ,GA,30344-1999,Private      ,475,521,996,981,893,1874
00155200,AUGUSTA STATE UNIVERSITY                ,GA,30904-2200,Public       ,0,0,0,644,618,1262
00155400,BERRY COLLEGE                           ,GA,30149-5007,Private      ,818,130,948,3683,309,3992
00155500,THOMAS UNIVERSITY                       ,GA,31792-7499,Private      ,252,598,850,435,999,1434
00155600,BRENAU UNIVERSITY                       ,GA,30501-3668,Private      ,517,1365,1882,1721,2698,4419
00155700,BREWTON PARKER COLLEGE                  ,GA,30445-0000,Private      ,283,81,364,498,137,635
00155800,COLLEGE OF COASTAL GEORGIA              ,GA,31520-3644,Public       ,1024,1022,2046,1897,1857,3754
00155900,CLARK ATLANTA UNIVERSITY                ,GA,30314-4385,Private      ,2196,1855,4051,9560,4641,14201
00156000,COLUMBIA THEOLOGICAL SEMINARY           ,GA,30031-0000,Private      ,3,130,133,6,189,195
00156100,COLUMBUS STATE UNIVERSITY               ,GA,31907-5645,Public       ,2440,2622,5062,5913,5186,11099
00156200,GEORGIA PERIMETER COLLEGE               ,GA,30021-0000,Public       ,6561,8319,14880,12144,15895,28039
00156300,EMMANUEL COLLEGE                        ,GA,30639-0000,Private      ,396,61,457,848,131,979
00156400,EMORY UNIVERSITY                        ,GA,30322-1960,Private      ,1331,2548,3879,12625,9199,21824
00156600,FORT VALLEY STATE UNIVERSITY            ,GA,31030-3298,Public       ,1426,1061,2487,3382,1986,5368
00156800,INTERDENOMINATIONAL THEOLOGY CENTER     ,GA,30314-0000,Private      ,2,225,227,6,381,387
00156900,GEORGIA INSTITUTE OF TECHNOLOGY         ,GA,30332-0325,Public       ,4743,2300,7043,21393,5401,26794
00157000,SOUTHERN POLYTECHNIC STATE UNIV         ,GA,30060-2896,Public       ,1651,1600,3251,5098,3834,8932
00157100,GEORGIA MILITARY COLLEGE                ,GA,31061-3398,Public       ,2173,2555,4728,3788,4530,8318
00157200,GEORGIA SOUTHERN UNIVERSITY             ,GA,30460-8065,Public       ,9133,3444,12577,21107,6473,27580
00157300,GEORGIA SOUTHWESTERN STATE UNIV         ,GA,31709-4693,Public       ,1168,964,2132,2489,1696,4185
00157400,GEORGIA STATE UNIVERSITY                ,GA,30303-3010,Public       ,11093,10288,21381,29250,22272,51522
00157500,GORDON COLLEGE                          ,GA,30204-1762,Public       ,1975,1194,3169,3457,2054,5511
00157700,KENNESAW STATE UNIVERSITY               ,GA,30144-5591,Public       ,9492,6353,15845,22633,12581,35214
00157800,LAGRANGE COLLEGE                        ,GA,30240-2999,Private      ,372,221,593,1312,449,1761
00157900,GEORGIA REGENTS UNIVERSITY              ,GA,30912-0004,Public       ,1926,2647,4573,3956,5319,9275
00158000,MERCER UNIVERSITY                       ,GA,31207-0003,Private      ,1571,4117,5688,5630,7524,13154
00158100,MIDDLE GEORGIA STATE COLLEGE            ,GA,31014-1599,Public       ,3183,2749,5932,5035,4236,9271
00158103,MIDDLE GEORGIA STATE COLLEGE - MACON CAM,GA,31206-5145,Public       ,0,0,0,448,487,935
00158200,MOREHOUSE COLLEGE                       ,GA,30314-3773,Private      ,785,392,1177,3733,1100,4833
00158500,UNIVERSITY OF NORTH GEORGIA             ,GA,30597-0001,Public       ,5302,2347,7649,11568,4400,15968
00158600,OGLETHORPE UNIVERSITY                   ,GA,30319-2737,Private      ,439,238,677,2065,533,2598
00158700,PAINE COLLEGE                           ,GA,30901-3182,Private      ,604,326,930,1237,661,1898
00158800,PIEDMONT COLLEGE                        ,GA,30535-5644,Private      ,453,670,1123,1109,1170,2279
00158900,REINHARDT UNIVERSITY                    ,GA,30183-2981,Private      ,599,307,906,1459,532,1991
00159000,SAVANNAH STATE UNIVERSITY               ,GA,31404-5298,Public       ,3474,1461,4935,7549,2932,10481
00159100,SHORTER UNIVERSITY                      ,GA,30165-4298,Private      ,678,912,1590,1710,1722,3432
00159200,SOUTH GEORGIA STATE COLLEGE             ,GA,31533-8104,Public       ,916,580,1496,1375,903,2278
00159203,SOUTH GEORGIA STATE COLLEGE - WAYCROSS C,GA,31503-0110,Public       ,209,124,333,429,364,793
00159400,SPELMAN COLLEGE                         ,GA,30314-4399,Private      ,894,450,1344,5617,1338,6955
00159600,TOCCOA FALLS COLLEGE                    ,GA,30598-0001,Private      ,349,92,441,796,189,985
00159700,TRUETT MCCONNELL COLLEGE                ,GA,30528-1264,Private      ,346,98,444,741,188,929
00159800,UNIVERSITY OF GEORGIA                   ,GA,30602-6114,Public       ,9846,4223,14069,29093,9641,38734
00159900,VALDOSTA STATE UNIVERSITY               ,GA,31698-0001,Public       ,5013,2994,8007,11065,5324,16389
00160000,WESLEYAN COLLEGE                        ,GA,31210-4407,Private      ,206,315,521,545,569,1114
00160100,UNIV OF WEST GEORGIA                    ,GA,30118-0002,Public       ,5867,3091,8958,12400,5476,17876
00160200,GEORGIA COLLEGE & STATE UNIVERSITY      ,GA,31061-0490,Public       ,2698,975,3673,7010,1807,8817
00160400,YOUNG HARRIS COLLEGE                    ,GA,30582-4137,Private      ,559,58,617,1472,143,1615
00348400,COVENANT COLLEGE                        ,GA,30750-4164,Private      ,223,42,265,1297,114,1411
00395600,DALTON STATE COLLEGE                    ,GA,30720-3797,Public       ,1978,1372,3350,3746,2610,6356
00402400,GEORGIA NORTHWESTERN TECHNICAL COLLEGE  ,GA,30161-6757,Public       ,1156,2422,3578,1920,4123,6043
00411700,GRADY HEALTH SYSTEM                     ,GA,30303-3050,Public       ,61,355,416,144,717,861
00489808,MCCANN SCHOOL OF BUSINESS & TECHNOLOGY -,GA,31210-0246,Proprietary  ,18,50,68,33,97,130
00525400,LANIER TECHNICAL COLLEGE                ,GA,30566-3499,Public       ,793,1570,2363,1271,2610,3881
00525500,MOULTRIE TECHNICAL COLLEGE              ,GA,31768-0000,Public       ,185,629,814,315,1085,1400
00525600,WIREGRASS GEORGIA TECHNICAL COLLEGE     ,GA,31602-0929,Public       ,700,1667,2367,1058,2782,3840
00551100,OKEFENOKEE TECHNICAL COLLEGE            ,GA,31501-4016,Public       ,314,686,1000,416,996,1412
00559900,AUGUSTA TECHNICAL COLLEGE               ,GA,30906-3399,Public       ,913,2139,3052,1497,3702,5199
00560000,ATHENS TECHNICAL COLLEGE                ,GA,30601-1579,Public       ,1208,1806,3014,1977,3238,5215
00560100,ALBANY TECHNICAL COLLEGE                ,GA,31701-2648,Public       ,575,2164,2739,930,3391,4321
00561500,SOUTHWEST GEORGIA TECHNICAL COLLEGE     ,GA,31792-2622,Public       ,340,741,1081,545,1218,1763
00561700,SOUTH GEORGIA TECHNICAL COLLEGE         ,GA,31709-8167,Public       ,304,446,750,490,731,1221
00561800,SAVANNAH TECHNICAL COLLEGE              ,GA,31405-5594,Public       ,982,2573,3555,1679,5074,6753
00561900,NORTH GEORGIA TECHNICAL COLLEGE         ,GA,30523-0000,Public       ,691,916,1607,1170,1705,2875
00562000,CHATTAHOOCHEE TECHNICAL COLLEGE         ,GA,30060-3398,Public       ,2437,4454,6891,3998,7587,11585
00562100,SOUTHERN CRESCENT TECHNICAL COLLEGE     ,GA,30223-2097,Public       ,908,2257,3165,1438,3850,5288
00562200,DEKALB TECHNICAL COLLEGE                ,GA,30021-0000,Public       ,562,2311,2873,1000,4354,5354
00562400,COLUMBUS TECHNICAL COLLEGE              ,GA,31904-6572,Public       ,731,1684,2415,1303,3013,4316
00576300,CENTRAL GEORGIA TECHNICAL COLLEGE       ,GA,31206-3628,Public       ,1131,3217,4348,1808,5130,6938
00854300,ATLANTA TECHNICAL COLLEGE               ,GA,30310-4499,Public       ,1304,4815,6119,2277,8938,11215
00897600,CLAYTON STATE UNIVERSITY                ,GA,30260-0285,Public       ,2686,4317,7003,5445,7729,13174
00927000,ART INSTITUTE OF ATLANTA (THE)          ,GA,30328-1649,Proprietary  ,2426,2213,4639,5656,4531,10187
00950700,GEORGIA HIGHLANDS COLLEGE               ,GA,30162-0000,Public       ,2134,1698,3832,3659,2903,6562
01031903,MEDIX SCHOOL                            ,GA,30080-7630,Proprietary  ,78,287,365,112,483,595
01048700,WEST GEORGIA TECHNICAL COLLEGE          ,GA,30182-6476,Public       ,1830,2915,4745,2931,4979,7910
01077100,GUPTON JONES COLLEGE                    ,GA,30035-4022,Private      ,43,140,183,107,276,383
01099700,EAST GEORGIA COLLEGE                    ,GA,30401-2699,Public       ,1566,593,2159,2667,1028,3695
01107400,BAINBRIDGE COLLEGE                      ,GA,39819-8400,Public       ,519,1143,1662,831,1833,2664
01110901,EVEREST COLLEGE - EVEREST INSTITUTE     ,GA,30067-8340,Proprietary  ,59,311,370,101,537,638
01110902,EVEREST COLLEGE - ATLANTA               ,GA,30331-2620,Proprietary  ,192,714,906,299,1169,1468
01112301,EVEREST COLLEGE - EVEREST INSTITUTE- NOR,GA,30093-2813,Proprietary  ,84,352,436,121,583,704
01157400,BAUDER COLLEGE                          ,GA,30313-2439,Proprietary  ,171,805,976,317,1436,1753
01205100,PRO WAY HAIR SCHOOL                     ,GA,30083-2884,Proprietary  ,29,118,147,48,173,221
01216500,ATLANTA METROPOLITAN COLLEGE            ,GA,30310-4498,Public       ,1507,2854,4361,2791,5545,8336
01246109,LINCOLN COLLEGE OF TECHNOLOGY - MARIETTA,GA,30067-8638,Proprietary  ,60,185,245,92,346,438
01303900,SOUTH UNIVERSITY                        ,GA,31406-4881,Proprietary  ,956,6564,7520,1769,11423,13192
02060900,BROWN CLG OF COURT REPORTING & M.T.     ,GA,30318-2570,Proprietary  ,17,215,232,30,357,387
02074800,LIFE UNIVERSITY                         ,GA,30060-0000,Private      ,202,817,1019,531,2644,3175
02113613,AMERICAN INTERCONTINENTAL UNIVERSITY    ,GA,30328-1649,Proprietary  ,206,995,1201,474,1946,2420
02116000,SANFORD-BROWN COLLEGE                   ,GA,30328-4803,Proprietary  ,81,445,526,160,797,957
02141500,SAVANNAH COLLEGE OF ART & DESIGN        ,GA,31402-3146,Private      ,2819,1494,4313,9991,3535,13526
02202800,AUGUSTA AREA DIET INTERN UNIV HOSP      ,GA,30901-0000,Private      ,6,34,40,14,68,82
02217200,PORTFOLIO CENTER                        ,GA,30309-0000,Proprietary  ,6,57,63,20,100,120
02266200,AMERICAN PROFESSIONAL INSTITUTE         ,GA,31201-3185,Private      ,18,103,121,33,164,197
02284300,INTERACTIVE COLLEGE OF TECHNOLOGY       ,GA,30341-0000,Proprietary  ,73,554,627,94,761,855
02284308,INTERACTIVE LEARNING SYSTEMS            ,GA,30260-0000,Proprietary  ,11,90,101,18,128,146
02284309,INTERACTIVE COLLEGE OF TECHNOLOGY       ,GA,30501-0000,Proprietary  ,38,136,174,53,204,257
02285500,"CREATIVE CIRCUS, THE                    ",GA,30324-0000,Proprietary  ,41,127,168,72,236,308
02288400,GWINNETT TECHNICAL COLLEGE              ,GA,30043-5702,Public       ,1748,3973,5721,2958,6819,9777
02313902,WESTWOOD COLLEGE - O'HARE AIRPORT - ATLA,GA,30345-2807,Proprietary  ,75,244,319,120,492,612
02321400,ROFFLER-MOLER HAIRSTYLING COLLEGE       ,GA,30062-0000,Proprietary  ,32,48,80,40,92,132
02482100,MOREHOUSE SCHOOL OF MEDICINE            ,GA,30310-0000,Private      ,58,266,324,162,844,1006
02520000,INTERNATIONAL SCH SKIN & NAILCARE       ,GA,30342-1119,Proprietary  ,32,163,195,60,310,370
02559315,(UNITED EDUCATION INSTITUTE) - UEI MORRO,GA,30260-2941,Proprietary  ,16,87,103,29,161,190
02577000,PAUL MITCHELL THE SCHOOL - ESANI        ,GA,30076-1507,Proprietary  ,40,80,120,73,158,231
02577700,BEAUTY COLLEGE OF AMERICA               ,GA,30297-0000,Proprietary  ,18,45,63,27,89,116
02580100,IVERSON INSTITUTE                       ,GA,30341-3662,Proprietary  ,7,52,59,12,87,99
02580200,ATLANTA SCHOOL OF MASSAGE               ,GA,30338-0000,Proprietary  ,50,246,296,89,465,554
02583000,GWINNETT COLLEGE OF BUSINESS            ,GA,30047-3447,Proprietary  ,57,270,327,94,432,526
02614206,MILLER - MOTTE TECHNICAL COLLEGE - COLUM,GA,31907-3222,Proprietary  ,85,502,587,145,792,937
02614207,MILLER - MOTTE TECHNICAL COLLEGE - AUGUS,GA,30907-0921,Proprietary  ,86,492,578,143,746,889
03005400,GEORGIA CAREER INSTITUTE                ,GA,30013-2076,Proprietary  ,98,250,348,146,396,542
03010619,VIRGINIA COLLEGE - AUGUSTA              ,GA,30909-5515,Proprietary  ,116,408,524,187,791,978
03010623,VIRGINIA COLLEGE - MACON                ,GA,31206-3180,Proprietary  ,76,264,340,134,504,638
03022601,WESTERN CULINARY INSTITUTE - LE CORDON B,GA,30084-5893,Proprietary  ,189,428,617,373,823,1196
03030000,OGEECHEE TECHNICAL COLLEGE              ,GA,30458-8049,Public       ,680,1191,1871,1047,2021,3068
03032100,ALTAMAHA TECHNICAL COLLEGE              ,GA,31545-4465,Public       ,167,438,605,283,792,1075
03042700,LAURUSTECHNICAL INSTITUTE               ,GA,30030-1506,Proprietary  ,26,209,235,46,375,421
03066500,SOUTHEASTERN TECHNICAL COLLEGE          ,GA,30474-8817,Public       ,321,727,1048,458,1151,1609
03072304,EVEREST COLLEGE - EVEREST INSTITUTE     ,GA,30236-0000,Proprietary  ,50,300,350,84,494,578
03076300,BEULAH HEIGHTS BIBLE COLLEGE            ,GA,30316-1873,Private      ,8,333,341,24,555,579
03079202,WESTWOOD COLLEGE - ATLANTA MIDTOWN      ,GA,30309-2848,Proprietary  ,214,561,775,352,1008,1360
03081500,SOUTHEASTERN BEAUTY SCHOOL              ,GA,31917-0000,Proprietary  ,28,72,100,50,127,177
03089100,GEORGIA INSTITUTE OF COSMETOLOGY        ,GA,30606-3152,Proprietary  ,74,232,306,144,328,472
03090600,COBB BEAUTY COLLEGE                     ,GA,30144-2828,Proprietary  ,30,87,117,46,142,188
03100900,LUTHER RICE UNIVERSITY                  ,GA,30038-2454,Private      ,19,469,488,32,836,868
03102000,RIVERTOWN SCHOOL OF BEAUTY              ,GA,31904-4747,Proprietary  ,36,106,142,65,170,235
03104500,ATLANTA INSTITUTE OF MUSIC              ,GA,30096-4988,Proprietary  ,126,163,289,246,309,555
03116100,VOGUE BEAUTY AND BARBER SCHOOL          ,GA,30141-2226,Proprietary  ,33,86,119,56,158,214
03155500,OCONEE FALL LINE TECHNICAL COLLEGE      ,GA,31082-6179,Public       ,227,627,854,339,944,1283
03173300,ATLANTA'S JOHN MARSHALL LAW SCHOOL      ,GA,30309-0000,Proprietary  ,13,527,540,48,1112,1160
03418300,GWINNETT COLLEGE-SANDY SPRINGS          ,GA,30328-3161,Proprietary  ,50,149,199,98,272,370
03445500,FAYETTE BEAUTY ACADEMY                  ,GA,30214-1191,Proprietary  ,11,48,59,16,91,107
03523300,AVIATION INSTITUTE OF MAINTENANCE       ,GA,30045-0000,Proprietary  ,99,325,424,131,483,614
03635300,CARVER BIBLE COLLEGE                    ,GA,30331-1300,Private      ,21,105,126,79,202,281
03748300,KEVOSNIK SCHOOL OF HAIR DESIGN          ,GA,31021-0000,Proprietary  ,5,15,20,7,29,36
03804400,MEDTECH INSTITUTE                       ,GA,30339-6040,Proprietary  ,83,314,397,144,586,730
03812300,OMNITECH INSTITUTE                      ,GA,30035-1206,Proprietary  ,19,118,137,33,204,237
04021300,AUGUSTA SCHOOL OF MASSAGE               ,GA,30809-0000,Proprietary  ,7,41,48,12,67,79
04051331,ART INSTITUTE OF PHOENIX (THE) - BROWN M,GA,30319-3054,Proprietary  ,58,224,282,146,425,571
04142900,GEORGIA GWINNETT COLLEGE                ,GA,30043-7409,Public       ,5626,3172,8798,9702,5760,15462
04147000,PAUL MITCHELL THE SCHOOL ATLANTA        ,GA,30318-5241,Proprietary  ,122,238,360,238,464,702
04147700,LAKE LANIER SCHOOL OF MASSAGE           ,GA,30501-4546,Proprietary  ,13,66,79,17,106,123
04149900,PROFILE INSTITUTE OF BARBER-STYLING     ,GA,30315-8459,Proprietary  ,18,73,91,31,143,174
04150900,PROCESS INSTITUTE OF COSMETOLOGY (THE)  ,GA,30043-7344,Proprietary  ,51,63,114,80,127,207
04152300,GEORGIA BEAUTY ACADEMY                  ,GA,30721-3952,Proprietary  ,32,65,97,55,115,170
04156500,GEORGIA CHRISTIAN UNIVERSITY            ,GA,30047-3778,Private      ,19,57,76,37,96,133
04160200,ATLANTA BEAUTY ACADEMY                  ,GA,30340-1334,Proprietary  ,31,135,166,67,228,295
04203800,WOODRUFF MEDICAL TRAINING AND TESTING   ,GA,30033-6103,Proprietary  ,13,78,91,26,139,165
04204500,ELAINE STERLING INSTITUTE(THE)          ,GA,30342-2633,Proprietary  ,8,59,67,20,98,118
04206400,HELMS COLLEGE                           ,GA,31206-5309,Private      ,51,100,151,80,185,265
04206600,SAE INSTITUTE OF TECHNOLOGY - ATLANTA   ,GA,30303-1736,Proprietary  ,127,251,378,218,477,695
04208000,TECHNOLOGY CENTER                       ,GA,30071-3519,Proprietary  ,4,71,75,11,116,127
04218000,UNITED MEDICAL AND BUSINESS INSTITUTE   ,GA,30344-6977,Proprietary  ,13,84,97,22,130,152
04221100,NEW HORIZONS MEDICAL INSTITUTE          ,GA,30071-2965,Proprietary  ,32,155,187,59,326,385
00149911,EVEREST COLLEGE - MERRIONETTE PARK      ,IL,60803-4517,Proprietary  ,44,205,249,108,398,506
00162800,AMERICAN ACADEMY OF ART                 ,IL,60604-4302,Proprietary  ,131,69,200,876,307,1183
00163300,AUGUSTANA COLLEGE                       ,IL,61201-2296,Private      ,111,41,152,4786,250,5036
00163400,AURORA UNIVERSITY                       ,IL,60506-4892,Private      ,411,861,1272,4094,2972,7066
00163600,SOUTHWESTERN ILLINOIS COLLEGE           ,IL,62221-5899,Public       ,1242,1882,3124,3656,4640,8296
00163800,BLACK HAWK COLLEGE                      ,IL,61265-5899,Public       ,677,817,1494,2328,2090,4418
00163900,BLACKBURN COLLEGE                       ,IL,62626-1498,Private      ,76,22,98,852,163,1015
00164000,PRAIRIE STATE COLLEGE                   ,IL,60411-8226,Public       ,644,1288,1932,2756,3934,6690
00164100,BRADLEY UNIVERSITY                      ,IL,61625-0002,Private      ,507,258,765,8034,1084,9118
00164300,SPOON RIVER COLLEGE                     ,IL,61520-8907,Public       ,132,214,346,712,725,1437
00164700,CITY COLLEGES OF CHICAGO                ,IL,60606-6998,Public       ,580,1422,2002,3241,4663,7904
00164800,TRUMAN COLLEGE                          ,IL,60640-5691,Public       ,564,1471,2035,2948,4789,7737
00164900,RICHARD J DALEY COLLEGE                 ,IL,60652-1299,Public       ,648,1268,1916,3573,4063,7636
00165000,CITY COLLEGES OF CHICAGO-MALCOLM X      ,IL,60612-3197,Public       ,835,2203,3038,4221,7211,11432
00165200,HAROLD WASHINGTON COLLEGE               ,IL,60601-2403,Public       ,1552,2445,3997,8214,7856,16070
00165400,KENNEDY KING COLLEGE                    ,IL,60621-3798,Public       ,504,1923,2427,2568,6132,8700
00165500,WRIGHT COLLEGE                          ,IL,60634-1591,Public       ,1045,1837,2882,5624,5509,11133
00165700,MIDWESTERN UNIVERSITY                   ,IL,60515-1200,Private      ,25,1119,1144,138,3569,3707
00165900,ROSALIND FRANKLIN UNIVERSITY OF MEDICINE,IL,60064-3095,Private      ,13,882,895,88,2691,2779
00166100,CHICAGO THEOLOGICAL SEMINARY            ,IL,60637-0000,Private      ,2,64,66,24,227,251
00166300,SPERTUS COLLEGE                         ,IL,60605-1995,Private      ,0,14,14,4,50,54
00166400,UNIVERSITY OF ST FRANCIS                ,IL,60435-6188,Private      ,209,582,791,2007,1804,3811
00166500,COLUMBIA COLLEGE                        ,IL,60605-1996,Private      ,1778,1145,2923,13647,4594,18241
00166600,CONCORDIA UNIVERSITY                    ,IL,60305-1499,Private      ,235,1245,1480,2817,2927,5744
00166900,DANVILLE AREA COMMUNITY COLLEGE         ,IL,61832-5199,Public       ,187,436,623,802,1023,1825
00167100,DEPAUL UNIVERSITY                       ,IL,60604-2287,Private      ,1449,2600,4049,23355,13722,37077
00167400,EASTERN ILLINOIS UNIVERSITY             ,IL,61920-3099,Public       ,1055,701,1756,10706,3265,13971
00167500,ELGIN COMMUNITY COLLEGE                 ,IL,60123-7193,Public       ,1125,1376,2501,3789,3274,7063
00167600,ELMHURST COLLEGE                        ,IL,60126-3296,Private      ,398,405,803,4159,1355,5514
00167800,EUREKA COLLEGE                          ,IL,61530-9976,Private      ,90,31,121,1056,191,1247
00168100,HIGHLAND COMMUNITY COLLEGE              ,IL,61032-9341,Public       ,270,327,597,811,749,1560
00168200,GARRETT-EVANGELICAL THEOLOGICAL SEM     ,IL,60201-0000,Private      ,1,68,69,2,179,181
00168400,GREENVILLE COLLEGE                      ,IL,62246-1199,Private      ,129,146,275,1660,462,2122
00168500,HEBREW THEOLOGICAL COLLEGE              ,IL,60077-3263,Private      ,145,6,151,436,24,460
00168800,ILLINOIS COLLEGE                        ,IL,62650-2299,Private      ,72,35,107,1939,210,2149
00168900,ILLINOIS COLLEGE OF OPTOMETRY           ,IL,60616-3878,Private      ,8,138,146,38,671,709
00169100,ILLINOIS INSTITUTE OF TECHNOLOGY        ,IL,60616-0000,Private      ,260,565,825,3624,2235,5859
00169103,CHICAGO KENT COLLEGE OF LAW             ,IL,60661-0000,Private      ,14,328,342,71,1372,1443
00169200,ILLINOIS STATE UNIVERSITY               ,IL,61790-1000,Public       ,2240,974,3214,23504,4579,28083
00169300,NORTHEASTERN ILLINOIS UNIV              ,IL,60625-4699,Public       ,912,1916,2828,7391,7201,14592
00169400,CHICAGO STATE UNIVERSITY                ,IL,60628-1598,Public       ,772,2592,3364,5918,9939,15857
00169600,ILLINOIS WESLEYAN UNIVERSITY            ,IL,61701-0000,Private      ,149,44,193,3345,207,3552
00169800,JOHN MARSHALL LAW SCHOOL                ,IL,60604-0000,Private      ,8,463,471,80,1874,1954
00169900,JOLIET JUNIOR COLLEGE                   ,IL,60431-8938,Public       ,1812,2041,3853,6751,5215,11966
00170000,JUDSON UNIVERSITY                       ,IL,60123-1498,Private      ,118,186,304,1121,706,1827
00170100,KASKASKIA COLLEGE                       ,IL,62801-7878,Public       ,330,630,960,1273,1369,2642
00170300,KENDALL COLLEGE                         ,IL,60622-4278,Proprietary  ,188,444,632,937,1489,2426
00170400,KNOX COLLEGE                            ,IL,61401-4999,Private      ,92,24,116,2690,157,2847
00170500,ILLINOIS VALLEY COMMUNITY COLLEGE       ,IL,61348-9692,Public       ,312,385,697,1388,1230,2618
00170600,LAKE FOREST COLLEGE                     ,IL,60045-2399,Private      ,206,48,254,2497,228,2725
00170700,LEWIS UNIVERSITY                        ,IL,60446-2200,Private      ,627,926,1553,5913,2951,8864
00170800,LINCOLN CHRISTIAN UNIVERSITY            ,IL,62656-2167,Private      ,53,140,193,399,515,914
00170900,LINCOLN COLLEGE                         ,IL,62656-1699,Private      ,125,103,228,1261,584,1845
00171000,LOYOLA UNIVERSITY CHICAGO               ,IL,60626-0000,Private      ,1200,2145,3345,19065,10176,29241
00171200,LUTHERAN SCHOOL OF THEOL AT CHICAGO     ,IL,60615-0000,Private      ,0,31,31,1,84,85
00171600,MACCORMAC COLLEGE                       ,IL,60602-4405,Private      ,9,41,50,61,208,269
00171700,MACMURRAY COLLEGE                       ,IL,62650-2590,Private      ,76,48,124,865,259,1124
00172100,MCCORMICK THEOLOGICAL SEMINARY          ,IL,60615-5108,Private      ,0,42,42,5,99,104
00172200,MCKENDREE UNIVERSITY                    ,IL,62254-1299,Private      ,236,394,630,2080,1199,3279
00172300,MEADVILLE LOMBARD THEOLOGICAL SCHOOL    ,IL,60637-1602,Private      ,0,8,8,1,83,84
00172400,MILLIKIN UNIVERSITY                     ,IL,62522-2084,Private      ,233,192,425,3185,802,3987
00172500,MONMOUTH COLLEGE                        ,IL,61462-1963,Private      ,106,19,125,2463,170,2633
00172700,MOODY BIBLE INSTITUTE                   ,IL,60610-3214,Private      ,663,686,1349,1876,1459,3335
00172800,MORTON COLLEGE                          ,IL,60804-4398,Public       ,597,676,1273,2324,1719,4043
00173200,NATIONAL UNIV OF HEALTH SCIENCES        ,IL,60148-4583,Private      ,14,409,423,44,760,804
00173300,NATIONAL-LOUIS UNIVERSITY               ,IL,60603-3032,Private      ,65,1637,1702,478,4544,5022
00173400,NORTH CENTRAL COLLEGE                   ,IL,60540-4690,Private      ,297,221,518,4679,826,5505
00173500,NORTH PARK UNIVERSITY                   ,IL,60625-4895,Private      ,327,452,779,3206,1650,4856
00173600,NORTHERN BAPTIST THEOL SEMINARY         ,IL,60148-0000,Private      ,0,31,31,3,55,58
00173700,NORTHERN ILLINOIS UNIVERSITY            ,IL,60115-2854,Public       ,2581,2290,4871,23578,9185,32763
00173900,NORTHWESTERN UNIV                       ,IL,60208-0001,Private      ,1540,2378,3918,20467,8871,29338
00174100,OLIVET NAZARENE UNIVERSITY              ,IL,60914-2271,Private      ,312,837,1149,4223,2213,6436
00174200,IL EASTERN COMM COLGS-OLNEY CENTRAL     ,IL,62450-1099,Public       ,74,171,245,513,479,992
00174500,QUINCY UNIVERSITY                       ,IL,62301-2699,Private      ,158,122,280,1579,471,2050
00174600,ROBERT MORRIS UNIVERSITY ILLINOIS       ,IL,60605-1225,Private      ,599,1031,1630,5304,4442,9746
00174700,ROCK VALLEY COLLEGE                     ,IL,61114-5699,Public       ,997,1351,2348,3361,3632,6993
00174800,ROCKFORD UNIVERSITY                     ,IL,61108-2393,Private      ,182,255,437,1523,1052,2575
00174900,ROOSEVELT UNIVERSITY                    ,IL,60605-1394,Private      ,618,1546,2164,6571,6280,12851
00175000,DOMINICAN UNIVERSITY                    ,IL,60305-1066,Private      ,232,524,756,3785,1605,5390
00175200,SAUK VALLEY COMMUNITY COLLEGE           ,IL,61021-9112,Public       ,256,321,577,914,842,1756
00175300,SCHOOL OF ART INSTITUTE OF CHICAGO      ,IL,60603-3013,Private      ,496,376,872,4268,2165,6433
00175600,SHIMER COLLEGE                          ,IL,60616-3893,Private      ,11,8,19,81,47,128
00175700,SOUTHEASTERN ILLINOIS COLLEGE           ,IL,62946-4925,Public       ,127,165,292,612,560,1172
00175800,SOUTHERN ILL UNIV-CARBONDALE            ,IL,62901-0000,Public       ,1769,2009,3778,17795,7246,25041
00175900,SOUTHERN ILL UNIV-EDWARDSVILLE          ,IL,62026-1060,Public       ,2032,1554,3586,13837,5273,19110
00175924,SO IL UNIV-SCHL OF DENTAL MEDICINE      ,IL,62002-0000,Public       ,2,46,48,9,152,161
00176500,UNIVERSITY OF ST MARY OF THE LAKE       ,IL,60060-0000,Private      ,1,6,7,6,14,20
00176700,BENEDICTINE UNIVERSITY                  ,IL,60532-0900,Private      ,364,1090,1454,3933,3323,7256
00176800,ST XAVIER UNIVERSITY                    ,IL,60655-3199,Private      ,387,664,1051,6938,2881,9819
00176900,SOUTH SUBURBAN COLLEGE                  ,IL,60473-9978,Public       ,565,1297,1862,2513,4126,6639
00177100,TRINITY CHRISTIAN COLLEGE               ,IL,60463-0929,Private      ,91,212,303,1317,800,2117
00177200,TRINITY INTERNATIONAL UNIVERSITY        ,IL,60015-1283,Private      ,118,266,384,861,825,1686
00177300,TRITON COLLEGE                          ,IL,60171-1995,Public       ,795,1237,2032,3868,3759,7627
00177400,UNIVERSITY OF CHICAGO                   ,IL,60637-1476,Private      ,1444,751,2195,18471,3732,22203
00177401,UNIV OF CHICAGO PRITZKER SCH OF MED     ,IL,60637-0000,Private      ,10,132,142,73,574,647
00177403,"UNIV OF CHICAGO, BOOTH SCH OF BUS       ",IL,60637-0000,Private      ,20,473,493,145,966,1111
00177405,UNIVERSITY OF CHICAGO GRADUATE          ,IL,60637-0000,Private      ,22,806,828,144,4106,4250
00177500,UNIV OF ILLINOIS @ URBANA-CHAMPAIGN     ,IL,61820-5796,Public       ,2071,1433,3504,33070,7933,41003
00177600,UNIV OF ILLINOIS AT CHICAGO             ,IL,60607-0000,Public       ,2474,3709,6183,27419,17021,44440
00177800,VANDERCOOK COLLEGE OF MUSIC             ,IL,60616-3731,Private      ,18,26,44,173,95,268
00177900,IL EASTERN COMM COLGS-WABASH VALLEY     ,IL,62863-2699,Public       ,117,99,216,464,265,729
00178000,WESTERN ILLINOIS UNIVERSITY             ,IL,61455-1390,Public       ,1247,959,2206,12977,4253,17230
00178100,WHEATON COLLEGE                         ,IL,60187-5535,Private      ,436,196,632,2982,500,3482
00178300,WORSHAM COLLEGE OF MORTUARY SCIENCE     ,IL,60090-2646,Proprietary  ,16,46,62,56,130,186
00396100,HARPER COLLEGE                          ,IL,60067-7398,Public       ,1299,1481,2780,4973,3391,8364
00456000,GEM CITY COLLEGE                        ,IL,62301-4949,Proprietary  ,7,20,27,14,41,55
00456800,MIDSTATE COLLEGE                        ,IL,61614-3558,Proprietary  ,25,175,200,85,711,796
00621400,BLESSING RIEMAN COLLEGE OF NURSING      ,IL,62301-0000,Private      ,18,40,58,158,184,342
00621401,BLESSING HOSPITAL - SCHOOL OF MEDICAL LA,IL,62305-7005,Private      ,2,9,11,12,27,39
00621402,BLESSING HOSPITAL - SCHOOL OF RADIOLOGIC,IL,62305-7005,Private      ,2,14,16,41,36,77
00622500,TRINITY COLLEGE OF NURSING AND HEALTH SC,IL,61201-5317,Private      ,35,62,97,150,236,386
00622800,METHODIST MED CTR OF ILL SCH NRSNG      ,IL,61636-0000,Private      ,57,121,178,319,601,920
00624000,ST FRANCIS MED CLG OF NRSG              ,IL,61603-3783,Private      ,60,144,204,375,545,920
00638500,CHAMBERLAIN COLLEGE OF NURSING          ,IL,60101-0000,Proprietary  ,725,8905,9630,2304,18953,21257
00665600,COLLEGE OF DUPAGE                       ,IL,60137-6599,Public       ,2643,2868,5511,10121,7476,17597
00675300,ILLINOIS CENTRAL COLLEGE                ,IL,61635-0001,Public       ,909,1429,2338,3866,3657,7523
00693100,WAUBONSEE COMMUNITY COLLEGE             ,IL,60554-0000,Public       ,843,1066,1909,3080,2827,5907
00711800,PARKLAND COLLEGE                        ,IL,61821-1899,Public       ,922,1008,1930,4262,2879,7141
00711900,REND LAKE COLLEGE                       ,IL,62846-9801,Public       ,291,385,676,1063,897,1960
00717000,LINCOLN LAND COMMUNITY COLLEGE          ,IL,62794-9256,Public       ,698,1202,1900,2665,2988,5653
00726500,CARL SANDBURG COLLEGE                   ,IL,61401-9576,Public       ,162,318,480,1030,1127,2157
00730307,LINCOLN COLLEGE OF TECHNOLOGY - MELROSE ,IL,60160-1605,Proprietary  ,251,245,496,505,425,930
00750103,VATTEROTT COLLEGE - FAIRVIEW HEIGHTS    ,IL,62208-2029,Proprietary  ,78,352,430,110,458,568
00754900,COYNE AMERICAN INSTITUTE                ,IL,60607-1300,Proprietary  ,135,474,609,337,820,1157
00764400,LAKE LAND COLLEGE                       ,IL,61938-9366,Public       ,394,592,986,2031,1623,3654
00768400,KISHWAUKEE COLLEGE                      ,IL,60150-9699,Public       ,463,568,1031,2090,1754,3844
00769000,KANKAKEE COMMUNITY COLLEGE              ,IL,60901-6505,Public       ,374,735,1109,1332,1746,3078
00769100,MCHENRY COUNTY COLLEGE                  ,IL,60012-2761,Public       ,622,670,1292,2004,1716,3720
00769200,MORAINE VALLEY COMMUNITY COLLEGE        ,IL,60465-0937,Public       ,1238,1390,2628,6694,4735,11429
00769300,SHAWNEE COMMUNITY COLLEGE               ,IL,62992-9725,Public       ,115,222,337,594,568,1162
00769400,COLLEGE OF LAKE COUNTY                  ,IL,60030-1198,Public       ,1075,1410,2485,3999,3451,7450
00793700,MS ROBERTS ACADEMY OF BEAUTY CULT       ,IL,60181-2930,Proprietary  ,3,12,15,11,27,38
00807600,JOHN A LOGAN COLLEGE                    ,IL,62918-2500,Public       ,449,765,1214,1748,1819,3567
00809003,EVEREST COLLEGE - BEDFORD PARK          ,IL,60629-5819,Proprietary  ,62,258,320,147,473,620
00825900,EDUCATORS OF BEAUTY                     ,IL,61081-3611,Proprietary  ,19,30,49,32,61,93
00825901,EDUCATORS OF BEAUTY                     ,IL,61104-0000,Proprietary  ,22,31,53,44,80,124
00832800,ALVAREITA'S COLLEGE OF COSMETOLOGY      ,IL,62025-2041,Proprietary  ,12,29,41,46,60,106
00869402,RASMUSSEN COLLEGE - ROCKFORD            ,IL,61108-2513,Proprietary  ,101,543,644,227,1155,1382
00869403,RASMUSSEN COLLEGE - AURORA              ,IL,60506-6219,Proprietary  ,46,227,273,139,486,625
00869404,RASMUSSEN COLLEGE - ROMEOVILLE          ,IL,60446-0000,Proprietary  ,85,388,473,164,758,922
00869418,RASMUSSEN COLLEGE -  MOKENA             ,IL,60448-0000,Proprietary  ,29,188,217,66,402,468
00888000,MORRISON INSTITUTE OF TECHNOLOGY        ,IL,61270-2959,Private      ,10,5,15,107,17,124
00893800,GRAHAM HOSPITAL SCH OF NURSING          ,IL,61520-2497,Private      ,9,16,25,41,93,134
00893900,CANNELLA SCHOOL OF HAIR DESIGN          ,IL,60406-2130,Proprietary  ,11,32,43,24,71,95
00914500,GOVERNORS STATE UNIVERSITY              ,IL,60466-0975,Public       ,401,1838,2239,1979,6164,8143
00923200,CATHOLIC THEOLOGICAL UNION              ,IL,60615-0000,Private      ,0,7,7,5,44,49
00933300,UNIV OF ILLINOIS AT SPRINGFIELD         ,IL,62703-5407,Public       ,326,846,1172,2813,2888,5701
00947500,EDUCATORS OF BEAUTY                     ,IL,61301-2404,Proprietary  ,9,10,19,15,23,38
00959500,CANNELLA SCHOOL OF HAIR DESIGN          ,IL,60617-4303,Proprietary  ,30,73,103,76,160,236
00976700,OLIVE-HARVEY COLLEGE                    ,IL,60628-1696,Public       ,355,1075,1430,1871,3825,5696
00978600,IL EASTERN COMM COLGS-LINCOLN TRAIL     ,IL,62454-5708,Public       ,65,106,171,358,291,649
00980000,RUSH UNIVERSITY                         ,IL,60612-3806,Private      ,59,689,748,413,3125,3538
00989600,OAKTON COMMUNITY COLLEGE                ,IL,60016-1268,Public       ,749,956,1705,3563,2628,6191
00998700,SAINT ANTHONY COLLEGE OF NURSING        ,IL,61108-2468,Private      ,46,126,172,195,398,593
01002000,LEWIS AND CLARK COMMUNITY COLLEGE       ,IL,62035-2466,Public       ,586,747,1333,1935,1848,3783
01050100,LAKEVIEW  COLLEGE OF NURSING            ,IL,61832-3781,Private      ,50,74,124,214,273,487
01069500,TRI-COUNTY BEAUTY ACADEMY               ,IL,62056-2036,Proprietary  ,5,5,10,9,14,23
01071000,CAPITAL AREA SCH OF PRAC NRSG           ,IL,62707-0000,Public       ,29,146,175,87,385,472
01072700,DEVRY UNIVERSITY                        ,IL,60618-5994,Proprietary  ,3156,22962,26118,8837,56207,65044
01083600,PIVOT POINT INTNL CSMTLGY RSRCH CTR     ,IL,60626-0000,Proprietary  ,61,104,165,214,336,550
01087900,RICHLAND COMMUNITY COLLEGE              ,IL,62521-8513,Public       ,279,598,877,974,1565,2539
01091303,ROCKFORD CAREER COLLEGE                 ,IL,61108-3900,Proprietary  ,128,466,594,280,788,1068
01151002,EVEREST INSTITUTE - EVEREST COLLEGE     ,IL,60542-1610,Proprietary  ,18,53,71,86,172,258
01181000,TAYLOR BUSINESS INSTITUTE               ,IL,60606-5111,Proprietary  ,9,60,69,29,122,151
01185204,ITT TECHNICAL INSTITUTE - ORLAND PARK CA,IL,60467-4900,Proprietary  ,0,1,1,0,1,1
01185800,EVEREST COLLEGE                         ,IL,60077-1074,Proprietary  ,50,123,173,106,245,351
01185802,EVEREST COLLEGE - BURR RIDGE            ,IL,60527-7826,Proprietary  ,60,117,177,95,224,319
01185803,EVEREST COLLEGE - MELROSE PARK          ,IL,60160-1526,Proprietary  ,91,275,366,151,472,623
01236200,NORTHWESTERN COLLEGE                    ,IL,60630-2298,Proprietary  ,192,607,799,1617,2879,4496
01238500,BLOOMINGTON-NORMAL SCH RADIOGRAPHY      ,IL,61761-4604,Private      ,6,17,23,29,55,84
01258400,ILLINOIS INSTITUTE OF ART (THE)         ,IL,60654-1593,Proprietary  ,928,868,1796,4285,2938,7223
01281300,JOHN WOOD COMMUNITY COLLEGE             ,IL,62305-0401,Public       ,153,305,458,960,923,1883
01308700,CAPRI BEAUTY COLLEGE                    ,IL,60629-1613,Proprietary  ,22,69,91,58,147,205
01308800,CAPRI OAK FOREST COLLEGE OF BEAUTY      ,IL,60452-2798,Proprietary  ,32,40,72,66,101,167
02055200,HARRINGTON COLLEGE OF DESIGN            ,IL,60606-3433,Proprietary  ,54,144,198,241,397,638
02068100,ADLER SCH OF PROFESSIONAL PSYCHLGY      ,IL,60601-0000,Private      ,24,474,498,116,1391,1507
02069300,VATTEROTT COLLEGE                       ,IL,62305-5938,Proprietary  ,32,116,148,82,193,275
02073200,TELSHE YESHIVA-CHICAGO                  ,IL,60625-0000,Private      ,4,2,6,32,6,38
02074400,IL EASTERN COMM COLGS-FRONTIER          ,IL,62837-0000,Public       ,34,84,118,143,210,353
02075400,KELLER GRADUATE SCHOOL OF MGMT.         ,IL,60515-5683,Proprietary  ,13,4457,4470,52,10054,10106
02113600,AMERICAN INTERCONTINENTAL UNIVERSITY    ,IL,60192-3713,Proprietary  ,436,8365,8801,815,15350,16165
02117400,BECK AREA CAREER CENTER                 ,IL,62278-0000,Public       ,15,68,83,33,136,169
02124400,UNIVERSITY OF SPA & COSMETOLOGY ART     ,IL,62704-0000,Proprietary  ,31,79,110,74,149,223
02150600,COSMETOLOGY AND SPA INSTITUTE (THE)     ,IL,60014-4003,Proprietary  ,43,47,90,69,102,171
02155300,THE CHICAGO SCHOOL OF PROF PSYCHOLOGY   ,IL,60610-4705,Private      ,14,1862,1876,78,4262,4340
02160300,INTERNATIONAL ACAD OF DESIGN & TECH     ,IL,60602-3319,Proprietary  ,69,107,176,242,370,612
02160304,INTERNATIONAL ACADEMY OF DESIGN AND TECH,IL,60173-5160,Proprietary  ,1,3,4,63,94,157
02168600,EAST WEST UNIVERSITY                    ,IL,60605-0000,Private      ,75,233,308,725,1065,1790
02179900,ARGOSY UNIVERSITY                       ,IL,60601-7757,Proprietary  ,1740,10082,11822,4675,18970,23645
02185400,ST AUGUSTINE COLLEGE                    ,IL,60640-0000,Private      ,54,208,262,609,1781,2390
02192400,MR JOHNS SCHOOL OF COSMETOLOGY          ,IL,62521-0000,Proprietary  ,5,34,39,17,53,70
02202600,CANNELLA SCHOOL OF HAIR DESIGN          ,IL,60181-1321,Proprietary  ,4,24,28,7,53,60
02214100,RESURRECTION UNIVERSITY                 ,IL,60302-2519,Private      ,29,174,203,255,704,959
02228100,MAC DANIEL'S BEAUTY SCHOOL              ,IL,60640-0000,Proprietary  ,11,23,34,33,60,93
02261200,HAIR PROFESSIONALS ACAD COSMETOLOGY     ,IL,60118-0000,Proprietary  ,18,79,97,26,107,133
02261201,HAIR PROFESSIONALS ACADEMY OF COSMETOLOG,IL,60118-9333,Proprietary  ,3,7,10,8,18,26
02262100,HAIR PROFESSIONALS SCH COSMETOLOGY      ,IL,60543-0000,Proprietary  ,11,28,39,19,37,56
02291200,CANNELLA SCHOOL OF HAIR DESIGN          ,IL,60639-0000,Proprietary  ,28,65,93,82,156,238
02295500,CANNELLA SCHOOL OF HAIR DESIGN          ,IL,60120-0000,Proprietary  ,5,35,40,15,45,60
02297500,OEHRLEIN SCHOOL OF COSMETOLOGY          ,IL,61611-0000,Proprietary  ,24,38,62,41,72,113
02312300,LA' JAMES COLLEGE HAIRSTYLING           ,IL,61244-0000,Proprietary  ,1,7,8,6,27,33
02313900,WESTWOOD COLLEGE - O'HARE AIRPORT       ,IL,60631-2801,Proprietary  ,69,242,311,181,524,705
02317300,CONCEPT COLLEGE OF COSMETOLOGY          ,IL,61832-0000,Proprietary  ,10,47,57,25,85,110
02319200,LAKE FOREST GRAD SCHL OF MGMT           ,IL,60045-4824,Private      ,1,63,64,8,133,141
02323300,PROFESSIONAL'S CHOICE HAIR DSN ACAD     ,IL,60435-0000,Proprietary  ,12,22,34,28,57,85
02332200,HAIR PROFESSIONALS CAREER COLLEGE       ,IL,60178-0000,Proprietary  ,7,29,36,15,35,50
02349400,ALVAREITA'S COLLEGE OF COSMETOLOGY      ,IL,62035-0000,Proprietary  ,8,19,27,35,58,93
02349500,CANNELLA SCHOOL OF HAIR DESIGN          ,IL,60632-0000,Proprietary  ,25,80,105,89,176,265
02352200,LE CORDON BLEU COLLEGE OF CULINARY ARTS ,IL,60610-3050,Proprietary  ,185,517,702,783,1223,2006
02498200,G SKIN & BEAUTY INSTITUTE               ,IL,60523-1805,Proprietary  ,27,111,138,52,176,228
02498201,HAIR PROFESSIONALS ACADEMY OF COSMETOLOG,IL,60563-0000,Proprietary  ,4,5,9,22,21,43
02522800,FOX COLLEGE                             ,IL,60638-1999,Proprietary  ,80,112,192,354,400,754
02522801,FOX COLLEGE -  VET TECH INSTITUTE       ,IL,60477-4451,Proprietary  ,0,0,0,38,32,70
02527600,LEXINGTON COLLEGE                       ,IL,60607-0000,Private      ,7,12,19,97,59,156
02536700,BELL MAR BEAUTY COLLEGE                 ,IL,60650-0000,Proprietary  ,14,22,36,29,46,75
02556100,ENVIRONMENTAL TECHNICAL INSTITUTE       ,IL,60143-0000,Proprietary  ,31,95,126,58,149,207
02556600,NILES SCHOOL OF COSMETOLOGY             ,IL,60714-0000,Proprietary  ,0,17,17,7,28,35
02573700,INSTITUTE FOR CLINICAL SOCIAL WORK      ,IL,60605-1229,Private      ,3,74,77,29,203,232
02584900,"FIRST INSTITUTE, INC.                   ",IL,60014-7489,Proprietary  ,37,118,155,60,196,256
02587700,HAIR PROFESSIONALS CAREER COLLEGE       ,IL,60465-1929,Proprietary  ,12,19,31,32,46,78
02622700,KNOWLEDGE SYSTEMS INSTITUTE             ,IL,60076-0000,Private      ,0,2,2,1,4,5
03002000,HAIRMASTERS INST OF COSMETOLOGY         ,IL,61701-5547,Proprietary  ,11,29,40,26,51,77
03027702,PACIFIC COLLEGE OF ORIENTAL MEDICINE - C,IL,60613-4418,Proprietary  ,6,97,103,27,233,260
03065300,TREND SETTERS COLL OF COSMETOLOGY       ,IL,60915-0000,Proprietary  ,48,87,135,79,119,198
03072701,WESTWOOD COLLEGE - RIVER OAKS           ,IL,60409-5503,Proprietary  ,33,179,212,82,364,446
03072702,WESTWOOD COLLEGE OF TECHNOLOGY          ,IL,60602-0000,Proprietary  ,85,352,437,239,775,1014
03078400,CAMEO BEAUTY ACADEMY                    ,IL,60453-3196,Proprietary  ,15,22,37,33,53,86
03079200,WESTWOOD COLLEGE - DUPAGE               ,IL,60517-2321,Proprietary  ,47,110,157,155,358,513
03082900,ROSEL SCHOOL OF COSMETOLOGY             ,IL,60659-1913,Proprietary  ,11,19,30,31,47,78
03083800,HEARTLAND COMMUNITY COLLEGE             ,IL,61761-9446,Public       ,475,574,1049,2176,1624,3800
03098000,ST JOHN'S COLLEGE OF NURSING            ,IL,62702-5321,Private      ,22,61,83,148,223,371
03098002,ST JOHN'S HOSP SCH MED TECH             ,IL,62769-5324,Private      ,5,19,24,30,56,86
03099700,CAIN'S BARBER COLLEGE                   ,IL,60615-3510,Proprietary  ,24,112,136,101,287,388
03099800,ILLINOIS SCHOOL OF HEALTH CAREERS       ,IL,60604-0000,Proprietary  ,42,195,237,229,629,858
03101800,ILLINOIS CENTER FOR BROADCASTING        ,IL,60148-7015,Proprietary  ,35,112,147,79,190,269
03128500,NATIONAL LATINO EDUCATION INSTITUTE     ,IL,60609-2205,Private      ,11,27,38,52,92,144
03199300,CHRISTIAN LIFE COLLEGE                  ,IL,60056-2522,Private      ,3,6,9,12,14,26
03368300,MIDWEST TECHNICAL INSTITUTE             ,IL,62707-8805,Proprietary  ,344,998,1342,667,1777,2444
03416300,COMPUTER SYSTEMS INSTITUTE              ,IL,60077-0000,Proprietary  ,121,430,551,223,680,903
03448300,BUSINESS INDUSTRIAL RESOURCES           ,IL,60659-1298,Proprietary  ,145,1618,1763,270,2255,2525
03455700,CORTIVA INSTITUTE - CHICAGO             ,IL,60602-3315,Proprietary  ,60,150,210,109,251,360
03455701,CORTIVA INSTITUTE - CHICAGO             ,IL,60014-6285,Proprietary  ,8,14,22,15,26,41
03490301,PAUL MITCHELL THE SCHOOL CHICAGO        ,IL,60607-0000,Proprietary  ,133,178,311,447,474,921
03490302,PAUL MITCHELL THE SCHOOL ESCANABA - PAUL,IL,60148-0000,Proprietary  ,24,37,61,32,57,89
03510300,ERIKSON INSTITUTE                       ,IL,60654-4510,Private      ,2,69,71,8,285,293
03643300,"MR. JOHN'S SCHOOL OF JACKSONVILLE,  INC,",IL,62650-3488,Proprietary  ,5,14,19,11,19,30
03655300,ILLINOIS CAREERPATH INSTITUTE           ,IL,60654-1103,Private      ,3,9,12,9,37,46
03684300,NORTHSHORE UNIVERSITY HEALTHSYSTEM SCHOO,IL,60201-9872,Private      ,3,14,17,9,56,65
03881400,EUROPEAN MASSAGE THERAPY SCHOOL         ,IL,60077-2269,Proprietary  ,14,52,66,22,74,96
03891300,SOMA INSTITUTE - THE NATIONAL SCHOOL OF ,IL,60604-4466,Proprietary  ,11,44,55,30,74,104
03914300,"CALC, INSTITUTE OF TECHNOLOGY           ",IL,62002-5931,Proprietary  ,9,82,91,23,125,148
04117500,SOLEX MEDICAL ACADEMY                   ,IL,60090-3104,Proprietary  ,1,8,9,2,16,18
04117600,LARRY'S BARBER COLLEGE                  ,IL,60628-2322,Proprietary  ,35,121,156,121,329,450
04118400,ZAREM /GOLDE ORT TECHNICAL INSTITUTE    ,IL,60077-3210,Private      ,7,68,75,12,110,122
04124700,AMBRIA COLLEGE OF NURSING               ,IL,60192-3712,Proprietary  ,28,284,312,86,613,699
04136900,UNIVERSITY OF AESTHETICS (THE)          ,IL,60622-2151,Proprietary  ,6,20,26,18,50,68
04137000,UNIVERSITY OF AESTHETICS & COSMETOLOGY (,IL,60515-4607,Proprietary  ,8,11,19,18,22,40
04137500,TRICOCI UNIVERSITY OF BEAUTY CULTURE    ,IL,60656-1805,Proprietary  ,59,110,169,195,251,446
04139000,MIDWESTERN CAREER COLLEGE               ,IL,60606-3103,Proprietary  ,20,176,196,70,397,467
04141000,AVEDA INSTITUTE CHICAGO                 ,IL,60647-0000,Proprietary  ,65,114,179,208,310,518
04147100,TRICOCI UNIVERSITY OF BEAUTY CULTURE    ,IL,60048-2906,Proprietary  ,31,22,53,55,60,115
04147200,TRICOCI UNIVERSITY OF BEAUTY CULTURE    ,IL,60455-1824,Proprietary  ,29,55,84,73,115,188
04147300,TRICOCI UNIVERSITY OF BEAUTY CULTURE    ,IL,60139-3119,Proprietary  ,30,56,86,61,97,158
04147400,TRICOCI UNIVERSITY OF BEAUTY CULTURE    ,IL,61614-4831,Proprietary  ,21,47,68,56,111,167
04147500,TRICOCI UNIVERSITY OF BEAUTY CULTURE    ,IL,61108-2337,Proprietary  ,25,52,77,79,126,205
04160600,PAUL MITCHELL THE SCHOOL NORMAL         ,IL,61761-0000,Proprietary  ,19,26,45,79,61,140
04167800,INNOVATIONS DESIGN ACADEMY              ,IL,61520-2625,Proprietary  ,6,25,31,15,44,59
04168500,SOLEX COLLEGE                           ,IL,60090-3192,Proprietary  ,8,131,139,12,151,163
04170800,UNITY COSMETOLOGY COLLEGE               ,IL,61764-9652,Proprietary  ,9,13,22,19,33,52
04171600,SALON PROFESSIONAL ACADEMY OF ELGIN (THE,IL,60123-2319,Proprietary  ,9,21,30,21,49,70
04174900,SKIN CARE AND SPA INSTITUTE             ,IL,60077-2200,Proprietary  ,3,34,37,8,47,55
04175000,UNIVERSAL SPA TRAINING ACADEMY          ,IL,60515-0000,Proprietary  ,6,50,56,18,82,100
04175800,J RENEE CAREER FACILITATION             ,IL,60014-7986,Proprietary  ,6,30,36,9,74,83
04179100,PCCTI  IT & HEALTHCARE                  ,IL,60523-0000,Proprietary  ,6,114,120,16,260,276
04179101,PCCTI  IT & HEALTHCARE -                ,IL,60606-0000,Proprietary  ,6,55,61,18,190,208
04186000,CHICAGO SCHOOL FOR PIANO TECHNOLOGY (THE,IL,60612-1630,Private      ,7,7,14,27,26,53
04187400,COSMETOLOGY CONCEPTS                    ,IL,60452-2501,Proprietary  ,32,86,118,70,156,226
04189200,SALON PROFESSIONAL ACADEMY (THE)        ,IL,60404-8789,Proprietary  ,7,18,25,17,40,57
04189400,SHEAR LEARNING ACADEMY OF COSMETOLOGY   ,IL,62523-1208,Proprietary  ,4,10,14,14,26,40
04189600,STATE CAREER SCHOOL                     ,IL,60085-5129,Proprietary  ,14,39,53,29,92,121
04192000,CURVE METRIC SCHOOL OF HAIR DESIGN      ,IL,60707-1118,Proprietary  ,3,15,18,4,18,22
04195600,TRIBECA FLASHPOINT MEDIA ARTS ACADEMY   ,IL,60602-2716,Proprietary  ,103,75,178,413,208,621
04224400,NETWORKS BARBER COLLEGE                 ,IL,60409-3401,Proprietary  ,3,14,17,6,29,35
04224500,TRENZ BEAUTY ACADEMY                    ,IL,60409-0000,Proprietary  ,6,26,32,15,57,72
04225300,CREATIVE TOUCH COSMETOLOGY SCHOOL       ,IL,62298-1609,Proprietary  ,1,5,6,5,16,21
04227900,MORTHLAND COLLEGE                       ,IL,62896-2742,Private      ,25,16,41,55,28,83
04229900,DEBUTANTES SCHOOL OF COSMETOLOGY AND NAI,IL,60115-3301,Proprietary  ,7,23,30,25,46,71
00195100,ALICE LLOYD COLLEGE                     ,KY,41844-9703,Private      ,78,25,103,1195,204,1399
00195200,ASBURY COLLEGE                          ,KY,40390-1198,Private      ,200,188,388,1721,596,2317
00195300,ASBURY THEOLOGICAL SEMINARY             ,KY,40390-0000,Private      ,3,272,275,22,1143,1165
00195400,BELLARMINE UNIVERSITY                   ,KY,40205-1877,Private      ,285,480,765,5279,1676,6955
00195500,BEREA COLLEGE                           ,KY,40403-0000,Private      ,197,151,348,3007,791,3798
00195800,BRESCIA UNIVERSITY                      ,KY,42301-3023,Private      ,114,277,391,1077,907,1984
00195900,CAMPBELLSVILLE UNIVERSITY               ,KY,42718-2799,Private      ,207,357,564,2686,1385,4071
00196000,SPALDING UNIVERSITY                     ,KY,40203-2188,Private      ,174,649,823,1393,2454,3847
00196100,CENTRE COLLEGE                          ,KY,40422-1394,Private      ,88,25,113,2519,125,2644
00196200,UNIVERSITY OF THE CUMBERLANDS           ,KY,40769-1372,Private      ,190,1253,1443,2655,2751,5406
00196300,EASTERN KENTUCKY UNIVERSITY             ,KY,40475-3102,Public       ,1589,2583,4172,13279,8440,21719
00196400,GEORGETOWN COLLEGE                      ,KY,40324-1628,Private      ,139,165,304,2300,534,2834
00196500,KENTUCKY CHRISTIAN UNIVERSITY           ,KY,41143-2205,Private      ,148,73,221,958,255,1213
00196800,KENTUCKY STATE UNIVERSITY               ,KY,40601-2355,Public       ,463,461,924,2988,1613,4601
00196900,KENTUCKY WESLEYAN COLLEGE               ,KY,42301-6057,Private      ,119,92,211,1223,371,1594
00197100,LEXINGTON THEOLOGICAL SEMINARY          ,KY,40508-0000,Private      ,2,29,31,6,70,76
00197200,LINDSEY WILSON COLLEGE                  ,KY,42728-1223,Private      ,183,308,491,2949,1448,4397
00197400,LOUISVILLE PRESBYTERIAN THEOL SEM       ,KY,40205-0000,Private      ,1,104,105,17,170,187
00197500,MIDWAY COLLEGE                          ,KY,40347-1120,Private      ,53,276,329,561,1236,1797
00197600,MOREHEAD STATE UNIVERSITY               ,KY,40351-1689,Public       ,1109,1438,2547,8155,4124,12279
00197700,MURRAY STATE UNIVERSITY                 ,KY,42071-0009,Public       ,1147,1318,2465,7601,3665,11266
00197900,WEST KENTUCKY CMNTY & TECHNICAL COLG    ,KY,42002-7380,Public       ,411,1024,1435,1850,3132,4982
00198000,UNIVERSITY OF PIKEVILLE                 ,KY,41501-1194,Private      ,192,269,461,2420,1378,3798
00198300,ST. CATHARINE COLLEGE                   ,KY,40061-9499,Private      ,89,65,154,765,317,1082
00198700,TRANSYLVANIA UNIVERSITY                 ,KY,40508-1797,Private      ,121,78,199,1935,251,2186
00198800,UNION COLLEGE                           ,KY,40906-1499,Private      ,154,208,362,1348,597,1945
00198900,UNIVERSITY OF KENTUCKY                  ,KY,40506-0054,Public       ,2806,2444,5250,23451,8640,32091
00198901,UNIV OF KY-COLLEGE OF DENTISTRY         ,KY,40536-0000,Public       ,13,152,165,60,308,368
00198902,UNIV OF KY-COLLEGE OF MEDICINE          ,KY,40536-0000,Public       ,21,180,201,125,641,766
00199000,ASHLAND COMMUNITY AND TECHNICAL COLLEGE ,KY,41101-3683,Public       ,332,777,1109,1254,1963,3217
00199100,ELIZABETHTOWN COMMUNITY  AND TECHNICAL C,KY,42701-3081,Public       ,531,1291,1822,2311,3734,6045
00199300,HENDERSON COMMUNITY COLLEGE             ,KY,42420-4699,Public       ,128,376,504,545,1035,1580
00199400,HOPKINSVILLE COMMUNITY COLLEGE          ,KY,42241-2621,Public       ,336,1089,1425,932,2666,3598
00199600,BIG SANDY COMMUNITY AND TECHNICAL COLG  ,KY,41653-1815,Public       ,325,740,1065,1877,2367,4244
00199700,SOMERSET COMMUNITY COLLEGE              ,KY,42501-2973,Public       ,533,1774,2307,2683,5091,7774
00199800,SOUTHEAST KENTUCKY COMMUNITY AND TECHNIC,KY,40823-1099,Public       ,199,498,697,1018,1438,2456
00199900,UNIVERSITY OF LOUISVILLE                ,KY,40292-0000,Public       ,2018,3400,5418,16391,11414,27805
00200100,THOMAS MORE COLLEGE                     ,KY,41017-3495,Private      ,149,224,373,1461,598,2059
00200200,WESTERN KENTUCKY UNIVERSITY             ,KY,42101-3576,Public       ,2198,2398,4596,15353,7580,22933
00461800,SPENCERIAN COLLEGE                      ,KY,40216-2605,Proprietary  ,92,366,458,468,1039,1507
00461900,SULLIVAN UNIVERSITY                     ,KY,40205-3000,Proprietary  ,352,1351,1703,1718,4177,5895
00493402,DAYMAR COLLEGE - BOWLING GREEN          ,KY,42101-4063,Proprietary  ,34,136,170,83,284,367
00493403,DAYMAR COLLEGE - CLINTON                ,KY,42031-9998,Proprietary  ,1,4,5,1,11,12
00493406,DAYMAR COLLEGE - RUSSELLVILLE           ,KY,42276-1622,Proprietary  ,6,24,30,13,60,73
00524400,BLUEGRASS COMMUNITY & TECHNICAL COLLEGE ,KY,40506-0235,Public       ,1144,2589,3733,4828,7254,12082
00527100,BOWLING GREEN TECHNICAL COLLEGE         ,KY,42101-3601,Public       ,421,1008,1429,1732,2719,4451
00527300,GATEWAY COMMUNITY & TECHNOLOGY COLL     ,KY,41011-0000,Public       ,373,1143,1516,1278,2873,4151
00696000,MAYSVILLE CMNTY & TECHNCL COLG          ,KY,41056-8910,Public       ,266,722,988,1059,2123,3182
00696100,JEFFERSON COMMUNITY AND TECHNICAL COLLEG,KY,40202-2005,Public       ,1367,3513,4880,5997,10754,16751
00696200,HAZARD COMMUNITY COLLEGE                ,KY,41701-2402,Public       ,165,497,662,1274,1884,3158
00696203,KY TECH-KNOTT CO. TECHNOLOGY CTR        ,KY,41822-0000,Public       ,2,5,7,7,18,25
00696204,KY TECH-LESLIE COUNTY AREA TECH CTR     ,KY,41749-0000,Public       ,2,5,7,5,8,13
00696205,KY TECH-LEE COUNTY AREA TECH CTR        ,KY,41311-0000,Public       ,0,0,0,1,1,2
00696206,KY TECH-LETCHER CNTY AREA TECH CTR      ,KY,41858-0000,Public       ,7,16,23,26,39,65
00696207,KY TECH-BREATHITT COUNTY VOC ED CTR     ,KY,41339-0000,Public       ,5,18,23,19,38,57
00736205,MEDTECH COLLEGE - LEXINGTON             ,KY,40511-1200,Proprietary  ,35,307,342,99,528,627
00842500,DAYMAR COLLEGE                          ,KY,42001-0000,Proprietary  ,14,72,86,45,201,246
00901000,MADISONVILLE COMMUNITY COLLEGE          ,KY,42431-9199,Public       ,248,651,899,986,1684,2670
00927500,NORTHERN KENTUCKY UNIVERSITY            ,KY,41099-0001,Public       ,1752,2125,3877,9861,5876,15737
00931300,DAYMAR COLLEGE                          ,KY,42301-5830,Proprietary  ,33,288,321,84,812,896
00931302,DAYMAR COLLEGE - LOUISVILLE             ,KY,40219-1973,Proprietary  ,17,109,126,77,372,449
00931304,DAYMAR COLLEGE - ALBANY                 ,KY,42602-1235,Proprietary  ,2,5,7,5,13,18
00931305,DAYMAR COLLEGE - BELLEVUE               ,KY,41073-2416,Proprietary  ,5,15,20,14,44,58
00931308,DAYMAR COLLEGE -  SCOTTSVILLE           ,KY,42164-1505,Proprietary  ,1,17,18,5,47,52
00931309,DAYMAR COLLEGE - LOUISVILLE EAST        ,KY,40245-1629,Proprietary  ,2,67,69,36,189,225
00931310,DAYMAR COLLEGE -  MADISONVILLE          ,KY,42431-0000,Proprietary  ,5,41,46,16,91,107
01042400,SALON PROFESSIONAL ACADEMY THE          ,KY,40502-0000,Proprietary  ,44,122,166,98,250,348
01048901,NATIONAL COLLEGE - FLORENCE CAMPUS      ,KY,41042-1812,Proprietary  ,4,44,48,27,163,190
01048902,NATIONAL COLLEGE - PIKEVILLE CAMPUS     ,KY,41501-1518,Proprietary  ,18,117,135,144,400,544
01048903,NATIONAL COLLEGE - DANVILLE CAMPUS      ,KY,40422-1517,Proprietary  ,7,54,61,39,252,291
01048904,NATIONAL COLLEGE - RICHMOND CAMPUS      ,KY,40475-2309,Proprietary  ,10,72,82,40,269,309
01048906,NATIONAL COLLEGE - LOUISVILLE CAMPUS    ,KY,40216-4147,Proprietary  ,17,171,188,87,588,675
01048907,NATIONAL COLLEGE - LEXINGTON CAMPUS     ,KY,40509-2256,Proprietary  ,16,134,150,70,514,584
01172500,COLLINS SCHOOL OF COSMETOLOGY           ,KY,40965-2809,Proprietary  ,11,22,33,33,51,84
01208800,SULLIVAN COLLEGE OF TECHNOLOGY AND DESIG,KY,40218-4528,Proprietary  ,78,199,277,411,578,989
01212801,SOUTHWESTERN COLLEGE                    ,KY,41042-1466,Proprietary  ,2,5,7,13,37,50
01272300,KY TECH-WAYNE COUNTY AREA TECH CTR      ,KY,42633-1088,Public       ,1,3,4,2,9,11
02159100,"APPALACHIAN BEAUTY SCHOOL, INC.         ",KY,41503-0000,Proprietary  ,9,10,19,31,32,63
02251500,TREND SETTERS ACAD OF BEAUTY CULT       ,KY,40258-0000,Proprietary  ,13,93,106,51,164,215
02275000,JENNY LEA ACADEMY OF COSMETOLOGY        ,KY,40831-0000,Proprietary  ,17,71,88,42,139,181
02284306,INTERACTIVE LEARNING SYSTEMS            ,KY,41042-0000,Proprietary  ,6,39,45,11,52,63
02323700,PAT WILSON'S BEAUTY COLLEGE             ,KY,42420-0000,Proprietary  ,7,29,36,13,47,60
02337200,PJ'S COLLEGE OF COSMETOLOGY             ,KY,42101-0000,Proprietary  ,36,155,191,83,293,376
02340800,PAUL MITCHELL THE SCHOOL LEXINGTON      ,KY,40514-1545,Proprietary  ,55,119,174,144,235,379
02351700,PAUL MITCHELL THE SCHOOL - LOUISVILLE   ,KY,40222-0000,Proprietary  ,66,127,193,180,280,460
02491100,BECKFIELD COLLEGE                       ,KY,41042-0000,Proprietary  ,100,827,927,243,1567,1810
02518900,BARRETT & COMPANY SCH HAIR DESIGN       ,KY,40356-0000,Proprietary  ,11,44,55,38,75,113
02526100,JENNY LEA ACADEMY OF COSMETOLOGY        ,KY,41858-0000,Proprietary  ,12,23,35,29,40,69
02535600,CLEAR CREEK BAPTIST BIBLE COLLEGE       ,KY,40977-0000,Private      ,13,63,76,33,111,144
02551100,PJ'S COLLEGE OF COSMETOLOGY             ,KY,42141-2434,Proprietary  ,13,37,50,36,72,108
02560800,SOUTHEAST SCHOOL OF COSMETOLOGY         ,KY,40962-0000,Proprietary  ,2,14,16,13,36,49
02576200,MID-CONTINENT UNIVERSITY                ,KY,42066-9007,Private      ,8,47,55,289,2339,2628
03002100,KENTUCKY MOUNTAIN BIBLE COLLEGE         ,KY,41385-0010,Private      ,16,16,32,40,24,64
03007000,FRONTIER SCH OF MIDWIFERY&FAMILY NU     ,KY,41749-0000,Private      ,2,586,588,11,1226,1237
03026200,HEAD'S WEST KENTUCKY BEAUTY COLLEGE     ,KY,42431-0000,Proprietary  ,4,19,23,20,56,76
03029200,NU-TEK ACADEMY OF BEAUTY                ,KY,40353-9767,Proprietary  ,4,12,16,12,32,44
03034500,OWENSBORO COMMUNITY & TECHNICAL COLLEGE ,KY,42303-1899,Public       ,296,679,975,1517,2039,3556
03083700,GALEN HEALTH INSTITUTES                 ,KY,40207-1047,Proprietary  ,281,1905,2186,691,4592,5283
03516500,EZELL'S COSMETOLOGY SCHOOL              ,KY,42071-2530,Proprietary  ,0,0,0,0,3,3
03611300,BRIGHTON CENTER'S CENTER FOR EMPLOY     ,KY,41071-1968,Private      ,3,15,18,8,25,33
03804300,BELLEFONTE ACADEMY OF BEAUTY            ,KY,41169-2015,Proprietary  ,13,50,63,26,80,106
03885300,EMPLOYMENT SOLUTIONS                    ,KY,40517-3260,Private      ,27,160,187,48,280,328
03886300,REGENCY SCHOOL OF HAIR DESIGN           ,KY,41653-1278,Proprietary  ,3,14,17,22,40,62
04038300,ATA CAREER EDUCATION                    ,KY,40223-3832,Proprietary  ,65,331,396,165,748,913
04038701,IDEAL BEAUTY ACADEMY - LOUISVILLE       ,KY,40223-5606,Proprietary  ,1,6,7,1,6,7
04051316,ART INSTITUTE OF PHOENIX (THE) - ATS - (,KY,41017-2136,Proprietary  ,16,106,122,68,346,414
04051319,ART INSTITUTE OF PHOENIX (THE) - BROWN M,KY,40219-1916,Proprietary  ,21,96,117,160,482,642
04051320,ART INSTITUTE OF PHOENIX (THE) - BROWN M,KY,42240-3579,Proprietary  ,17,72,89,53,219,272
04123900,LEXINGTON HEALING ARTS ACADEMY          ,KY,40503-1932,Proprietary  ,10,70,80,34,155,189
04177600,LINDSEY INSTITUTE OF COSMETOLOGY        ,KY,42103-8036,Proprietary  ,10,38,48,51,80,131
04177700,TRI-STATE INSTITUTE OF HAIR DESIGN      ,KY,40744-5234,Proprietary  ,8,36,44,30,74,104
04178000,SIMMONS COLLEGE OF KENTUCKY             ,KY,40203-3322,Private      ,7,63,70,48,157,205
04229300,MEDQUEST COLLEGE                        ,KY,40243-1882,Proprietary  ,18,58,76,39,93,132
00200300,CENTENARY COLLEGE OF LOUISIANA          ,LA,71104-3396,Private      ,322,151,473,835,284,1119
00200400,DILLARD UNIVERSITY                      ,LA,70122-3097,Private      ,855,527,1382,2469,1042,3511
00200500,NICHOLLS STATE UNIVERSITY               ,LA,70310-0001,Public       ,2881,1366,4247,5343,2219,7562
00200600,GRAMBLING STATE UNIVERSITY              ,LA,71245-2215,Public       ,1953,1558,3511,4348,2801,7149
00200700,LOUISIANA COLLEGE                       ,LA,71359-0000,Private      ,534,302,836,1077,518,1595
00200800,LOUISIANA TECH UNIVERSITY               ,LA,71272-0001,Public       ,3649,1328,4977,7244,2387,9631
00201000,LOUISIANA STATE UNIV & A&M COLG         ,LA,70803-5710,Public       ,10223,3442,13665,24709,7007,31716
00201100,LOUISIANA STATE UNIV-ALEXANDRIA         ,LA,71302-9121,Public       ,888,728,1616,2057,1563,3620
00201200,LOUISIANA STATE UNIV-EUNICE             ,LA,70535-6726,Public       ,1065,762,1827,1935,1468,3403
00201300,LOUISIANA STATE UNIV-SHREVEPORT         ,LA,71115-2399,Public       ,1249,1867,3116,2445,3008,5453
00201400,LA STATE UNIV HEALTH SCIENCES CTR       ,LA,70112-2223,Public       ,333,1139,1472,609,2307,2916
00201500,(THE) UNIVERSITY OF NEW ORLEANS         ,LA,70148-0001,Public       ,3071,3058,6129,6195,5309,11504
00201600,LOYOLA UNIVERSITY NEW ORLEANS           ,LA,70118-6195,Private      ,1230,1167,2397,4740,2267,7007
00201700,MCNEESE STATE UNIVERSITY                ,LA,70609-4510,Public       ,2640,1610,4250,4961,2803,7764
00201900,NEW ORLEANS BAPTIST THEOL SEMINARY      ,LA,70126-0000,Private      ,27,101,128,51,179,230
00202000,UNIVERSITY OF LOUISIANA AT MONROE       ,LA,71209-9001,Public       ,3160,2085,5245,6286,3678,9964
00202100,NORTHWESTERN STATE UNIVERSITY           ,LA,71497-0001,Public       ,2722,2450,5172,5436,4316,9752
00202200,NOTRE DAME SEMINARY                     ,LA,70118-0000,Private      ,3,9,12,10,20,30
00202300,OUR LADY OF HOLY CROSS COLLEGE          ,LA,70131-7399,Private      ,285,649,934,563,1077,1640
00202400,SOUTHEASTERN LOUISIANA UNIV             ,LA,70402-0001,Public       ,5456,2455,7911,10243,4162,14405
00202500,SOUTHERN UNIVERSITY A & M COLLEGE       ,LA,70813-9374,Public       ,3190,2865,6055,7179,5568,12747
00202600,SOUTHERN UNIV NEW ORLEANS               ,LA,70126-0002,Public       ,954,1976,2930,1842,3291,5133
00202700,ST JOSEPH SEMINARY COLLEGE              ,LA,70457-9990,Private      ,15,10,25,32,14,46
00202900,TULANE UNIVERSITY                       ,LA,70118-5698,Private      ,1571,2313,3884,11340,6056,17396
00203100,UNIV OF LOUISIANA AT LAFAYETTE          ,LA,70504-0001,Public       ,6844,2829,9673,13510,5066,18576
00203200,XAVIER UNIVERSITY OF LOUISIANA          ,LA,70125-1098,Private      ,1271,878,2149,4403,1577,5980
00462100,AYERS CAREER COLLEGE                    ,LA,71108-5845,Proprietary  ,33,169,202,48,274,322
00462500,DELGADO COMMUNITY COLLEGE               ,LA,70119-0000,Public       ,3721,7256,10977,6199,12276,18475
00546600,LOUISIANA TECHNICAL COLLEGE - T. H.  HAR,LA,70570-6113,Public       ,8,10,18,83,106,189
00546700,SOWELA TECHNICAL COMMUNITY COLLEGE      ,LA,70616-6950,Public       ,708,884,1592,1182,1422,2604
00546702,SOWELA TECHNICAL COMMUNITY COLLEGE - MOR,LA,70546-1327,Public       ,41,68,109,68,109,177
00546800,LOUISIANA TECHNICAL COLLEGE - ACADIAN CA,LA,70526-3215,Public       ,0,2,2,19,45,64
00548000,"LOUISIANA TECHNICAL COLLEGE, HUEY P. LON",LA,71483-3599,Public       ,0,0,0,1,0,1
00548200,LOUISIANA TECHNICAL COLLEGE - GULF AREA ,LA,70510-0878,Public       ,3,5,8,32,66,98
00548400,LOUISIANA TECHNICAL COLLEGE - EVANGELINE,LA,70582-3104,Public       ,2,3,5,19,24,43
00548800,CAPITAL AREA TECHNICAL COLLEGE          ,LA,70807-0000,Public       ,142,302,444,270,553,823
00548808,LOUISIANA TECHNICAL COLLEGE - CHARLES B.,LA,70586-0296,Public       ,3,3,6,27,36,63
00548812,LOUISIANA TECH COLG-FOLKES CAMPUS       ,LA,70748-0000,Public       ,8,13,21,14,23,37
00548817,LOUISIANA TEC CLG-JUMONVILLE MEM CP     ,LA,70760-0000,Public       ,8,12,20,13,23,36
00548818,LOUISIANA TECHNICAL COLLEGE - LAFAYETTE ,LA,70502-4909,Public       ,9,10,19,97,196,293
00548832,LOUISIANA TECH COLG-SHELBY JACKSON      ,LA,71334-0000,Public       ,0,0,0,1,1,2
00548839,LOUISIANA TECHNICAL COLLEGE - TECHE AREA,LA,70562-1057,Public       ,5,7,12,58,87,145
00548842,LOUISIANA TECHNICAL COLLEGE - WESTSIDE C,LA,70765-0733,Public       ,19,34,53,32,64,96
00548900,CENTRAL LOUISIANA TECHNICAL COLLEGE     ,LA,71302-3137,Public       ,188,477,665,336,770,1106
00552600,SOUTH CENTRAL LOUISIANA TECHNICAL COLG  ,LA,70381-2148,Public       ,41,117,158,79,212,291
00552602,SOUTH CENTRAL LOUISIANA TECHNICAL COLG  ,LA,70302-4336,Public       ,50,52,102,79,109,188
00552603,SOUTH CENTRAL LOUISIANA TECHNICAL COLG  ,LA,70084-6632,Public       ,174,228,402,292,390,682
00576100,L. E. FLETCHER TECHNICAL COMMUNITY COLLE,LA,70360-2863,Public       ,566,527,1093,919,921,1840
00675600,NORTHSHORE TECHNICAL COLLEGE            ,LA,70427-5866,Public       ,314,425,739,498,722,1220
00675603,NORTHSHORE TECHNICAL COLLEGE - HAMMOND  ,LA,70401-0000,Public       ,0,0,0,1,0,1
00768600,SOUTHERN UNIV AT SHREVEPORT/BOSSIER     ,LA,71107-4795,Public       ,715,1111,1826,1301,1891,3192
00806700,LSU HEALTH SCIENCES CENTR-SHREVEPOR     ,LA,71130-3932,Public       ,134,527,661,289,936,1225
00989800,DEMMON SCHOOL OF BEAUTY                 ,LA,70607-2128,Proprietary  ,13,43,56,24,60,84
00997500,NORTHWEST LOUISIANA TECHNICAL COLLEGE   ,LA,71055-2422,Public       ,98,167,265,163,271,434
00997503,NORTHWEST LOUISIANA TECHNICAL COLLEGE   ,LA,71137-8527,Public       ,119,366,485,216,652,868
00997504,NORTHWEST LOUISIANA TECHNICAL COLLEGE   ,LA,71052-1236,Public       ,42,75,117,51,104,155
00997505,NORTHWEST LOUISIANA TECHNICAL COLLEGE   ,LA,71449-0790,Public       ,20,27,47,28,54,82
00997506,NORTHWEST LOUISIANA TECHNICAL COLLEGE   ,LA,71458-0657,Public       ,77,90,167,134,175,309
01109700,CLOYD'S BEAUTY SCHOOL #1                ,LA,71291-3131,Proprietary  ,13,31,44,22,60,82
01163100,"D-JAY'S SCHL OF BEAUTY, ARTS & SCI      ",LA,70806-0000,Proprietary  ,15,38,53,29,73,102
01184100,JOHN JAY BEAUTY COLLEGE                 ,LA,70124-2592,Proprietary  ,48,88,136,81,151,232
01282300,PAT GOINS RUSTON BEAUTY SCHOOL          ,LA,71270-4301,Proprietary  ,5,16,21,11,29,40
01287900,PAT GOINS BENTON ROAD BEAUTY SCHOOL     ,LA,71111-4838,Proprietary  ,10,25,35,16,55,71
01288000,CELEBRITY STYLIST BEAUTY SCHOOL         ,LA,71201-5167,Proprietary  ,10,18,28,26,43,69
02055400,BOSSIER PARISH COMMUNITY COLLEGE        ,LA,71111-0000,Public       ,1621,2497,4118,2529,3975,6504
02055500,DELTA SCH OF BUSINESS & TECHNOLOGY      ,LA,70601-0000,Proprietary  ,63,171,234,109,251,360
02117800,AVEDA INSTITUTE LAFAYETTE               ,LA,70503-3246,Proprietary  ,86,103,189,126,156,282
02166100,NUNEZ COMMUNITY COLLEGE                 ,LA,70043-0000,Public       ,295,706,1001,501,1154,1655
02166200,ITI TECHNICAL COLLEGE                   ,LA,70817-0000,Proprietary  ,233,319,552,341,526,867
02197500,BATON ROUGE SCHOOL OF COMPUTERS         ,LA,70809-8188,Proprietary  ,34,67,101,59,103,162
02234000,CAMERON COLLEGE                         ,LA,70119-0000,Proprietary  ,26,106,132,54,191,245
02258400,AVEDA INSTITUTE BATON ROUGE             ,LA,70816-2246,Proprietary  ,110,128,238,160,219,379
02260200,DIESEL DRIVING ACADEMY                  ,LA,71109-5617,Proprietary  ,16,148,164,27,198,225
02265600,JOHN JAY KENNER ACADEMY                 ,LA,70062-0000,Proprietary  ,17,40,57,25,86,111
02269300,STEVENSON'S ACADEMY OF HAIR DESIGN      ,LA,70116-0000,Proprietary  ,27,82,109,52,137,189
02327800,PINEVILLE BEAUTY SCHOOL                 ,LA,71360-0000,Proprietary  ,33,55,88,45,83,128
02335700,BATON ROUGE GENERAL MEDICAL CENTER      ,LA,70806-3889,Private      ,65,67,132,107,135,242
02335701,BATON ROUGE GEN MED CTR SCH NSG         ,LA,70821-0000,Private      ,64,139,203,109,228,337
02335702,BATON ROUGE GEN MED CTR-RAD TECH        ,LA,70806-0000,Private      ,41,63,104,72,108,180
02338000,"CLOYD'S BEAUTY SCHOOL #2, INC           ",LA,71202-3539,Proprietary  ,19,22,41,34,65,99
02352500,"CLOYD'S BEAUTY SCHOOL #3, INC           ",LA,71201-3211,Proprietary  ,15,34,49,27,68,95
02358600,"STAGE ONE THE HAIR SCHOOL, INC.         ",LA,70605-0000,Proprietary  ,39,64,103,60,97,157
02518300,SOUTH LOUISIANA BEAUTY COLLEGE          ,LA,70363-0000,Proprietary  ,16,22,38,28,44,72
02536400,LOUISIANA ACADEMY OF BEAUTY             ,LA,70535-0000,Proprietary  ,15,25,40,27,47,74
02538300,DELTA COLLEGE OF ARTS & TECH INC        ,LA,70806-1529,Proprietary  ,142,305,447,188,463,651
02538301,DELTA COLLEGE OF ARTS & TECHNOLOGY - LAF,LA,70508-6831,Proprietary  ,68,195,263,105,316,421
02548500,COSMETOLOGY TRAINING CENTER             ,LA,70503-0000,Proprietary  ,46,50,96,73,71,144
02554800,VANGUARD COLLEGE OF COSMETOLOGY         ,LA,70458-8823,Proprietary  ,92,117,209,137,168,305
02582200,"GUY'S ACADEMY HAIR, SKIN & NAILS        ",LA,71105-2404,Proprietary  ,24,48,72,38,90,128
02600900,AVEDA INSTITUTE                         ,LA,70433-2922,Proprietary  ,489,673,1162,783,1187,1970
02601000,AMERICAN SCHOOL OF BUSINESS             ,LA,71105-5646,Proprietary  ,10,57,67,24,96,120
02601100,OPELOUSAS SCHOOL OF COSMETOLOGY         ,LA,70570-6156,Proprietary  ,19,13,32,26,34,60
02619200,DENHAM SPRINGS BEAUTY COLLEGE           ,LA,70726-3829,Proprietary  ,15,29,44,29,59,88
03010400,CRESCENT CITY SCH GAMING & BARTENDG     ,LA,70119-5507,Proprietary  ,31,266,297,50,387,437
03010624,VIRGINIA COLLEGE - BATON ROUGE          ,LA,70815-8604,Proprietary  ,73,180,253,118,363,481
03023500,CAMELOT CAREER COLLEGE                  ,LA,70805-7539,Proprietary  ,30,82,112,54,153,207
03026514,REMINGTON COLLEGE - LAFAYETTE           ,LA,70508-5760,Private      ,70,131,201,122,220,342
03026515,REMINGTON COLLEGE - BATON ROUGE         ,LA,70816-4040,Private      ,66,111,177,111,210,321
03027300,BLALOCK'S PROFESSIONAL BEAUTY COLLEGE   ,LA,71108-3246,Proprietary  ,9,27,36,17,45,62
03030900,DIESEL DRIVING ACADEMY                  ,LA,70815-8109,Proprietary  ,30,198,228,43,275,318
03106200,OUR LADY OF THE LAKE COLLEGE            ,LA,70808-4345,Private      ,564,847,1411,1026,1475,2501
03294300,BLUE CLIFF SCH THERAPEUTIC MASSAGE      ,LA,70002-3458,Proprietary  ,233,1209,1442,299,1615,1914
03294303,BLUE CLIFF COLLEGE - LAFAYETTE          ,LA,70508-3256,Proprietary  ,45,130,175,88,242,330
03294306,BLUE CLIFF COLLEGE - SHREVEPORT         ,LA,71105-6520,Proprietary  ,29,126,155,59,229,288
03332600,DELTA COLLEGE                           ,LA,70433-9042,Proprietary  ,62,135,197,110,247,357
03332601,DELTA COLLEGE - SLIDELL                 ,LA,70460-2624,Proprietary  ,72,226,298,116,360,476
03356300,MEDICAL TRAINING COLLEGE                ,LA,70816-5820,Proprietary  ,90,124,214,128,245,373
03480300,MEDVANCE INSTITUTE                      ,LA,70809-1908,Proprietary  ,68,234,302,84,304,388
03498400,OMEGA INSTITUTE OF COSMETOLOGY          ,LA,70360-0000,Proprietary  ,34,28,62,49,46,95
03727500,MOORE CAREER COLLEGE                    ,LA,70808-4191,Proprietary  ,10,54,64,18,75,93
03730300,BATON ROUGE COMMUNITY COLLEGE           ,LA,78806-4129,Public       ,2896,2777,5673,4744,4854,9598
03789300,UNITECH TRAINING ACADEMY                ,LA,70503-5132,Proprietary  ,101,386,487,140,476,616
03789301,UNITECH TRAINING ACADEMY - WEST MONROE  ,LA,71291-2913,Proprietary  ,41,184,225,72,320,392
03789302,UNITECH TRAINING ACADEMY - HOUMA        ,LA,70363-5556,Proprietary  ,46,107,153,58,152,210
03789303,UNITECH TRAINING ACADEMY -  ALEXANDRIA  ,LA,71303-3625,Proprietary  ,49,157,206,65,207,272
03789304,UNITECH TRAINING ACADEMY - LAKE CHARLES ,LA,70601-7887,Proprietary  ,58,174,232,89,248,337
03789400,RIVER PARISHES COMMUNITY COLLEGE        ,LA,70778-0310,Public       ,476,469,945,729,705,1434
03795300,CASSIA BEAUTY COLLEGE                   ,LA,70126-0000,Proprietary  ,14,27,41,30,48,78
03810500,COURT REPORTING INSTITUTE OF LOUISI     ,LA,70816-0000,Proprietary  ,2,31,33,6,51,57
03956300,SOUTH LOUISIANA COMMUNITY COLLEGE       ,LA,70506-0000,Public       ,1566,1557,3123,2659,2778,5437
04040300,COMPASS CAREER COLLEGE                  ,LA,70403-0653,Proprietary  ,75,161,236,120,242,362
04112300,LOUISIANA CULINARY INSTITUTE            ,LA,70816-4109,Proprietary  ,124,132,256,210,267,477
04130100,LOUISIANA DELTA COMMUNITY COLLEGE       ,LA,71203-3618,Public       ,943,1298,2241,1559,2359,3918
04149500,A & W HEALTHCARE EDUCATORS              ,LA,70122-3146,Proprietary  ,30,156,186,48,281,329
04151600,MY-LE'S BEAUTY COLLEGE                  ,LA,70056-3150,Proprietary  ,7,38,45,11,54,65
04217000,HEALTHCARE TRAINING INSTITUTE           ,LA,70062-7630,Proprietary  ,11,59,70,24,95,119
04225900,SETTING THE STANDARD BARBERING AND NATUR,LA,71109-4124,Proprietary  ,5,15,20,5,29,34
04226000,BOS-MAN'S BARBER COLLEGE                ,LA,71106-2653,Proprietary  ,4,28,32,9,52,61
04234600,PARK PLACE PREMIER BARBER SCHOOL        ,LA,70122-3808,Proprietary  ,8,29,37,8,29,37
00143600,CAPITOL COLLEGE                         ,MD,20708-9759,Private      ,60,149,209,416,400,816
00205700,ALLEGANY COLLEGE OF MARYLAND            ,MD,21502-2596,Public       ,528,607,1135,2320,1629,3949
00205800,ANNE ARUNDEL COMMUNITY COLLEGE          ,MD,21012-1895,Public       ,979,2000,2979,4147,6129,10276
00206100,BALTIMORE CITY COMMUNITY COLLEGE        ,MD,21215-7893,Public       ,666,2435,3101,3122,7454,10576
00206200,BOWIE STATE UNIVERSITY                  ,MD,20715-9465,Public       ,1028,1439,2467,7094,5182,12276
00206300,COMMUNITY COLLEGE OF BALTIMORE COUNTY   ,MD,21228-5381,Public       ,1792,4238,6030,8085,12588,20673
00206400,COLLEGE OF SOUTHERN MARYLAND            ,MD,20646-0910,Public       ,794,1363,2157,3196,3716,6912
00206500,NOTRE DAME OF MARYLAND UNIVERSITY       ,MD,21210-2476,Private      ,91,421,512,1084,1800,2884
00206700,WASHINGTON ADVENTIST UNIVERSITY         ,MD,20912-7796,Private      ,201,268,469,774,786,1560
00206800,COPPIN STATE UNIVERSITY                 ,MD,21216-3698,Public       ,550,1280,1830,3665,4611,8276
00207100,FREDERICK COMMUNITY COLLEGE             ,MD,21702-9745,Public       ,506,837,1343,1908,2168,4076
00207200,FROSTBURG STATE UNIVERSITY              ,MD,21532-1099,Public       ,573,374,947,6531,1680,8211
00207300,GOUCHER COLLEGE                         ,MD,21204-2794,Private      ,340,253,593,3067,818,3885
00207400,HAGERSTOWN COMMUNITY COLLEGE            ,MD,21742-6514,Public       ,486,907,1393,1740,2203,3943
00207500,HARFORD COMMUNITY COLLEGE               ,MD,21015-1696,Public       ,636,900,1536,2079,2147,4226
00207600,HOOD COLLEGE                            ,MD,21701-8575,Private      ,190,212,402,2158,764,2922
00207700,JOHNS HOPKINS UNIVERSITY                ,MD,21218-2693,Private      ,462,591,1053,10131,2062,12193
00207702,JOHNS HOPKINS UNIV SCH ARTS/SCI/ENG     ,MD,21218-0000,Private      ,764,632,1396,4832,1715,6547
00207703,JOHNS HOPKINS UNIV SCH OF BUS/ED        ,MD,21046-0000,Private      ,7,458,465,73,1062,1135
00207705,JOHNS HOPKINS BLOOMBERG SCH OF PH       ,MD,21205-0000,Private      ,7,391,398,72,1624,1696
00207706,JOHNS HOPKINS UNIV SCH OF MEDICINE      ,MD,21205-0000,Private      ,53,146,199,294,1029,1323
00207707,JOHNS HOPKINS UNIV SCH OF NURSING       ,MD,21205-0000,Private      ,58,345,403,346,1407,1753
00207708,JOHNS HOPKINS UNIV PEABODY CONSERV      ,MD,21202-2397,Private      ,34,72,106,483,392,875
00207764,JOHNS HOPKINS UNIVERSITY - CAREY BUSINES,MD,21202-4649,Private      ,10,263,273,66,637,703
00207800,LOYOLA UNIVERSITY MARYLAND              ,MD,21210-2699,Private      ,726,758,1484,9732,2389,12121
00208000,MARYLAND INST COLLEGE OF ART            ,MD,21217-4191,Private      ,297,188,485,2703,882,3585
00208300,MORGAN STATE UNIVERSITY                 ,MD,21251-0002,Public       ,1414,1581,2995,9405,5830,15235
00208600,MOUNT SAINT MARY'S UNIVERSITY           ,MD,21727-7799,Private      ,238,110,348,3998,397,4395
00208700,NER ISRAEL RABBINICAL COLLEGE           ,MD,21208-1198,Private      ,19,13,32,92,27,119
00208900,PRINCE GEORGES COMMUNITY COLLEGE        ,MD,20774-2199,Public       ,1497,3283,4780,6040,9153,15193
00209100,SALISBURY UNIVERSITY                    ,MD,21801-6862,Public       ,934,472,1406,11010,2209,13219
00209200,ST JOHN'S COLLEGE                       ,MD,21404-0000,Private      ,46,35,81,533,142,675
00209500,ST. MARY'S COLLEGE OF MARYLAND          ,MD,20686-3001,Public       ,154,61,215,2516,307,2823
00209600,ST MARY'S SEMINARY & UNIV               ,MD,21210-1994,Private      ,5,13,18,27,56,83
00209900,TOWSON UNIVERSITY                       ,MD,21252-0002,Public       ,1961,1792,3753,24880,8142,33022
00210200,UNIVERSITY OF BALTIMORE                 ,MD,21201-5779,Public       ,335,1741,2076,2153,6330,8483
00210300,"UNIVERSITY OF MARYLAND, COLLEGE PARK    ",MD,20742-5145,Public       ,2307,3206,5513,32780,12149,44929
00210400,"UNIVERSITY OF MARYLAND, BALTIMORE       ",MD,21201-1691,Public       ,506,2106,2612,4659,10020,14679
00210500,UMBC                                    ,MD,21250-0002,Public       ,937,1313,2250,10622,5504,16126
00210600,UNIVERSITY MARYLAND EASTERN SHORE       ,MD,21853-4053,Public       ,682,449,1131,5384,2147,7531
00210700,STEVENSON UNIVERSITY                    ,MD,21153-0641,Private      ,454,433,887,6132,1908,8040
00210800,WASHINGTON COLLEGE                      ,MD,21620-1197,Private      ,133,26,159,2448,125,2573
00210900,MCDANIEL COLLEGE                        ,MD,21157-4390,Private      ,175,194,369,3229,593,3822
00458612,KAPLAN COLLEGE                          ,MD,21742-2797,Proprietary  ,52,534,586,182,1434,1616
00465000,CHESAPEAKE COLLEGE                      ,MD,21679-0008,Public       ,298,443,741,1096,1140,2236
00691100,MONTGOMERY COLLEGE                      ,MD,20850-1195,Public       ,2705,3291,5996,10619,9735,20354
00734100,INTERNATIONAL BEAUTY SCHOOL             ,MD,21502-2370,Proprietary  ,6,61,67,15,85,100
00744700,DEL-MAR-VA BEAUTY ACADEMY               ,MD,21804-0000,Proprietary  ,15,33,48,39,84,123
00749100,TESST COLLEGE OF TECHNOLOGY             ,MD,21227-1063,Proprietary  ,87,292,379,322,964,1286
00793600,LINCOLN TECHNICAL INSTITUTE             ,MD,21046-1544,Proprietary  ,253,353,606,455,558,1013
00817500,HOWARD COMMUNITY COLLEGE                ,MD,21044-3197,Public       ,752,1292,2044,3494,3859,7353
00826300,AWARD BEAUTY SCHOOL                     ,MD,21740-5624,Proprietary  ,19,113,132,33,163,196
00830800,CECIL COLLEGE                           ,MD,21901-1999,Public       ,290,401,691,1001,1085,2086
00907906,EVEREST COLLEGE- EVEREST INSTITUTE      ,MD,20910-3737,Proprietary  ,81,257,338,178,536,714
01001400,GARRETT COMMUNITY COLLEGE               ,MD,21541-1265,Public       ,160,67,227,812,277,1089
01031900,MEDIX SCHOOL                            ,MD,21204-2538,Proprietary  ,287,1109,1396,446,1828,2274
01041000,TESST COLLEGE OF TECHNOLOGY             ,MD,21286-2201,Proprietary  ,46,173,219,144,411,555
01164400,UNIV OF MARYLAND UNIVERSITY COLLEGE     ,MD,20783-8078,Public       ,646,12241,12887,2373,27579,29952
01164402,U OF MD UNIVERSITY COLLEGE - EUROPE     ,MD,20832-0000,Public       ,35,242,277,293,605,898
01164404,U OF MD UNIVERSITY COLLEGE - ASIA       ,MD,31207-0000,Public       ,22,320,342,85,757,842
02073900,WOR-WIC COMMUNITY COLLEGE               ,MD,21804-0000,Public       ,263,581,844,1226,1752,2978
02083600,TESST COLLEGE OF TECHNOLOGY             ,MD,20705-2698,Proprietary  ,90,246,336,149,417,566
02127900,SOJOURNER DOUGLASS COLLEGE              ,MD,21205-0000,Private      ,35,467,502,199,1932,2131
02155100,MARYLAND COLLEGE OF ART AND DESIGN      ,MD,20902-0000,Private      ,34,46,80,144,149,293
02269700,"COLORLAB ACADEMY OF HAIR, THE           ",MD,21014-3639,Proprietary  ,10,24,34,29,48,77
02331000,MARYLAND BEAUTY ACADEMY OF ESSEX        ,MD,21221-0000,Proprietary  ,21,53,74,63,147,210
02333000,HAIR ACADEMY                            ,MD,20784-0000,Proprietary  ,42,218,260,79,281,360
02343800,MONTGOMERY BEAUTY SCHOOL                ,MD,20901-0000,Proprietary  ,18,48,66,62,125,187
02494700,BALTIMORE STUDIO OF HAIR DESIGN         ,MD,21201-0000,Proprietary  ,23,74,97,87,198,285
02495000,ROBERT PAUL ACAD COSMTGY ARTS & SCI     ,MD,21093-0000,Proprietary  ,15,28,43,40,51,91
02495100,MARYLAND BEAUTY ACADEMY                 ,MD,21136-0000,Proprietary  ,5,18,23,18,49,67
02545400,NORTH AMERICAN TRADE SCHOOLS            ,MD,21244-0069,Proprietary  ,60,321,381,145,630,775
02573800,"L' ACADEMIE DE CUISINE, INC.            ",MD,20877-0000,Proprietary  ,17,65,82,64,186,250
02578400,MARYLAND UNIVERSITY OF INTEGRATIVE HEALT,MD,20723-6010,Private      ,12,187,199,21,374,395
03027200,BLADES SCHOOL OF HAIR DESIGN            ,MD,20619-0226,Proprietary  ,6,43,49,12,70,82
03064900,AARON'S ACADEMY OF BEAUTY               ,MD,20602-2715,Proprietary  ,13,30,43,32,87,119
03097200,AESTHETICS INSTITUTE OF COSMETOLOGY     ,MD,20877-1305,Proprietary  ,11,30,41,30,72,102
03100700,CARROLL COMMUNITY COLLEGE               ,MD,21157-6913,Public       ,248,416,664,1115,1105,2220
03148300,AMERICAN BEAUTY ACADEMY                 ,MD,20902-1911,Proprietary  ,80,237,317,148,368,516
03296300,BALTIMORE SCHOOL OF MASSAGE             ,MD,21090-2261,Proprietary  ,43,165,208,86,289,375
03327300,NEW CREATIONS ACADEMY OF HAIR DSN       ,MD,20746-0000,Proprietary  ,16,42,58,30,82,112
03455500,NATIONAL LABOR COLLEGE                  ,MD,20903-1790,Private      ,1,6,7,5,51,56
03493300,ALL-STATE CAREER SCHOOL                 ,MD,21224-6658,Proprietary  ,120,597,717,265,1159,1424
03667300,FAITH THEOLOGICAL SEMINARY              ,MD,21212-2624,Private      ,0,38,38,4,109,113
03822400,MAPLE SPRINGS BAPTIST BIBLE COLLEGE & SE,MD,20743-5711,Private      ,3,14,17,7,40,47
03937300,YESHIVA COLLEGE OF THE NATION'S CAPITAL ,MD,20902-1700,Private      ,2,7,9,8,23,31
03965500,HAIR EXPRESSIONS ACADEMY                ,MD,20852-1729,Proprietary  ,39,73,112,83,137,220
04121600,FILA ACADEMY (THE)                      ,MD,21061-1634,Proprietary  ,3,17,20,14,35,49
04139700,FREDERICK SCHOOL OF COSMETOLOGY         ,MD,21701-0000,Proprietary  ,8,16,24,30,54,84
04141600,OMEGA STUDIOS' SCHOOL OF APPLIED RECORDI,MD,20852-1731,Proprietary  ,21,44,65,52,104,156
04151800,TEMPLE (THE): A PAUL MITCHELL PARTNER SC,MD,21701-5409,Proprietary  ,44,66,110,98,125,223
04167602,FINGER LAKES SCHOOL OF MASSAGE (THE)    ,MD,21701-3030,Proprietary  ,4,33,37,11,51,62
04168900,HOLISTIC MASSAGE TRAINING INSTITUTE     ,MD,21218-2407,Proprietary  ,4,44,48,18,109,127
04171501,COSMOPOLITAN BEAUTY & TECH SCHOOL -     ,MD,20143-3370,Proprietary  ,8,22,30,19,42,61
04188400,BAIS HAMEDRASH AND MESIVTA OF BALTIMORE ,MD,21209-1613,Private      ,3,5,8,36,12,48
04204000,ASPEN BEAUTY ACADEMY - LAUREL           ,MD,20724-2013,Proprietary  ,9,31,40,21,78,99
04209600,INSTITUTE OF HEALTH SCIENCES            ,MD,21031-1408,Proprietary  ,7,67,74,25,150,175
04211700,HARMON'S BEAUTY SCHOOL                  ,MD,20785-2135,Proprietary  ,6,21,27,18,46,64
00211400,AMERICAN INTERNATIONAL COLLEGE          ,MA,01109-3189,Private      ,480,1048,1528,2078,2350,4428
00211500,AMHERST COLLEGE                         ,MA,01002-5000,Private      ,413,86,499,4496,311,4807
00211600,ANDOVER NEWTON THEOLOGICAL SCHOOL       ,MA,02459-0000,Private      ,0,70,70,2,157,159
00211700,ANNA MARIA COLLEGE                      ,MA,01612-1198,Private      ,240,233,473,1722,539,2261
00211800,ASSUMPTION COLLEGE                      ,MA,01615-1294,Private      ,351,246,597,4476,810,5286
00212000,MERRIMACK COLLEGE                       ,MA,01845-5800,Private      ,587,213,800,6408,563,6971
00212100,BABSON COLLEGE                          ,MA,02457-0310,Private      ,322,176,498,2761,460,3221
00212200,BAY PATH COLLEGE                        ,MA,01106-2212,Private      ,231,884,1115,928,1931,2859
00212300,BECKER COLLEGE-WORCESTER                ,MA,01615-0071,Private      ,418,397,815,2660,931,3591
00212400,BENTLEY UNIVERSITY                      ,MA,02452-4705,Private      ,603,223,826,5999,638,6637
00212600,BERKLEE COLLEGE OF MUSIC                ,MA,02215-3693,Private      ,857,513,1370,4226,1385,5611
00212800,BOSTON COLLEGE                          ,MA,02467-3800,Private      ,1338,936,2274,15651,4989,20640
00212900,BOSTON CONSERVATORY OF MUSIC            ,MA,02215-9830,Private      ,135,86,221,1045,334,1379
00213000,BOSTON UNIVERSITY                       ,MA,02215-1789,Private      ,2902,3851,6753,36809,14646,51455
00213300,BRANDEIS UNIVERSITY                     ,MA,02453-2700,Private      ,873,350,1223,6275,1298,7573
00213900,CLARK UNIVERSITY                        ,MA,01610-1473,Private      ,499,247,746,4592,724,5316
00214000,ELMS COLLEGE                            ,MA,01013-2839,Private      ,194,335,529,1372,992,2364
00214100,COLLEGE OF THE HOLY CROSS               ,MA,01610-2395,Private      ,558,40,598,4809,140,4949
00214300,CURRY COLLEGE                           ,MA,02186-2395,Private      ,534,489,1023,5175,1205,6380
00214400,DEAN COLLEGE                            ,MA,02038-1994,Private      ,334,80,414,1794,259,2053
00214500,EASTERN NAZARENE COLLEGE                ,MA,02170-2999,Private      ,149,279,428,814,617,1431
00214507,EASTERN NAZARENE CLG - LEAD PROGRAM     ,MA,02170-0000,Private      ,15,154,169,42,317,359
00214600,EMERSON COLLEGE                         ,MA,02116-4624,Private      ,827,351,1178,7499,1382,8881
00214700,EMMANUEL COLLEGE                        ,MA,02115-5798,Private      ,309,111,420,4808,378,5186
00214800,ENDICOTT COLLEGE                        ,MA,01915-2098,Private      ,284,317,601,4841,711,5552
00214900,EPISCOPAL DIVINITY SCHOOL               ,MA,02138-0000,Private      ,0,22,22,0,55,55
00215000,FISHER COLLEGE                          ,MA,02116-1500,Private      ,350,450,800,1472,1096,2568
00215100,BENJAMIN FRANKLIN INSTITUTE OF TECH     ,MA,02116-6296,Public       ,163,137,300,496,284,780
00215300,GORDON COLLEGE                          ,MA,01984-1899,Private      ,484,67,551,2245,180,2425
00215400,HELLENIC COLLEGE                        ,MA,02445-7496,Private      ,18,47,65,48,87,135
00215500,HARVARD UNIVERSITY                      ,MA,02138-3800,Private      ,201,196,397,4117,821,4938
00215501,AMRCN REPERTORY THTR INST ADV THTR      ,MA,02138-0000,Private      ,1,8,9,5,107,112
00215502,HARVARD BUSINESS SCHOOL                 ,MA,02163-0000,Private      ,46,436,482,182,1433,1615
00215503,HARVARD EXTENSION SCHOOL                ,MA,02138-0000,Private      ,68,575,643,128,1185,1313
00215504,HARVARD SCH OF DENTAL MEDICINE          ,MA,02115-0000,Private      ,4,70,74,20,183,203
00215505,HARVARD UNIV GRAD SCH DESIGN            ,MA,02138-0000,Private      ,8,193,201,20,1005,1025
00215506,HARVARD DIVINITY SCHOOL                 ,MA,02138-0000,Private      ,8,97,105,17,543,560
00215507,HARVARD UNIV GRAD SCH ED                ,MA,02138-0000,Private      ,1,156,157,6,1153,1159
00215508,HARVARD UNIV GRAD S OF ARTS & SCIEN     ,MA,02138-0000,Private      ,10,81,91,43,690,733
00215509,HARVARD KENNEDY SCHOOL                  ,MA,02138-0000,Private      ,4,132,136,12,1151,1163
00215510,HARVARD LAW SCHOOL                      ,MA,02138-0000,Private      ,22,859,881,99,3046,3145
00215511,HARVARD UNIV MEDICAL SCHOOL             ,MA,02115-0000,Private      ,36,335,371,137,1020,1157
00215512,HARVARD UNIV SCH PUBLIC HEALTH          ,MA,02115-0000,Private      ,5,90,95,35,1037,1072
00215513,HARVARD UNIVERSITY-HARVARD COLLEGE      ,MA,02138-0000,Private      ,1622,257,1879,18152,1128,19280
00215700,HEBREW COLLEGE                          ,MA,02459-2237,Private      ,1,30,31,2,93,95
00215800,LASELL COLLEGE                          ,MA,02466-2716,Private      ,366,150,516,3026,446,3472
00216000,LESLEY UNIVERSITY                       ,MA,02138-2790,Private      ,341,1068,1409,2779,2492,5271
00216100,UMASS LOWELL                            ,MA,01854-3089,Public       ,1999,2045,4044,14194,5186,19380
00216400,NEW ENGLAND COLLEGE OF OPTOMETRY        ,MA,02115-1129,Private      ,3,97,100,10,426,436
00216500,MASS. COLLEGE OF PHARMACY  & HEALTH SCIE,MA,02115-5804,Private      ,486,838,1324,5506,3952,9458
00216700,BERKSHIRE COMMUNITY COLLEGE             ,MA,01201-5786,Public       ,468,705,1173,831,1163,1994
00216800,CAPE COD COMMUNITY COLLEGE              ,MA,02668-1599,Public       ,530,822,1352,1198,1614,2812
00216900,GREENFIELD COMMUNITY COLLEGE            ,MA,01301-9739,Public       ,308,552,860,670,1100,1770
00217000,HOLYOKE COMMUNITY COLLEGE               ,MA,01040-1099,Public       ,1436,1775,3211,3206,3468,6674
00217100,MASSACHUSETTS BAY COMMUNITY COLLEGE     ,MA,02181-0000,Public       ,717,1060,1777,1818,2074,3892
00217200,MOUNT WACHUSETT COMMUNITY COLLEGE       ,MA,01440-1000,Public       ,695,1134,1829,1699,2461,4160
00217300,NORTH SHORE COMMUNITY COLLEGE           ,MA,01923-4093,Public       ,1174,1752,2926,2519,3175,5694
00217400,NORTHERN ESSEX COMMUNITY COLLEGE        ,MA,01830-2399,Public       ,1236,1654,2890,2658,3012,5670
00217500,QUINSIGAMOND COMMUNITY COLLEGE          ,MA,01606-2092,Public       ,1247,1983,3230,3514,4733,8247
00217600,BRISTOL COMMUNITY COLLEGE               ,MA,02720-7399,Public       ,1476,2045,3521,3662,4340,8002
00217700,MASSASOIT COMMUNITY COLLEGE             ,MA,02302-3996,Public       ,1183,1694,2877,2841,3354,6195
00217800,MASSACHUSETTS INST OF TECHNOLOGY        ,MA,02139-4307,Private      ,968,617,1585,11974,2519,14493
00218000,MASSACHUSETTS COLLEGE OF ART AND DESIGN ,MA,02115-5803,Public       ,315,200,515,2404,736,3140
00218100,MASSACHUSETTS MARITIME ACADEMY          ,MA,02532-3400,Public       ,455,69,524,1590,142,1732
00218300,BRIDGEWATER STATE COLLEGE               ,MA,02325-0001,Public       ,1584,1148,2732,11378,3431,14809
00218400,FITCHBURG STATE UNIVERSITY              ,MA,01420-2697,Public       ,604,469,1073,6298,1498,7796
00218500,FRAMINGHAM STATE COLLEGE                ,MA,01702-2471,Public       ,804,486,1290,6996,1454,8450
00218700,MASSACHUSETTS CLG OF LIBERAL ARTS       ,MA,01247-4100,Public       ,278,162,440,2476,494,2970
00218800,SALEM STATE UNIVERSITY                  ,MA,01970-5353,Public       ,1247,1360,2607,8786,3629,12415
00218900,WESTFIELD STATE COLLEGE                 ,MA,01086-1630,Public       ,903,545,1448,8035,1758,9793
00219000,WORCESTER STATE COLLEGE                 ,MA,01602-2597,Public       ,725,704,1429,6300,2274,8574
00219200,MOUNT HOLYOKE COLLEGE                   ,MA,01075-1492,Private      ,456,76,532,2410,302,2712
00219300,MOUNT IDA COLLEGE                       ,MA,02459-3323,Private      ,351,140,491,1812,381,2193
00219400,NEW ENGLAND CONSERVATORY OF MUSIC       ,MA,02115-5018,Private      ,35,53,88,703,564,1267
00219700,NICHOLS COLLEGE                         ,MA,01571-6346,Private      ,295,93,388,2229,306,2535
00219900,NORTHEASTERN UNIVERSITY                 ,MA,02115-5000,Private      ,2685,3490,6175,33336,10569,43905
00220100,PINE MANOR COLLEGE                      ,MA,02167-0000,Private      ,125,54,179,399,140,539
00220500,QUINCY COLLEGE                          ,MA,02169-4324,Public       ,656,1518,2174,1479,3010,4489
00220600,REGIS COLLEGE                           ,MA,02193-0000,Private      ,292,335,627,2087,840,2927
00220800,SIMMONS COLLEGE                         ,MA,02115-5898,Private      ,212,1208,1420,3061,3890,6951
00220900,SMITH COLLEGE                           ,MA,01063-2936,Private      ,266,88,354,3570,473,4043
00220901,"SMITH COLLEGE, SCH FOR SOCIAL WORK      ",MA,01063-0000,Private      ,2,38,40,11,493,504
00221000,UNIV OF MASSACHUSETTS-DARTMOUTH         ,MA,02747-2300,Public       ,901,829,1730,11760,3351,15111
00221100,SPRINGFIELD COLLEGE                     ,MA,01109-3797,Private      ,551,1209,1760,3687,3059,6746
00221400,ST JOHN'S SEMINARY                      ,MA,02135-8839,Private      ,0,14,14,1,20,21
00221700,STONEHILL COLLEGE                       ,MA,02357-6110,Private      ,195,39,234,5706,178,5884
00221800,SUFFOLK UNIVERSITY                      ,MA,02108-2770,Private      ,1131,1072,2203,8166,3819,11985
00221900,TUFTS UNIVERSITY                        ,MA,02155-5808,Private      ,1036,400,1436,11048,2060,13108
00221901,TUFTS UNIV SCH OF DENTAL MEDICINE       ,MA,02111-0000,Private      ,2,401,403,31,848,879
00221902,TUFTS UNIVERSITY - CUMMINGS SCHOOL OF VE,MA,01536-0000,Private      ,2,117,119,28,470,498
00221904,TUFTS UNIV SCHOOL OF MEDICINE           ,MA,02111-0000,Private      ,19,353,372,94,2029,2123
00222100,UNIV OF MASSACHUSETTS-AMHERST           ,MA,01003-0000,Public       ,3029,1923,4952,38756,6521,45277
00222200,UNIV OF MASSACHUSETTS-BOSTON            ,MA,02125-3393,Public       ,2433,3813,6246,12642,9509,22151
00222400,WELLESLEY COLLEGE                       ,MA,02481-8203,Private      ,575,48,623,3402,193,3595
00222500,WENTWORTH INSTITUTE OF TECHNOLOGY       ,MA,02115-5998,Private      ,746,327,1073,6125,823,6948
00222600,WESTERN NEW ENGLAND UNIVERSITY          ,MA,01119-2654,Private      ,753,528,1281,6109,1503,7612
00222700,WHEATON COLLEGE                         ,MA,02766-2322,Private      ,338,19,357,2626,98,2724
00222800,WHEELOCK COLLEGE                        ,MA,02215-4176,Private      ,248,247,495,1589,711,2300
00222900,WILLIAMS COLLEGE                        ,MA,01267-2600,Private      ,495,14,509,3585,97,3682
00223300,WORCESTER POLYTECHNIC INSTITUTE         ,MA,01609-2280,Private      ,632,186,818,8250,587,8837
00267104,BARD COLLEGE - LONGY SCHOOL OF MUSIC    ,MA,02138-3599,Private      ,8,37,45,42,129,171
00396500,BAY STATE COLLEGE                       ,MA,02116-2901,Proprietary  ,274,427,701,1051,1089,2140
00396600,BOSTON ARCHITECTURAL COLLEGE            ,MA,02115-2795,Private      ,65,288,353,233,551,784
00466100,HAMPSHIRE COLLEGE                       ,MA,01002-3359,Private      ,466,72,538,2406,207,2613
00466600,SALTER COLLEGE                          ,MA,01583-1700,Proprietary  ,232,1128,1360,289,1509,1798
00466700,SCHOOL OF MUSEUM OF FINE ARTS           ,MA,02115-5534,Private      ,94,75,169,515,267,782
00466900,UPPER CAPE COD REGIONAL VOC TECH        ,MA,02532-3310,Public       ,14,34,48,30,90,120
00527900,GREATER LOWELL REGNL VOC TECH SCH       ,MA,01879-0000,Public       ,11,45,56,24,94,118
00551900,DIMAN REGIONAL VOC TECH INST            ,MA,02723-3519,Public       ,11,48,59,32,144,176
00552300,BLUE HILLS REGIONAL VOC TECH            ,MA,02021-1398,Public       ,13,74,87,29,127,156
00555700,MCCANN TECHNICAL SCHOOL                 ,MA,01247-0000,Public       ,19,39,58,30,61,91
00613600,NATIONAL AVIATION ACADEMY - NEW ENGLAND ,MA,01730-2620,Proprietary  ,29,56,85,75,145,220
00632200,BROCKTON HOSPITAL SCH OF NURSING        ,MA,02302-0000,Private      ,52,247,299,143,492,635
00632400,LABOURE COLLEGE                         ,MA,02124-0000,Private      ,50,401,451,151,769,920
00633100,LAWRENCE MEM HOSPITAL SCH OF NRSNG      ,MA,02155-1643,Private      ,21,152,173,46,288,334
00635200,BAYSTATE MEDICAL CENTER                 ,MA,01199-0001,Private      ,15,32,47,35,77,112
00687300,MARIAN COURT COLLEGE                    ,MA,01907-2896,Private      ,32,44,76,104,87,191
00748100,GIBBS COLLEGE                           ,MA,02116-2904,Proprietary  ,2,14,16,8,26,34
00748400,NEWBURY COLLEGE                         ,MA,02445-5796,Private      ,265,80,345,1891,269,2160
00748600,THE NEW ENGLAND INSTITUTE OF ART        ,MA,02445-7295,Proprietary  ,200,125,325,633,303,936
00748800,KAPLAN CAREER INSTITUTE                 ,MA,02129-1644,Proprietary  ,0,0,0,1,12,13
00807800,SPRINGFIELD TECHNICAL COMMUNITY CLG     ,MA,01105-0000,Public       ,1369,2010,3379,2973,3930,6903
00809002,EVEREST COLLEGE - EVEREST INSTITUTE     ,MA,02150-2333,Proprietary  ,40,123,163,61,201,262
00891600,NEW ENGLAND SCHOOL OF LAW               ,MA,02116-0000,Private      ,2,458,460,22,1401,1423
00964500,BARD COLLEGE AT SIMON'S ROCK            ,MA,01230-9702,Private      ,119,3,122,348,7,355
00974700,GORDON-CONWELL THEOLOGICAL SEMINARY     ,MA,01982-0000,Private      ,1,223,224,6,414,420
00975600,UNIVERSITY OF MASS MEDICAL CENTER       ,MA,01655-0000,Public       ,13,363,376,53,797,850
00987700,HENRI'S SCHOOL OF HAIR DESIGN           ,MA,01420-5675,Proprietary  ,11,15,26,23,29,52
00989900,LOWELL ACADEMY HAIRSTYLING INST         ,MA,01852-1909,Proprietary  ,8,31,39,25,54,79
00993600,MIDDLESEX COMMUNITY COLLEGE             ,MA,01730-1197,Public       ,700,787,1487,1469,1378,2847
00993602,"MIDDLESEX COMMUNITY COLLEGE, LOWELL     ",MA,01852-0000,Public       ,1202,1425,2627,2543,2507,5050
01121000,BUNKER HILL COMMUNITY COLLEGE           ,MA,02129-2991,Public       ,2598,4565,7163,5535,8478,14013
01151000,EVEREST INSTITUTE                       ,MA,02135-7638,Proprietary  ,26,46,72,38,95,133
01193000,ROXBURY COMMUNITY COLLEGE               ,MA,02120-3400,Public       ,297,1115,1412,679,2129,2808
01204200,MANSFIELD BEAUTY SCHOOLS                ,MA,02169-5061,Proprietary  ,9,31,40,15,45,60
01206800,MANSFIELD BEAUTY SCHOOL                 ,MA,01103-1410,Proprietary  ,7,26,33,17,44,61
01218700,BLACKSTONE VALLEY VOCATIONAL REGIONAL SC,MA,01568-1499,Public       ,6,23,29,10,52,62
01238600,SOUTHEASTERN TECHNICAL INSTITUTE        ,MA,02375-1780,Public       ,25,76,101,46,153,199
01246108,LINCOLN TECHNICAL INSTITUTE - BROCKTON  ,MA,02401-1818,Proprietary  ,52,154,206,91,247,338
01246114,LINCOLN TECHNICAL INSTITUTE - LOWELL    ,MA,01852-5119,Proprietary  ,76,151,227,125,244,369
01246115,LINCOLN TECHNICAL INSTITUTE - SOMERVILLE,MA,02145-1102,Proprietary  ,33,159,192,61,237,298
01288100,MONTACHUSETT REG VOC TECH SCH           ,MA,01420-4649,Public       ,10,39,49,32,87,119
01294800,ROB ROY ACADEMY                         ,MA,02721-5330,Proprietary  ,7,18,25,16,31,47
02063000,MONTSERRAT COLLEGE OF ART               ,MA,01915-0000,Private      ,116,24,140,659,64,723
02079400,EMPIRE BEAUTY SCHOOL                    ,MA,01702-5232,Proprietary  ,277,698,975,435,1063,1498
02092100,MASSACHUSETTS SCHOOL OF BARBERING       ,MA,02169-5058,Proprietary  ,5,40,45,14,62,76
02122000,NEW ENGLAND HAIR ACADEMY                ,MA,02148-0000,Proprietary  ,14,52,66,26,71,97
02137000,ROB ROY ACADEMY                         ,MA,02780-0000,Proprietary  ,4,9,13,10,16,26
02137200,MASS GEN HOSP DIETETIC INTERNSHIP       ,MA,02114-0000,Private      ,2,17,19,4,35,39
02163500,NEW ENGLAND SCHOOL OF PHOTOGRAPHY       ,MA,02215-0000,Proprietary  ,21,25,46,60,68,128
02163600,MASS SCH OF PROFESSIONAL PSYCHOLOGY     ,MA,02132-0000,Private      ,8,244,252,24,765,789
02169900,ASSABET VALLEY REGIONAL VOC SCHOOL      ,MA,01752-0000,Public       ,6,44,50,15,89,104
02181600,ROB ROY ACADEMY                         ,MA,01609-0000,Proprietary  ,18,23,41,24,47,71
02182900,CAMBRIDGE COLLEGE                       ,MA,02138-5304,Private      ,94,900,994,246,1700,1946
02197900,NORTH BENNET STREET SCHOOL              ,MA,02113-0000,Private      ,13,43,56,41,119,160
02215100,HALLMARK INSTITUTE OF PHOTOGRAPHY       ,MA,01376-0000,Proprietary  ,42,48,90,105,93,198
02219501,MILDRED ELLEY - PITTSFIELD              ,MA,01201-5300,Proprietary  ,9,40,49,16,70,86
02220400,CATHERINE HINDS INST OF ESTHETICS       ,MA,01801-0000,Proprietary  ,27,59,86,42,110,152
02231600,MGH INSTITUTE OF HEALTH PROFESSION      ,MA,02129-0000,Private      ,25,408,433,70,1343,1413
02274300,CONWAY SCHOOL OF LANDSCAPE DESIGN       ,MA,01341-0179,Private      ,0,10,10,2,23,25
02325700,LABARON HAIRDRESSING ACADEMY            ,MA,02740-0000,Proprietary  ,3,9,12,8,15,23
02325800,LABARON HAIRDRESSING ACAD-BROCKTON      ,MA,02301-0000,Proprietary  ,5,13,18,11,21,32
02337400,BANCROFT SCHOOL OF MASSAGE THERAPY      ,MA,01604-4614,Proprietary  ,10,17,27,17,50,67
02338200,BAY STATE SCHOOL OF TECHNOLOGY          ,MA,02021-0000,Proprietary  ,14,43,57,31,74,105
02339400,ROB ROY ACADEMY                         ,MA,02746-0000,Proprietary  ,2,11,13,6,15,21
02491700,CORTIVA INSTITUTE -  BOSTON             ,MA,02472-2577,Proprietary  ,8,24,32,15,47,62
02523900,ELIZABETH GRADY SCHOOL OF ESTHETICS     ,MA,02155-0000,Proprietary  ,15,41,56,32,104,136
02579800,NEW ENGLAND SCHOOL OF ACUPUNCTURE       ,MA,02458-0000,Private      ,1,67,68,1,112,113
02616704,LE CORDON BLEU COLLEGE OF CULINARY ARTS ,MA,02142-1221,Proprietary  ,36,63,99,137,163,300
03066700,AILANO SCHOOL OF COSMETOLOGY            ,MA,02303-4740,Proprietary  ,5,16,21,11,26,37
03104000,SHAWSHEEN ADULT TECHNICAL INSTITUTE     ,MA,01821-5499,Public       ,3,38,41,13,61,74
03115200,MOTORING TECHNICAL TRAINING INST        ,MA,02771-5933,Proprietary  ,53,91,144,108,166,274
03120800,KAY HARVEY HAIRDRESSING ACADEMY         ,MA,01089-2701,Proprietary  ,7,12,19,19,24,43
03130500,URBAN COLLEGE OF BOSTON                 ,MA,02111-1093,Private      ,19,326,345,39,490,529
03194300,BOSTON GRAD SCH OF PSYCHOANALYSIS       ,MA,02446-4602,Private      ,0,21,21,1,46,47
03205400,JOLIE HAIR & BEAUTY ACADEMY             ,MA,01056-2769,Proprietary  ,12,43,55,20,57,77
03235300,MASSACHUSETTS SCHOOL OF LAW             ,MA,01810-1094,Private      ,0,176,176,2,360,362
03240300,TONI & GUY HAIRDRESSING ACADEMY         ,MA,01605-2213,Proprietary  ,37,47,84,60,68,128
03240301,TONI & GUY HAIRDRESSING ACADEMY - BRAINT,MA,02184-2807,Proprietary  ,46,35,81,62,52,114
03248300,BOSTON BAPTIST COLLEGE                  ,MA,02136-4030,Private      ,22,16,38,56,43,99
03316400,FUNERAL INSTITUTE OF THE NORTHEAST      ,MA,02062-4766,Proprietary  ,15,42,57,25,75,100
03504300,NATL GRAD SCH OF QUALITY SYSTM MGMT     ,MA,02540-0000,Private      ,0,29,29,0,57,57
03570500,NORTHPOINT BIBLE COLLEGE                ,MA,01835-0000,Private      ,74,69,143,161,132,293
03763300,MEDICAL PROFESSIONAL INSTITUTE          ,MA,02148-8143,Proprietary  ,19,143,162,34,267,301
03859300,E.I.N.E.                                ,MA,01876-4709,Proprietary  ,2,14,16,3,32,35
03927303,MARINELLO SCHOOL OF BEAUTY - NORTHAMPTON,MA,01060-3947,Proprietary  ,12,25,37,24,42,66
03946300,FRANKLIN W. OLIN COLLEGE OF ENGINEERING ,MA,02492-1200,Private      ,58,8,66,582,19,601
03965300,NEW ENGLAND COLLEGE OF FINANCE          ,MA,02110-1605,Proprietary  ,32,362,394,78,634,712
04116900,DIGRIGOLI SCHOOL OF COSMETOLOGY         ,MA,01089-4623,Proprietary  ,17,34,51,36,48,84
04122000,TRI COUNTY REGIONAL VOCATIONAL TECHNICAL,MA,02038-0000,Public       ,6,23,29,18,53,71
04128000,MILLENNIUM TRAINING INSTITUTE           ,MA,01801-6386,Proprietary  ,2,52,54,2,77,79
04128900,CENTRAL MASS SCHOOL OF MASSAGE AND THERA,MA,01562-1712,Proprietary  ,1,4,5,5,9,14
04143200,HULT INTERNATIONAL BUSINESS SCHOOL      ,MA,02141-1805,Private      ,10,97,107,91,225,316
04153200,SOUTHERN WORCESTER COUNTY REGIONAL VOC S,MA,01507-1331,Public       ,5,21,26,11,39,50
04193100,ALEXANDER ACADEMY                       ,MA,01420-0000,Proprietary  ,5,21,26,13,33,46
04229200,JUPITER BEAUTY ACADEMY                  ,MA,02122-2834,Proprietary  ,1,8,9,5,13,18
00401200,HEBREW UNIVERSITY OF JERUSALEM (THE)    ,FC,00000-0000,Public       ,3,36,39,13,65,78
00403000,UNIVERSITY OF CAMBRIDGE                 ,FC,00000-0000,Public       ,3,29,32,13,77,90
00503400,AMERICAN UNIVERSITY OF CAIRO            ,FC,00000-0000,Private      ,14,32,46,35,80,115
00667100,KATHOLIEKE UNIVERSITEIT LEUVEN          ,FC,00000-0000,Private      ,0,12,12,0,36,36
00669000,UNIVERSITY OF COPENHAGEN                ,FC,00000-0000,Public       ,0,13,13,2,40,42
00669100,UNIVERSITY OF CAMBRIDGE - PEMBROKE      ,FC,00000-0000,Public       ,0,4,4,0,8,8
00669200,UNIVERSITY OF LEEDS                     ,FC,00000-0000,Public       ,4,30,34,25,85,110
00669300,UNIV OF LONDON-LONDON SCHOOL ECON       ,FC,00000-0000,Public       ,2,147,149,14,372,386
00669400,UNIVERSITY OF LONDON - SCHOOL OF ORIENTA,FC,00000-0000,Public       ,2,57,59,11,150,161
00669500,UNIV OF LONDON-UNIVERSITY COLLEGE       ,FC,00000-0000,Public       ,5,145,150,45,376,421
00669600,UNIV OF LONDON-SCH ADVANCED STUDY       ,FC,00000-0000,Public       ,0,7,7,0,12,12
00669700,"QUEEN MARY, UNIVERSITY OF LONDON        ",FC,00000-0000,Public       ,10,48,58,44,139,183
00669900,UNIVERSITY OF SUSSEX                    ,FC,00000-0000,Public       ,2,19,21,15,61,76
00670000,"UNIVERSITY OF YORK, THE                 ",FC,00000-0000,Public       ,3,52,55,25,146,171
00670400,UNIVERSITY COLLEGE CORK                 ,FC,00000-0000,Public       ,5,22,27,22,64,86
00671300,UPPSALA UNIVERSITY                      ,FC,00000-0000,Public       ,0,8,8,5,34,39
00671500,UNIVERSITY OF GENEVA                    ,FC,00000-0000,Public       ,0,30,30,0,89,89
00683900,UNIVERSITY OF EDINBURGH                 ,FC,00000-0000,Public       ,53,274,327,237,651,888
00684200,UNIVERSITY OF DUBLIN TRINITY COLLEG     ,FC,00000-0000,Public       ,10,83,93,55,187,242
00685000,UNIVERSITY OF CAMBRIDGE - DOWNING C     ,FC,00000-0000,Public       ,1,1,2,1,1,2
00763200,UNIVERSITY OF BRISTOL                   ,FC,00000-0000,Public       ,2,37,39,23,84,107
00768100,COLLEGE OF EUROPE                       ,FC,00000-0000,Private      ,0,2,2,0,8,8
00770500,ROYAL COLLEGE OF SURGEONS IN IRELAN     ,FC,00000-0000,Private      ,3,29,32,9,43,52
00788100,AMERICAN UNIVERSITY OF PARIS            ,FC,00000-0000,Private      ,100,77,177,499,255,754
00837100,AMERICAN UNIVERSITY OF BEIRUT           ,FC,00000-0000,Private      ,18,31,49,54,58,112
00837300,TEL-AVIV UNIVERSITY                     ,FC,00000-0000,Public       ,11,51,62,24,92,116
00837600,VRIJE UNIVERSITEIT AMSTERDAM            ,FC,00000-0000,Public       ,0,15,15,4,38,42
00837700,UNIVERSITEIT VAN AMSTERDAM(UNIVERSI     ,FC,00000-0000,Public       ,3,60,63,11,130,141
00838000,UNIVERSITY OF WARWICK                   ,FC,00000-0000,Public       ,0,16,16,8,53,61
00838300,UNIVERSITY OF GLASGOW                   ,FC,00000-0000,Public       ,14,140,154,74,341,415
00839300,UNIVERSITY OF OSLO                      ,FC,00000-0000,Public       ,3,8,11,9,23,32
00839400,UNIVERSITY OF OXFORD                    ,FC,00000-0000,Public       ,8,114,122,24,253,277
00839800,UNIVERSITY OF SHEFFIELD (THE)           ,FC,00000-0000,Public       ,3,32,35,12,78,90
00839900,UNIVERSITY OF SOUTHAMPTON               ,FC,00000-0000,Public       ,5,18,23,14,59,73
00845200,ABERYSTWYTH UNIVERSITY                  ,FC,00000-0000,Public       ,5,15,20,25,57,82
00845800,LOUGHBOROUGH UNIVERSITY                 ,FC,00000-0000,Public       ,0,6,6,2,14,16
00846000,UNIVERSITY OF NEWCASTLE UPON TYNE       ,FC,00000-0000,Public       ,5,30,35,25,82,107
00846100,UNIVERSITY OF SAINT ANDREWS             ,FC,00000-0000,Private      ,74,62,136,316,147,463
00850500,UNIVERSITY OF MELBOURNE                 ,FC,00000-0000,Public       ,7,40,47,17,114,131
00858600,SWANSEA UNIVERSITY                      ,FC,00000-0000,Public       ,4,17,21,14,46,60
00858700,UNIVERSITY OF DURHAM                    ,FC,00000-0000,Public       ,12,70,82,34,179,213
00866500,UNIVERSITY OF KENT AT CANTERBURY (THE)  ,FC,00000-0000,Public       ,7,61,68,41,147,188
00867000,UNIVERSITY OF NEW SOUTH WALES           ,FC,00000-0000,Public       ,8,27,35,19,68,87
00868700,UNIVERSITY OF ESSEX                     ,FC,00000-0000,Public       ,4,45,49,31,143,174
00869300,CITY UNIVERSITY                         ,FC,00000-0000,Public       ,8,64,72,30,163,193
00890800,THE UNIVERSITY OF BIRMINGHAM            ,FC,00000-0000,Public       ,1,40,41,24,106,130
00891000,UNIVERSITY OF HULL                      ,FC,00000-0000,Public       ,0,6,6,4,13,17
00892000,UNIVERSITY OF NOTTINGHAM                ,FC,00000-0000,Public       ,6,32,38,26,82,108
00900600,UNIVERSITY OF SALFORD (THE)             ,FC,00000-0000,Public       ,1,8,9,9,17,26
00908400,"UNIV OF LONDON, BIRKBECK                ",FC,00000-0000,Public       ,5,34,39,10,81,91
00908500,UNIV OF LONDON KING'S COLLEGE           ,FC,00000-0000,Public       ,12,163,175,120,388,508
00908600,UNIVERSITY OF LONDON - ROYAL HOLLOWAY   ,FC,00000-0000,Public       ,8,29,37,34,73,107
00914300,BAR-ILAN UNIVERSITY                     ,FC,00000-0000,Private      ,4,9,13,11,18,29
00924900,UNIVERSITY OF LIVERPOOL                 ,FC,00000-0000,Public       ,2,33,35,17,93,110
00936800,UNIVERSITY OF ABERDEEN                  ,FC,00000-0000,Public       ,8,56,64,48,134,182
00942300,ROYAL COLLEGE OF ART                    ,FC,00000-0000,Public       ,3,15,18,7,41,48
00942800,TECHNION-ISRAEL INST OF TECHLGY         ,FC,00000-0000,Public       ,3,20,23,5,39,44
00944200,UNIVERSITY OF EXETER                    ,FC,00000-0000,Public       ,2,31,33,24,85,109
00944400,UNIVERSITY OF LANCASTER                 ,FC,00000-0000,Public       ,0,16,16,9,38,47
00963400,UNIVERSITY OF OXFORD ST CATHERINE'S     ,FC,00000-0000,Public       ,0,4,4,1,5,6
00980800,UNIVERSITY OF STRATHCLYDE               ,FC,00000-0000,Public       ,3,16,19,14,42,56
00986000,UNIVERSITY OF SURREY                    ,FC,00000-0000,Public       ,1,10,11,12,38,50
00988800,KAROLINSKA INSTITUTET                   ,FC,00000-0000,Public       ,0,2,2,0,11,11
00990600,PONTIFICAL NORTH AMERICAN COLLEGE       ,FC,00000-0000,Private      ,0,0,0,0,2,2
00992700,UNIVERSITY OF CAMBRIDGE - FITZWILLI     ,FC,00000-0000,Public       ,0,5,5,0,6,6
01006700,LUND UNIVERSITY                         ,FC,00000-0000,Public       ,1,24,25,10,81,91
01008400,UNIVERSITY OF CAPE TOWN                 ,FC,00000-0000,Public       ,3,17,20,11,54,65
01008700,UNIVERSITY OF OXFORD ST PETER'S COL     ,FC,00000-0000,Public       ,0,4,4,0,4,4
01008800,UNIVERSITY OF OXFORD - CORPUS CHRIS     ,FC,00000-0000,Public       ,0,0,0,1,2,3
01008900,CENTRAL SCHOOL OF SPEECH AND DRAMA      ,FC,00000-0000,Private      ,4,24,28,19,62,81
01009000,UNIVERSITY OF OXFORD - BALLIOL COLL     ,FC,00000-0000,Public       ,1,2,3,2,7,9
01014300,UNIVERSITY OF READING                   ,FC,00000-0000,Public       ,2,20,22,9,48,57
01015700,CARDIFF UNIVERSITY                      ,FC,00000-0000,Public       ,5,21,26,28,61,89
01015900,PONTIFICIA UNIVERSITA GREGORIANA        ,FC,00000-0000,Private      ,0,1,1,1,2,3
01016000,CG JUNG INST                            ,FC,00000-0000,Private      ,0,1,1,0,2,2
01018800,UNIVERSITY COLLEGE DUBLIN               ,FC,00000-0000,Public       ,11,82,93,63,231,294
01019000,UNIVERSITY OF CAMBRIDGE CHURCHILL C     ,FC,00000-0000,Public       ,0,1,1,1,2,3
01022800,UNIVERSITY OF STIRLING                  ,FC,00000-0000,Public       ,9,18,27,32,49,81
01033200,UNIVERSITY OF CAMBRIDGE - CLARE COL     ,FC,00000-0000,Public       ,0,2,2,1,7,8
01045600,UNIVERSITY OF HAIFA                     ,FC,00000-0000,Public       ,2,19,21,5,45,50
01047200,INST EUROPEEN OPEEN D'ADMINISTRATIO     ,FC,00000-0000,Private      ,0,25,25,0,52,52
01049300,CRANFIELD UNIVERSITY                    ,FC,00000-0000,Public       ,0,6,6,0,19,19
01052000,TRINITY LABAN CONSERVATOIRE OF MUSIC AND,FC,00000-0000,Public       ,0,7,7,3,14,17
01052500,UNIVERSITY OF HERTFORDSHIRE             ,FC,00000-0000,Public       ,5,9,14,31,24,55
01057400,LONDON INTRNTL FILM SCHOOL              ,FC,00000-0000,Private      ,1,9,10,8,18,26
01058800,AUSTRALIAN NATIONAL UNIVERSITY          ,FC,00000-0000,Public       ,2,11,13,9,31,40
01058900,BANGOR UNIVERSITY                       ,FC,00000-0000,Public       ,6,6,12,20,22,42
01059400,"RICHMOND, THE AMERICAN INT UNI IN LONDON",FC,00000-0000,Private      ,70,29,99,389,77,466
01059900,INST D'ETUDES POLITIQUES DE PARIS       ,FC,00000-0000,Public       ,2,30,32,9,109,118
01068100,MACQUARIE UNIVERSITY                    ,FC,00000-0000,Public       ,3,12,15,7,20,27
01069200,UNIVERSITY OF QUEENSLAND (THE)          ,FC,00000-0000,Public       ,2,52,54,9,140,149
01078900,UNIVERSITY OF OXFORD - WORCESTER CO     ,FC,00000-0000,Public       ,0,3,3,0,3,3
01079700,"NATIONAL UNIVERSITY OF IRELAND, MAY     ",FC,00000-0000,Public       ,5,7,12,13,14,27
01081600,KINGSTON UNIVERSITY                     ,FC,00000-0000,Public       ,12,74,86,58,194,252
01083800,UNIVERSITITY OF BERGEN (UOB)            ,FC,00000-0000,Public       ,0,2,2,3,6,9
01086400,UNIV OF DUNDEE                          ,FC,00000-0000,Public       ,1,16,17,4,37,41
01086600,UNIVERSITY OF OXFORD - MAGDALEN COLLEGE ,FC,00000-0000,Public       ,0,1,1,1,9,10
01086700,UNIVERSITY OF OXFORD ST JOHN'S COLL     ,FC,00000-0000,Public       ,0,1,1,0,3,3
01091400,MONASH UNIVERSITY                       ,FC,00000-0000,Public       ,1,14,15,4,31,35
01091500,UNIV OF EAST ANGLIA                     ,FC,00000-0000,Public       ,4,42,46,22,90,112
01094200,UNIVERSITY OF OXFORD - ST HUGH'S CO     ,FC,00000-0000,Public       ,0,7,7,0,8,8
01097700,UNIVERSIDAD CENTRAL DEL ESTE            ,FC,00000-0000,Private      ,7,38,45,18,87,105
01098000,SOMERVILLE COLLEGE                      ,FC,00000-0000,Public       ,0,1,1,0,2,2
01099900,UNIV OF OXFORD - WADHAM COLLEGE         ,FC,00000-0000,Public       ,0,0,0,0,3,3
01104400,PONTIFICIA UNIVERSITA SAN TOMMASO       ,FC,00000-0000,Private      ,0,0,0,0,1,1
01105300,UNIVERSITY OF OXFORD - ST HILDA'S C     ,FC,00000-0000,Public       ,0,1,1,0,2,2
01105400,UNIVERSITY OF OXFORD - ST ANNE'S CO     ,FC,00000-0000,Public       ,0,5,5,1,8,9
01105500,UNIV OF OXFORD - LADY MARGARET HALL     ,FC,00000-0000,Public       ,0,3,3,0,5,5
01105600,UNIVERSITY OF OXFORD - UNIVERSITY C     ,FC,00000-0000,Public       ,5,21,26,14,46,60
01105700,UNIVERSITY OF OXFORD - TRINITY COLL     ,FC,00000-0000,Public       ,1,2,3,2,5,7
01105800,UNIVERSITY OF OXFORD-ST EDMUND HALL     ,FC,00000-0000,Public       ,0,4,4,1,8,9
01105900,UNIVERSITY OF OXFORD ST ANTONY'S CO     ,FC,00000-0000,Public       ,0,10,10,0,17,17
01106000,UNIVERSITY OF OXFORD - QUEEN'S COLL     ,FC,00000-0000,Public       ,0,1,1,0,4,4
01106100,UNIVERSITY OF OXFORD - PEMBROKE COL     ,FC,00000-0000,Public       ,0,4,4,0,6,6
01106200,UNIVERSITY OF OXFORD - ORIEL COLLEG     ,FC,00000-0000,Public       ,0,4,4,0,6,6
01106300,UNIVERSITY OF OXFORD - NUFFIELD COL     ,FC,00000-0000,Public       ,0,4,4,0,4,4
01106400,UNIVERSITY OF OXFORD - NEW COLLEGE      ,FC,00000-0000,Public       ,0,0,0,3,4,7
01106500,UNIVERSITY OF OXFORD MERTON COLLEGE     ,FC,00000-0000,Public       ,1,1,2,1,3,4
01106600,UNIVERSITY OF OXFORD - LINCOLN COLL     ,FC,00000-0000,Public       ,0,3,3,0,5,5
01106700,UNIVERSITY OF OXFORD - KEBLE COLLEG     ,FC,00000-0000,Public       ,0,1,1,0,3,3
01106800,UNIVERSITY OF OXFORD - JESUS COLLEG     ,FC,00000-0000,Public       ,1,2,3,1,4,5
01106900,UNIVERSITY OF OXFORD - HERTFORD COL     ,FC,00000-0000,Public       ,0,2,2,0,2,2
01107000,UNIVERSITY OF OXFORD EXETER COLLEGE     ,FC,00000-0000,Public       ,0,1,1,1,6,7
01107100,UNIV OF OXFORD - CHRIST CHURCH          ,FC,00000-0000,Public       ,0,4,4,0,7,7
01107200,UNIVERSITY OF OXFORD - BRASENOSE CO     ,FC,00000-0000,Public       ,0,0,0,0,6,6
01109100,FLINDERS UNIVERSITY OF S AUSTRALIA      ,FC,00000-0000,Public       ,0,4,4,1,17,18
01109400,UNIVERSITY OF WESTERN AUSTRALIA (THE)   ,FC,00000-0000,Public       ,0,4,4,1,17,18
01121400,UNIVERSITY OF THE WITWATERSRAND         ,FC,00000-0000,Public       ,1,3,4,3,12,15
01122600,AARHUS UNIVERSITY                       ,FC,00000-0000,Public       ,0,8,8,2,22,24
01156700,"IMPERIAL COLLEGE OF SCIENCE, TECHNOLOGY ",FC,00000-0000,Public       ,5,20,25,21,56,77
01167900,UNIVERSITY OF BATH                      ,FC,00000-0000,Public       ,2,17,19,19,30,49
01168300,FRANKLIN COLLEGE  SWITZERLAND           ,FC,00000-0000,Private      ,24,3,27,300,16,316
01175800,UNIV OF CAMBRIDGE - PETERHOUSE          ,FC,00000-0000,Public       ,0,2,2,0,3,3
01176400,ROYAL ACADEMY OF MUSIC                  ,FC,00000-0000,Public       ,1,3,4,11,12,23
01176500,GOLDSMITHS' COLLEGE-UNIV OF LONDON      ,FC,00000-0000,Public       ,15,61,76,51,157,208
01176600,UNIV OF LONDON - INST OF EDUC           ,FC,00000-0000,Public       ,0,12,12,0,36,36
01178000,BRUNEL UNIVERSITY                       ,FC,00000-0000,Public       ,3,16,19,13,42,55
01183800,UNIVERSITY OF OXFORD - MANSFIELD CO     ,FC,00000-0000,Public       ,0,2,2,0,3,3
01207500,UNIVERSITY CAMBRIDGE - TRINITY COLL     ,FC,00000-0000,Public       ,1,1,2,1,6,7
01207800,VICTORIA UNIV OF WELLINGTON             ,FC,00000-0000,Public       ,0,6,6,9,23,32
01209600,ECOLE HÔTELIERE DE LAUSANNE             ,FC,00000-0000,Private      ,3,6,9,7,12,19
01210100,UNIVERSITY OF CAMBRIDGE - GIRTON CO     ,FC,00000-0000,Public       ,0,6,6,0,10,10
01213600,VICTORIA UNIV OF MANCHESTER (THE)       ,FC,00000-0000,Public       ,6,51,57,37,123,160
01219800,UNIVERSITY OF BRADFORD                  ,FC,00000-0000,Public       ,2,10,12,4,22,26
01220100,UNIVERSITY OF OXFORD - REGENT'S PAR     ,FC,00000-0000,Public       ,0,1,1,3,2,5
01220600,JAMES COOK UNIVERSITY                   ,FC,00000-0000,Public       ,6,18,24,12,39,51
01221500,BIRMINGHAM CITY UNIVERSITY              ,FC,00000-0000,Public       ,3,10,13,10,26,36
01222300,JAGIELLONIAN UNIVERSITY COLLEGIUM M     ,FC,00000-0000,Public       ,1,7,8,5,16,21
01222500,UNIVERSITY OF SZEGED FACULTY OF MEDICINE,FC,00000-0000,Public       ,0,4,4,2,5,7
01225800,ASTON UNIVERSITY                        ,FC,00000-0000,Public       ,0,6,6,2,14,16
01227500,UNIVERSITY OF OXFORD - WOLFSON COLL     ,FC,00000-0000,Public       ,0,12,12,0,17,17
01230200,GONVILLE & CAIUS COLLEGE                ,FC,00000-0000,Public       ,0,1,1,0,1,1
01233500,ROYAL COLLEGE OF MUSIC                  ,FC,00000-0000,Public       ,1,9,10,8,17,25
01234100,UNIVERSITY OF WALES - ST DAVID'S UN     ,FC,00000-0000,Public       ,0,7,7,1,11,12
01242100,UNIV OF AUCKLAND                        ,FC,00000-0000,Public       ,6,13,19,19,55,74
01254000,UNIVERSIDAD DE NAVARRA                  ,FC,00000-0000,Private      ,3,6,9,5,19,24
01276500,UNIVERSITY OF OXFORD - LINACRE COLL     ,FC,00000-0000,Public       ,0,0,0,0,3,3
01276600,"NATIONAL UNIVERSITY IRELAND, GALWAY     ",FC,00000-0000,Public       ,9,42,51,25,94,119
01280200,PONTIFICIA UNIV CATOLICA MAD Y MAES     ,FC,00000-0000,Private      ,40,29,69,61,66,127
01281100,INST TECNOLOGICO DE SANTO DOMINGO       ,FC,00000-0000,Private      ,16,24,40,28,47,75
01283900,UNIVERSITY OF CAMBRIDGE - SAINT JOH     ,FC,00000-0000,Public       ,0,2,2,1,8,9
01297800,UNIVERSITY OF HUDDERSFIELD (THE)        ,FC,00000-0000,Public       ,4,4,8,13,14,27
01315300,MASSEY UNIVERSITY                       ,FC,00000-0000,Public       ,1,6,7,5,35,40
02052400,DARWIN COLLEGE                          ,FC,00000-0000,Public       ,0,5,5,0,8,8
02082400,UNIVERSITY OF CAMBRIDGE - QUEEN'S C     ,FC,00000-0000,Public       ,0,1,1,0,6,6
02083400,UNIVERSITY OF CAMBRIDGE - WOLFSON C     ,FC,00000-0000,Public       ,0,7,7,0,13,13
02087400,UNIVERSITY OF CAMBRIDGE - NEWNHAM C     ,FC,00000-0000,Public       ,0,3,3,1,6,7
02087900,OXFORD BROOKES UNIVERSITY               ,FC,00000-0000,Public       ,6,27,33,27,69,96
02094100,BEN-GURION UNIV                         ,FC,00000-0000,Public       ,0,41,41,0,104,104
02094400,UNIV OF CAMBRIDGE - ST EDMUND'S HOU     ,FC,00000-0000,Public       ,0,4,4,0,9,9
02095500,LONDON BUS SCHOOL                       ,FC,00000-0000,Public       ,0,50,50,1,97,98
02101900,ROEHAMPTON UNIVERSITY                   ,FC,00000-0000,Public       ,10,35,45,34,83,117
02108600,LONDON ACADEMY OF MUSIC & DRAMATIC      ,FC,00000-0000,Private      ,7,14,21,31,45,76
02115900,UNIVERSITY OF PORTSMOUTH                ,FC,00000-0000,Public       ,1,5,6,12,14,26
02116700,UNIVERSITY OF CAMBRIDGE - LUCY CAVE     ,FC,00000-0000,Public       ,0,2,2,0,6,6
02120000,UNIV OF LONDON - COURTALD INST OF A     ,FC,00000-0000,Public       ,0,10,10,2,21,23
02133400,UNIVERSITY OF CAMBRIDGE - SIDNEY SU     ,FC,00000-0000,Public       ,1,2,3,2,7,9
02142000,UNIVERSITY OF CAMBRIDGE - HOMERTON      ,FC,00000-0000,Public       ,0,2,2,0,5,5
02149700,UNIVERSITY OF WINCHESTER (THE)          ,FC,00000-0000,Public       ,3,6,9,19,15,34
02156800,UNIV OF OTAGO                           ,FC,00000-0000,Public       ,0,8,8,8,30,38
02162300,"IESE BUSINESS SCH, UNIV OF NAVARRA      ",FC,00000-0000,Private      ,2,21,23,4,55,59
02167400,UNIVERSITY OF CAMBRIDGE - CORPUS CH     ,FC,00000-0000,Public       ,0,0,0,0,3,3
02177700,KING'S COLLEGE- UNIV OF CAMBRIDGE       ,FC,00000-0000,Public       ,2,6,8,11,22,33
02180500,MIDDLESEX UNIVERSITY                    ,FC,00000-0000,Public       ,12,31,43,44,86,130
02181000,UNIVERSITY OF SOUTH AUSTRALIA           ,FC,00000-0000,Public       ,1,3,4,6,6,12
02183500,UNIV OF OXFORD - WYCLIFFE HALL          ,FC,00000-0000,Public       ,1,6,7,2,9,11
02186000,UNIVERSITY OF CAMBRIDGE - MAGDALENE     ,FC,00000-0000,Public       ,0,2,2,2,6,8
02186100,UNIVERSITY OF CAMBRIDGE - EMMANUEL      ,FC,00000-0000,Public       ,0,2,2,0,4,4
02189600,UNIVERSITY OF GRONINGEN                 ,FC,00000-0000,Public       ,0,2,2,1,13,14
02194800,UNIVERSITY OF THE WEST OF ENGLAND -     ,FC,00000-0000,Public       ,0,9,9,7,11,18
02195100,UNIV OF WESTMINSTER                     ,FC,00000-0000,Public       ,12,42,54,54,104,158
02196700,GUILDHALL SCHOOL OF MUSIC & DRAMA       ,FC,00000-0000,Public       ,4,3,7,11,13,24
02207300,UNIVERSITY OF CAMBRIDGE - CHRIST'S      ,FC,00000-0000,Public       ,1,1,2,1,6,7
02207400,CHINESE UNIVERSITY OF HONG KONG (THE)   ,FC,00000-0000,Public       ,2,3,5,13,30,43
02209500,UNIVERSITEIT UTRECHT                    ,FC,00000-0000,Public       ,2,16,18,9,53,62
02210000,UNIV OF LONDON - LONDON SCHOOL OF H     ,FC,00000-0000,Public       ,0,42,42,0,75,75
02225300,UNIVERSITY OF CANTERBURY                ,FC,00000-0000,Public       ,2,4,6,8,23,31
02229100,UNIVERSITY OF LEICESTER                 ,FC,00000-0000,Public       ,2,39,41,10,107,117
02229600,SACKLER SCHOOL OF MEDICINE              ,FC,00000-0000,Public       ,0,89,89,0,126,126
02232100,UNIVERSITY OF CAMBRIDGE                 ,FC,00000-0000,Public       ,1,10,11,1,27,28
02233300,"ST GEORGE'S UNIVERSITY, SCHOOL OF MEDICI",FC,00000-0000,Proprietary  ,4,1993,1997,14,3188,3202
02235300,LONDON METROPOLITAN UNIVERSITY          ,FC,00000-0000,Public       ,14,32,46,29,76,105
02244400,AMERICAN UNIV OF THE CARIBBEAN          ,FC,00000-0000,Proprietary  ,2,421,423,9,1238,1247
02266600,UNIVERSITY OF LONDON - SAINT GEORGE     ,FC,00000-0000,Public       ,0,21,21,2,39,41
02271700,UNIVERSITY OF CAMBRIDGE - CLARE HAL     ,FC,00000-0000,Public       ,1,3,4,1,4,5
02271900,UNIVERSITY OF OXFORD - BLACKFRIARS      ,FC,00000-0000,Public       ,0,1,1,0,1,1
02272200,UNIV OF CAMBRIDGE - NEW HALL            ,FC,00000-0000,Public       ,0,1,1,1,2,3
02273600,QUEEN'S UNIV OF BELFAST (THE)           ,FC,00000-0000,Public       ,2,22,24,7,58,65
02273900,HERIOT WATT UNIVERSITY                  ,FC,00000-0000,Public       ,2,11,13,11,27,38
02276700,NYENRODE BUSINESS UNIVERSITEIT          ,FC,00000-0000,Private      ,0,2,2,0,6,6
02293400,ECOLE DES HAUTES ETUDES COMERCIALS      ,FC,00000-0000,Public       ,0,11,11,0,23,23
02296300,UNIVERSITY OF CAMBRIDGE - JESUS COL     ,FC,00000-0000,Public       ,0,4,4,0,9,9
02310500,DE MONTFORT UNIVERSITY                  ,FC,00000-0000,Public       ,1,3,4,3,8,11
02320500,ROYAL NORTHERN COLLEGE OF MUSIC         ,FC,00000-0000,Public       ,0,4,4,2,8,10
02335100,UNIV OF CAMBRIDGE - TRINITY HALL        ,FC,00000-0000,Public       ,1,2,3,2,7,9
02338900,UNIVERSITY  FOR THE CREATIVE ARTS       ,FC,00000-0000,Public       ,2,4,6,6,7,13
02351800,UNIVERSIDAD IBEROAMERICANA (UNIBE       ,FC,00000-0000,Private      ,42,173,215,74,278,352
02352100,UNIVERSITY OF PLYMOUTH                  ,FC,00000-0000,Public       ,2,10,12,10,19,29
02493000,ESCUELA SUPERIOR ADMINISTRACION Y D     ,FC,00000-0000,Private      ,0,6,6,0,27,27
02496700,NATIONAL FILM & TV SCHOOL               ,FC,00000-0000,Public       ,1,3,4,3,8,11
02545700,GLASGOW SCHOOL OF ART                   ,FC,00000-0000,Public       ,2,14,16,7,28,35
02561600,SOUTHAMPTON SOLENT UNIVERSITY           ,FC,00000-0000,Public       ,3,6,9,9,9,18
02579600,MURDOCH UNIVERSITY                      ,FC,00000-0000,Public       ,0,5,5,2,24,26
02588000,UNIVERSITY OF ULSTER                    ,FC,00000-0000,Public       ,4,6,10,6,17,23
02591800,CURTIN UNIVERSITY OF TECHNOLOGY         ,FC,00000-0000,Public       ,1,5,6,1,10,11
02611700,DUBLIN CITY UNIVERSITY                  ,FC,00000-0000,Public       ,3,7,10,15,34,49
02623200,UNIVERSITY OF NEWCASTLE (THE)           ,FC,00000-0000,Public       ,3,7,10,5,12,17
03012700,UNIVERSITY OF BUCKINGHAM                ,FC,00000-0000,Private      ,1,5,6,4,13,17
03029400,KEELE UNIVERSITY                        ,FC,00000-0000,Public       ,3,3,6,13,14,27
03029500,NORTHUMBRIA UNIVERSITY                  ,FC,00000-0000,Public       ,1,13,14,10,26,36
03033300,MANCHESTER METROPOLITAN UNIV            ,FC,00000-0000,Public       ,9,17,26,35,41,76
03045000,UNIVERSITY OF EAST LONDON               ,FC,00000-0000,Public       ,13,22,35,32,64,96
03050100,STUDIO ART CENTERS INTERNATIONAL        ,FC,00000-0000,Private      ,1,8,9,10,55,65
03066800,PONTIFICIO ATENEO DELLA SANTA CROCE     ,FC,00000-0000,Private      ,0,1,1,0,1,1
03067200,UNIVERSITY OF SYDNEY                    ,FC,00000-0000,Public       ,8,50,58,26,146,172
03073800,UNIV OF DEBRECEN MED & HEALTH SCI       ,FC,00000-0000,Public       ,2,9,11,5,13,18
03078700,UNIVERSITA COMMERCIALE L BOCCONI        ,FC,00000-0000,Private      ,1,9,10,2,10,12
03080300,SHEFFIELD HALLAM UNIVERSITY             ,FC,00000-0000,Public       ,1,3,4,2,7,9
03084300,UNIVERSITY OF LIMERICK                  ,FC,00000-0000,Public       ,7,20,27,22,59,81
03088700,ROYAL SCOTTISH ACAD MUSIC & DRAMA       ,FC,00000-0000,Public       ,5,11,16,22,27,49
03091400,UNIVERSITY OF WOLLONGONG                ,FC,00000-0000,Public       ,2,2,4,3,12,15
03091500,UNIVERSITY OF CANBERRA                  ,FC,00000-0000,Public       ,0,0,0,2,2,4
03091700,POZNAN UNIVERSITY OF MEDICAL SCIENCES   ,FC,00000-0000,Public       ,0,15,15,5,32,37
03092500,NOTTINGHAM TRENT UNIVERSITY             ,FC,00000-0000,Public       ,3,13,16,9,25,34
03095000,RMIT UNIVERSITY                         ,FC,00000-0000,Public       ,2,11,13,6,25,31
03095400,BOND UNIVERSITY                         ,FC,00000-0000,Private      ,3,15,18,14,36,50
03095900,ESSEC BUSINESS SCHOOL                   ,FC,00000-0000,Private      ,0,4,4,1,12,13
03096100,LA TROBE UNIVERSITY                     ,FC,00000-0000,Public       ,3,10,13,3,20,23
03096900,DEAKIN UNIVERSITY                       ,FC,00000-0000,Public       ,0,3,3,3,8,11
03097100,UNIVERSITY OF WESTERN SYDNEY            ,FC,00000-0000,Public       ,0,2,2,1,3,4
03097300,VICTORIA UNIVERSITY OF TECHNOLOGY       ,FC,00000-0000,Public       ,1,5,6,4,9,13
03097500,CENTRAL QUEENSLAND UNIVERSITY           ,FC,00000-0000,Public       ,0,2,2,0,6,6
03100000,UNIVERSITY OF ADELAIDE (THE)            ,FC,00000-0000,Public       ,0,3,3,2,13,15
03101600,ASIAN INSTITUTE OF MANAGEMENT           ,FC,00000-0000,Private      ,0,4,4,1,8,9
03102500,AMERICAN UNIVERSITY OF ROME             ,FC,00000-0000,Private      ,30,25,55,137,55,192
03102800,ROBERT GORDON UNIVERSITY (THE)          ,FC,00000-0000,Public       ,0,9,9,2,29,31
03104800,GRIFFITH UNIVERSITY                     ,FC,00000-0000,Public       ,6,10,16,13,28,41
03136300,AUSTRALIAN CATHOLIC UNIVERSITY          ,FC,00000-0000,Public       ,0,1,1,2,4,6
03140300,EDITH COWAN UNIVERSITY                  ,FC,00000-0000,Public       ,0,0,0,1,1,2
03140400,NORTHERN TERRITORY UNIVERSITY           ,FC,00000-0000,Public       ,0,1,1,0,1,1
03140500,QUEENSLAND UNIVERSITY OF TECHNOLOGY     ,FC,00000-0000,Public       ,1,8,9,2,12,14
03140600,SOUTHERN CROSS UNIVERSITY               ,FC,00000-0000,Public       ,0,3,3,0,8,8
03140700,SWINBURNE UNIVERSITY OF TECHNOLOGY      ,FC,00000-0000,Public       ,1,4,5,1,8,9
03150400,"UNIVERSITY OF TECHNOLOGY, SYDNEY        ",FC,00000-0000,Public       ,1,4,5,4,20,24
03287300,LIVERPOOL INSTITUTE FOR PERFORMING ARTS ,FC,00000-0000,Public       ,4,0,4,15,1,16
03300300,"2ND SCHOOL OF MEDICINE, CHARLES UNI     ",FC,00000-0000,Public       ,2,4,6,4,9,13
03300400,"FIRST FACULTY OF MEDICINE, CHARLES UNIV.",FC,00000-0000,Public       ,0,10,10,2,16,18
03329300,JOHN CABOT UNIVERSITY                   ,FC,00000-0000,Private      ,23,6,29,171,28,199
03333300,MEDICAL UNIVERSITY SCHOOL OF LUBLIN     ,FC,00000-0000,Public       ,2,31,33,4,79,83
03334300,UNIVERSIDAD NORDESTANA                  ,FC,00000-0000,Private      ,1,8,9,10,36,46
03335300,MEDICAL UNIVERSITY OF SILESIA           ,FC,00000-0000,Public       ,0,5,5,2,18,20
03342300,GLASGOW CALEDONIAN UNIVERSITY           ,FC,00000-0000,Public       ,5,10,15,7,23,30
03349400,"QUEEN MARGARET UNIVERSITY, EDINBURGH    ",FC,00000-0000,Public       ,0,8,8,2,21,23
03350300,BOURNEMOUTH UNIVERSITY                  ,FC,00000-0000,Public       ,2,7,9,9,23,32
03352300,LONDON SOUTH BANK UNIVERSITY            ,FC,00000-0000,Private      ,3,12,15,14,32,46
03364300,"FACULTY OF MEDICINE, PALACKY UNIVER     ",FC,00000-0000,Public       ,0,0,0,1,1,2
03365400,AUCKLAND INSTITUTE OF TECHNOLOGY        ,FC,00000-0000,Public       ,0,0,0,4,2,6
03378300,"THE 3RD FACULTY OF MEDICINE, CHARLE     ",FC,00000-0000,Public       ,0,0,0,0,1,1
03418400,NAPIER UNIVERSITY                       ,FC,00000-0000,Public       ,2,26,28,12,59,71
03435300,ANGLIA  RUSKIN UNIVERSITY               ,FC,00000-0000,Private      ,1,9,10,17,32,49
03460300,INTERNATIONALES THEOLOGISCHES INSTI     ,FC,00000-0000,Private      ,1,1,2,1,3,4
03473300,UNIV OF ARTS LONDON - LON COLL FASHION  ,FC,00000-0000,Public       ,53,80,133,143,139,282
03478300,ROYAL WELSH COLLEGE OF MUSIC AND DRAMA  ,FC,00000-0000,Public       ,4,6,10,21,18,39
03492300,UNIVERSITY OF OXFORD - GREEN TEMPLETON C,FC,00000-0000,Public       ,0,13,13,0,15,15
03492400,UNIV OF CAMBRIDGE-ST CATHERINE'S CG     ,FC,00000-0000,Public       ,0,1,1,1,4,5
03494400,UNIV OF CAMBRIDGE-SELWYN COLLEGE        ,FC,00000-0000,Public       ,0,1,1,0,3,3
03494600,UNIV OF OXFORD-HARRIS MANCHESTER        ,FC,00000-0000,Public       ,0,0,0,3,4,7
03501400,LEEDS METROPOLITAN UNIVERSITY           ,FC,00000-0000,Public       ,3,18,21,12,39,51
03507300,UNIVERSITY OF SUNDERLAND                ,FC,00000-0000,Public       ,4,2,6,9,6,15
03515300,UNIVERSITY OF CENTRAL LANCASHIRE        ,FC,00000-0000,Public       ,5,9,14,13,24,37
03517300,UNIVERSITY OF BRIGHTON                  ,FC,00000-0000,Public       ,3,9,12,20,26,46
03518300,EUROPEAN GRADUATE SCHOOL                ,FC,00000-0000,Private      ,0,42,42,0,82,82
03527300,SOFIA UNIVERSITY ST. KLIMENT OHRIDSKI   ,FC,00000-0000,Public       ,0,1,1,2,5,7
03533300,BATH SPA UNIVERSITY                     ,FC,00000-0000,Public       ,3,4,7,10,12,22
03547300,UNIVERSITY OF GLAMORGAN                 ,FC,00000-0000,Public       ,1,3,4,2,7,9
03580300,LIVERPOOL JOHN MOORES UNIVERSITY        ,FC,00000-0000,Public       ,2,1,3,5,7,12
03589400,ARTS INSTITUTE AT BOURNEMOUTH (THE)     ,FC,00000-0000,Public       ,5,3,8,20,15,35
03590300,AVONDALE COLLEGE LIMITED                ,FC,00000-0000,Private      ,0,1,1,1,1,2
03594300,GROUP ESC GRENOBLE GRAD SCH OF BUS.     ,FC,00000-0000,Private      ,0,11,11,1,25,26
03597300,JAGIELLONIAN UNIVERSITY                 ,FC,00000-0000,Public       ,2,7,9,8,15,23
03601300,UNIVERSITAT JAUME I DE CASTELLO (UJI)   ,FC,00000-0000,Public       ,0,0,0,0,2,2
03619300,UNIVERSITY OF GREENWICH                 ,FC,00000-0000,Public       ,10,20,30,29,44,73
03653400,UNIVERSIDAD DE IBEROAMERICA - UNIBE     ,FC,00000-0000,Private      ,0,2,2,2,16,18
03674300,UNIVERSITY OF ABERTAY DUNDEE            ,FC,00000-0000,Public       ,0,1,1,3,3,6
03684400,UNIVERSITY OF LINCOLN                   ,FC,00000-0000,Public       ,3,8,11,6,21,27
03684500,MEDICAL UNIVERSITY OF GDANSK            ,FC,00000-0000,Public       ,0,0,0,1,10,11
03694300,UNIVERSITY OF CHICHESTER                ,FC,00000-0000,Public       ,3,1,4,4,1,5
03716300,"UNIVERSITY OF WALES, NEWPORT            ",FC,00000-0000,Public       ,1,5,6,2,6,8
03727400,UNIVERSITY OF WAIKATO (THE)             ,FC,00000-0000,Public       ,2,2,4,5,7,12
03728300,UNIVERSITY OF DERBY                     ,FC,00000-0000,Public       ,0,5,5,1,7,8
03738300,LONDON SCHOOL OF THEOLOGY               ,FC,00000-0000,Private      ,0,2,2,0,7,7
03741300,ALRA (ACADEMY OF LIVE AND RECORDED ARTS),FC,00000-0000,Private      ,3,1,4,6,8,14
03770300,NAZARENE THEOLOGICAL COLLEGE            ,FC,00000-0000,Private      ,0,1,1,0,2,2
03780300,SABA UNIVERSITY SCHOOL OF MEDICINE      ,FC,00000-0000,Proprietary  ,2,89,91,3,275,278
03784300,MEDICAL UNIVERSITY OF BIALYSTOK         ,FC,00000-0000,Public       ,0,0,0,1,1,2
03794400,ANGLO EUROPEAN COLLEGE OF CHIROPRACTIC  ,FC,00000-0000,Private      ,0,0,0,1,0,1
03807300,ROSE BRUFORD COLLEGE                    ,FC,00000-0000,Public       ,0,3,3,1,11,12
03816400,AMERICAN GRAD SCH OF INTERNTL REL & DIPL,FC,00000-0000,Private      ,1,12,13,4,46,50
03818300,LEIPZIG GRADUATE SCHOOL OF MANAGEMENT   ,FC,00000-0000,Private      ,0,4,4,1,7,8
03824300,"ROYAL VETERINARY COLLEGE (THE), UNIVERSI",FC,00000-0000,Public       ,0,35,35,2,75,77
03829300,INTERNATIONAL CHRISTIAN COLLEGE         ,FC,00000-0000,Private      ,0,1,1,0,1,1
03850500,MEDICAL UNIVERSITY OF LODZ              ,FC,00000-0000,Public       ,0,0,0,3,6,9
03859400,UNIVERSITY COLLEGE FALMOUTH             ,FC,00000-0000,Public       ,4,3,7,16,8,24
03873300,COPENHAGEN BUSINESS SCHOOL              ,FC,00000-0000,Public       ,1,9,10,3,25,28
03880300,UNIVERSITY OF GLOUCESTERSHIRE (THE)     ,FC,00000-0000,Public       ,3,6,9,4,10,14
03897400,INTERNATIONAL SPACE UNIVERSITY          ,FC,00000-0000,Private      ,0,3,3,1,7,8
03974300,"ST. GEORGE'S UNIVERSITY, SCHOOL OF VETER",FC,00000-0000,Proprietary  ,0,281,281,4,578,582
04015300,FRANKFURT SCHOOL OF FINANCE & MANAGEMENT,FC,00000-0000,Private      ,0,2,2,0,2,2
04021400,"AMERICAN COLLEGE, DUBLIN LIMITED (THE)  ",FC,00000-0000,Private      ,10,19,29,22,37,59
04021500,CENTRAL EUROPEAN UNIVERSITY             ,FC,00000-0000,Private      ,0,29,29,0,76,76
04032300,YORK ST JOHN UNIVERSITY                 ,FC,00000-0000,Public       ,1,2,3,8,6,14
04046300,HK UNIVERSITY OF SCI & TECH (HKUST)     ,FC,00000-0000,Public       ,2,4,6,8,14,22
04070300,"RAPHAEL RECANATI INTERNATIONAL SCHOOL, T",FC,00000-0000,Private      ,26,21,47,55,38,93
04076300,NEWCASTLE COLLEGE                       ,FC,00000-0000,Public       ,1,2,3,4,4,8
04085400,NEW ZEALAND COLLEGE OF CHIROPRACTIC     ,FC,00000-0000,Private      ,0,0,0,0,1,1
04113300,LEBANESE AMERICAN UNIVERSITY            ,FC,00000-0000,Private      ,16,9,25,33,19,52
04115900,LIVERPOOL HOPE UNIVERSITY               ,FC,00000-0000,Public       ,2,3,5,5,6,11
04116300,EDHEC BUSINESS SCHOOL                   ,FC,00000-0000,Private      ,0,9,9,0,20,20
04128600,UNIVERSITY OF WORCESTER                 ,FC,00000-0000,Public       ,2,1,3,6,2,8
04128700,HERTIE SCHOOL OF GOVERNANCE             ,FC,00000-0000,Private      ,0,9,9,2,31,33
04134200,LONDON CONTEMPORARY DANCE SCHOOL        ,FC,00000-0000,Private      ,2,4,6,4,5,9
04139100,UNIVERSITA DEGLI STUDI DI SCIENZE GASTRO,FC,00000-0000,Private      ,0,6,6,1,17,18
04143700,ST MARY'S UNIVERSITY COLLEGE TWICKENHAM ,FC,00000-0000,Public       ,4,8,12,10,15,25
04168200,EUROPEAN UNIVERSITY AT ST. PETERSBURG   ,FC,00000-0000,Private      ,2,11,13,3,24,27
04176500,ESMT EUROPEAN SCHOOL OF MANAGEMENT AND T,FC,00000-0000,Private      ,0,7,7,1,13,14
04219400,UNIVERSIDAD TORCUATO DI TELLA           ,FC,00000-0000,Private      ,1,2,3,2,8,10
00380600,ALDERSON BROADDUS UNIVERSITY            ,WV,26416-1051,Private      ,267,106,373,1771,390,2161
00380700,MOUNTAIN STATE UNIVERSITY               ,WV,25801-5624,Private      ,15,55,70,84,137,221
00380800,BETHANY COLLEGE                         ,WV,26032-0417,Private      ,240,35,275,1114,120,1234
00380900,BLUEFIELD STATE COLLEGE                 ,WV,24701-2198,Public       ,314,590,904,1199,1355,2554
00381000,CONCORD UNIVERSITY                      ,WV,24712-0000,Public       ,395,383,778,2366,1114,3480
00381100,DAVIS & ELKINS COLLEGE                  ,WV,26241-3996,Private      ,147,76,223,1008,257,1265
00381200,FAIRMONT STATE UNIVERSITY               ,WV,26554-2470,Public       ,641,778,1419,4383,2386,6769
00381300,GLENVILLE STATE COLLEGE                 ,WV,26351-1292,Public       ,256,143,399,1470,456,1926
00381500,MARSHALL UNIVERSITY                     ,WV,25755-3300,Public       ,1551,2196,3747,9628,6036,15664
00381600,SOUTHERN WV COMMUNITY COLLEGE           ,WV,25637-2900,Public       ,246,450,696,1155,1050,2205
00381800,UNIVERSITY OF CHARLESTON                ,WV,25304-1099,Private      ,336,608,944,1907,1649,3556
00381900,OHIO VALLEY COLLEGE                     ,WV,26105-8000,Private      ,144,43,187,479,109,588
00382000,SALEM INTERNATIONAL UNIVERSITY          ,WV,26426-0500,Proprietary  ,87,223,310,238,399,637
00382200,SHEPHERD UNIVERSITY                     ,WV,25443-5000,Public       ,426,358,784,4108,1346,5454
00382300,WEST LIBERTY UNIVERSITY                 ,WV,26074-0295,Public       ,562,324,886,2713,815,3528
00382600,WEST VIRGINIA STATE UNIVERSITY          ,WV,25112-0000,Public       ,474,637,1111,2349,1620,3969
00382700,WEST VIRGINIA UNIVERSITY                ,WV,26506-6201,Public       ,2527,2021,4548,24884,8658,33542
00382711,WEST VIRGINIA UNIVERSITY - POTOMAC STATE,WV,26726-3000,Public       ,236,168,404,1667,545,2212
00382721,WEST VIRGINIA UNIV INST OF TECH         ,WV,25136-2436,Public       ,242,180,422,1443,537,1980
00382800,WEST VIRGINIA UNIV AT PARKERSBURG       ,WV,26101-9577,Public       ,337,720,1057,1404,1831,3235
00383000,WEST VIRGINIA WESLEYAN COLLEGE          ,WV,26201-2600,Private      ,215,65,280,2097,258,2355
00383100,WHEELING JESUIT UNIVERSITY              ,WV,26003-6243,Private      ,236,319,555,1253,777,2030
00500700,WEST VIRGINIA JUNIOR COLLEGE            ,WV,26505-5596,Proprietary  ,83,167,250,267,456,723
00500800,MOUNTAIN STATE COLLEGE                  ,WV,26101-3993,Proprietary  ,11,119,130,41,265,306
00754400,APPALACHIAN BIBLE COLLEGE               ,WV,25818-1353,Private      ,71,33,104,235,63,298
00757800,HUNTINGTON SCHOOL OF BEAUTY CULTURE     ,WV,25705-2030,Proprietary  ,7,32,39,42,66,108
00760000,INTERNATIONAL BEAUTY SCHOOL             ,WV,25401-3231,Proprietary  ,9,35,44,19,52,71
00835500,JAMES RUMSEY TECHNICAL INSTITUTE        ,WV,25403-0259,Public       ,52,115,167,127,264,391
00895900,CLARKSBURG BEAUTY ACADEMY               ,WV,26301-2903,Proprietary  ,14,38,52,32,65,97
00904700,HUNTINGTON JUNIOR COLLEGE               ,WV,25701-2004,Proprietary  ,59,366,425,152,799,951
00905400,WEST VIRGINIA NORTHERN CMTY COLLEGE     ,WV,26003-0000,Public       ,291,630,921,859,1230,2089
01014000,MINERAL COUNTY VOCATIONAL TECH CTR      ,WV,26726-0000,Public       ,9,29,38,25,58,83
01035600,EVEREST INSTITUTE                       ,WV,25313-1304,Proprietary  ,16,98,114,52,191,243
01057300,WEST VIRGINIA JUNIOR COLLEGE            ,WV,25322-0000,Proprietary  ,64,120,184,170,315,485
01057302,WEST VIRGINIA JUNIOR COLLEGE            ,WV,26330-0000,Proprietary  ,34,66,100,153,211,364
01086100,WEST VIRGINIA BUSINESS COLLEGE          ,WV,26301-0000,Proprietary  ,9,57,66,27,119,146
01124500,WEST VIRGINIA SCH OSTEOPATHIC MED       ,WV,24901-1128,Public       ,3,292,295,16,888,904
01174900,WOOD COUNTY SCH OF PRAC NURSING         ,WV,26101-6424,Public       ,13,62,75,28,105,133
01235900,B M SPURR SCHOOL OF PRAC NURSING        ,WV,26038-1660,Private      ,4,18,22,17,36,53
01257300,WEST VIRGINIA UNIV-HOSP-RAD TECH        ,WV,26506-8062,Private      ,24,29,53,157,127,284
01274300,BENJAMIN FRANKLIN CAREER&TECH           ,WV,25064-0000,Public       ,28,65,93,71,146,217
01290400,MONONGALIA CNTY TECH ED CTR             ,WV,26501-6841,Public       ,18,58,76,77,131,208
01290500,ACADEMY OF CAREERS AND TECHNOLOGY       ,WV,25801-0000,Public       ,39,149,188,107,264,371
02057400,ROANE-JACKSON TECHNICAL CENTER          ,WV,25252-0000,Public       ,13,21,34,29,42,71
02068000,UNITED TECHNICAL CENTER                 ,WV,26301-0000,Public       ,10,27,37,38,102,140
02073400,CARVER CAREER TECH ED CTR               ,WV,25306-6397,Public       ,75,140,215,201,320,521
02145100,SCOTT COLLEGE OF COSMETOLOGY            ,WV,26003-0000,Proprietary  ,26,30,56,50,59,109
02178200,CHARLESTON SCHOOL OF BEAUTY CULTURE     ,WV,25301-0000,Proprietary  ,29,58,87,81,138,219
02218200,GARNET CAREER CENTER                    ,WV,25301-0000,Public       ,35,120,155,92,294,386
02275300,CABELL COUNTY CAREER TECHNOLOGY CTR     ,WV,25705-0000,Public       ,33,130,163,86,243,329
02524500,RALPH R WILLIS VOCATIONAL CENTER        ,WV,25601-0000,Public       ,11,29,40,35,59,94
02534800,FRED W EBERLE TECHNICAL CENTER          ,WV,26201-0000,Public       ,22,31,53,53,60,113
02535500,MERCER COUNTY TECH EDUC CNTR            ,WV,24740-0000,Public       ,38,97,135,79,215,294
02579900,NORTH CENTRAL OPPORTUNITIES INDUSTRIALIZ,WV,26554-2936,Private      ,10,33,43,26,65,91
02609400,VALLEY COLLEGE                          ,WV,25404-5711,Proprietary  ,15,83,98,30,182,212
03052000,MEREDITH MANOR EQUESTRIAN CENTRE        ,WV,26184-9707,Proprietary  ,72,26,98,186,81,267
03076500,FAYETTE INSTITUTE OF TECHNOLOGY         ,WV,25901-2174,Public       ,8,19,27,25,51,76
03084200,VALLEY COLLEGE                          ,WV,24740-3141,Proprietary  ,17,57,74,35,107,142
03084400,VALLEY COLLEGE                          ,WV,25801-2643,Proprietary  ,20,152,172,51,282,333
03098300,PUTNAM CAREER & TECHNICAL CENTER        ,WV,25070-0000,Public       ,22,39,61,58,96,154
03102100,MORGANTOWN BEAUTY COLLEGE               ,WV,26505-5430,Proprietary  ,27,25,52,74,67,141
03123200,STANLEY TECHNICAL INSTITUTE             ,WV,26505-3751,Private      ,4,11,15,21,33,54
03327500,SOUTH BRANCH VOCATIONAL TECH CENTER     ,WV,26847-1698,Public       ,0,0,0,11,5,16
03734300,JOHN D. ROCKEFELLER IV CAREER CENTER    ,WV,26047-9424,Public       ,5,14,19,10,24,34
03819300,AMERICAN PUBLIC UNIVERSITY SYSTEM       ,WV,25414-1621,Proprietary  ,740,18944,19684,1531,39795,41326
03957300,BLUE RIDGE COMMUNITY AND TECHNICAL COLLE,WV,25401-3244,Public       ,315,789,1104,873,1669,2542
03960300,NEW RIVER COMMUNITY AND TECHNICAL COLLEG,WV,25801-2636,Public       ,257,753,1010,959,1698,2657
04028300,MOUNTAIN STATE SCHOOL OF MASSAGE        ,WV,25304-2025,Proprietary  ,6,19,25,17,56,73
04038500,PIERPONT COMMUNITY & TECHNICAL COLLEGE  ,WV,26554-2451,Public       ,318,451,769,1423,1282,2705
04038600,KANAWHA VALLEY COMMUNITY & TECH COLLEGE ,WV,25112-1000,Public       ,209,662,871,658,1367,2025
04041400,MOUNTWEST COMMUNITY AND TECHNICAL COLLEG,WV,25755-3300,Public       ,288,657,945,869,1428,2297
04047300,BRIDGEMONT COMMUNITY & TECHNICAL COLLEGE,WV,25136-2435,Public       ,103,141,244,430,304,734
04119000,EASTERN WEST VIRGINIA COMMUNITY & TECHNI,WV,26836-0000,Public       ,53,204,257,198,400,598
04139900,FUTURE GENERATIONS GRADUATE SCHOOL      ,WV,26807-0000,Private      ,0,1,1,0,5,5
04234800,RANDOLPH TECHNICAL CENTER               ,WV,26241-9527,Public       ,0,9,9,0,9,9
00106100,ALASKA PACIFIC UNIVERSITY               ,AK,99508-4672,Private      ,92,270,362,416,593,1009
00106300,UNIVERSITY OF ALASKA FAIRBANKS          ,AK,99775-7500,Public       ,802,1160,1962,3098,2911,6009
00106500,UNIVERSITY OF ALASKA SOUTHEAST          ,AK,99801-8680,Public       ,203,380,583,738,995,1733
00884300,ALASKA BIBLE COLLEGE                    ,AK,99588-0000,Private      ,14,12,26,29,22,51
01146200,UNIVERSITY OF ALASKA ANCHORAGE          ,AK,99514-1608,Public       ,1798,2606,4404,5583,6295,11878
02541000,ALASKA CAREER COLLEGE                   ,AK,99507-1033,Proprietary  ,72,315,387,182,629,811
02576900,CHARTER COLLEGE                         ,AK,99508-0000,Proprietary  ,412,1770,2182,559,2430,2989
03160300,AVTEC                                   ,AK,99664-0889,Public       ,92,121,213,211,250,461
03461300,ILISAGVIK COLLEGE                       ,AK,99723-0749,Public       ,10,20,30,23,29,52
04138600,ALASKA CHRISTIAN COLLEGE                ,AK,99669-9755,Private      ,13,46,59,31,63,94
00108500,UNIV ARKANSAS MONTICELLO                ,AR,71656-0000,Public       ,1020,851,1871,2056,1455,3511
00108600,UNIV OF ARKANSAS AT PINE BLUFF          ,AR,71601-2790,Public       ,1023,598,1621,2654,1176,3830
00108700,ARKANSAS BAPTIST COLLEGE                ,AR,72202-6099,Private      ,385,444,829,638,763,1401
00108800,LYON COLLEGE                            ,AR,72501-3699,Private      ,343,62,405,1129,131,1260
00108900,ARKANSAS TECH UNIVERSITY                ,AR,72801-2222,Public       ,2771,2392,5163,6133,4040,10173
00109000,ARKANSAS STATE UNIVERSITY               ,AR,72467-0000,Public       ,3720,4192,7912,8289,7252,15541
00109100,ARKANSAS STATE UNIVERSITY - BEEBE       ,AR,72012-1000,Public       ,1105,1158,2263,2059,2072,4131
00109200,UNIVERSITY OF CENTRAL ARKANSAS          ,AR,72035-0001,Public       ,3842,2190,6032,8969,3776,12745
00109300,CENTRAL BAPTIST COLLEGE                 ,AR,72034-6470,Private      ,310,267,577,626,489,1115
00109400,UNIVERSITY OF THE OZARKS                ,AR,72830-2880,Private      ,225,51,276,609,113,722
00109500,CROWLEYS RIDGE COLLEGE                  ,AR,72450-9775,Private      ,66,54,120,159,99,258
00109700,HARDING UNIVERSITY                      ,AR,72149-0001,Private      ,1347,866,2213,3570,1402,4972
00109800,HENDERSON STATE UNIVERSITY              ,AR,71999-0001,Public       ,1569,854,2423,3350,1383,4733
00109900,HENDRIX COLLEGE                         ,AR,72032-3080,Private      ,228,109,337,1977,231,2208
00110000,JOHN BROWN UNIVERSITY                   ,AR,72761-2747,Private      ,351,487,838,1503,1028,2531
00110100,UNIV ARKANSAS LITTLE ROCK               ,AR,72204-1099,Public       ,2202,4247,6449,4791,7561,12352
00110200,OUACHITA BAPTIST UNIVERSITY             ,AR,71998-0001,Private      ,619,94,713,1702,174,1876
00110300,PHILANDER SMITH COLLEGE                 ,AR,72202-3718,Private      ,241,332,573,862,626,1488
00110400,PHILLIPS COUNTY COMMUNITY COLLEGE       ,AR,72342-0000,Public       ,194,225,419,326,388,714
00110500,SHORTER COLLEGE                         ,AR,72114-4885,Private      ,45,341,386,88,599,687
00110600,WILLIAMS BAPTIST COLLEGE                ,AR,72476-4661,Private      ,269,75,344,592,130,722
00110700,SOUTHERN ARKANSAS UNIVERSITY            ,AR,71754-0000,Public       ,1197,796,1993,2689,1302,3991
00110800,UNIV ARKANSAS FAYETTEVILLE              ,AR,72701-0000,Public       ,5609,2823,8432,16018,5447,21465
00110900,UNIVERSITY OF ARKANSAS FOR MEDICAL SCIEN,AR,72205-7102,Public       ,274,1441,1715,598,2670,3268
00111000,UNIVERSITY OF ARKANSAS-FORT SMITH       ,AR,72904-7397,Public       ,1887,1714,3601,3817,2959,6776
00524500,U OF A COMM COLLEGE AT MORRILTON        ,AR,72110-9601,Public       ,564,834,1398,1001,1356,2357
00570700,SEARK COLLEGE                           ,AR,71603-0000,Public       ,321,766,1087,528,1224,1752
00573200,UNIV AR COMMUNITY COLLEGE AT HOPE       ,AR,71801-0000,Public       ,277,405,682,517,690,1207
00704400,CROWLEYS RIDGE TECHNICAL INSTITUTE      ,AR,72336-0000,Public       ,61,118,179,84,175,259
00732967,ITT TECHNICAL INSTITUTE                 ,AR,72204-7739,Proprietary  ,85,346,431,159,561,720
00773800,SOUTHERN ARKANSAS UNIVERSITY TECH       ,AR,71701-1900,Public       ,247,345,592,477,577,1054
00792100,PAUL MITCHELL THE SCHOOL ARKANSAS       ,AR,72701-0000,Proprietary  ,34,62,96,66,95,161
00997600,COLLEGE OF THE OUACHITAS                ,AR,72104-0816,Public       ,219,476,695,357,805,1162
01074100,MELLIE'S BEAUTY COLLEGE                 ,AR,72901-3833,Proprietary  ,31,90,121,47,137,184
01210500,NATIONAL PARK COMMUNITY COLLEGE         ,AR,71913-9174,Public       ,494,901,1395,816,1489,2305
01226000,EAST ARKANSAS COMMUNITY COLLEGE         ,AR,72335-2204,Public       ,192,231,423,342,416,758
01226100,NORTH ARKANSAS COLLEGE                  ,AR,72601-5508,Public       ,428,644,1072,835,1186,2021
01286000,ARKANSAS NORTHEASTERN COLLEGE           ,AR,72316-1109,Public       ,297,426,723,593,669,1262
02052200,BLACK RIVER TECHNICAL COLLEGE           ,AR,72455-0000,Public       ,372,708,1080,597,1143,1740
02073500,UNIVERSITY OF ARKANSAS COMMUNITY COLLEGE,AR,72503-0000,Public       ,273,389,662,487,668,1155
02073700,NORTHWEST TECHNICAL INSTITUTE           ,AR,72765-0000,Public       ,120,172,292,223,332,555
02074600,SOUTH ARKANSAS COMMUNITY COLLEGE        ,AR,71731-0000,Public       ,322,784,1106,547,1257,1804
02075300,PULASKI TECHNICAL COLLEGE               ,AR,72118-0000,Public       ,1909,5215,7124,3070,8329,11399
02087000,OZARKA COLLEGE                          ,AR,72556-0000,Public       ,202,487,689,348,790,1138
02111100,RICH MOUNTAIN COMMUNITY COLLEGE         ,AR,71953-0000,Public       ,119,164,283,204,243,447
02202400,PROFESSIONAL COSMETOLOGY EDUC CTR       ,AR,71730-5828,Proprietary  ,17,43,60,27,66,93
02220900,COSSATOT COMMUNITY COLLEGE              ,AR,71832-0000,Public       ,241,385,626,448,653,1101
02272400,EASTERN COLLEGE OF HEALTH VOCATIONS     ,AR,72205-3535,Proprietary  ,78,247,325,113,413,526
02284200,NEW TYLER BARBER COLLEGE INC            ,AR,72114-0000,Proprietary  ,19,68,87,36,105,141
02287400,MARSHA KAY BEAUTY COLLEGE               ,AR,72653-0000,Proprietary  ,3,9,12,7,20,27
02330800,JEFFERSON SCHOOL OF NURSING             ,AR,71603-0000,Private      ,36,93,129,69,178,247
02339800,SOUTHERN INSTITUTE OF COSMETOLOGY       ,AR,72301-0000,Proprietary  ,5,6,11,9,17,26
02341700,CAREER ACADEMY OF HAIR DESIGN           ,AR,72764-4304,Proprietary  ,17,38,55,25,58,83
02341701,CAREER ACADEMY OF HAIR DESIGN - ROGERS  ,AR,72756-2102,Proprietary  ,20,46,66,33,68,101
02341702,CAREER ACADEMY OF HAIR DESIGN - SILOAM  ,AR,72761-4217,Proprietary  ,9,18,27,14,26,40
02341703,CAREER ACADEMY OF HAIR DESIGN - FAYETTEV,AR,72701-7731,Proprietary  ,17,23,40,29,30,59
02348200,MID-SOUTH COMMUNITY COLLEGE             ,AR,72301-0000,Public       ,242,457,699,511,965,1476
02363500,ARTHUR'S BEAUTY COLLEGE                 ,AR,72901-0000,Proprietary  ,26,89,115,40,146,186
02525800,LEE'S SCHOOL OF COSMETOLOGY             ,AR,72114-0000,Proprietary  ,16,56,72,28,81,109
02538500,ARTHUR'S BEAUTY COLLEGE                 ,AR,72076-0000,Proprietary  ,26,85,111,47,151,198
02569600,SEARCY BEAUTY COLLEGE                   ,AR,72143-0000,Proprietary  ,12,40,52,21,72,93
03005100,ARKANSAS BEAUTY SCHOOL                  ,AR,72209-5116,Proprietary  ,32,86,118,51,136,187
03007100,HOT SPRINGS BEAUTY COLLEGE              ,AR,71901-5432,Proprietary  ,21,60,81,28,80,108
03007600,ARKANSAS BEAUTY SCHOOL-CONWAY           ,AR,72032-4354,Proprietary  ,12,42,54,42,80,122
03023400,ARKANSAS COLLEGE OF BARBERING           ,AR,72114-5615,Proprietary  ,43,135,178,62,181,243
03063300,NORTHWEST ARKANSAS COMMUNITY COLLEG     ,AR,72712-5190,Public       ,1624,2132,3756,2815,3647,6462
03065100,ABC BEAUTY COLLEGE                      ,AR,71923-4206,Proprietary  ,8,29,37,17,39,56
03066302,BRYAN COLLEGE -                         ,AR,72756-1825,Proprietary  ,26,109,135,42,162,204
03105200,BAPTIST HEALTH SCHOOLS LITTLE ROCK      ,AR,72210-2820,Private      ,305,809,1114,492,1436,1928
03115102,HERITAGE COLLEGE - LITTLE ROCK          ,AR,72227-5544,Proprietary  ,93,320,413,135,519,654
03124900,IMAGINE -  PAUL MITCHELL PARTNER SCHOOL ,AR,72117-2516,Proprietary  ,114,176,290,173,270,443
03214300,VELVATEX COLLEGE OF BEAUTY CULTURE      ,AR,72202-5452,Proprietary  ,7,32,39,17,47,64
03254300,MARGARET'S HAIR ACADEMY                 ,AR,71655-4905,Proprietary  ,11,28,39,18,60,78
03519400,"LYNNDALE FUNDAMENTALS OF BEAUTY SCHOOL, ",AR,71730-4804,Proprietary  ,0,0,0,3,8,11
03855300,ECCLESIA COLLEGE                        ,AR,72762-8159,Private      ,68,42,110,150,80,230
03912300,CROSSETT SCHOOL OF COSMETOLOGY          ,AR,71635-0000,Proprietary  ,11,3,14,15,11,26
03997300,ARKANSAS BEAUTY COLLEGE                 ,AR,72801-3741,Proprietary  ,11,26,37,23,48,71
04183100,WASHINGTON BARBER COLLEGE               ,AR,72209-3820,Proprietary  ,13,56,69,23,92,115
04183400,SALON PROFESSIONAL ACADEMY (THE)        ,AR,72116-7310,Proprietary  ,15,55,70,36,84,120
04203400,ARKANSAS STATE UNIVERSITY - NEWPORT     ,AR,72112-9073,Public       ,509,696,1205,802,1124,1926
04220000,DESIGNER BARBER & STYLIST SCHOOL        ,AR,72903-3753,Proprietary  ,15,34,49,19,58,77
00133900,CORBAN UNIVERSITY                       ,OR,97301-9392,Private      ,165,203,368,1935,672,2607
00318600,BLUE MOUNTAIN COMMUNITY COLLEGE         ,OR,97801-0000,Public       ,185,377,562,1057,1356,2413
00318800,CENTRAL OREGON COMMUNITY COLLEGE        ,OR,97701-5998,Public       ,526,1355,1881,2509,4521,7030
00318900,CLATSOP COMMUNITY COLLEGE               ,OR,97103-3698,Public       ,75,189,264,440,744,1184
00319100,CONCORDIA UNIVERSITY                    ,OR,97211-6099,Private      ,228,3699,3927,2028,6785,8813
00319300,EASTERN OREGON UNIVERSITY               ,OR,97850-2899,Public       ,267,614,881,2612,2659,5271
00319400,GEORGE FOX UNIVERSITY                   ,OR,97132-2697,Private      ,302,537,839,3958,1818,5776
00319600,LANE COMMUNITY COLLEGE                  ,OR,97405-0640,Public       ,867,1960,2827,5539,8678,14217
00319700,LEWIS & CLARK COLLEGE                   ,OR,97219-7899,Private      ,209,451,660,5402,2865,8267
00319800,LINFIELD COLLEGE                        ,OR,97128-6894,Private      ,149,215,364,3515,992,4507
00319801,LINFIELD COLLEGE - PORTLAND CAMPUS      ,OR,97210-0000,Private      ,48,204,252,692,1018,1710
00319900,MARYLHURST UNIVERSITY                   ,OR,97036-7036,Private      ,12,345,357,111,1150,1261
00320300,MOUNT ANGEL SEMINARY                    ,OR,97373-9700,Private      ,2,2,4,7,17,24
00320400,MOUNT HOOD COMMUNITY COLLEGE            ,OR,97030-3300,Public       ,891,2003,2894,4452,6942,11394
00320600,MULTNOMAH UNIVERSITY                    ,OR,97220-5898,Private      ,85,267,352,406,684,1090
00320700,PACIFIC NORTHWEST COLLEGE OF ART        ,OR,97209-3023,Private      ,70,160,230,627,688,1315
00320800,NORTHWEST CHRISTIAN UNIVERSITY          ,OR,97401-3727,Private      ,78,200,278,719,723,1442
00320900,WESTERN OREGON UNIVERSITY               ,OR,97361-1394,Public       ,568,508,1076,7318,2975,10293
00321000,OREGON STATE UNIVERSITY                 ,OR,97331-8507,Public       ,2133,3010,5143,25567,12988,38555
00321100,OREGON INSTITUTE OF TECHNOLOGY          ,OR,97601-8801,Public       ,320,525,845,2813,2263,5076
00321200,PACIFIC UNIVERSITY                      ,OR,97116-1797,Private      ,186,394,580,3956,3050,7006
00321300,PORTLAND COMMUNITY COLLEGE              ,OR,97219-7198,Public       ,2554,7452,10006,12790,27368,40158
00321311,PORTLAND COMMUNITY COLLEGE - TILLAMOOK B,OR,97141-2599,Public       ,15,47,62,169,257,426
00321600,PORTLAND STATE UNIVERSITY               ,OR,97207-0000,Public       ,1851,4678,6529,16110,20473,36583
00321700,REED COLLEGE                            ,OR,97202-8199,Private      ,213,162,375,3246,670,3916
00321800,CHEMEKETA COMMUNITY COLLEGE             ,OR,97309-1500,Public       ,956,2251,3207,5845,9641,15486
00321900,SOUTHERN OREGON UNIVERSITY              ,OR,97520-5010,Public       ,442,619,1061,5428,3111,8539
00322000,SOUTHWESTERN OREGON COMMUNITY CLG       ,OR,97420-2956,Public       ,247,325,572,1456,1290,2746
00322100,TREASURE VALLEY COMMUNITY COLLEGE       ,OR,97914-3423,Public       ,253,544,797,1297,1583,2880
00322200,UMPQUA COMMUNITY COLLEGE                ,OR,97470-0226,Public       ,163,496,659,1065,1810,2875
00322300,UNIVERSITY OF OREGON                    ,OR,97403-1226,Public       ,1813,1685,3498,24665,9141,33806
00322400,UNIVERSITY OF PORTLAND                  ,OR,97203-5798,Private      ,629,695,1324,11014,2911,13925
00322500,WARNER PACIFIC COLLEGE                  ,OR,97215-4099,Private      ,144,370,514,1138,1462,2600
00322700,WILLAMETTE UNIVERSITY                   ,OR,97301-3930,Private      ,219,276,495,4867,1252,6119
00487800,CLACKAMAS COMMUNITY COLLEGE             ,OR,97045-7998,Public       ,776,1393,2169,3464,4635,8099
00488200,OREGON HEALTH & SCIENCE UNIVERSITY      ,OR,97239-0000,Public       ,124,736,860,1061,4108,5169
00693800,LINN BENTON COMMUNITY COLLEGE           ,OR,97321-3774,Public       ,580,1080,1660,3306,4065,7371
00717800,WESTERN SEMINARY                        ,OR,97215-0000,Private      ,4,204,208,26,463,489
00723402,HEALD COLLEGE - PORTLAND                ,OR,97205-3432,Proprietary  ,96,353,449,254,931,1185
00732969,ITT TECHNICAL INSTITUTE                 ,OR,97220-6819,Proprietary  ,108,765,873,366,1514,1880
00737101,MARINELLO SCHOOL OF BEAUTY - PORTLAND   ,OR,97212-3732,Proprietary  ,13,34,47,77,138,215
00781900,ART INSTITUTE OF PORTLAND (THE)         ,OR,97209-2911,Proprietary  ,305,496,801,1322,1459,2781
00888700,CONCORDE CAREER INSTITUTE               ,OR,97232-2242,Proprietary  ,97,351,448,292,876,1168
00907900,EVEREST COLLEGE                         ,OR,97204-2296,Proprietary  ,59,254,313,212,701,913
00958100,SPRINGFIELD COLLEGE OF BEAUTY           ,OR,97477-5474,Proprietary  ,11,40,51,48,110,158
01012200,PHAGANS' MEDFORD BEAUTY SCHOOL          ,OR,97504-5297,Proprietary  ,16,65,81,57,147,204
01018200,ROGUE COMMUNITY COLLEGE                 ,OR,97527-0000,Public       ,387,1265,1652,2354,5076,7430
01050700,ACADEMY OF HAIR DESIGN                  ,OR,97301-3526,Proprietary  ,14,47,61,56,154,210
01230900,UNIVERSITY OF WESTERN STATES            ,OR,97230-3099,Private      ,23,252,275,96,643,739
01234700,PHAGANS CENTRAL OREGON BEAUTY CLG       ,OR,97701-5175,Proprietary  ,20,63,83,75,147,222
01234800,PHAGANS BEAUTY COLLEGE                  ,OR,97333-4716,Proprietary  ,15,39,54,49,96,145
01235000,PHAGANS SCHOOL OF HAIR DESIGN           ,OR,97086-7721,Proprietary  ,33,70,103,66,145,211
01235100,PHAGANS SCHOOL OF BEAUTY                ,OR,97301-4732,Proprietary  ,18,67,85,63,174,237
01300800,PHAGANS TIGARD BEAUTY SCHOOL            ,OR,97223-0000,Proprietary  ,5,13,18,17,35,52
02101000,NORTHWEST COLLEGE OF HAIR DESIGN        ,OR,97086-7702,Proprietary  ,92,203,295,180,433,613
02101002,NORTHWEST COLLEGE                       ,OR,97007-3954,Proprietary  ,7,21,28,30,62,92
02104900,SUMNER COLLEGE                          ,OR,97219-4063,Proprietary  ,28,164,192,89,386,475
02106100,COLLEGE OF COSMETOLOGY                  ,OR,97601-0000,Proprietary  ,18,40,58,44,74,118
02154400,BEAU MONDE CLG OF HAIR DESIGN           ,OR,97205-0000,Proprietary  ,31,67,98,102,217,319
02159700,NEW HOPE CHRISTIAN COLLEGE              ,OR,97405-1194,Private      ,53,63,116,219,190,409
02201900,PHAGANS' SCHOOL OF HAIR DESIGN          ,OR,97232-0000,Proprietary  ,29,112,141,114,306,420
02239203,ANTHEM COLLEGE - BEAVERTON              ,OR,97005-0000,Proprietary  ,36,115,151,83,255,338
02311000,PAUL MITCHELL THE SCHOOL                ,OR,97205-3724,Proprietary  ,53,75,128,179,229,408
02330100,PIONEER PACIFIC COLLEGE                 ,OR,97070-0000,Proprietary  ,100,333,433,257,706,963
02330102,PIONEER PACIFIC COLLEGE                 ,OR,97403-0000,Proprietary  ,55,261,316,201,724,925
02337900,COLLEGE OF HAIR DESIGN CAREERS          ,OR,97301-0000,Proprietary  ,17,47,64,56,140,196
02344100,ROSEBURG BEAUTY COLLEGE                 ,OR,97470-0000,Proprietary  ,13,34,47,38,105,143
02534000,NATIONAL COLLEGE OF NATURAL MEDICINE    ,OR,97201-0000,Private      ,14,224,238,77,942,1019
02578800,NORTHWEST NANNIES INSTITUTE             ,OR,97035-0000,Proprietary  ,7,4,11,20,15,35
02603700,OREGON COL OF ORIENTAL MEDICINE         ,OR,97216-0000,Private      ,4,154,158,31,436,467
02617506,EVEREST COLLEGE - EVEREST INSTITUTE     ,OR,97223-6581,Proprietary  ,24,118,142,87,263,350
03007300,OREGON COLLEGE OF ART & CRAFT           ,OR,97225-6399,Private      ,50,111,161,307,452,759
03022600,LE CORDON BLEU COLLEGE OF CULINARY ARTS ,OR,97205-2793,Proprietary  ,209,451,660,618,1051,1669
03042500,CARRINGTON COLLEGE                      ,OR,97232-1302,Proprietary  ,63,289,352,145,555,700
03074400,PHAGANS NEWPORT ACAD CSMTLGY CAREER     ,OR,97365-4963,Proprietary  ,4,18,22,18,44,62
03074500,EAST-WEST COLLEGE OF THE HEALING ARTS   ,OR,97232-2765,Proprietary  ,19,120,139,75,351,426
03185300,PHAGANS GRANTS PASS COLLEGE OF BTY      ,OR,97527-0000,Proprietary  ,11,30,41,41,69,110
03428300,KLAMATH COMMUNITY COLLEGE               ,OR,97603-7121,Public       ,112,290,402,549,1065,1614
03642300,INSTITUTE OF TECHNOLOGY                 ,OR,97305-1373,Proprietary  ,51,215,266,129,435,564
03668300,BIRTHINGWAY COLLEGE OF MIDWIFERY        ,OR,97266-4042,Private      ,5,62,67,35,220,255
03783400,ABDILL CAREER COLLEGE                   ,OR,97504-7137,Proprietary  ,24,95,119,68,254,322
04146500,PORTLAND ACTORS CONSERVATORY            ,OR,97201-2557,Private      ,14,42,56,56,129,185
04151900,COLUMBIA GORGE COMMUNITY COLLEGE        ,OR,97058-3434,Public       ,70,217,287,484,730,1214
04167400,SAGE SCHOOL OF MASSAGE & HEALING ARTS   ,OR,97701-4082,Proprietary  ,8,46,54,28,119,147
04171400,AVEDA INSTITUTE PORTLAND                ,OR,97209-3144,Proprietary  ,105,158,263,283,405,688
04194400,AMERICAN COLLEGE OF HEALTHCARE SCIENCES ,OR,97239-3719,Proprietary  ,35,485,520,147,963,1110
04194900,TILLAMOOK BAY COMMUNITY COLLEGE         ,OR,97141-2807,Public       ,31,71,102,153,308,461
00137400,ALBERTUS MAGNUS COLLEGE                 ,CT,06511-1189,Private      ,215,697,912,1053,1506,2559
00137800,CENTRAL CONNECTICUT STATE UNIV          ,CT,06050-2490,Public       ,1768,1679,3447,11204,4413,15617
00137900,CONNECTICUT COLLEGE                     ,CT,06320-4196,Private      ,309,51,360,3312,180,3492
00138000,WESTERN CONNECTICUT STATE UNIV          ,CT,06810-6826,Public       ,698,463,1161,5625,1621,7246
00138500,FAIRFIELD UNIVERSITY                    ,CT,06430-0000,Private      ,797,340,1137,7601,958,8559
00138700,HARTFORD SEMINARY                       ,CT,06105-0000,Private      ,3,35,38,21,84,105
00138900,HOLY APOSTLES COLLEGE & SEMINARY        ,CT,06416-2027,Private      ,6,28,34,14,55,69
00139200,MANCHESTER COMMUNITY COLLEGE            ,CT,06045-1046,Public       ,1195,1459,2654,3184,2942,6126
00139300,MITCHELL COLLEGE                        ,CT,06320-4498,Private      ,227,97,324,952,247,1199
00139700,UNIVERSITY OF NEW HAVEN                 ,CT,06516-1999,Private      ,643,565,1208,9558,1900,11458
00139800,NORTHWESTERN CT COMMUNITY COLLEGE       ,CT,06098-1747,Public       ,188,243,431,486,518,1004
00139900,NORWALK COMMUNITY TECHNICAL COLLEGE     ,CT,06854-1655,Public       ,870,1130,2000,1989,2148,4137
00140100,POST UNIVERSITY                         ,CT,06723-3240,Proprietary  ,582,4033,4615,1529,7582,9111
00140200,QUINNIPIAC UNIVERSITY                   ,CT,06518-1908,Private      ,872,748,1620,17068,2661,19729
00140201,QUINNIPIAC UNIVERSITY SCHOOL OF LAW     ,CT,06518-0000,Private      ,5,141,146,81,587,668
00140300,SACRED HEART UNIVERSITY                 ,CT,06825-1000,Private      ,794,945,1739,8704,2554,11258
00140600,SOUTHERN CONNECTICUT STATE UNIV         ,CT,06515-1355,Public       ,1162,1413,2575,9331,4736,14067
00140900,SAINT JOSEPH COLLEGE                    ,CT,06117-2791,Private      ,162,740,902,1037,1679,2716
00141400,TRINITY COLLEGE                         ,CT,06106-3100,Private      ,301,124,425,3392,334,3726
00141600,UNIVERSITY OF BRIDGEPORT                ,CT,06601-5650,Private      ,577,1046,1623,3527,2828,6355
00141700,UNIVERSITY OF CONNECTICUT-STORRS        ,CT,06269-2151,Public       ,1723,1091,2814,31652,5445,37097
00141702,UNIV CONN STAMFORD                      ,CT,06901-0000,Public       ,167,191,358,1010,576,1586
00141703,UNIV OF CONNECTICUT - TORINGTON         ,CT,06790-0000,Public       ,43,36,79,253,115,368
00141706,UNIV OF CONNECTICUT SCH LAW             ,CT,06105-0000,Public       ,10,225,235,52,874,926
00141707,UNIV OF CT - SCH OF SOCIAL WORK         ,CT,06117-0000,Public       ,21,113,134,148,616,764
00141708,UNIVERSITY OF CONNECTICUT - SCHOOL OF ME,CT,06030-1920,Public       ,20,219,239,153,601,754
00141709,UNIVERSITY OF CONNECTICUT - SCHOOL OF DE,CT,06030-1920,Public       ,33,127,160,287,304,591
00142200,UNIVERSITY OF HARTFORD                  ,CT,06117-1599,Private      ,1210,736,1946,9664,2035,11699
00142400,WESLEYAN UNIVERSITY                     ,CT,06459-3208,Private      ,591,58,649,4991,269,5260
00142500,EASTERN CONNECTICUT STATE UNIV          ,CT,06226-2295,Public       ,571,374,945,6680,1321,8001
00142600,YALE UNIVERSITY                         ,CT,06520-8288,Private      ,1069,1168,2237,18264,7705,25969
00280301,RENSSELAER POLYTECHNIC INSTITUTE-RENSSEL,CT,06120-2991,Private      ,1,14,15,14,25,39
00451300,HOUSATONIC COMMUNITY COLLEGE            ,CT,06604-4704,Public       ,1044,1767,2811,2326,3158,5484
00618100,BRIDGEPORT HOSP SCHL OF NURSING         ,CT,06610-2896,Private      ,42,266,308,151,535,686
00619100,ST. VINCENT'S COLLEGE                   ,CT,06606-9966,Private      ,90,385,475,278,746,1024
00698200,NAUGATUCK VALLEY COMM-TECH COLG         ,CT,06708-3089,Public       ,1112,1413,2525,2718,3009,5727
00730000,ELI WHITNEY TECHNICAL HIGH SCHOOL       ,CT,06514-0000,Public       ,7,23,30,17,48,65
00730300,LINCOLN TECHNICAL INSTITUTE             ,CT,06051-0000,Proprietary  ,224,509,733,379,769,1148
00730306,LINCOLN TECHNICAL INSTITUTE - EAST WINDS,CT,06088-9631,Proprietary  ,493,238,731,824,396,1220
00730500,PORTER AND CHESTER INSTITUTE OF BRANFORD,CT,06405-4022,Proprietary  ,106,196,302,173,290,463
00731100,WINDHAM TECHNICAL HIGH SCHOOL           ,CT,06226-2100,Public       ,3,9,12,3,11,14
00745900,PAIER COLLEGE OF ART                    ,CT,06514-3902,Proprietary  ,20,20,40,87,44,131
00763500,CAPITAL COMMUNITY COLLEGE               ,CT,06103-1207,Public       ,639,1663,2302,1393,3055,4448
00803700,GATEWAY COMMUNITY-TECHNICAL COLLEGE     ,CT,06511-0000,Public       ,1164,2149,3313,3059,4369,7428
00803800,MIDDLESEX COMMUNITY CLG                 ,CT,06457-4889,Public       ,411,635,1046,1019,1239,2258
00887300,PAUL MITCHELL THE SCHOOL                ,CT,06810-6716,Proprietary  ,39,37,76,65,70,135
00887400,MARINELLO SCHOOL OF BEAUTY              ,CT,06450-4836,Proprietary  ,11,41,52,15,54,69
00887401,MARINELLO SCHOOL OF BEAUTY - HAMDEN     ,CT,06514-4132,Proprietary  ,11,38,49,18,52,70
00887402,MARINELLO SCHOOL OF BEAUTY - FAIRFIELD  ,CT,06825-4847,Proprietary  ,25,72,97,34,93,127
00887403,MARINELLO SCHOOL OF BEAUTY - WILLIMANTIC,CT,06226-1940,Proprietary  ,9,28,37,15,37,52
00927700,E C GOODWIN TECHNICAL HIGH SCHOOL       ,CT,06053-0000,Public       ,8,25,33,16,42,58
00940700,LINCOLN COLLEGE OF NEW ENGLAND          ,CT,06489-1057,Proprietary  ,188,305,493,416,483,899
00976400,TUNXIS COMMUNITY COLLEGE                ,CT,06032-3187,Public       ,632,794,1426,1794,1693,3487
00976500,THREE RIVERS COMMUNITY COLLEGE          ,CT,06360-6598,Public       ,670,1143,1813,1684,2277,3961
00982200,ALBERT I PRINCE TECHNICAL HIGH SCHOOL   ,CT,06106-3799,Public       ,8,35,43,22,59,81
01041700,MARINELLO SCHOOL OF BEAUTY              ,CT,06108-2220,Proprietary  ,13,35,48,36,73,109
01053000,QUINEBAUG VALLEY COMMUNITY COLLEGE      ,CT,06239-1440,Public       ,284,468,752,677,901,1578
01077900,PORTER AND CHESTER INSTITUTE-ALLCAMPUSES,CT,06615-7158,Proprietary  ,653,1165,1818,1065,2176,3241
01115000,ASNUNTUCK COMMUNITY COLLEGE             ,CT,06082-3800,Public       ,192,313,505,475,607,1082
01149600,BULLARD HAVENS VOC TECH SCHOOL          ,CT,06610-3499,Public       ,10,54,64,30,99,129
01169700,VINAL REGIONAL VOC TECH SCHOOL          ,CT,06457-4918,Public       ,1,6,7,3,24,27
01184300,NORWICH TECHNICAL HIGH SCHOOL           ,CT,06360-7097,Public       ,1,20,21,9,48,57
01242500,STONE ACADEMY                           ,CT,06516-4049,Proprietary  ,61,259,320,89,391,480
01242503,STONE ACADEMY -WATERBURY                ,CT,06705-3823,Proprietary  ,14,40,54,30,80,110
01242504,STONE ACADEMY -  EAST HARTFORD          ,CT,06118-0000,Proprietary  ,20,120,140,48,214,262
01287700,SANFORD-BROWN COLLEGE                   ,CT,06855-1436,Proprietary  ,5,18,23,19,32,51
01291300,LEON INSTITUTE OF HAIR DESIGN           ,CT,06604-4226,Proprietary  ,0,0,0,0,4,4
02074000,BRANFORD HALL CAREER INSTITUTE          ,CT,06405-0000,Proprietary  ,326,1238,1564,392,1514,1906
02106600,AMERICAN INSTITUTE                      ,CT,06110-1922,Proprietary  ,35,146,181,52,234,286
02112300,RIDLEY LOWELL BUSINESS & TECH INST      ,CT,06320-0000,Proprietary  ,45,232,277,88,420,508
02112700,NORTH HAVEN ACADEMY                     ,CT,06473-3108,Proprietary  ,52,35,87,86,65,151
02148700,CONNECTICUT INST OF HAIR DESIGN         ,CT,06716-0000,Proprietary  ,7,24,31,11,29,40
02202500,NEW ENGLAND TRACTOR TRAILER SCH         ,CT,06071-2036,Proprietary  ,36,368,404,40,403,443
02244900,GOODWIN COLLEGE                         ,CT,06118-9980,Private      ,274,1269,1543,906,3563,4469
02245300,HOWELL CHENEY TECHNICAL HIGH SCHOOL     ,CT,06040-0000,Public       ,4,4,8,8,14,22
02265900,WINDHAM COMMUNITY MEM HOSP-RAD TECH     ,CT,06226-0000,Private      ,2,16,18,11,31,42
02296100,YALE-NEW HAVEN HOSP DIETETIC INTERN     ,CT,06510-8900,Private      ,6,13,19,21,34,55
02300000,W F KAYNOR TECHNICAL HIGH SCHOOL        ,CT,06708-0000,Public       ,10,23,33,20,47,67
02316600,CONNECTICUT CTR FOR MASSAGE THERAPY     ,CT,06111-3975,Proprietary  ,18,72,90,30,97,127
02316601,CONNECTICUT CENTER FOR MASSAGE THERAPY -,CT,06880-4619,Proprietary  ,7,29,36,18,56,74
02316603,CONNECTICUT CENTER FOR MASSAGE THERAPY -,CT,06340-4619,Proprietary  ,5,22,27,12,38,50
02565000,PLATT TECHNICAL HIGH SCHOOL             ,CT,06460-2105,Public       ,3,9,12,5,16,21
03079400,LYME ACADEMY COLLEGE OF FINE ARTS       ,CT,06371-2333,Private      ,13,14,27,92,33,125
03094800,INDUSTRIAL MANAGEMENT & TRAINING        ,CT,06706-1211,Proprietary  ,13,36,49,23,65,88
03234300,CHARTER OAK STATE COLLEGE               ,CT,06053-2150,Public       ,39,731,770,109,1488,1597
03316300,LINCOLN TECHNICAL INSTITUTE - HARTFORD  ,CT,06105-3630,Proprietary  ,143,167,310,376,347,723
03927300,MARINELLO SCHOOL OF BEAUTY              ,CT,06357-2447,Proprietary  ,6,24,30,9,31,40
03927301,MARINELLO SCHOOL OF BEAUTY  - TORRINGTON,CT,06790-5425,Proprietary  ,5,17,22,9,25,34
03927302,MARINELLO SCHOOL OF BEAUTY  -  ENFIELD  ,CT,06082-2946,Proprietary  ,5,9,14,12,17,29
04104300,ACADEMY DI CAPELLI - SCHOOL OF COSMETOLO,CT,06492-0000,Proprietary  ,16,19,35,43,42,85
04128800,BRANFORD ACADEMY OF HAIR & COSMETOLOGY  ,CT,06405-0000,Proprietary  ,4,15,19,10,27,37
04145400,OXFORD ACADEMY OF HAIR DESIGN           ,CT,06483-2911,Proprietary  ,22,26,48,31,36,67
04148400,EUROPEAN ACADEMY OF COSMETOLOGY AND HAIR,CT,06437-0000,Proprietary  ,8,6,14,13,9,22
04152400,INTERNATIONAL INSTITUTE OF COSMETOLOGY  ,CT,06109-0000,Proprietary  ,32,27,59,55,66,121
04219200,ACE COSMETOLOGY & BARBERING TRAINING CEN,CT,06716-0000,Proprietary  ,5,13,18,10,19,29
04224200,BELLE ACADEMY OF COSMETOLOGY            ,CT,06704-0135,Proprietary  ,9,17,26,20,37,57
04230900,RICCI'S ACADEMY OF COSMETOLOGY          ,CT,06470-0000,Proprietary  ,14,13,27,28,32,60
00146600,BARRY UNIVERSITY                        ,FL,33161-6695,Private      ,1389,3202,4591,5231,6770,12001
00146601,BARRY UNIVERSITY - ORLANDO              ,FL,32807-3673,Private      ,120,647,767,365,1504,1869
00146700,BETHUNE COOKMAN UNIVERSITY              ,FL,32114-3099,Private      ,1741,655,2396,7213,1826,9039
00146800,ST THOMAS UNIVERSITY                    ,FL,33054-0000,Private      ,479,1044,1523,1513,2112,3625
00146900,FLORIDA INSTITUTE OF TECHNOLOGY         ,FL,32901-6988,Private      ,949,3076,4025,4648,5941,10589
00147000,EASTERN FLORIDA STATE COLLEGE           ,FL,32922-6503,Public       ,2452,3739,6191,4449,6540,10989
00147100,COLLEGE OF CENTRAL FLORIDA              ,FL,34474-4415,Public       ,1751,2764,4515,3489,5478,8967
00147200,CHIPOLA  COLLEGE                        ,FL,32446-2053,Public       ,464,509,973,842,875,1717
00147300,CLEARWATER CHRISTIAN COLLEGE            ,FL,33759-0000,Private      ,192,78,270,634,171,805
00147500,DAYTONA STATE COLLEGE                   ,FL,32114-2800,Public       ,2800,4341,7141,5723,8250,13973
00147700,EDISON STATE COLLEGE                    ,FL,33906-6210,Public       ,3308,3986,7294,6736,7177,13913
00147800,EDWARD WATERS COLLEGE                   ,FL,32209-6199,Private      ,530,387,917,1144,779,1923
00147900,EMBRY-RIDDLE AERONAUTICAL UNIV          ,FL,32114-3900,Private      ,1499,2946,4445,6944,6246,13190
00148000,FLORIDA A & M UNIVERSITY                ,FL,32307-3100,Public       ,3387,2391,5778,13497,6766,20263
00148100,FLORIDA ATLANTIC UNIVERSITY             ,FL,33431-6498,Public       ,6624,5964,12588,24352,14351,38703
00148101,FLORIDA ATLANTIC UNIVERSITY/DAVIE       ,FL,33314-0000,Public       ,920,1917,2837,2586,4209,6795
00148103,FLORIDA ATLANTIC UNIV-JUPITER/PSL       ,FL,33458-0000,Public       ,385,489,874,1274,1141,2415
00148200,FLORIDA COLLEGE                         ,FL,33617-5578,Private      ,219,42,261,476,80,556
00148400,FLORIDA STATE COLLEGE AT JACKSONVILLE   ,FL,32202-4030,Public       ,4665,8880,13545,9924,17946,27870
00148500,FLORIDA KEYS COMMUNITY COLLEGE          ,FL,33040-4397,Public       ,220,253,473,525,510,1035
00148600,FLORIDA MEMORIAL UNIVERSITY             ,FL,33054-6199,Private      ,765,507,1272,2472,1150,3622
00148700,ECKERD COLLEGE                          ,FL,33711-4744,Private      ,499,319,818,3194,718,3912
00148800,FLORIDA SOUTHERN COLLEGE                ,FL,33801-5698,Private      ,905,525,1430,4005,1074,5079
00148900,FLORIDA STATE UNIVERSITY                ,FL,32306-2430,Public       ,10498,5353,15851,46410,15637,62047
00149000,GULF COAST STATE COLLEGE                ,FL,32401-1058,Public       ,973,1783,2756,2008,3381,5389
00149300,INDIAN RIVER STATE COLLEGE              ,FL,34981-5596,Public       ,2568,3611,6179,5108,6819,11927
00149500,JACKSONVILLE UNIVERSITY                 ,FL,32211-3394,Private      ,925,1477,2402,3414,3100,6514
00149700,JONES COLLEGE                           ,FL,32211-5588,Private      ,49,304,353,92,645,737
00149900,EVEREST UNIVERSITY                      ,FL,32810-5601,Proprietary  ,208,1353,1561,501,3182,3683
00149901,EVEREST UNIVERSITY - ORLANDO SOUTH      ,FL,32819-7666,Proprietary  ,721,9421,10142,1386,19039,20425
00149902,EVEREST UNIVERSITY - MELBOURNE          ,FL,32905-6609,Proprietary  ,59,396,455,116,678,794
00149904,EVEREST UNIVERSITY - TAMPA              ,FL,33614-5801,Proprietary  ,132,959,1091,347,2655,3002
00149905,EVEREST UNIVERSITY - BRANDON            ,FL,33619-1354,Proprietary  ,184,2135,2319,310,3851,4161
00149906,EVEREST UNIVERSITY - ORANGE PARK        ,FL,32073-1111,Proprietary  ,42,296,338,88,709,797
00149907,EVEREST UNIVERSITY - LARGO              ,FL,33770-2556,Proprietary  ,41,236,277,75,574,649
00149908,EVEREST UNIVERSITY - LAKELAND           ,FL,33801-3801,Proprietary  ,64,424,488,121,691,812
00149909,EVEREST UNIVERSITY - JACKSONVILLE       ,FL,32256-0000,Proprietary  ,92,609,701,214,1136,1350
00149910,EVEREST UNIVERSITY - POMPANO            ,FL,33062-2522,Proprietary  ,93,1330,1423,169,2174,2343
00149913,EVEREST INSTITUTE - MIAMI               ,FL,33169-4759,Proprietary  ,88,232,320,161,498,659
00149914,EVEREST INSTITUTE - KENDALL             ,FL,33186-1410,Proprietary  ,47,136,183,113,334,447
00150000,BROWARD COLLEGE- DOWNTOWN CTR           ,FL,33301-2298,Public       ,3914,6229,10143,6444,10619,17063
00150001,BROWARD COLLEGE - DAVIE CAMPUS          ,FL,33314-0000,Public       ,3865,4346,8211,8573,9360,17933
00150002,BROWARD COLLEGE- NORTH CAMPUS           ,FL,33066-0000,Public       ,2401,3610,6011,5315,7874,13189
00150003,BROWARD COLLEGE- SOUTH CAMPUS           ,FL,33024-0000,Public       ,2802,3431,6233,6016,7350,13366
00150100,FLORIDA GATEWAY COLLEGE                 ,FL,32025-2007,Public       ,483,943,1426,915,1741,2656
00150200,LAKE SUMTER COMMUNITY COLLEGE           ,FL,34788-8751,Public       ,1044,993,2037,2135,2136,4271
00150400,"STATE COLLEGE OF FLORIDA, MANATEE-SARASO",FL,34207-3596,Public       ,1971,2690,4661,4126,5227,9353
00150500,LYNN UNIVERSITY                         ,FL,33431-5598,Private      ,573,402,975,2645,945,3590
00150600,MIAMI DADE COLLEGE ADMINISTRATION ONLY  ,FL,33176-3393,Public       ,209,315,524,466,624,1090
00150601,MIAMI DADE COLLEGE - NORTH CAMPUS       ,FL,33167-3495,Public       ,5259,6141,11400,11272,11747,23019
00150602,MIAMI DADE COLLEGE - KENDALL CAMPUS     ,FL,33176-3393,Public       ,7376,5933,13309,15284,11046,26330
00150603,MIAMI DADE COLLEGE - WOLFSON CAMPUS     ,FL,33132-2297,Public       ,4211,4145,8356,9328,8244,17572
00150604,MIAMI DADE COLLEGE - MEDICAL CAMPUS     ,FL,33127-4693,Public       ,1350,2673,4023,3063,5135,8198
00150605,MIAMI DADE COLLEGE - HOMESTEAD CAMPUS   ,FL,33030-6009,Public       ,1142,1439,2581,2454,2700,5154
00150606,MIAMI DADE COLLEGE -INTERAMERICAN CAMPUS,FL,33135-0000,Public       ,1732,2682,4414,3317,4957,8274
00150607,MIAMI DADE COLLEGE - HIALEAH CAMPUS     ,FL,33012-2918,Public       ,1696,1826,3522,3350,3319,6669
00150800,NORTH FLORIDA COMMUNITY COLLEGE         ,FL,32340-1699,Public       ,189,310,499,407,552,959
00150900,NOVA SOUTHEASTERN UNIVERSITY            ,FL,33314-7796,Private      ,1689,9732,11421,6762,23963,30725
00151000,NORTHWEST FLORIDA STATE COLLEGE         ,FL,32578-1295,Public       ,785,1592,2377,1616,3044,4660
00151200,PALM BEACH COMMUNITY COLLEGE            ,FL,33461-4796,Public       ,5891,5822,11713,11561,11437,22998
00151300,PENSACOLA STATE COLLEGE                 ,FL,32504-8998,Public       ,1675,3045,4720,3497,5950,9447
00151400,POLK STATE COLLEGE                      ,FL,33881-4256,Public       ,2165,3415,5580,4071,6210,10281
00151500,ROLLINS COLLEGE                         ,FL,32789-4499,Private      ,759,613,1372,3324,1173,4497
00151900,SANTA FE COLLEGE                        ,FL,32606-6200,Public       ,3349,3276,6625,8266,6930,15196
00152000,SEMINOLE STATE COLLEGE OF FLORIDA       ,FL,32773-6199,Public       ,3427,4756,8183,7088,9600,16688
00152100,SOUTHEASTERN UNIVERSITY                 ,FL,33801-6099,Private      ,1339,711,2050,3727,1438,5165
00152200,SOUTH FLORIDA COMMUNITY COLLEGE         ,FL,33825-9399,Public       ,562,793,1355,1087,1396,2483
00152300,SAINT JOHNS RIVER STATE COLLEGE         ,FL,32177-3897,Public       ,1060,1524,2584,2248,3218,5466
00152600,SAINT LEO UNIVERSITY                    ,FL,33574-6665,Private      ,772,5588,6360,4046,13207,17253
00152800,ST. PETERSBURG COLLEGE                  ,FL,33760-3768,Public       ,4091,9138,13229,8046,18007,26053
00153100,STETSON UNIVERSITY                      ,FL,32723-3761,Private      ,805,313,1118,6553,833,7386
00153101,STETSON UNIVERSITY - COLLEGE OF LAW     ,FL,33707-3299,Private      ,24,459,483,102,1335,1437
00153300,TALLAHASSEE COMMUNITY COLLEGE           ,FL,32304-2895,Public       ,3767,3303,7070,8474,6662,15136
00153500,UNIVERSITY OF FLORIDA                   ,FL,32611-3150,Public       ,8019,5831,13850,43115,18016,61131
00153600,UNIVERSITY OF MIAMI                     ,FL,33146-6531,Private      ,1830,1619,3449,21227,5597,26824
00153601,UNIV OF MIAMI SCHOOL OF LAW             ,FL,33124-0000,Private      ,44,427,471,171,1736,1907
00153602,UNIV OF MIAMI-SCH OF MEDICINE           ,FL,33136-0000,Private      ,242,624,866,879,1799,2678
00153700,UNIVERSITY OF SOUTH FLORIDA             ,FL,33620-6960,Public       ,7848,7963,15811,39179,21251,60430
00153701,UNIV OF SOUTH FLORIDA-ST PETERSBURG     ,FL,33701-0000,Public       ,1041,1296,2337,4417,3229,7646
00153702,UNIV OF SOUTH FLORIDA-SARASOTA          ,FL,34243-2025,Public       ,328,592,920,1154,1644,2798
00153705,UNIV OF SOUTH FLORIDA                   ,FL,33803-0000,Public       ,346,398,744,1145,959,2104
00153706,UNIV OF SOUTH FLORIDA- MEDICINE         ,FL,33612-0000,Public       ,405,615,1020,1550,2106,3656
00153800,UNIVERSITY OF TAMPA                     ,FL,33606-1490,Private      ,2250,1158,3408,13236,3102,16338
00154000,WEBBER INTERNATIONAL UNIVERSITY         ,FL,33827-0096,Private      ,456,149,605,1296,317,1613
00173308,NATIONAL-LOUIS UNIVERSITY               ,FL,33609-0000,Private      ,5,43,48,14,76,90
00177201,TRINITY INTERNATIONAL UNIVERSITY - SOUTH,FL,33324-4611,Private      ,29,181,210,68,365,433
00349503,JOHNSON UNIVERSITY - FLORIDA            ,FL,34744-5301,Private      ,28,9,37,164,85,249
00395400,UNIV OF CENTRAL FLORIDA                 ,FL,32816-0001,Public       ,16174,10990,27164,60979,27132,88111
00395500,UNIVERSITY OF WEST FLORIDA              ,FL,32514-5750,Public       ,2622,3018,5640,9085,6471,15556
00407215,NORTHWOOD UNIVERSITY                    ,FL,33409-0000,Private      ,242,174,416,709,366,1075
00491005,KAPLAN COLLEGE JACKSONVILLE             ,FL,32216-3216,Proprietary  ,65,889,954,134,1836,1970
00558500,LIVELY TECHNICAL CENTER                 ,FL,32304-0000,Public       ,228,600,828,408,1230,1638
00558600,LINDSEY HOPKINS TECHNICAL ED CENTER     ,FL,33127-4692,Public       ,118,396,514,219,658,877
00559400,D G ERWIN TECHNICAL CENTER              ,FL,33610-8255,Public       ,270,781,1051,498,1478,1976
00560500,PINELLAS TECH ED CTR-CLEARWATER         ,FL,33760-2194,Public       ,132,514,646,250,926,1176
00560700,SARASOTA COUNTY TECHNICAL INSTITUTE     ,FL,34233-0000,Public       ,142,315,457,262,608,870
00560800,MAYNARD A. TRAVISS CAREER CENTER        ,FL,33803-9709,Public       ,182,504,686,264,842,1106
00561200,MANATEE TECHNICAL INSTITUTE             ,FL,34210-0000,Public       ,202,479,681,352,864,1216
00561201,MANATEE TECHNICAL INSTITUTE-EAST        ,FL,34211-0000,Public       ,124,283,407,243,531,774
00675000,VALENCIA COMMUNITY COLLEGE              ,FL,32802-3028,Public       ,11423,10180,21603,25109,20749,45858
00732910,ITT TECHNICAL INSTITUTE                 ,FL,33634-7515,Proprietary  ,359,1791,2150,610,2621,3231
00732947,ITT TECHNICAL INSTITUTE                 ,FL,32746-1607,Proprietary  ,225,1045,1270,336,1683,2019
00736206,MEDTECH COLLEGE - MEDTECH INSTITUTE - OR,FL,32826-4906,Proprietary  ,87,487,574,162,763,925
00752500,SUWANNEE-HAMILTON AREA VOC TECH CTR     ,FL,32060-0000,Public       ,32,101,133,47,196,243
00752600,WASHINGTON HOLMES TECHNICAL CENTER      ,FL,32428-1699,Public       ,105,206,311,146,317,463
00755800,LEE COUNTY HIGH TECH CENTER CENTRAL     ,FL,33916-2299,Public       ,191,394,585,324,712,1036
00787000,HILLSBOROUGH COMMUNITY COLLEGE          ,FL,33606-3572,Public       ,6647,8965,15612,12879,16884,29763
00789300,FLAGLER COLLEGE                         ,FL,32085-1027,Private      ,1229,361,1590,4786,781,5567
00789301,FLAGLER COLLEGE - TALLAHASSEE COMMUNITY ,FL,32304-2895,Private      ,176,338,514,440,696,1136
00807500,ST JOHN VIANNEY COLLEGE SEMINARY        ,FL,33165-3244,Private      ,14,9,23,26,17,43
00822300,ST VINCENT DE PAUL REGIONL SEMINARY     ,FL,33436-0000,Private      ,0,6,6,0,14,14
00841700,STENOTYPE INST OF JACKSONVILLE          ,FL,32207-0000,Proprietary  ,19,90,109,29,177,206
00869410,RASMUSSEN COLLEGE - OCALA               ,FL,34471-7051,Proprietary  ,321,2588,2909,561,4748,5309
00869411,RASMUSSEN COLLEGE - NEW PORT RICHEY     ,FL,34690-4554,Proprietary  ,99,487,586,161,909,1070
00869413,RASMUSSEN COLLEGE - FORT MYERS          ,FL,33905-7805,Proprietary  ,149,557,706,293,1122,1415
00869420,RASMUSSEN COLLEGE - TAMPA               ,FL,33610-9558,Proprietary  ,81,454,535,166,867,1033
00869422,RASMUSSEN COLLEGE - PASCO               ,FL,33558-0000,Proprietary  ,34,185,219,59,334,393
00884800,WARNER UNIVERSITY                       ,FL,33859-8725,Private      ,320,325,645,875,616,1491
00884900,PALM BEACH ATLANTIC UNIVERSITY          ,FL,33401-6505,Private      ,1194,1128,2322,3602,2236,5838
00887800,MIAMI INTERNATIONAL UNIV ART&DESIGN     ,FL,33132-1418,Proprietary  ,822,789,1611,1914,1637,3551
00910400,TONI & GUY HAIRDRESSING ACADEMY         ,FL,32256-3810,Proprietary  ,0,0,0,6,22,28
00963500,FLORIDA INTERNATIONAL UNIVERSITY        ,FL,33199-0001,Public       ,9720,10026,19746,38190,26970,65160
00984100,UNIVERSITY OF NORTH FLORIDA             ,FL,32224-2645,Public       ,4277,3555,7832,14403,8005,22408
00990200,SHERIDAN TECHNICAL CENTER               ,FL,33021-3399,Public       ,238,821,1059,445,1443,1888
01016100,"LORAINE'S ACADEMY, INC                  ",FL,33710-0000,Proprietary  ,10,87,97,28,152,180
01019500,ART INSTITUTE OF FT LAUDERDALE          ,FL,33316-3000,Proprietary  ,618,757,1375,1371,1398,2769
01065200,PASCO-HERNANDO COMMUNITY CLG            ,FL,34654-5199,Public       ,2178,2836,5014,4091,5237,9328
01072401,CARLOS ALBIZU UNIVERSITY                ,FL,33172-0000,Private      ,41,399,440,97,716,813
01082600,TOM P. HANEY TECHNICAL CENTER           ,FL,32405-5099,Public       ,122,450,572,186,748,934
01112700,GOODING INST OF NUR ANES BAY MED CT     ,FL,32401-0000,Proprietary  ,9,58,67,16,98,114
01226300,ATLANTIC TECHNICAL CENTER               ,FL,33063-3902,Public       ,216,551,767,366,961,1327
01246117,LINCOLN COLLEGE OF TECHNOLOGY - WEST PAL,FL,33407-3105,Proprietary  ,202,393,595,318,586,904
01254400,FIRST COAST TECHNICAL COLLEGE           ,FL,32084-1921,Public       ,126,359,485,249,682,931
01257400,RINGLING SCHOOL OF ART AND DESIGN       ,FL,34234-5895,Private      ,300,111,411,1833,356,2189
01303904,SOUTH UNIVERSITY - WEST PALM BEACH CAMPU,FL,33409-5149,Proprietary  ,221,814,1035,487,1473,1960
01323400,LORENZO WALKER INST OF TECHNOLOGY       ,FL,34104-4405,Public       ,162,311,473,275,541,816
02089600,CONCORDE CAREER INSTITUTE               ,FL,32211-0000,Proprietary  ,116,590,706,193,1090,1283
02113609,AMERICAN INTERCONTINENTAL UNIV - WESTON ,FL,33326-3233,Proprietary  ,14,108,122,37,181,218
02115300,PINELLAS TECHNICAL EDUCATION CENTERS - S,FL,33711-0000,Public       ,162,655,817,301,1323,1624
02116006,SANFORD-BROWN INSTITUTE - FT. LAUDERDALE,FL,33309-1906,Proprietary  ,82,271,353,134,442,576
02148200,FASHION FOCUS HAIR ACADEMY              ,FL,34231-0000,Proprietary  ,15,31,46,26,56,82
02148300,MANHATTAN BEAUTY SCHOOL                 ,FL,33611-0000,Proprietary  ,29,77,106,52,148,200
02149900,PAUL MITCHELL THE SCHOOL-JACKSONVILLE   ,FL,32205-0000,Proprietary  ,45,117,162,89,215,304
02151900,KEISER  UNIVERSITY                      ,FL,33309-0000,Private      ,1692,6686,8378,3110,11737,14847
02159600,BAPTIST COLLEGE OF FLORIDA (THE)        ,FL,32440-0000,Private      ,79,121,200,174,205,379
02172700,CONCORDE CAREER INSTITUTE               ,FL,33607-0000,Proprietary  ,71,313,384,128,578,706
02188900,HOBE SOUND BIBLE COLLEGE                ,FL,33475-0000,Private      ,24,39,63,50,81,131
02200100,BRADENTON BEAUTY & BARBER ACADEMY       ,FL,34209-0000,Proprietary  ,15,57,72,23,82,105
02215900,ATI CAREER TRAINING CENTER              ,FL,33309-1785,Proprietary  ,18,67,85,18,67,85
02218700,FLORIDA TECHNICAL COLLEGE               ,FL,32826-2707,Proprietary  ,505,1616,2121,816,2560,3376
02218707,FLORIDA TECHNICAL COLLEGE - LAKELAND    ,FL,33813-2101,Proprietary  ,58,194,252,181,410,591
02218709,FLORIDA TECHNICAL COLLEGE - DELAND      ,FL,32720-7415,Proprietary  ,75,409,484,116,650,766
02218710,FLORIDA TECHNICAL COLLEGE -KISSIMMEE    ,FL,34741-0000,Proprietary  ,1,0,1,1,0,1
02228300,LAKE TECHNICAL CENTER                   ,FL,32726-0000,Public       ,177,487,664,315,879,1194
02245500,FORTIS COLLEGE                          ,FL,32789-4679,Proprietary  ,27,261,288,58,455,513
02257900,INTERNATIONAL ACADEMY                   ,FL,32119-3541,Proprietary  ,32,124,156,45,165,210
02275100,CONCORDE CAREER INSTITUTE               ,FL,33025-0000,Proprietary  ,54,224,278,107,373,480
02278800,SOUTHWEST FLORIDA COLLEGE               ,FL,33907-0000,Proprietary  ,228,664,892,462,1283,1745
02278801,SOUTHWEST FLORIDA COLLEGE - TAMPA       ,FL,33619-1344,Proprietary  ,147,336,483,377,725,1102
02278802,SOUTHWEST FLORIDA COLLEGE - INSTITUTUE O,FL,33928-9469,Proprietary  ,12,52,64,35,92,127
02278803,SOUTHWEST FLORIDA COLLEGE - PORT CHARLOT,FL,33953-3100,Proprietary  ,64,230,294,137,469,606
02279600,CORTIVA INSTITUTE - FLORIDA             ,FL,33781-0000,Proprietary  ,15,54,69,24,98,122
02283800,BEAUTY SCHOOLS OF AMERICA               ,FL,33012-3322,Proprietary  ,157,845,1002,225,1034,1259
02286502,ITT TECHNICAL INSTITUTE                 ,FL,32244-6630,Proprietary  ,0,1,1,0,1,1
02287100,LA BELLE BEAUTY SCHOOL                  ,FL,33012-3224,Proprietary  ,7,28,35,13,33,46
02293200,ATI CAREER TRAINING CENTER              ,FL,33309-5916,Proprietary  ,3,16,19,3,16,19
02293201,ATI CAREER TRAINING CENTER - MIAMI      ,FL,33122-1707,Proprietary  ,20,49,69,20,49,69
02293202,ATI CAREER TAINING CENTER - ATI COLLEGE ,FL,87109-2016,Proprietary  ,15,43,58,15,43,58
02293600,ADVANCED TECHNICAL CENTERS              ,FL,33266-1597,Private      ,15,34,49,36,61,97
02297000,CHARLOTTE TECHNICAL CENTER              ,FL,33948-0000,Public       ,69,128,197,152,263,415
02300900,WITHLACOOCHEE TECHNICAL INSTITUTE       ,FL,34450-0000,Public       ,86,229,315,135,414,549
02305700,FORTIS COLLEGE                          ,FL,33619-1283,Proprietary  ,0,0,0,4,11,15
02305800,FLORIDA CAREER COLLEGE                  ,FL,33012-7028,Proprietary  ,538,2986,3524,701,4159,4860
02305810,FLORIDA CAREER COLLEGE - CLEARWATER     ,FL,33759-3924,Proprietary  ,27,112,139,67,213,280
02307400,GEORGE STONE AREA VOCATIONAL TECHNICAL  ,FL,32526-0000,Public       ,119,409,528,211,797,1008
02314100,SCHILLER INTERNATIONAL UNIVERSITY       ,FL,33770-0000,Proprietary  ,24,135,159,59,209,268
02316200,MIAMI LAKES TECHNICAL EDUCATION CTR     ,FL,33014-0000,Public       ,130,410,540,281,745,1026
02321200,ORANGE TECH EDUC CTR- WESTSIDE TECH     ,FL,34787-0000,Public       ,105,229,334,188,427,615
02325100,KEY COLLEGE                             ,FL,33004-3046,Proprietary  ,3,38,41,8,69,77
02326303,MEDVANCE INSTITUTE - WEST PALM          ,FL,33461-2171,Proprietary  ,45,122,167,62,217,279
02326306,MEDVANCE INSTITUTE - MIAMI              ,FL,33173-3431,Proprietary  ,11,37,48,18,69,87
02326800,MERIDIAN COLLEGE                        ,FL,34240-8478,Proprietary  ,20,76,96,36,129,165
02326900,SUNSTATE ACADEMY OF HAIR DESIGN         ,FL,33907-1415,Proprietary  ,79,165,244,113,282,395
02329900,FLORIDA INSTITUTE OF ULTRASOUND         ,FL,32514-0000,Proprietary  ,50,136,186,85,266,351
02338400,FT PIERCE BEAUTY ACADEMY                ,FL,34982-0000,Proprietary  ,20,78,98,31,124,155
02346200,WYOTECH                                 ,FL,32174-1010,Proprietary  ,90,257,347,172,418,590
02362100,FULL SAIL UNIVERSITY                    ,FL,32792-0000,Proprietary  ,4401,7842,12243,10738,16244,26982
02499000,ACADEMY OF COSMETOLOGY                  ,FL,32953-3311,Proprietary  ,21,78,99,39,119,158
02501500,"O*TEC, MID-FLORIDA TECH                 ",FL,32809-0000,Public       ,152,442,594,281,869,1150
02502700,UEI (UNITED EDUCATION INSTITUTE)        ,FL,32207-5627,Proprietary  ,0,0,0,25,66,91
02504600,WINTER PARK TECH                        ,FL,32789-0000,Public       ,54,175,229,95,343,438
02508900,TALMUDIC COLLEGE OF FLORIDA             ,FL,33139-0000,Private      ,5,3,8,11,6,17
02511700,RIDGE TECHNICAL CENTER                  ,FL,33881-0000,Public       ,119,366,485,207,648,855
02513200,ORLANDO TECHNICAL CENTER                ,FL,32801-0000,Public       ,156,463,619,326,922,1248
02515400,CITY COLLEGE                            ,FL,33309-3073,Private      ,205,870,1075,337,1531,1868
02517100,SARASOTA SCHOOL OF MASSAGE THERAPY      ,FL,34243-6130,Proprietary  ,15,68,83,30,105,135
02524000,SUNSTATE ACADEMY OF HAIR DESIGN         ,FL,34624-0000,Proprietary  ,18,96,114,34,124,158
02524200,ROBERT MORGAN EDUCATIONAL CENTER        ,FL,33177-0000,Public       ,133,275,408,246,526,772
02531803,PAUL MITCHELL THE SCHOOL - ORLANDO      ,FL,32765-6444,Proprietary  ,51,77,128,114,137,251
02531805,PAUL MITCHELL THE SCHOOL -TAMPA         ,FL,33613-0000,Proprietary  ,55,107,162,103,191,294
02547600,FLORIDA NATIONAL COLLEGE                ,FL,33012-0000,Proprietary  ,193,676,869,284,959,1243
02547601,FLORIDA NATIONAL UNIVERSITY - SOUTH CAMP,FL,33175-2478,Proprietary  ,247,660,907,485,974,1459
02547602,FLORIDA NATIONAL UNIVERSITY - TRAINING A,FL,33012-4108,Proprietary  ,62,153,215,117,262,379
02554200,RADFORD LOCKLIN TECH CENTER             ,FL,32570-0000,Public       ,50,137,187,75,276,351
02573200,LA BELLE BEAUTY ACADEMY                 ,FL,33135-0000,Proprietary  ,29,125,154,58,159,217
02597100,HERITAGE INSTITUTE                      ,FL,33912-7132,Proprietary  ,151,342,493,251,597,848
02598200,SOUTHERN CAREER COLLEGE                 ,FL,32211-0000,Proprietary  ,33,178,211,52,263,315
02601600,HENRY W BREWSTER TECHNICAL CENTER       ,FL,33602-0000,Public       ,58,227,285,109,458,567
02612700,"SALON PROFESSIONAL ACADEMY - MELBOURNE, ",FL,32904-3919,Proprietary  ,16,52,68,27,98,125
02616400,SANFORD-BROWN INSTITUTE                 ,FL,32256-3520,Proprietary  ,68,290,358,121,537,658
02616401,SANFORD-BROWN INSTITUTE - TAMPA         ,FL,33610-8304,Proprietary  ,40,164,204,85,314,399
02616705,LE CORDON BLEU COLLEGE OF CULINARY ARTS ,FL,33025-3929,Proprietary  ,144,167,311,332,395,727
03003600,MCFATTER TECHNICAL CENTER               ,FL,33317-7499,Public       ,210,425,635,365,800,1165
03008600,FLORIDA COLLEGE OF NATURAL HEALTH       ,FL,33064-1342,Proprietary  ,65,237,302,106,347,453
03010608,VIRGINIA COLLEGE - PENSACOLA            ,FL,32501-5650,Proprietary  ,65,303,368,122,594,716
03010612,VIRGINIA COLLEGE - GOLF ACADEMY OF AMERI,FL,32701-0000,Proprietary  ,7,26,33,25,59,84
03010618,VIRGINIA COLLEGE - JACKSONVILLE         ,FL,32207-5167,Proprietary  ,50,279,329,121,577,698
03012300,ASM BEAUTY WORLD ACADEMY                ,FL,33021-0000,Proprietary  ,13,58,71,22,90,112
03018500,BENE'S INTERNATIONAL SCHOOL OF BEAUTY   ,FL,34652-1637,Proprietary  ,38,125,163,61,238,299
03026508,REMINGTON COLLEGE - TAMPA               ,FL,33619-1177,Private      ,41,176,217,95,399,494
03028200,TRINITY COLLEGE OF FLORIDA              ,FL,34655-4401,Private      ,79,85,164,140,148,288
03031400,INTERNATIONAL ACADEMY OF DESIGN AND TECH,FL,33634-6313,Proprietary  ,372,1128,1500,667,2246,2913
03031402,INTERNATIONAL ACADEMY OF DESIGN AND TECH,FL,32809-4613,Proprietary  ,142,206,348,274,441,715
03031403,IADT - ORLANDO CULINARY ACADEMY         ,FL,32819-0000,Proprietary  ,64,93,157,152,253,405
03035800,HERITAGE INSTITUTE                      ,FL,32216-0948,Proprietary  ,39,193,232,59,334,393
03035900,NATIONAL AVIATION ACADEMY               ,FL,33760-3931,Proprietary  ,168,268,436,307,590,897
03037500,HODGES UNIVERSITY                       ,FL,34119-7932,Private      ,250,1055,1305,496,2070,2566
03054200,FORTIS COLLEGE                          ,FL,33144-2373,Proprietary  ,12,34,46,34,108,142
03071600,COLLEGE OF BUSINESS & TECHNOLOGY        ,FL,33176-0000,Proprietary  ,128,455,583,251,625,876
03076402,BRYMAN SCHOOL OF ARIZONA (THE) - ANTHEM ,FL,32803-3509,Proprietary  ,50,181,231,85,323,408
03078003,OHIO CENTER FOR BROADCASTING - MIAMI MED,FL,33130-3042,Proprietary  ,21,68,89,31,91,122
03079800,GEORGE T BAKER AVIATION                 ,FL,33142-5687,Public       ,164,215,379,282,358,640
03079900,CITY COLLEGE                            ,FL,32707-0000,Private      ,64,283,347,79,427,506
03087601,ITT TECHNICAL INSTITUTE                 ,FL,33126-1823,Proprietary  ,0,0,0,0,1,1
03089200,NOUVELLE INSTITUTE                      ,FL,33125-4141,Proprietary  ,10,121,131,10,125,135
03096300,FORTIS INSTITUTE                        ,FL,33860-0000,Proprietary  ,23,68,91,28,117,145
03100800,TAYLOR TECHNICAL INSTITUTE              ,FL,32348-0894,Public       ,27,73,100,34,102,136
03101900,TRINITY BAPTIST COLLEGE                 ,FL,32221-1398,Private      ,161,108,269,305,197,502
03103900,MARION COUNTY COMMUNITY TECH & ADUL     ,FL,34474-3172,Public       ,182,564,746,316,1056,1372
03108500,EVERGLADES UNIVERSITY                   ,FL,33431-0000,Private      ,76,596,672,154,998,1152
03108600,COM-PU-MED VOCATIONAL CAREERS           ,FL,33012-4861,Proprietary  ,17,68,85,28,74,102
03113400,ACADEMY OF HEALING ARTS                 ,FL,33463-2113,Proprietary  ,8,27,35,19,56,75
03114700,PRAXIS INSTITUTE                        ,FL,33135-2657,Proprietary  ,7,52,59,14,82,96
03115500,ADVENTIST UNIVERSITY OF HEALTH SCIENCES ,FL,32803-1237,Private      ,426,870,1296,1094,1801,2895
03123900,KEISER CAREER COLLEGE                   ,FL,33413-0000,Proprietary  ,136,586,722,200,910,1110
03125600,MIAMI AD SCHOOL                         ,FL,33139-5203,Proprietary  ,25,96,121,62,242,304
03127900,TECHNICAL EDUCATION CTR OSCEOLA         ,FL,34744-4459,Public       ,151,415,566,271,685,956
03158300,LEE COUNTY HIGH TECH CENTER NORTH       ,FL,33993-2479,Public       ,62,160,222,110,271,381
03171300,UNIVERSITY OF ST. AUGUSTINE FOR HEALTH S,FL,32084-4215,Proprietary  ,35,505,540,111,1267,1378
03224300,NEW PROFESSIONS TECHNICAL INSTITUTE     ,FL,33134-1640,Proprietary  ,22,130,152,36,226,262
03230300,CHOICE HIGH SCHOOL AND TECHNICAL CENTER ,FL,32547-1299,Public       ,42,149,191,70,311,381
03238300,FLORIDA COLLEGE OF INTEGRATIVE MED      ,FL,32809-5721,Proprietary  ,34,142,176,99,274,373
03255300,FLORIDA GULF COAST UNIVERSITY           ,FL,33965-6565,Public       ,4086,2009,6095,18414,5066,23480
03256300,YESHIVA GEDOLAH RABBINICAL COLLEGE      ,FL,33139-4708,Private      ,2,1,3,6,5,11
03264300,SOUTH FLORIDA BIBLE COLLEGE AND THEOLOGI,FL,33441-5768,Private      ,4,75,79,9,99,108
03346300,ACAD FOR PRAC NURSING & HEALTH OCCP     ,FL,33417-4574,Private      ,78,492,570,146,709,855
03348400,PROFESSIONAL TRAINING CENTERS           ,FL,33184-0000,Proprietary  ,56,221,277,72,292,364
03373300,BEACON COLLEGE                          ,FL,34748-5224,Private      ,67,51,118,171,108,279
03374300,FLORIDA COASTAL SCHOOL OF LAW           ,FL,32256-0000,Proprietary  ,23,765,788,58,1851,1909
03382300,BRADFORD-UNION AREA CAREERTECHNICAL CENT,FL,32091-2434,Public       ,19,110,129,37,224,261
03390300,LINCOLN TECHNICAL INSTITUTE             ,FL,32730-2351,Proprietary  ,49,176,225,71,279,350
03411400,INTERNATIONAL TRAINING CAREERS          ,FL,33155-1462,Private      ,12,94,106,23,123,146
03414500,ACUPUNCTURE AND MASSAGE COLLEGE         ,FL,33176-1509,Proprietary  ,20,107,127,53,182,235
03425400,CENTRAL FLORIDA INSTITUTE               ,FL,34684-4436,Proprietary  ,11,44,55,30,93,123
03429600,ATLANTIC INST OF ORIENTAL MEDICINE      ,FL,33316-0000,Private      ,12,49,61,21,118,139
03429700,EAST WEST COLLG OF NATURAL MEDICINE     ,FL,34236-4959,Proprietary  ,5,85,90,21,142,163
03433400,NEW CONCEPT MASSAGE AND BEAUTY SCHO     ,FL,33135-0000,Proprietary  ,4,40,44,12,55,67
03434300,FORTIS COLLEGE                          ,FL,32073-2999,Proprietary  ,42,193,235,80,355,435
03480301,MEDVANCE INSTITUTE - FORT LAUDERDALE    ,FL,33313-7261,Proprietary  ,13,101,114,20,165,185
03480302,MEDVANCE INSTITUTE - STUART             ,FL,34994-3000,Proprietary  ,50,251,301,77,403,480
03491400,AMERICAN ADVANCED TECHNICIANS INST      ,FL,33014-4430,Proprietary  ,15,64,79,31,99,130
03549300,ULTIMATE MEDICAL ACADEMY                ,FL,33756-4917,Proprietary  ,618,6685,7303,917,10303,11220
03553300,KEISER CAREER COLLEGE                   ,FL,32216-0000,Proprietary  ,106,472,578,243,939,1182
03557300,NORTH FLORIDA COSMETOLOGY INSTITUTE     ,FL,32312-0000,Proprietary  ,36,118,154,94,261,355
03564300,"INTERNATIONAL SCHOOL OF HEALTH, BEAUTY &",FL,33311-1141,Proprietary  ,9,23,32,14,37,51
03570400,ENGLISH CENTER (THE)                    ,FL,33133-2703,Public       ,5,58,63,14,99,113
03611400,FLORIDA BARBER ACADEMY                  ,FL,33441-0000,Proprietary  ,12,115,127,24,166,190
03618300,FLORIDA INSTITUTE OF ANIMAL ARTS        ,FL,32792-0000,Proprietary  ,42,61,103,85,120,205
03627400,JACKSONVILLE BEAUTY INSTITUTE           ,FL,32208-1885,Proprietary  ,40,110,150,64,189,253
03627600,FLORIDA EDUCATION INSTITUTE             ,FL,33144-5036,Proprietary  ,22,140,162,44,217,261
03661400,SOUTH FLORIDA INSTITUTE OF TECHNOLO     ,FL,33135-0000,Proprietary  ,50,384,434,131,595,726
03691400,AVE MARIA SCHOOL OF LAW                 ,FL,34119-1376,Private      ,27,238,265,75,469,544
03696400,SABER                                   ,FL,33134-1604,Private      ,25,268,293,45,404,449
03706300,AMERICAN INSTITUTE                      ,FL,33319-0000,Proprietary  ,24,95,119,40,152,192
03757300,ADVANCE SCIENCE INSTITUTE               ,FL,33012-0000,Proprietary  ,10,12,22,28,25,53
03801400,BEAUTY INSTITUTE (THE)                  ,FL,33409-2972,Proprietary  ,15,43,58,32,68,100
03801401,BEAUTY INSTITUTE (THE) - MARGATE        ,FL,33068-5704,Proprietary  ,6,14,20,15,34,49
03816300,ARTISTIC NAILS & BEAUTY ACADEMY         ,FL,33605-5919,Proprietary  ,39,110,149,78,194,272
03823300,FLORIDA ACADEMY OF HEALTH & BEAUTY      ,FL,33311-0000,Proprietary  ,2,20,22,5,24,29
03832300,DADE MEDICAL COLLEGE                    ,FL,33126-5534,Proprietary  ,445,1768,2213,777,2906,3683
03842500,CAMBRIDGE INSTITUTE OF ALLIED HEALTH    ,FL,32750-0000,Proprietary  ,17,79,96,21,159,180
03856300,UNIVERSAL BEAUTY SCHOOL                 ,FL,33174-4406,Proprietary  ,12,70,82,13,72,85
03856500,FLORIDA SCHOOL OF TRADITIONAL MIDWIFERY ,FL,32601-5507,Private      ,4,51,55,15,120,135
03875300,MCI INSTITUTE OF TECHNOLOGY             ,FL,33409-4937,Proprietary  ,28,91,119,52,140,192
03888300,DRAGON RISES COLLEGE OF ORIENTAL MEDICIN,FL,32601-5089,Proprietary  ,0,0,0,5,27,32
03903500,SOUTHERN TECHNICAL COLLEGE              ,FL,32809-0000,Proprietary  ,134,870,1004,231,1333,1564
03907301,PAUL MITCHELL THE SCHOOL FT MYERS       ,FL,33907-0000,Proprietary  ,36,72,108,67,121,188
03911300,TOTAL INTERNATIONAL CAREER INSTITUTE    ,FL,33012-0000,Proprietary  ,1,18,19,4,21,25
03939300,WOLFORD COLLEGE                         ,FL,34108-1931,Proprietary  ,8,61,69,20,128,148
03939400,CENTURA INSTITUTE                       ,FL,32807-3566,Proprietary  ,22,110,132,53,207,260
03939600,DAYTONA COLLEGE                         ,FL,32174-8445,Proprietary  ,39,173,212,91,298,389
03941300,AVE MARIA UNIVERSITY                    ,FL,34142-9505,Private      ,380,56,436,1295,151,1446
03957400,NEW COLLEGE OF FLORIDA                  ,FL,34243-2109,Public       ,245,119,364,1865,333,2198
03985300,COMMERCIAL DIVING ACADEMY               ,FL,32208-0000,Proprietary  ,102,346,448,211,575,786
03986300,AVIATOR COLLEGE OF AERONAUTICAL SCIENCE ,FL,34946-9022,Proprietary  ,21,71,92,56,145,201
04016500,AMERICAN INSTITUTE OF BEAUTY            ,FL,33773-0000,Proprietary  ,25,109,134,37,153,190
04029300,TRENDSETTERS OF FLORIDA SCHOOL OF BEAUTY,FL,32205-4737,Proprietary  ,12,59,71,23,101,124
04038302,ATA COLLEGE-ATA CAREER EDUCATION        ,FL,34606-4300,Proprietary  ,45,197,242,73,309,382
04039300,SULLIVAN AND COGLIANO TRAINING CENTERS  ,FL,33014-6427,Proprietary  ,27,354,381,30,490,520
04083400,CAMBRIDGE INSTITUTE OF ALLIED HEALTH & T,FL,33484-6543,Proprietary  ,20,131,151,38,218,256
04105400,PENSACOLA SCHOOL OF MASSAGE THERAPY & HE,FL,32504-7337,Proprietary  ,16,110,126,32,214,246
04106300,PALM BEACH ACADEMY OF HEALTH & BEAUTY   ,FL,33403-2130,Proprietary  ,28,129,157,40,169,209
04116400,FUTURE-TECH INSTITUTE                   ,FL,33135-4142,Proprietary  ,11,70,81,27,79,106
04116600,TAYLOR COLLEGE                          ,FL,34420-8714,Proprietary  ,37,260,297,67,509,576
04119400,AVEDA INSTITUTE - SAINT PETERSBURG      ,FL,33701-4242,Proprietary  ,157,288,445,299,515,814
04120400,HI-TECH SCHOOL OF COSMETOLOGY           ,FL,33174-0000,Proprietary  ,40,47,87,63,77,140
04126900,ACADEMY OF CAREER TRAINING              ,FL,34741-4644,Proprietary  ,38,140,178,83,246,329
04127400,DIGITAL MEDIA ARTS COLLEGE              ,FL,33431-5919,Proprietary  ,128,100,228,257,162,419
04128400,MANAGEMENT RESOURCES INSTITUTE          ,FL,33126-5473,Proprietary  ,17,310,327,23,353,376
04129900,FLORIDA SCHOOL OF MASSAGE               ,FL,32608-5419,Proprietary  ,23,80,103,46,156,202
04130400,SHEAR EXCELLENCE INTERNATIONAL HAIR ACAD,FL,33614-2783,Proprietary  ,15,65,80,18,91,109
04133500,ACADEMY FOR FIVE ELEMENT ACUPUNCTURE    ,FL,32601-6811,Private      ,7,63,70,12,104,116
04133900,FUTURA CAREER INSTITUTE                 ,FL,33012-3325,Proprietary  ,14,59,73,16,61,77
04134800,AVEDA INSTITUTE - TALLAHASSEE           ,FL,32304-3186,Proprietary  ,153,222,375,270,436,706
04135000,COZMO THE SCHOOL                        ,FL,34135-4810,Proprietary  ,3,35,38,5,49,54
04135900,ALLIED HEALTH INSTITUTE                 ,FL,33068-0000,Proprietary  ,24,262,286,48,597,645
04140800,NORTH FLORIDA ACADEMY                   ,FL,32065-7758,Proprietary  ,8,25,33,17,51,68
04143100,PROFESSIONAL HANDS INSTITUTE            ,FL,33135-1939,Proprietary  ,2,14,16,5,22,27
04145900,CELEBRITY SCHOOL OF BEAUTY              ,FL,33144-4153,Proprietary  ,20,62,82,52,105,157
04146200,WALTON CAREER DEVELOPMENT CENTER        ,FL,32433-1557,Public       ,19,63,82,32,126,158
04146300,MARCHMAN TECHNICAL EDUCATION CENTER     ,FL,34653-1211,Public       ,74,124,198,133,239,372
04148500,MEDICAL INSTITUTE OF PALM BEACH         ,FL,33460-5042,Proprietary  ,26,59,85,63,110,173
04150800,IMMOKALEE TECHNICAL CENTER              ,FL,34142-3146,Public       ,91,76,167,146,145,291
04151500,AMERICAN ACADEMY OF COSMETOLOGY         ,FL,32065-8026,Proprietary  ,17,63,80,30,108,138
04156300,UNIVERSITY OF FORT LAUDERDALE           ,FL,33313-5809,Private      ,10,36,46,48,81,129
04156400,AVIATION INSTITUTE OF MAINTENANCE       ,FL,32803-6487,Proprietary  ,81,155,236,160,318,478
04157100,AEROSIM FLIGHT ACADEMY                  ,FL,32773-9683,Proprietary  ,42,78,120,94,147,241
04158300,FLAGLER TECHNICAL INSTITUTE             ,FL,32137-4714,Public       ,30,79,109,70,185,255
04162000,JOSE MARIA VARGAS UNIVERSITY            ,FL,33025-4534,Proprietary  ,4,32,36,9,53,62
04162500,HOLLYWOOD INSTITUTE OF BEAUTY CAREERS   ,FL,33020-4807,Proprietary  ,44,180,224,67,294,361
04163000,SALON PROFESSIONAL ACADEMY (THE)        ,FL,33624-6321,Proprietary  ,37,69,106,60,113,173
04163100,SALON PROFESSIONAL ACADEMY (THE)        ,FL,32607-1672,Proprietary  ,27,67,94,66,135,201
04163200,SALON PROFESSIONAL ACADEMY (THE)        ,FL,32162-9311,Proprietary  ,28,68,96,44,102,146
04164500,EUREKA INSTITUTE OF HEALTH AND BEAUTY   ,FL,33174-4205,Proprietary  ,10,18,28,19,35,54
04164600,D. A. DORSEY EDUCATIONAL CENTER         ,FL,33147-6304,Public       ,23,75,98,43,142,185
04167300,SALON PROFESSIONAL ACADEMY (THE)        ,FL,33904-4824,Proprietary  ,18,41,59,30,71,101
04170300,BEAUTY ACADEMY OF SOUTH FLORIDA         ,FL,33012-3221,Proprietary  ,10,27,37,18,38,56
04172300,ETERNITY COSMETOLOGY SCHOOL             ,FL,33415-5719,Proprietary  ,12,42,54,21,60,81
04176800,PROGRESSIVE TRAINING CENTERS            ,FL,33060-9238,Proprietary  ,4,16,20,6,24,30
04176900,AMERICAN HEALTH INSTITUTE               ,FL,34654-3743,Proprietary  ,9,48,57,26,85,111
04182500,MILLENNIA ATLANTIC UNIVERSITY           ,FL,33178-2369,Proprietary  ,5,20,25,18,40,58
04188300,FLORIDA ACADEMY                         ,FL,33966-1155,Proprietary  ,48,120,168,86,206,292
04192100,AMERICAN MEDICAL ACADEMY                ,FL,33186-4830,Proprietary  ,52,105,157,126,200,326
04194200,APARICIO-LEVY TECHNICAL CENTER          ,FL,33610-9666,Public       ,1,4,5,1,4,5
04195100,AMBIANCE BEAUTY & BARBER ACADEMY        ,FL,32935-8771,Proprietary  ,3,37,40,13,67,80
04197600,"FLORIDA INSTITUTE OF RECORDING, SOUND AN",FL,32804-3309,Proprietary  ,80,103,183,179,223,402
04204600,BEAUTY AND HEALTH INSTITUTE             ,FL,33626-2610,Proprietary  ,31,91,122,50,161,211
04206300,FLORIDA VOCATIONAL INSTITUTE            ,FL,33155-3762,Proprietary  ,13,85,98,28,126,154
04207900,SAE INSTITUTE OF TECHNOLOGY - MIAMI     ,FL,33160-4307,Proprietary  ,51,77,128,106,158,264
04209500,SHEAR FINESSE HAIRSTYLING ACADEMY       ,FL,32208-5005,Proprietary  ,6,25,31,19,52,71
04210800,ULTRASOUND MEDICAL INSTITUTE            ,FL,33462-4221,Proprietary  ,14,11,25,22,23,45
04212600,COSMIX SCHOOL OF MAKEUP ARTISTRY        ,FL,33306-1640,Proprietary  ,38,65,103,76,119,195
04213200,KAIZEN BEAUTY ACADEMY                   ,FL,33024-6609,Proprietary  ,4,16,20,12,29,41
04214500,PRESTIGE HEALTH & BEAUTY SCIENCES ACADEM,FL,33160-4102,Proprietary  ,2,23,25,11,35,46
04216600,AZURE COLLEGE                           ,FL,33169-5345,Proprietary  ,46,409,455,86,774,860
04216900,SAN IGNACIO COLLEGE                     ,FL,33178-2350,Proprietary  ,0,1,1,0,1,1
04217800,BOCA BEAUTY ACADEMY                     ,FL,33434-4178,Proprietary  ,21,69,90,50,121,171
04220200,MORE TECH INSTITUTE                     ,FL,33012-2165,Proprietary  ,4,19,23,11,28,39
04221200,BLY'S SCHOOL OF COSMETOLOGY             ,FL,32601-4021,Proprietary  ,15,64,79,34,118,152
04222100,ANTON AESTHETICS ACADEMY                ,FL,33416-4629,Proprietary  ,5,18,23,12,39,51
04223400,INTERAMERICAN TECHNICAL INSTITUTE       ,FL,00174-2950,Proprietary  ,7,29,36,7,29,36
04225000,PARISIAN SPA INSTITUTE                  ,FL,32204-4127,Proprietary  ,6,60,66,18,105,123
04225200,YECHANLAZ INSTITUTO VOCACIONAL          ,FL,33144-4817,Proprietary  ,4,47,51,6,50,56
04225800,FRED D. LEAREY TECHNICAL CENTER         ,FL,33614-1892,Public       ,1,8,9,1,8,9
04227500,MERRYFIELD SCHOOL OF PET GROOMING       ,FL,33334-4925,Proprietary  ,3,17,20,6,33,39
04228900,BEAUTY ANATOMY INSTITUTE OF COSMETOLOGY ,FL,33069-4313,Proprietary  ,7,23,30,19,43,62
04229700,FIRST COAST BARBER ACADEMY              ,FL,32210-8054,Proprietary  ,7,31,38,18,58,76
04233400,LEE PROFESSIONAL INSTITUTE              ,FL,33916-9320,Proprietary  ,19,51,70,19,51,70
04234500,BURNETT INTERNATIONAL COLLEGE           ,FL,33426-6591,Proprietary  ,3,39,42,3,39,42
00160500,CHAMINADE UNIV OF HONOLULU              ,HI,96816-1578,Private      ,368,638,1006,1955,1652,3607
00160600,BRIGHAM YOUNG UNIV-HAWAII CAMPUS        ,HI,96762-1294,Private      ,414,290,704,1614,661,2275
00161000,UNIVERSITY OF HAWAII AT MANOA           ,HI,96822-2399,Public       ,1946,2239,4185,13772,8121,21893
00161100,UNIVERSITY OF HAWAII AT HILO            ,HI,96720-4091,Public       ,594,723,1317,3644,2563,6207
00161200,HONOLULU COMMUNITY COLLEGE              ,HI,96817-4598,Public       ,683,999,1682,2095,2263,4358
00161300,KAPIOLANI COMMUNITY COLLEGE             ,HI,96816-4421,Public       ,947,1209,2156,3205,2939,6144
00161400,KAUAI COMMUNITY COLLEGE                 ,HI,96766-9591,Public       ,205,245,450,565,569,1134
00161500,UNIVERSITY OF HAWAII MAUI COLLEGE       ,HI,96732-1644,Public       ,430,911,1341,1485,2001,3486
00454900,LEEWARD COMMUNITY COLLEGE               ,HI,96782-3393,Public       ,972,1190,2162,2578,2735,5313
00525800,HAWAII COMMUNITY COLLEGE                ,HI,96720-4075,Public       ,403,690,1093,1508,1985,3493
00723401,HEALD COLLEGE - HONOLULU                ,HI,96814-0000,Proprietary  ,272,623,895,707,1411,2118
00727900,HAWAII PACIFIC UNIVERSITY               ,HI,96813-2882,Private      ,582,1076,1658,4505,2810,7315
01122000,WINDWARD COMMUNITY COLLEGE              ,HI,96744-0000,Public       ,258,420,678,911,1211,2122
02100300,MED-ASSIST SCHOOL OF HAWAII             ,HI,96813-0000,Proprietary  ,30,78,108,102,186,288
02107800,UNIVERSITY OF HAWAII - WEST OAHU        ,HI,96782-0000,Public       ,478,806,1284,1981,2129,4110
02139500,HAWAII INSTITUTE OF HAIR DESIGN         ,HI,96817-5195,Proprietary  ,22,62,84,54,109,163
03017800,TRAVEL INSTITUTE OF THE PACIFIC         ,HI,96814-1946,Proprietary  ,15,56,71,42,133,175
03072500,WORLD MEDICINE INSTITUTE                ,HI,96826-0000,Private      ,16,49,65,46,120,166
03735300,INST OF CLINICAL ACUPUNCTURE & ORIENT MD,HI,96813-2307,Proprietary  ,3,25,28,10,66,76
03999400,TRADITIONAL CHINESE MEDICAL COLLEGE OF H,HI,96743-8324,Private      ,0,11,11,6,31,37
04165200,MAUNA LOA HELICOPTERS                   ,HI,96740-2650,Proprietary  ,3,21,24,14,45,59
04175100,PAUL MITCHELL THE SCHOOL HONOLULU       ,HI,96816-2433,Proprietary  ,40,66,106,104,133,237
04182200,HAWAII MEDICAL INSTITUTE                ,HI,96814-3518,Proprietary  ,86,187,273,214,450,664
00161600,BOISE STATE UNIVERSITY                  ,ID,83725-1000,Public       ,1662,2890,4552,12989,9281,22270
00161700,"COLLEGE OF IDAHO, THE                   ",ID,83605-4432,Private      ,250,151,401,1795,439,2234
00161900,COLLEGE OF SOUTHERN IDAHO               ,ID,83301-0000,Public       ,689,1127,1816,2650,2556,5206
00162000,IDAHO STATE UNIVERSITY                  ,ID,83209-5377,Public       ,1175,2377,3552,5422,5815,11237
00162100,LEWIS-CLARK STATE COLLEGE               ,ID,83501-2698,Public       ,283,534,817,2405,1969,4374
00162300,NORTH IDAHO COLLEGE                     ,ID,83814-2199,Public       ,500,997,1497,2493,3066,5559
00162400,NORTHWEST NAZARENE UNIVERSITY           ,ID,83686-5897,Private      ,236,405,641,1677,1166,2843
00162500,BRIGHAM YOUNG UNIVERSITY-IDAHO          ,ID,83460-1650,Private      ,4984,4961,9945,12017,9520,21537
00162600,UNIVERSITY OF IDAHO                     ,ID,83844-4291,Public       ,749,859,1608,9540,3681,13221
00732915,ITT TECHNICAL INSTITUTE                 ,ID,83713-1529,Proprietary  ,144,604,748,305,1002,1307
00987300,MR JUAN'S CLG OF HAIR DESIGN            ,ID,83301-4154,Proprietary  ,6,25,31,19,56,75
01113300,EASTERN IDAHO TECHNICAL COLLEGE         ,ID,83404-5788,Public       ,118,368,486,318,752,1070
02218000,CARRINGTON COLLEGE                      ,ID,83704-0000,Proprietary  ,149,516,665,348,1120,1468
02234500,BOISE BIBLE COLLEGE                     ,ID,83714-1220,Private      ,63,37,100,192,103,295
02275800,MR LEONS SCHOOL OF HAIR DESIGN          ,ID,83843-8384,Proprietary  ,4,20,24,9,30,39
02275801,MR. LEON'S SCHOOL OF HAIR DESIGN        ,ID,83501-1910,Proprietary  ,2,9,11,5,17,22
02314000,SCHOOL OF HAIRSTYLING (THE)             ,ID,83202-0000,Proprietary  ,6,20,26,9,36,45
02319800,TONI&GUY HAIRDRESSING ACADEMY           ,ID,83814-2822,Proprietary  ,16,42,58,50,88,138
02319801,TONI&GUY HAIRDRESSING ACADEMY - BOISE   ,ID,83705-2636,Proprietary  ,31,47,78,65,97,162
02349200,HEADMASTERS SCHOOL OF HAIR DESIGN       ,ID,83501-0000,Proprietary  ,6,22,28,21,42,63
02559500,RAZZLE DAZZLE CLG OF HAIR DESIGN        ,ID,83686-5104,Proprietary  ,14,41,55,48,91,139
02607100,PAUL MITCHELL THE SCHOOL BOISE          ,ID,83709-1662,Proprietary  ,35,73,108,117,158,275
03098700,ACADEMY OF COURT REPORTING              ,ID,83704-8320,Proprietary  ,30,104,134,59,218,277
03832400,COSMETOLOGY SCHOOL OF ARTS & SCIENCES   ,ID,83318-1327,Proprietary  ,1,28,29,8,40,48
04051323,ART INSTITUTE OF PHOENIX (THE) - BROWN M,ID,83709-2746,Proprietary  ,16,71,87,45,148,193
04134300,EVANS HAIRSTYLING COLLEGE               ,ID,83440-5277,Proprietary  ,15,20,35,41,38,79
04144500,HAIR ACDMY PAUL MITCHELL PARTNER SCHOOL ,ID,83440-2600,Proprietary  ,37,59,96,66,89,155
04150600,D & L ACADEMY OF HAIR DESIGN            ,ID,83301-6229,Proprietary  ,6,16,22,12,36,48
04155200,OLIVER FINLEY ACADEMY OF COSMETOLOGY    ,ID,83704-8011,Proprietary  ,46,76,122,93,144,237
04163800,MASTER EDUCATORS BEAUTY SCHOOL          ,ID,83301-4118,Proprietary  ,13,18,31,27,37,64
04168600,COLLEGE OF MASSAGE THERAPY              ,ID,83221-1758,Proprietary  ,11,21,32,20,33,53
04176700,D'SHAW INSTITUTE OF COSMETOLOGY         ,ID,83704-4406,Proprietary  ,13,35,48,36,68,104
04194800,VELVET TOUCH ACADEMY OF COSMETOLOGY     ,ID,83687-5020,Proprietary  ,13,22,35,32,63,95
04203200,BOISE BARBER COLLEGE                    ,ID,83704-5919,Proprietary  ,5,38,43,14,66,80
04203500,AUSTIN KADE ACADEMY                     ,ID,83404-5540,Proprietary  ,28,112,140,54,172,226
04207200,ACADEMY DI FIRENZE                      ,ID,83338-2329,Proprietary  ,3,7,10,9,17,26
04211800,COLLEGE OF WESTERN IDAHO                ,ID,83687-5505,Public       ,1159,2641,3800,3733,5620,9353
00149912,EVEREST UNIVERSITY - EVEREST COLLEGE - K,MO,64114-3246,Proprietary  ,29,154,183,29,154,183
00163200,AQUINAS INSTITUTE OF THEOLOGY           ,MO,63108-3323,Private      ,2,26,28,4,58,62
00244900,AVILA UNIVERSITY                        ,MO,64145-1698,Private      ,350,554,904,1405,1285,2690
00245000,CALVARY BIBLE COLLEGE                   ,MO,64147-1341,Private      ,58,68,126,156,138,294
00245300,CENTRAL METHODIST UNIVERSITY            ,MO,65248-1198,Private      ,346,581,927,1931,1888,3819
00245400,UNIVERSITY OF CENTRAL MISSOURI          ,MO,64093-5178,Public       ,2209,1621,3830,8343,3767,12110
00245600,COLUMBIA COLLEGE                        ,MO,65216-4581,Private      ,746,4815,5561,2691,15866,18557
00245700,CONCORDIA SEMINARY                      ,MO,63105-3199,Private      ,2,80,82,3,397,400
00245800,COTTEY COLLEGE                          ,MO,64772-2790,Private      ,59,17,76,325,52,377
00245900,CROWDER COLLEGE                         ,MO,64850-9165,Public       ,899,1041,1940,2243,2171,4414
00246000,CULVER STOCKTON COLLEGE                 ,MO,63435-1299,Private      ,237,55,292,1357,180,1537
00246100,DRURY UNIVERSITY                        ,MO,65802-3791,Private      ,552,1233,1785,2253,2647,4900
00246200,EDEN THEOLOGICAL SEMINARY               ,MO,63119-0000,Private      ,1,42,43,2,96,98
00246300,EVANGEL UNIVERSITY                      ,MO,65802-2125,Private      ,646,390,1036,2065,786,2851
00246302,EVANGEL UNIVERSITY - ASSEMBLIES OF GOD T,MO,65802-2131,Private      ,50,56,106,180,147,327
00246400,FONTBONNE UNIVERSITY                    ,MO,63105-3098,Private      ,275,750,1025,1209,1714,2923
00246600,HARRIS-STOWE STATE COLLEGE              ,MO,63103-2199,Public       ,407,625,1032,1135,1368,2503
00246700,CONCEPTION SEMINARY COLLEGE             ,MO,64433-0502,Private      ,10,5,15,33,8,41
00246800,JEFFERSON COLLEGE                       ,MO,63050-2441,Public       ,960,1032,1992,2336,1986,4322
00247100,ST LOUIS COMMUNITY COLLEGE              ,MO,63102-0000,Public       ,3593,5593,9186,8786,10832,19618
00247300,KANSAS CITY ART INSTITUTE               ,MO,64111-1874,Private      ,236,112,348,1166,317,1483
00247400,KANSAS CITY UNIV OF MED AND BIOSCIENCES ,MO,64106-0000,Private      ,26,370,396,93,1156,1249
00247600,KENRICK-GLENNON SEMINARY                ,MO,63119-4330,Private      ,5,3,8,22,10,32
00247700,A.T. STILL UNIV OF HEALTH SCIENCES      ,MO,63501-0000,Private      ,7,1027,1034,30,2738,2768
00247900,LINCOLN UNIVERSITY                      ,MO,65101-3500,Public       ,683,514,1197,2279,1325,3604
00248000,LINDENWOOD UNIVERSITY                   ,MO,63301-1695,Private      ,1560,2175,3735,6436,5425,11861
00248200,MARYVILLE UNIVERSITY                    ,MO,63141-7299,Private      ,455,1599,2054,2582,3498,6080
00248400,METROPOLITAN COMMUNITY COLLEGE          ,MO,64111-2408,Public       ,3356,4769,8125,7503,9502,17005
00248500,MIDWESTERN BAPTIST THEOL SEMINARY       ,MO,64118-4697,Private      ,54,155,209,90,293,383
00248600,MINERAL AREA COLLEGE                    ,MO,63601-1000,Public       ,635,841,1476,1704,1743,3447
00248800,MISSOURI SOUTHERN STATE UNIVERSITY      ,MO,64801-1595,Public       ,1278,1289,2567,4056,2849,6905
00248900,MISSOURI VALLEY COLLEGE                 ,MO,65340-3197,Private      ,384,139,523,1503,344,1847
00249000,MISSOURI WESTERN STATE UNIVERSITY       ,MO,64507-2294,Public       ,890,771,1661,4091,2007,6098
00249100,MOBERLY AREA COMMUNITY COLLEGE          ,MO,65270-1304,Public       ,938,1057,1995,2659,2265,4924
00249400,NAZARENE THEOLOGICAL SEMINARY           ,MO,64131-1246,Private      ,3,41,44,9,141,150
00249500,TRUMAN STATE UNIVERSITY                 ,MO,63501-4221,Public       ,802,138,940,5645,512,6157
00249600,NORTHWEST MISSOURI STATE UNIV           ,MO,64468-6001,Public       ,1218,358,1576,5958,1134,7092
00249800,PARK UNIVERSITY                         ,MO,64152-3795,Private      ,430,2545,2975,1310,6097,7407
00249900,ROCKHURST UNIVERSITY                    ,MO,64110-2561,Private      ,320,412,732,2281,1056,3337
00250000,COLLEGE OF THE OZARKS                   ,MO,65726-2502,Private      ,304,77,381,3415,328,3743
00250100,SOUTHEAST MISSOURI STATE UNIV           ,MO,63701-4799,Public       ,1259,1097,2356,8646,3508,12154
00250200,SOUTHWEST BAPTIST UNIVERSITY            ,MO,65613-2597,Private      ,354,476,830,1950,1258,3208
00250300,MISSOURI STATE UNIVERSITY               ,MO,65897-0094,Public       ,3362,2632,5994,15628,6999,22627
00250400,ST LOUIS COLLEGE OF PHARMACY            ,MO,63110-1088,Private      ,153,241,394,766,703,1469
00250600,SAINT LOUIS UNIVERSITY                  ,MO,63103-2097,Private      ,977,1899,2876,10033,6431,16464
00250900,SAINT PAUL SCHOOL OF THEOLOGY           ,MO,64127-2499,Private      ,0,39,39,2,78,80
00251200,STEPHENS COLLEGE                        ,MO,65215-0001,Private      ,132,227,359,986,513,1499
00251400,NORTH CENTRAL MISSOURI COLLEGE          ,MO,64683-1824,Public       ,288,283,571,848,631,1479
00251600,UNIVERSITY OF MISSOURI - COLUMBIA       ,MO,65211-1600,Public       ,3223,2051,5274,26548,7575,34123
00251700,MISSOURI UNIVERSITY OF SCIENCE & TECHNOL,MO,65409-0250,Public       ,863,374,1237,6154,1207,7361
00251800,UNIVERSITY OF MISSOURI-KANSAS CITY      ,MO,64110-2497,Public       ,1694,3059,4753,7540,7858,15398
00251900,UNIVERSITY OF MISSOURI-ST LOUIS         ,MO,63121-4499,Public       ,1819,3488,5307,6577,8414,14991
00252000,WASHINGTON UNIVERSITY                   ,MO,63130-4899,Private      ,686,1312,1998,15571,4904,20475
00252001,WASHINGTON UNIV-SCHOOL OF MEDICINE      ,MO,63110-0000,Private      ,33,471,504,166,1460,1626
00252100,WEBSTER UNIVERSITY                      ,MO,63119-3194,Private      ,607,4358,4965,3421,9620,13041
00252200,WENTWORTH MILITARY ACADEMY              ,MO,64067-1799,Private      ,118,60,178,271,158,429
00252300,WESTMINSTER COLLEGE                     ,MO,65251-1299,Private      ,110,32,142,1121,150,1271
00252400,WILLIAM JEWELL COLLEGE                  ,MO,64068-1896,Private      ,153,84,237,1248,218,1466
00252500,WILLIAM WOODS UNIVERSITY                ,MO,65251-2388,Private      ,222,418,640,972,838,1810
00405704,NATIONAL AMERICAN UNIVERSITY            ,MO,64057-1791,Proprietary  ,16,188,204,40,453,493
00441300,MERCY HOSPITAL SPRINGFIELD SCHOOL OF RAD,MO,65804-2263,Private      ,30,80,110,106,189,295
00470300,LOGAN COLLEGE OF CHIROPRACTIC           ,MO,63006-0000,Private      ,9,230,239,40,619,659
00470700,COVENANT THEOLOGICAL SEMINARY           ,MO,63141-8697,Private      ,1,177,178,4,410,414
00471100,LINN STATE TECHNICAL COLLEGE            ,MO,65051-9607,Public       ,337,189,526,1398,447,1845
00471300,THREE RIVERS COMMUNITY COLLEGE          ,MO,63901-2393,Public       ,680,1101,1781,1739,2398,4137
00528800,KIRKSVILLE AREA TECHNICAL CENTER        ,MO,63501-0000,Public       ,7,27,34,32,62,94
00528900,WAYNESVILLE CAREER CENTER               ,MO,65583-2131,Public       ,41,51,92,70,102,172
00542400,SOUTH CENTRAL CAREER CENTER             ,MO,65775-3334,Public       ,19,43,62,41,104,145
00542600,SIKESTON CAREER AND TECHNOLOGY CTR      ,MO,63801-0000,Public       ,30,82,112,91,189,280
00542900,ROLLA TECHNICAL INSTITUTE               ,MO,65401-3601,Public       ,72,109,181,256,282,538
00543000,POPLAR BLUFF TECHNICAL CAREER CNTR      ,MO,63901-0000,Public       ,23,71,94,54,155,209
00543800,SALINE COUNTY CAREER CENTER             ,MO,65340-0000,Public       ,0,8,8,13,48,61
00544500,TRUMAN MEDICAL CENTER SCHOOL OF NURSE AN,MO,64108-2677,Private      ,24,64,88,70,156,226
00553100,GRAND RIVER TECHNICAL SCHOOL            ,MO,64601-1299,Public       ,27,16,43,64,42,106
00553200,CAPE GIRARDEAU CAREER & TECHNOLOGY CENTE,MO,63703-7511,Public       ,119,209,328,293,450,743
00638900,BARNES JEWISH COLLEGE OF NURSING AND ALL,MO,63110-1091,Private      ,156,344,500,542,968,1510
00639200,RESEARCH COLLEGE OF NURSING             ,MO,64132-1199,Proprietary  ,48,125,173,137,286,423
00639201,RESEARCH MEDICAL CENTER - COLLEGE OF NUR,MO,64132-1199,Proprietary  ,22,59,81,53,149,202
00639202,RESEARCH MED CTR SCHL OF RAD TECH       ,MO,64132-0000,Proprietary  ,6,21,27,15,61,76
00666600,LUTHERAN  SCHOOL OF NURSING             ,MO,63118-3909,Proprietary  ,40,183,223,105,421,526
00732923,ITT TECHNICAL INSTITUTE                 ,MO,63045-1122,Proprietary  ,231,1403,1634,397,2067,2464
00754000,MISSOURI BAPTIST UNIVERSITY             ,MO,63141-8698,Private      ,458,778,1236,1687,1797,3484
00808000,STATE FAIR COMMUNITY COLLEGE            ,MO,65301-0000,Public       ,775,1095,1870,1918,2136,4054
00826900,HILLYARD TECHNICAL CENTER               ,MO,64506-0000,Public       ,58,115,173,149,246,395
00855200,STEVENS INSTITUTE OF BUSINESS & ARTS    ,MO,63103-0000,Proprietary  ,46,100,146,100,194,294
00860600,TRI-COUNTY TECHNICAL SCHOOL             ,MO,65026-0000,Public       ,1,2,3,5,16,21
00886200,EAST CENTRAL COLLEGE                    ,MO,63084-0529,Public       ,590,708,1298,1766,1639,3405
00908900,HANNIBAL-LAGRANGE COLLEGE               ,MO,63401-1999,Private      ,189,176,365,782,420,1202
00952000,NATIONAL ACADEMY OF BEAUTY ARTS         ,MO,63128-1307,Proprietary  ,37,120,157,63,191,254
00959000,INDEPENDENCE COLLEGE OF COSMETOLOGY     ,MO,64055-1105,Proprietary  ,18,36,54,34,78,112
00960700,HOUSE OF HEAVILIN BEAUTY COLLEGE        ,MO,64110-2826,Proprietary  ,11,59,70,19,91,110
00978200,SAINT LUKE'S COLLEGE OF HEALTH SCIENCES ,MO,64114-3237,Private      ,92,223,315,246,471,717
00979500,MISSOURI COLLEGE                        ,MO,63144-2901,Proprietary  ,91,266,357,168,426,594
01014814,COLORADO TECHNL UNIV NORTH KANSAS CITY  ,MO,64116-3614,Proprietary  ,11,84,95,39,188,227
01027900,HICKEY COLLEGE                          ,MO,63146-0000,Proprietary  ,272,160,432,514,307,821
01040500,PINNACLE CAREER INSTITUTE               ,MO,64131-3367,Proprietary  ,58,616,674,82,833,915
01040501,PINNACLE CAREER INSTITUTE - NORTH KANSAS,MO,64153-1151,Proprietary  ,34,148,182,54,249,303
01050303,WICHITA TECHNICAL INSTITUTE - WTI JOPLIN,MO,64801-2970,Proprietary  ,19,147,166,33,226,259
01102600,WARRENSBURG AREA VOC TECH SCH           ,MO,64093-0000,Public       ,18,25,43,48,84,132
01173500,PIKE/LINCOLN TECHNICAL CENTER           ,MO,63344-0000,Public       ,19,27,46,32,50,82
01250000,RANKEN TECHNICAL COLLEGE                ,MO,63113-2811,Private      ,510,776,1286,1303,1440,2743
01258000,ST LOUIS CHRISTIAN COLLEGE              ,MO,63033-6499,Private      ,41,75,116,110,135,245
01320800,BAPTIST BIBLE COLLEGE                   ,MO,65803-3498,Private      ,106,76,182,234,172,406
02056100,FOUR RIVERS CAREER CENTER               ,MO,63090-0000,Public       ,7,21,28,15,52,67
02068200,COX HEALTH - COX COLLEGE                ,MO,65802-0000,Private      ,126,391,517,357,953,1310
02119204,COURT REPORTING INSTITUTE OF DALLAS - CO,MO,63105-3329,Proprietary  ,5,98,103,15,182,197
02121100,MIDWEST INSTITUTE                       ,MO,63122-0000,Proprietary  ,19,59,78,43,91,134
02124500,FRANKLIN TECHNOLOGY CENTER              ,MO,64801-0000,Public       ,44,179,223,84,324,408
02142200,LEX LA RAY TECHNICAL CENTER             ,MO,64067-0000,Public       ,13,21,34,27,68,95
02154900,MISSOURI SCH OF BARB & HAIR             ,MO,63031-0000,Proprietary  ,4,29,33,8,57,65
02164200,FOREST INST PROFESSIONAL PSYCHOLOGY     ,MO,65807-0000,Private      ,4,76,80,8,202,210
02165900,CHILLICOTHE BEAUTY ACADEMY              ,MO,64601-0000,Proprietary  ,2,9,11,5,17,22
02180200,METRO BUSINESS COLLEGE                  ,MO,63701-0000,Proprietary  ,45,240,285,90,442,532
02188000,NORTHWEST TECHNICAL SCHOOL              ,MO,64468-0000,Public       ,17,16,33,48,38,86
02188100,NORTHLAND CAREER CENTER                 ,MO,64079-8333,Public       ,10,27,37,23,55,78
02202700,OZARK CHRISTIAN COLLEGE                 ,MO,64801-0000,Private      ,189,57,246,606,160,766
02203400,NEVADA REGIONAL TECHNICAL CENTER        ,MO,64772-0000,Public       ,17,35,52,48,54,102
02205200,SANFORD-BROWN COLLEGE                   ,MO,63026-7305,Proprietary  ,10,47,57,19,86,105
02205203,SANFORD BROWN COLLEGE-ST. PETERS        ,MO,63376-5950,Proprietary  ,6,21,27,16,60,76
02214500,SALEM COLLEGE OF HAIRSTYLING            ,MO,65401-0000,Proprietary  ,7,12,19,11,25,36
02239200,ANTHEM COLLEGE                          ,MO,63043-0000,Proprietary  ,38,114,152,56,202,258
02239202,ANTHEM COLLEGE - METRO SOUTH            ,MO,63026-0000,Proprietary  ,59,135,194,76,210,286
02250600,EVEREST COLLEGE                         ,MO,65807-2446,Proprietary  ,49,208,257,96,431,527
02263106,ANTHEM COLLEGE - ANTHEM COLLEGE - KANSAS,MO,64114-3232,Proprietary  ,5,31,36,14,72,86
02263400,LAKE CAREER AND TECHNICAL CENTER        ,MO,65020-0000,Public       ,11,10,21,18,33,51
02266400,CENTRAL CHRISTIAN CLG OF THE BIBLE      ,MO,65270-0000,Private      ,74,69,143,197,122,319
02277500,HOUSE OF HEAVILIN OF BLUE SPRINGS       ,MO,64014-3953,Proprietary  ,23,51,74,37,79,116
02289200,COLUMBIA AREA CAREER CENTER             ,MO,65203-0000,Public       ,52,158,210,136,334,470
02295700,MISSOURI BEAUTY ACADEMY                 ,MO,63640-1827,Proprietary  ,20,31,51,35,56,91
02300105,EVEREST COLLEGE - EARTH CITY            ,MO,63045-1100,Proprietary  ,57,190,247,81,290,371
02304000,MISSOURI TECH                           ,MO,63303-3887,Proprietary  ,29,74,103,66,151,217
02309100,AMERICAN COLLEGE OF HAIR DESIGN         ,MO,65301-2144,Proprietary  ,5,18,23,15,29,44
02313000,CASS CAREER CENTER                      ,MO,64701-0000,Public       ,5,17,22,12,69,81
02340500,ST LOUIS COLLEGE OF HEALTH CAREERS      ,MO,63110-0000,Proprietary  ,117,427,544,212,737,949
02342100,CAREER & TECHNOLOGY CTR AT FT OSAGE     ,MO,64058-0000,Public       ,3,16,19,9,36,45
02361600,CONCORDE CAREER COLLEGE                 ,MO,64111-0000,Proprietary  ,118,539,657,206,979,1185
02497500,CLINTON TECHNICAL SCHOOL                ,MO,64735-2966,Public       ,7,43,50,16,70,86
02520800,MERRELL UNIV OF BTY ARTS & SCIENCES     ,MO,65109-0000,Proprietary  ,30,68,98,72,124,196
02530600,SAINT CHARLES COMMUNITY COLLEGE         ,MO,63376-0975,Public       ,1755,1130,2885,3732,2176,5908
02543800,PARIS II EDUCATIONAL CENTER (THE)       ,MO,64118-0000,Proprietary  ,16,50,66,25,75,100
02564700,ELAINE STEVEN BEAUTY COLLEGE            ,MO,63136-0000,Proprietary  ,33,89,122,58,159,217
02564702,ELAINE STEVEN BEAUTY COLLEGE - ADVANCE B,MO,63401-2269,Proprietary  ,3,3,6,13,10,23
02568500,GRABBER SCHOOL OF HAIR DESIGN           ,MO,63011-0000,Proprietary  ,51,58,109,77,85,162
02599700,VATTEROTT COLLEGE                       ,MO,63134-2900,Proprietary  ,205,881,1086,251,1174,1425
02599701,VATTEROTT COLLEGE - KANSAS CITY         ,MO,64117-0000,Proprietary  ,71,500,571,121,701,822
02599702,VATTEROTT COLLEGE - SPRINGFIELD LOCATION,MO,65807-5340,Proprietary  ,74,334,408,118,550,668
02599703,VATTEROTT COLLEGE - JOPLIN              ,MO,64801-5033,Proprietary  ,31,251,282,55,397,452
02599705,VATTEROTT COLLEGE - SUNSET HILLS        ,MO,63127-1516,Proprietary  ,55,318,373,83,475,558
02599712,VATTEROTT COLLEGE - O'FALLON            ,MO,63366-2748,Proprietary  ,72,251,323,97,389,486
02599714,VATTEROTT COLLEGE - EX'TREME INSTITUTE B,MO,63102-2115,Proprietary  ,138,304,442,231,526,757
02608000,NEOSHO BEAUTY COLLEGE                   ,MO,64850-1525,Proprietary  ,5,8,13,14,22,36
02609202,VATTEROTT COLLEGE-ST JOSEPH             ,MO,64501-2911,Proprietary  ,29,95,124,60,249,309
02609203,VATTEROTT COLLEGE - L'ECOLE CULINAIRE   ,MO,63124-1103,Proprietary  ,46,172,218,86,313,399
02609206,VATTEROTT COLLEGE - L'ECOLE CULINAIRE   ,MO,64112-2110,Proprietary  ,27,171,198,49,239,288
02611004,HERITAGE COLLEGE-KANSAS CITY            ,MO,64131-4203,Proprietary  ,81,281,362,146,516,662
03042400,LEBANON TECHNOLOGY & CAREER CENTER      ,MO,65536-3296,Public       ,15,8,23,46,49,95
03066300,BRYAN CAREER COLLEGE                    ,MO,65806-2507,Proprietary  ,35,300,335,58,412,470
03066303,BRYAN COLLEGE - COLUMBIA                ,MO,65201-8248,Proprietary  ,35,140,175,82,246,328
03068600,SPECIAL SCHOOL DISTRICT OF ST. LOUIS CO.,MO,63127-0000,Public       ,19,175,194,37,319,356
03070200,CENTRAL COLLEGE OF COSMETOLOGY          ,MO,65583-0000,Proprietary  ,13,22,35,18,39,57
03070900,SE MO HOSP CLG NURSING & HEALTH SCI     ,MO,63703-4507,Private      ,47,110,157,167,389,556
03072800,DALLAS COUNTY CAREER CENTER             ,MO,65685-9152,Public       ,0,0,0,0,1,1
03077200,COSMETOLOGY CONCEPTS INSTITUTE          ,MO,65202-1972,Proprietary  ,17,44,61,38,82,120
03083000,OZARKS TECHNICAL COMMUNITY COLLEGE      ,MO,65802-3601,Public       ,2756,4103,6859,6319,7673,13992
03092600,MESSENGER COLLEGE                       ,MO,64804-0000,Private      ,58,32,90,71,58,129
03097600,ST LOUIS HAIR ACADEMY                   ,MO,63107-1737,Proprietary  ,15,48,63,40,97,137
03101000,NEW DIMENSION SCHOOL OF HAIR DESIGN     ,MO,64801-5017,Proprietary  ,4,32,36,18,58,76
03106000,MISSOURI STATE UNIVERSITY - WEST PLAINS ,MO,65775-2715,Public       ,334,468,802,1117,953,2070
03110900,HOUSE OF HEAVILIN BEAUTY COLLEGE        ,MO,64083-9195,Proprietary  ,12,15,27,18,23,41
03174300,HERNDON CAREER CENTER                   ,MO,64138-2695,Public       ,2,0,2,7,6,13
03519300,MISSOURI COLLEGE OF COSMETOLOGY NORTH   ,MO,65803-0000,Proprietary  ,36,47,83,61,104,165
03579300,TEXAS COUNTY TECHNICAL INSTITUTE        ,MO,65483-2700,Private      ,12,51,63,30,188,218
03616300,AVIATION INSTITUTE OF MAINTENANCE       ,MO,64129-1811,Proprietary  ,18,106,124,28,158,186
03878300,PROFESSIONAL MASSAGE TRAINING CENTER    ,MO,65803-2939,Proprietary  ,8,43,51,17,72,89
03916300,ECLIPS SCHOOL OF COSMETOLOGY AND BARBERI,MO,63703-5809,Proprietary  ,19,70,89,45,116,161
03924300,HAIR ACADEMY 110 (THE)                  ,MO,63501-2915,Proprietary  ,4,12,16,7,17,24
03970400,WELLSPRING SCHOOL OF ALLIED HEALTH      ,MO,64114-3313,Proprietary  ,24,92,116,38,158,196
04037500,ACADEMY OF HAIR DESIGN                  ,MO,65804-2303,Proprietary  ,34,96,130,57,168,225
04051329,ART INSTITUTE OF PHOENIX (THE) - BROWN M,MO,63026-2564,Proprietary  ,53,71,124,96,154,250
04118700,AMERICAN COLLEGE OF TECHNOLOGY          ,MO,64506-2006,Proprietary  ,6,210,216,21,510,531
04119100,CITY VISION COLLEGE                     ,MO,64141-3188,Private      ,2,34,36,11,86,97
04122300,GRANTHAM UNIVERSITY                     ,MO,64153-2262,Proprietary  ,206,4232,4438,405,8265,8670
04130300,VICTORY TRADE SCHOOL                    ,MO,65803-2754,Private      ,8,22,30,15,62,77
04130600,"CENTER FOR HEALING ARTS (THE), LLC      ",MO,63143-2103,Proprietary  ,6,46,52,13,100,113
04133300,TREND SETTERS SCHOOL OF COSMETOLOGY     ,MO,63702-7607,Proprietary  ,15,29,44,38,60,98
04145200,TRANSFORMED BARBER AND COSMETOLOGY ACADE,MO,64137-1207,Proprietary  ,13,46,59,34,123,157
04145700,THE SYSTEM A PAUL MITCHELL PARTNER SCHL ,MO,65807-5969,Proprietary  ,43,46,89,78,97,175
04146100,URSHAN GRADUATE SCHOOL OF THEOLOGY      ,MO,63031-7526,Private      ,11,17,28,33,29,62
04152200,CARTHAGE R-9 SCHOOL DISTRICT/CARTHAGE TE,MO,64836-1332,Public       ,9,22,31,10,38,48
04170600,SALON PROFESSIONAL ACADEMY (THE)        ,MO,63301-1021,Proprietary  ,23,44,67,34,73,107
04170700,PAUL MITCHELL THE SCHOOL ST LOUIS       ,MO,63108-1554,Proprietary  ,80,110,190,155,188,343
04173900,COSMETOLOGY COLLEGE OF FRANKLIN COUNTY  ,MO,63077-3448,Proprietary  ,3,6,9,6,20,26
04174000,SKIN INSTITUTE                          ,MO,63128-1307,Proprietary  ,8,30,38,23,61,84
04174800,AMERICAN TRADE SCHOOL                   ,MO,63074-1807,Proprietary  ,12,55,67,28,104,132
04179000,"SALON PROFESSIONAL ACADEMY, THE         ",MO,65616-7216,Proprietary  ,2,17,19,6,35,41
04184400,SEYMOUR BEAUTY ACADEMY                  ,MO,65746-8743,Proprietary  ,5,16,21,8,21,29
04187000,DONNA'S ACADEMY OF HAIR DESIGN          ,MO,64089-9042,Proprietary  ,11,6,17,13,13,26
04212100,ACADEMY OF SALON PROFESSIONALS          ,MO,65301-6910,Proprietary  ,8,29,37,14,47,61
04218400,CITY POINTE BEAUTY ACADEMY              ,MO,64870-2502,Proprietary  ,22,28,50,37,40,77
00314600,WESTERN OKLAHOMA STATE COLLEGE          ,OK,73521-1397,Public       ,162,291,453,414,556,970
00314700,BACONE COLLEGE                          ,OK,74403-1597,Private      ,463,227,690,934,482,1416
00314900,SOUTHERN NAZARENE UNIVERSITY            ,OK,73008-2694,Private      ,307,708,1015,985,1336,2321
00315000,CAMERON UNIVERSITY                      ,OK,73505-6377,Public       ,600,1329,1929,1735,2790,4525
00315100,OKLAHOMA WESLEYAN UNIVERSITY            ,OK,74006-6299,Private      ,190,409,599,1004,878,1882
00315200,UNIV OF CENTRAL OKLAHOMA                ,OK,73034-5209,Public       ,2577,2784,5361,8466,5721,14187
00315300,CONNORS STATE COLLEGE                   ,OK,74469-2204,Public       ,356,449,805,1020,1107,2127
00315400,EAST CENTRAL UNIVERSITY                 ,OK,74820-6999,Public       ,575,813,1388,2357,1817,4174
00315500,EASTERN OKLAHOMA STATE COLLEGE          ,OK,74578-4999,Public       ,214,347,561,701,742,1443
00315600,REDLANDS COMMUNITY COLLEGE              ,OK,73036-5304,Public       ,191,334,525,617,659,1276
00315700,LANGSTON UNIVERSITY                     ,OK,73050-0000,Public       ,720,656,1376,2702,1535,4237
00315800,MURRAY STATE COLLEGE                    ,OK,73460-3137,Public       ,306,530,836,988,1108,2096
00316000,NORTHEASTERN OKLAHOMA A & M COLLEGE     ,OK,74354-6497,Public       ,499,395,894,1533,844,2377
00316100,NORTHEASTERN STATE UNIVERSITY           ,OK,74464-2399,Public       ,1411,1938,3349,4562,4599,9161
00316200,NORTHERN OKLAHOMA COLLEGE               ,OK,74653-0310,Public       ,524,556,1080,1373,1217,2590
00316300,NORTHWESTERN OKLAHOMA STATE UNIV        ,OK,73717-2799,Public       ,357,321,678,1196,683,1879
00316400,OKLAHOMA BAPTIST UNIVERSITY             ,OK,74801-2590,Private      ,486,134,620,2628,388,3016
00316500,OKLAHOMA CHRISTIAN UNIVERSITY           ,OK,73131-0000,Private      ,609,316,925,2232,704,2936
00316600,OKLAHOMA CITY UNIVERSITY                ,OK,73106-1493,Private      ,503,962,1465,2361,2110,4471
00316700,UNIV OF SCIENCE & ARTS OF OKLAHOMA      ,OK,73018-5322,Public       ,197,142,339,678,333,1011
00316800,ROGERS STATE UNIVERSITY                 ,OK,74017-3252,Public       ,745,934,1679,2326,2089,4415
00317000,OKLAHOMA STATE UNIVERSITY               ,OK,74078-1026,Public       ,4002,2538,6540,17457,6545,24002
00317200,OKLAHOMA STATE UNIVERSITY-OKMULGEE      ,OK,74447-3901,Public       ,450,491,941,1536,1466,3002
00317400,OKLAHOMA PANHANDLE STATE UNIVERSITY     ,OK,73939-0000,Public       ,228,135,363,702,276,978
00317600,CARL ALBERT STATE COLLEGE               ,OK,74953-5208,Public       ,367,614,981,1111,1230,2341
00317800,SEMINOLE STATE COLLEGE                  ,OK,74818-0351,Public       ,237,380,617,729,779,1508
00317900,SOUTHEASTERN OKLAHOMA STATE UNIV        ,OK,74701-0609,Public       ,583,806,1389,2051,1836,3887
00318000,SOUTHWESTERN CHRISTIAN UNIVERSITY       ,OK,73008-2335,Private      ,148,261,409,384,450,834
00318100,SOUTHWESTERN OKLAHOMA STATE UNIV        ,OK,73096-3098,Public       ,700,629,1329,2812,1453,4265
00318101,SOUTHWESTERN OK STATE UNIV AT SAYRE     ,OK,73662-0000,Public       ,19,64,83,100,121,221
00318300,ST GREGORY'S UNIVERSITY                 ,OK,74804-2499,Private      ,179,126,305,449,269,718
00318308,SAINT GREGORY'S UNIVERSITY - IPD TULSA  ,OK,74135-2499,Private      ,17,75,92,39,170,209
00318400,UNIVERSITY OF OKLAHOMA                  ,OK,73019-4078,Public       ,3432,3395,6827,17038,8112,25150
00318401,UNIVERSITY OF OKLAHOMA-HLTH SCI CTR     ,OK,73190-0000,Public       ,247,1332,1579,763,3066,3829
00318500,UNIVERSITY OF TULSA                     ,OK,74104-3189,Private      ,551,634,1185,3668,1615,5283
00398500,ORAL ROBERTS UNIVERSITY                 ,OK,74171-0001,Private      ,857,601,1458,2679,1378,4057
00531100,TULSA COUNTY AREA VOC TECH SCHOOL       ,OK,74145-0000,Public       ,262,595,857,511,1181,1692
00531200,RED RIVER TECHNOLOGY CENTER             ,OK,73533-2700,Public       ,14,49,63,25,100,125
00533900,METRO TECHNOLOGY CENTERS SCH DIST22     ,OK,73111-0000,Public       ,89,353,442,186,712,898
00533903,METRO TECHNOLOGY CENTERS SCH DIST22     ,OK,73129-0000,Public       ,48,245,293,102,494,596
00694200,MID-AMERICA CHRISTIAN UNIVERSITY        ,OK,73170-4504,Private      ,157,929,1086,423,2043,2466
00767800,SPARTAN COLLEGE OF AERONAUTICS AND TECHN,OK,74115-5800,Proprietary  ,332,318,650,707,507,1214
00791100,VIRGILS BEAUTY COLLEGE                  ,OK,74401-6802,Proprietary  ,9,13,22,14,29,43
00834300,AUTRY TECHNOLOGY CENTER                 ,OK,73703-2598,Public       ,39,97,136,83,184,267
00861900,TRI COUNTY TECHNOLOGY CENTER            ,OK,74006-6029,Public       ,15,41,56,34,92,126
00918500,ROSE STATE COLLEGE                      ,OK,73110-2799,Public       ,890,1640,2530,2217,3253,5470
00920400,KIAMICHI TECHNOLOGY CENTER              ,OK,74578-0548,Public       ,92,314,406,215,625,840
00961800,TULSA WELDING SCHOOL                    ,OK,74104-0000,Proprietary  ,552,735,1287,1136,1196,2332
00964700,"OKLAHOMA STATE UNIV, OKLA CITY          ",OK,73107-6159,Public       ,867,2265,3132,2552,4476,7028
00970800,EVES COLLEGE OF HAIRSTYLING             ,OK,73501-0000,Proprietary  ,11,48,59,17,74,91
00976300,TULSA COMMUNITY COLLEGE                 ,OK,74135-6198,Public       ,2923,3982,6905,6658,8451,15109
00996300,CADDO KIOWA VOC TECH CENTER             ,OK,73038-0000,Public       ,22,62,84,49,160,209
00996400,CENTRAL OKLAHOMA AREA VOC TECH SCH      ,OK,74030-9613,Public       ,28,90,118,59,195,254
00996500,CANADIAN VALLEY TECHNOLOGY CENTER       ,OK,73036-9117,Public       ,29,110,139,62,202,264
00996800,GORDON COOPER TECHNOLOGY CENTER         ,OK,74804-9913,Public       ,38,133,171,88,283,371
01005300,INDIAN CAPITAL TECHNOLGY CENTER #4      ,OK,74403-9907,Public       ,66,174,240,181,433,614
01026600,HILLSDALE FREE WILL BAPTIST COLLEGE     ,OK,73153-0000,Private      ,64,26,90,152,53,205
01034200,SOUTHERN OKLAHOMA TECHNOLOGY CENTER     ,OK,73401-2100,Public       ,29,97,126,63,192,255
01039100,OKLAHOMA CITY COMMUNITY COLLEGE         ,OK,73159-4444,Public       ,1469,2992,4461,3883,6012,9895
01050304,WTI TULSA CAMPUS                        ,OK,74112-3140,Proprietary  ,11,123,134,20,173,193
01071700,GREAT PLAINS TECHNOLOGY CENTER SCHOOL DI,OK,73505-8399,Public       ,73,240,313,140,457,597
01076200,WESTERN OK AREA VOC TECH SCH DIST12     ,OK,73624-1469,Public       ,16,35,51,32,75,107
01120600,PIONEER TECHNOLOGY CENTER               ,OK,74601-1106,Public       ,10,59,69,33,113,146
01128200,OKLAHOMA STATE UNV CLG OSTEOPTHC MD     ,OK,74107-0000,Public       ,46,298,344,134,623,757
01153700,MID-AMERICA TECHNOLOGY CENTER           ,OK,73095-0210,Public       ,11,42,53,22,82,104
01227200,MOORE-NORMAN TECHNOLOGY CENTER          ,OK,73069-8399,Public       ,106,301,407,213,614,827
02052700,NORTHEAST TECHNOLOGY CENTER             ,OK,74361-0487,Public       ,77,161,238,129,329,458
02060800,MERIDIAN TECHNOLOGY CENTER              ,OK,74074-0000,Public       ,58,106,164,128,220,348
02126500,ENID BEAUTY COLLEGE                     ,OK,73701-0000,Proprietary  ,12,19,31,17,32,49
02184400,SAND SPRINGS BEAUTY COLLEGE             ,OK,74063-0000,Proprietary  ,12,44,56,17,59,76
02197300,HOLLYWOOD COSMETOLOGY CENTER            ,OK,73189-0000,Proprietary  ,10,30,40,18,48,66
02222700,FRANCIS TUTTLE TECHNOLOGY CENTER        ,OK,73142-0000,Public       ,129,508,637,272,1010,1282
02238500,CENTRAL STATE BEAUTY ACADEMY            ,OK,73162-6007,Proprietary  ,29,113,142,49,186,235
02250900,E OK COUNTY AREA VO-TECH                ,OK,73020-0000,Public       ,24,28,52,43,53,96
02256200,"BROKEN ARROW BEAUTY COLLEGE, INC        ",OK,74012-0000,Proprietary  ,26,78,104,57,125,182
02282100,HIGH PLAINS AREA VOC-TECH               ,OK,73801-0000,Public       ,8,24,32,19,47,66
02306800,PLATT COLLEGE                           ,OK,74145-0000,Proprietary  ,93,475,568,168,808,976
02510300,BEAUTY TECHNICAL COLLEGE                ,OK,74465-0000,Proprietary  ,5,16,21,16,30,46
02531200,WOODWARD BEAUTY COLLEGE                 ,OK,73801-0000,Proprietary  ,11,21,32,12,26,38
02554300,AMERICAN BEAUTY INSTITUTE               ,OK,74501-0000,Proprietary  ,3,7,10,10,22,32
02556500,YUKON BEAUTY COLLEGE                    ,OK,73099-4108,Proprietary  ,2,11,13,6,15,21
02560200,PHILLIPS THEOLOGICAL SEMINARY -         ,OK,74116-5612,Private      ,1,34,35,2,56,58
02581100,CLAREMORE BEAUTY COLLEGE                ,OK,74017-7034,Proprietary  ,2,6,8,8,15,23
02581200,CC'S COSMETOLOGY COLLEGE                ,OK,74129-0000,Proprietary  ,24,54,78,48,114,162
02591101,CAREER POINT INSTITUTE                  ,OK,74146-0000,Proprietary  ,20,112,132,50,215,265
02596501,ATI-CAREER TRAINING CENTER - OKLAHOMA CI,OK,73107-2442,Proprietary  ,5,38,43,5,38,43
02596502,ATI- CAREER TRAINING CENTER - OKLAHOMA C,OK,76101-2740,Proprietary  ,10,55,65,10,55,65
02597400,PONTOTOC TECHNOLOGY CENTER SCHOOL       ,OK,74820-8621,Public       ,19,63,82,42,126,168
02599706,VATTEROTT COLLEGE - TULSA               ,OK,74146-2205,Proprietary  ,20,155,175,40,239,279
02600000,NORTHWEST TECHNOLOG CTR SCH DIST 10     ,OK,73717-9600,Public       ,3,10,13,14,23,37
02600500,WES WATKINS TECHNOLOGY CENTER           ,OK,74883-9660,Public       ,7,43,50,20,96,116
02609205,VATTEROTT COLLEGE - OKLAHOMA CITY       ,OK,73127-2103,Proprietary  ,26,273,299,54,460,514
03008700,SOUTHWEST TECHNOLOGY CENTER             ,OK,73521-1527,Public       ,15,50,65,29,96,125
03024700,STILLWATER BEAUTY ACADEMY               ,OK,74075-3467,Proprietary  ,3,16,19,19,34,53
03030700,OKLAHOMA SCHOOL OF PHOTOGRAPHY          ,OK,73160-3320,Proprietary  ,9,36,45,24,74,98
03030800,AMERICAN BROADCASTING SCHOOL            ,OK,73115-3334,Proprietary  ,12,78,90,25,163,188
03051100,CHISHOLM TRAIL TECHNOLOGY CENTER        ,OK,73764-6335,Public       ,5,21,26,8,40,48
03078500,TECH INST OF COSMETOLOGY ARTS & SCI     ,OK,74120-3610,Proprietary  ,11,24,35,24,56,80
03103800,SOUTHERN SCHOOL OF BEAUTY               ,OK,74701-5008,Proprietary  ,7,23,30,20,44,64
03109800,PONCA CITY BEAUTY COLLEGE               ,OK,74601-4201,Proprietary  ,5,15,20,9,26,35
03109801,BARTLESVILLE BEAUTY COLLEGE             ,OK,74003-2835,Proprietary  ,4,10,14,5,21,26
03115100,HERITAGE COLLEGE                        ,OK,73119-0000,Proprietary  ,76,355,431,154,652,806
03124800,PLATT COLLEGE                           ,OK,73501-3808,Proprietary  ,33,138,171,60,260,320
03124901,IMAGINE -  PAUL MITCHELL PARTNER SCHOOL ,OK,73072-4831,Proprietary  ,54,90,144,89,137,226
03126200,GREEN COUNTRY AREA VOC TECH SCHOOL      ,OK,74447-1217,Public       ,13,55,68,34,107,141
03198400,MID-DEL AREA VOCATIONAL & TECH SCH      ,OK,73110-4825,Public       ,19,62,81,37,124,161
03329400,PRYOR BEAUTY COLLEGE                    ,OK,74361-0000,Proprietary  ,1,15,16,4,23,27
03329401,PRYOR BEAUTY COLLEGE - GROVE BEAUTY COLL,OK,74345-0009,Proprietary  ,1,12,13,5,17,22
03329402,PRYOR BEAUTY COLLEGE - NORTH EAST OKLAHO,OK,74338-0000,Proprietary  ,2,2,4,3,3,6
03367400,COMMUNITY CARE COLLEGE                  ,OK,74145-6420,Proprietary  ,191,741,932,329,1177,1506
03453400,SHAWNEE BEAUTY COLLEGE                  ,OK,74801-7014,Proprietary  ,1,14,15,3,33,36
03676300,FAMILY OF FAITH COLLEGE                 ,OK,74802-1805,Private      ,0,8,8,9,17,26
03831300,INSTITUTE OF HAIR DESIGN                ,OK,74804-0000,Proprietary  ,1,12,13,2,20,22
03928300,CENTRAL STATE MASSAGE ACADEMY           ,OK,73162-6007,Proprietary  ,9,60,69,20,89,109
04051324,ART INSTITUTE OF PHOENIX (THE) - BROWN M,OK,74146-5234,Proprietary  ,24,95,119,69,277,346
04060300,AMERICAN INSTITUTE OF MEDICAL TECHNOLOGY,OK,74146-5201,Proprietary  ,31,89,120,82,193,275
04133600,CUTTER'S EDGE SCHOOL OF COSMETOLOGY     ,OK,74023-2905,Proprietary  ,3,8,11,7,13,20
04144400,ACADEMY OF HAIR DESIGN (THE)            ,OK,73120-6808,Proprietary  ,11,65,76,39,111,150
04184300,PAUL MITCHELL THE SCHOOL ARDMORE        ,OK,73401-3912,Proprietary  ,12,31,43,19,48,67
04213600,RIVER VALLEY COSMETOLOGY INSTITUTE      ,OK,74953-5260,Proprietary  ,5,20,25,13,40,53
04224700,JB'S HAIR DESIGN AND BARBER COLLEGE     ,OK,73139-1602,Proprietary  ,13,60,73,20,96,116
04224900,COLLEGE OF THE MUSCOGEE NATION          ,OK,74447-0917,Public       ,25,44,69,74,118,192
00163700,BETHANY THEOLOGICAL SEMINARY            ,IN,47374-0000,Private      ,0,30,30,3,49,52
00178400,ANCILLA COLLEGE-FINANCIAL AID OFFC      ,IN,46513-0001,Private      ,31,46,77,456,328,784
00178500,ANDERSON UNIVERSITY                     ,IN,46012-3495,Private      ,135,225,360,2597,971,3568
00178600,BALL STATE UNIVERSITY                   ,IN,47306-0880,Public       ,821,1199,2020,22861,7566,30427
00178700,BETHEL COLLEGE INC                      ,IN,46545-5591,Private      ,62,203,265,1575,1220,2795
00178800,BUTLER UNIVERSITY                       ,IN,46208-3487,Private      ,290,335,625,8738,2076,10814
00178900,CHRISTIAN THEOLOGICAL SEMINARY          ,IN,46208-0000,Private      ,0,50,50,18,243,261
00179200,DEPAUW UNIVERSITY                       ,IN,46135-0037,Private      ,285,28,313,3325,170,3495
00179300,EARLHAM COLLEGE                         ,IN,47374-4095,Private      ,171,42,213,1490,148,1638
00179301,EARLHAM SCHOOL OF RELIGION              ,IN,47374-0000,Private      ,2,15,17,14,29,43
00179500,UNIVERSITY OF EVANSVILLE                ,IN,47722-0002,Private      ,137,153,290,3382,810,4192
00179800,FRANKLIN COLLEGE OF INDIANA             ,IN,46131-2623,Private      ,45,40,85,1993,314,2307
00179900,GOSHEN COLLEGE                          ,IN,46526-4794,Private      ,70,77,147,900,472,1372
00180000,GRACE COLLEGE & THEO SEMINARY           ,IN,46590-1224,Private      ,119,103,222,2184,543,2727
00180100,HANOVER COLLEGE                         ,IN,47243-0108,Private      ,52,13,65,2236,118,2354
00180300,HUNTINGTON UNIVERSITY                   ,IN,46750-1299,Private      ,37,94,131,1355,447,1802
00180400,UNIVERSITY OF INDIANAPOLIS              ,IN,46227-3697,Private      ,183,668,851,6769,4802,11571
00180500,INDIANA INSTITUTE OF TECHNOLOGY         ,IN,46803-1297,Private      ,237,1272,1509,2529,6076,8605
00180700,INDIANA STATE UNIVERSITY                ,IN,47809-2501,Public       ,582,1224,1806,14769,6579,21348
00180800,UNIVERSITY OF SOUTHERN INDIANA          ,IN,47712-3596,Public       ,418,672,1090,8678,3442,12120
00180900,INDIANA UNIVERSITY-BLOOMINGTON          ,IN,47405-7000,Public       ,1587,1892,3479,34715,10393,45108
00181100,INDIANA UNIV-EAST                       ,IN,47374-1289,Public       ,124,531,655,2095,2477,4572
00181300,INDIANA UNIV-PURDUE UNIV INDPLS         ,IN,46202-5145,Public       ,1048,3324,4372,23831,21295,45126
00181301,INDIANA UNIVERSITY - PURDUE UNIVERSITY I,IN,47203-1769,Public       ,111,292,403,2152,1891,4043
00181400,INDIANA UNIV KOKOMO                     ,IN,46902-3557,Public       ,142,383,525,2534,2476,5010
00181500,INDIANA UNIV-NORTHWEST                  ,IN,46408-1197,Public       ,341,904,1245,4176,4809,8985
00181600,INDIANA UNIVERSITY - SOUTH BEND         ,IN,46615-0000,Public       ,251,737,988,5084,4825,9909
00181700,INDIANA UNIVERSITY-SOUTHEAST            ,IN,47150-6405,Public       ,393,745,1138,4358,3401,7759
00182000,MANCHESTER UNIVERSITY                   ,IN,46962-1276,Private      ,52,71,123,2448,524,2972
00182100,MARIAN UNIVERSITY                       ,IN,46222-1997,Private      ,106,552,658,2470,2963,5433
00182200,INDIANA WESLEYAN UNIVERSITY             ,IN,46953-4974,Private      ,321,3476,3797,4277,12399,16676
00182300,ASSOCIATED MENNONITE BIBLICAL SEM       ,IN,46517-1999,Private      ,1,42,43,2,81,83
00182400,OAKLAND CITY UNIVERSITY                 ,IN,47660-1099,Private      ,41,109,150,538,521,1059
00182500,PURDUE UNIVERSITY                       ,IN,47907-2050,Public       ,1118,1077,2195,33739,7103,40842
00182600,PURDUE UNIV NORTH CENTRAL CAMPUS        ,IN,46391-9542,Public       ,199,321,520,3063,2102,5165
00182700,PURDUE UNIV CALUMET                     ,IN,46323-2094,Public       ,520,1236,1756,5283,5546,10829
00182800,INDIANA UNIV-PURDUE UNIV FORT WAYNE     ,IN,46805-1499,Public       ,536,1121,1657,9756,6600,16356
00183000,ROSE HULMAN INSTITUTE OF TECHNOLOGY     ,IN,47803-3999,Private      ,172,30,202,3553,184,3737
00183200,UNIVERSITY OF SAINT FRANCIS             ,IN,46808-3994,Private      ,83,267,350,2432,1903,4335
00183300,ST JOSEPH'S COLLEGE                     ,IN,47978-0000,Private      ,87,31,118,1496,237,1733
00183400,CALUMET COLLEGE OF SAINT JOSEPH         ,IN,46394-2195,Private      ,62,135,197,540,620,1160
00183500,SAINT MARY-OF-THE-WOODS COLLEGE         ,IN,47876-0067,Private      ,34,196,230,420,900,1320
00183600,ST MARY'S COLLEGE                       ,IN,46556-5007,Private      ,78,18,96,1907,92,1999
00183800,TAYLOR UNIVERSITY                       ,IN,46989-1001,Private      ,115,62,177,2382,270,2652
00183900,TRINE UNIVERSITY                        ,IN,46703-1764,Private      ,76,121,197,3046,945,3991
00184000,UNIVERSITY OF NOTRE DAME                ,IN,46556-5602,Private      ,1608,500,2108,12705,2803,15508
00184200,VALPARAISO UNIVERSITY                   ,IN,46383-6493,Private      ,282,403,685,5777,1838,7615
00184300,VINCENNES UNIVERSITY                    ,IN,47591-1523,Public       ,435,724,1159,7091,3866,10957
00184400,WABASH COLLEGE                          ,IN,47933-0352,Private      ,54,15,69,1444,73,1517
00457900,INTERNATIONAL BUSINESS COLLEGE          ,IN,46804-0000,Proprietary  ,63,61,124,675,335,1010
00457901,INTERNATIONAL BUSINESS COLLEGE          ,IN,46256-0000,Proprietary  ,43,86,129,692,492,1184
00625700,SAINT ELIZABETH SCHOOL OF NURSING       ,IN,47904-2198,Private      ,5,59,64,203,416,619
00638510,CHAMBERLAIN COLLEGE OF NURSING - INDIANA,IN,46240-2158,Proprietary  ,25,343,368,155,1134,1289
00726300,HOLY CROSS COLLEGE                      ,IN,46556-0308,Private      ,66,24,90,720,112,832
00727600,SAINT MEINRAD SCHOOL OF THEOLOGY        ,IN,47577-1002,Private      ,0,16,16,4,51,55
00732900,ITT TECHNICAL INSTITUTE                 ,IN,46268-1119,Proprietary  ,1126,6473,7599,2225,11071,13296
00732933,ITT TECHNICAL INSTITUTE                 ,IN,46635-1512,Proprietary  ,39,243,282,299,854,1153
00732962,ITT TECHNICAL INSTITUTE                 ,IN,47630-7430,Proprietary  ,249,1703,1952,452,2630,3082
00732968,ITT TECHNICAL INSTITUTE                 ,IN,46410-0000,Proprietary  ,26,152,178,241,728,969
00732993,ITT TECHNICAL INSTITUTE                 ,IN,46825-2393,Proprietary  ,181,1051,1232,650,1968,2618
00736200,MEDTECH COLLEGE                         ,IN,46250-3970,Proprietary  ,44,362,406,298,1745,2043
00736202,MEDTECH COLLEGE - GREENWOOD             ,IN,46143-6478,Proprietary  ,24,146,170,144,772,916
00736204,MEDTECH COLLEGE - FORT WAYNE            ,IN,46804-2209,Proprietary  ,40,212,252,224,906,1130
00793800,LINCOLN COLLEGE OF TECHNOLOGY           ,IN,46202-0000,Proprietary  ,346,256,602,1449,848,2297
00931306,DAYMAR COLLEGE - ROCKPORT               ,IN,47635-1506,Proprietary  ,0,3,3,5,14,19
00951500,J MICHAEL HARROLD BEAUTY ACADEMY        ,IN,47807-3390,Proprietary  ,7,40,47,55,129,184
00961200,"APEX SCHOOL OF BEAUTY CULTURE, INC      ",IN,46016-0000,Proprietary  ,0,11,11,20,48,68
00961300,MERRILLVILLE BEAUTY COLLEGE             ,IN,46410-3401,Proprietary  ,6,53,59,53,162,215
00967300,RUDAE'S SCHOOL OF BEAUTY CULTURE        ,IN,46825-5444,Proprietary  ,14,71,85,122,194,316
00977700,KAPLAN COLLEGE                          ,IN,46278-1736,Proprietary  ,0,0,0,66,365,431
00977702,KAPLAN COLLEGE - TEMPORARY FACILITY EXPA,IN,46268-4111,Proprietary  ,0,0,0,2,8,10
00991700,IVY TECH COMMUNITY COLLEGE OF INDIANA   ,IN,46208-1763,Public       ,3311,13471,16782,38852,73115,111967
01015100,VINCENNES BEAUTY COLLEGE                ,IN,47591-1297,Proprietary  ,18,26,44,91,96,187
01040900,LAFAYETTE BEAUTY ACADEMY                ,IN,47901-1149,Proprietary  ,14,44,58,79,156,235
01048900,NATIONAL COLLEGE                        ,IN,46250-1930,Proprietary  ,4,84,88,42,383,425
01048910,NATIONAL COLLEGE - SOUTH BEND           ,IN,46617-3123,Proprietary  ,7,83,90,73,370,443
01048911,NATIONAL COLLEGE - FORT WAYNE           ,IN,46826-4905,Proprietary  ,5,56,61,50,253,303
01061800,MID-AMERICA CLG FUNERAL SERVICE         ,IN,47130-9990,Private      ,11,30,41,47,97,144
01150500,CREATIVE HAIR STYLING ACADEMY           ,IN,46322-1554,Proprietary  ,30,54,84,77,148,225
02084800,RAVENSCROFT BEAUTY COLLEGE              ,IN,46815-0000,Proprietary  ,17,77,94,91,182,273
02087600,CONCORDIA THEOLOGICAL SEMINARY          ,IN,46825-0000,Private      ,0,90,90,12,177,189
02100402,EVEREST INSTITUTE - EVEREST COLLEGE     ,IN,46410-7064,Proprietary  ,93,386,479,258,945,1203
02140800,MARTIN UNIVERSITY                       ,IN,46218-0000,Private      ,18,183,201,173,1067,1240
02158400,HARRISON COLLEGE                        ,IN,46204-2611,Proprietary  ,94,791,885,515,2770,3285
02158401,HARRISON COLLEGE - COLUMBUS             ,IN,47203-1843,Proprietary  ,24,111,135,139,512,651
02158402,HARRISON COLLEGE - LAFAYETTE            ,IN,47905-4859,Proprietary  ,17,137,154,159,528,687
02158405,HARRISON COLLEGE - TERRE HAUTE          ,IN,47802-0000,Proprietary  ,24,109,133,110,562,672
02158407,HARRISON COLLEGE - ANDERSON             ,IN,46013-0000,Proprietary  ,11,111,122,125,559,684
02158409,HARRISON COLLEGE - EVANSVILLE           ,IN,47715-3901,Proprietary  ,23,105,128,160,427,587
02158410,HARRISON COLLEGE - EAST                 ,IN,46239-8903,Proprietary  ,39,273,312,243,1100,1343
02158412,HARRISON COLLEGE - FORT WAYNE           ,IN,46825-0000,Proprietary  ,20,148,168,132,564,696
02158413,HARRISON COLLEGE - NORTHWEST            ,IN,46278-0000,Proprietary  ,22,82,104,191,424,615
02158415,HARRISON COLLEGE - MUNCIE               ,IN,47303-0000,Proprietary  ,5,42,47,102,206,308
02158416,HARRISON COLLEGE - ELKHART              ,IN,46516-0000,Proprietary  ,8,73,81,57,254,311
02158800,DON ROBERTS BEAUTY SCHOOLS              ,IN,46383-0000,Proprietary  ,8,12,20,28,53,81
02164300,DON ROBERTS SCHOOL OF HAIR DESIGN       ,IN,46375-9999,Proprietary  ,7,30,37,25,56,81
02180108,ROSS MEDICAL EDUCATION CENTER -         ,IN,46530-4479,Proprietary  ,5,36,41,39,141,180
02201800,KAPLAN COLLEGE                          ,IN,46324-3347,Proprietary  ,44,197,241,158,542,700
02201806,KAPLAN COLLEGE - SOUTHEAST INDIANAPOLIS ,IN,46227-1493,Proprietary  ,62,412,474,300,1144,1444
02241700,PJ'S COLLEGE OF COSMETOLOGY             ,IN,47129-0000,Proprietary  ,15,44,59,45,119,164
02245505,FORTIS COLLEGE - INDIANAPOLIS CAMPUS    ,IN,46268-0000,Proprietary  ,10,93,103,62,423,485
02302700,J EVERETT LIGHT CAREER CENTER           ,IN,46240-0000,Public       ,5,54,59,67,344,411
02304800,PJ'S COLLEGE OF COSMETOLOGY             ,IN,47374-0000,Proprietary  ,9,38,47,39,84,123
02308900,MASTER'S OF COSMETOLOGY COLLEGE         ,IN,46809-0000,Proprietary  ,24,41,65,119,145,264
02339600,ROGER'S ACADEMY OF HAIR DESIGN          ,IN,47712-0000,Proprietary  ,16,63,79,57,129,186
02351300,KNOX BEAUTY COLLEGE                     ,IN,46534-0000,Proprietary  ,4,7,11,13,26,39
02490500,HAIR FASHIONS BY KAYE BEAUTY CLG        ,IN,46250-0000,Proprietary  ,6,83,89,84,260,344
02490800,HAIR FASHIONS BY KAYE BEAUTY CLG        ,IN,46060-0000,Proprietary  ,19,33,52,46,68,114
02607000,HAIR ARTS ACADEMY                       ,IN,47404-2419,Proprietary  ,14,17,31,57,102,159
02615800,COLLEGE OF COURT REPORTING              ,IN,46342-5969,Proprietary  ,10,115,125,22,210,232
03100600,MARION COMM TUCKER AREA VOC SCHOOL      ,IN,46952-3831,Public       ,4,19,23,38,97,135
03176300,AVIATION INSTITUTE OF MAINTENANCE       ,IN,46241-1445,Proprietary  ,16,73,89,100,262,362
03456700,CROSSROADS BIBLE COLLEGE                ,IN,46219-4912,Private      ,1,61,62,65,371,436
03538300,ALEXANDRIA SCH OF SCIENTIFIC THERAP     ,IN,46001-0287,Proprietary  ,2,30,32,21,69,90
04038700,IDEAL BEAUTY ACADEMY                    ,IN,47130-4215,Proprietary  ,6,26,32,15,58,73
04051304,ART INSTITUTE OF PHOENIX (THE) - ART  IN,IN,46268-1170,Proprietary  ,102,203,305,996,928,1924
04051311,ART INSTITUTE OF PHOENIX (THE) - BROWN M,IN,46410-5608,Proprietary  ,42,193,235,166,597,763
04051312,ART INSTITUTE OF PHOENIX (THE) - BROWN M,IN,46360-7362,Proprietary  ,13,49,62,62,253,315
04051318,ART INSTITUTE OF PHOENIX (THE) - BROWN M,IN,46204-1017,Proprietary  ,40,404,444,270,1255,1525
04051321,ART INSTITUTE OF PHOENIX (THE) - BROWN M,IN,46635-1176,Proprietary  ,23,135,158,127,502,629
04051322,ART INSTITUTE OF PHOENIX (THE) - BROWN M,IN,46805-0000,Proprietary  ,43,185,228,201,659,860
04100300,SUCCESS SCHOOLS                         ,IN,46410-5310,Proprietary  ,27,89,116,74,179,253
04121000,TECHSKILLS - INDIANAPOLIS               ,IN,46240-4302,Proprietary  ,11,165,176,106,445,551
04130900,HONORS BEAUTY COLLEGE                   ,IN,46256-3317,Proprietary  ,12,70,82,90,252,342
04155900,AVEDA FREDRIC'S INSTITUTE               ,IN,46250-4746,Proprietary  ,27,55,82,158,204,362
04166700,REM SPA INC                             ,IN,46013-3136,Proprietary  ,11,36,47,46,104,150
04171700,AVANT GARD THE SCHOOL                   ,IN,46214-6500,Proprietary  ,5,19,24,27,69,96
04172700,SALON PROFESSIONAL ACADEMY (THE)        ,IN,47715-7822,Proprietary  ,32,61,93,122,146,268
04184000,PAUL MITCHELL THE SCHOOL INDIANAPOLIS   ,IN,46227-6252,Proprietary  ,17,69,86,158,249,407
04186600,SALON PROFESSIONAL ACADEMY (THE)        ,IN,46901-6248,Proprietary  ,18,34,52,71,96,167
04205500,LIL LOU'S BARBER COLLEGE                ,IN,46409-2645,Proprietary  ,11,58,69,31,120,151
04230300,EXCEL ACADEMIES OF COSMETOLOGY - MERRILL,IN,46410-5540,Proprietary  ,8,19,27,41,47,88
00190100,ALLEN COUNTY COMMUNITY COLLEGE          ,KS,66749-1607,Public       ,328,446,774,816,910,1726
00190200,COWLEY COUNTY COMMUNITY COLLEGE & AREA V,KS,67005-2662,Public       ,455,757,1212,1221,1373,2594
00190300,BAKER UNIVERSITY                        ,KS,66006-0065,Private      ,255,629,884,1310,1322,2632
00190400,BETHANY COLLEGE                         ,KS,67456-1897,Private      ,190,45,235,860,111,971
00190500,BETHEL COLLEGE                          ,KS,67117-8061,Private      ,157,50,207,724,136,860
00190600,BUTLER COUNTY COMMUNITY COLLEGE         ,KS,67042-3280,Public       ,1353,1783,3136,3350,3165,6515
00190700,CENTRAL BAPTIST THEOLOGY SEMINARY       ,KS,66226-3513,Private      ,0,20,20,1,37,38
00190800,CENTRAL CHRISTIAN COLLEGE OF KANSAS     ,KS,67460-5799,Private      ,159,279,438,389,459,848
00190900,CLOUD COUNTY COMMUNITY COLLEGE          ,KS,66901-1002,Public       ,218,309,527,626,681,1307
00191000,COFFEYVILLE COMMUNITY COLLEGE           ,KS,67337-5064,Public       ,306,193,499,742,315,1057
00191100,COLBY COMMUNITY COLLEGE                 ,KS,67701-4099,Public       ,198,156,354,556,340,896
00191300,DODGE CITY COMMUNITY COLLEGE            ,KS,67801-2399,Public       ,354,249,603,783,469,1252
00191400,DONNELLY COLLEGE                        ,KS,66102-4298,Private      ,100,209,309,325,413,738
00191500,FORT HAYS STATE UNIVERSITY              ,KS,67601-4099,Public       ,1142,2151,3293,4088,5028,9116
00191600,FORT SCOTT COMMUNITY COLLEGE            ,KS,66701-3199,Public       ,389,303,692,957,589,1546
00191700,BARCLAY COLLEGE                         ,KS,67059-0288,Private      ,42,32,74,111,61,172
00191800,FRIENDS UNIVERSITY                      ,KS,67213-3397,Private      ,257,730,987,1233,1514,2747
00191900,GARDEN CITY COMMUNITY COLLEGE           ,KS,67846-6398,Public       ,329,223,552,824,449,1273
00192000,HESSTON COLLEGE                         ,KS,67062-2093,Private      ,95,47,142,426,139,565
00192100,HIGHLAND COMMUNITY COLLEGE              ,KS,66035-4062,Public       ,399,461,860,1063,929,1992
00192300,HUTCHINSON COMMUNITY COLLEGE            ,KS,67501-5894,Public       ,635,841,1476,1808,1678,3486
00192400,INDEPENDENCE COMMUNITY COLLEGE          ,KS,67301-0708,Public       ,227,107,334,504,203,707
00192500,KANSAS CITY KANSAS COMMUNITY CLG        ,KS,66112-9978,Public       ,606,1553,2159,1574,3127,4701
00192600,PITTSBURG STATE UNIVERSITY              ,KS,66762-7500,Public       ,1400,959,2359,4857,2099,6956
00192700,EMPORIA STATE UNIVERSITY                ,KS,66801-5415,Public       ,874,976,1850,3184,2214,5398
00192800,KANSAS STATE UNIVERSITY                 ,KS,66506-1104,Public       ,2444,1789,4233,15729,5526,21255
00192900,KANSAS WESLEYAN UNIVERSITY              ,KS,67401-6196,Private      ,173,98,271,874,279,1153
00193000,LABETTE COMMUNITY COLLEGE               ,KS,67357-4299,Public       ,234,315,549,521,554,1075
00193100,MANHATTAN CHRISTIAN COLLEGE             ,KS,66502-4081,Private      ,90,32,122,309,86,395
00193300,MCPHERSON COLLEGE                       ,KS,67460-3899,Private      ,177,60,237,756,160,916
00193600,NEOSHO COUNTY COMMUNITY COLLEGE         ,KS,66720-2699,Public       ,232,373,605,653,791,1444
00193700,OTTAWA UNIVERSITY                       ,KS,66067-3399,Private      ,249,874,1123,972,1662,2634
00193800,PRATT COMMUNITY COLLEGE                 ,KS,67124-8432,Public       ,239,263,502,531,508,1039
00193900,NEWMAN UNIVERSITY                       ,KS,67213-2084,Private      ,288,564,852,1290,1244,2534
00194000,SOUTHWESTERN COLLEGE                    ,KS,67156-2499,Private      ,124,411,535,775,908,1683
00194300,UNIVERSITY OF ST MARY                   ,KS,66048-5023,Private      ,191,279,470,659,641,1300
00194500,STERLING COLLEGE                        ,KS,67579-1533,Private      ,122,55,177,903,125,1028
00194600,TABOR COLLEGE                           ,KS,67063-1799,Private      ,152,91,243,770,189,959
00194800,UNIVERSITY OF KANSAS                    ,KS,66045-7535,Public       ,2088,2129,4217,17760,8801,26561
00194900,WASHBURN UNIVERSITY                     ,KS,66621-1110,Public       ,631,1015,1646,3280,3071,6351
00194901,WASHBURN INSTITUTE OF TECHNOLOGY        ,KS,66604-2199,Public       ,125,334,459,295,632,927
00195000,WICHITA STATE UNIVERSITY                ,KS,67208-0000,Public       ,2089,2918,5007,7481,6085,13566
00460800,BARTON COUNTY COMMUNITY COLLEGE         ,KS,67530-9283,Public       ,310,753,1063,796,1484,2280
00526400,FLINT HILLS TECHNICAL COLLEGE           ,KS,66801-5999,Public       ,126,195,321,255,344,599
00526500,NORTH CENTRAL KANSAS TECH COLG          ,KS,67420-0000,Public       ,156,137,293,343,239,582
00526700,NORTHWEST KANSAS TECHNICAL SCHOOL       ,KS,67735-3441,Public       ,110,47,157,245,87,332
00549800,WICHITA AREA TECHNICAL COLLEGE          ,KS,67211-2099,Public       ,269,900,1169,553,1630,2183
00549900,SALINA AREA TECHNICAL COLLEGE           ,KS,67401-8195,Public       ,88,96,184,185,185,370
00550000,MANHATTAN AREA TECHNICAL COLLEGE        ,KS,66503-2499,Public       ,138,287,425,346,509,855
00675500,BROWN MACKIE COLLEGE (THE)              ,KS,67401-7307,Proprietary  ,160,692,852,293,1276,1569
00703200,MID AMERICA NAZARENE UNIVERSITY         ,KS,66062-1899,Private      ,183,403,586,963,899,1862
00822800,SEWARD CO COMM CO/AREA TECHNICAL SCHOOL ,KS,67905-0000,Public       ,177,163,340,400,277,677
00824400,JOHNSON COUNTY COMMUNITY COLLEGE        ,KS,66210-1299,Public       ,1722,2625,4347,4902,5283,10185
00833200,MARINELLO SCHOOL OF BEAUTY              ,KS,66502-6082,Proprietary  ,22,31,53,30,53,83
00833201,MARINELLO SCHOOL OF BEAUTY - LAWRENCE   ,KS,66046-2743,Proprietary  ,20,46,66,27,60,87
00869423,RASMUSSEN COLLEGE - OVERLAND PARK       ,KS,66210-2786,Proprietary  ,10,83,93,14,130,144
00869424,RASMUSSEN COLLEGE - TOPEKA              ,KS,66606-2339,Proprietary  ,20,148,168,51,248,299
01025600,BENEDICTINE COLLEGE                     ,KS,66002-1499,Private      ,383,46,429,2339,152,2491
01043800,HASKELL INDIAN NATIONS UNIVERSITY       ,KS,66046-4800,Public       ,383,257,640,854,527,1381
01050300,WICHITA TECHNICAL INSTITUTE             ,KS,67213-1927,Proprietary  ,56,359,415,110,530,640
01050302,WICHITA TECHNICAL INSTITUTE - WTI TOPEKA,KS,66609-1217,Proprietary  ,25,175,200,43,258,301
01050305,WICHITA TECHNICAL INSTITUTE - EAST CAMPU,KS,67208-4243,Proprietary  ,27,130,157,48,215,263
02090700,CLEVELAND CHIROPRACTIC COLLEGE          ,KS,66210-1613,Private      ,16,196,212,48,360,408
02134800,OLD TOWN BARBER AND BEAUTY COLLEGE      ,KS,67211-0000,Proprietary  ,18,56,74,30,95,125
02168900,KANSAS CITY COLLEGE & BIBLE SCHOOL      ,KS,66204-1975,Private      ,2,10,12,2,10,12
02257700,HAYS ACADEMY OF HAIR DESIGN             ,KS,67601-3685,Proprietary  ,21,28,49,52,40,92
02257702,HAYS ACADEMY OF HAIR DESIGN -           ,KS,67401-0000,Proprietary  ,13,27,40,27,49,76
02340700,LABARON HAIRDRESSING ACADEMY            ,KS,66204-0000,Proprietary  ,6,13,19,9,25,34
02590900,WRIGHT CAREER COLLEGE                   ,KS,66212-0000,Private      ,151,1289,1440,224,2007,2231
02599709,VATTEROTT COLLEGE - WICHITA             ,KS,67226-1304,Proprietary  ,28,154,182,60,322,382
02603100,XENON INTERNATIONAL ACADEMY             ,KS,67203-5428,Proprietary  ,52,78,130,88,153,241
02606300,PAUL MITCHELL THE SCHOOL WICHITA        ,KS,67226-2803,Proprietary  ,54,73,127,99,126,225
02611005,HERITAGE COLLEGE - WICHITA              ,KS,67210-1879,Proprietary  ,74,241,315,112,378,490
02613000,PINNACLE CAREER INSTITUTE               ,KS,66046-2703,Proprietary  ,27,125,152,42,194,236
03031300,XENON INTERNATIONAL ACADEMY IV          ,KS,66061-3765,Proprietary  ,6,18,24,13,32,45
03066200,BRYAN COLLEGE                           ,KS,66604-2496,Proprietary  ,23,109,132,35,154,189
03450300,MARINELLO SCHOOL OF BEAUTY              ,KS,66611-1101,Proprietary  ,18,55,73,34,80,114
03450301,MARINELLO SCHOOL OF BEAUTY - WICHITA    ,KS,67207-5148,Proprietary  ,18,68,86,23,95,118
03450302,MARINELLO SCHOOL OF BEAUTY - OVERLAND PA,KS,66212-5451,Proprietary  ,38,98,136,59,134,193
03529300,SIDNEY'S HAIRDRESSING COLLEGE           ,KS,67501-7094,Proprietary  ,7,13,20,19,19,38
04132900,Z HAIR ACADEMY                          ,KS,66046-4040,Proprietary  ,21,24,45,38,37,75
04162700,ERIC FISHER ACADEMY                     ,KS,67212-3376,Proprietary  ,50,66,116,106,132,238
04175700,ACADEMY OF AESTHETIC ARTS               ,KS,66203-3502,Proprietary  ,2,11,13,8,29,37
04179600,ENTOURAGE INSTITUTE OF BEAUTY AND ESTHET,KS,66215-3803,Proprietary  ,10,52,62,21,78,99
04205300,MITSU SATO HAIR ACADEMY                 ,KS,66212-1457,Proprietary  ,2,15,17,7,28,35
04209300,PAUL MITCHELL THE SCHOOL - OVERLAND PARK,KS,66212-4050,Proprietary  ,39,63,102,79,111,190
00203300,UNIVERSITY OF MAINE-PRESQUE ISLE        ,ME,04769-2888,Public       ,136,131,267,793,417,1210
00203600,BATES COLLEGE                           ,ME,04240-6028,Private      ,343,27,370,2898,97,2995
00203800,BOWDOIN COLLEGE                         ,ME,04011-8451,Private      ,287,21,308,3761,105,3866
00203900,COLBY COLLEGE                           ,ME,04901-8841,Private      ,279,20,299,2849,76,2925
00204000,UNIVERSITY OF MAINE-FARMINGTON          ,ME,04938-1990,Public       ,180,102,282,2378,472,2850
00204100,UNIVERSITY OF MAINE-FORT KENT           ,ME,04743-1292,Public       ,132,161,293,690,443,1133
00204300,HUSSON UNIVERSITY                       ,ME,04401-2999,Private      ,450,456,906,2922,1387,4309
00204400,MAINE MARITIME ACADEMY                  ,ME,04420-0001,Public       ,142,48,190,1238,158,1396
00205000,UNIVERSITY OF NEW ENGLAND               ,ME,04005-9599,Private      ,488,1667,2155,4554,4262,8816
00205100,SAINT JOSEPH'S COLLEGE                  ,ME,04084-5236,Private      ,240,535,775,1694,1142,2836
00205200,THOMAS COLLEGE                          ,ME,04901-5097,Private      ,157,94,251,1054,257,1311
00205300,UNIVERSITY OF MAINE                     ,ME,04469-0001,Public       ,973,574,1547,13357,2459,15816
00205400,UNIVERSITY OF SOUTHERN MAINE            ,ME,04104-0000,Public       ,595,987,1582,6015,4694,10709
00205500,UNIVERSITY OF MAINE-MACHIAS             ,ME,04654-1397,Public       ,105,95,200,495,293,788
00458615,KAPLAN UNIVERSITY - PORTLAND            ,ME,04106-2415,Proprietary  ,40,359,399,111,757,868
00458616,KAPLAN UNIVERSITY - LEWISTON            ,ME,04240-0000,Proprietary  ,30,285,315,74,714,788
00458617,KAPLAN UNIVERSITY - AUGUSTA             ,ME,04330-8038,Proprietary  ,52,322,374,109,695,804
00520400,BEAL COLLEGE                            ,ME,04401-6896,Proprietary  ,89,206,295,229,522,751
00527600,CENTRAL MAINE COMMUNITY COLLEGE         ,ME,04210-6498,Public       ,414,616,1030,1389,1552,2941
00527700,EASTERN MAINE COMMUNITY COLLEGE         ,ME,04401-4280,Public       ,456,571,1027,1648,1433,3081
00552500,SOUTHERN MAINE COMMUNITY  COLLEGE       ,ME,04106-1698,Public       ,1015,1403,2418,3215,3088,6303
00576000,NORTHERN MAINE COMMUNITY COLLEGE        ,ME,04769-2016,Public       ,130,202,332,413,443,856
00630500,CENTRAL MAINE MEDICAL CENTER COLLEGE OF ,ME,04243-9986,Private      ,22,96,118,107,282,389
00676000,UNIVERSITY OF MAINE-AUGUSTA             ,ME,04330-9410,Public       ,329,1183,1512,1502,3991,5493
00685800,UNITY COLLEGE                           ,ME,04988-9502,Private      ,157,41,198,960,93,1053
00903800,MR BERNARD'S SCH HAIR FASHION INC       ,ME,04243-1163,Proprietary  ,24,51,75,35,82,117
00923100,WASHINGTON COUNTY COMMUNITY COLLEGE     ,ME,04619-9704,Public       ,65,80,145,251,169,420
00945900,EMPIRE BEAUTY SCHOOL                    ,ME,04101-3348,Proprietary  ,223,549,772,359,815,1174
00982600,KENNEBEC VALLEY  COMMUNITY  COLLEGE     ,ME,04937-1367,Public       ,198,485,683,850,1449,2299
01138500,COLLEGE OF THE ATLANTIC                 ,ME,04609-1105,Private      ,46,18,64,622,86,708
01167300,MAINE COLLEGE OF ART                    ,ME,04101-3987,Private      ,80,43,123,713,208,921
02104400,SPA TECH INSTITUTE                      ,ME,04093-0000,Proprietary  ,62,153,215,118,260,378
02347100,NEW ENGLAND SCHOOL OF COMMUNICATIONS    ,ME,04401-0000,Private      ,71,32,103,423,99,522
02361300,LANDING SCHOOL OF BOATBUILDING & DESIGN ,ME,04046-1490,Private      ,7,22,29,27,42,69
03122900,YORK COUNTY COMMUNITY COLLEGE           ,ME,04090-0529,Public       ,228,280,508,613,721,1334
03429300,SEACOAST CAREER SCHOOLS                 ,ME,04073-0000,Proprietary  ,33,164,197,53,226,279
03612300,BIRTHWISE MIDWIFERY SCHOOL              ,ME,04009-1110,Proprietary  ,6,30,36,9,67,76
04177400,CAPILO SCHOOL OF HAIR DESIGN            ,ME,04330-0000,Proprietary  ,16,33,49,51,76,127
04185100,NORTHEAST TECHNICAL INSTITUTE           ,ME,04074-0000,Proprietary  ,30,217,247,74,414,488
04188800,INSTITUTE FOR DOCTORAL STUDIES IN THE VI,ME,04102-0000,Private      ,0,19,19,2,38,40
04214100,COSMOTECH SCHOOL OF COSMETOLOGY         ,ME,04092-2878,Proprietary  ,10,13,23,28,26,54
00209300,ST JOHN'S COLLEGE                       ,NM,87505-4599,Private      ,35,42,77,331,140,471
00264900,SANTA FE UNIVERSITY OF ART AND DESIGN   ,NM,87505-7634,Proprietary  ,221,108,329,1066,253,1319
00265000,UNIVERSITY OF THE SOUTHWEST             ,NM,88240-9129,Private      ,127,371,498,240,643,883
00265100,EASTERN NEW MEXICO UNIV PORTALES        ,NM,88130-6000,Public       ,1060,1173,2233,2760,2038,4798
00265101,EASTERN NEW MEXICO UNIV-ROSWELL CAM     ,NM,88202-0000,Public       ,337,491,828,713,845,1558
00265300,NEW MEXICO HIGHLANDS UNIVERSITY         ,NM,87701-4436,Public       ,457,977,1434,1783,1886,3669
00265400,NEW MEXICO INST OF MINING & TECH        ,NM,87801-4796,Public       ,284,155,439,1237,385,1622
00265500,NEW MEXICO JUNIOR COLLEGE               ,NM,88240-9123,Public       ,268,302,570,525,500,1025
00265600,NEW MEXICO MILITARY INSTITUTE           ,NM,88201-5173,Public       ,123,21,144,428,53,481
00265700,NEW MEXICO STATE UNIVERSITY             ,NM,88003-8001,Public       ,2595,2633,5228,10103,5860,15963
00265701,NEW MEXICO STATE UNIV-ALAMOGORDO        ,NM,88311-0000,Public       ,120,389,509,365,761,1126
00265702,NEW MEXICO STATE UNIV.-DONA ANA CLG     ,NM,88003-0000,Public       ,964,1400,2364,2607,2981,5588
00265703,NEW MEXICO STATE UNIV-CARLSBAD          ,NM,88220-0000,Public       ,108,199,307,231,353,584
00265704,NEW MEXICO STATE UNIV-GRANTS            ,NM,87020-0000,Public       ,67,158,225,159,309,468
00266000,SAN JUAN COLLEGE                        ,NM,87402-4699,Public       ,865,1902,2767,1547,3307,4854
00266300,THE UNIVERSITY OF NEW MEXICO            ,NM,87131-0001,Public       ,3235,4428,7663,17425,15218,32643
00266400,WESTERN NEW MEXICO UNIVERSITY           ,NM,88061-5417,Public       ,370,827,1197,1249,1562,2811
00405701,NATIONAL AMERICAN UNIVERSITY            ,NM,87110-0000,Proprietary  ,22,201,223,86,479,565
00474200,CENTRAL NEW MEXICO COMMUNITY COLLEGE    ,NM,87106-4096,Public       ,2806,5037,7843,6710,10415,17125
00474300,CLOVIS COMMUNITY COLLEGE                ,NM,88101-8381,Public       ,240,555,795,443,896,1339
00996200,LUNA COMMUNITY COLLEGE                  ,NM,87701-0000,Public       ,135,196,331,337,328,665
01063200,DEWOLFF CLG HAIRSTYLING/COSMETOLOGY     ,NM,87112-4113,Proprietary  ,18,55,73,57,120,177
01300500,OLYMPIAN UNIVERSITY OF COSMETOLOGY      ,NM,88310-5051,Proprietary  ,136,407,543,177,585,762
02083900,NORTHERN NEW MEXICO COLLEGE             ,NM,87530-0000,Public       ,166,252,418,430,523,953
02146400,INSTITUTE OF AMERICAN INDIAN ARTS       ,NM,87508-0000,Public       ,79,113,192,146,254,400
02218808,BROOKLINE COLLEGE - ALBUQUERQUE         ,NM,87105-1649,Proprietary  ,77,203,280,180,426,606
02278100,SANTA FE COMMUNITY COLLEGE              ,NM,87507-0000,Public       ,404,982,1386,807,1620,2427
02293203,ATI CAREER TRAINING CENTER - ALBUQUERQUE,NM,87109-2016,Proprietary  ,15,58,73,15,58,73
02357600,NAVAJO TECHNICAL COLLEGE                ,NM,87313-0000,Public       ,256,648,904,384,866,1250
02511000,SOUTHWESTERN INDIAN POLYTECH INST       ,NM,87184-0000,Public       ,128,168,296,212,332,544
02572003,COMPUTER CAREER CENTER - LAS CRUCES CAMP,NM,88011-8220,Proprietary  ,57,251,308,95,333,428
02622000,SOUTHWEST ACUPUNCTURE COLLEGE           ,NM,87505-0000,Proprietary  ,2,94,96,4,177,181
03076100,SOUTHWESTERN COLLEGE                    ,NM,87507-0000,Private      ,6,102,108,21,203,224
03206300,MESALANDS COMMUNITY COLLEGE             ,NM,88401-3352,Public       ,26,47,73,76,80,156
03430300,UNIVERSAL THERAPEUTIC MASSAGE INSTITUTE ,NM,87107-4403,Proprietary  ,16,43,59,37,105,142
03678300,PIMA MEDICAL INSTITUTE                  ,NM,87110-0000,Proprietary  ,125,256,381,329,556,885
03944300,MASSAGE THERAPY TRAINING INSTITUTE      ,NM,88007-0000,Proprietary  ,14,42,56,32,69,101
04162400,TONI AND GUY HAIRDRESSING  ACADEMY      ,NM,87110-4404,Proprietary  ,32,68,100,74,143,217
04174500,AVEDA INSTITUTE OF NEW MEXICO (THE)     ,NM,87110-3640,Proprietary  ,41,100,141,102,210,312
04178500,VOGUE COLLEGE OF COSMETOLOGY            ,NM,87505-7636,Proprietary  ,13,45,58,30,70,100
00223400,ADRIAN COLLEGE                          ,MI,49221-2575,Private      ,355,81,436,2931,287,3218
00223500,ALBION COLLEGE                          ,MI,49224-1831,Private      ,294,38,332,2580,139,2719
00223600,ALMA COLLEGE                            ,MI,48801-1599,Private      ,189,35,224,2547,132,2679
00223700,ALPENA COMMUNITY COLLEGE                ,MI,49707-1495,Public       ,171,273,444,835,663,1498
00223800,ANDREWS UNIVERSITY                      ,MI,49104-0750,Private      ,423,419,842,1619,979,2598
00223900,AQUINAS COLLEGE                         ,MI,49506-1799,Private      ,300,186,486,2742,531,3273
00224000,BAY DE NOC COMMUNITY COLLEGE            ,MI,49829-2524,Public       ,205,388,593,907,871,1778
00224100,CALVIN COLLEGE                          ,MI,49546-4388,Private      ,281,118,399,4543,402,4945
00224200,CALVIN THEOLOGICAL SEMINARY             ,MI,49546-4387,Private      ,1,21,22,13,142,155
00224300,CENTRAL MICHIGAN UNIVERSITY             ,MI,48859-0001,Public       ,3035,2913,5948,22306,8620,30926
00224600,CLEARY UNIVERSITY                       ,MI,48105-2659,Private      ,56,140,196,229,478,707
00224800,CRANBROOK ACADEMY OF ART                ,MI,48303-0000,Private      ,10,38,48,37,205,242
00224900,DAVENPORT UNIVERSITY                    ,MI,49503-0000,Private      ,656,2736,3392,3437,7479,10916
00225100,DELTA COLLEGE                           ,MI,48710-0001,Public       ,1416,2473,3889,5222,5378,10600
00225400,MICHIGAN STATE UNIVERSITY COLLEGE OF LAW,MI,48824-1300,Private      ,65,330,395,329,1661,1990
00225900,EASTERN MICHIGAN UNIVERSITY             ,MI,48197-2214,Public       ,3004,3830,6834,17066,10642,27708
00226000,FERRIS STATE UNIVERSITY                 ,MI,49307-2251,Public       ,1919,2007,3926,14461,6486,20947
00226100,CHARLES STEWART MOTT COMMUNITY CLG      ,MI,48503-2089,Public       ,1415,2791,4206,4453,6106,10559
00226200,KETTERING UNIVERSITY                    ,MI,48504-4898,Private      ,271,136,407,2154,370,2524
00226300,GLEN OAKS COMMUNITY COLLEGE             ,MI,49032-9784,Public       ,161,205,366,514,482,996
00226400,GOGEBIC COMMUNITY COLLEGE               ,MI,49938-1365,Public       ,132,143,275,601,342,943
00226500,GRACE BIBLE COLLEGE                     ,MI,49509-1998,Private      ,96,201,297,486,434,920
00226600,CORNERSTONE UNIVERSITY                  ,MI,49525-5897,Private      ,277,549,826,2164,1416,3580
00226700,GRAND RAPIDS COMMUNITY COLLEGE          ,MI,49503-3295,Public       ,2336,3452,5788,9454,7460,16914
00226800,GRAND VALLEY STATE UNIVERSITY           ,MI,49401-9403,Public       ,2606,1891,4497,26038,7138,33176
00226900,GREAT LAKES CHRISTIAN COLLEGE           ,MI,48917-1299,Private      ,43,59,102,151,129,280
00227000,HENRY FORD COMMUNITY COLLEGE            ,MI,48128-1495,Public       ,3122,4911,8033,8207,10434,18641
00227300,HOPE COLLEGE                            ,MI,49423-3607,Private      ,256,58,314,4881,214,5095
00227400,JACKSON COMMUNITY COLLEGE               ,MI,49201-8399,Public       ,723,1208,1931,2929,2789,5718
00227500,KALAMAZOO COLLEGE                       ,MI,49006-3295,Private      ,167,73,240,2349,239,2588
00227600,KELLOGG COMMUNITY COLLEGE               ,MI,49017-3397,Public       ,679,1673,2352,2463,3456,5919
00227700,LAKE MICHIGAN COLLEGE                   ,MI,49022-1899,Public       ,350,763,1113,1594,1879,3473
00227800,LANSING COMMUNITY COLLEGE               ,MI,48933-1293,Public       ,2424,3720,6144,7974,7086,15060
00227900,LAWRENCE TECHNOLOGICAL UNIVERSITY       ,MI,48075-1058,Private      ,336,392,728,2157,1013,3170
00228200,MADONNA UNIVERSITY                      ,MI,48150-1173,Private      ,354,953,1307,1609,2467,4076
00228400,MARYGROVE COLLEGE                       ,MI,48221-2599,Private      ,313,875,1188,1061,2121,3182
00228800,ROCHESTER COLLEGE                       ,MI,48307-2764,Private      ,247,272,519,817,645,1462
00229000,MICHIGAN STATE UNIVERSITY               ,MI,48824-1113,Public       ,5307,3605,8912,38507,12292,50799
00229200,MICHIGAN TECHNOLOGICAL UNIV             ,MI,49931-1295,Public       ,618,245,863,6235,870,7105
00229300,LAKE SUPERIOR STATE UNIVERSITY          ,MI,49783-1691,Public       ,251,193,444,2468,674,3142
00229400,MONROE COUNTY COMMUNITY CLG             ,MI,48161-9746,Public       ,476,735,1211,1434,1454,2888
00229500,MONTCALM COMMUNITY COLLEGE              ,MI,48885-9723,Public       ,173,371,544,785,991,1776
00229700,MUSKEGON COMMUNITY COLLEGE              ,MI,49442-1432,Public       ,623,887,1510,2727,2129,4856
00229900,NORTH CENTRAL MICHIGAN COLLEGE          ,MI,49770-8740,Public       ,238,396,634,951,878,1829
00230100,NORTHERN MICHIGAN UNIVERSITY            ,MI,49855-5316,Public       ,1128,634,1762,7988,2122,10110
00230200,NORTHWESTERN MICHIGAN COLLEGE           ,MI,49686-3061,Public       ,454,727,1181,2280,1989,4269
00230301,OAKLAND COMMUNITY COLLEGE - ORCHARD RIDG,MI,48334-4579,Public       ,980,1598,2578,3094,3953,7047
00230302,OAKLAND COMMUNITY COLLEGE - ROYAL OAK CA,MI,48067-3898,Public       ,1286,2359,3645,3778,5673,9451
00230303,OAKLAND COMMUNITY COLLEGE - SOUTHFIELD C,MI,48075-4793,Public       ,1114,2857,3971,3196,6666,9862
00230304,OAKLAND COMMUNITY COLLEGE - AUBURN HILLS,MI,48323-2845,Public       ,1207,1836,3043,4184,4486,8670
00230305,OAKLAND COMMUNITY COLLEGE - HIGHLAND LAK,MI,48327-4187,Public       ,657,1060,1717,2199,2679,4878
00230700,OAKLAND UNIVERSITY                      ,MI,48309-4401,Public       ,2661,2845,5506,16052,8394,24446
00230800,OLIVET COLLEGE                          ,MI,49076-9902,Private      ,223,67,290,1555,240,1795
00231000,ST. CLAIR COUNTY COMMUNITY COLLEGE      ,MI,48061-0000,Public       ,481,682,1163,1813,1523,3336
00231100,KUYPER COLLEGE                          ,MI,49525-9749,Private      ,60,56,116,364,139,503
00231300,SACRED HEART MAJOR SEMINARY             ,MI,48206-1799,Private      ,10,61,71,34,146,180
00231400,SAGINAW VALLEY STATE UNIV               ,MI,48710-0001,Public       ,1292,1104,2396,9868,3367,13235
00231500,SCHOOLCRAFT COLLEGE                     ,MI,48152-2696,Public       ,1754,3039,4793,5837,7048,12885
00231600,SIENA HEIGHTS UNIVERSITY                ,MI,49221-1796,Private      ,284,621,905,1784,1579,3363
00231700,SOUTHWESTERN MICHIGAN COLLEGE           ,MI,49047-9793,Public       ,363,450,813,2037,1292,3329
00231800,SPRING ARBOR UNIVERSITY                 ,MI,49283-9984,Private      ,301,983,1284,2280,2234,4514
00232200,FINLANDIA UNIVERSITY                    ,MI,49930-1882,Private      ,90,57,147,525,176,701
00232300,UNIVERSITY OF DETROIT MERCY             ,MI,48221-3038,Private      ,560,1127,1687,3208,3001,6209
00232303,UNIV OF DETROIT MERCY - LAW SCHOOL      ,MI,48226-0000,Private      ,12,183,195,54,551,605
00232330,UNIV OF DETROIT MERCY - DENTAL SCHOOL   ,MI,48208-2576,Private      ,39,169,208,152,564,716
00232500,UNIVERSITY OF MICHIGAN - ANN ARBOR      ,MI,48109-1316,Public       ,3589,2757,6346,36404,11251,47655
00232501,UNIVERSITY OF MICHIGAN-MEDICAL SCH      ,MI,48109-0000,Public       ,50,141,191,271,1002,1273
00232503,UNIVERSITY OF MICHIGAN LAW SCHOOL       ,MI,48109-0000,Public       ,26,355,381,116,2192,2308
00232600,UNIVERSITY OF MICHIGAN-DEARBORN         ,MI,48128-2406,Public       ,1313,1760,3073,7201,4738,11939
00232700,UNIVERSITY OF MICHIGAN-FLINT            ,MI,48502-1950,Public       ,772,1695,2467,4954,5351,10305
00232800,WASHTENAW COMMUNITY COLLEGE             ,MI,48106-0000,Public       ,1310,2166,3476,4105,4855,8960
00232900,WAYNE STATE UNIVERSITY                  ,MI,48202-0000,Public       ,3425,5850,9275,17679,16552,34231
00232901,WAYNE STATE UNIV SCH OF MEDICINE        ,MI,48201-3359,Public       ,154,617,771,787,1907,2694
00232902,WAYNE STATE UNIVERSITY - LAW SCHOOL     ,MI,48202-3424,Public       ,45,257,302,204,819,1023
00233000,WESTERN MICHIGAN UNIVERSITY             ,MI,49008-3899,Public       ,3124,2789,5913,20672,8601,29273
00233100,WESTERN THEOLOGICAL SEMINARY            ,MI,49423-0000,Private      ,1,67,68,5,146,151
00384256,CONCORDIA UNIVERSITY - WISCONSIN - ANN A,MI,48105-2750,Private      ,160,93,253,1034,252,1286
00407100,WALSH COLLEGE OF ACCT & BUS ADMN        ,MI,48007-7006,Private      ,81,633,714,304,1528,1832
00407200,NORTHWOOD UNIVERSITY                    ,MI,48640-2398,Private      ,310,533,843,1966,1354,3320
00467300,BAKER COLLEGE - FLINT                   ,MI,48507-5508,Private      ,656,1942,2598,2099,4390,6489
00467301,BAKER COLLEGE OF CADILLAC               ,MI,49601-0000,Private      ,131,502,633,456,1084,1540
00467302,BAKER COLLEGE OF CLINTON TOWNSHIP       ,MI,48035-0000,Private      ,446,1258,1704,1217,2789,4006
00467303,BAKER COLLEGE OF MUSKEGON               ,MI,49442-0000,Private      ,537,1028,1565,2145,2269,4414
00467304,BAKER COLLEGE OF OWOSSO                 ,MI,48867-0000,Private      ,466,647,1113,1477,1411,2888
00467305,BAKER COLLEGE OF AUBURN HILLS           ,MI,48326-0000,Private      ,292,1078,1370,854,2251,3105
00467306,BAKER COLLEGE OF PORT HURON             ,MI,48060-0000,Private      ,135,303,438,449,746,1195
00467309,BAKER COLLEGE OF JACKSON                ,MI,49202-0000,Private      ,156,770,926,630,1609,2239
00467311,BAKER COLLEGE-CASS CITY                 ,MI,48726-0000,Private      ,43,114,157,142,241,383
00467313,BAKER COLLEGE - GRADUATE ON-LINE        ,MI,48507-0000,Private      ,133,1722,1855,372,4136,4508
00467317,BAKER COLLEGE-ALLEN PARK                ,MI,48101-0000,Private      ,346,1385,1731,1004,3032,4036
00469200,DORSEY SCHOOL OF BUSINESS               ,MI,48195-2334,Proprietary  ,14,84,98,35,144,179
00469201,DORSEY SCHOOL OF BUSINESS               ,MI,48184-0000,Proprietary  ,19,97,116,31,154,185
00469202,DORSEY SCHOOL OF BUSINESS               ,MI,48071-0000,Proprietary  ,65,172,237,89,284,373
00469204,DORSEY SCHOOL OF BUSINESS               ,MI,48066-0000,Proprietary  ,97,311,408,128,438,566
00469205,DORSEY BUSINESS SCHOOL - FARMINGTON HILL,MI,48334-3385,Proprietary  ,15,67,82,25,129,154
00469206,DORSEY BUSINESS SCHOOL - ROSEVILLE CULIN,MI,48066-4555,Proprietary  ,36,133,169,69,237,306
00469207,DORSEY BUSINESS SCHOOL - WATERFORD/PONTI,MI,48341-1037,Proprietary  ,38,161,199,69,237,306
00469208,DORSEY BUSINESS SCHOOL - SAGINAW CAMPUS ,MI,48603-5201,Proprietary  ,30,143,173,58,226,284
00469209,DORSEY SCHOOL OF BUSINESS - LANSING     ,MI,48911-5744,Proprietary  ,18,142,160,43,198,241
00469210,DORSEY SCHOOL OF BUSINESS - DEARBORN    ,MI,48228-3858,Proprietary  ,85,287,372,148,484,632
00491003,KAPLAN CAREER INSTITUTE - DEARBORN      ,MI,48228-0000,Proprietary  ,10,73,83,61,290,351
00676800,MID MICHIGAN COMMUNITY COLLEGE          ,MI,48625-9447,Public       ,616,846,1462,1905,1725,3630
00677100,COLLEGE FOR CREATIVE STUDIES            ,MI,48202-4034,Private      ,364,262,626,1774,695,2469
00694900,KALAMAZOO VALLEY COMMUNITY COLLEGE      ,MI,49003-4070,Public       ,1282,1823,3105,4684,4227,8911
00717100,KIRTLAND COMMUNITY COLLEGE              ,MI,48653-0000,Public       ,203,520,723,732,1117,1849
00732991,ITT TECHNICAL INSTITUTE                 ,MI,49519-1851,Proprietary  ,204,999,1203,451,1767,2218
00761700,CARNEGIE INSTITUTE                      ,MI,48083-1159,Proprietary  ,28,165,193,48,279,327
00795000,WEST SHORE COMMUNITY COLLEGE            ,MI,49454-0000,Public       ,129,212,341,481,580,1061
00817800,EMPIRE BEAUTY SCHOOL                    ,MI,49525-2440,Proprietary  ,303,631,934,481,926,1407
00890600,MACOMB COMMUNITY COLLEGE                ,MI,48088-3896,Public       ,3258,4285,7543,10070,9607,19677
00894600,PORT HURON COSMETOLOGY COLLEGE          ,MI,48329-1618,Proprietary  ,4,13,17,13,22,35
00923000,WAYNE COUNTY COMMUNITY CLG-DISTRICT     ,MI,48226-3010,Public       ,2164,6831,8995,6214,15946,22160
00982800,EVEREST INSTITUTE                       ,MI,48033-4400,Proprietary  ,65,451,516,148,808,956
00982801,EVEREST INSTITUTE- DEARBORN             ,MI,48124-1927,Proprietary  ,79,341,420,190,629,819
00982803,EVEREST INSTITUTE - DETROIT             ,MI,48207-4291,Proprietary  ,91,320,411,212,634,846
01047000,KALAMAZOO BEAUTY ACADEMY                ,MI,49002-5220,Proprietary  ,12,19,31,22,39,61
01082700,DAVID PRESSLEY PROF SCH OF COSMTLGY     ,MI,48067-3219,Proprietary  ,38,80,118,92,165,257
01109800,FLINT INSTITUTE OF BARBERING            ,MI,48504-4395,Proprietary  ,14,68,82,31,127,158
01229100,WRIGHT BEAUTY ACADEMY                   ,MI,49015-2696,Proprietary  ,6,36,42,16,74,90
01262700,THOMAS M. COOLEY LAW SCHOOL             ,MI,48901-1586,Private      ,5,563,568,23,1646,1669
01321800,M J MURPHY BTY CLG MT PLEASANT          ,MI,48858-2502,Proprietary  ,22,25,47,41,46,87
02060300,MICHIGAN INSTITUTE OF AERONAUTICS       ,MI,48188-2533,Proprietary  ,168,263,431,402,419,821
02099700,ROSS MEDICAL EDUCATION CENTER           ,MI,48532-0000,Proprietary  ,136,391,527,248,732,980
02099701,ROSS MEDICAL EDUCATION CENTER-SAGINAW   ,MI,48603-5227,Proprietary  ,14,46,60,47,111,158
02099702,ROSS MEDICAL EDUCATION CENTER-PORT HURON,MI,48060-1958,Proprietary  ,7,21,28,22,46,68
02099703,ROSS MEDICAL EDUCATION CENTER-ROOSEVELT ,MI,49441-4156,Proprietary  ,5,7,12,8,18,26
02100400,EVEREST INSTITUTE                       ,MI,49525-2301,Proprietary  ,67,311,378,149,581,730
02100401,EVEREST INSTITUTE - KALAMAZOO           ,MI,49009-3307,Proprietary  ,47,179,226,96,302,398
02125600,MICHIGAN COLLEGE OF BEAUTY              ,MI,48083-0000,Proprietary  ,61,130,191,133,230,363
02158600,MR BELA'S SCHOOL OF COSMETOLOGY         ,MI,48092-4637,Proprietary  ,10,27,37,34,62,96
02160303,INTERNATIONAL ACADEMY OF DESIGN AND TECH,MI,48083-2160,Proprietary  ,58,116,174,142,218,360
02180100,ROSS MEDICAL EDUCATION CENTER           ,MI,48092-0000,Proprietary  ,75,266,341,159,539,698
02180105,ROSS MEDICAL EDUCATION CENTER-REDFORD   ,MI,48239-1260,Proprietary  ,8,40,48,22,91,113
02198900,MICHIGAN SCHOOL OF PROFESSIONAL PSYCHOLO,MI,48334-4512,Private      ,6,89,95,19,197,216
02209200,TAYLORTOWN SCHOOL OF BEAUTY             ,MI,48180-0000,Proprietary  ,30,80,110,68,164,232
02237800,SPECS HOWARD SCHOOL OF MEDIA ARTS       ,MI,48075-0000,Proprietary  ,164,302,466,439,591,1030
02285700,BAYSHIRE BEAUTY ACADEMY                 ,MI,48708-5614,Proprietary  ,10,44,54,34,95,129
02324500,MICHIGAN COLLEGE OF BEAUTY              ,MI,48161-3901,Proprietary  ,39,58,97,73,106,179
02339700,ROSS MEDICAL EDUCATION CENTER           ,MI,48116-0000,Proprietary  ,66,308,374,127,628,755
02339701,ROSS MEDICAL EDUCATION CENTER-ANN ARBOR ,MI,48108-1411,Proprietary  ,3,29,32,26,80,106
02339703,ROSS MEDICAL EDUCATION CENTER - DAVISON ,MI,48423-1751,Proprietary  ,2,18,20,9,47,56
02361500,MICHIGAN BARBER COLLEGE                 ,MI,48204-2244,Private      ,25,121,146,74,266,340
02363800,YESHIVA GEDOLAH OF GREATER DETROIT      ,MI,48237-0000,Private      ,1,0,1,1,6,7
02491000,WEST MI COLG OF BARBERING & BEAUTY      ,MI,49008-0000,Proprietary  ,10,30,40,28,67,95
02531806,PAUL MITCHELL THE SCHOOL -MICHIGAN      ,MI,48313-0000,Proprietary  ,51,72,123,135,161,296
02533600,ROSS MEDICAL EDUCATION CENTER           ,MI,48917-2108,Proprietary  ,67,215,282,126,430,556
02533601,ROSS MEDICAL EDUCATION CENTER - GRAND RA,MI,49546-2430,Proprietary  ,22,64,86,66,166,232
02588200,DOUGLAS J AVEDA INSTITUTE               ,MI,48823-4351,Proprietary  ,169,223,392,470,458,928
02588201,DOUGLAS J AVEDA INSTITUTE - ANN ARBOR   ,MI,48104-2211,Proprietary  ,31,57,88,115,123,238
02595700,HILLSDALE BEAUTY COLLEGE                ,MI,49242-0000,Proprietary  ,11,8,19,70,19,89
02618400,MICHIGAN CAREER & TECHNICAL INST        ,MI,49080-9254,Public       ,73,26,99,219,72,291
03005700,DETROIT BUSINESS INST. DOWNRIVER        ,MI,48193-6761,Proprietary  ,7,51,58,20,92,112
03066600,BAY MILLS COMMUNITY COLLEGE             ,MI,49715-9750,Public       ,34,105,139,161,253,414
03075200,TWIN CITY BEAUTY COLLEGE                ,MI,49085-3305,Proprietary  ,37,64,101,79,105,184
03075201,TWIN CITY BEAUTY COLLEGE - TRAVERSE CITY,MI,49686-5119,Proprietary  ,8,17,25,25,37,62
03090000,SHARP'S ACADEMY OF HAIRSTYLING          ,MI,48439-1838,Proprietary  ,7,20,27,14,31,45
03109700,HOUGHTON LAKE INST OF COSMETOLOGY       ,MI,48629-0669,Proprietary  ,9,29,38,15,50,65
03110300,THE SCHOOL OF CREATIVE HAIR DESIGN      ,MI,49036-1139,Proprietary  ,11,19,30,20,31,51
03124000,NORTHWESTERN TECHNOLOGICAL INST         ,MI,48075-2412,Proprietary  ,30,134,164,67,229,296
03284300,MICHIGAN JEWISH INSTITUTE               ,MI,48237-0000,Private      ,155,119,274,230,139,369
03490300,PAUL MITCHELL THE SCHOOL ESCANABA       ,MI,49829-0000,Proprietary  ,10,29,39,50,59,109
03588300,IRENE'S MYOMASSOLOGY INSTITUTE          ,MI,48033-2404,Proprietary  ,29,107,136,64,231,295
03704300,BLUE WATER COLLEGE OF COSMETOLOGY       ,MI,48040-2093,Proprietary  ,4,8,12,12,21,33
03772300,SAGINAW CHIPPEWA TRIBAL COLLEGE         ,MI,48858-0000,Public       ,9,27,36,20,57,77
03815300,IN SESSION-ARTS OF COSMETOLOGY BEAU     ,MI,48609-0000,Proprietary  ,14,24,38,45,74,119
03907300,PAUL MITCHELL THE SCHOOL GREAT LAKES    ,MI,48060-0000,Proprietary  ,15,19,34,44,40,84
03915300,CAREER QUEST LEARNING CENTER            ,MI,48910-4732,Proprietary  ,32,176,208,86,303,389
03915301,CAREER QUEST LEARNING CENTER - JACKSON  ,MI,49201-2475,Proprietary  ,25,146,171,54,244,298
03915302,CAREER QUEST LEARNING CENTER - KALAMAZOO,MI,49002-1711,Proprietary  ,20,102,122,42,162,204
03968300,LAKEWOOD SCHOOL OF THERAPEUTIC MASSAGE  ,MI,48060-0000,Proprietary  ,9,16,25,19,31,50
03976500,ANN ARBOR INSTITUTE OF MASSAGE THERAPY  ,MI,48103-0000,Proprietary  ,15,41,56,45,91,136
04002400,ECUMENICAL THEOLOGICAL SEMINARY         ,MI,48201-3035,Private      ,4,53,57,9,106,115
04006300,NUVO COLLEGE OF COSMETOLOGY             ,MI,49441-3822,Proprietary  ,7,18,25,21,30,51
04014300,P&A SCHOLARS BEAUTY SCHOOL              ,MI,48204-0000,Proprietary  ,64,156,220,131,354,485
04094300,ROBERT B. MILLER COLLEGE (THE)          ,MI,49017-3306,Private      ,22,147,169,84,340,424
04121100,GALLERY COLLEGE OF BEAUTY (THE)         ,MI,48036-3591,Proprietary  ,14,40,54,25,86,111
04136300,FOCUS:  HOPE INFORMATION TECHNOLOGIES CE,MI,48238-2949,Private      ,39,111,150,83,268,351
04138400,SCHOOL OF DESIGNING ARTS                ,MI,49015-2853,Proprietary  ,15,41,56,48,81,129
04140900,INTERNATIONAL COSMETOLOGY ACADEMY       ,MI,49508-1308,Proprietary  ,11,47,58,45,91,136
04141100,FRENCH ACADEMY OF COSMETOLOGY           ,MI,49456-3207,Proprietary  ,9,11,20,28,28,56
04158400,L'ESPRIT ACADEMY                        ,MI,48150-0000,Proprietary  ,34,76,110,69,138,207
04159300,MARKETTI ACADEMY OF COSMETOLOGY         ,MI,48329-3506,Proprietary  ,16,21,37,34,42,76
04163300,COMPASS COLLEGE OF CINEMATIC ARTS       ,MI,49503-4227,Private      ,23,25,48,146,70,216
04164700,KEWEENAW BAY OJIBWA COMMUNITY COLLEGE   ,MI,49908-0000,Public       ,2,6,8,7,29,36
04169300,SCHOLARS COSMETOLOGY UNIVERSITY         ,MI,48108-0000,Proprietary  ,2,19,21,9,40,49
04183300,ABCOTT INSTITUTE                        ,MI,48075-5227,Proprietary  ,13,80,93,23,127,150
04184700,PROTEGE ACADEMY                         ,MI,48823-8660,Proprietary  ,33,56,89,58,95,153
04207000,SCHOOL OF MISSIONARY AVIATION TECHNOLOGY,MI,48846-7412,Private      ,6,12,18,28,29,57
04211200,BRIGHTON INSTITUTE OF COSMETOLOGY       ,MI,48116-8360,Proprietary  ,7,10,17,24,30,54
04222300,MANTHANO CHRISTIAN COLLEGE              ,MI,48185-1919,Private      ,3,12,15,7,34,41
04230200,EXCEL ACADEMIES OF COSMETOLOGY          ,MI,48085-1300,Proprietary  ,14,20,34,20,26,46
04230400,EXCEL ACADEMIES OF COSMETOLOGY          ,MI,48912-4686,Proprietary  ,11,34,45,24,52,76
04230500,EXCEL ACADEMIES OF COSMETOLOGY          ,MI,49512-1781,Proprietary  ,7,9,16,25,19,44
00233200,ANOKA-RAMSEY CC-CAMBRIDGE/COONRAPID     ,MN,55433-3499,Public       ,1333,1689,3022,2409,2988,5397
00233400,AUGSBURG COLLEGE                        ,MN,55454-1351,Private      ,1098,1145,2243,3029,1809,4838
00233500,RIVERLAND COMMUNITY COLLEGE             ,MN,55912-1473,Public       ,351,571,922,603,914,1517
00233600,BEMIDJI STATE UNIVERSITY                ,MN,56601-2699,Public       ,1099,725,1824,3399,1499,4898
00233700,BETHANY LUTHERAN COLLEGE INC            ,MN,56001-6163,Private      ,199,26,225,589,60,649
00233900,CENTRAL LAKES COLG-BRAINERD/STAPLES     ,MN,56401-3900,Public       ,558,629,1187,928,1011,1939
00234000,CARLETON COLLEGE                        ,MN,55057-4001,Private      ,211,18,229,3385,89,3474
00234100,COLLEGE OF ST BENEDICT                  ,MN,56374-2099,Private      ,541,24,565,2036,65,2101
00234200,ST. CATHERINE UNIVERSITY                ,MN,55105-1789,Private      ,863,1390,2253,2676,2584,5260
00234300,COLLEGE OF ST SCHOLASTICA               ,MN,55811-4199,Private      ,699,829,1528,2245,1648,3893
00234500,UNIVERSITY OF ST THOMAS                 ,MN,55105-1096,Private      ,1266,1317,2583,6434,2475,8909
00234600,CONCORDIA COLLEGE-MOORHEAD              ,MN,56562-0001,Private      ,892,62,954,2743,165,2908
00234700,"CONCORDIA UNIVERSITY, ST PAUL, MN       ",MN,55104-5494,Private      ,530,1239,1769,1526,2111,3637
00235000,VERMILION COMMUNITY COLLEGE             ,MN,55731-1996,Public       ,187,64,251,377,121,498
00235300,GUSTAVUS ADOLPHUS COLLEGE               ,MN,56082-1498,Private      ,710,33,743,3150,89,3239
00235400,HAMLINE UNIVERSITY                      ,MN,55104-1284,Private      ,898,935,1833,3082,1792,4874
00235500,HIBBING COMMUNITY COLLEGE               ,MN,55746-3300,Public       ,240,326,566,401,507,908
00235600,ITASCA COMMUNITY COLLEGE                ,MN,55744-3397,Public       ,295,200,495,641,346,987
00235700,LUTHER SEMINARY                         ,MN,55108-0000,Private      ,2,121,123,2,286,288
00235800,MACALESTER COLLEGE                      ,MN,55105-1899,Private      ,617,69,686,3507,161,3668
00236000,"MINNESOTA STATE UNIVERSITY, MANKATO     ",MN,56002-0000,Public       ,3185,1511,4696,10617,3238,13855
00236100,MARTIN LUTHER COLLEGE                   ,MN,56073-3965,Private      ,265,23,288,680,44,724
00236200,MINNEAPOLIS COMM AND TECH COLLEGE       ,MN,55403-1779,Public       ,1637,3401,5038,2704,5684,8388
00236500,MINNEAPOLIS COLLEGE OF ART & DESIGN     ,MN,55404-4343,Private      ,181,137,318,837,369,1206
00236600,CROSSROADS COLLEGE                      ,MN,55902-2382,Private      ,42,29,71,71,51,122
00236700,MINNESOTA STATE UNIVERSITY MOORHEAD     ,MN,56563-0001,Public       ,1301,785,2086,4149,1654,5803
00236900,NORTH CENTRAL UNIVERSITY                ,MN,55404-1391,Private      ,472,157,629,1080,315,1395
00237000,NORTH HENNEPIN COMMUNITY COLLEGE        ,MN,55445-2299,Public       ,1081,2039,3120,1923,3330,5253
00237100,UNIVERSITY OF NORTHWESTERN- ST PAUL     ,MN,55113-1598,Private      ,758,305,1063,2054,541,2595
00237300,ROCHESTER COMMUNITY/TECH COLLEGE        ,MN,55904-4999,Public       ,1077,1442,2519,1886,2246,4132
00237500,SOUTHWEST MINNESOTA STATE UNIVERSITY    ,MN,56258-1598,Public       ,518,380,898,1855,743,2598
00237700,ST CLOUD STATE UNIVERSITY               ,MN,56301-4498,Public       ,3080,1736,4816,8087,3210,11297
00237900,SAINT JOHNS UNIVERSITY                  ,MN,56321-0000,Private      ,472,33,505,1786,82,1868
00238000,SAINT MARY'S UNIVERSITY                 ,MN,55987-1399,Private      ,247,1379,1626,1635,2270,3905
00238200,ST OLAF COLLEGE                         ,MN,55057-1098,Private      ,776,28,804,3610,101,3711
00238300,CROWN COLLEGE                           ,MN,55375-9001,Private      ,208,262,470,776,529,1305
00238500,NORTHLAND COMMUNITY & TECHNICAL CLG     ,MN,56701-2598,Public       ,522,629,1151,883,993,1876
00238600,UNITED THEOLGCL SEMINRY TWIN CITIES     ,MN,55112-0000,Private      ,1,42,43,2,65,67
00238800,"UNIVERSITY OF MINNESOTA, DULUTH         ",MN,55812-2496,Public       ,2919,807,3726,8712,1635,10347
00238900,"UNIVERSITY OF MINNESOTA, MORRIS         ",MN,56267-2113,Public       ,582,106,688,2077,233,2310
00239100,WILLIAM MITCHELL COLLEGE OF LAW         ,MN,55105-0000,Private      ,2,414,416,3,754,757
00239300,MINNESOTA STATE COLLEGE-SE TECH         ,MN,55987-0409,Public       ,305,531,836,511,841,1352
00239400,WINONA STATE UNIVERSITY                 ,MN,55987-5838,Public       ,2281,700,2981,6297,1205,7502
00396900,UNIVERSITY OF MINNESOTA-TWIN CITIES     ,MN,55455-0422,Public       ,7514,5409,12923,31044,12747,43791
00400900,MESABI RANGE CMNTY & TECH COLLEGE       ,MN,55792-0000,Public       ,161,208,369,292,323,615
00405708,NATIONAL AMERICAN UNIVERSITY            ,MN,55113-0000,Proprietary  ,7,75,82,12,184,196
00405715,NATIONAL AMERICAN UNIVERSITY - BLOOMINGT,MN,55425-5550,Proprietary  ,9,108,117,18,270,288
00406900,UNIVERSITY OF MINNESOTA-CROOKSTON       ,MN,56716-5001,Public       ,316,395,711,942,687,1629
00438600,VETERAN'S MEDICAL CTR- SCH RAD TECH     ,MN,55417-2399,Public       ,0,4,4,3,10,13
00464100,DUNWOODY COLLEGE OF TECHNOLOGY          ,MN,55403-1192,Private      ,268,500,768,459,763,1222
00464200,GLOBE UNIVERSITY                        ,MN,55125-5408,Proprietary  ,428,1345,1773,648,1955,2603
00464500,MINNEAPOLIS BUSINESS COLLEGE            ,MN,55113-4036,Proprietary  ,118,59,177,251,119,370
00464600,MINNESOTA SCHOOL OF BUSINESS            ,MN,55423-0000,Proprietary  ,449,1311,1760,607,1841,2448
00525200,RIDGEWATER COLLEGE                      ,MN,56201-2098,Public       ,727,615,1342,1321,1022,2343
00526300,MINNESOTA WEST CMNTY & TECH COLG        ,MN,56241-1096,Public       ,297,418,715,538,777,1315
00553300,"SAINT PAUL COLLEGE, COMMUNITY/TECHNICAL ",MN,55102-1800,Public       ,1358,2582,3940,2571,4166,6737
00553400,SAINT CLOUD TECHNICAL COLLEGE AND COMMUN,MN,56303-1240,Public       ,1169,1056,2225,1984,1732,3716
00553500,PINE TECHNICAL COLLEGE                  ,MN,55063-2198,Public       ,88,288,376,159,470,629
00553700,SOUTH CENTRAL COLLEGE                   ,MN,56003-0000,Public       ,631,749,1380,1117,1292,2409
00554100,MINNESOTA STATE COMMUNITY AND TECHNICAL ,MN,56573-1405,Public       ,876,1176,2052,1413,1915,3328
00554400,ALEXANDRIA TECHNICAL COLLEGE            ,MN,56308-3799,Public       ,542,310,852,972,519,1491
00575700,LAKE SUPERIOR COLLEGE                   ,MN,55811-3399,Public       ,790,1017,1807,1337,1692,3029
00575900,NORTHWEST TECHNICAL COLLEGE - BEMIDJI   ,MN,56601-4907,Public       ,174,338,512,303,553,856
00677500,RAINY RIVER COMMUNITY COLLEGE           ,MN,56649-2187,Public       ,55,34,89,101,61,162
00735000,ANOKA-HENNEPIN TECHNICAL COLLEGE        ,MN,55303-1590,Public       ,370,840,1210,645,1403,2048
00735100,BROWN COLLEGE                           ,MN,55120-1004,Proprietary  ,72,221,293,122,353,475
00795400,NORMANDALE COMMUNITY COLLEGE            ,MN,55431-4399,Public       ,1647,1868,3515,3088,3199,6287
00826700,NORTHWEST TECHNICAL INSTITUTE           ,MN,55121-5001,Proprietary  ,0,1,1,6,16,22
00869400,RASMUSSEN COLLEGE - ST. CLOUD           ,MN,56301-3713,Proprietary  ,133,571,704,197,982,1179
00869401,RASMUSSEN COLLEGE - BROOKLYN PARK       ,MN,55445-1512,Proprietary  ,85,491,576,149,812,961
00869406,RASMUSSEN COLLEGE - EAGAN               ,MN,55122-1346,Proprietary  ,61,395,456,103,773,876
00869407,RASMUSSEN COLLEGE - BLOOMINGTON         ,MN,55435-5444,Proprietary  ,104,560,664,171,997,1168
00869409,RASMUSSEN COLLEGE - MANKATO             ,MN,56001-8658,Proprietary  ,130,386,516,190,657,847
00869412,RASMUSSEN COLLEGE - LAKE ELMO           ,MN,55042-8624,Proprietary  ,55,376,431,82,618,700
00869416,RASMUSSEN COLLEGE - MOORHEAD            ,MN,56560-4513,Proprietary  ,74,332,406,110,514,624
00869417,RASMUSSEN COLLEGE - BLAINE              ,MN,55014-0000,Proprietary  ,97,492,589,147,752,899
00905800,BETHEL UNIVERSITY                       ,MN,55112-6999,Private      ,1002,894,1896,2959,1454,4413
00960000,COSMETOLOGY CAREERS UNLTD-DULUTH        ,MN,55802-2031,Proprietary  ,6,14,20,10,22,32
00974000,INVER HILLS COMMUNITY COLLEGE           ,MN,55076-3224,Public       ,878,1281,2159,1589,2236,3825
00983100,MODEL COLLEGE OF HAIR DESIGN            ,MN,56301-4280,Proprietary  ,35,32,67,59,54,113
00989200,"DULUTH BUSINESS UNIV, INC.              ",MN,55807-0000,Proprietary  ,35,143,178,70,255,325
00999200,OAK HILLS CHRISTIAN COLLEGE             ,MN,56601-0000,Private      ,40,32,72,91,45,136
01024800,ART INSTITUTES INTL MINNESOTA           ,MN,55402-3137,Proprietary  ,339,316,655,702,564,1266
01035602,EVEREST INSTITUTE - EAGAN               ,MN,55121-1696,Proprietary  ,22,143,165,27,202,229
01037400,METROPOLITAN STATE UNIVERSITY           ,MN,55106-5000,Public       ,897,3577,4474,1792,6017,7809
01040200,DAKOTA COUNTY TECHNICAL COLLEGE         ,MN,55068-2999,Public       ,385,664,1049,713,1107,1820
01049000,REGENCY BEAUTY INSTITUTE                ,MN,55428-0000,Proprietary  ,1163,2287,3450,1833,3399,5232
01049100,HENNEPIN TECHNICAL COLLEGE              ,MN,55445-2399,Public       ,744,2177,2921,1252,3534,4786
01054600,CENTURY COLLEGE                         ,MN,55110-1894,Public       ,1904,2902,4806,3343,4681,8024
01173200,"MAYO CLINIC, COLLEGE OF MEDICINE        ",MN,55905-0000,Private      ,26,149,175,64,389,453
01173201,MAYO SCHOOL OF HEALTH-RELATED SCIEN     ,MN,55905-0000,Private      ,32,74,106,83,196,279
01173206,MAYO GRAD SCHOOL                        ,MN,55901-0000,Private      ,2,11,13,5,41,46
01173207,MAYO MEDICAL SCHOOL                     ,MN,55901-0000,Private      ,10,40,50,26,144,170
01232800,NORTHWESTERN HEALTH SCIENCES UNIV       ,MN,55431-1599,Private      ,32,301,333,62,541,603
02050300,ACADEMY COLLEGE                         ,MN,55420-1554,Proprietary  ,15,94,109,27,121,148
02097300,HASTINGS BEAUTY SCHOOL                  ,MN,55033-1205,Proprietary  ,7,18,25,8,22,30
02123200,AVEDA INSTITUTE                         ,MN,55414-0000,Proprietary  ,149,161,310,255,293,548
02159800,COSMETOLOGY CAREERS UNLTD - HIBBING     ,MN,55746-0000,Proprietary  ,4,7,11,6,12,18
02160901,PCI ACADEMY - PCI ACADEMY               ,MN,55446-4928,Proprietary  ,15,35,50,21,49,70
02238100,MINNESOTA SCHOOL OF COSMETOLOGY         ,MN,55125-0000,Proprietary  ,73,95,168,111,144,255
02260500,SUMMIT ACAD OPPORTUNITIES IND CTR       ,MN,55405-0000,Private      ,29,179,208,45,297,342
02263102,ANTHEM COLLEGE - ST. LOUIS PARK         ,MN,55416-2467,Proprietary  ,4,7,11,5,18,23
02504200,WALDEN UNIVERSITY                       ,MN,55401-2511,Proprietary  ,132,18173,18305,270,36910,37180
02514100,AMERICAN INDIAN OPPORTUNITIES CTR       ,MN,55404-0000,Private      ,5,87,92,8,124,132
03001200,MCNALLY SMITH COLLEGE OF MUSIC          ,MN,55101-2220,Proprietary  ,156,73,229,490,169,659
03051900,ALFRED ADLER GRADUATE SCHOOL            ,MN,55305-0000,Private      ,0,138,138,0,236,236
03096400,LEECH LAKE TRIBAL COLLEGE               ,MN,56633-0000,Public       ,25,128,153,40,182,222
03129100,FOND DU LAC TRIBAL & COMMUNITY CLG      ,MN,55720-2984,Public       ,151,272,423,269,421,690
03267300,CAPELLA UNIVERSITY                      ,MN,55402-3389,Proprietary  ,138,22784,22922,255,39174,39429
03833300,AMERICAN ACADEMY OF ACUPUNCTURE AND ORIE,MN,55113-0000,Proprietary  ,1,9,10,1,29,30
03921400,WHITE EARTH TRIBAL AND COMMUNITY COLLEGE,MN,56557-0478,Private      ,2,26,28,5,35,40
04044300,HAZELDEN GRADUATE SCHOOL OF ADDICTION ST,MN,55012-0000,Private      ,0,45,45,0,94,94
04130200,INST. OF PRODUCTION AND RECORDING       ,MN,55401-1315,Proprietary  ,108,91,199,201,167,368
04148800,CENTERPOINT MASSAGE & SHIATSU THERAPY SC,MN,55414-4525,Proprietary  ,5,42,47,15,74,89
04157600,NOVA ACADEMY OF COSMETOLOGY             ,MN,55906-4103,Proprietary  ,17,31,48,23,46,69
04160500,AVALON SCHOOL OF COSMETOLOGY            ,MN,56187-1930,Proprietary  ,9,16,25,12,24,36
04174400,ROCHESTER SCHOOL OF HAIR DESIGN         ,MN,55901-4310,Proprietary  ,11,18,29,17,25,42
04175600,PARK AVENUE SCHOOL OF COSMETOLOGY       ,MN,56470-3361,Proprietary  ,13,46,59,16,68,84
00239600,ALCORN STATE UNIVERSITY                 ,MS,39096-7500,Public       ,1402,1321,2723,3591,2393,5984
00239700,BELHAVEN UNIVERSITY                     ,MS,39202-1789,Private      ,572,1794,2366,1730,3549,5279
00239800,BLUE MOUNTAIN COLLEGE                   ,MS,38610-9370,Private      ,179,129,308,513,258,771
00240100,COAHOMA COMMUNITY COLLEGE               ,MS,38614-9799,Public       ,498,464,962,965,855,1820
00240200,COPIAH-LINCOLN COMMUNITY COLLEGE        ,MS,39191-0649,Public       ,729,735,1464,1522,1254,2776
00240300,DELTA STATE UNIVERSITY                  ,MS,38733-0000,Public       ,1053,1183,2236,3174,2102,5276
00240400,EAST CENTRAL COMMUNITY COLLEGE          ,MS,39327-0129,Public       ,619,588,1207,1615,1076,2691
00240500,EAST MISSISSIPPI COMM COLLEGE           ,MS,39358-0000,Public       ,1182,1053,2235,2442,1819,4261
00240700,HINDS COMMUNITY COLLEGE                 ,MS,39154-9799,Public       ,2833,3589,6422,5780,6149,11929
00240800,HOLMES COMMUNITY COLLEGE                ,MS,39079-0000,Public       ,1481,1885,3366,3074,3443,6517
00240900,ITAWAMBA COMMUNITY COLLEGE              ,MS,38843-1099,Public       ,1477,1176,2653,3153,2040,5193
00241000,JACKSON STATE UNIVERSITY                ,MS,39217-0001,Public       ,2963,4288,7251,7678,7323,15001
00241100,JONES COUNTY JUNIOR COLLEGE             ,MS,39437-3999,Public       ,1396,828,2224,3114,1568,4682
00241300,MERIDIAN COMMUNITY COLLEGE              ,MS,39307-5890,Public       ,757,920,1677,1539,1610,3149
00241400,MILLSAPS COLLEGE                        ,MS,39201-0000,Private      ,283,252,535,1473,499,1972
00241500,MISSISSIPPI COLLEGE                     ,MS,39058-0001,Private      ,938,1433,2371,2675,2505,5180
00241501,MISSISSIPPI COLLEGE - SCHOOL OF LAW     ,MS,39201-1391,Private      ,42,321,363,89,644,733
00241600,MISSISSIPPI DELTA CMTY COLLEGE          ,MS,38761-0000,Public       ,736,658,1394,1483,1249,2732
00241700,MISSISSIPPI GULF CST CLG-PERKINSTON     ,MS,39573-0000,Public       ,2052,2715,4767,3948,4442,8390
00242200,MISSISSIPPI UNIV FOR WOMEN              ,MS,39701-5818,Public       ,657,1043,1700,1644,1890,3534
00242300,MISSISSIPPI STATE UNIVERSITY            ,MS,39762-9698,Public       ,4738,2715,7453,15524,5546,21070
00242400,MISSISSIPPI VALLEY STATE UNIVERSITY     ,MS,38941-1400,Public       ,1104,906,2010,2910,1737,4647
00242600,NORTHEAST MS CMNTY COLLEGE              ,MS,38829-1731,Public       ,1140,766,1906,2423,1328,3751
00242700,NORTHWEST MISSISSIPPI COMMUNITY CLG     ,MS,38668-1703,Public       ,2034,1885,3919,4707,3372,8079
00243000,PEARL RIVER COMMUNITY COLLEGE           ,MS,39470-2201,Public       ,1154,1109,2263,2450,1986,4436
00243300,RUST COLLEGE                            ,MS,38635-2328,Private      ,454,216,670,1276,512,1788
00243500,SOUTHEASTERN BAPTIST COLLEGE            ,MS,39440-0000,Private      ,6,10,16,18,28,46
00243600,SOUTHWEST MISSISSIPPI CMNTY CLG         ,MS,39666-8099,Public       ,617,520,1137,1152,860,2012
00243900,TOUGALOO COLLEGE                        ,MS,39174-9799,Private      ,495,281,776,1241,570,1811
00244000,UNIVERSITY OF MISSISSIPPI               ,MS,38677-1848,Public       ,4087,2426,6513,14995,4960,19955
00244001,UNIVERSITY OF MISSISSIPPI - MED CTR     ,MS,39216-0000,Public       ,265,1058,1323,749,2222,2971
00244100,UNIVERSITY OF SOUTHERN MISSISSIPPI      ,MS,39406-0001,Public       ,3628,3216,6844,11196,7267,18463
00244700,WILLIAM CAREY UNIVERSITY                ,MS,39401-5499,Private      ,735,1932,2667,1729,3335,5064
00489809,MCCANN SCHOOL OF BUSINESS & TECHNOLOGY -,MS,39503-3167,Proprietary  ,11,54,65,22,118,140
01289101,ANTONELLI COLLEGE - JACKSON             ,MS,39232-9514,Proprietary  ,69,506,575,98,746,844
01289102,ANTONELLI COLLEGE - HATTIESBURG         ,MS,39401-3056,Proprietary  ,65,306,371,121,435,556
02074900,CHRIS' BEAUTY COLLEGE                   ,MS,39501-0000,Proprietary  ,31,59,90,48,95,143
02160500,NORTH MISSISSIPPI MED CTR MED TECH      ,MS,38801-0000,Private      ,19,52,71,56,102,158
02235900,ACADEMY OF HAIR DESIGN #4               ,MS,39208-0000,Proprietary  ,20,40,60,39,96,135
02244300,ACADEMY OF HAIR DESIGN #1               ,MS,39204-5008,Proprietary  ,47,115,162,107,224,331
02244305,ACADEMY OF HAIR DESIGN #1-ACADEMY OF HAI,MS,38901-5108,Proprietary  ,7,27,34,26,60,86
02249900,DELTA BEAUTY COLLEGE                    ,MS,38701-0000,Proprietary  ,20,37,57,37,63,100
02251600,ACADEMY OF HAIR DESIGN #6               ,MS,39401-7581,Proprietary  ,43,107,150,76,181,257
02251700,FOSTER'S COSMETOLOGY COLLEGE            ,MS,38663-0000,Proprietary  ,2,12,14,4,23,27
02302800,MISSISSIPPI COLLEGE OF BEAUTY CULT      ,MS,39440-0000,Proprietary  ,9,26,35,23,44,67
02320800,MAGNOLIA COLLEGE OF COSMETOLOGY         ,MS,39206-0000,Proprietary  ,31,106,137,65,187,252
02502100,CREATIONS COLLEGE OF COSMETOLOGY        ,MS,38803-0000,Proprietary  ,5,23,28,14,64,78
02516200,WESLEY BIBLICAL SEMINARY                ,MS,39206-0000,Private      ,6,50,56,9,87,96
02586000,J & J HAIR DESIGN COLLEGE               ,MS,39051-3716,Proprietary  ,14,23,37,19,43,62
03010603,VIRGINIA COLLEGE - JACKSON              ,MS,39206-5602,Proprietary  ,64,290,354,104,522,626
03010610,VIRGINIA COLLEGE - BILOXI               ,MS,39532-2124,Proprietary  ,52,180,232,90,347,437
03032400,KC'S SCHOOL OF HAIR DESIGN              ,MS,38863-0000,Proprietary  ,16,43,59,30,71,101
03263300,TRAXLER'S SCHOOL OF HAIR                ,MS,39212-2529,Proprietary  ,9,21,30,18,43,61
03294305,BLUE CLIFF COLLEGE - GULFPORT           ,MS,39503-0000,Proprietary  ,28,128,156,55,234,289
03464300,ACADEMY OF HAIR DESIGN                  ,MS,39562-0000,Proprietary  ,4,11,15,9,20,29
03848300,DAY SPA CAREER COLLEGE                  ,MS,39564-0000,Proprietary  ,8,26,34,11,52,63
03963300,HEALING TOUCH SCHOOL OF MASSAGE THERAPY ,MS,39402-1300,Proprietary  ,31,103,134,59,175,234
04131300,CORINTH ACADEMY OF COSMETOLOGY          ,MS,38834-4813,Proprietary  ,16,49,65,25,88,113
04140200,"MISSISSIPPI INSTITUTE OF AESTHETICS, NAI",MS,39056-5628,Proprietary  ,19,59,78,28,100,128
00252600,CARROLL COLLEGE                         ,MT,59625-0002,Private      ,154,49,203,2319,211,2530
00252700,UNIVERSITY OF GREAT FALLS               ,MT,59405-4996,Private      ,108,169,277,834,459,1293
00252800,MILES COMMUNITY COLLEGE                 ,MT,59301-4799,Public       ,68,54,122,219,135,354
00252900,DAWSON COMMUNITY COLLEGE                ,MT,59330-1405,Public       ,38,43,81,173,89,262
00253000,MONTANA STATE UNIVERSITY - BILLINGS     ,MT,59101-0298,Public       ,479,916,1395,2492,2288,4780
00253100,MONTANA TECH OF THE UNIV OF MONTANA     ,MT,59701-8997,Public       ,229,338,567,1484,1130,2614
00253200,MONTANA STATE UNIVERSITY - BOZEMAN      ,MT,59717-4160,Public       ,1491,1119,2610,12322,3725,16047
00253300,MONTANA STATE UNIVERSITY-NORTHERN       ,MT,59501-3148,Public       ,171,237,408,734,575,1309
00253400,ROCKY MOUNTAIN COLLEGE                  ,MT,59102-1796,Private      ,195,118,313,1192,350,1542
00253600,UNIVERSITY OF MONTANA (THE)             ,MT,59812-0001,Public       ,1113,1520,2633,7631,5752,13383
00253700,UNIVERSITY OF MONTANA WESTERN (THE)     ,MT,59725-3598,Public       ,197,143,340,1254,427,1681
00677700,FLATHEAD VALLEY COMMUNITY COLLEGE       ,MT,59901-2699,Public       ,177,375,552,694,1095,1789
00757000,HELENA COLLEGE OF TECHNOLOGY            ,MT,59601-3098,Public       ,83,283,366,414,739,1153
00790000,BUTTE ACADEMY OF BEAUTY CULTURE         ,MT,59701-9197,Proprietary  ,12,26,38,21,46,67
00931400,GREAT FALLS COLLEGE MONTANA STATE UNIVER,MT,59405-4907,Public       ,133,443,576,535,1053,1588
02143400,SALISH KOOTENAI COLLEGE                 ,MT,59855-0000,Public       ,70,229,299,238,558,796
02286600,LITTLE BIG HORN COLLEGE                 ,MT,59022-0000,Public       ,12,23,35,55,72,127
02343000,FT PECK COMMUNITY COLLEGE               ,MT,59255-0000,Public       ,16,30,46,34,65,99
02510600,BLACKFEET COMMUNITY COLLEGE             ,MT,59417-0000,Private      ,10,47,57,98,170,268
02517500,FORT BELKNAP COLLEGE                    ,MT,59526-0000,Public       ,7,33,40,23,60,83
02545200,CHIEF DULL KNIFE COLLEGE                ,MT,59043-0098,Public       ,5,7,12,38,62,100
02610900,STONE CHILD COLLEGE                     ,MT,59521-9796,Public       ,3,13,16,37,66,103
02621300,ACADEMY OF COSMETOLOGY                  ,MT,59715-3544,Proprietary  ,9,18,27,33,47,80
03205300,MODERN BEAUTY SCHOOL                    ,MT,59801-8386,Proprietary  ,21,30,51,46,70,116
03763400,"ACADEMY OF NAIL, SKIN & HAIR            ",MT,59101-0000,Proprietary  ,17,50,67,54,99,153
03778300,HEALTH WORKS INSTITUTE                  ,MT,59715-0000,Proprietary  ,9,37,46,29,74,103
04163700,BITTERROOT SCHOOL OF COSMETOLOGY        ,MT,59840-3118,Proprietary  ,7,24,31,13,41,54
04164100,MONTANA ACADEMY OF SALON                ,MT,59405-0000,Proprietary  ,22,36,58,53,73,126
04187700,CREVIER'S SCHOOL OF COSMETOLOGY         ,MT,59901-4402,Proprietary  ,24,55,79,49,92,141
00253900,CHADRON STATE COLLEGE                   ,NE,69337-2690,Public       ,509,398,907,1658,791,2449
00254000,COLLEGE OF ST MARY                      ,NE,68106-2606,Private      ,136,431,567,493,890,1383
00254100,CONCORDIA UNIVERSITY                    ,NE,68434-1594,Private      ,305,260,565,1385,466,1851
00254200,CREIGHTON UNIVERSITY                    ,NE,68178-0001,Private      ,767,1583,2350,5935,4699,10634
00254400,DOANE COLLEGE                           ,NE,68333-2421,Private      ,388,412,800,1529,828,2357
00254700,GRACE UNIVERSITY                        ,NE,68108-3629,Private      ,135,109,244,392,225,617
00254800,HASTINGS COLLEGE                        ,NE,68901-7621,Private      ,325,73,398,1386,193,1579
00255100,UNIVERSITY OF NEBRASKA AT KEARNEY       ,NE,68849-0001,Public       ,936,728,1664,4100,1601,5701
00255300,MIDLAND UNIVERSITY                      ,NE,68025-4254,Private      ,444,143,587,1462,266,1728
00255400,UNIVERSITY OF NEBRASKA-OMAHA            ,NE,68182-0001,Public       ,2136,2202,4338,8601,5579,14180
00255500,NEBRASKA WESLEYAN UNIVERSITY            ,NE,68504-2796,Private      ,431,296,727,1704,599,2303
00255700,MID-PLAINS COMM COLLEGE - NORTH PLATTE  ,NE,69101-9420,Public       ,161,216,377,390,470,860
00255701,MID-PLAINS COMMUNITY COLLEGE - MCCOOK   ,NE,69001-2631,Public       ,59,50,109,180,115,295
00255900,PERU STATE COLLEGE                      ,NE,68421-0010,Public       ,264,315,579,1051,747,1798
00256000,WESTERN NEBRASKA COMMUNITY COLLEGE      ,NE,69361-1815,Public       ,170,272,442,570,648,1218
00256300,UNION COLLEGE                           ,NE,68506-4387,Private      ,298,170,468,736,335,1071
00256500,UNIVERSITY OF NEBRASKA-LINCOLN          ,NE,68588-0419,Public       ,3244,1504,4748,15718,4241,19959
00256596,UNIVERSITY OF NEBRASKA - CURTIS         ,NE,69025-9522,Public       ,77,21,98,232,44,276
00256600,WAYNE STATE COLLEGE                     ,NE,68787-1172,Public       ,707,325,1032,2869,688,3557
00256700,YORK COLLEGE                            ,NE,68467-2699,Private      ,183,49,232,373,88,461
00443600,REGNL WST MEDCL CTR SCHL RAD            ,NE,69361-0000,Private      ,4,8,12,21,24,45
00458608,KAPLAN UNIVERSITY - OMAHA               ,NE,68134-1002,Proprietary  ,63,632,695,118,1051,1169
00458609,KAPLAN UNIVERSITY - LINCOLN             ,NE,68508-2668,Proprietary  ,44,392,436,87,729,816
00639900,BRYANLGH COLLEGE OF HEALTH SCIENCES     ,NE,68506-1398,Private      ,102,116,218,405,318,723
00640400,NEBR METHODIST CLG OF NURS ALLD HLTH    ,NE,68114-2852,Private      ,160,400,560,456,785,1241
00689500,UNIVERSITY OF NEBRASKA-MED CTR          ,NE,68198-4265,Public       ,214,957,1171,675,2144,2819
00750100,VATTEROTT COLLEGE                       ,NE,68137-1237,Proprietary  ,41,142,183,84,336,420
00849200,ALEGENT HEALTH SCHOOLS                  ,NE,68114-2767,Private      ,30,96,126,84,201,285
00952300,BAHNER COLLEGE OF HAIRSTYLING           ,NE,68025-3297,Proprietary  ,7,13,20,15,19,34
00961700,CAPITOL BEAUTY SCHOOL                   ,NE,68144-0000,Proprietary  ,62,78,140,113,137,250
00974300,BELLEVUE UNIVERSITY                     ,NE,68005-0000,Private      ,296,2906,3202,641,5754,6395
00986200,CLARKSON COLLEGE                        ,NE,68131-2739,Private      ,143,499,642,468,1036,1504
01151900,JOSEPH'S COLLEGE OF BEAUTY/ALL CAMPUSES ,NE,68510-2226,Proprietary  ,66,115,181,115,186,301
01166700,NORTHEAST COMMUNITY COLLEGE             ,NE,68702-0000,Public       ,545,510,1055,1574,907,2481
01258600,METROPOLITAN COMMUNITY COLLEGE          ,NE,68103-0000,Public       ,1570,3611,5181,4009,7813,11822
01297600,NEBRASKA CHRISTIAN COLLEGE              ,NE,68046-4256,Private      ,50,31,81,128,40,168
02079700,COLLEGE OF HAIR DESIGN                  ,NE,68508-0000,Proprietary  ,76,89,165,134,154,288
02099500,CENTRAL COMMUNITY COLLEGE-ALL CAMPUSES  ,NE,68801-7299,Public       ,542,745,1287,1529,1437,2966
02099501,CENTRAL COMMUNITY COLLEGE - HASTINGS CAM,NE,68902-7712,Public       ,0,0,0,1,0,1
02099502,CENTRAL COMMUNITY COLLEGE - COLUMBUS CAM,NE,68602-8031,Public       ,0,0,0,0,1,1
02508300,SOUTHEAST COMM. COLLEGE-ALL CAMPUSES    ,NE,68520-0000,Public       ,1322,1794,3116,3754,4037,7791
02550800,NEBRASKA INDIAN COMMUNITY COLLEGE       ,NE,68039-0000,Public       ,5,30,35,14,55,69
02610500,XENON INTERNATIONAL ACADEMY II          ,NE,68127-3522,Proprietary  ,76,117,193,157,213,370
03164300,THE CREATIVE CENTER                     ,NE,68164-2911,Proprietary  ,47,36,83,112,66,178
03279300,MYOTHERAPY INSTITUTE                    ,NE,68516-0000,Proprietary  ,8,9,17,19,18,37
03323300,LITTLE PRIEST TRIBAL COLLEGE            ,NE,68071-0000,Private      ,4,23,27,11,46,57
03821400,UNIVERSAL COLLEGE OF HEALING ARTS       ,NE,68112-1810,Proprietary  ,7,34,41,19,73,92
00256800,UNIVERSITY OF NEVADA RENO               ,NV,89557-0002,Public       ,2147,1770,3917,15548,5798,21346
00256900,UNIVERSITY OF NEVADA-LAS VEGAS          ,NV,89154-1001,Public       ,4029,5339,9368,19611,14569,34180
00697700,GREAT BASIN COLLEGE                     ,NV,89801-3348,Public       ,185,445,630,531,857,1388
00732954,ITT TECHNICAL INSTITUTE                 ,NV,89014-6712,Proprietary  ,121,322,443,235,642,877
00736700,MARINELLO SCHOOLS OF BEAUTY             ,NV,89110-3563,Proprietary  ,72,187,259,148,306,454
00736701,MARINELLO SCHOOLS OF BEAUTY -           ,NV,89014-2244,Proprietary  ,25,86,111,50,151,201
00737100,MARINELLO SCHOOL OF BEAUTY              ,NV,89502-6530,Proprietary  ,54,108,162,106,168,274
00844103,ANTHEM INSTITUTE - MORRISON UNIVERSITY  ,NV,89521-4826,Proprietary  ,34,222,256,64,380,444
00919200,SIERRA NEVADA COLLEGE                   ,NV,89451-0000,Private      ,100,215,315,467,462,929
01036200,COLLEGE OF SOUTHERN NEVADA              ,NV,89146-1139,Public       ,4883,8982,13865,12986,18342,31328
01036300,WESTERN NEVADA COLLEGE                  ,NV,89703-0000,Public       ,445,980,1425,967,1915,2882
01246110,LINCOLN TECHNICAL INSTITUTE-EUPH INST OF,NV,89117-8803,Proprietary  ,65,111,176,95,183,278
01246111,LINCOLN TECHNICAL INSTITUTE-EUPH INS OFB,NV,89052-4964,Proprietary  ,36,67,103,47,98,145
01246112,LINCOLN TECHNICAL INSTITUTE- EUPH INST O,NV,89131-1036,Proprietary  ,33,69,102,70,131,201
01323200,ACADEMY OF HAIR DESIGN                  ,NV,89146-1617,Proprietary  ,57,139,196,141,285,426
02107700,TRUCKEE MEADOWS COMMUNITY CLG           ,NV,89512-0000,Public       ,1312,2463,3775,3751,5075,8826
02237500,EVEREST COLLEGE                         ,NV,89103-0000,Proprietary  ,212,651,863,580,1322,1902
02338512,GLENDALE CAREER COLLEGE - NEVADA CAREER ,NV,89131-3268,Proprietary  ,20,76,96,50,192,242
02616703,SCOTTSDALE CULINARY INSTITUTE - LE CORDO,NV,89144-7047,Proprietary  ,56,111,167,167,286,453
02621500,CAREER COLLEGE OF NORTHERN NEVADA       ,NV,89434-7905,Proprietary  ,110,355,465,179,548,727
03030603,UTAH CLG OF MASSAGE THERAPY-NSMT        ,NV,89123-0000,Proprietary  ,50,138,188,94,244,338
03031405,INTERNATIONAL ACADEMY OF DESIGN AND TECH,NV,89074-7750,Proprietary  ,125,195,320,213,349,562
03043200,KAPLAN COLLEGE                          ,NV,89102-8618,Proprietary  ,260,763,1023,566,1654,2220
03076404,BRYMAN SCHOOL OF ARIZONA (THE) - ANTHEM ,NV,89102-4514,Proprietary  ,77,161,238,113,304,417
03088200,CARSON CITY BEAUTY ACADEMY              ,NV,89706-0000,Proprietary  ,16,56,72,25,98,123
03787300,EXPERTISE SCHOOL OF BEAUTY              ,NV,89106-2516,Private      ,34,142,176,72,213,285
03838500,NORTHWEST HEALTH CAREERS                ,NV,89128-0255,Proprietary  ,68,208,276,191,413,604
03975300,INSTITUTE OF PROFESSIONAL CAREERS       ,NV,89119-7825,Proprietary  ,23,119,142,67,278,345
04051303,ART INSTITUTE OF PHOENIX (THE) - ART INS,NV,89074-7737,Proprietary  ,91,104,195,336,282,618
04065300,ROSEMAN UNIVERSITY OF HEALTH SCIENCES   ,NV,89014-2333,Private      ,41,685,726,328,1797,2125
04114300,NEVADA STATE COLLEGE                    ,NV,89002-9455,Public       ,557,1367,1924,1975,3096,5071
04142601,TOURO UNIVERSITY - NEVADA               ,NV,89014-8800,Private      ,23,228,251,95,716,811
04144800,INTERNATIONAL ACADEMY OF STYLE          ,NV,89509-3450,Proprietary  ,41,64,105,73,113,186
04147600,AVEDA INSTITUTE LAS VEGAS               ,NV,89119-6103,Proprietary  ,80,169,249,141,308,449
04171000,ADVANCED TRAINING INSTITUTE             ,NV,89115-7504,Proprietary  ,83,267,350,130,448,578
04186300,PAUL MITCHELL THE SCHOOL LAS VEGAS      ,NV,89123-8014,Proprietary  ,97,160,257,227,303,530
04190300,AMERICAN INSTITUTE OF MEDICAL SONOGRAPHY,NV,89146-6597,Proprietary  ,34,141,175,103,328,431
04191100,DESTINATION ACADEMY FOR SPA AND SALON PR,NV,89147-8397,Proprietary  ,0,0,0,8,16,24
04203100,PAUL MITCHELL THE SCHOOL RENO           ,NV,89501-3356,Proprietary  ,48,57,105,106,125,231
04226200,HEALTHCARE PREPARATORY INSTITUTE        ,NV,89130-2580,Proprietary  ,25,109,134,98,269,367
00257200,COLBY-SAWYER COLLEGE                    ,NH,03257-4648,Private      ,101,16,117,2572,121,2693
00257300,DARTMOUTH COLLEGE                       ,NH,03755-3529,Private      ,265,434,699,10158,1698,11856
00257500,FRANKLIN PIERCE UNIVERSITY              ,NH,03461-0060,Private      ,317,413,730,3234,952,4186
00257900,NEW ENGLAND COLLEGE                     ,NH,03242-3293,Private      ,375,744,1119,2326,1382,3708
00258000,SOUTHERN NEW HAMPSHIRE UNIVERSITY       ,NH,03106-1045,Private      ,1769,18927,20696,7610,35798,43408
00258100,NHTI  - CONCORD'S COMMUNITY COLLEGE     ,NH,03301-7412,Public       ,839,756,1595,2269,1485,3754
00258200,MANCHESTER COMMUNITY COLLEGE            ,NH,03102-8518,Public       ,496,661,1157,1099,1290,2389
00258300,GREAT BAY COMMUNITY COLLEGE             ,NH,03801-0000,Public       ,329,484,813,801,895,1696
00258600,RIVIER UNIVERSITY                       ,NH,03060-5086,Private      ,217,425,642,1363,918,2281
00258700,SAINT ANSELM COLLEGE                    ,NH,03102-1310,Private      ,391,46,437,3730,153,3883
00258900,UNIVERSITY OF NEW HAMPSHIRE             ,NH,03824-2511,Public       ,738,577,1315,20935,3180,24115
00258903,UNIV OF NEW HAMPSHIRE - SCHOOL OF LAW   ,NH,03301-4115,Public       ,3,63,66,26,335,361
00259000,KEENE STATE COLLEGE                     ,NH,03431-0000,Public       ,653,150,803,7536,650,8186
00259100,PLYMOUTH STATE UNIVERSITY               ,NH,03264-1595,Public       ,460,359,819,6149,1240,7389
00301004,ANTIOCH UNIVERSITY                      ,NH,03431-0000,Private      ,3,186,189,9,696,705
00472900,HESSER COLLEGE                          ,NH,03103-7230,Proprietary  ,100,418,518,200,739,939
00472901,HESSER COLLEGE - NASHUA CAMPUS          ,NH,03063-1286,Proprietary  ,43,138,181,73,241,314
00472904,HESSER COLLEGE - PORTSMOUTH CAMPUS      ,NH,03801-3245,Proprietary  ,1,0,1,12,33,45
00472905,HESSER COLLEGE - SALEM CAMPUS           ,NH,03079-2842,Proprietary  ,52,170,222,83,262,345
00472906,HESSER COLLEGE - CONCORD CAMPUS         ,NH,03301-3415,Proprietary  ,0,1,1,12,29,41
00473100,DANIEL WEBSTER COLLEGE                  ,NH,03063-1300,Proprietary  ,193,114,307,654,209,863
00529100,WHITE MOUNTAINS COMMUNITY COLLEGE       ,NH,03570-3799,Public       ,85,172,257,262,328,590
00702500,LEBANON COLLEGE                         ,NH,03766-0000,Private      ,13,27,40,28,51,79
00755500,LAKES REGION COMMUNITY COLLEGE          ,NH,03246-1326,Public       ,203,225,428,527,503,1030
00756000,RIVER VALLEY COMMUNITY COLLEGE          ,NH,03743-9707,Public       ,117,266,383,267,565,832
00864500,EMPIRE BEAUTY SCHOOL                    ,NH,03220-0000,Proprietary  ,32,35,67,53,64,117
00923600,NASHUA COMMUNITY COLLEGE                ,NH,03063-2052,Public       ,393,378,771,900,751,1651
01318900,CONTINENTAL ACADEMIE OF HAIR DESIGN     ,NH,03051-3754,Proprietary  ,29,20,49,47,26,73
02140400,ST JOSEPH SCH OF PRAC NRSG              ,NH,03060-0000,Private      ,14,92,106,38,185,223
02174800,MICHAEL'S SCHOOL OF HAIR DESIGN & ESTHET,NH,03110-0000,Proprietary  ,24,28,52,55,57,112
02179600,EMPIRE BEAUTY SCHOOL                    ,NH,03878-0000,Proprietary  ,23,44,67,35,57,92
02211600,PORTSMOUTH BTY SCH OF HAIR DESIGN       ,NH,03801-4084,Proprietary  ,14,14,28,21,16,37
02223300,MAGDALEN COLLEGE                        ,NH,03278-4012,Private      ,35,0,35,35,0,35
02245400,KEENE BEAUTY ACADEMY                    ,NH,03431-0000,Proprietary  ,18,20,38,37,28,65
02247000,NEW ENGLAND SCHOOL OF HAIR DESIGN       ,NH,03784-0000,Proprietary  ,13,23,36,25,34,59
03043100,THOMAS MORE COLLEGE OF LIBERAL ARTS     ,NH,03054-4818,Private      ,33,7,40,89,16,105
03101300,GRANITE STATE COLLEGE                   ,NH,03301-6400,Public       ,135,958,1093,356,1764,2120
03182300,NEW HAMPSHIRE INSTITUTE OF ART          ,NH,03104-4858,Private      ,117,76,193,615,162,777
03437300,UPPER VALLEY TEACHER TRANING PROGRAM    ,NH,03766-1358,Private      ,0,18,18,1,30,31
03729300,NH INSTITUTE FOR THERAPEUTIC ARTS       ,NH,03051-4906,Proprietary  ,2,13,15,3,30,33
04162200,LAIRD INSTITUTE OF SPA THERAPY          ,NH,03102-5263,Proprietary  ,7,29,36,13,45,58
00267000,BAPTIST BIBLE COLG OF PENNSYLVANIA      ,PA,18411-1297,Private      ,216,169,385,498,328,826
00322800,BRYN ATHYN COLLEGE OF THE NEW CHURCH    ,PA,19009-0717,Private      ,68,20,88,266,41,307
00322900,ALBRIGHT COLLEGE                        ,PA,19612-5234,Private      ,551,394,945,4483,971,5454
00323000,ALLEGHENY COLLEGE                       ,PA,16335-3902,Private      ,671,35,706,3404,97,3501
00323100,COMM CLG OF ALLEGHENY-ALLEGHENY CMP     ,PA,15212-0000,Public       ,1402,2301,3703,2423,4197,6620
00323101,"COMM CLG OF ALLEGHENY, BOYCE CAMPUS     ",PA,15146-0000,Public       ,701,948,1649,1215,1703,2918
00323102,"COMM CLG OF ALLEGHENY, NORTH CAMPUS     ",PA,15237-0000,Public       ,811,853,1664,1452,1594,3046
00323103,"COMM CLG OF ALLEGHENY, SOUTH CAMPUS     ",PA,15122-0000,Public       ,749,848,1597,1346,1561,2907
00323300,ALVERNIA UNIVERSITY                     ,PA,19607-1799,Private      ,652,687,1339,2442,1449,3891
00323500,ARCADIA UNIVERSITY                      ,PA,19038-3295,Private      ,775,528,1303,6383,1682,8065
00323700,BRYN MAWR COLLEGE                       ,PA,19010-2899,Private      ,228,167,395,1738,476,2214
00323800,BUCKNELL UNIVERSITY                     ,PA,17837-2122,Private      ,644,34,678,5208,201,5409
00323900,BUCKS COUNTY COMMUNITY COLLEGE          ,PA,18940-1320,Public       ,1530,1376,2906,3195,2708,5903
00324000,BUTLER COUNTY COMMUNITY COLLEGE         ,PA,16001-0000,Public       ,918,665,1583,1695,1298,2993
00324100,CABRINI COLLEGE                         ,PA,19087-3698,Private      ,460,221,681,1897,502,2399
00324200,CARNEGIE MELLON UNIVERSITY              ,PA,15213-3890,Private      ,1071,414,1485,12738,1492,14230
00324201,CARNEGIE MELLON UNIV- THE HEINZ COLLEGE ,PA,15213-0000,Private      ,24,125,149,135,551,686
00324202,CARNEGIE MELLON- TEPPER SCHOOL OF BUSINE,PA,15213-0000,Private      ,25,211,236,239,410,649
00324300,CEDAR CREST COLLEGE                     ,PA,18104-6196,Private      ,276,509,785,1082,1193,2275
00324400,CHATHAM UNIVERSITY                      ,PA,15232-2826,Private      ,152,594,746,675,1402,2077
00324500,CHESTNUT HILL COLLEGE                   ,PA,19118-2693,Private      ,443,798,1241,1633,1740,3373
00324700,MISERICORDIA  UNIVERSITY                ,PA,18612-1008,Private      ,676,590,1266,2611,1191,3802
00324900,COMMUNITY COLLEGE OF PHILADELPHIA       ,PA,19130-3991,Public       ,4222,7540,11762,10011,15757,25768
00325100,CURTIS INSTITUTE OF MUSIC               ,PA,19103-6187,Private      ,36,31,67,266,131,397
00325200,DELAWARE VALLEY COLLEGE                 ,PA,18901-2697,Private      ,576,159,735,2272,330,2602
00325300,DICKINSON COLLEGE                       ,PA,17013-2896,Private      ,482,28,510,3436,138,3574
00325600,DREXEL UNIVERSITY                       ,PA,19104-2875,Private      ,4056,5761,9817,32606,14698,47304
00325800,DUQUESNE UNIVERSITY                     ,PA,15282-0001,Private      ,2313,1617,3930,7776,3294,11070
00325900,EASTERN UNIVERSITY                      ,PA,19087-3696,Private      ,599,967,1566,2151,2099,4250
00326200,ELIZABETHTOWN COLLEGE                   ,PA,17022-2298,Private      ,302,216,518,2902,588,3490
00326300,EVANGELICAL SCHOOL OF THEOLOGY          ,PA,17067-0000,Private      ,0,52,52,0,75,75
00326500,FRANKLIN & MARSHALL COLLEGE             ,PA,17604-0000,Private      ,435,68,503,3475,173,3648
00326600,GANNON UNIVERSITY                       ,PA,16541-0001,Private      ,545,452,997,3748,1206,4954
00326700,GENEVA COLLEGE                          ,PA,15010-3599,Private      ,368,315,683,1790,641,2431
00326800,GETTYSBURG COLLEGE                      ,PA,17325-1486,Private      ,560,41,601,3883,147,4030
00326900,GROVE CITY COLLEGE                      ,PA,16127-2104,Private      ,355,22,377,1830,51,1881
00327000,GWYNEDD-MERCY COLLEGE                   ,PA,19437-0901,Private      ,448,679,1127,1459,1303,2762
00327200,HARCUM COLLEGE                          ,PA,19010-3476,Private      ,363,847,1210,833,1577,2410
00327300,HARRISBURG AREA COMMUNITY COLLEGE       ,PA,17110-2999,Public       ,3914,5270,9184,7581,10485,18066
00327400,HAVERFORD COLLEGE                       ,PA,19041-1392,Private      ,290,15,305,2083,69,2152
00327500,HOLY FAMILY UNIVERSITY                  ,PA,19114-2094,Private      ,469,592,1061,1861,1460,3321
00327600,IMMACULATA UNIVERSITY                   ,PA,19345-0647,Private      ,400,527,927,1667,1160,2827
00327700,INDIANA UNIVERSITY OF PENNSYLVANIA      ,PA,15705-1097,Public       ,4359,1418,5777,13729,3100,16829
00327900,JUNIATA COLLEGE                         ,PA,16652-2196,Private      ,194,27,221,2463,94,2557
00328000,KEYSTONE COLLEGE                        ,PA,18440-0200,Private      ,602,308,910,1541,567,2108
00328200,KINGS COLLEGE                           ,PA,18711-0801,Private      ,677,224,901,3050,486,3536
00328300,LACKAWANNA COLLEGE                      ,PA,18509-9961,Private      ,713,454,1167,1574,834,2408
00328400,LAFAYETTE COLLEGE                       ,PA,18042-1768,Private      ,470,35,505,4838,136,4974
00328500,LANCASTER BIBLE COLLEGE                 ,PA,17601-5036,Private      ,293,379,672,791,788,1579
00328600,LANCASTER THEOLOGICAL SEMINARY          ,PA,17603-0000,Private      ,0,63,63,0,96,96
00328700,LASALLE UNIVERSITY                      ,PA,19141-1199,Private      ,1339,1458,2797,6239,3526,9765
00328800,LEBANON VALLEY COLLEGE                  ,PA,17003-1400,Private      ,268,68,336,2902,249,3151
00328900,LEHIGH UNIVERSITY                       ,PA,18015-1588,Private      ,790,300,1090,8422,821,9243
00329000,LINCOLN UNIVERSITY                      ,PA,19352-0999,Public       ,658,309,967,2914,876,3790
00329100,LUTHERAN THEOLOG SEMINARY-GETTYSBRG     ,PA,17325-0000,Private      ,1,39,40,1,66,67
00329200,LUTHERAN THEOLOGICAL SEMINARY           ,PA,19119-0000,Private      ,1,76,77,2,143,145
00329300,LYCOMING COLLEGE                        ,PA,17701-5192,Private      ,455,54,509,1915,135,2050
00329400,MANOR COLLEGE                           ,PA,19046-3399,Private      ,208,190,398,616,450,1066
00329600,MARYWOOD UNIVERSITY                     ,PA,18509-1598,Private      ,659,569,1228,2797,1281,4078
00329700,MERCYHURST UNIVERSITY                   ,PA,16546-0001,Private      ,664,497,1161,3608,1355,4963
00329800,MESSIAH COLLEGE                         ,PA,17027-0000,Private      ,432,187,619,3251,437,3688
00330000,MOORE COLLEGE OF ART & DESIGN           ,PA,19103-1179,Private      ,94,81,175,663,316,979
00330100,MORAVIAN COLLEGE                        ,PA,18018-6650,Private      ,460,159,619,2128,402,2530
00330101,MORAVIAN THEOLOGICAL SEMINARY           ,PA,18018-0000,Private      ,3,38,41,10,63,73
00330200,MOUNT ALOYSIUS COLLEGE                  ,PA,16630-1999,Private      ,326,297,623,1351,772,2123
00330300,CARLOW UNIVERSITY                       ,PA,15213-3165,Private      ,412,783,1195,1160,1650,2810
00330400,MUHLENBERG COLLEGE                      ,PA,18104-5586,Private      ,463,171,634,3625,350,3975
00330600,VALLEY FORGE CHRISTIAN COLLEGE          ,PA,19460-2399,Private      ,291,113,404,726,225,951
00330900,PEIRCE COLLEGE                          ,PA,19102-4699,Private      ,204,1027,1231,436,2052,2488
00331100,SALUS UNIVERSITY                        ,PA,19027-1598,Private      ,4,288,292,16,1108,1124
00331300,WIDENER UNIVERSITY                      ,PA,19013-5792,Private      ,662,768,1430,4846,2287,7133
00331302,WIDENER UNIV SCH OF LAW- HARRISBURG     ,PA,17106-9381,Private      ,5,158,163,23,469,492
00331500,BLOOMSBURG UNIVERSITY OF PA             ,PA,17815-1301,Public       ,3370,815,4185,12370,1922,14292
00331600,CALIFORNIA UNIV OF PENNSYLVANIA         ,PA,15419-1394,Public       ,2061,1772,3833,5690,3420,9110
00331700,CHEYNEY UNIVERSITY OF PENNSYLVANIA      ,PA,19319-0200,Public       ,524,291,815,1692,712,2404
00331800,CLARION UNIVERSITY OF PENNSYLVANIA      ,PA,16214-1232,Public       ,1694,941,2635,4449,1900,6349
00332000,EAST STROUDSBURG UNIVERSITY             ,PA,18301-2999,Public       ,2026,784,2810,7456,1736,9192
00332100,EDINBORO UNIVERSITY OF PENNSYLVANIA     ,PA,16444-0001,Public       ,994,767,1761,5441,2478,7919
00332200,KUTZTOWN UNIVERSITY OF PENNSYLVANIA     ,PA,19530-9339,Public       ,2728,792,3520,10710,1925,12635
00332300,LOCK HAVEN UNIV OF PENNSYLVANIA         ,PA,17745-2439,Public       ,1285,424,1709,5262,1195,6457
00332400,MANSFIELD UNIVERSITY                    ,PA,16933-1123,Public       ,814,273,1087,2869,643,3512
00332500,MILLERSVILLE UNIVERSITY OF PA           ,PA,17551-1800,Public       ,2045,870,2915,8352,2183,10535
00332600,SHIPPENSBURG UNIVERSITY                 ,PA,17257-2299,Public       ,2297,645,2942,8560,1536,10096
00332700,SLIPPERY ROCK UNIVERSITY                ,PA,16057-1326,Public       ,2982,990,3972,8421,1850,10271
00332800,WEST CHESTER UNIVERSITY                 ,PA,19383-0001,Public       ,3511,1665,5176,17133,4229,21362
00332900,PENN STATE UNIVERSITY                   ,PA,16802-1503,Public       ,16154,8972,25126,69373,23078,92451
00335000,UNIVERSITY OF THE ARTS (THE)            ,PA,19102-9493,Private      ,533,203,736,2682,574,3256
00335100,CAIRN UNIVERSITY                        ,PA,19047-2942,Private      ,245,175,420,704,323,1027
00335200,PHILADELPHIA CLG OSTEOPATHIC MED        ,PA,19131-0000,Private      ,7,926,933,38,3237,3275
00335300,UNIVERSITY OF THE SCIENCES IN PHILADELPH,PA,19104-4495,Private      ,280,358,638,3342,1399,4741
00335400,PHILADELPHIA UNIVERSITY                 ,PA,19144-5497,Private      ,812,824,1636,4413,1931,6344
00335600,PITTSBURGH THEOLOGICAL SEMINARY         ,PA,15206-0000,Private      ,2,44,46,2,152,154
00335700,POINT PARK UNIVERSITY                   ,PA,15222-1912,Private      ,700,732,1432,3509,1786,5295
00335800,REFORMED PRESBYTERIAN THEOL SEMINAR     ,PA,15208-0000,Private      ,2,5,7,4,10,14
00335900,ROBERT MORRIS UNIVERSITY                ,PA,15108-1189,Private      ,1488,824,2312,5190,1762,6952
00336000,ROSEMONT COLLEGE                        ,PA,19010-1699,Private      ,177,206,383,639,466,1105
00336200,SETON HILL UNIVERSITY                   ,PA,15601-1599,Private      ,677,384,1061,2146,779,2925
00336400,ST. CHARLES BORROMEO SEMINARY           ,PA,19096-0000,Private      ,14,8,22,26,16,42
00336600,SAINT FRANCIS UNIVERSITY                ,PA,15940-0600,Private      ,532,267,799,1979,650,2629
00336700,SAINT JOSEPH'S UNIVERSITY               ,PA,19131-1395,Private      ,1137,1252,2389,7715,2672,10387
00336800,ST VINCENT COLLEGE                      ,PA,15650-2690,Private      ,650,127,777,1992,255,2247
00336900,SUSQUEHANNA UNIVERSITY                  ,PA,17870-1001,Private      ,388,30,418,3609,115,3724
00337000,SWARTHMORE COLLEGE                      ,PA,19081-1397,Private      ,345,18,363,3142,84,3226
00337100,TEMPLE UNIVERSITY                       ,PA,19122-6003,Private      ,5091,5106,10197,34823,17181,52004
00337600,THIEL COLLEGE                           ,PA,16125-2181,Private      ,405,46,451,1772,128,1900
00337800,UNIVERSITY OF PENNSYLVANIA              ,PA,19104-6216,Private      ,2467,3029,5496,22132,11161,33293
00337900,UNIVERSITY OF PITTSBURGH                ,PA,15260-0000,Public       ,5096,3016,8112,30287,8361,38648
00337906,UNIVERSITY OF PITTSBURGH - SCHOOL OF MED,PA,15261-0001,Public       ,42,314,356,185,924,1109
00337907,UNIVERSITY OF PITTSBURGH - SCHOOL OF DEN,PA,15261-2523,Public       ,29,151,180,94,351,445
00338400,UNIVERSITY OF SCRANTON                  ,PA,18510-4622,Private      ,1220,555,1775,7898,1183,9081
00338500,URSINUS COLLEGE                         ,PA,19426-1000,Private      ,539,28,567,2511,80,2591
00338600,VALLEY FORGE MILITARY COLLEGE           ,PA,19087-3695,Private      ,173,28,201,565,79,644
00338800,VILLANOVA UNIVERSITY                    ,PA,19085-1699,Private      ,1330,999,2329,12260,2373,14633
00338801,VILLANOVA UNIV SCH OF LAW               ,PA,19085-0000,Private      ,5,250,255,32,807,839
00338900,WASHINGTON & JEFFERSON COLLEGE          ,PA,15301-4801,Private      ,470,31,501,2698,88,2786
00339100,WAYNESBURG UNIVERSITY                   ,PA,15370-1222,Private      ,530,258,788,1875,513,2388
00339200,WESTMINSTER COLLEGE                     ,PA,16172-0002,Private      ,515,70,585,1864,146,2010
00339300,WESTMINSTER THEOLOGICAL SEMINARY        ,PA,19038-0000,Private      ,0,133,133,3,252,255
00339400,WILKES UNIVERSITY                       ,PA,18766-0998,Private      ,788,483,1271,3270,1009,4279
00339500,PENNSYLVANIA COLLEGE OF TECHNOLOGY      ,PA,17701-5779,Public       ,2011,919,2930,4878,1845,6723
00339600,WILSON COLLEGE                          ,PA,17201-1285,Private      ,119,127,246,523,325,848
00339900,YORK COLLEGE OF PENNSYLVANIA            ,PA,17405-7199,Private      ,1355,423,1778,8028,1047,9075
00398600,DESALES UNIVERSITY                      ,PA,18034-9568,Private      ,586,566,1152,2714,1233,3947
00398700,LA ROCHE COLLEGE                        ,PA,15237-5898,Private      ,478,228,706,1123,451,1574
00398800,NEUMANN UNIVERSITY                      ,PA,19014-1298,Private      ,785,493,1278,2837,1135,3972
00405800,GRATZ COLLEGE                           ,PA,19027-3097,Private      ,1,26,27,2,55,57
00445200,MONTGOMERY COUNTY COMMUNITY COLLEGE     ,PA,19422-6300,Public       ,2190,2273,4463,4399,4289,8688
00488900,CAMBRIA-ROWE BUSINESS COLLEGE           ,PA,15902-2494,Proprietary  ,39,45,84,87,123,210
00488901,CAMBRIA ROWE BUSINESS COLLEGE - INDIANA ,PA,15701-2804,Proprietary  ,30,41,71,57,90,147
00489000,CENTRAL PENNSYLVANIA COLLEGE            ,PA,17093-0309,Proprietary  ,330,561,891,961,1273,2234
00489300,DU BOIS BUSINESS COLLEGE                ,PA,15801-2401,Proprietary  ,61,74,135,116,199,315
00489400,ERIE BUSINESS CENTER                    ,PA,16501-1305,Proprietary  ,28,129,157,59,235,294
00489401,ERIE BUSINESS CENTER - NEW CASTLE CAMPUS,PA,16101-3950,Proprietary  ,16,61,77,23,95,118
00489800,MCCANN SCHOOL OF BUSINESS & TECHNOL     ,PA,17901-1335,Proprietary  ,624,2229,2853,1090,3767,4857
00489807,MCCANN SCHOOL OF BUSINESS & TECHNOLOGY -,PA,17013-3180,Proprietary  ,18,24,42,45,80,125
00489900,MERCY HOSP SCH OF NURSING               ,PA,15219-5166,Private      ,64,115,179,148,192,340
00490200,PENN COMMERCIAL BUSINESS/TECHNICAL SCHL ,PA,15301-2871,Proprietary  ,124,158,282,185,262,447
00491000,KAPLAN CAREER INSTITUTE                 ,PA,17111-3571,Proprietary  ,58,206,264,123,420,543
00491001,THOMPSON INSTITUTE-PHILADEPHIA CAMPUS   ,PA,19104-3386,Proprietary  ,123,264,387,187,453,640
00500701,WEST VIRGINIA CAREER INSTITUTE          ,PA,15456-0000,Proprietary  ,28,36,64,51,71,122
00531000,PITTSBURGH INST OF AERONAUTICS          ,PA,15236-0000,Private      ,136,127,263,313,239,552
00533000,FAYETTE CNTY AREA VOC TECH PRC NRSG     ,PA,15401-0000,Public       ,22,49,71,39,78,117
00533500,CENTRAL PENN INST OF SCI & TECH PNP     ,PA,16823-0000,Public       ,60,94,154,117,161,278
00536500,YORK CO AREA VOC-TECH SCH-PRAC NSG      ,PA,17402-0000,Public       ,25,125,150,49,227,276
00653400,CITIZENS SCHOOL OF NURSING              ,PA,15068-6591,Private      ,55,91,146,97,166,263
00653700,CONEMAUGH VLY MEM HOSP SCH NRSNG        ,PA,15905-4398,Private      ,45,65,110,132,111,243
00653704,CONEMAUGH VLY MEM HOSP SCH RAD TECH     ,PA,15905-0000,Private      ,6,11,17,35,23,58
00655100,ST MARGARET SCHL OF NURSING             ,PA,15238-3205,Private      ,57,107,164,109,198,307
00656000,OHIO VALLEY HOSP SCH OF NURSING         ,PA,15136-1694,Private      ,14,37,51,34,59,93
00656500,READING HOSPITAL SCHOOL OF HEALTH SCIENC,PA,19611-1744,Private      ,90,203,293,206,406,612
00657400,"ST LUKE'S HOSPITAL OF BETHLEHEM, PA     ",PA,18015-1065,Private      ,37,86,123,88,221,309
00657700,UPMC SHADYSIDE SCHOOL OF NURSING        ,PA,15232-1381,Private      ,92,179,271,222,339,561
00657800,SHARON REGIONAL SCHOOL OF NURSING       ,PA,16146-3395,Private      ,8,20,28,31,68,99
00658200,WASHINGTON HOSP SCH OF NURSING          ,PA,15301-3398,Private      ,19,45,64,33,81,114
00658202,WASHINGTON HOSP SCH OF RAD TECH         ,PA,15301-3398,Private      ,4,4,8,8,7,15
00658300,WESTERN PENN HOSP-SCH OF NURSING        ,PA,15224-1790,Private      ,50,99,149,123,183,306
00680700,COMMUNITY COLLEGE OF BEAVER COUNTY      ,PA,15061-2588,Public       ,519,528,1047,958,992,1950
00681000,LEHIGH CARBON COMMUNITY COLLEGE         ,PA,18078-2598,Public       ,1557,1496,3053,2862,2949,5811
00681100,LUZERNE COUNTY COMMUNITY COLLEGE        ,PA,18634-3899,Public       ,1287,1325,2612,2463,2596,5059
00708700,ABINGTON MEM HOSP SCHL OF NURSING       ,PA,19090-1284,Private      ,29,112,141,115,364,479
00709100,EVEREST INSTITUTE                       ,PA,15222-1320,Proprietary  ,68,276,344,120,524,644
00711000,DELAWARE COUNTY COMMUNITY COLLEGE       ,PA,19063-1094,Public       ,2554,3084,5638,5135,6219,11354
00719100,NORTHAMPTON COMMUNITY COLLEGE           ,PA,18020-7599,Public       ,1945,1842,3787,5667,4869,10536
00730305,LINCOLN TECHNICAL INSTITUTE - PHILADELPH,PA,19136-1530,Proprietary  ,114,172,286,218,337,555
00732955,ITT TECHNICAL INSTITUTE                 ,PA,19406-1212,Proprietary  ,69,212,281,161,477,638
00743000,ANTONELLI INST OF ART & PHOTOGRAPHY     ,PA,19038-8242,Proprietary  ,83,16,99,237,36,273
00743600,KAPLAN CAREER INSTITUTE - ICM CAMPUS    ,PA,15222-1977,Proprietary  ,88,248,336,157,525,682
00743700,PITTSBURGH TECHNICAL INSTITUTE          ,PA,15071-3205,Proprietary  ,836,446,1282,2024,1032,3056
00746900,"HUSSIAN SCHOOL OF ART, INC.             ",PA,19106-0000,Proprietary  ,55,15,70,105,44,149
00747000,"ART INSTITUTE OF PITTSBURGH, THE        ",PA,15219-1328,Proprietary  ,1039,4267,5306,2241,6983,9224
00752900,"CHESTER COUNTY INTERMEDIATE UNIT, PNP   ",PA,19335-3043,Public       ,15,50,65,27,118,145
00777900,LANSDALE SCHOOL OF BUSINESS             ,PA,19454-4114,Proprietary  ,38,172,210,53,282,335
00778000,NEW CASTLE SCHOOL OF TRADES             ,PA,16143-0000,Proprietary  ,164,275,439,261,409,670
00778100,CHI INSTITUTE/RETS CAMPUS               ,PA,19008-3516,Proprietary  ,48,151,199,69,252,321
00783900,TRIANGLE TECH                           ,PA,15214-3897,Proprietary  ,100,97,197,200,239,439
00791200,THADDEUS STEVENS CLG OF TECHNOLOGY      ,PA,17602-0000,Public       ,388,193,581,1300,506,1806
00791600,FRANKLIN CNTY CAREER & TECH CTR-PNP     ,PA,17201-0000,Public       ,25,49,74,34,88,122
00793807,LINCOLN TECHNICAL INSITUTE - ALLENTOWN  ,PA,18104-3212,Proprietary  ,195,285,480,293,436,729
00820000,JAMESON MEMORIAL HOSP SCH NURSING       ,PA,16105-2595,Private      ,20,31,51,44,83,127
00835000,ART INSTITUTE OF PHILADELPHIA           ,PA,19103-5198,Proprietary  ,741,741,1482,2114,1709,3823
00844100,ANTHEM INSTITUTE                        ,PA,19064-1243,Proprietary  ,22,113,135,50,236,286
00856800,VET TECH INSTITUTE                      ,PA,15222-3400,Proprietary  ,156,87,243,335,173,508
00865300,JEFFERSON CO DUBOIS VOC TECH-PR NSG     ,PA,15851-0000,Public       ,11,16,27,16,20,36
00895500,PRUONTOS HAIR DESIGN INSTITUTE          ,PA,16602-0000,Proprietary  ,17,11,28,26,18,44
00915705,WYOMING TECHNICAL INSTITUTE - BLAIRSVILL,PA,15717-8060,Proprietary  ,337,277,614,661,538,1199
00918600,DEAN INSTITUTE OF TECHNOLOGY            ,PA,15226-1197,Proprietary  ,25,69,94,34,97,131
00944900,PENNCO TECH                             ,PA,19007-0000,Proprietary  ,104,173,277,135,247,382
00966400,EMPIRE BEAUTY SCHOOL                    ,PA,18052-5730,Proprietary  ,267,593,860,386,855,1241
00972100,BRADFORD SCHOOL                         ,PA,15219-2602,Proprietary  ,175,61,236,545,149,694
00972300,ARIA HEALTH SCHOOL OF NURSING           ,PA,19053-6939,Private      ,68,168,236,131,307,438
00986300,LANCASTER GENERAL COLLEGE OF NURSING AND,PA,17602-4955,Private      ,235,477,712,646,942,1588
01000600,GREATER JOHNSTOWN AREA VOC TECH SCH     ,PA,15904-0000,Public       ,27,75,102,63,134,197
01005500,CRAWFORD CNTY AREA VO-TECH PRAC NUR     ,PA,16335-0000,Public       ,15,14,29,18,28,46
01017600,WESTMORELAND COUNTY COMMUNITY CLG       ,PA,15697-1895,Public       ,1180,1160,2340,2184,2191,4375
01038800,READING AREA COMMUNITY COLLEGE          ,PA,19603-1706,Public       ,938,1383,2321,1653,2510,4163
01054200,EMPIRE BEAUTY SCHOOL                    ,PA,18701-0000,Proprietary  ,279,650,929,426,961,1387
01081400,PITTSBURGH INST MORTUARY SCIENCE        ,PA,15206-3706,Private      ,36,96,132,83,206,289
01086000,GREATER ALTOONA CAREER/TECH CENTER      ,PA,16602-0000,Public       ,44,100,144,82,172,254
01096300,GREENE COUNTY VOC-TECH SCHOOL           ,PA,15370-0000,Public       ,9,20,29,13,27,40
01099800,PENNSYLVANIA INSTITUTE OF TECH          ,PA,19063-4098,Private      ,156,321,477,321,605,926
01162100,AUTOMOTIVE TRAINING CENTER              ,PA,19341-1310,Proprietary  ,297,149,446,609,260,869
01162200,WELDER TRAINING & TESTING INST          ,PA,18109-3253,Proprietary  ,13,33,46,30,72,102
01171500,SCHUYLKILL HEALTH SCHOOL OF NURSING     ,PA,17901-3692,Private      ,31,34,65,68,58,126
01191900,BEAVER FALLS BEAUTY ACADEMY             ,PA,15010-4208,Proprietary  ,5,14,19,14,26,40
01205000,ROSEDALE TECHNICAL INSTITUTE            ,PA,15205-9791,Private      ,151,147,298,271,292,563
01239300,THOMAS JEFF UNIV-CLG ALLIED HEALTH      ,PA,19107-0000,Private      ,85,386,471,314,1366,1680
01239301,THOMAS JEFFERSON UNIVERSITY - JEFFERSON ,PA,19107-5001,Private      ,118,663,781,431,2369,2800
01239303,THOMAS JEFFERSON UNIVERSITY - COLLEGE OF,PA,19107-6731,Private      ,62,281,343,203,735,938
01246104,LINCOLN TECHNICAL INSTITUTE             ,PA,19104-0202,Proprietary  ,127,318,445,228,523,751
01246105,LINCOLN TECHNICAL INSTITUTE             ,PA,19116-4202,Proprietary  ,91,197,288,166,364,530
01252300,TALMUDICAL YESHIVA OF PHILA             ,PA,19131-1296,Private      ,11,0,11,12,0,12
01260600,EMPIRE BEAUTY SCHOOL                    ,PA,17901-3859,Proprietary  ,262,531,793,395,830,1225
01292900,SOUTH HILLS BEAUTY ACADEMY              ,PA,15216-2335,Proprietary  ,32,46,78,44,93,137
01313400,YESHIVATH BETH MOSHE                    ,PA,18505-2196,Private      ,0,1,1,1,3,4
01321400,ROXBOROUGH MEM HOSP SCH OF NURSING      ,PA,19128-0000,Proprietary  ,41,170,211,81,348,429
01326300,SOUTH HILLS SCHOOL OF BUSINESS & TECHNOL,PA,16801-4516,Proprietary  ,280,220,500,480,393,873
02061000,VENUS BEAUTY ACADEMY                    ,PA,19079-0000,Proprietary  ,17,25,42,30,38,68
02068300,DOUGLAS SCHOOL OF BUSINESS              ,PA,15062-0000,Proprietary  ,97,79,176,177,153,330
02090200,TRIANGLE TECH                           ,PA,16502-0000,Proprietary  ,27,27,54,62,61,123
02092500,LAUREL TECHNICAL INSTITUTE              ,PA,16146-0000,Proprietary  ,87,109,196,140,223,363
02092502,BUSINESS INSTITUTE OF PENNSYLVANIA      ,PA,16335-0000,Proprietary  ,2,9,11,10,20,30
02104003,HARRIS SCHOOL OF BUSINESS - UPPER DARBY ,PA,19082-2528,Proprietary  ,9,13,22,20,32,52
02107300,PENNSYLVANIA ACADEMY OF FINE ARTS       ,PA,19102-1424,Private      ,51,71,122,260,270,530
02112200,GREAT LAKES INSTITUTE OF TECHNOLOGY     ,PA,16509-0000,Proprietary  ,147,190,337,267,311,578
02114200,JOHNSON COLLEGE                         ,PA,18508-0000,Private      ,197,110,307,432,233,665
02116001,SANFORD-BROWN INSTITUTE - TREVOSE       ,PA,19053-4700,Proprietary  ,0,1,1,2,7,9
02118000,LEVITTOWN BEAUTY ACADEMY LLC            ,PA,19054-1713,Proprietary  ,12,12,24,15,17,32
02119300,PA ACAD OF COSMETOLOGY ARTS & SCI       ,PA,15904-0000,Proprietary  ,18,24,42,36,34,70
02120800,"YORKTOWNE BUSINESS INSTITUTE, INC.      ",PA,17404-0000,Proprietary  ,39,82,121,76,163,239
02127400,YORK TECHNICAL INSTITUTE                ,PA,17402-0000,Proprietary  ,455,434,889,925,1107,2032
02129000,TRIANGLE TECH                           ,PA,15601-0000,Proprietary  ,97,110,207,171,197,368
02129001,TRIANGLE TECH - BUSINESS CAREERS INSTITU,PA,15601-3304,Proprietary  ,3,3,6,9,5,14
02144000,"VISION ACADEMY, THE                     ",PA,18103-0000,Proprietary  ,16,43,59,19,53,72
02151500,CENTRAL SUSQUEHANNA LPN CENTER          ,PA,17837-8818,Public       ,25,59,84,52,133,185
02158300,JUNIATA-MIFFLIN CO AREA VOC TECH        ,PA,17044-0000,Public       ,4,23,27,11,41,52
02161400,NORTHEASTERN HOSP SCH OF NRSG           ,PA,19134-0000,Private      ,28,120,148,63,265,328
02169600,CLEARFIELD CTY CAREER AND TECH CNTR     ,PA,16830-0000,Public       ,14,34,48,33,67,100
02174400,TRIANGLE TECH                           ,PA,15801-0000,Proprietary  ,122,69,191,223,145,368
02178900,ACADEMY OF HAIR DESIGN                  ,PA,18202-1465,Proprietary  ,43,114,157,51,160,211
02183000,ORLEANS TECHNICAL INSTITUTE             ,PA,19111-0000,Private      ,60,142,202,117,264,381
02192800,WALNUT HILL COLLEGE                     ,PA,19104-0000,Proprietary  ,156,152,308,388,304,692
02202300,SANFORD-BROWN INSTITUTE                 ,PA,15219-1907,Proprietary  ,33,63,96,57,144,201
02202301,SANFORD-BROWN INSTITUTE                 ,PA,15146-2141,Proprietary  ,7,13,20,10,21,31
02203900,ERIE INSTITUTE OF TECHNOLOGY            ,PA,16565-1002,Proprietary  ,70,90,160,144,181,325
02206200,"VISION ACADEMY, THE                     ",PA,19002-0000,Proprietary  ,50,59,109,56,78,134
02206300,STROUDSBURG SCHOOL OF COSMETOLOGY       ,PA,18360-0000,Proprietary  ,11,15,26,18,22,40
02212700,LANCASTER SCHOOL OF COSMETOLOGY         ,PA,17602-0000,Proprietary  ,31,55,86,50,76,126
02234200,ACADEMY OF MEDICAL ARTS & BUSINESS      ,PA,17112-0000,Proprietary  ,106,142,248,195,254,449
02240100,BARBER STYLING INSTITUTE                ,PA,17011-0000,Proprietary  ,0,1,1,0,1,1
02251200,SCHUYLKILL COUNTY AREA VOC TECH SCH     ,PA,17931-0000,Public       ,7,26,33,18,60,78
02251202,SCHUYLKILL COUNTY AREA VOC TECH SCH     ,PA,17931-0000,Public       ,4,8,12,8,20,28
02253900,BERKS TECHNICAL INSTITUTE               ,PA,19610-1168,Proprietary  ,379,855,1234,731,1338,2069
02255200,PENNSYLVANIA SCHOOL OF BUSINESS         ,PA,18101-1604,Proprietary  ,0,0,0,4,2,6
02269900,PENNSYLVANIA COLLEGE OF ART & DESIGN    ,PA,17603-3528,Private      ,121,40,161,407,79,486
02270500,BUCKS COUNTY SCHOOL OF BEAUTY CULT      ,PA,19053-0000,Proprietary  ,12,21,33,21,31,52
02273400,RECONSTRUCTIONIST RABBINICAL COLLEG     ,PA,19095-0000,Private      ,0,23,23,0,32,32
02276600,HANOVER PUBLIC SCH DIST PRAC NURSG      ,PA,17331-0000,Public       ,1,11,12,3,34,37
02282500,LENAPE SCHOOL OF PRACTICAL NURSING      ,PA,16226-0000,Public       ,23,58,81,42,103,145
02289500,PACE INSTITUTE                          ,PA,19601-0000,Proprietary  ,8,28,36,21,46,67
02289600,CONSOLIDATED SCHOOL OF BUSINESS         ,PA,17404-0000,Proprietary  ,46,77,123,57,121,178
02289700,ACADEMY OF CREATIVE HAIR DESIGN         ,PA,18702-0000,Proprietary  ,53,112,165,72,146,218
02289800,CHI INSTITUTE - FRANKLIN MILLS          ,PA,19154-0000,Proprietary  ,106,256,362,177,452,629
02290400,"ALTOONA BEAUTY SCHOOL, INC              ",PA,16602-0000,Proprietary  ,18,33,51,35,51,86
02292700,LANSDALE SCHOOL OF COSMETOLOGY          ,PA,19446-0000,Proprietary  ,5,7,12,5,19,24
02299300,TRINITY EPISCOPAL SCHOOL MINISTRY       ,PA,15003-0000,Private      ,0,44,44,2,68,70
02301300,PRISM CAREER INSTITUTE                  ,PA,19082-2448,Proprietary  ,22,102,124,65,225,290
02304400,YTI CAREER INSTITUTE - MECHANICSBURG    ,PA,17055-0000,Proprietary  ,11,12,23,37,35,72
02306200,VENANGO COUNTY AREA VOC TECH SCHOOL     ,PA,16301-0000,Public       ,14,28,42,24,47,71
02310800,LANCASTER COUNTY CAREER & TECH CTR      ,PA,17584-0000,Public       ,59,169,228,128,315,443
02323000,BIBLICAL THEOLOGICAL SEMINARY           ,PA,19440-2421,Private      ,1,30,31,1,53,54
02330300,LEBANON CO CAREER & TECHNOLOGY CTR      ,PA,17042-0000,Public       ,30,101,131,44,162,206
02330600,PENNSYLVANIA GUNSMITH SCHOOL            ,PA,15202-0000,Proprietary  ,20,24,44,57,69,126
02350100,WESTERN AREA CAREER & TECHNOLOGY CT     ,PA,15317-0000,Public       ,11,42,53,23,67,90
02350200,INDIANA COUNTY TECH CTR SCH PR NSG      ,PA,15701-1465,Public       ,22,54,76,33,88,121
02353100,NORTHERN TIER CAREER CENTER             ,PA,18848-0000,Public       ,17,22,39,28,55,83
02362300,MERCER COUNTY AREA VOC TECH SCHOOL      ,PA,16137-0000,Public       ,5,15,20,12,33,45
02492600,EASTERN CTR ARTS AND TECH PR NSG        ,PA,19090-0000,Public       ,15,57,72,20,103,123
02495500,ALL-STATE CAREER SCHOOL                 ,PA,19029-0000,Proprietary  ,64,308,372,114,494,608
02529800,WILKES BARRE AREA CAREER AND TECHNICAL C,PA,18705-0000,Public       ,30,62,92,65,133,198
02536600,COMMONWEALTH TECH INSTIT @ HIRAM G      ,PA,15905-0000,Public       ,71,31,102,143,56,199
02544300,BUTLER BEAUTY SCHOOL                    ,PA,16001-0000,Proprietary  ,11,34,45,22,49,71
02545000,LAWRENCE COUNTY CAREER AND TECHNICAL CEN,PA,16101-0000,Public       ,6,7,13,13,28,41
02546200,LAUREL BUSINESS INSTITUTE               ,PA,15401-0877,Proprietary  ,88,83,171,139,148,287
02550000,CLARION CO AREA VOC-TECH PRAC NRSG      ,PA,16254-4637,Public       ,7,27,34,14,40,54
02554500,HAZLETON AREA CAREER CENTER PRACTICAL NU,PA,18201-0000,Public       ,11,19,30,29,35,64
02557800,ART INSTITUTE OF YORK (THE) - PENNSYLVAN,PA,17402-9012,Proprietary  ,197,90,287,446,187,633
02566400,ALBERT EINSTEIN MED CTR DEPT DNTL       ,PA,19141-3098,Private      ,9,47,56,24,92,116
02574800,PENNSYLVANIA INSTITUTE OF TAXIDERMY     ,PA,15931-0000,Proprietary  ,6,4,10,12,8,20
02609500,CAREER TRAINING ACADEMY                 ,PA,15068-6308,Proprietary  ,56,156,212,70,214,284
02609501,CAREER TRAINING ACADEMY                 ,PA,15146-0000,Proprietary  ,2,13,15,7,27,34
02616100,JEAN MADELINE ED CTR FOR COSM           ,PA,19147-1542,Proprietary  ,102,92,194,204,193,397
02617507,EVEREST COLLEGE - EVEREST INSTITUTE - BE,PA,19020-2062,Proprietary  ,69,185,254,117,294,411
03010800,FORTIS INSTITUTE                        ,PA,16506-1013,Proprietary  ,255,683,938,471,1253,1724
03011500,FORTIS INSTITUTE                        ,PA,18702-0000,Proprietary  ,17,74,91,35,110,145
03011600,FORTIS INSTITUTE                        ,PA,18509-2903,Proprietary  ,76,151,227,134,298,432
03029900,CONSOLIDATED SCHOOL OF BUSINESS         ,PA,17603-2389,Proprietary  ,44,71,115,66,109,175
03067000,ANTONELLI MEDICAL & PROF INST           ,PA,19464-9244,Proprietary  ,12,79,91,19,92,111
03072600,DCI CAREER INSTITUTE                    ,PA,15061-2307,Proprietary  ,13,25,38,27,56,83
03081900,YTI CAREER INSTITUTE - ALTOONA          ,PA,16602-4457,Proprietary  ,101,118,219,181,263,444
03090800,LAKE ERIE COLL OF OSTEOPATHIC MED       ,PA,16509-0000,Private      ,21,1636,1657,97,3976,4073
03098600,CAREER TECH CTR OF LACKAWANNA CNTY      ,PA,18508-0000,Public       ,32,76,108,61,143,204
03101400,FORBES ROAD CAREER & TECHNOLOGY CTR     ,PA,15146-1550,Public       ,9,10,19,15,19,34
03101500,BIDWELL TRAINING CENTER                 ,PA,15233-2233,Private      ,22,27,49,27,56,83
03103300,JNA INSTITUTE OF CULINARY ARTS          ,PA,19146-3119,Proprietary  ,41,86,127,95,154,249
03109100,METROPOLITAN CAREER CENTER              ,PA,19144-0000,Private      ,13,40,53,28,90,118
03110700,AVIATION INSTITUTE OF MAINTENANCE       ,PA,19114-1017,Proprietary  ,64,141,205,103,243,346
03120400,REGIONAL CAREER & TECHNICAL CENTER      ,PA,16509-4699,Public       ,3,10,13,7,23,30
03128400,DELAWARE COUNTY TECHNICAL SCHOOL        ,PA,19008-1928,Public       ,20,52,72,41,115,156
03180400,PENNSYLVANIA HIGHLANDS COMMUNITY COLLEGE,PA,15904-2927,Public       ,324,268,592,790,624,1414
03236400,LT INTERNATIONAL BEAUTY SCHOOL          ,PA,19130-2235,Proprietary  ,7,23,30,18,56,74
03353300,ACADEMY OF VOCAL ARTS                   ,PA,19103-6685,Private      ,10,25,35,26,70,96
03380301,STAR CAREER ACADEMY - STAR PHILADELPHIA ,PA,19114-2204,Proprietary  ,129,426,555,218,683,901
03380304,STAR CAREER ACADEMY - STAR NORRISTOWN   ,PA,19403-2422,Proprietary  ,10,50,60,18,63,81
03493302,ALL-STATE CAREER - WEST MIFFLIN CAMPUS  ,PA,15122-0000,Proprietary  ,7,13,20,23,32,55
03535300,HUNTINGDON COUNTY CAREER AND TECHNO     ,PA,17060-0905,Public       ,7,19,26,10,25,35
03561400,SUSQUEHANNA COUNTY CAREER & TECHNOL     ,PA,18816-0100,Public       ,13,28,41,20,45,65
03766300,PENNSYLVANIA SCHOOL OF MUSCLE THERAPY   ,PA,19406-3101,Proprietary  ,21,61,82,30,76,106
03781300,PRINCETON INFORMATION TECHNOLOGY CENTER ,PA,19038-4535,Proprietary  ,8,121,129,13,172,185
03899300,CALVARY BAPTIST THEOLOGICAL SEMINARY    ,PA,19446-4718,Private      ,0,0,0,0,4,4
03923300,PRECISION MANUFACTURING INSTITUTE       ,PA,16335-8380,Private      ,12,24,36,16,47,63
03948300,HARRISBURG UNIVERSITY OF SCIENCE AND TEC,PA,17101-2116,Private      ,155,103,258,511,214,725
03949300,WON INSTITUTE OF GRADUATE STUDIES       ,PA,19038-4535,Private      ,0,20,20,2,35,37
03950500,NORTHWEST REGIONAL TECHNOLOGY INSTITUTE ,PA,16508-2820,Proprietary  ,2,17,19,6,27,33
03952300,NATIONAL MASSAGE THERAPY INSTITUTE      ,PA,19116-3965,Proprietary  ,12,59,71,24,103,127
04024300,EDUCATION AND TECHNOLOGY INSTITUTE      ,PA,15601-9214,Private      ,2,2,4,10,8,18
04041300,BERKS CAREER & TECHNOLOGY CENTER        ,PA,19533-9112,Public       ,10,18,28,24,31,55
04118000,BYZANTINE CATHOLIC SEMINARY OF SAINTS CY,PA,15214-2229,Private      ,0,3,3,0,9,9
04127500,CDE CAREER INSTITUTE                    ,PA,18372-9034,Proprietary  ,6,17,23,8,25,33
04145800,PULSE BEAUTY ACADEMY A PAUL MITCHELL PAR,PA,19335-0000,Proprietary  ,25,26,51,50,40,90
04149800,SOMERSET COUNTY TECHNOLOGY CENTER       ,PA,15501-1444,Public       ,12,31,43,28,71,99
04151700,BELLA CAPELLI ACADEMY                   ,PA,15146-2388,Proprietary  ,28,35,63,46,50,96
04151701,BELLA CAPELLI ACADEMY -                 ,PA,15205-2388,Proprietary  ,28,21,49,48,47,95
04155100,INSTITUTE OF MEDICAL CAREERS            ,PA,15235-3718,Proprietary  ,14,83,97,24,119,143
04158000,METRO BEAUTY ACADEMY                    ,PA,18106-9693,Proprietary  ,65,87,152,90,128,218
04164900,BARONE BEAUTY ACADEMY                   ,PA,17701-5316,Proprietary  ,12,13,25,20,39,59
04167200,COMMONWEALTH MEDICAL COLLEGE (THE)      ,PA,18503-3251,Private      ,10,211,221,19,618,637
04167500,WORLD A CUTS BARBER INSTITUTE           ,PA,17401-1105,Proprietary  ,1,17,18,2,28,30
04215500,CHAMP'S BARBER SCHOOL                   ,PA,17603-3809,Proprietary  ,10,35,45,18,54,72
04221300,PHILADELPHIA TECHNICIAN TRAINING        ,PA,19138-1324,Private      ,23,109,132,37,171,208
04224600,BARBER SCHOOL OF PITTSBURGH             ,PA,15220-5537,Proprietary  ,14,53,67,24,92,116
04226300,DIVINE CROWN ACADEMY OF COSMETOLOGY     ,PA,17104-2103,Proprietary  ,7,29,36,18,45,63
00267813,BRYANT & STRATTON COLLEGE - MIL DOWNTOWN,WI,53203-2608,Proprietary  ,281,902,1183,593,1973,2566
00383200,ALVERNO COLLEGE                         ,WI,53234-3922,Private      ,289,703,992,1326,1933,3259
00383500,BELOIT COLLEGE                          ,WI,53511-5595,Private      ,183,35,218,1980,129,2109
00383700,CARDINAL STRITCH UNIVERSITY             ,WI,53217-9884,Private      ,229,1302,1531,1195,2752,3947
00383800,CARROLL UNIVERSITY                      ,WI,53186-5593,Private      ,577,261,838,3855,705,4560
00383900,CARTHAGE COLLEGE                        ,WI,53141-0000,Private      ,589,235,824,4744,665,5409
00384000,WESTERN TECHNICAL COLLEGE               ,WI,54601-0908,Public       ,677,762,1439,1538,1377,2915
00384200,CONCORDIA UNIVERSITY WISCONSIN          ,WI,53097-2402,Private      ,512,1632,2144,3487,3343,6830
00384800,EDGEWOOD COLLEGE                        ,WI,53711-1958,Private      ,269,457,726,1773,1069,2842
00385000,SILVER LAKE COLLEGE                     ,WI,54220-9319,Private      ,57,127,184,182,231,413
00385400,LAKELAND COLLEGE                        ,WI,53082-0000,Private      ,174,658,832,1193,1403,2596
00385600,LAWRENCE UNIVERSITY                     ,WI,54912-0599,Private      ,253,38,291,2215,119,2334
00386100,MARIAN UNIVERSITY                       ,WI,54935-4699,Private      ,273,239,512,1339,697,2036
00386300,MARQUETTE UNIVERSITY                    ,WI,53201-1881,Private      ,464,717,1181,16369,3639,20008
00386600,MILWAUKEE AREA TECH COLLEGE             ,WI,53233-1443,Public       ,2249,5394,7643,5057,11050,16107
00386800,MILWAUKEE SCHOOL OF ENGINEERING         ,WI,53202-3109,Private      ,253,192,445,3008,697,3705
00386900,MOUNT MARY UNIVERSITY                   ,WI,53222-4597,Private      ,123,360,483,842,1122,1964
00387400,NASHOTAH HOUSE                          ,WI,53058-0000,Private      ,0,22,22,1,39,40
00387500,NORTHLAND COLLEGE                       ,WI,54806-3999,Private      ,180,31,211,856,84,940
00388400,RIPON COLLEGE                           ,WI,54971-0248,Private      ,125,20,145,1351,77,1428
00389200,ST. NORBERT COLLEGE                     ,WI,54115-2099,Private      ,261,30,291,2488,105,2593
00389500,UNIVERSITY OF WISCONSIN-MADISON         ,WI,53715-1382,Public       ,4558,2683,7241,25062,8310,33372
00389600,UNIVERSITY OF WISCONSIN-MILWAUKEE       ,WI,53201-3165,Public       ,4068,3802,7870,16131,10188,26319
00389700,UNIVERSITY OF WISCONSIN COLLEGES        ,WI,53708-8680,Public       ,452,536,988,2508,1437,3945
00389701,UNIVERSITY OF WISCONSIN-BARABOO         ,WI,53913-1098,Public       ,122,62,184,353,139,492
00389702,UNIVERSITY OF WISCONSIN-BARRON          ,WI,54868-2497,Public       ,116,81,197,323,157,480
00389703,UNIVERSITY OF WISCONSIN-FOND DU LAC     ,WI,54935-2998,Public       ,157,96,253,407,204,611
00389704,UNIVERSITY OF WISCONSIN-FOX VALLEY      ,WI,54952-1297,Public       ,351,170,521,999,350,1349
00389705,UNIVERSITY OF WISCONSIN-MANITOWOC       ,WI,54220-6699,Public       ,104,53,157,260,107,367
00389706,UNIVERSITY OF WISCONSIN-MARATHON        ,WI,54401-5396,Public       ,258,101,359,723,227,950
00389707,UNIVERSITY OF WISCONSIN-MARINETTE       ,WI,54143-4299,Public       ,67,42,109,259,87,346
00389708,UNIVERSITY OF WISCONSIN-MARSHFIELD      ,WI,54449-3310,Public       ,101,63,164,288,128,416
00389709,UNIVERSITY OF WISCONSIN-RICHLAND        ,WI,53581-1399,Public       ,89,43,132,240,83,323
00389710,UNIVERSITY OF WISCONSIN COLLEGES - ROCK ,WI,53546-5699,Public       ,261,208,469,636,435,1071
00389711,UNIVERSITY OF WISCONSIN-SHEBOYGAN       ,WI,53081-4789,Public       ,137,108,245,444,224,668
00389712,UNIVERSITY OF WISCONSIN-WASHINGTON      ,WI,53095-3699,Public       ,148,83,231,484,173,657
00389713,UNIVERSITY OF WISCONSIN-WAUKESHA        ,WI,53188-2799,Public       ,461,192,653,1339,474,1813
00389900,UNIVERSITY OF WISCONSIN-GREEN BAY       ,WI,54311-7001,Public       ,1021,904,1925,4084,2069,6153
00391100,VITERBO UNIVERSITY                      ,WI,54601-4777,Private      ,177,329,506,1790,951,2741
00391500,UNIVERSITY OF WISCONSIN-STOUT           ,WI,54751-0790,Public       ,1775,796,2571,5656,1619,7275
00391700,UNIVERSITY OF WISCONSIN-EAU CLAIRE      ,WI,54702-4004,Public       ,2459,692,3151,8499,1458,9957
00391900,UNIVERSITY OF WISCONSIN-LA CROSSE       ,WI,54601-3742,Public       ,1641,496,2137,8672,1399,10071
00392000,UNIVERSITY OF WISCONSIN-OSHKOSH         ,WI,54901-8604,Public       ,1925,1065,2990,8309,2662,10971
00392100,UNIVERSITY OF WISCONSIN-PLATTEVILLE     ,WI,53818-3099,Public       ,1307,518,1825,6926,1355,8281
00392300,UNIVERSITY OF WISCONSIN-RIVER FALLS     ,WI,54022-5013,Public       ,1461,532,1993,4099,977,5076
00392400,UNIVERSITY OF WISCONSIN-STEVENS POINT   ,WI,54481-3871,Public       ,2137,716,2853,7569,1639,9208
00392500,UNIVERSITY OF WISCONSIN-SUPERIOR        ,WI,54880-2898,Public       ,507,436,943,1408,953,2361
00392600,UNIVERSITY OF WISCONSIN-WHITEWATER      ,WI,53190-1792,Public       ,2046,828,2874,9431,2164,11595
00400700,MADISON AREA TECHNICAL COLLEGE          ,WI,53704-2599,Public       ,1781,2784,4565,3839,5458,9297
00501500,UNIVERSITY OF WISCONSIN-PARKSIDE        ,WI,53141-2000,Public       ,1073,805,1878,3273,1792,5065
00529400,WAUKESHA COUNTY TECHNICAL COLLEGE       ,WI,53072-4696,Public       ,578,1158,1736,1215,2214,3429
00530100,NORTHEAST WISCONSIN TECHNICAL COLLEGE   ,WI,54307-9042,Public       ,994,1753,2747,2267,3396,5663
00530400,CHIPPEWA VALLEY TECHNICAL COLLEGE       ,WI,54701-6162,Public       ,982,1356,2338,1931,2439,4370
00538000,MID-STATE TECHNICAL COLLEGE             ,WI,54494-5512,Public       ,340,641,981,662,1209,1871
00538400,NICOLET AREA TECHNICAL COLLEGE          ,WI,54501-0000,Public       ,178,250,428,409,516,925
00538700,NORTHCENTRAL TECHNICAL COLLEGE          ,WI,54401-1899,Public       ,511,1100,1611,1020,1870,2890
00538900,GATEWAY TECHNICAL COLLEGE               ,WI,53144-1690,Public       ,819,2068,2887,1798,5166,6964
00539000,BLACKHAWK TECHNICAL COLLEGE             ,WI,53547-5009,Public       ,376,1033,1409,762,1818,2580
00663900,BELLIN COLLEGE                          ,WI,54305-0000,Private      ,68,74,142,304,166,470
00732934,ITT TECHNICAL INSTITUTE                 ,WI,53220-4612,Proprietary  ,140,709,849,204,1003,1207
00766900,SOUTHWEST WISCONSIN TECH COLLEGE        ,WI,53809-0000,Public       ,247,284,531,682,589,1271
00821700,PAUL MITCHELL THE SCHOOL GREEN BAY      ,WI,54324-0257,Proprietary  ,40,36,76,62,70,132
00869405,RASMUSSEN COLLEGE - WAUSAU              ,WI,54401-7804,Proprietary  ,56,287,343,84,550,634
00869414,RASMUSSEN COLLEGE - GREEN BAY           ,WI,54303-2349,Proprietary  ,72,344,416,125,593,718
00869419,RASMUSSEN COLLEGE - APPLETON            ,WI,54915-7305,Proprietary  ,24,256,280,48,453,501
00919400,LAKESHORE TECHNICAL COLLEGE             ,WI,53015-1412,Public       ,272,587,859,572,1121,1693
00925600,MORAINE PARK TECHNICAL COLLEGE          ,WI,54936-0000,Public       ,416,980,1396,861,1946,2807
00941900,STATE CLG OF BEAUTY CULT-WAUSAU         ,WI,54403-4667,Proprietary  ,16,25,41,29,47,76
00962100,HERZING UNIVERSITY                      ,WI,53718-4236,Proprietary  ,428,3402,3830,817,7292,8109
00974400,FOX VALLEY TECHNICAL COLLEGE            ,WI,54913-0000,Public       ,1041,1709,2750,2382,3618,6000
01091300,MADISON MEDIA INSTITUTE                 ,WI,53718-6787,Proprietary  ,221,175,396,449,349,798
01148400,ADVANCED INSTITUTE OF HAIR DESIGN       ,WI,53225-0000,Proprietary  ,94,84,178,162,156,318
01182400,WISCONSIN INDIANHEAD TECH CLG WITC      ,WI,54871-9300,Public       ,420,839,1259,809,1497,2306
02077100,MILWAUKEE INST OF ART & DESIGN          ,WI,53202-0000,Private      ,250,105,355,880,272,1152
02078000,SACRED HEART SCHOOL OF THEOLOGY         ,WI,53130-0000,Private      ,0,1,1,0,2,2
02136600,WISCONSIN LUTHERAN COLLEGE              ,WI,53226-0000,Private      ,258,130,388,1239,269,1508
02239204,ANTHEM COLLEGE - BROOKFIELD             ,WI,53005-4207,Proprietary  ,26,133,159,32,170,202
02271300,WI SCH OF PROFESSIONAL PSYCHOLOGY       ,WI,53225-0000,Private      ,10,57,67,30,118,148
02317200,MARANATHA BAPTIST BIBLE COLLEGE         ,WI,53094-0000,Private      ,295,62,357,661,114,775
02453500,MEDICAL COLLEGE OF WISCONSIN            ,WI,53226-0000,Private      ,26,140,166,87,1171,1258
02494300,GILL-TECH ACADEMY OF HAIR DESIGN        ,WI,54911-0000,Proprietary  ,11,26,37,28,45,73
02532200,LAC COURTE OREILLES OJIBWA CMTY CLG     ,WI,54843-0000,Public       ,19,88,107,41,159,200
03061200,MIDWEST COLLEGE OF ORIENTAL MEDICINE    ,WI,53403-9747,Proprietary  ,12,67,79,26,138,164
03125100,COLLEGE OF MENOMINEE NATION             ,WI,54135-0000,Private      ,26,132,158,58,233,291
03125102,COLLEGE OF  THE MENOMINEE NATION - GREEN,WI,54304-4964,Private      ,16,68,84,32,154,186
03220300,"SALON PROFESSIONAL ACADEMY, THE         ",WI,54701-7633,Proprietary  ,17,32,49,31,58,89
03309300,MONTESSORI INSTITUTE OF MILWAUKEE       ,WI,53207-0000,Private      ,4,17,21,8,30,38
03808300,INSTITUTE OF BEAUTY AND WELLNESS (THE)  ,WI,53202-5715,Proprietary  ,51,86,137,116,161,277
03822300,PAUL MITCHELL THE SCHOOL - MONROE       ,WI,53566-0000,Proprietary  ,18,19,37,33,26,59
03872500,NORTHLAND INTERNATIONAL UNIVERSITY      ,WI,54119-9285,Private      ,50,15,65,153,29,182
03925300,BLUE SKY SCHOOL OF PROFESSIONAL MASSAGE ,WI,53024-9699,Private      ,4,5,9,9,12,21
03925301,BLUE SKY SCHOOL OF PROFESSIONAL MASSAGE ,WI,54115-7407,Private      ,5,13,18,7,23,30
03925303,BLUE SKY SCHOOL OF PROFESSIONAL MASSAGE ,WI,53713-2366,Private      ,7,17,24,11,37,48
04117400,MILWAUKEE CAREER COLLEGE                ,WI,53222-4305,Proprietary  ,80,180,260,165,367,532
04118600,ACADEMY OF COSMETOLOGY                  ,WI,53548-3307,Proprietary  ,15,43,58,32,80,112
04124800,VISIONS IN HAIR DESIGN INSTITUTE OF COSM,WI,53210-1120,Proprietary  ,8,17,25,23,43,66
04132600,WISCONSIN ACADEMY (THE)                 ,WI,54157-1726,Proprietary  ,9,14,23,15,29,44
04137900,BRENSTEN EDUCATION                      ,WI,53186-0000,Proprietary  ,14,224,238,24,336,360
04138200,SALON PROFESSIONAL ACADEMY (THE)        ,WI,54914-3921,Proprietary  ,24,25,49,40,50,90
04157700,SALON PROFESSIONAL ACADEMY (THE)        ,WI,54650-8699,Proprietary  ,22,37,59,36,53,89
04159400,COLUMBIA COLLEGE OF NURSING             ,WI,53211-2952,Private      ,52,95,147,181,234,415
04165300,ACADEMY WAUKESHA (THE)                  ,WI,53072-5524,Proprietary  ,47,47,94,72,81,153
04179200,ADVANCED COLLEGE OF COSMETOLOGY         ,WI,53963-0000,Proprietary  ,10,13,23,19,22,41
04182100,FIRST CLASS COSMETOLOGY SCHOOL          ,WI,52511-0000,Proprietary  ,12,21,33,25,50,75
04183600,SALON PROFESSIONAL ACADEMY OF KENOSHA (T,WI,53142-4950,Proprietary  ,35,65,100,57,110,167
04193800,SHEPHERDS COLLEGE                       ,WI,53182-1527,Private      ,43,5,48,55,11,66
04202800,PANACHE ACADEMY OF BEAUTY               ,WI,53913-2596,Proprietary  ,6,27,33,15,37,52
04219300,EAST-WEST HEALING ARTS INSTITUTE        ,WI,53719-1133,Proprietary  ,4,21,25,11,44,55
00290500,NORTH CAROLINA A&T STATE UNIV           ,NC,27411-0001,Public       ,3449,2253,5702,14820,5788,20608
00290600,APPALACHIAN STATE UNIVERSITY            ,NC,28608-2059,Public       ,2789,1335,4124,17085,4148,21233
00290700,UNIVERSITY OF NC AT ASHEVILLE           ,NC,28804-3299,Public       ,840,638,1478,4267,1662,5929
00290800,BARTON COLLEGE                          ,NC,27893-3104,Private      ,420,332,752,1513,677,2190
00291000,BELMONT ABBEY COLLEGE                   ,NC,28012-1802,Private      ,352,414,766,1320,869,2189
00291100,BENNETT COLLEGE                         ,NC,27401-3239,Private      ,250,135,385,1044,397,1441
00291200,BREVARD COLLEGE                         ,NC,28712-3306,Private      ,333,73,406,1251,181,1432
00291300,CAMPBELL UNIVERSITY                     ,NC,27506-0036,Private      ,1110,1487,2597,4830,3425,8255
00291400,CATAWBA COLLEGE                         ,NC,28144-2488,Private      ,468,231,699,1926,514,2440
00291500,CENTRAL PIEDMONT COMMUNITY COLLEGE      ,NC,28204-2297,Public       ,3973,7157,11130,8062,13019,21081
00291600,CHOWAN UNIVERSITY                       ,NC,27855-1850,Private      ,440,120,560,2280,391,2671
00291700,COLLEGE OF THE ALBEMARLE                ,NC,27909-2327,Public       ,342,582,924,765,1119,1884
00291800,DAVIDSON COLLEGE                        ,NC,28035-7157,Private      ,387,86,473,3637,206,3843
00291900,DAVIDSON COUNTY COMMUNITY COLLEGE       ,NC,27293-0000,Public       ,898,1772,2670,1670,3414,5084
00292000,DUKE UNIVERSITY                         ,NC,27708-0397,Private      ,1535,655,2190,18530,2440,20970
00292001,DUKE UNIV - SCHOOL OF MEDICINE          ,NC,27710-0000,Private      ,38,252,290,199,942,1141
00292002,DUKE UNIV - SCHOOL OF LAW               ,NC,27708-0000,Private      ,10,141,151,58,1912,1970
00292003,DUKE UNIV - GRAD SCH ARTS & SCIENCE     ,NC,27708-0000,Private      ,11,157,168,152,684,836
00292004,DUKE UNIV - FUQUA SCH OF BUSINESS       ,NC,27708-0000,Private      ,7,367,374,106,840,946
00292005,DUKE UNIV/NICHOLAS SCH OF ENVIRON.      ,NC,27708-0000,Private      ,7,60,67,28,339,367
00292006,DUKE UNIV - DIVINITY SCHOOL             ,NC,27708-0000,Private      ,30,284,314,322,728,1050
00292007,DUKE UNIV - SCHOOL OF NURSING           ,NC,27710-0000,Private      ,53,454,507,188,1236,1424
00292010,DUKE UNIVERSITY - SCHOOL OF PUBLIC POLIC,NC,27708-0239,Private      ,12,54,66,40,210,250
00292300,EAST CAROLINA UNIVERSITY                ,NC,27858-1818,Public       ,5106,4161,9267,22273,10287,32560
00292600,ELIZABETH CITY STATE UNIVERSITY         ,NC,27909-7806,Public       ,530,382,912,2458,1059,3517
00292700,ELON UNIVERSITY                         ,NC,27244-2010,Private      ,624,344,968,7335,1112,8447
00292800,FAYETTEVILLE STATE UNIVERSITY           ,NC,28301-4298,Public       ,1499,2768,4267,4787,5753,10540
00292900,GARDNER-WEBB UNIVERSITY                 ,NC,28017-0000,Private      ,624,1241,1865,2816,2531,5347
00293000,GREENSBORO COLLEGE                      ,NC,27401-1875,Private      ,406,363,769,1499,858,2357
00293100,GUILFORD COLLEGE                        ,NC,27410-4171,Private      ,555,832,1387,2708,1968,4676
00293300,HIGH POINT UNIVERSITY                   ,NC,27262-4221,Private      ,772,237,1009,5917,681,6598
00293400,ISOTHERMAL COMMUNITY COLLEGE            ,NC,28160-0804,Public       ,348,570,918,687,1001,1688
00293500,LAUREL UNIVERSITY                       ,NC,27265-3197,Private      ,55,115,170,75,235,310
00293600,JOHNSON C SMITH UNIVERSITY              ,NC,28216-5398,Private      ,591,599,1190,2326,1399,3725
00293700,KING'S COLLEGE-CHARLOTTE                ,NC,28204-2435,Proprietary  ,260,272,532,680,572,1252
00293900,LEES MCRAE COLLEGE                      ,NC,28604-0000,Private      ,261,163,424,1037,399,1436
00294000,LENOIR COMMUNITY COLLEGE                ,NC,28502-0188,Public       ,335,858,1193,785,1670,2455
00294100,LENOIR-RHYNE UNIVERSITY                 ,NC,28603-0000,Private      ,483,451,934,2506,1037,3543
00294200,LIVINGSTONE COLLEGE                     ,NC,28144-5298,Private      ,584,212,796,1549,508,2057
00294300,LOUISBURG COLLEGE                       ,NC,27549-2398,Private      ,403,85,488,1057,183,1240
00294400,MARS HILL COLLEGE                       ,NC,28754-0000,Private      ,454,135,589,2146,393,2539
00294500,MEREDITH COLLEGE                        ,NC,27607-5298,Private      ,494,349,843,2084,768,2852
00294600,METHODIST UNIVERSITY                    ,NC,28311-1420,Private      ,722,710,1432,2797,1564,4361
00294700,MITCHELL COMMUNITY COLLEGE              ,NC,28677-5264,Public       ,487,774,1261,929,1461,2390
00294800,MONTREAT COLLEGE                        ,NC,28757-1267,Private      ,160,244,404,505,506,1011
00294900,UNIVERSITY OF MOUNT OLIVE               ,NC,28365-1299,Private      ,450,1442,1892,1359,2985,4344
00295000,NORTH CAROLINA CENTRAL UNIVERSITY       ,NC,27707-3198,Public       ,1918,2138,4056,9510,6193,15703
00295100,NORTH CAROLINA WESLEYAN COLLEGE         ,NC,27804-8699,Private      ,416,764,1180,1343,1399,2742
00295300,PEACE COLLEGE                           ,NC,27604-1194,Private      ,367,292,659,1289,669,1958
00295400,UNIV OF NORTH CAROLINA AT PEMBROKE      ,NC,28372-1510,Public       ,1696,1528,3224,6229,3245,9474
00295500,PFEIFFER UNIVERSITY                     ,NC,28109-0000,Private      ,254,480,734,930,902,1832
00295600,PIEDMONT INTERNATIONAL UNIVERSITY       ,NC,27101-5025,Private      ,60,94,154,122,161,283
00295700,QUEENS UNIVERSITY OF CHARLOTTE          ,NC,28274-0001,Private      ,536,780,1316,2283,1662,3945
00295800,ROCKINGHAM COMMUNITY COLLEGE            ,NC,27375-0000,Public       ,263,430,693,718,963,1681
00296000,SALEM COLLEGE                           ,NC,27108-0000,Private      ,184,283,467,920,689,1609
00296100,SANDHILLS COMMUNITY COLLEGE             ,NC,28374-8283,Public       ,578,1100,1678,1293,2121,3414
00296200,SHAW UNIVERSITY                         ,NC,27601-2393,Private      ,894,747,1641,2768,1621,4389
00296300,SOUTHEASTERN BAPTIST THEOL SEMINARY     ,NC,27588-0000,Private      ,49,108,157,123,218,341
00296400,SOUTHEASTERN COMMUNITY COLLEGE          ,NC,28472-5422,Public       ,214,315,529,415,593,1008
00296800,ST AUGUSTINES COLLEGE                   ,NC,27610-2298,Private      ,517,276,793,1612,646,2258
00297000,SURRY COMMUNITY COLLEGE                 ,NC,27017-0304,Public       ,542,584,1126,1113,1168,2281
00297200,NORTH CAROLINA STATE UNIV-RALEIGH       ,NC,27695-7001,Public       ,3132,2948,6080,26486,9392,35878
00297300,GASTON COLLEGE                          ,NC,28034-1499,Public       ,753,1597,2350,1703,3089,4792
00297400,UNIVERSITY OF N C-CHAPEL HILL           ,NC,27514-0000,Public       ,1571,2687,4258,26416,11390,37806
00297500,UNIVERSITY OF NC AT CHARLOTTE           ,NC,28223-0001,Public       ,4637,4325,8962,24633,11299,35932
00297600,UNIVERSITY OF N C - GREENSBORO          ,NC,27412-0001,Public       ,3291,3223,6514,15979,9012,24991
00297800,WAKE FOREST UNIV - UNDERGRADUATE        ,NC,27109-7246,Private      ,344,142,486,7045,436,7481
00297801,WAKE FOREST UNIV - SCH OF MEDICINE      ,NC,27157-1090,Private      ,27,239,266,114,1147,1261
00297803,WAKE FOREST GRAD SCHOOLS OF BUSINESS    ,NC,27109-7659,Private      ,9,233,242,38,561,599
00297805,WAKE FOREST UNIV - SCH OF LAW           ,NC,27109-7206,Private      ,5,227,232,28,1025,1053
00297806,WAKE FOREST UNIV - GRAD A&S/DIVINITY    ,NC,27109-7246,Private      ,7,243,250,34,647,681
00297900,WARREN WILSON COLLEGE                   ,NC,28815-0000,Private      ,239,98,337,1225,368,1593
00298000,WAYNE COMMUNITY COLLEGE                 ,NC,27533-0000,Public       ,467,1035,1502,1035,2049,3084
00298100,WESTERN CAROLINA UNIVERSITY             ,NC,28723-9731,Public       ,1827,1288,3115,9848,3459,13307
00298200,WESTERN PIEDMONT COMMUNITY COLLEGE      ,NC,28655-4504,Public       ,367,572,939,755,1026,1781
00298300,WILKES COMMUNITY COLLEGE                ,NC,28697-2100,Public       ,397,609,1006,869,1065,1934
00298400,UNIVERSITY OF N C-WILMINGTON            ,NC,28403-3297,Public       ,2804,2054,4858,14611,5126,19737
00298500,WINGATE UNIVERSITY                      ,NC,28174-0159,Private      ,696,481,1177,4057,1211,5268
00298600,WINSTON-SALEM STATE UNIVERSITY          ,NC,27102-0000,Public       ,1439,1680,3119,6817,4395,11212
00398100,UNC SCHOOL OF THE ARTS                  ,NC,27127-2188,Public       ,223,109,332,1421,382,1803
00403300,ASHEVILLE BUNCOMBE TECH CMTY CLG        ,NC,28801-4897,Public       ,856,1861,2717,1858,3748,5606
00406200,PITT COMMUNITY COLLEGE                  ,NC,28590-0000,Public       ,1920,3307,5227,3723,5795,9518
00483500,CALDWELL COMMUNITY CLG & TECH INST      ,NC,28638-2626,Public       ,472,749,1221,1136,1620,2756
00483800,GUILFORD TECHNICAL COMMUNITY CLG        ,NC,27282-0309,Public       ,2069,3832,5901,5101,9367,14468
00484400,WAKE TECHNICAL COMMUNITY COLLEGE        ,NC,27603-5696,Public       ,3906,7024,10930,8045,13643,21688
00484500,WILSON COMMUNITY COLLEGE                ,NC,27893-3310,Public       ,256,737,993,484,1300,1784
00499201,MILLER-MOTTE TECHNICAL COLLEGE - MILLER-,NC,27511-9209,Proprietary  ,47,244,291,82,388,470
00499202,MILLER-MOTTE TECHNICAL COLLEGE - MILLER-,NC,27604-6072,Proprietary  ,147,581,728,261,1030,1291
00499203,MILLER-MOTTE TECHNICAL COLLEGE - FAYETTE,NC,28311-7651,Proprietary  ,155,817,972,259,1377,1636
00499205,MILLER-MOTTE TECHNICAL COLLEGE - MILLER-,NC,28540-5901,Proprietary  ,41,360,401,77,608,685
00531600,COASTAL CAROLINA COMMUNITY COLLEGE      ,NC,28546-6816,Public       ,514,1752,2266,1128,3213,4341
00531700,FORSYTH TECHNICAL COMMUNITY COLLEGE     ,NC,27103-5197,Public       ,1587,3160,4747,3308,6601,9909
00531800,CATAWBA VALLEY COMMUNITY COLLEGE        ,NC,28602-8302,Public       ,901,1228,2129,1976,2432,4408
00532000,CAPE FEAR COMMUNITY COLLEGE             ,NC,28401-3910,Public       ,1524,2375,3899,3206,4289,7495
00544700,RANDOLPH COMMUNITY COLLEGE              ,NC,27204-1009,Public       ,464,815,1279,996,1662,2658
00544800,DURHAM TECHNICAL CMNTY COLLEGE          ,NC,27703-5023,Public       ,714,2117,2831,1567,4252,5819
00544900,CENTRAL CAROLINA COMMUNITY COLLEGE      ,NC,27330-9000,Public       ,603,1491,2094,1276,2809,4085
00546300,ALAMANCE COMMUNITY COLLEGE              ,NC,27253-0000,Public       ,628,1284,1912,1395,2615,4010
00546400,RICHMOND COMMUNITY COLLEGE              ,NC,28345-4522,Public       ,291,724,1015,553,1260,1813
00575400,ROWAN-CABARRUS COMMUNITY COLLEGE        ,NC,28146-8357,Public       ,761,1827,2588,1503,3325,4828
00647700,CABARRUS COLLEGE OF HEALTH SCIENCES     ,NC,28025-0000,Private      ,105,263,368,318,619,937
00647800,MERCY HOSP SCH OF NURSING               ,NC,28207-0000,Public       ,54,273,327,152,608,760
00648300,WATTS SCHOOL OF NURSING                 ,NC,27704-0000,Private      ,32,135,167,88,313,401
00679900,CRAVEN COMMUNITY COLLEGE                ,NC,28562-0000,Public       ,327,1082,1409,694,2272,2966
00703100,PAMLICO COMMUNITY COLLEGE               ,NC,28529-0000,Public       ,26,118,144,46,202,248
00764000,FAYETTEVILLE TECHNICAL CMTY COLLEGE     ,NC,28303-0236,Public       ,1418,5141,6559,2742,9826,12568
00768700,JAMES SPRUNT COMMUNITY COLLEGE          ,NC,28349-0398,Public       ,149,431,580,277,790,1067
00781400,BROOKSTONE COLLEGE OF BUSINESS          ,NC,28262-1294,Proprietary  ,45,235,280,83,418,501
00781401,BROOKSTONE COLLEGE OF BUSINESS          ,NC,27409-0000,Proprietary  ,22,148,170,48,278,326
00789200,SAMPSON COMMUNITY COLLEGE               ,NC,28328-0000,Public       ,246,468,714,455,904,1359
00798500,SOUTH PIEDMONT COMMUNITY COLLEGE        ,NC,28135-9703,Public       ,314,656,970,639,1167,1806
00798600,HALIFAX COMMUNITY COLLEGE               ,NC,27890-0089,Public       ,151,375,526,362,684,1046
00798700,BLADEN COMMUNITY COLLEGE                ,NC,28332-0266,Public       ,184,491,675,329,856,1185
00798800,MARTIN COMMUNITY COLLEGE                ,NC,27892-8307,Public       ,101,247,348,224,465,689
00808100,CARTERET COMMUNITY COLLEGE              ,NC,28557-2989,Public       ,221,479,700,438,969,1407
00808200,CLEVELAND COMMUNITY COLLEGE             ,NC,28150-0000,Public       ,354,840,1194,700,1499,2199
00808300,HAYWOOD COMMUNITY COLLEGE               ,NC,28721-0000,Public       ,221,524,745,445,1038,1483
00808500,MCDOWELL TECHNICAL COMMUNITY CLG        ,NC,28752-8728,Public       ,119,268,387,227,491,718
00808700,MONTGOMERY COMMUNITY COLLEGE            ,NC,27371-0787,Public       ,117,244,361,238,487,725
00846600,SOUTHWESTERN COMMUNITY COLLEGE          ,NC,28779-8581,Public       ,352,667,1019,736,1217,1953
00855700,NASH COMMUNITY COLLEGE                  ,NC,27804-0488,Public       ,503,1172,1675,1001,2104,3105
00855800,BEAUFORT COUNTY COMMUNITY COLLEGE       ,NC,27889-7889,Public       ,267,755,1022,501,1304,1805
00861200,ROBESON COMMUNITY COLLEGE               ,NC,28359-2151,Public       ,396,1025,1421,719,1762,2481
00861300,ROANOKE-CHOWAN COMMUNITY COLLEGE        ,NC,27910-9522,Public       ,93,251,344,215,463,678
00885500,EDGECOMBE COMMUNITY COLLEGE             ,NC,27886-9399,Public       ,259,1119,1378,501,2027,2528
00933600,JOHNSTON COMMUNITY COLLEGE              ,NC,27577-0000,Public       ,689,1347,2036,1339,2495,3834
00943000,TRI-COUNTY COMMUNITY COLLEGE            ,NC,28906-7919,Public       ,114,245,359,240,445,685
00964600,PIEDMONT COMMUNITY COLLEGE              ,NC,27573-1197,Public       ,165,358,523,300,639,939
00968400,BLUE RIDGE COMMUNITY COLLEGE            ,NC,28731-9624,Public       ,208,455,663,480,991,1471
00974701,GORDON-CONWELL THEO SEM - CHARLOTTE     ,NC,28273-0000,Private      ,3,91,94,9,192,201
00990300,VANCE-GRANVILLE CMTY COLLEGE            ,NC,27536-0917,Public       ,375,979,1354,765,1765,2530
01019804,ECPI UNIVERSITY - GREENSBORO            ,NC,27409-9048,Proprietary  ,62,258,320,145,619,764
01019805,ECPI UNIVERSITY - CHARLOTTE             ,NC,28208-5886,Proprietary  ,89,600,689,216,1151,1367
01019810,ECPI UNIVERSITY - RALEIGH               ,NC,27613-7387,Proprietary  ,98,471,569,188,832,1020
01019812,ECPI UNIVERSITY - CONCORD               ,NC,28262-0000,Proprietary  ,41,189,230,81,364,445
01026400,SOUTH COLLEGE                           ,NC,28803-3152,Proprietary  ,48,248,296,105,440,545
01119400,STANLY COMMUNITY COLLEGE                ,NC,28001-7458,Public       ,310,746,1056,612,1402,2014
01119700,MAYLAND COMMUNITY COLLEGE               ,NC,28777-2777,Public       ,128,189,317,260,357,617
01179900,PAUL MITCHELL THE SCHOOL FAYETTEVILLE   ,NC,28303-5364,Proprietary  ,73,144,217,126,300,426
01192600,LEON'S BEAUTY SCHOOL                    ,NC,27403-2812,Proprietary  ,46,114,160,124,242,366
01303918,SOUTH UNIVERSITY - THE ART INSTITUTE OF ,NC,28217-4536,Proprietary  ,475,423,898,1143,929,2072
02056500,MITCHELL'S HAIR STYLING ACADEMY         ,NC,27893-0000,Proprietary  ,9,22,31,16,56,72
02056501,MITCHELL'S HAIR STYLING ACADEMY - MITCHE,NC,27606-3326,Proprietary  ,31,91,122,54,188,242
02158414,HARRISON COLLEGE - THE CHEF'S ACADEMY - ,NC,27560-0000,Proprietary  ,39,76,115,70,164,234
02170700,BRUNSWICK COMMUNITY COLLEGE             ,NC,28422-0000,Public       ,262,379,641,540,710,1250
02205000,COLLEGE OF WILMINGTON                   ,NC,28403-0000,Proprietary  ,62,172,234,150,326,476
02210400,FAYETTEVILLE BEAUTY COLLEGE             ,NC,28303-0000,Proprietary  ,38,150,188,71,274,345
02227800,MITCHELL'S HAIR STYLING ACADEMY         ,NC,27534-0000,Proprietary  ,5,22,27,12,46,58
02227900,MITCHELL'S HAIR STYLING ACADEMY         ,NC,27858-0000,Proprietary  ,5,19,24,17,42,59
02280900,MID-ATLANTIC CHRISTIAN UNIVERSITY       ,NC,27909-0000,Private      ,47,61,108,153,119,272
02326203,KAPLAN CAREER INSTITUTE - KAPLAN COLLEGE,NC,28212-6830,Proprietary  ,70,477,547,165,1028,1193
02558900,CHEVEUX SCHOOL OF HAIR DESIGN           ,NC,28540-0000,Proprietary  ,6,27,33,8,52,60
02560600,PINNACLE INSTITUTE OF COSMETOLOGY       ,NC,28115-8020,Proprietary  ,12,32,44,22,61,83
02614201,MILLER-MOTTE BUSINESS COLLEGE           ,NC,28403-0000,Proprietary  ,160,1461,1621,296,3063,3359
02614205,MILLER - MOTTE TECHNICAL COLLEGE - MILLE,NC,27834-5052,Proprietary  ,68,367,435,127,613,740
03009500,WINSTON-SALEM BARBER SCHOOL             ,NC,27107-0000,Proprietary  ,15,57,72,35,93,128
03064400,REGENCY BEAUTY INSTITUTE                ,NC,27127-0000,Proprietary  ,67,123,190,99,204,303
03089300,HERITAGE BIBLE COLLEGE                  ,NC,28335-0000,Private      ,12,34,46,20,59,79
03104200,CAROLINAS COLLEGE OF HEALTH SCIENCE     ,NC,28232-2861,Public       ,157,536,693,426,1095,1521
03109000,LIVING ARTS COLLEGE                     ,NC,27614-7076,Proprietary  ,174,271,445,347,498,845
03361300,MEDICAL ARTS MASSAGE SCHOOL             ,NC,27616-6453,Proprietary  ,38,164,202,57,268,325
03513400,APEX SCHOOL OF THEOLOGY                 ,NC,27703-8024,Private      ,11,389,400,16,644,660
03555300,SOUTHEASTERN INSTITUTE                  ,NC,28217-0000,Proprietary  ,38,214,252,74,417,491
03555400,SOUTHEASTERN SCHOOL OF NEUROMUSCULAR  MA,NC,29406-0000,Proprietary  ,8,42,50,10,55,65
03570300,CAROLINA CHRISTIAN COLLEGE              ,NC,27105-3241,Private      ,11,35,46,25,92,117
03663300,HOOD THEOLOGICAL SEMINARY               ,NC,28144-5768,Private      ,0,74,74,2,137,139
03748500,DURHAM BEAUTY ACADEMY                   ,NC,27707-3569,Proprietary  ,13,86,99,24,110,134
03777300,PAUL MITCHELL THE SCHOOL GASTONIA       ,NC,28054-0460,Proprietary  ,75,136,211,117,222,339
03827300,NEW LIFE THEOLOGICAL SEMINARY           ,NC,28205-1648,Private      ,5,86,91,11,168,179
04073300,JUNG TAO SCHOOL OF CLASSICAL CHINESE MED,NC,28679-9657,Private      ,1,35,36,2,55,57
04101300,CAROLINA SCHOOL OF BROADCASTING         ,NC,28214-8085,Proprietary  ,49,110,159,110,211,321
04115700,REGINA'S COLLEGE OF BEAUTY              ,NC,28110-2831,Proprietary  ,19,72,91,31,95,126
04120300,HEALTH AND STYLE INSTITUTE              ,NC,27265-3114,Proprietary  ,25,90,115,42,133,175
04129400,CENTER FOR MASSAGE & NATURAL HEALTH     ,NC,28787-8331,Proprietary  ,4,25,29,9,58,67
04140700,AVEDA INSTITUTE CHAPEL HILL             ,NC,27516-2559,Proprietary  ,60,89,149,107,154,261
04143500,CHARLOTTE SCHOOL OF LAW                 ,NC,28208-2816,Proprietary  ,17,624,641,56,1623,1679
04146400,DAOIST TRADITIONS COLLEGE OF CHINESE MED,NC,28801-1060,Proprietary  ,1,42,43,5,79,84
04149300,PARK WEST BARBER SCHOOL                 ,NC,27701-4022,Proprietary  ,60,299,359,103,518,621
04154200,CAROLINA COLLEGE OF BIBLICAL STUDIES    ,NC,29303-5157,Private      ,3,101,104,15,200,215
04172800,BODY THERAPY INSTITUTE                  ,NC,27344-6728,Proprietary  ,5,43,48,13,75,88
04173000,SHEPHERDS THEOLOGICAL SEMINARY          ,NC,27518-9316,Private      ,1,14,15,3,22,25
04173700,GRACE COLLEGE OF DIVINITY               ,NC,28314-2343,Private      ,13,62,75,18,106,124
04178100,CAROLINA COLLEGE OF HAIR DESIGN         ,NC,28802-1232,Proprietary  ,22,55,77,38,93,131
04204700,PAUL MITCHELL THE SCHOOL RALEIGH        ,NC,27612-7358,Proprietary  ,61,97,158,90,170,260
04206500,MYCOMPUTERCAREER.COM                    ,NC,27606-3365,Proprietary  ,13,135,148,25,229,254
04214600,GRACE COLLEGE OF BARBERING              ,NC,28513-7178,Private      ,6,29,35,10,35,45
04219100,ALEXANDER PAUL INSTITUTE OF HAIR DESIGN ,NC,27858-3344,Proprietary  ,16,23,39,25,41,66
04227600,SHERRILL'S UNIVERSITY OF BARBER & COSMET,NC,27610-2431,Proprietary  ,15,65,80,15,65,80
04228400,BEYOND MEASURE BARBERING INSTITUTE      ,NC,27302-2323,Proprietary  ,2,24,26,5,32,37
00298800,BISMARCK STATE COLLEGE                  ,ND,58501-1299,Public       ,784,518,1302,1495,932,2427
00298900,DICKINSON STATE UNIVERSITY              ,ND,58601-4896,Public       ,304,236,540,710,419,1129
00299000,JAMESTOWN COLLEGE                       ,ND,58405-3401,Private      ,222,88,310,799,166,965
00299100,LAKE REGION STATE COLLEGE               ,ND,58301-1598,Public       ,153,159,312,305,292,597
00299200,UNIVERSITY OF MARY                      ,ND,58504-9652,Private      ,493,449,942,1508,949,2457
00299300,MAYVILLE STATE UNIVERSITY               ,ND,58257-1299,Public       ,229,107,336,647,242,889
00299400,MINOT STATE UNIVERSITY                  ,ND,58707-0001,Public       ,546,475,1021,1336,987,2323
00299500,DAKOTA COLLEGE AT BOTTINEAU             ,ND,58318-1159,Public       ,182,93,275,345,205,550
00299600,NORTH DAKOTA STATE CLG OF SCIENCE       ,ND,58076-0002,Public       ,661,249,910,1349,465,1814
00299700,NORTH DAKOTA STATE UNIVERSITY           ,ND,58108-6050,Public       ,3378,1110,4488,8861,2331,11192
00300500,UNIVERSITY OF NORTH DAKOTA              ,ND,58202-8193,Public       ,2904,2100,5004,7412,4295,11707
00300700,WILLISTON STATE COLLEGE                 ,ND,58802-1326,Public       ,97,127,224,216,242,458
00300800,VALLEY CITY STATE UNIVERSITY            ,ND,58072-0000,Public       ,325,156,481,714,273,987
00775600,JOSEF'S SCHOOL OF HAIR DESIGN INC       ,ND,58102-4977,Proprietary  ,24,24,48,40,44,84
00869408,RASMUSSEN COLLEGE - FARGO               ,ND,58103-7196,Proprietary  ,76,307,383,114,480,594
00869415,RASMUSSEN COLLEGE - BISMARCK            ,ND,58503-0000,Proprietary  ,20,125,145,27,190,217
00935400,MEDCENTER ONE COLLEGE OF NURSING        ,ND,58501-4494,Private      ,32,30,62,87,60,147
01040600,JOSEF'S SCHOOL OF HAIR DESIGN           ,ND,58201-6394,Proprietary  ,25,32,57,41,58,99
01205900,TRINITY BIBLE COLLEGE                   ,ND,58436-7150,Private      ,90,43,133,182,68,250
01229500,JZ TREND ACADEMY PAUL MITCHELL PARTNER S,ND,58501-0000,Proprietary  ,19,16,35,36,27,63
02188200,SITTING BULL COLLEGE                    ,ND,58538-9701,Public       ,24,108,132,37,147,184
02236500,LITTLE HOOP COMMUNITY COLLEGE           ,ND,58335-0000,Public       ,11,36,47,21,72,93
02242900,UNITED TRIBES TECHNICAL COLLEGE         ,ND,58504-0000,Private      ,81,175,256,184,387,571
02298200,HEADQUARTERS ACADEMY OF HAIR DESIGN     ,ND,58701-0000,Proprietary  ,13,18,31,23,44,67
02301100,TURTLE MTN CMNTY COLG-FIN AID OFC       ,ND,58316-0000,Private      ,56,121,177,115,225,340
02553700,FORT BERTHOLD COMMUNITY COLLEGE         ,ND,58763-0000,Public       ,5,21,26,12,43,55
03087200,MOLER BARBER CLG OF HAIRSTYLING         ,ND,58103-0000,Proprietary  ,2,7,9,6,15,21
04031300,SALON PROFESSIONAL ACADEMY (THE)        ,ND,58103-3337,Proprietary  ,34,34,68,65,54,119
04139400,HAIR ACADEMY (THE)                      ,ND,58501-4929,Proprietary  ,18,23,41,29,33,62
04223500,LYNNES WELDING TRAINING                 ,ND,58102-4018,Proprietary  ,9,12,21,19,23,42
00301005,ANTIOCH UNIV/SEATTLE                    ,WA,98121-0000,Private      ,27,400,427,114,1066,1180
00376900,BELLEVUE COLLEGE                        ,WA,98007-6484,Public       ,1035,2052,3087,4894,6204,11098
00377000,BIG BEND COMMUNITY COLLEGE              ,WA,98837-3299,Public       ,206,425,631,1042,1293,2335
00377100,"CENTRAL WASHINGTON UNIV., FIN AID       ",WA,98926-7495,Public       ,1524,1230,2754,11836,5746,17582
00377200,CENTRALIA COLLEGE                       ,WA,98531-4099,Public       ,257,534,791,1241,1703,2944
00377300,CLARK COLLEGE                           ,WA,98663-3598,Public       ,1272,2654,3926,4642,7238,11880
00377400,COLUMBIA BASIN COLLEGE                  ,WA,99301-3379,Public       ,681,1167,1848,3165,3703,6868
00377500,EASTERN WASHINGTON UNIVERSITY           ,WA,99004-2447,Public       ,1084,1333,2417,12406,6913,19319
00377600,EVERETT COMMUNITY COLLEGE               ,WA,98201-1352,Public       ,823,1859,2682,3525,5711,9236
00377700,HERITAGE UNIVERSITY                     ,WA,98948-9562,Private      ,111,368,479,683,1320,2003
00377800,GONZAGA UNIVERSITY                      ,WA,99258-0083,Private      ,441,811,1252,8336,3030,11366
00377900,GRAYS HARBOR COLLEGE                    ,WA,98520-7599,Public       ,178,435,613,694,1293,1987
00378000,GREEN RIVER COMMUNITY COLLEGE           ,WA,98092-3622,Public       ,786,1566,2352,3075,4383,7458
00378100,HIGHLINE COMMUNITY COLLEGE              ,WA,98198-9800,Public       ,942,1815,2757,3333,4813,8146
00378200,LOWER COLUMBIA COLLEGE                  ,WA,98632-0310,Public       ,272,856,1128,1125,2461,3586
00378300,NORTHWEST UNIVERSITY                    ,WA,98083-0000,Private      ,225,353,578,1445,959,2404
00378400,OLYMPIC COLLEGE                         ,WA,98337-1600,Public       ,565,1535,2100,1985,4520,6505
00378500,PACIFIC LUTHERAN UNIVERSITY             ,WA,98447-0003,Private      ,493,566,1059,4747,2179,6926
00378600,PENINSULA COLLEGE                       ,WA,98362-6660,Public       ,186,578,764,584,1483,2067
00378700,SEATTLE CENTRAL COMMUNITY COLLEGE       ,WA,98122-2413,Public       ,796,2047,2843,3345,6026,9371
00378703,SEATTLE VOCATIONAL INSTITUTE            ,WA,98144-0000,Public       ,51,237,288,160,561,721
00378800,SEATTLE PACIFIC UNIVERSITY              ,WA,98119-1997,Private      ,956,899,1855,7446,2966,10412
00379000,SEATTLE UNIVERSITY                      ,WA,98122-1090,Private      ,787,1365,2152,9592,6249,15841
00379100,SHORELINE COMMUNITY COLLEGE             ,WA,98133-5696,Public       ,622,1343,1965,2542,4342,6884
00379200,SKAGIT VALLEY COLLEGE                   ,WA,98273-5899,Public       ,457,965,1422,1675,2767,4442
00379300,SPOKANE COMMUNITY COLLEGE               ,WA,99207-5399,Public       ,943,2526,3469,3989,7862,11851
00379400,ST MARTIN'S UNIVERSITY                  ,WA,98503-7500,Private      ,212,359,571,1448,1197,2645
00379600,TACOMA COMMUNITY COLLEGE                ,WA,98466-6100,Public       ,974,2734,3708,3946,8635,12581
00379700,UNIVERSITY OF PUGET SOUND               ,WA,98416-1039,Private      ,448,491,939,5461,1934,7395
00379800,UNIVERSITY OF WASHINGTON                ,WA,98195-1122,Public       ,2676,4894,7570,38415,27925,66340
00379900,WALLA WALLA UNIVERSITY                  ,WA,99324-1198,Private      ,415,183,598,1755,648,2403
00380000,WASHINGTON STATE UNIVERSITY             ,WA,99164-1035,Public       ,1737,2326,4063,28747,13120,41867
00380100,WENATCHEE VALLEY COLLEGE                ,WA,98801-1799,Public       ,339,615,954,1674,1912,3586
00380200,WESTERN WASHINGTON UNIVERSITY           ,WA,98225-5946,Public       ,1447,915,2362,17544,4831,22375
00380300,WHITMAN COLLEGE                         ,WA,99362-2067,Private      ,294,45,339,2902,164,3066
00380400,WHITWORTH UNIVERSITY                    ,WA,99251-0001,Private      ,488,407,895,4218,1336,5554
00380500,YAKIMA VALLEY COMMUNITY COLLEGE         ,WA,98907-2520,Public       ,521,1053,1574,2762,3896,6658
00499900,BELLINGHAM TECHNICAL COLLEGE            ,WA,98225-0000,Public       ,287,884,1171,1048,2232,3280
00500000,PIERCE COLLEGE                          ,WA,98498-1919,Public       ,897,2367,3264,3268,6646,9914
00500100,EDMONDS COMMUNITY COLLEGE               ,WA,98036-5999,Public       ,680,1453,2133,2518,4133,6651
00500600,WALLA WALLA COMMUNITY COLLEGE           ,WA,99362-9267,Public       ,286,599,885,1795,2095,3890
00530600,BATES TECHNICAL COLLEGE                 ,WA,98405-0000,Public       ,302,1243,1545,1008,3153,4161
00537200,SOUTH PUGET SOUND COMMUNITY COLLEGE     ,WA,98512-6292,Public       ,608,1398,2006,2094,4156,6250
00537300,LAKE WASHINGTON TECHNICAL COLLEGE       ,WA,98034-8505,Public       ,303,798,1101,851,2185,3036
00575200,CLOVER PARK TECHNICAL COLLEGE           ,WA,98499-0000,Public       ,424,1748,2172,1340,4678,6018
00815500,EVERGREEN STATE COLLEGE (THE)           ,WA,98505-0002,Public       ,441,820,1261,3433,3939,7372
00907901,EVEREST COLLEGE                         ,WA,98684-6950,Proprietary  ,50,245,295,158,519,677
00938700,PERRY TECHNICAL INSTITUTE               ,WA,98903-1239,Private      ,193,312,505,696,918,1614
00954400,SPOKANE FALLS COMMUNITY COLLEGE         ,WA,99224-5204,Public       ,995,1881,2876,4270,5827,10097
00970400,NORTH SEATTLE COMMUNITY COLLEGE         ,WA,98103-3599,Public       ,479,1513,1992,1964,4647,6611
00970600,SOUTH SEATTLE COMMUNITY COLLEGE         ,WA,98106-1499,Public       ,513,1487,2000,2323,4056,6379
00973900,GLEN DOW ACAD OF HAIR DESIGN            ,WA,99201-0209,Proprietary  ,32,83,115,122,194,316
01036400,WHATCOM COMMUNITY COLLEGE               ,WA,98226-8003,Public       ,429,734,1163,2084,2662,4746
01043400,RENTON TECHNICAL COLLEGE                ,WA,98056-0000,Public       ,365,1086,1451,1054,2656,3710
01148100,DIVERS INSTITUTE OF TECHNOLOGY          ,WA,98107-0000,Proprietary  ,57,187,244,126,409,535
01231500,CORNISH COLLEGE OF THE ARTS             ,WA,98121-4604,Private      ,158,125,283,1533,462,1995
01249600,TONI & GUY HAIRDRESSING ACADEMY         ,WA,98133-5615,Proprietary  ,5,12,17,19,24,43
01302200,CITY UNIVERSITY OF SEATTLE              ,WA,98005-0000,Private      ,67,710,777,285,1835,2120
02105300,EVERGREEN BEAUTY AND BARBER COLLEGE     ,WA,98007-3722,Proprietary  ,25,59,84,67,117,184
02106700,TRINITY LUTHERAN COLLEGE                ,WA,98201-3569,Private      ,46,43,89,268,132,400
02180000,NORTHWEST INDIAN COLLEGE                ,WA,98226-9278,Public       ,65,229,294,160,557,717
02184200,PAROBA COLLEGE OF COSMETOLOGY           ,WA,98208-0000,Proprietary  ,24,66,90,45,132,177
02202200,STYLEMASTERS COLLEGE OF HAIR DESIGN     ,WA,98632-0000,Proprietary  ,12,38,50,33,113,146
02203300,GENE JUAREZ BEAUTY SCHOOLS              ,WA,98043-5427,Proprietary  ,88,148,236,201,307,508
02222900,INTERNATIONAL AIR & HOSPITALITY ACADEMY ,WA,98661-4835,Proprietary  ,115,238,353,245,453,698
02236800,PROFESSIONAL BEAUTY SCHOOL              ,WA,98902-0000,Proprietary  ,15,30,45,62,113,175
02242500,BASTYR UNIVERSITY                       ,WA,98028-0000,Private      ,59,601,660,203,1618,1821
02291300,ART INSTITUTE OF SEATTLE                ,WA,98121-1622,Proprietary  ,394,544,938,1696,1566,3262
02300100,EVEREST COLLEGE                         ,WA,98367-1835,Proprietary  ,41,147,188,113,340,453
02300103,EVEREST COLLEGE - EVERETT               ,WA,98208-2610,Proprietary  ,65,255,320,208,572,780
02300104,EVEREST COLLEGE - TACOMA                ,WA,98402-3004,Proprietary  ,126,569,695,346,1199,1545
02326500,INTERFACE COLLEGE                       ,WA,99201-4326,Proprietary  ,11,76,87,34,191,225
02331400,NORTHWEST HAIR ACADEMY                  ,WA,98273-0000,Proprietary  ,18,50,68,40,99,139
02331402,NORTHWEST HAIR ACADEMY - EVERETT        ,WA,98204-0000,Proprietary  ,8,43,51,22,84,106
02331403,NORTHWEST HAIR ACADEMY - BELLINGHAM     ,WA,98226-5515,Proprietary  ,6,24,30,10,26,36
02331404,NORTHWEST HAIR ACADEMY - YAKIMA         ,WA,98901-2305,Proprietary  ,7,31,38,8,37,45
02504900,ACADEMY OF HAIR DESIGN (THE)            ,WA,98801-0000,Proprietary  ,12,38,50,39,89,128
02541900,BJ'S BEAUTY AND BARBER COLLEGE          ,WA,98409-0000,Proprietary  ,23,96,119,53,250,303
02602100,NORTHWEST COLLEGE OF ART                ,WA,98370-8625,Proprietary  ,27,24,51,159,70,229
02606200,EVEREST COLLEGE                         ,WA,98055-2990,Proprietary  ,67,255,322,206,528,734
02617500,EVEREST COLLEGE                         ,WA,98133-9018,Proprietary  ,59,172,231,259,464,723
03031406,INTERNATIONAL ACADEMY OF DESIGN & TECH  ,WA,98188-3319,Proprietary  ,110,197,307,265,449,714
03065000,LUCAS MARC ACADEMY                      ,WA,99352-9700,Proprietary  ,13,45,58,49,106,155
03071800,ITT TECHNICAL INSTITUTE                 ,WA,99216-1589,Proprietary  ,122,697,819,275,1163,1438
03071805,ITT TECHNICAL INSTITUTE - SEATTLE       ,WA,98168-3346,Proprietary  ,139,884,1023,405,1557,1962
03099000,CORTIVA INSTITUTE - SEATTLE             ,WA,98109-5474,Proprietary  ,49,144,193,84,268,352
03110800,BAKKE GRADUATE UNIVERSITY               ,WA,98104-1222,Private      ,7,21,28,11,51,62
03139500,MONTESSORI SCHOOLS OF WASHINGTON        ,WA,98203-6600,Private      ,1,13,14,8,32,40
03280300,SEATTLE INST OF ORIENTAL MEDICINE       ,WA,98115-0000,Proprietary  ,9,46,55,44,143,187
03283300,NORTHWEST HVAC/R ASSOCIATION & TRAINING ,WA,99202-0000,Private      ,10,32,42,27,99,126
03466400,SEATTLE SCHOOL OF THEOLOGY AND PSYCHOLOG,WA,98121-1177,Private      ,23,176,199,89,427,516
03483500,CASCADIA COMMUNITY COLLEGE              ,WA,98011-9510,Public       ,318,477,795,1297,1355,2652
03490400,EMIL FRIES PIANO HOSPITAL & TRAININ     ,WA,98661-4323,Private      ,4,8,12,7,24,31
03670301,TONI&GUY HAIRDRESSING ACADEMY -         ,WA,98225-4526,Proprietary  ,30,51,81,66,113,179
03689400,FAITH EVANGELICAL COLLEGE & SEMINARY    ,WA,98407-2607,Private      ,10,120,130,27,256,283
03724300,DIGIPEN INSTITUTE OF TECHNOLOGY         ,WA,98052-5170,Proprietary  ,252,132,384,1158,441,1599
03917300,EVERGREEN BEAUTY AND BARBER COLLEGE     ,WA,98208-3759,Proprietary  ,61,173,234,105,282,387
03932500,TOTAL COSMETOLOGY TRAINING CENTER       ,WA,99217-6231,Proprietary  ,17,87,104,56,180,236
04120000,SUNNYSIDE BEAUTY ACADEMY                ,WA,98944-8711,Proprietary  ,2,9,11,8,33,41
04127200,VICTORIA'S ACADEMY OF COSMETOLOGY       ,WA,99336-3826,Proprietary  ,23,64,87,61,152,213
04130500,PACIFIC NORTHWEST UNIV OF HEALTH SCIENCE,WA,98901-1471,Private      ,16,262,278,68,652,720
04130800,CASCADE BEAUTY COLLEGE                  ,WA,98002-5504,Proprietary  ,8,36,44,27,85,112
04132800,INLAND MASSAGE INSTITUTE                ,WA,99218-5016,Proprietary  ,10,44,54,39,129,168
04149400,GARY MANUEL AVEDA INSTITUTE             ,WA,98122-3807,Proprietary  ,69,151,220,170,324,494
04155000,NORTHWEST SCHOOL OF WOODEN BOAT BUILDING,WA,98339-8706,Private      ,1,41,42,7,84,91
04161200,BAINBRIDGE GRADUATE INSTITUTE           ,WA,98110-2870,Private      ,0,33,33,2,88,90
04170100,SALON PROFESSIONAL ACADEMY (THE)        ,WA,98409-7360,Proprietary  ,43,137,180,109,268,377
04172900,ACADEMY OF COSMETOLOGY                  ,WA,99354-2651,Proprietary  ,13,27,40,47,89,136
04188900,NORTHWEST INSTITUTE OF LITERARY ARTS    ,WA,98249-0000,Private      ,1,12,13,8,41,49
04191900,PAUL MITCHELL THE SCHOOL SPOKANE        ,WA,99037-5041,Proprietary  ,37,111,148,137,223,360
04223600,ACADEMY OF INTERACTIVE ENTERTAINMENT    ,WA,98109-4623,Private      ,51,55,106,160,148,308
04231000,STUDIO BEAUTY SCHOOL                    ,WA,99205-3357,Proprietary  ,1,1,2,1,1,2
00340100,BROWN UNIVERSITY                        ,RI,02912-9127,Private      ,1097,139,1236,18342,828,19170
00340101,BROWN UNIVERSITY - GRADUATE SCHOOL      ,RI,02912-1827,Private      ,4,135,139,70,1314,1384
00340102,BROWN MEDICAL SCHOOL                    ,RI,02912-0000,Private      ,5,71,76,48,539,587
00340200,BRYANT UNIVERSITY                       ,RI,02917-1284,Private      ,391,109,500,5379,452,5831
00340400,JOHNSON & WALES UNIVERSITY              ,RI,02903-3703,Private      ,2865,1071,3936,18687,3939,22626
00340600,PROVIDENCE COLLEGE                      ,RI,02918-0001,Private      ,771,237,1008,7652,826,8478
00340700,RHODE ISLAND COLLEGE                    ,RI,02908-1991,Public       ,588,922,1510,8058,4394,12452
00340800,COMMUNITY COLLEGE OF RI - WARWICK       ,RI,02906-0000,Public       ,1634,2774,4408,8016,9189,17205
00340900,RHODE ISLAND SCHOOL OF DESIGN           ,RI,02903-2784,Private      ,304,153,457,2749,901,3650
00341000,ROGER WILLIAMS UNIVERSITY               ,RI,02809-2921,Private      ,269,347,616,8874,1453,10327
00341100,SALVE REGINA UNIVERSITY                 ,RI,02840-4192,Private      ,208,140,348,4386,539,4925
00341400,UNIVERSITY OF RHODE ISLAND              ,RI,02881-0000,Public       ,1573,791,2364,22778,3723,26501
00659100,ST. JOSEPH HOSP SCH OF NURSING          ,RI,02904-5199,Private      ,17,69,86,88,284,372
00784400,SANFORD-BROWN INSTITUTE                 ,RI,02920-7807,Proprietary  ,0,0,0,5,17,22
00784500,NEW ENGLAND INSTITUTE OF TECHNOLOGY     ,RI,02886-0000,Private      ,468,694,1162,2380,2351,4731
01246116,LINCOLN TECHNICAL INSTITUTE - LINCOLN   ,RI,02865-4211,Proprietary  ,112,238,350,304,669,973
02531802,PAUL MITCHELL THE SCHOOL-CRANSTON       ,RI,02920-0000,Proprietary  ,30,35,65,88,92,180
02584400,NEW ENGLAND TRACTOR TRAILER TRAINING SCH,RI,02860-1752,Proprietary  ,32,367,399,49,408,457
03080000,NEWPORT SCHOOL OF HAIRDRESSING          ,RI,02860-4038,Proprietary  ,4,16,20,12,43,55
03732300,INTERNATIONAL YACHT RESTORATION SCH     ,RI,02840-6720,Private      ,6,21,27,43,39,82
04141200,TONI & GUY HAIRDRESSING ACADEMY         ,RI,02920-0000,Proprietary  ,57,44,101,97,90,187
00341700,ALLEN UNIVERSITY                        ,SC,29204-1085,Private      ,387,209,596,811,407,1218
00341800,ANDERSON UNIVERSITY                     ,SC,29621-4035,Private      ,981,567,1548,3092,1103,4195
00341900,CHARLESTON SOUTHERN UNIVERSITY          ,SC,29406-2160,Private      ,1453,942,2395,4333,1931,6264
00342000,BENEDICT COLLEGE                        ,SC,29204-1086,Private      ,1141,567,1708,3037,1229,4266
00342100,BOB JONES UNIVERSITY                    ,SC,29614-1000,Proprietary  ,1031,164,1195,2339,333,2672
00342200,SOUTHERN WESLEYAN UNIVERSITY            ,SC,29630-1020,Private      ,319,776,1095,841,1251,2092
00342300,THE CITADEL                             ,SC,29409-0002,Public       ,709,510,1219,2936,995,3931
00342400,CLAFLIN UNIVERSITY                      ,SC,29115-4498,Private      ,1044,509,1553,2436,908,3344
00342500,CLEMSON UNIVERSITY                      ,SC,29634-0001,Public       ,4224,1498,5722,20130,3369,23499
00342600,UNIV OF SC AT SUMTER                    ,SC,29150-2498,Public       ,354,301,655,743,545,1288
00342700,COKER COLLEGE                           ,SC,29550-3797,Private      ,445,439,884,1153,734,1887
00342800,COLLEGE OF CHARLESTON                   ,SC,29424-0100,Public       ,2618,1144,3762,11255,2544,13799
00342900,COLUMBIA INTERNATIONAL UNIVERSITY       ,SC,29203-1599,Private      ,228,292,520,580,546,1126
00343000,COLUMBIA COLLEGE                        ,SC,29203-5998,Private      ,452,742,1194,1044,1273,2317
00343100,CONVERSE COLLEGE                        ,SC,29302-1931,Private      ,369,291,660,1208,580,1788
00343200,ERSKINE COLLEGE                         ,SC,29639-0000,Private      ,251,24,275,720,52,772
00343201,ERSKINE THEOLOGICAL SEMINARY            ,SC,29639-0000,Private      ,1,45,46,3,67,70
00343400,FURMAN UNIVERSITY                       ,SC,29613-5253,Private      ,533,208,741,3417,410,3827
00343500,LANDER UNIVERSITY                       ,SC,29649-2099,Public       ,868,313,1181,3663,775,4438
00343600,LIMESTONE COLLEGE                       ,SC,29340-3799,Private      ,806,1228,2034,2017,2358,4375
00343700,LUTHERAN THEOLOGICAL SOUTHERN SEM       ,SC,29203-5898,Private      ,1,61,62,2,116,118
00343800,MEDICAL UNIV OF SOUTH CAROLINA - FA     ,SC,29425-1760,Public       ,128,1020,1148,387,3132,3519
00343900,MORRIS COLLEGE                          ,SC,29150-3599,Private      ,429,222,651,980,405,1385
00344000,NEWBERRY COLLEGE                        ,SC,29108-2197,Private      ,417,136,553,1627,304,1931
00344100,NORTH GREENVILLE COLLEGE                ,SC,29688-1892,Private      ,1150,256,1406,2565,420,2985
00344500,PRESBYTERIAN COLLEGE                    ,SC,29325-2503,Private      ,439,191,630,1653,410,2063
00344600,SOUTH CAROLINA STATE UNIVERSITY         ,SC,29117-4427,Public       ,1803,1084,2887,4404,2000,6404
00344700,SPARTANBURG METHODIST COLLEGE           ,SC,29301-5899,Private      ,585,108,693,1288,208,1496
00344800,UNIVERSITY OF SOUTH CAROLINA            ,SC,29208-3999,Public       ,6345,4525,10870,28235,10961,39196
00344900,UNIVERSITY OF SOUTH CAROLINA AIKEN      ,SC,29801-6399,Public       ,1143,712,1855,3273,1375,4648
00345000,UNIV OF SC AT BEAUFORT                  ,SC,29902-0000,Public       ,670,490,1160,1872,1032,2904
00345100,COASTAL CAROLINA UNIVERSITY             ,SC,29528-0000,Public       ,2943,1074,4017,13134,2540,15674
00345300,UNIV OF SC AT LANCASTER                 ,SC,29721-0889,Public       ,408,277,685,902,542,1444
00345400,UNIV OF SC SYSTEM SALKEHATCHIE          ,SC,29810-0617,Public       ,291,215,506,531,398,929
00345500,VOORHEES COLLEGE                        ,SC,29042-0000,Private      ,353,141,494,633,219,852
00345600,WINTHROP UNIVERSITY                     ,SC,29733-0001,Public       ,1785,920,2705,6301,1870,8171
00345700,WOFFORD COLLEGE                         ,SC,29303-3663,Private      ,266,61,327,2543,174,2717
00399000,FLORENCE-DARLINGTON TECH COLLEGE        ,SC,29501-0548,Public       ,1229,2451,3680,2246,4202,6448
00399100,GREENVILLE TECHNICAL COLLEGE            ,SC,29607-2439,Public       ,2953,4292,7245,5542,7480,13022
00399200,PIEDMONT TECHNICAL COLLEGE              ,SC,29648-1467,Public       ,1106,2034,3140,1769,3334,5103
00399300,MIDLANDS TECHNICAL COLLEGE              ,SC,29202-0000,Public       ,3427,4352,7779,6151,7878,14029
00399400,SPARTANBURG COMMUNITY COLLEGE           ,SC,29305-4386,Public       ,1446,1777,3223,2554,3199,5753
00399500,CENTRAL CAROLINA TECHNICAL COLLEGE      ,SC,29150-2499,Public       ,643,1471,2114,1088,2486,3574
00399600,YORK TECHNICAL COLLEGE                  ,SC,29730-3395,Public       ,1231,1817,3048,2207,3216,5423
00492000,TRIDENT TECHNICAL COLLEGE               ,SC,29423-8067,Public       ,2325,4647,6972,4377,8911,13288
00492300,CLINTON JR COLLEGE                      ,SC,29730-5152,Private      ,70,77,147,123,133,256
00492400,FORREST JUNIOR COLLEGE                  ,SC,29624-2405,Proprietary  ,20,126,146,28,199,227
00492500,HORRY-GEORGETOWN TECH COLLEGE           ,SC,29526-9521,Public       ,1485,2328,3813,3013,4787,7800
00492600,TRI-COUNTY TECHNICAL COLLEGE            ,SC,29670-9133,Public       ,1617,1329,2946,3480,2595,6075
00492700,UNIV OF SC AT UNION                     ,SC,29379-0729,Public       ,109,114,223,251,219,470
00499204,MILLER-MOTTE TECHNICAL COLLEGE - CONWAY ,SC,29526-9508,Proprietary  ,146,489,635,248,836,1084
00536300,DENMARK TECHNICAL COLLEGE               ,SC,29042-0000,Public       ,204,664,868,359,971,1330
00681500,ORANGEBURG-CALHOUN TECHNICAL COLG       ,SC,29118-8299,Public       ,741,1047,1788,1236,1705,2941
00695100,UNIVERSITY OF SOUTH CAROLINA UPSTATE    ,SC,29303-9972,Public       ,2054,1349,3403,5903,2711,8614
00760200,NORTHEASTERN TECHNICAL COLLEGE          ,SC,29520-7015,Public       ,290,476,766,468,743,1211
00922600,FRANCIS MARION UNIVERSITY               ,SC,29501-0000,Public       ,1534,792,2326,4231,1600,5831
00932200,WILLIAMSBURG TECHNICAL COLLEGE          ,SC,29556-4197,Public       ,104,213,317,195,358,553
00991000,TECHNICAL COLLEGE OF THE LOWCOUNTRY     ,SC,29902-5441,Public       ,430,1148,1578,770,2120,2890
00991100,UNIV OF SC-REGIONAL CAMPUSES ADMIN      ,SC,29208-0001,Public       ,93,115,208,273,275,548
01005600,AIKEN TECHNICAL COLLEGE                 ,SC,29802-0696,Public       ,641,1171,1812,1125,2125,3250
01019806,ECPI UNIVERSITY - GREENVILLE            ,SC,29615-4232,Proprietary  ,56,360,416,85,588,673
01019809,ECPI UNIVERSITY - CHARLESTON            ,SC,29420-4264,Proprietary  ,47,243,290,73,424,497
01019811,ECPI UNIVERSITY - COLUMBIA              ,SC,29210-6467,Proprietary  ,30,163,193,52,295,347
01179901,PAUL MITCHELL THE SCHOOL COLUMBIA       ,SC,29201-3126,Proprietary  ,39,79,118,68,141,209
01179902,PAUL MITCHELL THE SCHOOL CHARLESTON     ,SC,29418-6993,Proprietary  ,33,94,127,60,183,243
01179903,PAUL MITCHELL THE SCHOOL FAYETTEVILLE - ,SC,29607-0000,Proprietary  ,39,56,95,45,81,126
01209200,KENNETH SHULER SCHOOL OF COSMETOLOGY    ,SC,29732-2169,Proprietary  ,90,178,268,123,265,388
01303907,SOUTH UNIVERSITY                        ,SC,29203-6400,Proprietary  ,163,988,1151,352,1877,2229
02063700,SHERMAN CLG STRAIGHT CHIROPRACTIC       ,SC,29316-0000,Private      ,8,206,214,17,385,402
02338600,CHARZANNE BEAUTY COLLEGE                ,SC,29649-0000,Proprietary  ,15,37,52,24,53,77
02341100,KENNETH SHULER SCHOOL OF COSMETOLOGY & N,SC,29210-0000,Proprietary  ,101,310,411,159,443,602
02356600,CHARLESTON COSMETOLOGY INSTITUTE        ,SC,29420-0000,Proprietary  ,17,49,66,32,80,112
02359802,ITT TECHNICAL INSTITUTE -               ,SC,29615-4506,Proprietary  ,0,0,0,0,1,1
02552400,ACADEMY OF HAIR TECHNOLOGY              ,SC,29615-2363,Proprietary  ,22,73,95,33,119,152
02567600,SUMTER BEAUTY COLLEGE                   ,SC,29150-0000,Proprietary  ,21,46,67,25,70,95
02614202,MILLER - MOTTE TECHNICAL COLLEGE - NORTH,SC,29406-9239,Proprietary  ,118,530,648,175,792,967
03010614,VIRGINIA COLLEGE - GOLF ACADEMY OF AMERI,SC,29579-0000,Proprietary  ,29,46,75,76,125,201
03010617,VIRGINIA COLLEGE - GREENVILLE           ,SC,29607-7200,Proprietary  ,65,253,318,122,525,647
03010620,VIRGINIA COLLEGE - CHARLESTON           ,SC,29406-4999,Proprietary  ,75,236,311,124,433,557
03010621,VIRGINIA COLLEGE - COLUMBIA             ,SC,29223-7527,Proprietary  ,71,302,373,125,603,728
03052300,KENNETH SHULER SCH COSM & HAIR DESG     ,SC,29841-2013,Proprietary  ,76,182,258,99,240,339
03293300,STRAND COLLEGE OF HAIR DESIGN           ,SC,29572-4310,Proprietary  ,18,35,53,25,62,87
03304300,CENTURA COLLEGE                         ,SC,29406-9235,Proprietary  ,36,179,215,58,307,365
03513300,LACY COSMETOLOGY SCHOOL                 ,SC,29803-9084,Proprietary  ,0,0,0,5,9,14
03513301,LACY COSMETOLOGY SCHOOL -               ,SC,29072-0000,Proprietary  ,0,0,0,3,8,11
03513302,LACY COSMETOLOGY SCHOOL -               ,SC,29445-0000,Proprietary  ,0,0,0,6,5,11
03513303,LACY COSMETOLOGY SCHOOL - WEST ASHLEY   ,SC,29407-4605,Proprietary  ,0,0,0,3,6,9
03709301,EDWARD VIA VIRGINIA COLLEGE OF OSTEOPATH,SC,29303-3639,Private      ,8,449,457,18,708,726
03746300,LEGRAND INSTITUTE OF COSMETOLOGY        ,SC,29020-0000,Proprietary  ,6,17,23,13,32,45
03746400,SOUTHEASTERN INSTITUTE                  ,SC,29210-0000,Proprietary  ,26,137,163,50,243,293
03768400,STYLETRENDS BARBER AND HAIRSTYLING ACADE,SC,29730-4511,Proprietary  ,8,32,40,11,44,55
04083300,MARION COUNTY TECHNICAL EDUCATION CENTER,SC,29571-0000,Public       ,7,51,58,15,97,112
04096300,CHARLESTON SCHOOL OF LAW                ,SC,29402-0535,Proprietary  ,18,284,302,44,726,770
04158100,AIKEN SCHOOL OF COSMETOLOGY             ,SC,29801-4026,Proprietary  ,7,40,47,21,59,80
04166900,COSMETIC ARTS INSTITUTE                 ,SC,29488-2753,Proprietary  ,6,15,21,15,24,39
04172600,SALON 496 BARBER ACADEMY                ,SC,29607-2548,Proprietary  ,6,49,55,10,77,87
04192600,PALMETTO BEAUTY SCHOOL                  ,SC,29307-1424,Proprietary  ,18,43,61,28,71,99
04202900,JOLEI'S HAIR INSTITUTE                  ,SC,29114-9337,Proprietary  ,6,29,35,6,39,45
00345800,AUGUSTANA COLLEGE                       ,SD,57197-0001,Private      ,439,110,549,1477,211,1688
00345900,BLACK HILLS STATE UNIVERSITY            ,SD,57799-9670,Public       ,604,562,1166,1862,1170,3032
00346100,DAKOTA WESLEYAN UNIVERSITY              ,SD,57301-4398,Private      ,228,116,344,707,243,950
00346300,DAKOTA STATE UNIVERSITY                 ,SD,57042-1799,Public       ,379,322,701,1142,698,1840
00346500,MOUNT MARTY COLLEGE                     ,SD,57078-3724,Private      ,117,136,253,429,290,719
00346600,NORTHERN STATE UNIVERSITY               ,SD,57401-7198,Public       ,254,226,480,1479,616,2095
00346700,PRESENTATION COLLEGE                    ,SD,57401-1299,Private      ,138,193,331,511,389,900
00346900,UNIVERSITY OF SIOUX FALLS               ,SD,57105-1699,Private      ,240,213,453,1227,483,1710
00347000,SOUTH DAKOTA SCH OF MINES & TECH        ,SD,57701-3995,Public       ,438,237,675,1890,485,2375
00347100,SOUTH DAKOTA STATE UNIVERSITY           ,SD,57007-2298,Public       ,2415,1082,3497,7260,2219,9479
00347400,UNIVERSITY OF SOUTH DAKOTA              ,SD,57069-2390,Public       ,1647,1549,3196,4793,3321,8114
00405600,SIOUX FALLS SEMINARY                    ,SD,57105-2729,Private      ,2,24,26,4,42,46
00405700,NATIONAL AMERICAN UNIVERSITY            ,SD,57701-3692,Proprietary  ,301,5488,5789,405,7974,8379
00405707,NATIONAL AMERICAN UNIVERSITY            ,SD,57105-0000,Proprietary  ,19,184,203,47,532,579
00492900,MCKENNAN HOSP-RADOLOGICAL TECH          ,SD,57101-0000,Private      ,8,13,21,29,27,56
00530900,LAKE AREA TECHNICAL INSTITUTE           ,SD,57201-0730,Public       ,355,177,532,991,403,1394
00598700,AVERA SACRED HEART HOSPITAL SCHOOL OF RA,SD,57078-3899,Private      ,3,1,4,9,8,17
00776400,SOUTHEAST TECHNICAL INST                ,SD,57107-0000,Public       ,469,566,1035,1005,1067,2072
00828400,MITCHELL TECHNICAL INSTITUTE            ,SD,57301-9931,Public       ,313,153,466,662,303,965
01013800,STEWART SCHOOL                          ,SD,57104-0000,Proprietary  ,29,42,71,67,75,142
01014804,COLORADO TECHNICAL UNIVERSITY           ,SD,57108-2272,Proprietary  ,24,75,99,50,179,229
01017000,WESTERN DAKOTA TECHNICAL INSTITUTE      ,SD,57701-4018,Public       ,170,304,474,331,549,880
01147701,SIOUX VALLEY HOSP-MEDICAL TECH          ,SD,57117-5039,Private      ,12,9,21,25,19,44
01465900,OGLALA LAKOTA COLLEGE                   ,SD,57752-0490,Public       ,84,391,475,163,661,824
02137100,BLACK HILLS BEAUTY COLLEGE              ,SD,57701-0000,Proprietary  ,19,31,50,57,77,134
02143700,SINTE GLESKA UNIVERSITY                 ,SD,57570-0000,Public       ,11,84,95,47,205,252
02144600,KILIAN COMMUNITY COLLEGE                ,SD,57103-7020,Private      ,35,95,130,63,178,241
02277300,SISSETON WAHPETON COLLEGE               ,SD,57262-0000,Public       ,11,28,39,17,53,70
02297800,HEADLINES ACADEMY                       ,SD,57701-0000,Proprietary  ,22,29,51,43,64,107
00347700,AQUINAS COLLEGE                         ,TN,37205-2086,Private      ,78,233,311,289,537,826
00347800,AUSTIN PEAY STATE UNIVERSITY            ,TN,37044-0002,Public       ,1632,2361,3993,7601,6048,13649
00347900,BELMONT UNIVERSITY                      ,TN,37212-3757,Private      ,1019,1104,2123,7974,3171,11145
00348000,BETHEL UNIVERSITY                       ,TN,38201-1705,Private      ,362,1675,2037,1881,5384,7265
00348100,CARSON - NEWMAN UNIVERSITY              ,TN,37760-2204,Private      ,381,340,721,3284,776,4060
00348200,CHRISTIAN BROTHERS UNIVERSITY           ,TN,38104-5581,Private      ,314,503,817,2412,1523,3935
00348300,COLUMBIA STATE COMMUNITY COLLEGE        ,TN,38401-5653,Public       ,798,1005,1803,2763,2270,5033
00348500,CUMBERLAND UNIVERSITY                   ,TN,37087-3554,Private      ,240,373,613,1420,911,2331
00348600,LIPSCOMB UNIVERSITY                     ,TN,37204-3951,Private      ,642,898,1540,3808,2010,5818
00348700,EAST TENNESSEE STATE UNIV - MAIN CAMPUS ,TN,37614-2857,Public       ,2266,2465,4731,11504,6851,18355
00348701,EAST TENNESSEE STATE UNIV - MEDICINE    ,TN,37614-1708,Public       ,59,215,274,373,619,992
00348709,EAST TENNESSEE STATE UNIV - PHARMACY    ,TN,37614-1704,Public       ,21,203,224,131,448,579
00349000,FISK UNIVERSITY                         ,TN,37208-3045,Private      ,227,208,435,1621,681,2302
00349200,FREED-HARDEMAN UNIVERSITY               ,TN,38340-2399,Private      ,362,359,721,1704,742,2446
00349400,HIWASSEE COLLEGE                        ,TN,37354-4001,Private      ,93,55,148,354,159,513
00349500,JOHNSON UNIVERSITY                      ,TN,37998-9775,Private      ,247,245,492,1014,565,1579
00349600,KING COLLEGE                            ,TN,37620-2699,Private      ,414,1090,1504,1461,2445,3906
00349900,LANE COLLEGE                            ,TN,38301-4598,Private      ,344,229,573,1686,804,2490
00350000,LEE UNIVERSITY                          ,TN,37320-0000,Private      ,877,602,1479,3814,1321,5135
00350100,LEMOYNE-OWEN COLLEGE                    ,TN,38126-6510,Private      ,284,525,809,1577,1816,3393
00350200,LINCOLN MEMORIAL UNIVERSITY             ,TN,37752-7920,Private      ,317,1183,1500,1884,3079,4963
00350400,MARTIN METHODIST COLLEGE                ,TN,38478-2799,Private      ,216,90,306,1005,336,1341
00350500,MARYVILLE COLLEGE                       ,TN,37804-5907,Private      ,221,94,315,2095,285,2380
00350600,MEHARRY MEDICAL COLLEGE                 ,TN,37208-0000,Private      ,26,402,428,106,1222,1328
00350700,MEMPHIS COLLEGE OF ART                  ,TN,38104-2764,Private      ,176,127,303,799,347,1146
00350900,UNIVERSITY OF MEMPHIS (THE)             ,TN,38152-4611,Public       ,2917,4511,7428,16269,13949,30218
00351000,MIDDLE TENNESSEE STATE UNIV             ,TN,37130-0000,Public       ,4455,4298,8753,21147,10308,31455
00351100,MILLIGAN COLLEGE                        ,TN,37682-4001,Private      ,151,169,320,1120,498,1618
00351700,SOUTHERN COLLEGE OF OPTOMETRY           ,TN,38104-2222,Private      ,7,106,113,41,632,673
00351800,SOUTHERN ADVENTIST UNIVERSITY           ,TN,37315-0370,Private      ,683,337,1020,2472,811,3283
00351900,RHODES COLLEGE                          ,TN,38112-1690,Private      ,369,176,545,3012,503,3515
00352200,TENNESSEE STATE UNIVERSITY              ,TN,37209-1561,Public       ,2059,3054,5113,10783,7618,18401
00352300,TENNESSEE TECHNOLOGICAL UNIV            ,TN,38505-0001,Public       ,1748,1153,2901,10103,2898,13001
00352400,TENNESSEE TEMPLE UNIVERSITY             ,TN,37404-3587,Private      ,147,206,353,342,454,796
00352500,TENNESSEE WESLEYAN COLLEGE              ,TN,37371-0040,Private      ,124,167,291,1131,531,1662
00352600,TREVECCA NAZARENE UNIVERSITY            ,TN,37210-2877,Private      ,282,654,936,1527,1486,3013
00352700,TUSCULUM COLLEGE                        ,TN,37743-0001,Private      ,255,396,651,2248,1306,3554
00352800,UNION UNIVERSITY                        ,TN,38305-3697,Private      ,400,892,1292,2575,2400,4975
00352900,UNIVERSITY OF TENNESSEE-CHATTANOOGA     ,TN,37403-2598,Public       ,2501,1698,4199,13878,4366,18244
00353000,UNIVERSITY OF TENNESSEE-KNOXVILLE       ,TN,37996-0150,Public       ,3344,2651,5995,26791,8485,35276
00353006,UNIVERSITY OF TENNESSEE-HEALTH SCI CTR  ,TN,38103-0000,Public       ,111,804,915,613,3873,4486
00353100,UNIVERSITY OF TENNESSEE-MARTIN          ,TN,38238-0002,Public       ,1155,944,2099,7040,2731,9771
00353400,UNIVERSITY OF THE SOUTH                 ,TN,37383-1000,Private      ,108,26,134,2308,128,2436
00353500,VANDERBILT UNIVERSITY                   ,TN,37240-0001,Private      ,1359,1568,2927,19058,6469,25527
00353501,VANDERBILT UNIV MED CTR ALLIEDHEAL      ,TN,37232-5510,Private      ,40,166,206,206,568,774
00353600,BRYAN COLLEGE                           ,TN,37321-7000,Private      ,166,253,419,1067,687,1754
00399800,CHATTANOOGA STATE COMMUNITY COLLEGE     ,TN,37406-1097,Public       ,1674,2867,4541,4637,5971,10608
00399900,CLEVELAND STATE COMMUNITY COLLEGE       ,TN,37312-2858,Public       ,422,808,1230,2020,1786,3806
00402500,TN TECHNOLOGY CTR AT KNOXVILLE          ,TN,37919-2327,Public       ,178,530,708,628,1332,1960
00402600,TENNESSEE TECH. CNTR AT CROSSVILLE      ,TN,38555-4142,Public       ,86,181,267,551,458,1009
00461700,NATIONAL COLLEGE OF BUSINESS & TECH     ,TN,37211-6605,Proprietary  ,66,406,472,236,1337,1573
00493400,DAYMAR INSTITUTE                        ,TN,37217-1056,Proprietary  ,26,137,163,68,312,380
00493401,DAYMAR INSTITUTE - CLARKSVILLE          ,TN,37040-6718,Proprietary  ,74,369,443,153,774,927
00493404,DAYMAR INSTITUTE - MURFREESBORO         ,TN,37128-5508,Proprietary  ,37,133,170,87,276,363
00493700,JACKSON STATE COMMUNITY COLLEGE         ,TN,38301-3797,Public       ,623,1034,1657,2829,2798,5627
00493800,SOUTH COLLEGE                           ,TN,37909-3323,Proprietary  ,103,692,795,446,1739,2185
00494700,WEST TENNESSEE BUSINESS COLLEGE         ,TN,38301-3256,Proprietary  ,28,167,195,96,401,497
00528000,TN TECHNOLOGY CTR AT COVINGTON          ,TN,38019-0249,Public       ,47,111,158,127,282,409
00528100,TN TECHNOLOGY CTR AT ELIZABETHTON       ,TN,37643-0789,Public       ,65,243,308,261,605,866
00528200,TN TECHNOLOGY CTR AT HARTSVILLE         ,TN,37074-0000,Public       ,61,117,178,187,261,448
00528300,TN TECHNOLOGY CTR AT NEWBERN            ,TN,38059-1198,Public       ,46,108,154,167,299,466
00530700,TENNESSEE COLLEGE OF APPLIED TECHNOLOGY-,TN,37110-1322,Public       ,66,127,193,202,269,471
00535100,TENNESSEE TECHNOLOGY CENTER AT MORRISTOW,TN,37813-2094,Public       ,140,281,421,494,778,1272
00535200,TN TECHNOLOGY CENTER AT MCKENZIE        ,TN,38201-1620,Public       ,40,63,103,121,182,303
00535300,TN TECHNOLOGY CENTER AT LIVINGSTON      ,TN,38570-1291,Public       ,63,109,172,264,282,546
00535400,TN TECHNOLOGY CTR AT JACKSON            ,TN,38301-0000,Public       ,129,273,402,434,777,1211
00535600,TENNESSEE TECHNOLOGY CENTER AT HOHENWALD,TN,38462-0000,Public       ,83,121,204,195,259,454
00535700,TENNESSEE TECHNOLOGY CENTER AT CRUMP    ,TN,38327-3402,Public       ,53,98,151,150,276,426
00535800,TN TECHNOLOGY CENTER AT ATHENS          ,TN,37371-0848,Public       ,73,117,190,260,309,569
00535900,TENNESSEE TECHNOLOGY CENTER AT NASHVILLE,TN,37209-0000,Public       ,206,578,784,652,1356,2008
00536000,TENNESSEE TECHNOLOGY CENTER AT MEMPHIS  ,TN,38105-3604,Public       ,272,745,1017,1025,1922,2947
00537800,NORTHEAST STATE COMMUNITY COLLEGE       ,TN,37617-0246,Public       ,782,1305,2087,2949,3137,6086
00537900,TN TECHNOLOGY CTR AT SHELBYVILLE        ,TN,37160-3697,Public       ,108,183,291,325,440,765
00683500,DYERSBURG STATE COMMUNITY COLLEGE       ,TN,38024-0000,Public       ,364,668,1032,1456,1743,3199
00683600,MOTLOW STATE COMMUNITY COLLEGE          ,TN,37388-7972,Public       ,887,1050,1937,2946,2313,5259
00732941,ITT TECHNICAL INSTITUTE                 ,TN,37932-3343,Proprietary  ,315,1456,1771,626,2086,2712
00732958,ITT TECHNICAL INSTITUTE                 ,TN,37214-3717,Proprietary  ,207,963,1170,496,1682,2178
00743900,FOUNTAINHEAD COLLEGE OF TECHNOLOGY      ,TN,37918-0000,Proprietary  ,47,160,207,169,410,579
00778200,TENNESSEE TECHNOLOGY CENTER AT DICKSON  ,TN,37055-0000,Public       ,109,187,296,321,548,869
00778300,MIDDLE TENNESSEE SCH OF ANESTHESIA      ,TN,37116-0000,Private      ,2,63,65,18,142,160
00793803,NASHVILLE AUTO DIESEL COLLEGE - NASHVILL,TN,37206-3210,Proprietary  ,855,353,1208,1736,604,2340
00814500,NASHVILLE STATE TECH CMNTY COLLEGE      ,TN,37209-0000,Public       ,1474,3609,5083,4556,7665,12221
00865500,GENESIS CAREER COLLEGE OF COOKEVILLE    ,TN,38501-1959,Proprietary  ,67,180,247,113,284,397
00885900,JOHN A GUPTON COLLEGE                   ,TN,37203-2934,Private      ,27,58,85,85,163,248
00886300,WALTERS STATE COMMUNITY COLLEGE         ,TN,37813-6899,Public       ,836,1267,2103,4226,3021,7247
00946400,TN TECHNOLOGY CTR AT PULASKI            ,TN,38478-4541,Public       ,58,105,163,146,215,361
00956700,TENNESSEE SCHOOL OF BEAUTY              ,TN,37921-3303,Proprietary  ,51,122,173,187,300,487
00971000,TENNESSEE TECHNOLOGY CENTER AT ONEIDA/HU,TN,37756-4149,Public       ,25,54,79,79,119,198
00991200,VOLUNTEER STATE COMMUNITY COLLEGE       ,TN,37066-3188,Public       ,1061,1590,2651,3686,3458,7144
00991400,ROANE STATE COMMUNITY COLLEGE           ,TN,37748-8664,Public       ,615,1486,2101,3824,3349,7173
00998200,VICTORY UNIVERSITY                      ,TN,38111-4745,Proprietary  ,24,46,70,469,1246,1715
01032600,TN TECHNOLOGY CTR AT HARRIMAN           ,TN,37748-1109,Public       ,66,153,219,178,280,458
01043900,SOUTHWEST TENNESSEE COMMUNITY COLLG     ,TN,38104-3322,Public       ,1798,3913,5711,7648,10043,17691
01044700,"PLAZA BEAUTY SCHOOL, INC.               ",TN,38117-4822,Proprietary  ,46,106,152,135,220,355
01046000,AMERICAN BAPTIST THEOLOGICAL SEMINA     ,TN,37207-4994,Private      ,11,71,82,43,215,258
01052900,MEMPHIS THEOLOGICAL SEMINARY            ,TN,38104-0000,Private      ,6,152,158,18,277,295
01070000,TN TECHNOLOGY CENTER AT JACKSBORO       ,TN,37757-2461,Public       ,27,83,110,124,215,339
01155300,WM R MOORE COLLEGE OF TECHNOLOGY        ,TN,38104-0000,Private      ,43,97,140,159,267,426
01216400,TENNESSEE COLLEGE OF APPLIED TECHNOLOGY ,TN,38063-7359,Public       ,12,74,86,45,191,236
01254700,EMMANUEL SCHOOL OF RELIGION             ,TN,37601-0000,Private      ,3,15,18,8,42,50
01269300,PELLISSIPPI STATE COMMUNITY COLLEGE     ,TN,37933-0990,Public       ,1192,2050,3242,6110,4670,10780
02069303,VATTEROTT COLLEGE -                     ,TN,38016-5877,Proprietary  ,77,270,347,129,362,491
02092800,TENNESSEE TECHNOLOGY CENTER AT WHITEVILL,TN,38075-0000,Public       ,36,93,129,112,197,309
02103500,TENNESSEE COLLEGE OF APPLIED TECHNOLOGY ,TN,37129-3311,Public       ,129,305,434,469,662,1131
02106400,O'MORE COLLEGE OF DESIGN                ,TN,37064-0000,Private      ,48,36,84,182,92,274
02125300,NASHVILLE CLG OF MEDICAL CAREERS        ,TN,37115-0000,Proprietary  ,14,79,93,35,161,196
02153100,JON NAVE UNIVERSITY OF COSMETOLOGY      ,TN,37013-3347,Proprietary  ,45,106,151,99,181,280
02157100,CONCORDE CAREER COLLEGE                 ,TN,38137-0000,Proprietary  ,223,928,1151,655,2226,2881
02160307,INTERNATIONAL ACADEMY OF DESIGN & TECH  ,TN,37212-0000,Proprietary  ,32,86,118,101,180,281
02188300,PENTECOSTAL THEOLOGICAL SEMINARY        ,TN,37320-0000,Private      ,3,124,127,6,196,202
02204200,"CHATTANOOGA COLLEGE - MEDICAL, DENTAL AN",TN,37411-0000,Proprietary  ,75,276,351,188,608,796
02237900,TN TECHNOLOGY CENTER AT PARIS           ,TN,38242-0000,Public       ,36,136,172,123,351,474
02255000,KNOXVILLE INSTITUTE OF HAIR DESIGN      ,TN,37917-0000,Proprietary  ,11,75,86,71,189,260
02257400,ARNOLD'S BEAUTY SCHOOL                  ,TN,38358-0000,Proprietary  ,14,26,40,40,64,104
02263104,ANTHEM COLLEGE - ANTHEM CAREER COLLEGE -,TN,37214-2531,Proprietary  ,45,203,248,121,416,537
02275500,REUBEN-ALLEN COLLEGE                    ,TN,37922-0000,Proprietary  ,41,106,147,82,194,276
02278700,MR WAYNES SCH OF UNISEX HAIR DESIGN     ,TN,38501-0000,Proprietary  ,6,20,26,20,41,61
02293900,VOLUNTEER BEAUTY ACADEMY-NASHVILLE      ,TN,37115-2112,Proprietary  ,4,23,27,11,42,53
02294000,VOLUNTEER BEAUTY ACADEMY-DYERSBURG      ,TN,38024-1622,Proprietary  ,13,26,39,21,51,72
02326200,KAPLAN CAREER INSTITUTE                 ,TN,37212-5318,Proprietary  ,59,331,390,159,704,863
02326300,MEDVANCE INSTITUTE                      ,TN,38501-4305,Proprietary  ,62,126,188,108,204,312
02335900,VOLUNTEER BEAUTY ACADEMY-NASHVILLE      ,TN,37209-3033,Proprietary  ,18,48,66,41,98,139
02539800,QUEEN CITY COLLEGE                      ,TN,37042-0000,Proprietary  ,17,121,138,38,227,265
02540000,TENNESSEE ACADEMY OF COSMETOLOGY        ,TN,38133-0000,Proprietary  ,52,161,213,173,307,480
02578200,NOSSI COLLEGE OF ART                    ,TN,37115-5138,Proprietary  ,68,73,141,344,241,585
02595000,FAYETTEVILLE BEAUTY SCHOOL              ,TN,37334-2909,Proprietary  ,3,18,21,9,33,42
02599710,VATTEROTT COLLEGE - MEMPHIS             ,TN,38132-1714,Proprietary  ,96,402,498,321,1262,1583
02609204,VATTEROTT COLLEGE - VATTEROTT CAREER COL,TN,38133-4727,Proprietary  ,70,251,321,237,677,914
02614200,MILLER MOTTE BUSINESS COLLEGE           ,TN,37040-6023,Proprietary  ,84,357,441,163,712,875
02614203,MILLER - MOTTE TECHNICAL COLLEGE - CHATT,TN,37421-7220,Proprietary  ,72,260,332,174,590,764
02614204,MILLER - MOTTE TECHNICAL COLLEGE - MADIS,TN,37072-1870,Proprietary  ,61,291,352,100,417,517
03001800,FREE WILL BAPTIST BIBLE COLLEGE         ,TN,37205-2498,Private      ,91,43,134,220,96,316
03008800,FRANKLIN ACADEMY                        ,TN,37312-3939,Private      ,18,41,59,40,74,114
03010606,VIRGINIA COLLEGE - SCH OF BUSNSS & HLTH ,TN,37411-5600,Proprietary  ,67,303,370,167,723,890
03024900,TENNESSEE ACADEMY OF COSMETOLOGY        ,TN,38125-3442,Proprietary  ,44,151,195,170,301,471
03026517,REMINGTON COLLEGE - MEMPHIS             ,TN,38132-2107,Private      ,102,312,414,375,838,1213
03061100,GENESIS CAREER COLLEGE OF LEBANON       ,TN,37087-2718,Proprietary  ,35,76,111,63,126,189
03076405,BRYMAN SCHOOL OF ARIZONA (THE) - ANTHEM ,TN,38134-7345,Proprietary  ,69,339,408,114,554,668
03079100,NORTH CENTRAL INSTITUTE                 ,TN,37042-3116,Proprietary  ,19,47,66,37,114,151
03088800,"WATKINS COLLEGE OF ART, DESIGN & FILM   ",TN,37228-1306,Private      ,99,88,187,530,229,759
03126900,STYLES & PROFILES BEAUTY COLLEGE        ,TN,38375-2109,Proprietary  ,4,8,12,13,18,31
03253300,PAUL MITCHELL THE SCHOOL MEMPHIS        ,TN,38133-4067,Proprietary  ,38,62,100,125,137,262
03355400,RICHMONT GRADUATE UNIVERSITY            ,TN,37404-0000,Private      ,1,117,118,9,202,211
03440300,BAPTIST MEMORIAL COLLEGE OF HEALTH      ,TN,38104-3104,Private      ,196,595,791,1126,2135,3261
03480303,MEDVANCE INSTITUTE - NASHVILLE          ,TN,37203-1536,Proprietary  ,25,205,230,56,360,416
03513500,WILLIAMSON CHRISTIAN COLLEGE            ,TN,37067-8237,Private      ,23,26,49,47,48,95
03647300,NEW CONCEPTS SCHOOL OF COSMETOLOGY      ,TN,37311-7373,Proprietary  ,8,22,30,22,54,76
03683300,INTERNATIONAL BARBER & STYLE COLLEGE    ,TN,37209-2205,Proprietary  ,14,38,52,43,76,119
03701300,MEMPHIS INSTITUTE OF BARBERING          ,TN,38107-4334,Proprietary  ,55,101,156,151,261,412
03774400,SHEAR ACADEMY                           ,TN,38555-4177,Proprietary  ,7,17,24,13,39,52
03830300,SAE INSTITUTE OF TECHNOLOGY             ,TN,37203-4310,Proprietary  ,80,131,211,165,260,425
03840300,OXFORD GRADUATE SCHOOL                  ,TN,37321-6736,Private      ,0,14,14,4,27,31
03841300,CAREER BEAUTY COLLEGE                   ,TN,38464-3634,Proprietary  ,14,17,31,32,30,62
03920300,INSTITUTE OF HAIR DESIGN                ,TN,38310-1801,Proprietary  ,8,24,32,20,34,54
03930300,BUCHANAN BEAUTY COLLEGE                 ,TN,37160-2741,Proprietary  ,20,28,48,29,53,82
03982300,VISIBLE SCHOOL - MUSIC AND WORSHIPS ARTS,TN,38104-5814,Private      ,54,48,102,123,89,212
04035300,TENNESSEE CAREER INSTITUTE              ,TN,38401-6335,Proprietary  ,26,80,106,64,144,208
04124100,ELITE COLLEGE OF COSMETOLOGY            ,TN,38351-1431,Proprietary  ,8,36,44,24,49,73
04157200,LOVE BEAUTY SCHOOL                      ,TN,37355-2950,Proprietary  ,3,8,11,21,17,38
04165000,MERIDIAN INSTITUTE OF SURGICAL ASSISTING,TN,37080-0758,Proprietary  ,3,182,185,5,269,274
04174600,NASHVILLE BARBER AND STYLE ACADEMY      ,TN,37208-2826,Proprietary  ,15,47,62,43,106,149
04210200,MID-SOUTH CHRISTIAN COLLEGE             ,TN,38118-3151,Private      ,14,56,70,51,145,196
04213800,SALON PROFESSIONAL ACADEMY (THE)        ,TN,37214-2163,Proprietary  ,19,35,54,65,94,159
04215200,VIBE BARBER COLLEGE                     ,TN,38107-2538,Proprietary  ,14,54,68,26,86,112
04223900,MIND BODY INSTITUTE                     ,TN,37214-1012,Proprietary  ,6,46,52,12,68,80
00353700,ABILENE CHRISTIAN UNIVERSITY            ,TX,79699-3701,Private      ,1412,497,1909,5410,1076,6486
00353900,ALVIN COMMUNITY COLLEGE                 ,TX,77511-4807,Public       ,553,926,1479,1155,1795,2950
00354000,AMARILLO COLLEGE                        ,TX,79109-2446,Public       ,1447,2222,3669,2780,3786,6566
00354100,ANGELO STATE UNIVERSITY                 ,TX,76909-5069,Public       ,1638,1126,2764,5518,2335,7853
00354300,AUSTIN COLLEGE                          ,TX,75090-4440,Private      ,469,91,560,2087,202,2289
00354400,AUSTIN PRESBYTERIAN THEOLOGICAL SEM     ,TX,78705-5797,Private      ,2,87,89,5,146,151
00354500,BAYLOR UNIVERSITY                       ,TX,76798-7048,Private      ,2744,1204,3948,25342,4290,29632
00354600,COASTAL BEND COLLEGE                    ,TX,78102-2197,Public       ,599,638,1237,1143,1141,2284
00354900,BLINN COLLEGE                           ,TX,77833-4098,Public       ,5006,1989,6995,12612,4074,16686
00355300,CISCO JUNIOR COLLEGE                    ,TX,76437-9803,Public       ,706,900,1606,1451,1517,2968
00355400,CLARENDON COLLEGE                       ,TX,79226-0000,Public       ,203,206,409,405,335,740
00355600,COMMONWEALTH INST OF FUNERAL SVC        ,TX,77090-5918,Private      ,31,156,187,65,343,408
00355700,CONCORDIA UNIVERSITY TEXAS              ,TX,78726-4141,Private      ,462,939,1401,1442,1893,3335
00355800,NORTH CENTRAL TEXAS COLLEGE             ,TX,76240-4699,Public       ,1581,2105,3686,2948,3687,6635
00356000,DALLAS BAPTIST UNIVERSITY               ,TX,75211-9299,Private      ,1018,1552,2570,3275,2943,6218
00356100,CEDAR VALLEY COLLEGE                    ,TX,75134-0000,Public       ,906,1668,2574,1751,3048,4799
00356200,DALLAS THEOLOGICAL SEM                  ,TX,75204-0000,Private      ,18,342,360,36,644,680
00356300,DEL MAR COLLEGE                         ,TX,78404-3897,Public       ,2036,2814,4850,4239,5188,9427
00356400,EAST TEXAS BAPTIST UNIVERSITY           ,TX,75670-1423,Private      ,581,171,752,1681,375,2056
00356500,TEXAS A&M UNIVERSITY - COMMERCE         ,TX,75429-3011,Public       ,2032,2965,4997,6183,5937,12120
00356800,FRANK PHILLIPS COLLEGE                  ,TX,79008-0000,Public       ,142,178,320,275,291,566
00357000,GRAYSON COUNTY COLLEGE                  ,TX,75020-8299,Public       ,637,1236,1873,1254,2208,3462
00357100,HARDIN-SIMMONS UNIVERSITY               ,TX,79698-6050,Private      ,585,404,989,1767,775,2542
00357200,TRINITY VALLEY COMMUNITY COLLEGE        ,TX,75751-2734,Public       ,1054,1686,2740,2081,2944,5025
00357300,HILL COLLEGE                            ,TX,76645-2711,Public       ,379,491,870,823,899,1722
00357301,HILL COLLEGE                            ,TX,76031-0000,Public       ,398,704,1102,775,1301,2076
00357400,HOWARD COUNTY JUNIOR COLLEGE DISTRICT   ,TX,79720-0213,Public       ,530,745,1275,1104,1326,2430
00357500,HOWARD PAYNE UNIVERSITY                 ,TX,76801-2715,Private      ,424,148,572,1391,283,1674
00357600,HOUSTON BAPTIST UNIVERSITY              ,TX,77074-3298,Private      ,1294,1383,2677,5513,2836,8349
00357700,HUSTON - TILLOTSON UNIVERSITY           ,TX,78702-2795,Private      ,380,344,724,998,758,1756
00357800,UNIVERSITY OF THE INCARNATE WORD        ,TX,78209-6398,Private      ,1766,2569,4335,6700,5628,12328
00357900,JACKSONVILLE COLLEGE                    ,TX,75766-4759,Private      ,123,69,192,261,138,399
00358000,KILGORE COLLEGE                         ,TX,75662-3299,Public       ,1282,1645,2927,2469,2851,5320
00358100,LAMAR UNIVERSITY-BEAUMONT               ,TX,77710-0042,Public       ,2481,4006,6487,7386,7489,14875
00358200,LAREDO COMMUNITY COLLEGE                ,TX,78040-4395,Public       ,1865,1223,3088,4573,2168,6741
00358300,LEE COLLEGE                             ,TX,77520-4796,Public       ,732,1431,2163,1523,2551,4074
00358400,LETOURNEAU UNIVERSITY                   ,TX,75607-0000,Private      ,402,670,1072,1458,1484,2942
00358600,LUBBOCK CHRISTIAN UNIVERSITY            ,TX,79407-2099,Private      ,494,638,1132,1321,1150,2471
00358800,UNIVERSITY OF MARY HARDIN-BAYLOR        ,TX,76513-2599,Private      ,678,548,1226,5097,1468,6565
00359000,MCLENNAN COMMUNITY COLLEGE              ,TX,76708-1498,Public       ,1604,2697,4301,3593,4724,8317
00359100,MCMURRY UNIVERSITY                      ,TX,79697-0001,Private      ,415,270,685,1087,471,1558
00359200,MIDWESTERN STATE UNIVERSITY             ,TX,76308-2099,Public       ,1321,1165,2486,4663,2375,7038
00359300,NAVARRO COLLEGE                         ,TX,75110-4818,Public       ,1792,2104,3896,3823,3764,7587
00359400,UNIVERSITY OF NORTH TEXAS               ,TX,76203-5017,Public       ,8206,7063,15269,30871,16289,47160
00359500,OBLATE SCHOOL OF THEOLOGY               ,TX,78216-0000,Private      ,1,22,23,6,47,53
00359600,ODESSA COLLEGE                          ,TX,79764-7127,Public       ,519,930,1449,1150,1650,2800
00359800,OUR LADY OF THE LAKE UNIVERSITY         ,TX,78207-4689,Private      ,835,1325,2160,3046,2941,5987
00359900,UNIVERSITY OF TEXAS - PAN AMERICAN      ,TX,78541-2999,Public       ,3343,2887,6230,19659,8615,28274
00360000,PANOLA COLLEGE                          ,TX,75633-2397,Public       ,377,722,1099,855,1265,2120
00360100,PARIS JR COLLEGE                        ,TX,75460-6298,Public       ,710,1041,1751,1437,1797,3234
00360200,PAUL QUINN COLLEGE                      ,TX,75241-4398,Private      ,158,269,427,404,473,877
00360300,RANGER COLLEGE                          ,TX,76470-3298,Public       ,318,317,635,593,584,1177
00360305,RANGER COLLEGE-STEPHENVILE BEAUTY COLLEG,TX,76401-5136,Public       ,42,28,70,82,52,134
00360400,RICE UNIVERSITY                         ,TX,77251-1892,Private      ,1142,821,1963,11305,2391,13696
00360600,SAM HOUSTON STATE UNIVERSITY            ,TX,77340-0000,Public       ,5609,3630,9239,19907,8150,28057
00360700,ALAMO CMTY CLG DISTRICT PROGRAM         ,TX,78207-0000,Public       ,538,879,1417,1361,1877,3238
00360800,ST PHILLIPS COLLEGE                     ,TX,78203-2098,Public       ,2341,3914,6255,4873,7490,12363
00360900,SAN JACINTO CLG-CENTRAL-NORTH-SOUTH     ,TX,77501-0000,Public       ,4038,5634,9672,7988,10121,18109
00361000,SCHREINER UNIVERSITY                    ,TX,78028-5697,Private      ,460,191,651,1515,368,1883
00361100,SOUTH PLAINS COLLEGE                    ,TX,79336-6504,Public       ,1953,2062,4015,3954,3534,7488
00361200,UNIV OF HOUSTON-DOWNTOWN                ,TX,77002-1001,Public       ,3987,6943,10930,11416,14610,26026
00361300,SOUTHERN METHODIST UNIVERSITY           ,TX,75275-0181,Private      ,1269,1618,2887,7767,4020,11787
00361400,SOUTHWEST TEXAS JR COLLEGE              ,TX,78801-6221,Public       ,1008,933,1941,2085,1668,3753
00361500,TEXAS STATE UNIVERSITY--SAN MARCOS      ,TX,78666-4602,Public       ,7876,4485,12361,35760,12489,48249
00361600,SOUTHWESTERN ASSEMBLIES OF GOD UNIV     ,TX,75165-2397,Private      ,589,430,1019,1472,821,2293
00361800,SOUTHWESTERN CHRISTIAN COLLEGE          ,TX,75160-3400,Private      ,49,62,111,122,102,224
00361900,SOUTHWESTERN ADVENTIST UNIVERSITY       ,TX,76059-1922,Private      ,246,149,395,660,300,960
00362000,SOUTHWESTERN UNIVERSITY                 ,TX,78626-6111,Private      ,310,93,403,2526,298,2824
00362100,ST EDWARDS UNIVERSITY                   ,TX,78704-0000,Private      ,1110,951,2061,5566,2143,7709
00362300,ST MARY'S UNIV OF SAN ANTONIO           ,TX,78228-8500,Private      ,679,977,1656,4177,2663,6840
00362400,STEPHEN F AUSTIN STATE UNIVERSITY       ,TX,75962-0001,Public       ,3631,1916,5547,13547,4011,17558
00362500,SUL ROSS STATE UNIVERSITY               ,TX,79832-0113,Public       ,491,660,1151,1517,1259,2776
00362600,TARRANT COUNTY COLLEGE                  ,TX,76102-6599,Public       ,7856,12252,20108,15518,22162,37680
00362700,TEMPLE COLLEGE                          ,TX,76504-7435,Public       ,726,1891,2617,1673,3688,5361
00362800,TEXARKANA COLLEGE                       ,TX,75599-0001,Public       ,554,1284,1838,1036,2128,3164
00363000,PRAIRIE VIEW A&M UNIVERSITY             ,TX,77446-2967,Public       ,3234,2240,5474,9983,4549,14532
00363100,TARLETON STATE UNIVERSITY               ,TX,76402-0000,Public       ,2713,2231,4944,9460,4840,14300
00363200,TEXAS A&M UNIVERSITY                    ,TX,77843-1246,Public       ,7709,4056,11765,45759,12102,57861
00363208,TEXAS A&M UNIVERSITY - HEALTH SCIENCE CE,TX,77807-3260,Public       ,233,412,645,815,1285,2100
00363400,TEXAS STATE TECHNICAL CLG AT WACO       ,TX,76705-1695,Public       ,1138,1327,2465,2423,2403,4826
00363500,TEXAS CHIROPRACTIC COLLEGE              ,TX,77505-1699,Private      ,8,171,179,18,274,292
00363600,TEXAS CHRISTIAN UNIVERSITY              ,TX,76129-0001,Private      ,2011,1406,3417,11989,3352,15341
00363700,JARVIS CHRISTIAN COLLEGE                ,TX,75765-1470,Private      ,287,155,442,496,236,732
00363800,TEXAS COLLEGE                           ,TX,75702-4500,Private      ,375,370,745,716,650,1366
00363900,TEXAS A&M UNIVERSITY-KINGSVILLE         ,TX,78363-8203,Public       ,2141,2448,4589,9682,6146,15828
00364100,TEXAS LUTHERAN UNIVERSITY               ,TX,78155-5999,Private      ,514,128,642,1861,314,2175
00364200,TEXAS SOUTHERN UNIVERSITY               ,TX,77004-4598,Public       ,3417,4881,8298,9576,9739,19315
00364400,TEXAS TECH UNIVERSITY                   ,TX,79409-2011,Public       ,6513,4234,10747,27223,9448,36671
00364500,TEXAS WESLEYAN UNIVERSITY               ,TX,76105-1536,Private      ,606,1300,1906,1694,2693,4387
00364600,TEXAS WOMAN'S UNIVERSITY                ,TX,76204-5587,Public       ,2492,4614,7106,8997,11240,20237
00364700,TRINITY UNIVERSITY                      ,TX,78212-7200,Private      ,587,350,937,3459,835,4294
00364800,TYLER JUNIOR COLLEGE                    ,TX,75701-3436,Public       ,3162,2698,5860,7203,5000,12203
00365100,UNIVERSITY OF DALLAS                    ,TX,75062-4799,Private      ,401,614,1015,2200,1291,3491
00365200,UNIVERSITY OF HOUSTON                   ,TX,77204-2010,Public       ,8797,9662,18459,31586,22168,53754
00365400,UNIVERSITY OF ST THOMAS                 ,TX,77006-4626,Private      ,409,918,1327,1624,1925,3549
00365600,UNIVERSITY OF TEXAS-ARLINGTON           ,TX,76019-0000,Public       ,6465,11226,17691,22706,24540,47246
00365800,UNIVERSITY OF TEXAS-AUSTIN              ,TX,78713-7758,Public       ,5431,4871,10302,44960,17915,62875
00365900,UT HEALTH CENTER-SAN ANTONIO            ,TX,78229-3900,Public       ,435,1743,2178,1360,3927,5287
00366100,UNIVERSITY OF TEXAS-EL PASO             ,TX,79968-0629,Public       ,4808,4759,9567,16419,10817,27236
00366200,VICTORIA COLLEGE                        ,TX,77901-4494,Public       ,615,961,1576,1293,1771,3064
00366300,WAYLAND BAPTIST UNIVERSITY              ,TX,79072-6998,Private      ,472,1278,1750,1200,2516,3716
00366400,WEATHERFORD COLLEGE                     ,TX,76086-5699,Public       ,954,1389,2343,1975,2520,4495
00366500,WEST TEXAS A&M UNIVERSITY               ,TX,79016-0000,Public       ,2108,1808,3916,6006,3409,9415
00366800,WHARTON COUNTY JR COLLEGE               ,TX,77488-3298,Public       ,1341,1252,2593,2757,2271,5028
00366900,WILEY COLLEGE                           ,TX,75670-5199,Private      ,429,292,721,930,517,1447
00400300,CENTRAL TEXAS COLLEGE                   ,TX,76540-4199,Public       ,1070,5718,6788,2263,11360,13623
00407221,NORTHWOOD UNIVERSITY                    ,TX,75104-0000,Private      ,55,243,298,329,477,806
00445300,EL CENTRO COLLEGE                       ,TX,75202-3604,Public       ,2006,4563,6569,4122,8347,12469
00450303,EVEREST COLLEGE - FORT WORTH SOUTH      ,TX,76115-1407,Proprietary  ,106,443,549,173,686,859
00481102,EVEREST INSTITUTE - EVEREST COLLEGE     ,TX,76011-6630,Proprietary  ,79,324,403,141,542,683
00494900,BAYLOR COLLEGE OF MEDICINE              ,TX,77030-0000,Private      ,251,566,817,872,1986,2858
00495100,UNIV OF TEXAS HEALTH SCIENCE CENTER     ,TX,77225-0000,Public       ,378,1665,2043,1127,4009,5136
00495200,UNIV OF TEXAS MEDICAL BRANCH            ,TX,77550-0000,Public       ,265,1217,1482,774,2634,3408
00497200,GALVESTON COLLEGE                       ,TX,77550-7447,Public       ,403,673,1076,806,1229,2035
00497700,SOUTH TEXAS COLLEGE OF LAW              ,TX,77002-0000,Private      ,34,558,592,97,1550,1647
00660600,BAPTIST HS SCHOOL OF HEALTH PROFESSIONS ,TX,78229-3234,Proprietary  ,112,487,599,247,1129,1376
00661200,COVENANT SCH OF NSG & ALLIED HEALTH     ,TX,79410-0000,Private      ,99,230,329,180,402,582
00666100,ANGELINA COLLEGE                        ,TX,75902-0000,Public       ,779,1200,1979,1782,2214,3996
00694100,DALLAS CHRISTIAN COLLEGE                ,TX,75234-7229,Private      ,133,213,346,295,420,715
00709600,COLLEGE OF THE MAINLAND                 ,TX,77591-2499,Public       ,485,1134,1619,887,1990,2877
00728700,BRAZOSPORT COLLEGE                      ,TX,77566-3199,Public       ,590,734,1324,1075,1335,2410
00732907,ITT TECHNICAL INSTITUTE                 ,TX,77063-3751,Proprietary  ,210,586,796,384,1135,1519
00732913,ITT TECHNICAL INSTITUTE                 ,TX,76011-3919,Proprietary  ,136,621,757,259,980,1239
00732975,ITT TECHNICAL INSTITUTE                 ,TX,78249-3303,Proprietary  ,132,460,592,258,792,1050
00793804,LINCOLN COLLEGE OF TECHNOLOGY - GRAND PR,TX,75052-7605,Proprietary  ,304,269,573,525,431,956
00849800,MIMS CLASSIC BEAUTY COLLEGE             ,TX,78216-0000,Proprietary  ,25,35,60,34,58,92
00850300,MOUNTAIN VIEW COLLEGE                   ,TX,75211-6599,Public       ,1764,2504,4268,3417,4548,7965
00850400,RICHLAND COLLEGE                        ,TX,75243-2199,Public       ,2205,3417,5622,4610,6204,10814
00851000,EASTFIELD COLLEGE                       ,TX,75150-2099,Public       ,1809,3060,4869,3789,5556,9345
00907905,EVEREST COLLEGE                         ,TX,75206-5209,Proprietary  ,178,617,795,316,1132,1448
00908200,INTERNATIONAL BUSINESS COLLEGE          ,TX,79903-0000,Proprietary  ,32,96,128,98,192,290
00916300,SAN ANTONIO COLLEGE                     ,TX,78212-4299,Public       ,5137,7189,12326,11118,14006,25124
00922500,TEXAS STATE TECHNICAL COLLEGE  HARLINGEN,TX,78550-3697,Public       ,1309,1296,2605,3483,2586,6069
00946600,KAPLAN COLLEGE                          ,TX,78216-1899,Proprietary  ,127,465,592,215,842,1057
00946607,KAPLAN COLLEGE - MCALLEN                ,TX,78503-1622,Proprietary  ,157,217,374,285,372,657
00946609,KAPLAN COLLEGE - CAREER CENTERS OF TEXAS,TX,78416-9900,Proprietary  ,89,279,368,173,539,712
00946610,KAPLAN COLLEGE - CAREER CENTERS OF TEXAS,TX,76103-2310,Proprietary  ,82,294,376,125,513,638
00954900,WESTERN TEXAS COLLEGE                   ,TX,79549-9501,Public       ,256,134,390,517,288,805
00965100,TEXAS A&M INTERNATIONAL UNIVERSITY      ,TX,78041-1900,Public       ,1431,1121,2552,6187,2408,8595
00974100,UNIVERSITY OF TEXAS AT DALLAS           ,TX,75083-0000,Public       ,3051,3813,6864,12753,8541,21294
00976800,UNIVERSITY OF NORTH TEXAS HEALTH SCIENCE,TX,76107-2699,Public       ,197,1101,1298,602,2895,3497
00979700,MIDLAND COLLEGE                         ,TX,79705-6397,Public       ,577,830,1407,1237,1457,2694
00982802,EVEREST INSTITUTE- AUSTIN               ,TX,78754-0000,Proprietary  ,107,318,425,212,591,803
00993000,UNIVERSITY OF TEXAS-PERMIAN BASIN       ,TX,79762-0001,Public       ,752,1304,2056,1982,2371,4353
00993200,TEXAS STATE TECH CLG-WEST TEXAS         ,TX,79556-4108,Public       ,171,304,475,389,522,911
00993201,TEXAS STATE TECH COLLEGE-ABILENE        ,TX,79601-0000,Public       ,87,249,336,244,484,728
00993204,TEXAS STATE TECH CLG-BRECKENRIDGE       ,TX,76424-0000,Public       ,16,27,43,40,68,108
00993205,TEXAS STATE TECH COLLEGE-BROWNWOOD      ,TX,76801-0000,Public       ,36,88,124,85,176,261
01001900,UNIV OF TEXAS SOUTHWESTERN MED CTR      ,TX,75390-9096,Public       ,121,570,691,388,2044,2432
01005900,AMERICAN COMMERCIAL COLLEGE             ,TX,79761-0000,Proprietary  ,5,46,51,18,74,92
01005901,AMERICAN COMMERCIAL COLLEGE - AMERICAN C,TX,76310-2303,Proprietary  ,21,73,94,43,142,185
01006000,VERNON COLLEGE                          ,TX,76384-4092,Public       ,515,1031,1546,1019,1843,2862
01011500,UNIVERSITY OF TEXAS-SAN ANTONIO         ,TX,78249-0600,Public       ,6946,5655,12601,32517,14790,47307
01013000,WADE COLLEGE                            ,TX,75207-3199,Proprietary  ,82,146,228,174,265,439
01038700,EL PASO COMMUNITY COLLEGE               ,TX,79998-0000,Public       ,5186,5268,10454,13094,10814,23908
01050900,HALLMARK COLLEGE OF AERONAUTICS         ,TX,78214-0000,Private      ,98,385,483,149,636,785
01062400,LIGHTHOUSE CAREER INSTITUTE             ,TX,75231-5033,Private      ,7,25,32,16,52,68
01063300,HOUSTON COMMUNITY COLLEGE               ,TX,77002-0000,Public       ,8878,19265,28143,18602,35848,54450
01067400,TEXAS TECH U HEALTH SCIENCES CENTER     ,TX,79430-0000,Public       ,429,2375,2804,1435,4727,6162
01076100,DALLAS INSTITUTE OF FUNERAL SERVICE     ,TX,75227-4314,Private      ,40,134,174,83,265,348
01114500,LONE STAR COLLEGE SYSTEM                ,TX,77073-3499,Public       ,8286,14612,22898,16955,27417,44372
01116100,TEXAS A&M UNIV CORPUS CHRISTI           ,TX,78412-5599,Public       ,3107,2352,5459,11770,5121,16891
01116300,UNIVERSITY OF TEXAS AT TYLER            ,TX,75799-6699,Public       ,1668,2399,4067,5022,4796,9818
01171100,UNIVERSITY OF HOUSTON-CLEAR LAKE        ,TX,77058-1002,Public       ,1113,2936,4049,2935,6280,9215
01201500,AUSTIN COMMUNITY COLLEGE                ,TX,78752-4390,Public       ,4941,7443,12384,14173,16661,30834
01202000,VICTORIA BEAUTY COLLEGE                 ,TX,77901-6233,Proprietary  ,20,40,60,34,80,114
01226800,BALDWIN BEAUTY SCHOOL #5                ,TX,78704-4785,Proprietary  ,60,112,172,109,217,326
01229700,LAREDO BEAUTY COLLEGE                   ,TX,78040-1051,Proprietary  ,54,90,144,102,140,242
01248200,ATI TECHNICAL TRAINING CENTER           ,TX,75235-4622,Proprietary  ,28,87,115,28,87,115
01248209,ATI CAREER TRAINING CENTER - GARLAND    ,TX,75041-2497,Proprietary  ,3,26,29,3,26,29
01248210,ATI CAREER TRAINING CENTER - WACO       ,TX,76711-1682,Proprietary  ,28,55,83,28,55,83
01248300,COSMETOLOGY CAREER CENTER-A PAUL MITCHEL,TX,75006-2567,Proprietary  ,173,228,401,261,357,618
01248800,INTERNATIONAL BEAUTY COLLEGE NO 3       ,TX,75040-0000,Proprietary  ,7,21,28,12,49,61
01276400,METROPLEX BEAUTY SCHOOL                 ,TX,75149-0000,Proprietary  ,10,37,47,17,59,76
01293000,CHARLES & SUE'S SCH OF HAIR DESIGN      ,TX,77801-0000,Proprietary  ,29,39,68,49,75,124
01293200,TINT SCHOOL OF MAKEUP & COSMETOLOGY     ,TX,75061-4235,Proprietary  ,16,79,95,25,123,148
01300300,NEILSON BEAUTY COLLEGE                  ,TX,75208-4637,Proprietary  ,22,41,63,35,77,112
01301600,OGLE SCHOOL HAIR SKIN NAILS             ,TX,76013-7400,Proprietary  ,188,357,545,289,547,836
01303912,SOUTH UNIVERSITY - THE ART INSTITUTE OF ,TX,75231-5993,Proprietary  ,512,478,990,1144,919,2063
01303915,SOUTH UNIVERSITY - AUSTIN               ,TX,78729-8101,Proprietary  ,60,206,266,152,423,575
01323100,UNIVERSITY OF HOUSTON-VICTORIA          ,TX,77901-5731,Public       ,734,1592,2326,2728,3175,5903
02058600,CONLEE'S COLLEGE OF COSMETOLOGY         ,TX,78028-0000,Proprietary  ,4,13,17,15,27,42
02074100,CAPITOL CITY TRADE & TECHNICAL SCH      ,TX,78704-0000,Proprietary  ,57,156,213,90,247,337
02077400,NORTH LAKE COLLEGE                      ,TX,75038-0000,Public       ,1231,2176,3407,2447,3957,6404
02081400,ARLINGTON BAPTIST COLLEGE               ,TX,76012-0000,Private      ,103,122,225,190,233,423
02093600,SOUTHWEST SCHOOL OF ELECTRONIC          ,TX,78735-0000,Proprietary  ,16,33,49,27,66,93
02098300,WESTERN TECHNICAL COLLEGE               ,TX,79927-2105,Proprietary  ,342,633,975,660,1065,1725
02100200,BROOKHAVEN COLLEGE                      ,TX,75244-0000,Public       ,1200,2338,3538,2403,4267,6670
02113610,AMERICAN INTERCONTINENTAL UNIV - HOUSTON,TX,77042-4516,Proprietary  ,80,409,489,170,811,981
02116008,SANFORD-BROWN COLLEGE - HOUSTON         ,TX,77042-8900,Proprietary  ,152,428,580,268,798,1066
02116012,SANFORD-BROWN COLLEGE - HOUSTON NORTH LO,TX,77008-1058,Proprietary  ,17,108,125,53,215,268
02117100,ART INSTITUTE OF HOUSTON                ,TX,77056-0000,Proprietary  ,1423,1722,3145,3180,3157,6337
02119200,COURT REPORTING INSTITUTE OF DALLAS     ,TX,75247-6913,Proprietary  ,19,132,151,30,280,310
02128302,INSTITUTE FOR BUSINESS & TECHNOLOGY - LA,TX,78230-2520,Proprietary  ,49,135,184,110,242,352
02136800,AMERICAN COMMERCIAL COLLEGE             ,TX,76904-0000,Proprietary  ,15,45,60,29,78,107
02144800,VET TECH INSTITUTE OF HOUSTON           ,TX,77027-9881,Proprietary  ,176,196,372,304,314,618
02176100,PIPO ACADEMY OF HAIR DESIGN             ,TX,79903-0000,Proprietary  ,10,30,40,34,59,93
02218300,SOUTHWEST SCHOOL OF BUSINESS & TECHNICAL,TX,78221-0000,Proprietary  ,34,120,154,72,191,263
02218305,SOUTHWEST SCHOOL OF BUSINESS AND TECHNIC,TX,78501-6053,Proprietary  ,17,26,43,45,71,116
02218306,SOUTHWEST SCHOOL OF BUSINESS AND TECHNIC,TX,78413-2045,Proprietary  ,0,0,0,2,15,17
02224600,TRI-STATE BEAUTY SCHOOL #1              ,TX,79915-0000,Proprietary  ,34,121,155,66,178,244
02230500,OGLE SCHOOL HAIR SKIN NAILS             ,TX,76132-3638,Proprietary  ,168,391,559,249,613,862
02230600,OGLE SCHOOL HAIR SKIN NAILS             ,TX,76053-4650,Proprietary  ,108,210,318,147,311,458
02239100,CENTRAL TEXAS BEAUTY COLLEGE #2         ,TX,78664-4204,Proprietary  ,37,121,158,65,200,265
02248200,MILAN INSTITUTE OF COSMETOLOGY          ,TX,79103-0000,Proprietary  ,163,437,600,269,759,1028
02254800,TEXAS VOCATIONAL SCHOOLS                ,TX,77901-0000,Proprietary  ,9,31,40,17,83,100
02259400,AMBERTON UNIVERSITY                     ,TX,75041-0000,Private      ,12,148,160,37,282,319
02261300,EVEREST INSTITUTE                       ,TX,78213-3841,Proprietary  ,110,348,458,199,582,781
02261302,EVEREST INSTITUTE - HOUSTON GREENSPOINT ,TX,77060-3249,Proprietary  ,120,425,545,232,795,1027
02261303,EVEREST INSTITUTE - HOUSTON HOBBY       ,TX,77087-2737,Proprietary  ,91,319,410,137,523,660
02267100,EXPOSITO SCHOOL OF HAIR DESIGN          ,TX,79109-0000,Proprietary  ,7,21,28,17,41,58
02276000,FRANKLIN BEAUTY SCHOOL #2               ,TX,77021-0000,Proprietary  ,0,0,0,19,83,102
02285900,UNIVERSITY OF COSMETOLOGY ARTS&SCI      ,TX,78504-0000,Proprietary  ,101,166,267,161,242,403
02294800,CAPITOL CITY CAREERS                    ,TX,78745-0000,Proprietary  ,11,74,85,23,146,169
02298501,EVEREST COLLEGE- FORT WORTH             ,TX,76137-2472,Proprietary  ,82,370,452,141,634,775
02305300,PARKER COLLEGE OF CHIROPRACTIC          ,TX,75229-0000,Private      ,39,522,561,71,981,1052
02306700,FORT WORTH BEAUTY SCHOOL                ,TX,76116-3299,Proprietary  ,51,125,176,78,215,293
02312200,TEXAS SCHOOL OF BUSINESS                ,TX,77073-6032,Proprietary  ,104,377,481,203,700,903
02312202,TEXAS SCHOOL OF BUSINESS - FRIENDSWOOD C,TX,77546-8938,Proprietary  ,21,113,134,34,185,219
02313901,WESTWOOD COLLEGE - DALLAS               ,TX,75243-0000,Proprietary  ,26,154,180,67,330,397
02315400,NORTHEAST TEXAS COMMUNITY COLLEGE       ,TX,75456-0000,Public       ,599,843,1442,1192,1453,2645
02318200,"KD STUDIO, ACTOR'S CONSERVATORY         ",TX,75207-2111,Proprietary  ,101,108,209,159,198,357
02320200,HOUSTON GRADUATE SCHOOL OF THEOLOGY     ,TX,77092-0000,Private      ,8,99,107,16,183,199
02326000,SAN ANTONIO BEAUTY COLLEGE NO 3         ,TX,78217-0000,Proprietary  ,40,67,107,67,105,172
02331200,BAPTIST MISSIONARY ASSN THEOL SEM       ,TX,75766-0000,Private      ,6,36,42,9,58,67
02331300,INTERACTIVE LEARNING SYSTEMS            ,TX,77502-1201,Proprietary  ,21,117,138,24,142,166
02331301,INTERACTIVE LEARNING SYSTEMS            ,TX,77081-0000,Proprietary  ,49,232,281,67,354,421
02331304,INTERACTIVE LEARNING SYSTEMS            ,TX,77060-0000,Proprietary  ,12,88,100,25,136,161
02341300,PALO ALTO COLLEGE                       ,TX,78224-0000,Public       ,2414,2800,5214,4925,5266,10191
02348500,LAMAR STATE COLLEGE-PORT ARTHUR         ,TX,77640-0000,Public       ,411,722,1133,831,1326,2157
02357700,PAUL MITCHELL THE SCHOOL                ,TX,77043-3412,Proprietary  ,142,296,438,257,528,785
02358200,LAMAR STATE COLLEGE-ORANGE              ,TX,77630-0000,Public       ,323,720,1043,662,1248,1910
02361400,COLLIN COUNTY COMMUNITY COLLEGE         ,TX,75071-0000,Public       ,3146,4499,7645,6647,8302,14949
02362000,UNIVERSAL TECHNICAL INSTITUTE           ,TX,77073-0000,Proprietary  ,1618,1445,3063,4771,3315,8086
02362800,AUSTIN GRADUATE SCHOOL OF THEOLOGY      ,TX,78752-1333,Private      ,4,40,44,13,79,92
02521200,ARLINGTON CAREER INSTITUTE              ,TX,75050-0000,Proprietary  ,20,148,168,39,253,292
02521800,SEGUIN BEAUTY SCHOOL                    ,TX,78155-0000,Proprietary  ,10,24,34,18,40,58
02527500,HOUSTON TRAINING SCHOOLS                ,TX,77029-0000,Proprietary  ,50,300,350,84,474,558
02530700,SEBRING CAREER SCHOOLS                  ,TX,77083-1510,Proprietary  ,7,35,42,11,54,65
02548800,SOUTH TEXAS VO-TECH INSTITUTE           ,TX,78596-0000,Proprietary  ,94,149,243,119,174,293
02548802,SOUTH TEXAS VOCATIONAL TECHNICAL INSTITU,TX,78520-8710,Proprietary  ,97,108,205,144,156,300
02549400,SOUTH TEXAS VO-TECH INSTITUTE           ,TX,78501-0000,Proprietary  ,142,205,347,164,248,412
02549402,SOUTH TEXAS VOCATIONAL TECHNICAL INSTITU,TX,78416-1141,Proprietary  ,48,211,259,75,279,354
02555400,UNIV OF TX MD ANDERSON CANCER CTR       ,TX,77030-0000,Public       ,88,302,390,230,630,860
02567200,OFFICE CAREER CENTER                    ,TX,76180-0000,Proprietary  ,0,1,1,0,1,1
02568100,TEXAS BARBER COLLEGE                    ,TX,77063-3949,Proprietary  ,49,179,228,73,315,388
02568101,TEXAS BARBER COLLEGES & HAIRSTYLING SCHO,TX,75228-3841,Proprietary  ,37,109,146,58,196,254
02568106,TEXAS BARBER COLLEGES & HAIRSTYLING SCHO,TX,77009-0000,Proprietary  ,29,112,141,50,231,281
02568107,TEXAS BARBER COLLEGES & HAIRSTYLING SCHO,TX,77063-3951,Proprietary  ,28,127,155,44,249,293
02568108,TEXAS BARBER COLLEGES & HAIRSTYLING SCHO,TX,75241-1327,Proprietary  ,57,147,204,80,230,310
02568109,TEXAS BARBER COLLEGES & HAIRSTYLING SCHO,TX,77301-4407,Proprietary  ,7,30,37,9,49,58
02569300,LE CORDON BLEU COLLEGE OF CULINARY ARTS ,TX,78758-3647,Proprietary  ,457,932,1389,912,1777,2689
02572000,COMPUTER CAREER CENTER                  ,TX,79925-2021,Proprietary  ,205,627,832,286,812,1098
02572004,COMPUTER CAREER CENTER - AMARILLO CAMPUS,TX,79101-2404,Proprietary  ,45,187,232,64,292,356
02572005,COMPUTER CAREER CENTER - LUBBOCK CAMPUS ,TX,79414-3517,Proprietary  ,55,228,283,81,356,437
02572008,VISTA COLLEGE - BEAUMONT                ,TX,77701-3717,Proprietary  ,80,281,361,118,523,641
02572009,VISTA COLLEGE - LONGVIEW                ,TX,75604-1905,Proprietary  ,46,280,326,74,425,499
02572011,VISTA COLLEGE - KILLEEN                 ,TX,76541-7436,Proprietary  ,69,467,536,120,828,948
02591100,CAREER POINT COLLEGE                    ,TX,78201-2027,Proprietary  ,161,976,1137,245,1556,1801
02591900,KAPLAN COLLEGE                          ,TX,79907-1525,Proprietary  ,159,391,550,343,735,1078
02591905,KAPLAN COLLEGE - BROWNSVILLE            ,TX,78521-9905,Proprietary  ,68,126,194,149,293,442
02596400,REDSTONE COLLEGE - LOS ANGELES          ,TX,77061-0000,Proprietary  ,69,146,215,116,318,434
02596500,ATI CAREER TRAINING CENTER              ,TX,76180-1599,Proprietary  ,4,23,27,4,23,27
02596503,ATI- CAREER TRAINING CENTER - HOUSTON (#,TX,77029-1978,Proprietary  ,20,58,78,20,58,78
02596600,ATI-CAREER TRAINING CENTER              ,TX,75220-4443,Proprietary  ,15,76,91,15,76,91
02596601,ATI CAREER TRAINING CENTER - RICHARDSON ,TX,75081-1948,Proprietary  ,7,29,36,7,29,36
02596602,ATI CAREER TRAINING CENTER - DALLAS (STE,TX,75247-6103,Proprietary  ,35,113,148,35,113,148
02600200,OCEAN CORPORATION (THE)                 ,TX,77099-3479,Proprietary  ,59,299,358,106,525,631
02604700,CENTER FOR ADVANCED LEGAL STUDIES       ,TX,77098-4151,Proprietary  ,10,163,173,33,349,382
02606202,EVEREST COLLEGE - EVEREST INSTITUTE - BI,TX,77036-8014,Proprietary  ,150,540,690,250,912,1162
02615000,SANFORD-BROWN COLLEGE                   ,TX,75247-6931,Proprietary  ,94,420,514,207,807,1014
03009400,SW SCH BUS & TECH CAREERS               ,TX,78212-2840,Proprietary  ,18,68,86,36,96,132
03010604,VIRGINIA COLLEGE - VIRGINIA COLLEGE AT A,TX,78723-0000,Proprietary  ,49,223,272,110,452,562
03011800,UNIVERSITY OF COSMETOLOGY ARTS & SCIENCE,TX,78226-1194,Proprietary  ,30,53,83,57,102,159
03019800,PCI HEALTH TRAINING CENTER              ,TX,75247-4720,Proprietary  ,59,210,269,113,400,513
03019801,PCI HEALTH TRAINING CENTER - RICHARDSON ,TX,75081-2321,Proprietary  ,51,97,148,77,160,237
03021500,SW SCH BUS & TECH CAREERS               ,TX,78852-4859,Proprietary  ,71,92,163,131,142,273
03025000,TEXAS COLLEGE OF COSMETOLOGY            ,TX,79605-2001,Proprietary  ,36,108,144,63,163,226
03025001,TEXAS COLLEGE OF COSMETOLOGY - SAN ANGEL,TX,76903-4708,Proprietary  ,20,33,53,43,53,96
03026500,REMINGTON COLLEGE - HOUSTON CAMPUS      ,TX,77082-1849,Private      ,821,2731,3552,1091,3957,5048
03026501,REMINGTON COLLEGE - NORTH HOUSTON CAMPUS,TX,77067-1849,Private      ,63,231,294,140,456,596
03026506,REMINGTON COLLEGE - FT. WORTH CAMPUS    ,TX,76112-1280,Private      ,115,360,475,213,651,864
03028800,CIRCLE J BEAUTY SCHOOL                  ,TX,77587-3714,Proprietary  ,19,74,93,34,132,166
03030608,UTAH COLLEGE OF MASSAGE THERAPY - TEXAS ,TX,75801-4848,Proprietary  ,46,85,131,72,143,215
03030609,UTAH COLLEGE OF MASSAGE THERAPY - TEXAS ,TX,77040-6307,Proprietary  ,58,163,221,88,275,363
03031408,INTERNATIONAL ACADEMY OF DESIGN & TECHNO,TX,78229-2263,Proprietary  ,101,239,340,174,375,549
03032300,SCHOOL OF AUTOMOTIVE MACHINISTS         ,TX,77055-1803,Proprietary  ,60,124,184,123,221,344
03035200,TINT SCHOOL OF MAKEUP & COSMETOLOGY     ,TX,75229-3734,Proprietary  ,55,145,200,95,251,346
03035300,SOUTHERN CAREERS INSTITUTE              ,TX,78704-5252,Proprietary  ,398,1294,1692,500,1660,2160
03035301,SOUTHERN CAREERS INSTITUTE-PHARR        ,TX,78577-2118,Proprietary  ,56,136,192,79,212,291
03035302,SOUTHERN CAREERS INSTITUTE - CORPUS CHRI,TX,78414-2904,Proprietary  ,49,194,243,89,287,376
03035303,SOUTHERN CAREERS INSTITUTE - SAN ANTONIO,TX,78221-4351,Proprietary  ,32,74,106,66,138,204
03035305,SOUTHERN CAREERS INSTITUTE - BROWNSVILLE,TX,78520-8680,Proprietary  ,37,41,78,111,100,211
03035306,SOUTHERN CAREERS INSTITUTE - HARLINGEN  ,TX,78550-7911,Proprietary  ,24,51,75,78,98,176
03035308,SOUTHERN CAREERS INSTITUTE - SAN ANTONIO,TX,78238-4114,Proprietary  ,109,344,453,136,467,603
03061800,STAR COLLEGE OF COSMETOLOGY             ,TX,75702-8214,Proprietary  ,47,91,138,83,144,227
03064600,UNIVERSITY OF TEXAS AT BROWNSVILLE      ,TX,78520-4993,Public       ,2192,2630,4822,8378,5853,14231
03075400,ICC TECHNICAL INSTITUTE                 ,TX,77004-2930,Private      ,27,82,109,64,154,218
03076403,BRYMAN SCHOOL OF ARIZONA (THE) - ANTHEM ,TX,75038-4201,Proprietary  ,42,105,147,47,140,187
03103400,SOUTH TEXAS COLLEGE                     ,TX,78501-6699,Public       ,4173,3931,8104,12019,7728,19747
03108700,ROYAL BEAUTY CAREERS                    ,TX,77069-4611,Proprietary  ,45,148,193,74,258,332
03115800,KAPLAN COLLEGE                          ,TX,78238-4203,Proprietary  ,112,406,518,186,724,910
03115802,KAPLAN COLLEGE - LAREDO                 ,TX,78041-6181,Proprietary  ,97,157,254,145,224,369
03115803,KAPLAN COLLEGE-BEAUMONT                 ,TX,77701-3706,Proprietary  ,63,188,251,104,372,476
03115804,KAPLAN COLLEGE - LUBBOCK                ,TX,79401-2601,Proprietary  ,52,185,237,85,267,352
03128100,COLLEGE OF HEALTH CARE PROFESSIONS (THE),TX,77092-8108,Proprietary  ,286,1045,1331,518,1810,2328
03144300,NATIONAL BEAUTY COLLEGE                 ,TX,75043-4046,Proprietary  ,11,24,35,18,46,64
03153300,AMER COLL OF ACUPUNCTURE & O.M.         ,TX,77063-4104,Proprietary  ,8,50,58,18,104,122
03156400,ACADEMY OF ORIENTAL MEDICINE AT AUSTIN  ,TX,78757-1132,Proprietary  ,16,145,161,52,252,304
03159300,ARLINGTON MEDICAL INSTITUTE             ,TX,76011-0000,Proprietary  ,45,139,184,131,268,399
03170300,TEXAS A&M UNIVERSITY-TEXARKANA          ,TX,75501-0000,Public       ,450,788,1238,1228,1571,2799
03179500,TEXAS HEALTH AND SCIENCE UNIVERSITY     ,TX,78704-6748,Proprietary  ,89,168,257,306,403,709
03237400,FARIS COMPUTER SCHOOL                   ,TX,77627-3829,Proprietary  ,1,2,3,2,6,8
03272300,KAPLAN COLLEGE                          ,TX,75234-7288,Proprietary  ,112,526,638,214,1020,1234
03272301,KAPLAN COLLEGE - MIDLAND                ,TX,79703-5531,Proprietary  ,0,0,0,1,14,15
03272303,KAPLAN COLLEGE - ARLINGTON              ,TX,76010-8121,Proprietary  ,110,354,464,167,597,764
03275300,TOUCH OF CLASS SCHOOL OF COSM           ,TX,75402-6314,Proprietary  ,37,70,107,43,84,127
03276300,ACADEMY OF HAIR DESIGN                  ,TX,75901-4900,Proprietary  ,29,67,96,53,127,180
03277300,ACADEMY OF HAIR DESIGN                  ,TX,77701-4650,Proprietary  ,15,52,67,23,116,139
03303300,NORTHWEST EDUCATIONAL CENTER            ,TX,77092-7055,Proprietary  ,17,79,96,24,134,158
03371300,TONI&GUY HAIRDRESSING ACADEMY           ,TX,75006-2351,Proprietary  ,60,83,143,92,134,226
03372300,NORTHWEST VISTA COLLEGE                 ,TX,78251-4217,Public       ,3972,4046,8018,8504,7838,16342
03396500,TEXAS STATE TECHNICAL COLG/MARSHALL     ,TX,75672-7402,Public       ,178,220,398,319,376,695
03400300,CAREER QUEST                            ,TX,78229-3539,Proprietary  ,42,239,281,71,352,423
03412300,ADVANCED BARBER COLLEGE & HAIR DESI     ,TX,78596-0000,Proprietary  ,43,74,117,62,111,173
03416500,DALLAS NURSING INSTITUTE                ,TX,75243-5502,Proprietary  ,110,459,569,263,900,1163
03422300,MILAN INSTITUTE                         ,TX,78238-4103,Proprietary  ,216,554,770,401,1010,1411
03422400,COLLEGE OF BIBLICAL STUDIES-HOUSTON     ,TX,77036-3211,Private      ,36,355,391,76,662,738
03424400,MEDVANCE INSTITUTE                      ,TX,77057-7386,Proprietary  ,87,367,454,126,568,694
03426300,COLLEGE OF HEALTH CARE PROFESSIONS (THE),TX,78752-3630,Proprietary  ,93,311,404,190,524,714
03480304,MEDVANCE INSTITUTE OF BATON ROUGE - GRAN,TX,75050-2342,Proprietary  ,31,133,164,40,199,239
03520300,LUBBOCK HAIR ACADEMY                    ,TX,79410-3524,Proprietary  ,12,44,56,23,69,92
03542300,CONCORDE CAREER INSTITUTE               ,TX,76011-4016,Proprietary  ,116,555,671,187,992,1179
03556400,KUSSAD INSTITUTE OF COURT REPORTING     ,TX,78704-5712,Proprietary  ,2,17,19,3,30,33
03573300,AVIATION INSTITUTE OF MAINTENANCE       ,TX,75209-3017,Proprietary  ,51,171,222,93,313,406
03610300,MJ'S BEAUTY ACADEMY INC                 ,TX,75224-0000,Proprietary  ,32,80,112,51,133,184
03612400,VALLEY GRANDE INSTITUTE FOR ACADEMI     ,TX,78596-0000,Private      ,45,127,172,80,187,267
03627300,LAMAR INSTITUTE OF TECHNOLOGY           ,TX,77705-4142,Public       ,706,1056,1762,1486,1997,3483
03680300,JAY'S TECHNICAL INSTITUTE               ,TX,77031-3509,Proprietary  ,10,58,68,14,90,104
03682400,DALLAS BARBER & STYLIST COLLEGE         ,TX,75231-0000,Proprietary  ,60,224,284,90,391,481
03714300,TREND BARBER COLLEGE                    ,TX,77071-2104,Proprietary  ,29,119,148,46,206,252
03723300,CULINARY INST ALAIN & MARIE LENOTRE     ,TX,77022-4322,Proprietary  ,110,277,387,213,480,693
03727600,CULINARY ACADEMY OF AUSTIN              ,TX,78752-0000,Proprietary  ,98,154,252,254,301,555
03733300,BAPTIST UNIVERSITY OF THE AMERICAS      ,TX,78224-1336,Private      ,47,140,187,100,262,362
03756300,ANAMARC COLLEGE                         ,TX,79930-6230,Proprietary  ,122,526,648,241,907,1148
03922300,SOUTH TEXAS BARBER COLLEGE              ,TX,78415-3463,Proprietary  ,18,34,52,38,68,106
03944400,PROFESSIONAL CAREERS INSTITUTE          ,TX,77036-2252,Proprietary  ,6,59,65,18,110,128
03944401,PROFESSIONAL CAREERS INSTITUTE          ,TX,77090-3914,Proprietary  ,7,72,79,15,130,145
03970300,HANDS ON THERAPY                        ,TX,75149-2294,Proprietary  ,12,38,50,18,60,78
03987300,TEXAS HEALTH SCHOOL                     ,TX,77079-2106,Proprietary  ,77,251,328,219,468,687
04036300,SOUTHEAST TEXAS CAREER INSTITUTE        ,TX,77656-8601,Proprietary  ,11,45,56,17,85,102
04045300,NORTHWEST BEAUTY SCHOOL                 ,TX,77091-1208,Proprietary  ,25,64,89,48,122,170
04045400,MAI-TRIX BEAUTY COLLEGE                 ,TX,77040-0000,Proprietary  ,10,57,67,24,104,128
04082300,PROFESSIONAL CAREER TRAINING INSTITUTE  ,TX,77090-0000,Proprietary  ,12,97,109,27,185,212
04089400,CCI TRAINING CENTER                     ,TX,76011-4857,Proprietary  ,15,116,131,27,187,214
04117900,CHAMPION BEAUTY COLLEGE                 ,TX,77069-4611,Proprietary  ,28,107,135,62,229,291
04121800,CRISWELL COLLEGE                        ,TX,75246-1537,Private      ,63,158,221,109,300,409
04125400,ACADEMY AT AUSTIN (THE)                 ,TX,78660-3287,Proprietary  ,29,51,80,49,95,144
04125500,MANUEL AND THERESA'S SCHOOL OF HAIR DESI,TX,77803-3236,Proprietary  ,9,31,40,15,50,65
04129800,MEDIATECH INSTITUTE DALLAS              ,TX,75039-3105,Proprietary  ,64,137,201,97,207,304
04129801,MEDIATECH INSTITUTE - AUSTIN            ,TX,78704-8933,Proprietary  ,33,56,89,64,116,180
04129802,MEDIATECH INSTITUTE HOUSTON             ,TX,77042-4712,Proprietary  ,47,96,143,75,156,231
04131700,SOUTHWEST CAREER COLLEGE                ,TX,79925-6230,Proprietary  ,377,717,1094,724,1152,1876
04135600,CANNON INSTITUTE OF HIGHER LEARNING     ,TX,75247-9998,Proprietary  ,2,30,32,8,54,62
04136500,PCCENTER                                ,TX,75115-4214,Proprietary  ,6,20,26,16,32,48
04138500,CARDIOTECH ULTRASOUND SCHOOL            ,TX,77099-1440,Proprietary  ,22,182,204,62,371,433
04142300,AVEDA INSTITUTE SAN ANTONIO             ,TX,78215-1260,Proprietary  ,126,189,315,213,334,547
04146700,AVIATION INSTITUTE OF MAINTENANCE       ,TX,77061-4004,Proprietary  ,58,169,227,101,270,371
04146800,SOUTH TEXAS TRAINING CENTER             ,TX,78586-7721,Proprietary  ,13,59,72,19,72,91
04152700,ASTRODOME CAREER CENTERS                ,TX,77054-2678,Proprietary  ,17,64,81,34,129,163
04154800,DUVALL'S SCHOOL OF COSMETOLOGY          ,TX,76021-4159,Proprietary  ,12,38,50,20,58,78
04155800,ADVANCED BEAUTY COLLEGE                 ,TX,75061-1918,Proprietary  ,2,45,47,11,73,84
04158500,TEXAS BEAUTY COLLEGE                    ,TX,76117-3201,Proprietary  ,2,6,8,5,10,15
04160700,AVENUE FIVE INSTITUTE                   ,TX,78757-7000,Proprietary  ,53,110,163,101,214,315
04165800,SALON PROFESSIONAL ACADEMY (THE)        ,TX,75067-5390,Proprietary  ,19,53,72,29,79,108
04168700,LAWYER'S ASSISTANT SCHOOL OF DALLAS     ,TX,75201-2829,Proprietary  ,22,143,165,50,251,301
04168800,ABC BEAUTY ACADEMY                      ,TX,75042-8682,Proprietary  ,7,19,26,21,40,61
04169000,SALON & SPA INSTITUTE                   ,TX,78521-1727,Proprietary  ,17,37,54,37,59,96
04169100,DIAMONDS COSMETOLOGY COLLEGE            ,TX,75090-2657,Proprietary  ,12,52,64,15,74,89
04177900,BUCKNER BARBER SCHOOL                   ,TX,75217-1775,Proprietary  ,14,62,76,29,106,135
04178200,VOGUE COLLEGE - SAN ANTONIO             ,TX,78201-5035,Proprietary  ,20,83,103,38,123,161
04178300,VOGUE BEAUTY ACADEMY                    ,TX,78238-4402,Proprietary  ,35,71,106,63,113,176
04178400,VOGUE COLLEGE - MCALLEN                 ,TX,78501-1945,Proprietary  ,28,54,82,63,92,155
04179500,NORTH AMERICAN UNIVERSITY               ,TX,77038-1221,Private      ,98,91,189,211,187,398
04184800,EXCEL LEARNING CENTER                   ,TX,79907-1400,Proprietary  ,22,97,119,45,152,197
04187800,CYBERTEX INSTITUTE OF TECHNOLOGY        ,TX,78752-3825,Proprietary  ,24,98,122,51,170,221
04193000,RGV CAREERS AN INSTITUTE FOR HIGHER LEAR,TX,78577-2106,Proprietary  ,13,93,106,30,135,165
04205200,WADE GORDON HAIRDRESSING ACADEMY        ,TX,79121-0548,Proprietary  ,12,60,72,28,93,121
04206501,MYCOMPUTERCAREER.COM - DALLAS           ,TX,75062-8173,Proprietary  ,4,60,64,7,96,103
04206502,MYCOMPUTERCAREER.COM - HOUSTON          ,TX,77056-6764,Proprietary  ,9,86,95,27,184,211
04207300,SCHOOL FOR ALLIED HEALTH PROFESSIONALS  ,TX,76018-4104,Proprietary  ,17,112,129,28,151,179
04213300,SPA PROFESSIONALS ACADEMY (THE)         ,TX,78504-2569,Proprietary  ,13,32,45,29,68,97
04215000,TOTAL TRANSFORMATION INSTITUTE OF COSMET,TX,78666-8115,Proprietary  ,19,15,34,41,39,80
04215400,GRACE SCHOOL OF THEOLOGY                ,TX,77384-4894,Private      ,7,31,38,11,54,65
04219700,GEMINI SCHOOL OF VISUAL ARTS & COMMUNICA,TX,78613-2642,Proprietary  ,10,7,17,17,15,32
04224100,COSMETOLOGY ACADEMY OF TEXARKANA        ,TX,75503-4855,Proprietary  ,38,79,117,60,139,199
04226400,MT TRAINING CENTER                      ,TX,75051-3542,Proprietary  ,1,50,51,8,69,77
04229000,BARBER INSTITUTE OF TEXAS               ,TX,75602-3456,Proprietary  ,2,17,19,8,32,40
04229500,TEXAS A&M UNIVERSITY - CENTRAL TEXAS    ,TX,76549-5901,Public       ,215,1163,1378,526,2320,2846
04231200,NEECEE'S COLLEGE OF COSMETOLOGY         ,TX,79605-4735,Proprietary  ,6,22,28,11,53,64
04231300,YAHWEH BEAUTY ACADEMY                   ,TX,76543-4153,Proprietary  ,4,67,71,9,124,133
04231900,ALAMO CITY BARBER COLLEGE               ,TX,78250-3227,Proprietary  ,49,112,161,98,224,322
04232400,EXCEL LEARNING CENTER - SAN ANTONIO     ,TX,78230-4823,Proprietary  ,6,30,36,6,30,36
04232900,PREPARING PEOPLE BARBER STYLING COLLEGE ,TX,75215-2415,Proprietary  ,7,48,55,9,59,68
00367000,BRIGHAM YOUNG UNIVERSITY                ,UT,84602-8406,Private      ,3062,3858,6920,11277,8984,20261
00367100,DIXIE STATE COLLEGE OF UTAH             ,UT,84770-3876,Public       ,1867,1854,3721,4850,3025,7875
00367200,LDS BUSINESS COLLEGE                    ,UT,84101-3500,Private      ,311,433,744,722,751,1473
00367400,STEVENS HENAGER COLLEGE                 ,UT,84401-1420,Proprietary  ,675,6201,6876,917,9112,10029
00367500,UNIVERSITY OF UTAH                      ,UT,84112-9055,Public       ,3505,5307,8812,12520,12918,25438
00367700,UTAH STATE UNIVERSITY                   ,UT,84322-1400,Public       ,4031,5145,9176,10639,9294,19933
00367800,SOUTHERN UTAH UNIVERSITY                ,UT,84720-2470,Public       ,1485,1407,2892,4362,2439,6801
00367900,SNOW COLLEGE                            ,UT,84627-1299,Public       ,1068,440,1508,2537,756,3293
00368000,WEBER STATE UNIVERSITY                  ,UT,84408-1136,Public       ,2412,4628,7040,6211,9059,15270
00368100,WESTMINSTER COLLEGE                     ,UT,84105-3697,Private      ,604,654,1258,2283,1357,3640
00402700,UTAH VALLEY UNIVERSITY                  ,UT,84058-5999,Public       ,3452,5963,9415,7596,10387,17983
00522000,SALT LAKE COMMUNITY COLLEGE             ,UT,84123-0000,Public       ,2999,5875,8874,6024,11275,17299
00732953,ITT TECHNICAL INSTITUTE                 ,UT,84123-2500,Proprietary  ,164,764,928,235,1172,1407
00943300,SHERMAN KENDALL'S ACADEMY OF BEAUTY     ,UT,84106-1836,Proprietary  ,10,28,38,17,50,67
01009800,NEUMONT UNIVERSITY                      ,UT,84095-0000,Proprietary  ,238,41,279,716,103,819
01116500,UINTAH BASIN APPLIED TECHNOLOGY CLG     ,UT,84066-0000,Public       ,19,45,64,36,81,117
01116600,BROADVIEW UNIVERSITY                    ,UT,84088-4021,Proprietary  ,154,517,671,247,767,1014
02078800,SHERMAN KENDALL'S ACADEMY OF BEAUTY     ,UT,84047-0000,Proprietary  ,10,12,22,14,17,31
02115400,BRIDGERLAND APPLIED TECHNOLOGY COLLEGE  ,UT,84321-0000,Public       ,152,310,462,297,557,854
02156600,DAVIS APPLIED TECHNOLOGY COLLEGE        ,UT,84037-0000,Public       ,193,568,761,338,1056,1394
02178500,EAGLE GATE COLLEGE                      ,UT,84123-0000,Proprietary  ,61,357,418,106,645,751
02270800,AMERITECH COLLEGE                       ,UT,84604-6927,Proprietary  ,51,363,414,79,629,708
02270802,AMERITECH COLLEGE - DRAPER              ,UT,84020-6545,Proprietary  ,33,245,278,55,467,522
02298500,EVEREST COLLEGE                         ,UT,84119-2668,Proprietary  ,49,294,343,97,480,577
02346500,OGDEN-WEBER APPLIED TECHNOLOGY COLG     ,UT,84404-0000,Public       ,197,732,929,406,1407,1813
02360800,PROVO COLLEGE                           ,UT,84601-0000,Proprietary  ,66,223,289,124,346,470
02531800,PAUL MITCHELL THE SCHOOL - PROVO        ,UT,84606-0000,Proprietary  ,33,40,73,63,69,132
02556800,PAUL MITCHELL THE SCHOOL                ,UT,84117-7204,Proprietary  ,75,188,263,108,247,355
02556801,PAUL MITCHELL THE SCHOOL                ,UT,84780-0000,Proprietary  ,32,68,100,42,89,131
02572700,EVANS HAIRSTYLING COLLEGE               ,UT,84770-0000,Proprietary  ,23,14,37,34,24,58
02572800,VISTA COLLEGE                           ,UT,84015-0000,Proprietary  ,11,186,197,22,315,337
02573100,EVANS HAIRSTYLING COLLEGE               ,UT,84720-0000,Proprietary  ,12,15,27,29,27,56
02612200,MARINELLO SCHOOL OF BEAUTY              ,UT,84604-1585,Proprietary  ,23,32,55,37,57,94
03030600,UTAH COLLEGE OF MASSAGE THERAPY         ,UT,84111-1606,Proprietary  ,68,139,207,121,269,390
03030601,UTAH CLG OF MASSAGE THER-PROVO CMPS     ,UT,84042-0000,Proprietary  ,13,29,42,23,48,71
03082100,MYOTHERAPY COLLEGE OF UTAH              ,UT,84115-2522,Proprietary  ,4,35,39,8,68,76
03108200,ECHELON EDGE ACADEMY OF HAIR SKIN & NAIL,UT,84070-2004,Proprietary  ,9,13,22,16,30,46
03110400,HAIRITAGE HAIR ACADEMY                  ,UT,84770-5233,Proprietary  ,18,25,43,22,37,59
03339400,WESTERN GOVERNORS UNIVERSITY            ,UT,84107-2533,Private      ,574,19493,20067,1242,37449,38691
03413300,MOUNTAINLAND APPLIED TECHNOLOGY COLLEGE ,UT,84043-0000,Public       ,122,268,390,216,485,701
03463300,CAREERS UNLIMITED                       ,UT,84058-0000,Proprietary  ,26,59,85,48,132,180
03467308,MARINELLO SCHOOL OF BEAUTY - OGDEN      ,UT,84405-1501,Proprietary  ,24,62,86,38,114,152
03467309,MARINELLO SCHOOL OF BEAUTY - LAYTON     ,UT,84041-3002,Proprietary  ,27,65,92,33,96,129
03617300,HEALING MOUNTAIN MASSAGE SCHOOL         ,UT,84111-0000,Proprietary  ,11,55,66,27,124,151
03829500,SKINWORKS SCHOOL OF ADVANCED SKINCARE   ,UT,84115-0000,Proprietary  ,11,41,52,23,81,104
03838300,NIGHTINGALE COLL. SCH. OF NURSING SCH. O,UT,84403-0000,Proprietary  ,17,128,145,28,242,270
03909300,PAUL MITCHELL THE SCHOOL LOGAN          ,UT,84323-4679,Proprietary  ,21,27,48,35,48,83
03921300,CAMEO COLLEGE OF ESSENTIAL BEAUTY       ,UT,84115-0000,Proprietary  ,34,99,133,55,194,249
04054300,SOUTHWEST APPLIED TECHNOLOGY COLLEGE    ,UT,84720-6608,Public       ,34,76,110,68,146,214
04072300,AVEDA INSTITUTE PROVO                   ,UT,84604-1008,Proprietary  ,44,52,96,66,80,146
04121700,DIXIE APPLIED TECHNOLOGY COLLEGE        ,UT,84770-3025,Public       ,76,131,207,178,234,412
04145500,SKIN SCIENCE INSTITUTE (THE)            ,UT,84115-0000,Proprietary  ,11,60,71,26,119,145
04153000,RENAISSANCE ACADEMIE                    ,UT,84604-0000,Proprietary  ,14,25,39,25,51,76
04161900,MANDALYN ACADEMY                        ,UT,84003-2161,Proprietary  ,9,25,34,13,41,54
04165500,ACAYDIA SCHOOL OF AESTHETICS            ,UT,84601-0000,Proprietary  ,12,16,28,25,30,55
04169900,AMERICAN BEAUTY ACADEMY                 ,UT,84651-0000,Proprietary  ,3,19,22,7,29,36
04173200,TAYLOR ANDREWS ACADEMY OF HAIR DESIGN   ,UT,84088-6577,Proprietary  ,29,42,71,52,82,134
04173201,TAYLOR ANDREWS ACADEMY -  OREM          ,UT,84004-1872,Proprietary  ,19,31,50,35,49,84
04183000,TOP NAILS & HAIR BEAUTY SCHOOL          ,UT,84118-0000,Proprietary  ,5,28,33,6,47,53
04184200,TAYLOR ANDREWS ACADEMY-ST. GEORGE       ,UT,84790-2139,Proprietary  ,31,36,67,45,75,120
04192700,BARBER SCHOOL (THE)                     ,UT,84047-3723,Proprietary  ,10,38,48,16,72,88
04193200,ROCKY MOUNTAIN UNIVERSITY OF HEALTH PROF,UT,84606-7312,Proprietary  ,12,90,102,23,263,286
04210300,MEDSPA ACADEMIES                        ,UT,84095-3519,Proprietary  ,20,61,81,32,124,156
04211500,BEAUTIFUL YOU SCHOOL OF NAIL TECHNOLOGY ,UT,84720-8360,Proprietary  ,4,10,14,9,19,28
04216800,BONNIE JOSEPH ACADEMY OF COSMETOLOGY & B,UT,84032-2044,Proprietary  ,0,13,13,2,16,18
04218300,MIDWIVES COLLEGE OF UTAH                ,UT,84106-2671,Private      ,5,107,112,13,228,241
00368200,BENNINGTON COLLEGE                      ,VT,05201-6001,Private      ,144,61,205,984,180,1164
00368300,CASTLETON STATE COLLEGE                 ,VT,05735-0000,Public       ,400,143,543,2800,407,3207
00368400,CHAMPLAIN COLLEGE                       ,VT,05401-3950,Private      ,439,368,807,4240,1046,5286
00368500,COLLEGE OF ST JOSEPH                    ,VT,05701-3899,Private      ,67,68,135,217,150,367
00368600,GODDARD COLLEGE                         ,VT,05667-0000,Private      ,18,260,278,53,556,609
00368700,GREEN MOUNTAIN COLLEGE                  ,VT,05764-1199,Private      ,176,55,231,827,177,1004
00368800,JOHNSON STATE COLLEGE                   ,VT,05656-9898,Public       ,279,295,574,1241,692,1933
00368900,LYNDON STATE COLLEGE                    ,VT,05851-0919,Public       ,250,79,329,1750,277,2027
00369000,MARLBORO COLLEGE                        ,VT,05344-0300,Private      ,52,35,87,301,98,399
00369100,MIDDLEBURY COLLEGE                      ,VT,05753-0000,Private      ,486,146,632,3941,499,4440
00369200,NORWICH UNIVERSITY                      ,VT,05663-1035,Private      ,394,443,837,3025,1002,4027
00369300,SOUTHERN VERMONT COLLEGE                ,VT,05201-6002,Private      ,103,47,150,546,132,678
00369400,ST MICHAELS COLLEGE                     ,VT,05439-0001,Private      ,450,47,497,3790,165,3955
00369600,UNIVERSITY OF VERMONT                   ,VT,05405-0160,Public       ,778,525,1303,18830,2861,21691
00369700,VERMONT COLLEGE OF FINE ARTS            ,VT,05602-3128,Private      ,2,128,130,12,305,317
00369800,VERMONT TECHNICAL COLLEGE               ,VT,05061-0000,Public       ,184,209,393,992,732,1724
00857500,SALON PROFESSIONAL ACADEMY (THE)        ,VT,05495-4001,Proprietary  ,0,1,1,13,22,35
00865800,O'BRIENS AVEDA INSTITUTE                ,VT,05403-7747,Proprietary  ,24,40,64,46,60,106
00886000,SIT                                     ,VT,05301-4801,Private      ,106,140,246,296,475,771
01116700,COMMUNITY COLLEGE OF VERMONT            ,VT,05676-0000,Public       ,491,1311,1802,1123,2740,3863
01193400,VERMONT LAW SCHOOL                      ,VT,05068-0000,Private      ,0,287,287,5,813,818
01218300,BURLINGTON COLLEGE                      ,VT,05401-8477,Private      ,42,47,89,244,135,379
02143500,STERLING COLLEGE                        ,VT,05827-0000,Private      ,22,21,43,119,51,170
02254000,NEW ENGLAND CULINARY INSTITUTE          ,VT,05602-0000,Proprietary  ,103,53,156,310,142,452
02532600,LANDMARK COLLEGE                        ,VT,05346-0000,Private      ,93,32,125,473,108,581
04146900,ADVANCED WELDING INSTITUTE              ,VT,05403-0000,Proprietary  ,14,25,39,37,40,77
00392800,CASPER COLLEGE                          ,WY,82601-4612,Public       ,279,506,785,1079,1082,2161
00392900,EASTERN WYOMING COLLEGE                 ,WY,82240-1603,Public       ,109,104,213,419,238,657
00393000,SHERIDAN COLLEGE                        ,WY,82801-9133,Public       ,226,315,541,802,711,1513
00393100,NORTHWEST COLLEGE                       ,WY,82435-1895,Public       ,184,168,352,733,342,1075
00393200,UNIVERSITY OF WYOMING                   ,WY,82071-2000,Public       ,1419,1368,2787,6381,3671,10052
00393300,WESTERN WYOMING COMMUNITY COLLEGE       ,WY,82902-0000,Public       ,291,365,656,726,722,1448
00728900,CENTRAL WYOMING COLLEGE                 ,WY,82501-0000,Public       ,136,267,403,427,534,961
00915700,WYOMING TECHNICAL INSTITUTE             ,WY,82072-9519,Proprietary  ,441,279,720,887,531,1418
00925900,LARAMIE COUNTY COMMUNITY CLG            ,WY,82007-3299,Public       ,462,833,1295,1327,1606,2933
02211900,CHEEKS INTERNATIONAL ACDMY              ,WY,82001-0000,Proprietary  ,15,50,65,34,76,110
00393500,UNIV OF GUAM                            ,GU,96923-0000,Public       ,1017,668,1685,1914,1235,3149
01536100,GUAM COMMUNITY COLLEGE                  ,GU,96921-0000,Public       ,825,640,1465,1265,1138,2403
03438300,PACIFIC ISLANDS UNIVERSITY              ,GU,96913-2619,Private      ,23,36,59,55,65,120
00393600,PONTIFICAL CATHOLIC UNIV OF PR          ,PR,00717-0777,Private      ,3466,1691,5157,5164,2499,7663
00393700,UNIVERSITY OF THE SACRED HEART          ,PR,00914-0383,Private      ,1847,634,2481,2627,1060,3687
00393800,INTER-AMER UNIV PR-CNTRL ADMN           ,PR,00936-0000,Private      ,1920,2087,4007,2310,2732,5042
00393801,INTER-AMER UNIV PR SCHL LAW             ,PR,00936-8351,Private      ,12,172,184,22,258,280
00393802,INTER AMERICAN UNIVERSITY OF PUERTO RICO,PR,00926-0000,Private      ,539,366,905,824,573,1397
00393803,INTER AMERICAN UNIVERSITY OF PR         ,PR,00683-0000,Private      ,2318,730,3048,2753,963,3716
00393804,INTER-AMER UNIV PR-RECINTO AGUADILA     ,PR,00605-2000,Private      ,2075,795,2870,2578,1041,3619
00393805,INTER-AMER UNIV PR-ARECIBO CAMPUS       ,PR,00614-4050,Private      ,2066,891,2957,2606,1269,3875
00393806,INTER-AMER UNIV PR-BARRANQUITAS REG     ,PR,00794-0517,Private      ,1019,359,1378,1388,468,1856
00393807,INTER-AMER UNIV PR-FAJARDO REGIONAL     ,PR,00738-0000,Private      ,829,404,1233,1009,538,1547
00393808,INTER-AMER UNIV PR - GUAYAMA CAMPUS     ,PR,00785-4004,Private      ,761,516,1277,914,686,1600
00393809,INTER-AMER UNIV PR-PONCE REGIONAL       ,PR,00715-0000,Private      ,2434,1184,3618,3095,1594,4689
00393811,INTER-AMER UNIV PR-BAYAMON REG CLG      ,PR,00959-0000,Private      ,2482,662,3144,3186,918,4104
00394100,UNIVERSIDAD DEL ESTE                    ,PR,00984-2010,Private      ,3866,2952,6818,5051,3829,8880
00394200,UNIVERSITY OF PR-CENTRAL ADMINISTRATION ,PR,00936-4984,Public       ,224,104,328,355,160,515
00394300,UNIVERSITY OF PUERTO RICO - HUMACAO UNIV,PR,00791-4300,Public       ,2393,235,2628,2850,307,3157
00394400,UNIVERSITY OF PUERTO RICO - MAYAGUEZ    ,PR,00680-0000,Public       ,6071,970,7041,8091,1379,9470
00501900,UNIV ADVENTISTA DE LAS ANTILLAS         ,PR,00681-0118,Private      ,524,230,754,743,339,1082
00502200,BAYAMON CENTRAL UNIVERSITY              ,PR,00960-0000,Private      ,749,549,1298,857,640,1497
00710800,UNIVERSITY OF PUERTO RICO - RIO PIEDRAS ,PR,00931-3300,Public       ,6511,1849,8360,8566,2453,11019
00720600,UNIVERSITY OF PUERTO RICO - CAYEY UNIVER,PR,00736-5534,Public       ,1667,122,1789,3342,331,3673
00722800,UNIVERSITY OF PUERTO RICO - ARECIBO     ,PR,00614-4010,Public       ,2977,322,3299,3608,421,4029
00890200,COLUMBIA CENTRO UNIVERSITARIO           ,PR,00726-0000,Proprietary  ,630,415,1045,830,582,1412
00965200,"UNIVERSITY OF PUERTO RICO, PONCE TECH UN",PR,00716-0000,Public       ,2188,245,2433,3157,382,3539
01056700,COLEGIO TECNOLOGICO DE SAN JUAN         ,PR,00918-2973,Public       ,482,470,952,518,532,1050
01072400,CARLOS ALBIZU UNIVERSITY                ,PR,00902-3711,Private      ,75,675,750,108,831,939
01081900,CONSERVATORIO DE MUSICA DE PUERTO RICO  ,PR,00907-3373,Public       ,220,53,273,287,74,361
01092200,UNIVERSITY OF PUERTO RICO - UTUADO      ,PR,00641-2500,Public       ,1073,124,1197,1348,167,1515
01097500,UNIVERSITY OF PUERTO RICO BAYAMON TECHNI,PR,00959-1911,Public       ,3081,307,3388,4272,481,4753
01120300,RYDER MEMORIAL HOSP SCH OF NURSING      ,PR,00792-0000,Private      ,10,8,18,12,15,27
01171900,UNIVERSIDAD DEL TURABO                  ,PR,00778-0000,Private      ,4941,3960,8901,6322,5153,11475
01194000,ICPR JUNIOR COLLEGE                     ,PR,00919-0000,Proprietary  ,667,663,1330,752,821,1573
01194100,AMERICAN UNIVERSITY OF PUERTO RICO      ,PR,00960-2037,Private      ,343,166,509,451,248,699
01194101,AMERICAN UNIVERSITY OF PUERTO RICO      ,PR,00674-0000,Private      ,305,160,465,472,247,719
01212300,"UNIVERSITY OF PUERTO RICO, AGUADILLA REG",PR,00604-0160,Public       ,1969,230,2199,2603,342,2945
01252500,CARIBBEAN UNIVERSITY                    ,PR,00960-0493,Private      ,1424,1182,2606,1673,1440,3113
02063100,MBTI BUSINESS TRNG INSTITUTE            ,PR,00907-3917,Proprietary  ,566,1417,1983,614,1696,2310
02100000,POLYTECHNIC UNIVERSITY OF PR            ,PR,00917-0000,Private      ,1363,1047,2410,1770,1384,3154
02163300,UNIVERSIDAD CENTRAL DEL CARIBE          ,PR,00960-0000,Private      ,90,166,256,144,239,383
02165100,EDP COLLEGE OF PUERTO RICO              ,PR,00919-0000,Private      ,529,671,1200,555,806,1361
02166000,CENTER FOR ADVANCED STUDIES OF PUER     ,PR,00902-0000,Private      ,1,37,38,3,76,79
02166400,INSTITUTO DE BANCA Y COMERCIO           ,PR,00925-0000,Proprietary  ,2836,3292,6128,3801,4802,8603
02170300,INST EDUC TECNIA OCUP LA REINA          ,PR,00674-0000,Proprietary  ,129,100,229,131,104,235
02189100,CENTRO DE ESTUDIOS MULTIDISCIPLIN       ,PR,00926-0000,Private      ,468,405,873,512,468,980
02189300,EMMA'S BEAUTY ACADEMY                   ,PR,00680-0000,Proprietary  ,132,50,182,137,55,192
02195400,MODERN HAIRSTYLING INSTITUTE            ,PR,00961-0000,Proprietary  ,244,135,379,253,142,395
02195500,MODERN HAIRSTYLING INSTITUTE            ,PR,00612-0000,Proprietary  ,2,2,4,2,4,6
02195800,LICEO E ARTE Y TECNOLGIA                ,PR,00919-0000,Proprietary  ,425,349,774,589,481,1070
02195900,MODERN HAIRSTYLING INSTITUTE            ,PR,00980-0000,Proprietary  ,3,3,6,5,6,11
02234900,ANTILLES SCHOOL OF TECH CAREERS         ,PR,00909-3006,Proprietary  ,116,154,270,126,167,293
02241901,COMMONWEALTH OF PR DEPT OF EDUC - CARLOS,PR,00986-0000,Public       ,8,2,10,10,5,15
02241902,COMMONWEALTH OF PR DEPT OF EDUC - TOMAS ,PR,00613-0000,Public       ,1,1,2,3,3,6
02241904,COMMONWEALTH OF PR DEPT OF EDUC - ITPR R,PR,00655-0000,Public       ,270,171,441,323,211,534
02241905,COMMONWEALTH OF PR DEPT OF EDUC - JOSE A,PR,00674-0000,Public       ,18,6,24,25,10,35
02241907,COMMONWEALTH OF PR DEPT OF EDUC - ITPR R,PR,00928-0000,Public       ,238,126,364,259,135,394
02241908,COMMONWEALTH OF PR DEPT OF EDUC - ITPR R,PR,00732-0000,Public       ,217,95,312,261,152,413
02241909,COMMONWEALTH OF PR DEPT OF EDUC - TROQUE,PR,00959-0000,Public       ,47,13,60,55,15,70
02241910,COMMONWEALTH OF PR DEPT OF EDUC - ITPR R,PR,00701-1091,Public       ,370,136,506,545,201,746
02260600,NATIONAL COLLEGE OF BUSINESS & TECH     ,PR,00960-2036,Proprietary  ,2232,3976,6208,3164,5837,9001
02260800,HUERTAS COLLEGE                         ,PR,00726-0000,Proprietary  ,449,334,783,516,417,933
02297700,AUTOMECA TECHNICAL COLLEGE              ,PR,00957-0000,Proprietary  ,479,241,720,531,300,831
02303800,AMERICAN EDUCATIONAL COLLEGE            ,PR,00961-0000,Proprietary  ,76,94,170,79,105,184
02335500,COLEGIO BIBLICO PENTECOSTAL DE PR       ,PR,00978-0000,Private      ,12,103,115,14,112,126
02340600,HUMACAO COMMUNITY COLLEGE               ,PR,00792-0000,Private      ,125,136,261,255,280,535
02343600,INSTITUTE OF BEAUTY CAREERS             ,PR,00613-0000,Proprietary  ,189,129,318,195,137,332
02460000,UNIVERSITY OF PUERTO RICO - MEDICAL SCIE,PR,00936-0000,Public       ,450,1024,1474,624,1181,1805
02482400,PONCE SCHOOL OF MEDICINE AND HEALTH SCIE,PR,00716-2347,Private      ,34,514,548,65,673,738
02502400,SERBIA'S SCHOOL OF BEAUTY CULTURE       ,PR,00785-0000,Proprietary  ,26,32,58,37,52,89
02504500,INSTITUCION CHAVIANO DE MAYAGUEZ        ,PR,00708-0000,Proprietary  ,3,3,6,4,4,8
02505400,ATLANTIC COLLEGE                        ,PR,00970-0000,Private      ,545,138,683,636,165,801
02534900,PONCE PARAMEDICAL COLLEGE (POPAC)       ,PR,00731-0000,Proprietary  ,584,397,981,635,441,1076
02552300,COLEGIO MAYOR DE TECHNOLOGIA            ,PR,00714-0000,Proprietary  ,81,73,154,93,93,186
02562500,INTERNATIONAL TECHNICAL COLLEGE         ,PR,00918-0000,Proprietary  ,22,38,60,25,44,69
02563500,ROGIES SCHOOL OF BEAUTY CULTURE         ,PR,00910-0000,Proprietary  ,2,2,4,3,4,7
02569400,ESCUELA DE ARTES PLASTICAS              ,PR,00902-1112,Public       ,318,89,407,428,122,550
02570400,EDUCATIONAL TECHNICAL COLLEGE           ,PR,00925-3404,Proprietary  ,228,303,531,241,318,559
02576100,ESCUELA TECNICA DE ELECTRICIDAD         ,PR,00731-0000,Proprietary  ,138,125,263,165,157,322
02587500,UNIVERSIDAD METROPOLITANA               ,PR,00928-0000,Private      ,3446,2843,6289,4527,3726,8253
02588600,SEMINARIO EVANGELICO DE PUERTO RICO     ,PR,00925-0000,Private      ,0,20,20,1,27,28
02593700,HISPANIC AMERICAN COLLEGE               ,PR,00725-0000,Proprietary  ,51,58,109,60,65,125
03016000,UNIVERSITY OF PUERTO RICO CAROLINA REGIO,PR,00985-0000,Public       ,2576,349,2925,3384,518,3902
03021900,EDIC COLLEGE                            ,PR,00726-0000,Proprietary  ,562,458,1020,594,485,1079
03025500,MECH TECH COLLEGE                       ,PR,00725-6118,Proprietary  ,1321,711,2032,1705,985,2690
03025900,"LICEO DE ARTE, DISENOS Y COMERCIO       ",PR,00726-0000,Proprietary  ,76,140,216,82,145,227
03029700,"UNIVERSAL TECHNOLOGY CLG OF PR, INC     ",PR,00605-0000,Private      ,184,264,448,325,484,809
03061900,COLEGIO TECHNOLOGICO Y COMERCIAL        ,PR,00602-0960,Proprietary  ,5,3,8,5,3,8
03068400,STAR BEAUTY ACADEMY                     ,PR,00961-6312,Proprietary  ,1,0,1,3,4,7
03070500,D'MART INSTITUTE                        ,PR,00794-3517,Proprietary  ,238,278,516,370,463,833
03075600,EMMA'S BEAUTY ACADEMY                   ,PR,00795-0000,Proprietary  ,136,48,184,140,53,193
03085700,PROFESSIONAL TECHNICAL INSTITUTION      ,PR,00960-7061,Proprietary  ,115,92,207,122,99,221
03104400,PROFESSIONAL ELECTRIC SCHOOL            ,PR,00674-1797,Proprietary  ,19,13,32,22,13,35
03106900,ESCUELA DE PERITOS ELECTRICITAS         ,PR,00662-0457,Proprietary  ,29,28,57,31,29,60
03112100,JOHN DEWEY COLLEGE                      ,PR,00915-9538,Private      ,584,1064,1648,676,1240,1916
03112101,JOHN DEWEY COLLEGE                      ,PR,00986-0000,Private      ,99,195,294,108,203,311
03112102,JOHN DEWEY COLLEGE-BAYAMON CAMPUS       ,PR,00959-0000,Private      ,61,95,156,64,104,168
03112104,JOHN DEWEY COLLEGE - YABUCOA LRNING SITE,PR,00767-0767,Private      ,1,2,3,1,2,3
03112105,JOHN DEWEY COLLEGE - FAJARDO BRANCH     ,PR,00738-0738,Private      ,56,82,138,87,176,263
03112106,JOHN DEWEY COLLEGE - ARROYO BRANCH      ,PR,00714-0714,Private      ,23,31,54,31,63,94
03112107,JOHN DEWEY COLLEGE - JUANA DIAZ BRANCH  ,PR,00795-0000,Private      ,101,94,195,149,158,307
03112108,JOHN DEWEY COLLEGE - HATILLO CAMPUS     ,PR,00659-0000,Private      ,30,65,95,31,67,98
03112109,JOHN DEWEY COLLEGE - MANATI             ,PR,00674-0000,Private      ,156,182,338,166,189,355
03112110,DEWEY UNIVERSITY - MAYAGUEZ             ,PR,00682-0000,Private      ,18,18,36,18,18,36
03115900,TRINITY COLLEGE OF PUERTO RICO          ,PR,00734-0000,Private      ,53,55,108,59,63,122
03122500,ACADEMIA SERRANT INC.                   ,PR,00717-1568,Proprietary  ,56,48,104,65,62,127
03123100,GLOBELLE TECHNICAL INSTITUTE            ,PR,00693-4218,Proprietary  ,43,33,76,44,34,78
03124200,NOVA COLLEGE DE PUERTO RICO             ,PR,00960-4016,Proprietary  ,56,79,135,60,92,152
03157600,"COLEGIO DE CINEMATOGRAFIA, ARTES Y TELEV",PR,00961-6345,Proprietary  ,309,140,449,336,159,495
03177300,SAN JUAN BAUTISTA SCH OF MEDICINE       ,PR,00726-0000,Private      ,17,146,163,24,293,317
03336300,CENTURY COLLEGE                         ,PR,00603-0000,Proprietary  ,59,71,130,66,80,146
03414300,MONTECLARO                              ,PR,00745-9612,Private      ,3,10,13,8,16,24
03452300,INSTITUTO PRE-VOCACIONAL E INDUSTRI     ,PR,00613-1800,Private      ,4,4,8,6,7,13
03469300,IVAEM COLLEGE                           ,PR,00725-0000,Proprietary  ,52,16,68,59,21,80
03531300,UNIVERSIDAD PENTECOSTAL MIZPA           ,PR,00928-0966,Private      ,23,169,192,26,193,219
03544300,ATENAS COLLEGE                          ,PR,00674-0000,Private      ,568,319,887,667,403,1070
03552300,LESTON COLLEGE                          ,PR,00961-6309,Proprietary  ,23,23,46,23,25,48
03608300,CARIBBEAN FORENSIC & TECHNICAL COLL     ,PR,00926-0000,Proprietary  ,10,12,22,13,18,31
03638300,ROSSLYN TRAINING ACADEMY OF COSMETOLOGY ,PR,00602-3225,Proprietary  ,3,15,18,3,15,18
03735400,"CHARLIES GUARD,DETECTIVE BUREAU&ACA     ",PR,00605-0000,Proprietary  ,2,3,5,6,4,10
03751300,ESCUELA HOTELERA DE SAN JUAN            ,PR,00917-0091,Proprietary  ,351,195,546,492,267,759
03758300,BAYAMON COMMUNITY COLLEGE               ,PR,00960-0000,Proprietary  ,15,47,62,19,50,69
03781400,INDUSTRIAL TECHNICAL COLLEGE            ,PR,00792-0000,Proprietary  ,51,93,144,51,95,146
03785300,J.G. GUAYNABO TECHNICAL COLLEGE         ,PR,00960-0000,Proprietary  ,15,40,55,15,43,58
03800300,COLEGIO TECNICO DE ELECTRICIDAD GALLOSA ,PR,00602-0000,Proprietary  ,2,0,2,3,1,4
03800400,INSTITUTE OF BEAUTY OCCUPATIONS AND TECH,PR,00676-5071,Proprietary  ,28,40,68,53,94,147
03843300,ADVANCED TECH COLLEGE                   ,PR,00961-6321,Proprietary  ,2,4,6,6,11,17
03849300,AGUADILLA TECHNICAL COLLEGE             ,PR,00603-0000,Proprietary  ,24,30,54,30,34,64
03965400,MYRANGEL BEAUTY INSTITUTE               ,PR,00754-3917,Proprietary  ,31,47,78,32,48,80
04107300,CARIB TECHNOLOGICAL INSTITUTE           ,PR,00960-0000,Proprietary  ,57,45,102,58,47,105
04117200,INSTITUTO EDUCATIVO PREMIER             ,PR,00731-0000,Proprietary  ,86,77,163,94,83,177
04131600,LIBERTY TECHNICAL COLLEGE               ,PR,00737-1298,Proprietary  ,25,43,68,27,50,77
04164300,GLOBAL INSTITUTE                        ,PR,00725-6485,Proprietary  ,4,2,6,4,3,7
04176000,AMERICAN TECHNICAL INSTITUTE            ,PR,00957-0000,Proprietary  ,15,22,37,19,29,48
00394600,UNIVERSITY OF THE VIRGIN ISLANDS        ,VI,00802-9990,Public       ,302,232,534,1029,566,1595
00394601,UNIV OF THE VIRGIN ISLANDS-ST CROIX     ,VI,00850-0000,Public       ,154,252,406,420,515,935
00667700,MCGILL UNIVERSITY                       ,CN,00000-0000,Public       ,228,110,338,1442,332,1774
00667900,QUEEN'S UNIVERSITY AT KINGSTON          ,CN,00000-0000,Public       ,16,11,27,80,29,109
00668100,ST FRANCIS XAVIER UNIVERSITY            ,CN,00000-0000,Public       ,4,1,5,30,4,34
00668200,ST THOMAS UNIVERSITY                    ,CN,00000-0000,Public       ,8,1,9,29,2,31
00668300,UNIVERSITY OF GUELPH                    ,CN,00000-0000,Public       ,6,20,26,32,56,88
00668400,UNIVERSITY OF MANITOBA                  ,CN,00000-0000,Public       ,19,14,33,66,36,102
00668500,UNIVERSITY OF NEW BRUNSWICK (THE)       ,CN,00000-0000,Public       ,5,3,8,29,9,38
00668600,UNIVERSITY OF OTTAWA                    ,CN,00000-0000,Public       ,9,25,34,51,53,104
00668800,UNIVERSITY OF TORONTO                   ,CN,00000-0000,Public       ,71,84,155,428,303,731
00668900,UNIVERSITY OF WINDSOR                   ,CN,00000-0000,Public       ,9,8,17,26,29,55
00683700,UNIVERSITE LAVAL                        ,CN,00000-0000,Public       ,3,4,7,7,23,30
00683800,DALHOUSIE UNIVERSITY                    ,CN,00000-0000,Public       ,20,22,42,104,62,166
00683805,DALHOUSIE UNIVERSITY - AGRICULTURAL CAMP,CN,00000-0000,Public       ,1,0,1,4,2,6
00685200,BISHOP'S UNIVERSITY                     ,CN,00000-0000,Private      ,7,2,9,50,4,54
00685300,MCMASTER UNIVERSITY                     ,CN,00000-0000,Public       ,4,10,14,34,28,62
00767900,YORK UNIVERSITY                         ,CN,00000-0000,Public       ,20,24,44,70,66,136
00787400,UNIVERSITY AT CALGARY (THE)             ,CN,00000-0000,Public       ,8,13,21,38,51,89
00814800,UNIVERSITY OF WINNIPEG                  ,CN,00000-0000,Public       ,4,4,8,22,12,34
00836200,UNIVERSITY OF ALBERTA (THE)             ,CN,00000-0000,Public       ,0,0,0,31,12,43
00836300,MOUNT SAINT VINCENT UNIVERSITY          ,CN,00000-0000,Public       ,3,0,3,5,3,8
00836400,SAINT MARY'S UNIVERSITY                 ,CN,00000-0000,Public       ,6,4,10,23,12,35
00836500,CONCORDIA UNIVERSITY - SIR GEORGE W     ,CN,00000-0000,Public       ,58,54,112,263,128,391
00836600,UNIVERSITE DE MONTREAL                  ,CN,00000-0000,Public       ,7,23,30,23,51,74
00836800,CARLETON UNIVERSITY                     ,CN,00000-0000,Public       ,20,16,36,57,41,98
00836900,UNIVERSITY OF BRITISH COLUMBIA          ,CN,00000-0000,Public       ,82,118,200,800,415,1215
00837000,"SAFA, UNIVERSITY OF VICTORIA            ",CN,00000-0000,Public       ,14,26,40,143,60,203
00844400,SIMON FRASER UNIVERSITY                 ,CN,00000-0000,Public       ,29,31,60,134,80,214
00844600,UNIVERSITY OF WESTERN ONTARIO (THE)     ,CN,00000-0000,Public       ,8,20,28,51,51,102
00844800,UNIVERSITY OF REGINA                    ,CN,00000-0000,Public       ,2,0,2,6,3,9
00844900,ACADIA UNIVERSITY                       ,CN,00000-0000,Public       ,9,6,15,43,14,57
00852600,UNIVERSITY OF WATERLOO                  ,CN,00000-0000,Public       ,7,3,10,65,20,85
00858200,WILFRID LAURIER UNIVERSITY              ,CN,00000-0000,Public       ,3,4,7,11,11,22
00891300,LAKEHEAD UNIVERSITY                     ,CN,00000-0000,Public       ,2,4,6,9,7,16
00936700,UNIVERSITY OF PRINCE EDWARD ISLAND      ,CN,00000-0000,Public       ,9,29,38,23,86,109
00942100,BRANDON UNIVERSITY                      ,CN,00000-0000,Public       ,1,7,8,5,18,23
00948600,TRINITY WESTERN UNIVERSITY              ,CN,00000-0000,Private      ,11,14,25,102,35,137
00950000,MEMORIAL UNIVERSITY OF NEWFOUNDLAND     ,CN,00000-0000,Public       ,8,14,22,29,32,61
00950100,UNIVERSITY OF KING'S COLLEGE            ,CN,00000-0000,Public       ,7,2,9,14,2,16
00950300,MOUNT ALLISON UNIVERSITY                ,CN,00000-0000,Public       ,13,1,14,33,1,34
00950500,TRENT UNIVERSITY                        ,CN,00000-0000,Public       ,4,2,6,8,4,12
00969800,MEDICINE HAT COLLEGE                    ,CN,00000-0000,Public       ,2,0,2,4,1,5
01012300,NOVA SCOTIA COLLEGE OF ART & DESIGN     ,CN,00000-0000,Public       ,1,0,1,11,4,15
01022100,SAINT PAUL UNIVERSITY                   ,CN,00000-0000,Public       ,1,3,4,1,10,11
01045800,SHERIDAN COLLEGE OF APPLIED ARTS AN     ,CN,00000-0000,Public       ,14,8,22,69,24,93
01067500,REGENT COLLEGE                          ,CN,00000-0000,Private      ,1,25,26,5,53,58
01070300,UNIVERSITY OF LETHBRIDGE                ,CN,00000-0000,Public       ,1,1,2,8,3,11
01072000,RYERSON UNIVERSITY                      ,CN,00000-0000,Public       ,14,12,26,62,40,102
01172200,BRIERCREST BIBLE COLLEGE                ,CN,00000-0000,Private      ,4,3,7,6,4,10
01222800,HUMBER COLLEGE                          ,CN,00000-0000,Public       ,11,17,28,35,39,74
01227400,PROVIDENCE COLLEGE                      ,CN,00000-0000,Private      ,6,2,8,23,5,28
02102100,KINGSWOOD UNIVERSITY                    ,CN,00000-0000,Private      ,14,3,17,33,7,40
02167000,PRAIRIE BIBLE INST                      ,CN,00000-0000,Private      ,9,0,9,19,3,22
02184600,INSTITUTE FOR CHRISTIAN STUDIES         ,CN,00000-0000,Private      ,0,2,2,2,4,6
02195700,TAYLOR UNIVERSITY COLLEGE AND SEMINARY  ,CN,00000-0000,Private      ,0,0,0,0,2,2
02201100,COLUMBIA BIBLE COLLEGE                  ,CN,00000-0000,Private      ,6,6,12,10,8,18
02216400,TYNDALE COLLEGE & SEMINARY              ,CN,00000-0000,Private      ,2,6,8,7,9,16
02219200,UNIVERSITY OF SASKATCHEWAN              ,CN,00000-0000,Public       ,4,6,10,20,13,33
02324900,EMMANUEL BIBLE COLLEGE                  ,CN,00000-0000,Private      ,0,1,1,1,2,3
02338800,EMILY CARR UNIVERSITY OF ART AND DESIGN ,CN,00000-0000,Public       ,8,9,17,40,26,66
02577200,SALVATION ARMY WM & CATHERINE BOOTH     ,CN,00000-0000,Private      ,0,0,0,1,1,2
02593800,CONCORDIA UNIVERSITY COLLEGE            ,CN,00000-0000,Private      ,1,4,5,4,10,14
02611900,THE KING'S UNIVERSITY COLLEGE           ,CN,00000-0000,Private      ,1,1,2,2,2,4
03018300,ROCKY MOUNTAIN COLLEGE: CENTRE FOR BIBLI,CN,00000-0000,Private      ,0,2,2,0,2,2
03033800,UNIVERSITY COLLEGE OF CAPE BRETON       ,CN,00000-0000,Public       ,1,1,2,3,5,8
03078300,VANCOUVER SCHOOL OF THEOLOGY            ,CN,00000-0000,Private      ,0,1,1,3,8,11
03273300,CANADIAN COLLEGE OF NATUROPATHIC ME     ,CN,00000-0000,Private      ,1,17,18,7,28,35
03298300,ALBERTA COLLEGE OF ART & DESIGN         ,CN,00000-0000,Public       ,9,12,21,35,19,54
03332500,KWANTLEN UNIVERSITY COLLEGE             ,CN,00000-0000,Public       ,1,7,8,6,12,18
03335400,CANADIAN UNIVERSITY COLLEGE             ,CN,00000-0000,Private      ,6,6,12,22,11,33
03339300,ST. STEPHENS UNIVERSITY                 ,CN,00000-0000,Private      ,0,0,0,3,0,3
03348500,REDEEMER UNIVERSITY COLLEGE             ,CN,00000-0000,Private      ,2,1,3,7,1,8
03420300,HOLLAND COLLEGE                         ,CN,00000-0000,Public       ,3,4,7,13,8,21
03560400,NIAGARA COLLEGE-WELLAND CAMPUS          ,CN,00000-0000,Public       ,3,6,9,8,9,17
03613300,UNIV OF NORTHERN BRITISH COLUMBIA       ,CN,00000-0000,Public       ,4,2,6,7,11,18
03644400,CANADIAN MENNONITE UNIVERSITY           ,CN,00000-0000,Private      ,3,0,3,7,2,9
03674400,CANADIAN SOUTHERN BAPTIST SEMINARY      ,CN,00000-0000,Private      ,0,3,3,0,3,3
03711300,CAPILANO UNIVERSITY                     ,CN,00000-0000,Public       ,5,6,11,18,18,36
03846300,PACIFIC LIFE BIBLE COLLEGE              ,CN,00000-0000,Private      ,4,4,8,9,5,14
03847300,CRANDALL UNIVERSITY                     ,CN,00000-0000,Private      ,1,0,1,2,0,2
04075300,QUEST UNIVERSITY CANADA                 ,CN,00000-0000,Private      ,45,6,51,179,16,195
04123100,ATLANTIC SCHOOL OF THEOLOGY             ,CN,00000-0000,Public       ,0,1,1,1,4,5
04156700,AMBROSE UNIVERSITY COLLEGE              ,CN,00000-0000,Private      ,1,4,5,9,8,17
00814700,UNIVERSIDAD AUTONOMA DE GUADALAJARA     ,MX,00000-0000,Private      ,21,545,566,68,911,979
01041800,INST TEC Y DE ESTSUPER DE MONTERRE      ,MX,00000-0000,Private      ,37,15,52,85,54,139
01067600,UNIVERSIDAD DE MONTERREY                ,MX,00000-0000,Private      ,11,8,19,33,22,55
01093800,UNIVERSIDAD DE GUANAJUATO               ,MX,00000-0000,Public       ,1,8,9,15,27,42
01230100,UNIV AUTON DE TAMAULIPAS FAC DEMED      ,MX,00000-0000,Public       ,1,1,2,4,5,9
02053300,CENTRO DE ESTUDIOS UNIVERSITARIOS D     ,MX,00000-0000,Private      ,6,12,18,15,40,55
04183900,CETYS UNIVERSIDAD                       ,MX,00000-0000,Private      ,25,25,50,80,47,127
01001000,AMERICAN SAMOA CMNTY COLLEGE            ,AS,96799-2609,Public       ,201,78,279,349,159,508
01034300,COLLEGE OF MICRONESIA - FSM             ,FM,96941-0159,Public       ,445,88,533,652,154,806
01100900,PALAU COMMUNITY COLLEGE                 ,PW,96940-0009,Public       ,254,108,362,508,193,701
03022400,COLLEGE OF THE MARSHALL ISLANDS         ,MH,96960-1258,Public       ,104,89,193,137,104,241
03033000,NORTHERN MARIANAS COLLEGE               ,MP,96950-0000,Public       ,408,201,609,523,275,798
