OPE ID,School,State,Zip Code,School Type,20142015Qtr4_Dependent Students,20142015Qtr4_Independent Students,Quarterly Total,YTD_20142015Qtr4_Dependent Students,YTD_20142015Qtr4_Independent Students,Award Year To Date Total
00100200,ALABAMA AGRCLTL & MECHL UNIV            ,AL,35762-1357,Public       ,204,228,432,6574,3739,10313
00100300,FAULKNER UNIVERSITY                     ,AL,36109-3398,Private      ,134,398,532,2319,4201,6520
00100400,UNIVERSITY OF MONTEVALLO                ,AL,35115-6000,Public       ,120,113,233,2636,1492,4128
00100500,ALABAMA STATE UNIVERSITY                ,AL,36101-0000,Public       ,422,467,889,9790,5639,15429
00100700,CENTRAL ALABAMA COMMUNITY COLLEGE       ,AL,35011-0000,Public       ,96,178,274,1444,1699,3143
00100800,ATHENS STATE UNIVERSITY                 ,AL,35611-1999,Public       ,60,276,336,1002,3395,4397
00100900,AUBURN UNIVERSITY                       ,AL,36849-5113,Public       ,996,524,1520,19906,7121,27027
00101200,BIRMINGHAM SOUTHERN COLLEGE             ,AL,35254-0002,Private      ,93,91,184,2082,786,2868
00101300,CALHOUN COMMUNITY COLLEGE               ,AL,35609-0000,Public       ,400,884,1284,5348,7847,13195
00101500,ENTERPRISE STATE COMMUNITY COLLEGE      ,AL,36331-1300,Public       ,79,181,260,1314,1558,2872
00101600,UNIVERSITY OF NORTH ALABAMA             ,AL,35632-0001,Public       ,457,277,734,5564,3005,8569
00101700,GADSDEN STATE COMMUNITY COLLEGE         ,AL,35903-2269,Public       ,193,621,814,3273,5317,8590
00101800,GEORGE C WALLACE COMMUNITY COLLEGE      ,AL,36303-0943,Public       ,167,521,688,2570,4328,6898
00101900,HUNTINGDON COLLEGE                      ,AL,36106-2148,Private      ,68,100,168,1565,882,2447
00102000,JACKSONVILLE STATE UNIVERSITY           ,AL,36265-1602,Public       ,281,392,673,7200,5552,12752
00102100,JEFFERSON DAVIS COMMUNITY COLLEGE       ,AL,36427-2790,Public       ,38,103,141,594,922,1516
00102200,JEFFERSON STATE COMMUNITY COLLEGE       ,AL,35215-3098,Public       ,351,955,1306,5207,8496,13703
00102300,JUDSON COLLEGE                          ,AL,36756-2504,Private      ,15,40,55,339,231,570
00102400,UNIVERSITY OF WEST ALABAMA              ,AL,35470-0000,Public       ,114,389,503,2623,4324,6947
00102600,MARION MILITARY INSTITUTE               ,AL,36756-3214,Public       ,37,6,43,623,104,727
00102800,MILES COLLEGE                           ,AL,35064-2697,Private      ,88,101,189,2733,1406,4139
00102900,UNIVERSITY OF MOBILE                    ,AL,36613-0000,Private      ,108,236,344,2042,2106,4148
00103000,BISHOP STATE COMMUNITY COLLEGE          ,AL,36603-5898,Public       ,222,662,884,2697,4967,7664
00103100,NORTHEAST ALABAMA STATE CMNTY COLG      ,AL,35986-0159,Public       ,110,216,326,1388,1758,3146
00103300,OAKWOOD COLLEGE                         ,AL,35896-0001,Private      ,62,84,146,1992,1129,3121
00103400,ALABAMA SOUTHERN COMMUNITY COLLEGE      ,AL,36460-5698,Public       ,62,111,173,1151,978,2129
00103600,SAMFORD UNIVERSITY                      ,AL,35229-7000,Private      ,199,266,465,3971,3148,7119
00103800,SNEAD STATE COMMUNITY COLLEGE           ,AL,35957-0734,Public       ,111,204,315,1759,1826,3585
00104000,SOUTHERN UNION STATE COMMUNITY CLG      ,AL,36276-0000,Public       ,235,335,570,3704,3360,7064
00104100,SPRING HILL COLLEGE                     ,AL,36608-1791,Private      ,116,109,225,2607,971,3578
00104400,STILLMAN COLLEGE                        ,AL,35403-0000,Private      ,80,85,165,2004,806,2810
00104600,TALLADEGA COLLEGE                       ,AL,35160-2354,Private      ,23,34,57,1271,559,1830
00104700,TROY UNIVERSITY                         ,AL,36082-0001,Public       ,553,1694,2247,9296,19008,28304
00105000,TUSKEGEE UNIVERSITY                     ,AL,36088-1645,Private      ,153,80,233,5158,1504,6662
00105100,UNIVERSITY OF ALABAMA (THE)             ,AL,35487-0120,Public       ,1297,935,2232,29094,11841,40935
00105200,UNIVERSITY OF ALABAMA AT BIRMINGHAM     ,AL,35294-1150,Public       ,652,1155,1807,12482,13690,26172
00105500,UNIVERSITY OF ALABAMA IN HUNTSVILLE     ,AL,35899-0001,Public       ,328,401,729,5329,4818,10147
00105700,UNIVERSITY OF SOUTH ALABAMA             ,AL,36688-0002,Public       ,609,1015,1624,11460,11154,22614
00105900,LAWSON STATE COMMUNITY COLLEGE          ,AL,35221-1798,Public       ,119,387,506,2459,3746,6205
00105901,LAWSON STATE COMMUNITY COLLEGE - BESSEME,AL,35021-0308,Public       ,36,146,182,847,1535,2382
00106000,FAULKNER STATE COMMUNITY COLLEGE        ,AL,36507-2698,Public       ,289,425,714,3771,3853,7624
00526000,J.F. DRAKE STATE TECH COLLEGE           ,AL,35811-1584,Public       ,57,317,374,719,2175,2894
00569100,SHELTON STATE COMMUNITY CLG             ,AL,35405-4017,Public       ,281,468,749,4235,3949,8184
00569200,REID STATE TECHNICAL COLLEGE            ,AL,36401-0000,Public       ,21,100,121,288,684,972
00569700,NORTHWEST- SHOALS COMMUNITY COLLEGE     ,AL,35661-0000,Public       ,487,356,843,2716,2589,5305
00569900,GEORGE C WALLACE STATE CMTY COLLEGE     ,AL,36703-0000,Public       ,61,195,256,1310,1758,3068
00573300,BEVILL STATE CMTY COLLEGE-WALKER        ,AL,35148-0000,Public       ,136,395,531,2352,3146,5498
00573400,H. COUNCILL TRENHOLM STATE TECH COLLEGE ,AL,36108-0020,Public       ,91,280,371,913,2049,2962
00573401,H. C. TRENHOLM ST TECH COL-PATTERSON CAM,AL,36116-2612,Public       ,47,171,218,558,1236,1794
00787100,GEORGE C WALLACE STATE CMTY CLG         ,AL,35077-2000,Public       ,280,464,744,3783,4212,7995
00831000,AUBURN UNIVERSITY-MONTGOMERY            ,AL,36124-0000,Public       ,237,399,636,4805,4773,9578
00898800,LURLEEN B WALLACE COMMUNITY COLLEGE     ,AL,36420-0418,Public       ,46,150,196,1146,1189,2335
01055400,CONCORDIA COLLEGE                       ,AL,36701-3323,Private      ,21,49,70,769,479,1248
01218200,CHATTAHOOCHEE VALLEY CMTY CLG           ,AL,36869-7917,Public       ,75,228,303,1238,2269,3507
01303906,SOUTH UNIVERSITY - MONTGOMERY           ,AL,36116-1120,Proprietary  ,53,270,323,426,1744,2170
02170600,UNITED STATES SPORTS ACADEMY            ,AL,36526-7055,Private      ,6,88,94,44,751,795
02199700,HERITAGE CHRISTIAN UNIVERSITY           ,AL,35630-0000,Private      ,3,16,19,30,88,118
02270400,SOUTHEASTERN BIBLE COLLEGE              ,AL,35244-2083,Private      ,10,26,36,119,292,411
02285000,PAUL MITCHELL THE SCHOOL HUNTSVILLE     ,AL,35758-0000,Proprietary  ,10,32,42,110,185,295
02296000,PRINCE INSTITUTE OF PROFESSIONAL STUDIES,AL,36117-0000,Proprietary  ,2,14,16,46,277,323
02341000,FORTIS COLLEGE                          ,AL,36609-0000,Proprietary  ,62,347,409,687,2435,3122
02503400,AMRIDGE UNIVERSITY                      ,AL,36124-0000,Private      ,10,123,133,118,1180,1298
03010600,VIRGINIA COLLEGE                        ,AL,35209-5154,Proprietary  ,566,2723,3289,4165,21680,25845
03010602,VIRGINIA COLLEGE - HUNTSVILLE           ,AL,35801-5608,Proprietary  ,26,138,164,224,930,1154
03010607,VIRGINIA COLLEGE - MOBILE               ,AL,36608-1626,Proprietary  ,16,95,111,263,877,1140
03010616,VIRGINIA COLLEGE - MONTGOMERY           ,AL,36117-2802,Proprietary  ,32,138,170,399,1422,1821
03026516,REMINGTON COLLEGE - MOBILE              ,AL,36609-5593,Private      ,27,84,111,291,692,983
03032500,ALABAMA STATE CLG BARBER STYLING        ,AL,35215-0000,Proprietary  ,9,34,43,111,176,287
03361400,FORTIS COLLEGE                          ,AL,36535-0000,Proprietary  ,12,97,109,138,611,749
03459300,SOUTHEASTERN SCHOOL OF COSMETOLOGY      ,AL,35228-0000,Private      ,2,31,33,39,154,193
03783300,BLUE CLIFF CAREER COLLEGE               ,AL,63306-4749,Proprietary  ,16,53,69,121,347,468
03894300,HUNTSVILLE BIBLE COLLEGE                ,AL,35811-0000,Private      ,2,24,26,26,255,281
04066300,CARDIAC AND VASCULAR INSTITUTE OF ULTRAS,AL,36604-1411,Proprietary  ,2,33,35,71,303,374
04067300,SELMA UNIVERSITY                        ,AL,36701-0000,Private      ,5,49,54,254,590,844
04121500,COLUMBIA SOUTHERN UNIVERSITY            ,AL,36561-3815,Proprietary  ,58,1965,2023,592,17226,17818
04149200,XCELL ACADEMY-A PAUL MITCHELL PARTNER SC,AL,35216-4990,Proprietary  ,12,26,38,124,262,386
04187200,NEW BEGINNING COLLEGE OF COSMETOLOGY    ,AL,35950-2415,Proprietary  ,8,20,28,94,150,244
04187300,HAIR ACADEMY (THE)                      ,AL,36111-2201,Proprietary  ,7,21,28,57,133,190
04197500,UNIVERSITY ACADEMY OF HAIR DESIGN       ,AL,35476-3100,Proprietary  ,2,6,8,48,72,120
04211000,SALON PROFESSIONAL ACADEMY (THE)        ,AL,35816-1849,Proprietary  ,8,16,24,68,157,225
04217900,NUNATION SCHOOL OF COSMETOLOGY          ,AL,35064-2222,Proprietary  ,1,6,7,6,46,52
04226700,ALABAMA COLLEGE OF OSTEOPATHIC MEDICINE ,AL,36303-2251,Private      ,2,20,22,13,364,377
00111100,ALLAN HANCOCK COLLEGE                   ,CA,93454-6399,Public       ,280,720,1000,5292,5939,11231
00111300,ANTELOPE VALLEY COLLEGE                 ,CA,93536-5426,Public       ,540,1208,1748,7969,12446,20415
00111600,ART CENTER COLLEGE OF DESIGN            ,CA,91103-1999,Private      ,121,124,245,2036,1626,3662
00111700,AZUSA PACIFIC UNIVERSITY                ,CA,91702-7000,Private      ,309,799,1108,10460,9802,20262
00111800,BAKERSFIELD COLLEGE                     ,CA,93305-1299,Public       ,581,1335,1916,11798,12036,23834
00111900,BARSTOW COMMUNITY COLLEGE               ,CA,92311-6608,Public       ,96,538,634,1570,4392,5962
00112000,AMER BAPT SEM OF THE WEST-BERKELEY      ,CA,94704-0000,Private      ,1,6,7,13,67,80
00112200,BIOLA UNIVERSITY                        ,CA,90639-0001,Private      ,164,143,307,6613,2423,9036
00112300,BROOKS INSTITUTE                        ,CA,93103-1809,Proprietary  ,27,29,56,510,351,861
00112400,CABRILLO COLLEGE                        ,CA,95003-3194,Public       ,307,614,921,5372,5702,11074
00112500,CALIFORNIA BAPTIST UNIVERSITY           ,CA,92504-3297,Private      ,213,506,719,7921,6643,14564
00112700,CALIFORNIA COLLEGE OF THE ARTS          ,CA,94107-2206,Private      ,115,123,238,2498,1831,4329
00113100,CALIFORNIA INSTITUTE OF TECHNOLOGY      ,CA,91125-0001,Private      ,184,48,232,4023,732,4755
00113200,CALIFORNIA INSTITUTE OF THE ARTS        ,CA,91355-2397,Private      ,167,92,259,2853,1685,4538
00113300,CALIFORNIA LUTHERAN UNIVERSITY          ,CA,91360-2787,Private      ,118,130,248,5355,1879,7234
00113400,CALIFORNIA MARITIME ACADEMY             ,CA,94590-8181,Public       ,32,29,61,1233,449,1682
00113700,CALIF STATE UNIV-FULLERTON              ,CA,92831-3599,Public       ,1269,1145,2414,51907,24996,76903
00113800,"CALIFORNIA STATE UNIVERSITY, EAST BAY   ",CA,94542-3000,Public       ,437,743,1180,18215,14815,33030
00113900,CALIF STATE UNIV-LONG BEACH             ,CA,90840-0006,Public       ,1662,1314,2976,61063,27384,88447
00114000,CALIF STATE UNIV-LOS ANGELES            ,CA,90032-4226,Public       ,929,1154,2083,39249,24844,64093
00114100,"CALIF STATE UNIV, DOMINGUEZ HILLS       ",CA,90747-0001,Public       ,384,709,1093,19828,16950,36778
00114200,CALIF STATE UNIV SAN BERNARDINO         ,CA,92407-2397,Public       ,479,690,1169,22781,15070,37851
00114300,CAL POLY STATE UNIVERSITY               ,CA,93407-0001,Public       ,978,284,1262,41719,5161,46880
00114400,CALIF STATE POLYTECHNIC UNIV POMONA     ,CA,91768-2500,Public       ,791,517,1308,38003,12877,50880
00114600,CALIF STATE UNIV - CHICO                ,CA,95929-0001,Public       ,715,406,1121,25106,7905,33011
00114700,CALIF STATE UNIV - FRESNO               ,CA,93740-8026,Public       ,709,702,1411,28412,14091,42503
00114900,HUMBOLDT STATE UNIVERSITY               ,CA,95521-8299,Public       ,380,204,584,14062,4793,18855
00115000,CALIF STATE UNIV-SACRAMENTO             ,CA,95819-6044,Public       ,892,1059,1951,35349,21625,56974
00115100,SAN DIEGO STATE UNIVERSITY              ,CA,92182-1690,Public       ,1655,1262,2917,60659,23257,83916
00115300,CALIF STATE UNIV-NORTHRIDGE             ,CA,91330-8307,Public       ,985,1038,2023,47860,24540,72400
00115400,SAN FRANCISCO STATE UNIVERSITY          ,CA,94132-1740,Public       ,1009,990,1999,38602,19530,58132
00115500,SAN JOSE STATE UNIVERSITY               ,CA,95192-0036,Public       ,855,859,1714,36024,18425,54449
00115600,SONOMA STATE UNIVERSITY                 ,CA,94928-3609,Public       ,339,223,562,14331,3991,18322
00115700,CALIF STATE UNIV-STANISLAUS             ,CA,95382-0299,Public       ,230,345,575,10826,6708,17534
00116100,CERRITOS COLLEGE                        ,CA,90650-6296,Public       ,701,1310,2011,18408,14925,33333
00116200,CHABOT COLLEGE                          ,CA,94545-2400,Public       ,348,792,1140,6842,7658,14500
00116300,CHAFFEY COLLEGE                         ,CA,91737-9400,Public       ,723,1482,2205,16249,16259,32508
00116400,CHAPMAN UNIVERSITY                      ,CA,92866-1099,Private      ,359,160,519,12383,3671,16054
00116453,CHAPMAN UNIVERSITY DALE E. FOWLER SCHOOL,CA,92866-0000,Private      ,2,25,27,77,1224,1301
00116500,CHURCH DIV SCH OF THE PACIFIC           ,CA,94709-0000,Private      ,0,8,8,4,70,74
00116600,CITRUS COLLEGE                          ,CA,91741-1899,Public       ,392,598,990,11015,8199,19214
00116900,CLAREMONT GRADUATE UNIVERSITY           ,CA,91711-0000,Private      ,2,80,82,38,1902,1940
00117000,CLAREMONT MCKENNA COLLEGE               ,CA,91711-6400,Private      ,125,14,139,3621,216,3837
00117100,HARVEY MUDD COLLEGE                     ,CA,91711-5990,Private      ,49,8,57,2661,115,2776
00117200,PITZER COLLEGE                          ,CA,91711-6101,Private      ,106,13,119,2985,209,3194
00117300,POMONA COLLEGE                          ,CA,91711-6301,Private      ,151,26,177,5122,299,5421
00117400,SCRIPPS COLLEGE                         ,CA,91711-3948,Private      ,50,16,66,2174,186,2360
00117600,WEST HILLS COMMUNITY COLLEGE            ,CA,93210-1399,Public       ,72,106,178,1528,1344,2872
00117700,COGSWELL POLYTECHNICAL COLLEGE          ,CA,94089-1210,Proprietary  ,25,16,41,596,274,870
00117800,COLLEGE OF MARIN                        ,CA,94904-2590,Public       ,58,185,243,1304,2235,3539
00117801,COLG OF MARIN-INDIAN VALLEY CMPS        ,CA,94949-0000,Public       ,22,66,88,390,707,1097
00117900,NOTRE DAME DE NAMUR UNIVERSITY          ,CA,94002-1997,Private      ,33,80,113,1801,1458,3259
00118100,COLLEGE OF SAN MATEO                    ,CA,94402-3784,Public       ,179,312,491,4006,3254,7260
00118200,COLLEGE OF THE DESERT                   ,CA,92260-9305,Public       ,281,620,901,6342,6729,13071
00118300,HOLY NAMES UNIVERSITY                   ,CA,94619-1699,Private      ,32,72,104,983,1137,2120
00118500,COLLEGE OF THE REDWOODS                 ,CA,95501-9300,Public       ,180,456,636,2843,3885,6728
00118600,COLLEGE OF THE SEQUOIAS                 ,CA,93277-2234,Public       ,410,951,1361,7196,7618,14814
00118700,COLLEGE OF THE SISKIYOUS                ,CA,96094-2899,Public       ,54,115,169,1073,1153,2226
00118701,COLLEGE OF THE SISKIYOUS - YREKA CENTER ,CA,96097-9538,Public       ,10,34,44,154,386,540
00119000,CONTRA COSTA COLLEGE                    ,CA,94806-3195,Public       ,130,344,474,2684,3838,6522
00119100,DIABLO VALLEY COLLEGE                   ,CA,94523-1544,Public       ,397,695,1092,7119,6640,13759
00119200,CUESTA COLLEGE                          ,CA,93403-8106,Public       ,256,549,805,4909,4386,9295
00119300,CYPRESS COLLEGE                         ,CA,90630-5897,Public       ,456,930,1386,12342,9643,21985
00119600,DOMINICAN UNIVERSITY OF CALIFORNIA      ,CA,94901-2298,Private      ,56,75,131,2809,1312,4121
00119700,EL CAMINO COLLEGE                       ,CA,90506-0002,Public       ,694,1246,1940,16496,14065,30561
00119701,COMPTON COMMUNITY COLLEGE               ,CA,90221-5393,Public       ,160,493,653,4140,6190,10330
00119900,FOOTHILL COLLEGE                        ,CA,94022-4597,Public       ,186,401,587,4468,5233,9701
00120000,FULLER THEOLOGICAL SEMINARY             ,CA,91182-0000,Private      ,2,119,121,17,2173,2190
00120100,FULLERTON COLLEGE                       ,CA,92832-2095,Public       ,678,1116,1794,16747,11357,28104
00120200,GAVILAN COLLEGE                         ,CA,95020-9599,Public       ,125,246,371,2309,2212,4521
00120300,GLENDALE COMMUNITY COLLEGE              ,CA,91208-2894,Public       ,358,746,1104,10665,9821,20486
00120500,GOLDEN GATE UNIVERSITY                  ,CA,94105-2967,Private      ,12,222,234,222,3045,3267
00120600,GOLDEN WEST COLLEGE                     ,CA,92647-2748,Public       ,428,817,1245,10124,8651,18775
00120700,GRADUATE THEOLOGICAL UNION              ,CA,94709-0000,Private      ,0,10,10,3,270,273
00120800,GROSSMONT COLLEGE                       ,CA,92020-1799,Public       ,609,1367,1976,10942,12300,23242
00120900,HARTNELL COMMUNITY COLLEGE              ,CA,93901-1697,Public       ,250,379,629,4631,3584,8215
00121200,HUMPHREYS COLLEGE                       ,CA,95207-3896,Private      ,20,100,120,352,1178,1530
00121400,IMPERIAL VALLEY COLLEGE                 ,CA,92251-9787,Public       ,222,446,668,4974,4300,9274
00121500,LA SIERRA UNIVERSITY                    ,CA,92515-3332,Private      ,78,131,209,3881,1698,5579
00121600,UNIVERSITY OF LA VERNE                  ,CA,91750-4443,Private      ,162,490,652,6324,7302,13626
00121700,LASSEN COLLEGE                          ,CA,96130-3000,Public       ,35,86,121,614,699,1313
00121800,LOMA LINDA UNIVERSITY                   ,CA,92350-0001,Private      ,39,213,252,1383,6224,7607
00121900,LONG BEACH CITY COLLEGE                 ,CA,90808-1780,Public       ,679,1444,2123,19586,17122,36708
00122000,MASTER'S COLLEGE & SEMINARY (THE)       ,CA,91321-1200,Private      ,38,35,73,1376,495,1871
00122300,LOS ANGELES CITY COLLEGE                ,CA,90029-3588,Public       ,533,1533,2066,11497,17824,29321
00122400,LOS ANGELES HARBOR COLLEGE              ,CA,90744-2397,Public       ,238,498,736,5035,5871,10906
00122600,LOS ANGELES PIERCE COLLEGE              ,CA,91371-0001,Public       ,538,1069,1607,14261,12973,27234
00122700,LOS ANGELES TRADE TECH COLLEGE          ,CA,90015-4181,Public       ,491,1661,2152,8048,16203,24251
00122800,LOS ANGELES VALLEY COLLEGE              ,CA,91401-4096,Public       ,475,927,1402,10659,12320,22979
00122900,SO CA UNIV  HEALTH SCIENCES             ,CA,90604-4051,Private      ,1,74,75,57,801,858
00123000,MARSHALL B. KETCHUM UNIVERSITY          ,CA,92831-1699,Private      ,2,5,7,21,568,589
00123200,AMERICAN RIVER COLLEGE                  ,CA,95841-4286,Public       ,753,2224,2977,15098,22985,38083
00123300,SACRAMENTO CITY COLLEGE                 ,CA,95822-1386,Public       ,661,1777,2438,15069,18428,33497
00123600,MENLO COLLEGE                           ,CA,94027-4301,Private      ,37,13,50,1742,224,1966
00123700,MERCED COMMUNITY COLLEGE                ,CA,95348-2898,Public       ,331,654,985,7173,6454,13627
00123800,MILLS COLLEGE                           ,CA,94613-1301,Private      ,42,117,159,1994,2118,4112
00123900,MIRACOSTA COLLEGE                       ,CA,92056-3899,Public       ,412,1086,1498,6105,8764,14869
00124000,MODESTO JUNIOR COLLEGE                  ,CA,95350-5800,Public       ,573,1306,1879,11074,12689,23763
00124200,MONTEREY PENINSULA COLLEGE              ,CA,93940-4799,Public       ,179,312,491,3491,3209,6700
00124300,MOUNT ST MARYS COLLEGE                  ,CA,90049-1599,Private      ,56,198,254,3686,2811,6497
00124500,MT. SAN ANTONIO COLLEGE                 ,CA,91789-1399,Public       ,693,1126,1819,21216,17008,38224
00124600,MT SAN JACINTO COLLEGE                  ,CA,92583-2399,Public       ,622,1506,2128,9958,13517,23475
00124700,NAPA VALLEY COLLEGE                     ,CA,94558-6236,Public       ,181,353,534,3254,3126,6380
00124900,OCCIDENTAL COLLEGE                      ,CA,90041-3314,Private      ,134,33,167,5175,417,5592
00125000,ORANGE COAST COLLEGE - FIN AID OFF      ,CA,92628-5005,Public       ,618,1144,1762,15156,12020,27176
00125100,OTIS COLLEGE OF ART AND DESIGN          ,CA,90045-3505,Private      ,73,75,148,1890,976,2866
00125200,HOPE INTERNATIONAL UNIVERSITY           ,CA,92631-0000,Private      ,28,72,100,848,1125,1973
00125300,FRESNO PACIFIC UNIVERSITY               ,CA,93702-4798,Private      ,76,330,406,2730,4609,7339
00125400,PACIFIC LUTHERAN THEOLOGICAL SEM        ,CA,94708-0000,Private      ,0,2,2,5,65,70
00125500,PACIFIC OAKS COLLEGE                    ,CA,91103-3606,Private      ,4,151,155,68,1615,1683
00125600,PACIFIC SCHOOL OF RELIGION              ,CA,94709-0000,Private      ,0,2,2,4,205,209
00125800,PACIFIC UNION COLLEGE                   ,CA,94508-9797,Private      ,43,48,91,2132,616,2748
00125900,PALO VERDE COLLEGE                      ,CA,92225-0000,Public       ,17,57,74,346,608,954
00126000,PALOMAR COLLEGE                         ,CA,92069-1486,Public       ,633,1372,2005,11243,11324,22567
00126100,PASADENA CITY COLLEGE                   ,CA,91106-2003,Public       ,787,1386,2173,20889,16071,36960
00126200,POINT LOMA NAZARENE UNIVERSITY          ,CA,92106-2899,Private      ,124,163,287,4667,1702,6369
00126600,LANEY COLLEGE                           ,CA,94607-4893,Public       ,245,909,1154,4633,9128,13761
00126700,MERRITT COLLEGE                         ,CA,94619-3196,Public       ,139,600,739,2860,6169,9029
00126800,PORTERVILLE COLLEGE                     ,CA,93257-6059,Public       ,101,251,352,2573,2462,5035
00126900,RIO HONDO COLLEGE                       ,CA,90601-1699,Public       ,492,834,1326,13018,9644,22662
00127000,RIVERSIDE CITY COLLEGE                  ,CA,92506-1299,Public       ,782,1563,2345,20659,19775,40434
00127200,SAN BERNARDINO VALLEY COLLEGE           ,CA,92410-2798,Public       ,537,1334,1871,10593,14967,25560
00127300,SAN DIEGO CITY COLLEGE                  ,CA,92101-4787,Public       ,685,2016,2701,11888,17312,29200
00127500,SAN DIEGO MESA COLLEGE                  ,CA,92111-4996,Public       ,767,1639,2406,13178,15037,28215
00127800,SAN FRANCISCO CONSERVATORY OF MUSIC     ,CA,94122-4498,Private      ,18,24,42,336,432,768
00127900,SAN FRANCISCO THEOLOGICAL SEMINARY      ,CA,94960-0000,Private      ,0,3,3,8,58,66
00128000,SAN JOAQUIN DELTA COLLEGE               ,CA,95207-6370,Public       ,529,1386,1915,11518,12608,24126
00128100,WILLIAM JESSUP UNIVERSITY               ,CA,95765-3707,Private      ,30,75,105,1346,818,2164
00128200,SAN JOSE CITY COLLEGE                   ,CA,95128-2797,Public       ,227,697,924,5459,7192,12651
00128400,SANTA ANA COLLEGE                       ,CA,92706-3398,Public       ,340,724,1064,10206,8750,18956
00128500,SANTA BARBARA CITY COLLEGE              ,CA,93109-2394,Public       ,448,657,1105,10692,6725,17417
00128600,SANTA MONICA COLLEGE                    ,CA,90405-1644,Public       ,779,1352,2131,22159,14143,36302
00128700,SANTA ROSA JUNIOR COLLEGE               ,CA,95401-4395,Public       ,395,837,1232,7207,7873,15080
00128800,CLAREMONT SCHOOL OF THEOLOGY            ,CA,91711-0000,Private      ,0,18,18,7,314,321
00128900,SHASTA COLLEGE                          ,CA,96049-7692,Public       ,263,689,952,4103,5718,9821
00129000,SIERRA COLLEGE                          ,CA,95677-3397,Public       ,573,1155,1728,9755,10997,20752
00129100,SIMPSON UNIVERSITY                      ,CA,96003-8606,Private      ,36,106,142,1338,1234,2572
00129200,SOLANO COMMUNITY COLLEGE                ,CA,94534-3197,Public       ,312,722,1034,4336,6492,10828
00129300,VANGUARD UNIVERSITY OF SOUTHERN CA      ,CA,92626-6597,Private      ,73,111,184,2346,1346,3692
00129400,SOUTHWESTERN COLLEGE                    ,CA,91910-7299,Public       ,555,976,1531,11152,10049,21201
00129500,SOUTHWESTERN LAW SCHOOL                 ,CA,90010-1106,Private      ,3,34,37,56,2200,2256
00129600,DOMINICAN SCH PHILOSOPHY & THEOLOGY     ,CA,94709-0000,Private      ,1,5,6,5,52,57
00129900,ST JOHN'S SEMINARY COLLEGE              ,CA,93010-0000,Private      ,2,0,2,10,8,18
00130200,SAINT MARY'S COLLEGE OF CALIFORNIA      ,CA,94556-2744,Private      ,106,139,245,5524,1737,7261
00130500,STANFORD UNIVERSITY                     ,CA,94305-6106,Private      ,969,256,1225,27994,3831,31825
00130501,STANFORD UNIVERSITY - SCHOOL OF MEDICINE,CA,94305-5404,Private      ,22,39,61,219,1300,1519
00130502,STANFORD UNIVERSITY - GRADUATE SCHOOL OF,CA,94305-7298,Private      ,6,168,174,108,2137,2245
00130503,STANFORD UNIVERSITY - STANFORD LAW SCHOO,CA,94305-8610,Private      ,22,58,80,255,2541,2796
00130700,FRESNO CITY COLLEGE                     ,CA,93741-0002,Public       ,912,2322,3234,17615,19212,36827
00130800,REEDLEY COLLEGE                         ,CA,93654-2099,Public       ,394,670,1064,8211,6190,14401
00130900,TAFT COLLEGE                            ,CA,93268-2317,Public       ,82,209,291,2116,1958,4074
00131200,"UNIVERSITY OF CALIFORNIA, BERKELEY      ",CA,94720-1520,Public       ,1410,996,2406,61268,20765,82033
00131300,UNIVERSITY OF CALIFORNIA-DAVIS          ,CA,95616-8558,Public       ,1046,522,1568,57554,15916,73470
00131400,UNIVERSITY OF CALIFORNIA-IRVINE         ,CA,92697-2825,Public       ,1074,580,1654,64242,15187,79429
00131500,UNIVERSITY OF CALIFORNIA (UCLA)         ,CA,90095-9000,Public       ,2007,1403,3410,78470,28388,106858
00131502,UNIV OF CALIFORNIA LOS ANG SCH MED      ,CA,90095-0000,Public       ,24,30,54,367,1205,1572
00131503,UNIV OF CALIFORNIA LOS ANG DENTAL       ,CA,90095-0000,Public       ,5,8,13,128,227,355
00131600,UNIVERSITY OF CALIFORNIA-RIVERSIDE      ,CA,92521-0209,Public       ,668,489,1157,42688,10844,53532
00131700,UNIVERSITY OF CALIFORNIA-SAN DIEGO      ,CA,92093-0013,Public       ,1152,559,1711,57938,11959,69897
00131900,UNIVERSITY OF CALIFORNIA-SFRANCISCO     ,CA,94143-0246,Public       ,128,196,324,1875,4942,6817
00132000,UNIVERSITY OF CALIFORNIA-SANTA BARB     ,CA,93106-3180,Public       ,1042,340,1382,55787,8030,63817
00132100,UNIVERSITY OF CALIFORNIA-SANTA CRUZ     ,CA,95064-0001,Public       ,772,278,1050,38846,5775,44621
00132200,UNIVERSITY OF REDLANDS                  ,CA,92373-0999,Private      ,169,332,501,5710,3916,9626
00132500,UNIVERSITY OF SAN FRANCISCO             ,CA,94117-1080,Private      ,392,489,881,13980,8775,22755
00132600,SANTA CLARA UNIVERSITY                  ,CA,95053-4956,Private      ,355,156,511,11968,3373,15341
00132604,JESUIT SCHOOL OF THEOLOGY - BERKELEY    ,CA,94709-1193,Private      ,0,1,1,5,65,70
00132800,UNIVERSITY OF SOUTHERN CALIFORNIA       ,CA,90089-0914,Private      ,1360,1680,3040,46727,30849,77576
00132900,UNIVERSITY OF THE PACIFIC               ,CA,95211-0197,Private      ,220,146,366,10569,3641,14210
00132901,UNIVERSITY OF THE PACIFIC - MCGEORGE SCH,CA,95817-2799,Private      ,11,61,72,213,1446,1659
00132902,UNIV OF THE PACIFIC SCH OF DENT         ,CA,94115-0000,Private      ,5,11,16,86,660,746
00133400,VENTURA COLLEGE                         ,CA,93003-3899,Public       ,363,767,1130,7002,6194,13196
00133500,VICTOR VALLEY COLLEGE                   ,CA,92395-5849,Public       ,414,1119,1533,7806,11184,18990
00133800,WEST VALLEY COLLEGE                     ,CA,95070-5697,Public       ,166,268,434,3271,3025,6296
00134100,WESTMONT COLLEGE                        ,CA,93108-1099,Private      ,71,17,88,2567,208,2775
00134200,WHITTIER COLLEGE                        ,CA,90601-0000,Private      ,129,42,171,4408,680,5088
00134201,WHITTIER COLLEGE - COLLEGE OF LAW       ,CA,92626-1501,Private      ,1,15,16,23,1123,1146
00134300,WOODBURY UNIVERSITY                     ,CA,91510-7846,Private      ,34,41,75,1284,938,2222
00134400,YUBA COLLEGE                            ,CA,95901-7699,Public       ,236,706,942,3845,5356,9201
00177212,TRINITY INTERNATIONAL UNIV-CA           ,CA,92705-0000,Private      ,0,19,19,9,330,339
00188100,ASHFORD UNIVERSITY                      ,CA,92123-1406,Proprietary  ,266,10382,10648,2052,89138,91190
00274100,AMERICAN JEWISH UNIVERSITY              ,CA,90077-1599,Private      ,8,9,17,90,147,237
00301002,ANTIOCH UNIV/LOS ANGELES                ,CA,90230-7615,Private      ,3,98,101,64,1153,1217
00301003,ANTIOCH  UNIV/SANTA BARBARA             ,CA,93101-0000,Private      ,40,46,86,794,685,1479
00369110,MIDDLEBURY COLLEGE - MONTEREY INSTITUTE ,CA,93940-2691,Private      ,4,49,53,46,862,908
00394700,UC-HASTINGS COLLEGE OF THE LAW          ,CA,94102-0000,Public       ,1,44,45,35,2577,2612
00394800,SAN FRANCISCO ART INSTITUTE             ,CA,94133-2299,Private      ,128,125,253,2002,1331,3333
00408000,STARR KING SCHOOL FOR THE MINISTRY      ,CA,94709-1299,Private      ,0,7,7,4,107,111
00448000,DE ANZA COLLEGE                         ,CA,95014-5793,Public       ,494,722,1216,10851,8124,18975
00448100,OHLONE COLLEGE                          ,CA,94539-5847,Public       ,172,291,463,4098,3612,7710
00448400,JOHN F. KENNEDY UNIVERSITY              ,CA,94523-4817,Private      ,7,140,147,66,1466,1532
00449400,EVEREST COLLEGE                         ,CA,92408-3752,Proprietary  ,41,157,198,549,1078,1627
00450200,CITY COLLEGE OF SAN FRANCISCO           ,CA,94112-0000,Public       ,422,1645,2067,8855,14143,22998
00450302,EVEREST COLLEGE - SANTA ANA             ,CA,92701-4559,Proprietary  ,23,57,80,339,553,892
00563800,DOWNEY ADULT SCHOOL                     ,CA,90241-5610,Public       ,31,126,157,312,860,1172
00565500,HACIENDA LA PUENTE ADULT EDUC CTR       ,CA,91746-0000,Public       ,31,88,119,248,742,990
00616500,LA CNTY CLG OF NURSING & ALLD HLTH      ,CA,90033-1018,Public       ,14,51,65,223,727,950
00672000,COLLEGE OF ALAMEDA                      ,CA,94501-2109,Public       ,132,398,530,3045,4394,7439
00673100,CASA LOMA COLLEGE                       ,CA,91405-4523,Private      ,12,66,78,230,613,843
00697300,CANADA COLLEGE                          ,CA,94061-1099,Public       ,78,206,284,1587,2275,3862
00697500,LINCOLN UNIVERSITY                      ,CA,94612-2801,Private      ,1,17,18,46,178,224
00701200,SAMUEL MERRITT COLLEGE                  ,CA,94609-3108,Private      ,13,151,164,449,2841,3290
00704700,LOS ANGELES SOUTHWEST COLLEGE           ,CA,90047-4810,Public       ,196,729,925,3957,8508,12465
00705000,BELLUS ACADEMY                          ,CA,91950-3616,Proprietary  ,14,26,40,160,240,400
00711500,MOORPARK COLLEGE                        ,CA,93021-1695,Public       ,350,569,919,6907,5084,11991
00713000,NEWBERRY SCHOOLS OF BEAUTY              ,CA,91344-7404,Proprietary  ,15,29,44,81,123,204
00714200,LYLE'S COLLEGE OF BEAUTY                ,CA,93710-3948,Proprietary  ,1,29,30,126,171,297
00716400,BRYAN COLLEGE                           ,CA,90057-0000,Proprietary  ,39,461,500,250,2092,2342
00718700,NORTH ADRIAN'S COLLEGE OF BEAUTY        ,CA,95350-2381,Proprietary  ,29,51,80,125,278,403
00719000,WYOTECH                                 ,CA,94539-7663,Proprietary  ,32,91,123,516,945,1461
00720300,SALON SUCCESS ACADEMY                   ,CA,91786-4060,Proprietary  ,6,30,36,93,155,248
00720400,MODERN BEAUTY ACADEMY                   ,CA,93030-7016,Proprietary  ,1,14,15,60,77,137
00720900,REDONDO BEACH BEAUTY COLLEGE            ,CA,90278-3111,Proprietary  ,3,8,11,11,36,47
00723400,HEALD COLLEGE                           ,CA,94105-2206,Proprietary  ,30,108,138,486,1252,1738
00723404,HEALD COLLEGE - CONCORD                 ,CA,94520-0000,Proprietary  ,57,138,195,726,1749,2475
00723405,HEALD COLLEGE - MILPITAS                ,CA,95035-8008,Proprietary  ,55,133,188,668,1775,2443
00723406,HEALD COLLEGE - HAYWARD                 ,CA,94545-2352,Proprietary  ,23,101,124,704,1565,2269
00723407,HEALD COLLEGE - MODESTO                 ,CA,95368-9095,Proprietary  ,40,80,120,681,1176,1857
00723408,HEALD COLLEGE - ROSEVILLE               ,CA,95678-5303,Proprietary  ,39,92,131,565,1583,2148
00723409,HEALD COLLEGE - SALINAS                 ,CA,93906-5100,Proprietary  ,25,73,98,555,1051,1606
00723410,HEALD COLLEGE - STOCKTON                ,CA,95210-5667,Proprietary  ,39,135,174,896,1697,2593
00723411,HEALD COLLEGE - RANCHO CORDOVA          ,CA,95670-6005,Proprietary  ,21,86,107,447,1368,1815
00723412,HEALD COLLEGE - FRESNO                  ,CA,93704-1706,Proprietary  ,38,177,215,1148,2133,3281
00725300,FEDERICO BEAUTY INSTITUTE               ,CA,95834-1905,Proprietary  ,29,93,122,297,522,819
00729600,COLEMAN COLLEGE                         ,CA,92123-0000,Private      ,19,140,159,253,815,1068
00732909,ITT TECHNICAL INSTITUTE                 ,CA,92868-3506,Proprietary  ,79,342,421,629,2492,3121
00732971,ITT TECHNICAL INSTITUTE                 ,CA,95670-6047,Proprietary  ,59,270,329,509,1989,2498
00732976,ITT TECHNICAL INSTITUTE                 ,CA,92408-3519,Proprietary  ,100,349,449,984,2735,3719
00732981,ITT TECHNICAL INSTITUTE                 ,CA,92123-2662,Proprietary  ,82,351,433,743,2980,3723
00732985,ITT TECHNICAL INSTITUTE                 ,CA,91773-2933,Proprietary  ,42,169,211,480,1696,2176
00732989,ITT TECHNICAL INSTITUTE                 ,CA,90502-1356,Proprietary  ,61,288,349,464,1953,2417
00732994,ITT TECHNICAL INSTITUTE                 ,CA,91342-3664,Proprietary  ,70,241,311,434,1688,2122
00746901,HUSSIAN SCHOOL OF ART-RELATIVITY CAMPUS ,CA,90017-2019,Proprietary  ,1,4,5,1,4,5
00747600,MARINELLO SCHOOLS OF BEAUTY             ,CA,90023-2666,Proprietary  ,30,77,107,371,601,972
00747602,MARINELLO SCHOOLS OF BEAUTY - SPA ACADEM,CA,90048-5101,Proprietary  ,12,28,40,121,242,363
00747603,MARINELLO SCHOOLS OF BEAUTY - INGLEWOOD ,CA,90301-2306,Proprietary  ,13,36,49,146,233,379
00747604,MARINELLO SCHOOLS OF BEAUTY - RESEDA    ,CA,91335-4218,Proprietary  ,2,10,12,41,58,99
00747606,MARINELLO SCHOOLS OF BEAUTY - WEST COVIN,CA,91790-2805,Proprietary  ,8,31,39,113,161,274
00747607,MARINELLO SCHOOLS OF BEAUTY - SAN BERNAR,CA,92410-3261,Proprietary  ,15,41,56,135,220,355
00747608,MARINELLO SCHOOLS OF BEAUTY - ONTARIO   ,CA,91762-2113,Proprietary  ,11,30,41,196,287,483
00747609,MARINELLO SCHOOLS OF BEAUTY - WHITTIER  ,CA,90601-4107,Proprietary  ,8,24,32,114,151,265
00747610,MARINELLO SCHOOLS OF BEAUTY - LOMITA    ,CA,90717-1460,Proprietary  ,6,24,30,65,132,197
00747611,MARINELLO SCHOOLS OF BEAUTY - SAN DIEGO ,CA,92126-4217,Proprietary  ,15,61,76,211,458,669
00747612,MARINELLO SCHOOLS OF BEAUTY - EL CAJON  ,CA,92020-2503,Proprietary  ,5,33,38,114,232,346
00747613,MARINELLO SCHOOLS OF BEAUTY - VICTORVILL,CA,92392-5496,Proprietary  ,16,51,67,159,332,491
00747614,MARINELLO SCHOOLS OF BEAUTY - ANAHEIM   ,CA,92801-4622,Proprietary  ,20,18,38,179,212,391
00747615,MARINELLO SCHOOLS OF BEAUTY - SIMI VALLE,CA,93065-2801,Proprietary  ,4,7,11,64,98,162
00753100,ACADEMY OF ART UNIVERSITY               ,CA,94105-3410,Proprietary  ,409,930,1339,7329,11226,18555
00753600,COSUMNES RIVER COLLEGE                  ,CA,95823-5799,Public       ,426,1072,1498,9774,11523,21297
00754802,WESTWOOD COLLEGE OF TECHNOLOGY          ,CA,92801-0000,Proprietary  ,29,43,72,608,661,1269
00754803,WESTWOOD COLLEGE OF TECHNOLOGY          ,CA,91786-0000,Proprietary  ,40,58,98,717,860,1577
00760600,EVEREST COLLEGE                         ,CA,90010-2221,Proprietary  ,0,0,0,251,380,631
00760700,CONCORDE CAREER INSTITUTE               ,CA,91606-3134,Proprietary  ,38,91,129,390,777,1167
00770700,COLUMBIA COLLEGE                        ,CA,95370-8580,Public       ,90,186,276,1392,1505,2897
00771300,SKYLINE COLLEGE                         ,CA,94066-1698,Public       ,197,403,600,4238,4123,8361
00793000,CONCORDE CAREER INSTITUTE               ,CA,92108-0000,Proprietary  ,41,158,199,357,1244,1601
00799300,CALIF STATE UNIV BAKERSFIELD            ,CA,93311-1022,Public       ,292,450,742,11617,7568,19185
00807100,CONCORDE CAREER INSTITUTE               ,CA,92840-9201,Proprietary  ,37,81,118,363,896,1259
00807300,BUTTE COMMUNITY COLLEGE                 ,CA,95965-0000,Public       ,393,959,1352,7840,8679,16519
00809000,EVEREST COLLEGE                         ,CA,91803-1310,Proprietary  ,27,61,88,252,552,804
00853700,CONCORDE CAREER INSTITUTE               ,CA,92401-0000,Proprietary  ,38,105,143,439,1126,1565
00859600,WEST LOS ANGELES COLLEGE                ,CA,90230-3500,Public       ,254,794,1048,5701,9227,14928
00859700,FEATHER RIVER COLLEGE                   ,CA,95971-9124,Public       ,30,67,97,796,536,1332
00884400,CALIFORNIA CHRISTIAN COLLEGE            ,CA,93703-3599,Private      ,7,20,27,98,181,279
00884600,WRIGHT INSTITUTE                        ,CA,94704-0000,Private      ,0,15,15,5,495,500
00890300,COLLEGE OF THE CANYONS                  ,CA,91355-1899,Public       ,345,522,867,9335,6990,16325
00891800,SADDLEBACK COLLEGE                      ,CA,92692-3699,Public       ,460,836,1296,6844,7802,14646
00902200,ASSOCIATED TECHNICAL COLLEGE            ,CA,90017-0000,Proprietary  ,23,132,155,192,527,719
00903200,EMPIRE COLLEGE                          ,CA,95403-2122,Proprietary  ,22,62,84,200,542,742
00915706,WYOTECH - WEST SACRAMENTO CAMPUS        ,CA,95605-1507,Proprietary  ,0,0,0,16,23,39
00927200,CRAFTON HILLS COLLEGE                   ,CA,92399-1799,Public       ,229,464,693,4543,4575,9118
00950900,SKILLS & BUSINESS EDUCATION CENTER      ,CA,95824-1529,Public       ,30,137,167,314,1009,1323
00974800,CARRINGTON COLLEGE CALIFORNIA           ,CA,95826-3203,Proprietary  ,101,319,420,1268,2825,4093
00974801,CARRINGTON COLLEGE CALIFORNIA - SAN LEAN,CA,94578-3711,Proprietary  ,26,74,100,332,657,989
00974802,CARRINGTON COLLEGE CALIFORNIA - PLEASANT,CA,94523-1984,Proprietary  ,47,89,136,395,847,1242
00974803,CARRINGTON COLLEGE CALIFORNIA - STOCKTON,CA,95207-5509,Proprietary  ,57,110,167,539,766,1305
00974804,CARRINGTON COLLEGE CALIFORNIA - CITRUS H,CA,95621-5577,Proprietary  ,37,92,129,321,741,1062
00974807,CARRINGTON COLLEGE CALIFORNIA - SAN JOSE,CA,95119-1325,Proprietary  ,71,144,215,719,1251,1970
00998900,SANTA BARBARA BUSINESS COLLEGE          ,CA,93111-0000,Proprietary  ,37,66,103,350,625,975
01011100,CERRO-COSO COMMUNITY COLLEGE            ,CA,93555-9571,Public       ,69,332,401,928,2633,3561
01014900,PEPPERDINE UNIVERSITY                   ,CA,90263-0000,Private      ,319,385,704,8896,6372,15268
01034000,LOS MEDANOS COLLEGE                     ,CA,94565-5197,Public       ,289,535,824,3826,4708,8534
01036500,CHARLES R DREW UNIV OF MED & SCI        ,CA,90059-0000,Private      ,6,73,79,127,1034,1161
01039500,UNIVERSITY OF SAN DIEGO                 ,CA,92110-2492,Private      ,661,526,1187,18457,6664,25121
01039501,UNIVERSITY OF SAN DIEGO - SCHOOL OF LAW ,CA,92110-2492,Private      ,21,80,101,262,2297,2559
01044100,PARDEE RAND GRADUATE SCHOOL             ,CA,90407-2138,Private      ,0,4,4,4,26,30
01047400,MARYMOUNT COLLEGE OF PALOS VERDES       ,CA,90275-0000,Private      ,19,12,31,1137,256,1393
01085400,THOMAS JEFFERSON SCHOOL OF LAW          ,CA,92110-0000,Private      ,4,67,71,39,1613,1652
01102400,EVEREST COLLEGE                         ,CA,94103-2091,Proprietary  ,0,0,0,104,191,295
01110700,EVEREST  COLLEGE                        ,CA,92801-5231,Proprietary  ,29,70,99,360,651,1011
01110900,EVEREST COLLEGE                         ,CA,91335-4631,Proprietary  ,30,91,121,334,656,990
01111200,FIDM-FASHION INSTITUTE OF DESIGN        ,CA,90015-1421,Proprietary  ,222,194,416,5214,2284,7498
01111700,ALLIANT INTERNATIONAL UNIVERSITY        ,CA,92131-1799,Private      ,12,104,116,213,2047,2260
01111705,ALLIANT INTERNATIONAL UNIVERSITY - LOS A,CA,91803-1360,Private      ,2,27,29,18,700,718
01111706,ALLIANT INTERNATIONAL UNIVERSITY - SAN F,CA,94133-1221,Private      ,3,43,46,41,823,864
01111707,ALLIANT INTERNATIONAL UNIVERSITY - FRESN,CA,93727-2014,Private      ,4,41,45,75,568,643
01112100,EVEREST COLLEGE                         ,CA,94541-4007,Proprietary  ,0,0,0,87,156,243
01112300,EVEREST COLLEGE                         ,CA,90247-4163,Proprietary  ,19,95,114,176,623,799
01146000,NATIONAL UNIVERSITY                     ,CA,92037-1011,Private      ,82,2558,2640,999,19744,20743
01162600,PRACTICAL SCHOOLS                       ,CA,92805-0000,Proprietary  ,18,35,53,271,511,782
01164900,LOYOLA MARYMOUNT UNIVERSITY             ,CA,90045-0000,Private      ,369,183,552,12970,3829,16799
01164901,LMU  - LOYOLA LAW SCHOOL                ,CA,90015-0019,Private      ,10,60,70,187,2672,2859
01167200,MENDOCINO COLLEGE                       ,CA,95482-3000,Public       ,68,249,317,1416,2128,3544
01170700,NORTH-WEST COLLEGE                      ,CA,91790-2097,Proprietary  ,30,75,105,311,567,878
01179200,FRANCISCAN SCHOOL OF THEOLOGY           ,CA,94709-0000,Private      ,0,2,2,5,32,37
01182000,SAN DIEGO MIRAMAR COLLEGE               ,CA,92126-0000,Public       ,333,1044,1377,6202,9234,15436
01186500,CALIFORNIA HAIR DESIGN ACADEMY          ,CA,92115-0000,Proprietary  ,24,59,83,174,276,450
01186600,LU ROSS ACADEMY                         ,CA,93001-2927,Proprietary  ,23,77,100,181,349,530
01202600,BELLUS ACADEMY                          ,CA,92021-6247,Proprietary  ,19,25,44,139,236,375
01203100,SAN DIEGO CHRISTIAN COLLEGE             ,CA,92019-1157,Private      ,42,54,96,896,771,1667
01206100,EVEREST COLLEGE                         ,CA,95128-3908,Proprietary  ,0,0,0,191,328,519
01215400,CALIFORNIA INSTITUTE OF INTEGRAL STUDIES,CA,94103-2557,Private      ,2,87,89,53,1560,1613
01231600,MANCHESTER BEAUTY COLLEGE               ,CA,93726-5306,Proprietary  ,3,21,24,103,159,262
01231700,TULARE BEAUTY COLLEGE                   ,CA,93274-3432,Proprietary  ,4,12,16,37,58,95
01244600,UNIVERSAL COLLEGE OF BEAUTY             ,CA,90044-0044,Proprietary  ,7,23,30,77,136,213
01245200,EVERGREEN VALLEY COLLEGE                ,CA,95135-1598,Public       ,248,558,806,5383,5971,11354
01255000,LOS ANGELES MISSION COLLEGE             ,CA,91342-3200,Public       ,235,514,749,6274,6399,12673
01265000,MARINELLO SCHOOL OF BEAUTY              ,CA,91502-2828,Proprietary  ,25,55,80,204,378,582
01265001,MARINELLO SCHOOL OF BEAUTY - PALMDALE   ,CA,93550-4686,Proprietary  ,7,18,25,69,118,187
01284200,OXNARD COLLEGE                          ,CA,93030-0000,Public       ,236,485,721,3924,4327,8251
01287200,NORTH-WEST COLLEGE                      ,CA,91768-3199,Proprietary  ,40,140,180,450,890,1340
01287300,WYOTECH                                 ,CA,90810-3800,Proprietary  ,75,204,279,782,1473,2255
01287301,WYOTECH - EVEREST  COLLEGE              ,CA,90034-3158,Proprietary  ,10,56,66,224,460,684
01287302,WYOTECH - EVEREST  COLLEGE              ,CA,91746-3412,Proprietary  ,53,93,146,379,735,1114
01290700,LAKE TAHOE COMMUNITY COLLEGE            ,CA,96150-4524,Public       ,45,118,163,746,1100,1846
01291200,MTI COLLEGE                             ,CA,95841-0000,Proprietary  ,58,203,261,539,1591,2130
01294200,ROSEMEAD BEAUTY SCHOOL                  ,CA,91770-1639,Proprietary  ,6,44,50,29,269,298
01298400,PROFESSIONAL INSTITUTE OF BEAUTY        ,CA,91731-2613,Proprietary  ,4,33,37,33,105,138
01298500,HAIR CALIFORNIA BEAUTY ACADEMY          ,CA,92867-7127,Proprietary  ,2,12,14,17,46,63
01298900,OCEANSIDE COLLEGE OF BEAUTY             ,CA,92054-5393,Proprietary  ,11,24,35,107,188,295
01301000,LANCASTER BEAUTY SCHOOL                 ,CA,93534-3098,Proprietary  ,13,38,51,138,265,403
01307400,AMERICAN BEAUTY COLLEGE                 ,CA,91790-2906,Proprietary  ,11,21,32,58,101,159
01309500,SALON SUCCESS ACADEMY                   ,CA,92879-0000,Proprietary  ,17,35,52,179,268,447
01310300,CALIFORNIA WESTERN SCHOOL OF LAW        ,CA,92101-0000,Private      ,6,92,98,116,1687,1803
01324000,LYTLE'S REDWOOD EMPIRE BEAUTY CLG       ,CA,95403-0000,Proprietary  ,15,33,48,164,226,390
02054900,MARINELLO SCHOOL OF BEAUTY              ,CA,92630-0000,Proprietary  ,12,40,52,118,243,361
02054902,MARINELLO SCHOOL OF BEAUTY - BAKERSFIELD,CA,93309-5001,Proprietary  ,20,49,69,365,451,816
02054903,MARINELLO SCHOOL OF BEAUTY - VISALIA    ,CA,93277-6228,Proprietary  ,4,19,23,112,139,251
02059800,PARIS BEAUTY COLLEGE                    ,CA,94520-2611,Proprietary  ,9,29,38,55,168,223
02061600,WAYNES COLLEGE OF BEAUTY                ,CA,93906-2830,Proprietary  ,4,13,17,65,95,160
02063500,COASTLINE COMMUNITY COLLEGE             ,CA,92708-0000,Public       ,123,988,1111,2602,8745,11347
02064300,SIERRA COLLEGE OF BEAUTY                ,CA,95340-0000,Proprietary  ,7,16,23,93,140,233
02065700,CALIFORNIA BEAUTY COLLEGE               ,CA,95354-0000,Proprietary  ,16,22,38,153,219,372
02070500,CONCORDIA UNIVERSITY                    ,CA,92612-0000,Private      ,72,296,368,3327,3391,6718
02075800,SOUTHERN CA INST OF ARCHITECTURE        ,CA,90013-0000,Private      ,11,20,31,239,500,739
02086400,MARINELLO SCHOOL OF BEAUTY              ,CA,95050-0000,Proprietary  ,4,28,32,100,178,278
02086401,MARINELLO SCHOOL OF BEAUTY - SEASIDE    ,CA,93955-3615,Proprietary  ,6,31,37,82,188,270
02086402,MARINELLO SCHOOL OF BEAUTY - SAN MATEO  ,CA,94401-3801,Proprietary  ,6,26,32,68,121,189
02086403,MARINELLO SCHOOL OF BEAUTY - HAYWARD    ,CA,94541-5111,Proprietary  ,10,29,39,99,223,322
02086404,MARINELLO SCHOOL OF BEAUTY - CASTRO VALL,CA,94546-5506,Proprietary  ,7,3,10,48,70,118
02091200,ELEGANCE INTERNATIONAL                  ,CA,90028-0000,Proprietary  ,29,44,73,229,265,494
02091700,KAPLAN COLLEGE                          ,CA,92123-1509,Proprietary  ,58,292,350,754,2380,3134
02091702,KAPLAN COLLEGE - CHULA VISTA            ,CA,91910-5342,Proprietary  ,26,56,82,263,474,737
02096100,FIELDING GRADUATE UNIVERSITY            ,CA,93105-0000,Private      ,0,166,166,3,1036,1039
02099200,AMERICAN CONSERVATORY THEATER           ,CA,94108-0000,Private      ,7,18,25,98,271,369
02110200,COLUMBIA COLLEGE                        ,CA,91356-0000,Private      ,29,23,52,439,182,621
02110800,CALIFORNIA COLLEGE SAN DIEGO            ,CA,92108-3821,Proprietary  ,125,372,497,2336,3235,5571
02111300,CUYAMACA COLLEGE                        ,CA,92019-0000,Public       ,293,833,1126,5030,7321,12351
02119100,MISSION COLLEGE                         ,CA,95054-1897,Public       ,161,413,574,3585,4994,8579
02120600,SAYBROOK GRADUATE SCHOOL                ,CA,94111-1920,Private      ,0,46,46,2,686,688
02120601,SAYBROOK UNIVERSITY -  WESTIN HOTEL     ,CA,94030-3120,Private      ,0,8,8,0,10,10
02120700,SAN JOAQUIN VALLEY COLLEGE              ,CA,93291-0000,Proprietary  ,277,827,1104,2505,5429,7934
02125000,CAREER ACADEMY OF BEAUTY                ,CA,92845-0000,Proprietary  ,8,22,30,76,194,270
02128200,"VICTOR VALLEY BEAUTY COLLEGE, INC       ",CA,92392-0000,Proprietary  ,10,34,44,166,227,393
02128300,INSTITUTE FOR BUSINESS & TECHNOLOGY     ,CA,95050-0000,Proprietary  ,29,108,137,163,549,712
02128301,INSTITUTE FOR BUSINESS & TECHNOLOGY - NA,CA,95670-6351,Proprietary  ,10,51,61,78,299,377
02138300,PALO ALTO UNIVERSITY                    ,CA,94304-1337,Private      ,1,48,49,83,1144,1227
02161800,MUSICIANS INSTITUTE                     ,CA,90028-6157,Proprietary  ,83,150,233,1174,1031,2205
02167800,ESTES INSTITUTE OF COSMETOLOGY          ,CA,93291-0000,Proprietary  ,5,13,18,106,112,218
02178700,CITRUS HEIGHTS BEAUTY COLLEGE           ,CA,95610-1410,Proprietary  ,11,19,30,135,135,270
02179937,WESTERN STATE COLLEGE OF LAW            ,CA,92831-3014,Proprietary  ,0,20,20,36,814,850
02179938,"ART INSTITUTE OF CALIFORNIA, HOLLYWOOD  ",CA,91601-3112,Proprietary  ,159,193,352,2575,1855,4430
02179941,"ART INSTITUTE OF CALIFORNIA, LOS ANGELES",CA,90405-3035,Proprietary  ,204,192,396,3368,2185,5553
02179947,"ART INSTITUTE OF CALIFORNIA, SAN DIEGO  ",CA,92108-4423,Proprietary  ,220,284,504,2760,2772,5532
02185800,MOLER BARBER COLLEGE                    ,CA,94611-0000,Proprietary  ,11,41,52,75,212,287
02188400,SIERRA VALLEY COLLEGE OF COURT REPORTING,CA,93726-0000,Proprietary  ,2,18,20,86,194,280
02208600,MADERA BEAUTY COLLEGE                   ,CA,93637-3519,Proprietary  ,4,12,16,53,75,128
02211000,SALON SUCCESS ACADEMY                   ,CA,92405-0000,Proprietary  ,4,21,25,91,142,233
02220000,COLLEEN O'HARA BEAUTY ACADEMY           ,CA,92701-0000,Proprietary  ,6,17,23,65,76,141
02220200,CALIFORNIA CULINARY ACADEMY             ,CA,94102-3336,Proprietary  ,32,82,114,481,570,1051
02221300,MARINELLO SCHOOL OF BEAUTY              ,CA,92553-0000,Proprietary  ,8,24,32,182,284,466
02221303,MARINELLO SCHOOL OF BEAUTY - SAN RAFAEL ,CA,94901-3224,Proprietary  ,0,10,10,36,106,142
02222000,AMERICAN FILM INSTITUTE                 ,CA,90027-0000,Private      ,28,92,120,509,1042,1551
02226000,EAST LOS ANGELES COLLEGE                ,CA,91754-0000,Public       ,578,1050,1628,16865,15079,31944
02228500,LIFE CHIROPRACTIC COLLEGE WEST          ,CA,94545-0000,Private      ,1,36,37,36,599,635
02230900,FREDRICK & CHARLES BEAUTY COLLEGE       ,CA,95501-0000,Proprietary  ,14,17,31,86,135,221
02231900,GEMOLOGICAL INSTITUTE OF AMERICA        ,CA,92008-4698,Private      ,10,65,75,78,416,494
02236400,"THANH LE COLG, SCH OF COSMETOLOGY       ",CA,92840-0000,Proprietary  ,3,6,9,14,50,64
02237200,PHILLIPS GRADUATE INSTITUTE             ,CA,91316-0000,Private      ,0,60,60,10,278,288
02241800,AMERICAN CAREER COLLEGE                 ,CA,90004-0000,Proprietary  ,230,577,807,1843,3805,5648
02242700,BERKELEY CITY COLLEGE                   ,CA,94704-0000,Public       ,241,501,742,4392,5467,9859
02250602,EVEREST COLLEGE                         ,CA,91761-8525,Proprietary  ,29,160,189,491,1163,1654
02255400,INTERNATIONAL SCHOOL OF COSMETOLOGY     ,CA,90250-0000,Proprietary  ,25,36,61,180,225,405
02258600,ALAMEDA BEAUTY COLLEGE                  ,CA,94501-0000,Proprietary  ,19,34,53,152,288,440
02262400,YESHIVA OHR ELCHONON CHABAD             ,CA,90046-0000,Private      ,54,0,54,106,2,108
02263101,ANTHEM COLLEGE - SACRAMENTO             ,CA,95827-3378,Proprietary  ,0,0,0,91,382,473
02267600,INSTITUTE OF TRANSPERSONAL PSYCHLGY     ,CA,94303-4624,Proprietary  ,3,24,27,12,392,404
02270600,LIFE PACIFIC COLLEGE                    ,CA,91773-0000,Private      ,16,32,48,482,289,771
02276800,WESTMINSTER SEMINARY CALIFORNIA         ,CA,92027-0000,Private      ,0,9,9,9,159,168
02277400,SOUTH COAST COLLEGE                     ,CA,92868-2616,Proprietary  ,16,59,75,215,483,698
02282300,ALHAMBRA BEAUTY COLLEGE                 ,CA,91802-0000,Proprietary  ,2,12,14,38,96,134
02285100,HILLTOP BEAUTY SCHOOL                   ,CA,94014-0000,Proprietary  ,4,12,16,24,76,100
02298000,DESIGN INSTITUTE OF SAN DIEGO           ,CA,92121-0000,Proprietary  ,7,33,40,225,322,547
02304300,"PLATT COLLEGE, SAN DIEGO                ",CA,92115-0000,Proprietary  ,23,52,75,224,381,605
02306300,KAPLAN COLLEGE                          ,CA,95368-0000,Proprietary  ,25,70,95,269,593,862
02306302,KAPLAN COLLEGE - FRESNO                 ,CA,93612-3802,Proprietary  ,14,49,63,171,358,529
02309500,CLOVIS ADULT EDUC                       ,CA,93611-0000,Public       ,18,85,103,113,470,583
02327601,ART INSTITUTE OF CALIFORNIA - SAN DIEGO ,CA,92408-2800,Proprietary  ,0,0,0,0,1,1
02330500,LAGUNA COLLEGE OF ART AND DESIGN        ,CA,92651-0000,Private      ,48,24,72,813,346,1159
02332800,CENTER FOR EMPLOYMENT TRAINING          ,CA,95110-0000,Private      ,134,493,627,592,2231,2823
02338500,GLENDALE CAREER COLLEGE                 ,CA,91203-1207,Proprietary  ,35,122,157,289,662,951
02338700,MARINELLO SCHOOL OF BEAUTY              ,CA,94103-1600,Proprietary  ,10,34,44,118,201,319
02338701,MARINELLO SCHOOL OF BEAUTY - CHICO      ,CA,95928-7184,Proprietary  ,16,46,62,127,229,356
02338702,MARINELLO SCHOOL OF BEAUTY - REDDING    ,CA,96001-1023,Proprietary  ,4,31,35,78,236,314
02338703,MARINELLO SCHOOL OF BEAUTY - FRESNO     ,CA,93711-3246,Proprietary  ,9,48,57,214,301,515
02342400,ACADEMY OF RADIO BROADCASTING           ,CA,92647-3809,Proprietary  ,8,32,40,79,232,311
02343400,BELLUS ACADEMY                          ,CA,92064-4633,Proprietary  ,22,72,94,266,520,786
02351900,KAPLAN COLLEGE                          ,CA,95660-5512,Proprietary  ,45,187,232,545,1577,2122
02351901,KAPLAN COLLEGE - BAKERSFIELD            ,CA,93304-0000,Proprietary  ,33,118,151,618,911,1529
02358000,THOMAS AQUINAS COLLEGE                  ,CA,93060-9622,Private      ,8,1,9,412,36,448
02359300,SHASTA BIBLE COLLEGE                    ,CA,96002-0000,Private      ,5,18,23,59,99,158
02482700,WESTERN UNIVERSITY OF HEALTH S          ,CA,91766-1854,Private      ,6,78,84,190,5627,5817
02494800,LOLA BEAUTY COLLEGE                     ,CA,92641-0000,Proprietary  ,2,6,8,23,55,78
02497300,TRINITY COLLEGE                         ,CA,93277-8109,Proprietary  ,23,122,145,210,576,786
02500000,SAN JOAQUIN COLLEGE OF LAW              ,CA,93612-0000,Private      ,1,7,8,29,281,310
02518400,THE NATIONAL HISPANIC UNIVERSITY        ,CA,95127-0000,Proprietary  ,5,30,35,248,558,806
02519800,AVANCE BEAUTY COLLEGE                   ,CA,92154-0000,Proprietary  ,7,24,31,114,183,297
02520200,CALIFORNIA CAREER SCHOOLS               ,CA,92805-0000,Proprietary  ,12,39,51,72,243,315
02520300,INTERIOR DESIGNERS INSTITUTE            ,CA,92660-0000,Proprietary  ,8,21,29,53,184,237
02520400,ADRIAN'S BEAUTY COLLEGE OF TURLOCK      ,CA,95382-0000,Proprietary  ,16,33,49,124,135,259
02531801,PAUL MITCHELL THE SCHOOL-COSTA MESA     ,CA,92626-3804,Proprietary  ,19,45,64,206,267,473
02531804,PAUL MITCHELL THE SCHOOL - SAN DIEGO    ,CA,92101-0000,Proprietary  ,32,65,97,347,445,792
02537200,PALOMAR INSTITUTE OF COSMETOLOGY        ,CA,92069-0000,Proprietary  ,10,42,52,212,324,536
02539100,KAPLAN COLLEGE                          ,CA,91606-3231,Proprietary  ,46,131,177,442,1017,1459
02539102,KAPLAN COLLEGE -  RIVERSIDE             ,CA,92507-4223,Proprietary  ,27,126,153,361,889,1250
02539500,IRVINE VALLEY COLLEGE                   ,CA,92620-0000,Public       ,335,619,954,7500,5602,13102
02542300,NATIONAL HOLISTIC INSTITUTE             ,CA,94608-0000,Proprietary  ,33,157,190,232,1026,1258
02543400,BROWNSON TECHNICAL SCHOOL               ,CA,92805-0000,Proprietary  ,12,37,49,58,179,237
02545900,HYPNOSIS MOTIVATION INSTITUTE           ,CA,91356-0000,Private      ,1,35,36,4,127,131
02546400,MTI BUSINESS COLLEGE INC                ,CA,95207-0000,Proprietary  ,6,38,44,72,243,315
02549000,KAPLAN COLLEGE                          ,CA,92083-7736,Proprietary  ,39,166,205,398,1082,1480
02549005,KAPLAN COLLEGE -  PALM SPRINGS          ,CA,92262-7011,Proprietary  ,26,69,95,286,505,791
02553500,ASSOCIATED TECHNICAL COLLEGE            ,CA,92101-0000,Proprietary  ,15,93,108,140,430,570
02553600,DIVERSIFIED LANGUAGE INSTITUTE          ,CA,90017-0000,Proprietary  ,16,184,200,80,718,798
02559300,UNITED EDUCATION INSTITUTE              ,CA,90020-0000,Proprietary  ,260,680,940,1241,2910,4151
02559400,INTERCOAST COLLEGES                     ,CA,92868-1656,Proprietary  ,53,402,455,294,2028,2322
02570300,LOS ANGELES ORT TECHNICAL INSTITUTE     ,CA,90048-4904,Private      ,28,156,184,187,765,952
02577900,SANTA BARBARA BUSINESS COLLEGE          ,CA,93309-1664,Proprietary  ,38,106,144,562,974,1536
02578000,SANTA BARBARA BUSINESS COLLEGE          ,CA,93454-6943,Proprietary  ,15,50,65,216,426,642
02591600,NORTH-WEST COLLEGE                      ,CA,91101-1744,Proprietary  ,10,22,32,120,274,394
02595600,ASIAN AMERICAN INTERNATIONAL BTY CG     ,CA,92683-4043,Proprietary  ,5,19,24,16,92,108
02596400,CRIMSON TECHNICAL COLLEGE - LOS ANGELES ,CA,90301-2904,Proprietary  ,26,62,88,169,448,617
02597300,SOUTH BAYLO UNIVERSITY                  ,CA,92801-1701,Private      ,0,56,56,3,331,334
02602300,CENTRAL COAST COLLEGE                   ,CA,93901-3301,Proprietary  ,31,43,74,276,365,641
02608900,PINNACLE COLLEGE                        ,CA,91803-8842,Proprietary  ,6,6,12,67,87,154
02608901,PINNACLE COLLEGE - SACRAMENTO           ,CA,95670-6386,Proprietary  ,8,14,22,94,150,244
02609000,EMPERORS COLG OF TRAD ORIENTAL MED      ,CA,90403-5609,Proprietary  ,0,29,29,9,217,226
03010611,VIRGINIA COLLEGE - GOLF ACADEMY OF AMERI,CA,92008-6512,Proprietary  ,8,23,31,39,87,126
03011300,"CALIF STATE UNIV, SAN MARCOS            ",CA,92096-0001,Public       ,488,602,1090,16920,8592,25512
03019900,CAPSTONE COLLEGE                        ,CA,91402-0000,Proprietary  ,2,13,15,30,89,119
03025600,DELL'ARTE SCH OF PHYSICAL THEATRE       ,CA,95525-0816,Private      ,1,0,1,7,33,40
03027700,PACIFIC COLLEGE OF ORIENTAL MED         ,CA,92108-4408,Proprietary  ,11,69,80,84,646,730
03029600,POMONA ADULT SCHOOL                     ,CA,91766-0000,Public       ,13,46,59,152,377,529
03031409,INTERNATIONAL ACADEMY OF DESIGN AND TECH,CA,95834-9664,Proprietary  ,10,28,38,198,319,517
03035700,LAS POSITAS COLLEGE                     ,CA,94551-6750,Public       ,175,317,492,3512,3006,6518
03039900,FREMONT COLLEGE                         ,CA,90703-5342,Proprietary  ,22,88,110,349,632,981
03043900,NEWSCHOOL OF ARCHITECTURE & DESIGN      ,CA,92101-6634,Proprietary  ,20,50,70,326,532,858
03054100,ROYALE COLLEGE OF BEAUTY                ,CA,92590-2525,Proprietary  ,4,23,27,73,120,193
03062300,WESTECH COLLEGE                         ,CA,91764-4988,Proprietary  ,22,111,133,292,760,1052
03062400,MT DIABLO ADULT EDUC LOMA VISTA CTR     ,CA,94518-1122,Public       ,12,35,47,130,282,412
03062700,PLATT COLLEGE                           ,CA,90041-0000,Proprietary  ,42,65,107,535,871,1406
03062701,PLATT COLLEGE                           ,CA,91764-0000,Proprietary  ,35,69,104,450,634,1084
03062702,PLATT COLLEGE - RIVERSIDE               ,CA,92507-0730,Proprietary  ,29,76,105,558,750,1308
03063400,MODERN TECHNOLOGY SCHOOL                ,CA,92708-9821,Proprietary  ,5,22,27,69,167,236
03067400,BALDWIN PARK ADULT SCHOOL               ,CA,91706-4897,Public       ,8,51,59,165,331,496
03067500,INSTITUTE OF TECHNOLOGY                 ,CA,93612-3217,Proprietary  ,67,258,325,557,1517,2074
03069500,SAGE COLLEGE                            ,CA,92557-6720,Proprietary  ,19,85,104,153,700,853
03072300,EVEREST COLLEGE                         ,CA,91761-3222,Proprietary  ,42,122,164,409,831,1240
03072700,WESTWOOD COLLEGE - LOS ANGELES          ,CA,90010-1577,Proprietary  ,62,322,384,1051,3649,4700
03078200,AMERICAN CLG TRADITIONAL CHINESE MD     ,CA,94107-2813,Private      ,0,37,37,9,266,275
03084700,VENTURA ADULT\CONTINUING EDUCATION      ,CA,93003-7313,Public       ,9,45,54,57,305,362
03094400,MARINELLO SCHOOL OF BEAUTY              ,CA,95841-2909,Proprietary  ,13,63,76,143,372,515
03094401,MARINELLO SCHOOL OF BEAUTY - CONCORD    ,CA,94520-2581,Proprietary  ,12,27,39,107,179,286
03094402,MARINELLO SCHOOL OF BEAUTY- STOCKTON    ,CA,95203-3149,Proprietary  ,14,38,52,146,281,427
03097700,CENTRAL CALIF SCH CONTINUING EDUC       ,CA,93401-6739,Proprietary  ,4,39,43,73,232,305
03098200,YO SAN UNIV TRADITIONAL CHINESE MED     ,CA,90066-1103,Private      ,0,50,50,4,204,208
03108100,SUMMIT COLLEGE                          ,CA,92324-3956,Proprietary  ,33,134,167,337,842,1179
03109500,DONGGUK  UNIVERSITY LOS ANGELES         ,CA,90020-1765,Private      ,3,13,16,40,107,147
03113300,UEI COLLEGE                             ,CA,93727-1620,Proprietary  ,92,305,397,642,1465,2107
03113600,SOUTHERN CALIFORNIA INST OF TECHNOL     ,CA,92805-3758,Proprietary  ,42,113,155,206,622,828
03116600,EAST SAN GABRIEL VLY REG OCCUP PROG     ,CA,91790-2105,Public       ,33,81,114,305,455,760
03125300,JOHN WESLEY INTER. BARBER & BTY CLG     ,CA,90813-4321,Proprietary  ,12,26,38,87,232,319
03125800,PREMIERE CAREER COLLEGE                 ,CA,91706-3746,Proprietary  ,17,56,73,106,361,467
03126800,PACIFICA GRADUATE INSTITUTE             ,CA,93013-0000,Proprietary  ,0,73,73,2,961,963
03128700,MT SIERRA COLLEGE                       ,CA,91016-3414,Proprietary  ,13,23,36,307,385,692
03131300,FIVE BRANCHES UNIVERSITY                ,CA,95062-4669,Proprietary  ,3,28,31,19,364,383
03144400,AMERICAN CLG OF HEALTH PROFESSIONS      ,CA,92505-3038,Proprietary  ,28,93,121,273,690,963
03150500,VIRGINIA SEWING MACHINES & SCH CTR      ,CA,90015-3535,Proprietary  ,10,17,27,44,104,148
03162300,FOUR-D SUCCESS ACADEMY                  ,CA,92324-4218,Proprietary  ,25,82,107,192,635,827
03163300,PACIFIC STATES UNIVERSITY               ,CA,90006-0000,Private      ,4,8,12,71,86,157
03195400,EVEREST COLLEGE                         ,CA,90501-2867,Proprietary  ,7,25,32,117,262,379
03210300,LE CORDON BLEU COLLEGE OF CULINARY ARTS ,CA,91101-5221,Proprietary  ,136,312,448,1794,2562,4356
03225300,AMERICAN UNIVERSITY OF HEALTH SCIENCES  ,CA,90755-3612,Proprietary  ,6,26,32,121,362,483
03242300,CAREER NETWORK INSTITUTE                ,CA,92868-4710,Proprietary  ,19,102,121,160,730,890
03250300,COMMUNITY BASED EDUCATION AND DEVELOPMEN,CA,90010-2722,Private      ,22,89,111,154,405,559
03260300,CALIFORNIA STATE U-MONTEREY BAY         ,CA,93955-8001,Public       ,411,286,697,14413,4633,19046
03266300,BETHESDA UNIVERSITY OF CALIFORNIA       ,CA,92801-4132,Private      ,10,14,24,168,144,312
03278300,CHARTER COLLEGE                         ,CA,91351-5432,Proprietary  ,30,97,127,375,950,1325
03288300,ACAD CHINESE CULTURE & HEALTH SCIS      ,CA,94512-0000,Private      ,3,27,30,22,210,232
03299300,PACIFIC COLLEGE                         ,CA,92626-3160,Proprietary  ,10,66,76,107,410,517
03308300,BRISTOL UNIVERSITY                      ,CA,92806-6198,Proprietary  ,10,22,32,87,240,327
03327400,ACUPUNCTURE AND INTEGRATIVE MEDICINE COL,CA,94704-2724,Private      ,3,23,26,25,230,255
03332300,SOUTHERN CA BIBLE CLG & SEMINARY        ,CA,92019-1109,Private      ,5,32,37,19,221,240
03359300,ST. FRANCIS CAREER COLLEGE              ,CA,90262-2659,Proprietary  ,15,33,48,125,265,390
03367300,PROFESSIONAL GOLFERS CAREER COLLEGE     ,CA,92591-6013,Proprietary  ,7,14,21,91,157,248
03395300,INTERNATIONAL CAREER DEVELOPMENT        ,CA,90027-5794,Proprietary  ,140,1500,1640,594,5852,6446
03399300,NORTHWESTERN TECHNICAL COLLEGE          ,CA,95670-4443,Proprietary  ,2,6,8,42,140,182
03403300,EPIC BIBLE COLLEGE                      ,CA,95841-3546,Private      ,8,46,54,109,447,556
03413400,ENGLISH CENTER  (THE)                   ,CA,94607-3734,Private      ,7,37,44,30,162,192
03427400,CAREER COLLEGES OF AMERICA              ,CA,90280-7420,Proprietary  ,0,0,0,20,24,44
03427500,UNIVERSITY OF ANTELOPE VALLEY           ,CA,93534-3324,Proprietary  ,51,147,198,627,1230,1857
03440400,MARIAN HEALTH CAREERS CENTER            ,CA,90010-1728,Proprietary  ,8,22,30,61,184,245
03458300,MY LE'S BEAUTY COLLEGE                  ,CA,95824-0000,Proprietary  ,4,30,34,79,263,342
03467300,MARINELLO SCHOOL OF BEAUTY              ,CA,92545-3661,Proprietary  ,11,39,50,101,291,392
03467301,MARINELLO SCHOOL OF BEAUTY - CATHEDRAL C,CA,92234-6656,Proprietary  ,0,0,0,21,20,41
03467302,MARINELLO SCHOOL OF BEAUTY - MURRIETA   ,CA,92563-5039,Proprietary  ,10,40,50,121,242,363
03467303,MARINELLO SCHOOL OF BEAUTY - NAPA       ,CA,94559-1237,Proprietary  ,4,20,24,79,133,212
03467304,MARINELLO SCHOOL OF BEAUTY - CITY OF IND,CA,91748-1674,Proprietary  ,6,19,25,35,85,120
03467305,MARINELLO SCHOOL OF BEAUTY - BELL       ,CA,90201-1193,Proprietary  ,6,13,19,68,92,160
03467306,MARINELLO SCHOOL OF BEAUTY - PARAMOUNT  ,CA,90723-5256,Proprietary  ,14,27,41,114,164,278
03467307,MARINELLO SCHOOL OF BEAUTY - HUNTINGTON ,CA,92646-2552,Proprietary  ,6,22,28,108,160,268
03479300,PROFESSIONAL CAREER INSTITUTE           ,CA,90703-2522,Proprietary  ,3,24,27,95,163,258
03516300,KING'S UNIVERSITY (THE)                 ,CA,91405-2233,Private      ,14,80,94,189,591,780
03532400,ADVANCED TRAINING ASSOCIATES            ,CA,92020-1236,Proprietary  ,7,23,30,37,143,180
03542400,COPPER MOUNTAIN COLLEGE                 ,CA,92252-6102,Public       ,77,238,315,736,1955,2691
03577300,COBA ACADEMY                            ,CA,92866-1407,Proprietary  ,3,10,13,37,49,86
03590400,NTMA TRAINING CENTERS OF SOUTHERN C     ,CA,90650-0000,Private      ,24,90,114,124,532,656
03592400,IRELL & MANELLA GRADUATE SCHOOL OF BIOLO,CA,91010-0000,Private      ,0,1,1,1,9,10
03598300,AVALON BEAUTY COLLEGE                   ,CA,93103-3137,Proprietary  ,10,13,23,121,113,234
03614300,DAVID'S ACADEMY OF BEAUTY               ,CA,91780-1089,Proprietary  ,5,13,18,27,78,105
03639300,WEST COAST ULTRASOUND INSTITUTE         ,CA,90211-3312,Proprietary  ,35,171,206,468,1474,1942
03646300,DESIGN'S SCHOOL OF COSMETOLOGY          ,CA,93446-9530,Proprietary  ,12,36,48,85,154,239
03681300,CALIFORNIA HEALING ARTS COLLEGE         ,CA,90025-0000,Proprietary  ,16,61,77,138,372,510
03695300,COMMUNITY ENHANCEMENT SERVICES          ,CA,91502-2750,Private      ,3,24,27,18,173,191
03695700,SANTIAGO CANYON COLLEGE                 ,CA,92869-4512,Public       ,222,289,511,4907,3062,7969
03696300,UNIVERSITY OF THE WEST                  ,CA,91770-3709,Private      ,2,10,12,63,114,177
03698300,WEST COAST UNIVERSITY                   ,CA,91606-3206,Proprietary  ,203,551,754,2472,6228,8700
03698400,CA COLLEGE OF VOCATIONAL CAREER         ,CA,93301-1800,Proprietary  ,0,0,0,222,397,619
03736300,ADVANCE BEAUTY COLLEGE                  ,CA,92843-4752,Proprietary  ,15,82,97,83,445,528
03736301,ADVANCE BEAUTY COLLEGE - LAGUNA HILLS   ,CA,92653-1980,Proprietary  ,7,11,18,33,50,83
03740400,ATI COLLEGE                             ,CA,90650-0000,Proprietary  ,9,16,25,66,174,240
03752400,SCHOOL OF URBAN MISSIONS                ,CA,94603-0000,Private      ,15,36,51,236,398,634
03759300,COMPUTER TUTOR BUSINESS & TECH INST     ,CA,95356-0000,Proprietary  ,20,60,80,112,264,376
03786300,ADVANCED COLLEGE                        ,CA,90280-5255,Proprietary  ,4,22,26,106,222,328
03797400,CAREER CARE INSTITUTE                   ,CA,93534-4766,Proprietary  ,35,110,145,312,882,1194
03797401,CAREER CARE INSTITUTE - VENTURA         ,CA,93001-0000,Proprietary  ,5,24,29,79,197,276
03797402,CAREER CARE INSTITUTE - MORENO VALLEY   ,CA,92553-7519,Proprietary  ,6,23,29,63,180,243
03814400,SOKA UNIVERSITY OF AMERICA              ,CA,92656-8081,Private      ,20,7,27,557,70,627
03853300,KECK GRADUATE INSTITUTE OF APPLIED LIFE ,CA,91711-4817,Private      ,0,7,7,12,270,282
03868300,WORLD MISSION UNIVERSITY                ,CA,90020-1789,Private      ,0,14,14,12,116,128
03868400,LOS ANGELES MUSIC ACADEMY               ,CA,91105-2540,Proprietary  ,22,27,49,229,200,429
03871300,FOLSOM LAKE COLLEGE                     ,CA,95630-6798,Public       ,218,473,691,3962,4465,8427
03874300,CAMBRIDGE JUNIOR COLLEGE                ,CA,95993-0000,Proprietary  ,20,58,78,209,488,697
03874400,COMMMUNITY CHRISTIAN COLLEGE            ,CA,92373-4465,Private      ,1,16,17,102,124,226
03889300,STANBRIDGE COLLEGE                      ,CA,92612-0000,Proprietary  ,48,177,225,465,1379,1844
03901300,PACIFIC COAST TRADE SCHOOL              ,CA,93033-2441,Proprietary  ,0,0,0,51,74,125
03910400,NATIONAL POLYTECHNIC COLLEGE            ,CA,90040-3066,Proprietary  ,16,30,46,117,167,284
03933300,MUELLER COLLEGE OF HOLISTIC STUDIES     ,CA,92116-2630,Proprietary  ,7,33,40,70,265,335
03935300,CALIFORNIA NURSES EDUCATIONAL INSTITUTE ,CA,92234-7248,Proprietary  ,12,47,59,124,294,418
03962300,AMERICAN INSTITUTE OF MASSAGE THERAPY   ,CA,92705-5463,Proprietary  ,5,13,18,52,104,156
03964400,INTERNATIONAL SCHOOL OF BEAUTY          ,CA,92260-2740,Proprietary  ,15,33,48,132,271,403
03969600,UEI COLLEGE                             ,CA,90703-2637,Proprietary  ,103,289,392,582,1285,1867
03971300,AMERICAN CAREER COLLEGE                 ,CA,91764-4906,Proprietary  ,96,272,368,901,1886,2787
03973300,EX'PRESSION COLLEGE FOR DIGTAL ARTS     ,CA,94608-1021,Proprietary  ,49,52,101,564,460,1024
03974500,CALIFORNIA CAREER COLLEGE               ,CA,91303-2006,Proprietary  ,5,27,32,36,150,186
03980300,CALIFORNIA STATE UNIVERSITY CHANNEL ISLA,CA,93012-8599,Public       ,200,186,386,9840,4205,14045
03995300,UNIVERSITY OF EAST-WEST MEDICINE        ,CA,94085-3922,Proprietary  ,1,10,11,8,84,92
03999300,BEAUMONT ADULT SCHOOL                   ,CA,92223-1927,Public       ,7,48,55,39,188,227
04001300,PALACE BEAUTY COLLEGE                   ,CA,90006-4233,Proprietary  ,4,35,39,77,189,266
04003300,BLAKE AUSTIN COLLEGE                    ,CA,95687-3100,Proprietary  ,30,73,103,243,567,810
04004300,THUY PRINCESS BEAUTY COLLEGE            ,CA,91766-0000,Proprietary  ,5,21,26,28,87,115
04005300,UNITED STATES UNIVERSITY                ,CA,91911-1683,Proprietary  ,5,90,95,74,554,628
04014400,PALLADIUM TECHNICAL ACADEMY             ,CA,91731-2429,Proprietary  ,6,9,15,44,54,98
04037300,LOS ANGELES FILM SCHOOL (THE)           ,CA,90028-7300,Proprietary  ,228,384,612,2018,2660,4678
04056300,CAREER COLLEGE OF CALIFORNIA            ,CA,92705-5805,Proprietary  ,11,41,52,143,214,357
04057300,TECHSKILLS OF CALIFORNIA                ,CA,95815-4025,Proprietary  ,21,122,143,201,900,1101
04076400,GNOMON SCHOOL OF VISUAL EFFECTS         ,CA,90038-2616,Proprietary  ,17,31,48,171,274,445
04088300,WESTMED COLLEGE                         ,CA,95128-2541,Private      ,10,48,58,142,412,554
04088301,WESTMED COLLEGE - MERCED                ,CA,95340-9165,Private      ,10,30,40,123,307,430
04092300,COASTLINE BEAUTY COLLEGE                ,CA,92708-3847,Proprietary  ,4,29,33,70,209,279
04092400,MAKE-UP DESIGNORY                       ,CA,91502-1322,Proprietary  ,33,42,75,298,342,640
04100400,TAFT UNIVERSITY SYSTEM (THE)            ,CA,92704-6954,Proprietary  ,0,72,72,9,454,463
04111300,WEST HILLS COLLEGE LEMOORE              ,CA,93245-9248,Public       ,102,325,427,2492,3343,5835
04114500,VALLEY COLLEGE OF MEDICAL CAREERS       ,CA,91304-2354,Proprietary  ,6,41,47,77,153,230
04115300,COACHELLA VALLEY BEAUTY COLLEGE         ,CA,92253-2051,Proprietary  ,13,14,27,113,128,241
04115600,MAYFIELD COLLEGE                        ,CA,92234-7014,Proprietary  ,22,71,93,222,486,708
04116000,VIDEO SYMPHONY ENTERTRAINING            ,CA,91502-3253,Proprietary  ,5,9,14,77,182,259
04118800,NEW YORK FILM ACADEMY                   ,CA,91608-1002,Proprietary  ,71,141,212,895,1109,2004
04119200,CAREER COLLEGE CONSULTANTS              ,CA,90041-2088,Proprietary  ,3,32,35,39,139,178
04119800,GDS INSTITUTE                           ,CA,90280-2072,Proprietary  ,0,2,2,0,2,2
04126400,CHAMPION INSTITUTE OF COSMETOLOGY       ,CA,92264-7458,Proprietary  ,5,9,14,34,68,102
04126500,COAST CAREER INSTITUTE                  ,CA,90015-3040,Proprietary  ,17,69,86,116,357,473
04127100,"UNIVERSITY OF CALIFORNIA, MERCED        ",CA,95343-5001,Public       ,240,66,306,15841,2198,18039
04127900,TRIDENT UNIVERSITY INTERNATIONAL        ,CA,90630-5023,Proprietary  ,15,550,565,62,3377,3439
04129700,INTERNATIONAL POLYTECHNIC INSTITUTE     ,CA,92231-1737,Private      ,2,1,3,20,25,45
04129803,MEDIATECH INSTITUTE - OCEANSIDE         ,CA,92054-5116,Proprietary  ,5,22,27,63,163,226
04132400,ACADEMY OF ESTHETICS AND COSMETOLOGY    ,CA,91342-3373,Proprietary  ,5,17,22,58,102,160
04132700,INFOTECH CAREER COLLEGE                 ,CA,90706-5579,Proprietary  ,5,9,14,55,147,202
04133000,BIOHEALTH COLLEGE                       ,CA,95134-2033,Proprietary  ,0,0,0,68,178,246
04133100,CALIFORNIA UNIVERSITY OF MANAGEMENT AND ,CA,92801-1702,Private      ,2,14,16,24,100,124
04134500,CAREER COLLEGE OF SAN DIEGO             ,CA,92102-3348,Proprietary  ,23,100,123,278,696,974
04134700,INTERNATL PROFESSIONAL SCHL OF BODYWORK ,CA,92123-1520,Proprietary  ,3,24,27,43,245,288
04137200,BORNER'S BARBER COLLEGE                 ,CA,90047-3856,Proprietary  ,8,43,51,91,263,354
04138700,PAUL MITCHELL THE SCHOOL - PASADENA     ,CA,91801-3903,Proprietary  ,11,22,33,96,122,218
04140500,HORIZON UNIVERSITY                      ,CA,92111-2622,Private      ,1,13,14,39,109,148
04141300,SAN FRANCISCO INSTITUTE OF ESTHETICS    ,CA,94103-4083,Proprietary  ,15,29,44,136,232,368
04141400,LAURUS COLLEGE                          ,CA,93401-5405,Proprietary  ,25,145,170,206,1000,1206
04141700,HEALING HANDS SCHOOL OF HOLISTIC HEALTH ,CA,92025-1722,Proprietary  ,6,47,53,51,248,299
04142500,TOURO COLLEGE LOS ANGELES               ,CA,90046-4506,Private      ,5,44,49,118,346,464
04142600,TOURO UNIVERSITY                        ,CA,94592-1118,Private      ,2,63,65,34,2897,2931
04143800,WOODLAND COMMUNITY COLLEGE              ,CA,95776-5156,Public       ,95,249,344,1500,1864,3364
04144200,CAREER DEVELOPMENT INSTITUTE            ,CA,90035-4364,Proprietary  ,5,25,30,50,194,244
04145000,SAN DIEGO CULINARY INSTITUTE            ,CA,91941-6435,Proprietary  ,21,73,94,344,571,915
04145600,INTERNATIONAL COLLEGE OF COSMETOLOGY    ,CA,94601-3525,Proprietary  ,4,35,39,72,207,279
04146000,NATIONAL CAREER COLLEGE                 ,CA,91605-1400,Proprietary  ,13,47,60,69,233,302
04148200,BEYOND 21ST CENTURY BEAUTY ACADEMY      ,CA,90670-6316,Proprietary  ,3,2,5,33,39,72
04148900,N CALIF INSTITUTE OF COSMETOLOGY        ,CA,94577-2820,Proprietary  ,2,13,15,23,57,80
04149700,HOMESTEAD SCHOOLS                       ,CA,90505-5945,Private      ,11,37,48,56,248,304
04150000,CENTRAL NURSING COLLEGE                 ,CA,90010-2444,Proprietary  ,8,31,39,206,327,533
04150100,GOLDEN STATE COLLEGE OF COURT REPORTING ,CA,94568-2948,Proprietary  ,0,9,9,9,57,66
04150300,RWM FIBER OPTICS                        ,CA,90746-1051,Proprietary  ,4,45,49,17,128,145
04150500,"PREFERRED COLLEGE OF NURSING, LOS ANGELE",CA,90010-2202,Proprietary  ,6,21,27,95,202,297
04152800,CALIFORNIA ACADEMY (THE) - A PAUL MITCHE,CA,95825-2276,Proprietary  ,48,121,169,440,648,1088
04153900,PROVIDENCE CHRISTIAN COLLEGE            ,CA,91104-2635,Private      ,10,4,14,113,48,161
04155500,"ACADEMY FOR JEWISH RELIGION, CALIFORNIA ",CA,90024-3234,Private      ,1,16,17,31,98,129
04156100,TONI & GUY HAIRDRESSING ACADEMY         ,CA,95356-9695,Proprietary  ,7,25,32,90,159,249
04157800,GRACE MISSION UNIVERSITY                ,CA,92833-3860,Private      ,0,7,7,17,76,93
04158200,PAUL MITCHELL THE SCHOOL SHERMAN OAKS   ,CA,91403-5882,Proprietary  ,21,33,54,194,246,440
04158700,HOLLYWOOD BEAUTY COLLEGE                ,CA,95210-3514,Proprietary  ,3,18,21,69,169,238
04158900,FLAIR BEAUTY COLLEGE                    ,CA,91351-3381,Proprietary  ,4,6,10,35,59,94
04159600,GALAXY MEDICAL COLLEGE                  ,CA,91606-1593,Proprietary  ,3,17,20,54,81,135
04159700,AMERICAN MEDICAL SCIENCES CENTER        ,CA,91204-5108,Proprietary  ,7,19,26,87,146,233
04160100,TRINITY VOCATIONAL CENTER               ,CA,90248-4334,Proprietary  ,2,16,18,26,170,196
04160400,ANGELES COLLEGE OF NURSING              ,CA,90010-2100,Proprietary  ,32,79,111,458,657,1115
04161300,PREFERRED COLLEGE OF NURSING            ,CA,91401-1442,Proprietary  ,1,9,10,31,96,127
04161700,SHASTA SCHOOL OF COSMETOLOGY            ,CA,96003-0000,Proprietary  ,4,26,30,99,159,258
04161800,BRANDMAN UNIVERSITY                     ,CA,92618-3801,Private      ,30,854,884,524,9074,9598
04162800,S.I.C.E PAUL MITCHELL PARTNER SCHOOL    ,CA,95350-1440,Proprietary  ,20,55,75,270,352,622
04163400,COSMO BEAUTY ACADEMY                    ,CA,95605-1904,Proprietary  ,12,43,55,175,330,505
04164400,ANGELES INSTITUTE                       ,CA,90712-2903,Proprietary  ,9,36,45,88,215,303
04165900,PAUL MITCHELL THE SCHOOL FRESNO         ,CA,93710-7617,Proprietary  ,18,37,55,362,289,651
04167000,PAUL MITCHELL THE SCHOOL TEMECULA       ,CA,92591-4663,Proprietary  ,26,44,70,292,305,597
04169200,TRAMY BEAUTY SCHOOL                     ,CA,92115-6347,Proprietary  ,6,39,45,100,263,363
04169700,UNITEK COLLEGE                          ,CA,94538-3185,Proprietary  ,66,411,477,518,2299,2817
04169800,GURNICK ACADEMY OF MEDICAL ARTS         ,CA,94403-1849,Proprietary  ,34,187,221,337,1634,1971
04172000,SOUTHERN CALIFORNIA UNIVERSITY SOMA     ,CA,90017-2211,Proprietary  ,12,36,48,234,385,619
04173400,SANTA ANA BEAUTY ACADEMY                ,CA,92705-7820,Proprietary  ,2,12,14,44,66,110
04173500,MORENO VALLEY COLLEGE                   ,CA,92551-2204,Public       ,237,553,790,5610,7083,12693
04175200,PAUL MITCHELL THE SCHOOL EAST BAY       ,CA,94523-5515,Proprietary  ,27,30,57,213,249,462
04175400,ELITE COSMETOLOGY SCHOOL                ,CA,92284-2860,Proprietary  ,4,22,26,37,134,171
04176100,NORCO COLLEGE                           ,CA,92860-2600,Public       ,214,398,612,5406,5211,10617
04176200,TWIN RIVERS ADULT SCHOOL                ,CA,95660-5523,Public       ,0,0,0,8,22,30
04176300,BERGIN UNIVERSITY OF CANINE STUDIES     ,CA,95407-6834,Private      ,3,7,10,40,70,110
04177200,REAL BARBERS COLLEGE (THE)              ,CA,92805-2533,Proprietary  ,21,37,58,96,164,260
04178900,HANDS-ON MEDICAL MASSAGE SCHOOL         ,CA,92373-6271,Proprietary  ,4,1,5,31,53,84
04180000,CINTA AVEDA INSTITUTE                   ,CA,94108-3204,Proprietary  ,27,65,92,202,460,662
04181200,SOUTHERN CALIFORNIA HEALTH INSTITUTE    ,CA,91601-3100,Proprietary  ,24,104,128,75,333,408
04181600,INTEGRITY COLLEGE OF HEALTH             ,CA,91104-2300,Proprietary  ,3,14,17,23,92,115
04185200,SALINAS BEAUTY COLLEGE                  ,CA,93901-2405,Proprietary  ,2,13,15,62,104,166
04185500,ACADEMY OF COUTURE ART                  ,CA,90069-5701,Proprietary  ,7,17,24,155,172,327
04185600,MEDICAL ALLIED CAREER CENTER            ,CA,90670-4710,Proprietary  ,2,29,31,18,116,134
04185700,ACADEMY FOR SALON PROFESSIONALS (THE)   ,CA,95050-4057,Proprietary  ,14,28,42,101,170,271
04186900,"INTERNATIONAL COLLEGE OF BEAUTY, ARTS & ",CA,90039-1012,Proprietary  ,5,31,36,131,225,356
04187900,JOE BLASCO MAKEUP ARTIST TRAINING CENTER,CA,90027-5580,Proprietary  ,0,0,0,4,7,11
04189300,ALLIED AMERICAN UNIVERSITY              ,CA,92653-1337,Proprietary  ,19,467,486,123,2473,2596
04189700,CALIFORNIA MIRAMAR UNIVERSITY           ,CA,92126-7501,Proprietary  ,25,81,106,477,667,1144
04189800,ACADEMY FOR SALON PROFESSIONALS         ,CA,91304-2305,Proprietary  ,2,23,25,44,120,164
04190800,SANTA ANA BEAUTY COLLEGE                ,CA,92706-2321,Proprietary  ,3,21,24,83,160,243
04190900,SUTTER BEAUTY COLLEGE                   ,CA,95991-3624,Proprietary  ,6,24,30,86,143,229
04191300,ANNENBERG SCHOOL OF NURSING             ,CA,91335-5426,Private      ,2,16,18,54,92,146
04193500,LEMELANGE ACADEMY OF HAIR               ,CA,94558-2935,Proprietary  ,2,9,11,28,61,89
04193700,JOHN PAUL THE GREAT CATHOLIC UNIVERSITY ,CA,92131-1652,Private      ,13,11,24,255,133,388
04194300,COLTON-REDLANDS-YUCAIPA REGIONAL OCCUPAT,CA,92374-2896,Public       ,6,37,43,92,209,301
04194600,BRAND COLLEGE                           ,CA,91203-3646,Proprietary  ,0,7,7,30,57,87
04195200,DIAMOND BEAUTY COLLEGE                  ,CA,91733-2180,Proprietary  ,2,24,26,18,65,83
04195400,NCP COLLEGE OF NURSING                  ,CA,94080-1005,Proprietary  ,1,27,28,86,240,326
04195401,NCP COLLEGE OF NURSING - HAYWARD CAMPUS ,CA,94541-7026,Proprietary  ,11,37,48,132,356,488
04205800,"SAE INSTITUTE OF TECHNOLOGY, LOS ANGELES",CA,90028-7219,Proprietary  ,22,54,76,284,409,693
04206800,ADVANCE BEAUTY TECHS ACADEMY            ,CA,92583-6572,Proprietary  ,5,12,17,49,89,138
04208100,UKIAH ADULT SCHOOL                      ,CA,95482-3865,Public       ,0,14,14,21,93,114
04208400,RIVERSIDE COUNTY OFFICE OF EDUCATION    ,CA,92503-3504,Public       ,13,65,78,309,511,820
04208900,ADVANCED CAREER INSTITUTE               ,CA,93291-9254,Proprietary  ,7,81,88,79,370,449
04209000,SAN FRANCISCO COLLEGE OF COSMETOLOGY    ,CA,94110-1217,Proprietary  ,1,12,13,1,12,13
04209800,HINTON BARBER COLLEGE                   ,CA,94590-4547,Proprietary  ,6,14,20,36,97,133
04210600,ADVANCED COMPUTING INSTITUTE            ,CA,90010-3911,Proprietary  ,3,75,78,137,298,435
04211900,XAVIER COLLEGE SCHOOL OF NURSING        ,CA,95202-1332,Proprietary  ,6,50,56,158,394,552
04212000,LAWRENCE & COMPANY COLLEGE OF COSMETOLOG,CA,93230-4102,Proprietary  ,6,19,25,87,115,202
04215100,CALIFORNIA CAREER INSTITUTE             ,CA,92840-2816,Proprietary  ,3,40,43,46,275,321
04215300,COSMO FACTORY COSMETOLOGY ACADEMY (THE) ,CA,95060-4401,Proprietary  ,5,8,13,47,78,125
04216300,UEI COLLEGE                             ,CA,95065-1520,Proprietary  ,3,10,13,101,146,247
04217100,RUDOLF STEINER COLLEGE                  ,CA,95628-6811,Private      ,0,4,4,5,74,79
04217400,HIGH TECH HIGH GRADUATE SCHOOL OF EDUCAT,CA,92106-6025,Private      ,3,9,12,9,27,36
04217500,W INSTITUTE OF COSMETOLOGY              ,CA,94521-5385,Proprietary  ,6,12,18,35,66,101
04221800,TONI&GUY HAIRDRESSING ACADEMY           ,CA,95337-5703,Proprietary  ,7,11,18,67,107,174
04221900,COMPUTER TRAINING ACADEMY               ,CA,92507-2122,Proprietary  ,11,63,74,116,408,524
04222200,FAB SCHOOL (THE)                        ,CA,92507-3434,Proprietary  ,26,40,66,143,267,410
04223700,BAY AREA MEDICAL ACADEMY                ,CA,94102-2844,Proprietary  ,17,49,66,215,344,559
04226100,LAWRENCE AND COMPANY COLLEGE OF COSMETOL,CA,93662-3509,Proprietary  ,6,4,10,34,47,81
04228100,HIGH DESERT MEDICAL COLLEGE             ,CA,93534-1134,Proprietary  ,18,99,117,152,494,646
04228800,BAY AREA COLLEGE OF NURSING             ,CA,94303-4617,Proprietary  ,6,18,24,14,70,84
04234000,SAN FRANCISCO SCHOOL OF DIGITAL FILMMAKI,CA,94103-2835,Proprietary  ,8,20,28,27,64,91
04237100,SALON PROFESSIONAL ACADEMY (THE)        ,CA,95129-5101,Proprietary  ,9,28,37,47,140,187
04237800,CALIFORNIA BARBER AND BEAUTY COLLEGE    ,CA,92115-4730,Proprietary  ,22,65,87,53,171,224
00184600,BRIAR CLIFF UNIVERSITY                  ,IA,51104-2100,Private      ,37,47,84,1213,684,1897
00184700,BUENA VISTA UNIVERSITY                  ,IA,50588-9987,Private      ,31,168,199,1525,1950,3475
00184800,SOUTHEASTERN COMMUNITY COLLEGE          ,IA,52655-0000,Public       ,52,136,188,1163,1579,2742
00185000,CENTRAL COLLEGE                         ,IA,50219-1999,Private      ,41,7,48,2267,110,2377
00185200,CLARKE UNIVERSITY                       ,IA,52001-3198,Private      ,24,25,49,1283,569,1852
00185400,COE COLLEGE                             ,IA,52402-5092,Private      ,35,20,55,2504,272,2776
00185500,DES MOINES UNIV-OSTEOPATHIC MED CTR     ,IA,50312-0000,Private      ,2,46,48,51,1687,1738
00185600,CORNELL COLLEGE                         ,IA,52314-1098,Private      ,32,4,36,1893,124,2017
00185700,SOUTHWESTERN COMMUNITY COLLEGE          ,IA,50801-1098,Public       ,25,58,83,692,570,1262
00185800,DIVINE WORD COLLEGE                     ,IA,52045-0380,Private      ,5,0,5,24,16,40
00185900,DORDT COLLEGE                           ,IA,51250-1697,Private      ,14,8,22,1492,109,1601
00186000,DRAKE UNIVERSITY                        ,IA,50311-4505,Private      ,110,96,206,5067,2025,7092
00186200,ELLSWORTH COMMUNITY COLLEGE             ,IA,50126-1199,Public       ,21,31,52,852,326,1178
00186400,IOWA LAKES COMMUNITY COLLEGE            ,IA,51334-2234,Public       ,36,78,114,1095,827,1922
00186500,IOWA CENTRAL COMMUNITY COLLEGE          ,IA,50501-0000,Public       ,92,343,435,3034,2998,6032
00186600,GRACELAND UNIVERSITY                    ,IA,50140-1699,Private      ,33,91,124,1444,1497,2941
00186700,GRAND VIEW UNIVERSITY                   ,IA,50316-1599,Private      ,46,102,148,2135,1396,3531
00186800,GRINNELL COLLEGE                        ,IA,50112-1690,Private      ,67,7,74,3295,129,3424
00186900,IOWA STATE UNIV SCIENCE & TECHNOLOG     ,IA,50011-2028,Public       ,469,329,798,29018,6405,35423
00187100,IOWA WESLEYAN COLLEGE                   ,IA,52641-1398,Private      ,41,18,59,633,312,945
00187300,LORAS COLLEGE                           ,IA,52004-0178,Private      ,30,16,46,2014,221,2235
00187400,LUTHER COLLEGE                          ,IA,52101-1045,Private      ,37,9,46,3167,129,3296
00187500,MARSHALLTOWN COMMUNITY COLLEGE          ,IA,50158-4760,Public       ,42,94,136,790,811,1601
00187700,NORTH IOWA AREA COMMUNITY COLLEGE       ,IA,50401-7299,Public       ,53,111,164,1392,994,2386
00187900,MORNINGSIDE COLLEGE                     ,IA,51106-1751,Private      ,100,89,189,2174,943,3117
00188000,MOUNT MERCY UNIVERSITY                  ,IA,52402-4797,Private      ,23,91,114,1067,1142,2209
00188300,NORTHWESTERN COLLEGE                    ,IA,51041-1996,Private      ,19,10,29,1412,175,1587
00188700,SIMPSON COLLEGE                         ,IA,50125-1297,Private      ,28,23,51,2173,479,2652
00188900,ST AMBROSE UNIVERSITY                   ,IA,52803-2898,Private      ,70,87,157,3370,1470,4840
00189000,UNIVERSITY OF NORTHERN IOWA             ,IA,50614-0002,Public       ,208,175,383,10183,2899,13082
00189100,UNIVERSITY OF DUBUQUE                   ,IA,52001-5099,Private      ,50,62,112,2171,779,2950
00189200,UNIVERSITY OF IOWA                      ,IA,52242-1316,Public       ,486,412,898,22070,9158,31228
00189300,UPPER IOWA UNIVERSITY                   ,IA,52142-9206,Private      ,58,520,578,1741,5350,7091
00189500,WALDORF COLLEGE                         ,IA,50436-1700,Proprietary  ,12,118,130,712,1047,1759
00189600,WARTBURG COLLEGE                        ,IA,50677-2200,Private      ,25,7,32,2240,117,2357
00189700,WARTBURG THEOLOGICAL SEMINARY           ,IA,52004-5004,Private      ,2,1,3,11,121,132
00190000,WILLIAM PENN UNIVERSITY                 ,IA,52577-1799,Private      ,22,84,106,1271,1011,2282
00396300,AIB COLLEGE OF BUSINESS                 ,IA,50321-1799,Private      ,23,67,90,834,809,1643
00407500,ESTRN IOWA COMMUNITY COLLEGE DIST       ,IA,52801-1201,Public       ,16,83,99,227,684,911
00407501,CLINTON COMMUNITY COLLEGE               ,IA,52732-0000,Public       ,29,178,207,515,2262,2777
00407502,MUSCATINE COMMUNITY COLLEGE             ,IA,52761-0000,Public       ,27,73,100,604,691,1295
00407503,SCOTT COMMUNITY COLLEGE                 ,IA,52722-0000,Public       ,100,290,390,1589,2766,4355
00407600,KIRKWOOD COMMUNITY COLLEGE              ,IA,52406-2068,Public       ,231,723,954,6558,6876,13434
00423300,MERCY/ST. LUKE'S SCH RAD TECH           ,IA,52402-0000,Private      ,2,2,4,40,47,87
00458600,KAPLAN UNIVERSITY                       ,IA,52807-2095,Proprietary  ,593,10152,10745,3843,76516,80359
00458604,KAPLAN UNIVERSITY - CEDAR RAPIDS        ,IA,52404-2998,Proprietary  ,21,206,227,167,1841,2008
00458605,KAPLAN UNIVERSITY - DES MOINES          ,IA,50323-5702,Proprietary  ,21,257,278,195,2127,2322
00458606,KAPLAN UNIVERSITY - MASON CITY          ,IA,50401-4665,Proprietary  ,7,99,106,67,875,942
00458607,KAPLAN UNIVERSITY - CEDAR FALLS         ,IA,50613-6309,Proprietary  ,12,166,178,139,1429,1568
00458700,NORTHEAST IOWA COMMUNITY COLLEGE        ,IA,52132-0400,Public       ,22,77,99,683,666,1349
00458701,NORTHEAST IOWA COMMUNITY COLLEGE        ,IA,52068-0000,Public       ,51,131,182,1033,1248,2281
00459500,HAWKEYE COMMUNITY COLLEGE               ,IA,50701-0000,Public       ,150,340,490,2773,2692,5465
00459800,IOWA WESTERN CMTY CLG-COUNCIL BLUFF     ,IA,51502-0000,Public       ,183,346,529,3783,3611,7394
00460000,NORTHWEST IOWA COMMUNITY COLLEGE        ,IA,51201-1046,Public       ,22,51,73,578,462,1040
00626700,IOWA METHODIST MEDICAL CENTER SCHOOLS   ,IA,50309-1499,Private      ,0,15,15,38,111,149
00627300,MERCY COLLEGE OF HEALTH SCIENCES        ,IA,50309-1239,Private      ,10,85,95,485,973,1458
00712000,DES MOINES AREA CMTY COLLEGE            ,IA,50021-0000,Public       ,410,1085,1495,7958,9868,17826
00712100,FAITH BAPTIST BIBLE CLG & THEOL SEM     ,IA,50021-0000,Private      ,9,8,17,298,79,377
00729100,ST LUKE'S COLLEGE                       ,IA,51104-0263,Private      ,3,19,22,144,239,383
00731600,WESTERN IOWA TECH COMMUNITY COLLEGE     ,IA,51106-0000,Public       ,121,382,503,2160,3226,5386
00758800,CAPRI COLLEGE                           ,IA,52004-0873,Proprietary  ,19,25,44,131,177,308
00761100,EQ SCHOOL OF HAIR DESIGN                ,IA,51503-0813,Proprietary  ,2,16,18,45,77,122
00765600,AMERICAN COLLEGE OF HARISTYLING -CR     ,IA,52402-0000,Proprietary  ,1,6,7,11,47,58
00765800,AMER COLL OF HAIRSTYLING-DES MOINES     ,IA,50309-5446,Proprietary  ,2,19,21,22,74,96
00765900,LA JAMES COLLEGE OF HAIRSTYLING         ,IA,50401-3308,Proprietary  ,6,8,14,64,66,130
00771700,CAPRI COLLEGE                           ,IA,52807-2622,Proprietary  ,14,27,41,129,207,336
00794100,COLLEGE OF HAIR DESIGN                  ,IA,50703-1834,Proprietary  ,1,9,10,11,56,67
00826000,IOWA SCHOOL OF BEAUTY INC               ,IA,50322-0000,Proprietary  ,9,28,37,107,244,351
00840300,INDIAN HILLS COMMUNITY COLLEGE          ,IA,52501-1398,Public       ,97,291,388,2001,2402,4403
00842400,LA JAMES INTERNATIONAL COLLEGE          ,IA,50501-5577,Proprietary  ,3,6,9,46,59,105
00959300,LA'JAMES COLLEGE OF HAIRSTYLING         ,IA,52240-0000,Proprietary  ,4,5,9,52,95,147
01111300,MAHARISHI UNIV OF MANAGEMENT            ,IA,52557-0001,Private      ,7,51,58,143,499,642
01206400,HAMILTON TECHNICAL COLLEGE              ,IA,52807-2653,Proprietary  ,10,40,50,96,265,361
01230000,PALMER COLLEGE OF CHIROPRACTIC          ,IA,52803-5287,Private      ,6,75,81,91,2328,2419
01300600,LA' JAMES INTERNATIONAL COLLEGE-CF      ,IA,50613-5242,Proprietary  ,2,13,15,35,62,97
02090300,CAPRI COLLEGE                           ,IA,52404-0000,Proprietary  ,12,21,33,135,169,304
02134500,LA JAMES INTERNATIONAL COLLEGE - DAV    ,IA,52806-3952,Proprietary  ,4,11,15,30,91,121
02160900,PCI ACADEMY                             ,IA,50010-6062,Proprietary  ,6,10,16,122,101,223
02262500,FAUST INSTITUTE OF COSMETOLOGY          ,IA,50588-0000,Proprietary  ,0,1,1,29,33,62
02274100,LA' JAMES INTERNATIONAL COLLEGE - DM    ,IA,50131-0000,Proprietary  ,4,12,16,67,99,166
02289000,AMERICAN HAIR ACADEMY                   ,IA,52627-4530,Proprietary  ,0,1,1,23,32,55
02306900,IOWA SCHOOL OF BEAUTY                   ,IA,52501-0000,Proprietary  ,3,2,5,45,57,102
02328900,EMMAUS BIBLE COLLEGE                    ,IA,52001-0000,Private      ,4,7,11,245,64,309
02330900,IOWA SCHOOL OF BEAUTY                   ,IA,50158-0000,Proprietary  ,1,5,6,19,44,63
02609200,VATTEROTT COLLEGE                       ,IA,50321-4704,Proprietary  ,14,95,109,107,556,663
03065302,PAUL MITCHELL THE SCHOOL DAVENPORT      ,IA,52806-4000,Proprietary  ,6,8,14,8,26,34
03069100,ALLEN COLLEGE                           ,IA,50703-1916,Private      ,6,46,52,397,587,984
03441300,IOWA SCHOOL OF BEAUTY                   ,IA,51106-5111,Proprietary  ,7,8,15,39,96,135
03607400,TOTAL LOOK SCHOOL OF COSMETOLOGY AND MAS,IA,52136-1053,Proprietary  ,0,0,0,5,14,19
03720300,CARLSON COLLEGE OF MASSAGE THERAPY      ,IA,52205-7519,Proprietary  ,1,5,6,14,31,45
04051313,ART INSTITUTE OF PHOENIX (THE) - BROWN M,IA,52722-3628,Proprietary  ,0,10,10,19,100,119
04177800,SALON PROFESSIONAL ACADEMY (THE)        ,IA,52240-6083,Proprietary  ,8,6,14,47,68,115
04203300,AVEDA INSTITUTE DES MOINES              ,IA,50266-8137,Proprietary  ,18,22,40,186,166,352
00259600,ATLANTIC COMMUNITY COLLEGE              ,NJ,08330-2699,Public       ,279,696,975,3992,4886,8878
00259700,BLOOMFIELD COLLEGE                      ,NJ,07003-3425,Private      ,88,112,200,3062,1597,4659
00259800,CALDWELL COLLEGE                        ,NJ,07006-6195,Private      ,81,92,173,2599,1161,3760
00259900,CENTENARY COLLEGE                       ,NJ,07840-2184,Private      ,34,88,122,1700,947,2647
00260000,COLLEGE OF SAINT ELIZABETH              ,NJ,07960-6989,Private      ,14,54,68,1168,749,1917
00260100,CUMBERLAND COUNTY COLLEGE               ,NJ,08362-9912,Public       ,162,426,588,2421,3436,5857
00260300,DREW UNIVERSITY                         ,NJ,07940-4063,Private      ,70,38,108,2781,628,3409
00260700,FAIRLEIGH DICKINSON UNIV-TEANECK        ,NJ,07666-1996,Private      ,150,251,401,4323,3098,7421
00260701,FAIRLEIGH DICKINSON UNIV-FLORHAM        ,NJ,07940-0000,Private      ,115,79,194,3856,1190,5046
00260702,FAIRLEIGH DICKINSON UNIV-ED WMS CLG     ,NJ,07601-0000,Private      ,27,47,74,626,605,1231
00260703,FAIRLEIGH DICKINSON UNIVERSITY          ,NJ,07940-0000,Private      ,59,72,131,1562,842,2404
00260800,GEORGIAN COURT UNIVERSITY               ,NJ,08701-2697,Private      ,44,98,142,1734,1353,3087
00260900,ROWAN UNIVERSITY                        ,NJ,08028-1702,Public       ,504,468,972,16160,6340,22500
00261000,FELICIAN COLLEGE                        ,NJ,07644-2198,Private      ,54,111,165,1947,1398,3345
00261300,NEW JERSEY CITY UNIVERSITY              ,NJ,07305-1597,Public       ,169,467,636,5304,6617,11921
00261500,MIDDLESEX COUNTY COLLEGE                ,NJ,08818-3050,Public       ,395,546,941,7021,5339,12360
00261600,MONMOUTH UNIVERSITY                     ,NJ,07764-1898,Private      ,255,176,431,8584,2608,11192
00261700,MONTCLAIR STATE UNIVERSITY              ,NJ,07043-9987,Public       ,637,595,1232,20557,8559,29116
00261900,NEW BRUNSWICK THEOLOGICAL SEMINARY      ,NJ,08901-0000,Private      ,3,14,17,89,202,291
00262100,NEW JERSEY INST OF TECHNOLOGY           ,NJ,07102-1982,Public       ,241,308,549,7580,4136,11716
00262200,KEAN UNIVERSITY                         ,NJ,07083-7131,Public       ,452,634,1086,12484,9530,22014
00262400,OCEAN COUNTY COLLEGE                    ,NJ,08754-2001,Public       ,266,511,777,5113,4446,9559
00262500,WILLIAM PATERSON UNIVERSITY             ,NJ,07470-2152,Public       ,388,348,736,13627,5792,19419
00262600,PRINCETON THEOLOGICAL SEMINARY          ,NJ,08542-0000,Private      ,0,20,20,16,589,605
00262700,PRINCETON UNIVERSITY                    ,NJ,08544-0001,Private      ,618,131,749,16930,1682,18612
00262800,RIDER UNIVERSITY                        ,NJ,08648-3099,Private      ,240,128,368,8750,1746,10496
00262900,"RUTGERS, THE STATE UNIVERSITY OF NJ     ",NJ,08901-1281,Public       ,1660,1837,3497,51322,29992,81314
00263200,SETON HALL UNIVERSITY                   ,NJ,07079-2697,Private      ,362,284,646,12363,4217,16580
00263201,SETON HALL UNIVERSITY - SCHOOL OF LAW   ,NJ,07079-5210,Private      ,22,86,108,272,1613,1885
00263800,SAINT PETER'S UNIVERSITY                ,NJ,07306-5997,Private      ,100,169,269,4156,2175,6331
00263900,STEVENS INSTITUTE OF TECHNOLOGY         ,NJ,07030-5370,Private      ,158,65,223,5159,674,5833
00264200,COLLEGE OF NEW JERSEY (THE)             ,NJ,08628-0718,Public       ,320,128,448,12263,1545,13808
00264300,UNION COUNTY COLLEGE                    ,NJ,07016-1598,Public       ,355,931,1286,5883,8467,14350
00473600,BERGEN COMMUNITY COLLEGE                ,NJ,07652-1595,Public       ,424,617,1041,8925,6263,15188
00474000,MERCER COUNTY COMMUNITY COLLEGE         ,NJ,08690-0000,Public       ,220,444,664,3718,4420,8138
00539900,MONMOUTH COUNTY VOCATIONAL SCH DIST     ,NJ,07728-5033,Public       ,2,19,21,77,159,236
00545200,TETERBORO SCH OF AERONAUTICS            ,NJ,07608-1083,Proprietary  ,33,30,63,112,138,250
00546100,SALEM COMMUNITY COLLEGE                 ,NJ,08069-2799,Public       ,26,73,99,618,766,1384
00641700,HOLY NAME MEDICAL CENTER SCHOOL OF NURSI,NJ,07666-4254,Private      ,2,9,11,77,311,388
00642000,MOUNTAINSIDE HOSP SCH NRSG              ,NJ,07042-4898,Proprietary  ,1,8,9,49,199,248
00642100,MUHLENBERG SNYDER SCHOOLS               ,NJ,07061-3399,Private      ,9,33,42,120,537,657
00642900,ST FRANCIS MEDICAL CTR SCH NURSING      ,NJ,08629-1986,Private      ,7,22,29,43,143,186
00642902,ST FRANCIS MED CTR RAD TECH             ,NJ,08629-0000,Private      ,1,11,12,16,74,90
00686500,CAMDEN COUNTY COLLEGE                   ,NJ,08012-3240,Public       ,367,996,1363,6532,8650,15182
00690100,GLOUCESTER COUNTY COLLEGE               ,NJ,08080-4249,Public       ,175,332,507,4154,3470,7624
00710700,ESSEX COUNTY COLLEGE                    ,NJ,07102-1798,Public       ,397,1019,1416,6167,9875,16042
00750200,BERKELEY COLLEGE                        ,NJ,07424-3367,Proprietary  ,164,469,633,2649,4100,6749
00759300,PARISIAN BEAUTY ACADEMY                 ,NJ,07601-5509,Proprietary  ,24,40,64,211,283,494
00772900,COUNTY COLLEGE OF MORRIS                ,NJ,07869-0000,Public       ,215,265,480,4011,2209,6220
00773000,BURLINGTON COUNTY COLLEGE               ,NJ,08068-1599,Public       ,266,628,894,4539,5467,10006
00773100,RARITAN VALLEY COMMUNITY COLLEGE        ,NJ,08876-1265,Public       ,162,243,405,3002,2370,5372
00780401,STAR CAREER ACADEMY - STAR LAKEWOOD     ,NJ,08701-5900,Proprietary  ,23,71,94,144,394,538
00780402,STAR CAREER ACADEMY - STAR EGG HARBOR   ,NJ,08234-4863,Proprietary  ,24,85,109,108,329,437
00793808,LINCOLN TECHNICAL INSTITUTE - SOUTH PLAI,NJ,07080-2424,Proprietary  ,17,39,56,194,237,431
00793810,LINCOLN TECHNICAL INSTITUTE - MAHWAH    ,NJ,07430-2106,Proprietary  ,86,68,154,563,397,960
00793811,LINCOLN TECHNICAL INSTITUTE - UNION     ,NJ,07083-5032,Proprietary  ,106,155,261,790,825,1615
00794700,BETH MEDRASH GOVOHA OF AMERICA          ,NJ,08701-0000,Private      ,116,318,434,294,1766,2060
00840400,BROOKDALE COMMUNITY COLLEGE             ,NJ,07738-1597,Public       ,277,513,790,6071,4675,10746
00844101,ANTHEM INSTITUTE                        ,NJ,08002-0000,Proprietary  ,0,0,0,66,267,333
00849400,HO HO KUS SCHL OF TRADE & TECH SCIENCES ,NJ,07513-1402,Proprietary  ,14,48,62,114,238,352
00860900,RABBINICAL COLLEGE OF AMERICA           ,NJ,07960-3600,Private      ,35,20,55,80,28,108
00907800,CAPRI INSTITUTE OF HAIR DESIGN          ,NJ,07011-2111,Proprietary  ,18,37,55,89,204,293
00934400,RAMAPO COLLEGE OF NEW JERSEY            ,NJ,07430-1680,Public       ,239,104,343,7948,1709,9657
00934500,RICHARD STOCKTON COLLEGE OF NJ          ,NJ,08205-9441,Public       ,277,253,530,9831,3632,13463
00982804,EVEREST INSTITUTE - SOUTH PLAINFIELD    ,NJ,07080-1125,Proprietary  ,35,88,123,243,595,838
00999400,PASSAIC COUNTY COMMUNITY COLLEGE        ,NJ,07505-1179,Public       ,312,518,830,4834,5371,10205
01062900,P B COSMETOLOGY EDUCATION CENTRE        ,NJ,08030-1750,Proprietary  ,6,16,22,105,130,235
01085100,ANTHEM INSTITUTE                        ,NJ,07054-3409,Proprietary  ,38,118,156,194,660,854
01085101,ANTHEM INSTITUTE                        ,NJ,07306-0000,Proprietary  ,3,10,13,46,134,180
01085102,ANTHEM INSTITUTE                        ,NJ,08902-0000,Proprietary  ,1,14,15,37,107,144
01090300,RIZZIERI INSTITUTE                      ,NJ,08043-4600,Proprietary  ,16,24,40,144,176,320
01152300,MORRIS COUNTY SCHOOL OF TECHNOLOGY      ,NJ,07834-0000,Public       ,3,4,7,68,107,175
01198900,TALMUDICAL ACADEMY                      ,NJ,07710-0000,Private      ,8,4,12,48,6,54
01209000,ROBERT FIANCE BEAUTY SCHOOLS            ,NJ,08861-4118,Proprietary  ,19,24,43,111,167,278
01246100,LINCOLN TECHNICAL INSTITUTE             ,NJ,08820-2896,Proprietary  ,20,75,95,275,681,956
01246102,LINCOLN TECHNICAL INSTITUTE             ,NJ,08057-3212,Proprietary  ,13,87,100,228,701,929
01246103,LINCOLN TECHNICAL INSTITUTE             ,NJ,07652-2106,Proprietary  ,40,79,119,373,719,1092
01246200,HOHOKUS - HACKENSACK SCHOOL OF BUSINESS ,NJ,07601-7197,Proprietary  ,34,115,149,150,551,701
01295400,HUDSON COUNTY COMMUNITY COLLEGE         ,NJ,07306-4012,Public       ,316,809,1125,5708,6751,12459
02053700,EASTWICK COLLEGE                        ,NJ,07446-0000,Proprietary  ,62,166,228,390,1255,1645
02061800,ROMAN ACADEMY OF BEAUTY CULTURE         ,NJ,07506-0000,Proprietary  ,2,3,5,18,23,41
02092300,HOHOKUS SCHOOL - RETS/NUTLEY            ,NJ,07110-0000,Proprietary  ,31,86,117,186,406,592
02103700,CAPRI INSTITUTE OF HAIR DESIGN          ,NJ,07652-0000,Proprietary  ,8,25,33,68,102,170
02104000,HARRIS SCHOOL OF BUSINESS               ,NJ,08002-2983,Proprietary  ,108,429,537,474,1808,2282
02106601,AMERICAN INSTITUTE - CLIFTON            ,NJ,07011-2345,Proprietary  ,34,116,150,219,610,829
02106605,AMERICAN INSTITUTE - TOMS RIVER         ,NJ,08755-1524,Proprietary  ,18,85,103,87,428,515
02131100,DU CRET SCHOOL OF THE ARTS              ,NJ,07060-0000,Private      ,5,2,7,39,23,62
02131600,PENNCO TECH                             ,NJ,08012-0000,Proprietary  ,66,129,195,456,719,1175
02132300,FORTIS INSTITUTE                        ,NJ,07470-7041,Proprietary  ,53,100,153,399,643,1042
02146800,JOE KUBERT SCH OF CARTOON & GRAPHIC     ,NJ,07801-0000,Proprietary  ,1,4,5,88,63,151
02154000,DIVERS ACAD OF EASTERN SEABOARD         ,NJ,08081-1139,Proprietary  ,10,47,57,96,186,282
02183600,CAPRI INSTITUTE OF HAIR DESIGN          ,NJ,07033-0000,Proprietary  ,10,19,29,67,139,206
02192200,THOMAS EDISON STATE COLLEGE             ,NJ,08608-0000,Public       ,62,1110,1172,626,8671,9297
02219600,OMEGA INSTITUTE                         ,NJ,08109-0000,Proprietary  ,1,9,10,37,134,171
02223700,ROBERT FIANCE BEAUTY SCHOOLS            ,NJ,07093-4623,Proprietary  ,17,72,89,72,213,285
02223900,DRAKE COLLEGE OF BUSINESS               ,NJ,07201-0000,Proprietary  ,26,236,262,125,922,1047
02223902,DRAKE COLLEGE OF BUSINESS - NEWARK CAMPU,NJ,07112-2760,Proprietary  ,38,276,314,222,1267,1489
02232500,UNION COUNTY VOCATIONAL TECH INST       ,NJ,07076-0000,Public       ,10,20,30,92,110,202
02234600,ATLANTIC BEAUTY & SPA ACADEMY           ,NJ,08234-2621,Proprietary  ,10,35,45,73,186,259
02246000,ROSS UNIVERSITY - MEDICAL SCHOOL        ,NJ,08837-0000,Proprietary  ,5,296,301,35,3551,3586
02248600,COOPER HEALTH SYS-CTR ALLIED HEALTH     ,NJ,08103-0000,Private      ,9,62,71,115,442,557
02265500,CAPRI INSTITUTE OF HAIR DESIGN          ,NJ,08724-0000,Proprietary  ,13,34,47,60,152,212
02277900,ROSS UNIV - SCH OF VETERINARY MED       ,NJ,08837-0000,Proprietary  ,1,84,85,17,1533,1550
02312000,BERGEN COUNTY TECHNICAL SCHOOLS         ,NJ,07601-6110,Public       ,16,39,55,129,194,323
02503900,WARREN COUNTY COMMUNITY COLLEGE         ,NJ,07882-0000,Public       ,33,62,95,731,734,1465
02523700,OCEAN COUNTY VOCATIONAL-TECH SCHOOL     ,NJ,08753-0000,Public       ,11,39,50,295,535,830
02525900,ARTISTIC ACADEMY OF HAIR DESIGN         ,NJ,07950-1409,Proprietary  ,9,17,26,85,84,169
02528200,ROBERT FIANCE BEAUTY SCHOOLS            ,NJ,07060-4840,Proprietary  ,10,32,42,72,182,254
02558700,PRISM CAREER INSTITUTE                  ,NJ,08037-0000,Proprietary  ,21,76,97,152,732,884
02568800,SUSSEX COUNTY COMMUNITY COLLEGE         ,NJ,07860-1149,Public       ,68,129,197,1654,1136,2790
02586900,HARRIS SCHOOL OF BUSINESS               ,NJ,08043-2604,Proprietary  ,39,190,229,182,865,1047
02616402,SANFORD-BROWN INSTITUTE - ISELIN        ,NJ,08830-0000,Proprietary  ,20,63,83,194,511,705
03077500,RABBI JACOB JOSEPH SCHOOL               ,NJ,08817-4494,Private      ,14,2,16,31,6,37
03122600,EASTERN INTERNATIONAL COLLEGE           ,NJ,07306-3906,Proprietary  ,9,33,42,196,546,742
03187300,STENOTECH CAREER INSTITUTE              ,NJ,07004-0000,Proprietary  ,4,8,12,16,38,54
03197300,INSTITUTE FOR HEALTH EDUCATION(THE)     ,NJ,07306-2929,Proprietary  ,5,7,12,37,121,158
03324300,CENTRAL CAREER SCHOOL                   ,NJ,07080-2408,Proprietary  ,11,66,77,35,193,228
03380302,STAR CAREER ACADEMY - STAR NEWARK       ,NJ,07102-4510,Proprietary  ,33,115,148,221,801,1022
03380303,STAR CAREER ACADEMY - STAR CLIFTON      ,NJ,07011-2248,Proprietary  ,17,38,55,89,290,379
03389300,ACADEMY OF MASSAGE THERAPY              ,NJ,07631-0000,Proprietary  ,0,0,0,26,70,96
03536300,INSTITUTE FOR THERAPEUTIC MASSAGE       ,NJ,07420-1452,Proprietary  ,9,35,44,36,136,172
03650600,PC AGE                                  ,NJ,07306-3936,Proprietary  ,10,53,63,58,310,368
03650603,PC AGE                                  ,NJ,08817-2842,Proprietary  ,2,9,11,10,60,70
03666300,PILLAR COLLEGE                          ,NJ,07102-5511,Private      ,13,78,91,116,838,954
03803300,HEALTHCARE TRAINING INSTITUTE           ,NJ,07083-3504,Proprietary  ,19,66,85,92,389,481
03811300,EASTERN SCHOOL OF ACUPUNCTURE AND TRADIT,NJ,07042-3562,Proprietary  ,0,7,7,6,67,73
04081300,BAIS MEDRASH TORAS CHESED               ,NJ,08701-0000,Private      ,10,5,15,36,13,49
04123400,YESHIVAS BE'ER YITZCHOK                 ,NJ,07208-2380,Private      ,3,10,13,20,49,69
04125000,GENTLE HEALING SCHOOL OF MASSAGE        ,NJ,08512-3600,Proprietary  ,1,10,11,7,38,45
04131100,YESHIVA TORAS CHAIM                     ,NJ,08701-2120,Private      ,8,1,9,129,2,131
04131200,TOTAL IMAGE BEAUTY ACADEMY              ,NJ,07307-2943,Proprietary  ,4,30,34,31,122,153
04134100,JERSEY COLLEGE                          ,NJ,07608-1104,Proprietary  ,34,323,357,204,2480,2684
04136400,AMERICAN INSTITUTE OF MEDICAL SCIENCES &,NJ,07080-1183,Proprietary  ,9,64,73,95,343,438
04154500,STARTING POINTS FOR CHILDREN            ,NJ,07306-0001,Private      ,4,18,22,17,126,143
04154900,NATIONAL CAREER INSTITUTE               ,NJ,07018-2011,Proprietary  ,5,72,77,18,197,215
04154901,NATIONAL CAREER INSTITUTE - JERSEY CITY ,NJ,07306-4300,Proprietary  ,9,51,60,45,216,261
04173100,LAB PAUL MITCHELL PARTNER SCHOOL (THE)  ,NJ,08628-2500,Proprietary  ,10,16,26,85,99,184
04180300,MESIVTA KESER TORAH                     ,NJ,07719-2409,Private      ,0,1,1,0,2,2
04181400,BEST CARE TRAINING INSTITUTE            ,NJ,07018-1703,Proprietary  ,5,26,31,24,194,218
04184500,CHRISTINE VALMY INTERNATIONAL SCHOOL OF ,NJ,07058-9589,Proprietary  ,2,20,22,33,87,120
04188700,ASI CAREER INSTITUTE                    ,NJ,08012-1043,Proprietary  ,4,43,47,32,196,228
04192400,YESHIVA GEDOLAH ZICHRON LEYMA           ,NJ,07036-3905,Private      ,2,3,5,2,7,9
04207500,MEDICAL CAREER INSTITUTE                ,NJ,07712-7202,Proprietary  ,7,30,37,44,173,217
04215600,AMERICAN INSTITUTE OF PHARMACEUTICAL TEC,NJ,07601-9991,Proprietary  ,0,1,1,0,1,1
04216000,UNIVERSAL TRAINING INSTITUTE            ,NJ,08861-4106,Proprietary  ,2,19,21,32,173,205
04216100,YESHIVA YESODEI HATORAH                 ,NJ,08701-4946,Private      ,0,0,0,2,2,4
04216500,RIZZIERI INSTITUTE                      ,NJ,08043-1911,Proprietary  ,6,7,13,56,80,136
04218200,PAUL MITCHELL THE SCHOOL - JERSEY SHORE ,NJ,08723-3413,Proprietary  ,19,21,40,114,128,242
04218500,SALON PROFESSIONAL ACADEMY THE          ,NJ,07080-0000,Proprietary  ,9,22,31,54,138,192
00266500,VAUGHN COLLEGE OF AERONAUTICS AND TECHNO,NY,11369-9997,Private      ,60,119,179,1290,963,2253
00266600,ADELPHI UNIVERSITY                      ,NY,11530-4299,Private      ,235,299,534,8892,4527,13419
00266700,DOWLING COLLEGE                         ,NY,11769-1999,Private      ,37,66,103,1836,1012,2848
00266800,ALFRED UNIVERSITY                       ,NY,14802-1205,Private      ,84,44,128,3734,727,4461
00266900,BANK STREET COLLEGE OF EDUCATION        ,NY,10025-0000,Private      ,2,51,53,24,718,742
00267100,BARD COLLEGE                            ,NY,12504-5000,Private      ,127,30,157,3762,740,4502
00267400,NEW YORK THEOLOGICAL SEMINARY           ,NY,10115-0002,Private      ,2,31,33,5,295,300
00267700,BROOKLYN LAW SCHOOL                     ,NY,11201-0000,Private      ,18,63,81,111,2416,2527
00267800,BRYANT & STRATTON COLLEGE               ,NY,14203-1713,Proprietary  ,271,1792,2063,2808,15610,18418
00267803,BRYANT & STRATTON COLLEGE - GREECE      ,NY,14606-4227,Proprietary  ,36,154,190,372,1321,1693
00267805,BRYANT & STRATTON COLLEGE - SYRACUSE    ,NY,13203-2502,Proprietary  ,43,163,206,591,1493,2084
00267807,BRYANT & STRATTON COLLEGE - ALBANY      ,NY,12205-5230,Proprietary  ,22,107,129,266,943,1209
00268100,CANISIUS COLLEGE                        ,NY,14208-1098,Private      ,100,126,226,4556,1741,6297
00268500,CAZENOVIA COLLEGE                       ,NY,13035-1085,Private      ,32,22,54,1971,236,2207
00268700,CUNY-BROOKLYN COLLEGE                   ,NY,11210-2814,Public       ,770,1142,1912,21235,13465,34700
00268800,CITY COLLEGE-CUNY                       ,NY,10031-9198,Public       ,753,1122,1875,22467,12561,35028
00268900,CUNY-HUNTER COLLEGE                     ,NY,10021-0000,Public       ,1007,1545,2552,29968,17566,47534
00269000,QUEENS COLLEGE-CUNY                     ,NY,11367-1597,Public       ,679,827,1506,19408,9981,29389
00269100,CUNY- BOROUGH OF MANHATTAN CMTY CLG     ,NY,10007-1047,Public       ,1908,2126,4034,31465,18986,50451
00269200,CUNY BRONX COMMUNITY COLLEGE            ,NY,10453-3102,Public       ,912,1305,2217,12776,11645,24421
00269300,CUNY-JOHN JAY CLG CRIMINAL JUSTICE      ,NY,10019-1093,Public       ,581,781,1362,18198,9274,27472
00269400,KINGSBOROUGH COMMUNITY COLLEGE          ,NY,11235-2398,Public       ,870,831,1701,15840,9467,25307
00269600,NY CITY COLLEGE OF TECHNOLOGY-CUNY      ,NY,11201-2983,Public       ,833,1045,1878,20410,10828,31238
00269700,QUEENSBOROUGH COMMUNITY COLLEGE         ,NY,11364-1497,Public       ,910,852,1762,15788,7555,23343
00269800,CUNY THE COLLEGE OF STATEN ISLAND       ,NY,10314-6600,Public       ,567,480,1047,14949,5291,20240
00269900,CLARKSON UNIVERSITY                     ,NY,13699-5615,Private      ,159,29,188,6542,575,7117
00270000,COLGATE ROCHESTER CROZER DIVINITY S     ,NY,14620-0000,Private      ,1,17,18,6,100,106
00270100,COLGATE UNIVERSITY                      ,NY,13346-1386,Private      ,129,8,137,4561,117,4678
00270300,COLLEGE OF MOUNT SAINT VINCENT          ,NY,10471-1093,Private      ,56,22,78,2756,513,3269
00270400,COLLEGE OF NEW ROCHELLE                 ,NY,10805-2339,Private      ,55,338,393,1405,4317,5722
00270500,COLLEGE OF SAINT ROSE                   ,NY,12203-1490,Private      ,104,148,252,5012,1758,6770
00270700,COLUMBIA UNIVERSITY                     ,NY,10027-0000,Private      ,980,1075,2055,23261,21511,44772
00270800,BARNARD COLLEGE-COLUMBIA UNIV           ,NY,10027-6598,Private      ,158,60,218,4619,511,5130
00270900,CONCORDIA COLLEGE                       ,NY,10708-1998,Private      ,17,73,90,949,668,1617
00271000,COOPER UNION                            ,NY,10003-7120,Private      ,74,36,110,1452,325,1777
00271100,CORNELL UNIVERSITY                      ,NY,14853-2801,Private      ,880,240,1120,30606,6202,36808
00271101,WEILL CORNELL MEDICAL COLLEGE AND GRADUA,NY,10021-0000,Private      ,5,38,43,48,768,816
00271200,D'YOUVILLE COLLEGE                      ,NY,14201-1084,Private      ,55,114,169,2065,2266,4331
00271300,DOMINICAN COLLEGE                       ,NY,10962-1299,Private      ,58,95,153,1900,1123,3023
00271800,ELMIRA COLLEGE                          ,NY,14901-2099,Private      ,51,25,76,2399,328,2727
00272200,FORDHAM UNIVERSITY                      ,NY,10458-5157,Private      ,866,629,1495,27502,9208,36710
00272600,GENERAL THEOLOGICAL SEMINARY            ,NY,10011-0000,Private      ,0,3,3,4,76,80
00272800,HAMILTON COLLEGE                        ,NY,13323-1218,Private      ,95,5,100,3115,80,3195
00272900,HARTWICK COLLEGE                        ,NY,13820-4020,Private      ,38,6,44,3952,207,4159
00273100,HOBART & WILLIAM SMITH COLLEGES         ,NY,14456-3397,Private      ,65,6,71,3592,102,3694
00273200,HOFSTRA UNIVERSITY                      ,NY,11549-1010,Private      ,483,265,748,18294,5481,23775
00273400,HOUGHTON COLLEGE                        ,NY,14744-0128,Private      ,20,20,40,1333,180,1513
00273500,HILBERT COLLEGE                         ,NY,14075-1597,Private      ,31,26,57,1101,362,1463
00273700,IONA COLLEGE                            ,NY,10801-1890,Private      ,174,75,249,7930,1114,9044
00273900,ITHACA COLLEGE                          ,NY,14850-7130,Private      ,371,51,422,15385,1060,16445
00274000,JEWISH THEOLOGICAL SEMINARY OF AMER     ,NY,10027-4649,Private      ,5,8,13,134,157,291
00274200,THE JUILLIARD SCHOOL                    ,NY,10023-6588,Private      ,94,46,140,1595,866,2461
00274400,KEUKA COLLEGE                           ,NY,14478-0000,Private      ,43,99,142,1689,1371,3060
00274800,LEMOYNE COLLEGE                         ,NY,13214-1399,Private      ,108,64,172,5619,1032,6651
00274900,NEW YORK COLLEGE OF PODIATRIC MED       ,NY,10035-1940,Private      ,1,28,29,43,462,505
00275100,LONG ISLAND UNIVERSITY                  ,NY,11548-1326,Private      ,305,634,939,13245,10787,24032
00275800,MANHATTAN COLLEGE                       ,NY,10471-4098,Private      ,172,83,255,7283,859,8142
00275900,MANHATTAN SCHOOL OF MUSIC               ,NY,10027-4689,Private      ,33,38,71,657,641,1298
00276000,MANHATTANVILLE COLLEGE                  ,NY,10577-2132,Private      ,70,89,159,3257,832,4089
00276300,MARIA COLLEGE                           ,NY,12208-1798,Private      ,21,64,85,317,901,1218
00276500,MARIST COLLEGE                          ,NY,12601-1387,Private      ,206,123,329,9654,1527,11181
00276900,MARYMOUNT MANHATTAN COLLEGE             ,NY,10021-4597,Private      ,139,45,184,3917,402,4319
00277200,MERCY COLLEGE                           ,NY,10522-1189,Private      ,236,638,874,6523,7624,14147
00277500,MOLLOY COLLEGE                          ,NY,11570-1100,Private      ,130,207,337,4307,2485,6792
00277700,MEDAILLE COLLEGE                        ,NY,14214-2695,Private      ,59,173,232,1763,1689,3452
00277800,MOUNT SAINT MARY COLLEGE                ,NY,12550-3494,Private      ,88,114,202,3991,1279,5270
00277900,NAZARETH COLLEGE OF ROCHESTER           ,NY,14618-3790,Private      ,103,74,177,3955,1488,5443
00278200,NEW YORK INSTITUTE OF TECHNOLOGY        ,NY,11568-8000,Private      ,172,185,357,6527,2603,9130
00278202,NY INSTITUTE OF TECHNOLOGY-OSTEOPATHIC M,NY,11568-0000,Private      ,2,9,11,72,1155,1227
00278300,NEW YORK LAW SCHOOL                     ,NY,10013-0000,Private      ,13,75,88,85,2257,2342
00278400,NEW YORK MEDICAL COLLEGE                ,NY,10595-0000,Private      ,3,38,41,49,1951,2000
00278500,NEW YORK UNIVERSITY                     ,NY,10012-1091,Private      ,1990,1815,3805,44000,28892,72892
00278520,NEW YORK UNIVERSITY - BROOKLYN          ,NY,11201-3840,Private      ,0,0,0,751,163,914
00278800,NIAGARA UNIVERSITY                      ,NY,14109-2010,Private      ,78,69,147,3908,973,4881
00279000,NYACK COLLEGE                           ,NY,10960-3698,Private      ,25,156,181,1317,1824,3141
00279100,PACE UNIVERSITY - NEW YORK              ,NY,10038-1598,Private      ,446,394,840,13180,4580,17760
00279101,PACE UNIVERSITY-PLEASANTVILLE           ,NY,10570-0000,Private      ,93,135,228,4133,1453,5586
00279102,PACE UNIVERSITY - WHITE PLAINS          ,NY,10603-0000,Private      ,31,83,114,619,1681,2300
00279500,PAUL SMITHS CLG OF ARTS & SCIENCES      ,NY,12970-0000,Private      ,33,9,42,1223,157,1380
00279800,PRATT INSTITUTE                         ,NY,11205-3899,Private      ,255,154,409,5449,2317,7766
00280300,RENSSELAER POLYTECHNIC INSTITUTE        ,NY,12180-3590,Private      ,272,36,308,13050,743,13793
00280500,ROBERTS WESLEYAN COLLEGE                ,NY,14624-1997,Private      ,39,132,171,1352,1449,2801
00280600,ROCHESTER INSTITUTE OF TECHNOLOGY       ,NY,14623-5608,Private      ,411,181,592,17111,2853,19964
00280700,ROCKEFELLER UNIVERSITY                  ,NY,10021-0000,Private      ,7,12,19,40,72,112
00280800,DAEMEN COLLEGE                          ,NY,14226-3592,Private      ,46,81,127,2858,1310,4168
00281000,THE SAGE COLLEGES                       ,NY,12180-4199,Private      ,48,132,180,2187,1953,4140
00281200,TROCAIRE COLLEGE                        ,NY,14220-2094,Private      ,38,139,177,935,1688,2623
00281300,SARAH LAWRENCE COLLEGE                  ,NY,10708-5999,Private      ,75,18,93,2314,667,2981
00281400,SKIDMORE COLLEGE                        ,NY,12866-1632,Private      ,127,17,144,4807,162,4969
00281500,ST BERNARDS SCH THEOLOGY & MINISTRY     ,NY,14618-3822,Private      ,0,2,2,1,44,45
00281600,SIENA COLLEGE                           ,NY,12211-1462,Private      ,128,10,138,6273,309,6582
00281700,ST BONAVENTURE UNIVERSITY               ,NY,14778-2284,Private      ,63,28,91,2830,513,3343
00282000,ST FRANCIS COLLEGE                      ,NY,11201-4398,Private      ,154,83,237,3173,832,4005
00282100,ST JOHN FISHER COLLEGE                  ,NY,14618-3597,Private      ,106,124,230,4844,1980,6824
00282200,CHRIST THE KING SEMINARY                ,NY,14052-0607,Private      ,0,0,0,0,10,10
00282300,ST JOHN'S UNIVERSITY                    ,NY,11439-1343,Private      ,527,286,813,25671,6553,32224
00282500,ST JOSEPH'S COLLEGE                     ,NY,11205-3688,Private      ,67,83,150,1626,906,2532
00282501,ST JOSEPH'S COLLEGE-SUFFOLK CAMPUS      ,NY,11772-0000,Private      ,96,146,242,2972,1709,4681
00282900,ST LAWRENCE UNIVERSITY                  ,NY,13617-1455,Private      ,67,6,73,2795,171,2966
00283200,ST THOMAS AQUINAS COLLEGE               ,NY,10976-1050,Private      ,60,24,84,1922,285,2207
00283300,ST VLADIMIR ORTHODOX THEOL SEM          ,NY,10707-0000,Private      ,0,4,4,0,63,63
00283400,EXCELSIOR COLLEGE                       ,NY,12203-5159,Private      ,79,2179,2258,646,13119,13765
00283500,SUNY AT ALBANY                          ,NY,12222-0001,Public       ,627,291,918,22695,5275,27970
00283600,BINGHAMTON UNIVERSITY (SUNY)            ,NY,13902-6000,Public       ,673,162,835,25869,3257,29126
00283700,SUNY AT BUFFALO                         ,NY,14260-0001,Public       ,615,452,1067,26271,10050,36321
00283800,SUNY AT STONY BROOK                     ,NY,11794-0701,Public       ,790,502,1292,30153,8635,38788
00283900,SUNY-DOWNSTATE MEDICAL CENTER           ,NY,11203-2098,Public       ,17,91,108,268,2527,2795
00284000,SUNY UPSTATE MEDICAL UNIVERSITY         ,NY,13210-2375,Public       ,13,44,57,293,1513,1806
00284100,SUNY BROCKPORT - FIN AID OFF            ,NY,14420-2914,Public       ,263,246,509,10743,3115,13858
00284200,BUFFALO STATE COLLEGE - SUNY            ,NY,14222-1095,Public       ,391,349,740,14660,5217,19877
00284300,SUNY COLLEGE-CORTLAND                   ,NY,13045-0900,Public       ,295,108,403,12162,1477,13639
00284400,SUNY AT FREDONIA                        ,NY,14063-1145,Public       ,151,47,198,7689,983,8672
00284500,SUNY GENESEO                            ,NY,14454-1401,Public       ,204,45,249,9576,614,10190
00284600,SUNY COLLEGE-NEW PALTZ                  ,NY,12561-2499,Public       ,321,120,441,13016,2267,15283
00284700,SUNY COLLEGE-ONEONTA                    ,NY,13820-4015,Public       ,229,44,273,11659,862,12521
00284800,SUNY OSWEGO                             ,NY,13126-3599,Public       ,254,147,401,12327,2067,14394
00284900,SUNY COLLEGE AT PLATTSBURGH             ,NY,12901-2681,Public       ,200,101,301,8388,1519,9907
00285000,SUNY COLLEGE-POTSDAM                    ,NY,13676-2294,Public       ,131,51,182,6164,975,7139
00285100,SUNY COLLEGE OF ENVIRONMENT SCIENCE AND ,NY,13210-2778,Public       ,79,33,112,2406,604,3010
00285300,SUNY MARITIME COLLEGE                   ,NY,10465-4198,Public       ,60,53,113,2045,395,2440
00285400,SUNY COLLEGE OF TECHNOLOGY-ALFRED       ,NY,14802-9951,Public       ,141,77,218,5072,1143,6215
00285500,SUNY CANTON COLG OF TECHNOLOGY          ,NY,13617-1098,Public       ,67,117,184,3944,1519,5463
00285600,SUNY AG & TECH COLLEGE-COBLESKILL       ,NY,12043-9986,Public       ,96,34,130,3582,653,4235
00285700,SUNY DELHI                              ,NY,13753-1190,Public       ,139,117,256,4793,1351,6144
00285800,SUNY FARMINGDALE                        ,NY,11735-1021,Public       ,296,278,574,7810,3023,10833
00285900,SUNY COLLEGE OF AG & TECH AT MORRISVILLE,NY,13408-0901,Public       ,96,81,177,4355,1044,5399
00286000,ADIRONDACK COMMUNITY COLLEGE            ,NY,12804-1445,Public       ,123,198,321,2518,1819,4337
00286100,CAYUGA COMMUNITY COLLEGE                ,NY,13021-3099,Public       ,90,240,330,1735,2162,3897
00286200,BROOME COMMUNITY COLLEGE                ,NY,13902-0000,Public       ,164,301,465,3982,2894,6876
00286300,CORNING COMMUNITY COLLEGE               ,NY,14830-3297,Public       ,107,187,294,1986,1784,3770
00286400,DUTCHESS COMMUNITY COLLEGE              ,NY,12601-1595,Public       ,289,279,568,4855,2406,7261
00286600,FASHION INSTITUTE OF TECHNOLOGY         ,NY,10001-5992,Public       ,388,381,769,9836,3717,13553
00286700,SUNY FULTON MONTGOMERY COMM CLG         ,NY,12095-3790,Public       ,65,103,168,1805,1139,2944
00286800,HUDSON VALLEY COMMUNITY COLLEGE         ,NY,12180-6096,Public       ,353,564,917,6679,4829,11508
00286900,JAMESTOWN COMMUNITY COLLEGE             ,NY,14702-0020,Public       ,124,195,319,2584,1799,4383
00287000,JEFFERSON COMMUNITY COLLEGE             ,NY,13601-1897,Public       ,76,340,416,1708,2783,4491
00287100,"SUNY, MOHAWK VALLEY COMMUNITY CLG       ",NY,13501-5394,Public       ,190,337,527,3981,3366,7347
00287200,MONROE COMMUNITY COLLEGE                ,NY,14623-5780,Public       ,661,1087,1748,10122,9872,19994
00287300,NASSAU COMMUNITY COLLEGE                ,NY,11530-6793,Public       ,807,871,1678,13283,7736,21019
00287400,NIAGARA COUNTY COMMUNITY COLLEGE        ,NY,14132-9460,Public       ,198,307,505,4051,2968,7019
00287500,ONONDAGA COMMUNITY COLLEGE              ,NY,13215-4585,Public       ,375,526,901,7666,4751,12417
00287600,ORANGE COUNTY COMMUNITY COLLEGE         ,NY,10940-6441,Public       ,222,316,538,3342,2611,5953
00287700,ROCKLAND COMMUNITY COLLEGE              ,NY,10901-3611,Public       ,183,239,422,2967,2363,5330
00287800,SUFFOLK COMMUNITY COLLEGE               ,NY,11784-2899,Public       ,432,472,904,7720,3872,11592
00287801,SUFFOLK COMMUNITY CLG-W. CAMPUS         ,NY,11717-0000,Public       ,353,416,769,5414,3682,9096
00287803,SUFFOLK COMMUNITY CLG-EASTRN CAMPUS     ,NY,11901-0000,Public       ,141,174,315,2052,1325,3377
00287900,SULLIVAN COUNTY COMMUNITY COLLEGE       ,NY,12759-5151,Public       ,61,87,148,1352,700,2052
00288000,ULSTER COUNTY COMMUNITY COLLEGE         ,NY,12484-0557,Public       ,83,151,234,1322,1170,2492
00288100,SUNY WESTCHESTER COMMUNITY COLLEGE      ,NY,10595-1698,Public       ,499,674,1173,7235,5820,13055
00288200,SYRACUSE UNIVERSITY                     ,NY,13244-2130,Private      ,838,385,1223,26558,6535,33093
00288300,UTICA COLLEGE- UTICA                    ,NY,13502-4892,Private      ,104,237,341,3939,2533,6472
00288500,ALBANY COLLEGE OF PHARMACY AND HEALTH SC,NY,12208-3492,Private      ,32,15,47,1936,875,2811
00288600,ALBANY LAW SCHOOL                       ,NY,12208-0000,Private      ,13,15,28,84,915,999
00288700,ALBANY MEDICAL COLLEGE                  ,NY,12208-0000,Private      ,9,39,48,117,1244,1361
00288900,UNION COLLEGE                           ,NY,12308-2311,Private      ,112,13,125,3810,145,3955
00289000,UNION THEOLOGICAL SEMINARY              ,NY,10027-0000,Private      ,0,10,10,2,280,282
00289200,UNITED STATES MERCHANT MARINE ACADEMY   ,NY,11024-1634,Public       ,12,3,15,393,28,421
00289400,UNIVERSITY OF ROCHESTER                 ,NY,14627-9000,Private      ,254,172,426,9464,2069,11533
00289401,EASTMAN SCH OF MUSIC/UNIV ROCHESTER     ,NY,14604-0000,Private      ,28,10,38,878,434,1312
00289402,UNIV OF ROCHESTER SCHL OF MEDICINE      ,NY,14642-0000,Private      ,6,17,23,90,710,800
00289500,VASSAR COLLEGE                          ,NY,12604-0008,Private      ,120,15,135,4986,208,5194
00289600,VILLA MARIA COLLEGE-BUFFALO             ,NY,14225-3999,Private      ,22,33,55,501,363,864
00289900,WAGNER COLLEGE                          ,NY,10301-4495,Private      ,87,42,129,2847,633,3480
00290000,WEBB INSTITUTE                          ,NY,11542-1398,Private      ,1,0,1,92,4,96
00290100,WELLS COLLEGE                           ,NY,13026-0500,Private      ,24,7,31,1391,101,1492
00290300,YESHIVA UNIVERSITY                      ,NY,10033-3201,Private      ,84,97,181,2508,2551,5059
00290302,YESHIVA UNIVERSITY - BRONX CAMPUS       ,NY,10461-1975,Private      ,5,23,28,99,1172,1271
00397400,MESIVTHA TIFERETH JERUSALEM OF AMER     ,NY,10002-6382,Private      ,19,1,20,38,2,40
00397600,RABBINICAL ACAD MESIVTA RABBI CHAIM     ,NY,11230-4715,Private      ,9,0,9,15,1,16
00397700,RABBINICAL COLLEGE CH'SAN SOFER         ,NY,11204-1252,Private      ,0,5,5,1,7,8
00397800,RABBINICAL SEMINARY OF AMERICA          ,NY,11375-0000,Private      ,9,17,26,97,41,138
00397900,COLUMBIA UNIV TEACHERS COLLEGE          ,NY,10027-0000,Private      ,6,233,239,134,4746,4880
00405400,HEBREW UNION COL-JEWISH INST OF REL     ,NY,10012-0000,Private      ,0,4,4,2,234,236
00475900,"CUNY, YORK COLLEGE                      ",NY,11451-0001,Public       ,437,626,1063,13100,6729,19829
00476500,CUNY GRADUATE SCH & UNIV CTR            ,NY,10016-4309,Public       ,12,334,346,140,3423,3563
00477600,CENTRAL YESHIVA TOMCHEI TMIMIM LUBA     ,NY,11230-2798,Private      ,107,18,125,157,31,188
00478800,HERKIMER COUNTY COMMUNITY COLLEGE       ,NY,13350-1598,Public       ,82,112,194,1996,1339,3335
00479800,MIRRER YESHIVA CENTRAL INST             ,NY,11223-2010,Private      ,11,3,14,51,21,72
00479900,MONROE COLLEGE                          ,NY,10468-4305,Proprietary  ,226,520,746,5203,6281,11484
00481100,EVEREST INSTITUTE                       ,NY,14621-3007,Proprietary  ,14,85,99,147,853,1000
00506400,SAINT JAMES MERCY HOSPITAL SCHOOL OF RAD,NY,14843-2197,Private      ,0,1,1,7,15,22
00517700,LONG ISLAND COLLEGE HOSPITAL SCHOOL OF R,NY,11201-0000,Private      ,0,0,0,130,234,364
00520800,THE COLLEGE OF WESTCHESTER              ,NY,10602-0000,Proprietary  ,46,80,126,901,900,1801
00587700,ROBERT J HOCHSTIM SCHOOL OF RADIOG      ,NY,11572-1151,Private      ,0,0,0,3,8,11
00643501,ARNOT OGDEN MEDICAL CENTER              ,NY,14905-1676,Private      ,0,3,3,44,51,95
00643800,PHILLIPS BETH ISRAEL SCH OF NURSING     ,NY,10001-6354,Private      ,4,28,32,80,430,510
00644300,COCHRAN SCH NSG-ST JOHN RVSDE HOSP      ,NY,10701-1399,Private      ,2,23,25,39,207,246
00644500,CROUSE HOSP SCH OF NURSING              ,NY,13210-1690,Private      ,9,28,37,262,408,670
00644800,BELANGER SCHOOL OF NURSING              ,NY,12304-1009,Private      ,7,11,18,83,172,255
00646100,SAINT ELIZABETH MEDICAL CENTER          ,NY,13501-2998,Private      ,7,11,18,161,200,361
00646102,ST ELIZABETH SCH OF RADIOGRAPHY         ,NY,13501-0000,Private      ,0,0,0,4,24,28
00646700,SAINT JOSEPH'S COLLEGE OF NURSING       ,NY,13203-1806,Private      ,6,18,24,227,307,534
00678200,GENESEE COMMUNITY COLLEGE               ,NY,14020-9704,Public       ,154,302,456,3124,2732,5856
00678500,SCHENECTADY COUNTY COMMUNITY CLG        ,NY,12305-2294,Public       ,117,242,359,2519,2478,4997
00678700,CLINTON COMMUNITY COLLEGE               ,NY,12901-5690,Public       ,49,84,133,1105,710,1815
00678800,TOMPKINS CORTLAND COMMUNITY COLLEGE     ,NY,13053-0139,Public       ,143,164,307,2714,1713,4427
00678900,COLUMBIA-GREENE COMMUNITY COLLEGE       ,NY,12534-9543,Public       ,49,103,152,924,985,1909
00679100,SUNY AT PURCHASE                        ,NY,10577-1400,Public       ,226,81,307,7983,1176,9159
00702200,CUNY-LEHMAN COLLEGE                     ,NY,10468-1589,Public       ,569,1267,1836,14514,13227,27741
00702600,MOUNT SINAI SCHOOL OF MEDICINE          ,NY,10029-0000,Private      ,7,44,51,47,1117,1164
00710900,SUNY COLLEGE-OLD WESTBURY               ,NY,11568-0210,Public       ,166,145,311,5886,2380,8266
00711100,NORTH COUNTRY COMMUNITY COLLEGE         ,NY,12983-2046,Public       ,23,50,73,745,631,1376
00726400,MESIFTA TORAH VODAATH RABBINCAL SEM     ,NY,11218-5209,Private      ,9,13,22,16,55,71
00727300,CUNY-BERNARD BARUCH COLLEGE             ,NY,10010-5518,Public       ,624,921,1545,19746,10593,30339
00730400,CULINARY INSTITUTE OF AMERICA           ,NY,12538-1499,Private      ,270,183,453,3815,1456,5271
00732916,ITT TECHNICAL INSTITUTE                 ,NY,12205-1003,Proprietary  ,15,81,96,173,527,700
00737200,AUSTIN'S SCHOOL OF SPA TECHNOLOGY       ,NY,12206-1513,Proprietary  ,14,66,80,105,363,468
00737500,ISLAND DRAFTING & TECHNICAL INST        ,NY,11701-2704,Proprietary  ,2,6,8,71,76,147
00738700,LONG ISLAND BEAUTY SCHOOL               ,NY,11788-4346,Proprietary  ,21,39,60,162,263,425
00738800,LONG ISLAND BEAUTY SCHOOL               ,NY,11550-3704,Proprietary  ,5,18,23,41,116,157
00739100,BEAUTY SCHOOL OF MIDDLETOWN             ,NY,10940-6574,Proprietary  ,8,20,28,51,81,132
00739400,BERKELEY COLLEGE                        ,NY,10017-0000,Proprietary  ,244,571,815,3190,4648,7838
00740100,MANDL SCHOOL                            ,NY,10019-5516,Proprietary  ,24,129,153,267,987,1254
00740500,WOOD TOBE-COBURN SCHOOL                 ,NY,10016-0102,Proprietary  ,4,12,16,499,175,674
00746500,AMERICAN ACADEMY OF DRAMATIC ARTS       ,NY,10016-7089,Private      ,58,53,111,1248,424,1672
00746600,LIM COLLEGE                             ,NY,10022-5268,Proprietary  ,75,58,133,2246,609,2855
00746800,SCHOOL OF VISUAL ARTS                   ,NY,10010-3994,Proprietary  ,137,130,267,3927,1648,5575
00751800,APEX TECHNICAL SCHOOL                   ,NY,10011-0000,Proprietary  ,100,344,444,526,1528,2054
00752200,CONTINENTAL SCH OF BEAUTY CULTURE       ,NY,14623-3231,Proprietary  ,31,91,122,229,543,772
00752205,CONTINENTAL SCHOOL OF BEAUTY CULTURE - M,NY,13211-1003,Proprietary  ,1,6,7,16,41,57
00753200,FINGER LAKES COMMUNITY COLLEGE          ,NY,14424-8395,Public       ,153,278,431,3586,2672,6258
00757200,AMERICAN MUSICAL AND DRAMATIC ACAD      ,NY,10023-2106,Private      ,146,70,216,3125,605,3730
00757300,EMPIRE BEAUTY SCHOOL                    ,NY,11103-4028,Proprietary  ,94,263,357,643,1729,2372
00780400,STAR CAREER ACADEMY                     ,NY,10011-7307,Proprietary  ,30,135,165,187,656,843
00793809,LINCOLN TECHNICAL INSTITUTE - WHITESTONE,NY,11357-6092,Proprietary  ,70,48,118,553,340,893
00818900,CONTINENTAL SCHOOL OF BEAUTY CULTURE - B,NY,14224-3402,Proprietary  ,15,17,32,65,88,153
00818903,CONTINENTAL SCHOOL OF BEAUTY CULTURE - B,NY,14223-2911,Proprietary  ,11,48,59,96,213,309
00843700,CHAMPLAIN VALLEY - TEC/PRN              ,NY,12901-0000,Public       ,1,8,9,36,84,120
00849500,JAMESTOWN BUSINESS COLLEGE              ,NY,14702-0429,Proprietary  ,12,26,38,237,269,506
00861100,"CUNY, HOSTOS CMTY COLLEGE               ",NY,10451-1499,Public       ,700,1119,1819,9697,8635,18332
00861400,RABBINICAL CLG BOBOVER YESHIVA BNEI     ,NY,11219-3293,Private      ,54,31,85,111,40,151
00878800,STATE UNIVERSITY OF NEW YORK STUDENT LOA,NY,12246-0000,Public       ,30,32,62,507,373,880
00902900,NEIGHBORHOOD PLAYHOUSE                  ,NY,10022-5017,Private      ,2,3,5,32,55,87
00904300,ELMIRA BUSINESS INSTITUTE               ,NY,14901-2731,Proprietary  ,11,94,105,103,731,834
00907700,UTICA SCHOOL OF COMMERCE                ,NY,13501-2280,Proprietary  ,12,34,46,92,337,429
00924800,SAMARITAN HOSPITAL SCH NURSING          ,NY,12180-2475,Private      ,9,20,29,92,235,327
00928300,MIDWAY-PARIS BEAUTY SCHOOL              ,NY,11385-3453,Proprietary  ,6,34,40,24,105,129
00928400,BRITTANY BEAUTY SCHOOL                  ,NY,11756-1345,Proprietary  ,16,56,72,94,252,346
00933500,MESIVTA EASTERN PKWY RABBINICAL CLG     ,NY,11218-5559,Private      ,16,3,19,29,12,41
00947900,SAINT VINCENTS CMC SI NURSING SCHOOL    ,NY,10304-3850,Proprietary  ,25,69,94,282,684,966
00976900,METROPOLITAN COLLEGE OF NEW YORK        ,NY,10013-1919,Private      ,29,199,228,268,2084,2352
00992900,SUNY COLLEGE OF OPTOMETRY               ,NY,10036-8003,Public       ,2,10,12,34,369,403
01005100,LA GUARDIA CMTY COLLEGE - CUNY          ,NY,11101-3083,Public       ,975,1167,2142,18987,12176,31163
01005200,JEFFERSON-LEWIS BOCES PRAC NRSGPRG      ,NY,13601-9509,Public       ,5,35,40,32,183,215
01009700,CUNY-MEDGAR W EVERS COLLEGE             ,NY,11225-2010,Public       ,360,603,963,7984,6645,14629
01014200,TOURO COLLEGE                           ,NY,10010-4202,Private      ,233,651,884,3323,9780,13103
01014700,WESTERN SUFFOLK BOCES                   ,NY,11768-3499,Public       ,15,48,63,172,379,551
01015300,HELENE FULD COL OF NRSNG/N GEN HOSP     ,NY,10035-0000,Private      ,7,116,123,37,811,848
01028600,EMPIRE STATE COLLEGE                    ,NY,12866-4391,Public       ,95,1262,1357,1137,12976,14113
01037800,RABBINICAL COLLEGE OF LONG ISLAND       ,NY,11561-3244,Private      ,21,0,21,40,1,41
01054900,KEHILATH YAKOV RABBINICAL SEMINARY      ,NY,10562-1001,Private      ,30,0,30,30,0,30
01055100,NEW YORK SCH MED & DENTAL ASSISTANT     ,NY,11101-2327,Proprietary  ,22,64,86,137,288,425
01064100,SOUTHERN WESTCHESTER BOCES              ,NY,10543-0000,Public       ,2,10,12,36,211,247
01068400,ERIE COMMUNITY COLLEGE-ALL CAMPUSES     ,NY,14203-2698,Public       ,401,795,1196,7895,7775,15670
01081300,AMERICAN ACAD MCALLISTER INST           ,NY,10019-3604,Private      ,14,89,103,132,663,795
01083700,SIMMONS INST OF FUNERAL SERVICE         ,NY,13207-2098,Proprietary  ,0,0,0,1,9,10
01094300,RABBINICAL COLLEGE BETH SHRAGA          ,NY,10952-3033,Private      ,0,0,0,6,0,6
01095200,PNW BOCES LPN PROGRAM                   ,NY,10598-0000,Public       ,0,6,6,18,53,71
01103100,TECHNICAL CAREER INSTITUTE              ,NY,10001-2789,Proprietary  ,131,260,391,1166,2954,4120
01118900,UNITED TALMUDICAL SEMINARY              ,NY,11211-7984,Private      ,532,282,814,750,370,1120
01119200,BETH HAMEDRASH SHAAREI YOSHER INST      ,NY,11204-1052,Private      ,1,11,12,3,17,20
01161400,CHAMPLAIN VALLEY HOSP SCH RAD TECH      ,NY,12901-1490,Private      ,0,3,3,28,30,58
01161700,NEW YORK METHODIST HOSPITAL             ,NY,11229-9023,Private      ,9,78,87,114,487,601
01164700,SBI CAMPUS - AN AFFILIATE OF SANFORD-BRO,NY,11747-3785,Proprietary  ,14,20,34,138,238,376
01167000,YESHIVA OF NITRA RABBINICAL COLLEGE -   ,NY,10549-4112,Private      ,84,0,84,84,0,84
01167700,MEMORIAL SLOAN KETTERING CANCER CTR     ,NY,10021-6094,Private      ,0,7,7,2,46,48
01167800,SUNY INST OF TECHNOLOGY UTICA ROME      ,NY,13504-3050,Public       ,68,88,156,2444,1280,3724
01182100,YESHIVATH ZICHRON MOSHE                 ,NY,12779-0580,Private      ,23,1,24,78,1,79
01183000,BERK TRADE AND BUSINESS SCHOOL          ,NY,11101-0000,Proprietary  ,30,49,79,112,196,308
01185900,WORD OF LIFE BIBLE INSTITUTE            ,NY,12860-0129,Private      ,14,7,21,596,85,681
01186000,MERCY MED CNTR SCHL OF RADIOGRAPHY      ,NY,11570-1098,Private      ,1,8,9,19,33,52
01192100,WESTCHESTER SCH OF BEAUTY CULTURE       ,NY,10550-2295,Proprietary  ,5,25,30,40,124,164
01192200,BETH HATALMUD RABBINICAL CLG            ,NY,11214-2594,Private      ,0,2,2,4,15,19
01198400,OHR HAMEIR THEOLOGICAL SEMINARY         ,NY,10566-0990,Private      ,37,1,38,41,2,43
01201100,TALMUDICAL SEM OHOLEI TORAH             ,NY,11213-3310,Private      ,73,1,74,82,2,84
01210700,INSTITUTE OF DESIGN & CONSTRUCTION      ,NY,11201-5380,Private      ,7,25,32,61,137,198
01220300,MEMORIAL HOSPITAL SCH OF NURSING        ,NY,12204-1083,Private      ,6,17,23,71,179,250
01227700,NEW YORK CHIROPRACTIC COLLEGE           ,NY,13148-0800,Private      ,1,59,60,13,879,892
01229300,VEEB NASSAU CNTY SCHL OF PRACT NURS     ,NY,11553-3040,Public       ,4,20,24,67,286,353
01235800,PLAZA COLLEGE                           ,NY,11372-6300,Proprietary  ,93,346,439,231,826,1057
01236400,SAINT VINCENTS CATHOLIC MEDICAL CENTERS ,NY,11354-0000,Proprietary  ,9,53,62,124,553,677
01240700,SCHUYLER-CHEMUNG-TIOGA BOCES            ,NY,14903-1089,Public       ,1,7,8,54,230,284
01240701,STEUBEN SCHUYLER CHEMUNG TIOGA ALLEGANY ,NY,14870-9518,Public       ,0,2,2,1,10,11
01256100,FIVE TOWNS COLLEGE                      ,NY,11746-5871,Proprietary  ,38,32,70,767,274,1041
01258900,ERIE 1 BOCES                            ,NY,14224-0000,Public       ,11,47,58,111,435,546
01265200,ONONDAGA CORTLAND MADISON BOCES         ,NY,13090-4500,Public       ,30,107,137,183,637,820
01278300,OSWEGO COUNTY BOCES ADULT CAREERS       ,NY,13114-4498,Public       ,9,15,24,40,88,128
01292700,SYRACUSE CITY SCHOOL DISTRICT           ,NY,13202-3092,Public       ,2,6,8,32,135,167
01302600,MACHZIKEI HADATH RABBINICAL COLLEGE     ,NY,11204-1805,Private      ,0,1,1,2,3,5
01302700,YESHIVATH VIZNITZ                       ,NY,10952-3021,Private      ,0,9,9,0,9,9
01302900,BORICUA COLLEGE                         ,NY,10032-1599,Private      ,57,128,185,480,1291,1771
02056400,CAPRI COSMETOLOGY LEARNING CENTER       ,NY,10954-0000,Proprietary  ,37,47,84,148,209,357
02066200,THE NEW SCHOOL                          ,NY,10011-0000,Private      ,314,422,736,6395,5370,11765
02069000,NEW YORK SCHOOL OF INTERIOR DESIGN      ,NY,10021-0000,Private      ,16,51,67,226,444,670
02075700,BRIARCLIFFE COLLEGE                     ,NY,11714-0000,Proprietary  ,17,105,122,516,1292,1808
02075702,BRIARCLIFFE COLLEGE - PATCHOGUE         ,NY,11772-3019,Proprietary  ,36,86,122,572,795,1367
02092400,RIDLEY-LOWELL SCHOOL OF BUSINESS        ,NY,13905-0000,Proprietary  ,11,40,51,53,204,257
02093700,LONG ISLAND BUSINESS INSTITUTE          ,NY,11725-0000,Proprietary  ,140,395,535,378,1245,1623
02093701,LONG ISLAND BUSINESS INSTITUTE - FLUSHIN,NY,11354-4429,Proprietary  ,1,5,6,16,39,55
02098400,HERKIMER COUNTY BOCES                   ,NY,13350-0000,Public       ,0,4,4,39,131,170
02104300,OTSEGO AREA SCHOOL OF PRAC NURSING      ,NY,12167-0000,Public       ,2,1,3,14,34,48
02105900,HAIR DESIGN INSTITUTE AT FIFTH AVE      ,NY,11220-0000,Proprietary  ,21,59,80,100,286,386
02106800,BRAMSON ORT COLLEGE                     ,NY,11375-0000,Private      ,45,105,150,266,620,886
02110900,CATTARAUGUS/ALLEGANY BOCES              ,NY,14760-0000,Public       ,1,11,12,69,123,192
02112301,RIDLEY - LOWELL BUSINESS & TECHNICAL INS,NY,12601-3328,Proprietary  ,26,129,155,160,612,772
02116011,SANFORD-BROWN INSTITUTE - NEW YORK      ,NY,10003-2103,Proprietary  ,51,200,251,442,1362,1804
02118700,LONG ISLAND COLLEGE HOSPITAL - SCHOOL OF,NY,11201-6001,Private      ,0,0,0,107,187,294
02124000,ORANGE ULSTER BOCES SCH OF PRAC NRS     ,NY,10924-9401,Public       ,5,27,32,45,198,243
02125500,CIRCLE IN THE SQUARE THEATRE SCHOOL     ,NY,10019-0000,Private      ,0,4,4,55,79,134
02126300,MADISON-ONEIDA BOCES PRAC NRS           ,NY,13478-0000,Public       ,7,20,27,27,69,96
02138500,BOCES RENSSELAER SCHOOL OF PN           ,NY,12033-3221,Public       ,1,3,4,23,60,83
02145800,CAYUGA ONONDAGA BOCES                   ,NY,13021-9430,Public       ,3,11,14,40,95,135
02146000,WAYNE-FINGER LAKES BOCES                ,NY,14513-0000,Public       ,1,7,8,59,311,370
02152000,YESHIVA SHAAR HATORAH ITRI TORAH        ,NY,11418-0000,Private      ,0,1,1,8,3,11
02153600,BROOME-TIOGA BOCES PN PROG              ,NY,13905-0000,Public       ,2,9,11,39,144,183
02157900,ROCHESTER GENERAL HOSPITAL              ,NY,14621-3001,Private      ,5,23,28,42,149,191
02158200,WSHNGTN-SARTGA-WARN-HMLTN-ESX BOCES     ,NY,12839-1051,Public       ,1,3,4,11,62,73
02160100,GENEVA GENERAL HOSPITAL                 ,NY,14456-0000,Private      ,1,16,17,43,181,224
02163400,NEW YORK CAREER INSTITUTE               ,NY,10007-2801,Proprietary  ,17,80,97,179,641,820
02169100,DAVIS COLLEGE                           ,NY,13790-0000,Private      ,7,9,16,190,140,330
02170000,SWEDISH INSTITUTE                       ,NY,10001-0000,Proprietary  ,28,155,183,214,1015,1229
02170200,ALBANY SCHOHARIE SCHENECTADY            ,NY,12205-0000,Public       ,1,19,20,35,153,188
02171900,AILEY SCHOOL (THE)                      ,NY,10019-4402,Private      ,8,21,29,155,104,259
02172100,HAMILTON-FULTON-MONTGOMERY BOCES        ,NY,12095-0665,Public       ,0,7,7,46,102,148
02172800,DUTCHESS COUNTY BOCES SCH PRAC NURS     ,NY,12601-0000,Public       ,11,39,50,77,213,290
02173200,EMPIRE BEAUTY SCHOOL                    ,NY,10001-0000,Proprietary  ,108,279,387,904,1856,2760
02173900,ULSTER COUNTY BOCES PRACTICAL NRSG      ,NY,12466-0000,Public       ,1,15,16,40,202,242
02176000,CHERYL FELL'S SCHOOL OF BUSINESS        ,NY,14304-0000,Proprietary  ,0,24,24,12,125,137
02179400,EASTERN SUFFOLK BOCES                   ,NY,11713-0000,Public       ,4,18,22,173,415,588
02182200,NEW SCHOOL OF RADIO & TELEVISION        ,NY,12206-1106,Proprietary  ,2,12,14,67,100,167
02191600,TORAH TEMIMAH TALMUDICAL SEMINARY       ,NY,11218-0000,Private      ,12,0,12,16,1,17
02192500,BELLEVUE HOSP CTR SCH RAD TECH          ,NY,10016-0000,Public       ,3,19,22,19,106,125
02199300,ORLEANS-NIAGARA BOCES                   ,NY,14132-0000,Public       ,0,9,9,31,113,144
02206000,HUNTER BUSINESS SCHOOL                  ,NY,11756-0000,Proprietary  ,65,176,241,313,795,1108
02217800,D.HOPFER SCH NURSING AT MT.VRN HOSP     ,NY,10550-0000,Private      ,0,0,0,1,1,2
02219500,MILDRED ELLEY                           ,NY,12206-1513,Proprietary  ,63,379,442,355,2277,2632
02235600,ERIE 2-CHAUTAUQUA-CATTARAUGUS BOCES     ,NY,14006-0000,Public       ,12,20,32,38,110,148
02265100,YESHIVA DERECH CHAIM                    ,NY,11218-0000,Private      ,19,5,24,42,17,59
02272900,ROCKLAND COUNTY BOCES PRAC NRSG SCH     ,NY,10994-0000,Public       ,1,9,10,41,117,158
02275900,"MODERN WELDING SCHOOL, INC.             ",NY,12304-0000,Proprietary  ,15,27,42,68,123,191
02287800,NATIONAL TRACTOR TRAILER SCHOOL         ,NY,13088-2505,Proprietary  ,11,127,138,47,533,580
02294900,INSTITUTE OF AUDIO RESEARCH             ,NY,10003-0000,Proprietary  ,35,61,96,244,449,693
02306500,PROFESSIONAL BUSINESS COLLEGE           ,NY,10013-5049,Private      ,8,11,19,212,566,778
02314200,NORTHERN WESTCHESTER SCH COSMETOL       ,NY,10566-0000,Proprietary  ,3,8,11,24,25,49
02320100,OHR SOMAYACH TANENBAUM EDUCATIONAL CENTE,NY,10952-0000,Private      ,0,0,0,0,1,1
02350600,YESHIVA AND KOLLEL HARBOTZAS TORAH      ,NY,11230-0000,Private      ,0,9,9,0,17,17
02491400,SPANISH AMERICAN INSTITUTE              ,NY,10036-0000,Private      ,0,0,0,7,9,16
02505800,YESHIVA KARLIN STOLIN RAB INSTITUTE     ,NY,11204-0000,Private      ,18,21,39,19,22,41
02505900,SH-OR YOSHUV RABBINICAL COLLEGE         ,NY,11691-0000,Private      ,9,3,12,22,15,37
02506000,ASSOCIATED BETH RIVKAH SCHOOLS          ,NY,11225-0000,Private      ,18,4,22,131,20,151
02506100,CITY UNIV OF NEW YORK-CENTRAL           ,NY,10021-0000,Public       ,83,150,233,2117,1408,3525
02506800,YESHIVAT MIKDASH MELECH                 ,NY,11230-0000,Private      ,3,0,3,21,2,23
02511500,JOFFREY BALLET SCHOOL                   ,NY,10011-0000,Proprietary  ,4,2,6,152,21,173
02513500,MAR JON SCHOOL OF BEAUTY CULTURE        ,NY,14150-0000,Proprietary  ,5,17,22,34,85,119
02525600,ART INSTITUTE OF NEW YORK CITY (THE)    ,NY,10013-2429,Proprietary  ,158,205,363,1782,1471,3253
02540800,"GLOBE INSTITUTE OF TECHNOLOGY, INC.     ",NY,10007-0000,Proprietary  ,29,42,71,421,412,833
02546000,TRI-STATE COLLEGE OF ACUPUNCTURE        ,NY,10011-0000,Proprietary  ,0,12,12,2,117,119
02546300,YESHIVA OF THE TELSHE ALUMNI            ,NY,10471-0000,Private      ,1,0,1,3,0,3
02550600,TALMUDICAL INST OF UPSTATE NY           ,NY,14607-0000,Private      ,3,0,3,10,3,13
02556700,SEMINAR L'MOROS BAIS YAAKOV             ,NY,11219-0000,Private      ,16,1,17,211,4,215
02572900,BUSINESS INFORMATICS CENTER             ,NY,11580-0000,Proprietary  ,4,2,6,14,27,41
02575400,FRENCH CULINARY INSTITUTE               ,NY,10013-2618,Proprietary  ,59,128,187,334,763,1097
02587600,ORLO SCH HAIR DESIGN & COSMETOLOGY      ,NY,12206-1723,Proprietary  ,16,13,29,64,55,119
02599400,NEW YORK COLLEGE OF HEALTH PROFESSIONS  ,NY,11791-4413,Private      ,16,81,97,170,879,1049
02600100,NEW YORK ACADEMY OF ART (THE)           ,NY,10013-2911,Private      ,29,36,65,234,334,568
02614900,SANFORD-BROWN INSTITUTE                 ,NY,10604-2910,Proprietary  ,4,13,17,21,101,122
02615001,SANFORD-BROWN COLLEGE - SANFORD-BROWN IN,NY,11530-4734,Proprietary  ,48,91,139,290,586,876
02616600,SHEAR EGO INTERNATIONAL SCHOOL OF HAIR D,NY,14617-3501,Proprietary  ,14,26,40,85,149,234
02617000,CONTINENTAL SCH OF BEAUTY CULTURE       ,NY,14020-0000,Proprietary  ,8,15,23,31,69,100
02617002,CONTINENTAL SCHOOL OF BEAUTY CULTURE  - ,NY,14020-1908,Proprietary  ,1,9,10,20,44,64
02622900,BAIS MEDRASH ELYON                      ,NY,10952-3013,Private      ,9,14,23,11,14,25
03000100,YESHIVA GEDOLAH IMREI YOSEF DSPINKA     ,NY,11219-4696,Private      ,3,62,65,3,65,68
03007200,DANCE THEATRE OF HARLEM                 ,NY,10031-0000,Private      ,4,5,9,50,56,106
03027701,PACIFIC COLLEGE OF ORIENTAL MEDICINE - N,NY,10010-7108,Proprietary  ,5,66,71,29,513,542
03081600,DELAWARE CHENANGO MADISON OT. BOCES     ,NY,13815-9554,Public       ,1,6,7,16,58,74
03095500,ASA INST BUSINESS & COMPUTER TECH       ,NY,11201-5208,Proprietary  ,360,563,923,2007,3990,5997
03096200,CHARLES STUART SCHOOL                   ,NY,11229-2004,Proprietary  ,2,10,12,9,33,42
03103700,ADIRONDACK BEAUTY SCHOOL                ,NY,12801-3158,Proprietary  ,2,11,13,19,50,69
03104900,SULLIVAN COUNTY BOCES                   ,NY,12754-2116,Public       ,2,6,8,14,45,59
03115300,GENESEE VALLEY BOCES                    ,NY,14020-1099,Public       ,9,34,43,52,157,209
03120700,NEW YORK CONSERVATORY FOR DRAMATIC ARTS ,NY,10011-4225,Proprietary  ,25,18,43,468,206,674
03127100,YESHIVAS NOVOMINSK                      ,NY,11219-0000,Private      ,2,0,2,40,0,40
03129200,RABBINICAL CLG OHR SHIMAR YISROEL       ,NY,11211-8102,Private      ,22,54,76,24,61,85
03169300,STUDIO JEWELERS                         ,NY,10016-4112,Proprietary  ,1,9,10,2,38,40
03181400,MERKAZ BNOS                             ,NY,11214-4911,Private      ,8,38,46,15,148,163
03191300,CUNY SCHOOL OF LAW @ QUEENS COLLEGE     ,NY,11367-0000,Public       ,25,64,89,407,1168,1575
03193300,MANHATTAN SCHOOL OF COMPUTER TECH       ,NY,11230-1617,Private      ,41,164,205,225,689,914
03203300,NEW YORK INSTITUTE OF MASSAGE           ,NY,14221-6021,Proprietary  ,2,38,40,30,156,186
03216300,UNIFICATION THEOLOGICAL SEMINARY        ,NY,12507-5021,Private      ,1,6,7,19,37,56
03328300,FRANKLIN CAREER INSTITUTE               ,NY,11550-3003,Private      ,2,2,4,59,138,197
03328301,FRANKLIN CAREER INSTITUTE - BROOKLYN    ,NY,11220-3110,Private      ,12,60,72,116,355,471
03358300,ALLEN SCHOOL                            ,NY,11432-4901,Proprietary  ,31,307,338,197,1591,1788
03358301,ALLEN SCHOOL - BROOKLYN                 ,NY,11201-0000,Proprietary  ,26,137,163,211,735,946
03380300,STAR CAREER ACADEMY                     ,NY,11791-5311,Proprietary  ,9,42,51,94,264,358
03419400,NORTHEASTERN SEMINARY                   ,NY,14624-1997,Private      ,2,10,12,28,143,171
03433500,LIA SCHORR INSTITUTE OF COSMETIC SK     ,NY,10022-2614,Proprietary  ,1,4,5,8,33,41
03443300,NEW YORK COLLEGE OF TRADITIONAL CHINESE ,NY,11501-0000,Private      ,1,8,9,5,99,104
03496300,YESHIVA SHAAREI TORAH OF ROCKLAND       ,NY,10901-4003,Private      ,16,36,52,17,37,54
03537300,NEW YORK AUTOMOTIVE & DIESEL INSTIT     ,NY,11101-0000,Proprietary  ,21,64,85,145,303,448
03568300,LEON STUDIO ONE SCHOOL OF HAIR DESI     ,NY,14221-5323,Proprietary  ,0,0,0,16,31,47
03651300,SAINT JOSEPH'S MEDICAL CENTER SCHOO     ,NY,10701-4080,Private      ,1,8,9,25,35,60
03652300,METROPOLITAN LEARNING INSTITUTE         ,NY,11374-2101,Private      ,6,122,128,61,966,1027
03665400,CHRISTIE'S EDUCATION                    ,NY,10036-8002,Proprietary  ,0,1,1,3,42,45
03713300,BEIS MEDRASH HEICHAL DOVID              ,NY,11691-4433,Private      ,12,0,12,28,1,29
03773300,CENTER FOR NATURAL WELLNESS SCHOOL OF MA,NY,12205-1601,Proprietary  ,7,23,30,44,174,218
03802300,UTA MESIVTA OF KIRYAS JOEL              ,NY,10950-2169,Private      ,464,275,739,534,368,902
03809400,MICROPOWER CAREER INSTITUTE             ,NY,10001-2812,Proprietary  ,0,0,0,26,153,179
03839300,AVEDA INSTITUTE NEW YORK                ,NY,10013-1522,Proprietary  ,22,70,92,176,397,573
03881300,UNION GRADUATE COLLEGE                  ,NY,12308-3131,Private      ,0,17,17,11,185,196
03903400,AMERICAN BEAUTY SCHOOL                  ,NY,10462-8003,Proprietary  ,19,77,96,151,384,535
03941400,ELITE ACADEMY OF BEAUTY ARTS            ,NY,11223-1630,Proprietary  ,5,8,13,28,72,100
03983300,"SCHOOL OF PROFESSIONAL HORTICULTURE, AT ",NY,10458-5126,Private      ,2,12,14,14,53,67
03988300,"SAE INSTITUTE OF TECHNOLOGY, NEW YORK   ",NY,10001-2915,Proprietary  ,59,88,147,376,513,889
04043300,ACE COMPUTER TRAINING CENTER            ,NY,11375-5337,Proprietary  ,8,36,44,50,240,290
04092401,MAKE-UP DESIGNORY -                     ,NY,10012-0041,Proprietary  ,34,56,90,302,375,677
04095300,KING'S COLLEGE (THE)                    ,NY,10018-0110,Private      ,33,22,55,984,197,1181
04102300,NEW AGE TRAINING                        ,NY,10001-4006,Proprietary  ,9,68,77,60,289,349
04115500,TALMUDICAL SEMINARY OF BOBOV            ,NY,11219-3826,Private      ,115,44,159,140,47,187
04117100,EDP SCHOOL OF COMPUTER PROGRAMMING      ,NY,11235-0000,Private      ,5,39,44,20,127,147
04117700,"MONROE 2-ORLEANS BOCES, CENTER FOR WORK ",NY,14624-1119,Public       ,10,51,61,100,309,409
04119600,YESHIVA OF FAR ROCKAWAY DERECH AYSON RAB,NY,11691-5219,Private      ,3,0,3,19,0,19
04123200,INSTITUTE OF ALLIED MEDICAL PROFESSIONS ,NY,11373-5541,Private      ,0,0,0,13,33,46
04125600,CAREER SCHOOL OF NY                     ,NY,10301-2416,Private      ,11,23,34,69,121,190
04131500,COLLECTIVE (THE)                        ,NY,10011-2026,Proprietary  ,0,1,1,18,20,38
04133700,NEW YORK MEDICAL CAREER TRAINING CENTER ,NY,11354-6504,Proprietary  ,5,36,41,32,161,193
04133701,NEW YORK MEDICAL CAREER TRAINING CENTER ,NY,10018-6504,Proprietary  ,17,57,74,90,290,380
04134000,"JOHN PAOLO'S XTREME BEAUTY INSTITUTE, GO",NY,12020-1245,Proprietary  ,6,12,18,17,53,70
04134001,"JOHN PAOLO'S XTREME BEAUTY INSTITUTE, GO",NY,13417-1319,Proprietary  ,4,22,26,24,102,126
04137700,ANN MARIE'S WORLD OF BEAUTY SCHOOL      ,NY,13901-2308,Proprietary  ,0,2,2,6,21,27
04138100,YESHIVA OF MACHZIKAI HADAS              ,NY,11219-1408,Private      ,93,35,128,160,66,226
04144300,INSTITUTE OF CULINARY EDUCATION         ,NY,10010-5205,Proprietary  ,72,189,261,590,1136,1726
04148000,NEW LIFE BUSINESS INSTITUTE             ,NY,11432-6149,Proprietary  ,1,65,66,30,261,291
04151200,SALON PROFESSIONAL ACADEMY (THE)        ,NY,14150-9200,Proprietary  ,4,16,20,71,137,208
04155300,ONONDAGA SCHOOL OF THERAPEUTIC MASSAGE  ,NY,13210-1533,Proprietary  ,13,51,64,72,255,327
04156000,ACADEMY OF COSMETOLOGY & ESTHETICS NYC (,NY,10306-3003,Proprietary  ,15,34,49,126,167,293
04157500,ACCESS CAREERS                          ,NY,11201-5826,Proprietary  ,12,76,88,67,294,361
04165700,"JOHN PAOLO'S XTREME BEAUTY INSTITUTE, GO",NY,12110-3053,Proprietary  ,3,6,9,7,32,39
04166000,MANHATTAN INSTITUTE (THE)               ,NY,10016-6516,Proprietary  ,16,72,88,137,308,445
04167600,FINGER LAKES SCHOOL OF MASSAGE (THE)    ,NY,14850-1384,Proprietary  ,11,34,45,51,158,209
04167601,FINGER LAKES SCHOOL OF MASSAGE (THE) -  ,NY,10549-1103,Proprietary  ,3,25,28,14,115,129
04178700,ATELIER ESTHETIQUE INSTITUTE OF ESTHETIC,NY,10016-8804,Proprietary  ,6,50,56,31,234,265
04179800,SOTHEBY'S INSTITUTE OF ART - NY         ,NY,10022-6717,Proprietary  ,2,6,8,23,160,183
04180200,LONG ISLAND NAIL & SKIN CARE INSTITUTE  ,NY,11756-1316,Proprietary  ,4,28,32,24,110,134
04189000,LONG ISLAND BARBER INSTITUTE (THE)      ,NY,11550-6317,Proprietary  ,2,25,27,19,75,94
04190500,NEW YORK SCHOOL OF ESTHETICS & DAY SPA  ,NY,10591-3232,Proprietary  ,7,11,18,21,80,101
04192800,BE'ER YAAKOV TALMUDIC SEMINARY          ,NY,10977-1912,Private      ,1,88,89,2,157,159
04204300,AESTHETIC SCIENCE INSTITUTE (THE)       ,NY,12110-1095,Proprietary  ,3,9,12,30,64,94
04206200,DIGITAL FILM ACADEMY                    ,NY,10036-3708,Proprietary  ,18,40,58,140,249,389
04207400,YESHIVA GEDOLA OHR YISRAEL              ,NY,11229-1817,Private      ,1,0,1,1,0,1
04207600,AMERICAN ACADEMY OF PERSONAL TRAINING   ,NY,10011-7301,Proprietary  ,12,41,53,56,204,260
04208600,RELAY SCHOOL OF EDUCATION               ,NY,10011-4233,Private      ,0,18,18,2,322,324
04208800,GLORIA FRANCIS SCHOOL OF MAKE-UP ARTISTR,NY,11801-3873,Proprietary  ,7,15,22,24,56,80
04210100,STELLA AND CHARLES GUTTMAN COMMUNITY COL,NY,10018-2602,Public       ,69,24,93,2954,755,3709
04210700,NEW YORK INSTITUTE OF BEAUTY            ,NY,11749-1479,Proprietary  ,4,16,20,34,99,133
04212500,CACTUS ACADEMY (THE)                    ,NY,11530-3402,Proprietary  ,13,18,31,76,98,174
04213400,ACCESS CAREERS                          ,NY,11550-0000,Proprietary  ,4,23,27,13,108,121
04213500,SHARP EDGEZ BARBER INSTITUTE            ,NY,14620-0000,Proprietary  ,3,21,24,14,83,97
04215900,YESHIVA GEDOLAH KESSER TORAH            ,NY,10952-2127,Private      ,6,1,7,46,2,48
04223100,ARROJO COSMETOLOGY SCHOOL               ,NY,10014-4960,Proprietary  ,9,42,51,87,189,276
04223200,GRACE INTERNATIONAL BEAUTY SCHOOL       ,NY,11355-2446,Proprietary  ,2,26,28,5,61,66
04223300,ALLIANCE COMPUTING SOLUTIONS            ,NY,11354-6507,Proprietary  ,2,6,8,7,30,37
04223800,ELECTRICAL TRAINING CENTER (THE)        ,NY,11726-2701,Proprietary  ,8,18,26,44,77,121
04225500,WESTCHESTER SCHOOL FOR DENTAL ASSISTANTS,NY,10606-1246,Proprietary  ,5,20,25,31,94,125
04227200,BET MEDRASH GADOL ATERET TORAH          ,NY,11223-1933,Private      ,4,2,6,4,2,6
04228300,PAUL MITCHELL THE SCHOOL                ,NY,12305-2303,Proprietary  ,11,9,20,74,84,158
04230100,RABBINICAL COLLEGE OHR YISROEL          ,NY,11236-5141,Private      ,24,0,24,24,0,24
04231500,YESHIVA SHOLOM SHACHNA                  ,NY,11230-2621,Private      ,2,0,2,2,0,2
04233700,CHRISTINE VALMY INTERNATIONAL SCHOOL FOR,NY,10016-7701,Proprietary  ,9,72,81,38,235,273
04234300,CULINARY TECH CENTER                    ,NY,10001-2320,Proprietary  ,14,58,72,14,58,72
04237500,DERMALOGICA ACADEMY                     ,NY,10011-2420,Proprietary  ,1,12,13,1,12,13
00267808,BRYANT & STRATTON COLLEGE - PARMA       ,OH,44130-0000,Proprietary  ,55,291,346,534,3136,3670
00301000,ANTIOCH UNIVERSITY                      ,OH,45387-1608,Private      ,7,68,75,225,714,939
00301100,ART ACADEMY OF CINCINNATI               ,OH,45202-7106,Private      ,19,28,47,418,249,667
00301200,ASHLAND UNIVERSITY                      ,OH,44805-3799,Private      ,92,266,358,3877,2826,6703
00301300,ATHENAEUM OF OHIO                       ,OH,45230-2000,Private      ,0,1,1,7,15,22
00301400,BALDWIN-WALLACE COLLEGE                 ,OH,44017-2088,Private      ,129,115,244,5031,1664,6695
00301600,BLUFFTON UNIVERSITY                     ,OH,45817-2104,Private      ,19,23,42,1555,356,1911
00301800,BOWLING GREEN STATE UNIVERSITY          ,OH,43403-0001,Public       ,427,402,829,19623,5954,25577
00302300,CAPITAL UNIVERSITY                      ,OH,43209-2394,Private      ,93,214,307,4211,2893,7104
00302400,CASE WESTERN RESERVE UNIV               ,OH,44106-0000,Private      ,306,149,455,11184,2227,13411
00302401,CASE WESTERN RESERVE UNIV - MED         ,OH,44106-0000,Private      ,9,14,23,97,1162,1259
00302402,CASE WESTERN RESERVE UNIV - DENTAL      ,OH,44106-0000,Private      ,6,8,14,42,304,346
00302403,CASE WESTERN RESERVE UNIV - LAW         ,OH,44106-0000,Private      ,2,13,15,31,809,840
00302404,CASE WESTERN RESERVE UNIV - UG          ,OH,44106-0000,Private      ,7,1,8,224,30,254
00302405,CASE WESTERN RESERVE UNIV - MSASS       ,OH,44106-0000,Private      ,1,28,29,18,629,647
00302406,CASE WESTERN RESERVE UNIV - NURS UG     ,OH,44106-0000,Private      ,4,21,25,241,238,479
00302407,CASE WESTERN RESERVE UNIV - WSOM        ,OH,44106-0000,Private      ,2,9,11,25,211,236
00302408,CASE WESTERN RESERVE UNIV -A&S GRAD     ,OH,44106-0000,Private      ,0,6,6,9,284,293
00302409,CASE WESTERN RESERVE UNIV -ENG GRAD     ,OH,44106-0000,Private      ,3,2,5,56,100,156
00302410,CASE WESTERN RESERVE UNIV -NURS GRD     ,OH,44106-0000,Private      ,2,22,24,16,404,420
00302500,CEDARVILLE UNIVERSITY                   ,OH,45314-8564,Private      ,71,39,110,4116,558,4674
00302600,CENTRAL STATE UNIVERSITY                ,OH,45384-1004,Public       ,73,99,172,3057,1547,4604
00302900,CINCINNATI CHRISTIAN UNIVERSITY         ,OH,45204-3200,Private      ,20,56,76,664,727,1391
00303000,OHIO CHRISTIAN UNIVERSITY               ,OH,43113-9487,Private      ,36,630,666,941,4508,5449
00303100,CLEVELAND INSTITUTE OF MUSIC            ,OH,44106-1776,Private      ,17,14,31,436,365,801
00303200,CLEVELAND STATE UNIVERSITY              ,OH,44115-2214,Public       ,324,961,1285,11676,13811,25487
00303300,MOUNT ST. JOSEPH UNIVERSITY             ,OH,45233-1670,Private      ,46,114,160,1781,1470,3251
00303500,OHIO DOMINICAN UNIVERSITY               ,OH,43219-2099,Private      ,57,184,241,2048,2377,4425
00303600,FRANCISCAN UNIV OF STEUBENVILLE         ,OH,43952-1763,Private      ,60,57,117,2494,700,3194
00303700,COLLEGE OF WOOSTER                      ,OH,44691-2363,Private      ,62,13,75,3401,153,3554
00303900,COLUMBUS COLLEGE OF ART AND DESIGN      ,OH,43215-1758,Private      ,70,86,156,1677,811,2488
00304000,CUYAHOGA COMMUNITY COLLEGE              ,OH,44115-2878,Public       ,862,2873,3735,11754,25238,36992
00304100,"DEFIANCE COLLEGE, THE                   ",OH,43512-1695,Private      ,18,21,39,1480,402,1882
00304200,DENISON UNIVERSITY                      ,OH,43023-1329,Private      ,77,11,88,3075,124,3199
00304400,TRINITY LUTHERAN SEMINARY               ,OH,43209-0000,Private      ,0,8,8,3,119,122
00304500,UNIVERSITY OF FINDLAY                   ,OH,45840-3695,Private      ,67,141,208,3441,1695,5136
00304600,FRANKLIN UNIVERSITY                     ,OH,43215-5399,Private      ,84,795,879,1179,9846,11025
00304800,HEIDELBERG UNIVERSITY                   ,OH,44883-2462,Private      ,27,27,54,1901,322,2223
00304900,HIRAM COLLEGE                           ,OH,44234-1808,Private      ,26,29,55,1702,398,2100
00305000,JOHN CARROLL UNIVERSITY                 ,OH,44118-4581,Private      ,79,43,122,4726,939,5665
00305100,KENT STATE UNIVERSITY                   ,OH,44242-0001,Public       ,559,802,1361,27122,12888,40010
00305101,KENT STATE UNIVERSITY - GEAUGA CAMPUS   ,OH,44021-9500,Public       ,36,78,114,931,1057,1988
00305102,KENT STATE UNIVERSITY - STARK CAMPUS    ,OH,44720-7599,Public       ,138,270,408,3459,3815,7274
00305103,KENT STATE UNIVERSITY - TUSCARAWAS CAMPU,OH,44663-9403,Public       ,26,69,95,951,1276,2227
00305104,KENT STATE UNIVERSITY - TRUMBULL CAMPUS ,OH,44483-1998,Public       ,58,148,206,1223,2118,3341
00305105,KENT STATE UNIVERSITY - ASHTABULA CAMPUS,OH,44004-2299,Public       ,43,124,167,901,1877,2778
00305106,KENT STATE UNIVERSITY - EAST LIVERPOOL C,OH,43920-3497,Public       ,13,63,76,466,855,1321
00305107,KENT STATE UNIVERSITY - SALEM CAMPUS    ,OH,44460-9412,Public       ,33,77,110,996,1178,2174
00306500,KENYON COLLEGE                          ,OH,43022-9623,Private      ,105,5,110,3781,83,3864
00306600,LAKE ERIE COLLEGE                       ,OH,44077-3389,Private      ,28,28,56,1223,399,1622
00306800,LORAIN COUNTY COMMUNITY COLLEGE         ,OH,44035-1691,Public       ,184,609,793,4193,7518,11711
00306900,LOURDES COLLEGE                         ,OH,43560-2898,Private      ,31,88,119,1178,1427,2605
00307200,MALONE UNIVERSITY                       ,OH,44709-3897,Private      ,34,108,142,1798,1317,3115
00307300,MARIETTA COLLEGE                        ,OH,45750-4033,Private      ,22,18,40,2368,385,2753
00307500,METHODIST THEOLOGICAL SCH IN OHIO       ,OH,43015-0000,Private      ,0,6,6,0,181,181
00307700,MIAMI UNIVERSITY                        ,OH,45056-1831,Public       ,490,347,837,23059,5340,28399
00307800,WRIGHT STATE UNIVERSITY                 ,OH,45435-0002,Public       ,328,617,945,13034,10539,23573
00308300,UNIVERSITY OF MOUNT UNION               ,OH,44601-3993,Private      ,54,20,74,3450,373,3823
00308400,MUSKINGUM UNIVERSITY                    ,OH,43762-1199,Private      ,29,49,78,2190,642,2832
00308500,NOTRE DAME COLLEGE OF OHIO              ,OH,44121-4293,Private      ,61,180,241,2348,1763,4111
00308600,OBERLIN COLLEGE                         ,OH,44074-1090,Private      ,164,20,184,4826,225,5051
00308900,OHIO NORTHERN UNIVERSITY                ,OH,45810-1555,Private      ,40,26,66,3740,937,4677
00309000,OHIO STATE UNIVERSITY-ALL CAMPUSES      ,OH,43210-1358,Public       ,1399,1306,2705,57108,24747,81855
00310000,OHIO UNIVERSITY                         ,OH,45701-2979,Public       ,550,1137,1687,24521,13037,37558
00310002,"OHIO UNIVERSITY, ZANESVILLE CAMPUS      ",OH,43701-0000,Public       ,33,117,150,1287,1560,2847
00310003,"OHIO UNIVERSITY, LANCASTER CAMPUS       ",OH,43130-0000,Public       ,66,152,218,1611,1945,3556
00310004,"OHIO UNIVERSITY, SOUTHERN CAMPUS        ",OH,45638-0000,Public       ,32,123,155,869,1835,2704
00310005,"OHIO UNIVERSITY, CHILLICOTHE CAMPUS     ",OH,45601-0000,Public       ,66,184,250,1296,2071,3367
00310006,"OHIO UNIVERSITY, EASTERN CAMPUS         ",OH,43950-0000,Public       ,15,34,49,504,442,946
00310008,OHIO UNIV COLL OF OSTEOPATHIC MED       ,OH,45701-0000,Public       ,2,6,8,25,688,713
00310900,OHIO WESLEYAN UNIVERSITY                ,OH,43015-2398,Private      ,65,25,90,3134,256,3390
00311000,OTTERBEIN UNIVERSITY                    ,OH,43081-2006,Private      ,61,67,128,3664,980,4644
00311300,PONTIFICAL COLLEGE JOSEPHINUM           ,OH,43235-1498,Private      ,1,1,2,53,22,75
00311400,FIRELANDS REGIONAL MEDICAL CENTER - SOUT,OH,44870-4788,Private      ,4,12,16,66,164,230
00311500,RABBINICAL COLLEGE OF TELSHE            ,OH,44092-2584,Private      ,1,4,5,16,23,39
00311600,UNIV OF RIO GRANDE                      ,OH,45674-3131,Private      ,57,157,214,1588,1943,3531
00311900,SINCLAIR COMMUNITY COLLEGE              ,OH,45402-1460,Public       ,574,1882,2456,8832,16387,25219
00312100,TIFFIN UNIVERSITY                       ,OH,44883-2161,Private      ,75,223,298,2615,3365,5980
00312200,UNITED THEOLOGICAL SEMINARY             ,OH,45406-0000,Private      ,0,49,49,1,654,655
00312300,UNIVERSITY OF AKRON                     ,OH,44325-6211,Public       ,474,761,1235,20768,12965,33733
00312500,UNIVERSITY OF CINCINNATI                ,OH,45221-0125,Public       ,919,1656,2575,30506,22531,53037
00312504,UNIVERSITY OF CINCINNATI - MEDICINE     ,OH,45267-0553,Public       ,25,61,86,380,1696,2076
00312700,UNIVERSITY OF DAYTON                    ,OH,45469-0002,Private      ,242,214,456,12813,3315,16128
00313100,UNIVERSITY OF TOLEDO                    ,OH,43606-3390,Public       ,394,623,1017,16880,10014,26894
00313300,URBANA UNIVERSITY                       ,OH,43078-2091,Private      ,16,57,73,936,772,1708
00313400,URSULINE COLLEGE                        ,OH,44124-4398,Private      ,15,97,112,616,1248,1864
00313500,WALSH UNIVERSITY                        ,OH,44720-3396,Private      ,41,84,125,2561,1426,3987
00314100,WILBERFORCE UNIVERSITY                  ,OH,45384-1001,Private      ,13,54,67,536,458,994
00314200,WILMINGTON COLLEGE                      ,OH,45177-2499,Private      ,40,34,74,2189,489,2678
00314300,WITTENBERG UNIVERSITY                   ,OH,45501-2199,Private      ,76,29,105,3866,428,4294
00314400,XAVIER UNIVERSITY                       ,OH,45207-1035,Private      ,126,232,358,8417,2955,11372
00314500,YOUNGSTOWN STATE UNIVERSITY             ,OH,44555-0001,Public       ,244,394,638,8967,6547,15514
00398200,CLEVELAND INSTITUTE OF ART              ,OH,44106-1700,Private      ,32,33,65,1078,334,1412
00406000,WINEBRENNER THEOLOGICAL SEMINARY        ,OH,45840-0000,Private      ,0,19,19,2,63,65
00485200,CLARK STATE COMMUNITY COLLEGE           ,OH,45505-4795,Public       ,122,656,778,1943,5846,7789
00485300,BRADFORD SCHOOL                         ,OH,43219-0000,Proprietary  ,24,69,93,608,706,1314
00485500,DAVIS COLLEGE                           ,OH,43623-4307,Proprietary  ,12,78,90,138,605,743
00486100,UNIVERSITY OF NORTHWESTERN OHIO         ,OH,45805-1498,Private      ,161,183,344,4809,1896,6705
00486600,STAUTZENBERGER COLLEGE                  ,OH,43537-4007,Proprietary  ,35,144,179,445,1295,1740
00510200,SCH OF DIAGNOSTIC IMAGING-CLEVELAND     ,OH,44119-0000,Private      ,1,6,7,17,62,79
00531300,NORTH CENTRAL STATE COLLEGE             ,OH,44901-0000,Public       ,78,212,290,1384,2363,3747
00575300,OWENS STATE COMMUNITY COLLEGE           ,OH,43699-0000,Public       ,275,774,1049,5199,8637,13836
00648700,AULTMAN COLLEGE OF NURSING AND HEALTH SC,OH,44710-1799,Private      ,9,30,39,201,519,720
00648900,CHRIST COLLEGE OF NURSING AND HEALTH SCI,OH,45219-2906,Private      ,11,73,84,400,918,1318
00649400,GOOD SAMARITAN COLG-NURSING/HEALTH      ,OH,45220-2489,Private      ,17,61,78,325,684,1009
00650700,TRINIT HEALTH SYSTEM SCH OF NURSING     ,OH,43952-2667,Private      ,3,9,12,80,164,244
00680400,LAKELAND COMMUNITY COLLEGE              ,OH,44094-5198,Public       ,170,587,757,3052,5978,9030
00686700,COLUMBUS STATE COMMUNITY COLLEGE        ,OH,43215-1786,Public       ,1013,2484,3497,13970,22760,36730
00703500,KETTERING COLLEGE OF MEDICAL ARTS       ,OH,45429-1299,Private      ,16,47,63,580,744,1324
00708500,MOUNT VERNON NAZARENE UNIVERSITY        ,OH,43050-9500,Private      ,17,106,123,1501,1006,2507
00708501,MOUNT VERNON NAZARENE UNIV - AGS        ,OH,43050-0000,Private      ,5,33,38,80,454,534
00727500,EASTERN GATEWAY COMMUNITY COLLEGE       ,OH,43952-3598,Public       ,65,263,328,1325,2709,4034
00732920,ITT TECHNICAL INSTITUTE                 ,OH,45414-3456,Proprietary  ,39,187,226,380,1693,2073
00732992,ITT TECHNICAL INSTITUTE                 ,OH,44509-4098,Proprietary  ,35,178,213,437,1644,2081
00747300,CHOFFIN CAREER & TECHNICAL CENTER       ,OH,44503-1628,Public       ,0,0,0,78,261,339
00759800,HOCKING TECHNICAL COLLEGE               ,OH,45764-9582,Public       ,157,258,415,2937,2612,5549
00777701,EDUCATION AMERICA                       ,OH,44137-0000,Private      ,0,0,0,18,79,97
00812900,ADULT AND COMMUNITY EDUCATION @ HUDSON  ,OH,43211-2017,Public       ,4,53,57,69,498,567
00813200,TOLEDO SCHOOL OF PRACTICAL NURSING      ,OH,43613-5110,Public       ,8,60,68,112,493,605
00813300,ZANE STATE COLLEGE                      ,OH,43701-2626,Public       ,56,155,211,1284,1763,3047
00819400,AKRON SCHOOL OF PRACTICAL NRSG          ,OH,44311-0000,Public       ,5,26,31,158,294,452
00827800,TERRA COMMUNITY COLLEGE                 ,OH,43420-9670,Public       ,55,164,219,873,1690,2563
00867700,NORTHWEST STATE COMMUNITY COLLEGE       ,OH,43502-9542,Public       ,50,209,259,1044,1983,3027
00888600,PORTAGE LAKES CAREER CENTER             ,OH,44685-9554,Public       ,1,3,4,32,121,153
00915600,WAYNE COUNTY SCHOOLS CAREER CENTER      ,OH,44677-9672,Public       ,1,14,15,54,234,288
00941200,FORTIS COLLEGE                          ,OH,44221-2998,Proprietary  ,19,152,171,243,1184,1427
00953000,GERBER AKRON BEAUTY SCHOOL              ,OH,44313-6995,Proprietary  ,8,17,25,39,154,193
00953100,SPA SCHOOL (THE)                        ,OH,43214-1524,Proprietary  ,11,40,51,74,309,383
00966000,TIFFIN ACADEMY OF HAIR DESIGN           ,OH,44883-2833,Proprietary  ,3,5,8,33,66,99
00994100,BELMONT TECHNICAL COLLEGE               ,OH,43950-9766,Public       ,16,84,100,645,1091,1736
00994200,SHAWNEE STATE UNIVERSITY                ,OH,45662-4344,Public       ,104,157,261,4190,2273,6463
01001700,PAYNE THEOLOGICAL SEMINARY              ,OH,45384-0474,Private      ,0,9,9,2,157,159
01002700,JAMES A. RHODES STATE COLLEGE           ,OH,45804-3597,Public       ,64,236,300,1616,2441,4057
01016800,NATIONWIDE BEAUTY ACADEMY               ,OH,43228-1000,Proprietary  ,8,33,41,113,248,361
01028000,OHIO STATE BEAUTY ACADEMY               ,OH,45801-0000,Proprietary  ,8,23,31,131,196,327
01032300,HANNAH E MULLINS SCH-PRAC NRSG          ,OH,44460-2906,Public       ,0,12,12,30,90,120
01034500,CINCINNATI STATE TECH & COMM CLG        ,OH,45223-2690,Public       ,356,1277,1633,5020,11426,16446
01045300,WASHINGTON STATE CMTY COLLEGE           ,OH,45750-9225,Public       ,42,103,145,846,1102,1948
01063000,NORTHERN INSTITUTE OF COSMETOLOGY       ,OH,44052-1803,Proprietary  ,6,9,15,21,88,109
01073600,MARION TECHNICAL COLLEGE                ,OH,43302-5694,Public       ,38,221,259,829,1776,2605
01088000,CHATFIELD COLLEGE                       ,OH,45118-9705,Private      ,6,35,41,111,398,509
01088100,STARK STATE COLLEGE                     ,OH,44720-7299,Public       ,305,971,1276,4281,11449,15730
01090600,CINCINNATI CLG OF MORTUARY SCIENCE      ,OH,45224-1428,Private      ,5,20,25,86,221,307
01092300,UNION INSTITUTE & UNIVERSITY            ,OH,45206-1925,Private      ,5,270,275,61,2029,2090
01099300,HOBART INSTITUTE OF WELDING TECHNOLOGY  ,OH,45373-2400,Private      ,21,54,75,379,332,711
01100500,KAPLAN COLLEGE                          ,OH,43232-4827,Proprietary  ,0,0,0,12,81,93
01104600,CENTRAL OHIO TECHNICAL COLLEGE          ,OH,43055-1767,Public       ,86,335,421,1701,4170,5871
01170300,PENTA COUNTY JOINT VOCATIONAL SCH       ,OH,43551-0000,Public       ,2,6,8,29,138,167
01174400,NATIONAL BEAUTY COLLEGE                 ,OH,44720-0000,Proprietary  ,0,17,17,32,118,150
01174500,OHIO TECHNICAL COLLEGE                  ,OH,44103-1228,Proprietary  ,55,139,194,1431,1114,2545
01212800,SOUTHWESTERN COLLEGE                    ,OH,45402-3003,Proprietary  ,0,0,0,10,84,94
01212804,SOUTHWESTERN COLLEGE                    ,OH,45246-3121,Proprietary  ,0,0,0,21,62,83
01212806,LINCOLN COLLEGE OF TECHNOLOGY - TOLEDO  ,OH,43615-6800,Proprietary  ,0,0,0,20,45,65
01212808,LINCOLN COLLEGE OF TECHNOLOGY - CLEVELAN,OH,44114-3266,Proprietary  ,0,0,0,29,59,88
01216600,CAROUSEL BEAUTY COLLEGE                 ,OH,45402-8935,Proprietary  ,8,35,43,98,297,395
01216603,CAROUSEL BEAUTY COLLEGE - OF MIAMI VALLE,OH,45424-2063,Proprietary  ,0,4,4,9,31,40
01224800,CENTRAL SCHOOL OF PRACTICAL NURSING     ,OH,44131-2155,Private      ,4,22,26,67,336,403
01267200,CAROUSEL BEAUTY COLLEGE                 ,OH,45044-5113,Proprietary  ,1,9,10,15,48,63
01275000,EDISON COMMUNITY COLLEGE                ,OH,45356-9239,Public       ,53,188,241,882,2196,3078
01283800,LAURA AND ALVIN SIEGAL COLLEGE OF JUDAIC,OH,44122-7197,Private      ,0,0,0,1,3,4
01284800,MOLER-HOLLYWOOD BEAUTY COLLEGE          ,OH,45202-2577,Proprietary  ,5,28,33,30,136,166
01287000,SOUTHERN STATE COMMUNITY COLLEGE        ,OH,45133-9406,Public       ,64,239,303,1091,2154,3245
01289100,ANTONELLI COLLEGE                       ,OH,45202-2592,Proprietary  ,11,80,91,121,688,809
01289600,VIRGINIA MARTI COLLEGE OF ART AND DESIGN,OH,44107-0778,Proprietary  ,9,20,29,145,178,323
01303922,SOUTH UNIVERSITY - CLEVELAND            ,OH,44128-5919,Proprietary  ,16,101,117,82,759,841
01313200,INTERNATIONAL CLG OF BROADCASTING       ,OH,45431-1898,Proprietary  ,7,25,32,90,199,289
02052000,KAPLAN COLLEGE                          ,OH,45439-1984,Proprietary  ,25,209,234,196,1458,1654
02054300,TRUMBULL BUSINESS COLLEGE               ,OH,44484-0000,Proprietary  ,5,28,33,40,349,389
02056800,DAYMAR COLLEGE                          ,OH,45601-1038,Proprietary  ,1,23,24,36,174,210
02056802,DAYMAR COLLEGE - LANCASTER              ,OH,43130-0000,Proprietary  ,5,20,25,38,165,203
02056803,DAYMAR COLLEGE - NEW BOSTON             ,OH,45662-4900,Proprietary  ,1,11,12,22,117,139
02056804,DAYMAR COLLEGE - JACKSON                ,OH,45640-1728,Proprietary  ,0,9,9,18,108,126
02066100,OHIO STATE COLLEGE/BARBER STYLING       ,OH,43213-0000,Proprietary  ,11,50,61,138,387,525
02073300,GALLIA-JACKSON-VINTON SCH ADULT ED      ,OH,45674-0000,Public       ,6,11,17,70,240,310
02110700,CLEVELAND INST OF DENTAL-MED ASST       ,OH,44115-2285,Proprietary  ,32,91,123,162,585,747
02116009,SANFORD-BROWN COLLEGE - MIDDLEBURG HEIGH,OH,44130-8362,Proprietary  ,0,10,10,13,137,150
02116900,UPPER VALLEY JVS                        ,OH,45356-0000,Public       ,1,38,39,36,266,302
02117300,GREAT OAKS INSTITUTE OF TECHNOLOGY      ,OH,45241-1581,Public       ,11,86,97,239,837,1076
02128600,THE ART INSTITUTE OF CINCINNATI         ,OH,45246-0000,Proprietary  ,36,34,70,477,330,807
02140700,CANTON CITY SCHOOLS ADULT CAREER & TECH ,OH,44702-1710,Public       ,1,25,26,22,222,244
02158417,"HARRISON COLLEGE - COLUMBUS, OH         ",OH,43123-0000,Proprietary  ,25,65,90,95,510,605
02158500,OHIO BUSINESS COLLEGE                   ,OH,44035-0701,Proprietary  ,11,47,58,102,501,603
02158501,OHIO BUSINESS COLLEGE                   ,OH,44870-9953,Proprietary  ,8,61,69,56,405,461
02158503,OHIO BUSINESS COLLEGE - COLUMBUS        ,OH,43229-3523,Proprietary  ,19,92,111,171,584,755
02158504,OHIO BUSINESS COLLEGE - DAYTON          ,OH,45417-4094,Proprietary  ,2,30,32,30,219,249
02168100,TRI-COUNTY JOINT VOCATIONAL SCHOOL      ,OH,45764-0000,Public       ,4,25,29,71,169,240
02187900,ASHTABULA CO JOINT VOC SCH ADULT ED     ,OH,44047-0000,Public       ,0,8,8,55,189,244
02189000,MID-EAST CAREER & TECH CENTERS-ADULT ED ,OH,43701-4600,Public       ,9,47,56,143,420,563
02190700,FORTIS COLLEGE                          ,OH,45459-0000,Proprietary  ,32,273,305,368,2877,3245
02192100,BUTLER TECHNOLOGY AND CAREER DEVELOPMENT,OH,45011-0000,Public       ,25,98,123,226,659,885
02196300,COLLINS CAREER CENTER                   ,OH,45619-0000,Public       ,9,60,69,201,600,801
02210800,MEDINA COUNTY CAREER CENTER             ,OH,44256-0000,Public       ,1,12,13,30,115,145
02220500,GOD'S BIBLE SCHOOL & COLLEGE            ,OH,45210-0000,Private      ,6,14,20,164,117,281
02220800,CAREER & TECHNOLOGY EDUCATION CENTERS OF,OH,43055-0000,Public       ,11,47,58,126,390,516
02239800,PIONEER CAREER & TECHNOLOGY CENTER      ,OH,44875-9704,Public       ,0,6,6,6,58,64
02245600,WARREN COUNTY CAREER CENTER             ,OH,45036-0000,Public       ,14,41,55,86,293,379
02246300,INSTITUTE OF MEDICAL-DENTAL TECH        ,OH,45246-3317,Proprietary  ,42,148,190,193,832,1025
02263700,MIAMI VALLEY CAREER TECHNOLOGY CTR      ,OH,45315-0000,Public       ,10,73,83,118,543,661
02269400,EASTERN HILLS ACAD OF HAIR DESIGN       ,OH,45255-0000,Proprietary  ,4,8,12,20,64,84
02269500,WESTERN HILLS SCHOOL OF BEAUTY & HAIR DE,OH,45211-0000,Proprietary  ,7,50,57,54,284,338
02270100,OHIO HI-POINT CAREER CENTER             ,OH,43311-0000,Public       ,0,0,0,10,46,56
02272700,COLUMBIANA COUNTY CAREER CENTER         ,OH,44432-0000,Public       ,7,37,44,58,238,296
02287900,RAPHAEL'S SCHOOL OF BEAUTY CULTURE      ,OH,44446-0000,Proprietary  ,13,32,45,53,192,245
02301400,OHIO VALLEY COLLEGE OF TECHNOLOGY       ,OH,43920-9139,Proprietary  ,8,28,36,91,267,358
02303600,FORTIS COLLEGE - RAVENNA CAMPUS         ,OH,44266-0000,Proprietary  ,0,0,0,15,85,100
02304700,TRI-RIVERS CAREER CENTER                ,OH,43302-0000,Public       ,4,37,41,72,306,378
02311200,AMERICAN SCHOOL OF TECHNOLOGY           ,OH,43229-0000,Proprietary  ,15,82,97,112,558,670
02315500,TOLEDO ACADEMY OF BEAUTY CULTURE - EAST ,OH,43616-0000,Proprietary  ,3,18,21,39,157,196
02324400,ALLSTATE HAIRSTYLING & BARBER CLG       ,OH,44113-0000,Proprietary  ,9,50,59,64,337,401
02328500,MOLER-PICKENS BEAUTY COLLEGE            ,OH,45014-0000,Proprietary  ,4,23,27,24,70,94
02334300,INTERNATIONAL ACAD OF HAIR DESIGN       ,OH,45239-0000,Proprietary  ,8,28,36,89,225,314
02336300,KNOX COUNTY CAREER CENTER               ,OH,43050-4298,Public       ,8,33,41,60,297,357
02336700,CUYAHOGA VALLEY CAREER CENTER           ,OH,44141-1296,Public       ,3,18,21,75,227,302
02337700,PROFESSIONAL SKILLS INSTITUTE           ,OH,43607-0000,Proprietary  ,9,58,67,125,607,732
02351500,WILLOUGHBY EASTLAKE SCH OF PRAC NSG     ,OH,44094-0000,Public       ,5,27,32,35,209,244
02352800,POLARIS CAREER CENTER-ADULT ED DEPT     ,OH,44130-0000,Public       ,11,44,55,136,453,589
02354200,SCIOTO COUNTY JOINT VOCATIONAL SCH      ,OH,45648-0000,Public       ,12,41,53,105,343,448
02359803,ITT TECHNICAL INSTITUTE -               ,OH,45212-2273,Proprietary  ,0,0,0,0,1,1
02454400,NORTHEAST OHIO MEDICAL UNIVERSITY       ,OH,44272-9621,Public       ,14,12,26,156,905,1061
02497800,GREENE COUNTY CAREER CENTER             ,OH,45385-0000,Public       ,4,21,25,30,118,148
02519300,OHIO STATE SCH COSMETOLOGY              ,OH,43110-2754,Proprietary  ,6,27,33,113,228,341
02522700,EASTLAND-FAIRFIELD CAREER AND TECHNICAL ,OH,43125-0000,Public       ,9,39,48,69,284,353
02528300,TDDS TECHNICAL INSTITUTE                ,OH,44429-0000,Proprietary  ,17,141,158,96,514,610
02529500,HAMRICK SCHOOL                          ,OH,44256-0000,Proprietary  ,4,67,71,20,272,292
02545800,INNER STATE BEAUTY SCHOOLS              ,OH,44124-0000,Proprietary  ,5,30,35,59,221,280
02553000,SCHOOL OF ADVERTISING ART               ,OH,45440-0000,Proprietary  ,7,4,11,260,57,317
02560000,CASAL AVEDA INSTITUTE                   ,OH,44515-0000,Proprietary  ,9,31,40,130,211,341
02560700,PICKAWAY ROSS CO JOINT VOC TECH SCH     ,OH,45601-0000,Public       ,6,29,35,98,364,462
02562300,APOLLO CAREER CENTER-ADULT EDUC         ,OH,45806-0000,Public       ,6,51,57,96,485,581
02563000,RAPHAELS SCHOOL OF BEAUTY CULTURE       ,OH,44601-2847,Proprietary  ,9,23,32,49,162,211
02568600,MAHONING COUNTY CAREER & TECH CENTR     ,OH,44406-0000,Public       ,0,8,8,28,122,150
02582900,KAPLAN CAREER INSTITUTE                 ,OH,44129-6810,Proprietary  ,2,30,32,35,363,398
02586400,TRUMBULL CAREER & TECH CENTER-ADULT     ,OH,44483-1997,Public       ,4,29,33,60,257,317
02588500,OHIO STATE SCHOOL OF COSMETOLOGY        ,OH,43081-0000,Proprietary  ,7,21,28,163,239,402
02599711,VATTEROTT COLLEGE - CLEVELAND           ,OH,44147-3502,Proprietary  ,14,70,84,63,375,438
02603800,LORAIN COUNTY JVS ADULT CAREER CTR      ,OH,44074-9799,Public       ,4,23,27,69,212,281
02611007,HERITAGE COLLEGE - COLUMBUS             ,OH,43213-4440,Proprietary  ,24,144,168,238,903,1141
02620000,SANDUSKY CAREER CENTER                  ,OH,44870-4786,Public       ,4,28,32,21,170,191
03007900,GALLIPOLIS CAREER COLLEGE               ,OH,45631-2600,Proprietary  ,3,23,26,18,173,191
03015100,ALLIANCE HIGH SCH-CMTY SERVICES DIV     ,OH,44601-2899,Public       ,2,6,8,31,88,119
03015300,EHOVE CAREER CENTER                     ,OH,44846-9500,Public       ,3,34,37,79,394,473
03023700,MADISON ADULT CAREER CENTER             ,OH,44905-2718,Public       ,7,30,37,62,304,366
03024300,VALLEY BEAUTY SCHOOL                    ,OH,43725-2332,Proprietary  ,1,1,2,19,35,54
03026511,REMINGTON COLLEGE - CLEVELAND           ,OH,44125-1957,Private      ,19,115,134,183,726,909
03027100,FAIRVIEW ACADEMY                        ,OH,44126-2214,Proprietary  ,0,8,8,15,73,88
03034200,WASHINGTON COUNTY CAREER CENTER ADULT TE,OH,45750-9290,Public       ,9,43,52,104,449,553
03035801,HERITAGE INSTITUTE - HERITAGE COLLEGE/CL,OH,44130-3304,Proprietary  ,10,31,41,13,41,54
03051400,AUBURN CAREER CENTER                    ,OH,44077-9723,Public       ,9,35,44,82,227,309
03051500,US GRANT JOINT VOCATIONAL SCHOOL        ,OH,45106-9502,Public       ,0,5,5,4,27,31
03065900,BUCKEYE CAREER CENTER                   ,OH,44663-9437,Public       ,0,19,19,58,192,250
03067600,RAPHAEL'S SCHOOL OF BEAUTY CULTURE      ,OH,44512-2222,Proprietary  ,13,22,35,49,155,204
03068200,OHIO CENTER FOR BROADCASTING            ,OH,44125-6273,Proprietary  ,10,34,44,67,197,264
03068202,OHIO CENTER FOR BROADCASTING - COLUMBUS ,OH,43213-2571,Proprietary  ,4,49,53,56,262,318
03071900,MOUNT CARMEL COLLEGE OF NURSING         ,OH,43222-1598,Private      ,26,93,119,842,1157,1999
03072303,EVEREST INSTITUTE - COLUMBUS            ,OH,43230-6653,Proprietary  ,36,128,164,124,595,719
03078000,OHIO CENTER FOR BROADCASTING            ,OH,45227-1509,Proprietary  ,1,28,29,44,146,190
03079000,ETI TECHNICAL COLLEGE                   ,OH,44446-4398,Proprietary  ,6,37,43,76,316,392
03084800,DELAWARE AREA CAREER CENTER             ,OH,43015-8969,Public       ,2,12,14,16,69,85
03084801,DELAWARE AREA CAREER CENTER -           ,OH,43015-9001,Public       ,2,8,10,10,54,64
03095600,VANTAGE CAREER CENTER                   ,OH,45891-1378,Public       ,3,14,17,29,104,133
03097000,MERCY COLLEGE OF OHIO                   ,OH,43604-1132,Private      ,15,117,132,660,1457,2117
03100100,PARAMOUNT BEAUTY ACADEMY                ,OH,45662-4136,Proprietary  ,5,32,37,37,146,183
03116200,DAYTON BARBER COLLEGE                   ,OH,45342-4196,Proprietary  ,4,17,21,26,112,138
03116300,OHIO COLLEGE OF MASSOTHERAPY            ,OH,44321-1363,Private      ,4,12,16,38,139,177
03116400,VANGUARD-SENTINELL VOC SCH DISTRICT     ,OH,43420-1197,Public       ,0,9,9,10,76,86
03117000,ASHLAND COUNTY-W HOLMES CAREER CTR      ,OH,44805-0000,Public       ,8,15,23,32,147,179
03319300,CREATIVE IMAGES-A CERTIFIED MATRIX      ,OH,45414-2557,Proprietary  ,11,43,54,122,313,435
03319301,CREATIVE IMAGES-A CERTIFIED MATRIX      ,OH,45459-0000,Proprietary  ,11,33,44,76,219,295
03416400,VALLEY BEAUTY SCHOOL                    ,OH,43701-3624,Proprietary  ,0,2,2,27,65,92
03425300,ROSEDALE BIBLE COLLEGE                  ,OH,43029-9517,Private      ,4,3,7,62,10,72
03457300,ALLEGHENY WESLEYAN COLLEGE              ,OH,44460-9598,Private      ,5,2,7,52,22,74
03468400,NATIONAL INSTITUTE OF MASSOTHERAPY      ,OH,44319-2100,Proprietary  ,3,7,10,21,98,119
03468500,ATS INSTITUTE OF TECHNOLOGY             ,OH,44143-2216,Proprietary  ,7,106,113,84,814,898
03475400,TRI-STATE BIBLE COLLEGE                 ,OH,45680-8402,Private      ,0,5,5,4,78,82
03534400,AMERICAN INST OF ALTERNATIVE MEDICI     ,OH,43229-1113,Proprietary  ,9,79,88,77,743,820
03583300,OHIO INSTITUTE OF ALLIED HEALTH         ,OH,45424-3646,Private      ,1,11,12,7,65,72
03626300,BROWN AVEDA INSTITUTE                   ,OH,44060-6212,Proprietary  ,19,51,70,195,342,537
03700300,REGENCY BEAUTY INSTITUTE - CLEVELAND    ,OH,44094-0000,Proprietary  ,13,58,71,156,435,591
03726300,TEMPLE BAPTIST COLLEGE                  ,OH,45240-0000,Private      ,3,7,10,30,62,92
03747300,BEXLEY HALL SEMINARY                    ,OH,43209-2325,Private      ,0,3,3,2,44,46
03776400,HEALING ARTS INSTITUTE                  ,OH,43551-3138,Proprietary  ,5,17,22,23,88,111
03837300,AVEDA FREDRIC'S INSTITUTE               ,OH,45208-1304,Proprietary  ,17,39,56,171,245,416
04051307,ART INSTITUTE OF PHOENIX (THE) - BROWN M,OH,45215-1107,Proprietary  ,34,152,186,267,1350,1617
04051308,ART INSTITUTE OF PHOENIX (THE) - BROWN M,OH,44320-4420,Proprietary  ,10,39,49,166,650,816
04051317,ART INSTITUTE OF PHOENIX (THE) - BROWN M,OH,45840-6848,Proprietary  ,47,225,272,433,1976,2409
04051326,ART INSTITUTE OF PHOENIX (THE) - BROWN M,OH,44718-3674,Proprietary  ,13,75,88,137,686,823
04068300,FOUR COUNTY CAREER CENTER               ,OH,43512-9541,Public       ,2,4,6,11,40,51
04074300,HONDROS COLLEGE                         ,OH,43081-3855,Proprietary  ,57,408,465,511,3702,4213
04117300,DAYTON SCHOOL OF MEDICAL MASSAGE        ,OH,45429-1111,Proprietary  ,20,91,111,145,535,680
04118300,NORTHCOAST MEDICAL TRAINING ACADEMY     ,OH,44240-4174,Proprietary  ,14,39,53,69,223,292
04124500,TECHSKILLS                              ,OH,43231-0000,Proprietary  ,14,139,153,71,587,658
04126000,OHIO ACADEMY PAUL MITCHELL PARTNER SCHOO,OH,44087-3107,Proprietary  ,8,30,38,127,219,346
04137800,AVEDA INSTITUTE COLUMBUS                ,OH,43201-2333,Proprietary  ,42,86,128,324,532,856
04138000,INSTITUTE OF THERAPEUTIC MASSAGE        ,OH,45875-0350,Proprietary  ,4,3,7,24,38,62
04149100,PAUL MITCHELL THE SCHOOL CINCINNATI     ,OH,45241-1702,Proprietary  ,18,32,50,183,271,454
04149101,PAUL MITCHELL THE SCHOOL CINCINNATI - TO,OH,43560-2539,Proprietary  ,13,28,41,63,116,179
04151400,VANITY SCHOOL OF COSMETOLOGY            ,OH,44035-0000,Proprietary  ,4,11,15,30,77,107
04152100,TOLEDO RESTAURANT TRAINING CENTER       ,OH,43604-6508,Private      ,5,21,26,18,101,119
04152600,PIKE COUNTY CAREER TECHNOLOGY CENTER    ,OH,45661-9114,Public       ,2,4,6,22,100,122
04153300,OHIO ACADEMY COLUMBUS (THE)             ,OH,43231-6038,Proprietary  ,19,34,53,144,269,413
04166800,SALON PROFESSIONAL ACADEMY (THE)        ,OH,45551-0000,Proprietary  ,5,8,13,43,89,132
04167700,ARTISAN COLLEGE OF COSMETOLOGY (THE)    ,OH,45840-6848,Proprietary  ,1,10,11,19,43,62
04177300,OHIO MEDICAL CAREER COLLEGE             ,OH,45417-4094,Proprietary  ,11,95,106,15,124,139
04185900,ELITE SCHOOL OF COSMETOLOGY             ,OH,44857-2714,Proprietary  ,1,12,13,16,80,96
04189100,TONI & GUY HAIRDRESSING ACADEMY         ,OH,43615-1731,Proprietary  ,15,24,39,105,145,250
04192200,ATHENA CAREER ACADEMY                   ,OH,43560-2796,Proprietary  ,3,47,50,58,421,479
04206700,ELITE WELDING ACADEMY                   ,OH,45246-1013,Proprietary  ,9,39,48,37,133,170
04220900,NATIONAL PERSONAL TRAINING INSTITUTE OF ,OH,43235-5739,Proprietary  ,0,25,25,29,162,191
04224300,VALOR CHRISTIAN COLLEGE                 ,OH,43216-0800,Private      ,35,61,96,35,61,96
04225700,LABARBERIA INSTITUTE OF HAIR            ,OH,44106-1923,Proprietary  ,5,21,26,28,125,153
        ,INVALID SCHOOL CODE                     ,  ,00000-0000,,105,990,1095,886,4665,5551
00134500,ADAMS STATE COLLEGE                     ,CO,81102-2373,Public       ,95,215,310,2932,2288,5220
00134600,ARAPAHOE COMMUNITY COLLEGE              ,CO,80160-9002,Public       ,240,738,978,3338,6763,10101
00134700,COLORADO COLLEGE                        ,CO,80903-3294,Private      ,190,131,321,3614,1034,4648
00134800,COLORADO SCHOOL OF MINES                ,CO,80401-1887,Public       ,209,94,303,7074,1427,8501
00134900,UNIVERSITY OF NORTHERN COLORADO         ,CO,80639-0001,Public       ,317,312,629,10722,5284,16006
00135000,COLORADO STATE UNIVERSITY               ,CO,80523-0100,Public       ,937,780,1717,25821,11422,37243
00135200,DENVER  SEMINARY                        ,CO,80120-2192,Private      ,3,43,46,15,712,727
00135300,FORT LEWIS COLLEGE                      ,CO,81301-3999,Public       ,191,141,332,4836,1743,6579
00135400,ILIFF SCHOOL OF THEOLOGY                ,CO,80210-0000,Private      ,0,21,21,8,339,347
00135500,LAMAR COMMUNITY COLLEGE                 ,CO,81052-3999,Public       ,23,27,50,457,323,780
00135800,COLORADO MESA UNIVERSITY                ,CO,81501-3122,Public       ,311,334,645,7761,3940,11701
00135900,COLORADO NORTHWESTERN COMMUNITY COLLEGE ,CO,81648-3598,Public       ,24,59,83,532,495,1027
00136000,METROPOLITAN STATE UNIVERSITY OF DENVER ,CO,80204-3362,Public       ,651,1519,2170,12917,17052,29969
00136100,NORTHEASTERN JUNIOR COLLEGE             ,CO,80751-2399,Public       ,47,64,111,1237,520,1757
00136200,OTERO JUNIOR COLLEGE                    ,CO,81050-3346,Public       ,28,97,125,683,709,1392
00136300,REGIS UNIVERSITY                        ,CO,80221-1099,Private      ,93,641,734,3438,8203,11641
00136500,COLORADO STATE UNIVERSITY-PUEBLO        ,CO,81001-4901,Public       ,208,261,469,5504,3278,8782
00136800,TRINIDAD STATE JR COLLEGE               ,CO,81082-2396,Public       ,42,123,165,802,1077,1879
00137000,UNIVERSITY OF COLORADO-BOULDER          ,CO,80309-0077,Public       ,1132,573,1705,28895,9974,38869
00137100,UNIVERSITY OF DENVER                    ,CO,80208-2000,Private      ,392,672,1064,10472,10108,20580
00137200,WESTERN STATE COLLEGE                   ,CO,81231-0000,Public       ,94,60,154,2302,690,2992
00405702,NATIONAL AMERICAN UNIVERSITY - COLORADO ,CO,80920-4001,Proprietary  ,5,55,60,45,446,491
00405703,NATIONAL AMERICAN UNIVERSITY            ,CO,80222-0000,Proprietary  ,3,31,34,32,270,302
00450300,EVEREST COLLEGE                         ,CO,80916-3548,Proprietary  ,25,130,155,172,1266,1438
00450600,COLORADO MOUNTAIN COLLEGE               ,CO,81602-0000,Public       ,139,258,397,2012,2185,4197
00450700,EVEREST COLLEGE                         ,CO,80229-4339,Proprietary  ,12,59,71,129,564,693
00450701,"EVEREST COLLEGE- EVEREST COLLEGE, AURORA",CO,80012-5692,Proprietary  ,23,71,94,176,616,792
00450800,UNIVERSITY OF COLORADO DENVER           ,CO,80204-2029,Public       ,511,1134,1645,11157,16824,27981
00450900,UNIV OF COLORADO AT COLO SPRINGS        ,CO,80918-3735,Public       ,436,574,1010,10129,7372,17501
00559600,EMILY GRIFFITH OPPORTUNITY SCH          ,CO,80204-2197,Public       ,57,282,339,746,2197,2943
00729700,REDSTONE COLLEGE                        ,CO,80020-9988,Proprietary  ,16,87,103,281,697,978
00732912,ITT TECHNICAL INSTITUTE                 ,CO,80229-5338,Proprietary  ,39,202,241,271,1405,1676
00754800,WESTWOOD COLLEGE - DENVER NORTH         ,CO,80221-3653,Proprietary  ,17,134,151,226,1164,1390
00754801,WESTWOOD COLLEGE - DENVER SOUTH         ,CO,80227-3653,Proprietary  ,6,80,86,123,769,892
00758200,AIMS COMMUNITY COLLEGE                  ,CO,80632-0000,Public       ,154,450,604,2245,3759,6004
00764900,ROCKY MOUNTAIN COLG OF ART & DESIGN     ,CO,80214-0000,Proprietary  ,77,209,286,903,1444,2347
00793300,FRONT RANGE COMMUNITY COLLEGE           ,CO,80031-2199,Public       ,642,1509,2151,7783,13272,21055
00793806,LINCOLN COLLEGE OF TECHNOLOGY - DENVER  ,CO,80239-3006,Proprietary  ,144,140,284,1233,1134,2367
00863500,INTELLITEC MEDICAL INSTITUTE            ,CO,80909-0000,Proprietary  ,20,92,112,106,598,704
00887100,CONCORDE CAREER INSTITUTE               ,CO,80203-0000,Proprietary  ,57,208,265,471,1685,2156
00889600,PIKES PEAK COMMUNITY COLLEGE            ,CO,80906-5498,Public       ,409,1627,2036,5197,12924,18121
00940100,COLORADO CHRISTIAN UNIVERSITY           ,CO,80226-7449,Private      ,124,742,866,2209,5030,7239
00954200,COMMUNITY COLLEGE OF DENVER             ,CO,80217-2026,Public       ,421,1224,1645,6355,11457,17812
00954300,RED ROCKS COMMUNITY COLLEGE             ,CO,80228-1255,Public       ,244,737,981,3402,6232,9634
00998100,MORGAN COMMUNITY COLLEGE                ,CO,80701-4399,Public       ,16,81,97,386,813,1199
01014800,COLORADO TECHNICAL UNIVERSITY           ,CO,80907-3896,Proprietary  ,59,614,673,435,4593,5028
01014802,COLORADO TECHNICAL UNIV - DENVER        ,CO,80111-3201,Proprietary  ,17,185,202,121,1084,1205
01014805,COLORADO TECH UNIV - ON LINE            ,CO,80907-0000,Proprietary  ,349,6001,6350,2079,40141,42220
01014812,COLORADO TECHNICAL UNIVERSITY - WESTMINS,CO,80021-3498,Proprietary  ,4,68,72,60,561,621
01014815,COLORADO TECHNCL UNIV PUEBLO            ,CO,81003-2315,Proprietary  ,0,6,6,77,249,326
01157200,COLORADO SCHOOL OF TRADES               ,CO,80215-2996,Proprietary  ,14,61,75,77,408,485
01267000,BEL-REA INST OF ANIMAL TECH             ,CO,80247-3048,Proprietary  ,34,61,95,414,650,1064
01285000,INTERNATIONAL SALON AND SPA ACADEMY     ,CO,80918-3684,Proprietary  ,10,56,66,96,339,435
01287500,PICKENS TECHNICAL COLLEGE               ,CO,80011-9307,Public       ,39,118,157,418,915,1333
01300700,NAZARENE BIBLE COLLEGE                  ,CO,80910-3704,Private      ,5,43,48,77,643,720
02078900,ART INSTITUTE OF COLORADO (THE)         ,CO,80203-2983,Proprietary  ,214,249,463,1793,2062,3855
02116300,PUEBLO COMMUNITY COLLEGE                ,CO,81004-0000,Public       ,178,706,884,2164,5824,7988
02117500,NAROPA UNIVERSITY                       ,CO,80302-0000,Private      ,23,78,101,400,1213,1613
02156200,DELTA - MONTROSE TECHNICAL COLLEGE      ,CO,81416-0000,Public       ,11,38,49,89,261,350
02165200,SALON PROFESSIONAL ACADEMY (THE)        ,CO,81504-5309,Proprietary  ,11,19,30,64,106,170
02171300,TRINIDAD STATE JUNIOR COLLEGE           ,CO,81101-0000,Proprietary  ,0,0,0,0,1,1
02211901,CHEEKS INTERNATIONAL ACADEMY OF BEAUTY C,CO,80525-3053,Proprietary  ,7,16,23,38,76,114
02211902,CHEEKS INTERNATIONAL ACDMY BTY CULT     ,CO,80631-0000,Proprietary  ,2,12,14,19,56,75
02253700,INTELLITEC COLLEGE                      ,CO,80909-0000,Proprietary  ,32,203,235,162,1077,1239
02267500,GLENWOOD BEAUTY ACADEMY                 ,CO,81601-0000,Proprietary  ,2,12,14,18,47,65
02276900,COMMUNITY COLLEGE OF AURORA             ,CO,80011-9036,Public       ,283,883,1166,3120,7004,10124
02296004,PRINCE INSTITUTE - SOUTHEAST - PRINCE IN,CO,80031-2943,Proprietary  ,0,1,1,4,40,44
02518500,HAIR DYNAMICS EDUCATION CENTER          ,CO,80525-0000,Proprietary  ,12,28,40,105,176,281
02594300,COLLEGE AMERICA - DENVER                ,CO,80222-3380,Proprietary  ,51,261,312,338,1903,2241
02611000,HERITAGE COLLEGE                        ,CO,80212-7413,Proprietary  ,31,113,144,209,659,868
03006300,INST OF BUSINESS & MEDICAL CAREERS      ,CO,80525-3044,Proprietary  ,65,205,270,424,1485,1909
03010622,VIRGINIA COLLEGE - ECOTECH INSTITUTE - A,CO,80012-4627,Proprietary  ,13,50,63,75,338,413
03012100,REMINGTON COLLEGE - COLORADO SPRINGS CAM,CO,80215-0000,Private      ,0,0,0,6,4,10
03014900,PLATT COLLEGE                           ,CO,80014-3141,Proprietary  ,3,45,48,67,338,405
03027400,XENON INTERNATIONAL ACADEMY III         ,CO,80014-1193,Proprietary  ,3,14,17,60,117,177
03030606,UTAH COLLEGE OF MASSAGE THERAPY - DENVER,CO,80031-2921,Proprietary  ,11,23,34,50,145,195
03030607,UTAH COLLEGE OF MASSAGE THERAPY - DENVER,CO,80012-2523,Proprietary  ,12,47,59,76,190,266
03066900,INTELLITEC COLLEGE                      ,CO,81506-3994,Proprietary  ,21,113,134,187,718,905
03068201,OHIO CENTER FOR BROADCASTING - COLORADO ,CO,80214-4129,Proprietary  ,9,28,37,55,145,200
03076401,BRYMAN SCHOOL OF ARIZONA (THE) - ANTHEM ,CO,80014-2622,Proprietary  ,0,0,0,8,22,30
03289300,COLORADO HEIGHTS UNIVERSITY             ,CO,80236-2711,Private      ,14,63,77,146,367,513
03306300,MONTESSORI EDUC CRT OF THE ROCKIES      ,CO,80301-2587,Private      ,0,7,7,8,66,74
03534300,JONES INTERNATIONAL UNIVERSITY          ,CO,80112-3446,Proprietary  ,7,326,333,100,3500,3600
03545300,UNIVERSITY OF THE ROCKIES               ,CO,80903-3612,Proprietary  ,15,270,285,117,2953,3070
03584400,COLORADO SCHOOL OF HEALING ARTS         ,CO,80226-4332,Proprietary  ,15,25,40,78,265,343
03670300,TONI & GUY HAIRDRESSING ACADEMY         ,CO,80911-0000,Proprietary  ,17,42,59,102,222,324
03686300,COLORADO SCHOOL OF TRADITIONAL CHINESE M,CO,80206-2127,Proprietary  ,0,31,31,17,224,241
03776300,AUGUSTE ESCOFFIER SCHOOL OF CULINARY ART,CO,80305-5961,Proprietary  ,38,80,118,288,443,731
03976300,MASSAGE THERAPY INSTITUTE OF COLORADO   ,CO,80206-2127,Proprietary  ,8,33,41,97,229,326
04080300,ASPEN UNIVERSITY                        ,CO,80246-1930,Proprietary  ,22,162,184,165,1017,1182
04093300,ACADEMY OF NATURAL THERAPY              ,CO,80631-3425,Proprietary  ,8,25,33,53,146,199
04121200,INSTITUTE OF TAOIST EDUCATION AND ACUPUN,CO,80027-1028,Private      ,1,1,2,1,54,55
04125100,MONTESSORI CASA INTERNATIONAL           ,CO,80111-5263,Private      ,0,0,0,1,11,12
04127700,AMERICAN SENTINEL UNIVERSITY            ,CO,80014-6510,Proprietary  ,1,228,229,17,1652,1669
04139300,NATIONAL BEAUTY COLLEGE                 ,CO,80221-0000,Proprietary  ,7,19,26,55,155,210
04148300,DENVER SCHOOL OF NURSING                ,CO,80202-1213,Proprietary  ,34,146,180,432,1462,1894
04151100,SUMMIT SALON & BEAUTY SCHOOL            ,CO,80866-4569,Proprietary  ,0,0,0,1,0,1
04167100,AVEDA INSTITUTE DENVER                  ,CO,80202-0000,Proprietary  ,43,63,106,348,471,819
04170200,PAUL MITCHELL THE SCHOOL COLORADO SPRING,CO,80903-0000,Proprietary  ,28,80,108,136,382,518
04172500,ROLF INSTITUTE OF STRUCTURAL INTEGRATION,CO,80301-0000,Private      ,0,26,26,5,122,127
04173800,SALON PROFESSIONAL ACADEMY (THE)        ,CO,80918-2932,Proprietary  ,6,18,24,57,138,195
04177100,PIMA MEDICAL INSTITUTE-SOUTH DENVER     ,CO,80231-0000,Proprietary  ,50,139,189,350,883,1233
04179700,UNITED BEAUTY COLLEGE                   ,CO,80223-2936,Proprietary  ,2,22,24,49,156,205
04183700,HEALING ARTS INSTITUTE                  ,CO,80525-3479,Proprietary  ,8,25,33,44,159,203
04184900,COLLEGE OF INTERNATIONAL ESTHETICS      ,CO,80002-3754,Proprietary  ,7,27,34,36,185,221
04185000,COLORADO ACADEMY OF VETERINARY TECHNOLOG,CO,80906-4944,Proprietary  ,8,46,54,132,291,423
04185400,NATIONAL PERSONAL TRAINING INSTITUTE OF ,CO,80401-3304,Proprietary  ,3,17,20,27,127,154
04195300,LONGS PEAK ACADEMY                      ,CO,80501-6458,Proprietary  ,8,19,27,46,136,182
04202600,NEW DIMENSIONS BEAUTY ACADEMY           ,CO,80138-9801,Proprietary  ,3,7,10,24,61,85
04208700,COLORADO STATE UNIVERSITY - GLOBAL CAMPU,CO,80111-0000,Public       ,64,1399,1463,570,8651,9221
04218900,ROCKY VISTA UNIVERSITY COLLEGE OF OSTEOP,CO,80134-9498,Proprietary  ,0,6,6,6,602,608
04221400,PAUL MITCHELL THE SCHOOL DENVER         ,CO,80226-7395,Proprietary  ,26,36,62,123,177,300
00267811,BRYANT & STRATTON COLLEGE - VIRGINIA BEA,VA,23462-4417,Proprietary  ,35,210,245,635,2829,3464
00370200,AVERETT UNIVERSITY                      ,VA,24541-3692,Private      ,47,186,233,1488,1512,3000
00370300,BLUEFIELD COLLEGE                       ,VA,24605-1799,Private      ,24,70,94,963,808,1771
00370400,BRIDGEWATER COLLEGE                     ,VA,22812-1599,Private      ,66,24,90,3458,248,3706
00370500,COLLEGE OF WILLIAM & MARY               ,VA,23187-8795,Public       ,344,144,488,11543,3816,15359
00370600,CHRISTOPHER NEWPORT UNIVERSITY          ,VA,23606-3072,Public       ,203,134,337,8499,1367,9866
00370700,RICHARD BLAND COLLEGE                   ,VA,23805-7100,Public       ,52,65,117,1435,678,2113
00370800,EASTERN MENNONITE UNIVERSITY            ,VA,22802-2462,Private      ,18,53,71,1482,685,2167
00370900,EMORY & HENRY COLLEGE                   ,VA,24327-0010,Private      ,30,15,45,1610,208,1818
00371100,FERRUM COLLEGE                          ,VA,24088-2612,Private      ,57,22,79,2982,361,3343
00371200,TIDEWATER COMMUNITY COLLEGE             ,VA,23510-1910,Public       ,822,3095,3917,11570,26139,37709
00371300,HAMPDEN-SYDNEY COLLEGE                  ,VA,23943-0128,Private      ,42,9,51,1745,66,1811
00371400,HAMPTON UNIVERSITY                      ,VA,23668-0099,Private      ,293,255,548,9646,3488,13134
00371500,HOLLINS UNIVERSITY                      ,VA,24020-0000,Private      ,29,38,67,1007,606,1613
00371900,LONGWOOD UNIVERSITY                     ,VA,23909-1899,Public       ,138,73,211,6080,1047,7127
00372000,LYNCHBURG COLLEGE                       ,VA,24501-3199,Private      ,82,87,169,3662,1207,4869
00372100,JAMES MADISON UNIVERSITY                ,VA,22807-3780,Public       ,612,204,816,25845,3260,29105
00372300,MARY BALDWIN COLLEGE                    ,VA,24401-3610,Private      ,38,100,138,1853,1291,3144
00372400,MARYMOUNT UNIVERSITY                    ,VA,22207-4224,Private      ,99,190,289,2888,2514,5402
00372600,AMERICAN NATIONAL UNIVERSITY            ,VA,24153-4524,Proprietary  ,44,362,406,403,3770,4173
00372700,NORTHERN VA CMTY CLG                    ,VA,22003-3743,Public       ,1189,2628,3817,18863,23457,42320
00372800,OLD DOMINION UNIVERSITY                 ,VA,23529-0052,Public       ,594,1250,1844,20127,16798,36925
00373200,RADFORD UNIVERSITY                      ,VA,24142-6905,Public       ,265,149,414,11305,2882,14187
00373300,RANDOLPH-MACON COLLEGE                  ,VA,23005-5505,Private      ,51,22,73,2709,212,2921
00373400,RANDOLPH COLLEGE                        ,VA,24503-1526,Private      ,26,28,54,1183,249,1432
00373500,VIRGINIA COMMONWEALTH UNIVERSITY        ,VA,23284-9004,Public       ,834,921,1755,26274,15426,41700
00373600,ROANOKE COLLEGE                         ,VA,24153-3794,Private      ,61,27,88,3661,349,4010
00373700,SHENANDOAH UNIVERSITY                   ,VA,22601-5195,Private      ,103,122,225,3247,2395,5642
00373800,SOUTHERN VIRGINIA UNIVERSITY            ,VA,24416-3038,Private      ,91,33,124,1111,354,1465
00374200,SWEET BRIAR COLLEGE                     ,VA,24595-9998,Private      ,29,9,38,1019,100,1119
00374300,UNION PRESBYTERIAN SEMINARY             ,VA,23227-0000,Private      ,0,7,7,2,93,95
00374400,UNIVERSITY OF RICHMOND                  ,VA,23173-0001,Private      ,215,182,397,6835,2821,9656
00374500,UNIVERSITY OF VIRGINIA - SFS            ,VA,22903-0000,Public       ,649,332,981,22900,8738,31638
00374600,UNIVERSITY OF MARY WASHINGTON           ,VA,22401-5358,Public       ,149,140,289,5852,1618,7470
00374700,UNIV OF VIRGINIA'S COLLEGE AT WISE      ,VA,24293-4412,Public       ,37,35,72,1886,616,2502
00374800,EASTERN SHORE COMMUNITY COLLEGE         ,VA,23410-3001,Public       ,26,94,120,366,617,983
00374900,GEORGE MASON UNIVERSITY                 ,VA,22030-4444,Public       ,692,1063,1755,25751,16036,41787
00375100,PATRICK HENRY COMMUNITY COLLEGE         ,VA,24112-5311,Public       ,65,205,270,1305,2100,3405
00375200,VIRGINIA INTERMONT COLLEGE              ,VA,24201-4298,Private      ,0,0,0,236,97,333
00375300,VIRGINIA MILITARY INSTITUTE             ,VA,24450-2138,Public       ,93,8,101,2348,115,2463
00375400,VIRGINIA POLYTECH INST & STATE UNIV     ,VA,24061-2000,Public       ,654,289,943,28012,5492,33504
00375800,DANVILLE COMMUNITY COLLEGE              ,VA,24541-4004,Public       ,129,318,447,1561,2543,4104
00375900,J. SARGEANT REYNOLDS COMMUNITY CLG      ,VA,23285-0000,Public       ,364,1337,1701,5842,12633,18475
00376000,VIRGINIA WESTERN CMTY COLLEGE           ,VA,24038-0000,Public       ,177,537,714,3541,4725,8266
00376100,WYTHEVILLE COMMUNITY COLLEGE            ,VA,24382-3308,Public       ,65,167,232,1339,1745,3084
00376200,VIRGINIA UNIVERSITY OF LYNCHBURG        ,VA,24501-6400,Private      ,21,48,69,291,594,885
00376400,VIRGINIA STATE UNIVERSITY               ,VA,23806-0001,Public       ,263,237,500,9192,3598,12790
00376500,NORFOLK STATE UNIVERSITY                ,VA,23504-8000,Public       ,214,538,752,7717,7299,15016
00376600,VIRGINIA UNION UNIVERSITY               ,VA,23220-1711,Private      ,91,136,227,4554,1865,6419
00376700,VIRGINIA WESLEYAN COLLEGE               ,VA,23502-5599,Private      ,74,86,160,2611,1014,3625
00376800,WASHINGTON & LEE UNIVERSITY             ,VA,24450-0303,Private      ,112,20,132,3297,1020,4317
00400400,JOHN TYLER COMMUNITY COLLEGE            ,VA,23831-5316,Public       ,282,772,1054,4347,6714,11061
00450301,EVEREST COLLEGE -  MCLEAN               ,VA,22182-2214,Proprietary  ,9,26,35,50,271,321
00498800,CENTRAL VIRGINIA COMMUNITY COLLEGE      ,VA,24502-2498,Public       ,116,337,453,1878,2516,4394
00499200,MILLER-MOTTE TECHNICAL COLLEGE          ,VA,24505-0000,Proprietary  ,26,123,149,313,1100,1413
00499600,DABNEY S LANCASTER COMMUNITY CLG        ,VA,24422-1000,Public       ,26,65,91,506,550,1056
00522300,NEW RIVER COMMUNITY COLLEGE             ,VA,24084-1127,Public       ,67,227,294,1695,2444,4139
00662200,COLLEGE OF HEALTH SCIENCES - CHRV       ,VA,24031-0000,Private      ,14,55,69,730,1190,1920
00681900,BLUE RIDGE COMMUNITY COLLEGE            ,VA,24486-0080,Public       ,132,294,426,2365,2653,5018
00687100,THOMAS NELSON COMMUNITY COLLEGE         ,VA,23670-0000,Public       ,401,1162,1563,4433,9945,14378
00709900,VIRGINIA HIGHLANDS COMMUNITY CLG        ,VA,24210-4210,Public       ,49,166,215,1192,1613,2805
00726000,SOUTHWEST VIRGINIA COMMUNITY CLG        ,VA,24641-0000,Public       ,48,245,293,1263,1806,3069
00865900,LORD FAIRFAX COMMUNITY COLLEGE          ,VA,22645-0047,Public       ,171,375,546,2456,3224,5680
00866000,GERMANNA COMMUNITY COLLEGE              ,VA,22508-0339,Public       ,236,547,783,3203,4429,7632
00866100,SOUTHSIDE VIRGINIA CMTY CLG             ,VA,23821-2930,Public       ,122,431,553,1685,2986,4671
00915900,PAUL D CAMP COMMUNITY COLLEGE           ,VA,23851-0737,Public       ,40,142,182,504,1258,1762
00916000,RAPPAHANNOCK COMMUNITY COLLEGE          ,VA,23149-2616,Public       ,72,207,279,1000,1565,2565
00926700,EVEREST COLLEGE                         ,VA,23606-4203,Proprietary  ,12,118,130,134,833,967
00926701,EVEREST COLLEGE - CHESAPEAKE            ,VA,23320-2637,Proprietary  ,26,139,165,181,1013,1194
00942000,SANFORD-BROWN COLLEGE                   ,VA,22102-4301,Proprietary  ,0,10,10,14,103,117
00953500,STAUNTON SCHOOL OF COSMETOLOGY          ,VA,24401-4323,Proprietary  ,2,4,6,20,61,81
00953700,VIRGINIA SCH OF HAIR DESIGN             ,VA,23669-0000,Proprietary  ,6,26,32,46,175,221
00962900,MOUNTAIN EMPIRE COMMUNITY COLLEGE       ,VA,24219-0700,Public       ,44,143,187,1113,1668,2781
00992800,PIEDMONT VIRGINIA COMMUNITY COLLEGE     ,VA,22902-7589,Public       ,121,403,524,1889,3113,5002
01004300,BON SECOURS MEMORIAL COLLEGE OF NURSING ,VA,23227-4612,Private      ,8,82,90,347,956,1303
01019800,ECPI UNIVERSITY                         ,VA,23462-6542,Proprietary  ,132,894,1026,1096,6105,7201
01019802,ECPI UNIVERSITY - NEWPORT NEWS          ,VA,23606-4298,Proprietary  ,43,247,290,423,1934,2357
01019807,ECPI UNIVERSITY - MANASSAS              ,VA,20109-2665,Proprietary  ,43,140,183,254,900,1154
01019813,ECPI UNIVERSITY - CULINARY INSTITUTE OF ,VA,23513-2448,Proprietary  ,17,54,71,209,438,647
01019814,ECPI UNIVERSITY - VIRGINIA BEACH HEALTH ,VA,23462-6540,Proprietary  ,16,108,124,160,901,1061
01019815,ECPI UNIVERSITY - RICHMOND SOUTH        ,VA,23236-3659,Proprietary  ,31,134,165,346,988,1334
01019816,ECPI UNIVERSITY - INNSBROOK             ,VA,23060-3359,Proprietary  ,12,56,68,138,408,546
01019817,ECPI UNIVERSITY - RICHMOND WEST         ,VA,23294-3730,Proprietary  ,17,90,107,212,744,956
01033800,EASTERN VIRGINIA MEDICAL SCHOOL         ,VA,23501-1980,Public       ,8,56,64,119,1992,2111
01159600,SYLVAIN MELLOUL INTERNATIONAL HAIR ACADE,VA,24502-2652,Proprietary  ,5,25,30,56,151,207
01162601,WESTWOOD COLLEGE - SOUTH BAY - ARLINGTON,VA,22203-4167,Proprietary  ,13,82,95,210,658,868
01162602,WESTWOOD COLLEGE - SOUTH BAY - ANNANDALE,VA,22003-2602,Proprietary  ,16,78,94,122,531,653
01274400,SOUTHSIDE REGIONAL MED CTR PROF SCHOOLS ,VA,23803-5133,Proprietary  ,4,34,38,114,340,454
02053000,LIBERTY UNIVERSITY                      ,VA,24502-0000,Private      ,1037,9299,10336,22721,89570,112291
02108800,WARDS CORNER BEAUTY ACADEMY             ,VA,23505-0000,Proprietary  ,9,55,64,85,359,444
02111600,DANVILLE REGIONAL MEDICAL CENTER SCHOOL ,VA,24541-0000,Proprietary  ,2,13,15,39,106,145
02128700,CENTRAL SCHOOL OF PRACTICAL NURSING     ,VA,23502-2230,Public       ,9,33,42,97,368,465
02140000,RIVERSIDE SCHOOL OF HEALTH CAREERS      ,VA,23608-3802,Private      ,14,68,82,197,717,914
02149901,PAUL MITCHELL THE SCHOOL-JACKSONVILLE - ,VA,22102-0000,Proprietary  ,18,29,47,94,195,289
02149902,PAUL MITCHELL THE SCHOOL-JACKSONVILLE - ,VA,22192-0000,Proprietary  ,11,38,49,99,223,322
02175800,LYNCHBURG GENERAL HOSP SCH OF NURSG     ,VA,24501-0000,Private      ,6,24,30,114,295,409
02197600,WOODROW WILSON REHABILITATION CTR       ,VA,22939-0000,Public       ,24,13,37,50,36,86
02242400,HENRICO CTY ST MARYS HOSP PRAC NRSG     ,VA,23075-0000,Public       ,1,2,3,15,79,94
02320900,TIDEWATER TECH                          ,VA,23502-1747,Proprietary  ,35,213,248,264,1145,1409
02334400,CENTURA COLLEGE                         ,VA,23452-0000,Proprietary  ,48,274,322,321,1855,2176
02342700,FORTIS COLLEGE                          ,VA,23502-4101,Proprietary  ,24,131,155,233,1077,1310
02342701,FORTIS COLLEGE - RICHMOND CAMPUS        ,VA,23230-0000,Proprietary  ,31,116,147,274,955,1229
02358500,BON SECOURS SAINT MARY'S HOSPITAL SCHOOL,VA,23227-4612,Private      ,6,42,48,137,397,534
02538800,SUFFOLK BEAUTY ACADEMY                  ,VA,23434-0000,Proprietary  ,3,14,17,33,93,126
02541200,STRATFORD UNIVERSITY                    ,VA,22043-0000,Proprietary  ,76,397,473,630,3229,3859
02541201,STRATFORD UNIVERSITY-WOODBRIDGE         ,VA,22192-0000,Proprietary  ,17,98,115,187,837,1024
02541204,STRATFORD UNIVERSITY - GLEN ALLEN CAMPUS,VA,23060-5937,Proprietary  ,2,11,13,4,22,26
02588900,MEDTECH INSTITUTE                       ,VA,22042-3013,Proprietary  ,82,310,392,421,1531,1952
02610100,WASHINGTON COUNTY ADULT SKILL CTR       ,VA,24210-2346,Public       ,10,33,43,71,166,237
02617508,EVEREST COLLEGE - WOODBRIDGE            ,VA,22192-6808,Proprietary  ,42,158,200,230,858,1088
03002400,GRAHAM WEBB INTERNATIONAL ACAD HAIR     ,VA,22209-2129,Proprietary  ,13,33,46,53,173,226
03010700,BAR PALMA BEAUTY CAREERS  ACADEMY       ,VA,24014-2255,Proprietary  ,5,12,17,35,125,160
03042800,"VIRGINIA BEACH CITY SCHOOLS, SCH.-PR.NSG",VA,23456-0038,Public       ,2,27,29,60,225,285
03091300,REGENT UNIVERSITY                       ,VA,23464-9800,Private      ,97,854,951,1855,7440,9295
03092700,SKYLINE COLLEGE                         ,VA,24012-1603,Proprietary  ,11,51,62,92,439,531
03096500,SPRINGFIELD BEAUTY ACADEMY              ,VA,22003-3016,Proprietary  ,4,18,22,14,97,111
03106500,SENTARA COLLEGE OF HEALTH SCIENCES      ,VA,23320-2843,Private      ,11,95,106,205,965,1170
03116900,BAPTIST THEOLOGICAL SEM.-RICHMOND       ,VA,23227-0000,Private      ,1,16,17,15,167,182
03126300,AVIATION INSTITUTE OF MAINTENANCE       ,VA,23320-5987,Proprietary  ,15,53,68,91,408,499
03126400,CENTURA COLLEGE                         ,VA,23235-5230,Proprietary  ,9,134,143,157,891,1048
03127500,ADVANCED TECHNOLOGY INSTITUTE           ,VA,23462-2409,Proprietary  ,48,137,185,559,854,1413
03280400,VIRGINIA SCHOOL OF MASSAGE              ,VA,22903-0000,Proprietary  ,9,36,45,54,157,211
03409500,CHESTER CAREER COLLEGE                  ,VA,23836-2516,Proprietary  ,9,46,55,129,516,645
03455300,CRESCENT COSMETOLOGY UNIVERSITY         ,VA,23666-3115,Proprietary  ,1,8,9,8,48,56
03559300,APPALACHIAN SCHOOL OF LAW               ,VA,24614-0000,Private      ,3,11,14,15,336,351
03645400,RUDY & KELLY ACADEMY OF HAIR AND NA     ,VA,23464-6857,Proprietary  ,28,52,80,154,343,497
03654300,CAREER TRAINING SOLUTIONS               ,VA,22406-1014,Proprietary  ,22,98,120,136,776,912
03709300,EDWARD VIA VIRGINIA CLG OSTEOPATHIC MED ,VA,24060-6360,Private      ,1,5,6,14,890,904
03862600,VIRGINIA BAPTIST COLLEGE                ,VA,22407-0000,Private      ,5,17,22,42,109,151
03872400,INSTITUTE FOR THE PSYCHOLOGICAL SCIENCES,VA,22202-3609,Private      ,3,25,28,23,168,191
03876300,CULPEPER COSMETOLOGY TRAINING CENTER    ,VA,22701-3155,Public       ,0,9,9,23,63,86
03883400,AVIATION INSTITUTE OF MAINTENANCE       ,VA,20110-4156,Proprietary  ,13,37,50,76,232,308
03966300,CENTRAL BAPTIST THEOLOGICAL SEMINARY OF ,VA,23464-6847,Private      ,0,4,4,0,4,4
04038400,AVI CAREER INSTITUTE                    ,VA,22066-1839,Proprietary  ,1,20,21,15,96,111
04110300,UNIVERSITY OF MANAGEMENT AND TECHNOLOGY ,VA,22209-1609,Proprietary  ,3,98,101,28,527,555
04124000,DOMINION SCHOOL OF HAIR DESIGN          ,VA,23062-2221,Proprietary  ,6,8,14,19,30,49
04127300,COLUMBIA COLLEGE                        ,VA,22031-4413,Proprietary  ,16,220,236,84,802,886
04133400,CENTURA COLLEGE                         ,VA,22312-2670,Proprietary  ,0,0,0,20,76,96
04137300,CAYCE/REILLY SCHOOL OF MASSOTHERAPY     ,VA,23451-2061,Private      ,2,18,20,18,113,131
04140000,GLOBAL HEALTH NURSE TRAINING SERVICES   ,VA,22314-4585,Proprietary  ,5,74,79,62,709,771
04153800,BETHEL COLLEGE                          ,VA,23666-3122,Private      ,4,17,21,42,150,192
04156200,INSTITUTE OF ADVANCED MEDICAL ESTHETICS ,VA,23294-4701,Proprietary  ,4,24,28,27,139,166
04169400,NORTHERN VIRGINIA SCHOOL OF THERAPEUTIC ,VA,22046-4302,Proprietary  ,11,23,34,39,137,176
04171500,COSMOPOLITAN BEAUTY & TECH SCHOOL       ,VA,22003-3204,Proprietary  ,3,33,36,20,205,225
04179900,TOMORROW'S IMAGE BARBER ACADEMY OF VIRGI,VA,23602-5532,Proprietary  ,1,31,32,14,99,113
04180600,APPALACHIAN COLLEGE OF PHARMACY         ,VA,24631-9210,Private      ,0,19,19,25,311,336
04214700,LUCKES BEAUTY ACADEMY                   ,VA,23601-1303,Proprietary  ,4,18,22,14,63,77
04218600,VIRGINIA TECH CARILION SCHOOL OF MEDICIN,VA,24016-4950,Private      ,15,21,36,212,439,651
04219000,IGLOBAL UNIVERSITY                      ,VA,22003-2400,Proprietary  ,2,5,7,4,35,39
04220100,NATIONAL PERSONAL TRAINING INSTITUTE    ,VA,22182-2412,Proprietary  ,3,12,15,14,67,81
04220400,CHRYSM INSTITUTE OF ESTHETICS (THE)     ,VA,23462-3650,Proprietary  ,5,32,37,27,191,218
04221000,"STANDARD HEALTHCARE SERVICES, COLLEGE OF",VA,22046-4612,Proprietary  ,3,39,42,21,345,366
04235400,SAINT MICHAEL COLLEGE OF ALLIED HEALTH  ,VA,22309-2348,Proprietary  ,0,10,10,0,10,10
00107000,THUNDERBIRD SCHOOL OF GLOBAL MANAGEMENT ,AZ,85306-6000,Private      ,3,21,24,29,531,560
00107100,ARIZONA WESTERN COLLEGE                 ,AZ,85366-0000,Public       ,283,574,857,4884,4882,9766
00107200,COCHISE COLLEGE                         ,AZ,85607-6190,Public       ,121,399,520,1702,2927,4629
00107300,EASTERN ARIZONA COLLEGE                 ,AZ,85552-0769,Public       ,101,241,342,1589,1578,3167
00107400,GRAND CANYON UNIVERSITY                 ,AZ,85017-3030,Proprietary  ,964,11806,12770,18608,69379,87987
00107600,GLENDALE COMMUNITY COLLEGE              ,AZ,85302-3090,Public       ,779,1590,2369,11786,14990,26776
00107700,MESA COMMUNITY COLLEGE                  ,AZ,85202-4866,Public       ,792,1842,2634,11504,17862,29366
00107800,PHOENIX COLLEGE                         ,AZ,85013-4234,Public       ,483,1519,2002,7059,13904,20963
00107900,YAVAPAI COLLEGE                         ,AZ,86301-3297,Public       ,199,566,765,2171,4443,6614
00108100,ARIZONA STATE UNIV (ALL CAMPUSES)       ,AZ,85287-0412,Public       ,2489,4226,6715,62002,52550,114552
00108200,NORTHERN ARIZONA UNIVERSITY             ,AZ,86011-0001,Public       ,1062,1049,2111,32576,15817,48393
00108300,UNIVERSITY OF ARIZONA                   ,AZ,85721-0066,Public       ,1243,1222,2465,36639,17935,54574
00165701,MIDWESTERN UNIVERSITY                   ,AZ,85308-0000,Private      ,14,86,100,249,4338,4587
00446700,TUCSON COLLEGE                          ,AZ,85711-3781,Proprietary  ,22,86,108,314,655,969
00711300,ARIZONA CHRISTIAN UNIVERSITY            ,AZ,85032-7097,Private      ,81,114,195,1403,840,2243
00726600,PIMA COUNTY COMMUNITY COLLEGE           ,AZ,85709-1110,Public       ,629,1703,2332,10618,16147,26765
00728300,CENTRAL ARIZONA COLLEGE                 ,AZ,85228-9779,Public       ,214,562,776,3114,4808,7922
00732911,ITT TECHNICAL INSTITUTE                 ,AZ,85282-9272,Proprietary  ,65,372,437,617,2826,3443
00732990,ITT TECHNICAL INSTITUTE                 ,AZ,85704-5829,Proprietary  ,116,426,542,737,2500,3237
00822100,UNIVERSAL TECHNICAL INSTITUTE           ,AZ,85323-7946,Proprietary  ,884,1292,2176,9722,8097,17819
00824600,DINÉ COLLEGE                            ,AZ,86556-0126,Public       ,51,154,205,777,1309,2086
00830300,GATEWAY COMMUNITY COLLEGE               ,AZ,85034-1795,Public       ,243,1028,1271,3801,8944,12745
00830302,MARICOPA SKILL CENTER                   ,AZ,85034-0000,Public       ,45,212,257,442,1524,1966
00830400,SCOTTSDALE COMMUNITY COLLEGE            ,AZ,85250-0000,Public       ,299,613,912,4468,5287,9755
00886400,ARIZONA ACADEMY OF BEAUTY               ,AZ,85712-5021,Proprietary  ,15,31,46,95,193,288
01085800,AVALON SCHOOL OF COSMETOLOGY            ,AZ,85210-4010,Proprietary  ,87,145,232,548,973,1521
01168900,REFRIGERATION SCHOOL                    ,AZ,85034-0000,Proprietary  ,37,186,223,203,973,1176
01180200,ARIZONA ACADEMY OF BEAUTY-NORTH         ,AZ,85705-2720,Proprietary  ,7,13,20,47,117,164
01186200,NORTHLAND PIONEER COLLEGE               ,AZ,86025-0610,Public       ,84,267,351,650,1854,2504
01186400,MOHAVE COMMUNITY COLLEGE                ,AZ,86409-1238,Public       ,110,400,510,1434,3923,5357
01218400,INTERNATIONAL ACAD OF HAIR DESIGN       ,AZ,85225-7198,Proprietary  ,15,22,37,82,213,295
02065300,PRESCOTT COLLEGE                        ,AZ,86301-0000,Private      ,37,96,133,608,1050,1658
02071200,KAPLAN COLLEGE                          ,AZ,85029-4349,Proprietary  ,0,0,0,139,935,1074
02098800,UNIVERSITY OF PHOENIX                   ,AZ,85040-0000,Proprietary  ,2392,46541,48933,15452,279304,294756
02100500,UNIVERSAL TECHNICAL INSTITUTE           ,AZ,85027-0000,Proprietary  ,813,1369,2182,6878,9146,16024
02100600,CARRINGTON COLLEGE                      ,AZ,85015-4096,Proprietary  ,209,690,899,1836,5090,6926
02113800,ROBERTO-VENN SCH OF LUTHIERY            ,AZ,85040-0000,Proprietary  ,4,15,19,47,65,112
02146600,SOUTH MOUNTAIN COMMUNITY COLLEGE        ,AZ,85040-0000,Public       ,165,483,648,2827,4822,7649
02160305,COLLINS COLLEGE                         ,AZ,85040-4000,Proprietary  ,6,50,56,133,390,523
02160306,INTERNATIONAL ACADEMY OF DESIGN AND TECH,AZ,85281-6705,Proprietary  ,5,15,20,43,87,130
02171500,WESTERN INTERNATIONAL UNIVERSITY        ,AZ,85021-0000,Proprietary  ,17,284,301,103,1389,1492
02177500,RIO SALADO COMMUNITY COLLEGE            ,AZ,85281-6948,Public       ,248,1907,2155,3027,16379,19406
02199900,AMERICAN INDIAN CLG-ASSEMBLIES GOD      ,AZ,85021-0000,Private      ,8,26,34,71,154,225
02217100,PIMA MEDICAL INSTITUTE                  ,AZ,85716-0000,Proprietary  ,517,1358,1875,3561,9122,12683
02218800,BROOKLINE COLLEGE                       ,AZ,85021-5815,Proprietary  ,60,363,423,444,2405,2849
02218804,BROOKLINE COLLEGE - MESA                ,AZ,85204-4448,Proprietary  ,14,142,156,180,844,1024
02218805,BROOKLINE COLLEGE - TUCSON              ,AZ,85711-5444,Proprietary  ,25,135,160,250,950,1200
02263100,ANTHEM COLLEGE                          ,AZ,85014-4973,Proprietary  ,12,45,57,505,2039,2544
02280500,CHARLES OF ITALY BEAUTY COLLEGE         ,AZ,86403-0000,Proprietary  ,8,20,28,38,110,148
02295000,EVEREST COLLEGE                         ,AZ,85021-1610,Proprietary  ,58,474,532,836,6551,7387
02295002,EVEREST COLLEGE - MESA                  ,AZ,85206-4704,Proprietary  ,22,143,165,218,1214,1432
02306807,ARIZONA AUTOMOTIVE INSTITUTE            ,AZ,85301-3503,Proprietary  ,61,248,309,498,1493,1991
02317800,AMERICAN INSTITUTE OF TECHNOLOGY        ,AZ,85043-0000,Proprietary  ,44,343,387,225,1355,1580
02491500,SOUTHWEST UNIVERSITY OF VISUAL ARTS     ,AZ,85716-0000,Proprietary  ,28,62,90,200,352,552
02533200,FRANK LLOYD WRIGHT SCHOOL OF ARCHITECTUR,AZ,85261-4430,Private      ,2,4,6,24,63,87
02559000,UNIVERSITY OF ADVANCING TECHNOLOGY      ,AZ,85283-0000,Proprietary  ,59,96,155,965,834,1799
02561900,BRILLARE HAIRDRESSING ACADEMY           ,AZ,85254-3301,Proprietary  ,0,0,0,33,64,97
02582700,CORTIVA INSTITUTE - TUCSON              ,AZ,85710-3503,Proprietary  ,15,65,80,102,297,399
02616700,LE CORDON BLEU COLLEGE OF CULINARY ARTS ,AZ,85251-2729,Proprietary  ,101,446,547,946,3560,4506
02623600,PARADISE VALLEY COMMUNITY COLLEGE       ,AZ,85032-1210,Public       ,264,628,892,3890,5435,9325
02623800,CORTIVA INSTITUTE - SCOTTSDALE          ,AZ,85257-4218,Proprietary  ,1,27,28,20,135,155
03005000,SAFFORD COLLEGE OF BEAUTY CULTURE       ,AZ,85546-3309,Proprietary  ,2,15,17,9,38,47
03010613,VIRGINIA COLLEGE - GOLF ACADEMY OF AMERI,AZ,85225-3412,Proprietary  ,2,12,14,26,84,110
03030604,UTAH COLLEGE OF MASSAGE THERAPY - ARIZON,AZ,85282-0000,Proprietary  ,14,47,61,111,278,389
03030605,UTAH COLLEGE OF MASSAGE THERAPY - ARIZON,AZ,85051-3470,Proprietary  ,34,82,116,150,410,560
03034400,CONSERVATORY RECORDING ARTS & SCIS      ,AZ,85282-1707,Proprietary  ,86,91,177,697,731,1428
03072200,CHANDLER-GILBERT COMMUNITY COLLEGE      ,AZ,85225-2499,Public       ,427,744,1171,6053,6989,13042
03076400,BRYMAN SCHOOL OF ARIZONA (THE)          ,AZ,85029-4919,Proprietary  ,4,39,43,172,655,827
03097800,CARSTEN INSTITUTE OF HAIR & BEAUTY      ,AZ,85282-5404,Proprietary  ,19,51,70,110,273,383
03100400,COCONINO COUNTY COMMUNITY COLLEGE       ,AZ,86001-0000,Public       ,143,263,406,2025,2351,4376
03107000,SOUTHWEST CLG OF NATUROPATHIC MED       ,AZ,85282-0000,Private      ,2,36,38,23,657,680
03115000,ARIZONA COLLEGE OF ALLIED HEALTH        ,AZ,85302-3843,Proprietary  ,74,279,353,441,1479,1920
03120300,COLLEGE AMERICA                         ,AZ,86004-3936,Proprietary  ,60,236,296,426,1546,1972
03156300,ESTRELLA MOUNTAIN COMMUNITY COLLEGE     ,AZ,85392-1010,Public       ,355,747,1102,5375,7648,13023
03347300,INTERNATIONAL BAPTIST COLLEGE           ,AZ,85282-6799,Private      ,4,4,8,59,37,96
03445300,HDS TRUCK DRIVING INSTITUTE             ,AZ,85731-0000,Proprietary  ,2,58,60,28,242,270
03478400,PHOENIX SEMINARY                        ,AZ,85018-7611,Private      ,0,32,32,7,199,206
03572300,EAST VALLEY INSTITUTE OF TECHNOLOGY     ,AZ,85201-6910,Public       ,35,123,158,404,838,1242
03593300,SOUTHWEST INSTITUTE OF HEALING ARTS     ,AZ,85281-3658,Proprietary  ,35,315,350,201,1889,2090
03617500,PHOENIX INSTITUTE OF HERBAL MEDICINE & A,AZ,85012-0000,Proprietary  ,3,65,68,61,474,535
03695500,ARIZONA SCHOOL OF ACUPUNCTURE AND ORIENT,AZ,85712-1100,Proprietary  ,3,6,9,18,118,136
03784400,TOHONO O'ODHAM COMMUNITY COLLEGE        ,AZ,85634-3129,Public       ,3,11,14,84,134,218
03813300,NORTHCENTRAL UNIVERSITY                 ,AZ,86314-2336,Proprietary  ,4,1359,1363,86,8157,8243
03814300,TURNING POINT BEAUTY COLLEGE            ,AZ,85222-4229,Proprietary  ,4,13,17,23,92,115
04051300,ART INSTITUTE OF PHOENIX (THE)          ,AZ,85021-2859,Proprietary  ,893,2562,3455,7046,21352,28398
04051306,ART INSTITUTE OF PHOENIX (THE) - ART INS,AZ,85712-2732,Proprietary  ,66,79,145,518,593,1111
04051325,ART INSTITUTE OF PHOENIX (THE) - BROWN M,AZ,85712-5300,Proprietary  ,27,111,138,233,904,1137
04051327,ART INSTITUTE OF PHOENIX (THE) - BROWN M,AZ,85029-1348,Proprietary  ,11,48,59,189,431,620
04059300,TUCSON COLLEGE OF BEAUTY                ,AZ,85705-2451,Proprietary  ,8,26,34,76,198,274
04120900,ARIZONA CULINARY INSTITUTE              ,AZ,85259-4939,Proprietary  ,21,59,80,225,369,594
04131400,ARIZONA SUMMIT LAW SCHOOL               ,AZ,85004-4418,Proprietary  ,5,84,89,83,1206,1289
04139200,UNIVERSAL BARBER COLLEGE                ,AZ,85007-3914,Proprietary  ,0,0,0,1,1,2
04148700,AMERICAN INSTITUTE OF INTERIOR DESIGN   ,AZ,85268-3827,Proprietary  ,3,8,11,22,80,102
04152900,STUDIO ACADEMY OF BEAUTY (THE)          ,AZ,85224-3600,Proprietary  ,23,57,80,149,356,505
04157400,NATIONAL PARALEGAL COLLEGE              ,AZ,85014-1262,Proprietary  ,9,189,198,74,1599,1673
04174100,PAUL MITCHELL THE SCHOOL PHOENIX        ,AZ,85017-1919,Proprietary  ,29,72,101,204,472,676
04174200,ALL BEAUTY COLLEGE                      ,AZ,86426-8326,Proprietary  ,11,29,40,58,175,233
04175300,PENROSE ACADEMY                         ,AZ,85254-4065,Proprietary  ,10,21,31,112,175,287
04177500,PURE AESTHETICS                         ,AZ,85711-2328,Proprietary  ,1,19,20,38,141,179
04191200,CLASSIC COOKING ACADEMY                 ,AZ,85255-8699,Private      ,0,0,0,4,7,11
04194500,AVEDA INSTITUTE TUCSON                  ,AZ,85719-4876,Proprietary  ,23,39,62,227,387,614
04194501,AVEDA INSTITUTE TUCSON - PHOENIX        ,AZ,85284-1064,Proprietary  ,11,17,28,11,17,28
04217600,SESSIONS COLLEGE FOR PROFESSIONAL DESIGN,AZ,85281-2840,Proprietary  ,6,37,43,30,171,201
04233100,ARIZONA SCHOOL OF INTEGRATIVE STUDIES   ,AZ,86324-3106,Proprietary  ,1,14,15,15,59,74
04233101,ARIZONA SCHOOL OF INTEGRATIVE STUDIES - ,AZ,86001-5510,Proprietary  ,3,14,17,12,62,74
04233102,ARIZONA SCHOOL OF INTEGRATIVE STUDIES - ,AZ,86303-4711,Proprietary  ,1,18,19,16,86,102
04233103,ARIZONA SCHOOL OF INTEGRATIVE STUDIES - ,AZ,85705-8330,Proprietary  ,5,15,20,26,89,115
00142800,DELAWARE STATE UNIVERSITY               ,DE,19901-2277,Public       ,258,180,438,8317,2688,11005
00142900,GOLDEY BEACOM COLLEGE                   ,DE,19808-1993,Private      ,29,63,92,679,584,1263
00143100,UNIVERSITY OF DELAWARE                  ,DE,19716-0099,Public       ,631,234,865,27557,3484,31041
00143300,WESLEY COLLEGE                          ,DE,19901-3875,Private      ,76,72,148,2588,851,3439
00143301,WESLEY COLLEGE-CTR FOR ADULT STUDIE     ,DE,19720-0000,Private      ,0,0,0,1,0,1
00331301,WIDENER UNIV SCHOOL OF LAW - DE         ,DE,19803-0000,Private      ,3,40,43,80,1162,1242
00705300,DELAWARE TECHNICAL COMMUNITY COLLEGE - O,DE,19947-0000,Public       ,158,433,591,2643,3595,6238
00794800,WILMINGTON UNIVERSITY                   ,DE,19720-6491,Private      ,190,1075,1265,3507,11136,14643
01172700,DELAWARE TECHNICAL COMMUNITY COLLEGE    ,DE,19901-8736,Public       ,131,333,464,2326,3082,5408
02125200,BEEBE SCHOOL OF NURSING                 ,DE,19958-1462,Private      ,5,13,18,63,126,189
02144900,DELAWARE TECHNICAL  COMMUNITY COLLEGE   ,DE,19801-2412,Public       ,236,583,819,4301,5425,9726
02190400,SCHILLING DOUGLAS SCH OF HAIR DSGN      ,DE,19711-0000,Proprietary  ,4,8,12,92,98,190
02586902,STAR TECHNICAL INSTITUTE -              ,DE,19901-4615,Proprietary  ,4,14,18,27,102,129
03025800,DAWN TRAINING CENTRE                    ,DE,19805-1511,Proprietary  ,22,117,139,121,662,783
03543300,HARRIS SCHOOL OF BUSINESS               ,DE,19803-5341,Proprietary  ,26,128,154,149,507,656
03702300,DELAWARE LEARNING INSTITUTE OF COSMETOLO,DE,19939-9759,Proprietary  ,8,12,20,60,84,144
04130700,ACADEMY OF MASSAGE AND BODYWORK         ,DE,19701-1321,Proprietary  ,3,18,21,22,88,110
04139800,DELAWARE COLLEGE OF ART & DESIGN        ,DE,19801-3007,Private      ,22,16,38,416,188,604
04171100,PAUL MITCHELL THE SCHOOL-DELAWARE       ,DE,19702-5108,Proprietary  ,14,24,38,107,139,246
        ,FEDERAL STUDENT AID USE ONLY            ,DC,20202-0000,,0,0,0,0,2,2
00143400,AMERICAN UNIVERSITY                     ,DC,20016-8020,Private      ,402,480,882,13688,9821,23509
00143700,CATHOLIC UNIVERSITY OF AMERICA          ,DC,20064-0002,Private      ,156,191,347,5688,2723,8411
00143711,"CATHOLIC UNIV AMERICA, LAW SCHOOL       ",DC,20064-0000,Private      ,2,20,22,85,1100,1185
00144100,UNIV OF THE DISTRICT OF COLUMBIA        ,DC,20008-0000,Public       ,164,698,862,2979,7403,10382
00144102,UNIV OF THE DIST OF COLU -SCHOOL OF LAW ,DC,20008-1173,Public       ,3,37,40,58,825,883
00144300,GALLAUDET UNIVERSITY                    ,DC,20002-3695,Private      ,48,61,109,991,1245,2236
00144400,GEORGE WASHINGTON UNIVERSITY            ,DC,20052-2353,Private      ,431,854,1285,14685,12225,26910
00144402,GEORGE WASHINGTON UNIV LAW SCHL         ,DC,20052-0000,Private      ,6,74,80,89,3853,3942
00144403,GEORGE WASHINGTON UNIV SCH MED          ,DC,20052-0000,Private      ,9,79,88,122,1773,1895
00144437,GEORGE WASHINGTON UNIVERSITY            ,DC,20006-4804,Private      ,42,99,141,365,432,797
00144500,GEORGETOWN UNIVERSITY                   ,DC,20057-1252,Private      ,426,390,816,12974,5151,18125
00144501,"GEORGETOWN UNIV, SCH OF MEDICINE        ",DC,20007-0000,Private      ,5,24,29,111,1405,1516
00144502,GEORGETOWN UNIVERSITY - GRADUATE SCHOOL ,DC,20057-0004,Private      ,3,311,314,75,4743,4818
00144503,GEORGETOWN UNIV LAW CENTER              ,DC,20001-0000,Private      ,2,89,91,63,5079,5142
00144800,HOWARD UNIVERSITY                       ,DC,20059-0001,Private      ,491,435,926,15421,9354,24775
00145900,STRAYER UNIVERSITY                      ,DC,20005-2603,Proprietary  ,240,5069,5309,1919,46335,48254
00146000,TRINITY UNIVERSITY                      ,DC,20017-1004,Private      ,36,193,229,1463,2860,4323
00146400,WESLEY THEOLOGICAL SEMINARY             ,DC,20016-0000,Private      ,1,26,27,4,362,366
00207701,JOHNS HOPKINS UNIV SCH ADV INTL STU     ,DC,20036-0000,Private      ,8,74,82,97,1628,1725
01006500,WASHINGTON THEOLOGICAL UNION            ,DC,20012-0000,Private      ,0,0,0,2,13,15
01280300,DOMINICAN HOUSE OF STUDIES              ,DC,20017-1584,Private      ,0,3,3,3,32,35
02132800,NAT'L CONSERVATORY DRAMATIC ARTS        ,DC,20007-2758,Private      ,1,10,11,26,62,88
03104300,CAREER BLAZERS LEARNING CENTER OF WASHIN,DC,20037-1881,Proprietary  ,16,229,245,80,899,979
03218300,POTOMAC COLLEGE                         ,DC,20016-1860,Proprietary  ,4,45,49,62,394,456
03409600,BENNETT CAREER INSTITUTE                ,DC,20017-1754,Proprietary  ,15,61,76,121,422,543
03750300,TECHNICAL LEARNING CENTERS              ,DC,20006-3749,Proprietary  ,43,207,250,137,653,790
04114400,INSTITUTE OF WORLD POLITICS (THE)       ,DC,20036-1464,Private      ,1,12,13,9,199,208
04142700,PONTIFICAL JOHN PAUL II INSTITUTE FOR ST,DC,20064-0001,Private      ,0,4,4,3,27,30
04190000,RADIANS COLLEGE                         ,DC,20005-3542,Proprietary  ,7,105,112,79,1067,1146
04202500,GRADUATE SCHOOL                         ,DC,20024-2520,Private      ,0,20,20,4,106,110
00154100,ABRAHAM BALDWIN AGRICULTURAL CLG        ,GA,31794-0000,Public       ,116,168,284,3553,1902,5455
00154200,AGNES SCOTT COLLEGE                     ,GA,30030-3770,Private      ,56,60,116,1538,596,2134
00154300,DARTON COLLEGE                          ,GA,31707-3098,Public       ,244,639,883,4361,7115,11476
00154400,ALBANY STATE UNIVERSITY                 ,GA,31705-2796,Public       ,254,394,648,6724,5634,12358
00154500,ANDREW COLLEGE                          ,GA,39840-1395,Private      ,16,11,27,485,115,600
00154600,ARMSTRONG ATLANTIC STATE UNIVERSITY     ,GA,31419-1997,Public       ,296,591,887,6867,6818,13685
00154700,POINT UNIVERSITY                        ,GA,30344-1999,Private      ,34,74,108,1190,1189,2379
00155200,AUGUSTA STATE UNIVERSITY                ,GA,30904-2200,Public       ,0,0,0,644,618,1262
00155400,BERRY COLLEGE                           ,GA,30149-5007,Private      ,146,36,182,4011,428,4439
00155500,THOMAS UNIVERSITY                       ,GA,31792-7499,Private      ,20,151,171,555,1502,2057
00155600,BRENAU UNIVERSITY                       ,GA,30501-3668,Private      ,113,348,461,2018,3889,5907
00155700,BREWTON PARKER COLLEGE                  ,GA,30445-0000,Private      ,13,18,31,629,215,844
00155800,COLLEGE OF COASTAL GEORGIA              ,GA,31520-3644,Public       ,154,284,438,2474,2754,5228
00155900,CLARK ATLANTA UNIVERSITY                ,GA,30314-4385,Private      ,518,523,1041,11061,6345,17406
00156000,COLUMBIA THEOLOGICAL SEMINARY           ,GA,30031-0000,Private      ,1,20,21,8,252,260
00156100,COLUMBUS STATE UNIVERSITY               ,GA,31907-5645,Public       ,292,675,967,7152,7566,14718
00156200,GEORGIA PERIMETER COLLEGE               ,GA,30021-0000,Public       ,1249,2581,3830,16948,23950,40898
00156300,EMMANUEL COLLEGE                        ,GA,30639-0000,Private      ,18,17,35,988,194,1182
00156400,EMORY UNIVERSITY                        ,GA,30322-1960,Private      ,560,539,1099,13657,10861,24518
00156600,FORT VALLEY STATE UNIVERSITY            ,GA,31030-3298,Public       ,147,194,341,4087,2849,6936
00156800,INTERDENOMINATIONAL THEOLOGY CENTER     ,GA,30314-0000,Private      ,2,32,34,8,566,574
00156900,GEORGIA INSTITUTE OF TECHNOLOGY         ,GA,30332-0325,Public       ,807,629,1436,23336,7271,30607
00157000,SOUTHERN POLYTECHNIC STATE UNIV         ,GA,30060-2896,Public       ,251,430,681,5906,5135,11041
00157100,GEORGIA MILITARY COLLEGE                ,GA,31061-3398,Public       ,447,850,1297,6038,7613,13651
00157200,GEORGIA SOUTHERN UNIVERSITY             ,GA,30460-8065,Public       ,819,655,1474,24260,8785,33045
00157300,GEORGIA SOUTHWESTERN STATE UNIV         ,GA,31709-4693,Public       ,103,178,281,2959,2414,5373
00157400,GEORGIA STATE UNIVERSITY                ,GA,30303-3010,Public       ,1396,2294,3690,35016,30407,65423
00157500,GORDON COLLEGE                          ,GA,30204-1762,Public       ,200,277,477,4534,3002,7536
00157700,KENNESAW STATE UNIVERSITY               ,GA,30144-5591,Public       ,1159,1322,2481,27072,17257,44329
00157800,LAGRANGE COLLEGE                        ,GA,30240-2999,Private      ,53,40,93,1477,600,2077
00157900,GEORGIA REGENTS UNIVERSITY              ,GA,30912-0004,Public       ,213,390,603,4765,6708,11473
00158000,MERCER UNIVERSITY                       ,GA,31207-0003,Private      ,254,599,853,6382,9750,16132
00158100,MIDDLE GEORGIA STATE COLLEGE            ,GA,31014-1599,Public       ,258,562,820,6293,6287,12580
00158103,MIDDLE GEORGIA STATE COLLEGE - MACON CAM,GA,31206-5145,Public       ,0,0,0,448,487,935
00158200,MOREHOUSE COLLEGE                       ,GA,30314-3773,Private      ,173,145,318,4384,1560,5944
00158500,UNIVERSITY OF NORTH GEORGIA             ,GA,30597-0001,Public       ,677,536,1213,14163,6156,20319
00158600,OGLETHORPE UNIVERSITY                   ,GA,30319-2737,Private      ,111,94,205,2340,793,3133
00158700,PAINE COLLEGE                           ,GA,30901-3182,Private      ,51,76,127,1578,978,2556
00158800,PIEDMONT COLLEGE                        ,GA,30535-5644,Private      ,76,204,280,1373,1853,3226
00158900,REINHARDT UNIVERSITY                    ,GA,30183-2981,Private      ,68,65,133,1699,769,2468
00159000,SAVANNAH STATE UNIVERSITY               ,GA,31404-5298,Public       ,359,377,736,9246,4268,13514
00159100,SHORTER UNIVERSITY                      ,GA,30165-4298,Private      ,69,200,269,2001,2442,4443
00159200,SOUTH GEORGIA STATE COLLEGE             ,GA,31533-8104,Public       ,113,208,321,2097,1620,3717
00159203,SOUTH GEORGIA STATE COLLEGE - WAYCROSS C,GA,31503-0110,Public       ,0,0,0,429,364,793
00159400,SPELMAN COLLEGE                         ,GA,30314-4399,Private      ,319,181,500,6365,1821,8186
00159600,TOCCOA FALLS COLLEGE                    ,GA,30598-0001,Private      ,27,26,53,942,295,1237
00159700,TRUETT MCCONNELL COLLEGE                ,GA,30528-1264,Private      ,42,32,74,902,292,1194
00159800,UNIVERSITY OF GEORGIA                   ,GA,30602-6114,Public       ,1193,734,1927,34072,12542,46614
00159900,VALDOSTA STATE UNIVERSITY               ,GA,31698-0001,Public       ,485,595,1080,13322,7699,21021
00160000,WESLEYAN COLLEGE                        ,GA,31210-4407,Private      ,23,77,100,657,858,1515
00160100,UNIV OF WEST GEORGIA                    ,GA,30118-0002,Public       ,545,637,1182,14577,7736,22313
00160200,GEORGIA COLLEGE & STATE UNIVERSITY      ,GA,31061-0490,Public       ,272,219,491,8265,2642,10907
00160400,YOUNG HARRIS COLLEGE                    ,GA,30582-4137,Private      ,56,18,74,1649,205,1854
00348400,COVENANT COLLEGE                        ,GA,30750-4164,Private      ,51,16,67,1423,164,1587
00395600,DALTON STATE COLLEGE                    ,GA,30720-3797,Public       ,186,339,525,4536,3621,8157
00402400,GEORGIA NORTHWESTERN TECHNICAL COLLEGE  ,GA,30161-6757,Public       ,288,843,1131,3107,6702,9809
00411700,GRADY HEALTH SYSTEM                     ,GA,30303-3050,Public       ,16,84,100,200,1023,1223
00489808,MCCANN SCHOOL OF BUSINESS & TECHNOLOGY -,GA,31210-0246,Proprietary  ,5,23,28,46,182,228
00525400,LANIER TECHNICAL COLLEGE                ,GA,30566-3499,Public       ,235,512,747,2047,4148,6195
00525500,MOULTRIE TECHNICAL COLLEGE              ,GA,31768-0000,Public       ,57,242,299,648,2080,2728
00525600,WIREGRASS GEORGIA TECHNICAL COLLEGE     ,GA,31602-0929,Public       ,198,662,860,1886,4890,6776
00551100,OKEFENOKEE TECHNICAL COLLEGE            ,GA,31501-4016,Public       ,92,293,385,814,1971,2785
00551102,COASTAL PINES TECHNICAL COLLEGE - JESUP ,GA,31545-4465,Public       ,40,139,179,443,1212,1655
00559900,AUGUSTA TECHNICAL COLLEGE               ,GA,30906-3399,Public       ,251,781,1032,2530,6430,8960
00560000,ATHENS TECHNICAL COLLEGE                ,GA,30601-1579,Public       ,264,621,885,3039,5205,8244
00560100,ALBANY TECHNICAL COLLEGE                ,GA,31701-2648,Public       ,169,594,763,1816,6225,8041
00561500,SOUTHWEST GEORGIA TECHNICAL COLLEGE     ,GA,31792-2622,Public       ,168,222,390,1159,2010,3169
00561700,SOUTH GEORGIA TECHNICAL COLLEGE         ,GA,31709-8167,Public       ,70,187,257,995,1579,2574
00561800,SAVANNAH TECHNICAL COLLEGE              ,GA,31405-5594,Public       ,292,1074,1366,2899,8537,11436
00561900,NORTH GEORGIA TECHNICAL COLLEGE         ,GA,30523-0000,Public       ,160,363,523,1853,2809,4662
00562000,CHATTAHOOCHEE TECHNICAL COLLEGE         ,GA,30060-3398,Public       ,654,1590,2244,6670,12431,19101
00562100,SOUTHERN CRESCENT TECHNICAL COLLEGE     ,GA,30223-2097,Public       ,249,783,1032,2563,6634,9197
00562200,DEKALB TECHNICAL COLLEGE                ,GA,30021-0000,Public       ,165,748,913,1643,7115,8758
00562400,COLUMBUS TECHNICAL COLLEGE              ,GA,31904-6572,Public       ,162,552,714,2225,5313,7538
00576300,CENTRAL GEORGIA TECHNICAL COLLEGE       ,GA,31206-3628,Public       ,331,1161,1492,3397,9636,13033
00854300,ATLANTA TECHNICAL COLLEGE               ,GA,30310-4499,Public       ,365,1529,1894,3446,13426,16872
00897600,CLAYTON STATE UNIVERSITY                ,GA,30260-0285,Public       ,282,867,1149,6755,10891,17646
00927000,ART INSTITUTE OF ATLANTA (THE)          ,GA,30328-1649,Proprietary  ,697,815,1512,7897,6998,14895
00950700,GEORGIA HIGHLANDS COLLEGE               ,GA,30162-0000,Public       ,369,507,876,5200,4396,9596
01031903,FORTIS INSTITUTE - FORTIS COLLEGE       ,GA,30080-7630,Proprietary  ,37,113,150,215,802,1017
01048700,WEST GEORGIA TECHNICAL COLLEGE          ,GA,30182-6476,Public       ,412,1026,1438,4411,8016,12427
01077100,GUPTON JONES COLLEGE                    ,GA,30035-4022,Private      ,8,45,53,162,423,585
01099700,EAST GEORGIA COLLEGE                    ,GA,30401-2699,Public       ,154,160,314,3534,1614,5148
01107400,BAINBRIDGE COLLEGE                      ,GA,39819-8400,Public       ,63,219,282,1300,2953,4253
01110901,EVEREST COLLEGE - EVEREST INSTITUTE     ,GA,30067-8340,Proprietary  ,34,168,202,184,991,1175
01110902,EVEREST COLLEGE - ATLANTA               ,GA,30331-2620,Proprietary  ,59,328,387,467,2067,2534
01112301,EVEREST COLLEGE - EVEREST INSTITUTE- NOR,GA,30093-2813,Proprietary  ,45,183,228,228,1053,1281
01157400,BAUDER COLLEGE                          ,GA,30313-2439,Proprietary  ,19,110,129,385,1833,2218
01205100,PRO WAY HAIR SCHOOL                     ,GA,30083-2884,Proprietary  ,15,48,63,95,349,444
01216500,ATLANTA METROPOLITAN COLLEGE            ,GA,30310-4498,Public       ,317,894,1211,4151,8467,12618
01246109,LINCOLN COLLEGE OF TECHNOLOGY - MARIETTA,GA,30067-8638,Proprietary  ,13,83,96,143,573,716
01303900,SOUTH UNIVERSITY                        ,GA,31406-4881,Proprietary  ,514,4407,4921,3190,23157,26347
02060900,BROWN CLG OF COURT REPORTING & M.T.     ,GA,30318-2570,Proprietary  ,6,72,78,45,568,613
02074800,LIFE UNIVERSITY                         ,GA,30060-0000,Private      ,38,141,179,676,3199,3875
02113613,AMERICAN INTERCONTINENTAL UNIVERSITY    ,GA,30328-1649,Proprietary  ,78,429,507,682,3186,3868
02116000,SANFORD-BROWN COLLEGE                   ,GA,30328-4803,Proprietary  ,28,186,214,251,1331,1582
02141500,SAVANNAH COLLEGE OF ART & DESIGN        ,GA,31402-3146,Private      ,476,388,864,11594,4886,16480
02202800,AUGUSTA AREA DIET INTERN UNIV HOSP      ,GA,30901-0000,Private      ,5,7,12,23,101,124
02217200,PORTFOLIO CENTER                        ,GA,30309-0000,Proprietary  ,3,17,20,46,158,204
02266200,AMERICAN PROFESSIONAL INSTITUTE         ,GA,31201-3185,Private      ,9,52,61,62,333,395
02284300,INTERACTIVE COLLEGE OF TECHNOLOGY       ,GA,30341-0000,Proprietary  ,42,309,351,219,1590,1809
02284308,INTERACTIVE LEARNING SYSTEMS            ,GA,30260-0000,Proprietary  ,12,43,55,52,263,315
02284309,INTERACTIVE COLLEGE OF TECHNOLOGY       ,GA,30501-0000,Proprietary  ,12,57,69,92,382,474
02285500,"CREATIVE CIRCUS, THE                    ",GA,30324-0000,Proprietary  ,5,34,39,96,350,446
02288400,GWINNETT TECHNICAL COLLEGE              ,GA,30043-5702,Public       ,469,1143,1612,4440,10459,14899
02313902,WESTWOOD COLLEGE - O'HARE AIRPORT - ATLA,GA,30345-2807,Proprietary  ,16,103,119,189,788,977
02321400,ROFFLER-MOLER HAIRSTYLING COLLEGE       ,GA,30062-0000,Proprietary  ,5,24,29,59,143,202
02482100,MOREHOUSE SCHOOL OF MEDICINE            ,GA,30310-0000,Private      ,16,40,56,222,971,1193
02520000,INTERNATIONAL SCH SKIN & NAILCARE       ,GA,30342-1119,Proprietary  ,11,77,88,107,537,644
02559315,(UNITED EDUCATION INSTITUTE) - UEI MORRO,GA,30260-2941,Proprietary  ,9,37,46,52,284,336
02577000,PAUL MITCHELL THE SCHOOL - ESANI        ,GA,30076-1507,Proprietary  ,24,27,51,148,271,419
02577700,BEAUTY COLLEGE OF AMERICA               ,GA,30297-0000,Proprietary  ,8,25,33,45,155,200
02580100,IVERSON INSTITUTE                       ,GA,30341-3662,Proprietary  ,1,4,5,28,177,205
02580200,ATLANTA SCHOOL OF MASSAGE               ,GA,30338-0000,Proprietary  ,23,138,161,152,815,967
02583000,GWINNETT COLLEGE OF BUSINESS            ,GA,30047-3447,Proprietary  ,18,94,112,150,760,910
02614206,MILLER - MOTTE TECHNICAL COLLEGE - COLUM,GA,31907-3222,Proprietary  ,26,170,196,253,1374,1627
02614207,MILLER - MOTTE TECHNICAL COLLEGE - AUGUS,GA,30907-0921,Proprietary  ,23,172,195,243,1328,1571
03005400,GEORGIA CAREER INSTITUTE                ,GA,30013-2076,Proprietary  ,38,127,165,274,740,1014
03010619,VIRGINIA COLLEGE - AUGUSTA              ,GA,30909-5515,Proprietary  ,21,134,155,283,1190,1473
03010623,VIRGINIA COLLEGE - MACON                ,GA,31206-3180,Proprietary  ,13,103,116,191,830,1021
03022601,WESTERN CULINARY INSTITUTE - LE CORDON B,GA,30084-5893,Proprietary  ,40,174,214,494,1271,1765
03030000,OGEECHEE TECHNICAL COLLEGE              ,GA,30458-8049,Public       ,144,363,507,1734,3357,5091
03042700,LAURUSTECHNICAL INSTITUTE               ,GA,30030-1506,Proprietary  ,16,123,139,96,705,801
03066500,SOUTHEASTERN TECHNICAL COLLEGE          ,GA,30474-8817,Public       ,65,203,268,731,1850,2581
03072304,EVEREST COLLEGE - EVEREST INSTITUTE     ,GA,30236-0000,Proprietary  ,26,145,171,154,902,1056
03076300,BEULAH HEIGHTS BIBLE COLLEGE            ,GA,30316-1873,Private      ,3,72,75,38,936,974
03079202,WESTWOOD COLLEGE - ATLANTA MIDTOWN      ,GA,30309-2848,Proprietary  ,43,190,233,498,1549,2047
03081500,SOUTHEASTERN BEAUTY SCHOOL              ,GA,31917-0000,Proprietary  ,0,0,0,71,165,236
03089100,GEORGIA INSTITUTE OF COSMETOLOGY        ,GA,30606-3152,Proprietary  ,31,74,105,247,529,776
03090600,COBB BEAUTY COLLEGE                     ,GA,30144-2828,Proprietary  ,6,23,29,75,211,286
03100900,LUTHER RICE UNIVERSITY                  ,GA,30038-2454,Private      ,4,121,125,56,1246,1302
03102000,RIVERTOWN SCHOOL OF BEAUTY              ,GA,31904-4747,Proprietary  ,12,65,77,107,369,476
03104500,ATLANTA INSTITUTE OF MUSIC              ,GA,30096-4988,Proprietary  ,43,44,87,373,467,840
03116100,VOGUE BEAUTY AND BARBER SCHOOL          ,GA,30141-2226,Proprietary  ,10,39,49,84,263,347
03155500,OCONEE FALL LINE TECHNICAL COLLEGE      ,GA,31082-6179,Public       ,56,257,313,665,2011,2676
03173300,ATLANTA'S JOHN MARSHALL LAW SCHOOL      ,GA,30309-0000,Proprietary  ,5,69,74,67,1443,1510
03418300,GWINNETT COLLEGE-SANDY SPRINGS          ,GA,30328-3161,Proprietary  ,12,46,58,130,423,553
03445500,FAYETTE BEAUTY ACADEMY                  ,GA,30214-1191,Proprietary  ,7,18,25,41,167,208
03523300,AVIATION INSTITUTE OF MAINTENANCE       ,GA,30096-5038,Proprietary  ,65,214,279,283,942,1225
03635300,CARVER BIBLE COLLEGE                    ,GA,30331-1300,Private      ,4,41,45,102,338,440
03748300,KEVOSNIK SCHOOL OF HAIR DESIGN          ,GA,31021-0000,Proprietary  ,0,3,3,10,45,55
03804400,MEDTECH INSTITUTE                       ,GA,30339-6040,Proprietary  ,23,106,129,210,892,1102
03812300,OMNITECH INSTITUTE                      ,GA,30035-1206,Proprietary  ,15,89,104,68,425,493
04021300,AUGUSTA SCHOOL OF MASSAGE               ,GA,30809-0000,Proprietary  ,5,22,27,23,114,137
04051331,ART INSTITUTE OF PHOENIX (THE) - BROWN M,GA,30319-3054,Proprietary  ,34,95,129,211,667,878
04142900,GEORGIA GWINNETT COLLEGE                ,GA,30043-7409,Public       ,796,809,1605,12210,7984,20194
04147000,PAUL MITCHELL THE SCHOOL ATLANTA        ,GA,30318-5241,Proprietary  ,53,110,163,410,757,1167
04147700,LAKE LANIER SCHOOL OF MASSAGE           ,GA,30501-4546,Proprietary  ,6,43,49,35,222,257
04149900,PROFILE INSTITUTE OF BARBER-STYLING     ,GA,30315-8459,Proprietary  ,8,46,54,51,256,307
04150900,PROCESS INSTITUTE OF COSMETOLOGY (THE)  ,GA,30043-7344,Proprietary  ,20,29,49,126,211,337
04152300,GEORGIA BEAUTY ACADEMY                  ,GA,30721-3952,Proprietary  ,6,22,28,74,173,247
04156500,GEORGIA CHRISTIAN UNIVERSITY            ,GA,30047-3778,Private      ,6,24,30,49,179,228
04160200,ATLANTA BEAUTY ACADEMY                  ,GA,30340-1334,Proprietary  ,10,56,66,97,386,483
04203800,WOODRUFF MEDICAL TRAINING AND TESTING   ,GA,30033-6103,Proprietary  ,9,62,71,60,313,373
04204500,ELAINE STERLING INSTITUTE(THE)          ,GA,30342-2633,Proprietary  ,13,42,55,41,216,257
04206400,HELMS COLLEGE                           ,GA,31206-5309,Private      ,18,59,77,146,377,523
04206600,SAE INSTITUTE OF TECHNOLOGY - ATLANTA   ,GA,30303-1736,Proprietary  ,45,110,155,364,776,1140
04208000,TECHNOLOGY CENTER                       ,GA,30071-3519,Proprietary  ,1,18,19,18,213,231
04218000,UNITED MEDICAL AND BUSINESS INSTITUTE   ,GA,30344-6977,Proprietary  ,11,52,63,44,258,302
04221100,NEW HORIZONS MEDICAL INSTITUTE          ,GA,30071-2965,Proprietary  ,21,95,116,102,546,648
00149911,EVEREST COLLEGE - MERRIONETTE PARK      ,IL,60803-4517,Proprietary  ,0,12,12,134,503,637
00162800,AMERICAN ACADEMY OF ART                 ,IL,60604-4302,Proprietary  ,26,47,73,957,418,1375
00163300,AUGUSTANA COLLEGE                       ,IL,61201-2296,Private      ,82,22,104,4939,304,5243
00163400,AURORA UNIVERSITY                       ,IL,60506-4892,Private      ,116,320,436,4417,3911,8328
00163600,SOUTHWESTERN ILLINOIS COLLEGE           ,IL,62221-5899,Public       ,295,744,1039,4967,7047,12014
00163800,BLACK HAWK COLLEGE                      ,IL,61265-5899,Public       ,152,378,530,2889,3178,6067
00163900,BLACKBURN COLLEGE                       ,IL,62626-1498,Private      ,16,10,26,906,198,1104
00164000,PRAIRIE STATE COLLEGE                   ,IL,60411-8226,Public       ,171,508,679,3609,5624,9233
00164100,BRADLEY UNIVERSITY                      ,IL,61625-0002,Private      ,104,88,192,8365,1319,9684
00164300,SPOON RIVER COLLEGE                     ,IL,61520-8907,Public       ,43,85,128,858,974,1832
00164700,CITY COLLEGES OF CHICAGO                ,IL,60606-6998,Public       ,146,545,691,3751,6390,10141
00164800,TRUMAN COLLEGE                          ,IL,60640-5691,Public       ,166,619,785,3640,6797,10437
00164900,RICHARD J DALEY COLLEGE                 ,IL,60652-1299,Public       ,165,500,665,4373,5786,10159
00165000,CITY COLLEGES OF CHICAGO-MALCOLM X      ,IL,60612-3197,Public       ,255,944,1199,5295,10405,15700
00165200,HAROLD WASHINGTON COLLEGE               ,IL,60601-2403,Public       ,443,966,1409,9922,10928,20850
00165400,KENNEDY KING COLLEGE                    ,IL,60621-3798,Public       ,166,914,1080,3273,9070,12343
00165500,WRIGHT COLLEGE                          ,IL,60634-1591,Public       ,269,715,984,6850,7827,14677
00165700,MIDWESTERN UNIVERSITY                   ,IL,60515-1200,Private      ,2,36,38,148,3794,3942
00165900,ROSALIND FRANKLIN UNIVERSITY OF MEDICINE,IL,60064-3095,Private      ,3,42,45,94,2843,2937
00166100,CHICAGO THEOLOGICAL SEMINARY            ,IL,60637-0000,Private      ,1,19,20,27,310,337
00166300,SPERTUS COLLEGE                         ,IL,60605-1995,Private      ,0,8,8,4,64,68
00166400,UNIVERSITY OF ST FRANCIS                ,IL,60435-6188,Private      ,61,240,301,2159,2513,4672
00166500,COLUMBIA COLLEGE                        ,IL,60605-1996,Private      ,516,411,927,14980,5797,20777
00166600,CONCORDIA UNIVERSITY                    ,IL,60305-1499,Private      ,58,421,479,2984,4180,7164
00166900,DANVILLE AREA COMMUNITY COLLEGE         ,IL,61832-5199,Public       ,77,188,265,1090,1611,2701
00167100,DEPAUL UNIVERSITY                       ,IL,60604-2287,Private      ,575,949,1524,24798,16908,41706
00167400,EASTERN ILLINOIS UNIVERSITY             ,IL,61920-3099,Public       ,250,217,467,11530,3946,15476
00167500,ELGIN COMMUNITY COLLEGE                 ,IL,60123-7193,Public       ,301,506,807,4846,4676,9522
00167600,ELMHURST COLLEGE                        ,IL,60126-3296,Private      ,70,97,167,4453,1695,6148
00167800,EUREKA COLLEGE                          ,IL,61530-9976,Private      ,26,8,34,1119,227,1346
00168100,HIGHLAND COMMUNITY COLLEGE              ,IL,61032-9341,Public       ,53,127,180,984,1150,2134
00168200,GARRETT-EVANGELICAL THEOLOGICAL SEM     ,IL,60201-0000,Private      ,0,12,12,2,252,254
00168400,GREENVILLE COLLEGE                      ,IL,62246-1199,Private      ,47,52,99,1771,615,2386
00168500,HEBREW THEOLOGICAL COLLEGE              ,IL,60077-3263,Private      ,15,3,18,495,34,529
00168800,ILLINOIS COLLEGE                        ,IL,62650-2299,Private      ,28,14,42,1989,248,2237
00168900,ILLINOIS COLLEGE OF OPTOMETRY           ,IL,60616-3878,Private      ,3,11,14,42,705,747
00169100,ILLINOIS INSTITUTE OF TECHNOLOGY        ,IL,60616-0000,Private      ,114,176,290,3889,2783,6672
00169103,CHICAGO KENT COLLEGE OF LAW             ,IL,60661-0000,Private      ,10,48,58,90,1593,1683
00169200,ILLINOIS STATE UNIVERSITY               ,IL,61790-1000,Public       ,499,286,785,25070,5417,30487
00169300,NORTHEASTERN ILLINOIS UNIV              ,IL,60625-4699,Public       ,260,592,852,8127,9170,17297
00169400,CHICAGO STATE UNIVERSITY                ,IL,60628-1598,Public       ,202,757,959,6651,12681,19332
00169600,ILLINOIS WESLEYAN UNIVERSITY            ,IL,61701-0000,Private      ,77,20,97,3464,255,3719
00169800,JOHN MARSHALL LAW SCHOOL                ,IL,60604-0000,Private      ,8,76,84,92,2197,2289
00169900,JOLIET JUNIOR COLLEGE                   ,IL,60431-8938,Public       ,488,736,1224,8172,7229,15401
00170000,JUDSON UNIVERSITY                       ,IL,60123-1498,Private      ,32,76,108,1215,951,2166
00170100,KASKASKIA COLLEGE                       ,IL,62801-7878,Public       ,109,223,332,1700,2196,3896
00170300,KENDALL COLLEGE                         ,IL,60622-4278,Proprietary  ,46,184,230,1107,2047,3154
00170400,KNOX COLLEGE                            ,IL,61401-4999,Private      ,60,16,76,2791,196,2987
00170500,ILLINOIS VALLEY COMMUNITY COLLEGE       ,IL,61348-9692,Public       ,86,176,262,1672,1715,3387
00170600,LAKE FOREST COLLEGE                     ,IL,60045-2399,Private      ,51,11,62,2593,267,2860
00170700,LEWIS UNIVERSITY                        ,IL,60446-2200,Private      ,134,309,443,6352,3969,10321
00170800,LINCOLN CHRISTIAN UNIVERSITY            ,IL,62656-2167,Private      ,11,54,65,448,682,1130
00170900,LINCOLN COLLEGE                         ,IL,62656-1699,Private      ,40,38,78,1394,726,2120
00171000,LOYOLA UNIVERSITY CHICAGO               ,IL,60626-0000,Private      ,464,670,1134,20102,12111,32213
00171200,LUTHERAN SCHOOL OF THEOL AT CHICAGO     ,IL,60615-0000,Private      ,2,6,8,3,123,126
00171600,MACCORMAC COLLEGE                       ,IL,60602-4405,Private      ,4,20,24,71,281,352
00171700,MACMURRAY COLLEGE                       ,IL,62650-2590,Private      ,13,18,31,912,317,1229
00172100,MCCORMICK THEOLOGICAL SEMINARY          ,IL,60615-5108,Private      ,1,10,11,6,131,137
00172200,MCKENDREE UNIVERSITY                    ,IL,62254-1299,Private      ,39,128,167,2229,1682,3911
00172300,MEADVILLE LOMBARD THEOLOGICAL SCHOOL    ,IL,60637-1602,Private      ,0,6,6,1,92,93
00172400,MILLIKIN UNIVERSITY                     ,IL,62522-2084,Private      ,55,75,130,3315,987,4302
00172500,MONMOUTH COLLEGE                        ,IL,61462-1963,Private      ,31,5,36,2545,191,2736
00172700,MOODY BIBLE INSTITUTE                   ,IL,60610-3214,Private      ,73,189,262,2286,2159,4445
00172800,MORTON COLLEGE                          ,IL,60804-4398,Public       ,152,218,370,2954,2471,5425
00173200,NATIONAL UNIV OF HEALTH SCIENCES        ,IL,60148-4583,Private      ,0,53,53,54,925,979
00173300,NATIONAL-LOUIS UNIVERSITY               ,IL,60603-3032,Private      ,14,456,470,534,6249,6783
00173400,NORTH CENTRAL COLLEGE                   ,IL,60540-4690,Private      ,100,76,176,4929,1084,6013
00173500,NORTH PARK UNIVERSITY                   ,IL,60625-4895,Private      ,98,162,260,3442,2177,5619
00173600,NORTHERN BAPTIST THEOL SEMINARY         ,IL,60148-0000,Private      ,0,2,2,3,89,92
00173700,NORTHERN ILLINOIS UNIVERSITY            ,IL,60115-2854,Public       ,571,566,1137,25418,11164,36582
00173900,NORTHWESTERN UNIV                       ,IL,60208-0001,Private      ,550,569,1119,21321,10672,31993
00174100,OLIVET NAZARENE UNIVERSITY              ,IL,60914-2271,Private      ,81,254,335,4470,2982,7452
00174200,IL EASTERN COMM COLGS-OLNEY CENTRAL     ,IL,62450-1099,Public       ,22,69,91,584,685,1269
00174500,QUINCY UNIVERSITY                       ,IL,62301-2699,Private      ,24,28,52,1654,553,2207
00174600,ROBERT MORRIS UNIVERSITY ILLINOIS       ,IL,60605-1225,Private      ,134,361,495,5811,5677,11488
00174700,ROCK VALLEY COLLEGE                     ,IL,61114-5699,Public       ,278,594,872,4070,5229,9299
00174800,ROCKFORD UNIVERSITY                     ,IL,61108-2393,Private      ,52,113,165,1663,1391,3054
00174900,ROOSEVELT UNIVERSITY                    ,IL,60605-1394,Private      ,162,467,629,7068,7799,14867
00175000,DOMINICAN UNIVERSITY                    ,IL,60305-1066,Private      ,67,127,194,3942,2038,5980
00175200,SAUK VALLEY COMMUNITY COLLEGE           ,IL,61021-9112,Public       ,47,134,181,1104,1210,2314
00175300,SCHOOL OF ART INSTITUTE OF CHICAGO      ,IL,60603-3013,Private      ,212,156,368,4681,2526,7207
00175600,SHIMER COLLEGE                          ,IL,60616-3893,Private      ,8,3,11,96,57,153
00175700,SOUTHEASTERN ILLINOIS COLLEGE           ,IL,62946-4925,Public       ,17,97,114,717,888,1605
00175800,SOUTHERN ILL UNIV-CARBONDALE            ,IL,62901-0000,Public       ,410,517,927,18992,9206,28198
00175900,SOUTHERN ILL UNIV-EDWARDSVILLE          ,IL,62026-1060,Public       ,365,389,754,15191,6649,21840
00175924,SO IL UNIV-SCHL OF DENTAL MEDICINE      ,IL,62002-0000,Public       ,1,1,2,10,199,209
00176500,UNIVERSITY OF ST MARY OF THE LAKE       ,IL,60060-0000,Private      ,0,3,3,6,22,28
00176700,BENEDICTINE UNIVERSITY                  ,IL,60532-0900,Private      ,89,338,427,4227,4335,8562
00176800,ST XAVIER UNIVERSITY                    ,IL,60655-3199,Private      ,130,200,330,7276,3615,10891
00176900,SOUTH SUBURBAN COLLEGE                  ,IL,60473-9978,Public       ,150,551,701,3355,6157,9512
00177100,TRINITY CHRISTIAN COLLEGE               ,IL,60463-0929,Private      ,22,70,92,1408,1018,2426
00177200,TRINITY INTERNATIONAL UNIVERSITY        ,IL,60015-1283,Private      ,29,63,92,959,1102,2061
00177300,TRITON COLLEGE                          ,IL,60171-1995,Public       ,180,491,671,4972,5556,10528
00177400,UNIVERSITY OF CHICAGO                   ,IL,60637-1476,Private      ,740,296,1036,19731,4497,24228
00177401,UNIV OF CHICAGO PRITZKER SCH OF MED     ,IL,60637-0000,Private      ,7,10,17,92,640,732
00177403,"UNIV OF CHICAGO, BOOTH SCH OF BUS       ",IL,60637-0000,Private      ,14,121,135,170,1452,1622
00177405,UNIVERSITY OF CHICAGO GRADUATE          ,IL,60637-0000,Private      ,10,190,200,160,4704,4864
00177500,UNIV OF ILLINOIS @ URBANA-CHAMPAIGN     ,IL,61820-5796,Public       ,708,431,1139,34861,9175,44036
00177600,UNIV OF ILLINOIS AT CHICAGO             ,IL,60607-0000,Public       ,742,1069,1811,29432,20273,49705
00177800,VANDERCOOK COLLEGE OF MUSIC             ,IL,60616-3731,Private      ,6,14,20,190,127,317
00177900,IL EASTERN COMM COLGS-WABASH VALLEY     ,IL,62863-2699,Public       ,14,37,51,535,389,924
00178000,WESTERN ILLINOIS UNIVERSITY             ,IL,61455-1390,Public       ,334,289,623,13969,5246,19215
00178100,WHEATON COLLEGE                         ,IL,60187-5535,Private      ,68,38,106,3138,627,3765
00178300,WORSHAM COLLEGE OF MORTUARY SCIENCE     ,IL,60090-2646,Proprietary  ,5,16,21,74,181,255
00396100,HARPER COLLEGE                          ,IL,60067-7398,Public       ,330,598,928,6297,5295,11592
00456000,GEM CITY COLLEGE                        ,IL,62301-4949,Proprietary  ,5,9,14,24,65,89
00456800,MIDSTATE COLLEGE                        ,IL,61614-3558,Proprietary  ,6,78,84,110,983,1093
00621400,BLESSING RIEMAN COLLEGE OF NURSING      ,IL,62301-0000,Private      ,4,12,16,172,223,395
00621401,BLESSING HOSPITAL - SCHOOL OF MEDICAL LA,IL,62305-7005,Private      ,0,5,5,13,40,53
00621402,BLESSING HOSPITAL - SCHOOL OF RADIOLOGIC,IL,62305-7005,Private      ,2,7,9,44,49,93
00622500,TRINITY COLLEGE OF NURSING AND HEALTH SC,IL,61201-5317,Private      ,6,15,21,164,289,453
00622800,METHODIST MED CTR OF ILL SCH NRSNG      ,IL,61636-0000,Private      ,19,55,74,359,712,1071
00624000,ST FRANCIS MED CLG OF NRSG              ,IL,61603-3783,Private      ,13,36,49,404,641,1045
00638500,CHAMBERLAIN COLLEGE OF NURSING          ,IL,60101-0000,Proprietary  ,173,3077,3250,2757,26604,29361
00665600,COLLEGE OF DUPAGE                       ,IL,60137-6599,Public       ,666,1057,1723,12965,11129,24094
00675300,ILLINOIS CENTRAL COLLEGE                ,IL,61635-0001,Public       ,196,603,799,4687,5499,10186
00693100,WAUBONSEE COMMUNITY COLLEGE             ,IL,60554-0000,Public       ,263,460,723,4001,4273,8274
00711800,PARKLAND COLLEGE                        ,IL,61821-1899,Public       ,200,454,654,4989,4199,9188
00711900,REND LAKE COLLEGE                       ,IL,62846-9801,Public       ,49,166,215,1277,1420,2697
00717000,LINCOLN LAND COMMUNITY COLLEGE          ,IL,62794-9256,Public       ,201,482,683,3236,4345,7581
00726500,CARL SANDBURG COLLEGE                   ,IL,61401-9576,Public       ,66,149,215,1189,1506,2695
00730307,LINCOLN COLLEGE OF TECHNOLOGY - MELROSE ,IL,60160-1605,Proprietary  ,66,70,136,656,607,1263
00754900,COYNE AMERICAN INSTITUTE                ,IL,60607-1300,Proprietary  ,32,144,176,445,1212,1657
00764400,LAKE LAND COLLEGE                       ,IL,61938-9366,Public       ,117,298,415,2398,2405,4803
00768400,KISHWAUKEE COLLEGE                      ,IL,60150-9699,Public       ,117,188,305,2548,2368,4916
00769000,KANKAKEE COMMUNITY COLLEGE              ,IL,60901-6505,Public       ,87,272,359,1679,2676,4355
00769100,MCHENRY COUNTY COLLEGE                  ,IL,60012-2761,Public       ,183,284,467,2679,2538,5217
00769200,MORAINE VALLEY COMMUNITY COLLEGE        ,IL,60465-0937,Public       ,426,656,1082,8112,6600,14712
00769300,SHAWNEE COMMUNITY COLLEGE               ,IL,62992-9725,Public       ,19,101,120,745,997,1742
00769400,COLLEGE OF LAKE COUNTY                  ,IL,60030-1198,Public       ,274,668,942,5385,5571,10956
00793700,MS ROBERTS ACADEMY OF BEAUTY CULT       ,IL,60181-2930,Proprietary  ,1,11,12,13,44,57
00807600,JOHN A LOGAN COLLEGE                    ,IL,62918-2500,Public       ,107,262,369,2173,2754,4927
00809003,EVEREST COLLEGE - BEDFORD PARK          ,IL,60629-5819,Proprietary  ,14,31,45,185,598,783
00825900,EDUCATORS OF BEAUTY                     ,IL,61081-3611,Proprietary  ,12,16,28,58,108,166
00825901,EDUCATORS OF BEAUTY                     ,IL,61104-0000,Proprietary  ,2,16,18,55,118,173
00832800,ALVAREITA'S COLLEGE OF COSMETOLOGY      ,IL,62025-2041,Proprietary  ,2,14,16,57,103,160
00869402,RASMUSSEN COLLEGE - ROCKFORD            ,IL,61108-2513,Proprietary  ,19,150,169,294,1575,1869
00869403,RASMUSSEN COLLEGE - AURORA              ,IL,60506-6219,Proprietary  ,15,98,113,182,742,924
00869404,RASMUSSEN COLLEGE - ROMEOVILLE          ,IL,60446-0000,Proprietary  ,14,120,134,224,1090,1314
00869418,RASMUSSEN COLLEGE -  MOKENA             ,IL,60448-0000,Proprietary  ,9,79,88,86,615,701
00888000,MORRISON INSTITUTE OF TECHNOLOGY        ,IL,61270-2959,Private      ,5,4,9,121,27,148
00893800,GRAHAM HOSPITAL SCH OF NURSING          ,IL,61520-2497,Private      ,0,3,3,44,106,150
00893900,CANNELLA SCHOOL OF HAIR DESIGN          ,IL,60406-2130,Proprietary  ,3,11,14,35,111,146
00914500,GOVERNORS STATE UNIVERSITY              ,IL,60466-0975,Public       ,85,488,573,2333,7934,10267
00923200,CATHOLIC THEOLOGICAL UNION              ,IL,60615-0000,Private      ,0,7,7,7,74,81
00933300,UNIV OF ILLINOIS AT SPRINGFIELD         ,IL,62703-5407,Public       ,89,236,325,3088,3743,6831
00947500,EDUCATORS OF BEAUTY                     ,IL,61301-2404,Proprietary  ,2,5,7,26,45,71
00959500,CANNELLA SCHOOL OF HAIR DESIGN          ,IL,60617-4303,Proprietary  ,6,29,35,92,226,318
00976700,OLIVE-HARVEY COLLEGE                    ,IL,60628-1696,Public       ,126,509,635,2459,5570,8029
00978600,IL EASTERN COMM COLGS-LINCOLN TRAIL     ,IL,62454-5708,Public       ,15,33,48,423,408,831
00980000,RUSH UNIVERSITY                         ,IL,60612-3806,Private      ,13,175,188,464,3657,4121
00989600,OAKTON COMMUNITY COLLEGE                ,IL,60016-1268,Public       ,187,400,587,4332,3838,8170
00998700,SAINT ANTHONY COLLEGE OF NURSING        ,IL,61108-2468,Private      ,11,54,65,223,529,752
01002000,LEWIS AND CLARK COMMUNITY COLLEGE       ,IL,62035-2466,Public       ,153,304,457,2592,2937,5529
01050100,LAKEVIEW  COLLEGE OF NURSING            ,IL,61832-3781,Private      ,9,17,26,238,328,566
01069500,TRI-COUNTY BEAUTY ACADEMY               ,IL,62056-2036,Proprietary  ,1,3,4,16,23,39
01071000,CAPITAL AREA SCH OF PRAC NRSG           ,IL,62707-0000,Public       ,12,61,73,112,533,645
01072700,DEVRY UNIVERSITY                        ,IL,60618-5994,Proprietary  ,827,7594,8421,11261,76057,87318
01083600,PIVOT POINT ACADEMY                     ,IL,60626-0000,Proprietary  ,15,41,56,282,483,765
01087900,RICHLAND COMMUNITY COLLEGE              ,IL,62521-8513,Public       ,87,298,385,1252,2386,3638
01091303,ROCKFORD CAREER COLLEGE                 ,IL,61108-3900,Proprietary  ,28,144,172,357,1161,1518
01151002,EVEREST INSTITUTE - EVEREST COLLEGE     ,IL,60542-1610,Proprietary  ,5,27,32,106,247,353
01181000,TAYLOR BUSINESS INSTITUTE               ,IL,60606-5111,Proprietary  ,10,32,42,52,221,273
01185204,ITT TECHNICAL INSTITUTE - ORLAND PARK CA,IL,60467-4900,Proprietary  ,0,0,0,0,2,2
01185800,EVEREST COLLEGE                         ,IL,60077-1074,Proprietary  ,8,25,33,133,327,460
01185802,EVEREST COLLEGE - BURR RIDGE            ,IL,60527-7826,Proprietary  ,7,13,20,121,300,421
01185803,EVEREST COLLEGE - MELROSE PARK          ,IL,60160-1526,Proprietary  ,18,35,53,191,599,790
01236200,NORTHWESTERN COLLEGE                    ,IL,60630-2298,Proprietary  ,106,341,447,1874,3849,5723
01238500,BLOOMINGTON-NORMAL SCH RADIOGRAPHY      ,IL,61761-4604,Private      ,4,10,14,37,76,113
01258400,ILLINOIS INSTITUTE OF ART (THE)         ,IL,60654-1593,Proprietary  ,442,368,810,5328,3966,9294
01281300,JOHN WOOD COMMUNITY COLLEGE             ,IL,62305-0401,Public       ,45,177,222,1168,1372,2540
01308700,CAPRI BEAUTY COLLEGE                    ,IL,60629-1613,Proprietary  ,11,37,48,91,234,325
01308800,CAPRI OAK FOREST COLLEGE OF BEAUTY      ,IL,60452-2798,Proprietary  ,9,20,29,98,159,257
02055200,HARRINGTON COLLEGE OF DESIGN            ,IL,60606-3433,Proprietary  ,18,50,68,288,536,824
02068100,ADLER SCH OF PROFESSIONAL PSYCHLGY      ,IL,60601-0000,Private      ,5,101,106,135,1807,1942
02069300,VATTEROTT COLLEGE                       ,IL,62305-5938,Proprietary  ,10,41,51,105,289,394
02073200,TELSHE YESHIVA-CHICAGO                  ,IL,60625-0000,Private      ,2,4,6,36,14,50
02074400,IL EASTERN COMM COLGS-FRONTIER          ,IL,62837-0000,Public       ,8,26,34,179,312,491
02113600,AMERICAN INTERCONTINENTAL UNIVERSITY    ,IL,60192-3713,Proprietary  ,274,4345,4619,1525,26285,27810
02117400,BECK AREA CAREER CENTER                 ,IL,62278-0000,Public       ,3,18,21,40,177,217
02124400,UNIVERSITY OF SPA & COSMETOLOGY ART     ,IL,62704-0000,Proprietary  ,15,34,49,121,250,371
02150600,COSMETOLOGY AND SPA INSTITUTE (THE)     ,IL,60014-4003,Proprietary  ,18,33,51,116,179,295
02155300,THE CHICAGO SCHOOL OF PROF PSYCHOLOGY   ,IL,60610-4705,Private      ,3,349,352,90,5556,5646
02160300,INTERNATIONAL ACAD OF DESIGN & TECH     ,IL,60602-3319,Proprietary  ,4,17,21,273,456,729
02160304,INTERNATIONAL ACADEMY OF DESIGN AND TECH,IL,60173-5160,Proprietary  ,0,0,0,63,94,157
02168600,EAST WEST UNIVERSITY                    ,IL,60605-0000,Private      ,29,78,107,832,1362,2194
02179900,ARGOSY UNIVERSITY                       ,IL,60601-7757,Proprietary  ,990,5731,6721,7360,34705,42065
02185400,ST AUGUSTINE COLLEGE                    ,IL,60640-0000,Private      ,36,149,185,726,2228,2954
02192400,MR JOHNS SCHOOL OF COSMETOLOGY          ,IL,62521-0000,Proprietary  ,6,17,23,32,99,131
02202600,CANNELLA SCHOOL OF HAIR DESIGN          ,IL,60181-1321,Proprietary  ,2,3,5,10,67,77
02214100,RESURRECTION UNIVERSITY                 ,IL,60302-2519,Private      ,5,50,55,275,853,1128
02228100,MAC DANIEL'S BEAUTY SCHOOL              ,IL,60640-0000,Proprietary  ,4,17,21,47,102,149
02261200,HAIR PROFESSIONALS ACAD COSMETOLOGY     ,IL,60118-0000,Proprietary  ,9,36,45,61,226,287
02261201,HAIR PROFESSIONALS ACADEMY OF COSMETOLOG,IL,60118-9333,Proprietary  ,0,2,2,11,20,31
02262100,HAIR PROFESSIONALS SCH COSMETOLOGY      ,IL,60543-0000,Proprietary  ,5,16,21,34,79,113
02291200,CANNELLA SCHOOL OF HAIR DESIGN          ,IL,60639-0000,Proprietary  ,1,30,31,95,220,315
02295500,CANNELLA SCHOOL OF HAIR DESIGN          ,IL,60120-0000,Proprietary  ,1,8,9,19,66,85
02297500,OEHRLEIN SCHOOL OF COSMETOLOGY          ,IL,61611-0000,Proprietary  ,3,12,15,57,101,158
02312300,LA' JAMES COLLEGE HAIRSTYLING           ,IL,61244-0000,Proprietary  ,2,10,12,12,49,61
02313900,WESTWOOD COLLEGE - O'HARE AIRPORT       ,IL,60631-2801,Proprietary  ,14,80,94,232,731,963
02317300,CONCEPT COLLEGE OF COSMETOLOGY          ,IL,61832-0000,Proprietary  ,2,19,21,45,131,176
02319200,LAKE FOREST GRAD SCHL OF MGMT           ,IL,60045-4824,Private      ,1,42,43,10,249,259
02323300,PROFESSIONAL'S CHOICE HAIR DSN ACAD     ,IL,60435-0000,Proprietary  ,6,15,21,49,105,154
02332200,HAIR PROFESSIONALS CAREER COLLEGE       ,IL,60178-0000,Proprietary  ,5,8,13,24,61,85
02349400,ALVAREITA'S COLLEGE OF COSMETOLOGY      ,IL,62035-0000,Proprietary  ,3,13,16,47,103,150
02349500,CANNELLA SCHOOL OF HAIR DESIGN          ,IL,60632-0000,Proprietary  ,8,24,32,121,274,395
02352200,LE CORDON BLEU COLLEGE OF CULINARY ARTS ,IL,60610-3050,Proprietary  ,69,216,285,973,1830,2803
02498200,G SKIN & BEAUTY INSTITUTE               ,IL,60523-1805,Proprietary  ,23,64,87,105,368,473
02498201,HAIR PROFESSIONALS ACADEMY OF COSMETOLOG,IL,60563-0000,Proprietary  ,0,3,3,26,36,62
02522800,FOX COLLEGE                             ,IL,60638-1999,Proprietary  ,28,40,68,417,504,921
02522801,FOX COLLEGE -  VET TECH INSTITUTE       ,IL,60477-4451,Proprietary  ,0,0,0,38,32,70
02527600,LEXINGTON COLLEGE                       ,IL,60607-0000,Private      ,0,0,0,97,62,159
02536700,BELL MAR BEAUTY COLLEGE                 ,IL,60650-0000,Proprietary  ,3,12,15,40,80,120
02556100,ENVIRONMENTAL TECHNICAL INSTITUTE       ,IL,60143-0000,Proprietary  ,24,77,101,104,334,438
02556600,NILES SCHOOL OF COSMETOLOGY             ,IL,60714-0000,Proprietary  ,3,5,8,19,52,71
02573700,INSTITUTE FOR CLINICAL SOCIAL WORK      ,IL,60605-1229,Private      ,0,19,19,35,278,313
02584900,"FIRST INSTITUTE, INC.                   ",IL,60014-7489,Proprietary  ,16,54,70,114,333,447
02587700,HAIR PROFESSIONALS CAREER COLLEGE       ,IL,60465-1929,Proprietary  ,6,15,21,49,85,134
02599716,VATTEROTT COLLEGE - FAIRVIEW HEIGHTS    ,IL,62208-2029,Proprietary  ,26,105,131,192,753,945
02622700,KNOWLEDGE SYSTEMS INSTITUTE             ,IL,60076-0000,Private      ,0,2,2,2,9,11
03002000,HAIRMASTERS INST OF COSMETOLOGY         ,IL,61701-5547,Proprietary  ,8,8,16,51,87,138
03027702,PACIFIC COLLEGE OF ORIENTAL MEDICINE - C,IL,60601-7296,Proprietary  ,2,27,29,36,291,327
03065300,TREND SETTERS COLL OF COSMETOLOGY       ,IL,60915-0000,Proprietary  ,13,16,29,110,167,277
03065301,PAUL MITCHELL THE SCHOOL TINLEY PARK    ,IL,60477-6273,Proprietary  ,15,39,54,53,89,142
03072701,WESTWOOD COLLEGE - RIVER OAKS           ,IL,60409-5503,Proprietary  ,16,77,93,135,591,726
03072702,WESTWOOD COLLEGE OF TECHNOLOGY          ,IL,60602-0000,Proprietary  ,15,117,132,297,1098,1395
03078400,CAMEO BEAUTY ACADEMY                    ,IL,60453-3196,Proprietary  ,4,14,18,49,98,147
03079200,WESTWOOD COLLEGE - DUPAGE               ,IL,60517-2321,Proprietary  ,2,36,38,177,479,656
03082900,ROSEL SCHOOL OF COSMETOLOGY             ,IL,60659-1913,Proprietary  ,2,37,39,38,133,171
03083800,HEARTLAND COMMUNITY COLLEGE             ,IL,61761-9446,Public       ,130,260,390,2636,2338,4974
03098000,ST JOHN'S COLLEGE OF NURSING            ,IL,62702-5321,Private      ,4,21,25,163,291,454
03098002,ST JOHN'S HOSP SCH MED TECH             ,IL,62769-5324,Private      ,1,13,14,34,92,126
03099700,CAIN'S BARBER COLLEGE                   ,IL,60615-3510,Proprietary  ,10,59,69,132,445,577
03099800,ILLINOIS SCHOOL OF HEALTH CAREERS       ,IL,60604-0000,Proprietary  ,20,82,102,284,884,1168
03101800,ILLINOIS CENTER FOR BROADCASTING        ,IL,60148-7015,Proprietary  ,18,63,81,126,350,476
03128500,NATIONAL LATINO EDUCATION INSTITUTE     ,IL,60609-2205,Private      ,3,7,10,70,139,209
03199300,CHRISTIAN LIFE COLLEGE                  ,IL,60056-2522,Private      ,0,4,4,16,27,43
03368300,MIDWEST TECHNICAL INSTITUTE             ,IL,62707-8805,Proprietary  ,193,640,833,1201,3369,4570
03416300,COMPUTER SYSTEMS INSTITUTE              ,IL,60077-0000,Proprietary  ,48,341,389,374,1392,1766
03448300,BUSINESS INDUSTRIAL RESOURCES           ,IL,60659-1298,Proprietary  ,0,0,0,314,2627,2941
03455700,CORTIVA INSTITUTE - CHICAGO             ,IL,60602-3315,Proprietary  ,32,98,130,203,469,672
03455701,CORTIVA INSTITUTE - CHICAGO             ,IL,60014-6285,Proprietary  ,4,10,14,24,48,72
03490301,PAUL MITCHELL THE SCHOOL CHICAGO        ,IL,60607-0000,Proprietary  ,44,84,128,549,686,1235
03490302,PAUL MITCHELL THE SCHOOL ESCANABA - PAUL,IL,60148-0000,Proprietary  ,14,19,33,69,101,170
03510300,ERIKSON INSTITUTE                       ,IL,60654-4510,Private      ,0,16,16,8,340,348
03643300,"MR. JOHN'S SCHOOL OF JACKSONVILLE,  INC,",IL,62650-3488,Proprietary  ,2,5,7,14,40,54
03655300,ILLINOIS CAREERPATH INSTITUTE           ,IL,60654-1103,Private      ,0,0,0,9,37,46
03684300,NORTHSHORE UNIVERSITY HEALTHSYSTEM SCHOO,IL,60201-9872,Private      ,0,8,8,12,72,84
03881400,EUROPEAN MASSAGE THERAPY SCHOOL         ,IL,60077-2269,Proprietary  ,5,50,55,33,178,211
03891300,SOMA INSTITUTE - THE NATIONAL SCHOOL OF ,IL,60604-4466,Proprietary  ,18,42,60,72,171,243
03914300,"CALC, INSTITUTE OF TECHNOLOGY           ",IL,62002-5946,Proprietary  ,9,37,46,50,239,289
04117500,SOLEX MEDICAL ACADEMY                   ,IL,60090-3104,Proprietary  ,0,1,1,3,22,25
04117600,LARRY'S BARBER COLLEGE                  ,IL,60628-2322,Proprietary  ,16,72,88,161,515,676
04118400,CHICAGO ORT TECHNICAL INSTITUTE         ,IL,60077-3210,Private      ,16,58,74,39,243,282
04124700,AMBRIA COLLEGE OF NURSING               ,IL,60192-3712,Proprietary  ,11,95,106,125,940,1065
04136900,UNIVERSITY OF AESTHETICS (THE)          ,IL,60622-2151,Proprietary  ,4,15,19,25,81,106
04137000,UNIVERSITY OF AESTHETICS & COSMETOLOGY (,IL,60515-4607,Proprietary  ,4,11,15,28,50,78
04137500,TRICOCI UNIVERSITY OF BEAUTY CULTURE    ,IL,60656-1805,Proprietary  ,32,46,78,267,370,637
04139000,MIDWESTERN CAREER COLLEGE               ,IL,60606-3103,Proprietary  ,9,93,102,107,672,779
04141000,AVEDA INSTITUTE CHICAGO                 ,IL,60647-0000,Proprietary  ,22,61,83,274,480,754
04147100,TRICOCI UNIVERSITY OF BEAUTY CULTURE    ,IL,60048-2906,Proprietary  ,6,10,16,83,93,176
04147200,TRICOCI UNIVERSITY OF BEAUTY CULTURE    ,IL,60455-1824,Proprietary  ,8,27,35,112,191,303
04147300,TRICOCI UNIVERSITY OF BEAUTY CULTURE    ,IL,60139-3119,Proprietary  ,13,18,31,115,152,267
04147400,TRICOCI UNIVERSITY OF BEAUTY CULTURE    ,IL,61614-4831,Proprietary  ,3,27,30,77,167,244
04147500,TRICOCI UNIVERSITY OF BEAUTY CULTURE    ,IL,61108-2337,Proprietary  ,5,23,28,101,206,307
04160600,PAUL MITCHELL THE SCHOOL NORMAL         ,IL,61761-0000,Proprietary  ,7,7,14,103,92,195
04167800,INNOVATIONS DESIGN ACADEMY              ,IL,61520-2625,Proprietary  ,3,9,12,22,66,88
04168500,SOLEX COLLEGE                           ,IL,60090-3192,Proprietary  ,4,94,98,26,410,436
04170800,UNITY COSMETOLOGY COLLEGE               ,IL,61764-9652,Proprietary  ,4,4,8,29,48,77
04171600,SALON PROFESSIONAL ACADEMY OF ELGIN (THE,IL,60123-2319,Proprietary  ,0,0,0,25,70,95
04174900,SKIN CARE AND SPA INSTITUTE             ,IL,60077-2200,Proprietary  ,2,17,19,13,96,109
04175000,UNIVERSAL SPA TRAINING ACADEMY          ,IL,60515-0000,Proprietary  ,3,30,33,29,169,198
04175800,J RENEE CAREER FACILITATION             ,IL,60014-7986,Proprietary  ,3,16,19,20,133,153
04179100,PCCTI  IT & HEALTHCARE                  ,IL,60523-0000,Proprietary  ,4,58,62,31,457,488
04179101,PCCTI  IT & HEALTHCARE -                ,IL,60606-0000,Proprietary  ,0,9,9,26,257,283
04186000,CHICAGO SCHOOL FOR PIANO TECHNOLOGY (THE,IL,60612-1630,Private      ,0,0,0,28,27,55
04187400,COSMETOLOGY CONCEPTS                    ,IL,60452-2501,Proprietary  ,12,45,57,104,253,357
04189200,SALON PROFESSIONAL ACADEMY (THE)        ,IL,60404-8789,Proprietary  ,2,7,9,33,60,93
04189400,SHEAR LEARNING ACADEMY OF COSMETOLOGY   ,IL,62523-1208,Proprietary  ,2,9,11,19,45,64
04189600,STATE CAREER SCHOOL                     ,IL,60085-5129,Proprietary  ,3,23,26,46,155,201
04192000,CURVE METRIC SCHOOL OF HAIR DESIGN      ,IL,60707-1118,Proprietary  ,1,3,4,10,31,41
04195600,TRIBECA FLASHPOINT MEDIA ARTS ACADEMY   ,IL,60602-2716,Proprietary  ,35,20,55,544,303,847
04224400,NETWORKS BARBER COLLEGE                 ,IL,60409-3401,Proprietary  ,1,6,7,14,50,64
04224500,TRENZ BEAUTY ACADEMY                    ,IL,60409-0000,Proprietary  ,3,9,12,30,93,123
04225300,CREATIVE TOUCH COSMETOLOGY SCHOOL       ,IL,62298-1609,Proprietary  ,1,2,3,9,23,32
04227900,MORTHLAND COLLEGE                       ,IL,62896-2742,Private      ,2,3,5,71,34,105
04229900,DEBUTANTES SCHOOL OF COSMETOLOGY AND NAI,IL,60115-3301,Proprietary  ,0,8,8,32,77,109
11072707,DEVRY UNIVERSITY - DOWNERS              ,IL,60515-0000,Proprietary  ,28,481,509,132,11837,11969
00195100,ALICE LLOYD COLLEGE                     ,KY,41844-9703,Private      ,25,28,53,1264,254,1518
00195200,ASBURY COLLEGE                          ,KY,40390-1198,Private      ,55,39,94,1861,751,2612
00195300,ASBURY THEOLOGICAL SEMINARY             ,KY,40390-0000,Private      ,2,52,54,25,1369,1394
00195400,BELLARMINE UNIVERSITY                   ,KY,40205-1877,Private      ,150,160,310,5617,2206,7823
00195500,BEREA COLLEGE                           ,KY,40403-0000,Private      ,83,59,142,3201,939,4140
00195800,BRESCIA UNIVERSITY                      ,KY,42301-3023,Private      ,36,88,124,1179,1152,2331
00195900,CAMPBELLSVILLE UNIVERSITY               ,KY,42718-2799,Private      ,96,132,228,2932,1848,4780
00196000,SPALDING UNIVERSITY                     ,KY,40203-2188,Private      ,56,201,257,1537,3085,4622
00196100,CENTRE COLLEGE                          ,KY,40422-1394,Private      ,72,12,84,2629,154,2783
00196200,UNIVERSITY OF THE CUMBERLANDS           ,KY,40769-1372,Private      ,60,318,378,2815,3909,6724
00196300,EASTERN KENTUCKY UNIVERSITY             ,KY,40475-3102,Public       ,449,866,1315,14818,11183,26001
00196400,GEORGETOWN COLLEGE                      ,KY,40324-1628,Private      ,64,44,108,2445,719,3164
00196500,KENTUCKY CHRISTIAN UNIVERSITY           ,KY,41143-2205,Private      ,59,21,80,1082,318,1400
00196800,KENTUCKY STATE UNIVERSITY               ,KY,40601-2355,Public       ,106,124,230,3373,2095,5468
00196900,KENTUCKY WESLEYAN COLLEGE               ,KY,42301-6057,Private      ,36,31,67,1336,467,1803
00197100,LEXINGTON THEOLOGICAL SEMINARY          ,KY,40508-0000,Private      ,1,4,5,7,99,106
00197200,LINDSEY WILSON COLLEGE                  ,KY,42728-1223,Private      ,73,132,205,3098,1842,4940
00197400,LOUISVILLE PRESBYTERIAN THEOL SEM       ,KY,40205-0000,Private      ,0,12,12,17,199,216
00197500,MIDWAY COLLEGE                          ,KY,40347-1120,Private      ,13,115,128,612,1586,2198
00197600,MOREHEAD STATE UNIVERSITY               ,KY,40351-1689,Public       ,220,393,613,9030,5529,14559
00197700,MURRAY STATE UNIVERSITY                 ,KY,42071-0009,Public       ,251,324,575,8450,4778,13228
00197900,WEST KENTUCKY CMNTY & TECHNICAL COLG    ,KY,42002-7380,Public       ,118,481,599,2296,4587,6883
00198000,UNIVERSITY OF PIKEVILLE                 ,KY,41501-1194,Private      ,63,59,122,2568,1563,4131
00198300,ST. CATHARINE COLLEGE                   ,KY,40061-9499,Private      ,24,33,57,834,405,1239
00198700,TRANSYLVANIA UNIVERSITY                 ,KY,40508-1797,Private      ,68,23,91,2048,332,2380
00198800,UNION COLLEGE                           ,KY,40906-1499,Private      ,37,58,95,1443,854,2297
00198900,UNIVERSITY OF KENTUCKY                  ,KY,40506-0054,Public       ,802,571,1373,25952,10720,36672
00198901,UNIV OF KY-COLLEGE OF DENTISTRY         ,KY,40536-0000,Public       ,8,6,14,79,330,409
00198902,UNIV OF KY-COLLEGE OF MEDICINE          ,KY,40536-0000,Public       ,12,16,28,150,696,846
00199000,ASHLAND COMMUNITY AND TECHNICAL COLLEGE ,KY,41101-3683,Public       ,68,363,431,1603,3136,4739
00199100,ELIZABETHTOWN COMMUNITY  AND TECHNICAL C,KY,42701-3081,Public       ,151,518,669,2900,5459,8359
00199300,HENDERSON COMMUNITY COLLEGE             ,KY,42420-4699,Public       ,34,149,183,689,1508,2197
00199400,HOPKINSVILLE COMMUNITY COLLEGE          ,KY,42241-2621,Public       ,55,454,509,1209,4120,5329
00199600,BIG SANDY COMMUNITY AND TECHNICAL COLG  ,KY,41653-1815,Public       ,81,317,398,2236,3443,5679
00199700,SOMERSET COMMUNITY COLLEGE              ,KY,42501-2973,Public       ,144,684,828,3248,7190,10438
00199800,SOUTHEAST KENTUCKY COMMUNITY AND TECHNIC,KY,40823-1099,Public       ,39,204,243,1337,2340,3677
00199900,UNIVERSITY OF LOUISVILLE                ,KY,40292-0000,Public       ,543,758,1301,18041,13933,31974
00200100,THOMAS MORE COLLEGE                     ,KY,41017-3495,Private      ,23,103,126,1573,872,2445
00200200,WESTERN KENTUCKY UNIVERSITY             ,KY,42101-3576,Public       ,523,658,1181,17466,10009,27475
00461800,SPENCERIAN COLLEGE                      ,KY,40216-2605,Proprietary  ,36,139,175,568,1529,2097
00461900,SULLIVAN UNIVERSITY                     ,KY,40205-3000,Proprietary  ,147,550,697,2073,5777,7850
00493402,DAYMAR COLLEGE - BOWLING GREEN          ,KY,42101-4063,Proprietary  ,6,63,69,102,441,543
00493403,DAYMAR COLLEGE - CLINTON                ,KY,42031-9998,Proprietary  ,0,0,0,1,13,14
00493406,DAYMAR COLLEGE - RUSSELLVILLE           ,KY,42276-1622,Proprietary  ,1,17,18,19,102,121
00524400,BLUEGRASS COMMUNITY & TECHNICAL COLLEGE ,KY,40506-0235,Public       ,275,936,1211,6051,10410,16461
00527100,BOWLING GREEN TECHNICAL COLLEGE         ,KY,42101-3601,Public       ,136,347,483,2247,3880,6127
00527300,GATEWAY COMMUNITY & TECHNOLOGY COLL     ,KY,41011-0000,Public       ,121,424,545,1755,4266,6021
00696000,MAYSVILLE CMNTY & TECHNCL COLG          ,KY,41056-8910,Public       ,74,340,414,1353,3207,4560
00696100,JEFFERSON COMMUNITY AND TECHNICAL COLLEG,KY,40202-2005,Public       ,429,1402,1831,7503,14660,22163
00696200,HAZARD COMMUNITY COLLEGE                ,KY,41701-2402,Public       ,50,234,284,1474,2640,4114
00696203,KY TECH-KNOTT CO. TECHNOLOGY CTR        ,KY,41822-0000,Public       ,1,5,6,9,25,34
00696204,KY TECH-LESLIE COUNTY AREA TECH CTR     ,KY,41749-0000,Public       ,1,1,2,7,14,21
00696205,KY TECH-LEE COUNTY AREA TECH CTR        ,KY,41311-0000,Public       ,0,0,0,1,3,4
00696206,KY TECH-LETCHER CNTY AREA TECH CTR      ,KY,41858-0000,Public       ,1,7,8,35,63,98
00696207,KY TECH-BREATHITT COUNTY VOC ED CTR     ,KY,41339-0000,Public       ,1,7,8,21,57,78
00736205,MEDTECH COLLEGE - LEXINGTON             ,KY,40511-1200,Proprietary  ,23,153,176,154,882,1036
00842500,DAYMAR COLLEGE                          ,KY,42001-0000,Proprietary  ,2,20,22,55,279,334
00901000,MADISONVILLE COMMUNITY COLLEGE          ,KY,42431-9199,Public       ,59,221,280,1258,2454,3712
00927500,NORTHERN KENTUCKY UNIVERSITY            ,KY,41099-0001,Public       ,326,452,778,11164,7593,18757
00931300,DAYMAR COLLEGE                          ,KY,42301-5830,Proprietary  ,6,79,85,105,1061,1166
00931302,DAYMAR COLLEGE - LOUISVILLE             ,KY,40219-1973,Proprietary  ,7,70,77,93,547,640
00931304,DAYMAR COLLEGE - ALBANY                 ,KY,42602-1235,Proprietary  ,0,0,0,6,17,23
00931305,DAYMAR COLLEGE - BELLEVUE               ,KY,41073-2416,Proprietary  ,0,5,5,15,54,69
00931308,DAYMAR COLLEGE -  SCOTTSVILLE           ,KY,42164-1505,Proprietary  ,0,0,0,6,56,62
00931309,DAYMAR COLLEGE - LOUISVILLE EAST        ,KY,40245-1629,Proprietary  ,3,26,29,43,263,306
00931310,DAYMAR COLLEGE -  MADISONVILLE          ,KY,42431-0000,Proprietary  ,5,21,26,25,146,171
01042400,SALON PROFESSIONAL ACADEMY THE          ,KY,40502-0000,Proprietary  ,18,66,84,150,422,572
01048901,NATIONAL COLLEGE - FLORENCE CAMPUS      ,KY,41042-1812,Proprietary  ,3,23,26,36,234,270
01048902,NATIONAL COLLEGE - PIKEVILLE CAMPUS     ,KY,41501-1518,Proprietary  ,9,36,45,163,513,676
01048903,NATIONAL COLLEGE - DANVILLE CAMPUS      ,KY,40422-1517,Proprietary  ,6,29,35,51,334,385
01048904,NATIONAL COLLEGE - RICHMOND CAMPUS      ,KY,40475-2309,Proprietary  ,4,42,46,53,375,428
01048906,NATIONAL COLLEGE - LOUISVILLE CAMPUS    ,KY,40216-4147,Proprietary  ,9,63,72,114,790,904
01048907,NATIONAL COLLEGE - LEXINGTON CAMPUS     ,KY,40509-2256,Proprietary  ,7,57,64,89,703,792
01172500,COLLINS SCHOOL OF COSMETOLOGY           ,KY,40965-2809,Proprietary  ,6,19,25,48,108,156
01208800,SULLIVAN COLLEGE OF TECHNOLOGY AND DESIG,KY,40218-4528,Proprietary  ,34,119,153,493,845,1338
01212801,SOUTHWESTERN COLLEGE                    ,KY,41042-1466,Proprietary  ,0,0,0,13,37,50
01272300,KY TECH-WAYNE COUNTY AREA TECH CTR      ,KY,42633-1088,Public       ,1,2,3,3,12,15
02159100,"APPALACHIAN BEAUTY SCHOOL, INC.         ",KY,41503-0000,Proprietary  ,3,12,15,34,59,93
02251500,TREND SETTERS ACAD OF BEAUTY CULT       ,KY,40258-0000,Proprietary  ,15,30,45,83,276,359
02275000,JENNY LEA ACADEMY OF COSMETOLOGY        ,KY,40831-0000,Proprietary  ,11,40,51,73,242,315
02284306,INTERACTIVE LEARNING SYSTEMS            ,KY,41042-0000,Proprietary  ,3,25,28,17,113,130
02323700,PAT WILSON'S BEAUTY COLLEGE             ,KY,42420-0000,Proprietary  ,1,15,16,18,96,114
02337200,PJ'S COLLEGE OF COSMETOLOGY             ,KY,42101-0000,Proprietary  ,9,58,67,110,464,574
02340800,PAUL MITCHELL THE SCHOOL LEXINGTON      ,KY,40514-1545,Proprietary  ,23,37,60,210,353,563
02351700,PAUL MITCHELL THE SCHOOL - LOUISVILLE   ,KY,40222-0000,Proprietary  ,24,46,70,239,391,630
02491100,BECKFIELD COLLEGE                       ,KY,41042-0000,Proprietary  ,37,291,328,362,2383,2745
02518900,BARRETT & COMPANY SCH HAIR DESIGN       ,KY,40356-0000,Proprietary  ,4,13,17,54,115,169
02526100,JENNY LEA ACADEMY OF COSMETOLOGY        ,KY,41858-0000,Proprietary  ,1,8,9,34,68,102
02535600,CLEAR CREEK BAPTIST BIBLE COLLEGE       ,KY,40977-0000,Private      ,2,12,14,44,157,201
02551100,PJ'S COLLEGE OF COSMETOLOGY             ,KY,42141-2434,Proprietary  ,1,18,19,40,112,152
02560800,SOUTHEAST SCHOOL OF COSMETOLOGY         ,KY,40962-0000,Proprietary  ,2,13,15,19,77,96
02576200,MID-CONTINENT UNIVERSITY                ,KY,42066-9007,Private      ,0,0,0,289,2341,2630
03002100,KENTUCKY MOUNTAIN BIBLE COLLEGE         ,KY,41385-0010,Private      ,3,2,5,51,41,92
03007000,FRONTIER SCH OF MIDWIFERY&FAMILY NU     ,KY,41749-0000,Private      ,0,329,329,13,1958,1971
03026200,HEAD'S WEST KENTUCKY BEAUTY COLLEGE     ,KY,42431-0000,Proprietary  ,4,9,13,28,85,113
03029200,NU-TEK ACADEMY OF BEAUTY                ,KY,40353-9767,Proprietary  ,0,8,8,14,44,58
03034500,OWENSBORO COMMUNITY & TECHNICAL COLLEGE ,KY,42303-1899,Public       ,79,276,355,1856,2964,4820
03083700,GALEN HEALTH INSTITUTES                 ,KY,40207-1047,Proprietary  ,79,641,720,921,6333,7254
03516500,EZELL'S COSMETOLOGY SCHOOL              ,KY,42071-2530,Proprietary  ,0,0,0,0,3,3
03611300,BRIGHTON CENTER'S CENTER FOR EMPLOY     ,KY,41071-1968,Private      ,2,32,34,12,96,108
03804300,BELLEFONTE ACADEMY OF BEAUTY            ,KY,41169-2015,Proprietary  ,4,46,50,44,207,251
03885300,EMPLOYMENT SOLUTIONS                    ,KY,40517-3260,Private      ,12,55,67,81,448,529
03886300,REGENCY SCHOOL OF HAIR DESIGN           ,KY,41653-1278,Proprietary  ,0,0,0,23,52,75
04038300,ATA CAREER EDUCATION                    ,KY,40223-3832,Proprietary  ,33,131,164,259,1130,1389
04038701,IDEAL BEAUTY ACADEMY - LOUISVILLE       ,KY,40223-5606,Proprietary  ,2,19,21,7,60,67
04051316,ART INSTITUTE OF PHOENIX (THE) - ATS - (,KY,41017-2136,Proprietary  ,10,45,55,98,473,571
04051319,ART INSTITUTE OF PHOENIX (THE) - BROWN M,KY,40219-1916,Proprietary  ,19,57,76,200,615,815
04051320,ART INSTITUTE OF PHOENIX (THE) - BROWN M,KY,42240-3579,Proprietary  ,4,32,36,62,299,361
04123900,LEXINGTON HEALING ARTS ACADEMY          ,KY,40503-1932,Proprietary  ,4,37,41,44,245,289
04177600,LINDSEY INSTITUTE OF COSMETOLOGY        ,KY,42103-8036,Proprietary  ,6,18,24,67,138,205
04177700,TRI-STATE INSTITUTE OF HAIR DESIGN      ,KY,40744-5234,Proprietary  ,1,24,25,35,139,174
04178000,SIMMONS COLLEGE OF KENTUCKY             ,KY,40203-3322,Private      ,4,29,33,69,290,359
04204800,AMERICAN COLLEGE OF BARBERING           ,KY,40229-2862,Proprietary  ,9,46,55,18,98,116
04229300,MEDQUEST COLLEGE                        ,KY,40243-1882,Proprietary  ,15,36,51,89,190,279
00200300,CENTENARY COLLEGE OF LOUISIANA          ,LA,71104-3396,Private      ,33,55,88,974,442,1416
00200400,DILLARD UNIVERSITY                      ,LA,70122-3097,Private      ,79,145,224,2825,1497,4322
00200500,NICHOLLS STATE UNIVERSITY               ,LA,70310-0001,Public       ,159,262,421,6131,3193,9324
00200600,GRAMBLING STATE UNIVERSITY              ,LA,71245-2215,Public       ,166,290,456,5502,4331,9833
00200700,LOUISIANA COLLEGE                       ,LA,71359-0000,Private      ,29,42,71,1282,766,2048
00200800,LOUISIANA TECH UNIVERSITY               ,LA,71272-0001,Public       ,248,287,535,8650,3521,12171
00201000,LOUISIANA STATE UNIV & A&M COLG         ,LA,70803-5710,Public       ,933,626,1559,28484,9306,37790
00201100,LOUISIANA STATE UNIV-ALEXANDRIA         ,LA,71302-9121,Public       ,120,213,333,2465,2241,4706
00201200,LOUISIANA STATE UNIV-EUNICE             ,LA,70535-6726,Public       ,128,202,330,2294,1993,4287
00201300,LOUISIANA STATE UNIV-SHREVEPORT         ,LA,71115-2399,Public       ,139,519,658,3090,4750,7840
00201400,LA STATE UNIV HEALTH SCIENCES CTR       ,LA,70112-2223,Public       ,20,138,158,715,2798,3513
00201500,(THE) UNIVERSITY OF NEW ORLEANS         ,LA,70148-0001,Public       ,318,726,1044,7606,7850,15456
00201600,LOYOLA UNIVERSITY NEW ORLEANS           ,LA,70118-6195,Private      ,179,232,411,5354,3154,8508
00201700,MCNEESE STATE UNIVERSITY                ,LA,70609-4510,Public       ,176,355,531,6051,4113,10164
00201900,NEW ORLEANS BAPTIST THEOL SEMINARY      ,LA,70126-0000,Private      ,1,48,49,66,307,373
00202000,UNIVERSITY OF LOUISIANA AT MONROE       ,LA,71209-9001,Public       ,214,429,643,7326,5124,12450
00202100,NORTHWESTERN STATE UNIVERSITY           ,LA,71497-0001,Public       ,229,549,778,6366,6256,12622
00202200,NOTRE DAME SEMINARY                     ,LA,70118-0000,Private      ,1,3,4,15,29,44
00202300,OUR LADY OF HOLY CROSS COLLEGE          ,LA,70131-7399,Private      ,24,143,167,697,1592,2289
00202400,SOUTHEASTERN LOUISIANA UNIV             ,LA,70402-0001,Public       ,411,527,938,12333,6049,18382
00202500,SOUTHERN UNIVERSITY A & M COLLEGE       ,LA,70813-9374,Public       ,263,469,732,8519,7587,16106
00202600,SOUTHERN UNIV NEW ORLEANS               ,LA,70126-0002,Public       ,108,431,539,2521,5166,7687
00202700,ST JOSEPH SEMINARY COLLEGE              ,LA,70457-9990,Private      ,3,3,6,71,29,100
00202900,TULANE UNIVERSITY                       ,LA,70118-5698,Private      ,536,490,1026,12458,7603,20061
00203100,UNIV OF LOUISIANA AT LAFAYETTE          ,LA,70504-0001,Public       ,539,651,1190,15821,7116,22937
00203200,XAVIER UNIVERSITY OF LOUISIANA          ,LA,70125-1098,Private      ,160,172,332,5056,2171,7227
00462100,AYERS CAREER COLLEGE                    ,LA,71108-5845,Proprietary  ,18,102,120,101,529,630
00462500,DELGADO COMMUNITY COLLEGE               ,LA,70119-0000,Public       ,656,2078,2734,9235,19188,28423
00546600,LOUISIANA TECHNICAL COLLEGE - T. H.  HAR,LA,70570-6113,Public       ,0,0,0,83,106,189
00546700,SOWELA TECHNICAL COMMUNITY COLLEGE      ,LA,70616-6950,Public       ,114,318,432,1774,2470,4244
00546702,SOWELA TECHNICAL COMMUNITY COLLEGE - MOR,LA,70546-1327,Public       ,8,24,32,97,199,296
00546800,LOUISIANA TECHNICAL COLLEGE - ACADIAN CA,LA,70526-3215,Public       ,0,0,0,19,45,64
00548000,"LOUISIANA TECHNICAL COLLEGE, HUEY P. LON",LA,71483-3599,Public       ,0,0,0,1,0,1
00548100,LOUISIANA TECHNICAL COLLEGE - HAMMOND AR,LA,70401-9501,Public       ,0,0,0,1,0,1
00548200,LOUISIANA TECHNICAL COLLEGE - GULF AREA ,LA,70510-0878,Public       ,0,0,0,32,66,98
00548400,LOUISIANA TECHNICAL COLLEGE - EVANGELINE,LA,70582-3104,Public       ,0,0,0,19,24,43
00548800,CAPITAL AREA TECHNICAL COLLEGE          ,LA,70807-0000,Public       ,16,98,114,418,990,1408
00548808,LOUISIANA TECHNICAL COLLEGE - CHARLES B.,LA,70586-0296,Public       ,0,0,0,27,36,63
00548812,LOUISIANA TECH COLG-FOLKES CAMPUS       ,LA,70748-0000,Public       ,2,12,14,34,57,91
00548817,LOUISIANA TEC CLG-JUMONVILLE MEM CP     ,LA,70760-0000,Public       ,4,5,9,25,55,80
00548818,LOUISIANA TECHNICAL COLLEGE - LAFAYETTE ,LA,70502-4909,Public       ,0,0,0,97,196,293
00548832,LOUISIANA TECH COLG-SHELBY JACKSON      ,LA,71334-0000,Public       ,0,0,0,1,1,2
00548839,LOUISIANA TECHNICAL COLLEGE - TECHE AREA,LA,70562-1057,Public       ,0,0,0,58,87,145
00548842,LOUISIANA TECHNICAL COLLEGE - WESTSIDE C,LA,70765-0733,Public       ,6,6,12,41,96,137
00548900,CENTRAL LOUISIANA TECHNICAL COLLEGE     ,LA,71302-3137,Public       ,44,204,248,595,1471,2066
00552600,SOUTH CENTRAL LOUISIANA TECHNICAL COLG  ,LA,70381-2148,Public       ,16,38,54,137,356,493
00552602,SOUTH CENTRAL LOUISIANA TECHNICAL COLG  ,LA,70302-4336,Public       ,14,31,45,123,202,325
00552603,SOUTH CENTRAL LOUISIANA TECHNICAL COLG  ,LA,70084-6632,Public       ,32,98,130,453,719,1172
00576100,L. E. FLETCHER TECHNICAL COMMUNITY COLLE,LA,70360-2863,Public       ,78,180,258,1292,1458,2750
00675600,NORTHSHORE TECHNICAL COLLEGE            ,LA,70427-5866,Public       ,81,182,263,910,1429,2339
00768600,SOUTHERN UNIV AT SHREVEPORT/BOSSIER     ,LA,71107-4795,Public       ,81,311,392,1959,3405,5364
00806700,LSU HEALTH SCIENCES CENTR-SHREVEPOR     ,LA,71130-3932,Public       ,28,70,98,354,1209,1563
00989800,DEMMON SCHOOL OF BEAUTY                 ,LA,70607-2128,Proprietary  ,3,14,17,36,104,140
00997500,NORTHWEST LOUISIANA TECHNICAL COLLEGE   ,LA,71055-2422,Public       ,24,46,70,297,514,811
00997503,NORTHWEST LOUISIANA TECHNICAL COLLEGE   ,LA,71137-8527,Public       ,31,157,188,386,1273,1659
00997504,NORTHWEST LOUISIANA TECHNICAL COLLEGE   ,LA,71052-1236,Public       ,4,30,34,92,212,304
00997505,NORTHWEST LOUISIANA TECHNICAL COLLEGE   ,LA,71449-0790,Public       ,2,15,17,53,114,167
00997506,NORTHWEST LOUISIANA TECHNICAL COLLEGE   ,LA,71458-0657,Public       ,16,48,64,199,346,545
01109700,CLOYD'S BEAUTY SCHOOL #1                ,LA,71291-3131,Proprietary  ,2,23,25,40,145,185
01163100,"D-JAY'S SCHL OF BEAUTY, ARTS & SCI      ",LA,70806-0000,Proprietary  ,5,19,24,53,127,180
01184100,JOHN JAY BEAUTY COLLEGE                 ,LA,70124-2592,Proprietary  ,9,37,46,112,263,375
01282300,PAT GOINS RUSTON BEAUTY SCHOOL          ,LA,71270-4301,Proprietary  ,3,14,17,31,64,95
01287900,PAT GOINS BENTON ROAD BEAUTY SCHOOL     ,LA,71111-4838,Proprietary  ,3,8,11,26,99,125
01288000,CELEBRITY STYLIST BEAUTY SCHOOL         ,LA,71201-5167,Proprietary  ,4,27,31,41,108,149
02055400,BOSSIER PARISH COMMUNITY COLLEGE        ,LA,71111-0000,Public       ,220,725,945,4002,6987,10989
02055500,DELTA SCH OF BUSINESS & TECHNOLOGY      ,LA,70601-0000,Proprietary  ,14,57,71,159,421,580
02117800,AVEDA INSTITUTE LAFAYETTE               ,LA,70503-3246,Proprietary  ,14,42,56,166,264,430
02166100,NUNEZ COMMUNITY COLLEGE                 ,LA,70043-0000,Public       ,52,198,250,882,2135,3017
02166200,ITI TECHNICAL COLLEGE                   ,LA,70817-0000,Proprietary  ,65,156,221,570,1017,1587
02197500,BATON ROUGE SCHOOL OF COMPUTERS         ,LA,70809-8188,Proprietary  ,7,34,41,80,194,274
02234000,CAMERON COLLEGE                         ,LA,70119-0000,Proprietary  ,14,79,93,114,435,549
02258400,AVEDA INSTITUTE BATON ROUGE             ,LA,70816-2246,Proprietary  ,20,44,64,224,347,571
02260200,DIESEL DRIVING ACADEMY                  ,LA,71109-5617,Proprietary  ,19,130,149,74,540,614
02265600,JOHN JAY KENNER ACADEMY                 ,LA,70062-0000,Proprietary  ,6,17,23,46,147,193
02269300,STEVENSON'S ACADEMY OF HAIR DESIGN      ,LA,70116-0000,Proprietary  ,5,29,34,87,249,336
02327800,PINEVILLE BEAUTY SCHOOL                 ,LA,71360-0000,Proprietary  ,5,13,18,59,122,181
02335700,BATON ROUGE GENERAL MEDICAL CENTER      ,LA,70806-3889,Private      ,7,36,43,136,240,376
02335701,BATON ROUGE GEN MED CTR SCH NSG         ,LA,70821-0000,Private      ,8,44,52,139,369,508
02335702,BATON ROUGE GEN MED CTR-RAD TECH        ,LA,70806-0000,Private      ,5,31,36,90,206,296
02338000,"CLOYD'S BEAUTY SCHOOL #2, INC           ",LA,71202-3539,Proprietary  ,4,29,33,67,145,212
02352500,"CLOYD'S BEAUTY SCHOOL #3, INC           ",LA,71201-3211,Proprietary  ,2,18,20,54,132,186
02358600,"STAGE ONE THE HAIR SCHOOL, INC.         ",LA,70605-0000,Proprietary  ,10,24,34,101,170,271
02518300,SOUTH LOUISIANA BEAUTY COLLEGE          ,LA,70363-0000,Proprietary  ,2,12,14,41,77,118
02536400,LOUISIANA ACADEMY OF BEAUTY             ,LA,70535-0000,Proprietary  ,1,9,10,35,78,113
02538300,DELTA COLLEGE OF ARTS & TECH INC        ,LA,70806-1529,Proprietary  ,26,89,115,293,785,1078
02538301,DELTA COLLEGE OF ARTS & TECHNOLOGY - LAF,LA,70508-6831,Proprietary  ,14,63,77,158,502,660
02548500,COSMETOLOGY TRAINING CENTER             ,LA,70503-0000,Proprietary  ,16,29,45,121,147,268
02554800,VANGUARD COLLEGE OF COSMETOLOGY         ,LA,70458-8823,Proprietary  ,20,45,65,217,292,509
02582200,"GUY'S ACADEMY HAIR, SKIN & NAILS        ",LA,71105-2404,Proprietary  ,6,14,20,64,147,211
02600900,AVEDA INSTITUTE                         ,LA,70433-2922,Proprietary  ,195,313,508,1281,1959,3240
02601000,AMERICAN SCHOOL OF BUSINESS             ,LA,71105-5646,Proprietary  ,11,61,72,44,231,275
02601100,OPELOUSAS SCHOOL OF COSMETOLOGY         ,LA,70570-6156,Proprietary  ,2,7,9,35,59,94
02619200,DENHAM SPRINGS BEAUTY COLLEGE           ,LA,70726-3829,Proprietary  ,3,24,27,43,107,150
03010400,CRESCENT CITY SCH GAMING & BARTENDG     ,LA,70119-5507,Proprietary  ,13,183,196,100,889,989
03010624,VIRGINIA COLLEGE - BATON ROUGE          ,LA,70815-8604,Proprietary  ,11,60,71,171,558,729
03023500,CAMELOT CAREER COLLEGE                  ,LA,70805-7539,Proprietary  ,11,59,70,112,376,488
03026514,REMINGTON COLLEGE - LAFAYETTE           ,LA,70508-5760,Private      ,12,60,72,167,384,551
03026515,REMINGTON COLLEGE - BATON ROUGE         ,LA,70816-4040,Private      ,11,44,55,165,351,516
03027300,BLALOCK'S PROFESSIONAL BEAUTY COLLEGE   ,LA,71108-3246,Proprietary  ,1,12,13,22,80,102
03030900,DIESEL DRIVING ACADEMY                  ,LA,70815-8109,Proprietary  ,18,140,158,92,633,725
03106200,OUR LADY OF THE LAKE COLLEGE            ,LA,70808-4345,Private      ,34,208,242,1210,2126,3336
03294300,BLUE CLIFF SCH THERAPEUTIC MASSAGE      ,LA,70002-3458,Proprietary  ,104,496,600,698,3103,3801
03294303,BLUE CLIFF COLLEGE - LAFAYETTE          ,LA,70508-3256,Proprietary  ,16,51,67,126,392,518
03294306,BLUE CLIFF COLLEGE - SHREVEPORT         ,LA,71105-6520,Proprietary  ,13,100,113,104,451,555
03332600,DELTA COLLEGE                           ,LA,70433-9042,Proprietary  ,16,67,83,169,440,609
03332601,DELTA COLLEGE - SLIDELL                 ,LA,70460-2624,Proprietary  ,22,96,118,184,620,804
03356300,MEDICAL TRAINING COLLEGE                ,LA,70816-5820,Proprietary  ,15,73,88,204,466,670
03480300,MEDVANCE INSTITUTE                      ,LA,70809-1908,Proprietary  ,19,70,89,149,523,672
03498400,OMEGA INSTITUTE OF COSMETOLOGY          ,LA,70360-0000,Proprietary  ,3,9,12,62,71,133
03727500,MOORE CAREER COLLEGE                    ,LA,70808-4191,Proprietary  ,2,26,28,32,141,173
03730300,BATON ROUGE COMMUNITY COLLEGE           ,LA,78806-4129,Public       ,364,827,1191,6739,7818,14557
03789300,UNITECH TRAINING ACADEMY                ,LA,70503-5132,Proprietary  ,36,129,165,263,879,1142
03789301,UNITECH TRAINING ACADEMY - WEST MONROE  ,LA,71291-2913,Proprietary  ,9,90,99,122,639,761
03789302,UNITECH TRAINING ACADEMY - HOUMA        ,LA,70363-5556,Proprietary  ,19,38,57,107,257,364
03789303,UNITECH TRAINING ACADEMY -  ALEXANDRIA  ,LA,71303-3625,Proprietary  ,23,53,76,122,397,519
03789304,UNITECH TRAINING ACADEMY - LAKE CHARLES ,LA,70601-7887,Proprietary  ,22,68,90,146,418,564
03789400,RIVER PARISHES COMMUNITY COLLEGE        ,LA,70778-0310,Public       ,82,164,246,1098,1197,2295
03795300,CASSIA BEAUTY COLLEGE                   ,LA,70126-0000,Proprietary  ,3,10,13,46,78,124
03810500,COURT REPORTING INSTITUTE OF LOUISI     ,LA,70816-0000,Proprietary  ,2,12,14,14,88,102
03956300,SOUTH LOUISIANA COMMUNITY COLLEGE       ,LA,70506-0000,Public       ,314,679,993,3771,4532,8303
04040300,COMPASS CAREER COLLEGE                  ,LA,70403-0653,Proprietary  ,34,74,108,211,467,678
04112300,LOUISIANA CULINARY INSTITUTE            ,LA,70816-4109,Proprietary  ,22,40,62,275,380,655
04130100,LOUISIANA DELTA COMMUNITY COLLEGE       ,LA,71203-3618,Public       ,124,475,599,2172,3858,6030
04149500,A & W HEALTHCARE EDUCATORS              ,LA,70122-3146,Proprietary  ,10,45,55,68,429,497
04151600,MY-LE'S BEAUTY COLLEGE                  ,LA,70056-3150,Proprietary  ,9,36,45,28,133,161
04217000,HEALTHCARE TRAINING INSTITUTE           ,LA,70062-7630,Proprietary  ,2,29,31,36,199,235
04225900,SETTING THE STANDARD BARBERING AND NATUR,LA,71109-4124,Proprietary  ,2,7,9,8,56,64
04226000,BOS-MAN'S BARBER COLLEGE                ,LA,71106-2653,Proprietary  ,4,19,23,21,103,124
04234600,PARK PLACE PREMIER BARBER SCHOOL        ,LA,70122-3808,Proprietary  ,3,15,18,24,69,93
00143600,CAPITOL COLLEGE                         ,MD,20708-9759,Private      ,11,71,82,475,600,1075
00205700,ALLEGANY COLLEGE OF MARYLAND            ,MD,21502-2596,Public       ,90,185,275,2700,2196,4896
00205800,ANNE ARUNDEL COMMUNITY COLLEGE          ,MD,21012-1895,Public       ,292,887,1179,5524,9130,14654
00206100,BALTIMORE CITY COMMUNITY COLLEGE        ,MD,21215-7893,Public       ,213,989,1202,4042,10789,14831
00206200,BOWIE STATE UNIVERSITY                  ,MD,20715-9465,Public       ,237,401,638,7976,6653,14629
00206300,COMMUNITY COLLEGE OF BALTIMORE COUNTY   ,MD,21228-5381,Public       ,426,1567,1993,10546,18209,28755
00206400,COLLEGE OF SOUTHERN MARYLAND            ,MD,20646-0910,Public       ,217,625,842,4133,5626,9759
00206500,NOTRE DAME OF MARYLAND UNIVERSITY       ,MD,21210-2476,Private      ,37,136,173,1165,2228,3393
00206700,WASHINGTON ADVENTIST UNIVERSITY         ,MD,20912-7796,Private      ,16,68,84,943,1095,2038
00206800,COPPIN STATE UNIVERSITY                 ,MD,21216-3698,Public       ,130,390,520,4163,6052,10215
00207100,FREDERICK COMMUNITY COLLEGE             ,MD,21702-9745,Public       ,113,325,438,2429,3218,5647
00207200,FROSTBURG STATE UNIVERSITY              ,MD,21532-1099,Public       ,172,135,307,7033,2054,9087
00207300,GOUCHER COLLEGE                         ,MD,21204-2794,Private      ,88,91,179,3228,1066,4294
00207400,HAGERSTOWN COMMUNITY COLLEGE            ,MD,21742-6514,Public       ,128,370,498,2244,3377,5621
00207500,HARFORD COMMUNITY COLLEGE               ,MD,21015-1696,Public       ,144,300,444,2744,3219,5963
00207600,HOOD COLLEGE                            ,MD,21701-8575,Private      ,55,67,122,2272,973,3245
00207700,JOHNS HOPKINS UNIVERSITY                ,MD,21218-2693,Private      ,372,231,603,10691,2688,13379
00207702,JOHNS HOPKINS UNIV SCH ARTS/SCI/ENG     ,MD,21218-0000,Private      ,107,315,422,5028,2574,7602
00207703,JOHNS HOPKINS UNIV SCH OF BUS/ED        ,MD,21046-0000,Private      ,4,102,106,82,1369,1451
00207705,JOHNS HOPKINS BLOOMBERG SCH OF PH       ,MD,21205-0000,Private      ,6,87,93,88,1846,1934
00207706,JOHNS HOPKINS UNIV SCH OF MEDICINE      ,MD,21205-0000,Private      ,57,64,121,402,1174,1576
00207707,JOHNS HOPKINS UNIV SCH OF NURSING       ,MD,21205-0000,Private      ,32,115,147,413,1702,2115
00207708,JOHNS HOPKINS UNIV PEABODY CONSERV      ,MD,21202-2397,Private      ,25,16,41,528,460,988
00207764,JOHNS HOPKINS UNIVERSITY - CAREY BUSINES,MD,21202-4649,Private      ,7,78,85,79,861,940
00207800,LOYOLA UNIVERSITY MARYLAND              ,MD,21210-2699,Private      ,244,208,452,10175,3025,13200
00208000,MARYLAND INST COLLEGE OF ART            ,MD,21217-4191,Private      ,110,65,175,2913,1052,3965
00208300,MORGAN STATE UNIVERSITY                 ,MD,21251-0002,Public       ,311,460,771,10671,7663,18334
00208600,MOUNT SAINT MARY'S UNIVERSITY           ,MD,21727-7799,Private      ,87,45,132,4150,530,4680
00208700,NER ISRAEL RABBINICAL COLLEGE           ,MD,21208-1198,Private      ,3,12,15,104,48,152
00208900,PRINCE GEORGES COMMUNITY COLLEGE        ,MD,20774-2199,Public       ,404,1168,1572,7704,12980,20684
00209100,SALISBURY UNIVERSITY                    ,MD,21801-6862,Public       ,333,200,533,11897,2772,14669
00209200,ST JOHN'S COLLEGE                       ,MD,21404-0000,Private      ,16,25,41,568,205,773
00209500,ST. MARY'S COLLEGE OF MARYLAND          ,MD,20686-3001,Public       ,78,37,115,2683,393,3076
00209600,ST MARY'S SEMINARY & UNIV               ,MD,21210-1994,Private      ,3,11,14,32,78,110
00209900,TOWSON UNIVERSITY                       ,MD,21252-0002,Public       ,756,553,1309,26686,9826,36512
00210200,UNIVERSITY OF BALTIMORE                 ,MD,21201-5779,Public       ,87,462,549,2476,8125,10601
00210300,"UNIVERSITY OF MARYLAND, COLLEGE PARK    ",MD,20742-5145,Public       ,1036,961,1997,35173,15219,50392
00210400,"UNIVERSITY OF MARYLAND, BALTIMORE       ",MD,21201-1691,Public       ,237,626,863,5171,11850,17021
00210500,UMBC                                    ,MD,21250-0002,Public       ,330,406,736,11513,6827,18340
00210600,UNIVERSITY MARYLAND EASTERN SHORE       ,MD,21853-4053,Public       ,155,162,317,5949,2622,8571
00210700,STEVENSON UNIVERSITY                    ,MD,21153-0641,Private      ,170,151,321,6509,2377,8886
00210800,WASHINGTON COLLEGE                      ,MD,21620-1197,Private      ,62,17,79,2571,157,2728
00210900,MCDANIEL COLLEGE                        ,MD,21157-4390,Private      ,79,57,136,3372,762,4134
00458612,KAPLAN COLLEGE                          ,MD,21742-2797,Proprietary  ,14,251,265,237,2092,2329
00465000,CHESAPEAKE COLLEGE                      ,MD,21679-0008,Public       ,65,205,270,1338,1665,3003
00691100,MONTGOMERY COLLEGE                      ,MD,20850-1195,Public       ,590,1173,1763,12925,13144,26069
00734100,INTERNATIONAL BEAUTY SCHOOL             ,MD,21502-2370,Proprietary  ,0,44,44,17,142,159
00744700,DEL-MAR-VA BEAUTY ACADEMY               ,MD,21804-0000,Proprietary  ,6,22,28,63,154,217
00749100,TESST COLLEGE OF TECHNOLOGY             ,MD,21227-1063,Proprietary  ,43,177,220,431,1449,1880
00793600,LINCOLN TECHNICAL INSTITUTE             ,MD,21046-1544,Proprietary  ,48,122,170,601,878,1479
00817500,HOWARD COMMUNITY COLLEGE                ,MD,21044-3197,Public       ,228,502,730,4398,5447,9845
00826300,AWARD BEAUTY SCHOOL                     ,MD,21740-5624,Proprietary  ,6,69,75,56,368,424
00830800,CECIL COLLEGE                           ,MD,21901-1999,Public       ,87,175,262,1288,1605,2893
00907906,EVEREST COLLEGE- EVEREST INSTITUTE      ,MD,20910-3737,Proprietary  ,19,70,89,230,714,944
01001400,GARRETT COMMUNITY COLLEGE               ,MD,21541-1265,Public       ,28,34,62,937,367,1304
01031900,FORTIS INSTITUTE                        ,MD,21204-2538,Proprietary  ,53,286,339,646,2704,3350
01041000,TESST COLLEGE OF TECHNOLOGY             ,MD,21286-2201,Proprietary  ,23,92,115,208,636,844
01164400,UNIV OF MARYLAND UNIVERSITY COLLEGE     ,MD,20783-8078,Public       ,241,4711,4952,3171,41961,45132
01164402,U OF MD UNIVERSITY COLLEGE - EUROPE     ,MD,20832-0000,Public       ,16,112,128,331,908,1239
01164404,U OF MD UNIVERSITY COLLEGE - ASIA       ,MD,31207-0000,Public       ,10,146,156,112,1134,1246
02073900,WOR-WIC COMMUNITY COLLEGE               ,MD,21804-0000,Public       ,94,336,430,1644,2766,4410
02083600,TESST COLLEGE OF TECHNOLOGY             ,MD,20705-2698,Proprietary  ,22,82,104,226,644,870
02127900,SOJOURNER DOUGLASS COLLEGE              ,MD,21205-0000,Private      ,14,224,238,254,2657,2911
02155100,MARYLAND COLLEGE OF ART AND DESIGN      ,MD,20902-0000,Private      ,12,23,35,166,208,374
02269700,"COLORLAB ACADEMY OF HAIR, THE           ",MD,21014-3639,Proprietary  ,9,16,25,49,90,139
02331000,MARYLAND BEAUTY ACADEMY OF ESSEX        ,MD,21221-0000,Proprietary  ,15,36,51,109,268,377
02333000,HAIR ACADEMY                            ,MD,20784-0000,Proprietary  ,32,108,140,167,597,764
02343800,MONTGOMERY BEAUTY SCHOOL                ,MD,20901-0000,Proprietary  ,16,63,79,98,275,373
02494700,BALTIMORE STUDIO OF HAIR DESIGN         ,MD,21201-0000,Proprietary  ,6,47,53,112,356,468
02495000,ROBERT PAUL ACAD COSMTGY ARTS & SCI     ,MD,21093-0000,Proprietary  ,12,15,27,62,84,146
02495100,MARYLAND BEAUTY ACADEMY                 ,MD,21136-0000,Proprietary  ,3,5,8,29,86,115
02545400,NORTH AMERICAN TRADE SCHOOLS            ,MD,21244-0069,Proprietary  ,38,262,300,240,1220,1460
02573800,"L' ACADEMIE DE CUISINE, INC.            ",MD,20877-0000,Proprietary  ,13,42,55,92,279,371
02578400,MARYLAND UNIVERSITY OF INTEGRATIVE HEALT,MD,20723-6010,Private      ,6,219,225,33,795,828
03027200,BLADES SCHOOL OF HAIR DESIGN            ,MD,20619-0226,Proprietary  ,12,22,34,36,129,165
03064900,AARON'S ACADEMY OF BEAUTY               ,MD,20602-2715,Proprietary  ,8,16,24,55,125,180
03097200,AESTHETICS INSTITUTE OF COSMETOLOGY     ,MD,20877-1305,Proprietary  ,8,29,37,41,135,176
03100700,CARROLL COMMUNITY COLLEGE               ,MD,21157-6913,Public       ,66,156,222,1429,1583,3012
03148300,AMERICAN BEAUTY ACADEMY                 ,MD,20902-1911,Proprietary  ,61,177,238,316,786,1102
03296300,BALTIMORE SCHOOL OF MASSAGE             ,MD,21090-2261,Proprietary  ,28,160,188,171,627,798
03327300,NEW CREATIONS ACADEMY OF HAIR DSN       ,MD,20746-0000,Proprietary  ,9,33,42,50,163,213
03455500,NATIONAL LABOR COLLEGE                  ,MD,20903-1790,Private      ,0,0,0,5,51,56
03493300,ALL-STATE CAREER SCHOOL                 ,MD,21224-6658,Proprietary  ,84,431,515,487,2165,2652
03667300,FAITH THEOLOGICAL SEMINARY              ,MD,21212-2624,Private      ,0,13,13,5,169,174
03822400,MAPLE SPRINGS BAPTIST BIBLE COLLEGE & SE,MD,20743-5711,Private      ,0,8,8,7,59,66
03937300,YESHIVA COLLEGE OF THE NATION'S CAPITAL ,MD,20902-1700,Private      ,3,3,6,15,36,51
03965500,HAIR EXPRESSIONS ACADEMY                ,MD,20852-1729,Proprietary  ,37,42,79,157,247,404
04121600,FILA ACADEMY (THE)                      ,MD,21061-1634,Proprietary  ,0,0,0,14,35,49
04139700,FREDERICK SCHOOL OF COSMETOLOGY         ,MD,21701-0000,Proprietary  ,3,9,12,40,81,121
04141600,OMEGA STUDIOS' SCHOOL OF APPLIED RECORDI,MD,20852-1731,Proprietary  ,17,33,50,91,187,278
04151800,TEMPLE (THE): A PAUL MITCHELL PARTNER SC,MD,21701-5409,Proprietary  ,15,26,41,143,194,337
04167602,FINGER LAKES SCHOOL OF MASSAGE (THE)    ,MD,21701-3030,Proprietary  ,2,31,33,21,114,135
04168900,HOLISTIC MASSAGE TRAINING INSTITUTE     ,MD,21218-2407,Proprietary  ,3,21,24,30,173,203
04171501,COSMOPOLITAN BEAUTY & TECH SCHOOL -     ,MD,20143-3370,Proprietary  ,1,4,5,21,68,89
04188400,BAIS HAMEDRASH AND MESIVTA OF BALTIMORE ,MD,21209-1613,Private      ,2,0,2,39,15,54
04204000,ASPEN BEAUTY ACADEMY - LAUREL           ,MD,20724-2013,Proprietary  ,9,28,37,43,144,187
04209600,INSTITUTE OF HEALTH SCIENCES            ,MD,21031-1408,Proprietary  ,3,37,40,31,232,263
04211700,HARMON'S BEAUTY SCHOOL                  ,MD,20785-2135,Proprietary  ,3,14,17,28,78,106
00211400,AMERICAN INTERNATIONAL COLLEGE          ,MA,01109-3189,Private      ,52,281,333,2221,3229,5450
00211500,AMHERST COLLEGE                         ,MA,01002-5000,Private      ,119,27,146,4708,387,5095
00211600,ANDOVER NEWTON THEOLOGICAL SCHOOL       ,MA,02459-0000,Private      ,0,9,9,3,196,199
00211700,ANNA MARIA COLLEGE                      ,MA,01612-1198,Private      ,43,77,120,1841,797,2638
00211800,ASSUMPTION COLLEGE                      ,MA,01615-1294,Private      ,93,52,145,4705,972,5677
00212000,MERRIMACK COLLEGE                       ,MA,01845-5800,Private      ,147,43,190,6737,690,7427
00212100,BABSON COLLEGE                          ,MA,02457-0310,Private      ,148,56,204,2964,642,3606
00212200,BAY PATH COLLEGE                        ,MA,01106-2212,Private      ,27,231,258,1007,2792,3799
00212300,BECKER COLLEGE-WORCESTER                ,MA,01615-0071,Private      ,93,81,174,2888,1224,4112
00212400,BENTLEY UNIVERSITY                      ,MA,02452-4705,Private      ,222,65,287,6330,802,7132
00212600,BERKLEE COLLEGE OF MUSIC                ,MA,02215-3693,Private      ,204,228,432,4745,1973,6718
00212800,BOSTON COLLEGE                          ,MA,02467-3800,Private      ,602,236,838,16570,5544,22114
00212900,BOSTON CONSERVATORY OF MUSIC            ,MA,02215-9830,Private      ,41,16,57,1123,376,1499
00213000,BOSTON UNIVERSITY                       ,MA,02215-1789,Private      ,1250,914,2164,38684,17155,55839
00213300,BRANDEIS UNIVERSITY                     ,MA,02453-2700,Private      ,162,67,229,6506,1529,8035
00213900,CLARK UNIVERSITY                        ,MA,01610-1473,Private      ,106,45,151,4771,872,5643
00214000,ELMS COLLEGE                            ,MA,01013-2839,Private      ,24,57,81,1447,1211,2658
00214100,COLLEGE OF THE HOLY CROSS               ,MA,01610-2395,Private      ,124,11,135,4989,180,5169
00214300,CURRY COLLEGE                           ,MA,02186-2395,Private      ,109,109,218,5393,1572,6965
00214400,DEAN COLLEGE                            ,MA,02038-1994,Private      ,41,20,61,1954,343,2297
00214500,EASTERN NAZARENE COLLEGE                ,MA,02170-2999,Private      ,14,35,49,907,744,1651
00214507,EASTERN NAZARENE CLG - LEAD PROGRAM     ,MA,02170-0000,Private      ,1,17,18,47,365,412
00214600,EMERSON COLLEGE                         ,MA,02116-4624,Private      ,254,67,321,7882,1536,9418
00214700,EMMANUEL COLLEGE                        ,MA,02115-5798,Private      ,104,56,160,4997,506,5503
00214800,ENDICOTT COLLEGE                        ,MA,01915-2098,Private      ,141,107,248,5096,1041,6137
00214900,EPISCOPAL DIVINITY SCHOOL               ,MA,02138-0000,Private      ,0,4,4,0,74,74
00215000,FISHER COLLEGE                          ,MA,02116-1500,Private      ,51,192,243,1668,1638,3306
00215100,BENJAMIN FRANKLIN INSTITUTE OF TECH     ,MA,02116-6296,Public       ,28,72,100,592,478,1070
00215300,GORDON COLLEGE                          ,MA,01984-1899,Private      ,43,15,58,2355,236,2591
00215400,HELLENIC COLLEGE                        ,MA,02445-7496,Private      ,3,9,12,64,116,180
00215500,HARVARD UNIVERSITY                      ,MA,02138-3800,Private      ,148,95,243,4381,1047,5428
00215501,AMRCN REPERTORY THTR INST ADV THTR      ,MA,02138-0000,Private      ,1,2,3,6,113,119
00215502,HARVARD BUSINESS SCHOOL                 ,MA,02163-0000,Private      ,28,74,102,241,1642,1883
00215503,HARVARD EXTENSION SCHOOL                ,MA,02138-0000,Private      ,6,208,214,158,1770,1928
00215504,HARVARD SCH OF DENTAL MEDICINE          ,MA,02115-0000,Private      ,4,11,15,29,208,237
00215505,HARVARD UNIV GRAD SCH DESIGN            ,MA,02138-0000,Private      ,1,16,17,22,1046,1068
00215506,HARVARD DIVINITY SCHOOL                 ,MA,02138-0000,Private      ,2,18,20,19,585,604
00215507,HARVARD UNIV GRAD SCH ED                ,MA,02138-0000,Private      ,1,39,40,7,1239,1246
00215508,HARVARD UNIV GRAD S OF ARTS & SCIEN     ,MA,02138-0000,Private      ,6,44,50,59,820,879
00215509,HARVARD KENNEDY SCHOOL                  ,MA,02138-0000,Private      ,1,34,35,13,1222,1235
00215510,HARVARD LAW SCHOOL                      ,MA,02138-0000,Private      ,12,69,81,124,3191,3315
00215511,HARVARD UNIV MEDICAL SCHOOL             ,MA,02115-0000,Private      ,28,22,50,196,1098,1294
00215512,HARVARD UNIV SCH PUBLIC HEALTH          ,MA,02115-0000,Private      ,4,31,35,41,1109,1150
00215513,HARVARD UNIVERSITY-HARVARD COLLEGE      ,MA,02138-0000,Private      ,577,98,675,19066,1397,20463
00215700,HEBREW COLLEGE                          ,MA,02459-2237,Private      ,0,2,2,2,104,106
00215800,LASELL COLLEGE                          ,MA,02466-2716,Private      ,60,49,109,3153,559,3712
00216000,LESLEY UNIVERSITY                       ,MA,02138-2790,Private      ,70,240,310,2993,3366,6359
00216100,UMASS LOWELL                            ,MA,01854-3089,Public       ,443,570,1013,15453,7088,22541
00216400,NEW ENGLAND COLLEGE OF OPTOMETRY        ,MA,02115-1129,Private      ,2,7,9,13,442,455
00216500,MASS. COLLEGE OF PHARMACY  & HEALTH SCIE,MA,02115-5804,Private      ,124,155,279,5813,4477,10290
00216700,BERKSHIRE COMMUNITY COLLEGE             ,MA,01201-5786,Public       ,38,119,157,979,1492,2471
00216800,CAPE COD COMMUNITY COLLEGE              ,MA,02668-1599,Public       ,105,280,385,1584,2466,4050
00216900,GREENFIELD COMMUNITY COLLEGE            ,MA,01301-9739,Public       ,55,146,201,902,1613,2515
00217000,HOLYOKE COMMUNITY COLLEGE               ,MA,01040-1099,Public       ,186,460,646,3995,4872,8867
00217100,MASSACHUSETTS BAY COMMUNITY COLLEGE     ,MA,02181-0000,Public       ,134,299,433,2382,3041,5423
00217200,MOUNT WACHUSETT COMMUNITY COLLEGE       ,MA,01440-1000,Public       ,112,302,414,2128,3474,5602
00217300,NORTH SHORE COMMUNITY COLLEGE           ,MA,01923-4093,Public       ,237,508,745,3559,4888,8447
00217400,NORTHERN ESSEX COMMUNITY COLLEGE        ,MA,01830-2399,Public       ,197,473,670,3646,4577,8223
00217500,QUINSIGAMOND COMMUNITY COLLEGE          ,MA,01606-2092,Public       ,233,602,835,4575,6705,11280
00217600,BRISTOL COMMUNITY COLLEGE               ,MA,02720-7399,Public       ,229,611,840,4822,6336,11158
00217700,MASSASOIT COMMUNITY COLLEGE             ,MA,02302-3996,Public       ,245,474,719,3933,4959,8892
00217800,MASSACHUSETTS INST OF TECHNOLOGY        ,MA,02139-4307,Private      ,454,276,730,12728,3102,15830
00218000,MASSACHUSETTS COLLEGE OF ART AND DESIGN ,MA,02115-5803,Public       ,75,52,127,2592,899,3491
00218100,MASSACHUSETTS MARITIME ACADEMY          ,MA,02532-3400,Public       ,27,13,40,1674,185,1859
00218300,BRIDGEWATER STATE UNIVERSITY            ,MA,02325-0001,Public       ,306,262,568,12331,4274,16605
00218400,FITCHBURG STATE UNIVERSITY              ,MA,01420-2697,Public       ,159,137,296,6699,1955,8654
00218500,FRAMINGHAM STATE COLLEGE                ,MA,01702-2471,Public       ,168,132,300,7469,1861,9330
00218700,MASSACHUSETTS CLG OF LIBERAL ARTS       ,MA,01247-4100,Public       ,50,28,78,2609,589,3198
00218800,SALEM STATE UNIVERSITY                  ,MA,01970-5353,Public       ,276,309,585,9528,4611,14139
00218900,WESTFIELD STATE UNIVERSITY              ,MA,01086-1630,Public       ,169,140,309,8472,2203,10675
00219000,WORCESTER STATE COLLEGE                 ,MA,01602-2597,Public       ,156,205,361,6815,2878,9693
00219200,MOUNT HOLYOKE COLLEGE                   ,MA,01075-1492,Private      ,74,19,93,2513,354,2867
00219300,MOUNT IDA COLLEGE                       ,MA,02459-3323,Private      ,43,26,69,1908,457,2365
00219400,NEW ENGLAND CONSERVATORY OF MUSIC       ,MA,02115-5018,Private      ,30,14,44,743,597,1340
00219700,NICHOLS COLLEGE                         ,MA,01571-6346,Private      ,36,38,74,2345,444,2789
00219900,NORTHEASTERN UNIVERSITY                 ,MA,02115-5000,Private      ,950,950,1900,34894,13376,48270
00220100,PINE MANOR COLLEGE                      ,MA,02167-0000,Private      ,10,5,15,432,161,593
00220200,BLESSED JOHN XXIII NATIONAL SEMINARY    ,MA,02493-0000,Private      ,0,0,0,0,3,3
00220500,QUINCY COLLEGE                          ,MA,02169-4324,Public       ,139,468,607,2081,4553,6634
00220600,REGIS COLLEGE                           ,MA,02193-0000,Private      ,46,72,118,2201,1048,3249
00220800,SIMMONS COLLEGE                         ,MA,02115-5898,Private      ,83,491,574,3220,5186,8406
00220900,SMITH COLLEGE                           ,MA,01063-2936,Private      ,106,17,123,3737,520,4257
00220901,"SMITH COLLEGE, SCH FOR SOCIAL WORK      ",MA,01063-0000,Private      ,1,18,19,12,520,532
00221000,UNIV OF MASSACHUSETTS-DARTMOUTH         ,MA,02747-2300,Public       ,250,215,465,12359,4030,16389
00221100,SPRINGFIELD COLLEGE                     ,MA,01109-3797,Private      ,115,368,483,4019,4522,8541
00221400,ST JOHN'S SEMINARY                      ,MA,02135-8839,Private      ,5,9,14,8,43,51
00221700,STONEHILL COLLEGE                       ,MA,02357-6110,Private      ,132,16,148,5875,216,6091
00221800,SUFFOLK UNIVERSITY                      ,MA,02108-2770,Private      ,173,174,347,8519,4377,12896
00221900,TUFTS UNIVERSITY                        ,MA,02155-5808,Private      ,258,141,399,11403,2372,13775
00221901,TUFTS UNIV SCH OF DENTAL MEDICINE       ,MA,02111-0000,Private      ,2,24,26,36,902,938
00221902,TUFTS UNIVERSITY - CUMMINGS SCHOOL OF VE,MA,01536-0000,Private      ,4,3,7,36,487,523
00221904,TUFTS UNIV SCHOOL OF MEDICINE           ,MA,02111-0000,Private      ,5,58,63,108,2246,2354
00222100,UNIV OF MASSACHUSETTS-AMHERST           ,MA,01003-0000,Public       ,953,553,1506,40970,8106,49076
00222200,UNIV OF MASSACHUSETTS-BOSTON            ,MA,02125-3393,Public       ,409,847,1256,13745,12058,25803
00222400,WELLESLEY COLLEGE                       ,MA,02481-8203,Private      ,97,13,110,3560,223,3783
00222500,WENTWORTH INSTITUTE OF TECHNOLOGY       ,MA,02115-5998,Private      ,148,117,265,6496,1148,7644
00222600,WESTERN NEW ENGLAND UNIVERSITY          ,MA,01119-2654,Private      ,116,88,204,6344,1795,8139
00222700,WHEATON COLLEGE                         ,MA,02766-2322,Private      ,64,7,71,2745,113,2858
00222800,WHEELOCK COLLEGE                        ,MA,02215-4176,Private      ,33,46,79,1663,843,2506
00222900,WILLIAMS COLLEGE                        ,MA,01267-2600,Private      ,95,11,106,3731,112,3843
00223300,WORCESTER POLYTECHNIC INSTITUTE         ,MA,01609-2280,Private      ,189,55,244,8539,736,9275
00267104,BARD COLLEGE - LONGY SCHOOL OF MUSIC    ,MA,02138-3599,Private      ,0,5,5,44,149,193
00396500,BAY STATE COLLEGE                       ,MA,02116-2901,Proprietary  ,41,132,173,1208,1480,2688
00396600,BOSTON ARCHITECTURAL COLLEGE            ,MA,02115-2795,Private      ,17,53,70,289,766,1055
00466100,HAMPSHIRE COLLEGE                       ,MA,01002-3359,Private      ,88,11,99,2537,238,2775
00466600,SALTER COLLEGE                          ,MA,01583-1700,Proprietary  ,90,402,492,496,2559,3055
00466700,SCHOOL OF MUSEUM OF FINE ARTS           ,MA,02115-5534,Private      ,25,18,43,548,311,859
00466900,UPPER CAPE COD REGIONAL VOC TECH        ,MA,02532-3310,Public       ,2,11,13,38,121,159
00527900,GREATER LOWELL REGNL VOC TECH SCH       ,MA,01879-0000,Public       ,0,6,6,26,127,153
00551900,DIMAN REGIONAL VOC TECH INST            ,MA,02723-3519,Public       ,2,15,17,37,182,219
00552300,BLUE HILLS REGIONAL VOC TECH            ,MA,02021-1398,Public       ,5,10,15,40,176,216
00555700,MCCANN TECHNICAL SCHOOL                 ,MA,01247-0000,Public       ,3,6,9,34,74,108
00613600,NATIONAL AVIATION ACADEMY - NEW ENGLAND ,MA,01730-2620,Proprietary  ,16,44,60,118,249,367
00632200,BROCKTON HOSPITAL SCH OF NURSING        ,MA,02302-0000,Private      ,2,27,29,153,595,748
00632400,LABOURE COLLEGE                         ,MA,02124-0000,Private      ,17,101,118,208,1126,1334
00633100,LAWRENCE MEM HOSPITAL SCH OF NRSNG      ,MA,02155-1643,Private      ,5,31,36,53,369,422
00635200,BAYSTATE MEDICAL CENTER                 ,MA,01199-0001,Private      ,6,13,19,46,114,160
00687300,MARIAN COURT COLLEGE                    ,MA,01907-2896,Private      ,2,6,8,126,118,244
00748100,GIBBS COLLEGE                           ,MA,02116-2904,Proprietary  ,0,0,0,8,26,34
00748400,NEWBURY COLLEGE                         ,MA,02445-5796,Private      ,30,25,55,1959,317,2276
00748600,THE NEW ENGLAND INSTITUTE OF ART        ,MA,02445-7295,Proprietary  ,58,47,105,818,454,1272
00748800,KAPLAN CAREER INSTITUTE                 ,MA,02129-1644,Proprietary  ,0,0,0,1,12,13
00807800,SPRINGFIELD TECHNICAL COMMUNITY CLG     ,MA,01105-0000,Public       ,190,537,727,3851,5637,9488
00809002,EVEREST COLLEGE - EVEREST INSTITUTE     ,MA,02150-2333,Proprietary  ,7,16,23,80,239,319
00891600,NEW ENGLAND SCHOOL OF LAW               ,MA,02116-0000,Private      ,1,18,19,24,1503,1527
00964500,BARD COLLEGE AT SIMON'S ROCK            ,MA,01230-9702,Private      ,30,0,30,406,9,415
00974700,GORDON-CONWELL THEOLOGICAL SEMINARY     ,MA,01982-0000,Private      ,2,40,42,11,540,551
00975600,UNIVERSITY OF MASS MEDICAL CENTER       ,MA,01655-0000,Public       ,6,28,34,64,883,947
00987700,HENRI'S SCHOOL OF HAIR DESIGN           ,MA,01420-5675,Proprietary  ,2,10,12,27,54,81
00989900,LOWELL ACADEMY HAIRSTYLING INST         ,MA,01852-1909,Proprietary  ,9,21,30,50,100,150
00993600,MIDDLESEX COMMUNITY COLLEGE             ,MA,01730-1197,Public       ,103,176,279,1921,1987,3908
00993602,"MIDDLESEX COMMUNITY COLLEGE, LOWELL     ",MA,01852-0000,Public       ,142,320,462,3279,3627,6906
01121000,BUNKER HILL COMMUNITY COLLEGE           ,MA,02129-2991,Public       ,478,1262,1740,7115,11942,19057
01151000,EVEREST INSTITUTE                       ,MA,02135-7638,Proprietary  ,2,3,5,41,113,154
01193000,ROXBURY COMMUNITY COLLEGE               ,MA,02120-3400,Public       ,70,319,389,983,3301,4284
01204200,MANSFIELD BEAUTY SCHOOLS                ,MA,02169-5061,Proprietary  ,2,9,11,22,77,99
01206800,MANSFIELD BEAUTY SCHOOL                 ,MA,01103-1410,Proprietary  ,0,8,8,21,70,91
01218700,BLACKSTONE VALLEY VOCATIONAL REGIONAL SC,MA,01568-1499,Public       ,1,5,6,13,64,77
01238600,SOUTHEASTERN TECHNICAL INSTITUTE        ,MA,02375-1780,Public       ,4,17,21,61,226,287
01246108,LINCOLN TECHNICAL INSTITUTE - BROCKTON  ,MA,02401-1818,Proprietary  ,17,80,97,151,430,581
01246114,LINCOLN TECHNICAL INSTITUTE - LOWELL    ,MA,01852-5119,Proprietary  ,17,55,72,175,385,560
01246115,LINCOLN TECHNICAL INSTITUTE - SOMERVILLE,MA,02145-1102,Proprietary  ,32,59,91,137,381,518
01288100,MONTACHUSETT REG VOC TECH SCH           ,MA,01420-4649,Public       ,1,7,8,35,107,142
01294800,ROB ROY ACADEMY                         ,MA,02721-5330,Proprietary  ,9,19,28,38,76,114
02063000,MONTSERRAT COLLEGE OF ART               ,MA,01915-0000,Private      ,13,6,19,687,74,761
02079400,EMPIRE BEAUTY SCHOOL                    ,MA,01702-5232,Proprietary  ,73,224,297,719,1648,2367
02092100,MASSACHUSETTS SCHOOL OF BARBERING       ,MA,02169-5058,Proprietary  ,9,22,31,29,129,158
02122000,NEW ENGLAND HAIR ACADEMY                ,MA,02148-0000,Proprietary  ,14,26,40,63,145,208
02137000,ROB ROY ACADEMY                         ,MA,02780-0000,Proprietary  ,5,5,10,22,33,55
02137200,MASS GEN HOSP DIETETIC INTERNSHIP       ,MA,02114-0000,Private      ,0,0,0,5,39,44
02163500,NEW ENGLAND SCHOOL OF PHOTOGRAPHY       ,MA,02215-0000,Proprietary  ,7,16,23,78,95,173
02163600,MASS SCH OF PROFESSIONAL PSYCHOLOGY     ,MA,02132-0000,Private      ,7,42,49,33,886,919
02169900,ASSABET VALLEY REGIONAL VOC SCHOOL      ,MA,01752-0000,Public       ,1,10,11,18,119,137
02181600,ROB ROY ACADEMY                         ,MA,01609-0000,Proprietary  ,14,42,56,66,140,206
02182900,CAMBRIDGE COLLEGE                       ,MA,02138-5304,Private      ,45,284,329,394,2979,3373
02197900,NORTH BENNET STREET SCHOOL              ,MA,02113-0000,Private      ,1,15,16,48,163,211
02215100,HALLMARK INSTITUTE OF PHOTOGRAPHY       ,MA,01376-0000,Proprietary  ,7,11,18,124,139,263
02219501,MILDRED ELLEY - PITTSFIELD              ,MA,01201-5300,Proprietary  ,0,2,2,22,84,106
02220400,CATHERINE HINDS INST OF ESTHETICS       ,MA,01801-0000,Proprietary  ,8,32,40,72,202,274
02231600,MGH INSTITUTE OF HEALTH PROFESSION      ,MA,02129-0000,Private      ,12,100,112,97,1629,1726
02274300,CONWAY SCHOOL OF LANDSCAPE DESIGN       ,MA,01341-0179,Private      ,0,0,0,2,30,32
02325700,LABARON HAIRDRESSING ACADEMY            ,MA,02740-0000,Proprietary  ,4,9,13,20,37,57
02325800,LABARON HAIRDRESSING ACAD-BROCKTON      ,MA,02301-0000,Proprietary  ,1,5,6,14,41,55
02337400,BANCROFT SCHOOL OF MASSAGE THERAPY      ,MA,01604-4614,Proprietary  ,1,15,16,22,83,105
02338200,BAY STATE SCHOOL OF TECHNOLOGY          ,MA,02021-0000,Proprietary  ,8,32,40,49,190,239
02339400,ROB ROY ACADEMY                         ,MA,02746-0000,Proprietary  ,1,6,7,13,33,46
02491700,CORTIVA INSTITUTE -  BOSTON             ,MA,02472-2577,Proprietary  ,7,15,22,30,85,115
02523900,ELIZABETH GRADY SCHOOL OF ESTHETICS     ,MA,02155-0000,Proprietary  ,9,24,33,62,186,248
02579800,NEW ENGLAND SCHOOL OF ACUPUNCTURE       ,MA,02458-0000,Private      ,0,8,8,2,160,162
02616704,LE CORDON BLEU COLLEGE OF CULINARY ARTS ,MA,02142-1221,Proprietary  ,6,37,43,168,248,416
03066700,AILANO SCHOOL OF COSMETOLOGY            ,MA,02303-4740,Proprietary  ,1,15,16,22,64,86
03104000,SHAWSHEEN ADULT TECHNICAL INSTITUTE     ,MA,01821-5499,Public       ,1,5,6,18,80,98
03115200,MOTORING TECHNICAL TRAINING INST        ,MA,02771-5933,Proprietary  ,20,45,65,182,305,487
03120800,KAY HARVEY HAIRDRESSING ACADEMY         ,MA,01089-2701,Proprietary  ,0,8,8,21,55,76
03130500,URBAN COLLEGE OF BOSTON                 ,MA,02111-1093,Private      ,6,74,80,64,853,917
03194300,BOSTON GRAD SCH OF PSYCHOANALYSIS       ,MA,02446-4602,Private      ,1,4,5,2,79,81
03205400,JOLIE HAIR & BEAUTY ACADEMY             ,MA,01056-2769,Proprietary  ,8,34,42,40,134,174
03235300,MASSACHUSETTS SCHOOL OF LAW             ,MA,01810-1094,Private      ,0,45,45,2,487,489
03240300,TONI & GUY HAIRDRESSING ACADEMY         ,MA,01605-2213,Proprietary  ,5,17,22,83,110,193
03240301,TONI & GUY HAIRDRESSING ACADEMY - BRAINT,MA,02184-2807,Proprietary  ,9,15,24,91,80,171
03248300,BOSTON BAPTIST COLLEGE                  ,MA,02136-4030,Private      ,3,9,12,85,69,154
03316400,FUNERAL INSTITUTE OF THE NORTHEAST      ,MA,02062-4766,Proprietary  ,4,13,17,32,105,137
03504300,NATL GRAD SCH OF QUALITY SYSTM MGMT     ,MA,02540-0000,Private      ,0,18,18,1,94,95
03570500,NORTHPOINT BIBLE COLLEGE                ,MA,01835-0000,Private      ,8,10,18,216,176,392
03763300,MEDICAL PROFESSIONAL INSTITUTE          ,MA,02148-8143,Proprietary  ,5,39,44,46,381,427
03859300,E.I.N.E.                                ,MA,01876-4709,Proprietary  ,0,9,9,7,59,66
03927303,MARINELLO SCHOOL OF BEAUTY - NORTHAMPTON,MA,01060-3947,Proprietary  ,4,14,18,42,89,131
03946300,FRANKLIN W. OLIN COLLEGE OF ENGINEERING ,MA,02492-1200,Private      ,28,2,30,626,27,653
03965300,NEW ENGLAND COLLEGE OF FINANCE          ,MA,02110-1605,Proprietary  ,7,125,132,98,937,1035
04116900,DIGRIGOLI SCHOOL OF COSMETOLOGY         ,MA,01089-4623,Proprietary  ,8,11,19,69,89,158
04122000,TRI COUNTY REGIONAL VOCATIONAL TECHNICAL,MA,02038-0000,Public       ,1,8,9,25,85,110
04128000,MILLENNIUM TRAINING INSTITUTE           ,MA,01801-6386,Proprietary  ,0,31,31,3,154,157
04128900,CENTRAL MASS SCHOOL OF MASSAGE AND THERA,MA,01562-1712,Proprietary  ,1,1,2,7,15,22
04143200,HULT INTERNATIONAL BUSINESS SCHOOL      ,MA,02141-1805,Private      ,8,10,18,103,281,384
04153200,SOUTHERN WORCESTER COUNTY REGIONAL VOC S,MA,01507-1331,Public       ,2,6,8,16,55,71
04193100,ALEXANDER ACADEMY                       ,MA,01420-0000,Proprietary  ,0,15,15,21,78,99
04229200,JUPITER BEAUTY ACADEMY                  ,MA,02122-2834,Proprietary  ,3,7,10,13,39,52
00401200,HEBREW UNIVERSITY OF JERUSALEM (THE)    ,FC,00000-0000,Public       ,5,8,13,26,94,120
00403000,UNIVERSITY OF CAMBRIDGE                 ,FC,00000-0000,Public       ,1,6,7,16,96,112
00503400,AMERICAN UNIVERSITY OF CAIRO            ,FC,00000-0000,Private      ,4,6,10,47,116,163
00667100,KATHOLIEKE UNIVERSITEIT LEUVEN          ,FC,00000-0000,Private      ,0,2,2,0,42,42
00669000,UNIVERSITY OF COPENHAGEN                ,FC,00000-0000,Public       ,0,6,6,2,50,52
00669100,UNIVERSITY OF CAMBRIDGE - PEMBROKE      ,FC,00000-0000,Public       ,0,0,0,0,10,10
00669200,UNIVERSITY OF LEEDS                     ,FC,00000-0000,Public       ,1,5,6,29,119,148
00669300,UNIV OF LONDON-LONDON SCHOOL ECON       ,FC,00000-0000,Public       ,0,13,13,14,434,448
00669400,UNIVERSITY OF LONDON - SCHOOL OF ORIENTA,FC,00000-0000,Public       ,1,8,9,14,189,203
00669500,UNIV OF LONDON-UNIVERSITY COLLEGE       ,FC,00000-0000,Public       ,6,15,21,53,458,511
00669600,UNIV OF LONDON-SCH ADVANCED STUDY       ,FC,00000-0000,Public       ,0,0,0,0,15,15
00669700,"QUEEN MARY, UNIVERSITY OF LONDON        ",FC,00000-0000,Public       ,3,4,7,49,169,218
00669900,UNIVERSITY OF SUSSEX                    ,FC,00000-0000,Public       ,0,4,4,20,77,97
00670000,"UNIVERSITY OF YORK, THE                 ",FC,00000-0000,Public       ,0,8,8,26,167,193
00670400,UNIVERSITY COLLEGE CORK                 ,FC,00000-0000,Public       ,1,4,5,27,80,107
00671300,UPPSALA UNIVERSITY                      ,FC,00000-0000,Public       ,0,3,3,5,42,47
00671500,UNIVERSITY OF GENEVA                    ,FC,00000-0000,Public       ,0,4,4,1,103,104
00683900,UNIVERSITY OF EDINBURGH                 ,FC,00000-0000,Public       ,8,20,28,277,771,1048
00684200,UNIVERSITY OF DUBLIN TRINITY COLLEG     ,FC,00000-0000,Public       ,3,7,10,67,237,304
00685000,UNIVERSITY OF CAMBRIDGE - DOWNING C     ,FC,00000-0000,Public       ,0,0,0,1,1,2
00763200,UNIVERSITY OF BRISTOL                   ,FC,00000-0000,Public       ,2,3,5,26,101,127
00768100,COLLEGE OF EUROPE                       ,FC,00000-0000,Private      ,0,0,0,0,8,8
00770500,ROYAL COLLEGE OF SURGEONS IN IRELAN     ,FC,00000-0000,Private      ,0,0,0,10,59,69
00788100,AMERICAN UNIVERSITY OF PARIS            ,FC,00000-0000,Private      ,31,19,50,557,315,872
00837100,AMERICAN UNIVERSITY OF BEIRUT           ,FC,00000-0000,Private      ,7,4,11,81,71,152
00837300,TEL-AVIV UNIVERSITY                     ,FC,00000-0000,Public       ,4,9,13,33,138,171
00837600,VRIJE UNIVERSITEIT AMSTERDAM            ,FC,00000-0000,Public       ,1,1,2,5,40,45
00837700,UNIVERSITEIT VAN AMSTERDAM(UNIVERSI     ,FC,00000-0000,Public       ,1,5,6,15,154,169
00838000,UNIVERSITY OF WARWICK                   ,FC,00000-0000,Public       ,1,4,5,10,64,74
00838300,UNIVERSITY OF GLASGOW                   ,FC,00000-0000,Public       ,7,3,10,94,420,514
00839300,UNIVERSITY OF OSLO                      ,FC,00000-0000,Public       ,0,0,0,10,30,40
00839400,UNIVERSITY OF OXFORD                    ,FC,00000-0000,Public       ,2,10,12,36,354,390
00839800,UNIVERSITY OF SHEFFIELD (THE)           ,FC,00000-0000,Public       ,0,4,4,12,92,104
00839900,UNIVERSITY OF SOUTHAMPTON               ,FC,00000-0000,Public       ,0,5,5,16,79,95
00845200,ABERYSTWYTH UNIVERSITY                  ,FC,00000-0000,Public       ,0,2,2,29,67,96
00845800,LOUGHBOROUGH UNIVERSITY                 ,FC,00000-0000,Public       ,0,0,0,4,15,19
00846000,UNIVERSITY OF NEWCASTLE UPON TYNE       ,FC,00000-0000,Public       ,0,4,4,27,97,124
00846100,UNIVERSITY OF SAINT ANDREWS             ,FC,00000-0000,Private      ,14,5,19,372,187,559
00850500,UNIVERSITY OF MELBOURNE                 ,FC,00000-0000,Public       ,3,41,44,20,185,205
00858600,SWANSEA UNIVERSITY                      ,FC,00000-0000,Public       ,0,3,3,15,57,72
00858700,UNIVERSITY OF DURHAM                    ,FC,00000-0000,Public       ,1,6,7,37,236,273
00866500,UNIVERSITY OF KENT AT CANTERBURY (THE)  ,FC,00000-0000,Public       ,2,8,10,47,178,225
00867000,UNIVERSITY OF NEW SOUTH WALES           ,FC,00000-0000,Public       ,1,16,17,22,95,117
00868700,UNIVERSITY OF ESSEX                     ,FC,00000-0000,Public       ,1,6,7,38,165,203
00869300,CITY UNIVERSITY                         ,FC,00000-0000,Public       ,1,10,11,32,208,240
00890800,THE UNIVERSITY OF BIRMINGHAM            ,FC,00000-0000,Public       ,0,6,6,28,143,171
00891000,UNIVERSITY OF HULL                      ,FC,00000-0000,Public       ,0,0,0,4,14,18
00892000,UNIVERSITY OF NOTTINGHAM                ,FC,00000-0000,Public       ,2,4,6,29,105,134
00900600,UNIVERSITY OF SALFORD (THE)             ,FC,00000-0000,Public       ,0,2,2,11,22,33
00908400,"UNIV OF LONDON, BIRKBECK                ",FC,00000-0000,Public       ,0,3,3,12,116,128
00908500,UNIV OF LONDON KING'S COLLEGE           ,FC,00000-0000,Public       ,4,18,22,130,501,631
00908600,UNIVERSITY OF LONDON - ROYAL HOLLOWAY   ,FC,00000-0000,Public       ,1,3,4,38,92,130
00914300,BAR-ILAN UNIVERSITY                     ,FC,00000-0000,Private      ,1,1,2,15,24,39
00924900,UNIVERSITY OF LIVERPOOL                 ,FC,00000-0000,Public       ,3,2,5,21,111,132
00936800,UNIVERSITY OF ABERDEEN                  ,FC,00000-0000,Public       ,1,8,9,51,158,209
00942300,ROYAL COLLEGE OF ART                    ,FC,00000-0000,Public       ,1,3,4,9,58,67
00942800,TECHNION-ISRAEL INST OF TECHLGY         ,FC,00000-0000,Public       ,0,6,6,5,74,79
00944200,UNIVERSITY OF EXETER                    ,FC,00000-0000,Public       ,0,4,4,26,107,133
00944400,UNIVERSITY OF LANCASTER                 ,FC,00000-0000,Public       ,0,2,2,12,45,57
00963400,UNIVERSITY OF OXFORD ST CATHERINE'S     ,FC,00000-0000,Public       ,0,0,0,1,7,8
00980800,UNIVERSITY OF STRATHCLYDE               ,FC,00000-0000,Public       ,0,0,0,15,50,65
00986000,UNIVERSITY OF SURREY                    ,FC,00000-0000,Public       ,0,4,4,14,51,65
00988800,KAROLINSKA INSTITUTET                   ,FC,00000-0000,Public       ,0,1,1,1,15,16
00990600,PONTIFICAL NORTH AMERICAN COLLEGE       ,FC,00000-0000,Private      ,0,0,0,1,4,5
00992700,UNIVERSITY OF CAMBRIDGE - FITZWILLI     ,FC,00000-0000,Public       ,0,2,2,0,9,9
01006700,LUND UNIVERSITY                         ,FC,00000-0000,Public       ,0,5,5,12,94,106
01008400,UNIVERSITY OF CAPE TOWN                 ,FC,00000-0000,Public       ,2,10,12,15,79,94
01008700,UNIVERSITY OF OXFORD ST PETER'S COL     ,FC,00000-0000,Public       ,0,1,1,0,7,7
01008800,UNIVERSITY OF OXFORD - CORPUS CHRIS     ,FC,00000-0000,Public       ,0,0,0,1,2,3
01008900,CENTRAL SCHOOL OF SPEECH AND DRAMA      ,FC,00000-0000,Private      ,2,1,3,24,69,93
01009000,UNIVERSITY OF OXFORD - BALLIOL COLL     ,FC,00000-0000,Public       ,0,0,0,3,9,12
01014300,UNIVERSITY OF READING                   ,FC,00000-0000,Public       ,0,3,3,10,61,71
01015700,CARDIFF UNIVERSITY                      ,FC,00000-0000,Public       ,0,4,4,31,79,110
01015900,PONTIFICIA UNIVERSITA GREGORIANA        ,FC,00000-0000,Private      ,0,0,0,2,5,7
01016000,CG JUNG INST                            ,FC,00000-0000,Private      ,0,0,0,0,3,3
01018800,UNIVERSITY COLLEGE DUBLIN               ,FC,00000-0000,Public       ,1,8,9,71,299,370
01019000,UNIVERSITY OF CAMBRIDGE CHURCHILL C     ,FC,00000-0000,Public       ,0,0,0,1,2,3
01022800,UNIVERSITY OF STIRLING                  ,FC,00000-0000,Public       ,0,1,1,34,54,88
01033200,UNIVERSITY OF CAMBRIDGE - CLARE COL     ,FC,00000-0000,Public       ,0,0,0,1,7,8
01045600,UNIVERSITY OF HAIFA                     ,FC,00000-0000,Public       ,2,4,6,7,55,62
01047200,INST EUROPEEN OPEEN D'ADMINISTRATIO     ,FC,00000-0000,Private      ,0,5,5,0,69,69
01049300,CRANFIELD UNIVERSITY                    ,FC,00000-0000,Public       ,0,0,0,0,19,19
01052000,TRINITY LABAN CONSERVATOIRE OF MUSIC AND,FC,00000-0000,Public       ,0,0,0,3,16,19
01052500,UNIVERSITY OF HERTFORDSHIRE             ,FC,00000-0000,Public       ,1,2,3,35,35,70
01057400,LONDON INTRNTL FILM SCHOOL              ,FC,00000-0000,Private      ,0,3,3,11,29,40
01058800,AUSTRALIAN NATIONAL UNIVERSITY          ,FC,00000-0000,Public       ,2,8,10,12,48,60
01058900,BANGOR UNIVERSITY                       ,FC,00000-0000,Public       ,0,2,2,22,27,49
01059400,"RICHMOND, THE AMERICAN INT UNI IN LONDON",FC,00000-0000,Private      ,9,4,13,423,86,509
01059900,INST D'ETUDES POLITIQUES DE PARIS       ,FC,00000-0000,Public       ,1,3,4,11,131,142
01068100,MACQUARIE UNIVERSITY                    ,FC,00000-0000,Public       ,0,5,5,7,32,39
01069200,UNIVERSITY OF QUEENSLAND (THE)          ,FC,00000-0000,Public       ,0,224,224,11,445,456
01078900,UNIVERSITY OF OXFORD - WORCESTER CO     ,FC,00000-0000,Public       ,0,0,0,0,3,3
01079700,"NATIONAL UNIVERSITY OF IRELAND, MAY     ",FC,00000-0000,Public       ,0,1,1,16,17,33
01081600,KINGSTON UNIVERSITY                     ,FC,00000-0000,Public       ,2,3,5,63,239,302
01083800,UNIVERSITITY OF BERGEN (UOB)            ,FC,00000-0000,Public       ,0,1,1,3,9,12
01086400,UNIV OF DUNDEE                          ,FC,00000-0000,Public       ,0,2,2,7,43,50
01086600,UNIVERSITY OF OXFORD - MAGDALEN COLLEGE ,FC,00000-0000,Public       ,0,1,1,1,11,12
01086700,UNIVERSITY OF OXFORD ST JOHN'S COLL     ,FC,00000-0000,Public       ,0,0,0,1,5,6
01091400,MONASH UNIVERSITY                       ,FC,00000-0000,Public       ,2,9,11,7,43,50
01091500,UNIV OF EAST ANGLIA                     ,FC,00000-0000,Public       ,0,5,5,24,108,132
01094200,UNIVERSITY OF OXFORD - ST HUGH'S CO     ,FC,00000-0000,Public       ,0,0,0,0,10,10
01097700,UNIVERSIDAD CENTRAL DEL ESTE            ,FC,00000-0000,Private      ,6,7,13,37,147,184
01098000,SOMERVILLE COLLEGE                      ,FC,00000-0000,Public       ,0,0,0,1,4,5
01099900,UNIV OF OXFORD - WADHAM COLLEGE         ,FC,00000-0000,Public       ,0,0,0,0,3,3
01104400,PONTIFICIA UNIVERSITA SAN TOMMASO       ,FC,00000-0000,Private      ,0,0,0,0,2,2
01105300,UNIVERSITY OF OXFORD - ST HILDA'S C     ,FC,00000-0000,Public       ,0,0,0,1,4,5
01105400,UNIVERSITY OF OXFORD - ST ANNE'S CO     ,FC,00000-0000,Public       ,0,0,0,1,9,10
01105500,UNIV OF OXFORD - LADY MARGARET HALL     ,FC,00000-0000,Public       ,0,0,0,0,7,7
01105600,UNIVERSITY OF OXFORD - UNIVERSITY C     ,FC,00000-0000,Public       ,2,6,8,18,61,79
01105700,UNIVERSITY OF OXFORD - TRINITY COLL     ,FC,00000-0000,Public       ,0,0,0,2,6,8
01105800,UNIVERSITY OF OXFORD-ST EDMUND HALL     ,FC,00000-0000,Public       ,0,0,0,1,9,10
01105900,UNIVERSITY OF OXFORD ST ANTONY'S CO     ,FC,00000-0000,Public       ,0,2,2,0,25,25
01106000,UNIVERSITY OF OXFORD - QUEEN'S COLL     ,FC,00000-0000,Public       ,0,2,2,0,7,7
01106100,UNIVERSITY OF OXFORD - PEMBROKE COL     ,FC,00000-0000,Public       ,0,1,1,1,10,11
01106200,UNIVERSITY OF OXFORD - ORIEL COLLEG     ,FC,00000-0000,Public       ,0,1,1,0,9,9
01106300,UNIVERSITY OF OXFORD - NUFFIELD COL     ,FC,00000-0000,Public       ,0,0,0,0,5,5
01106400,UNIVERSITY OF OXFORD - NEW COLLEGE      ,FC,00000-0000,Public       ,0,1,1,3,7,10
01106500,UNIVERSITY OF OXFORD MERTON COLLEGE     ,FC,00000-0000,Public       ,0,1,1,1,8,9
01106600,UNIVERSITY OF OXFORD - LINCOLN COLL     ,FC,00000-0000,Public       ,0,0,0,0,9,9
01106700,UNIVERSITY OF OXFORD - KEBLE COLLEG     ,FC,00000-0000,Public       ,1,1,2,1,6,7
01106800,UNIVERSITY OF OXFORD - JESUS COLLEG     ,FC,00000-0000,Public       ,0,1,1,1,5,6
01106900,UNIVERSITY OF OXFORD - HERTFORD COL     ,FC,00000-0000,Public       ,0,0,0,0,2,2
01107000,UNIVERSITY OF OXFORD EXETER COLLEGE     ,FC,00000-0000,Public       ,0,0,0,1,7,8
01107100,UNIV OF OXFORD - CHRIST CHURCH          ,FC,00000-0000,Public       ,0,2,2,0,13,13
01107200,UNIVERSITY OF OXFORD - BRASENOSE CO     ,FC,00000-0000,Public       ,0,0,0,0,7,7
01109100,FLINDERS UNIVERSITY OF S AUSTRALIA      ,FC,00000-0000,Public       ,0,7,7,2,29,31
01109400,UNIVERSITY OF WESTERN AUSTRALIA (THE)   ,FC,00000-0000,Public       ,0,4,4,3,25,28
01121400,UNIVERSITY OF THE WITWATERSRAND         ,FC,00000-0000,Public       ,1,7,8,4,21,25
01122600,AARHUS UNIVERSITY                       ,FC,00000-0000,Public       ,0,3,3,3,26,29
01156700,"IMPERIAL COLLEGE OF SCIENCE, TECHNOLOGY ",FC,00000-0000,Public       ,1,5,6,27,78,105
01167900,UNIVERSITY OF BATH                      ,FC,00000-0000,Public       ,1,0,1,20,34,54
01168300,FRANKLIN COLLEGE  SWITZERLAND           ,FC,00000-0000,Private      ,6,4,10,314,22,336
01175800,UNIV OF CAMBRIDGE - PETERHOUSE          ,FC,00000-0000,Public       ,0,0,0,0,3,3
01176400,ROYAL ACADEMY OF MUSIC                  ,FC,00000-0000,Public       ,0,0,0,14,19,33
01176500,GOLDSMITHS' COLLEGE-UNIV OF LONDON      ,FC,00000-0000,Public       ,1,7,8,58,193,251
01176600,UNIV OF LONDON - INST OF EDUC           ,FC,00000-0000,Public       ,0,1,1,0,48,48
01178000,BRUNEL UNIVERSITY                       ,FC,00000-0000,Public       ,0,4,4,15,53,68
01183800,UNIVERSITY OF OXFORD - MANSFIELD CO     ,FC,00000-0000,Public       ,0,0,0,0,4,4
01207500,UNIVERSITY CAMBRIDGE - TRINITY COLL     ,FC,00000-0000,Public       ,0,0,0,1,6,7
01207800,VICTORIA UNIV OF WELLINGTON             ,FC,00000-0000,Public       ,3,7,10,15,36,51
01209600,ECOLE HÔTELIERE DE LAUSANNE             ,FC,00000-0000,Private      ,1,0,1,8,12,20
01210100,UNIVERSITY OF CAMBRIDGE - GIRTON CO     ,FC,00000-0000,Public       ,0,0,0,0,10,10
01213600,VICTORIA UNIV OF MANCHESTER (THE)       ,FC,00000-0000,Public       ,2,9,11,41,156,197
01219800,UNIVERSITY OF BRADFORD                  ,FC,00000-0000,Public       ,0,2,2,4,27,31
01220100,UNIVERSITY OF OXFORD - REGENT'S PAR     ,FC,00000-0000,Public       ,0,0,0,3,3,6
01220600,JAMES COOK UNIVERSITY                   ,FC,00000-0000,Public       ,0,4,4,14,50,64
01221500,BIRMINGHAM CITY UNIVERSITY              ,FC,00000-0000,Public       ,0,1,1,12,31,43
01222300,JAGIELLONIAN UNIVERSITY COLLEGIUM M     ,FC,00000-0000,Public       ,0,2,2,5,25,30
01222500,UNIVERSITY OF SZEGED FACULTY OF MEDICINE,FC,00000-0000,Public       ,0,0,0,2,8,10
01225800,ASTON UNIVERSITY                        ,FC,00000-0000,Public       ,0,4,4,2,21,23
01227500,UNIVERSITY OF OXFORD - WOLFSON COLL     ,FC,00000-0000,Public       ,0,0,0,0,20,20
01230200,GONVILLE & CAIUS COLLEGE                ,FC,00000-0000,Public       ,0,0,0,0,1,1
01233500,ROYAL COLLEGE OF MUSIC                  ,FC,00000-0000,Public       ,1,1,2,10,22,32
01234100,UNIVERSITY OF WALES - ST DAVID'S UN     ,FC,00000-0000,Public       ,0,0,0,3,16,19
01242100,UNIV OF AUCKLAND                        ,FC,00000-0000,Public       ,3,20,23,25,86,111
01254000,UNIVERSIDAD DE NAVARRA                  ,FC,00000-0000,Private      ,2,3,5,14,27,41
01276500,UNIVERSITY OF OXFORD - LINACRE COLL     ,FC,00000-0000,Public       ,0,0,0,0,6,6
01276600,"NATIONAL UNIVERSITY IRELAND, GALWAY     ",FC,00000-0000,Public       ,2,3,5,31,115,146
01280200,PONTIFICIA UNIV CATOLICA MAD Y MAES     ,FC,00000-0000,Private      ,8,10,18,148,124,272
01281100,INST TECNOLOGICO DE SANTO DOMINGO       ,FC,00000-0000,Private      ,4,5,9,41,64,105
01283900,UNIVERSITY OF CAMBRIDGE - SAINT JOH     ,FC,00000-0000,Public       ,0,1,1,1,10,11
01297800,UNIVERSITY OF HUDDERSFIELD (THE)        ,FC,00000-0000,Public       ,1,0,1,15,22,37
01315300,MASSEY UNIVERSITY                       ,FC,00000-0000,Public       ,0,14,14,7,52,59
02052400,DARWIN COLLEGE                          ,FC,00000-0000,Public       ,0,0,0,0,12,12
02082400,UNIVERSITY OF CAMBRIDGE - QUEEN'S C     ,FC,00000-0000,Public       ,0,2,2,1,9,10
02083400,UNIVERSITY OF CAMBRIDGE - WOLFSON C     ,FC,00000-0000,Public       ,0,1,1,1,16,17
02087400,UNIVERSITY OF CAMBRIDGE - NEWNHAM C     ,FC,00000-0000,Public       ,0,0,0,1,8,9
02087900,OXFORD BROOKES UNIVERSITY               ,FC,00000-0000,Public       ,0,6,6,32,89,121
02094100,BEN-GURION UNIV                         ,FC,00000-0000,Public       ,1,2,3,2,110,112
02094400,UNIV OF CAMBRIDGE - ST EDMUND'S HOU     ,FC,00000-0000,Public       ,0,1,1,0,12,12
02095500,LONDON BUS SCHOOL                       ,FC,00000-0000,Public       ,0,3,3,1,113,114
02101900,ROEHAMPTON UNIVERSITY                   ,FC,00000-0000,Public       ,0,7,7,38,110,148
02108600,LONDON ACADEMY OF MUSIC & DRAMATIC      ,FC,00000-0000,Private      ,3,1,4,37,53,90
02115900,UNIVERSITY OF PORTSMOUTH                ,FC,00000-0000,Public       ,2,1,3,17,16,33
02116700,UNIVERSITY OF CAMBRIDGE - LUCY CAVE     ,FC,00000-0000,Public       ,0,1,1,0,7,7
02120000,UNIV OF LONDON - COURTALD INST OF A     ,FC,00000-0000,Public       ,0,1,1,2,29,31
02133400,UNIVERSITY OF CAMBRIDGE - SIDNEY SU     ,FC,00000-0000,Public       ,0,0,0,2,9,11
02142000,UNIVERSITY OF CAMBRIDGE - HOMERTON      ,FC,00000-0000,Public       ,0,2,2,0,11,11
02149700,UNIVERSITY OF WINCHESTER (THE)          ,FC,00000-0000,Public       ,1,1,2,24,18,42
02156800,UNIV OF OTAGO                           ,FC,00000-0000,Public       ,1,10,11,12,45,57
02162300,"IESE BUSINESS SCH, UNIV OF NAVARRA      ",FC,00000-0000,Private      ,0,4,4,5,74,79
02167400,UNIVERSITY OF CAMBRIDGE - CORPUS CH     ,FC,00000-0000,Public       ,0,0,0,0,4,4
02177700,KING'S COLLEGE- UNIV OF CAMBRIDGE       ,FC,00000-0000,Public       ,1,1,2,12,26,38
02180500,MIDDLESEX UNIVERSITY                    ,FC,00000-0000,Public       ,2,5,7,55,106,161
02181000,UNIVERSITY OF SOUTH AUSTRALIA           ,FC,00000-0000,Public       ,0,0,0,6,7,13
02183500,UNIV OF OXFORD - WYCLIFFE HALL          ,FC,00000-0000,Public       ,0,1,1,3,11,14
02186000,UNIVERSITY OF CAMBRIDGE - MAGDALENE     ,FC,00000-0000,Public       ,0,0,0,2,6,8
02186100,UNIVERSITY OF CAMBRIDGE - EMMANUEL      ,FC,00000-0000,Public       ,0,0,0,0,5,5
02189600,UNIVERSITY OF GRONINGEN                 ,FC,00000-0000,Public       ,0,0,0,1,13,14
02194800,UNIVERSITY OF THE WEST OF ENGLAND -     ,FC,00000-0000,Public       ,0,0,0,8,14,22
02195100,UNIV OF WESTMINSTER                     ,FC,00000-0000,Public       ,2,10,12,61,137,198
02196700,GUILDHALL SCHOOL OF MUSIC & DRAMA       ,FC,00000-0000,Public       ,1,2,3,15,18,33
02207300,UNIVERSITY OF CAMBRIDGE - CHRIST'S      ,FC,00000-0000,Public       ,0,0,0,1,6,7
02207400,CHINESE UNIVERSITY OF HONG KONG (THE)   ,FC,00000-0000,Public       ,1,4,5,17,37,54
02209500,UNIVERSITEIT UTRECHT                    ,FC,00000-0000,Public       ,1,0,1,13,59,72
02210000,UNIV OF LONDON - LONDON SCHOOL OF H     ,FC,00000-0000,Public       ,0,5,5,0,107,107
02225300,UNIVERSITY OF CANTERBURY                ,FC,00000-0000,Public       ,1,4,5,10,29,39
02229100,UNIVERSITY OF LEICESTER                 ,FC,00000-0000,Public       ,3,9,12,14,136,150
02229600,SACKLER SCHOOL OF MEDICINE              ,FC,00000-0000,Public       ,0,2,2,0,150,150
02232100,UNIVERSITY OF CAMBRIDGE                 ,FC,00000-0000,Public       ,0,4,4,2,38,40
02233300,"ST GEORGE'S UNIVERSITY, SCHOOL OF MEDICI",FC,00000-0000,Proprietary  ,5,292,297,21,3909,3930
02235300,LONDON METROPOLITAN UNIVERSITY          ,FC,00000-0000,Public       ,1,6,7,32,102,134
02244400,AMERICAN UNIV OF THE CARIBBEAN          ,FC,00000-0000,Proprietary  ,1,153,154,11,1671,1682
02266600,UNIVERSITY OF LONDON - SAINT GEORGE     ,FC,00000-0000,Public       ,0,3,3,3,53,56
02271700,UNIVERSITY OF CAMBRIDGE - CLARE HAL     ,FC,00000-0000,Public       ,0,0,0,1,4,5
02271900,UNIVERSITY OF OXFORD - BLACKFRIARS      ,FC,00000-0000,Public       ,0,0,0,1,2,3
02272200,UNIVERSITY OF CAMBRIDGE - MURRAY EDWARDS,FC,00000-0000,Public       ,0,0,0,1,2,3
02273600,QUEEN'S UNIV OF BELFAST (THE)           ,FC,00000-0000,Public       ,1,3,4,8,83,91
02273900,HERIOT WATT UNIVERSITY                  ,FC,00000-0000,Public       ,0,4,4,13,38,51
02276700,NYENRODE BUSINESS UNIVERSITEIT          ,FC,00000-0000,Private      ,0,0,0,0,6,6
02293400,ECOLE DES HAUTES ETUDES COMERCIALS      ,FC,00000-0000,Public       ,0,6,6,0,30,30
02296300,UNIVERSITY OF CAMBRIDGE - JESUS COL     ,FC,00000-0000,Public       ,0,2,2,0,12,12
02310500,DE MONTFORT UNIVERSITY                  ,FC,00000-0000,Public       ,0,2,2,4,13,17
02320500,ROYAL NORTHERN COLLEGE OF MUSIC         ,FC,00000-0000,Public       ,0,0,0,2,12,14
02335100,UNIV OF CAMBRIDGE - TRINITY HALL        ,FC,00000-0000,Public       ,0,1,1,2,10,12
02338900,UNIVERSITY  FOR THE CREATIVE ARTS       ,FC,00000-0000,Public       ,0,0,0,9,10,19
02351800,UNIVERSIDAD IBEROAMERICANA (UNIBE       ,FC,00000-0000,Private      ,9,32,41,104,397,501
02352100,UNIVERSITY OF PLYMOUTH                  ,FC,00000-0000,Public       ,0,0,0,11,23,34
02493000,ESCUELA SUPERIOR ADMINISTRACION Y D     ,FC,00000-0000,Private      ,0,0,0,1,35,36
02496700,NATIONAL FILM & TV SCHOOL               ,FC,00000-0000,Public       ,0,1,1,3,12,15
02545700,GLASGOW SCHOOL OF ART                   ,FC,00000-0000,Public       ,0,1,1,8,29,37
02561600,SOUTHAMPTON SOLENT UNIVERSITY           ,FC,00000-0000,Public       ,0,0,0,10,9,19
02579600,MURDOCH UNIVERSITY                      ,FC,00000-0000,Public       ,0,2,2,2,36,38
02588000,UNIVERSITY OF ULSTER                    ,FC,00000-0000,Public       ,0,0,0,8,24,32
02591800,CURTIN UNIVERSITY OF TECHNOLOGY         ,FC,00000-0000,Public       ,0,2,2,1,14,15
02611700,DUBLIN CITY UNIVERSITY                  ,FC,00000-0000,Public       ,0,5,5,16,43,59
02623200,UNIVERSITY OF NEWCASTLE (THE)           ,FC,00000-0000,Public       ,0,0,0,5,14,19
03012700,UNIVERSITY OF BUCKINGHAM                ,FC,00000-0000,Private      ,1,0,1,6,13,19
03029400,KEELE UNIVERSITY                        ,FC,00000-0000,Public       ,0,0,0,15,17,32
03029500,NORTHUMBRIA UNIVERSITY                  ,FC,00000-0000,Public       ,0,2,2,10,32,42
03033300,MANCHESTER METROPOLITAN UNIV            ,FC,00000-0000,Public       ,5,3,8,44,54,98
03045000,UNIVERSITY OF EAST LONDON               ,FC,00000-0000,Public       ,2,2,4,41,81,122
03050100,STUDIO ART CENTERS INTERNATIONAL        ,FC,00000-0000,Private      ,3,1,4,16,58,74
03066800,PONTIFICIO ATENEO DELLA SANTA CROCE     ,FC,00000-0000,Private      ,0,0,0,0,1,1
03067200,UNIVERSITY OF SYDNEY                    ,FC,00000-0000,Public       ,4,43,47,32,209,241
03073800,UNIV OF DEBRECEN MED & HEALTH SCI       ,FC,00000-0000,Public       ,0,1,1,8,24,32
03078700,UNIVERSITA COMMERCIALE L BOCCONI        ,FC,00000-0000,Private      ,0,3,3,2,27,29
03080300,SHEFFIELD HALLAM UNIVERSITY             ,FC,00000-0000,Public       ,0,1,1,2,9,11
03084300,UNIVERSITY OF LIMERICK                  ,FC,00000-0000,Public       ,1,1,2,26,70,96
03088700,ROYAL SCOTTISH ACAD MUSIC & DRAMA       ,FC,00000-0000,Public       ,0,2,2,25,34,59
03091400,UNIVERSITY OF WOLLONGONG                ,FC,00000-0000,Public       ,1,4,5,4,17,21
03091500,UNIVERSITY OF CANBERRA                  ,FC,00000-0000,Public       ,1,0,1,4,6,10
03091700,POZNAN UNIVERSITY OF MEDICAL SCIENCES   ,FC,00000-0000,Public       ,0,0,0,6,51,57
03092500,NOTTINGHAM TRENT UNIVERSITY             ,FC,00000-0000,Public       ,0,2,2,10,31,41
03095000,RMIT UNIVERSITY                         ,FC,00000-0000,Public       ,2,12,14,10,44,54
03095400,BOND UNIVERSITY                         ,FC,00000-0000,Private      ,1,14,15,17,64,81
03095900,ESSEC BUSINESS SCHOOL                   ,FC,00000-0000,Private      ,0,2,2,1,15,16
03096100,LA TROBE UNIVERSITY                     ,FC,00000-0000,Public       ,3,5,8,8,29,37
03096900,DEAKIN UNIVERSITY                       ,FC,00000-0000,Public       ,0,0,0,4,8,12
03097100,UNIVERSITY OF WESTERN SYDNEY            ,FC,00000-0000,Public       ,0,0,0,1,4,5
03097300,VICTORIA UNIVERSITY OF TECHNOLOGY       ,FC,00000-0000,Public       ,0,0,0,5,11,16
03097500,CENTRAL QUEENSLAND UNIVERSITY           ,FC,00000-0000,Public       ,0,0,0,0,7,7
03100000,UNIVERSITY OF ADELAIDE (THE)            ,FC,00000-0000,Public       ,0,5,5,3,23,26
03101600,ASIAN INSTITUTE OF MANAGEMENT           ,FC,00000-0000,Private      ,1,2,3,2,16,18
03102500,AMERICAN UNIVERSITY OF ROME             ,FC,00000-0000,Private      ,9,5,14,161,79,240
03102800,ROBERT GORDON UNIVERSITY (THE)          ,FC,00000-0000,Public       ,1,11,12,4,43,47
03104800,GRIFFITH UNIVERSITY                     ,FC,00000-0000,Public       ,1,8,9,15,44,59
03136300,AUSTRALIAN CATHOLIC UNIVERSITY          ,FC,00000-0000,Public       ,0,0,0,3,10,13
03140300,EDITH COWAN UNIVERSITY                  ,FC,00000-0000,Public       ,0,0,0,1,1,2
03140400,NORTHERN TERRITORY UNIVERSITY           ,FC,00000-0000,Public       ,0,0,0,0,2,2
03140500,QUEENSLAND UNIVERSITY OF TECHNOLOGY     ,FC,00000-0000,Public       ,0,2,2,3,16,19
03140600,SOUTHERN CROSS UNIVERSITY               ,FC,00000-0000,Public       ,1,2,3,1,12,13
03140700,SWINBURNE UNIVERSITY OF TECHNOLOGY      ,FC,00000-0000,Public       ,0,0,0,2,12,14
03150400,"UNIVERSITY OF TECHNOLOGY, SYDNEY        ",FC,00000-0000,Public       ,0,13,13,4,35,39
03287300,LIVERPOOL INSTITUTE FOR PERFORMING ARTS ,FC,00000-0000,Public       ,1,0,1,17,2,19
03300300,"2ND SCHOOL OF MEDICINE, CHARLES UNI     ",FC,00000-0000,Public       ,1,6,7,5,18,23
03300400,"FIRST FACULTY OF MEDICINE, CHARLES UNIV.",FC,00000-0000,Public       ,0,1,1,2,27,29
03329300,JOHN CABOT UNIVERSITY                   ,FC,00000-0000,Private      ,4,3,7,190,38,228
03333300,MEDICAL UNIVERSITY SCHOOL OF LUBLIN     ,FC,00000-0000,Public       ,0,19,19,6,163,169
03334300,UNIVERSIDAD NORDESTANA                  ,FC,00000-0000,Private      ,3,3,6,16,47,63
03335300,MEDICAL UNIVERSITY OF SILESIA           ,FC,00000-0000,Public       ,0,8,8,3,62,65
03342300,GLASGOW CALEDONIAN UNIVERSITY           ,FC,00000-0000,Public       ,0,2,2,7,31,38
03349400,"QUEEN MARGARET UNIVERSITY, EDINBURGH    ",FC,00000-0000,Public       ,1,0,1,3,22,25
03350300,BOURNEMOUTH UNIVERSITY                  ,FC,00000-0000,Public       ,0,1,1,11,33,44
03352300,LONDON SOUTH BANK UNIVERSITY            ,FC,00000-0000,Private      ,0,4,4,16,47,63
03364300,"FACULTY OF MEDICINE, PALACKY UNIVER     ",FC,00000-0000,Public       ,0,0,0,1,2,3
03365400,AUCKLAND INSTITUTE OF TECHNOLOGY        ,FC,00000-0000,Public       ,0,0,0,4,2,6
03378300,"THE 3RD FACULTY OF MEDICINE, CHARLE     ",FC,00000-0000,Public       ,0,0,0,0,1,1
03418400,NAPIER UNIVERSITY                       ,FC,00000-0000,Public       ,1,1,2,16,66,82
03435300,ANGLIA  RUSKIN UNIVERSITY               ,FC,00000-0000,Private      ,2,3,5,21,43,64
03460300,INTERNATIONALES THEOLOGISCHES INSTI     ,FC,00000-0000,Private      ,0,1,1,2,16,18
03473300,UNIVERSITY OF THE ARTS LONDON           ,FC,00000-0000,Public       ,4,11,15,171,193,364
03478300,ROYAL WELSH COLLEGE OF MUSIC AND DRAMA  ,FC,00000-0000,Public       ,0,1,1,22,21,43
03492300,UNIVERSITY OF OXFORD - GREEN TEMPLETON C,FC,00000-0000,Public       ,0,2,2,1,22,23
03492400,UNIV OF CAMBRIDGE-ST CATHERINE'S CG     ,FC,00000-0000,Public       ,0,0,0,2,4,6
03494400,UNIV OF CAMBRIDGE-SELWYN COLLEGE        ,FC,00000-0000,Public       ,0,1,1,1,4,5
03494600,UNIV OF OXFORD-HARRIS MANCHESTER        ,FC,00000-0000,Public       ,0,0,0,3,5,8
03501400,LEEDS METROPOLITAN UNIVERSITY           ,FC,00000-0000,Public       ,0,1,1,14,47,61
03507300,UNIVERSITY OF SUNDERLAND                ,FC,00000-0000,Public       ,0,1,1,9,9,18
03515300,UNIVERSITY OF CENTRAL LANCASHIRE        ,FC,00000-0000,Public       ,1,0,1,15,26,41
03517300,UNIVERSITY OF BRIGHTON                  ,FC,00000-0000,Public       ,1,1,2,21,34,55
03518300,EUROPEAN GRADUATE SCHOOL (EGS)          ,FC,00000-0000,Private      ,0,7,7,0,97,97
03527300,SOFIA UNIVERSITY ST. KLIMENT OHRIDSKI   ,FC,00000-0000,Public       ,0,3,3,4,10,14
03533300,BATH SPA UNIVERSITY                     ,FC,00000-0000,Public       ,0,0,0,11,18,29
03547300,UNIVERSITY OF SOUTH WALES               ,FC,00000-0000,Public       ,0,0,0,2,11,13
03547303,"UNIVERSITY OF SOUTH WALES - NEWPORT, CAE",FC,00000-0000,Public       ,0,1,1,2,10,12
03580300,LIVERPOOL JOHN MOORES UNIVERSITY        ,FC,00000-0000,Public       ,0,0,0,5,11,16
03589400,ARTS INSTITUTE AT BOURNEMOUTH (THE)     ,FC,00000-0000,Public       ,1,1,2,21,18,39
03590300,AVONDALE COLLEGE LIMITED                ,FC,00000-0000,Private      ,0,0,0,1,2,3
03594300,GROUP ESC GRENOBLE GRAD SCH OF BUS.     ,FC,00000-0000,Private      ,0,3,3,1,34,35
03597300,JAGIELLONIAN UNIVERSITY                 ,FC,00000-0000,Public       ,0,2,2,8,24,32
03601300,UNIVERSITAT JAUME I DE CASTELLO (UJI)   ,FC,00000-0000,Public       ,0,0,0,0,2,2
03619300,UNIVERSITY OF GREENWICH                 ,FC,00000-0000,Public       ,1,8,9,36,63,99
03653400,UNIVERSIDAD DE IBEROAMERICA - UNIBE     ,FC,00000-0000,Private      ,0,1,1,3,22,25
03674300,UNIVERSITY OF ABERTAY DUNDEE            ,FC,00000-0000,Public       ,0,0,0,3,3,6
03684400,UNIVERSITY OF LINCOLN                   ,FC,00000-0000,Public       ,1,0,1,8,25,33
03684500,MEDICAL UNIVERSITY OF GDANSK            ,FC,00000-0000,Public       ,0,0,0,1,11,12
03694300,UNIVERSITY OF CHICHESTER                ,FC,00000-0000,Public       ,0,1,1,5,3,8
03727400,UNIVERSITY OF WAIKATO (THE)             ,FC,00000-0000,Public       ,0,0,0,5,7,12
03728300,UNIVERSITY OF DERBY                     ,FC,00000-0000,Public       ,0,1,1,1,10,11
03738300,LONDON SCHOOL OF THEOLOGY               ,FC,00000-0000,Private      ,1,0,1,2,8,10
03741300,ALRA (ACADEMY OF LIVE AND RECORDED ARTS),FC,00000-0000,Private      ,0,0,0,8,10,18
03770300,NAZARENE THEOLOGICAL COLLEGE            ,FC,00000-0000,Private      ,0,0,0,0,3,3
03780300,SABA UNIVERSITY SCHOOL OF MEDICINE      ,FC,00000-0000,Proprietary  ,0,43,43,3,407,410
03784300,MEDICAL UNIVERSITY OF BIALYSTOK         ,FC,00000-0000,Public       ,0,1,1,3,4,7
03794400,ANGLO EUROPEAN COLLEGE OF CHIROPRACTIC  ,FC,00000-0000,Private      ,0,0,0,1,0,1
03807300,ROSE BRUFORD COLLEGE                    ,FC,00000-0000,Public       ,0,1,1,1,14,15
03816400,AMERICAN GRAD SCH OF INTERNTL REL & DIPL,FC,00000-0000,Private      ,1,4,5,7,62,69
03818300,LEIPZIG GRADUATE SCHOOL OF MANAGEMENT   ,FC,00000-0000,Private      ,0,2,2,1,10,11
03824300,"ROYAL VETERINARY COLLEGE (THE), UNIVERSI",FC,00000-0000,Public       ,0,1,1,2,108,110
03829300,INTERNATIONAL CHRISTIAN COLLEGE         ,FC,00000-0000,Private      ,1,0,1,1,1,2
03850500,MEDICAL UNIVERSITY OF LODZ              ,FC,00000-0000,Public       ,0,0,0,3,6,9
03859400,UNIVERSITY COLLEGE FALMOUTH             ,FC,00000-0000,Public       ,0,1,1,20,11,31
03873300,COPENHAGEN BUSINESS SCHOOL              ,FC,00000-0000,Public       ,0,1,1,3,28,31
03880300,UNIVERSITY OF GLOUCESTERSHIRE (THE)     ,FC,00000-0000,Public       ,1,1,2,5,12,17
03897400,INTERNATIONAL SPACE UNIVERSITY          ,FC,00000-0000,Private      ,0,0,0,2,8,10
03945300,UNIVERSITY OF WEST LONDON               ,FC,00000-0000,Public       ,1,1,2,1,1,2
03974300,"ST. GEORGE'S UNIVERSITY, SCHOOL OF VETER",FC,00000-0000,Proprietary  ,0,32,32,4,675,679
04015300,FRANKFURT SCHOOL OF FINANCE & MANAGEMENT,FC,00000-0000,Private      ,1,4,5,1,9,10
04021400,"AMERICAN COLLEGE, DUBLIN LIMITED (THE)  ",FC,00000-0000,Private      ,2,4,6,29,50,79
04021500,CENTRAL EUROPEAN UNIVERSITY             ,FC,00000-0000,Private      ,0,3,3,1,90,91
04032300,YORK ST JOHN UNIVERSITY                 ,FC,00000-0000,Public       ,0,1,1,8,8,16
04046300,HK UNIVERSITY OF SCI & TECH (HKUST)     ,FC,00000-0000,Public       ,0,1,1,8,20,28
04070300,"RAPHAEL RECANATI INTERNATIONAL SCHOOL, T",FC,00000-0000,Private      ,9,5,14,87,72,159
04076300,NEWCASTLE COLLEGE                       ,FC,00000-0000,Public       ,0,1,1,4,5,9
04085400,NEW ZEALAND COLLEGE OF CHIROPRACTIC     ,FC,00000-0000,Private      ,0,2,2,0,3,3
04113300,LEBANESE AMERICAN UNIVERSITY            ,FC,00000-0000,Private      ,5,3,8,58,30,88
04115900,LIVERPOOL HOPE UNIVERSITY               ,FC,00000-0000,Public       ,1,0,1,6,9,15
04116300,EDHEC BUSINESS SCHOOL                   ,FC,00000-0000,Private      ,0,3,3,1,27,28
04128600,UNIVERSITY OF WORCESTER                 ,FC,00000-0000,Public       ,0,0,0,6,5,11
04128700,HERTIE SCHOOL OF GOVERNANCE             ,FC,00000-0000,Private      ,0,1,1,2,34,36
04134200,LONDON CONTEMPORARY DANCE SCHOOL        ,FC,00000-0000,Private      ,1,0,1,6,5,11
04139100,UNIVERSITA DEGLI STUDI DI SCIENZE GASTRO,FC,00000-0000,Private      ,0,0,0,2,23,25
04143700,ST MARY'S UNIVERSITY COLLEGE TWICKENHAM ,FC,00000-0000,Public       ,0,2,2,10,27,37
04168200,EUROPEAN UNIVERSITY AT ST. PETERSBURG   ,FC,00000-0000,Private      ,0,1,1,4,32,36
04176500,ESMT EUROPEAN SCHOOL OF MANAGEMENT AND T,FC,00000-0000,Private      ,0,3,3,1,18,19
04180700,"HEYTHROP COLLEGE, UNIVERSITY OF LONDON  ",FC,00000-0000,Public       ,1,0,1,2,1,3
04218800,REGENT'S UNIVERSITY LONDON              ,FC,00000-0000,Private      ,3,6,9,3,6,9
04219400,UNIVERSIDAD TORCUATO DI TELLA           ,FC,00000-0000,Private      ,0,3,3,2,12,14
00380600,ALDERSON BROADDUS UNIVERSITY            ,WV,26416-1051,Private      ,29,14,43,1855,449,2304
00380700,MOUNTAIN STATE UNIVERSITY               ,WV,25801-5624,Private      ,3,40,43,99,231,330
00380800,BETHANY COLLEGE                         ,WV,26032-0417,Private      ,25,15,40,1226,163,1389
00380900,BLUEFIELD STATE COLLEGE                 ,WV,24701-2198,Public       ,45,155,200,1353,1851,3204
00381000,CONCORD UNIVERSITY                      ,WV,24712-0000,Public       ,61,105,166,2569,1487,4056
00381100,DAVIS & ELKINS COLLEGE                  ,WV,26241-3996,Private      ,31,32,63,1100,333,1433
00381200,FAIRMONT STATE UNIVERSITY               ,WV,26554-2470,Public       ,106,220,326,4705,3089,7794
00381300,GLENVILLE STATE COLLEGE                 ,WV,26351-1292,Public       ,35,47,82,1587,614,2201
00381500,MARSHALL UNIVERSITY                     ,WV,25755-3300,Public       ,211,470,681,10429,7790,18219
00381600,SOUTHERN WV COMMUNITY COLLEGE           ,WV,25637-2900,Public       ,45,172,217,1344,1582,2926
00381800,UNIVERSITY OF CHARLESTON                ,WV,25304-1099,Private      ,45,190,235,2066,2180,4246
00381900,OHIO VALLEY COLLEGE                     ,WV,26105-8000,Private      ,18,21,39,531,170,701
00382000,SALEM INTERNATIONAL UNIVERSITY          ,WV,26426-0500,Proprietary  ,10,80,90,310,644,954
00382200,SHEPHERD UNIVERSITY                     ,WV,25443-5000,Public       ,80,98,178,4367,1697,6064
00382300,WEST LIBERTY UNIVERSITY                 ,WV,26074-0295,Public       ,42,69,111,2895,1088,3983
00382600,WEST VIRGINIA STATE UNIVERSITY          ,WV,25112-0000,Public       ,63,186,249,2620,2198,4818
00382700,WEST VIRGINIA UNIVERSITY                ,WV,26506-6201,Public       ,448,503,951,26152,10181,36333
00382711,WEST VIRGINIA UNIVERSITY - POTOMAC STATE,WV,26726-3000,Public       ,47,53,100,1820,707,2527
00382721,WEST VIRGINIA UNIV INST OF TECH         ,WV,25136-2436,Public       ,27,59,86,1536,712,2248
00382800,WEST VIRGINIA UNIV AT PARKERSBURG       ,WV,26101-9577,Public       ,79,257,336,1682,2660,4342
00383000,WEST VIRGINIA WESLEYAN COLLEGE          ,WV,26201-2600,Private      ,34,22,56,2181,324,2505
00383100,WHEELING JESUIT UNIVERSITY              ,WV,26003-6243,Private      ,19,51,70,1349,980,2329
00500700,WEST VIRGINIA JUNIOR COLLEGE            ,WV,26505-5596,Proprietary  ,15,62,77,340,626,966
00500800,MOUNTAIN STATE COLLEGE                  ,WV,26101-3993,Proprietary  ,10,39,49,63,377,440
00754400,APPALACHIAN BIBLE COLLEGE               ,WV,25818-1353,Private      ,3,10,13,247,100,347
00757800,HUNTINGTON SCHOOL OF BEAUTY CULTURE     ,WV,25705-2030,Proprietary  ,0,0,0,42,68,110
00760000,INTERNATIONAL BEAUTY SCHOOL             ,WV,25401-3231,Proprietary  ,7,16,23,32,108,140
00835500,JAMES RUMSEY TECHNICAL INSTITUTE        ,WV,25403-0259,Public       ,10,45,55,156,381,537
00895900,CLARKSBURG BEAUTY ACADEMY               ,WV,26301-2903,Proprietary  ,7,17,24,51,128,179
00904700,HUNTINGTON JUNIOR COLLEGE               ,WV,25701-2004,Proprietary  ,20,115,135,225,1162,1387
00905400,WEST VIRGINIA NORTHERN CMTY COLLEGE     ,WV,26003-0000,Public       ,45,163,208,1075,1793,2868
01014000,MINERAL COUNTY VOCATIONAL TECH CTR      ,WV,26726-0000,Public       ,3,10,13,30,86,116
01035600,EVEREST INSTITUTE                       ,WV,25313-1304,Proprietary  ,0,5,5,62,236,298
01057300,WEST VIRGINIA JUNIOR COLLEGE            ,WV,25322-0000,Proprietary  ,17,55,72,220,479,699
01057302,WEST VIRGINIA JUNIOR COLLEGE            ,WV,26330-0000,Proprietary  ,24,41,65,195,303,498
01086100,WEST VIRGINIA BUSINESS COLLEGE          ,WV,26301-0000,Proprietary  ,3,26,29,36,197,233
01124500,WEST VIRGINIA SCH OSTEOPATHIC MED       ,WV,24901-1128,Public       ,0,9,9,19,916,935
01174900,WOOD COUNTY SCH OF PRAC NURSING         ,WV,26101-6424,Public       ,1,10,11,34,136,170
01235900,B M SPURR SCHOOL OF PRAC NURSING        ,WV,26038-1660,Private      ,0,0,0,20,42,62
01257300,WEST VIRGINIA UNIV-HOSP-RAD TECH        ,WV,26506-8062,Private      ,6,10,16,173,157,330
01274300,BENJAMIN FRANKLIN CAREER&TECH           ,WV,25064-0000,Public       ,6,25,31,97,237,334
01290400,MONONGALIA CNTY TECH ED CTR             ,WV,26501-6841,Public       ,2,11,13,83,170,253
01290500,ACADEMY OF CAREERS AND TECHNOLOGY       ,WV,25801-0000,Public       ,15,93,108,153,472,625
02057400,ROANE-JACKSON TECHNICAL CENTER          ,WV,25252-0000,Public       ,2,6,8,37,65,102
02068000,UNITED TECHNICAL CENTER                 ,WV,26301-0000,Public       ,1,20,21,43,147,190
02073400,CARVER CAREER TECH ED CTR               ,WV,25306-6397,Public       ,10,58,68,250,508,758
02145100,SCOTT COLLEGE OF COSMETOLOGY            ,WV,26003-0000,Proprietary  ,7,13,20,73,99,172
02178200,CHARLESTON SCHOOL OF BEAUTY CULTURE     ,WV,25301-0000,Proprietary  ,6,32,38,112,240,352
02218200,GARNET CAREER CENTER                    ,WV,25301-0000,Public       ,6,65,71,126,478,604
02275300,CABELL COUNTY CAREER TECHNOLOGY CTR     ,WV,25705-0000,Public       ,8,51,59,126,380,506
02524500,RALPH R WILLIS VOCATIONAL CENTER        ,WV,25601-0000,Public       ,1,8,9,40,101,141
02534800,FRED W EBERLE TECHNICAL CENTER          ,WV,26201-0000,Public       ,9,22,31,77,118,195
02535500,MERCER COUNTY TECH EDUC CNTR            ,WV,24740-0000,Public       ,5,52,57,101,358,459
02579900,NORTH CENTRAL OPPORTUNITIES INDUSTRIALIZ,WV,26554-2936,Private      ,1,21,22,37,116,153
02609400,VALLEY COLLEGE                          ,WV,25404-5711,Proprietary  ,11,58,69,58,351,409
03052000,MEREDITH MANOR EQUESTRIAN CENTRE        ,WV,26184-9707,Proprietary  ,31,20,51,245,136,381
03076500,FAYETTE INSTITUTE OF TECHNOLOGY         ,WV,25901-2174,Public       ,2,17,19,29,93,122
03084200,VALLEY COLLEGE                          ,WV,24740-3141,Proprietary  ,8,46,54,57,212,269
03084400,VALLEY COLLEGE                          ,WV,25801-2643,Proprietary  ,14,103,117,93,530,623
03098300,PUTNAM CAREER & TECHNICAL CENTER        ,WV,25070-0000,Public       ,1,10,11,79,133,212
03102100,MORGANTOWN BEAUTY COLLEGE               ,WV,26505-5430,Proprietary  ,6,21,27,96,108,204
03123200,STANLEY TECHNICAL INSTITUTE             ,WV,26505-3751,Private      ,0,0,0,21,37,58
03327500,SOUTH BRANCH VOCATIONAL TECH CENTER     ,WV,26847-1698,Public       ,0,0,0,11,5,16
03734300,JOHN D. ROCKEFELLER IV CAREER CENTER    ,WV,26047-9424,Public       ,0,0,0,11,35,46
03819300,AMERICAN PUBLIC UNIVERSITY SYSTEM       ,WV,25414-1621,Proprietary  ,345,10035,10380,2522,66456,68978
03957300,BLUE RIDGE COMMUNITY AND TECHNICAL COLLE,WV,25401-3244,Public       ,56,216,272,1104,2370,3474
03960300,NEW RIVER COMMUNITY AND TECHNICAL COLLEG,WV,25801-2636,Public       ,68,298,366,1201,2512,3713
04028300,MOUNTAIN STATE SCHOOL OF MASSAGE        ,WV,25304-2025,Proprietary  ,1,13,14,19,85,104
04038500,PIERPONT COMMUNITY & TECHNICAL COLLEGE  ,WV,26554-2451,Public       ,57,172,229,1623,1786,3409
04038600,BRIDGEVALLEY COMMUNITY AND TECHNICAL COL,WV,25303-2735,Public       ,47,201,248,835,1954,2789
04038601,BRIDGEVALLEY COMMUNITY AND TECHNICAL COL,WV,25136-2435,Public       ,7,35,42,471,405,876
04041400,MOUNTWEST COMMUNITY AND TECHNICAL COLLEG,WV,25755-3300,Public       ,77,249,326,1119,2178,3297
04119000,EASTERN WEST VIRGINIA COMMUNITY & TECHNI,WV,26836-0000,Public       ,18,66,84,268,682,950
04139900,FUTURE GENERATIONS GRADUATE SCHOOL      ,WV,26807-0000,Private      ,0,0,0,0,5,5
04212400,MINGO EXTENDED LEARNING CENTER          ,WV,25670-9797,Public       ,3,16,19,3,18,21
04234800,RANDOLPH TECHNICAL CENTER               ,WV,26241-9527,Public       ,1,5,6,2,33,35
00106100,ALASKA PACIFIC UNIVERSITY               ,AK,99508-4672,Private      ,34,90,124,502,875,1377
00106300,UNIVERSITY OF ALASKA FAIRBANKS          ,AK,99775-7500,Public       ,156,381,537,3690,4352,8042
00106500,UNIVERSITY OF ALASKA SOUTHEAST          ,AK,99801-8680,Public       ,48,160,208,914,1483,2397
00884300,ALASKA BIBLE COLLEGE                    ,AK,99588-0000,Private      ,1,7,8,36,37,73
01146200,UNIVERSITY OF ALASKA ANCHORAGE          ,AK,99514-1608,Public       ,378,882,1260,6999,9058,16057
02541000,ALASKA CAREER COLLEGE                   ,AK,99507-1033,Proprietary  ,34,140,174,289,1018,1307
02576900,CHARTER COLLEGE                         ,AK,99508-0000,Proprietary  ,140,621,761,896,3812,4708
03160300,AVTEC - ALASKA'S INSTITUTE OF TECHNOLOGY,AK,99664-0889,Public       ,15,63,78,264,398,662
03461300,ILISAGVIK COLLEGE                       ,AK,99723-0749,Public       ,0,9,9,37,67,104
04138600,ALASKA CHRISTIAN COLLEGE                ,AK,99669-9755,Private      ,1,8,9,40,101,141
00108500,UNIV ARKANSAS MONTICELLO                ,AR,71656-0000,Public       ,93,202,295,2575,2324,4899
00108600,UNIV OF ARKANSAS AT PINE BLUFF          ,AR,71601-2790,Public       ,73,155,228,3290,1871,5161
00108700,ARKANSAS BAPTIST COLLEGE                ,AR,72202-6099,Private      ,54,130,184,1000,1268,2268
00108800,LYON COLLEGE                            ,AR,72501-3699,Private      ,48,18,66,1260,186,1446
00108900,ARKANSAS TECH UNIVERSITY                ,AR,72801-2222,Public       ,259,485,744,7345,5991,13336
00109000,ARKANSAS STATE UNIVERSITY               ,AR,72467-0000,Public       ,410,1007,1417,9915,11167,21082
00109100,ARKANSAS STATE UNIVERSITY - BEEBE       ,AR,72012-1000,Public       ,143,365,508,2487,3119,5606
00109200,UNIVERSITY OF CENTRAL ARKANSAS          ,AR,72035-0001,Public       ,409,411,820,10635,5339,15974
00109300,CENTRAL BAPTIST COLLEGE                 ,AR,72034-6470,Private      ,19,87,106,735,700,1435
00109400,UNIVERSITY OF THE OZARKS                ,AR,72830-2880,Private      ,35,21,56,745,167,912
00109500,CROWLEYS RIDGE COLLEGE                  ,AR,72450-9775,Private      ,16,29,45,225,196,421
00109700,HARDING UNIVERSITY                      ,AR,72149-0001,Private      ,121,134,255,4231,1940,6171
00109800,HENDERSON STATE UNIVERSITY              ,AR,71999-0001,Public       ,121,145,266,3954,1989,5943
00109900,HENDRIX COLLEGE                         ,AR,72032-3080,Private      ,76,37,113,2164,315,2479
00110000,JOHN BROWN UNIVERSITY                   ,AR,72761-2747,Private      ,54,117,171,1650,1424,3074
00110100,UNIV ARKANSAS LITTLE ROCK               ,AR,72204-1099,Public       ,269,864,1133,5805,10677,16482
00110200,OUACHITA BAPTIST UNIVERSITY             ,AR,71998-0001,Private      ,59,20,79,1942,250,2192
00110300,PHILANDER SMITH COLLEGE                 ,AR,72202-3718,Private      ,39,88,127,1027,938,1965
00110400,PHILLIPS COUNTY COMMUNITY COLLEGE       ,AR,72342-0000,Public       ,17,79,96,505,765,1270
00110500,SHORTER COLLEGE                         ,AR,72114-4885,Private      ,11,94,105,145,1013,1158
00110600,WILLIAMS BAPTIST COLLEGE                ,AR,72476-4661,Private      ,12,16,28,654,188,842
00110700,SOUTHERN ARKANSAS UNIVERSITY            ,AR,71754-0000,Public       ,106,167,273,3244,2016,5260
00110800,UNIV ARKANSAS FAYETTEVILLE              ,AR,72701-0000,Public       ,776,556,1332,18883,7704,26587
00110900,UNIVERSITY OF ARKANSAS FOR MEDICAL SCIEN,AR,72205-7102,Public       ,50,205,255,721,3400,4121
00111000,UNIVERSITY OF ARKANSAS-FORT SMITH       ,AR,72904-7397,Public       ,173,407,580,4574,4198,8772
00524500,U OF A COMM COLLEGE AT MORRILTON        ,AR,72110-9601,Public       ,86,234,320,1284,1973,3257
00570700,SEARK COLLEGE                           ,AR,71603-0000,Public       ,45,189,234,761,1925,2686
00573200,UNIV AR COMMUNITY COLLEGE AT HOPE       ,AR,71801-0000,Public       ,23,112,135,663,1171,1834
00704400,CROWLEYS RIDGE TECHNICAL INSTITUTE      ,AR,72336-0000,Public       ,17,63,80,155,356,511
00732967,ITT TECHNICAL INSTITUTE                 ,AR,72204-7739,Proprietary  ,32,151,183,251,997,1248
00773800,SOUTHERN ARKANSAS UNIVERSITY TECH       ,AR,71701-1900,Public       ,22,111,133,597,906,1503
00792100,PAUL MITCHELL THE SCHOOL ARKANSAS       ,AR,72701-0000,Proprietary  ,9,32,41,106,182,288
00997600,COLLEGE OF THE OUACHITAS                ,AR,72104-0816,Public       ,34,143,177,482,1243,1725
01074100,MELLIE'S BEAUTY COLLEGE                 ,AR,72901-3833,Proprietary  ,8,29,37,75,208,283
01210500,NATIONAL PARK COMMUNITY COLLEGE         ,AR,71913-9174,Public       ,67,287,354,1138,2584,3722
01226000,EAST ARKANSAS COMMUNITY COLLEGE         ,AR,72335-2204,Public       ,21,101,122,506,768,1274
01226100,NORTH ARKANSAS COLLEGE                  ,AR,72601-5508,Public       ,43,219,262,1036,1763,2799
01286000,ARKANSAS NORTHEASTERN COLLEGE           ,AR,72316-1109,Public       ,31,178,209,787,1254,2041
02052200,BLACK RIVER TECHNICAL COLLEGE           ,AR,72455-0000,Public       ,56,224,280,805,1908,2713
02073500,UNIVERSITY OF ARKANSAS COMMUNITY COLLEGE,AR,72503-0000,Public       ,40,128,168,642,1113,1755
02073700,NORTHWEST TECHNICAL INSTITUTE           ,AR,72765-0000,Public       ,28,100,128,303,584,887
02074600,SOUTH ARKANSAS COMMUNITY COLLEGE        ,AR,71731-0000,Public       ,36,216,252,728,1923,2651
02075300,PULASKI TECHNICAL COLLEGE               ,AR,72118-0000,Public       ,286,1293,1579,4252,12554,16806
02087000,OZARKA COLLEGE                          ,AR,72556-0000,Public       ,27,137,164,443,1213,1656
02111100,RICH MOUNTAIN COMMUNITY COLLEGE         ,AR,71953-0000,Public       ,22,62,84,295,511,806
02202400,PROFESSIONAL COSMETOLOGY EDUC CTR       ,AR,71730-5828,Proprietary  ,1,16,17,39,112,151
02220900,COSSATOT COMMUNITY COLLEGE              ,AR,71832-0000,Public       ,23,122,145,536,1009,1545
02272400,EASTERN COLLEGE OF HEALTH VOCATIONS     ,AR,72205-3535,Proprietary  ,29,113,142,215,755,970
02284200,NEW TYLER BARBER COLLEGE INC            ,AR,72114-0000,Proprietary  ,6,37,43,68,201,269
02287400,MARSHA KAY BEAUTY COLLEGE               ,AR,72653-0000,Proprietary  ,0,0,0,7,20,27
02330800,JEFFERSON SCHOOL OF NURSING             ,AR,71603-0000,Private      ,7,22,29,84,248,332
02339800,SOUTHERN INSTITUTE OF COSMETOLOGY       ,AR,72301-0000,Proprietary  ,3,11,14,20,54,74
02341700,CAREER ACADEMY OF HAIR DESIGN           ,AR,72764-4304,Proprietary  ,3,27,30,36,112,148
02341701,CAREER ACADEMY OF HAIR DESIGN - ROGERS  ,AR,72756-2102,Proprietary  ,6,28,34,47,138,185
02341702,CAREER ACADEMY OF HAIR DESIGN - SILOAM  ,AR,72761-4217,Proprietary  ,5,9,14,21,51,72
02341703,CAREER ACADEMY OF HAIR DESIGN - FAYETTEV,AR,72701-7731,Proprietary  ,3,19,22,35,74,109
02348200,MID-SOUTH COMMUNITY COLLEGE             ,AR,72301-0000,Public       ,43,186,229,814,1661,2475
02363500,ARTHUR'S BEAUTY COLLEGE                 ,AR,72901-0000,Proprietary  ,5,30,35,61,221,282
02525800,LEE'S SCHOOL OF COSMETOLOGY             ,AR,72114-0000,Proprietary  ,5,24,29,42,137,179
02538500,ARTHUR'S BEAUTY COLLEGE                 ,AR,72076-0000,Proprietary  ,5,24,29,71,240,311
02569600,SEARCY BEAUTY COLLEGE                   ,AR,72143-0000,Proprietary  ,0,18,18,28,131,159
03005100,ARKANSAS BEAUTY SCHOOL                  ,AR,72209-5116,Proprietary  ,15,38,53,88,252,340
03007100,HOT SPRINGS BEAUTY COLLEGE              ,AR,71901-5432,Proprietary  ,4,27,31,38,142,180
03007600,ARKANSAS BEAUTY SCHOOL-CONWAY           ,AR,72032-4354,Proprietary  ,11,24,35,68,145,213
03023400,ARKANSAS COLLEGE OF BARBERING           ,AR,72114-5615,Proprietary  ,12,53,65,111,354,465
03063300,NORTHWEST ARKANSAS COMMUNITY COLLEG     ,AR,72712-5190,Public       ,237,642,879,3774,5633,9407
03065100,ABC BEAUTY COLLEGE                      ,AR,71923-4206,Proprietary  ,2,12,14,27,72,99
03066302,BRYAN UNIVERSITY - ROGERS               ,AR,72756-1825,Proprietary  ,6,66,72,59,303,362
03105200,BAPTIST HEALTH SCHOOLS LITTLE ROCK      ,AR,72210-2820,Private      ,32,175,207,581,1863,2444
03115102,HERITAGE COLLEGE - LITTLE ROCK          ,AR,72227-5544,Proprietary  ,44,178,222,239,959,1198
03124900,IMAGINE -  PAUL MITCHELL PARTNER SCHOOL ,AR,72117-2516,Proprietary  ,27,54,81,239,431,670
03214300,VELVATEX COLLEGE OF BEAUTY CULTURE      ,AR,72202-5452,Proprietary  ,0,14,14,23,84,107
03254300,MARGARET'S HAIR ACADEMY                 ,AR,71655-4905,Proprietary  ,4,10,14,29,96,125
03519400,"LYNNDALE FUNDAMENTALS OF BEAUTY SCHOOL, ",AR,71730-4804,Proprietary  ,0,0,0,3,8,11
03855300,ECCLESIA COLLEGE                        ,AR,72762-8159,Private      ,11,28,39,201,151,352
03912300,CROSSETT SCHOOL OF COSMETOLOGY          ,AR,71635-0000,Proprietary  ,2,11,13,25,42,67
03997300,ARKANSAS BEAUTY COLLEGE                 ,AR,72801-3741,Proprietary  ,4,12,16,39,83,122
04183100,WASHINGTON BARBER COLLEGE               ,AR,72209-3820,Proprietary  ,7,37,44,55,206,261
04183400,SALON PROFESSIONAL ACADEMY (THE)        ,AR,72116-7310,Proprietary  ,8,26,34,62,160,222
04203400,ARKANSAS STATE UNIVERSITY - NEWPORT     ,AR,72112-9073,Public       ,53,209,262,1026,1853,2879
04220000,DESIGNER BARBER & STYLIST SCHOOL        ,AR,72903-3753,Proprietary  ,6,24,30,36,106,142
04241800,ACADEMY OF PROFESSIONAL COSMETOLOGY     ,AR,72756-2028,Proprietary  ,6,14,20,10,41,51
00133900,CORBAN UNIVERSITY                       ,OR,97301-9392,Private      ,66,65,131,2075,857,2932
00318600,BLUE MOUNTAIN COMMUNITY COLLEGE         ,OR,97801-0000,Public       ,67,163,230,1254,1797,3051
00318800,CENTRAL OREGON COMMUNITY COLLEGE        ,OR,97701-5998,Public       ,192,583,775,3110,6108,9218
00318900,CLATSOP COMMUNITY COLLEGE               ,OR,97103-3698,Public       ,23,107,130,530,1023,1553
00319100,CONCORDIA UNIVERSITY                    ,OR,97211-6099,Private      ,89,1136,1225,2247,10564,12811
00319300,EASTERN OREGON UNIVERSITY               ,OR,97850-2899,Public       ,118,192,310,2876,3226,6102
00319400,GEORGE FOX UNIVERSITY                   ,OR,97132-2697,Private      ,110,175,285,4260,2497,6757
00319600,LANE COMMUNITY COLLEGE                  ,OR,97405-0640,Public       ,361,861,1222,6589,11026,17615
00319700,LEWIS & CLARK COLLEGE                   ,OR,97219-7899,Private      ,217,120,337,5735,3208,8943
00319800,LINFIELD COLLEGE                        ,OR,97128-6894,Private      ,99,84,183,3694,1198,4892
00319801,LINFIELD COLLEGE - PORTLAND CAMPUS      ,OR,97210-0000,Private      ,36,82,118,760,1215,1975
00319900,MARYLHURST UNIVERSITY                   ,OR,97036-7036,Private      ,12,122,134,137,1585,1722
00320300,MOUNT ANGEL SEMINARY                    ,OR,97373-9700,Private      ,2,1,3,10,24,34
00320400,MOUNT HOOD COMMUNITY COLLEGE            ,OR,97030-3300,Public       ,291,798,1089,5385,9222,14607
00320600,MULTNOMAH UNIVERSITY                    ,OR,97220-5898,Private      ,30,86,116,490,949,1439
00320700,PACIFIC NORTHWEST COLLEGE OF ART        ,OR,97209-3023,Private      ,68,52,120,746,841,1587
00320800,NORTHWEST CHRISTIAN UNIVERSITY          ,OR,97401-3727,Private      ,27,57,84,800,930,1730
00320900,WESTERN OREGON UNIVERSITY               ,OR,97361-1394,Public       ,236,166,402,7839,3496,11335
00321000,OREGON STATE UNIVERSITY                 ,OR,97331-8507,Public       ,972,1136,2108,27790,16158,43948
00321100,OREGON INSTITUTE OF TECHNOLOGY          ,OR,97601-8801,Public       ,87,174,261,3115,2814,5929
00321200,PACIFIC UNIVERSITY                      ,OR,97116-1797,Private      ,128,109,237,4206,3378,7584
00321300,PORTLAND COMMUNITY COLLEGE              ,OR,97219-7198,Public       ,943,2908,3851,15816,35694,51510
00321311,PORTLAND COMMUNITY COLLEGE - TILLAMOOK B,OR,97141-2599,Public       ,0,0,0,169,257,426
00321600,PORTLAND STATE UNIVERSITY               ,OR,97207-0000,Public       ,764,1527,2291,18117,25550,43667
00321700,REED COLLEGE                            ,OR,97202-8199,Private      ,134,70,204,3455,855,4310
00321800,CHEMEKETA COMMUNITY COLLEGE             ,OR,97309-1500,Public       ,367,1126,1493,6860,12440,19300
00321900,SOUTHERN OREGON UNIVERSITY              ,OR,97520-5010,Public       ,213,255,468,5940,3869,9809
00322000,SOUTHWESTERN OREGON COMMUNITY CLG       ,OR,97420-2956,Public       ,71,167,238,1662,1711,3373
00322100,TREASURE VALLEY COMMUNITY COLLEGE       ,OR,97914-3423,Public       ,85,216,301,1622,2312,3934
00322200,UMPQUA COMMUNITY COLLEGE                ,OR,97470-0226,Public       ,51,217,268,1249,2441,3690
00322300,UNIVERSITY OF OREGON                    ,OR,97403-1226,Public       ,1044,607,1651,26953,10804,37757
00322400,UNIVERSITY OF PORTLAND                  ,OR,97203-5798,Private      ,361,240,601,11719,3540,15259
00322500,WARNER PACIFIC COLLEGE                  ,OR,97215-4099,Private      ,46,175,221,1248,1890,3138
00322700,WILLAMETTE UNIVERSITY                   ,OR,97301-3930,Private      ,187,84,271,5184,1488,6672
00487800,CLACKAMAS COMMUNITY COLLEGE             ,OR,97045-7998,Public       ,225,611,836,4171,6188,10359
00488200,OREGON HEALTH & SCIENCE UNIVERSITY      ,OR,97239-0000,Public       ,50,214,264,1201,4709,5910
00693800,LINN BENTON COMMUNITY COLLEGE           ,OR,97321-3774,Public       ,200,448,648,3909,5218,9127
00717800,WESTERN SEMINARY                        ,OR,97215-0000,Private      ,5,75,80,33,665,698
00723402,HEALD COLLEGE - PORTLAND                ,OR,97205-3432,Proprietary  ,23,86,109,321,1194,1515
00732969,ITT TECHNICAL INSTITUTE                 ,OR,97220-6819,Proprietary  ,53,271,324,519,2240,2759
00737101,MARINELLO SCHOOL OF BEAUTY - PORTLAND   ,OR,97212-3732,Proprietary  ,0,0,0,81,148,229
00781900,ART INSTITUTE OF PORTLAND (THE)         ,OR,97209-2911,Proprietary  ,157,180,337,1652,1942,3594
00888700,CONCORDE CAREER INSTITUTE               ,OR,97232-2242,Proprietary  ,46,152,198,427,1280,1707
00907900,EVEREST COLLEGE                         ,OR,97204-2296,Proprietary  ,23,97,120,266,954,1220
00958100,SPRINGFIELD COLLEGE OF BEAUTY           ,OR,97477-5474,Proprietary  ,7,17,24,64,157,221
01012200,PHAGANS' MEDFORD BEAUTY SCHOOL          ,OR,97504-5297,Proprietary  ,9,32,41,79,231,310
01018200,ROGUE COMMUNITY COLLEGE                 ,OR,97527-0000,Public       ,171,627,798,2852,6640,9492
01050700,ACADEMY OF HAIR DESIGN                  ,OR,97301-3526,Proprietary  ,8,21,29,75,226,301
01230900,UNIVERSITY OF WESTERN STATES            ,OR,97230-3099,Private      ,8,59,67,117,841,958
01234700,PHAGANS CENTRAL OREGON BEAUTY CLG       ,OR,97701-5175,Proprietary  ,7,33,40,105,249,354
01234800,PHAGANS BEAUTY COLLEGE                  ,OR,97333-4716,Proprietary  ,3,18,21,62,141,203
01235000,PHAGANS SCHOOL OF HAIR DESIGN           ,OR,97086-7721,Proprietary  ,19,21,40,108,200,308
01235100,PHAGANS SCHOOL OF BEAUTY                ,OR,97301-4732,Proprietary  ,12,28,40,82,249,331
01300800,PHAGANS TIGARD BEAUTY SCHOOL            ,OR,97223-0000,Proprietary  ,0,6,6,20,62,82
02101000,NORTHWEST COLLEGE OF HAIR DESIGN        ,OR,97086-7702,Proprietary  ,38,90,128,269,659,928
02101002,NORTHWEST COLLEGE                       ,OR,97007-3954,Proprietary  ,3,6,9,39,89,128
02104900,SUMNER COLLEGE                          ,OR,97219-4063,Proprietary  ,11,52,63,119,544,663
02106100,COLLEGE OF COSMETOLOGY                  ,OR,97601-0000,Proprietary  ,5,21,26,56,123,179
02154400,BEAU MONDE CLG OF HAIR DESIGN           ,OR,97205-0000,Proprietary  ,8,30,38,132,305,437
02154401,BEAU MONDE COLLEGE OF HAIR DESIGN - BEAU,OR,97232-1315,Proprietary  ,6,22,28,15,52,67
02159700,NEW HOPE CHRISTIAN COLLEGE              ,OR,97405-1194,Private      ,17,26,43,278,280,558
02201900,PHAGANS' SCHOOL OF HAIR DESIGN          ,OR,97232-0000,Proprietary  ,14,44,58,155,447,602
02239203,ANTHEM COLLEGE - BEAVERTON              ,OR,97005-0000,Proprietary  ,0,0,0,133,333,466
02311000,PAUL MITCHELL THE SCHOOL                ,OR,97205-3724,Proprietary  ,17,57,74,241,367,608
02330100,PIONEER PACIFIC COLLEGE                 ,OR,97070-0000,Proprietary  ,35,124,159,356,1056,1412
02330102,PIONEER PACIFIC COLLEGE                 ,OR,97403-0000,Proprietary  ,29,103,132,261,1021,1282
02337900,COLLEGE OF HAIR DESIGN CAREERS          ,OR,97301-0000,Proprietary  ,11,26,37,77,218,295
02344100,ROSEBURG BEAUTY COLLEGE                 ,OR,97470-0000,Proprietary  ,3,26,29,52,157,209
02534000,NATIONAL COLLEGE OF NATURAL MEDICINE    ,OR,97201-0000,Private      ,10,52,62,98,1096,1194
02578800,NORTHWEST NANNIES INSTITUTE             ,OR,97035-0000,Proprietary  ,2,2,4,28,18,46
02603700,OREGON COL OF ORIENTAL MEDICINE         ,OR,97216-0000,Private      ,7,31,38,50,512,562
02617506,EVEREST COLLEGE - EVEREST INSTITUTE     ,OR,97223-6581,Proprietary  ,20,52,72,139,404,543
03007300,OREGON COLLEGE OF ART & CRAFT           ,OR,97225-6399,Private      ,23,33,56,354,562,916
03022600,LE CORDON BLEU COLLEGE OF CULINARY ARTS ,OR,97205-2793,Proprietary  ,62,234,296,809,1602,2411
03042500,CARRINGTON COLLEGE                      ,OR,97232-1302,Proprietary  ,42,166,208,238,887,1125
03074400,PHAGANS NEWPORT ACAD CSMTLGY CAREER     ,OR,97365-4963,Proprietary  ,4,9,13,26,71,97
03074500,EAST-WEST COLLEGE OF THE HEALING ARTS   ,OR,97232-2765,Proprietary  ,14,61,75,109,512,621
03185300,PHAGANS GRANTS PASS COLLEGE OF BTY      ,OR,97527-0000,Proprietary  ,4,15,19,51,119,170
03428300,KLAMATH COMMUNITY COLLEGE               ,OR,97603-7121,Public       ,34,157,191,678,1537,2215
03642300,INSTITUTE OF TECHNOLOGY                 ,OR,97305-1373,Proprietary  ,19,94,113,196,712,908
03668300,BIRTHINGWAY COLLEGE OF MIDWIFERY        ,OR,97266-4042,Private      ,4,29,33,45,286,331
03783400,ABDILL CAREER COLLEGE                   ,OR,97504-7137,Proprietary  ,9,61,70,94,393,487
04146500,PORTLAND ACTORS CONSERVATORY            ,OR,97201-2557,Private      ,5,11,16,65,160,225
04151900,COLUMBIA GORGE COMMUNITY COLLEGE        ,OR,97058-3434,Public       ,29,78,107,592,961,1553
04167400,SAGE SCHOOL OF MASSAGE & HEALING ARTS   ,OR,97701-4082,Proprietary  ,1,22,23,34,182,216
04171400,AVEDA INSTITUTE PORTLAND                ,OR,97209-3144,Proprietary  ,38,73,111,391,597,988
04194400,AMERICAN COLLEGE OF HEALTHCARE SCIENCES ,OR,97239-3719,Proprietary  ,18,228,246,195,1493,1688
04194900,TILLAMOOK BAY COMMUNITY COLLEGE         ,OR,97141-2807,Public       ,12,28,40,188,398,586
00137400,ALBERTUS MAGNUS COLLEGE                 ,CT,06511-1189,Private      ,25,180,205,1145,2098,3243
00137800,CENTRAL CONNECTICUT STATE UNIV          ,CT,06050-2490,Public       ,320,416,736,12099,5711,17810
00137900,CONNECTICUT COLLEGE                     ,CT,06320-4196,Private      ,89,17,106,3449,223,3672
00138000,WESTERN CONNECTICUT STATE UNIV          ,CT,06810-6826,Public       ,192,159,351,6194,2154,8348
00138500,FAIRFIELD UNIVERSITY                    ,CT,06430-0000,Private      ,217,92,309,7896,1207,9103
00138700,HARTFORD SEMINARY                       ,CT,06105-0000,Private      ,2,10,12,23,119,142
00138900,HOLY APOSTLES COLLEGE & SEMINARY        ,CT,06416-2027,Private      ,0,8,8,18,85,103
00139200,MANCHESTER COMMUNITY COLLEGE            ,CT,06045-1046,Public       ,248,484,732,4305,4512,8817
00139300,MITCHELL COLLEGE                        ,CT,06320-4498,Private      ,23,19,42,1055,320,1375
00139700,UNIVERSITY OF NEW HAVEN                 ,CT,06516-1999,Private      ,242,166,408,10012,2461,12473
00139800,NORTHWESTERN CT COMMUNITY COLLEGE       ,CT,06098-1747,Public       ,46,81,127,657,815,1472
00139900,NORWALK COMMUNITY TECHNICAL COLLEGE     ,CT,06854-1655,Public       ,169,359,528,2766,3377,6143
00140100,POST UNIVERSITY                         ,CT,06723-3240,Proprietary  ,212,2251,2463,2087,13127,15214
00140200,QUINNIPIAC UNIVERSITY                   ,CT,06518-1908,Private      ,394,186,580,17752,3222,20974
00140201,QUINNIPIAC UNIVERSITY SCHOOL OF LAW     ,CT,06518-0000,Private      ,7,21,28,91,654,745
00140300,SACRED HEART UNIVERSITY                 ,CT,06825-1000,Private      ,211,259,470,9061,3435,12496
00140600,SOUTHERN CONNECTICUT STATE UNIV         ,CT,06515-1355,Public       ,269,393,662,10148,6049,16197
00140900,SAINT JOSEPH COLLEGE                    ,CT,06117-2791,Private      ,31,139,170,1116,2195,3311
00141400,TRINITY COLLEGE                         ,CT,06106-3100,Private      ,109,26,135,3561,423,3984
00141600,UNIVERSITY OF BRIDGEPORT                ,CT,06601-5650,Private      ,111,306,417,3863,3798,7661
00141700,UNIVERSITY OF CONNECTICUT-STORRS        ,CT,06269-2151,Public       ,719,310,1029,33093,6410,39503
00141702,UNIV CONN STAMFORD                      ,CT,06901-0000,Public       ,35,66,101,1124,768,1892
00141703,UNIV OF CONNECTICUT - TORINGTON         ,CT,06790-0000,Public       ,16,14,30,282,154,436
00141706,UNIV OF CONNECTICUT SCH LAW             ,CT,06105-0000,Public       ,1,21,22,63,958,1021
00141707,UNIV OF CT - SCH OF SOCIAL WORK         ,CT,06117-0000,Public       ,4,34,38,166,710,876
00141708,UNIVERSITY OF CONNECTICUT - SCHOOL OF ME,CT,06030-1920,Public       ,14,16,30,176,657,833
00141709,UNIVERSITY OF CONNECTICUT - SCHOOL OF DE,CT,06030-1920,Public       ,24,18,42,321,362,683
00142200,UNIVERSITY OF HARTFORD                  ,CT,06117-1599,Private      ,227,144,371,10275,2530,12805
00142400,WESLEYAN UNIVERSITY                     ,CT,06459-3208,Private      ,133,20,153,5204,346,5550
00142500,EASTERN CONNECTICUT STATE UNIV          ,CT,06226-2295,Public       ,182,119,301,7118,1675,8793
00142600,YALE UNIVERSITY                         ,CT,06520-8288,Private      ,634,313,947,19245,8393,27638
00280301,RENSSELAER POLYTECHNIC INSTITUTE-RENSSEL,CT,06120-2991,Private      ,1,8,9,17,40,57
00451300,HOUSATONIC COMMUNITY COLLEGE            ,CT,06604-4704,Public       ,207,534,741,3146,4719,7865
00618100,BRIDGEPORT HOSP SCHL OF NURSING         ,CT,06610-2896,Private      ,19,65,84,198,724,922
00619100,ST. VINCENT'S COLLEGE                   ,CT,06606-9966,Private      ,20,106,126,329,1029,1358
00698200,NAUGATUCK VALLEY COMM-TECH COLG         ,CT,06708-3089,Public       ,218,492,710,3651,4559,8210
00730000,ELI WHITNEY TECHNICAL HIGH SCHOOL       ,CT,06514-0000,Public       ,1,10,11,22,77,99
00730300,LINCOLN TECHNICAL INSTITUTE             ,CT,06051-0000,Proprietary  ,37,157,194,533,1150,1683
00730306,LINCOLN TECHNICAL INSTITUTE - EAST WINDS,CT,06088-9631,Proprietary  ,65,64,129,1017,594,1611
00730500,PORTER AND CHESTER INSTITUTE OF BRANFORD,CT,06405-4022,Proprietary  ,22,80,102,252,455,707
00731100,WINDHAM TECHNICAL HIGH SCHOOL           ,CT,06226-2100,Public       ,0,0,0,7,14,21
00745900,PAIER COLLEGE OF ART                    ,CT,06514-3902,Proprietary  ,3,5,8,116,69,185
00763500,CAPITAL COMMUNITY COLLEGE               ,CT,06103-1207,Public       ,115,413,528,1988,4676,6664
00803700,GATEWAY COMMUNITY-TECHNICAL COLLEGE     ,CT,06511-0000,Public       ,247,623,870,4136,6538,10674
00803800,MIDDLESEX COMMUNITY CLG                 ,CT,06457-4889,Public       ,89,239,328,1473,1970,3443
00887300,PAUL MITCHELL THE SCHOOL                ,CT,06810-6716,Proprietary  ,5,10,15,103,101,204
00887400,MARINELLO SCHOOL OF BEAUTY              ,CT,06450-4836,Proprietary  ,10,23,33,49,114,163
00887401,MARINELLO SCHOOL OF BEAUTY - HAMDEN     ,CT,06514-4132,Proprietary  ,2,23,25,27,98,125
00887402,MARINELLO SCHOOL OF BEAUTY - FAIRFIELD  ,CT,06825-4847,Proprietary  ,10,52,62,69,207,276
00887403,MARINELLO SCHOOL OF BEAUTY - WILLIMANTIC,CT,06226-1940,Proprietary  ,3,18,21,29,83,112
00927700,E C GOODWIN TECHNICAL HIGH SCHOOL       ,CT,06053-0000,Public       ,3,11,14,33,73,106
00940700,LINCOLN COLLEGE OF NEW ENGLAND          ,CT,06489-1057,Proprietary  ,26,63,89,565,725,1290
00976400,TUNXIS COMMUNITY COLLEGE                ,CT,06032-3187,Public       ,144,250,394,2362,2494,4856
00976500,THREE RIVERS COMMUNITY COLLEGE          ,CT,06360-6598,Public       ,113,346,459,2130,3333,5463
00982200,ALBERT I PRINCE TECHNICAL HIGH SCHOOL   ,CT,06106-3799,Public       ,0,12,12,32,97,129
01041700,MARINELLO SCHOOL OF BEAUTY              ,CT,06108-2220,Proprietary  ,28,42,70,108,228,336
01053000,QUINEBAUG VALLEY COMMUNITY COLLEGE      ,CT,06239-1440,Public       ,50,168,218,971,1442,2413
01077900,PORTER AND CHESTER INSTITUTE-ALLCAMPUSES,CT,06615-7158,Proprietary  ,229,480,709,1664,3271,4935
01115000,ASNUNTUCK COMMUNITY COLLEGE             ,CT,06082-3800,Public       ,46,109,155,718,980,1698
01149600,BULLARD HAVENS VOC TECH SCHOOL          ,CT,06610-3499,Public       ,3,22,25,41,158,199
01169700,VINAL REGIONAL VOC TECH SCHOOL          ,CT,06457-4918,Public       ,1,3,4,6,39,45
01184300,NORWICH TECHNICAL HIGH SCHOOL           ,CT,06360-7097,Public       ,0,5,5,10,64,74
01242500,STONE ACADEMY                           ,CT,06516-4049,Proprietary  ,43,200,243,215,914,1129
01242503,STONE ACADEMY -WATERBURY                ,CT,06705-3823,Proprietary  ,4,8,12,47,121,168
01242504,STONE ACADEMY -  EAST HARTFORD          ,CT,06118-0000,Proprietary  ,8,36,44,73,339,412
01287700,SANFORD-BROWN COLLEGE                   ,CT,06855-1436,Proprietary  ,0,0,0,20,35,55
01291300,LEON INSTITUTE OF HAIR DESIGN           ,CT,06604-4226,Proprietary  ,0,0,0,0,4,4
02074000,BRANFORD HALL CAREER INSTITUTE          ,CT,06405-0000,Proprietary  ,147,619,766,934,3417,4351
02106600,AMERICAN INSTITUTE                      ,CT,06110-1922,Proprietary  ,17,80,97,111,486,597
02112300,RIDLEY LOWELL BUSINESS & TECH INST      ,CT,06320-0000,Proprietary  ,20,106,126,165,685,850
02112700,NORTH HAVEN ACADEMY                     ,CT,06473-3108,Proprietary  ,22,19,41,133,120,253
02148700,CONNECTICUT INST OF HAIR DESIGN         ,CT,06716-0000,Proprietary  ,1,8,9,17,45,62
02202500,NEW ENGLAND TRACTOR TRAILER SCH         ,CT,06071-2036,Proprietary  ,33,340,373,111,1169,1280
02244900,GOODWIN COLLEGE                         ,CT,06118-9980,Private      ,85,524,609,1301,5379,6680
02245300,HOWELL CHENEY TECHNICAL HIGH SCHOOL     ,CT,06040-0000,Public       ,0,2,2,13,26,39
02265900,WINDHAM COMMUNITY MEM HOSP-RAD TECH     ,CT,06226-0000,Private      ,0,1,1,14,41,55
02296100,YALE-NEW HAVEN HOSP DIETETIC INTERN     ,CT,06510-8900,Private      ,0,5,5,28,50,78
02300000,W F KAYNOR TECHNICAL HIGH SCHOOL        ,CT,06708-0000,Public       ,0,9,9,25,72,97
02316600,CONNECTICUT CTR FOR MASSAGE THERAPY     ,CT,06111-3975,Proprietary  ,19,43,62,76,200,276
02316601,CONNECTICUT CENTER FOR MASSAGE THERAPY -,CT,06880-4619,Proprietary  ,10,39,49,39,131,170
02316603,CONNECTICUT CENTER FOR MASSAGE THERAPY -,CT,06340-4619,Proprietary  ,9,25,34,36,99,135
02565000,PLATT TECHNICAL HIGH SCHOOL             ,CT,06460-2105,Public       ,0,2,2,8,29,37
03079400,LYME ACADEMY COLLEGE OF FINE ARTS       ,CT,06371-2333,Private      ,2,1,3,101,37,138
03094800,INDUSTRIAL MANAGEMENT & TRAINING        ,CT,06706-1211,Proprietary  ,5,14,19,44,127,171
03234300,CHARTER OAK STATE COLLEGE               ,CT,06053-2150,Public       ,17,218,235,164,2312,2476
03316300,LINCOLN TECHNICAL INSTITUTE - HARTFORD  ,CT,06105-3630,Proprietary  ,30,69,99,477,534,1011
03927300,MARINELLO SCHOOL OF BEAUTY              ,CT,06357-2447,Proprietary  ,7,7,14,25,78,103
03927301,MARINELLO SCHOOL OF BEAUTY  - TORRINGTON,CT,06790-5425,Proprietary  ,10,9,19,32,47,79
03927302,MARINELLO SCHOOL OF BEAUTY  -  ENFIELD  ,CT,06082-2946,Proprietary  ,0,2,2,14,28,42
04104300,ACADEMY DI CAPELLI - SCHOOL OF COSMETOLO,CT,06492-0000,Proprietary  ,14,29,43,75,108,183
04128800,BRANFORD ACADEMY OF HAIR & COSMETOLOGY  ,CT,06405-0000,Proprietary  ,4,16,20,17,68,85
04145400,OXFORD ACADEMY OF HAIR DESIGN           ,CT,06483-2911,Proprietary  ,8,10,18,56,63,119
04148400,EUROPEAN ACADEMY OF COSMETOLOGY AND HAIR,CT,06437-0000,Proprietary  ,2,3,5,24,18,42
04152400,INTERNATIONAL INSTITUTE OF COSMETOLOGY  ,CT,06109-0000,Proprietary  ,21,16,37,108,116,224
04219200,ACE COSMETOLOGY & BARBERING TRAINING CEN,CT,06716-0000,Proprietary  ,1,8,9,15,34,49
04224200,BELLE ACADEMY OF COSMETOLOGY            ,CT,06704-0135,Proprietary  ,4,13,17,26,78,104
04230900,RICCI'S ACADEMY OF COSMETOLOGY          ,CT,06470-0000,Proprietary  ,6,10,16,49,51,100
00146600,BARRY UNIVERSITY                        ,FL,33161-6695,Private      ,242,613,855,5934,9158,15092
00146601,BARRY UNIVERSITY - ORLANDO              ,FL,32807-3673,Private      ,35,124,159,451,2076,2527
00146700,BETHUNE COOKMAN UNIVERSITY              ,FL,32114-3099,Private      ,342,178,520,8180,2456,10636
00146800,ST THOMAS UNIVERSITY                    ,FL,33054-0000,Private      ,90,344,434,1779,3094,4873
00146900,FLORIDA INSTITUTE OF TECHNOLOGY         ,FL,32901-6988,Private      ,232,924,1156,5333,8702,14035
00147000,EASTERN FLORIDA STATE COLLEGE           ,FL,32922-6503,Public       ,431,1111,1542,6478,10518,16996
00147100,COLLEGE OF CENTRAL FLORIDA              ,FL,34474-4415,Public       ,302,744,1046,4785,7940,12725
00147200,CHIPOLA  COLLEGE                        ,FL,32446-2053,Public       ,67,176,243,1119,1414,2533
00147300,CLEARWATER CHRISTIAN COLLEGE            ,FL,33759-0000,Private      ,24,26,50,725,242,967
00147500,DAYTONA STATE COLLEGE                   ,FL,32114-2800,Public       ,632,1406,2038,8362,13171,21533
00147700,EDISON STATE COLLEGE                    ,FL,33906-6210,Public       ,488,900,1388,8879,10278,19157
00147800,EDWARD WATERS COLLEGE                   ,FL,32209-6199,Private      ,65,103,168,1454,1192,2646
00147900,EMBRY-RIDDLE AERONAUTICAL UNIV          ,FL,32114-3900,Private      ,318,1361,1679,7927,10189,18116
00148000,FLORIDA A & M UNIVERSITY                ,FL,32307-3100,Public       ,859,528,1387,15815,8660,24475
00148100,FLORIDA ATLANTIC UNIVERSITY             ,FL,33431-6498,Public       ,1536,1346,2882,28629,19104,47733
00148101,FLORIDA ATLANTIC UNIVERSITY/DAVIE       ,FL,33314-0000,Public       ,159,429,588,3190,5696,8886
00148103,FLORIDA ATLANTIC UNIV-JUPITER/PSL       ,FL,33458-0000,Public       ,81,116,197,1518,1512,3030
00148200,FLORIDA COLLEGE                         ,FL,33617-5578,Private      ,20,10,30,594,127,721
00148400,FLORIDA STATE COLLEGE AT JACKSONVILLE   ,FL,32202-4030,Public       ,1056,3052,4108,14251,28219,42470
00148500,FLORIDA KEYS COMMUNITY COLLEGE          ,FL,33040-4397,Public       ,42,96,138,723,813,1536
00148600,FLORIDA MEMORIAL UNIVERSITY             ,FL,33054-6199,Private      ,129,142,271,2980,1646,4626
00148700,ECKERD COLLEGE                          ,FL,33711-4744,Private      ,122,125,247,3495,1128,4623
00148800,FLORIDA SOUTHERN COLLEGE                ,FL,33801-5698,Private      ,195,169,364,4500,1603,6103
00148900,FLORIDA STATE UNIVERSITY                ,FL,32306-2430,Public       ,2671,1237,3908,54204,20091,74295
00149000,GULF COAST STATE COLLEGE                ,FL,32401-1058,Public       ,184,681,865,2792,5376,8168
00149300,INDIAN RIVER STATE COLLEGE              ,FL,34981-5596,Public       ,496,1244,1740,7636,11176,18812
00149500,JACKSONVILLE UNIVERSITY                 ,FL,32211-3394,Private      ,223,487,710,4149,4720,8869
00149700,JONES COLLEGE                           ,FL,32205-5395,Private      ,13,85,98,144,1007,1151
00149900,EVEREST UNIVERSITY                      ,FL,32810-5601,Proprietary  ,64,419,483,705,4449,5154
00149901,EVEREST UNIVERSITY - ORLANDO SOUTH      ,FL,32819-7666,Proprietary  ,331,2986,3317,2300,27574,29874
00149902,EVEREST UNIVERSITY - MELBOURNE          ,FL,32905-6609,Proprietary  ,20,154,174,174,1137,1311
00149904,EVEREST UNIVERSITY - TAMPA              ,FL,33614-5801,Proprietary  ,44,333,377,497,3628,4125
00149905,EVEREST UNIVERSITY - BRANDON            ,FL,33619-1354,Proprietary  ,51,422,473,453,5148,5601
00149906,EVEREST UNIVERSITY - ORANGE PARK        ,FL,32073-1111,Proprietary  ,19,116,135,154,1045,1199
00149907,EVEREST UNIVERSITY - LARGO              ,FL,33770-2556,Proprietary  ,16,96,112,121,838,959
00149908,EVEREST UNIVERSITY - LAKELAND           ,FL,33801-3801,Proprietary  ,33,161,194,232,1119,1351
00149909,EVEREST UNIVERSITY - JACKSONVILLE       ,FL,32256-0000,Proprietary  ,34,243,277,321,1875,2196
00149910,EVEREST UNIVERSITY - POMPANO            ,FL,33062-2522,Proprietary  ,26,212,238,244,2834,3078
00149913,EVEREST INSTITUTE - MIAMI               ,FL,33169-4759,Proprietary  ,7,54,61,197,687,884
00149914,EVEREST INSTITUTE - KENDALL             ,FL,33186-1410,Proprietary  ,7,30,37,138,455,593
00150000,BROWARD COLLEGE- DOWNTOWN CTR           ,FL,33301-2298,Public       ,647,1798,2445,10307,17441,27748
00150001,BROWARD COLLEGE - A. HUGH ADAMS CENTRAL ,FL,33314-1604,Public       ,702,1420,2122,11175,13332,24507
00150002,BROWARD COLLEGE - NORTH CAMPUS          ,FL,33066-1697,Public       ,463,1094,1557,7039,10998,18037
00150003,BROWARD  COLLEGE - JUDSON A. SAMUELS SOU,FL,33024-7225,Public       ,492,1071,1563,7875,10549,18424
00150100,FLORIDA GATEWAY COLLEGE                 ,FL,32025-2007,Public       ,86,339,425,1292,2743,4035
00150200,LAKE SUMTER COMMUNITY COLLEGE           ,FL,34788-8751,Public       ,196,376,572,2807,3170,5977
00150400,"STATE COLLEGE OF FLORIDA, MANATEE-SARASO",FL,34207-3596,Public       ,396,794,1190,5621,7738,13359
00150500,LYNN UNIVERSITY                         ,FL,33431-5598,Private      ,137,148,285,3080,1370,4450
00150600,MIAMI DADE COLLEGE ADMINISTRATION ONLY  ,FL,33176-3393,Public       ,46,114,160,672,992,1664
00150601,MIAMI DADE COLLEGE - NORTH CAMPUS       ,FL,33167-3495,Public       ,861,1766,2627,15484,18142,33626
00150602,MIAMI DADE COLLEGE - KENDALL CAMPUS     ,FL,33176-3393,Public       ,1248,1862,3110,21508,17452,38960
00150603,MIAMI DADE COLLEGE - WOLFSON CAMPUS     ,FL,33132-2297,Public       ,745,1443,2188,12909,13076,25985
00150604,MIAMI DADE COLLEGE - MEDICAL CAMPUS     ,FL,33127-4693,Public       ,242,839,1081,4059,7842,11901
00150605,MIAMI DADE COLLEGE - HOMESTEAD CAMPUS   ,FL,33030-6009,Public       ,269,527,796,3535,4404,7939
00150606,MIAMI DADE COLLEGE -INTERAMERICAN CAMPUS,FL,33135-0000,Public       ,325,869,1194,4805,7762,12567
00150607,MIAMI DADE COLLEGE - HIALEAH CAMPUS     ,FL,33012-2918,Public       ,416,596,1012,4892,5198,10090
00150800,NORTH FLORIDA COMMUNITY COLLEGE         ,FL,32340-1699,Public       ,31,135,166,583,988,1571
00150900,NOVA SOUTHEASTERN UNIVERSITY            ,FL,33314-7796,Private      ,420,1885,2305,7732,29968,37700
00151000,NORTHWEST FLORIDA STATE COLLEGE         ,FL,32578-1295,Public       ,184,740,924,2353,5153,7506
00151200,PALM BEACH COMMUNITY COLLEGE            ,FL,33461-4796,Public       ,1097,1806,2903,16242,17492,33734
00151300,PENSACOLA STATE COLLEGE                 ,FL,32504-8998,Public       ,419,1201,1620,5131,9584,14715
00151400,POLK STATE COLLEGE                      ,FL,33881-4256,Public       ,391,877,1268,5746,9236,14982
00151500,ROLLINS COLLEGE                         ,FL,32789-4499,Private      ,176,148,324,3653,1585,5238
00151900,SANTA FE COLLEGE                        ,FL,32606-6200,Public       ,622,951,1573,10565,10074,20639
00152000,SEMINOLE STATE COLLEGE OF FLORIDA       ,FL,32773-6199,Public       ,768,1518,2286,10664,15108,25772
00152100,SOUTHEASTERN UNIVERSITY                 ,FL,33801-6099,Private      ,226,277,503,4539,2297,6836
00152200,SOUTH FLORIDA COMMUNITY COLLEGE         ,FL,33825-9399,Public       ,104,213,317,1508,2139,3647
00152300,SAINT JOHNS RIVER STATE COLLEGE         ,FL,32177-3897,Public       ,220,537,757,3143,4928,8071
00152600,SAINT LEO UNIVERSITY                    ,FL,33574-6665,Private      ,223,1658,1881,4659,18162,22821
00152800,ST. PETERSBURG COLLEGE                  ,FL,33760-3768,Public       ,901,2589,3490,11496,26464,37960
00153100,STETSON UNIVERSITY                      ,FL,32723-3761,Private      ,274,86,360,7142,1107,8249
00153101,STETSON UNIVERSITY - COLLEGE OF LAW     ,FL,33707-3299,Private      ,12,54,66,122,1698,1820
00153300,TALLAHASSEE COMMUNITY COLLEGE           ,FL,32304-2895,Public       ,652,929,1581,11325,9946,21271
00153500,UNIVERSITY OF FLORIDA                   ,FL,32611-3150,Public       ,2249,1495,3744,48957,23011,71968
00153600,UNIVERSITY OF MIAMI                     ,FL,33146-6531,Private      ,1116,602,1718,23344,7131,30475
00153601,UNIV OF MIAMI SCHOOL OF LAW             ,FL,33124-0000,Private      ,15,37,52,202,1999,2201
00153602,UNIV OF MIAMI-SCH OF MEDICINE           ,FL,33136-0000,Private      ,82,96,178,1080,2071,3151
00153700,UNIVERSITY OF SOUTH FLORIDA             ,FL,33620-6960,Public       ,2139,2000,4139,44780,27789,72569
00153701,UNIV OF SOUTH FLORIDA-ST PETERSBURG     ,FL,33701-0000,Public       ,308,423,731,5192,4520,9712
00153702,UNIV OF SOUTH FLORIDA-SARASOTA          ,FL,34243-2025,Public       ,75,165,240,1373,2193,3566
00153705,UNIV OF SOUTH FLORIDA                   ,FL,33803-0000,Public       ,88,133,221,1371,1364,2735
00153706,UNIV OF SOUTH FLORIDA- MEDICINE         ,FL,33612-0000,Public       ,146,139,285,1872,2547,4419
00153800,UNIVERSITY OF TAMPA                     ,FL,33606-1490,Private      ,660,371,1031,14762,4201,18963
00154000,WEBBER INTERNATIONAL UNIVERSITY         ,FL,33827-0096,Private      ,36,42,78,1515,443,1958
00173308,NATIONAL-LOUIS UNIVERSITY               ,FL,33609-0000,Private      ,1,12,13,21,119,140
00177201,TRINITY INTERNATIONAL UNIVERSITY - SOUTH,FL,33324-4611,Private      ,6,48,54,81,536,617
00349503,JOHNSON UNIVERSITY - FLORIDA            ,FL,34744-5301,Private      ,0,0,0,164,85,249
00395400,UNIV OF CENTRAL FLORIDA                 ,FL,32816-0001,Public       ,3370,2292,5662,71017,35904,106921
00395500,UNIVERSITY OF WEST FLORIDA              ,FL,32514-5750,Public       ,499,835,1334,10654,9144,19798
00407215,NORTHWOOD UNIVERSITY                    ,FL,33409-0000,Private      ,31,72,103,836,578,1414
00491005,KAPLAN COLLEGE JACKSONVILLE             ,FL,32216-3216,Proprietary  ,29,374,403,220,3009,3229
00558500,LIVELY TECHNICAL CENTER                 ,FL,32304-0000,Public       ,83,306,389,738,2287,3025
00558600,LINDSEY HOPKINS TECHNICAL ED CENTER     ,FL,33127-4692,Public       ,32,133,165,371,1176,1547
00559400,D G ERWIN TECHNICAL CENTER              ,FL,33610-8255,Public       ,82,292,374,729,2251,2980
00560500,PINELLAS TECH ED CTR-CLEARWATER         ,FL,33760-2194,Public       ,41,268,309,411,1612,2023
00560700,SARASOTA COUNTY TECHNICAL INSTITUTE     ,FL,34233-0000,Public       ,37,134,171,357,989,1346
00560800,MAYNARD A. TRAVISS CAREER CENTER        ,FL,33803-9709,Public       ,53,155,208,421,1304,1725
00561200,MANATEE TECHNICAL INSTITUTE             ,FL,34210-0000,Public       ,68,204,272,597,1510,2107
00561201,MANATEE TECHNICAL INSTITUTE-EAST        ,FL,34211-0000,Public       ,30,110,140,347,874,1221
00675000,VALENCIA COMMUNITY COLLEGE              ,FL,32802-3028,Public       ,2505,3402,5907,34135,31300,65435
00732910,ITT TECHNICAL INSTITUTE                 ,FL,33634-7515,Proprietary  ,156,681,837,1063,4440,5503
00732947,ITT TECHNICAL INSTITUTE                 ,FL,32746-1607,Proprietary  ,67,325,392,549,2723,3272
00736206,MEDTECH COLLEGE - MEDTECH INSTITUTE - OR,FL,32826-4906,Proprietary  ,32,172,204,246,1202,1448
00752500,SUWANNEE-HAMILTON AREA VOC TECH CTR     ,FL,32060-0000,Public       ,2,32,34,86,309,395
00752600,WASHINGTON HOLMES TECHNICAL CENTER      ,FL,32428-1699,Public       ,22,74,96,219,499,718
00755800,LEE COUNTY HIGH TECH CENTER CENTRAL     ,FL,33916-2299,Public       ,47,156,203,508,1207,1715
00787000,HILLSBOROUGH COMMUNITY COLLEGE          ,FL,33606-3572,Public       ,1245,2819,4064,16938,24748,41686
00789300,FLAGLER COLLEGE                         ,FL,32085-1027,Private      ,235,79,314,5337,1027,6364
00789301,FLAGLER COLLEGE - TALLAHASSEE COMMUNITY ,FL,32304-2895,Private      ,38,99,137,564,992,1556
00807500,ST JOHN VIANNEY COLLEGE SEMINARY        ,FL,33165-3244,Private      ,2,2,4,44,29,73
00822300,ST VINCENT DE PAUL REGIONL SEMINARY     ,FL,33436-0000,Private      ,0,1,1,0,16,16
00841700,STENOTYPE INST OF JACKSONVILLE          ,FL,32207-0000,Proprietary  ,5,47,52,42,329,371
00869410,RASMUSSEN COLLEGE - OCALA               ,FL,34471-7051,Proprietary  ,74,696,770,816,6847,7663
00869411,RASMUSSEN COLLEGE - NEW PORT RICHEY     ,FL,34690-4554,Proprietary  ,24,129,153,229,1276,1505
00869413,RASMUSSEN COLLEGE - FORT MYERS          ,FL,33905-7805,Proprietary  ,28,198,226,395,1671,2066
00869420,RASMUSSEN COLLEGE - TAMPA               ,FL,33610-9558,Proprietary  ,26,164,190,262,1320,1582
00869422,RASMUSSEN COLLEGE - PASCO               ,FL,33558-0000,Proprietary  ,12,57,69,84,493,577
00884800,WARNER UNIVERSITY                       ,FL,33859-8725,Private      ,60,99,159,1097,1002,2099
00884900,PALM BEACH ATLANTIC UNIVERSITY          ,FL,33401-6505,Private      ,171,229,400,4167,3053,7220
00887800,MIAMI INTERNATIONAL UNIV ART&DESIGN     ,FL,33132-1418,Proprietary  ,241,243,484,2639,2487,5126
00910400,TONI & GUY HAIRDRESSING ACADEMY         ,FL,32256-3810,Proprietary  ,3,11,14,24,61,85
00963500,FLORIDA INTERNATIONAL UNIVERSITY        ,FL,33199-0001,Public       ,2009,2321,4330,44383,35110,79493
00984100,UNIVERSITY OF NORTH FLORIDA             ,FL,32224-2645,Public       ,946,851,1797,17192,11086,28278
00990200,SHERIDAN TECHNICAL CENTER               ,FL,33021-3399,Public       ,124,404,528,849,2664,3513
01016100,"LORAINE'S ACADEMY, INC                  ",FL,33710-0000,Proprietary  ,8,65,73,53,306,359
01019500,ART INSTITUTE OF FT LAUDERDALE          ,FL,33316-3000,Proprietary  ,131,189,320,1758,1987,3745
01065200,PASCO-HERNANDO COMMUNITY CLG            ,FL,34654-5199,Public       ,461,953,1414,6111,8437,14548
01072401,CARLOS ALBIZU UNIVERSITY                ,FL,33172-0000,Private      ,10,133,143,144,1229,1373
01082600,TOM P. HANEY TECHNICAL CENTER           ,FL,32405-5099,Public       ,53,194,247,329,1242,1571
01112700,GOODING INST OF NUR ANES BAY MED CT     ,FL,32401-0000,Proprietary  ,6,16,22,27,155,182
01226300,ATLANTIC TECHNICAL CENTER               ,FL,33063-3902,Public       ,104,264,368,685,1720,2405
01246117,LINCOLN COLLEGE OF TECHNOLOGY - WEST PAL,FL,33407-3105,Proprietary  ,49,112,161,527,936,1463
01254400,FIRST COAST TECHNICAL COLLEGE           ,FL,32084-1921,Public       ,51,173,224,422,1175,1597
01257400,RINGLING SCHOOL OF ART AND DESIGN       ,FL,34234-5895,Private      ,84,35,119,2009,455,2464
01303904,SOUTH UNIVERSITY - WEST PALM BEACH CAMPU,FL,33409-5149,Proprietary  ,54,327,381,651,2427,3078
01323400,LORENZO WALKER INST OF TECHNOLOGY       ,FL,34104-4405,Public       ,37,101,138,411,843,1254
02089600,CONCORDE CAREER INSTITUTE               ,FL,32211-0000,Proprietary  ,34,231,265,341,1792,2133
02113609,AMERICAN INTERCONTINENTAL UNIV - WESTON ,FL,33326-3233,Proprietary  ,3,43,46,48,298,346
02115300,PINELLAS TECHNICAL EDUCATION CENTERS - S,FL,33711-0000,Public       ,65,382,447,534,2341,2875
02116006,SANFORD-BROWN INSTITUTE - FT. LAUDERDALE,FL,33309-1906,Proprietary  ,23,99,122,228,722,950
02148200,FASHION FOCUS HAIR ACADEMY              ,FL,34231-0000,Proprietary  ,3,21,24,42,115,157
02148300,MANHATTAN BEAUTY SCHOOL                 ,FL,33611-0000,Proprietary  ,10,47,57,89,277,366
02149900,PAUL MITCHELL THE SCHOOL-JACKSONVILLE   ,FL,32205-0000,Proprietary  ,20,51,71,143,370,513
02151900,KEISER  UNIVERSITY                      ,FL,33309-0000,Private      ,662,3237,3899,5307,21500,26807
02159600,BAPTIST COLLEGE OF FLORIDA (THE)        ,FL,32440-0000,Private      ,19,18,37,286,324,610
02172700,CONCORDE CAREER INSTITUTE               ,FL,33607-0000,Proprietary  ,21,146,167,214,944,1158
02188900,HOBE SOUND BIBLE COLLEGE                ,FL,33475-0000,Private      ,6,8,14,96,117,213
02200100,BRADENTON BEAUTY & BARBER ACADEMY       ,FL,34209-0000,Proprietary  ,3,28,31,41,165,206
02215900,ATI CAREER TRAINING CENTER              ,FL,33309-1785,Proprietary  ,7,46,53,36,168,204
02218700,FLORIDA TECHNICAL COLLEGE               ,FL,32826-2707,Proprietary  ,173,698,871,1311,4341,5652
02218707,FLORIDA TECHNICAL COLLEGE - LAKELAND    ,FL,33813-2101,Proprietary  ,21,83,104,243,647,890
02218709,FLORIDA TECHNICAL COLLEGE - DELAND      ,FL,32720-7415,Proprietary  ,39,221,260,242,1201,1443
02218710,FLORIDA TECHNICAL COLLEGE -KISSIMMEE    ,FL,34741-0000,Proprietary  ,0,0,0,1,0,1
02228300,LAKE TECHNICAL CENTER                   ,FL,32726-0000,Public       ,80,236,316,552,1515,2067
02245500,FORTIS COLLEGE                          ,FL,32789-4679,Proprietary  ,10,67,77,92,652,744
02257900,INTERNATIONAL ACADEMY                   ,FL,32119-3541,Proprietary  ,14,39,53,87,288,375
02275100,CONCORDE CAREER INSTITUTE               ,FL,33025-0000,Proprietary  ,20,96,116,172,615,787
02278800,SOUTHWEST FLORIDA COLLEGE               ,FL,33907-0000,Proprietary  ,119,335,454,850,2297,3147
02278801,SOUTHWEST FLORIDA COLLEGE - TAMPA       ,FL,33619-1344,Proprietary  ,48,167,215,522,1182,1704
02278802,SOUTHWEST FLORIDA COLLEGE - INSTITUTUE O,FL,33928-9469,Proprietary  ,7,15,22,61,158,219
02278803,SOUTHWEST FLORIDA COLLEGE - PORT CHARLOT,FL,33953-3100,Proprietary  ,30,107,137,220,763,983
02279600,CORTIVA INSTITUTE - FLORIDA             ,FL,33781-0000,Proprietary  ,75,170,245,115,314,429
02283800,BEAUTY SCHOOLS OF AMERICA               ,FL,33012-3322,Proprietary  ,87,468,555,491,2435,2926
02286502,ITT TECHNICAL INSTITUTE                 ,FL,32244-6630,Proprietary  ,0,0,0,0,2,2
02287100,LA BELLE BEAUTY SCHOOL                  ,FL,33012-3224,Proprietary  ,6,56,62,37,193,230
02293200,ATI CAREER TRAINING CENTER              ,FL,33309-5916,Proprietary  ,0,9,9,5,34,39
02293201,ATI CAREER TRAINING CENTER - MIAMI      ,FL,33122-1707,Proprietary  ,5,29,34,41,138,179
02293202,ATI CAREER TAINING CENTER - ATI COLLEGE ,FL,87109-2016,Proprietary  ,9,23,32,43,112,155
02293600,ADVANCED TECHNICAL CENTERS              ,FL,33266-1597,Private      ,4,27,31,52,118,170
02297000,CHARLOTTE TECHNICAL CENTER              ,FL,33948-0000,Public       ,17,75,92,205,467,672
02300900,WITHLACOOCHEE TECHNICAL INSTITUTE       ,FL,34450-0000,Public       ,33,108,141,233,693,926
02305700,FORTIS COLLEGE                          ,FL,33619-1283,Proprietary  ,0,0,0,4,11,15
02305800,FLORIDA CAREER COLLEGE                  ,FL,33012-7028,Proprietary  ,167,934,1101,1304,6703,8007
02305810,FLORIDA CAREER COLLEGE - CLEARWATER     ,FL,33759-3924,Proprietary  ,9,62,71,93,348,441
02307400,GEORGE STONE AREA VOCATIONAL TECHNICAL  ,FL,32526-0000,Public       ,45,214,259,352,1395,1747
02314100,SCHILLER INTERNATIONAL UNIVERSITY       ,FL,33770-0000,Proprietary  ,8,30,38,75,308,383
02316200,MIAMI LAKES TECHNICAL EDUCATION CTR     ,FL,33014-0000,Public       ,38,183,221,435,1358,1793
02321200,ORANGE TECH EDUC CTR- WESTSIDE TECH     ,FL,34787-0000,Public       ,31,98,129,308,738,1046
02325100,KEY COLLEGE                             ,FL,33004-3046,Proprietary  ,2,10,12,12,101,113
02326303,MEDVANCE INSTITUTE - WEST PALM          ,FL,33461-2171,Proprietary  ,13,33,46,94,309,403
02326306,MEDVANCE INSTITUTE - MIAMI              ,FL,33173-3431,Proprietary  ,3,9,12,24,102,126
02326800,MERIDIAN COLLEGE                        ,FL,34240-8478,Proprietary  ,9,55,64,67,306,373
02326900,SUNSTATE ACADEMY OF HAIR DESIGN         ,FL,33907-1415,Proprietary  ,19,92,111,179,518,697
02329900,FLORIDA INSTITUTE OF ULTRASOUND         ,FL,32514-0000,Proprietary  ,7,52,59,109,410,519
02338400,FT PIERCE BEAUTY ACADEMY                ,FL,34982-0000,Proprietary  ,13,73,86,79,339,418
02346200,WYOTECH                                 ,FL,32174-1010,Proprietary  ,27,67,94,251,599,850
02362100,FULL SAIL UNIVERSITY                    ,FL,32792-0000,Proprietary  ,1403,3188,4591,14664,25063,39727
02499000,ACADEMY OF COSMETOLOGY                  ,FL,32953-3311,Proprietary  ,13,35,48,66,231,297
02501500,"O*TEC, MID-FLORIDA TECH                 ",FL,32809-0000,Public       ,70,305,375,507,1654,2161
02502700,UEI (UNITED EDUCATION INSTITUTE)        ,FL,32207-5627,Proprietary  ,0,0,0,25,66,91
02504600,WINTER PARK TECH                        ,FL,32789-0000,Public       ,19,78,97,166,584,750
02508900,TALMUDIC COLLEGE OF FLORIDA             ,FL,33139-0000,Private      ,2,6,8,24,14,38
02511700,RIDGE TECHNICAL CENTER                  ,FL,33881-0000,Public       ,30,120,150,343,1098,1441
02513200,ORLANDO TECHNICAL CENTER                ,FL,32801-0000,Public       ,61,230,291,508,1576,2084
02515400,CITY COLLEGE                            ,FL,33309-3073,Private      ,57,287,344,538,2333,2871
02517100,SARASOTA SCHOOL OF MASSAGE THERAPY      ,FL,34243-6130,Proprietary  ,9,32,41,48,189,237
02524000,SUNSTATE ACADEMY OF HAIR DESIGN         ,FL,34624-0000,Proprietary  ,19,46,65,80,240,320
02524002,SUNSTATE ACADEMY - JONES TECHNICAL INSTI,FL,32256-0367,Proprietary  ,11,51,62,31,89,120
02524200,ROBERT MORGAN EDUCATIONAL CENTER        ,FL,33177-0000,Public       ,42,111,153,473,969,1442
02531803,PAUL MITCHELL THE SCHOOL - ORLANDO      ,FL,32765-6444,Proprietary  ,17,43,60,188,261,449
02531805,PAUL MITCHELL THE SCHOOL -TAMPA         ,FL,33613-0000,Proprietary  ,27,66,93,194,355,549
02547600,FLORIDA NATIONAL COLLEGE                ,FL,33012-0000,Proprietary  ,56,212,268,470,1541,2011
02547601,FLORIDA NATIONAL UNIVERSITY - SOUTH CAMP,FL,33175-2478,Proprietary  ,82,220,302,725,1560,2285
02547602,FLORIDA NATIONAL UNIVERSITY - TRAINING A,FL,33012-4108,Proprietary  ,18,45,63,156,391,547
02554200,RADFORD LOCKLIN TECH CENTER             ,FL,32570-0000,Public       ,18,46,64,121,408,529
02573200,LA BELLE BEAUTY ACADEMY                 ,FL,33135-0000,Proprietary  ,9,70,79,100,328,428
02597100,HERITAGE INSTITUTE                      ,FL,33912-7132,Proprietary  ,57,156,213,437,1058,1495
02598200,SOUTHERN CAREER COLLEGE                 ,FL,32225-9828,Proprietary  ,6,57,63,69,417,486
02601600,HENRY W BREWSTER TECHNICAL CENTER       ,FL,33602-0000,Public       ,21,87,108,167,713,880
02612700,"SALON PROFESSIONAL ACADEMY - MELBOURNE, ",FL,32904-3919,Proprietary  ,11,33,44,59,190,249
02616400,SANFORD-BROWN INSTITUTE                 ,FL,32256-3520,Proprietary  ,24,110,134,197,844,1041
02616401,SANFORD-BROWN INSTITUTE - TAMPA         ,FL,33610-8304,Proprietary  ,0,0,0,85,314,399
02616705,LE CORDON BLEU COLLEGE OF CULINARY ARTS ,FL,33025-3929,Proprietary  ,33,69,102,434,609,1043
03003600,MCFATTER TECHNICAL CENTER               ,FL,33317-7499,Public       ,73,215,288,649,1472,2121
03008600,FLORIDA COLLEGE OF NATURAL HEALTH       ,FL,33064-1342,Proprietary  ,38,151,189,205,733,938
03010608,VIRGINIA COLLEGE - PENSACOLA            ,FL,32501-5650,Proprietary  ,18,93,111,174,876,1050
03010612,VIRGINIA COLLEGE - GOLF ACADEMY OF AMERI,FL,32701-0000,Proprietary  ,4,8,12,35,85,120
03010618,VIRGINIA COLLEGE - JACKSONVILLE         ,FL,32207-5167,Proprietary  ,14,102,116,170,908,1078
03012300,ASM BEAUTY WORLD ACADEMY                ,FL,33021-0000,Proprietary  ,2,25,27,28,150,178
03018500,BENE'S INTERNATIONAL SCHOOL OF BEAUTY   ,FL,34652-1636,Proprietary  ,20,90,110,130,465,595
03026508,REMINGTON COLLEGE - TAMPA               ,FL,33619-1177,Private      ,12,90,102,135,630,765
03028200,TRINITY COLLEGE OF FLORIDA              ,FL,34655-4401,Private      ,13,23,36,189,229,418
03031400,INTERNATIONAL ACADEMY OF DESIGN AND TECH,FL,33634-6313,Proprietary  ,85,337,422,930,3228,4158
03031402,INTERNATIONAL ACADEMY OF DESIGN AND TECH,FL,32809-4613,Proprietary  ,16,62,78,320,612,932
03031403,IADT - ORLANDO CULINARY ACADEMY         ,FL,32819-0000,Proprietary  ,25,43,68,206,367,573
03035800,HERITAGE INSTITUTE                      ,FL,32216-0948,Proprietary  ,18,121,139,118,681,799
03035900,NATIONAL AVIATION ACADEMY               ,FL,33760-3931,Proprietary  ,40,109,149,410,867,1277
03037500,HODGES UNIVERSITY                       ,FL,34119-7932,Private      ,74,421,495,786,3365,4151
03054200,FORTIS COLLEGE                          ,FL,33144-2373,Proprietary  ,0,0,0,34,108,142
03071600,COLLEGE OF BUSINESS & TECHNOLOGY        ,FL,33176-0000,Proprietary  ,33,246,279,363,1298,1661
03076402,BRYMAN SCHOOL OF ARIZONA (THE) - ANTHEM ,FL,32803-3509,Proprietary  ,0,0,0,128,429,557
03078003,OHIO CENTER FOR BROADCASTING - MIAMI MED,FL,33130-3042,Proprietary  ,4,21,25,51,154,205
03079800,GEORGE T BAKER AVIATION                 ,FL,33142-5687,Public       ,44,65,109,428,544,972
03079900,CITY COLLEGE                            ,FL,32714-3129,Private      ,19,94,113,131,644,775
03087601,ITT TECHNICAL INSTITUTE                 ,FL,33126-1823,Proprietary  ,0,0,0,0,2,2
03089200,NOUVELLE INSTITUTE                      ,FL,33125-4141,Proprietary  ,7,62,69,23,383,406
03096300,FORTIS INSTITUTE                        ,FL,33860-0000,Proprietary  ,1,11,12,33,158,191
03099600,MERCY HOSPITAL SCHOOL OF PRACTICAL NSG  ,FL,33133-4237,Proprietary  ,8,38,46,22,95,117
03100800,TAYLOR TECHNICAL INSTITUTE              ,FL,32348-0894,Public       ,6,21,27,63,174,237
03101900,TRINITY BAPTIST COLLEGE                 ,FL,32221-1398,Private      ,14,31,45,405,305,710
03103900,MARION COUNTY COMMUNITY TECH & ADUL     ,FL,34474-3172,Public       ,51,206,257,451,1575,2026
03108500,EVERGLADES UNIVERSITY                   ,FL,33431-0000,Private      ,34,293,327,254,1848,2102
03108600,COM-PU-MED VOCATIONAL CAREERS           ,FL,33012-4861,Proprietary  ,6,52,58,53,255,308
03113400,ACADEMY OF HEALING ARTS                 ,FL,33463-2113,Proprietary  ,7,28,35,39,129,168
03114700,PRAXIS INSTITUTE                        ,FL,33135-2657,Proprietary  ,9,50,59,33,269,302
03115500,ADVENTIST UNIVERSITY OF HEALTH SCIENCES ,FL,32803-1237,Private      ,81,268,349,1426,2763,4189
03123900,SOUTHEASTERN COLLEGE                    ,FL,33413-0000,Proprietary  ,56,212,268,352,1575,1927
03125600,MIAMI AD SCHOOL                         ,FL,33139-5203,Proprietary  ,6,44,50,81,366,447
03127900,TECHNICAL EDUCATION CTR OSCEOLA         ,FL,34744-4459,Public       ,50,194,244,440,1232,1672
03158300,LEE COUNTY HIGH TECH CENTER NORTH       ,FL,33993-2479,Public       ,15,72,87,189,486,675
03171300,UNIVERSITY OF ST. AUGUSTINE FOR HEALTH S,FL,32084-4215,Proprietary  ,12,349,361,135,1984,2119
03224300,NEW PROFESSIONS TECHNICAL INSTITUTE     ,FL,33134-1640,Proprietary  ,22,110,132,93,556,649
03230300,CHOICE HIGH SCHOOL AND TECHNICAL CENTER ,FL,32547-1299,Public       ,22,92,114,134,607,741
03238300,FLORIDA COLLEGE OF INTEGRATIVE MED      ,FL,32809-5721,Proprietary  ,10,73,83,132,436,568
03255300,FLORIDA GULF COAST UNIVERSITY           ,FL,33965-6565,Public       ,1085,499,1584,21042,6657,27699
03256300,YESHIVA GEDOLAH RABBINICAL COLLEGE      ,FL,33139-4708,Private      ,14,1,15,26,8,34
03264300,SOUTH FLORIDA BIBLE COLLEGE AND THEOLOGI,FL,33441-5768,Private      ,1,9,10,21,171,192
03346300,ACAD FOR PRAC NURSING & HEALTH OCCP     ,FL,33417-4574,Private      ,26,143,169,234,1098,1332
03348400,PROFESSIONAL TRAINING CENTERS           ,FL,33184-0000,Proprietary  ,26,126,152,184,826,1010
03373300,BEACON COLLEGE                          ,FL,34748-5224,Private      ,18,19,37,224,150,374
03374300,FLORIDA COASTAL SCHOOL OF LAW           ,FL,32256-0000,Proprietary  ,5,78,83,78,2238,2316
03382300,BRADFORD-UNION AREA CAREERTECHNICAL CENT,FL,32091-2434,Public       ,16,59,75,81,359,440
03390300,LINCOLN TECHNICAL INSTITUTE             ,FL,32730-2351,Proprietary  ,9,28,37,101,370,471
03411400,INTERNATIONAL TRAINING CAREERS          ,FL,33155-1462,Private      ,12,66,78,47,308,355
03414500,ACUPUNCTURE AND MASSAGE COLLEGE         ,FL,33176-1509,Proprietary  ,11,51,62,87,316,403
03425400,CENTRAL FLORIDA INSTITUTE               ,FL,34684-4436,Proprietary  ,2,7,9,40,129,169
03429600,ATLANTIC INST OF ORIENTAL MEDICINE      ,FL,33316-0000,Private      ,5,28,33,36,204,240
03429700,EAST WEST COLLG OF NATURAL MEDICINE     ,FL,34236-4959,Proprietary  ,4,28,32,27,231,258
03433400,NEW CONCEPT MASSAGE AND BEAUTY SCHO     ,FL,33135-0000,Proprietary  ,2,16,18,23,108,131
03434300,FORTIS COLLEGE                          ,FL,32073-2999,Proprietary  ,19,64,83,131,540,671
03480301,MEDVANCE INSTITUTE - FORT LAUDERDALE    ,FL,33313-7261,Proprietary  ,4,15,19,37,240,277
03480302,MEDVANCE INSTITUTE - STUART             ,FL,34994-3000,Proprietary  ,11,65,76,119,627,746
03491400,AMERICAN ADVANCED TECHNICIANS INST      ,FL,33014-4430,Proprietary  ,5,34,39,49,191,240
03549300,ULTIMATE MEDICAL ACADEMY                ,FL,33756-4917,Proprietary  ,465,4343,4808,2000,20912,22912
03553300,SOUTHEASTERN COLLEGE                    ,FL,32216-0000,Proprietary  ,11,70,81,320,1400,1720
03557300,NORTH FLORIDA COSMETOLOGY INSTITUTE     ,FL,32312-0000,Proprietary  ,15,40,55,155,412,567
03564300,"INTERNATIONAL SCHOOL OF HEALTH, BEAUTY &",FL,33311-1141,Proprietary  ,0,0,0,25,68,93
03570400,ENGLISH CENTER (THE)                    ,FL,33133-2703,Public       ,1,30,31,27,228,255
03611400,FLORIDA BARBER ACADEMY                  ,FL,33441-0000,Proprietary  ,6,59,65,54,338,392
03618300,FLORIDA INSTITUTE OF ANIMAL ARTS        ,FL,32792-0000,Proprietary  ,28,44,72,158,237,395
03627400,JACKSONVILLE BEAUTY INSTITUTE           ,FL,32208-1885,Proprietary  ,9,62,71,96,375,471
03627600,FLORIDA EDUCATION INSTITUTE             ,FL,33144-5036,Proprietary  ,14,71,85,71,392,463
03661400,SOUTH FLORIDA INSTITUTE OF TECHNOLO     ,FL,33135-0000,Proprietary  ,32,239,271,212,1192,1404
03691400,AVE MARIA SCHOOL OF LAW                 ,FL,34119-1376,Private      ,5,15,20,86,575,661
03696400,SABER                                   ,FL,33134-1604,Private      ,10,87,97,75,706,781
03698308,WEST COAST UNIVERSITY - MIAMI           ,FL,33178-2431,Proprietary  ,10,17,27,14,29,43
03706300,AMERICAN INSTITUTE                      ,FL,33319-0000,Proprietary  ,10,45,55,72,262,334
03757300,ADVANCE SCIENCE INSTITUTE               ,FL,33012-0000,Proprietary  ,4,18,22,37,80,117
03801400,BEAUTY INSTITUTE (THE)                  ,FL,33409-2972,Proprietary  ,5,35,40,52,150,202
03801401,BEAUTY INSTITUTE (THE) - MARGATE        ,FL,33068-5704,Proprietary  ,1,13,14,22,59,81
03816300,ARTISTIC NAILS & BEAUTY ACADEMY         ,FL,33605-5919,Proprietary  ,23,112,135,150,489,639
03823300,FLORIDA ACADEMY OF HEALTH & BEAUTY      ,FL,33311-0000,Proprietary  ,5,12,17,14,51,65
03832300,DADE MEDICAL COLLEGE                    ,FL,33126-5534,Proprietary  ,75,401,476,1061,4046,5107
03842500,CAMBRIDGE INSTITUTE OF ALLIED HEALTH    ,FL,32750-0000,Proprietary  ,4,38,42,34,267,301
03856300,UNIVERSAL BEAUTY SCHOOL                 ,FL,33174-4406,Proprietary  ,5,39,44,20,140,160
03856500,FLORIDA SCHOOL OF TRADITIONAL MIDWIFERY ,FL,32601-5507,Private      ,1,12,13,22,167,189
03875300,MCI INSTITUTE OF TECHNOLOGY             ,FL,33409-4937,Proprietary  ,14,83,97,89,347,436
03888300,DRAGON RISES COLLEGE OF ORIENTAL MEDICIN,FL,32601-5089,Private      ,0,6,6,6,66,72
03903500,SOUTHERN TECHNICAL COLLEGE              ,FL,32809-0000,Proprietary  ,51,345,396,360,2292,2652
03907301,PAUL MITCHELL THE SCHOOL FT MYERS       ,FL,33907-0000,Proprietary  ,19,42,61,115,208,323
03911300,TOTAL INTERNATIONAL CAREER INSTITUTE    ,FL,33012-0000,Proprietary  ,1,4,5,10,38,48
03939300,WOLFORD COLLEGE                         ,FL,34108-1931,Proprietary  ,5,40,45,30,322,352
03939400,CENTURA INSTITUTE                       ,FL,32807-3566,Proprietary  ,11,59,70,83,380,463
03939600,DAYTONA COLLEGE                         ,FL,32174-8445,Proprietary  ,10,71,81,142,484,626
03941300,AVE MARIA UNIVERSITY                    ,FL,34142-9505,Private      ,58,9,67,1517,213,1730
03957400,NEW COLLEGE OF FLORIDA                  ,FL,34243-2109,Public       ,71,52,123,2026,470,2496
03985300,COMMERCIAL DIVING ACADEMY               ,FL,32208-0000,Proprietary  ,62,167,229,380,1021,1401
03986300,AVIATOR COLLEGE OF AERONAUTICAL SCIENCE ,FL,34946-9022,Proprietary  ,10,42,52,86,248,334
04016500,AMERICAN INSTITUTE OF BEAUTY            ,FL,33773-0000,Proprietary  ,8,62,70,64,324,388
04029300,TRENDSETTERS OF FLORIDA SCHOOL OF BEAUTY,FL,32205-4737,Proprietary  ,6,29,35,35,173,208
04038302,ATA COLLEGE-ATA CAREER EDUCATION        ,FL,34606-4300,Proprietary  ,17,62,79,126,499,625
04039300,SULLIVAN AND COGLIANO TRAINING CENTERS  ,FL,33014-6427,Proprietary  ,14,253,267,74,1142,1216
04083400,CAMBRIDGE INSTITUTE OF ALLIED HEALTH & T,FL,33484-6543,Proprietary  ,21,90,111,88,425,513
04105400,PENSACOLA SCHOOL OF MASSAGE THERAPY & HE,FL,32504-7337,Proprietary  ,13,48,61,64,354,418
04106300,PALM BEACH ACADEMY OF HEALTH & BEAUTY   ,FL,33403-2130,Proprietary  ,12,123,135,70,408,478
04116400,FUTURE-TECH INSTITUTE                   ,FL,33135-4142,Proprietary  ,6,48,54,45,218,263
04116600,TAYLOR COLLEGE                          ,FL,34420-8714,Proprietary  ,10,52,62,101,681,782
04119400,AVEDA INSTITUTE - SAINT PETERSBURG      ,FL,33701-4242,Proprietary  ,51,113,164,449,799,1248
04120400,HI-TECH SCHOOL OF COSMETOLOGY           ,FL,33174-0000,Proprietary  ,8,25,33,97,140,237
04126900,ACADEMY OF CAREER TRAINING              ,FL,34741-4644,Proprietary  ,21,80,101,150,482,632
04127400,DIGITAL MEDIA ARTS COLLEGE              ,FL,33431-5919,Proprietary  ,17,14,31,343,225,568
04128400,MANAGEMENT RESOURCES INSTITUTE          ,FL,33126-5473,Proprietary  ,6,189,195,58,900,958
04129900,FLORIDA SCHOOL OF MASSAGE               ,FL,32608-5419,Proprietary  ,8,52,60,70,288,358
04130400,SHEAR EXCELLENCE INTERNATIONAL HAIR ACAD,FL,33614-2783,Proprietary  ,6,30,36,42,172,214
04133500,ACADEMY FOR FIVE ELEMENT ACUPUNCTURE    ,FL,32601-6811,Private      ,1,15,16,17,149,166
04133900,FUTURA CAREER INSTITUTE                 ,FL,33012-3325,Proprietary  ,5,32,37,23,146,169
04134800,AVEDA INSTITUTE - TALLAHASSEE           ,FL,32304-3186,Proprietary  ,44,99,143,404,692,1096
04135000,COZMO THE SCHOOL                        ,FL,34135-4810,Proprietary  ,4,20,24,16,93,109
04135900,ALLIED HEALTH INSTITUTE                 ,FL,33068-0000,Proprietary  ,8,104,112,69,884,953
04140800,NORTH FLORIDA ACADEMY                   ,FL,32065-7758,Proprietary  ,4,21,25,31,89,120
04143100,PROFESSIONAL HANDS INSTITUTE            ,FL,33135-1939,Proprietary  ,2,26,28,10,64,74
04145900,CELEBRITY SCHOOL OF BEAUTY              ,FL,33144-4153,Proprietary  ,10,41,51,86,244,330
04146200,WALTON CAREER DEVELOPMENT CENTER        ,FL,32433-1557,Public       ,6,33,39,54,231,285
04146300,MARCHMAN TECHNICAL EDUCATION CENTER     ,FL,34653-1211,Public       ,19,64,83,211,404,615
04148500,MEDICAL INSTITUTE OF PALM BEACH         ,FL,33463-3276,Proprietary  ,15,24,39,96,215,311
04150800,IMMOKALEE TECHNICAL CENTER              ,FL,34142-3146,Public       ,13,17,30,215,213,428
04151500,AMERICAN ACADEMY OF COSMETOLOGY         ,FL,32065-8026,Proprietary  ,11,31,42,61,198,259
04156300,UNIVERSITY OF FORT LAUDERDALE           ,FL,33313-5809,Private      ,7,13,20,66,140,206
04156400,AVIATION INSTITUTE OF MAINTENANCE       ,FL,32803-6487,Proprietary  ,35,76,111,245,520,765
04157100,AEROSIM FLIGHT ACADEMY                  ,FL,32773-9683,Proprietary  ,21,55,76,154,282,436
04158300,FLAGLER TECHNICAL INSTITUTE             ,FL,32137-4714,Public       ,10,37,47,105,309,414
04162000,JOSE MARIA VARGAS UNIVERSITY            ,FL,33025-4534,Proprietary  ,1,8,9,16,92,108
04162500,HOLLYWOOD INSTITUTE OF BEAUTY CAREERS   ,FL,33023-6720,Proprietary  ,33,185,218,176,895,1071
04163000,SALON PROFESSIONAL ACADEMY (THE)        ,FL,33624-6321,Proprietary  ,12,30,42,101,212,313
04163100,SALON PROFESSIONAL ACADEMY (THE)        ,FL,32607-1672,Proprietary  ,10,36,46,102,235,337
04163200,SALON PROFESSIONAL ACADEMY (THE)        ,FL,32162-9311,Proprietary  ,9,50,59,69,184,253
04164500,EUREKA INSTITUTE OF HEALTH AND BEAUTY   ,FL,33174-4205,Proprietary  ,1,14,15,24,82,106
04164600,D. A. DORSEY EDUCATIONAL CENTER         ,FL,33147-6304,Public       ,3,27,30,70,257,327
04167300,SALON PROFESSIONAL ACADEMY (THE)        ,FL,33904-4824,Proprietary  ,3,17,20,39,106,145
04170300,BEAUTY ACADEMY OF SOUTH FLORIDA         ,FL,33012-3221,Proprietary  ,2,51,53,36,216,252
04172300,ETERNITY COSMETOLOGY SCHOOL             ,FL,33415-5719,Proprietary  ,8,81,89,48,225,273
04176800,PROGRESSIVE TRAINING CENTERS            ,FL,33060-9238,Proprietary  ,0,5,5,10,41,51
04176900,AMERICAN HEALTH INSTITUTE               ,FL,34654-3743,Proprietary  ,3,32,35,38,167,205
04182500,MILLENNIA ATLANTIC UNIVERSITY           ,FL,33178-2369,Proprietary  ,0,4,4,24,61,85
04188300,FLORIDA ACADEMY                         ,FL,33966-1155,Proprietary  ,19,80,99,130,385,515
04192100,AMERICAN MEDICAL ACADEMY                ,FL,33186-4830,Proprietary  ,22,48,70,173,333,506
04194000,"SCHOOL DISTRICT OF INDIAN RIVER COUNTY, ",FL,32960-3527,Public       ,2,11,13,2,11,13
04194200,APARICIO-LEVY TECHNICAL CENTER          ,FL,33610-9666,Public       ,7,39,46,26,102,128
04195100,AMBIANCE BEAUTY & BARBER ACADEMY        ,FL,32935-8771,Proprietary  ,2,28,30,21,144,165
04197600,"FLORIDA INSTITUTE OF RECORDING, SOUND AN",FL,32804-3309,Proprietary  ,23,56,79,244,381,625
04204600,BEAUTY AND HEALTH INSTITUTE             ,FL,33626-2610,Proprietary  ,6,53,59,85,313,398
04206300,FLORIDA VOCATIONAL INSTITUTE            ,FL,33155-3762,Proprietary  ,7,39,46,48,237,285
04207900,SAE INSTITUTE OF TECHNOLOGY - MIAMI     ,FL,33160-4307,Proprietary  ,22,54,76,166,292,458
04209500,SHEAR FINESSE HAIRSTYLING ACADEMY       ,FL,32208-5005,Proprietary  ,4,20,24,26,91,117
04210800,ULTRASOUND MEDICAL INSTITUTE            ,FL,33462-4221,Proprietary  ,2,7,9,29,44,73
04212600,COSMIX SCHOOL OF MAKEUP ARTISTRY        ,FL,33306-1640,Proprietary  ,16,39,55,115,198,313
04213200,KAIZEN BEAUTY ACADEMY                   ,FL,33024-6609,Proprietary  ,2,8,10,24,52,76
04214500,PRESTIGE HEALTH & BEAUTY SCIENCES ACADEM,FL,33160-4102,Proprietary  ,2,18,20,19,69,88
04216600,AZURE COLLEGE                           ,FL,33169-5345,Proprietary  ,12,69,81,121,1013,1134
04216900,SAN IGNACIO COLLEGE                     ,FL,33178-2350,Proprietary  ,1,3,4,8,14,22
04217800,BOCA BEAUTY ACADEMY                     ,FL,33434-4178,Proprietary  ,6,54,60,74,254,328
04220200,MORE TECH INSTITUTE                     ,FL,33012-2165,Proprietary  ,2,11,13,15,63,78
04221200,BLY'S SCHOOL OF COSMETOLOGY             ,FL,32601-4021,Proprietary  ,3,34,37,50,204,254
04222100,ANTON AESTHETICS ACADEMY                ,FL,33416-4629,Proprietary  ,0,4,4,14,55,69
04223400,INTERAMERICAN TECHNICAL INSTITUTE       ,FL,00174-2950,Proprietary  ,2,32,34,14,110,124
04225000,PARISIAN SPA INSTITUTE                  ,FL,32204-4127,Proprietary  ,5,44,49,36,190,226
04225200,YECHANLAZ INSTITUTO VOCACIONAL          ,FL,33144-4817,Proprietary  ,1,14,15,8,90,98
04225800,FRED D. LEAREY TECHNICAL CENTER         ,FL,33614-1892,Public       ,20,53,73,41,146,187
04227500,MERRYFIELD SCHOOL OF PET GROOMING       ,FL,33334-4925,Proprietary  ,2,12,14,14,62,76
04228900,BEAUTY ANATOMY INSTITUTE OF COSMETOLOGY ,FL,33069-4313,Proprietary  ,0,10,10,24,77,101
04229700,FIRST COAST BARBER ACADEMY              ,FL,32210-8054,Proprietary  ,2,24,26,27,118,145
04233200,UNILATINA INTERNATIONAL COLLEGE         ,FL,33025-3943,Proprietary  ,1,6,7,1,9,10
04233400,LEE PROFESSIONAL INSTITUTE              ,FL,33916-9320,Proprietary  ,3,37,40,35,149,184
04233900,ATLANTIS UNIVERSITY                     ,FL,33132-1417,Proprietary  ,16,33,49,22,44,66
04234500,BURNETT INTERNATIONAL COLLEGE           ,FL,33426-6591,Proprietary  ,3,17,20,9,88,97
04238400,FLORIDA INTERNATIONAL TRAINING INSTITUTE,FL,33172-1507,Proprietary  ,2,20,22,2,20,22
00160500,CHAMINADE UNIV OF HONOLULU              ,HI,96816-1578,Private      ,152,221,373,2284,2313,4597
00160600,BRIGHAM YOUNG UNIV-HAWAII CAMPUS        ,HI,96762-1294,Private      ,240,101,341,2137,1031,3168
00161000,UNIVERSITY OF HAWAII AT MANOA           ,HI,96822-2399,Public       ,488,506,994,15050,9664,24714
00161100,UNIVERSITY OF HAWAII AT HILO            ,HI,96720-4091,Public       ,138,159,297,4062,3027,7089
00161200,HONOLULU COMMUNITY COLLEGE              ,HI,96817-4598,Public       ,127,312,439,2552,3110,5662
00161300,KAPIOLANI COMMUNITY COLLEGE             ,HI,96816-4421,Public       ,184,369,553,3818,3952,7770
00161400,KAUAI COMMUNITY COLLEGE                 ,HI,96766-9591,Public       ,30,80,110,695,807,1502
00161500,UNIVERSITY OF HAWAII MAUI COLLEGE       ,HI,96732-1644,Public       ,106,277,383,1815,2801,4616
00454900,LEEWARD COMMUNITY COLLEGE               ,HI,96782-3393,Public       ,187,427,614,3291,3853,7144
00525800,HAWAII COMMUNITY COLLEGE                ,HI,96720-4075,Public       ,89,238,327,1788,2587,4375
00723401,HEALD COLLEGE - HONOLULU                ,HI,96814-0000,Proprietary  ,76,193,269,938,1989,2927
00727900,HAWAII PACIFIC UNIVERSITY               ,HI,96813-2882,Private      ,206,338,544,4979,3814,8793
01122000,WINDWARD COMMUNITY COLLEGE              ,HI,96744-0000,Public       ,49,169,218,1152,1658,2810
02100300,MED-ASSIST SCHOOL OF HAWAII             ,HI,96813-0000,Proprietary  ,14,36,50,138,281,419
02107800,UNIVERSITY OF HAWAII - WEST OAHU        ,HI,96707-0000,Public       ,112,210,322,2284,2671,4955
02139500,HAWAII INSTITUTE OF HAIR DESIGN         ,HI,96817-5195,Proprietary  ,13,32,45,85,184,269
03017800,TRAVEL INSTITUTE OF THE PACIFIC         ,HI,96814-1946,Proprietary  ,7,24,31,61,213,274
03072500,WORLD MEDICINE INSTITUTE                ,HI,96826-0000,Private      ,0,18,18,49,169,218
03735300,INST OF CLINICAL ACUPUNCTURE & ORIENT MD,HI,96813-2307,Proprietary  ,2,10,12,13,103,116
03999400,TRADITIONAL CHINESE MEDICAL COLLEGE OF H,HI,96743-8324,Private      ,0,0,0,7,37,44
04165200,MAUNA LOA HELICOPTERS                   ,HI,96740-2650,Proprietary  ,6,10,16,23,71,94
04175100,PAUL MITCHELL THE SCHOOL HONOLULU       ,HI,96816-2433,Proprietary  ,17,38,55,146,228,374
04182200,HAWAII MEDICAL INSTITUTE                ,HI,96814-3518,Proprietary  ,41,79,120,305,715,1020
00161600,BOISE STATE UNIVERSITY                  ,ID,83725-1000,Public       ,516,799,1315,14384,11844,26228
00161700,"COLLEGE OF IDAHO, THE                   ",ID,83605-4432,Private      ,69,64,133,1972,607,2579
00161900,COLLEGE OF SOUTHERN IDAHO               ,ID,83301-0000,Public       ,184,377,561,3289,3803,7092
00162000,IDAHO STATE UNIVERSITY                  ,ID,83209-5377,Public       ,330,597,927,6557,8220,14777
00162100,LEWIS-CLARK STATE COLLEGE               ,ID,83501-2698,Public       ,87,177,264,2673,2551,5224
00162300,NORTH IDAHO COLLEGE                     ,ID,83814-2199,Public       ,177,445,622,3056,4332,7388
00162400,NORTHWEST NAZARENE UNIVERSITY           ,ID,83686-5897,Private      ,39,122,161,1825,1634,3459
00162500,BRIGHAM YOUNG UNIVERSITY-IDAHO          ,ID,83460-1650,Private      ,1601,1232,2833,15223,13039,28262
00162600,UNIVERSITY OF IDAHO                     ,ID,83844-4291,Public       ,221,275,496,10365,4648,15013
00732915,ITT TECHNICAL INSTITUTE                 ,ID,83713-1529,Proprietary  ,57,286,343,467,1805,2272
00987300,MR JUAN'S CLG OF HAIR DESIGN            ,ID,83301-4154,Proprietary  ,2,12,14,27,81,108
01113300,EASTERN IDAHO TECHNICAL COLLEGE         ,ID,83404-5788,Public       ,39,170,209,424,1178,1602
02218000,CARRINGTON COLLEGE                      ,ID,83704-0000,Proprietary  ,53,206,259,522,1687,2209
02234500,BOISE BIBLE COLLEGE                     ,ID,83714-1220,Private      ,8,13,21,225,139,364
02275800,MR LEONS SCHOOL OF HAIR DESIGN          ,ID,83843-8384,Proprietary  ,0,9,9,16,48,64
02275801,MR. LEON'S SCHOOL OF HAIR DESIGN        ,ID,83501-1910,Proprietary  ,0,5,5,7,27,34
02314000,SCHOOL OF HAIRSTYLING (THE)             ,ID,83202-0000,Proprietary  ,1,6,7,13,56,69
02319800,TONI&GUY HAIRDRESSING ACADEMY           ,ID,83814-2822,Proprietary  ,6,14,20,72,137,209
02319801,TONI&GUY HAIRDRESSING ACADEMY - BOISE   ,ID,83705-2636,Proprietary  ,16,16,32,102,161,263
02349200,HEADMASTERS SCHOOL OF HAIR DESIGN       ,ID,83501-0000,Proprietary  ,3,6,9,33,63,96
02559500,RAZZLE DAZZLE CLG OF HAIR DESIGN        ,ID,83686-5104,Proprietary  ,12,16,28,78,163,241
02607100,PAUL MITCHELL THE SCHOOL BOISE          ,ID,83709-1662,Proprietary  ,22,36,58,176,265,441
03098700,ACADEMY OF COURT REPORTING              ,ID,83704-8320,Proprietary  ,10,64,74,105,388,493
03832400,COSMETOLOGY SCHOOL OF ARTS & SCIENCES   ,ID,83318-1327,Proprietary  ,1,14,15,13,71,84
04051323,ART INSTITUTE OF PHOENIX (THE) - BROWN M,ID,83709-2746,Proprietary  ,6,18,24,56,211,267
04134300,EVANS HAIRSTYLING COLLEGE               ,ID,83440-5277,Proprietary  ,8,6,14,56,56,112
04144500,HAIR ACDMY PAUL MITCHELL PARTNER SCHOOL ,ID,83440-2600,Proprietary  ,18,16,34,95,126,221
04150600,D & L ACADEMY OF HAIR DESIGN            ,ID,83301-6229,Proprietary  ,0,17,17,17,67,84
04155200,OLIVER FINLEY ACADEMY OF COSMETOLOGY    ,ID,83704-8011,Proprietary  ,23,41,64,162,262,424
04163800,MASTER EDUCATORS BEAUTY SCHOOL          ,ID,83301-4118,Proprietary  ,5,13,18,43,61,104
04168600,COLLEGE OF MASSAGE THERAPY              ,ID,83221-1758,Proprietary  ,7,11,18,31,53,84
04176700,D'SHAW INSTITUTE OF COSMETOLOGY         ,ID,83704-4406,Proprietary  ,3,15,18,55,104,159
04194800,VELVET TOUCH ACADEMY OF COSMETOLOGY     ,ID,83687-5020,Proprietary  ,6,15,21,44,108,152
04203200,BOISE BARBER COLLEGE                    ,ID,83704-5919,Proprietary  ,4,21,25,27,126,153
04203500,AUSTIN KADE ACADEMY                     ,ID,83404-5540,Proprietary  ,9,51,60,75,295,370
04207200,ACADEMY DI FIRENZE                      ,ID,83338-2329,Proprietary  ,1,2,3,10,33,43
04211800,COLLEGE OF WESTERN IDAHO                ,ID,83687-5505,Public       ,366,927,1293,4982,8483,13465
00149912,EVEREST UNIVERSITY - EVEREST COLLEGE - K,MO,64114-3246,Proprietary  ,27,136,163,89,534,623
00163200,AQUINAS INSTITUTE OF THEOLOGY           ,MO,63108-3323,Private      ,1,11,12,7,82,89
00244900,AVILA UNIVERSITY                        ,MO,64145-1698,Private      ,36,176,212,1557,1863,3420
00245000,CALVARY BIBLE COLLEGE                   ,MO,64147-1341,Private      ,8,24,32,188,237,425
00245300,CENTRAL METHODIST UNIVERSITY            ,MO,65248-1198,Private      ,50,149,199,2109,2444,4553
00245400,UNIVERSITY OF CENTRAL MISSOURI          ,MO,64093-5178,Public       ,292,404,696,9498,5222,14720
00245600,COLUMBIA COLLEGE                        ,MO,65216-4581,Private      ,174,1974,2148,3335,21972,25307
00245700,CONCORDIA SEMINARY                      ,MO,63105-3199,Private      ,0,15,15,4,435,439
00245800,COTTEY COLLEGE                          ,MO,64772-2790,Private      ,12,10,22,357,76,433
00245900,CROWDER COLLEGE                         ,MO,64850-9165,Public       ,155,354,509,2894,3331,6225
00246000,CULVER STOCKTON COLLEGE                 ,MO,63435-1299,Private      ,35,19,54,1453,237,1690
00246100,DRURY UNIVERSITY                        ,MO,65802-3791,Private      ,101,320,421,2624,3870,6494
00246200,EDEN THEOLOGICAL SEMINARY               ,MO,63119-0000,Private      ,0,7,7,2,149,151
00246300,EVANGEL UNIVERSITY                      ,MO,65802-2125,Private      ,63,114,177,2316,1153,3469
00246302,EVANGEL UNIVERSITY - ASSEMBLIES OF GOD T,MO,65802-2131,Private      ,0,0,0,192,179,371
00246400,FONTBONNE UNIVERSITY                    ,MO,63105-3098,Private      ,44,172,216,1333,2276,3609
00246600,HARRIS-STOWE STATE COLLEGE              ,MO,63103-2199,Public       ,55,173,228,1461,2057,3518
00246700,CONCEPTION SEMINARY COLLEGE             ,MO,64433-0502,Private      ,1,1,2,65,16,81
00246800,JEFFERSON COLLEGE                       ,MO,63050-2441,Public       ,143,349,492,2951,3127,6078
00247100,ST LOUIS COMMUNITY COLLEGE              ,MO,63102-0000,Public       ,706,1769,2475,11860,16939,28799
00247300,KANSAS CITY ART INSTITUTE               ,MO,64111-1874,Private      ,47,44,91,1275,434,1709
00247400,KANSAS CITY UNIV OF MED AND BIOSCIENCES ,MO,64106-0000,Private      ,6,30,36,109,1276,1385
00247600,KENRICK-GLENNON SEMINARY                ,MO,63119-4330,Private      ,2,2,4,29,13,42
00247700,A.T. STILL UNIV OF HEALTH SCIENCES      ,MO,63501-0000,Private      ,0,111,111,32,2993,3025
00247900,LINCOLN UNIVERSITY                      ,MO,65101-3500,Public       ,71,140,211,2646,1877,4523
00248000,LINDENWOOD UNIVERSITY                   ,MO,63301-1695,Private      ,261,686,947,7310,7696,15006
00248200,MARYVILLE UNIVERSITY                    ,MO,63141-7299,Private      ,81,504,585,2827,5230,8057
00248400,METROPOLITAN COMMUNITY COLLEGE          ,MO,64111-2408,Public       ,667,1717,2384,9938,14495,24433
00248500,MIDWESTERN BAPTIST THEOL SEMINARY       ,MO,64118-4697,Private      ,4,39,43,126,487,613
00248600,MINERAL AREA COLLEGE                    ,MO,63601-1000,Public       ,94,321,415,2141,2666,4807
00248800,MISSOURI SOUTHERN STATE UNIVERSITY      ,MO,64801-1595,Public       ,158,316,474,4626,3862,8488
00248900,MISSOURI VALLEY COLLEGE                 ,MO,65340-3197,Private      ,89,50,139,1792,502,2294
00249000,MISSOURI WESTERN STATE UNIVERSITY       ,MO,64507-2294,Public       ,189,196,385,4783,2800,7583
00249100,MOBERLY AREA COMMUNITY COLLEGE          ,MO,65270-1304,Public       ,146,350,496,3349,3345,6694
00249400,NAZARENE THEOLOGICAL SEMINARY           ,MO,64131-1246,Private      ,0,7,7,9,184,193
00249500,TRUMAN STATE UNIVERSITY                 ,MO,63501-4221,Public       ,143,35,178,6002,624,6626
00249600,NORTHWEST MISSOURI STATE UNIV           ,MO,64468-6001,Public       ,153,104,257,6575,1489,8064
00249800,PARK UNIVERSITY                         ,MO,64152-3795,Private      ,71,1006,1077,1610,9403,11013
00249900,ROCKHURST UNIVERSITY                    ,MO,64110-2561,Private      ,59,89,148,2452,1384,3836
00250000,COLLEGE OF THE OZARKS                   ,MO,65726-2502,Private      ,137,39,176,3700,422,4122
00250100,SOUTHEAST MISSOURI STATE UNIV           ,MO,63701-4799,Public       ,267,378,645,9450,4649,14099
00250200,SOUTHWEST BAPTIST UNIVERSITY            ,MO,65613-2597,Private      ,67,117,184,2177,1753,3930
00250300,MISSOURI STATE UNIVERSITY               ,MO,65897-0094,Public       ,609,641,1250,17517,9196,26713
00250400,ST LOUIS COLLEGE OF PHARMACY            ,MO,63110-1088,Private      ,19,26,45,830,839,1669
00250600,SAINT LOUIS UNIVERSITY                  ,MO,63103-2097,Private      ,234,391,625,10647,7902,18549
00250900,SAINT PAUL SCHOOL OF THEOLOGY           ,MO,64127-2499,Private      ,0,9,9,2,122,124
00251200,STEPHENS COLLEGE                        ,MO,65215-0001,Private      ,53,56,109,1075,671,1746
00251400,NORTH CENTRAL MISSOURI COLLEGE          ,MO,64683-1824,Public       ,30,90,120,982,903,1885
00251600,UNIVERSITY OF MISSOURI - COLUMBIA       ,MO,65211-1600,Public       ,849,530,1379,28841,9310,38151
00251700,MISSOURI UNIVERSITY OF SCIENCE & TECHNOL,MO,65409-0250,Public       ,183,111,294,6667,1570,8237
00251800,UNIVERSITY OF MISSOURI-KANSAS CITY      ,MO,64110-2497,Public       ,305,616,921,8570,10222,18792
00251900,UNIVERSITY OF MISSOURI-ST LOUIS         ,MO,63121-4499,Public       ,272,668,940,7610,11241,18851
00252000,WASHINGTON UNIVERSITY                   ,MO,63130-4899,Private      ,426,281,707,16265,5762,22027
00252001,WASHINGTON UNIV-SCHOOL OF MEDICINE      ,MO,63110-0000,Private      ,20,29,49,207,1546,1753
00252100,WEBSTER UNIVERSITY                      ,MO,63119-3194,Private      ,112,900,1012,3788,12623,16411
00252200,WENTWORTH MILITARY ACADEMY              ,MO,64067-1799,Private      ,8,13,21,349,226,575
00252300,WESTMINSTER COLLEGE                     ,MO,65251-1299,Private      ,34,15,49,1189,196,1385
00252400,WILLIAM JEWELL COLLEGE                  ,MO,64068-1896,Private      ,36,30,66,1335,305,1640
00252500,WILLIAM WOODS UNIVERSITY                ,MO,65251-2388,Private      ,34,208,242,1104,1385,2489
00405704,NATIONAL AMERICAN UNIVERSITY            ,MO,64057-1791,Proprietary  ,8,62,70,62,637,699
00441300,MERCY HOSPITAL SPRINGFIELD SCHOOL OF RAD,MO,65804-2263,Private      ,0,0,0,121,262,383
00470300,LOGAN COLLEGE OF CHIROPRACTIC           ,MO,63006-0000,Private      ,4,98,102,50,933,983
00470700,COVENANT THEOLOGICAL SEMINARY           ,MO,63141-8697,Private      ,0,21,21,6,455,461
00471100,LINN STATE TECHNICAL COLLEGE            ,MO,65051-9607,Public       ,42,57,99,1544,618,2162
00471300,THREE RIVERS COMMUNITY COLLEGE          ,MO,63901-2393,Public       ,145,478,623,2279,3777,6056
00528800,KIRKSVILLE AREA TECHNICAL CENTER        ,MO,63501-0000,Public       ,5,7,12,44,94,138
00528900,WAYNESVILLE CAREER CENTER               ,MO,65583-2131,Public       ,6,20,26,93,158,251
00542400,SOUTH CENTRAL CAREER CENTER             ,MO,65775-3052,Public       ,3,26,29,58,184,242
00542600,SIKESTON CAREER AND TECHNOLOGY CTR      ,MO,63801-0000,Public       ,5,45,50,116,293,409
00542900,ROLLA TECHNICAL INSTITUTE               ,MO,65401-3601,Public       ,11,45,56,288,392,680
00543000,POPLAR BLUFF TECHNICAL CAREER CNTR      ,MO,63901-0000,Public       ,5,31,36,65,246,311
00543800,SALINE COUNTY CAREER CENTER             ,MO,65340-0000,Public       ,0,9,9,15,64,79
00544500,TRUMAN MEDICAL CENTER SCHOOL OF NURSE AN,MO,64108-2677,Private      ,9,26,35,90,221,311
00553100,GRAND RIVER TECHNICAL SCHOOL            ,MO,64601-1299,Public       ,1,4,5,81,66,147
00553200,CAPE GIRARDEAU CAREER & TECHNOLOGY CENTE,MO,63703-7511,Public       ,17,69,86,357,663,1020
00638900,BARNES JEWISH COLLEGE OF NURSING AND ALL,MO,63110-1091,Private      ,29,105,134,630,1284,1914
00639200,RESEARCH COLLEGE OF NURSING             ,MO,64132-1199,Proprietary  ,4,38,42,150,397,547
00639201,RESEARCH MEDICAL CENTER - COLLEGE OF NUR,MO,64132-1199,Proprietary  ,2,27,29,64,218,282
00639202,RESEARCH MED CTR SCHL OF RAD TECH       ,MO,64132-0000,Proprietary  ,1,12,13,18,95,113
00666600,LUTHERAN  SCHOOL OF NURSING             ,MO,63118-3909,Proprietary  ,7,46,53,116,500,616
00732923,ITT TECHNICAL INSTITUTE                 ,MO,63045-1122,Proprietary  ,73,464,537,699,3410,4109
00754000,MISSOURI BAPTIST UNIVERSITY             ,MO,63141-8698,Private      ,88,222,310,1967,2687,4654
00808000,STATE FAIR COMMUNITY COLLEGE            ,MO,65301-0000,Public       ,151,386,537,2719,3602,6321
00826900,HILLYARD TECHNICAL CENTER               ,MO,64506-0000,Public       ,3,37,40,181,324,505
00855200,STEVENS INSTITUTE OF BUSINESS & ARTS    ,MO,63103-0000,Proprietary  ,3,22,25,119,275,394
00860600,TRI-COUNTY TECHNICAL SCHOOL             ,MO,65026-0000,Public       ,0,0,0,5,16,21
00886200,EAST CENTRAL COLLEGE                    ,MO,63084-0529,Public       ,95,224,319,2172,2423,4595
00908900,HANNIBAL-LAGRANGE COLLEGE               ,MO,63401-1999,Private      ,28,54,82,876,604,1480
00952000,NATIONAL ACADEMY OF BEAUTY ARTS         ,MO,63128-1307,Proprietary  ,9,31,40,104,299,403
00959000,INDEPENDENCE COLLEGE OF COSMETOLOGY     ,MO,64055-1105,Proprietary  ,8,18,26,53,124,177
00960700,HOUSE OF HEAVILIN BEAUTY COLLEGE        ,MO,64110-2826,Proprietary  ,6,19,25,40,149,189
00978200,SAINT LUKE'S COLLEGE OF HEALTH SCIENCES ,MO,64114-3237,Private      ,11,47,58,278,620,898
00979500,MISSOURI COLLEGE                        ,MO,63144-2901,Proprietary  ,25,95,120,266,674,940
01014814,COLORADO TECHNL UNIV NORTH KANSAS CITY  ,MO,64116-3614,Proprietary  ,0,0,0,40,211,251
01027900,HICKEY COLLEGE                          ,MO,63146-0000,Proprietary  ,23,55,78,584,437,1021
01040500,PINNACLE CAREER INSTITUTE               ,MO,64131-3367,Proprietary  ,31,264,295,161,1553,1714
01040501,PINNACLE CAREER INSTITUTE - NORTH KANSAS,MO,64153-1151,Proprietary  ,11,40,51,81,392,473
01050303,WICHITA TECHNICAL INSTITUTE - WTI JOPLIN,MO,64801-2970,Proprietary  ,4,48,52,48,366,414
01102600,WARRENSBURG AREA VOC TECH SCH           ,MO,64093-0000,Public       ,2,18,20,53,116,169
01173500,PIKE/LINCOLN TECHNICAL CENTER           ,MO,63344-0000,Public       ,1,5,6,36,67,103
01250000,RANKEN TECHNICAL COLLEGE                ,MO,63113-2811,Private      ,122,285,407,1655,2213,3868
01258000,ST LOUIS CHRISTIAN COLLEGE              ,MO,63033-6499,Private      ,4,22,26,147,203,350
01320800,BAPTIST BIBLE COLLEGE                   ,MO,65803-3498,Private      ,11,33,44,306,275,581
02056100,FOUR RIVERS CAREER CENTER               ,MO,63090-0000,Public       ,0,8,8,23,77,100
02068200,COX HEALTH - COX COLLEGE                ,MO,65802-0000,Private      ,22,98,120,426,1294,1720
02119204,COURT REPORTING INSTITUTE OF DALLAS - CO,MO,63105-3329,Proprietary  ,3,30,33,23,250,273
02121100,MIDWEST INSTITUTE                       ,MO,63122-0000,Proprietary  ,6,31,37,72,177,249
02124500,FRANKLIN TECHNOLOGY CENTER              ,MO,64801-0000,Public       ,4,42,46,113,469,582
02142200,LEX LA RAY TECHNICAL CENTER             ,MO,64067-0000,Public       ,0,5,5,31,87,118
02154900,MISSOURI SCH OF BARB & HAIR             ,MO,63031-0000,Proprietary  ,2,13,15,19,93,112
02164200,FOREST INSTITUTE OF PROFESSIONAL PSYCHOL,MO,65807-1445,Private      ,3,23,26,12,303,315
02165900,CHILLICOTHE BEAUTY ACADEMY              ,MO,64601-0000,Proprietary  ,0,4,4,9,25,34
02180200,METRO BUSINESS COLLEGE                  ,MO,63701-0000,Proprietary  ,12,82,94,129,704,833
02188000,NORTHWEST TECHNICAL SCHOOL              ,MO,64468-0000,Public       ,0,0,0,48,39,87
02188100,NORTHLAND CAREER CENTER                 ,MO,64079-8333,Public       ,0,6,6,24,71,95
02202700,OZARK CHRISTIAN COLLEGE                 ,MO,64801-0000,Private      ,20,23,43,736,246,982
02203400,NEVADA REGIONAL TECHNICAL CENTER        ,MO,64772-0000,Public       ,2,9,11,52,80,132
02205200,SANFORD-BROWN COLLEGE                   ,MO,63026-7305,Proprietary  ,5,19,24,30,141,171
02205203,SANFORD BROWN COLLEGE-ST. PETERS        ,MO,63376-5950,Proprietary  ,0,0,0,16,60,76
02214500,SALEM COLLEGE OF HAIRSTYLING            ,MO,65401-0000,Proprietary  ,1,7,8,22,50,72
02239200,ANTHEM COLLEGE                          ,MO,63043-0000,Proprietary  ,1,11,12,61,228,289
02239202,ANTHEM COLLEGE - METRO SOUTH            ,MO,63026-0000,Proprietary  ,0,0,0,86,240,326
02250600,EVEREST COLLEGE                         ,MO,65807-2446,Proprietary  ,17,97,114,139,699,838
02263106,ANTHEM COLLEGE - ANTHEM COLLEGE - KANSAS,MO,64114-3232,Proprietary  ,0,0,0,19,91,110
02263400,LAKE CAREER AND TECHNICAL CENTER        ,MO,65020-0000,Public       ,1,9,10,22,59,81
02266400,CENTRAL CHRISTIAN CLG OF THE BIBLE      ,MO,65270-0000,Private      ,6,10,16,234,163,397
02277500,HOUSE OF HEAVILIN BEAUTY COLLEGE        ,MO,64014-3953,Proprietary  ,5,23,28,55,127,182
02289200,COLUMBIA AREA CAREER CENTER             ,MO,65203-0000,Public       ,12,45,57,179,498,677
02295700,MISSOURI BEAUTY ACADEMY                 ,MO,63640-1827,Proprietary  ,3,12,15,48,105,153
02300105,EVEREST COLLEGE - EARTH CITY            ,MO,63045-1100,Proprietary  ,2,21,23,94,351,445
02304000,MISSOURI TECH                           ,MO,63303-3887,Proprietary  ,8,35,43,93,232,325
02309100,AMERICAN COLLEGE OF HAIR DESIGN         ,MO,65301-2144,Proprietary  ,2,23,25,24,67,91
02313000,CASS CAREER CENTER                      ,MO,64701-0000,Public       ,1,8,9,14,92,106
02340500,ST LOUIS COLLEGE OF HEALTH CAREERS      ,MO,63110-0000,Proprietary  ,36,178,214,345,1262,1607
02342100,CAREER & TECHNOLOGY CTR AT FT OSAGE     ,MO,64058-0000,Public       ,4,9,13,19,65,84
02361600,CONCORDE CAREER COLLEGE                 ,MO,64111-0000,Proprietary  ,68,243,311,372,1617,1989
02497500,CLINTON TECHNICAL SCHOOL                ,MO,64735-2966,Public       ,2,20,22,22,118,140
02520800,MERRELL UNIV OF BTY ARTS & SCIENCES     ,MO,65109-0000,Proprietary  ,7,29,36,94,196,290
02530600,SAINT CHARLES COMMUNITY COLLEGE         ,MO,63376-0975,Public       ,263,388,651,4594,3318,7912
02543800,PARIS II EDUCATIONAL CENTER (THE)       ,MO,64118-0000,Proprietary  ,6,27,33,46,143,189
02564700,ELAINE STEVEN BEAUTY COLLEGE            ,MO,63136-0000,Proprietary  ,10,36,46,104,300,404
02564702,ELAINE STEVEN BEAUTY COLLEGE - ADVANCE B,MO,63401-2269,Proprietary  ,0,1,1,14,17,31
02568500,GRABBER SCHOOL OF HAIR DESIGN           ,MO,63011-0000,Proprietary  ,15,30,45,125,156,281
02599700,VATTEROTT COLLEGE                       ,MO,63134-2900,Proprietary  ,60,305,365,450,1900,2350
02599701,VATTEROTT COLLEGE - KANSAS CITY         ,MO,64117-0000,Proprietary  ,27,202,229,195,1202,1397
02599702,VATTEROTT COLLEGE - SPRINGFIELD LOCATION,MO,65807-5340,Proprietary  ,24,148,172,169,931,1100
02599703,VATTEROTT COLLEGE - JOPLIN              ,MO,64801-5033,Proprietary  ,19,101,120,102,668,770
02599705,VATTEROTT COLLEGE - SUNSET HILLS        ,MO,63127-1516,Proprietary  ,22,150,172,150,833,983
02599712,VATTEROTT COLLEGE - O'FALLON            ,MO,63366-2748,Proprietary  ,26,65,91,155,611,766
02599714,VATTEROTT COLLEGE - EX'TREME INSTITUTE B,MO,63102-2115,Proprietary  ,41,103,144,338,798,1136
02608000,NEOSHO BEAUTY COLLEGE                   ,MO,64850-1525,Proprietary  ,1,4,5,20,37,57
02609202,VATTEROTT COLLEGE-ST JOSEPH             ,MO,64501-2911,Proprietary  ,6,55,61,74,379,453
02609203,VATTEROTT COLLEGE - L'ECOLE CULINAIRE   ,MO,63124-1103,Proprietary  ,20,64,84,130,496,626
02609206,VATTEROTT COLLEGE - L'ECOLE CULINAIRE   ,MO,64112-2110,Proprietary  ,6,61,67,80,413,493
02611004,HERITAGE COLLEGE-KANSAS CITY            ,MO,64131-4203,Proprietary  ,24,131,155,220,827,1047
03042400,LEBANON TECHNOLOGY & CAREER CENTER      ,MO,65536-3296,Public       ,0,0,0,46,49,95
03066300,BRYAN CAREER COLLEGE                    ,MO,65806-2507,Proprietary  ,12,130,142,89,718,807
03066303,BRYAN COLLEGE - COLUMBIA                ,MO,65201-8248,Proprietary  ,10,45,55,101,385,486
03068600,SPECIAL SCHOOL DISTRICT OF ST. LOUIS CO.,MO,63127-1324,Public       ,7,52,59,55,455,510
03070200,CENTRAL COLLEGE OF COSMETOLOGY          ,MO,65583-0000,Proprietary  ,3,12,15,38,95,133
03070900,SE MO HOSP CLG NURSING & HEALTH SCI     ,MO,63703-4507,Private      ,12,37,49,192,504,696
03072800,DALLAS COUNTY CAREER CENTER             ,MO,65685-9152,Public       ,0,0,0,0,1,1
03077200,COSMETOLOGY CONCEPTS INSTITUTE          ,MO,65202-1972,Proprietary  ,9,19,28,65,150,215
03083000,OZARKS TECHNICAL COMMUNITY COLLEGE      ,MO,65802-3601,Public       ,500,1386,1886,8447,12056,20503
03092600,MESSENGER COLLEGE                       ,MO,64804-0000,Private      ,7,10,17,121,92,213
03097600,ST LOUIS HAIR ACADEMY                   ,MO,63107-1737,Proprietary  ,4,17,21,57,153,210
03101000,NEW DIMENSION SCHOOL OF HAIR DESIGN     ,MO,64801-5017,Proprietary  ,3,13,16,25,94,119
03106000,MISSOURI STATE UNIVERSITY - WEST PLAINS ,MO,65775-2715,Public       ,67,154,221,1364,1436,2800
03110900,HOUSE OF HEAVILIN BEAUTY COLLEGE        ,MO,64083-9195,Proprietary  ,3,6,9,24,40,64
03174300,HERNDON CAREER CENTER                   ,MO,64138-2695,Public       ,0,0,0,7,6,13
03519300,MISSOURI COLLEGE OF COSMETOLOGY NORTH   ,MO,65803-0000,Proprietary  ,10,29,39,86,202,288
03579300,TEXAS COUNTY TECHNICAL INSTITUTE        ,MO,65483-2700,Private      ,2,17,19,38,253,291
03616300,AVIATION INSTITUTE OF MAINTENANCE       ,MO,64129-1811,Proprietary  ,10,86,96,68,354,422
03878300,PROFESSIONAL MASSAGE TRAINING CENTER    ,MO,65803-2939,Proprietary  ,5,23,28,26,139,165
03916300,ECLIPS SCHOOL OF COSMETOLOGY AND BARBERI,MO,63703-5809,Proprietary  ,7,38,45,62,215,277
03924300,HAIR ACADEMY 110 (THE)                  ,MO,63501-2915,Proprietary  ,0,4,4,8,24,32
03970400,WELLSPRING SCHOOL OF ALLIED HEALTH      ,MO,64114-3313,Proprietary  ,12,50,62,65,285,350
04037500,ACADEMY OF HAIR DESIGN                  ,MO,65804-2303,Proprietary  ,16,55,71,88,318,406
04051329,ART INSTITUTE OF PHOENIX (THE) - BROWN M,MO,63026-2564,Proprietary  ,5,32,37,116,221,337
04118700,AMERICAN COLLEGE OF TECHNOLOGY          ,MO,64506-2006,Proprietary  ,5,64,69,31,663,694
04119100,CITY VISION COLLEGE                     ,MO,64141-3188,Private      ,4,21,25,19,142,161
04122300,GRANTHAM UNIVERSITY                     ,MO,64153-2262,Proprietary  ,86,1666,1752,686,14004,14690
04130300,VICTORY TRADE SCHOOL                    ,MO,65803-2754,Private      ,0,0,0,15,63,78
04130600,"CENTER FOR HEALING ARTS (THE), LLC      ",MO,63143-2103,Proprietary  ,3,36,39,30,184,214
04133300,TREND SETTERS SCHOOL OF COSMETOLOGY     ,MO,63702-7607,Proprietary  ,5,16,21,52,109,161
04145200,TRANSFORMED BARBER AND COSMETOLOGY ACADE,MO,64137-1207,Proprietary  ,7,36,43,55,217,272
04145700,THE SYSTEM A PAUL MITCHELL PARTNER SCHL ,MO,65807-5969,Proprietary  ,12,31,43,110,193,303
04146100,URSHAN GRADUATE SCHOOL OF THEOLOGY      ,MO,63031-7526,Private      ,2,6,8,39,49,88
04152200,CARTHAGE R-9 SCHOOL DISTRICT/CARTHAGE TE,MO,64836-1332,Public       ,2,8,10,16,65,81
04170600,SALON PROFESSIONAL ACADEMY (THE)        ,MO,63301-1021,Proprietary  ,6,15,21,50,119,169
04170700,PAUL MITCHELL THE SCHOOL ST LOUIS       ,MO,63108-1554,Proprietary  ,14,37,51,221,302,523
04173900,COSMETOLOGY COLLEGE OF FRANKLIN COUNTY  ,MO,63077-3448,Proprietary  ,9,8,17,17,36,53
04174000,SKIN INSTITUTE                          ,MO,63128-1307,Proprietary  ,4,12,16,36,102,138
04174800,AMERICAN TRADE SCHOOL                   ,MO,63074-1807,Proprietary  ,5,33,38,42,172,214
04179000,"SALON PROFESSIONAL ACADEMY, THE         ",MO,65616-7216,Proprietary  ,8,16,24,17,65,82
04184400,SEYMOUR BEAUTY ACADEMY                  ,MO,65746-8743,Proprietary  ,0,5,5,10,41,51
04187000,DONNA'S ACADEMY OF HAIR DESIGN          ,MO,64089-9042,Proprietary  ,0,2,2,24,24,48
04212100,ACADEMY OF SALON PROFESSIONALS          ,MO,65301-6910,Proprietary  ,4,19,23,25,80,105
04218400,CITY POINTE BEAUTY ACADEMY              ,MO,64870-2502,Proprietary  ,7,10,17,55,68,123
00314600,WESTERN OKLAHOMA STATE COLLEGE          ,OK,73521-1397,Public       ,33,99,132,599,953,1552
00314700,BACONE COLLEGE                          ,OK,74403-1597,Private      ,35,65,100,1169,747,1916
00314900,SOUTHERN NAZARENE UNIVERSITY            ,OK,73008-2694,Private      ,49,222,271,1250,2139,3389
00315000,CAMERON UNIVERSITY                      ,OK,73505-6377,Public       ,114,356,470,2313,4230,6543
00315100,OKLAHOMA WESLEYAN UNIVERSITY            ,OK,74006-6299,Private      ,45,178,223,1091,1370,2461
00315200,UNIV OF CENTRAL OKLAHOMA                ,OK,73034-5209,Public       ,500,642,1142,10503,8312,18815
00315300,CONNORS STATE COLLEGE                   ,OK,74469-2204,Public       ,71,151,222,1318,1671,2989
00315400,EAST CENTRAL UNIVERSITY                 ,OK,74820-6999,Public       ,134,224,358,2937,2635,5572
00315500,EASTERN OKLAHOMA STATE COLLEGE          ,OK,74578-4999,Public       ,43,120,163,900,1222,2122
00315600,REDLANDS COMMUNITY COLLEGE              ,OK,73036-5304,Public       ,51,123,174,821,1079,1900
00315700,LANGSTON UNIVERSITY                     ,OK,73050-0000,Public       ,99,165,264,3213,2220,5433
00315800,MURRAY STATE COLLEGE                    ,OK,73460-3137,Public       ,61,150,211,1274,1644,2918
00316000,NORTHEASTERN OKLAHOMA A & M COLLEGE     ,OK,74354-6497,Public       ,113,149,262,1887,1346,3233
00316100,NORTHEASTERN STATE UNIVERSITY           ,OK,74464-2399,Public       ,178,427,605,5387,6325,11712
00316200,NORTHERN OKLAHOMA COLLEGE               ,OK,74653-0310,Public       ,83,179,262,1949,1934,3883
00316300,NORTHWESTERN OKLAHOMA STATE UNIV        ,OK,73717-2799,Public       ,62,93,155,1525,1026,2551
00316400,OKLAHOMA BAPTIST UNIVERSITY             ,OK,74801-2590,Private      ,156,66,222,3049,564,3613
00316500,OKLAHOMA CHRISTIAN UNIVERSITY           ,OK,73131-0000,Private      ,109,104,213,2583,1089,3672
00316600,OKLAHOMA CITY UNIVERSITY                ,OK,73106-1493,Private      ,143,233,376,2800,2944,5744
00316700,UNIV OF SCIENCE & ARTS OF OKLAHOMA      ,OK,73018-5322,Public       ,49,49,98,826,482,1308
00316800,ROGERS STATE UNIVERSITY                 ,OK,74017-3252,Public       ,108,277,385,2804,3053,5857
00317000,OKLAHOMA STATE UNIVERSITY               ,OK,74078-1026,Public       ,851,625,1476,20529,8961,29490
00317200,OKLAHOMA STATE UNIVERSITY-OKMULGEE      ,OK,74447-3901,Public       ,140,215,355,2040,2168,4208
00317400,OKLAHOMA PANHANDLE STATE UNIVERSITY     ,OK,73939-0000,Public       ,60,41,101,947,462,1409
00317600,CARL ALBERT STATE COLLEGE               ,OK,74953-5208,Public       ,62,200,262,1377,1853,3230
00317800,SEMINOLE STATE COLLEGE                  ,OK,74818-0351,Public       ,56,123,179,1001,1219,2220
00317900,SOUTHEASTERN OKLAHOMA STATE UNIV        ,OK,74701-0609,Public       ,120,215,335,2588,2721,5309
00318000,SOUTHWESTERN CHRISTIAN UNIVERSITY       ,OK,73008-2335,Private      ,11,62,73,495,688,1183
00318100,SOUTHWESTERN OKLAHOMA STATE UNIV        ,OK,73096-3098,Public       ,166,174,340,3429,2174,5603
00318101,SOUTHWESTERN OK STATE UNIV AT SAYRE     ,OK,73662-0000,Public       ,11,16,27,143,187,330
00318300,ST GREGORY'S UNIVERSITY                 ,OK,74804-2499,Private      ,20,53,73,545,421,966
00318308,SAINT GREGORY'S UNIVERSITY - IPD TULSA  ,OK,74135-2499,Private      ,5,23,28,53,246,299
00318400,UNIVERSITY OF OKLAHOMA                  ,OK,73019-4078,Public       ,829,827,1656,19530,10908,30438
00318401,UNIVERSITY OF OKLAHOMA-HLTH SCI CTR     ,OK,73190-0000,Public       ,35,167,202,884,3643,4527
00318500,UNIVERSITY OF TULSA                     ,OK,74104-3189,Private      ,127,174,301,4069,2206,6275
00398500,ORAL ROBERTS UNIVERSITY                 ,OK,74171-0001,Private      ,98,226,324,3129,2097,5226
00531100,TULSA COUNTY AREA VOC TECH SCHOOL       ,OK,74145-0000,Public       ,53,199,252,696,1892,2588
00531200,RED RIVER TECHNOLOGY CENTER             ,OK,73533-2700,Public       ,2,23,25,47,182,229
00533900,METRO TECHNOLOGY CENTERS SCH DIST22     ,OK,73111-0000,Public       ,27,166,193,284,1207,1491
00533903,METRO TECHNOLOGY CENTERS SCH DIST22     ,OK,73129-0000,Public       ,15,121,136,159,794,953
00694200,MID-AMERICA CHRISTIAN UNIVERSITY        ,OK,73170-4504,Private      ,39,332,371,586,3211,3797
00767800,SPARTAN COLLEGE OF AERONAUTICS AND TECHN,OK,74115-5800,Proprietary  ,62,121,183,875,802,1677
00791100,VIRGILS BEAUTY COLLEGE                  ,OK,74401-6802,Proprietary  ,3,12,15,23,64,87
00834300,AUTRY TECHNOLOGY CENTER                 ,OK,73703-2598,Public       ,9,26,35,119,291,410
00861900,TRI COUNTY TECHNOLOGY CENTER            ,OK,74006-6029,Public       ,2,22,24,40,139,179
00918500,ROSE STATE COLLEGE                      ,OK,73110-2799,Public       ,190,582,772,3059,5407,8466
00920400,KIAMICHI TECHNOLOGY CENTER              ,OK,74578-0548,Public       ,24,88,112,333,960,1293
00961800,TULSA WELDING SCHOOL                    ,OK,74104-0000,Proprietary  ,310,533,843,1788,2346,4134
00964700,"OKLAHOMA STATE UNIV, OKLA CITY          ",OK,73107-6159,Public       ,256,729,985,3447,7087,10534
00970800,EVES COLLEGE OF HAIRSTYLING             ,OK,73501-0000,Proprietary  ,7,20,27,37,146,183
00976300,TULSA COMMUNITY COLLEGE                 ,OK,74135-6198,Public       ,435,1308,1743,8524,12869,21393
00996300,CADDO KIOWA VOC TECH CENTER             ,OK,73038-0000,Public       ,7,35,42,76,292,368
00996400,CENTRAL OKLAHOMA AREA VOC TECH SCH      ,OK,74030-9613,Public       ,7,42,49,101,326,427
00996500,CANADIAN VALLEY TECHNOLOGY CENTER       ,OK,73036-9117,Public       ,13,36,49,111,351,462
00996800,GORDON COOPER TECHNOLOGY CENTER         ,OK,74804-9913,Public       ,6,57,63,121,452,573
01005300,INDIAN CAPITAL TECHNOLGY CENTER #4      ,OK,74403-9907,Public       ,16,56,72,266,665,931
01026600,HILLSDALE FREE WILL BAPTIST COLLEGE     ,OK,73153-0000,Private      ,12,15,27,220,103,323
01034200,SOUTHERN OKLAHOMA TECHNOLOGY CENTER     ,OK,73401-2100,Public       ,6,47,53,89,321,410
01039100,OKLAHOMA CITY COMMUNITY COLLEGE         ,OK,73159-4444,Public       ,357,1057,1414,5595,9711,15306
01050304,WTI TULSA CAMPUS                        ,OK,74112-3140,Proprietary  ,3,49,52,32,293,325
01071700,GREAT PLAINS TECHNOLOGY CENTER SCHOOL DI,OK,73505-8399,Public       ,20,74,94,200,722,922
01076200,WESTERN OK AREA VOC TECH SCH DIST12     ,OK,73624-1469,Public       ,3,14,17,50,129,179
01120600,PIONEER TECHNOLOGY CENTER               ,OK,74601-1106,Public       ,1,17,18,42,186,228
01128200,OKLAHOMA STATE UNV CLG OSTEOPTHC MD     ,OK,74107-0000,Public       ,6,38,44,163,805,968
01153700,MID-AMERICA TECHNOLOGY CENTER           ,OK,73095-0210,Public       ,2,9,11,30,132,162
01227200,MOORE-NORMAN TECHNOLOGY CENTER          ,OK,73069-8399,Public       ,25,116,141,296,983,1279
02052700,NORTHEAST TECHNOLOGY CENTER             ,OK,74361-0487,Public       ,5,64,69,184,511,695
02060800,MERIDIAN TECHNOLOGY CENTER              ,OK,74074-0000,Public       ,16,35,51,187,335,522
02126500,ENID BEAUTY COLLEGE                     ,OK,73701-0000,Proprietary  ,1,11,12,25,56,81
02184400,SAND SPRINGS BEAUTY COLLEGE             ,OK,74063-0000,Proprietary  ,6,13,19,34,104,138
02197300,HOLLYWOOD COSMETOLOGY CENTER            ,OK,73189-0000,Proprietary  ,3,14,17,26,88,114
02222700,FRANCIS TUTTLE TECHNOLOGY CENTER        ,OK,73142-0000,Public       ,43,219,262,420,1722,2142
02238500,CENTRAL STATE BEAUTY ACADEMY            ,OK,73162-6007,Proprietary  ,11,42,53,87,344,431
02250900,E OK COUNTY AREA VO-TECH                ,OK,73020-0000,Public       ,6,12,18,54,93,147
02256200,"BROKEN ARROW BEAUTY COLLEGE, INC        ",OK,74012-0000,Proprietary  ,12,35,47,88,234,322
02282100,HIGH PLAINS AREA VOC-TECH               ,OK,73801-0000,Public       ,0,14,14,29,92,121
02306800,PLATT COLLEGE                           ,OK,74145-0000,Proprietary  ,23,165,188,289,1329,1618
02306811,PLATT COLLEGE - LAWTON                  ,OK,73501-3808,Proprietary  ,15,70,85,92,445,537
02510300,BEAUTY TECHNICAL COLLEGE                ,OK,74465-0000,Proprietary  ,1,5,6,24,52,76
02531200,WOODWARD BEAUTY COLLEGE                 ,OK,73801-0000,Proprietary  ,0,5,5,12,40,52
02554300,AMERICAN BEAUTY INSTITUTE               ,OK,74501-0000,Proprietary  ,0,0,0,10,26,36
02556500,YUKON BEAUTY COLLEGE                    ,OK,73099-4108,Proprietary  ,2,10,12,9,39,48
02560200,PHILLIPS THEOLOGICAL SEMINARY -         ,OK,74116-5612,Private      ,0,9,9,3,111,114
02581100,CLAREMORE BEAUTY COLLEGE                ,OK,74017-7034,Proprietary  ,0,10,10,14,40,54
02581200,CC'S COSMETOLOGY COLLEGE                ,OK,74129-0000,Proprietary  ,10,29,39,75,219,294
02591101,CAREER POINT INSTITUTE                  ,OK,74146-0000,Proprietary  ,10,56,66,78,366,444
02596501,ATI-CAREER TRAINING CENTER - OKLAHOMA CI,OK,73107-2442,Proprietary  ,0,31,31,9,104,113
02596502,ATI- CAREER TRAINING CENTER - OKLAHOMA C,OK,76101-2740,Proprietary  ,2,41,43,16,148,164
02597400,PONTOTOC TECHNOLOGY CENTER SCHOOL       ,OK,74820-8621,Public       ,4,27,31,63,186,249
02599706,VATTEROTT COLLEGE - TULSA               ,OK,74146-2205,Proprietary  ,11,63,74,75,412,487
02600000,NORTHWEST TECHNOLOG CTR SCH DIST 10     ,OK,73717-9600,Public       ,1,5,6,24,50,74
02600500,WES WATKINS TECHNOLOGY CENTER           ,OK,74883-9660,Public       ,3,14,17,31,137,168
02609205,VATTEROTT COLLEGE - OKLAHOMA CITY       ,OK,73127-2103,Proprietary  ,8,122,130,82,792,874
03008700,SOUTHWEST TECHNOLOGY CENTER             ,OK,73521-1527,Public       ,5,24,29,58,179,237
03024700,STILLWATER BEAUTY ACADEMY               ,OK,74075-3467,Proprietary  ,3,8,11,34,69,103
03030700,OKLAHOMA SCHOOL OF PHOTOGRAPHY          ,OK,73160-3320,Proprietary  ,3,17,20,31,118,149
03030800,AMERICAN BROADCASTING SCHOOL            ,OK,73115-3334,Proprietary  ,2,40,42,35,255,290
03051100,CHISHOLM TRAIL TECHNOLOGY CENTER        ,OK,73764-6335,Public       ,4,11,15,16,71,87
03078500,TECH INST OF COSMETOLOGY ARTS & SCI     ,OK,74120-3610,Proprietary  ,1,12,13,31,106,137
03103800,SOUTHERN SCHOOL OF BEAUTY               ,OK,74701-5008,Proprietary  ,3,13,16,27,76,103
03109800,PONCA CITY BEAUTY COLLEGE               ,OK,74601-4201,Proprietary  ,1,7,8,13,42,55
03109801,BARTLESVILLE BEAUTY COLLEGE             ,OK,74003-2835,Proprietary  ,3,7,10,13,41,54
03115100,HERITAGE COLLEGE                        ,OK,73119-0000,Proprietary  ,33,172,205,250,1106,1356
03124901,IMAGINE -  PAUL MITCHELL PARTNER SCHOOL ,OK,73072-4831,Proprietary  ,16,45,61,124,237,361
03126200,GREEN COUNTRY AREA VOC TECH SCHOOL      ,OK,74447-1217,Public       ,7,30,37,56,193,249
03198400,MID-DEL AREA VOCATIONAL & TECH SCH      ,OK,73110-4825,Public       ,3,29,32,59,213,272
03329400,PRYOR BEAUTY COLLEGE                    ,OK,74361-0000,Proprietary  ,0,6,6,6,45,51
03329401,PRYOR BEAUTY COLLEGE - GROVE BEAUTY COLL,OK,74345-0009,Proprietary  ,0,6,6,6,31,37
03329402,PRYOR BEAUTY COLLEGE - NORTH EAST OKLAHO,OK,74338-0000,Proprietary  ,0,0,0,4,4,8
03367400,COMMUNITY CARE COLLEGE                  ,OK,74145-6420,Proprietary  ,66,311,377,524,2034,2558
03453400,SHAWNEE BEAUTY COLLEGE                  ,OK,74801-7014,Proprietary  ,2,15,17,8,61,69
03676300,FAMILY OF FAITH COLLEGE                 ,OK,74802-1805,Private      ,1,5,6,16,40,56
03831300,INSTITUTE OF HAIR DESIGN                ,OK,74804-0000,Proprietary  ,1,11,12,7,42,49
03928300,CENTRAL STATE MASSAGE ACADEMY           ,OK,73162-6007,Proprietary  ,3,17,20,25,145,170
04051324,ART INSTITUTE OF PHOENIX (THE) - BROWN M,OK,74146-5234,Proprietary  ,12,36,48,92,388,480
04060300,AMERICAN INSTITUTE OF MEDICAL TECHNOLOGY,OK,74146-5201,Proprietary  ,6,47,53,108,318,426
04133600,CUTTER'S EDGE SCHOOL OF COSMETOLOGY     ,OK,74023-2905,Proprietary  ,2,4,6,13,26,39
04144400,ACADEMY OF HAIR DESIGN (THE)            ,OK,73120-6808,Proprietary  ,5,33,38,57,200,257
04184300,PAUL MITCHELL THE SCHOOL ARDMORE        ,OK,73401-3912,Proprietary  ,2,9,11,25,73,98
04213600,RIVER VALLEY COSMETOLOGY INSTITUTE      ,OK,74953-5260,Proprietary  ,4,18,22,24,83,107
04224700,JB'S HAIR DESIGN AND BARBER COLLEGE     ,OK,73139-1602,Proprietary  ,7,25,32,40,162,202
04224900,COLLEGE OF THE MUSCOGEE NATION          ,OK,74447-0917,Public       ,18,25,43,131,209,340
04225100,COMANCHE NATION COLLEGE                 ,OK,73501-7434,Public       ,1,3,4,1,3,4
04240500,PAUL MITCHELL THE SCHOOL TULSA          ,OK,74134-1410,Proprietary  ,16,36,52,30,67,97
00163700,BETHANY THEOLOGICAL SEMINARY            ,IN,47374-0000,Private      ,0,7,7,3,65,68
00178400,ANCILLA COLLEGE-FINANCIAL AID OFFC      ,IN,46513-0001,Private      ,12,30,42,490,400,890
00178500,ANDERSON UNIVERSITY                     ,IN,46012-3495,Private      ,39,103,142,2735,1262,3997
00178600,BALL STATE UNIVERSITY                   ,IN,47306-0880,Public       ,403,583,986,23841,9150,32991
00178700,BETHEL COLLEGE INC                      ,IN,46545-5591,Private      ,35,97,132,1662,1474,3136
00178800,BUTLER UNIVERSITY                       ,IN,46208-3487,Private      ,149,156,305,9040,2488,11528
00178900,CHRISTIAN THEOLOGICAL SEMINARY          ,IN,46208-0000,Private      ,1,18,19,20,297,317
00179200,DEPAUW UNIVERSITY                       ,IN,46135-0037,Private      ,60,12,72,3447,206,3653
00179300,EARLHAM COLLEGE                         ,IN,47374-4095,Private      ,27,15,42,1568,180,1748
00179301,EARLHAM SCHOOL OF RELIGION              ,IN,47374-0000,Private      ,0,3,3,14,39,53
00179500,UNIVERSITY OF EVANSVILLE                ,IN,47722-0002,Private      ,53,53,106,3527,971,4498
00179800,FRANKLIN COLLEGE OF INDIANA             ,IN,46131-2623,Private      ,31,24,55,2058,381,2439
00179900,GOSHEN COLLEGE                          ,IN,46526-4794,Private      ,7,40,47,937,579,1516
00180000,GRACE COLLEGE & THEO SEMINARY           ,IN,46590-1224,Private      ,22,65,87,2255,706,2961
00180100,HANOVER COLLEGE                         ,IN,47243-0108,Private      ,38,9,47,2320,147,2467
00180300,HUNTINGTON UNIVERSITY                   ,IN,46750-1299,Private      ,18,41,59,1395,560,1955
00180400,UNIVERSITY OF INDIANAPOLIS              ,IN,46227-3697,Private      ,118,270,388,7042,5661,12703
00180500,INDIANA INSTITUTE OF TECHNOLOGY         ,IN,46803-1297,Private      ,102,693,795,2837,8307,11144
00180700,INDIANA STATE UNIVERSITY                ,IN,47809-2501,Public       ,254,470,724,15437,7948,23385
00180800,UNIVERSITY OF SOUTHERN INDIANA          ,IN,47712-3596,Public       ,155,225,380,9125,4172,13297
00180900,INDIANA UNIVERSITY-BLOOMINGTON          ,IN,47405-7000,Public       ,709,517,1226,36530,12063,48593
00181100,INDIANA UNIV-EAST                       ,IN,47374-1289,Public       ,44,199,243,2235,3133,5368
00181300,INDIANA UNIV-PURDUE UNIV INDPLS         ,IN,46202-5145,Public       ,455,1077,1532,25013,24694,49707
00181301,INDIANA UNIVERSITY - PURDUE UNIVERSITY I,IN,47203-1769,Public       ,68,125,193,2298,2278,4576
00181400,INDIANA UNIV KOKOMO                     ,IN,46902-3557,Public       ,60,159,219,2713,2943,5656
00181500,INDIANA UNIV-NORTHWEST                  ,IN,46408-1197,Public       ,110,329,439,4594,5905,10499
00181600,INDIANA UNIVERSITY - SOUTH BEND         ,IN,46615-0000,Public       ,117,295,412,5425,5755,11180
00181700,INDIANA UNIVERSITY-SOUTHEAST            ,IN,47150-6405,Public       ,102,265,367,4742,4320,9062
00182000,MANCHESTER UNIVERSITY                   ,IN,46962-1276,Private      ,40,21,61,2520,562,3082
00182100,MARIAN UNIVERSITY                       ,IN,46222-1997,Private      ,53,197,250,2611,3526,6137
00182200,INDIANA WESLEYAN UNIVERSITY             ,IN,46953-4974,Private      ,95,1720,1815,4547,16767,21314
00182300,ASSOCIATED MENNONITE BIBLICAL SEM       ,IN,46517-1999,Private      ,1,7,8,5,101,106
00182400,OAKLAND CITY UNIVERSITY                 ,IN,47660-1099,Private      ,12,74,86,576,704,1280
00182500,PURDUE UNIVERSITY                       ,IN,47907-2050,Public       ,684,409,1093,35227,8440,43667
00182600,PURDUE UNIV NORTH CENTRAL CAMPUS        ,IN,46391-9542,Public       ,50,141,191,3279,2533,5812
00182700,PURDUE UNIV CALUMET                     ,IN,46323-2094,Public       ,154,469,623,5887,7024,12911
00182800,INDIANA UNIV-PURDUE UNIV FORT WAYNE     ,IN,46805-1499,Public       ,182,420,602,10353,7956,18309
00183000,ROSE HULMAN INSTITUTE OF TECHNOLOGY     ,IN,47803-3999,Private      ,55,8,63,3664,225,3889
00183200,UNIVERSITY OF SAINT FRANCIS             ,IN,46808-3994,Private      ,46,147,193,2522,2293,4815
00183300,ST JOSEPH'S COLLEGE                     ,IN,47978-0000,Private      ,27,9,36,1545,269,1814
00183400,CALUMET COLLEGE OF SAINT JOSEPH         ,IN,46394-2195,Private      ,25,77,102,648,860,1508
00183500,SAINT MARY-OF-THE-WOODS COLLEGE         ,IN,47876-0067,Private      ,8,64,72,447,1136,1583
00183600,ST MARY'S COLLEGE                       ,IN,46556-5007,Private      ,25,6,31,1975,106,2081
00183800,TAYLOR UNIVERSITY                       ,IN,46989-1001,Private      ,50,21,71,2498,333,2831
00183900,TRINE UNIVERSITY                        ,IN,46703-1764,Private      ,45,75,120,3127,1158,4285
00184000,UNIVERSITY OF NOTRE DAME                ,IN,46556-5602,Private      ,366,182,548,13287,3250,16537
00184200,VALPARAISO UNIVERSITY                   ,IN,46383-6493,Private      ,114,91,205,6056,2188,8244
00184300,VINCENNES UNIVERSITY                    ,IN,47591-1523,Public       ,173,456,629,7694,5154,12848
00184400,WABASH COLLEGE                          ,IN,47933-0352,Private      ,24,6,30,1489,94,1583
00457900,INTERNATIONAL BUSINESS COLLEGE          ,IN,46804-0000,Proprietary  ,11,33,44,716,438,1154
00457901,INTERNATIONAL BUSINESS COLLEGE          ,IN,46256-0000,Proprietary  ,7,39,46,728,616,1344
00625700,SAINT ELIZABETH SCHOOL OF NURSING       ,IN,47904-2198,Private      ,7,20,27,215,478,693
00638510,CHAMBERLAIN COLLEGE OF NURSING - INDIANA,IN,46240-2158,Proprietary  ,10,112,122,182,1452,1634
00726300,HOLY CROSS COLLEGE                      ,IN,46556-0308,Private      ,13,16,29,763,145,908
00727600,SAINT MEINRAD SCHOOL OF THEOLOGY        ,IN,47577-1002,Private      ,0,5,5,4,97,101
00732900,ITT TECHNICAL INSTITUTE                 ,IN,46268-1119,Proprietary  ,488,2995,3483,3686,19115,22801
00732933,ITT TECHNICAL INSTITUTE                 ,IN,46635-1512,Proprietary  ,12,139,151,346,1212,1558
00732962,ITT TECHNICAL INSTITUTE                 ,IN,47630-7430,Proprietary  ,82,532,614,752,4090,4842
00732968,ITT TECHNICAL INSTITUTE                 ,IN,46410-0000,Proprietary  ,13,91,104,284,974,1258
00732993,ITT TECHNICAL INSTITUTE                 ,IN,46825-2393,Proprietary  ,75,402,477,889,3215,4104
00736200,MEDTECH COLLEGE                         ,IN,46250-3970,Proprietary  ,19,140,159,357,2153,2510
00736202,MEDTECH COLLEGE - GREENWOOD             ,IN,46143-6478,Proprietary  ,9,59,68,178,953,1131
00736204,MEDTECH COLLEGE - FORT WAYNE            ,IN,46804-2209,Proprietary  ,10,102,112,261,1155,1416
00793800,LINCOLN COLLEGE OF TECHNOLOGY           ,IN,46202-0000,Proprietary  ,160,154,314,1815,1206,3021
00931306,DAYMAR COLLEGE - ROCKPORT               ,IN,47635-1506,Proprietary  ,0,1,1,5,19,24
00951500,J MICHAEL HARROLD BEAUTY ACADEMY        ,IN,47807-3390,Proprietary  ,7,20,27,70,188,258
00961200,"APEX SCHOOL OF BEAUTY CULTURE, INC      ",IN,46016-0000,Proprietary  ,0,14,14,23,79,102
00961300,MERRILLVILLE BEAUTY COLLEGE             ,IN,46410-3401,Proprietary  ,9,34,43,66,234,300
00967300,RUDAE'S SCHOOL OF BEAUTY CULTURE        ,IN,46825-5444,Proprietary  ,13,29,42,157,270,427
00977700,KAPLAN COLLEGE                          ,IN,46278-1736,Proprietary  ,0,0,0,66,365,431
00977702,KAPLAN COLLEGE - TEMPORARY FACILITY EXPA,IN,46268-4111,Proprietary  ,0,0,0,2,8,10
00991700,IVY TECH COMMUNITY COLLEGE OF INDIANA   ,IN,46208-1763,Public       ,1957,7894,9851,44848,95504,140352
01015100,VINCENNES BEAUTY COLLEGE                ,IN,47591-1297,Proprietary  ,3,16,19,103,125,228
01040900,LAFAYETTE BEAUTY ACADEMY                ,IN,47901-1149,Proprietary  ,5,27,32,95,220,315
01048900,NATIONAL COLLEGE                        ,IN,46250-1930,Proprietary  ,3,34,37,51,490,541
01048910,NATIONAL COLLEGE - SOUTH BEND           ,IN,46617-3123,Proprietary  ,3,49,52,86,496,582
01048911,NATIONAL COLLEGE - FORT WAYNE           ,IN,46826-4905,Proprietary  ,1,25,26,55,332,387
01061800,MID-AMERICA CLG FUNERAL SERVICE         ,IN,47130-9990,Private      ,4,11,15,59,138,197
01150500,CREATIVE HAIR STYLING ACADEMY           ,IN,46322-1554,Proprietary  ,8,40,48,115,244,359
02084800,RAVENSCROFT BEAUTY COLLEGE              ,IN,46815-0000,Proprietary  ,13,53,66,122,293,415
02087600,CONCORDIA THEOLOGICAL SEMINARY          ,IN,46825-0000,Private      ,0,7,7,13,216,229
02100402,EVEREST INSTITUTE - EVEREST COLLEGE     ,IN,46410-7064,Proprietary  ,6,43,49,277,1097,1374
02140800,MARTIN UNIVERSITY                       ,IN,46218-0000,Private      ,4,80,84,191,1316,1507
02158400,HARRISON COLLEGE                        ,IN,46204-2611,Proprietary  ,57,386,443,664,3770,4434
02158401,HARRISON COLLEGE - COLUMBUS             ,IN,47203-1843,Proprietary  ,12,65,77,168,678,846
02158402,HARRISON COLLEGE - LAFAYETTE            ,IN,47905-4859,Proprietary  ,17,67,84,196,720,916
02158405,HARRISON COLLEGE - TERRE HAUTE          ,IN,47802-0000,Proprietary  ,12,78,90,142,763,905
02158407,HARRISON COLLEGE - ANDERSON             ,IN,46013-0000,Proprietary  ,9,67,76,146,725,871
02158409,HARRISON COLLEGE - EVANSVILLE           ,IN,47715-3901,Proprietary  ,11,81,92,188,615,803
02158410,HARRISON COLLEGE - EAST                 ,IN,46239-8903,Proprietary  ,19,102,121,293,1369,1662
02158412,HARRISON COLLEGE - FORT WAYNE           ,IN,46825-0000,Proprietary  ,7,90,97,156,771,927
02158413,HARRISON COLLEGE - NORTHWEST            ,IN,46278-0000,Proprietary  ,13,35,48,227,523,750
02158415,HARRISON COLLEGE - MUNCIE               ,IN,47303-0000,Proprietary  ,4,35,39,110,270,380
02158416,HARRISON COLLEGE - ELKHART              ,IN,46516-0000,Proprietary  ,5,52,57,70,369,439
02158800,DON ROBERTS BEAUTY SCHOOLS              ,IN,46383-0000,Proprietary  ,2,16,18,37,95,132
02164300,DON ROBERTS SCHOOL OF HAIR DESIGN       ,IN,46375-9999,Proprietary  ,0,15,15,28,83,111
02180108,ROSS MEDICAL EDUCATION CENTER -         ,IN,46530-4479,Proprietary  ,0,21,21,43,207,250
02201800,KAPLAN COLLEGE                          ,IN,46324-3347,Proprietary  ,23,119,142,227,881,1108
02201806,KAPLAN COLLEGE - SOUTHEAST INDIANAPOLIS ,IN,46227-1493,Proprietary  ,35,230,265,398,1808,2206
02241700,PJ'S COLLEGE OF COSMETOLOGY             ,IN,47129-0000,Proprietary  ,6,29,35,57,190,247
02245505,FORTIS COLLEGE - INDIANAPOLIS CAMPUS    ,IN,46268-0000,Proprietary  ,5,62,67,81,577,658
02302700,J EVERETT LIGHT CAREER CENTER           ,IN,46240-0000,Public       ,0,0,0,70,387,457
02304800,PJ'S COLLEGE OF COSMETOLOGY             ,IN,47374-0000,Proprietary  ,2,20,22,48,125,173
02308900,MASTER'S OF COSMETOLOGY COLLEGE         ,IN,46809-0000,Proprietary  ,8,24,32,144,208,352
02339600,ROGER'S ACADEMY OF HAIR DESIGN          ,IN,47712-0000,Proprietary  ,6,29,35,81,205,286
02351300,KNOX BEAUTY COLLEGE                     ,IN,46534-0000,Proprietary  ,1,6,7,17,43,60
02490500,HAIR FASHIONS BY KAYE BEAUTY CLG        ,IN,46250-0000,Proprietary  ,8,38,46,109,377,486
02490800,HAIR FASHIONS BY KAYE BEAUTY CLG        ,IN,46060-0000,Proprietary  ,0,7,7,55,88,143
02607000,HAIR ARTS ACADEMY                       ,IN,47404-2419,Proprietary  ,3,19,22,69,142,211
02615800,COLLEGE OF COURT REPORTING              ,IN,46342-5969,Proprietary  ,5,39,44,30,324,354
03100600,MARION COMM TUCKER AREA VOC SCHOOL      ,IN,46952-3831,Public       ,1,14,15,40,134,174
03176300,AVIATION INSTITUTE OF MAINTENANCE       ,IN,46241-1445,Proprietary  ,13,57,70,130,391,521
03456700,CROSSROADS BIBLE COLLEGE                ,IN,46219-4912,Private      ,1,35,36,70,448,518
03538300,ALEXANDRIA SCH OF SCIENTIFIC THERAP     ,IN,46001-0287,Proprietary  ,0,7,7,22,92,114
04038700,IDEAL BEAUTY ACADEMY                    ,IN,47130-4215,Proprietary  ,2,17,19,23,98,121
04051304,ART INSTITUTE OF PHOENIX (THE) - ART  IN,IN,46268-1170,Proprietary  ,111,113,224,1203,1224,2427
04051311,ART INSTITUTE OF PHOENIX (THE) - BROWN M,IN,46410-5608,Proprietary  ,13,84,97,208,795,1003
04051312,ART INSTITUTE OF PHOENIX (THE) - BROWN M,IN,46360-7362,Proprietary  ,3,8,11,68,276,344
04051318,ART INSTITUTE OF PHOENIX (THE) - BROWN M,IN,46204-1017,Proprietary  ,23,191,214,328,1757,2085
04051321,ART INSTITUTE OF PHOENIX (THE) - BROWN M,IN,46635-1176,Proprietary  ,12,72,84,164,700,864
04051322,ART INSTITUTE OF PHOENIX (THE) - BROWN M,IN,46805-0000,Proprietary  ,14,90,104,238,870,1108
04100300,SUCCESS SCHOOLS                         ,IN,46410-5310,Proprietary  ,7,40,47,95,272,367
04121000,TECHSKILLS - INDIANAPOLIS               ,IN,46240-4302,Proprietary  ,19,116,135,143,749,892
04130900,HONORS BEAUTY COLLEGE                   ,IN,46256-3317,Proprietary  ,7,32,39,112,345,457
04155900,AVEDA FREDRIC'S INSTITUTE               ,IN,46250-4746,Proprietary  ,13,40,53,190,295,485
04166700,REM SPA INC                             ,IN,46013-3136,Proprietary  ,6,22,28,63,167,230
04171700,AVANT GARD THE SCHOOL                   ,IN,46214-6500,Proprietary  ,1,10,11,32,91,123
04172700,SALON PROFESSIONAL ACADEMY (THE)        ,IN,47715-7822,Proprietary  ,7,26,33,141,208,349
04184000,PAUL MITCHELL THE SCHOOL INDIANAPOLIS   ,IN,46227-6252,Proprietary  ,11,41,52,196,372,568
04186600,SALON PROFESSIONAL ACADEMY (THE)        ,IN,46901-6248,Proprietary  ,9,29,38,89,166,255
04205500,LIL LOU'S BARBER COLLEGE                ,IN,46409-2645,Proprietary  ,4,40,44,44,209,253
04230300,EXCEL ACADEMIES OF COSMETOLOGY - MERRILL,IN,46410-5540,Proprietary  ,1,12,13,54,80,134
00190100,ALLEN COUNTY COMMUNITY COLLEGE          ,KS,66749-1607,Public       ,63,136,199,1089,1445,2534
00190200,COWLEY COUNTY COMMUNITY COLLEGE & AREA V,KS,67005-2662,Public       ,103,223,326,1659,2384,4043
00190300,BAKER UNIVERSITY                        ,KS,66006-0065,Private      ,40,258,298,1436,2109,3545
00190400,BETHANY COLLEGE                         ,KS,67456-1897,Private      ,32,8,40,975,147,1122
00190500,BETHEL COLLEGE                          ,KS,67117-8061,Private      ,36,14,50,794,176,970
00190600,BUTLER COUNTY COMMUNITY COLLEGE         ,KS,67042-3280,Public       ,248,547,795,4465,5220,9685
00190700,CENTRAL BAPTIST THEOLOGY SEMINARY       ,KS,66226-3513,Private      ,0,9,9,1,68,69
00190800,CENTRAL CHRISTIAN COLLEGE OF KANSAS     ,KS,67460-5799,Private      ,18,227,245,456,934,1390
00190900,CLOUD COUNTY COMMUNITY COLLEGE          ,KS,66901-1002,Public       ,48,99,147,776,1062,1838
00191000,COFFEYVILLE COMMUNITY COLLEGE           ,KS,67337-5064,Public       ,59,107,166,994,544,1538
00191100,COLBY COMMUNITY COLLEGE                 ,KS,67701-4099,Public       ,24,42,66,698,495,1193
00191300,DODGE CITY COMMUNITY COLLEGE            ,KS,67801-2399,Public       ,51,73,124,1020,758,1778
00191400,DONNELLY COLLEGE                        ,KS,66102-4298,Private      ,8,50,58,390,663,1053
00191500,FORT HAYS STATE UNIVERSITY              ,KS,67601-4099,Public       ,146,574,720,4699,6984,11683
00191600,FORT SCOTT COMMUNITY COLLEGE            ,KS,66701-3199,Public       ,67,104,171,1223,945,2168
00191700,BARCLAY COLLEGE                         ,KS,67059-0288,Private      ,6,21,27,160,140,300
00191800,FRIENDS UNIVERSITY                      ,KS,67213-3397,Private      ,53,179,232,1380,2131,3511
00191900,GARDEN CITY COMMUNITY COLLEGE           ,KS,67846-6398,Public       ,63,64,127,1116,689,1805
00192000,HESSTON COLLEGE                         ,KS,67062-2093,Private      ,10,7,17,469,170,639
00192100,HIGHLAND COMMUNITY COLLEGE              ,KS,66035-4062,Public       ,76,136,212,1342,1407,2749
00192300,HUTCHINSON COMMUNITY COLLEGE            ,KS,67501-5894,Public       ,111,288,399,2290,2697,4987
00192400,INDEPENDENCE COMMUNITY COLLEGE          ,KS,67301-0708,Public       ,39,86,125,689,417,1106
00192500,KANSAS CITY KANSAS COMMUNITY CLG        ,KS,66112-9978,Public       ,152,479,631,2254,5106,7360
00192600,PITTSBURG STATE UNIVERSITY              ,KS,66762-7500,Public       ,168,203,371,5653,2976,8629
00192700,EMPORIA STATE UNIVERSITY                ,KS,66801-5415,Public       ,115,225,340,3680,2939,6619
00192800,KANSAS STATE UNIVERSITY                 ,KS,66506-1104,Public       ,529,531,1060,17505,7311,24816
00192900,KANSAS WESLEYAN UNIVERSITY              ,KS,67401-6196,Private      ,44,20,64,963,367,1330
00193000,LABETTE COMMUNITY COLLEGE               ,KS,67357-4299,Public       ,27,98,125,662,869,1531
00193100,MANHATTAN CHRISTIAN COLLEGE             ,KS,66502-4081,Private      ,13,11,24,333,125,458
00193300,MCPHERSON COLLEGE                       ,KS,67460-3899,Private      ,18,12,30,831,217,1048
00193600,NEOSHO COUNTY COMMUNITY COLLEGE         ,KS,66720-2699,Public       ,25,114,139,838,1177,2015
00193700,OTTAWA UNIVERSITY                       ,KS,66067-3399,Private      ,45,288,333,1104,2625,3729
00193800,PRATT COMMUNITY COLLEGE                 ,KS,67124-8432,Public       ,33,75,108,685,792,1477
00193900,NEWMAN UNIVERSITY                       ,KS,67213-2084,Private      ,40,115,155,1449,1728,3177
00194000,SOUTHWESTERN COLLEGE                    ,KS,67156-2499,Private      ,21,113,134,836,1325,2161
00194300,UNIVERSITY OF ST MARY                   ,KS,66048-5023,Private      ,31,88,119,756,967,1723
00194500,STERLING COLLEGE                        ,KS,67579-1533,Private      ,25,17,42,973,186,1159
00194600,TABOR COLLEGE                           ,KS,67063-1799,Private      ,34,27,61,880,298,1178
00194800,UNIVERSITY OF KANSAS                    ,KS,66045-7535,Public       ,598,554,1152,19454,10527,29981
00194900,WASHBURN UNIVERSITY                     ,KS,66621-1110,Public       ,129,284,413,3754,4081,7835
00194901,WASHBURN INSTITUTE OF TECHNOLOGY        ,KS,66604-2199,Public       ,43,119,162,454,1037,1491
00195000,WICHITA STATE UNIVERSITY                ,KS,67208-0000,Public       ,328,628,956,8812,8521,17333
00460800,BARTON COUNTY COMMUNITY COLLEGE         ,KS,67530-9283,Public       ,48,333,381,1021,2588,3609
00526400,FLINT HILLS TECHNICAL COLLEGE           ,KS,66801-5999,Public       ,21,33,54,341,488,829
00526500,NORTH CENTRAL KANSAS TECH COLG          ,KS,67420-0000,Public       ,9,30,39,418,366,784
00526700,NORTHWEST KANSAS TECHNICAL SCHOOL       ,KS,67735-3441,Public       ,13,8,21,321,111,432
00549800,WICHITA AREA TECHNICAL COLLEGE          ,KS,67211-2099,Public       ,75,380,455,905,3086,3991
00549900,SALINA AREA TECHNICAL COLLEGE           ,KS,67401-8195,Public       ,10,35,45,214,286,500
00550000,MANHATTAN AREA TECHNICAL COLLEGE        ,KS,66503-2499,Public       ,32,68,100,447,791,1238
00675500,BROWN MACKIE COLLEGE (THE)              ,KS,67401-7307,Proprietary  ,49,184,233,449,1826,2275
00703200,MID AMERICA NAZARENE UNIVERSITY         ,KS,66062-1899,Private      ,31,143,174,1083,1372,2455
00822800,SEWARD CO COMM CO/AREA TECHNICAL SCHOOL ,KS,67905-0000,Public       ,33,44,77,583,478,1061
00824400,JOHNSON COUNTY COMMUNITY COLLEGE        ,KS,66210-1299,Public       ,389,926,1315,6309,7927,14236
00833200,MARINELLO SCHOOL OF BEAUTY              ,KS,66502-6082,Proprietary  ,6,20,26,45,99,144
00833201,MARINELLO SCHOOL OF BEAUTY - LAWRENCE   ,KS,66046-2743,Proprietary  ,6,10,16,38,88,126
00869423,RASMUSSEN COLLEGE - OVERLAND PARK       ,KS,66210-2786,Proprietary  ,1,32,33,21,206,227
00869424,RASMUSSEN COLLEGE - TOPEKA              ,KS,66606-2339,Proprietary  ,7,49,56,73,414,487
01025600,BENEDICTINE COLLEGE                     ,KS,66002-1499,Private      ,52,16,68,2536,197,2733
01043800,HASKELL INDIAN NATIONS UNIVERSITY       ,KS,66046-4800,Public       ,53,58,111,1115,732,1847
01050300,WICHITA TECHNICAL INSTITUTE             ,KS,67213-1927,Proprietary  ,39,152,191,215,1031,1246
01050302,WICHITA TECHNICAL INSTITUTE - WTI TOPEKA,KS,66609-1217,Proprietary  ,18,54,72,73,396,469
01050305,WICHITA TECHNICAL INSTITUTE - EAST CAMPU,KS,67208-4243,Proprietary  ,12,55,67,91,381,472
02090700,CLEVELAND CHIROPRACTIC COLLEGE          ,KS,66210-1613,Private      ,1,20,21,54,538,592
02134800,OLD TOWN BARBER AND BEAUTY COLLEGE      ,KS,67211-0000,Proprietary  ,1,23,24,44,165,209
02168900,KANSAS CITY COLLEGE & BIBLE SCHOOL      ,KS,66204-1975,Private      ,0,2,2,4,28,32
02257700,HAYS ACADEMY OF HAIR DESIGN             ,KS,67601-3685,Proprietary  ,4,5,9,65,66,131
02257702,HAYS ACADEMY OF HAIR DESIGN -           ,KS,67401-0000,Proprietary  ,5,10,15,36,75,111
02340700,LABARON HAIRDRESSING ACADEMY            ,KS,66204-0000,Proprietary  ,1,5,6,15,43,58
02590900,WRIGHT CAREER COLLEGE                   ,KS,66212-0000,Private      ,45,388,433,364,3024,3388
02599709,VATTEROTT COLLEGE - WICHITA             ,KS,67226-1304,Proprietary  ,16,71,87,96,525,621
02603100,XENON INTERNATIONAL ACADEMY             ,KS,67203-5428,Proprietary  ,12,36,48,143,271,414
02606300,PAUL MITCHELL THE SCHOOL WICHITA        ,KS,67226-2803,Proprietary  ,12,29,41,145,213,358
02611005,HERITAGE COLLEGE - WICHITA              ,KS,67210-1879,Proprietary  ,17,108,125,180,685,865
02613000,PINNACLE CAREER INSTITUTE               ,KS,66046-2703,Proprietary  ,9,28,37,66,301,367
03031300,XENON INTERNATIONAL ACADEMY IV          ,KS,66061-3765,Proprietary  ,0,0,0,15,35,50
03066200,BRYAN COLLEGE                           ,KS,66604-2496,Proprietary  ,4,34,38,47,252,299
03450300,MARINELLO SCHOOL OF BEAUTY              ,KS,66611-1101,Proprietary  ,7,28,35,44,146,190
03450301,MARINELLO SCHOOL OF BEAUTY - WICHITA    ,KS,67207-5148,Proprietary  ,6,24,30,44,154,198
03450302,MARINELLO SCHOOL OF BEAUTY - OVERLAND PA,KS,66212-5451,Proprietary  ,8,30,38,88,222,310
03529300,SIDNEY'S HAIRDRESSING COLLEGE           ,KS,67501-7094,Proprietary  ,3,5,8,25,36,61
04132900,Z HAIR ACADEMY                          ,KS,66046-4040,Proprietary  ,14,17,31,73,86,159
04162700,ERIC FISHER ACADEMY                     ,KS,67212-3376,Proprietary  ,23,25,48,179,224,403
04175700,ACADEMY OF AESTHETIC ARTS               ,KS,66203-3502,Proprietary  ,2,0,2,10,39,49
04179600,ENTOURAGE INSTITUTE OF BEAUTY AND ESTHET,KS,66215-3803,Proprietary  ,6,18,24,42,134,176
04205300,MITSU SATO HAIR ACADEMY                 ,KS,66212-1457,Proprietary  ,2,7,9,16,51,67
04209300,PAUL MITCHELL THE SCHOOL - OVERLAND PARK,KS,66212-4050,Proprietary  ,24,20,44,144,177,321
00203300,UNIVERSITY OF MAINE-PRESQUE ISLE        ,ME,04769-2888,Public       ,22,37,59,854,569,1423
00203600,BATES COLLEGE                           ,ME,04240-6028,Private      ,82,14,96,3042,128,3170
00203800,BOWDOIN COLLEGE                         ,ME,04011-8451,Private      ,110,8,118,3910,123,4033
00203900,COLBY COLLEGE                           ,ME,04901-8841,Private      ,89,14,103,2978,100,3078
00204000,UNIVERSITY OF MAINE-FARMINGTON          ,ME,04938-1990,Public       ,48,36,84,2502,575,3077
00204100,UNIVERSITY OF MAINE-FORT KENT           ,ME,04743-1292,Public       ,13,63,76,735,615,1350
00204300,HUSSON UNIVERSITY                       ,ME,04401-2999,Private      ,55,74,129,3041,1643,4684
00204400,MAINE MARITIME ACADEMY                  ,ME,04420-0001,Public       ,27,5,32,1302,182,1484
00205000,UNIVERSITY OF NEW ENGLAND               ,ME,04005-9599,Private      ,97,341,438,4752,5179,9931
00205100,SAINT JOSEPH'S COLLEGE                  ,ME,04084-5236,Private      ,33,155,188,1767,1602,3369
00205200,THOMAS COLLEGE                          ,ME,04901-5097,Private      ,27,18,45,1154,338,1492
00205300,UNIVERSITY OF MAINE                     ,ME,04469-0001,Public       ,245,149,394,13930,2970,16900
00205400,UNIVERSITY OF SOUTHERN MAINE            ,ME,04104-0000,Public       ,139,299,438,6405,5579,11984
00205500,UNIVERSITY OF MAINE-MACHIAS             ,ME,04654-1397,Public       ,13,26,39,553,389,942
00458615,KAPLAN UNIVERSITY - PORTLAND            ,ME,04106-2415,Proprietary  ,13,110,123,145,1039,1184
00458616,KAPLAN UNIVERSITY - LEWISTON            ,ME,04240-0000,Proprietary  ,12,100,112,107,973,1080
00458617,KAPLAN UNIVERSITY - AUGUSTA             ,ME,04330-8038,Proprietary  ,11,109,120,145,1002,1147
00520400,BEAL COLLEGE                            ,ME,04401-6896,Proprietary  ,9,75,84,270,718,988
00527600,CENTRAL MAINE COMMUNITY COLLEGE         ,ME,04210-6498,Public       ,64,190,254,1687,2197,3884
00527700,EASTERN MAINE COMMUNITY COLLEGE         ,ME,04401-4280,Public       ,42,157,199,1861,1918,3779
00552500,SOUTHERN MAINE COMMUNITY  COLLEGE       ,ME,04106-1698,Public       ,188,372,560,3947,4307,8254
00576000,NORTHERN MAINE COMMUNITY COLLEGE        ,ME,04769-2016,Public       ,19,35,54,494,584,1078
00630500,CENTRAL MAINE MEDICAL CENTER COLLEGE OF ,ME,04243-9986,Private      ,5,27,32,119,361,480
00676000,UNIVERSITY OF MAINE-AUGUSTA             ,ME,04330-9410,Public       ,65,415,480,1730,5150,6880
00685800,UNITY COLLEGE                           ,ME,04988-9502,Private      ,27,12,39,1005,122,1127
00903800,MR BERNARD'S SCH HAIR FASHION INC       ,ME,04243-1163,Proprietary  ,6,20,26,54,125,179
00923100,WASHINGTON COUNTY COMMUNITY COLLEGE     ,ME,04619-9704,Public       ,8,31,39,285,260,545
00945900,EMPIRE BEAUTY SCHOOL                    ,ME,04101-3348,Proprietary  ,88,220,308,642,1458,2100
00982600,KENNEBEC VALLEY  COMMUNITY  COLLEGE     ,ME,04937-1367,Public       ,37,134,171,975,1909,2884
01138500,COLLEGE OF THE ATLANTIC                 ,ME,04609-1105,Private      ,23,7,30,654,100,754
01167300,MAINE COLLEGE OF ART                    ,ME,04101-3987,Private      ,21,12,33,767,246,1013
02104400,SPA TECH INSTITUTE                      ,ME,04093-0000,Proprietary  ,22,92,114,187,480,667
02347100,NEW ENGLAND SCHOOL OF COMMUNICATIONS    ,ME,04401-0000,Private      ,2,7,9,434,118,552
02361300,LANDING SCHOOL OF BOATBUILDING & DESIGN ,ME,04046-1490,Private      ,0,3,3,36,55,91
03122900,YORK COUNTY COMMUNITY COLLEGE           ,ME,04090-0529,Public       ,49,114,163,811,1055,1866
03429300,SEACOAST CAREER SCHOOLS                 ,ME,04073-0000,Proprietary  ,12,90,102,96,460,556
03612300,BIRTHWISE MIDWIFERY SCHOOL              ,ME,04009-1110,Proprietary  ,1,3,4,10,83,93
04177400,CAPILO SCHOOL OF HAIR DESIGN            ,ME,04330-0000,Proprietary  ,6,19,25,76,136,212
04185100,NORTHEAST TECHNICAL INSTITUTE           ,ME,04074-0000,Proprietary  ,23,129,152,135,686,821
04188800,INSTITUTE FOR DOCTORAL STUDIES IN THE VI,ME,04102-0000,Private      ,0,14,14,2,64,66
04214100,COSMOTECH SCHOOL OF COSMETOLOGY         ,ME,04092-2878,Proprietary  ,3,16,19,37,57,94
00209300,ST JOHN'S COLLEGE                       ,NM,87505-4599,Private      ,13,13,26,366,180,546
00264900,SANTA FE UNIVERSITY OF ART AND DESIGN   ,NM,87505-7634,Proprietary  ,83,40,123,1286,379,1665
00265000,UNIVERSITY OF THE SOUTHWEST             ,NM,88240-9129,Private      ,11,105,116,339,1143,1482
00265100,EASTERN NEW MEXICO UNIV PORTALES        ,NM,88130-6000,Public       ,117,261,378,3374,3108,6482
00265101,EASTERN NEW MEXICO UNIV-ROSWELL CAM     ,NM,88202-0000,Public       ,62,169,231,1042,1523,2565
00265300,NEW MEXICO HIGHLANDS UNIVERSITY         ,NM,87701-4436,Public       ,63,188,251,2104,2706,4810
00265400,NEW MEXICO INST OF MINING & TECH        ,NM,87801-4796,Public       ,60,39,99,1451,540,1991
00265500,NEW MEXICO JUNIOR COLLEGE               ,NM,88240-9123,Public       ,66,127,193,813,916,1729
00265600,NEW MEXICO MILITARY INSTITUTE           ,NM,88201-5173,Public       ,30,10,40,544,72,616
00265700,NEW MEXICO STATE UNIVERSITY             ,NM,88003-8001,Public       ,422,516,938,11879,8094,19973
00265701,NEW MEXICO STATE UNIV-ALAMOGORDO        ,NM,88311-0000,Public       ,43,120,163,549,1243,1792
00265702,NEW MEXICO STATE UNIV.-DONA ANA CLG     ,NM,88003-0000,Public       ,159,364,523,3447,4462,7909
00265703,NEW MEXICO STATE UNIV-CARLSBAD          ,NM,88220-0000,Public       ,23,59,82,386,626,1012
00265704,NEW MEXICO STATE UNIV-GRANTS            ,NM,87020-0000,Public       ,11,45,56,249,534,783
00266000,SAN JUAN COLLEGE                        ,NM,87402-4699,Public       ,174,632,806,2201,5090,7291
00266300,THE UNIVERSITY OF NEW MEXICO            ,NM,87131-0001,Public       ,692,1252,1944,20002,19884,39886
00266400,WESTERN NEW MEXICO UNIVERSITY           ,NM,88061-5417,Public       ,70,181,251,1537,2300,3837
00405701,NATIONAL AMERICAN UNIVERSITY            ,NM,87110-0000,Proprietary  ,8,67,75,117,690,807
00474200,CENTRAL NEW MEXICO COMMUNITY COLLEGE    ,NM,87106-4096,Public       ,541,1853,2394,9456,17087,26543
00474300,CLOVIS COMMUNITY COLLEGE                ,NM,88101-8381,Public       ,51,211,262,735,1706,2441
00996200,LUNA COMMUNITY COLLEGE                  ,NM,87701-0000,Public       ,16,49,65,512,634,1146
01063200,DEWOLFF CLG HAIRSTYLING/COSMETOLOGY     ,NM,87112-4113,Proprietary  ,12,27,39,94,213,307
01300500,OLYMPIAN UNIVERSITY OF COSMETOLOGY      ,NM,88310-5051,Proprietary  ,53,184,237,358,1108,1466
02083900,NORTHERN NEW MEXICO COLLEGE             ,NM,87530-0000,Public       ,13,72,85,538,809,1347
02146400,INSTITUTE OF AMERICAN INDIAN ARTS       ,NM,87508-0000,Public       ,14,28,42,193,337,530
02218808,BROOKLINE COLLEGE - ALBUQUERQUE         ,NM,87105-1649,Proprietary  ,39,117,156,275,744,1019
02278100,SANTA FE COMMUNITY COLLEGE              ,NM,87507-0000,Public       ,71,238,309,1193,2575,3768
02293203,ATI CAREER TRAINING CENTER - ALBUQUERQUE,NM,87109-2016,Proprietary  ,5,33,38,30,154,184
02357600,NAVAJO TECHNICAL COLLEGE                ,NM,87313-0000,Public       ,43,135,178,645,1564,2209
02511000,SOUTHWESTERN INDIAN POLYTECH INST       ,NM,87184-0000,Public       ,37,54,91,388,567,955
02572003,COMPUTER CAREER CENTER - LAS CRUCES CAMP,NM,88011-8220,Proprietary  ,33,93,126,176,565,741
02622000,SOUTHWEST ACUPUNCTURE COLLEGE           ,NM,87505-0000,Proprietary  ,0,9,9,6,236,242
03076100,SOUTHWESTERN COLLEGE                    ,NM,87507-0000,Private      ,1,29,30,23,286,309
03206300,MESALANDS COMMUNITY COLLEGE             ,NM,88401-3352,Public       ,6,25,31,131,166,297
03430300,UNIVERSAL THERAPEUTIC MASSAGE INSTITUTE ,NM,87107-4403,Proprietary  ,9,31,40,54,182,236
03678300,PIMA MEDICAL INSTITUTE                  ,NM,87110-0000,Proprietary  ,32,132,164,456,925,1381
03944300,MASSAGE THERAPY TRAINING INSTITUTE      ,NM,88007-0000,Proprietary  ,5,17,22,47,118,165
04162400,TONI AND GUY HAIRDRESSING  ACADEMY      ,NM,87110-4404,Proprietary  ,16,46,62,117,263,380
04174500,AVEDA INSTITUTE OF NEW MEXICO (THE)     ,NM,87110-3640,Proprietary  ,23,52,75,159,358,517
04178500,VOGUE COLLEGE OF COSMETOLOGY            ,NM,87505-7636,Proprietary  ,6,22,28,51,128,179
00223400,ADRIAN COLLEGE                          ,MI,49221-2575,Private      ,75,45,120,3174,414,3588
00223500,ALBION COLLEGE                          ,MI,49224-1831,Private      ,47,14,61,2725,175,2900
00223600,ALMA COLLEGE                            ,MI,48801-1599,Private      ,59,17,76,2710,181,2891
00223700,ALPENA COMMUNITY COLLEGE                ,MI,49707-1495,Public       ,39,98,137,1068,1020,2088
00223800,ANDREWS UNIVERSITY                      ,MI,49104-0750,Private      ,52,81,133,1910,1415,3325
00223900,AQUINAS COLLEGE                         ,MI,49506-1799,Private      ,67,109,176,2925,829,3754
00224000,BAY DE NOC COMMUNITY COLLEGE            ,MI,49829-2524,Public       ,54,157,211,1170,1429,2599
00224100,CALVIN COLLEGE                          ,MI,49546-4388,Private      ,80,69,149,4746,576,5322
00224200,CALVIN THEOLOGICAL SEMINARY             ,MI,49546-4387,Private      ,0,13,13,16,172,188
00224300,CENTRAL MICHIGAN UNIVERSITY             ,MI,48859-0001,Public       ,529,887,1416,24389,11737,36126
00224600,CLEARY UNIVERSITY                       ,MI,48105-2659,Private      ,9,61,70,262,679,941
00224800,CRANBROOK ACADEMY OF ART                ,MI,48303-0000,Private      ,3,12,15,46,233,279
00224900,DAVENPORT UNIVERSITY                    ,MI,49503-0000,Private      ,169,1004,1173,4139,11340,15479
00225100,DELTA COLLEGE                           ,MI,48710-0001,Public       ,319,917,1236,6365,7888,14253
00225400,MICHIGAN STATE UNIVERSITY COLLEGE OF LAW,MI,48824-1300,Private      ,31,49,80,387,1873,2260
00225900,EASTERN MICHIGAN UNIVERSITY             ,MI,48197-2214,Public       ,547,990,1537,19310,14343,33653
00226000,FERRIS STATE UNIVERSITY                 ,MI,49307-2251,Public       ,373,493,866,15825,8262,24087
00226100,CHARLES STEWART MOTT COMMUNITY CLG      ,MI,48503-2089,Public       ,493,1156,1649,6339,9834,16173
00226200,KETTERING UNIVERSITY                    ,MI,48504-4898,Private      ,63,69,132,2351,551,2902
00226300,GLEN OAKS COMMUNITY COLLEGE             ,MI,49032-9784,Public       ,33,94,127,634,773,1407
00226400,GOGEBIC COMMUNITY COLLEGE               ,MI,49938-1365,Public       ,16,38,54,729,519,1248
00226500,GRACE BIBLE COLLEGE                     ,MI,49509-1998,Private      ,20,142,162,553,789,1342
00226600,CORNERSTONE UNIVERSITY                  ,MI,49525-5897,Private      ,46,242,288,2307,2061,4368
00226700,GRAND RAPIDS COMMUNITY COLLEGE          ,MI,49503-3295,Public       ,604,1249,1853,11836,11386,23222
00226800,GRAND VALLEY STATE UNIVERSITY           ,MI,49401-9403,Public       ,550,513,1063,27937,9068,37005
00226900,GREAT LAKES CHRISTIAN COLLEGE           ,MI,48917-1299,Private      ,6,18,24,199,205,404
00227000,HENRY FORD COMMUNITY COLLEGE            ,MI,48128-1495,Public       ,724,1736,2460,10967,15709,26676
00227300,HOPE COLLEGE                            ,MI,49423-3607,Private      ,79,17,96,5037,268,5305
00227400,JACKSON COMMUNITY COLLEGE               ,MI,49201-8399,Public       ,193,514,707,3812,4604,8416
00227500,KALAMAZOO COLLEGE                       ,MI,49006-3295,Private      ,70,41,111,2495,366,2861
00227600,KELLOGG COMMUNITY COLLEGE               ,MI,49017-3397,Public       ,153,565,718,3028,5396,8424
00227700,LAKE MICHIGAN COLLEGE                   ,MI,49022-1899,Public       ,115,341,456,2097,2991,5088
00227800,LANSING COMMUNITY COLLEGE               ,MI,48933-1293,Public       ,522,1168,1690,10191,11141,21332
00227900,LAWRENCE TECHNOLOGICAL UNIVERSITY       ,MI,48075-1058,Private      ,75,135,210,2413,1491,3904
00228200,MADONNA UNIVERSITY                      ,MI,48150-1173,Private      ,64,222,286,1863,3327,5190
00228400,MARYGROVE COLLEGE                       ,MI,48221-2599,Private      ,56,332,388,1360,3361,4721
00228800,ROCHESTER COLLEGE                       ,MI,48307-2764,Private      ,30,66,96,962,894,1856
00229000,MICHIGAN STATE UNIVERSITY               ,MI,48824-1113,Public       ,979,908,1887,41942,15319,57261
00229200,MICHIGAN TECHNOLOGICAL UNIV             ,MI,49931-1295,Public       ,111,61,172,6680,1094,7774
00229300,LAKE SUPERIOR STATE UNIVERSITY          ,MI,49783-1691,Public       ,68,83,151,2688,928,3616
00229400,MONROE COUNTY COMMUNITY CLG             ,MI,48161-9746,Public       ,133,284,417,1904,2354,4258
00229500,MONTCALM COMMUNITY COLLEGE              ,MI,48885-9723,Public       ,48,162,210,1005,1466,2471
00229700,MUSKEGON COMMUNITY COLLEGE              ,MI,49442-1432,Public       ,160,396,556,3376,3287,6663
00229900,NORTH CENTRAL MICHIGAN COLLEGE          ,MI,49770-8740,Public       ,63,197,260,1214,1423,2637
00230100,NORTHERN MICHIGAN UNIVERSITY            ,MI,49855-5316,Public       ,189,164,353,8779,2793,11572
00230200,NORTHWESTERN MICHIGAN COLLEGE           ,MI,49686-3061,Public       ,143,288,431,2799,2873,5672
00230301,OAKLAND COMMUNITY COLLEGE - ORCHARD RIDG,MI,48334-4579,Public       ,228,609,837,4188,6000,10188
00230302,OAKLAND COMMUNITY COLLEGE - ROYAL OAK CA,MI,48067-3898,Public       ,322,842,1164,5257,8744,14001
00230303,OAKLAND COMMUNITY COLLEGE - SOUTHFIELD C,MI,48075-4793,Public       ,282,1049,1331,4474,10719,15193
00230304,OAKLAND COMMUNITY COLLEGE - AUBURN HILLS,MI,48323-2845,Public       ,329,702,1031,5546,6796,12342
00230305,OAKLAND COMMUNITY COLLEGE - HIGHLAND LAK,MI,48327-4187,Public       ,178,403,581,2920,4014,6934
00230700,OAKLAND UNIVERSITY                      ,MI,48309-4401,Public       ,506,731,1237,18078,11197,29275
00230800,OLIVET COLLEGE                          ,MI,49076-9902,Private      ,26,16,42,1662,297,1959
00231000,ST. CLAIR COUNTY COMMUNITY COLLEGE      ,MI,48061-0000,Public       ,106,261,367,2273,2389,4662
00231100,KUYPER COLLEGE                          ,MI,49525-9749,Private      ,8,21,29,390,193,583
00231300,SACRED HEART MAJOR SEMINARY             ,MI,48206-1799,Private      ,1,13,14,43,198,241
00231400,SAGINAW VALLEY STATE UNIV               ,MI,48710-0001,Public       ,222,343,565,10692,4399,15091
00231500,SCHOOLCRAFT COLLEGE                     ,MI,48152-2696,Public       ,494,1097,1591,7671,10597,18268
00231600,SIENA HEIGHTS UNIVERSITY                ,MI,49221-1796,Private      ,48,196,244,1974,2347,4321
00231700,SOUTHWESTERN MICHIGAN COLLEGE           ,MI,49047-9793,Public       ,80,181,261,2430,1905,4335
00231800,SPRING ARBOR UNIVERSITY                 ,MI,49283-9984,Private      ,44,231,275,2466,3263,5729
00232200,FINLANDIA UNIVERSITY                    ,MI,49930-1882,Private      ,17,19,36,610,236,846
00232300,UNIVERSITY OF DETROIT MERCY             ,MI,48221-3038,Private      ,123,337,460,3669,4184,7853
00232303,UNIV OF DETROIT MERCY - LAW SCHOOL      ,MI,48226-0000,Private      ,2,26,28,67,696,763
00232330,UNIV OF DETROIT MERCY - DENTAL SCHOOL   ,MI,48208-2576,Private      ,10,38,48,183,714,897
00232500,UNIVERSITY OF MICHIGAN - ANN ARBOR      ,MI,48109-1316,Public       ,1110,661,1771,38619,13119,51738
00232501,UNIVERSITY OF MICHIGAN-MEDICAL SCH      ,MI,48109-0000,Public       ,19,21,40,322,1076,1398
00232503,UNIVERSITY OF MICHIGAN LAW SCHOOL       ,MI,48109-0000,Public       ,9,38,47,135,2331,2466
00232600,UNIVERSITY OF MICHIGAN-DEARBORN         ,MI,48128-2406,Public       ,258,457,715,8260,6396,14656
00232700,UNIVERSITY OF MICHIGAN-FLINT            ,MI,48502-1950,Public       ,199,491,690,5737,7218,12955
00232800,WASHTENAW COMMUNITY COLLEGE             ,MI,48106-0000,Public       ,360,963,1323,5818,8187,14005
00232900,WAYNE STATE UNIVERSITY                  ,MI,48202-0000,Public       ,658,1476,2134,20349,22336,42685
00232901,WAYNE STATE UNIV SCH OF MEDICINE        ,MI,48201-3359,Public       ,46,73,119,917,2202,3119
00232902,WAYNE STATE UNIVERSITY - LAW SCHOOL     ,MI,48202-3424,Public       ,11,55,66,237,1061,1298
00233000,WESTERN MICHIGAN UNIVERSITY             ,MI,49008-3899,Public       ,559,624,1183,23001,11016,34017
00233100,WESTERN THEOLOGICAL SEMINARY            ,MI,49423-0000,Private      ,0,4,4,6,180,186
00384256,CONCORDIA UNIVERSITY - WISCONSIN - ANN A,MI,48105-2750,Private      ,32,42,74,1136,387,1523
00407100,WALSH COLLEGE OF ACCT & BUS ADMN        ,MI,48007-7006,Private      ,20,277,297,390,2617,3007
00407200,NORTHWOOD UNIVERSITY                    ,MI,48640-2398,Private      ,63,184,247,2165,1950,4115
00467300,BAKER COLLEGE - FLINT                   ,MI,48507-5508,Private      ,172,552,724,2822,6736,9558
00467301,BAKER COLLEGE OF CADILLAC               ,MI,49601-0000,Private      ,40,142,182,631,1670,2301
00467302,BAKER COLLEGE OF CLINTON TOWNSHIP       ,MI,48035-0000,Private      ,98,426,524,1671,4421,6092
00467303,BAKER COLLEGE OF MUSKEGON               ,MI,49442-0000,Private      ,105,323,428,2616,3504,6120
00467304,BAKER COLLEGE OF OWOSSO                 ,MI,48867-0000,Private      ,68,150,218,1811,2080,3891
00467305,BAKER COLLEGE OF AUBURN HILLS           ,MI,48326-0000,Private      ,83,310,393,1165,3414,4579
00467306,BAKER COLLEGE OF PORT HURON             ,MI,48060-0000,Private      ,25,80,105,538,1019,1557
00467309,BAKER COLLEGE OF JACKSON                ,MI,49202-0000,Private      ,63,243,306,851,2565,3416
00467311,BAKER COLLEGE-CASS CITY                 ,MI,48726-0000,Private      ,9,34,43,181,345,526
00467313,BAKER COLLEGE - GRADUATE ON-LINE        ,MI,48507-0000,Private      ,40,516,556,529,6057,6586
00467317,BAKER COLLEGE-ALLEN PARK                ,MI,48101-0000,Private      ,82,400,482,1376,4711,6087
00467330,BAKER COLLEGE - CULINARY INSTITUTE OF MI,MI,49440-1246,Private      ,18,26,44,18,26,44
00467343,BAKER COLLEGE - CULINARY INSTITUTE OF MI,MI,48060-0000,Private      ,10,17,27,10,17,27
00467348,BAKER COLLEGE - AUTO DIESEL INSTITUTE OF,MI,48867-0000,Private      ,18,27,45,18,27,45
00469200,DORSEY SCHOOL OF BUSINESS               ,MI,48195-2334,Proprietary  ,17,70,87,73,338,411
00469201,DORSEY SCHOOL OF BUSINESS               ,MI,48184-0000,Proprietary  ,20,72,92,73,334,407
00469202,DORSEY SCHOOL OF BUSINESS               ,MI,48071-0000,Proprietary  ,27,67,94,143,435,578
00469204,DORSEY SCHOOL OF BUSINESS               ,MI,48066-0000,Proprietary  ,43,141,184,259,801,1060
00469205,DORSEY BUSINESS SCHOOL - FARMINGTON HILL,MI,48334-3385,Proprietary  ,6,41,47,56,235,291
00469206,DORSEY BUSINESS SCHOOL - ROSEVILLE CULIN,MI,48066-4555,Proprietary  ,11,62,73,117,424,541
00469207,DORSEY BUSINESS SCHOOL - WATERFORD/PONTI,MI,48341-1037,Proprietary  ,22,61,83,114,416,530
00469208,DORSEY BUSINESS SCHOOL - SAGINAW CAMPUS ,MI,48603-5201,Proprietary  ,12,95,107,107,474,581
00469209,DORSEY SCHOOL OF BUSINESS - LANSING     ,MI,48911-5744,Proprietary  ,14,58,72,81,382,463
00469210,DORSEY SCHOOL OF BUSINESS - DEARBORN    ,MI,48228-3858,Proprietary  ,27,158,185,224,877,1101
00491003,KAPLAN CAREER INSTITUTE - DEARBORN      ,MI,48228-0000,Proprietary  ,0,0,0,61,290,351
00676800,MID MICHIGAN COMMUNITY COLLEGE          ,MI,48625-9447,Public       ,141,291,432,2459,2751,5210
00677100,COLLEGE FOR CREATIVE STUDIES            ,MI,48202-4034,Private      ,94,111,205,2032,966,2998
00694900,KALAMAZOO VALLEY COMMUNITY COLLEGE      ,MI,49003-4070,Public       ,326,790,1116,6040,6896,12936
00717100,KIRTLAND COMMUNITY COLLEGE              ,MI,48653-0000,Public       ,61,180,241,956,1696,2652
00732991,ITT TECHNICAL INSTITUTE                 ,MI,49519-1851,Proprietary  ,66,399,465,650,2752,3402
00761700,CARNEGIE INSTITUTE                      ,MI,48083-1159,Proprietary  ,8,30,38,77,391,468
00795000,WEST SHORE COMMUNITY COLLEGE            ,MI,49454-0000,Public       ,42,100,142,625,896,1521
00817800,EMPIRE BEAUTY SCHOOL                    ,MI,49525-2440,Proprietary  ,103,230,333,753,1592,2345
00890600,MACOMB COMMUNITY COLLEGE                ,MI,48088-3896,Public       ,922,1759,2681,13988,15608,29596
00894600,PORT HURON COSMETOLOGY COLLEGE          ,MI,48329-1618,Proprietary  ,6,13,19,27,59,86
00923000,WAYNE COUNTY COMMUNITY CLG-DISTRICT     ,MI,48226-3010,Public       ,670,2712,3382,9075,25837,34912
00982800,EVEREST INSTITUTE                       ,MI,48033-4400,Proprietary  ,37,212,249,274,1412,1686
00982801,EVEREST INSTITUTE- DEARBORN             ,MI,48124-1927,Proprietary  ,35,146,181,301,1062,1363
00982803,EVEREST INSTITUTE - DETROIT             ,MI,48207-4291,Proprietary  ,50,183,233,340,1198,1538
01047000,KALAMAZOO BEAUTY ACADEMY                ,MI,49002-5220,Proprietary  ,7,11,18,36,71,107
01082700,DAVID PRESSLEY PROF SCH OF COSMTLGY     ,MI,48067-3219,Proprietary  ,17,61,78,159,280,439
01109800,FLINT INSTITUTE OF BARBERING            ,MI,48504-4395,Proprietary  ,5,34,39,50,215,265
01229100,WRIGHT BEAUTY ACADEMY                   ,MI,49015-2696,Proprietary  ,4,16,20,32,130,162
01262700,THOMAS M. COOLEY LAW SCHOOL             ,MI,48901-1586,Private      ,0,111,111,26,2579,2605
01321800,M J MURPHY BTY CLG MT PLEASANT          ,MI,48858-2502,Proprietary  ,7,16,23,63,98,161
02060300,MICHIGAN INSTITUTE OF AERONAUTICS       ,MI,48188-2533,Proprietary  ,44,69,113,582,681,1263
02099700,ROSS MEDICAL EDUCATION CENTER           ,MI,48532-0000,Proprietary  ,83,276,359,459,1381,1840
02099701,ROSS MEDICAL EDUCATION CENTER-SAGINAW   ,MI,48603-5227,Proprietary  ,2,26,28,64,174,238
02099702,ROSS MEDICAL EDUCATION CENTER-PORT HURON,MI,48060-1958,Proprietary  ,0,10,10,26,72,98
02099703,ROSS MEDICAL EDUCATION CENTER-ROOSEVELT ,MI,49441-4156,Proprietary  ,1,2,3,11,30,41
02100400,EVEREST INSTITUTE                       ,MI,49525-2301,Proprietary  ,13,49,62,187,764,951
02100401,EVEREST INSTITUTE - KALAMAZOO           ,MI,49009-3307,Proprietary  ,11,52,63,118,417,535
02125600,MICHIGAN COLLEGE OF BEAUTY              ,MI,48083-0000,Proprietary  ,23,51,74,200,356,556
02158600,MR BELA'S SCHOOL OF COSMETOLOGY         ,MI,48092-4637,Proprietary  ,13,20,33,59,150,209
02160303,INTERNATIONAL ACADEMY OF DESIGN AND TECH,MI,48083-2160,Proprietary  ,7,24,31,164,282,446
02180100,ROSS MEDICAL EDUCATION CENTER           ,MI,48092-0000,Proprietary  ,37,150,187,274,923,1197
02180105,ROSS MEDICAL EDUCATION CENTER-REDFORD   ,MI,48239-1260,Proprietary  ,2,18,20,33,141,174
02198900,MICHIGAN SCHOOL OF PROFESSIONAL PSYCHOLO,MI,48334-4512,Private      ,3,24,27,28,294,322
02209200,TAYLORTOWN SCHOOL OF BEAUTY             ,MI,48180-0000,Proprietary  ,7,51,58,121,304,425
02237800,SPECS HOWARD SCHOOL OF MEDIA ARTS       ,MI,48075-0000,Proprietary  ,89,107,196,673,912,1585
02285700,BAYSHIRE BEAUTY ACADEMY                 ,MI,48708-5614,Proprietary  ,5,21,26,45,160,205
02324500,MICHIGAN COLLEGE OF BEAUTY              ,MI,48161-3901,Proprietary  ,8,30,38,117,200,317
02339700,ROSS MEDICAL EDUCATION CENTER           ,MI,48116-0000,Proprietary  ,53,178,231,285,1120,1405
02339701,ROSS MEDICAL EDUCATION CENTER-ANN ARBOR ,MI,48108-1411,Proprietary  ,2,17,19,34,131,165
02339703,ROSS MEDICAL EDUCATION CENTER - DAVISON ,MI,48423-1751,Proprietary  ,2,6,8,17,74,91
02361500,MICHIGAN BARBER COLLEGE                 ,MI,48204-2244,Private      ,15,85,100,127,533,660
02363800,YESHIVA GEDOLAH OF GREATER DETROIT      ,MI,48237-0000,Private      ,9,1,10,27,9,36
02491000,WEST MI COLG OF BARBERING & BEAUTY      ,MI,49008-0000,Proprietary  ,6,18,24,44,124,168
02531806,PAUL MITCHELL THE SCHOOL -MICHIGAN      ,MI,48313-0000,Proprietary  ,24,42,66,216,290,506
02533600,ROSS MEDICAL EDUCATION CENTER           ,MI,48917-2108,Proprietary  ,50,156,206,264,822,1086
02533601,ROSS MEDICAL EDUCATION CENTER - GRAND RA,MI,49546-2430,Proprietary  ,10,28,38,89,255,344
02588200,DOUGLAS J AVEDA INSTITUTE               ,MI,48823-4351,Proprietary  ,90,113,203,673,742,1415
02588201,DOUGLAS J AVEDA INSTITUTE - ANN ARBOR   ,MI,48104-2211,Proprietary  ,19,20,39,175,189,364
02595700,HILLSDALE BEAUTY COLLEGE                ,MI,49242-0000,Proprietary  ,3,12,15,83,38,121
02618400,MICHIGAN CAREER & TECHNICAL INST        ,MI,49080-9254,Public       ,59,23,82,407,136,543
03005700,DETROIT BUSINESS INST. DOWNRIVER        ,MI,48193-6761,Proprietary  ,6,29,35,36,210,246
03066600,BAY MILLS COMMUNITY COLLEGE             ,MI,49715-9750,Public       ,19,61,80,229,458,687
03075200,TWIN CITY BEAUTY COLLEGE                ,MI,49085-3305,Proprietary  ,16,31,47,130,190,320
03075201,TWIN CITY BEAUTY COLLEGE - TRAVERSE CITY,MI,49686-5119,Proprietary  ,0,5,5,31,56,87
03090000,SHARP'S ACADEMY OF HAIRSTYLING          ,MI,48439-1838,Proprietary  ,2,8,10,20,50,70
03109700,HOUGHTON LAKE INST OF COSMETOLOGY       ,MI,48629-0669,Proprietary  ,4,13,17,26,81,107
03110300,THE SCHOOL OF CREATIVE HAIR DESIGN      ,MI,49036-1139,Proprietary  ,6,19,25,36,80,116
03124000,NORTHWESTERN TECHNOLOGICAL INST         ,MI,48075-2412,Proprietary  ,13,91,104,120,467,587
03284300,MICHIGAN JEWISH INSTITUTE               ,MI,48237-0000,Private      ,428,519,947,1383,1194,2577
03490300,PAUL MITCHELL THE SCHOOL ESCANABA       ,MI,49829-0000,Proprietary  ,2,7,9,60,77,137
03588300,IRENE'S MYOMASSOLOGY INSTITUTE          ,MI,48033-2404,Proprietary  ,13,46,59,101,380,481
03704300,BLUE WATER COLLEGE OF COSMETOLOGY       ,MI,48040-2093,Proprietary  ,1,9,10,21,49,70
03772300,SAGINAW CHIPPEWA TRIBAL COLLEGE         ,MI,48858-0000,Public       ,2,13,15,35,132,167
03815300,IN SESSION-ARTS OF COSMETOLOGY BEAU     ,MI,48609-0000,Proprietary  ,5,25,30,61,143,204
03907300,PAUL MITCHELL THE SCHOOL GREAT LAKES    ,MI,48060-0000,Proprietary  ,8,27,35,76,101,177
03915300,CAREER QUEST LEARNING CENTER            ,MI,48910-4732,Proprietary  ,16,146,162,142,675,817
03915301,CAREER QUEST LEARNING CENTER - JACKSON  ,MI,49201-2475,Proprietary  ,8,91,99,79,497,576
03915302,CAREER QUEST LEARNING CENTER - KALAMAZOO,MI,49002-1711,Proprietary  ,3,14,17,51,230,281
03968300,LAKEWOOD SCHOOL OF THERAPEUTIC MASSAGE  ,MI,48060-0000,Proprietary  ,2,13,15,25,55,80
03976500,ANN ARBOR INSTITUTE OF MASSAGE THERAPY  ,MI,48103-0000,Proprietary  ,3,19,22,61,152,213
04002400,ECUMENICAL THEOLOGICAL SEMINARY         ,MI,48201-3035,Private      ,1,19,20,10,155,165
04006300,NUVO COLLEGE OF COSMETOLOGY             ,MI,49441-3822,Proprietary  ,2,14,16,36,67,103
04014300,P&A SCHOLARS BEAUTY SCHOOL              ,MI,48204-0000,Proprietary  ,24,93,117,214,640,854
04094300,ROBERT B. MILLER COLLEGE (THE)          ,MI,49017-3306,Private      ,6,33,39,106,492,598
04121100,GALLERY COLLEGE OF BEAUTY (THE)         ,MI,48036-3591,Proprietary  ,8,39,47,60,183,243
04136300,FOCUS:  HOPE INFORMATION TECHNOLOGIES CE,MI,48238-2949,Private      ,7,61,68,123,442,565
04138400,SCHOOL OF DESIGNING ARTS                ,MI,49015-2853,Proprietary  ,7,18,25,71,134,205
04140900,INTERNATIONAL COSMETOLOGY ACADEMY       ,MI,49508-1308,Proprietary  ,3,12,15,58,140,198
04141100,FRENCH ACADEMY OF COSMETOLOGY           ,MI,49456-3207,Proprietary  ,5,7,12,44,57,101
04158400,L'ESPRIT ACADEMY                        ,MI,48150-0000,Proprietary  ,14,35,49,122,228,350
04159300,MARKETTI ACADEMY OF COSMETOLOGY         ,MI,48329-3506,Proprietary  ,10,26,36,56,88,144
04163300,COMPASS COLLEGE OF CINEMATIC ARTS       ,MI,49503-4227,Private      ,9,8,17,166,90,256
04164700,KEWEENAW BAY OJIBWA COMMUNITY COLLEGE   ,MI,49908-0000,Public       ,3,7,10,23,87,110
04169300,SCHOLARS COSMETOLOGY UNIVERSITY         ,MI,48108-0000,Proprietary  ,1,1,2,13,53,66
04183300,ABCOTT INSTITUTE                        ,MI,48075-5227,Proprietary  ,7,49,56,51,244,295
04184700,PROTEGE ACADEMY                         ,MI,48823-8660,Proprietary  ,6,22,28,80,172,252
04207000,SCHOOL OF MISSIONARY AVIATION TECHNOLOGY,MI,48846-7412,Private      ,0,3,3,31,40,71
04211200,BRIGHTON INSTITUTE OF COSMETOLOGY       ,MI,48116-8360,Proprietary  ,2,8,10,37,48,85
04222300,MANTHANO CHRISTIAN COLLEGE              ,MI,48185-1919,Private      ,0,4,4,10,53,63
04230200,EXCEL ACADEMIES OF COSMETOLOGY          ,MI,48085-1300,Proprietary  ,1,11,12,30,44,74
04230400,EXCEL ACADEMIES OF COSMETOLOGY          ,MI,48912-4686,Proprietary  ,2,16,18,35,93,128
04230500,EXCEL ACADEMIES OF COSMETOLOGY          ,MI,49512-1781,Proprietary  ,4,11,15,34,38,72
04231800,PRINCESS BEAUTY SCHOOL                  ,MI,48127-2999,Proprietary  ,9,22,31,11,27,38
00233200,ANOKA-RAMSEY CC-CAMBRIDGE/COONRAPID     ,MN,55433-3499,Public       ,274,519,793,3983,4942,8925
00233400,AUGSBURG COLLEGE                        ,MN,55454-1351,Private      ,80,172,252,3291,2427,5718
00233500,RIVERLAND COMMUNITY COLLEGE             ,MN,55912-1473,Public       ,57,183,240,1018,1670,2688
00233600,BEMIDJI STATE UNIVERSITY                ,MN,56601-2699,Public       ,91,226,317,3927,2270,6197
00233700,BETHANY LUTHERAN COLLEGE INC            ,MN,56001-6163,Private      ,3,9,12,665,88,753
00233900,CENTRAL LAKES COLG-BRAINERD/STAPLES     ,MN,56401-3900,Public       ,47,195,242,1349,1829,3178
00234000,CARLETON COLLEGE                        ,MN,55057-4001,Private      ,58,7,65,3483,105,3588
00234100,COLLEGE OF ST BENEDICT                  ,MN,56374-2099,Private      ,23,4,27,2196,82,2278
00234200,ST. CATHERINE UNIVERSITY                ,MN,55105-1789,Private      ,62,251,313,2954,3601,6555
00234300,COLLEGE OF ST SCHOLASTICA               ,MN,55811-4199,Private      ,59,251,310,2574,2610,5184
00234500,UNIVERSITY OF ST THOMAS                 ,MN,55105-1096,Private      ,114,277,391,6977,3564,10541
00234600,CONCORDIA COLLEGE-MOORHEAD              ,MN,56562-0001,Private      ,32,18,50,2876,214,3090
00234700,"CONCORDIA UNIVERSITY, ST PAUL, MN       ",MN,55104-5494,Private      ,72,475,547,1853,3828,5681
00235000,VERMILION COMMUNITY COLLEGE             ,MN,55731-1996,Public       ,15,13,28,489,164,653
00235300,GUSTAVUS ADOLPHUS COLLEGE               ,MN,56082-1498,Private      ,72,6,78,3467,116,3583
00235400,HAMLINE UNIVERSITY                      ,MN,55104-1284,Private      ,95,218,313,3484,2677,6161
00235500,HIBBING COMMUNITY COLLEGE               ,MN,55746-3300,Public       ,22,74,96,641,912,1553
00235600,ITASCA COMMUNITY COLLEGE                ,MN,55744-3397,Public       ,30,78,108,837,614,1451
00235700,LUTHER SEMINARY                         ,MN,55108-0000,Private      ,1,10,11,4,340,344
00235800,MACALESTER COLLEGE                      ,MN,55105-1899,Private      ,79,14,93,3638,212,3850
00236000,"MINNESOTA STATE UNIVERSITY, MANKATO     ",MN,56002-0000,Public       ,268,347,615,12431,4661,17092
00236100,MARTIN LUTHER COLLEGE                   ,MN,56073-3965,Private      ,8,7,15,710,65,775
00236200,MINNEAPOLIS COMM AND TECH COLLEGE       ,MN,55403-1779,Public       ,354,1247,1601,4246,10034,14280
00236500,MINNEAPOLIS COLLEGE OF ART & DESIGN     ,MN,55404-4343,Private      ,40,68,108,937,520,1457
00236600,CROSSROADS COLLEGE                      ,MN,55902-2382,Private      ,2,9,11,94,84,178
00236700,MINNESOTA STATE UNIVERSITY MOORHEAD     ,MN,56563-0001,Public       ,120,208,328,5031,2587,7618
00236900,NORTH CENTRAL UNIVERSITY                ,MN,55404-1391,Private      ,35,49,84,1270,488,1758
00237000,NORTH HENNEPIN COMMUNITY COLLEGE        ,MN,55445-2299,Public       ,241,656,897,3181,5919,9100
00237100,UNIVERSITY OF NORTHWESTERN- ST PAUL     ,MN,55113-1598,Private      ,60,88,148,2302,898,3200
00237300,ROCHESTER COMMUNITY/TECH COLLEGE        ,MN,55904-4999,Public       ,166,458,624,2800,3882,6682
00237500,SOUTHWEST MINNESOTA STATE UNIVERSITY    ,MN,56258-1598,Public       ,40,63,103,2117,1149,3266
00237700,ST CLOUD STATE UNIVERSITY               ,MN,56301-4498,Public       ,289,427,716,10046,5139,15185
00237900,SAINT JOHNS UNIVERSITY                  ,MN,56321-0000,Private      ,21,12,33,1969,112,2081
00238000,SAINT MARY'S UNIVERSITY                 ,MN,55987-1399,Private      ,46,392,438,1780,3706,5486
00238200,ST OLAF COLLEGE                         ,MN,55057-1098,Private      ,75,11,86,3781,130,3911
00238300,CROWN COLLEGE                           ,MN,55375-9001,Private      ,22,78,100,883,875,1758
00238500,NORTHLAND COMMUNITY & TECHNICAL CLG     ,MN,56701-2598,Public       ,73,168,241,1397,1804,3201
00238600,UNITED THEOLGCL SEMINRY TWIN CITIES     ,MN,55112-0000,Private      ,0,4,4,2,117,119
00238800,"UNIVERSITY OF MINNESOTA, DULUTH         ",MN,55812-2496,Public       ,206,160,366,10409,2384,12793
00238900,"UNIVERSITY OF MINNESOTA, MORRIS         ",MN,56267-2113,Public       ,44,22,66,2312,319,2631
00239100,WILLIAM MITCHELL COLLEGE OF LAW         ,MN,55105-0000,Private      ,0,50,50,3,953,956
00239300,MINNESOTA STATE COLLEGE-SE TECH         ,MN,55987-0409,Public       ,50,171,221,792,1462,2254
00239400,WINONA STATE UNIVERSITY                 ,MN,55987-5838,Public       ,133,132,265,7552,1902,9454
00396900,UNIVERSITY OF MINNESOTA-TWIN CITIES     ,MN,55455-0422,Public       ,783,888,1671,34739,17056,51795
00400900,MESABI RANGE CMNTY & TECH COLLEGE       ,MN,55792-0000,Public       ,29,55,84,516,633,1149
00405708,NATIONAL AMERICAN UNIVERSITY            ,MN,55113-0000,Proprietary  ,1,33,34,17,263,280
00405715,NATIONAL AMERICAN UNIVERSITY - BLOOMINGT,MN,55425-5550,Proprietary  ,0,42,42,28,383,411
00406900,UNIVERSITY OF MINNESOTA-CROOKSTON       ,MN,56716-5001,Public       ,20,110,130,1113,1083,2196
00438600,VETERAN'S MEDICAL CTR- SCH RAD TECH     ,MN,55417-2399,Public       ,0,1,1,4,17,21
00464100,DUNWOODY COLLEGE OF TECHNOLOGY          ,MN,55403-1192,Private      ,63,204,267,682,1307,1989
00464200,GLOBE UNIVERSITY                        ,MN,55125-5408,Proprietary  ,89,319,408,918,2923,3841
00464500,MINNEAPOLIS BUSINESS COLLEGE            ,MN,55113-4036,Proprietary  ,2,21,23,294,183,477
00464600,MINNESOTA SCHOOL OF BUSINESS            ,MN,55423-0000,Proprietary  ,59,264,323,835,2618,3453
00525200,RIDGEWATER COLLEGE                      ,MN,56201-2098,Public       ,101,257,358,1919,1834,3753
00526300,MINNESOTA WEST CMNTY & TECH COLG        ,MN,56241-1096,Public       ,46,144,190,840,1362,2202
00553300,"SAINT PAUL COLLEGE, COMMUNITY/TECHNICAL ",MN,55102-1800,Public       ,286,997,1283,3792,7620,11412
00553400,SAINT CLOUD TECHNICAL COLLEGE AND COMMUN,MN,56303-1240,Public       ,189,334,523,3076,2942,6018
00553500,PINE TECHNICAL COLLEGE                  ,MN,55063-2198,Public       ,10,82,92,241,822,1063
00553700,SOUTH CENTRAL COLLEGE                   ,MN,56003-0000,Public       ,91,201,292,1719,2112,3831
00554100,MINNESOTA STATE COMMUNITY AND TECHNICAL ,MN,56573-1405,Public       ,147,306,453,2256,3215,5471
00554400,ALEXANDRIA TECHNICAL COLLEGE            ,MN,56308-3799,Public       ,49,103,152,1305,880,2185
00575700,LAKE SUPERIOR COLLEGE                   ,MN,55811-3399,Public       ,119,351,470,2144,3023,5167
00575900,NORTHWEST TECHNICAL COLLEGE - BEMIDJI   ,MN,56601-4907,Public       ,24,101,125,416,897,1313
00677500,RAINY RIVER COMMUNITY COLLEGE           ,MN,56649-2187,Public       ,8,13,21,148,115,263
00735000,ANOKA-HENNEPIN TECHNICAL COLLEGE        ,MN,55303-1590,Public       ,81,337,418,1021,2558,3579
00735100,BROWN COLLEGE                           ,MN,55120-1004,Proprietary  ,10,34,44,162,512,674
00795400,NORMANDALE COMMUNITY COLLEGE            ,MN,55431-4399,Public       ,370,676,1046,4872,5577,10449
00826700,NORTHWEST TECHNICAL INSTITUTE           ,MN,55121-5001,Proprietary  ,0,0,0,6,16,22
00869400,RASMUSSEN COLLEGE - ST. CLOUD           ,MN,56301-3713,Proprietary  ,25,131,156,296,1372,1668
00869401,RASMUSSEN COLLEGE - BROOKLYN PARK       ,MN,55445-1512,Proprietary  ,25,135,160,234,1270,1504
00869406,RASMUSSEN COLLEGE - EAGAN               ,MN,55122-1346,Proprietary  ,24,135,159,174,1123,1297
00869407,RASMUSSEN COLLEGE - BLOOMINGTON         ,MN,55435-5444,Proprietary  ,24,154,178,249,1474,1723
00869409,RASMUSSEN COLLEGE - MANKATO             ,MN,56001-8658,Proprietary  ,18,84,102,255,945,1200
00869412,RASMUSSEN COLLEGE - LAKE ELMO           ,MN,55042-8624,Proprietary  ,17,85,102,144,869,1013
00869416,RASMUSSEN COLLEGE - MOORHEAD            ,MN,56560-4513,Proprietary  ,20,66,86,177,742,919
00869417,RASMUSSEN COLLEGE - BLAINE              ,MN,55014-0000,Proprietary  ,18,108,126,229,1110,1339
00905800,BETHEL UNIVERSITY                       ,MN,55112-6999,Private      ,49,209,258,3282,2349,5631
00960000,COSMETOLOGY CAREERS UNLTD-DULUTH        ,MN,55802-2031,Proprietary  ,2,10,12,19,41,60
00974000,INVER HILLS COMMUNITY COLLEGE           ,MN,55076-3224,Public       ,167,427,594,2560,3797,6357
00983100,MODEL COLLEGE OF HAIR DESIGN            ,MN,56301-4280,Proprietary  ,6,16,22,94,91,185
00989200,"DULUTH BUSINESS UNIV, INC.              ",MN,55807-0000,Proprietary  ,12,32,44,103,355,458
00999200,OAK HILLS CHRISTIAN COLLEGE             ,MN,56601-0000,Private      ,7,8,15,123,77,200
01024800,ART INSTITUTES INTL MINNESOTA           ,MN,55402-3137,Proprietary  ,75,140,215,953,929,1882
01035602,EVEREST INSTITUTE - EAGAN               ,MN,55121-1696,Proprietary  ,1,3,4,41,263,304
01037400,METROPOLITAN STATE UNIVERSITY           ,MN,55106-5000,Public       ,111,874,985,2383,9514,11897
01040200,DAKOTA COUNTY TECHNICAL COLLEGE         ,MN,55068-2999,Public       ,77,231,308,1194,2056,3250
01049000,REGENCY BEAUTY INSTITUTE                ,MN,55428-0000,Proprietary  ,317,757,1074,3173,5988,9161
01049100,HENNEPIN TECHNICAL COLLEGE              ,MN,55445-2399,Public       ,165,733,898,2034,6132,8166
01054600,CENTURY COLLEGE                         ,MN,55110-1894,Public       ,355,758,1113,4981,7483,12464
01173200,"MAYO CLINIC, COLLEGE OF MEDICINE        ",MN,55905-0000,Private      ,4,13,17,76,430,506
01173201,MAYO SCHOOL OF HEALTH-RELATED SCIEN     ,MN,55905-0000,Private      ,2,21,23,98,253,351
01173206,MAYO GRAD SCHOOL                        ,MN,55901-0000,Private      ,1,3,4,8,55,63
01173207,MAYO MEDICAL SCHOOL                     ,MN,55901-0000,Private      ,2,6,8,32,164,196
01232800,NORTHWESTERN HEALTH SCIENCES UNIV       ,MN,55431-1599,Private      ,11,42,53,93,921,1014
02050300,ACADEMY COLLEGE                         ,MN,55420-1554,Proprietary  ,9,22,31,49,194,243
02097300,HASTINGS BEAUTY SCHOOL                  ,MN,55033-1205,Proprietary  ,2,10,12,17,41,58
02123200,AVEDA INSTITUTE                         ,MN,55414-0000,Proprietary  ,42,77,119,393,504,897
02159800,COSMETOLOGY CAREERS UNLTD - HIBBING     ,MN,55746-0000,Proprietary  ,2,9,11,14,28,42
02160901,PCI ACADEMY - PCI ACADEMY               ,MN,55446-4928,Proprietary  ,3,13,16,32,82,114
02238100,MINNESOTA SCHOOL OF COSMETOLOGY         ,MN,55125-0000,Proprietary  ,11,32,43,155,227,382
02260500,SUMMIT ACAD OPPORTUNITIES IND CTR       ,MN,55405-0000,Private      ,19,139,158,93,658,751
02263102,ANTHEM COLLEGE - ST. LOUIS PARK         ,MN,55416-2467,Proprietary  ,0,0,0,5,28,33
02504200,WALDEN UNIVERSITY                       ,MN,55401-2511,Proprietary  ,39,7813,7852,414,59210,59624
02514100,AMERICAN INDIAN OPPORTUNITIES CTR       ,MN,55404-0000,Private      ,2,22,24,14,189,203
03001200,MCNALLY SMITH COLLEGE OF MUSIC          ,MN,55101-2220,Proprietary  ,25,27,52,604,263,867
03051900,ALFRED ADLER GRADUATE SCHOOL            ,MN,55305-0000,Private      ,0,20,20,0,334,334
03096400,LEECH LAKE TRIBAL COLLEGE               ,MN,56633-0000,Public       ,4,32,36,64,358,422
03129100,FOND DU LAC TRIBAL & COMMUNITY CLG      ,MN,55720-2984,Public       ,21,101,122,482,839,1321
03267300,CAPELLA UNIVERSITY                      ,MN,55402-3389,Proprietary  ,41,4677,4718,394,53400,53794
03833300,AMERICAN ACADEMY OF ACUPUNCTURE AND ORIE,MN,55113-0000,Proprietary  ,0,16,16,3,68,71
03921400,WHITE EARTH TRIBAL AND COMMUNITY COLLEGE,MN,56557-0478,Private      ,1,11,12,16,87,103
04044300,HAZELDEN GRADUATE SCHOOL OF ADDICTION ST,MN,55012-0000,Private      ,0,23,23,0,150,150
04130200,INST. OF PRODUCTION AND RECORDING       ,MN,55401-1315,Proprietary  ,13,43,56,282,292,574
04148800,CENTERPOINT MASSAGE & SHIATSU THERAPY SC,MN,55414-4525,Proprietary  ,7,40,47,40,198,238
04157600,NOVA ACADEMY OF COSMETOLOGY             ,MN,55906-4103,Proprietary  ,5,10,15,36,84,120
04160500,AVALON SCHOOL OF COSMETOLOGY            ,MN,56187-1930,Proprietary  ,0,3,3,15,37,52
04174400,ROCHESTER SCHOOL OF HAIR DESIGN         ,MN,55901-4310,Proprietary  ,2,11,13,25,54,79
04175600,PARK AVENUE SCHOOL OF COSMETOLOGY       ,MN,56470-3361,Proprietary  ,3,23,26,33,133,166
00239600,ALCORN STATE UNIVERSITY                 ,MS,39096-7500,Public       ,145,257,402,4406,3845,8251
00239700,BELHAVEN UNIVERSITY                     ,MS,39202-1789,Private      ,100,522,622,2096,5585,7681
00239800,BLUE MOUNTAIN COLLEGE                   ,MS,38610-9370,Private      ,21,30,51,619,383,1002
00240100,COAHOMA COMMUNITY COLLEGE               ,MS,38614-9799,Public       ,58,137,195,1604,1924,3528
00240200,COPIAH-LINCOLN COMMUNITY COLLEGE        ,MS,39191-0649,Public       ,103,198,301,2182,2167,4349
00240300,DELTA STATE UNIVERSITY                  ,MS,38733-0000,Public       ,132,207,339,3825,3108,6933
00240400,EAST CENTRAL COMMUNITY COLLEGE          ,MS,39327-0129,Public       ,65,195,260,2097,1823,3920
00240500,EAST MISSISSIPPI COMM COLLEGE           ,MS,39358-0000,Public       ,160,316,476,3586,3265,6851
00240700,HINDS COMMUNITY COLLEGE                 ,MS,39154-9799,Public       ,428,1090,1518,8362,10516,18878
00240800,HOLMES COMMUNITY COLLEGE                ,MS,39079-0000,Public       ,226,548,774,4420,5808,10228
00240900,ITAWAMBA COMMUNITY COLLEGE              ,MS,38843-1099,Public       ,145,357,502,4347,3623,7970
00241000,JACKSON STATE UNIVERSITY                ,MS,39217-0001,Public       ,304,630,934,9218,10761,19979
00241100,JONES COUNTY JUNIOR COLLEGE             ,MS,39437-3999,Public       ,222,267,489,4158,2574,6732
00241300,MERIDIAN COMMUNITY COLLEGE              ,MS,39307-5890,Public       ,99,309,408,2283,2885,5168
00241400,MILLSAPS COLLEGE                        ,MS,39201-0000,Private      ,76,72,148,1695,778,2473
00241500,MISSISSIPPI COLLEGE                     ,MS,39058-0001,Private      ,130,225,355,3208,3526,6734
00241501,MISSISSIPPI COLLEGE - SCHOOL OF LAW     ,MS,39201-1391,Private      ,14,46,60,128,862,990
00241600,MISSISSIPPI DELTA CMTY COLLEGE          ,MS,38761-0000,Public       ,104,162,266,2350,2150,4500
00241700,MISSISSIPPI GULF CST CLG-PERKINSTON     ,MS,39573-0000,Public       ,371,998,1369,5635,7669,13304
00242200,MISSISSIPPI UNIV FOR WOMEN              ,MS,39701-5818,Public       ,60,189,249,2003,2826,4829
00242300,MISSISSIPPI STATE UNIVERSITY            ,MS,39762-9698,Public       ,744,653,1397,18440,8067,26507
00242400,MISSISSIPPI VALLEY STATE UNIVERSITY     ,MS,38941-1400,Public       ,108,173,281,3548,2799,6347
00242600,NORTHEAST MS CMNTY COLLEGE              ,MS,38829-1731,Public       ,116,266,382,3095,2233,5328
00242700,NORTHWEST MISSISSIPPI COMMUNITY CLG     ,MS,38668-1703,Public       ,250,508,758,6436,5526,11962
00243000,PEARL RIVER COMMUNITY COLLEGE           ,MS,39470-2201,Public       ,171,375,546,3570,3387,6957
00243300,RUST COLLEGE                            ,MS,38635-2328,Private      ,49,51,100,1600,774,2374
00243500,SOUTHEASTERN BAPTIST COLLEGE            ,MS,39440-0000,Private      ,3,12,15,28,81,109
00243600,SOUTHWEST MISSISSIPPI CMNTY CLG         ,MS,39666-8099,Public       ,80,163,243,1619,1447,3066
00243900,TOUGALOO COLLEGE                        ,MS,39174-9799,Private      ,44,71,115,1570,863,2433
00244000,UNIVERSITY OF MISSISSIPPI               ,MS,38677-1848,Public       ,735,494,1229,17988,7249,25237
00244001,UNIVERSITY OF MISSISSIPPI - MED CTR     ,MS,39216-0000,Public       ,33,135,168,890,2825,3715
00244100,UNIVERSITY OF SOUTHERN MISSISSIPPI      ,MS,39406-0001,Public       ,487,758,1245,13433,10308,23741
00244700,WILLIAM CAREY UNIVERSITY                ,MS,39401-5499,Private      ,84,313,397,2217,4698,6915
00489809,MCCANN SCHOOL OF BUSINESS & TECHNOLOGY -,MS,39503-3167,Proprietary  ,7,32,39,40,210,250
01289101,ANTONELLI COLLEGE - JACKSON             ,MS,39232-9514,Proprietary  ,19,246,265,169,1376,1545
01289102,ANTONELLI COLLEGE - HATTIESBURG         ,MS,39401-3056,Proprietary  ,16,132,148,166,792,958
02074900,CHRIS' BEAUTY COLLEGE                   ,MS,39501-0000,Proprietary  ,4,24,28,65,183,248
02160500,NORTH MISSISSIPPI MED CTR MED TECH      ,MS,38801-0000,Private      ,7,29,36,75,180,255
02235900,ACADEMY OF HAIR DESIGN #4               ,MS,39208-0000,Proprietary  ,5,21,26,63,163,226
02244300,ACADEMY OF HAIR DESIGN #1               ,MS,39204-5008,Proprietary  ,11,39,50,154,376,530
02244305,ACADEMY OF HAIR DESIGN #1-ACADEMY OF HAI,MS,38901-5108,Proprietary  ,2,11,13,37,88,125
02249900,DELTA BEAUTY COLLEGE                    ,MS,38701-0000,Proprietary  ,1,13,14,59,109,168
02251600,ACADEMY OF HAIR DESIGN #6               ,MS,39401-7581,Proprietary  ,14,47,61,113,302,415
02251700,FOSTER'S COSMETOLOGY COLLEGE            ,MS,38663-0000,Proprietary  ,0,8,8,9,49,58
02302800,MISSISSIPPI COLLEGE OF BEAUTY CULT      ,MS,39440-0000,Proprietary  ,11,16,27,47,97,144
02320800,MAGNOLIA COLLEGE OF COSMETOLOGY         ,MS,39206-0000,Proprietary  ,14,54,68,110,375,485
02502100,CREATIONS COLLEGE OF COSMETOLOGY        ,MS,38803-0000,Proprietary  ,6,32,38,30,136,166
02516200,WESLEY BIBLICAL SEMINARY                ,MS,39206-0000,Private      ,2,12,14,12,151,163
02586000,J & J HAIR DESIGN COLLEGE               ,MS,39051-3716,Proprietary  ,4,20,24,38,113,151
03010603,VIRGINIA COLLEGE - JACKSON              ,MS,39206-5602,Proprietary  ,16,93,109,176,858,1034
03010610,VIRGINIA COLLEGE - BILOXI               ,MS,39532-2124,Proprietary  ,18,71,89,131,550,681
03032400,KC'S SCHOOL OF HAIR DESIGN              ,MS,38863-0000,Proprietary  ,4,16,20,43,119,162
03263300,TRAXLER'S SCHOOL OF HAIR                ,MS,39212-2529,Proprietary  ,6,15,21,35,101,136
03294305,BLUE CLIFF COLLEGE - GULFPORT           ,MS,39503-0000,Proprietary  ,15,54,69,107,414,521
03464300,ACADEMY OF HAIR DESIGN                  ,MS,39562-0000,Proprietary  ,1,16,17,18,56,74
03848300,DAY SPA CAREER COLLEGE                  ,MS,39564-0000,Proprietary  ,0,19,19,19,101,120
03963300,HEALING TOUCH CAREER COLLEGE            ,MS,39402-1300,Proprietary  ,9,42,51,81,315,396
04131300,CORINTH ACADEMY OF COSMETOLOGY          ,MS,38834-4813,Proprietary  ,4,20,24,45,169,214
04140200,"MISSISSIPPI INSTITUTE OF AESTHETICS, NAI",MS,39056-5628,Proprietary  ,4,33,37,46,181,227
00252600,CARROLL COLLEGE                         ,MT,59625-0002,Private      ,58,19,77,2430,270,2700
00252700,UNIVERSITY OF GREAT FALLS               ,MT,59405-4996,Private      ,34,51,85,976,677,1653
00252800,MILES COMMUNITY COLLEGE                 ,MT,59301-4799,Public       ,10,17,27,271,204,475
00252900,DAWSON COMMUNITY COLLEGE                ,MT,59330-1405,Public       ,8,14,22,225,140,365
00253000,MONTANA STATE UNIVERSITY - BILLINGS     ,MT,59101-0298,Public       ,128,294,422,3012,3307,6319
00253100,MONTANA TECH OF THE UNIV OF MONTANA     ,MT,59701-8997,Public       ,57,123,180,1674,1509,3183
00253200,MONTANA STATE UNIVERSITY - BOZEMAN      ,MT,59717-4160,Public       ,384,356,740,13534,4981,18515
00253300,MONTANA STATE UNIVERSITY-NORTHERN       ,MT,59501-3148,Public       ,36,60,96,879,840,1719
00253400,ROCKY MOUNTAIN COLLEGE                  ,MT,59102-1796,Private      ,29,33,62,1283,478,1761
00253600,UNIVERSITY OF MONTANA (THE)             ,MT,59812-0001,Public       ,296,465,761,8689,7414,16103
00253700,UNIVERSITY OF MONTANA WESTERN (THE)     ,MT,59725-3598,Public       ,63,46,109,1441,566,2007
00677700,FLATHEAD VALLEY COMMUNITY COLLEGE       ,MT,59901-2699,Public       ,64,203,267,899,1606,2505
00757000,HELENA COLLEGE OF TECHNOLOGY            ,MT,59601-3098,Public       ,37,109,146,543,1097,1640
00790000,BUTTE ACADEMY OF BEAUTY CULTURE         ,MT,59701-9197,Proprietary  ,3,9,12,31,79,110
00931400,GREAT FALLS COLLEGE MONTANA STATE UNIVER,MT,59405-4907,Public       ,53,201,254,735,1691,2426
02143400,SALISH KOOTENAI COLLEGE                 ,MT,59855-0000,Public       ,15,94,109,333,948,1281
02286600,LITTLE BIG HORN COLLEGE                 ,MT,59022-0000,Public       ,10,7,17,102,171,273
02343000,FT PECK COMMUNITY COLLEGE               ,MT,59255-0000,Public       ,8,21,29,86,186,272
02510600,BLACKFEET COMMUNITY COLLEGE             ,MT,59417-0000,Private      ,9,40,49,172,406,578
02517500,FORT BELKNAP COLLEGE                    ,MT,59526-0000,Public       ,3,16,19,48,132,180
02545200,CHIEF DULL KNIFE COLLEGE                ,MT,59043-0098,Public       ,2,11,13,58,137,195
02610900,STONE CHILD COLLEGE                     ,MT,59521-9796,Public       ,3,6,9,74,193,267
02621300,ACADEMY OF COSMETOLOGY                  ,MT,59715-3544,Proprietary  ,5,6,11,49,70,119
03205300,MODERN BEAUTY SCHOOL                    ,MT,59801-8386,Proprietary  ,6,24,30,64,116,180
03763400,"ACADEMY OF NAIL, SKIN & HAIR            ",MT,59101-0000,Proprietary  ,13,27,40,83,182,265
03778300,HEALTH WORKS INSTITUTE                  ,MT,59715-0000,Proprietary  ,3,11,14,40,121,161
04163700,BITTERROOT SCHOOL OF COSMETOLOGY        ,MT,59840-3118,Proprietary  ,2,7,9,18,63,81
04164100,MONTANA ACADEMY OF SALON                ,MT,59405-0000,Proprietary  ,6,20,26,66,119,185
04187700,CREVIER'S SCHOOL OF COSMETOLOGY         ,MT,59901-4402,Proprietary  ,10,18,28,75,139,214
00253900,CHADRON STATE COLLEGE                   ,NE,69337-2690,Public       ,74,115,189,1931,1197,3128
00254000,COLLEGE OF ST MARY                      ,NE,68106-2606,Private      ,13,81,94,578,1201,1779
00254100,CONCORDIA UNIVERSITY                    ,NE,68434-1594,Private      ,32,185,217,1497,928,2425
00254200,CREIGHTON UNIVERSITY                    ,NE,68178-0001,Private      ,151,259,410,6320,5542,11862
00254400,DOANE COLLEGE                           ,NE,68333-2421,Private      ,50,104,154,1673,1211,2884
00254700,GRACE UNIVERSITY                        ,NE,68108-3629,Private      ,11,49,60,469,381,850
00254800,HASTINGS COLLEGE                        ,NE,68901-7621,Private      ,60,31,91,1555,293,1848
00255100,UNIVERSITY OF NEBRASKA AT KEARNEY       ,NE,68849-0001,Public       ,144,209,353,4692,2350,7042
00255300,MIDLAND UNIVERSITY                      ,NE,68025-4254,Private      ,40,46,86,1680,400,2080
00255400,UNIVERSITY OF NEBRASKA-OMAHA            ,NE,68182-0001,Public       ,339,580,919,9906,7562,17468
00255500,NEBRASKA WESLEYAN UNIVERSITY            ,NE,68504-2796,Private      ,91,89,180,1996,877,2873
00255700,MID-PLAINS COMM COLLEGE - NORTH PLATTE  ,NE,69101-9420,Public       ,28,66,94,535,745,1280
00255701,MID-PLAINS COMMUNITY COLLEGE - MCCOOK   ,NE,69001-2631,Public       ,13,25,38,253,206,459
00255900,PERU STATE COLLEGE                      ,NE,68421-0010,Public       ,51,73,124,1257,1078,2335
00256000,WESTERN NEBRASKA COMMUNITY COLLEGE      ,NE,69361-1815,Public       ,38,97,135,748,986,1734
00256300,UNION COLLEGE                           ,NE,68506-4387,Private      ,27,32,59,900,446,1346
00256500,UNIVERSITY OF NEBRASKA-LINCOLN          ,NE,68588-0419,Public       ,452,383,835,17366,5494,22860
00256596,UNIVERSITY OF NEBRASKA - CURTIS         ,NE,69025-9522,Public       ,9,8,17,269,63,332
00256600,WAYNE STATE COLLEGE                     ,NE,68787-1172,Public       ,74,62,136,3227,974,4201
00256700,YORK COLLEGE                            ,NE,68467-2699,Private      ,12,9,21,487,135,622
00443600,REGNL WST MEDCL CTR SCHL RAD            ,NE,69361-0000,Private      ,0,6,6,21,32,53
00458608,KAPLAN UNIVERSITY - OMAHA               ,NE,68134-1002,Proprietary  ,15,209,224,176,1604,1780
00458609,KAPLAN UNIVERSITY - LINCOLN             ,NE,68508-2668,Proprietary  ,22,149,171,127,1128,1255
00639900,BRYANLGH COLLEGE OF HEALTH SCIENCES     ,NE,68506-1398,Private      ,19,36,55,473,443,916
00640400,NEBR METHODIST CLG OF NURS ALLD HLTH    ,NE,68114-2852,Private      ,17,101,118,539,1146,1685
00689500,UNIVERSITY OF NEBRASKA-MED CTR          ,NE,68198-4265,Public       ,25,98,123,747,2522,3269
00750100,VATTEROTT COLLEGE                       ,NE,68137-1237,Proprietary  ,1,45,46,92,436,528
00849200,ALEGENT HEALTH SCHOOLS                  ,NE,68114-2767,Private      ,3,25,28,96,288,384
00952300,BAHNER COLLEGE OF HAIRSTYLING           ,NE,68025-3297,Proprietary  ,4,7,11,22,28,50
00961700,CAPITOL BEAUTY SCHOOL                   ,NE,68144-0000,Proprietary  ,14,38,52,150,233,383
00974300,BELLEVUE UNIVERSITY                     ,NE,68005-0000,Private      ,62,957,1019,894,9027,9921
00986200,CLARKSON COLLEGE                        ,NE,68131-2739,Private      ,20,121,141,545,1460,2005
01151900,JOSEPH'S COLLEGE OF BEAUTY/ALL CAMPUSES ,NE,68510-2226,Proprietary  ,14,52,66,160,305,465
01166700,NORTHEAST COMMUNITY COLLEGE             ,NE,68702-0000,Public       ,77,134,211,1944,1406,3350
01258600,METROPOLITAN COMMUNITY COLLEGE          ,NE,68103-0000,Public       ,333,1272,1605,5425,11589,17014
01297600,NEBRASKA CHRISTIAN COLLEGE              ,NE,68046-4256,Private      ,5,8,13,158,68,226
02079700,COLLEGE OF HAIR DESIGN                  ,NE,68508-0000,Proprietary  ,13,46,59,176,253,429
02099500,CENTRAL COMMUNITY COLLEGE-ALL CAMPUSES  ,NE,68801-7299,Public       ,105,307,412,2009,2457,4466
02099501,CENTRAL COMMUNITY COLLEGE - HASTINGS CAM,NE,68902-7712,Public       ,0,0,0,1,0,1
02099502,CENTRAL COMMUNITY COLLEGE - COLUMBUS CAM,NE,68602-8031,Public       ,0,0,0,0,1,1
02508300,SOUTHEAST COMM. COLLEGE-ALL CAMPUSES    ,NE,68520-0000,Public       ,331,644,975,4871,5927,10798
02550800,NEBRASKA INDIAN COMMUNITY COLLEGE       ,NE,68039-0000,Public       ,3,9,12,34,119,153
02610500,XENON INTERNATIONAL ACADEMY II          ,NE,68127-3522,Proprietary  ,9,34,43,187,311,498
03164300,THE CREATIVE CENTER                     ,NE,68164-2911,Proprietary  ,4,7,11,138,93,231
03279300,MYOTHERAPY INSTITUTE                    ,NE,68516-0000,Proprietary  ,3,8,11,26,37,63
03323300,LITTLE PRIEST TRIBAL COLLEGE            ,NE,68071-0000,Private      ,2,11,13,33,137,170
03821400,UNIVERSAL COLLEGE OF HEALING ARTS       ,NE,68112-1810,Proprietary  ,3,15,18,26,111,137
00256800,UNIVERSITY OF NEVADA RENO               ,NV,89557-0002,Public       ,711,632,1343,17350,7585,24935
00256900,UNIVERSITY OF NEVADA-LAS VEGAS          ,NV,89154-1001,Public       ,941,1422,2363,22620,19207,41827
00697700,GREAT BASIN COLLEGE                     ,NV,89801-3348,Public       ,43,159,202,729,1394,2123
00732954,ITT TECHNICAL INSTITUTE                 ,NV,89014-6712,Proprietary  ,32,138,170,328,1016,1344
00736700,MARINELLO SCHOOLS OF BEAUTY             ,NV,89110-3563,Proprietary  ,29,86,115,248,570,818
00736701,MARINELLO SCHOOLS OF BEAUTY -           ,NV,89014-2244,Proprietary  ,10,45,55,78,272,350
00737100,MARINELLO SCHOOL OF BEAUTY              ,NV,89502-6530,Proprietary  ,18,42,60,160,296,456
00844103,ANTHEM INSTITUTE - MORRISON UNIVERSITY  ,NV,89521-4826,Proprietary  ,0,0,0,98,533,631
00919200,SIERRA NEVADA COLLEGE                   ,NV,89451-0000,Private      ,27,74,101,570,725,1295
01036200,COLLEGE OF SOUTHERN NEVADA              ,NV,89146-1139,Public       ,1337,3988,5325,17300,28831,46131
01036300,WESTERN NEVADA COLLEGE                  ,NV,89703-0000,Public       ,109,367,476,1310,2876,4186
01246110,LINCOLN TECHNICAL INSTITUTE-EUPH INST OF,NV,89117-8803,Proprietary  ,17,53,70,158,322,480
01246111,LINCOLN TECHNICAL INSTITUTE-EUPH INS OFB,NV,89052-4964,Proprietary  ,8,23,31,81,172,253
01246112,LINCOLN TECHNICAL INSTITUTE- EUPH INST O,NV,89131-1036,Proprietary  ,0,0,0,74,147,221
01323200,ACADEMY OF HAIR DESIGN                  ,NV,89146-1617,Proprietary  ,27,89,116,237,525,762
02107700,TRUCKEE MEADOWS COMMUNITY CLG           ,NV,89512-0000,Public       ,345,956,1301,4817,7590,12407
02237500,EVEREST COLLEGE                         ,NV,89103-0000,Proprietary  ,66,245,311,823,2074,2897
02338512,GLENDALE CAREER COLLEGE - NEVADA CAREER ,NV,89131-3268,Proprietary  ,4,51,55,70,332,402
02616703,SCOTTSDALE CULINARY INSTITUTE - LE CORDO,NV,89144-7047,Proprietary  ,9,41,50,197,390,587
02621500,CAREER COLLEGE OF NORTHERN NEVADA       ,NV,89434-7905,Proprietary  ,32,125,157,275,880,1155
03030603,UTAH CLG OF MASSAGE THERAPY-NSMT        ,NV,89123-0000,Proprietary  ,26,93,119,172,450,622
03031405,INTERNATIONAL ACADEMY OF DESIGN AND TECH,NV,89074-7750,Proprietary  ,5,26,31,260,451,711
03043200,KAPLAN COLLEGE                          ,NV,89102-8618,Proprietary  ,87,393,480,816,2661,3477
03076404,BRYMAN SCHOOL OF ARIZONA (THE) - ANTHEM ,NV,89102-4514,Proprietary  ,0,0,0,136,384,520
03088200,CARSON CITY BEAUTY ACADEMY              ,NV,89706-0000,Proprietary  ,0,0,0,26,103,129
03787300,EXPERTISE SCHOOL OF BEAUTY              ,NV,89106-2516,Private      ,18,64,82,117,368,485
03838500,NORTHWEST HEALTH CAREERS                ,NV,89128-0255,Proprietary  ,34,125,159,278,759,1037
03975300,INSTITUTE OF PROFESSIONAL CAREERS       ,NV,89119-7825,Proprietary  ,12,83,95,94,478,572
04051303,ART INSTITUTE OF PHOENIX (THE) - ART INS,NV,89074-7737,Proprietary  ,24,57,81,400,423,823
04065300,ROSEMAN UNIVERSITY OF HEALTH SCIENCES   ,NV,89014-2333,Private      ,14,70,84,357,2037,2394
04114300,NEVADA STATE COLLEGE                    ,NV,89002-9455,Public       ,137,382,519,2429,4285,6714
04142601,TOURO UNIVERSITY - NEVADA               ,NV,89014-8800,Private      ,10,52,62,122,900,1022
04144800,INTERNATIONAL ACADEMY OF STYLE          ,NV,89509-3450,Proprietary  ,16,20,36,105,186,291
04147600,AVEDA INSTITUTE LAS VEGAS               ,NV,89119-6103,Proprietary  ,19,73,92,200,487,687
04171000,ADVANCED TRAINING INSTITUTE             ,NV,89115-7504,Proprietary  ,46,143,189,247,864,1111
04186300,PAUL MITCHELL THE SCHOOL LAS VEGAS      ,NV,89123-8014,Proprietary  ,43,85,128,350,525,875
04190300,AMERICAN INSTITUTE OF MEDICAL SONOGRAPHY,NV,89146-6597,Proprietary  ,18,78,96,144,554,698
04191100,DESTINATION ACADEMY FOR SPA AND SALON PR,NV,89147-8397,Proprietary  ,0,0,0,8,16,24
04203100,PAUL MITCHELL THE SCHOOL RENO           ,NV,89501-3356,Proprietary  ,22,36,58,166,227,393
04226200,HEALTHCARE PREPARATORY INSTITUTE        ,NV,89130-2580,Proprietary  ,20,88,108,152,517,669
00257200,COLBY-SAWYER COLLEGE                    ,NH,03257-4648,Private      ,33,5,38,2634,143,2777
00257300,DARTMOUTH COLLEGE                       ,NH,03755-3529,Private      ,250,62,312,10539,1866,12405
00257500,FRANKLIN PIERCE UNIVERSITY              ,NH,03461-0060,Private      ,39,84,123,3342,1208,4550
00257900,NEW ENGLAND COLLEGE                     ,NH,03242-3293,Private      ,59,248,307,2498,2054,4552
00258000,SOUTHERN NEW HAMPSHIRE UNIVERSITY       ,NH,03106-1045,Private      ,621,6966,7587,9228,54072,63300
00258100,NHTI  - CONCORD'S COMMUNITY COLLEGE     ,NH,03301-7412,Public       ,116,197,313,2910,2206,5116
00258200,MANCHESTER COMMUNITY COLLEGE            ,NH,03102-8518,Public       ,74,188,262,1584,2018,3602
00258300,GREAT BAY COMMUNITY COLLEGE             ,NH,03801-0000,Public       ,62,159,221,1136,1376,2512
00258600,RIVIER UNIVERSITY                       ,NH,03060-5086,Private      ,29,85,114,1445,1227,2672
00258700,SAINT ANSELM COLLEGE                    ,NH,03102-1310,Private      ,87,19,106,3876,205,4081
00258900,UNIVERSITY OF NEW HAMPSHIRE             ,NH,03824-2511,Public       ,397,204,601,21636,3715,25351
00258903,UNIV OF NEW HAMPSHIRE - SCHOOL OF LAW   ,NH,03301-4115,Public       ,0,10,10,28,366,394
00259000,KEENE STATE COLLEGE                     ,NH,03431-0000,Public       ,127,48,175,7919,788,8707
00259100,PLYMOUTH STATE UNIVERSITY               ,NH,03264-1595,Public       ,115,95,210,6419,1511,7930
00301004,ANTIOCH UNIVERSITY                      ,NH,03431-0000,Private      ,0,39,39,13,804,817
00472900,HESSER COLLEGE                          ,NH,03103-7230,Proprietary  ,23,182,205,287,1221,1508
00472901,HESSER COLLEGE - NASHUA CAMPUS          ,NH,03063-1286,Proprietary  ,1,23,24,81,318,399
00472904,HESSER COLLEGE - PORTSMOUTH CAMPUS      ,NH,03801-3245,Proprietary  ,0,0,0,12,33,45
00472905,HESSER COLLEGE - SALEM CAMPUS           ,NH,03079-2842,Proprietary  ,3,16,19,101,351,452
00472906,HESSER COLLEGE - CONCORD CAMPUS         ,NH,03301-3415,Proprietary  ,0,0,0,12,29,41
00473100,DANIEL WEBSTER COLLEGE                  ,NH,03063-1300,Proprietary  ,23,42,65,754,344,1098
00529100,WHITE MOUNTAINS COMMUNITY COLLEGE       ,NH,03570-3799,Public       ,21,49,70,357,511,868
00702500,LEBANON COLLEGE                         ,NH,03766-0000,Private      ,0,4,4,31,73,104
00755500,LAKES REGION COMMUNITY COLLEGE          ,NH,03246-1326,Public       ,25,82,107,701,788,1489
00756000,RIVER VALLEY COMMUNITY COLLEGE          ,NH,03743-9707,Public       ,16,68,84,370,826,1196
00864500,EMPIRE BEAUTY SCHOOL                    ,NH,03220-0000,Proprietary  ,21,22,43,113,138,251
00923600,NASHUA COMMUNITY COLLEGE                ,NH,03063-2052,Public       ,54,113,167,1264,1138,2402
01318900,CONTINENTAL ACADEMIE OF HAIR DESIGN     ,NH,03051-3754,Proprietary  ,5,4,9,67,42,109
02140400,ST JOSEPH SCH OF PRAC NRSG              ,NH,03060-0000,Private      ,1,9,10,50,232,282
02174800,MICHAEL'S SCHOOL OF HAIR DESIGN & ESTHET,NH,03110-0000,Proprietary  ,21,15,36,113,98,211
02179600,EMPIRE BEAUTY SCHOOL                    ,NH,03878-0000,Proprietary  ,17,31,48,85,128,213
02211600,PORTSMOUTH BTY SCH OF HAIR DESIGN       ,NH,03801-4084,Proprietary  ,3,10,13,34,40,74
02223300,MAGDALEN COLLEGE                        ,NH,03278-4012,Private      ,1,0,1,51,2,53
02245400,KEENE BEAUTY ACADEMY                    ,NH,03431-0000,Proprietary  ,2,10,12,45,47,92
02247000,NEW ENGLAND SCHOOL OF HAIR DESIGN       ,NH,03784-0000,Proprietary  ,0,5,5,30,45,75
03043100,THOMAS MORE COLLEGE OF LIBERAL ARTS     ,NH,03054-4818,Private      ,1,2,3,109,24,133
03101300,GRANITE STATE COLLEGE                   ,NH,03301-6400,Public       ,37,223,260,492,2448,2940
03182300,NEW HAMPSHIRE INSTITUTE OF ART          ,NH,03104-4858,Private      ,15,23,38,649,215,864
03437300,UPPER VALLEY TEACHER TRANING PROGRAM    ,NH,03766-1358,Private      ,0,1,1,2,38,40
03729300,NH INSTITUTE FOR THERAPEUTIC ARTS       ,NH,03051-4906,Proprietary  ,3,9,12,9,50,59
04162200,LAIRD INSTITUTE OF SPA THERAPY          ,NH,03102-5263,Proprietary  ,3,16,19,20,80,100
00267000,BAPTIST BIBLE COLG OF PENNSYLVANIA      ,PA,18411-1297,Private      ,17,52,69,589,506,1095
00322800,BRYN ATHYN COLLEGE OF THE NEW CHURCH    ,PA,19009-0717,Private      ,10,1,11,288,46,334
00322900,ALBRIGHT COLLEGE                        ,PA,19612-5234,Private      ,123,116,239,4774,1292,6066
00323000,ALLEGHENY COLLEGE                       ,PA,16335-3902,Private      ,50,16,66,3512,133,3645
00323100,COMM CLG OF ALLEGHENY-ALLEGHENY CMP     ,PA,15212-0000,Public       ,248,710,958,3322,6338,9660
00323101,"COMM CLG OF ALLEGHENY, BOYCE CAMPUS     ",PA,15146-0000,Public       ,94,306,400,1629,2519,4148
00323102,"COMM CLG OF ALLEGHENY, NORTH CAMPUS     ",PA,15237-0000,Public       ,136,343,479,1958,2517,4475
00323103,"COMM CLG OF ALLEGHENY, SOUTH CAMPUS     ",PA,15122-0000,Public       ,110,274,384,1763,2311,4074
00323300,ALVERNIA UNIVERSITY                     ,PA,19607-1799,Private      ,52,105,157,2555,1776,4331
00323500,ARCADIA UNIVERSITY                      ,PA,19038-3295,Private      ,155,127,282,6654,2044,8698
00323700,BRYN MAWR COLLEGE                       ,PA,19010-2899,Private      ,47,32,79,1818,537,2355
00323800,BUCKNELL UNIVERSITY                     ,PA,17837-2122,Private      ,179,15,194,5464,238,5702
00323900,BUCKS COUNTY COMMUNITY COLLEGE          ,PA,18940-1320,Public       ,242,430,672,4225,4014,8239
00324000,BUTLER COUNTY COMMUNITY COLLEGE         ,PA,16001-0000,Public       ,102,183,285,2083,1831,3914
00324100,CABRINI COLLEGE                         ,PA,19087-3698,Private      ,38,113,151,2028,897,2925
00324200,CARNEGIE MELLON UNIVERSITY              ,PA,15213-3890,Private      ,417,97,514,13451,1808,15259
00324201,CARNEGIE MELLON UNIV- THE HEINZ COLLEGE ,PA,15213-0000,Private      ,12,40,52,156,645,801
00324202,CARNEGIE MELLON- TEPPER SCHOOL OF BUSINE,PA,15213-0000,Private      ,9,28,37,251,527,778
00324300,CEDAR CREST COLLEGE                     ,PA,18104-6196,Private      ,24,96,120,1136,1451,2587
00324400,CHATHAM UNIVERSITY                      ,PA,15232-2826,Private      ,33,161,194,748,1845,2593
00324500,CHESTNUT HILL COLLEGE                   ,PA,19118-2693,Private      ,56,183,239,1789,2332,4121
00324700,MISERICORDIA  UNIVERSITY                ,PA,18612-1008,Private      ,46,54,100,2753,1485,4238
00324900,COMMUNITY COLLEGE OF PHILADELPHIA       ,PA,19130-3991,Public       ,965,2781,3746,13329,23837,37166
00325100,CURTIS INSTITUTE OF MUSIC               ,PA,19103-6187,Private      ,8,14,22,282,160,442
00325200,DELAWARE VALLEY COLLEGE                 ,PA,18901-2697,Private      ,51,45,96,2469,456,2925
00325300,DICKINSON COLLEGE                       ,PA,17013-2896,Private      ,89,10,99,3582,167,3749
00325600,DREXEL UNIVERSITY                       ,PA,19104-2875,Private      ,777,1186,1963,34173,18595,52768
00325800,DUQUESNE UNIVERSITY                     ,PA,15282-0001,Private      ,147,163,310,8100,3807,11907
00325900,EASTERN UNIVERSITY                      ,PA,19087-3696,Private      ,74,176,250,2350,2680,5030
00326200,ELIZABETHTOWN COLLEGE                   ,PA,17022-2298,Private      ,56,57,113,3018,738,3756
00326300,EVANGELICAL SCHOOL OF THEOLOGY          ,PA,17067-0000,Private      ,0,1,1,0,92,92
00326500,FRANKLIN & MARSHALL COLLEGE             ,PA,17604-0000,Private      ,129,19,148,3657,227,3884
00326600,GANNON UNIVERSITY                       ,PA,16541-0001,Private      ,47,61,108,3881,1447,5328
00326700,GENEVA COLLEGE                          ,PA,15010-3599,Private      ,21,60,81,1866,858,2724
00326800,GETTYSBURG COLLEGE                      ,PA,17325-1486,Private      ,88,18,106,4037,190,4227
00326900,GROVE CITY COLLEGE                      ,PA,16127-2104,Private      ,28,4,32,1876,62,1938
00327000,GWYNEDD-MERCY COLLEGE                   ,PA,19437-0901,Private      ,28,165,193,1550,1765,3315
00327200,HARCUM COLLEGE                          ,PA,19010-3476,Private      ,65,175,240,988,1977,2965
00327300,HARRISBURG AREA COMMUNITY COLLEGE       ,PA,17110-2999,Public       ,652,1613,2265,9901,15252,25153
00327400,HAVERFORD COLLEGE                       ,PA,19041-1392,Private      ,57,8,65,2176,86,2262
00327500,HOLY FAMILY UNIVERSITY                  ,PA,19114-2094,Private      ,45,147,192,2008,1931,3939
00327600,IMMACULATA UNIVERSITY                   ,PA,19345-0647,Private      ,32,89,121,1804,1585,3389
00327700,INDIANA UNIVERSITY OF PENNSYLVANIA      ,PA,15705-1097,Public       ,294,216,510,14901,3881,18782
00327900,JUNIATA COLLEGE                         ,PA,16652-2196,Private      ,37,10,47,2530,112,2642
00328000,KEYSTONE COLLEGE                        ,PA,18440-0200,Private      ,41,57,98,1661,694,2355
00328200,KINGS COLLEGE                           ,PA,18711-0801,Private      ,67,33,100,3239,588,3827
00328300,LACKAWANNA COLLEGE                      ,PA,18509-9961,Private      ,72,127,199,1865,1201,3066
00328400,LAFAYETTE COLLEGE                       ,PA,18042-1768,Private      ,136,11,147,5043,171,5214
00328500,LANCASTER BIBLE COLLEGE                 ,PA,17601-5036,Private      ,25,115,140,862,1153,2015
00328600,LANCASTER THEOLOGICAL SEMINARY          ,PA,17603-0000,Private      ,0,5,5,0,129,129
00328700,LASALLE UNIVERSITY                      ,PA,19141-1199,Private      ,166,289,455,6726,4431,11157
00328800,LEBANON VALLEY COLLEGE                  ,PA,17003-1400,Private      ,149,18,167,3079,288,3367
00328900,LEHIGH UNIVERSITY                       ,PA,18015-1588,Private      ,210,69,279,8780,1008,9788
00329000,LINCOLN UNIVERSITY                      ,PA,19352-0999,Public       ,83,84,167,3221,1201,4422
00329100,LUTHERAN THEOLOG SEMINARY-GETTYSBRG     ,PA,17325-0000,Private      ,0,2,2,1,87,88
00329200,LUTHERAN THEOLOGICAL SEMINARY           ,PA,19119-0000,Private      ,0,11,11,2,196,198
00329300,LYCOMING COLLEGE                        ,PA,17701-5192,Private      ,37,14,51,1989,175,2164
00329400,MANOR COLLEGE                           ,PA,19046-3399,Private      ,21,50,71,746,608,1354
00329600,MARYWOOD UNIVERSITY                     ,PA,18509-1598,Private      ,54,82,136,2916,1531,4447
00329700,MERCYHURST UNIVERSITY                   ,PA,16546-0001,Private      ,59,98,157,3858,1697,5555
00329800,MESSIAH COLLEGE                         ,PA,17027-0000,Private      ,57,53,110,3439,585,4024
00330000,MOORE COLLEGE OF ART & DESIGN           ,PA,19103-1179,Private      ,26,32,58,749,397,1146
00330100,MORAVIAN COLLEGE                        ,PA,18018-6650,Private      ,51,40,91,2228,510,2738
00330101,MORAVIAN THEOLOGICAL SEMINARY           ,PA,18018-0000,Private      ,2,5,7,13,77,90
00330200,MOUNT ALOYSIUS COLLEGE                  ,PA,16630-1999,Private      ,23,38,61,1418,915,2333
00330300,CARLOW UNIVERSITY                       ,PA,15213-3165,Private      ,29,158,187,1255,2142,3397
00330400,MUHLENBERG COLLEGE                      ,PA,18104-5586,Private      ,107,35,142,3802,452,4254
00330600,VALLEY FORGE CHRISTIAN COLLEGE          ,PA,19460-2399,Private      ,17,36,53,812,327,1139
00330900,PEIRCE COLLEGE                          ,PA,19102-4699,Private      ,43,234,277,570,2850,3420
00331100,SALUS UNIVERSITY                        ,PA,19027-1598,Private      ,0,14,14,18,1160,1178
00331300,WIDENER UNIVERSITY                      ,PA,19013-5792,Private      ,98,179,277,5163,2803,7966
00331302,WIDENER UNIV SCH OF LAW- HARRISBURG     ,PA,17106-9381,Private      ,3,13,16,28,526,554
00331500,BLOOMSBURG UNIVERSITY OF PA             ,PA,17815-1301,Public       ,239,129,368,13307,2267,15574
00331600,CALIFORNIA UNIV OF PENNSYLVANIA         ,PA,15419-1394,Public       ,111,382,493,6228,4551,10779
00331700,CHEYNEY UNIVERSITY OF PENNSYLVANIA      ,PA,19319-0200,Public       ,68,55,123,1919,928,2847
00331800,CLARION UNIVERSITY OF PENNSYLVANIA      ,PA,16214-1232,Public       ,92,148,240,4807,2379,7186
00332000,EAST STROUDSBURG UNIVERSITY             ,PA,18301-2999,Public       ,199,130,329,8173,2168,10341
00332100,EDINBORO UNIVERSITY OF PENNSYLVANIA     ,PA,16444-0001,Public       ,118,177,295,5892,3086,8978
00332200,KUTZTOWN UNIVERSITY OF PENNSYLVANIA     ,PA,19530-9339,Public       ,242,115,357,11595,2311,13906
00332300,LOCK HAVEN UNIV OF PENNSYLVANIA         ,PA,17745-2439,Public       ,94,89,183,5596,1470,7066
00332400,MANSFIELD UNIVERSITY                    ,PA,16933-1123,Public       ,61,52,113,3120,828,3948
00332500,MILLERSVILLE UNIVERSITY OF PA           ,PA,17551-1800,Public       ,169,140,309,9023,2634,11657
00332600,SHIPPENSBURG UNIVERSITY                 ,PA,17257-2299,Public       ,175,108,283,9112,1860,10972
00332700,SLIPPERY ROCK UNIVERSITY                ,PA,16057-1326,Public       ,122,189,311,8872,2397,11269
00332800,WEST CHESTER UNIVERSITY                 ,PA,19383-0001,Public       ,409,355,764,18439,5338,23777
00332900,PENNSYLVANIA STATE UNIVERSITY (THE)     ,PA,16802-1503,Public       ,1910,2251,4161,75581,29580,105161
00335000,UNIVERSITY OF THE ARTS (THE)            ,PA,19102-9493,Private      ,110,58,168,2984,721,3705
00335100,CAIRN UNIVERSITY                        ,PA,19047-2942,Private      ,12,37,49,800,464,1264
00335200,PHILADELPHIA CLG OSTEOPATHIC MED        ,PA,19131-0000,Private      ,2,27,29,45,3460,3505
00335300,UNIVERSITY OF THE SCIENCES IN PHILADELPH,PA,19104-4495,Private      ,75,60,135,3493,1599,5092
00335400,PHILADELPHIA UNIVERSITY                 ,PA,19144-5497,Private      ,115,220,335,4706,2583,7289
00335600,PITTSBURGH THEOLOGICAL SEMINARY         ,PA,15206-0000,Private      ,0,10,10,3,179,182
00335700,POINT PARK UNIVERSITY                   ,PA,15222-1912,Private      ,92,184,276,3761,2387,6148
00335800,REFORMED PRESBYTERIAN THEOL SEMINAR     ,PA,15208-0000,Private      ,0,3,3,4,22,26
00335900,ROBERT MORRIS UNIVERSITY                ,PA,15108-1189,Private      ,87,168,255,5440,2281,7721
00336000,ROSEMONT COLLEGE                        ,PA,19010-1699,Private      ,16,63,79,685,681,1366
00336200,SETON HILL UNIVERSITY                   ,PA,15601-1599,Private      ,42,50,92,2259,907,3166
00336400,ST. CHARLES BORROMEO SEMINARY           ,PA,19096-0000,Private      ,2,2,4,29,28,57
00336600,SAINT FRANCIS UNIVERSITY                ,PA,15940-0600,Private      ,41,41,82,2129,806,2935
00336700,SAINT JOSEPH'S UNIVERSITY               ,PA,19131-1395,Private      ,191,403,594,8210,3960,12170
00336800,ST VINCENT COLLEGE                      ,PA,15650-2690,Private      ,29,10,39,2075,293,2368
00336900,SUSQUEHANNA UNIVERSITY                  ,PA,17870-1001,Private      ,53,10,63,3710,143,3853
00337000,SWARTHMORE COLLEGE                      ,PA,19081-1397,Private      ,86,9,95,3282,102,3384
00337100,TEMPLE UNIVERSITY                       ,PA,19122-6003,Private      ,980,987,1967,37498,20516,58014
00337600,THIEL COLLEGE                           ,PA,16125-2181,Private      ,34,11,45,1881,162,2043
00337800,UNIVERSITY OF PENNSYLVANIA              ,PA,19104-6216,Private      ,799,577,1376,23451,12861,36312
00337900,UNIVERSITY OF PITTSBURGH                ,PA,15260-0000,Public       ,662,601,1263,32055,10267,42322
00337906,UNIVERSITY OF PITTSBURGH - SCHOOL OF MED,PA,15261-0001,Public       ,22,21,43,223,977,1200
00337907,UNIVERSITY OF PITTSBURGH - SCHOOL OF DEN,PA,15261-2523,Public       ,4,8,12,103,371,474
00338400,UNIVERSITY OF SCRANTON                  ,PA,18510-4622,Private      ,168,150,318,8241,1607,9848
00338500,URSINUS COLLEGE                         ,PA,19426-1000,Private      ,48,11,59,2611,108,2719
00338600,VALLEY FORGE MILITARY COLLEGE           ,PA,19087-3695,Private      ,15,4,19,634,94,728
00338800,VILLANOVA UNIVERSITY                    ,PA,19085-1699,Private      ,331,319,650,12783,3231,16014
00338801,VILLANOVA UNIV SCH OF LAW               ,PA,19085-0000,Private      ,7,28,35,41,922,963
00338900,WASHINGTON & JEFFERSON COLLEGE          ,PA,15301-4801,Private      ,52,10,62,2847,109,2956
00339100,WAYNESBURG UNIVERSITY                   ,PA,15370-1222,Private      ,27,55,82,1952,716,2668
00339200,WESTMINSTER COLLEGE                     ,PA,16172-0002,Private      ,29,29,58,1925,214,2139
00339300,WESTMINSTER THEOLOGICAL SEMINARY        ,PA,19038-0000,Private      ,0,16,16,3,296,299
00339400,WILKES UNIVERSITY                       ,PA,18766-0998,Private      ,60,136,196,3477,1417,4894
00339500,PENNSYLVANIA COLLEGE OF TECHNOLOGY      ,PA,17701-5779,Public       ,129,190,319,5300,2316,7616
00339600,WILSON COLLEGE                          ,PA,17201-1285,Private      ,19,36,55,566,450,1016
00339900,YORK COLLEGE OF PENNSYLVANIA            ,PA,17405-7199,Private      ,166,107,273,8556,1350,9906
00398600,DESALES UNIVERSITY                      ,PA,18034-9568,Private      ,71,104,175,2881,1560,4441
00398700,LA ROCHE COLLEGE                        ,PA,15237-5898,Private      ,24,39,63,1200,579,1779
00398800,NEUMANN UNIVERSITY                      ,PA,19014-1298,Private      ,83,101,184,3137,1486,4623
00405800,GRATZ COLLEGE                           ,PA,19027-3097,Private      ,0,9,9,3,103,106
00445200,MONTGOMERY COUNTY COMMUNITY COLLEGE     ,PA,19422-6300,Public       ,303,586,889,5552,6001,11553
00488900,CAMBRIA-ROWE BUSINESS COLLEGE           ,PA,15902-2494,Proprietary  ,4,17,21,103,177,280
00488901,CAMBRIA ROWE BUSINESS COLLEGE - INDIANA ,PA,15701-2804,Proprietary  ,2,14,16,65,123,188
00489000,CENTRAL PENN COLLEGE                    ,PA,17093-0309,Proprietary  ,42,144,186,1076,1604,2680
00489300,DU BOIS BUSINESS COLLEGE                ,PA,15801-2401,Proprietary  ,7,20,27,138,259,397
00489400,ERIE BUSINESS CENTER                    ,PA,16501-1305,Proprietary  ,1,3,4,63,263,326
00489401,ERIE BUSINESS CENTER - NEW CASTLE CAMPUS,PA,16101-3950,Proprietary  ,1,3,4,28,107,135
00489800,MCCANN SCHOOL OF BUSINESS & TECHNOL     ,PA,17901-1335,Proprietary  ,129,538,667,1528,5431,6959
00489807,MCCANN SCHOOL OF BUSINESS & TECHNOLOGY -,PA,17013-3180,Proprietary  ,1,9,10,50,107,157
00489900,MERCY HOSP SCH OF NURSING               ,PA,15219-5166,Private      ,7,16,23,172,235,407
00490200,PENN COMMERCIAL BUSINESS/TECHNICAL SCHL ,PA,15301-2871,Proprietary  ,17,57,74,242,444,686
00491000,KAPLAN CAREER INSTITUTE                 ,PA,17111-3571,Proprietary  ,23,114,137,185,693,878
00491001,THOMPSON INSTITUTE-PHILADEPHIA CAMPUS   ,PA,19104-3386,Proprietary  ,48,104,152,317,737,1054
00500701,WEST VIRGINIA CAREER INSTITUTE          ,PA,15456-0000,Proprietary  ,5,12,17,62,96,158
00531000,PITTSBURGH INST OF AERONAUTICS          ,PA,15236-0000,Private      ,22,39,61,390,323,713
00533000,FAYETTE CNTY AREA VOC TECH PRC NRSG     ,PA,15401-0000,Public       ,3,10,13,52,118,170
00533500,CENTRAL PENN INST OF SCI & TECH PNP     ,PA,16823-0000,Public       ,3,25,28,150,251,401
00536500,YORK CO AREA VOC-TECH SCH-PRAC NSG      ,PA,17402-0000,Public       ,14,64,78,81,399,480
00653400,CITIZENS SCHOOL OF NURSING              ,PA,15068-6591,Private      ,2,7,9,107,186,293
00653700,CONEMAUGH VLY MEM HOSP SCH NRSNG        ,PA,15905-4398,Private      ,0,3,3,140,144,284
00653704,CONEMAUGH VLY MEM HOSP SCH RAD TECH     ,PA,15905-0000,Private      ,0,0,0,35,28,63
00655100,ST MARGARET SCHL OF NURSING             ,PA,15238-3205,Private      ,4,11,15,123,231,354
00656000,OHIO VALLEY HOSP SCH OF NURSING         ,PA,15136-1694,Private      ,0,2,2,39,75,114
00656500,READING HOSPITAL SCHOOL OF HEALTH SCIENC,PA,19611-1744,Private      ,9,21,30,233,472,705
00657400,"ST LUKE'S HOSPITAL OF BETHLEHEM, PA     ",PA,18015-1065,Private      ,11,30,41,111,282,393
00657700,UPMC SHADYSIDE SCHOOL OF NURSING        ,PA,15232-1381,Private      ,23,58,81,278,483,761
00657800,SHARON REGIONAL HEALTH SYSTEM SCHOOL OF ,PA,16146-3395,Private      ,0,5,5,31,73,104
00658200,WASHINGTON HOSP SCH OF NURSING          ,PA,15301-3398,Private      ,4,10,14,41,108,149
00658202,WASHINGTON HOSP SCH OF RAD TECH         ,PA,15301-3398,Private      ,0,0,0,8,18,26
00658300,WESTERN PENN HOSP-SCH OF NURSING        ,PA,15224-1790,Private      ,3,21,24,135,234,369
00680700,COMMUNITY COLLEGE OF BEAVER COUNTY      ,PA,15061-2588,Public       ,52,151,203,1246,1464,2710
00681000,LEHIGH CARBON COMMUNITY COLLEGE         ,PA,18078-2598,Public       ,225,477,702,3514,4159,7673
00681100,LUZERNE COUNTY COMMUNITY COLLEGE        ,PA,18634-3899,Public       ,164,354,518,3193,3733,6926
00708700,ABINGTON MEM HOSP SCHL OF NURSING       ,PA,19090-1284,Private      ,4,26,30,125,426,551
00709100,EVEREST INSTITUTE                       ,PA,15222-1320,Proprietary  ,27,78,105,196,764,960
00711000,DELAWARE COUNTY COMMUNITY COLLEGE       ,PA,19063-1094,Public       ,443,950,1393,6660,8928,15588
00719100,NORTHAMPTON COMMUNITY COLLEGE           ,PA,18020-7599,Public       ,358,635,993,6840,6637,13477
00730305,LINCOLN TECHNICAL INSTITUTE - PHILADELPH,PA,19136-1530,Proprietary  ,39,83,122,321,555,876
00732955,ITT TECHNICAL INSTITUTE                 ,PA,19406-1212,Proprietary  ,20,85,105,213,710,923
00743000,ANTONELLI INST OF ART & PHOTOGRAPHY     ,PA,19038-8242,Proprietary  ,11,3,14,252,50,302
00743600,KAPLAN CAREER INSTITUTE - ICM CAMPUS    ,PA,15222-1977,Proprietary  ,36,136,172,223,844,1067
00743700,PITTSBURGH TECHNICAL INSTITUTE          ,PA,15071-3205,Proprietary  ,90,150,240,2331,1403,3734
00746900,"HUSSIAN SCHOOL OF ART, INC.             ",PA,19106-0000,Proprietary  ,7,3,10,137,56,193
00747000,"ART INSTITUTE OF PITTSBURGH, THE        ",PA,15219-1328,Proprietary  ,496,2224,2720,3732,13930,17662
00752900,"CHESTER COUNTY INTERMEDIATE UNIT, PNP   ",PA,19335-3043,Public       ,5,25,30,45,183,228
00777900,LANSDALE SCHOOL OF BUSINESS             ,PA,19454-4114,Proprietary  ,7,30,37,76,377,453
00778000,NEW CASTLE SCHOOL OF TRADES             ,PA,16143-0000,Proprietary  ,36,134,170,377,717,1094
00778100,CHI INSTITUTE/RETS CAMPUS               ,PA,19008-3516,Proprietary  ,16,47,63,120,370,490
00783900,TRIANGLE TECH                           ,PA,15214-3897,Proprietary  ,16,38,54,251,330,581
00791200,THADDEUS STEVENS CLG OF TECHNOLOGY      ,PA,17602-0000,Public       ,36,30,66,1398,630,2028
00791600,FRANKLIN CNTY CAREER & TECH CTR-PNP     ,PA,17201-0000,Public       ,9,18,27,51,123,174
00793807,LINCOLN TECHNICAL INSITUTE - ALLENTOWN  ,PA,18104-3212,Proprietary  ,39,104,143,398,684,1082
00820000,JAMESON MEMORIAL HOSP SCH NURSING       ,PA,16105-2595,Private      ,2,3,5,47,92,139
00835000,ART INSTITUTE OF PHILADELPHIA           ,PA,19103-5198,Proprietary  ,192,281,473,2718,2531,5249
00844100,ANTHEM INSTITUTE                        ,PA,19064-1243,Proprietary  ,1,3,4,55,256,311
00856800,VET TECH INSTITUTE                      ,PA,15222-3400,Proprietary  ,20,19,39,403,245,648
00865300,JEFFERSON CO DUBOIS VOC TECH-PR NSG     ,PA,15851-0000,Public       ,2,0,2,20,29,49
00895500,SALON PROFESSIONAL ACADEMY (THE)        ,PA,16602-0000,Proprietary  ,0,8,8,33,37,70
00915705,WYOTECH - BLAIRSVILLE                   ,PA,15717-8060,Proprietary  ,97,81,178,848,739,1587
00918600,DEAN INSTITUTE OF TECHNOLOGY            ,PA,15226-1197,Proprietary  ,5,23,28,47,153,200
00944900,PENNCO TECH                             ,PA,19007-0000,Proprietary  ,31,81,112,224,458,682
00966400,EMPIRE BEAUTY SCHOOL                    ,PA,18052-5730,Proprietary  ,69,221,290,651,1443,2094
00972100,BRADFORD SCHOOL                         ,PA,15219-2602,Proprietary  ,9,14,23,586,192,778
00972300,ARIA HEALTH SCHOOL OF NURSING           ,PA,19053-6939,Private      ,9,19,28,145,347,492
00983702,ITT TECHNICAL INSTITUTE                 ,PA,15220-3805,Proprietary  ,0,0,0,0,1,1
00986300,PENNSYLVANIA COLLEGE OF HEALTH SCIENCES ,PA,17602-4955,Private      ,29,80,109,723,1217,1940
01000600,GREATER JOHNSTOWN AREA VOC TECH SCH     ,PA,15904-0000,Public       ,4,17,21,90,228,318
01005500,CRAWFORD CNTY AREA VO-TECH PRAC NUR     ,PA,16335-0000,Public       ,0,4,4,20,39,59
01017600,WESTMORELAND COUNTY COMMUNITY CLG       ,PA,15697-1895,Public       ,123,314,437,2926,3358,6284
01038800,READING AREA COMMUNITY COLLEGE          ,PA,19603-1706,Public       ,150,407,557,2268,3846,6114
01054200,EMPIRE BEAUTY SCHOOL                    ,PA,18701-0000,Proprietary  ,86,239,325,689,1584,2273
01081400,PITTSBURGH INST MORTUARY SCIENCE        ,PA,15206-3706,Private      ,9,31,40,113,300,413
01086000,GREATER ALTOONA CAREER/TECH CENTER      ,PA,16602-0000,Public       ,1,10,11,116,251,367
01096300,GREENE COUNTY VOC-TECH SCHOOL           ,PA,15370-0000,Public       ,0,0,0,14,28,42
01099800,PENNSYLVANIA INSTITUTE OF TECH          ,PA,19063-4098,Private      ,45,120,165,468,958,1426
01162100,AUTOMOTIVE TRAINING CENTER              ,PA,19341-1310,Proprietary  ,79,56,135,815,400,1215
01162200,WELDER TRAINING & TESTING INST          ,PA,18109-3253,Proprietary  ,8,39,47,47,149,196
01171500,SCHUYLKILL HEALTH SCHOOL OF NURSING     ,PA,17901-3692,Private      ,1,3,4,69,64,133
01191900,BEAVER FALLS BEAUTY ACADEMY             ,PA,15010-4208,Proprietary  ,2,8,10,25,51,76
01205000,ROSEDALE TECHNICAL INSTITUTE            ,PA,15205-9791,Private      ,16,45,61,338,400,738
01239300,THOMAS JEFF UNIV-CLG ALLIED HEALTH      ,PA,19107-0000,Private      ,12,55,67,350,1563,1913
01239301,THOMAS JEFFERSON UNIVERSITY - JEFFERSON ,PA,19107-5001,Private      ,28,96,124,495,2674,3169
01239303,THOMAS JEFFERSON UNIVERSITY - COLLEGE OF,PA,19107-6731,Private      ,16,54,70,245,929,1174
01246104,LINCOLN TECHNICAL INSTITUTE             ,PA,19104-0202,Proprietary  ,24,112,136,335,850,1185
01246105,LINCOLN TECHNICAL INSTITUTE             ,PA,19116-4202,Proprietary  ,22,84,106,242,581,823
01252300,TALMUDICAL YESHIVA OF PHILA             ,PA,19131-1296,Private      ,25,0,25,42,1,43
01260600,EMPIRE BEAUTY SCHOOL                    ,PA,17901-3859,Proprietary  ,63,184,247,599,1322,1921
01292900,SOUTH HILLS BEAUTY ACADEMY              ,PA,15216-2335,Proprietary  ,11,38,49,72,191,263
01313400,YESHIVATH BETH MOSHE                    ,PA,18505-2196,Private      ,28,1,29,33,5,38
01321400,ROXBOROUGH MEM HOSP SCH OF NURSING      ,PA,19128-0000,Proprietary  ,8,31,39,96,431,527
01326300,SOUTH HILLS SCHOOL OF BUSINESS & TECHNOL,PA,16801-4516,Proprietary  ,21,38,59,533,516,1049
02061000,VENUS BEAUTY ACADEMY                    ,PA,19079-0000,Proprietary  ,6,11,17,53,71,124
02068300,DOUGLAS SCHOOL OF BUSINESS              ,PA,15062-0000,Proprietary  ,16,26,42,240,235,475
02090200,TRIANGLE TECH                           ,PA,16502-0000,Proprietary  ,6,6,12,76,86,162
02092500,LAUREL TECHNICAL INSTITUTE              ,PA,16146-0000,Proprietary  ,14,29,43,183,315,498
02092502,BUSINESS INSTITUTE OF PENNSYLVANIA      ,PA,16335-0000,Proprietary  ,0,5,5,13,32,45
02104003,HARRIS SCHOOL OF BUSINESS - UPPER DARBY ,PA,19082-2528,Proprietary  ,1,11,12,28,59,87
02107300,PENNSYLVANIA ACADEMY OF FINE ARTS       ,PA,19102-1424,Private      ,14,21,35,286,319,605
02112200,GREAT LAKES INSTITUTE OF TECHNOLOGY     ,PA,16509-0000,Proprietary  ,27,60,87,351,463,814
02114200,JOHNSON COLLEGE                         ,PA,18508-0000,Private      ,22,27,49,499,309,808
02116001,SANFORD-BROWN INSTITUTE - TREVOSE       ,PA,19053-4700,Proprietary  ,0,0,0,2,7,9
02118000,LEVITTOWN BEAUTY ACADEMY LLC            ,PA,19054-1713,Proprietary  ,3,8,11,26,43,69
02119300,PA ACAD OF COSMETOLOGY ARTS & SCI       ,PA,15904-0000,Proprietary  ,3,12,15,53,68,121
02120800,"YORKTOWNE BUSINESS INSTITUTE, INC.      ",PA,17404-0000,Proprietary  ,7,28,35,103,229,332
02127400,YORK TECHNICAL INSTITUTE                ,PA,17402-0000,Proprietary  ,85,165,250,1169,1555,2724
02129000,TRIANGLE TECH                           ,PA,15601-0000,Proprietary  ,32,38,70,246,303,549
02129001,TRIANGLE TECH - BUSINESS CAREERS INSTITU,PA,15601-3304,Proprietary  ,1,0,1,11,11,22
02144000,"VISION ACADEMY, THE                     ",PA,18103-0000,Proprietary  ,10,33,43,39,124,163
02151500,CENTRAL SUSQUEHANNA LPN CENTER          ,PA,17837-8818,Public       ,1,14,15,54,173,227
02158300,JUNIATA-MIFFLIN CO AREA VOC TECH        ,PA,17044-0000,Public       ,1,3,4,18,56,74
02161400,NORTHEASTERN HOSP SCH OF NRSG           ,PA,19134-0000,Private      ,7,31,38,79,347,426
02169600,CLEARFIELD CTY CAREER AND TECH CNTR     ,PA,16830-0000,Public       ,2,13,15,44,104,148
02174400,TRIANGLE TECH                           ,PA,15801-0000,Proprietary  ,34,14,48,292,192,484
02178900,ACADEMY OF HAIR DESIGN                  ,PA,18202-1465,Proprietary  ,28,55,83,113,286,399
02183000,ORLEANS TECHNICAL INSTITUTE             ,PA,19111-0000,Private      ,14,91,105,171,475,646
02192800,WALNUT HILL COLLEGE                     ,PA,19104-0000,Proprietary  ,47,50,97,480,449,929
02202300,PITTSBURGH CAREER INSTITUTE             ,PA,15219-1907,Proprietary  ,9,50,59,69,228,297
02202301,SANFORD-BROWN INSTITUTE                 ,PA,15146-2141,Proprietary  ,0,0,0,10,22,32
02203900,ERIE INSTITUTE OF TECHNOLOGY            ,PA,16565-1002,Proprietary  ,9,49,58,175,306,481
02206200,"VISION ACADEMY, THE                     ",PA,19002-0000,Proprietary  ,19,42,61,103,176,279
02206300,STROUDSBURG SCHOOL OF COSMETOLOGY       ,PA,18360-0000,Proprietary  ,3,10,13,32,64,96
02212700,LANCASTER SCHOOL OF COSMETOLOGY         ,PA,17602-0000,Proprietary  ,7,36,43,77,191,268
02234200,ACADEMY OF MEDICAL ARTS & BUSINESS      ,PA,17112-0000,Proprietary  ,18,57,75,232,379,611
02240100,BARBER STYLING INSTITUTE                ,PA,17011-0000,Proprietary  ,0,0,0,0,1,1
02251200,SCHUYLKILL COUNTY AREA VOC TECH SCH     ,PA,17931-0000,Public       ,2,4,6,23,77,100
02251202,SCHUYLKILL COUNTY AREA VOC TECH SCH     ,PA,17931-0000,Public       ,1,0,1,10,23,33
02253900,BERKS TECHNICAL INSTITUTE               ,PA,19610-1168,Proprietary  ,70,231,301,940,1975,2915
02255200,PENNSYLVANIA SCHOOL OF BUSINESS         ,PA,18101-1604,Proprietary  ,0,0,0,4,2,6
02269900,PENNSYLVANIA COLLEGE OF ART & DESIGN    ,PA,17603-3528,Private      ,26,7,33,453,112,565
02270500,BUCKS COUNTY SCHOOL OF BEAUTY CULT      ,PA,19053-0000,Proprietary  ,6,11,17,36,60,96
02273400,RECONSTRUCTIONIST RABBINICAL COLLEG     ,PA,19095-0000,Private      ,0,0,0,0,34,34
02276600,HANOVER PUBLIC SCH DIST PRAC NURSG      ,PA,17331-0000,Public       ,0,3,3,5,45,50
02282500,LENAPE SCHOOL OF PRACTICAL NURSING      ,PA,16226-0000,Public       ,6,22,28,64,161,225
02289500,PACE INSTITUTE                          ,PA,19601-0000,Proprietary  ,3,11,14,26,73,99
02289600,CONSOLIDATED SCHOOL OF BUSINESS         ,PA,17404-0000,Proprietary  ,2,34,36,67,195,262
02289700,ACADEMY OF CREATIVE HAIR DESIGN         ,PA,18702-0000,Proprietary  ,23,44,67,127,245,372
02289800,CHI INSTITUTE - FRANKLIN MILLS          ,PA,19154-0000,Proprietary  ,45,94,139,279,713,992
02290400,"ALTOONA BEAUTY SCHOOL, INC              ",PA,16602-0000,Proprietary  ,3,8,11,48,86,134
02292700,LANSDALE SCHOOL OF COSMETOLOGY          ,PA,19446-0000,Proprietary  ,1,5,6,14,38,52
02299300,TRINITY EPISCOPAL SCHOOL MINISTRY       ,PA,15003-0000,Private      ,0,3,3,2,87,89
02301300,PRISM CAREER INSTITUTE                  ,PA,19082-2448,Proprietary  ,10,38,48,96,350,446
02304400,YTI CAREER INSTITUTE - MECHANICSBURG    ,PA,17055-0000,Proprietary  ,0,0,0,37,35,72
02306200,VENANGO COUNTY AREA VOC TECH SCHOOL     ,PA,16301-0000,Public       ,0,4,4,28,75,103
02310800,LANCASTER COUNTY CAREER & TECH CTR      ,PA,17584-0000,Public       ,23,61,84,201,535,736
02323000,BIBLICAL THEOLOGICAL SEMINARY           ,PA,19440-2421,Private      ,0,15,15,1,101,102
02330300,LEBANON CO CAREER & TECHNOLOGY CTR      ,PA,17042-0000,Public       ,7,20,27,70,256,326
02330600,PENNSYLVANIA GUNSMITH SCHOOL            ,PA,15202-0000,Proprietary  ,6,9,15,76,103,179
02350100,WESTERN AREA CAREER & TECHNOLOGY CT     ,PA,15317-0000,Public       ,1,3,4,28,93,121
02350200,INDIANA COUNTY TECH CTR SCH PR NSG      ,PA,15701-1465,Public       ,3,6,9,48,131,179
02353100,NORTHERN TIER CAREER CENTER             ,PA,18848-0000,Public       ,1,3,4,34,66,100
02362300,MERCER COUNTY AREA VOC TECH SCHOOL      ,PA,16137-0000,Public       ,0,3,3,16,47,63
02492600,EASTERN CTR ARTS AND TECH PR NSG        ,PA,19090-0000,Public       ,2,29,31,29,174,203
02495500,ALL-STATE CAREER SCHOOL                 ,PA,19029-0000,Proprietary  ,32,188,220,193,948,1141
02529800,WILKES BARRE AREA CAREER AND TECHNICAL C,PA,18705-0000,Public       ,9,31,40,91,207,298
02536600,COMMONWEALTH TECH INSTIT @ HIRAM G      ,PA,15905-0000,Public       ,34,19,53,209,90,299
02544300,BUTLER BEAUTY SCHOOL                    ,PA,16001-0000,Proprietary  ,3,21,24,43,105,148
02545000,LAWRENCE COUNTY CAREER AND TECHNICAL CEN,PA,16101-0000,Public       ,0,0,0,16,32,48
02546200,LAUREL BUSINESS INSTITUTE               ,PA,15401-0877,Proprietary  ,10,23,33,191,228,419
02550000,CLARION CO AREA VOC-TECH PRAC NRSG      ,PA,16254-4637,Public       ,0,4,4,18,58,76
02554500,HAZLETON AREA CAREER CENTER PRACTICAL NU,PA,18201-0000,Public       ,3,10,13,38,59,97
02557800,ART INSTITUTE OF YORK (THE) - PENNSYLVAN,PA,17402-9012,Proprietary  ,23,27,50,518,259,777
02566400,ALBERT EINSTEIN MED CTR DEPT DNTL       ,PA,19141-3098,Private      ,0,0,0,25,95,120
02574800,PENNSYLVANIA INSTITUTE OF TAXIDERMY     ,PA,15931-0000,Proprietary  ,0,8,8,16,19,35
02609500,CAREER TRAINING ACADEMY                 ,PA,15068-6308,Proprietary  ,15,51,66,111,352,463
02609501,CAREER TRAINING ACADEMY                 ,PA,15146-0000,Proprietary  ,0,8,8,10,46,56
02616100,JEAN MADELINE ED CTR FOR COSM           ,PA,19147-1542,Proprietary  ,31,49,80,299,345,644
02617507,EVEREST COLLEGE - EVEREST INSTITUTE - BE,PA,19020-2062,Proprietary  ,6,15,21,125,360,485
03010800,FORTIS INSTITUTE                        ,PA,16506-1013,Proprietary  ,47,193,240,622,1749,2371
03011500,FORTIS INSTITUTE                        ,PA,18702-0000,Proprietary  ,8,42,50,61,228,289
03011600,FORTIS INSTITUTE                        ,PA,18509-2903,Proprietary  ,21,49,70,192,453,645
03029900,CONSOLIDATED SCHOOL OF BUSINESS         ,PA,17603-2389,Proprietary  ,8,16,24,87,157,244
03067000,ANTONELLI MEDICAL & PROF INST           ,PA,19464-9244,Proprietary  ,10,24,34,55,192,247
03072600,DCI CAREER INSTITUTE                    ,PA,15061-2307,Proprietary  ,4,25,29,43,120,163
03081900,YTI CAREER INSTITUTE - ALTOONA          ,PA,16602-4457,Proprietary  ,18,37,55,234,389,623
03090800,LAKE ERIE COLL OF OSTEOPATHIC MED       ,PA,16509-0000,Private      ,1,40,41,102,4164,4266
03098600,CAREER TECH CTR OF LACKAWANNA CNTY      ,PA,18508-0000,Public       ,8,32,40,79,230,309
03101400,FORBES ROAD CAREER & TECHNOLOGY CTR     ,PA,15146-1550,Public       ,2,8,10,20,40,60
03101500,BIDWELL TRAINING CENTER                 ,PA,15233-2233,Private      ,4,18,22,36,101,137
03103300,JNA INSTITUTE OF CULINARY ARTS          ,PA,19146-3119,Proprietary  ,15,39,54,134,252,386
03109100,METROPOLITAN CAREER CENTER              ,PA,19144-0000,Private      ,3,35,38,35,144,179
03110700,AVIATION INSTITUTE OF MAINTENANCE       ,PA,19114-1017,Proprietary  ,51,122,173,187,493,680
03120400,REGIONAL CAREER & TECHNICAL CENTER      ,PA,16509-4699,Public       ,0,2,2,7,31,38
03128400,DELAWARE COUNTY TECHNICAL SCHOOL        ,PA,19008-1928,Public       ,2,16,18,53,190,243
03180400,PENNSYLVANIA HIGHLANDS COMMUNITY COLLEGE,PA,15904-2927,Public       ,52,102,154,972,924,1896
03236400,L T INTERNATIONAL BEAUTY SCHOOL         ,PA,19130-2235,Proprietary  ,6,28,34,34,133,167
03353300,ACADEMY OF VOCAL ARTS                   ,PA,19103-6685,Private      ,9,20,29,40,110,150
03380301,STAR CAREER ACADEMY - STAR PHILADELPHIA ,PA,19114-2204,Proprietary  ,72,223,295,430,1347,1777
03380304,STAR CAREER ACADEMY - STAR NORRISTOWN   ,PA,19403-2422,Proprietary  ,26,43,69,78,220,298
03493302,ALL-STATE CAREER - WEST MIFFLIN CAMPUS  ,PA,15122-0000,Proprietary  ,1,12,13,28,61,89
03535300,HUNTINGDON COUNTY CAREER AND TECHNO     ,PA,17060-0905,Public       ,0,0,0,17,36,53
03561400,SUSQUEHANNA COUNTY CAREER & TECHNOL     ,PA,18816-0100,Public       ,1,8,9,24,66,90
03766300,PENNSYLVANIA SCHOOL OF MUSCLE THERAPY   ,PA,19406-3101,Proprietary  ,17,46,63,68,186,254
03781300,PRINCETON INFORMATION TECHNOLOGY CENTER ,PA,19038-4535,Proprietary  ,3,35,38,28,302,330
03899300,CALVARY BAPTIST THEOLOGICAL SEMINARY    ,PA,19446-4718,Private      ,0,0,0,0,4,4
03923300,PRECISION MANUFACTURING INSTITUTE       ,PA,16335-8380,Private      ,3,9,12,30,70,100
03948300,HARRISBURG UNIVERSITY OF SCIENCE AND TEC,PA,17101-2116,Private      ,17,41,58,559,319,878
03949300,WON INSTITUTE OF GRADUATE STUDIES       ,PA,19038-4535,Private      ,0,2,2,3,62,65
03950500,NORTHWEST REGIONAL TECHNOLOGY INSTITUTE ,PA,16508-2820,Proprietary  ,0,28,28,7,99,106
03952300,NATIONAL MASSAGE THERAPY INSTITUTE      ,PA,19116-3965,Proprietary  ,4,21,25,36,148,184
04024300,EDUCATION AND TECHNOLOGY INSTITUTE      ,PA,15601-9214,Private      ,0,3,3,11,16,27
04041300,BERKS CAREER & TECHNOLOGY CENTER        ,PA,19533-9112,Public       ,1,10,11,35,65,100
04118000,BYZANTINE CATHOLIC SEMINARY OF SAINTS CY,PA,15214-2229,Private      ,0,0,0,0,9,9
04124600,PROFESSIONAL ACADEMY OF COSMETOLOGY     ,PA,19401-0000,Proprietary  ,0,1,1,0,1,1
04127500,CDE CAREER INSTITUTE                    ,PA,18372-9034,Proprietary  ,6,36,42,22,82,104
04145800,PULSE BEAUTY ACADEMY A PAUL MITCHELL PAR,PA,19335-0000,Proprietary  ,8,15,23,84,85,169
04149800,SOMERSET COUNTY TECHNOLOGY CENTER       ,PA,15501-1444,Public       ,2,15,17,32,108,140
04151700,BELLA CAPELLI ACADEMY                   ,PA,15146-2388,Proprietary  ,4,13,17,68,86,154
04151701,BELLA CAPELLI ACADEMY -                 ,PA,15205-2388,Proprietary  ,8,17,25,90,99,189
04155100,INSTITUTE OF MEDICAL CAREERS            ,PA,15235-3718,Proprietary  ,7,40,47,44,224,268
04158000,METRO BEAUTY ACADEMY                    ,PA,18106-9693,Proprietary  ,7,35,42,134,220,354
04164900,BARONE BEAUTY ACADEMY                   ,PA,17701-5316,Proprietary  ,2,6,8,25,54,79
04167200,COMMONWEALTH MEDICAL COLLEGE (THE)      ,PA,18509-3240,Private      ,0,8,8,20,678,698
04167500,WORLD A CUTS BARBER INSTITUTE           ,PA,17401-1105,Proprietary  ,0,1,1,4,61,65
04215500,CHAMP'S BARBER SCHOOL                   ,PA,17603-3809,Proprietary  ,8,24,32,39,115,154
04221300,PHILADELPHIA TECHNICIAN TRAINING        ,PA,19138-1324,Private      ,13,85,98,72,358,430
04224600,BARBER SCHOOL OF PITTSBURGH             ,PA,15220-5537,Proprietary  ,5,21,26,35,150,185
04226300,DIVINE CROWN ACADEMY OF COSMETOLOGY     ,PA,17104-2103,Proprietary  ,3,20,23,28,89,117
04236800,FOUNTAIN OF YOUTH ACADEMY OF COSMETOLOGY,PA,16046-2430,Proprietary  ,0,4,4,1,8,9
00267813,BRYANT & STRATTON COLLEGE - MIL DOWNTOWN,WI,53203-2608,Proprietary  ,77,342,419,877,2998,3875
00383200,ALVERNO COLLEGE                         ,WI,53234-3922,Private      ,43,163,206,1533,2518,4051
00383500,BELOIT COLLEGE                          ,WI,53511-5595,Private      ,58,19,77,2077,179,2256
00383700,CARDINAL STRITCH UNIVERSITY             ,WI,53217-9884,Private      ,47,406,453,1324,3917,5241
00383800,CARROLL UNIVERSITY                      ,WI,53186-5593,Private      ,54,45,99,4035,881,4916
00383900,CARTHAGE COLLEGE                        ,WI,53141-0000,Private      ,117,92,209,5066,930,5996
00384000,WESTERN TECHNICAL COLLEGE               ,WI,54601-0908,Public       ,155,303,458,2128,2424,4552
00384200,CONCORDIA UNIVERSITY WISCONSIN          ,WI,53097-2402,Private      ,68,397,465,3847,4901,8748
00384800,EDGEWOOD COLLEGE                        ,WI,53711-1958,Private      ,31,101,132,1885,1399,3284
00385000,SILVER LAKE COLLEGE                     ,WI,54220-9319,Private      ,7,30,37,219,357,576
00385400,LAKELAND COLLEGE                        ,WI,53082-0000,Private      ,34,177,211,1285,2087,3372
00385600,LAWRENCE UNIVERSITY                     ,WI,54912-0599,Private      ,41,10,51,2315,146,2461
00386100,MARIAN UNIVERSITY                       ,WI,54935-4699,Private      ,36,85,121,1478,986,2464
00386300,MARQUETTE UNIVERSITY                    ,WI,53201-1881,Private      ,259,153,412,16868,4173,21041
00386600,MILWAUKEE AREA TECH COLLEGE             ,WI,53233-1443,Public       ,586,1958,2544,7576,17827,25403
00386800,MILWAUKEE SCHOOL OF ENGINEERING         ,WI,53202-3109,Private      ,60,78,138,3186,937,4123
00386900,MOUNT MARY UNIVERSITY                   ,WI,53222-4597,Private      ,23,92,115,913,1396,2309
00387400,NASHOTAH HOUSE                          ,WI,53058-0000,Private      ,0,6,6,1,60,61
00387500,NORTHLAND COLLEGE                       ,WI,54806-3999,Private      ,12,10,22,928,118,1046
00388400,RIPON COLLEGE                           ,WI,54971-0248,Private      ,17,9,26,1393,98,1491
00389200,ST. NORBERT COLLEGE                     ,WI,54115-2099,Private      ,25,7,32,2608,129,2737
00389500,UNIVERSITY OF WISCONSIN-MADISON         ,WI,53715-1382,Public       ,587,407,994,27442,9919,37361
00389600,UNIVERSITY OF WISCONSIN-MILWAUKEE       ,WI,53201-3165,Public       ,505,891,1396,18558,13456,32014
00389700,UNIVERSITY OF WISCONSIN COLLEGES        ,WI,53708-8680,Public       ,128,186,314,2936,2024,4960
00389701,UNIVERSITY OF WISCONSIN-BARABOO         ,WI,53913-1098,Public       ,14,27,41,435,213,648
00389702,UNIVERSITY OF WISCONSIN-BARRON          ,WI,54868-2497,Public       ,20,24,44,409,247,656
00389703,UNIVERSITY OF WISCONSIN-FOND DU LAC     ,WI,54935-2998,Public       ,17,31,48,531,294,825
00389704,UNIVERSITY OF WISCONSIN-FOX VALLEY      ,WI,54952-1297,Public       ,48,43,91,1237,536,1773
00389705,UNIVERSITY OF WISCONSIN-MANITOWOC       ,WI,54220-6699,Public       ,11,7,18,328,146,474
00389706,UNIVERSITY OF WISCONSIN-MARATHON        ,WI,54401-5396,Public       ,20,30,50,861,328,1189
00389707,UNIVERSITY OF WISCONSIN-MARINETTE       ,WI,54143-4299,Public       ,12,15,27,315,142,457
00389708,UNIVERSITY OF WISCONSIN-MARSHFIELD      ,WI,54449-3310,Public       ,9,16,25,346,194,540
00389709,UNIVERSITY OF WISCONSIN-RICHLAND        ,WI,53581-1399,Public       ,8,13,21,290,115,405
00389710,UNIVERSITY OF WISCONSIN COLLEGES - ROCK ,WI,53546-5699,Public       ,47,62,109,826,649,1475
00389711,UNIVERSITY OF WISCONSIN-SHEBOYGAN       ,WI,53081-4789,Public       ,28,36,64,564,337,901
00389712,UNIVERSITY OF WISCONSIN-WASHINGTON      ,WI,53095-3699,Public       ,24,34,58,656,284,940
00389713,UNIVERSITY OF WISCONSIN-WAUKESHA        ,WI,53188-2799,Public       ,76,80,156,1691,712,2403
00389900,UNIVERSITY OF WISCONSIN-GREEN BAY       ,WI,54311-7001,Public       ,86,183,269,4598,2779,7377
00391100,VITERBO UNIVERSITY                      ,WI,54601-4777,Private      ,27,80,107,1897,1273,3170
00391500,UNIVERSITY OF WISCONSIN-STOUT           ,WI,54751-0790,Public       ,134,141,275,6583,2315,8898
00391700,UNIVERSITY OF WISCONSIN-EAU CLAIRE      ,WI,54702-4004,Public       ,181,158,339,9447,1993,11440
00391900,UNIVERSITY OF WISCONSIN-LA CROSSE       ,WI,54601-3742,Public       ,170,103,273,9430,1754,11184
00392000,UNIVERSITY OF WISCONSIN-OSHKOSH         ,WI,54901-8604,Public       ,182,208,390,9462,3558,13020
00392100,UNIVERSITY OF WISCONSIN-PLATTEVILLE     ,WI,53818-3099,Public       ,139,154,293,7658,1897,9555
00392300,UNIVERSITY OF WISCONSIN-RIVER FALLS     ,WI,54022-5013,Public       ,110,99,209,4924,1465,6389
00392400,UNIVERSITY OF WISCONSIN-STEVENS POINT   ,WI,54481-3897,Public       ,147,118,265,8409,2092,10501
00392500,UNIVERSITY OF WISCONSIN-SUPERIOR        ,WI,54880-2898,Public       ,49,127,176,1714,1459,3173
00392600,UNIVERSITY OF WISCONSIN-WHITEWATER      ,WI,53190-1792,Public       ,225,202,427,10653,2922,13575
00400700,MADISON AREA TECHNICAL COLLEGE          ,WI,53704-2599,Public       ,332,849,1181,5386,8438,13824
00501500,UNIVERSITY OF WISCONSIN-PARKSIDE        ,WI,53141-2000,Public       ,114,188,302,4015,2605,6620
00529400,WAUKESHA COUNTY TECHNICAL COLLEGE       ,WI,53072-4696,Public       ,121,369,490,1736,3429,5165
00530100,NORTHEAST WISCONSIN TECHNICAL COLLEGE   ,WI,54307-9042,Public       ,192,487,679,3292,5423,8715
00530400,CHIPPEWA VALLEY TECHNICAL COLLEGE       ,WI,54701-6162,Public       ,152,340,492,2502,3417,5919
00538000,MID-STATE TECHNICAL COLLEGE             ,WI,54494-5512,Public       ,60,207,267,942,1925,2867
00538400,NICOLET AREA TECHNICAL COLLEGE          ,WI,54501-0000,Public       ,32,83,115,563,833,1396
00538700,NORTHCENTRAL TECHNICAL COLLEGE          ,WI,54401-1899,Public       ,99,298,397,1480,2989,4469
00538900,GATEWAY TECHNICAL COLLEGE               ,WI,53144-1690,Public       ,219,705,924,2675,7350,10025
00539000,BLACKHAWK TECHNICAL COLLEGE             ,WI,53547-5009,Public       ,83,312,395,1060,2734,3794
00663900,BELLIN COLLEGE                          ,WI,54305-0000,Private      ,7,16,23,329,218,547
00732934,ITT TECHNICAL INSTITUTE                 ,WI,53220-4612,Proprietary  ,34,295,329,325,1822,2147
00766900,SOUTHWEST WISCONSIN TECH COLLEGE        ,WI,53809-0000,Public       ,34,98,132,834,875,1709
00821700,PAUL MITCHELL THE SCHOOL GREEN BAY      ,WI,54324-0257,Proprietary  ,14,25,39,98,119,217
00869405,RASMUSSEN COLLEGE - WAUSAU              ,WI,54401-7804,Proprietary  ,11,47,58,115,726,841
00869414,RASMUSSEN COLLEGE - GREEN BAY           ,WI,54303-2349,Proprietary  ,10,79,89,158,832,990
00869419,RASMUSSEN COLLEGE - APPLETON            ,WI,54915-7305,Proprietary  ,8,60,68,77,631,708
00919400,LAKESHORE TECHNICAL COLLEGE             ,WI,53015-1412,Public       ,45,159,204,774,1610,2384
00925600,MORAINE PARK TECHNICAL COLLEGE          ,WI,54936-0000,Public       ,70,283,353,1075,2617,3692
00941900,STATE CLG OF BEAUTY CULT-WAUSAU         ,WI,54403-4667,Proprietary  ,4,7,11,37,72,109
00962100,HERZING UNIVERSITY                      ,WI,53718-4236,Proprietary  ,116,1420,1536,1209,10988,12197
00974400,FOX VALLEY TECHNICAL COLLEGE            ,WI,54913-0000,Public       ,226,642,868,3240,5549,8789
01091300,MADISON MEDIA INSTITUTE                 ,WI,53718-6787,Proprietary  ,26,59,85,569,517,1086
01148400,ADVANCED INSTITUTE OF HAIR DESIGN       ,WI,53225-0000,Proprietary  ,29,40,69,245,239,484
01182400,WISCONSIN INDIANHEAD TECH CLG WITC      ,WI,54871-9300,Public       ,74,228,302,1104,2187,3291
02077100,MILWAUKEE INST OF ART & DESIGN          ,WI,53202-0000,Private      ,34,47,81,1016,371,1387
02078000,SACRED HEART SCHOOL OF THEOLOGY         ,WI,53130-0000,Private      ,0,0,0,0,6,6
02136600,WISCONSIN LUTHERAN COLLEGE              ,WI,53226-0000,Private      ,22,57,79,1341,454,1795
02239204,ANTHEM COLLEGE - BROOKFIELD             ,WI,53005-4207,Proprietary  ,0,0,0,38,208,246
02271300,WI SCH OF PROFESSIONAL PSYCHOLOGY       ,WI,53225-0000,Private      ,5,17,22,39,181,220
02317200,MARANATHA BAPTIST BIBLE COLLEGE         ,WI,53094-0000,Private      ,31,16,47,833,179,1012
02453500,MEDICAL COLLEGE OF WISCONSIN            ,WI,53226-0000,Private      ,8,23,31,112,1268,1380
02494300,GILL-TECH ACADEMY OF HAIR DESIGN        ,WI,54911-0000,Proprietary  ,6,17,23,46,84,130
02532200,LAC COURTE OREILLES OJIBWA CMTY CLG     ,WI,54843-0000,Public       ,5,63,68,89,457,546
03061200,MIDWEST COLLEGE OF ORIENTAL MEDICINE    ,WI,53403-9747,Proprietary  ,1,35,36,36,239,275
03125100,COLLEGE OF MENOMINEE NATION             ,WI,54135-0000,Private      ,6,30,36,105,420,525
03125102,COLLEGE OF  THE MENOMINEE NATION - GREEN,WI,54304-4964,Private      ,5,20,25,42,229,271
03220300,"SALON PROFESSIONAL ACADEMY, THE         ",WI,54701-7633,Proprietary  ,5,19,24,49,86,135
03309300,MONTESSORI INSTITUTE OF MILWAUKEE       ,WI,53207-0000,Private      ,1,8,9,11,46,57
03808300,INSTITUTE OF BEAUTY AND WELLNESS (THE)  ,WI,53202-5715,Proprietary  ,24,48,72,182,267,449
03822300,PAUL MITCHELL THE SCHOOL - MONROE       ,WI,53566-0000,Proprietary  ,2,5,7,43,38,81
03872500,NORTHLAND INTERNATIONAL UNIVERSITY      ,WI,54119-9285,Private      ,9,5,14,196,49,245
03925300,BLUE SKY SCHOOL OF PROFESSIONAL MASSAGE ,WI,53024-9699,Private      ,0,6,6,10,28,38
03925301,BLUE SKY SCHOOL OF PROFESSIONAL MASSAGE ,WI,54115-7407,Private      ,1,2,3,11,30,41
03925303,BLUE SKY SCHOOL OF PROFESSIONAL MASSAGE ,WI,53713-2366,Private      ,1,5,6,14,58,72
04117400,MILWAUKEE CAREER COLLEGE                ,WI,53222-4305,Proprietary  ,37,86,123,279,634,913
04118600,ACADEMY OF COSMETOLOGY                  ,WI,53548-3307,Proprietary  ,5,20,25,47,125,172
04124800,VISIONS IN HAIR DESIGN INSTITUTE OF COSM,WI,53210-1120,Proprietary  ,3,13,16,39,76,115
04132600,WISCONSIN ACADEMY (THE)                 ,WI,54157-1726,Proprietary  ,2,5,7,18,43,61
04137900,BRENSTEN EDUCATION                      ,WI,53186-0000,Proprietary  ,6,103,109,42,619,661
04138200,SALON PROFESSIONAL ACADEMY (THE)        ,WI,54914-3921,Proprietary  ,7,11,18,57,80,137
04157700,SALON PROFESSIONAL ACADEMY (THE)        ,WI,54650-8699,Proprietary  ,12,16,28,54,90,144
04159400,COLUMBIA COLLEGE OF NURSING             ,WI,53211-2952,Private      ,13,19,32,213,299,512
04165300,ACADEMY WAUKESHA (THE)                  ,WI,53072-5524,Proprietary  ,15,23,38,101,138,239
04179200,ADVANCED COLLEGE OF COSMETOLOGY         ,WI,53963-0000,Proprietary  ,3,4,7,27,34,61
04182100,FIRST CLASS COSMETOLOGY SCHOOL          ,WI,52511-0000,Proprietary  ,2,19,21,38,101,139
04183600,SALON PROFESSIONAL ACADEMY OF KENOSHA (T,WI,53142-4950,Proprietary  ,4,11,15,75,164,239
04193800,SHEPHERDS COLLEGE                       ,WI,53182-1527,Private      ,0,1,1,61,17,78
04202800,PANACHE ACADEMY OF BEAUTY               ,WI,53913-2596,Proprietary  ,2,9,11,20,55,75
04219300,EAST-WEST HEALING ARTS INSTITUTE        ,WI,53719-1133,Proprietary  ,0,19,19,12,88,100
04237400,WRIGHT GRADUATE UNIVERSITY FOR THE REALI,WI,53121-2556,Private      ,2,18,20,2,18,20
00290500,NORTH CAROLINA A&T STATE UNIV           ,NC,27411-0001,Public       ,536,586,1122,16430,7600,24030
00290600,APPALACHIAN STATE UNIVERSITY            ,NC,28608-2059,Public       ,648,348,996,18796,5209,24005
00290700,UNIVERSITY OF NC AT ASHEVILLE           ,NC,28804-3299,Public       ,195,199,394,4806,2222,7028
00290800,BARTON COLLEGE                          ,NC,27893-3104,Private      ,65,74,139,1663,920,2583
00291000,BELMONT ABBEY COLLEGE                   ,NC,28012-1802,Private      ,49,91,140,1477,1186,2663
00291100,BENNETT COLLEGE                         ,NC,27401-3239,Private      ,34,58,92,1156,534,1690
00291200,BREVARD COLLEGE                         ,NC,28712-3306,Private      ,68,26,94,1396,260,1656
00291300,CAMPBELL UNIVERSITY                     ,NC,27506-0036,Private      ,208,349,557,5489,4656,10145
00291400,CATAWBA COLLEGE                         ,NC,28144-2488,Private      ,68,57,125,2132,715,2847
00291500,CENTRAL PIEDMONT COMMUNITY COLLEGE      ,NC,28204-2297,Public       ,975,2579,3554,11849,20598,32447
00291600,CHOWAN UNIVERSITY                       ,NC,27855-1850,Private      ,50,30,80,2464,490,2954
00291700,COLLEGE OF THE ALBEMARLE                ,NC,27909-2327,Public       ,88,262,350,1069,1826,2895
00291800,DAVIDSON COLLEGE                        ,NC,28035-7157,Private      ,118,33,151,3837,288,4125
00291900,DAVIDSON COUNTY COMMUNITY COLLEGE       ,NC,27293-0000,Public       ,147,537,684,2127,4891,7018
00292000,DUKE UNIVERSITY                         ,NC,27708-0397,Private      ,644,171,815,19680,2849,22529
00292001,DUKE UNIV - SCHOOL OF MEDICINE          ,NC,27710-0000,Private      ,31,47,78,258,1056,1314
00292002,DUKE UNIV - SCHOOL OF LAW               ,NC,27708-0000,Private      ,11,44,55,86,2012,2098
00292003,DUKE UNIV - GRAD SCH ARTS & SCIENCE     ,NC,27708-0000,Private      ,13,46,59,173,812,985
00292004,DUKE UNIV - FUQUA SCH OF BUSINESS       ,NC,27708-0000,Private      ,12,64,76,133,998,1131
00292005,DUKE UNIV/NICHOLAS SCH OF ENVIRON.      ,NC,27708-0000,Private      ,0,16,16,33,383,416
00292006,DUKE UNIV - DIVINITY SCHOOL             ,NC,27708-0000,Private      ,25,25,50,358,839,1197
00292007,DUKE UNIV - SCHOOL OF NURSING           ,NC,27710-0000,Private      ,17,133,150,251,1617,1868
00292010,DUKE UNIVERSITY - SCHOOL OF PUBLIC POLIC,NC,27708-0239,Private      ,2,9,11,46,236,282
00292300,EAST CAROLINA UNIVERSITY                ,NC,27858-1818,Public       ,896,946,1842,24969,13366,38335
00292600,ELIZABETH CITY STATE UNIVERSITY         ,NC,27909-7806,Public       ,61,110,171,2749,1414,4163
00292700,ELON UNIVERSITY                         ,NC,27244-2010,Private      ,275,120,395,7925,1418,9343
00292800,FAYETTEVILLE STATE UNIVERSITY           ,NC,28301-4298,Public       ,198,687,885,5572,8238,13810
00292900,GARDNER-WEBB UNIVERSITY                 ,NC,28017-0000,Private      ,75,375,450,3138,3790,6928
00293000,GREENSBORO COLLEGE                      ,NC,27401-1875,Private      ,83,146,229,1743,1267,3010
00293100,GUILFORD COLLEGE                        ,NC,27410-4171,Private      ,131,290,421,3103,2871,5974
00293300,HIGH POINT UNIVERSITY                   ,NC,27262-4221,Private      ,252,71,323,6379,918,7297
00293400,ISOTHERMAL COMMUNITY COLLEGE            ,NC,28160-0804,Public       ,57,167,224,935,1519,2454
00293500,LAUREL UNIVERSITY                       ,NC,27265-3197,Private      ,2,17,19,93,319,412
00293600,JOHNSON C SMITH UNIVERSITY              ,NC,28216-5398,Private      ,114,235,349,2693,2038,4731
00293700,KING'S COLLEGE-CHARLOTTE                ,NC,28204-2435,Proprietary  ,43,96,139,838,873,1711
00293900,LEES MCRAE COLLEGE                      ,NC,28604-0000,Private      ,33,34,67,1170,525,1695
00294000,LENOIR COMMUNITY COLLEGE                ,NC,28502-0188,Public       ,77,315,392,1206,2865,4071
00294100,LENOIR-RHYNE UNIVERSITY                 ,NC,28603-0000,Private      ,132,111,243,2885,1374,4259
00294200,LIVINGSTONE COLLEGE                     ,NC,28144-5298,Private      ,65,52,117,1870,705,2575
00294300,LOUISBURG COLLEGE                       ,NC,27549-2398,Private      ,55,31,86,1288,268,1556
00294400,MARS HILL COLLEGE                       ,NC,28754-0000,Private      ,56,43,99,2336,548,2884
00294500,MEREDITH COLLEGE                        ,NC,27607-5298,Private      ,91,124,215,2298,1070,3368
00294600,METHODIST UNIVERSITY                    ,NC,28311-1420,Private      ,101,205,306,3141,2292,5433
00294700,MITCHELL COMMUNITY COLLEGE              ,NC,28677-5264,Public       ,96,283,379,1328,2291,3619
00294800,MONTREAT COLLEGE                        ,NC,28757-1267,Private      ,24,66,90,593,731,1324
00294900,UNIVERSITY OF MOUNT OLIVE               ,NC,28365-1299,Private      ,78,397,475,1568,4168,5736
00295000,NORTH CAROLINA CENTRAL UNIVERSITY       ,NC,27707-3198,Public       ,398,543,941,10648,7899,18547
00295100,NORTH CAROLINA WESLEYAN COLLEGE         ,NC,27804-8699,Private      ,61,156,217,1565,1931,3496
00295300,WILLIAM PEACE UNIVERSITY                ,NC,27604-1194,Private      ,69,82,151,1501,938,2439
00295400,UNIV OF NORTH CAROLINA AT PEMBROKE      ,NC,28372-1510,Public       ,265,326,591,7137,4537,11674
00295500,PFEIFFER UNIVERSITY                     ,NC,28109-0000,Private      ,27,114,141,1036,1356,2392
00295600,PIEDMONT INTERNATIONAL UNIVERSITY       ,NC,27101-5025,Private      ,11,19,30,162,245,407
00295700,QUEENS UNIVERSITY OF CHARLOTTE          ,NC,28274-0001,Private      ,103,328,431,2654,2556,5210
00295800,ROCKINGHAM COMMUNITY COLLEGE            ,NC,27375-0000,Public       ,76,209,285,967,1547,2514
00296000,SALEM COLLEGE                           ,NC,27108-0000,Private      ,41,75,116,1035,936,1971
00296100,SANDHILLS COMMUNITY COLLEGE             ,NC,28374-8283,Public       ,146,416,562,1918,3476,5394
00296200,SHAW UNIVERSITY                         ,NC,27601-2393,Private      ,105,194,299,3206,2256,5462
00296300,SOUTHEASTERN BAPTIST THEOL SEMINARY     ,NC,27588-0000,Private      ,12,22,34,153,307,460
00296400,SOUTHEASTERN COMMUNITY COLLEGE          ,NC,28472-5422,Public       ,49,168,217,744,1163,1907
00296800,ST AUGUSTINES COLLEGE                   ,NC,27610-2298,Private      ,49,81,130,1885,892,2777
00297000,SURRY COMMUNITY COLLEGE                 ,NC,27017-0304,Public       ,83,221,304,1456,1824,3280
00297200,NORTH CAROLINA STATE UNIV-RALEIGH       ,NC,27695-7001,Public       ,889,916,1805,28655,11903,40558
00297300,GASTON COLLEGE                          ,NC,28034-1499,Public       ,198,580,778,2502,4892,7394
00297400,UNIVERSITY OF N C-CHAPEL HILL           ,NC,27514-0000,Public       ,976,753,1729,28354,13588,41942
00297500,UNIVERSITY OF NC AT CHARLOTTE           ,NC,28223-0001,Public       ,873,1178,2051,27473,15030,42503
00297600,UNIVERSITY OF N C - GREENSBORO          ,NC,27412-0001,Public       ,659,753,1412,17795,11431,29226
00297800,WAKE FOREST UNIV - UNDERGRADUATE        ,NC,27109-7246,Private      ,279,53,332,7562,570,8132
00297801,WAKE FOREST UNIV - SCH OF MEDICINE      ,NC,27157-1090,Private      ,21,38,59,163,1243,1406
00297803,WAKE FOREST GRAD SCHOOLS OF BUSINESS    ,NC,27109-7659,Private      ,7,47,54,50,757,807
00297805,WAKE FOREST UNIV - SCH OF LAW           ,NC,27109-7206,Private      ,5,16,21,44,1107,1151
00297806,WAKE FOREST UNIV - GRAD A&S/DIVINITY    ,NC,27109-7246,Private      ,3,42,45,40,812,852
00297900,WARREN WILSON COLLEGE                   ,NC,28815-0000,Private      ,45,40,85,1337,490,1827
00298000,WAYNE COMMUNITY COLLEGE                 ,NC,27533-0000,Public       ,131,413,544,1622,3411,5033
00298100,WESTERN CAROLINA UNIVERSITY             ,NC,28723-9731,Public       ,382,358,740,10828,4487,15315
00298200,WESTERN PIEDMONT COMMUNITY COLLEGE      ,NC,28655-4504,Public       ,84,176,260,1151,1679,2830
00298300,WILKES COMMUNITY COLLEGE                ,NC,28697-2100,Public       ,89,194,283,1196,1576,2772
00298400,UNIVERSITY OF N C-WILMINGTON            ,NC,28403-3297,Public       ,591,530,1121,16328,6782,23110
00298500,WINGATE UNIVERSITY                      ,NC,28174-0159,Private      ,275,84,359,4672,1548,6220
00298600,WINSTON-SALEM STATE UNIVERSITY          ,NC,27102-0000,Public       ,279,465,744,7568,5659,13227
00398100,UNC SCHOOL OF THE ARTS                  ,NC,27127-2188,Public       ,60,32,92,1579,501,2080
00403300,ASHEVILLE BUNCOMBE TECH CMTY CLG        ,NC,28801-4897,Public       ,224,652,876,2739,5913,8652
00406200,PITT COMMUNITY COLLEGE                  ,NC,28590-0000,Public       ,319,833,1152,4950,8393,13343
00483500,CALDWELL COMMUNITY CLG & TECH INST      ,NC,28638-2626,Public       ,132,263,395,1602,2426,4028
00483800,GUILFORD TECHNICAL COMMUNITY CLG        ,NC,27282-0309,Public       ,522,1385,1907,6854,13493,20347
00484400,WAKE TECHNICAL COMMUNITY COLLEGE        ,NC,27603-5696,Public       ,836,2140,2976,10439,19247,29686
00484500,WILSON COMMUNITY COLLEGE                ,NC,27893-3310,Public       ,58,226,284,782,2177,2959
00499201,MILLER-MOTTE TECHNICAL COLLEGE - MILLER-,NC,27511-9209,Proprietary  ,16,106,122,129,660,789
00499202,MILLER-MOTTE TECHNICAL COLLEGE - MILLER-,NC,27604-6072,Proprietary  ,34,229,263,393,1649,2042
00499203,MILLER-MOTTE TECHNICAL COLLEGE - FAYETTE,NC,28311-7651,Proprietary  ,48,336,384,403,2371,2774
00499205,MILLER-MOTTE TECHNICAL COLLEGE - MILLER-,NC,28540-5901,Proprietary  ,23,178,201,144,1122,1266
00531600,COASTAL CAROLINA COMMUNITY COLLEGE      ,NC,28546-6816,Public       ,135,802,937,1701,5620,7321
00531700,FORSYTH TECHNICAL COMMUNITY COLLEGE     ,NC,27103-5197,Public       ,356,1056,1412,4478,9610,14088
00531800,CATAWBA VALLEY COMMUNITY COLLEGE        ,NC,28602-8302,Public       ,183,373,556,2609,3671,6280
00532000,CAPE FEAR COMMUNITY COLLEGE             ,NC,28401-3910,Public       ,382,838,1220,4755,7087,11842
00544700,RANDOLPH COMMUNITY COLLEGE              ,NC,27204-1009,Public       ,87,304,391,1343,2496,3839
00544800,DURHAM TECHNICAL CMNTY COLLEGE          ,NC,27703-5023,Public       ,210,750,960,2346,6468,8814
00544900,CENTRAL CAROLINA COMMUNITY COLLEGE      ,NC,27330-9000,Public       ,169,518,687,1929,4500,6429
00546300,ALAMANCE COMMUNITY COLLEGE              ,NC,27253-0000,Public       ,183,473,656,1982,3926,5908
00546400,RICHMOND COMMUNITY COLLEGE              ,NC,28345-4522,Public       ,79,216,295,962,2154,3116
00575400,ROWAN-CABARRUS COMMUNITY COLLEGE        ,NC,28146-8357,Public       ,198,591,789,2528,5685,8213
00647700,CABARRUS COLLEGE OF HEALTH SCIENCES     ,NC,28025-0000,Private      ,27,112,139,406,945,1351
00647800,MERCY HOSP SCH OF NURSING               ,NC,28207-0000,Public       ,11,70,81,195,876,1071
00648300,WATTS SCHOOL OF NURSING                 ,NC,27704-0000,Private      ,6,37,43,109,420,529
00679900,CRAVEN COMMUNITY COLLEGE                ,NC,28562-0000,Public       ,107,454,561,1070,3671,4741
00703100,PAMLICO COMMUNITY COLLEGE               ,NC,28529-0000,Public       ,12,39,51,95,347,442
00764000,FAYETTEVILLE TECHNICAL CMTY COLLEGE     ,NC,28303-0236,Public       ,416,1947,2363,4246,16165,20411
00768700,JAMES SPRUNT COMMUNITY COLLEGE          ,NC,28349-0398,Public       ,42,106,148,417,1139,1556
00781400,BROOKSTONE COLLEGE OF BUSINESS          ,NC,28262-1294,Proprietary  ,16,112,128,128,696,824
00781401,BROOKSTONE COLLEGE OF BUSINESS          ,NC,27409-0000,Proprietary  ,21,77,98,100,506,606
00789200,SAMPSON COMMUNITY COLLEGE               ,NC,28328-0000,Public       ,41,117,158,639,1320,1959
00798500,SOUTH PIEDMONT COMMUNITY COLLEGE        ,NC,28135-9703,Public       ,86,224,310,985,1863,2848
00798600,HALIFAX COMMUNITY COLLEGE               ,NC,27890-0089,Public       ,41,125,166,558,1199,1757
00798700,BLADEN COMMUNITY COLLEGE                ,NC,28332-0266,Public       ,44,155,199,600,1570,2170
00798800,MARTIN COMMUNITY COLLEGE                ,NC,27892-8307,Public       ,24,76,100,318,732,1050
00808100,CARTERET COMMUNITY COLLEGE              ,NC,28557-2989,Public       ,54,208,262,644,1611,2255
00808200,CLEVELAND COMMUNITY COLLEGE             ,NC,28150-0000,Public       ,70,299,369,1063,2542,3605
00808300,HAYWOOD COMMUNITY COLLEGE               ,NC,28721-0000,Public       ,59,170,229,659,1570,2229
00808500,MCDOWELL TECHNICAL COMMUNITY CLG        ,NC,28752-8728,Public       ,33,104,137,369,854,1223
00808700,MONTGOMERY COMMUNITY COLLEGE            ,NC,27371-0787,Public       ,20,78,98,345,750,1095
00846600,SOUTHWESTERN COMMUNITY COLLEGE          ,NC,28779-8581,Public       ,64,210,274,945,1749,2694
00855700,NASH COMMUNITY COLLEGE                  ,NC,27804-0488,Public       ,129,375,504,1566,3445,5011
00855800,BEAUFORT COUNTY COMMUNITY COLLEGE       ,NC,27889-7889,Public       ,52,202,254,770,2006,2776
00861200,ROBESON COMMUNITY COLLEGE               ,NC,28359-2151,Public       ,108,342,450,1196,2904,4100
00861300,ROANOKE-CHOWAN COMMUNITY COLLEGE        ,NC,27910-9522,Public       ,21,85,106,346,799,1145
00885500,EDGECOMBE COMMUNITY COLLEGE             ,NC,27886-9399,Public       ,72,384,456,867,3498,4365
00933600,JOHNSTON COMMUNITY COLLEGE              ,NC,27577-0000,Public       ,129,406,535,1790,3631,5421
00943000,TRI-COUNTY COMMUNITY COLLEGE            ,NC,28906-7919,Public       ,28,111,139,383,856,1239
00964600,PIEDMONT COMMUNITY COLLEGE              ,NC,27573-1197,Public       ,45,136,181,527,1146,1673
00968400,BLUE RIDGE COMMUNITY COLLEGE            ,NC,28731-9624,Public       ,66,185,251,747,1657,2404
00974701,GORDON-CONWELL THEO SEM - CHARLOTTE     ,NC,28273-0000,Private      ,2,34,36,12,299,311
00990300,VANCE-GRANVILLE CMTY COLLEGE            ,NC,27536-0917,Public       ,108,341,449,1270,2968,4238
01019804,ECPI UNIVERSITY - GREENSBORO            ,NC,27409-9048,Proprietary  ,25,139,164,225,995,1220
01019805,ECPI UNIVERSITY - CHARLOTTE             ,NC,28208-5886,Proprietary  ,46,288,334,372,1976,2348
01019810,ECPI UNIVERSITY - RALEIGH               ,NC,27613-7387,Proprietary  ,53,275,328,340,1507,1847
01019812,ECPI UNIVERSITY - CONCORD               ,NC,28262-0000,Proprietary  ,19,111,130,138,662,800
01026400,SOUTH COLLEGE                           ,NC,28803-3152,Proprietary  ,18,101,119,159,746,905
01119400,STANLY COMMUNITY COLLEGE                ,NC,28001-7458,Public       ,62,237,299,941,2332,3273
01119700,MAYLAND COMMUNITY COLLEGE               ,NC,28777-2777,Public       ,26,57,83,375,572,947
01179900,PAUL MITCHELL THE SCHOOL FAYETTEVILLE   ,NC,28303-5364,Proprietary  ,22,88,110,187,542,729
01192600,LEON'S BEAUTY SCHOOL                    ,NC,27403-2812,Proprietary  ,20,55,75,180,392,572
01303918,SOUTH UNIVERSITY - THE ART INSTITUTE OF ,NC,28217-4536,Proprietary  ,173,179,352,1611,1428,3039
02056500,MITCHELL'S HAIR STYLING ACADEMY         ,NC,27893-0000,Proprietary  ,4,17,21,34,102,136
02056501,MITCHELL'S HAIR STYLING ACADEMY - MITCHE,NC,27606-3326,Proprietary  ,19,25,44,91,284,375
02110502,ART INSTITUTE OF CHARLOTTE (THE) - THE A,NC,27701-3986,Proprietary  ,0,1,1,0,1,1
02158414,HARRISON COLLEGE - THE CHEF'S ACADEMY - ,NC,27560-0000,Proprietary  ,20,42,62,121,259,380
02170700,BRUNSWICK COMMUNITY COLLEGE             ,NC,28422-0000,Public       ,45,147,192,757,1185,1942
02205000,COLLEGE OF WILMINGTON                   ,NC,28403-0000,Proprietary  ,23,133,156,225,690,915
02210400,FAYETTEVILLE BEAUTY COLLEGE             ,NC,28303-0000,Proprietary  ,8,68,76,104,472,576
02227800,MITCHELL'S HAIR STYLING ACADEMY         ,NC,27534-0000,Proprietary  ,7,12,19,30,94,124
02227900,MITCHELL'S HAIR STYLING ACADEMY         ,NC,27858-0000,Proprietary  ,0,0,0,17,42,59
02280900,MID-ATLANTIC CHRISTIAN UNIVERSITY       ,NC,27909-0000,Private      ,13,16,29,196,206,402
02326203,KAPLAN CAREER INSTITUTE - KAPLAN COLLEGE,NC,28212-6830,Proprietary  ,30,268,298,278,1774,2052
02558900,CHEVEUX SCHOOL OF HAIR DESIGN           ,NC,28540-0000,Proprietary  ,0,0,0,10,76,86
02560600,PINNACLE INSTITUTE OF COSMETOLOGY       ,NC,28115-8020,Proprietary  ,3,12,15,39,106,145
02614201,MILLER-MOTTE BUSINESS COLLEGE           ,NC,28403-0000,Proprietary  ,92,635,727,556,5194,5750
02614205,MILLER - MOTTE TECHNICAL COLLEGE - MILLE,NC,27834-5052,Proprietary  ,16,123,139,228,1054,1282
03009500,WINSTON-SALEM BARBER SCHOOL             ,NC,27107-0000,Proprietary  ,6,32,38,55,168,223
03064400,REGENCY BEAUTY INSTITUTE                ,NC,27127-0000,Proprietary  ,15,41,56,149,344,493
03089300,HERITAGE BIBLE COLLEGE                  ,NC,28335-0000,Private      ,5,9,14,27,84,111
03104200,CAROLINAS COLLEGE OF HEALTH SCIENCE     ,NC,28232-2861,Public       ,30,170,200,551,1619,2170
03109000,LIVING ARTS COLLEGE                     ,NC,27614-7076,Proprietary  ,59,111,170,482,755,1237
03361300,MEDICAL ARTS MASSAGE SCHOOL             ,NC,27616-6453,Proprietary  ,14,60,74,102,455,557
03513400,APEX SCHOOL OF THEOLOGY                 ,NC,27703-8024,Private      ,9,103,112,35,1259,1294
03555300,SOUTHEASTERN INSTITUTE                  ,NC,28217-0000,Proprietary  ,15,117,132,128,730,858
03570300,CAROLINA CHRISTIAN COLLEGE              ,NC,27105-3241,Private      ,5,23,28,42,157,199
03663300,HOOD THEOLOGICAL SEMINARY               ,NC,28144-5768,Private      ,0,10,10,2,211,213
03748500,DURHAM BEAUTY ACADEMY                   ,NC,27707-3569,Proprietary  ,5,31,36,44,210,254
03777300,PAUL MITCHELL THE SCHOOL GASTONIA       ,NC,28054-0460,Proprietary  ,39,74,113,232,468,700
03827300,CHARLOTTE CHRISTIAN COLLEGE AND THEOLOGI,NC,28205-1648,Private      ,2,37,39,16,290,306
04073300,JUNG TAO SCHOOL OF CLASSICAL CHINESE MED,NC,28679-9657,Private      ,0,0,0,3,65,68
04101300,CAROLINA SCHOOL OF BROADCASTING         ,NC,28214-8085,Proprietary  ,16,49,65,154,372,526
04115700,REGINA'S COLLEGE OF BEAUTY              ,NC,28110-2831,Proprietary  ,3,25,28,44,199,243
04120300,HEALTH AND STYLE INSTITUTE              ,NC,27265-3114,Proprietary  ,16,86,102,94,334,428
04129400,CENTER FOR MASSAGE & NATURAL HEALTH     ,NC,28787-8331,Proprietary  ,4,24,28,19,117,136
04140700,AVEDA INSTITUTE CHAPEL HILL             ,NC,27516-2559,Proprietary  ,30,53,83,172,282,454
04143500,CHARLOTTE SCHOOL OF LAW                 ,NC,28208-2816,Proprietary  ,6,93,99,83,2350,2433
04146400,DAOIST TRADITIONS COLLEGE OF CHINESE MED,NC,28801-1060,Proprietary  ,0,10,10,7,132,139
04149300,PARK WEST BARBER SCHOOL                 ,NC,27701-4022,Proprietary  ,30,159,189,183,858,1041
04154200,CAROLINA COLLEGE OF BIBLICAL STUDIES    ,NC,29303-5157,Private      ,6,24,30,29,326,355
04172800,BODY THERAPY INSTITUTE                  ,NC,27344-6728,Proprietary  ,1,9,10,15,101,116
04173000,SHEPHERDS THEOLOGICAL SEMINARY          ,NC,27518-9316,Private      ,2,2,4,6,32,38
04173700,GRACE COLLEGE OF DIVINITY               ,NC,28314-2343,Private      ,3,14,17,33,162,195
04178100,CAROLINA COLLEGE OF HAIR DESIGN         ,NC,28802-1232,Proprietary  ,6,12,18,49,135,184
04204700,PAUL MITCHELL THE SCHOOL RALEIGH        ,NC,27612-7358,Proprietary  ,20,39,59,137,286,423
04206500,MYCOMPUTERCAREER.COM                    ,NC,27606-3365,Proprietary  ,20,135,155,64,597,661
04214600,GRACE COLLEGE OF BARBERING              ,NC,28513-7178,Private      ,0,10,10,13,60,73
04219100,ALEXANDER PAUL INSTITUTE OF HAIR DESIGN ,NC,27858-3344,Proprietary  ,6,9,15,38,73,111
04227600,SHERRILL'S UNIVERSITY OF BARBER & COSMET,NC,27610-2431,Proprietary  ,11,47,58,51,176,227
04228400,BEYOND MEASURE BARBERING INSTITUTE      ,NC,27302-2323,Proprietary  ,0,15,15,11,69,80
00298800,BISMARCK STATE COLLEGE                  ,ND,58501-1299,Public       ,55,175,230,1891,1509,3400
00298900,DICKINSON STATE UNIVERSITY              ,ND,58601-4896,Public       ,29,40,69,868,592,1460
00299000,JAMESTOWN COLLEGE                       ,ND,58405-3401,Private      ,46,11,57,980,210,1190
00299100,LAKE REGION STATE COLLEGE               ,ND,58301-1598,Public       ,14,55,69,406,482,888
00299200,UNIVERSITY OF MARY                      ,ND,58504-9652,Private      ,38,118,156,1711,1347,3058
00299300,MAYVILLE STATE UNIVERSITY               ,ND,58257-1299,Public       ,11,23,34,740,338,1078
00299400,MINOT STATE UNIVERSITY                  ,ND,58707-0001,Public       ,58,134,192,1577,1412,2989
00299500,DAKOTA COLLEGE AT BOTTINEAU             ,ND,58318-1159,Public       ,10,16,26,436,288,724
00299600,NORTH DAKOTA STATE CLG OF SCIENCE       ,ND,58076-0002,Public       ,48,64,112,1754,744,2498
00299700,NORTH DAKOTA STATE UNIVERSITY           ,ND,58108-6050,Public       ,211,228,439,10319,3271,13590
00300500,UNIVERSITY OF NORTH DAKOTA              ,ND,58202-8193,Public       ,170,396,566,8455,5807,14262
00300700,WILLISTON STATE COLLEGE                 ,ND,58802-1326,Public       ,18,52,70,305,418,723
00300800,VALLEY CITY STATE UNIVERSITY            ,ND,58072-0000,Public       ,17,19,36,820,391,1211
00775600,JOSEF'S SCHOOL OF HAIR DESIGN INC       ,ND,58102-4977,Proprietary  ,10,16,26,73,81,154
00869408,RASMUSSEN COLLEGE - FARGO               ,ND,58103-7196,Proprietary  ,19,75,94,175,669,844
00869415,RASMUSSEN COLLEGE - BISMARCK            ,ND,58503-0000,Proprietary  ,3,27,30,43,278,321
00935400,MEDCENTER ONE COLLEGE OF NURSING        ,ND,58501-4494,Private      ,1,9,10,99,89,188
01040600,JOSEF'S SCHOOL OF HAIR DESIGN           ,ND,58201-6394,Proprietary  ,14,17,31,74,99,173
01205900,TRINITY BIBLE COLLEGE                   ,ND,58436-7150,Private      ,3,3,6,218,94,312
01229500,JZ TREND ACADEMY PAUL MITCHELL PARTNER S,ND,58501-0000,Proprietary  ,2,11,13,47,53,100
02188200,SITTING BULL COLLEGE                    ,ND,58538-9701,Public       ,4,32,36,77,322,399
02236500,LITTLE HOOP COMMUNITY COLLEGE           ,ND,58335-0000,Public       ,2,11,13,37,151,188
02242900,UNITED TRIBES TECHNICAL COLLEGE         ,ND,58504-0000,Private      ,27,85,112,287,700,987
02298200,HEADQUARTERS ACADEMY OF HAIR DESIGN     ,ND,58701-0000,Proprietary  ,4,9,13,35,79,114
02301100,TURTLE MTN CMNTY COLG-FIN AID OFC       ,ND,58316-0000,Private      ,14,46,60,215,471,686
02553700,FORT BERTHOLD COMMUNITY COLLEGE         ,ND,58763-0000,Public       ,2,28,30,32,128,160
03087200,MOLER BARBER CLG OF HAIRSTYLING         ,ND,58103-0000,Proprietary  ,0,5,5,9,30,39
04031300,SALON PROFESSIONAL ACADEMY (THE)        ,ND,58103-3337,Proprietary  ,5,12,17,82,77,159
04139400,HAIR ACADEMY (THE)                      ,ND,58501-4929,Proprietary  ,2,9,11,39,57,96
04223500,LYNNES WELDING TRAINING                 ,ND,58102-4018,Proprietary  ,3,9,12,28,47,75
00301005,ANTIOCH UNIV/SEATTLE                    ,WA,98121-0000,Private      ,10,104,114,136,1343,1479
00376900,BELLEVUE COLLEGE                        ,WA,98007-6484,Public       ,364,871,1235,5901,8416,14317
00377000,BIG BEND COMMUNITY COLLEGE              ,WA,98837-3299,Public       ,78,223,301,1266,1827,3093
00377100,CENTRAL WASHINGTON UNIVERSITY           ,WA,98926-7495,Public       ,419,427,846,13035,7021,20056
00377200,CENTRALIA COLLEGE                       ,WA,98531-4099,Public       ,74,280,354,1454,2351,3805
00377300,CLARK COLLEGE                           ,WA,98663-3598,Public       ,384,987,1371,5738,9749,15487
00377400,COLUMBIA BASIN COLLEGE                  ,WA,99301-3379,Public       ,244,502,746,3815,4994,8809
00377500,EASTERN WASHINGTON UNIVERSITY           ,WA,99004-2447,Public       ,404,438,842,13427,8228,21655
00377600,EVERETT COMMUNITY COLLEGE               ,WA,98201-1352,Public       ,278,933,1211,4249,8003,12252
00377700,HERITAGE UNIVERSITY                     ,WA,98948-9562,Private      ,18,90,108,736,1636,2372
00377800,GONZAGA UNIVERSITY                      ,WA,99258-0083,Private      ,222,260,482,8790,3980,12770
00377900,GRAYS HARBOR COLLEGE                    ,WA,98520-7599,Public       ,62,227,289,892,1833,2725
00378000,GREEN RIVER COMMUNITY COLLEGE           ,WA,98092-3622,Public       ,286,704,990,3828,6144,9972
00378100,HIGHLINE COMMUNITY COLLEGE              ,WA,98198-9800,Public       ,290,788,1078,4086,6673,10759
00378200,LOWER COLUMBIA COLLEGE                  ,WA,98632-0310,Public       ,100,444,544,1435,3526,4961
00378300,NORTHWEST UNIVERSITY                    ,WA,98083-0000,Private      ,67,160,227,1671,1422,3093
00378400,OLYMPIC COLLEGE                         ,WA,98337-1600,Public       ,176,699,875,2512,6445,8957
00378500,PACIFIC LUTHERAN UNIVERSITY             ,WA,98447-0003,Private      ,130,178,308,5094,2649,7743
00378600,PENINSULA COLLEGE                       ,WA,98362-6660,Public       ,64,238,302,747,2064,2811
00378700,SEATTLE CENTRAL COMMUNITY COLLEGE       ,WA,98122-2413,Public       ,282,948,1230,4109,8411,12520
00378703,SEATTLE VOCATIONAL INSTITUTE            ,WA,98144-0000,Public       ,19,122,141,207,900,1107
00378800,SEATTLE PACIFIC UNIVERSITY              ,WA,98119-1997,Private      ,280,270,550,7959,3634,11593
00379000,SEATTLE UNIVERSITY                      ,WA,98122-1090,Private      ,401,430,831,10490,7406,17896
00379100,SHORELINE COMMUNITY COLLEGE             ,WA,98133-5696,Public       ,187,607,794,3065,5813,8878
00379200,SKAGIT VALLEY COLLEGE                   ,WA,98273-5899,Public       ,125,499,624,2031,3968,5999
00379300,SPOKANE COMMUNITY COLLEGE               ,WA,99207-5399,Public       ,306,1091,1397,4753,10672,15425
00379400,ST MARTIN'S UNIVERSITY                  ,WA,98503-7500,Private      ,33,92,125,1547,1464,3011
00379600,TACOMA COMMUNITY COLLEGE                ,WA,98466-6100,Public       ,355,1247,1602,4780,11644,16424
00379700,UNIVERSITY OF PUGET SOUND               ,WA,98416-1039,Private      ,185,199,384,5831,2429,8260
00379800,UNIVERSITY OF WASHINGTON                ,WA,98195-1122,Public       ,1509,1741,3250,41536,32445,73981
00379900,WALLA WALLA UNIVERSITY                  ,WA,99324-1198,Private      ,55,50,105,2035,809,2844
00380000,WASHINGTON STATE UNIVERSITY             ,WA,99164-1035,Public       ,935,890,1825,30801,15671,46472
00380100,WENATCHEE VALLEY COLLEGE                ,WA,98801-1799,Public       ,98,306,404,2028,2753,4781
00380200,WESTERN WASHINGTON UNIVERSITY           ,WA,98225-5946,Public       ,652,363,1015,19020,5819,24839
00380300,WHITMAN COLLEGE                         ,WA,99362-2067,Private      ,94,15,109,3041,199,3240
00380400,WHITWORTH UNIVERSITY                    ,WA,99251-0001,Private      ,111,130,241,4489,1699,6188
00380500,YAKIMA VALLEY COMMUNITY COLLEGE         ,WA,98907-2520,Public       ,157,431,588,3267,5051,8318
00499900,BELLINGHAM TECHNICAL COLLEGE            ,WA,98225-0000,Public       ,92,368,460,1299,3193,4492
00500000,PIERCE COLLEGE                          ,WA,98498-1919,Public       ,297,1030,1327,4086,9311,13397
00500100,EDMONDS COMMUNITY COLLEGE               ,WA,98036-5999,Public       ,195,550,745,3025,5571,8596
00500600,WALLA WALLA COMMUNITY COLLEGE           ,WA,99362-9267,Public       ,104,258,362,2058,2865,4923
00530600,BATES TECHNICAL COLLEGE                 ,WA,98405-0000,Public       ,97,666,763,1310,4783,6093
00537200,SOUTH PUGET SOUND COMMUNITY COLLEGE     ,WA,98512-6292,Public       ,211,634,845,2566,5663,8229
00537300,LAKE WASHINGTON TECHNICAL COLLEGE       ,WA,98034-8505,Public       ,69,295,364,1054,3008,4062
00575200,CLOVER PARK TECHNICAL COLLEGE           ,WA,98499-0000,Public       ,170,761,931,1765,6619,8384
00815500,EVERGREEN STATE COLLEGE (THE)           ,WA,98505-0002,Public       ,192,322,514,3887,4870,8757
00907901,EVEREST COLLEGE                         ,WA,98684-6950,Proprietary  ,27,109,136,217,769,986
00938700,PERRY TECHNICAL INSTITUTE               ,WA,98903-1239,Private      ,76,137,213,898,1275,2173
00954400,SPOKANE FALLS COMMUNITY COLLEGE         ,WA,99224-5204,Public       ,292,778,1070,4991,7812,12803
00970400,NORTH SEATTLE COMMUNITY COLLEGE         ,WA,98103-3599,Public       ,151,667,818,2380,6363,8743
00970600,SOUTH SEATTLE COMMUNITY COLLEGE         ,WA,98106-1499,Public       ,155,613,768,2755,5561,8316
00973900,GLEN DOW ACAD OF HAIR DESIGN            ,WA,99201-0209,Proprietary  ,11,53,64,151,334,485
01036400,WHATCOM COMMUNITY COLLEGE               ,WA,98226-8003,Public       ,154,378,532,2494,3578,6072
01043400,RENTON TECHNICAL COLLEGE                ,WA,98056-0000,Public       ,110,475,585,1374,3819,5193
01148100,DIVERS INSTITUTE OF TECHNOLOGY          ,WA,98107-0000,Proprietary  ,35,128,163,203,696,899
01231500,CORNISH COLLEGE OF THE ARTS             ,WA,98121-4604,Private      ,65,35,100,1663,561,2224
01249600,TONI & GUY HAIRDRESSING ACADEMY         ,WA,98133-5615,Proprietary  ,5,24,29,36,65,101
01302200,CITY UNIVERSITY OF SEATTLE              ,WA,98005-0000,Private      ,18,244,262,332,2590,2922
02105300,EVERGREEN BEAUTY AND BARBER COLLEGE     ,WA,98007-3722,Proprietary  ,11,27,38,89,204,293
02106700,TRINITY LUTHERAN COLLEGE                ,WA,98201-3569,Private      ,11,15,26,310,177,487
02180000,NORTHWEST INDIAN COLLEGE                ,WA,98226-9278,Public       ,22,87,109,244,926,1170
02184200,PAROBA COLLEGE OF COSMETOLOGY           ,WA,98208-0000,Proprietary  ,15,53,68,79,250,329
02202200,STYLEMASTERS COLLEGE OF HAIR DESIGN     ,WA,98632-0000,Proprietary  ,4,38,42,44,196,240
02203300,GENE JUAREZ BEAUTY SCHOOLS              ,WA,98043-5427,Proprietary  ,33,68,101,278,470,748
02222900,INTERNATIONAL AIR & HOSPITALITY ACADEMY ,WA,98661-4835,Proprietary  ,60,147,207,379,797,1176
02236800,PROFESSIONAL BEAUTY SCHOOL              ,WA,98902-0000,Proprietary  ,4,15,19,78,153,231
02242500,BASTYR UNIVERSITY                       ,WA,98028-0000,Private      ,8,109,117,228,1880,2108
02291300,ART INSTITUTE OF SEATTLE                ,WA,98121-1622,Proprietary  ,229,270,499,2212,2313,4525
02300100,EVEREST COLLEGE                         ,WA,98367-1835,Proprietary  ,19,77,96,162,539,701
02300103,EVEREST COLLEGE - EVERETT               ,WA,98208-2610,Proprietary  ,34,143,177,309,921,1230
02300104,EVEREST COLLEGE - TACOMA                ,WA,98402-3004,Proprietary  ,57,290,347,483,1946,2429
02326500,INTERFACE COLLEGE                       ,WA,99201-4326,Proprietary  ,7,48,55,44,302,346
02331400,NORTHWEST HAIR ACADEMY                  ,WA,98273-0000,Proprietary  ,8,23,31,55,147,202
02331402,NORTHWEST HAIR ACADEMY - EVERETT        ,WA,98204-0000,Proprietary  ,8,16,24,36,125,161
02331403,NORTHWEST HAIR ACADEMY - BELLINGHAM     ,WA,98226-5515,Proprietary  ,4,19,23,17,70,87
02331404,NORTHWEST HAIR ACADEMY - YAKIMA         ,WA,98901-2305,Proprietary  ,3,10,13,20,68,88
02504900,ACADEMY OF HAIR DESIGN (THE)            ,WA,98801-0000,Proprietary  ,3,9,12,52,127,179
02541900,BJ'S BEAUTY AND BARBER COLLEGE          ,WA,98409-0000,Proprietary  ,12,66,78,78,394,472
02602100,NORTHWEST COLLEGE OF ART & DESIGN       ,WA,98370-8625,Proprietary  ,8,6,14,182,95,277
02606200,EVEREST COLLEGE                         ,WA,98055-2990,Proprietary  ,32,120,152,291,836,1127
02617500,EVEREST COLLEGE                         ,WA,98133-9018,Proprietary  ,28,88,116,315,690,1005
03031406,INTERNATIONAL ACADEMY OF DESIGN & TECH  ,WA,98188-3319,Proprietary  ,16,53,69,318,601,919
03065000,LUCAS MARC ACADEMY                      ,WA,99352-9700,Proprietary  ,13,23,36,84,170,254
03071800,ITT TECHNICAL INSTITUTE                 ,WA,99216-1589,Proprietary  ,48,231,279,396,1784,2180
03071805,ITT TECHNICAL INSTITUTE - SEATTLE       ,WA,98168-3346,Proprietary  ,73,358,431,586,2551,3137
03099000,CORTIVA INSTITUTE - SEATTLE             ,WA,98109-5474,Proprietary  ,25,98,123,147,489,636
03110800,BAKKE GRADUATE UNIVERSITY               ,WA,98104-1222,Private      ,3,7,10,15,80,95
03139500,MONTESSORI SCHOOLS OF WASHINGTON        ,WA,98203-6600,Private      ,1,5,6,10,40,50
03280300,SEATTLE INST OF ORIENTAL MEDICINE       ,WA,98115-0000,Proprietary  ,3,21,24,52,191,243
03283300,NORTHWEST HVAC/R ASSOCIATION & TRAINING ,WA,99207-2125,Private      ,4,19,23,36,155,191
03466400,SEATTLE SCHOOL OF THEOLOGY AND PSYCHOLOG,WA,98121-1177,Private      ,8,41,49,109,558,667
03483500,CASCADIA COMMUNITY COLLEGE              ,WA,98011-9510,Public       ,114,184,298,1608,1872,3480
03490400,EMIL FRIES PIANO HOSPITAL & TRAININ     ,WA,98661-4323,Private      ,2,5,7,11,37,48
03670301,TONI&GUY HAIRDRESSING ACADEMY -         ,WA,98225-4526,Proprietary  ,8,22,30,83,164,247
03689400,FAITH EVANGELICAL COLLEGE & SEMINARY    ,WA,98407-2607,Private      ,3,40,43,32,401,433
03724300,DIGIPEN INSTITUTE OF TECHNOLOGY         ,WA,98052-5170,Proprietary  ,59,35,94,1302,558,1860
03917300,EVERGREEN BEAUTY AND BARBER COLLEGE     ,WA,98208-3759,Proprietary  ,30,71,101,167,465,632
03932500,TOTAL COSMETOLOGY TRAINING CENTER       ,WA,99217-6231,Proprietary  ,9,49,58,77,291,368
04120000,SUNNYSIDE BEAUTY ACADEMY                ,WA,98944-8711,Proprietary  ,2,5,7,13,49,62
04127200,VICTORIA'S ACADEMY OF COSMETOLOGY       ,WA,99336-3826,Proprietary  ,15,40,55,98,256,354
04130500,PACIFIC NORTHWEST UNIV OF HEALTH SCIENCE,WA,98901-1471,Private      ,8,22,30,79,720,799
04130800,CASCADE BEAUTY COLLEGE                  ,WA,98002-5504,Proprietary  ,5,16,21,40,130,170
04132800,INLAND MASSAGE INSTITUTE                ,WA,99218-5016,Proprietary  ,8,23,31,50,200,250
04149400,GARY MANUEL AVEDA INSTITUTE             ,WA,98122-3807,Proprietary  ,29,80,109,230,497,727
04155000,NORTHWEST SCHOOL OF WOODEN BOAT BUILDING,WA,98339-8706,Private      ,0,8,8,11,108,119
04161200,PINCHOT UNIVERSITY                      ,WA,98104-2617,Private      ,1,15,16,5,145,150
04170100,SALON PROFESSIONAL ACADEMY (THE)        ,WA,98409-7360,Proprietary  ,12,66,78,148,416,564
04172900,ACADEMY OF COSMETOLOGY                  ,WA,99354-2651,Proprietary  ,5,10,15,64,115,179
04188900,NORTHWEST INSTITUTE OF LITERARY ARTS    ,WA,98249-0000,Private      ,1,4,5,9,55,64
04191900,PAUL MITCHELL THE SCHOOL SPOKANE        ,WA,99037-5041,Proprietary  ,18,49,67,189,349,538
04223600,ACADEMY OF INTERACTIVE ENTERTAINMENT    ,WA,98109-4623,Private      ,9,39,48,198,223,421
04231000,STUDIO BEAUTY SCHOOL                    ,WA,99205-3357,Proprietary  ,4,18,22,12,47,59
00340100,BROWN UNIVERSITY                        ,RI,02912-9127,Private      ,527,68,595,19071,979,20050
00340101,BROWN UNIVERSITY - GRADUATE SCHOOL      ,RI,02912-1827,Private      ,5,85,90,78,1471,1549
00340102,BROWN MEDICAL SCHOOL                    ,RI,02912-0000,Private      ,8,11,19,64,567,631
00340200,BRYANT UNIVERSITY                       ,RI,02917-1284,Private      ,159,62,221,5729,624,6353
00340400,JOHNSON & WALES UNIVERSITY              ,RI,02903-3703,Private      ,478,391,869,19966,5035,25001
00340600,PROVIDENCE COLLEGE                      ,RI,02918-0001,Private      ,212,100,312,7966,1105,9071
00340700,RHODE ISLAND COLLEGE                    ,RI,02908-1991,Public       ,153,289,442,8572,5320,13892
00340800,COMMUNITY COLLEGE OF RI - WARWICK       ,RI,02906-0000,Public       ,508,1145,1653,10070,12578,22648
00340900,RHODE ISLAND SCHOOL OF DESIGN           ,RI,02903-2784,Private      ,129,48,177,2993,1039,4032
00341000,ROGER WILLIAMS UNIVERSITY               ,RI,02809-2921,Private      ,204,78,282,9180,1699,10879
00341100,SALVE REGINA UNIVERSITY                 ,RI,02840-4192,Private      ,95,52,147,4531,699,5230
00341400,UNIVERSITY OF RHODE ISLAND              ,RI,02881-0000,Public       ,543,269,812,24219,4630,28849
00659100,ST. JOSEPH HOSP SCH OF NURSING          ,RI,02904-5199,Private      ,3,24,27,101,345,446
00784400,SANFORD-BROWN INSTITUTE                 ,RI,02920-7807,Proprietary  ,0,0,0,5,17,22
00784500,NEW ENGLAND INSTITUTE OF TECHNOLOGY     ,RI,02886-0000,Private      ,170,311,481,2845,3184,6029
01246116,LINCOLN TECHNICAL INSTITUTE - LINCOLN   ,RI,02865-4211,Proprietary  ,43,113,156,418,966,1384
02531802,PAUL MITCHELL THE SCHOOL-CRANSTON       ,RI,02920-0000,Proprietary  ,15,27,42,147,169,316
02584400,NEW ENGLAND TRACTOR TRAILER TRAINING SCH,RI,02860-1752,Proprietary  ,39,332,371,136,1139,1275
03080000,NEWPORT SCHOOL OF HAIRDRESSING          ,RI,02860-4038,Proprietary  ,3,9,12,19,67,86
03732300,INTERNATIONAL YACHT RESTORATION SCH     ,RI,02840-6720,Private      ,2,3,5,51,61,112
04141200,TONI & GUY HAIRDRESSING ACADEMY         ,RI,02920-0000,Proprietary  ,17,32,49,128,147,275
04246000,MKG BEAUTY & BUSINESS                   ,RI,02920-4358,Proprietary  ,3,6,9,3,6,9
00294102,LENOIR-RHYNE UNIVERSITY - LUTHERAN THEOL,SC,29203-5863,Private      ,0,12,12,3,151,154
00341700,ALLEN UNIVERSITY                        ,SC,29204-1085,Private      ,53,79,132,1054,665,1719
00341800,ANDERSON UNIVERSITY                     ,SC,29621-4035,Private      ,93,129,222,3412,1506,4918
00341900,CHARLESTON SOUTHERN UNIVERSITY          ,SC,29406-2160,Private      ,183,270,453,4917,2813,7730
00342000,BENEDICT COLLEGE                        ,SC,29204-1086,Private      ,137,156,293,3694,1800,5494
00342100,BOB JONES UNIVERSITY                    ,SC,29614-1000,Proprietary  ,68,54,122,2689,485,3174
00342200,SOUTHERN WESLEYAN UNIVERSITY            ,SC,29630-1020,Private      ,24,168,192,950,1773,2723
00342300,THE CITADEL                             ,SC,29409-0002,Public       ,136,114,250,3354,1435,4789
00342400,CLAFLIN UNIVERSITY                      ,SC,29115-4498,Private      ,87,90,177,2805,1298,4103
00342500,CLEMSON UNIVERSITY                      ,SC,29634-0001,Public       ,632,368,1000,22289,4665,26954
00342600,UNIV OF SC AT SUMTER                    ,SC,29150-2498,Public       ,31,88,119,964,891,1855
00342700,COKER COLLEGE                           ,SC,29550-3797,Private      ,49,75,124,1304,1014,2318
00342800,COLLEGE OF CHARLESTON                   ,SC,29424-0100,Public       ,464,300,764,12814,3574,16388
00342900,COLUMBIA INTERNATIONAL UNIVERSITY       ,SC,29203-1599,Private      ,22,60,82,659,793,1452
00343000,COLUMBIA COLLEGE                        ,SC,29203-5998,Private      ,55,295,350,1207,2080,3287
00343100,CONVERSE COLLEGE                        ,SC,29302-1931,Private      ,42,62,104,1342,801,2143
00343200,ERSKINE COLLEGE                         ,SC,29639-0000,Private      ,17,13,30,798,80,878
00343201,ERSKINE THEOLOGICAL SEMINARY            ,SC,29639-0000,Private      ,0,8,8,3,91,94
00343400,FURMAN UNIVERSITY                       ,SC,29613-5253,Private      ,145,74,219,3804,633,4437
00343500,LANDER UNIVERSITY                       ,SC,29649-2099,Public       ,89,82,171,4026,1078,5104
00343600,LIMESTONE COLLEGE                       ,SC,29340-3799,Private      ,79,257,336,2327,3189,5516
00343800,MEDICAL UNIV OF SOUTH CAROLINA - FA     ,SC,29425-1760,Public       ,47,143,190,491,3662,4153
00343900,MORRIS COLLEGE                          ,SC,29150-3599,Private      ,51,59,110,1211,623,1834
00344000,NEWBERRY COLLEGE                        ,SC,29108-2197,Private      ,57,42,99,1785,435,2220
00344100,NORTH GREENVILLE COLLEGE                ,SC,29688-1892,Private      ,51,66,117,2796,634,3430
00344500,PRESBYTERIAN COLLEGE                    ,SC,29325-2503,Private      ,37,14,51,1770,456,2226
00344600,SOUTH CAROLINA STATE UNIVERSITY         ,SC,29117-4427,Public       ,162,195,357,5063,2738,7801
00344700,SPARTANBURG METHODIST COLLEGE           ,SC,29301-5899,Private      ,32,29,61,1474,321,1795
00344800,UNIVERSITY OF SOUTH CAROLINA            ,SC,29208-3999,Public       ,817,870,1687,31507,13976,45483
00344900,UNIVERSITY OF SOUTH CAROLINA AIKEN      ,SC,29801-6399,Public       ,117,151,268,3812,1956,5768
00345000,UNIV OF SC AT BEAUFORT                  ,SC,29902-0000,Public       ,82,139,221,2227,1461,3688
00345100,COASTAL CAROLINA UNIVERSITY             ,SC,29528-0000,Public       ,467,318,785,14783,3548,18331
00345300,UNIV OF SC AT LANCASTER                 ,SC,29721-0889,Public       ,47,72,119,1198,829,2027
00345400,UNIV OF SC SYSTEM SALKEHATCHIE          ,SC,29810-0617,Public       ,23,64,87,727,668,1395
00345500,VOORHEES COLLEGE                        ,SC,29042-0000,Private      ,28,15,43,790,312,1102
00345600,WINTHROP UNIVERSITY                     ,SC,29733-0001,Public       ,185,198,383,7011,2490,9501
00345700,WOFFORD COLLEGE                         ,SC,29303-3663,Private      ,57,38,95,2710,272,2982
00399000,FLORENCE-DARLINGTON TECH COLLEGE        ,SC,29501-0548,Public       ,240,736,976,3537,7109,10646
00399100,GREENVILLE TECHNICAL COLLEGE            ,SC,29607-2439,Public       ,493,1307,1800,8060,11949,20009
00399200,PIEDMONT TECHNICAL COLLEGE              ,SC,29648-1467,Public       ,150,565,715,2718,5720,8438
00399300,MIDLANDS TECHNICAL COLLEGE              ,SC,29202-0000,Public       ,460,1156,1616,8235,11783,20018
00399400,SPARTANBURG COMMUNITY COLLEGE           ,SC,29305-0000,Public       ,197,480,677,3573,4880,8453
00399500,CENTRAL CAROLINA TECHNICAL COLLEGE      ,SC,29150-2499,Public       ,123,454,577,1893,4436,6329
00399600,YORK TECHNICAL COLLEGE                  ,SC,29730-3395,Public       ,247,593,840,3350,5271,8621
00492000,TRIDENT TECHNICAL COLLEGE               ,SC,29423-8067,Public       ,521,1481,2002,7476,15533,23009
00492300,CLINTON JR COLLEGE                      ,SC,29730-5152,Private      ,13,20,33,201,233,434
00492400,FORREST COLLEGE                         ,SC,29624-2405,Proprietary  ,4,36,40,42,291,333
00492500,HORRY-GEORGETOWN TECH COLLEGE           ,SC,29526-9521,Public       ,341,815,1156,4336,7248,11584
00492600,TRI-COUNTY TECHNICAL COLLEGE            ,SC,29670-9133,Public       ,236,421,657,4631,4062,8693
00492700,UNIV OF SC AT UNION                     ,SC,29379-0729,Public       ,4,33,37,337,359,696
00499204,MILLER-MOTTE TECHNICAL COLLEGE - CONWAY ,SC,29526-9508,Proprietary  ,37,168,205,379,1397,1776
00536300,DENMARK TECHNICAL COLLEGE               ,SC,29042-0000,Public       ,37,120,157,714,2030,2744
00681500,ORANGEBURG-CALHOUN TECHNICAL COLG       ,SC,29118-8299,Public       ,90,288,378,1922,2835,4757
00695100,UNIVERSITY OF SOUTH CAROLINA UPSTATE    ,SC,29303-9972,Public       ,176,274,450,6826,3756,10582
00760200,NORTHEASTERN TECHNICAL COLLEGE          ,SC,29520-7015,Public       ,27,128,155,699,1191,1890
00922600,FRANCIS MARION UNIVERSITY               ,SC,29501-0000,Public       ,159,213,372,4912,2289,7201
00932200,WILLIAMSBURG TECHNICAL COLLEGE          ,SC,29556-4197,Public       ,10,74,84,331,658,989
00991000,TECHNICAL COLLEGE OF THE LOWCOUNTRY     ,SC,29902-5441,Public       ,97,337,434,1167,3275,4442
00991100,UNIV OF SC-REGIONAL CAMPUSES ADMIN      ,SC,29208-0001,Public       ,5,29,34,316,372,688
01005600,AIKEN TECHNICAL COLLEGE                 ,SC,29802-0696,Public       ,133,370,503,1649,3298,4947
01019806,ECPI UNIVERSITY - GREENVILLE            ,SC,29615-4232,Proprietary  ,14,96,110,122,896,1018
01019809,ECPI UNIVERSITY - CHARLESTON            ,SC,29420-4264,Proprietary  ,11,128,139,117,797,914
01019811,ECPI UNIVERSITY - COLUMBIA              ,SC,29210-6467,Proprietary  ,6,74,80,82,488,570
01179901,PAUL MITCHELL THE SCHOOL COLUMBIA       ,SC,29201-3126,Proprietary  ,18,52,70,124,281,405
01179902,PAUL MITCHELL THE SCHOOL CHARLESTON     ,SC,29418-6993,Proprietary  ,15,51,66,119,317,436
01179903,PAUL MITCHELL THE SCHOOL FAYETTEVILLE - ,SC,29607-0000,Proprietary  ,13,31,44,87,158,245
01209200,KENNETH SHULER SCHOOL OF COSMETOLOGY    ,SC,29732-2169,Proprietary  ,15,61,76,169,449,618
01303907,SOUTH UNIVERSITY                        ,SC,29203-6400,Proprietary  ,57,440,497,528,3043,3571
02063700,SHERMAN CLG STRAIGHT CHIROPRACTIC       ,SC,29316-0000,Private      ,0,21,21,19,441,460
02338600,CHARZANNE BEAUTY COLLEGE                ,SC,29649-0000,Proprietary  ,2,8,10,32,97,129
02341100,KENNETH SHULER SCHOOL OF COSMETOLOGY & N,SC,29210-0000,Proprietary  ,24,76,100,235,724,959
02356600,CHARLESTON COSMETOLOGY INSTITUTE        ,SC,29420-0000,Proprietary  ,14,30,44,65,176,241
02359802,ITT TECHNICAL INSTITUTE -               ,SC,29615-4506,Proprietary  ,0,0,0,0,2,2
02552400,ACADEMY OF HAIR TECHNOLOGY              ,SC,29615-2363,Proprietary  ,10,28,38,57,199,256
02567600,SUMTER BEAUTY COLLEGE                   ,SC,29150-0000,Proprietary  ,0,10,10,33,123,156
02614202,MILLER - MOTTE TECHNICAL COLLEGE - NORTH,SC,29406-9239,Proprietary  ,44,164,208,327,1364,1691
03010614,VIRGINIA COLLEGE - GOLF ACADEMY OF AMERI,SC,29579-0000,Proprietary  ,7,21,28,100,187,287
03010617,VIRGINIA COLLEGE - GREENVILLE           ,SC,29607-7200,Proprietary  ,16,98,114,180,832,1012
03010620,VIRGINIA COLLEGE - CHARLESTON           ,SC,29406-4999,Proprietary  ,20,74,94,180,704,884
03010621,VIRGINIA COLLEGE - COLUMBIA             ,SC,29223-7527,Proprietary  ,13,106,119,181,936,1117
03052300,KENNETH SHULER SCH COSM & HAIR DESG     ,SC,29841-2013,Proprietary  ,22,44,66,159,386,545
03293300,STRAND COLLEGE OF HAIR DESIGN           ,SC,29572-4310,Proprietary  ,6,22,28,48,127,175
03304300,CENTURA COLLEGE                         ,SC,29406-9235,Proprietary  ,27,109,136,109,614,723
03513300,LACY COSMETOLOGY SCHOOL                 ,SC,29803-9084,Proprietary  ,0,0,0,5,9,14
03513301,LACY COSMETOLOGY SCHOOL -               ,SC,29072-0000,Proprietary  ,0,0,0,3,8,11
03513302,LACY COSMETOLOGY SCHOOL -               ,SC,29445-0000,Proprietary  ,0,0,0,6,5,11
03513303,LACY COSMETOLOGY SCHOOL - WEST ASHLEY   ,SC,29407-4605,Proprietary  ,0,0,0,3,6,9
03555400,SOUTHEASTERN INSTITUTE                  ,SC,29406-0000,Proprietary  ,10,42,52,29,128,157
03709301,EDWARD VIA VIRGINIA COLLEGE OF OSTEOPATH,SC,29303-3639,Private      ,2,14,16,22,763,785
03746300,LEGRAND INSTITUTE OF COSMETOLOGY        ,SC,29020-0000,Proprietary  ,3,9,12,24,56,80
03746400,SOUTHEASTERN INSTITUTE                  ,SC,29210-0000,Proprietary  ,11,72,83,77,457,534
03768400,STYLETRENDS BARBER AND HAIRSTYLING ACADE,SC,29730-4511,Proprietary  ,3,13,16,23,87,110
04083300,MARION COUNTY TECHNICAL EDUCATION CENTER,SC,29571-0000,Public       ,1,14,15,24,140,164
04096300,CHARLESTON SCHOOL OF LAW                ,SC,29402-0535,Proprietary  ,3,20,23,61,886,947
04158100,AIKEN SCHOOL OF COSMETOLOGY             ,SC,29801-4554,Proprietary  ,4,16,20,34,105,139
04166900,COSMETIC ARTS INSTITUTE                 ,SC,29488-4216,Proprietary  ,0,7,7,21,58,79
04172600,SALON 496 BARBER ACADEMY                ,SC,29607-2548,Proprietary  ,2,23,25,16,137,153
04192600,PALMETTO BEAUTY SCHOOL                  ,SC,29307-1424,Proprietary  ,5,22,27,51,134,185
04202900,JOLEI'S HAIR INSTITUTE                  ,SC,29114-9337,Proprietary  ,2,2,4,9,54,63
00345800,AUGUSTANA COLLEGE                       ,SD,57197-0001,Private      ,33,29,62,1660,306,1966
00345900,BLACK HILLS STATE UNIVERSITY            ,SD,57799-9670,Public       ,92,131,223,2306,1666,3972
00346100,DAKOTA WESLEYAN UNIVERSITY              ,SD,57301-4398,Private      ,11,27,38,781,314,1095
00346300,DAKOTA STATE UNIVERSITY                 ,SD,57042-1799,Public       ,38,80,118,1351,997,2348
00346500,MOUNT MARTY COLLEGE                     ,SD,57078-3724,Private      ,13,18,31,495,398,893
00346600,NORTHERN STATE UNIVERSITY               ,SD,57401-7198,Public       ,49,42,91,1645,789,2434
00346700,PRESENTATION COLLEGE                    ,SD,57401-1299,Private      ,18,46,64,589,536,1125
00346900,UNIVERSITY OF SIOUX FALLS               ,SD,57105-1699,Private      ,37,64,101,1343,685,2028
00347000,SOUTH DAKOTA SCH OF MINES & TECH        ,SD,57701-3995,Public       ,47,40,87,2181,716,2897
00347100,SOUTH DAKOTA STATE UNIVERSITY           ,SD,57007-2298,Public       ,175,183,358,8546,3097,11643
00347400,UNIVERSITY OF SOUTH DAKOTA              ,SD,57069-2390,Public       ,140,266,406,5603,4345,9948
00405600,SIOUX FALLS SEMINARY                    ,SD,57105-2729,Private      ,0,10,10,4,86,90
00405700,NATIONAL AMERICAN UNIVERSITY            ,SD,57701-3692,Proprietary  ,117,1390,1507,773,12676,13449
00405707,NATIONAL AMERICAN UNIVERSITY - SIOUX FAL,SD,57108-4293,Proprietary  ,3,44,47,63,703,766
00492900,MCKENNAN HOSP-RADOLOGICAL TECH          ,SD,57101-0000,Private      ,2,2,4,32,35,67
00530900,LAKE AREA TECHNICAL INSTITUTE           ,SD,57201-0730,Public       ,34,71,105,1235,623,1858
00598700,AVERA SACRED HEART HOSPITAL SCHOOL OF RA,SD,57078-3899,Private      ,0,0,0,10,12,22
00776400,SOUTHEAST TECHNICAL INST                ,SD,57107-0000,Public       ,72,150,222,1370,1670,3040
00828400,MITCHELL TECHNICAL INSTITUTE            ,SD,57301-9931,Public       ,24,21,45,831,440,1271
01013800,STEWART SCHOOL                          ,SD,57104-0000,Proprietary  ,14,19,33,95,124,219
01014804,COLORADO TECHNICAL UNIVERSITY           ,SD,57108-2272,Proprietary  ,3,20,23,57,254,311
01017000,WESTERN DAKOTA TECHNICAL INSTITUTE      ,SD,57701-4018,Public       ,35,106,141,507,943,1450
01147701,SANFORD MEDICAL CENTER -RAD TECH        ,SD,57117-5039,Private      ,1,4,5,28,31,59
01465900,OGLALA LAKOTA COLLEGE                   ,SD,57752-0490,Public       ,18,137,155,332,1391,1723
02137100,BLACK HILLS BEAUTY COLLEGE              ,SD,57701-0000,Proprietary  ,13,16,29,103,135,238
02143700,SINTE GLESKA UNIVERSITY                 ,SD,57570-0000,Public       ,5,32,37,120,507,627
02144600,KILIAN COMMUNITY COLLEGE                ,SD,57103-7020,Private      ,7,34,41,108,320,428
02277300,SISSETON WAHPETON COLLEGE               ,SD,57262-0000,Public       ,0,11,11,35,148,183
02297800,HEADLINES ACADEMY                       ,SD,57701-2733,Proprietary  ,9,23,32,65,126,191
00347700,AQUINAS COLLEGE                         ,TN,37205-2086,Private      ,18,62,80,336,730,1066
00347800,AUSTIN PEAY STATE UNIVERSITY            ,TN,37044-0002,Public       ,304,795,1099,8783,8606,17389
00347900,BELMONT UNIVERSITY                      ,TN,37212-3757,Private      ,303,255,558,8787,4052,12839
00348000,BETHEL UNIVERSITY                       ,TN,38201-1705,Private      ,90,788,878,2136,7569,9705
00348100,CARSON - NEWMAN UNIVERSITY              ,TN,37760-2204,Private      ,121,127,248,3641,1131,4772
00348200,CHRISTIAN BROTHERS UNIVERSITY           ,TN,38104-5581,Private      ,102,198,300,2728,2160,4888
00348300,COLUMBIA STATE COMMUNITY COLLEGE        ,TN,38401-5653,Public       ,168,349,517,3503,3450,6953
00348500,CUMBERLAND UNIVERSITY                   ,TN,37087-3554,Private      ,53,99,152,1568,1218,2786
00348600,LIPSCOMB UNIVERSITY                     ,TN,37204-3951,Private      ,116,250,366,4230,2915,7145
00348700,EAST TENNESSEE STATE UNIV - MAIN CAMPUS ,TN,37614-2857,Public       ,449,581,1030,13077,8890,21967
00348701,EAST TENNESSEE STATE UNIV - MEDICINE    ,TN,37614-1708,Public       ,24,40,64,425,727,1152
00348709,EAST TENNESSEE STATE UNIV - PHARMACY    ,TN,37614-1704,Public       ,10,12,22,151,493,644
00349000,FISK UNIVERSITY                         ,TN,37208-3045,Private      ,72,78,150,1822,931,2753
00349200,FREED-HARDEMAN UNIVERSITY               ,TN,38340-2399,Private      ,53,79,132,1890,1054,2944
00349400,HIWASSEE COLLEGE                        ,TN,37354-4001,Private      ,15,23,38,427,221,648
00349500,JOHNSON UNIVERSITY                      ,TN,37998-9775,Private      ,28,78,106,1174,815,1989
00349600,KING COLLEGE                            ,TN,37620-2699,Private      ,50,277,327,1655,3276,4931
00349900,LANE COLLEGE                            ,TN,38301-4598,Private      ,59,74,133,1979,1080,3059
00350000,LEE UNIVERSITY                          ,TN,37320-0000,Private      ,135,157,292,4397,1989,6386
00350100,LEMOYNE-OWEN COLLEGE                    ,TN,38126-6510,Private      ,84,208,292,1927,2597,4524
00350200,LINCOLN MEMORIAL UNIVERSITY             ,TN,37752-7920,Private      ,70,158,228,2123,3763,5886
00350400,MARTIN METHODIST COLLEGE                ,TN,38478-2799,Private      ,27,35,62,1116,475,1591
00350500,MARYVILLE COLLEGE                       ,TN,37804-5907,Private      ,54,46,100,2238,402,2640
00350600,MEHARRY MEDICAL COLLEGE                 ,TN,37208-0000,Private      ,5,30,35,131,1343,1474
00350700,MEMPHIS COLLEGE OF ART                  ,TN,38104-2764,Private      ,41,45,86,931,502,1433
00350900,UNIVERSITY OF MEMPHIS (THE)             ,TN,38152-4611,Public       ,617,1135,1752,18920,18242,37162
00351000,MIDDLE TENNESSEE STATE UNIV             ,TN,37130-0000,Public       ,828,1105,1933,24493,14105,38598
00351100,MILLIGAN COLLEGE                        ,TN,37682-4001,Private      ,24,53,77,1229,634,1863
00351700,SOUTHERN COLLEGE OF OPTOMETRY           ,TN,38104-2222,Private      ,4,13,17,50,683,733
00351800,SOUTHERN ADVENTIST UNIVERSITY           ,TN,37315-0370,Private      ,73,68,141,2833,1117,3950
00351900,RHODES COLLEGE                          ,TN,38112-1690,Private      ,164,72,236,3363,703,4066
00352200,TENNESSEE STATE UNIVERSITY              ,TN,37209-1561,Public       ,432,737,1169,12238,10183,22421
00352300,TENNESSEE TECHNOLOGICAL UNIV            ,TN,38505-0001,Public       ,298,270,568,11434,3908,15342
00352400,TENNESSEE TEMPLE UNIVERSITY             ,TN,37404-3587,Private      ,29,66,95,468,723,1191
00352500,TENNESSEE WESLEYAN COLLEGE              ,TN,37371-0040,Private      ,42,48,90,1257,694,1951
00352600,TREVECCA NAZARENE UNIVERSITY            ,TN,37210-2877,Private      ,50,181,231,1738,2197,3935
00352700,TUSCULUM COLLEGE                        ,TN,37743-0001,Private      ,78,132,210,2447,1763,4210
00352800,UNION UNIVERSITY                        ,TN,38305-3697,Private      ,88,229,317,2859,3209,6068
00352900,UNIVERSITY OF TENNESSEE-CHATTANOOGA     ,TN,37403-2598,Public       ,560,463,1023,15834,5943,21777
00353000,UNIVERSITY OF TENNESSEE-KNOXVILLE       ,TN,37996-0150,Public       ,940,672,1612,30066,10957,41023
00353006,UNIVERSITY OF TENNESSEE-HEALTH SCI CTR  ,TN,38103-0000,Public       ,42,169,211,745,4425,5170
00353100,UNIVERSITY OF TENNESSEE-MARTIN          ,TN,38238-0002,Public       ,236,254,490,7995,3740,11735
00353400,UNIVERSITY OF THE SOUTH                 ,TN,37383-1000,Private      ,93,10,103,2449,164,2613
00353500,VANDERBILT UNIVERSITY                   ,TN,37240-0001,Private      ,733,326,1059,20364,7542,27906
00353501,VANDERBILT UNIV MED CTR ALLIEDHEAL      ,TN,37232-5510,Private      ,19,51,70,249,703,952
00353600,BRYAN COLLEGE                           ,TN,37321-7000,Private      ,31,62,93,1178,910,2088
00399800,CHATTANOOGA STATE COMMUNITY COLLEGE     ,TN,37406-1097,Public       ,473,1118,1591,6370,9468,15838
00399900,CLEVELAND STATE COMMUNITY COLLEGE       ,TN,37312-2858,Public       ,137,320,457,2478,2771,5249
00402500,TENNESSEE COLLEGE OF APPLIED TECHNOLOGY ,TN,37919-2327,Public       ,109,243,352,868,1986,2854
00402600,TENNESSEE COLLEGE OF APPLIED TECHNOLOGY ,TN,38555-4142,Public       ,30,64,94,652,629,1281
00461700,NATIONAL COLLEGE                        ,TN,37211-6605,Proprietary  ,22,152,174,303,1794,2097
00493400,DAYMAR INSTITUTE                        ,TN,37217-1056,Proprietary  ,13,77,90,90,505,595
00493401,DAYMAR INSTITUTE - CLARKSVILLE          ,TN,37040-6718,Proprietary  ,22,133,155,217,1129,1346
00493404,DAYMAR INSTITUTE - MURFREESBORO         ,TN,37128-5508,Proprietary  ,21,75,96,134,451,585
00493700,JACKSON STATE COMMUNITY COLLEGE         ,TN,38301-3797,Public       ,149,379,528,3371,3996,7367
00493800,SOUTH COLLEGE                           ,TN,37909-3323,Proprietary  ,49,236,285,578,2543,3121
00494700,WEST TENNESSEE BUSINESS COLLEGE         ,TN,38301-3256,Proprietary  ,14,61,75,138,624,762
00528000,TENNESSEE COLLEGE OF APPLIED TECHNOLOGY ,TN,38019-0249,Public       ,16,43,59,194,437,631
00528100,TENNESSEE COLLEGE OF APPLIED TECHNOLOGY ,TN,37643-6054,Public       ,41,118,159,369,937,1306
00528200,TENNESSEE COLLEGE OF APPLIED TECHNOLOGY-,TN,37074-2032,Public       ,20,48,68,235,364,599
00528300,TENNESSEE COLLEGE OF APPLIED TECHNOLOGY ,TN,38059-1198,Public       ,10,54,64,206,459,665
00530700,TENNESSEE COLLEGE OF APPLIED TECHNOLOGY-,TN,37110-1322,Public       ,23,63,86,275,425,700
00535100,TENNESSEE COLLEGE OF APPLIED TECHNOLOGY ,TN,37813-2094,Public       ,48,95,143,615,1086,1701
00535200,TENNESSEE COLLEGE OF APPLIED TECHNOLOGY-,TN,38201-1620,Public       ,8,37,45,151,286,437
00535300,TENNESSEE COLLEGE OF APPLIED TECHNOLOGY-,TN,38570-1291,Public       ,20,61,81,326,413,739
00535400,TENNESSEE COLLEGE OF APPLIED TECHNOLOGY-,TN,38301-9609,Public       ,30,127,157,529,1162,1691
00535600,TENNESSEE COLLEGE OF APPLIED TECHNOLOGY ,TN,38462-2201,Public       ,18,54,72,252,391,643
00535700,TENNESSEE COLLEGE OF APPLIED TECHNOLOGY ,TN,38327-3402,Public       ,10,35,45,183,382,565
00535800,TENNESSEE COLLEGE OF APPLIED TECHNOLOGY ,TN,37371-0848,Public       ,27,56,83,336,443,779
00535900,TENNESSEE COLLEGE OF APPLIED TECHNOLOGY ,TN,37209-4515,Public       ,60,203,263,828,1969,2797
00536000,TENNESSEE COLLEGE OF APPLIED TECHNOLOGY-,TN,38105-3604,Public       ,61,279,340,1256,2772,4028
00537800,NORTHEAST STATE COMMUNITY COLLEGE       ,TN,37617-0246,Public       ,205,496,701,3713,4680,8393
00537900,TENNESSEE COLLEGE OF APPLIED TECHNOLOGY-,TN,37160-3697,Public       ,27,70,97,440,675,1115
00683500,DYERSBURG STATE COMMUNITY COLLEGE       ,TN,38024-0000,Public       ,82,266,348,1821,2554,4375
00683600,MOTLOW STATE COMMUNITY COLLEGE          ,TN,37388-7972,Public       ,217,434,651,3770,3540,7310
00732941,ITT TECHNICAL INSTITUTE                 ,TN,37932-3343,Proprietary  ,132,502,634,988,3591,4579
00732958,ITT TECHNICAL INSTITUTE                 ,TN,37214-3717,Proprietary  ,63,421,484,739,2839,3578
00743900,FOUNTAINHEAD COLLEGE OF TECHNOLOGY      ,TN,37918-0000,Proprietary  ,21,74,95,212,602,814
00778200,TENNESSEE COLLEGE OF APPLIED TECHNOLOGY ,TN,37055-2556,Public       ,40,105,145,420,801,1221
00778300,MIDDLE TENNESSEE SCH OF ANESTHESIA      ,TN,37116-0000,Private      ,0,6,6,21,187,208
00793803,NASHVILLE AUTO DIESEL COLLEGE - NASHVILL,TN,37206-3210,Proprietary  ,417,135,552,2507,944,3451
00814500,NASHVILLE STATE TECH CMNTY COLLEGE      ,TN,37209-0000,Public       ,441,1213,1654,5971,11139,17110
00865500,GENESIS CAREER COLLEGE                  ,TN,38501-1959,Proprietary  ,25,80,105,195,499,694
00885900,JOHN A GUPTON COLLEGE                   ,TN,37203-2934,Private      ,3,13,16,96,219,315
00886300,WALTERS STATE COMMUNITY COLLEGE         ,TN,37813-6899,Public       ,214,487,701,4832,4290,9122
00946400,TENNESSEE COLLEGE OF APPLIED TECHNOLOGY-,TN,38478-4541,Public       ,17,38,55,198,339,537
00956700,TENNESSEE SCHOOL OF BEAUTY              ,TN,37921-3303,Proprietary  ,26,73,99,266,525,791
00971000,TENNESSEE COLLEGE OF APPLIED TECHNOLOGY ,TN,37756-4149,Public       ,13,42,55,115,239,354
00991200,VOLUNTEER STATE COMMUNITY COLLEGE       ,TN,37066-3188,Public       ,294,553,847,4810,5183,9993
00991400,ROANE STATE COMMUNITY COLLEGE           ,TN,37748-8664,Public       ,197,504,701,4480,4938,9418
00998200,VICTORY UNIVERSITY                      ,TN,38111-4745,Proprietary  ,0,0,0,469,1246,1715
01032600,TENNESSEE COLLEGE OF APPLIED TECHNOLOGY ,TN,37748-5849,Public       ,25,65,90,252,430,682
01043900,SOUTHWEST TENNESSEE COMMUNITY COLLG     ,TN,38104-3322,Public       ,501,1408,1909,9751,14809,24560
01044700,"PLAZA BEAUTY SCHOOL, INC.               ",TN,38117-4822,Proprietary  ,3,19,22,172,321,493
01046000,AMERICAN BAPTIST THEOLOGICAL SEMINA     ,TN,37207-4994,Private      ,9,21,30,58,296,354
01052900,MEMPHIS THEOLOGICAL SEMINARY            ,TN,38104-0000,Private      ,2,21,23,23,411,434
01070000,TENNESSEE COLLEGE OF APPLIED TECHNOLOGY-,TN,37757-2461,Public       ,5,34,39,150,296,446
01155300,WM R MOORE COLLEGE OF TECHNOLOGY        ,TN,38104-0000,Private      ,19,57,76,211,440,651
01216400,TENNESSEE COLLEGE OF APPLIED TECHNOLOGY ,TN,38063-7359,Public       ,7,31,38,74,273,347
01254700,EMMANUEL SCHOOL OF RELIGION             ,TN,37601-0000,Private      ,0,2,2,8,55,63
01269300,PELLISSIPPI STATE COMMUNITY COLLEGE     ,TN,37933-0990,Public       ,445,812,1257,7562,7203,14765
02069303,VATTEROTT COLLEGE -                     ,TN,38016-5877,Proprietary  ,17,96,113,179,580,759
02092800,TENNESSEE COLLEGE OF APPLIED TECHNOLOGY ,TN,38075-0489,Public       ,14,31,45,151,319,470
02103500,TENNESSEE COLLEGE OF APPLIED TECHNOLOGY ,TN,37129-3311,Public       ,50,106,156,644,1029,1673
02106400,O'MORE COLLEGE OF DESIGN                ,TN,37064-0000,Private      ,9,9,18,219,120,339
02125300,NASHVILLE CLG OF MEDICAL CAREERS        ,TN,37115-0000,Proprietary  ,7,28,35,53,256,309
02153100,JON NAVE UNIVERSITY OF COSMETOLOGY      ,TN,37013-3347,Proprietary  ,14,28,42,159,280,439
02157100,CONCORDE CAREER COLLEGE                 ,TN,38137-0000,Proprietary  ,81,361,442,921,3282,4203
02160307,INTERNATIONAL ACADEMY OF DESIGN & TECH  ,TN,37212-0000,Proprietary  ,12,29,41,122,262,384
02188300,PENTECOSTAL THEOLOGICAL SEMINARY        ,TN,37320-0000,Private      ,0,30,30,8,337,345
02204200,"CHATTANOOGA COLLEGE - MEDICAL, DENTAL AN",TN,37411-0000,Proprietary  ,23,108,131,253,930,1183
02237900,TENNESSEE COLLEGE OF APPLIED TECHNOLOGY-,TN,38242-5023,Public       ,26,63,89,191,536,727
02255000,KNOXVILLE INSTITUTE OF HAIR DESIGN      ,TN,37917-0000,Proprietary  ,12,27,39,102,285,387
02257400,ARNOLD'S BEAUTY SCHOOL                  ,TN,38358-0000,Proprietary  ,5,10,15,57,98,155
02263104,ANTHEM COLLEGE - ANTHEM CAREER COLLEGE -,TN,37214-2531,Proprietary  ,0,0,0,144,524,668
02275500,REUBEN-ALLEN COLLEGE                    ,TN,37922-0000,Proprietary  ,22,41,63,138,312,450
02278700,MR WAYNES SCH OF UNISEX HAIR DESIGN     ,TN,38501-0000,Proprietary  ,7,8,15,37,66,103
02293900,VOLUNTEER BEAUTY ACADEMY-NASHVILLE      ,TN,37115-2112,Proprietary  ,4,5,9,17,69,86
02294000,VOLUNTEER BEAUTY ACADEMY-DYERSBURG      ,TN,38024-1622,Proprietary  ,2,8,10,33,84,117
02326200,KAPLAN CAREER INSTITUTE                 ,TN,37212-5318,Proprietary  ,20,174,194,227,1163,1390
02326300,MEDVANCE INSTITUTE                      ,TN,38501-4305,Proprietary  ,12,59,71,136,321,457
02335900,VOLUNTEER BEAUTY ACADEMY-NASHVILLE      ,TN,37209-3033,Proprietary  ,8,10,18,62,163,225
02539800,QUEEN CITY COLLEGE                      ,TN,37042-0000,Proprietary  ,6,37,43,69,386,455
02540000,TENNESSEE ACADEMY OF COSMETOLOGY        ,TN,38133-0000,Proprietary  ,11,75,86,232,480,712
02578200,NOSSI COLLEGE OF ART                    ,TN,37115-5138,Proprietary  ,20,38,58,409,347,756
02595000,FAYETTEVILLE BEAUTY SCHOOL              ,TN,37334-2909,Proprietary  ,6,22,28,26,79,105
02599710,VATTEROTT COLLEGE - MEMPHIS             ,TN,38132-1714,Proprietary  ,48,212,260,438,1835,2273
02609204,VATTEROTT COLLEGE - VATTEROTT CAREER COL,TN,38133-4727,Proprietary  ,27,127,154,313,1049,1362
02614200,MILLER MOTTE BUSINESS COLLEGE           ,TN,37040-6023,Proprietary  ,21,135,156,236,1051,1287
02614203,MILLER - MOTTE TECHNICAL COLLEGE - CHATT,TN,37421-7220,Proprietary  ,22,153,175,270,1003,1273
02614204,MILLER - MOTTE TECHNICAL COLLEGE - MADIS,TN,37072-1870,Proprietary  ,20,95,115,178,690,868
03001800,FREE WILL BAPTIST BIBLE COLLEGE         ,TN,37205-2498,Private      ,12,10,22,284,146,430
03008800,FRANKLIN ACADEMY                        ,TN,37312-3939,Private      ,3,22,25,49,137,186
03010606,VIRGINIA COLLEGE - SCH OF BUSNSS & HLTH ,TN,37411-5600,Proprietary  ,17,133,150,239,1091,1330
03024900,TENNESSEE ACADEMY OF COSMETOLOGY        ,TN,38125-3442,Proprietary  ,16,69,85,215,498,713
03026517,REMINGTON COLLEGE - MEMPHIS             ,TN,38132-2107,Private      ,42,145,187,493,1265,1758
03061100,GENESIS CAREER COLLEGE OF LEBANON       ,TN,37087-2718,Proprietary  ,15,38,53,106,242,348
03076405,BRYMAN SCHOOL OF ARIZONA (THE) - ANTHEM ,TN,38134-7345,Proprietary  ,0,0,0,162,791,953
03079100,NORTH CENTRAL INSTITUTE                 ,TN,37042-3116,Proprietary  ,4,28,32,49,195,244
03088800,"WATKINS COLLEGE OF ART, DESIGN & FILM   ",TN,37228-1306,Private      ,30,41,71,616,326,942
03126900,STYLES & PROFILES BEAUTY COLLEGE        ,TN,38375-2109,Proprietary  ,0,7,7,19,45,64
03253300,PAUL MITCHELL THE SCHOOL MEMPHIS        ,TN,38133-4067,Proprietary  ,16,32,48,171,235,406
03355400,RICHMONT GRADUATE UNIVERSITY            ,TN,37404-0000,Private      ,0,19,19,9,283,292
03440300,BAPTIST MEMORIAL COLLEGE OF HEALTH      ,TN,38104-3104,Private      ,42,202,244,1287,2706,3993
03480303,MEDVANCE INSTITUTE - NASHVILLE          ,TN,37203-1536,Proprietary  ,12,66,78,85,578,663
03513500,WILLIAMSON CHRISTIAN COLLEGE            ,TN,37067-8237,Private      ,4,7,11,59,74,133
03647300,NEW CONCEPTS SCHOOL OF COSMETOLOGY      ,TN,37311-7373,Proprietary  ,6,14,20,38,91,129
03683300,INTERNATIONAL BARBER & STYLE COLLEGE    ,TN,37209-2205,Proprietary  ,7,60,67,67,214,281
03701300,MEMPHIS INSTITUTE OF BARBERING          ,TN,38107-4334,Proprietary  ,23,64,87,205,458,663
03774400,SHEAR ACADEMY                           ,TN,38555-4177,Proprietary  ,3,14,17,27,79,106
03830300,SAE INSTITUTE OF TECHNOLOGY             ,TN,37203-4310,Proprietary  ,30,44,74,268,426,694
03840300,OXFORD GRADUATE SCHOOL                  ,TN,37321-6736,Private      ,0,5,5,4,45,49
03841300,CAREER BEAUTY COLLEGE                   ,TN,38464-3634,Proprietary  ,0,15,15,36,54,90
03920300,INSTITUTE OF HAIR DESIGN                ,TN,38310-1801,Proprietary  ,2,7,9,27,48,75
03930300,BUCHANAN BEAUTY COLLEGE                 ,TN,37160-2741,Proprietary  ,3,15,18,42,93,135
03982300,VISIBLE SCHOOL - MUSIC AND WORSHIPS ARTS,TN,38104-5814,Private      ,10,19,29,152,145,297
04035300,TENNESSEE CAREER INSTITUTE              ,TN,38401-6335,Proprietary  ,6,26,32,89,240,329
04124100,ELITE COLLEGE OF COSMETOLOGY            ,TN,38351-1431,Proprietary  ,3,9,12,33,77,110
04157200,LOVE BEAUTY SCHOOL                      ,TN,37355-2950,Proprietary  ,5,25,30,34,74,108
04165000,MERIDIAN INSTITUTE OF SURGICAL ASSISTING,TN,37080-0758,Proprietary  ,0,52,52,8,411,419
04174600,NASHVILLE BARBER AND STYLE ACADEMY      ,TN,37208-2826,Proprietary  ,5,20,25,64,178,242
04210200,MID-SOUTH CHRISTIAN COLLEGE             ,TN,38118-3151,Private      ,5,23,28,62,218,280
04213800,SALON PROFESSIONAL ACADEMY (THE)        ,TN,37214-2163,Proprietary  ,8,12,20,92,144,236
04215200,VIBE BARBER COLLEGE                     ,TN,38107-2538,Proprietary  ,7,20,27,48,157,205
04223900,MIND BODY INSTITUTE                     ,TN,37214-1012,Proprietary  ,1,21,22,18,115,133
04236400,SANDRA ACADEMY OF SALON SERVICES        ,TN,37825-7239,Proprietary  ,6,24,30,6,24,30
04238600,GOULD'S ACADEMY                         ,TN,38119-5317,Proprietary  ,12,24,36,12,24,36
00353700,ABILENE CHRISTIAN UNIVERSITY            ,TX,79699-3701,Private      ,284,164,448,6160,1596,7756
00353900,ALVIN COMMUNITY COLLEGE                 ,TX,77511-4807,Public       ,112,374,486,1620,2909,4529
00354000,AMARILLO COLLEGE                        ,TX,79109-2446,Public       ,281,805,1086,3970,6419,10389
00354100,ANGELO STATE UNIVERSITY                 ,TX,76909-5069,Public       ,264,254,518,6472,3247,9719
00354300,AUSTIN COLLEGE                          ,TX,75090-4440,Private      ,82,26,108,2271,283,2554
00354400,AUSTIN PRESBYTERIAN THEOLOGICAL SEM     ,TX,78705-5797,Private      ,2,8,10,8,176,184
00354500,BAYLOR UNIVERSITY                       ,TX,76798-7048,Private      ,1374,422,1796,27879,5379,33258
00354600,COASTAL BEND COLLEGE                    ,TX,78102-2197,Public       ,103,233,336,1709,1960,3669
00354900,BLINN COLLEGE                           ,TX,77833-4098,Public       ,763,571,1334,15291,5935,21226
00355300,CISCO JUNIOR COLLEGE                    ,TX,76437-9803,Public       ,118,341,459,2079,2637,4716
00355400,CLARENDON COLLEGE                       ,TX,79226-0000,Public       ,35,73,108,609,664,1273
00355600,COMMONWEALTH INST OF FUNERAL SVC        ,TX,77090-5918,Private      ,7,75,82,97,527,624
00355700,CONCORDIA UNIVERSITY TEXAS              ,TX,78726-4141,Private      ,95,334,429,1698,2848,4546
00355800,NORTH CENTRAL TEXAS COLLEGE             ,TX,76240-4699,Public       ,299,581,880,4152,5675,9827
00356000,DALLAS BAPTIST UNIVERSITY               ,TX,75211-9299,Private      ,200,435,635,3992,4564,8556
00356100,CEDAR VALLEY COLLEGE                    ,TX,75134-0000,Public       ,148,529,677,2462,5081,7543
00356200,DALLAS THEOLOGICAL SEM                  ,TX,75204-0000,Private      ,4,84,88,45,915,960
00356300,DEL MAR COLLEGE                         ,TX,78404-3897,Public       ,447,896,1343,5662,7908,13570
00356400,EAST TEXAS BAPTIST UNIVERSITY           ,TX,75670-1423,Private      ,69,43,112,1849,532,2381
00356500,TEXAS A&M UNIVERSITY - COMMERCE         ,TX,75429-3011,Public       ,294,659,953,7283,8660,15943
00356600,EPISCOPAL THEOLOGICAL SEMINARY OF THE SO,TX,78705-3128,Private      ,1,14,15,2,28,30
00356800,FRANK PHILLIPS COLLEGE                  ,TX,79008-0000,Public       ,22,59,81,411,544,955
00357000,GRAYSON COUNTY COLLEGE                  ,TX,75020-8299,Public       ,117,435,552,1928,3811,5739
00357100,HARDIN-SIMMONS UNIVERSITY               ,TX,79698-6050,Private      ,83,92,175,2060,1034,3094
00357200,TRINITY VALLEY COMMUNITY COLLEGE        ,TX,75751-2734,Public       ,174,525,699,2805,4539,7344
00357300,HILL COLLEGE                            ,TX,76645-2711,Public       ,58,169,227,1118,1516,2634
00357301,HILL COLLEGE                            ,TX,76031-0000,Public       ,112,264,376,1184,2145,3329
00357400,HOWARD COUNTY JUNIOR COLLEGE DISTRICT   ,TX,79720-0213,Public       ,79,244,323,1460,2127,3587
00357500,HOWARD PAYNE UNIVERSITY                 ,TX,76801-2715,Private      ,54,37,91,1587,409,1996
00357600,HOUSTON BAPTIST UNIVERSITY              ,TX,77074-3298,Private      ,279,351,630,6315,4014,10329
00357700,HUSTON - TILLOTSON UNIVERSITY           ,TX,78702-2795,Private      ,51,134,185,1263,1176,2439
00357800,UNIVERSITY OF THE INCARNATE WORD        ,TX,78209-6398,Private      ,294,654,948,7643,7626,15269
00357900,JACKSONVILLE COLLEGE                    ,TX,75766-4759,Private      ,7,36,43,330,247,577
00358000,KILGORE COLLEGE                         ,TX,75662-3299,Public       ,195,524,719,3272,4468,7740
00358100,LAMAR UNIVERSITY-BEAUMONT               ,TX,77710-0042,Public       ,411,1222,1633,8866,11831,20697
00358200,LAREDO COMMUNITY COLLEGE                ,TX,78040-4395,Public       ,384,385,769,6257,3575,9832
00358300,LEE COLLEGE                             ,TX,77520-4796,Public       ,162,560,722,2128,4191,6319
00358400,LETOURNEAU UNIVERSITY                   ,TX,75607-0000,Private      ,47,203,250,1651,2277,3928
00358600,LUBBOCK CHRISTIAN UNIVERSITY            ,TX,79407-2099,Private      ,97,137,234,1646,1625,3271
00358800,UNIVERSITY OF MARY HARDIN-BAYLOR        ,TX,76513-2599,Private      ,277,132,409,5613,1933,7546
00359000,MCLENNAN COMMUNITY COLLEGE              ,TX,76708-1498,Public       ,261,778,1039,4699,7296,11995
00359100,MCMURRY UNIVERSITY                      ,TX,79697-0001,Private      ,65,87,152,1352,745,2097
00359200,MIDWESTERN STATE UNIVERSITY             ,TX,76308-2099,Public       ,201,261,462,5391,3321,8712
00359300,NAVARRO COLLEGE                         ,TX,75110-4818,Public       ,317,680,997,5348,6536,11884
00359400,UNIVERSITY OF NORTH TEXAS               ,TX,76203-5017,Public       ,1518,1525,3043,35744,21923,57667
00359412,UNIVERSITY OF NORTH TEXAS AT DALLAS     ,TX,75241-4605,Public       ,122,339,461,122,339,461
00359500,OBLATE SCHOOL OF THEOLOGY               ,TX,78216-0000,Private      ,0,5,5,6,72,78
00359600,ODESSA COLLEGE                          ,TX,79764-7127,Public       ,123,374,497,1668,2736,4404
00359800,OUR LADY OF THE LAKE UNIVERSITY         ,TX,78207-4689,Private      ,142,345,487,3438,4163,7601
00359900,UNIVERSITY OF TEXAS - PAN AMERICAN      ,TX,78541-2999,Public       ,1276,865,2141,22179,11601,33780
00360000,PANOLA COLLEGE                          ,TX,75633-2397,Public       ,56,223,279,1196,2070,3266
00360100,PARIS JR COLLEGE                        ,TX,75460-6298,Public       ,109,323,432,2095,3089,5184
00360200,PAUL QUINN COLLEGE                      ,TX,75241-4398,Private      ,19,93,112,498,789,1287
00360300,RANGER COLLEGE                          ,TX,76470-3298,Public       ,50,96,146,830,912,1742
00360305,RANGER COLLEGE-STEPHENVILE BEAUTY COLLEG,TX,76401-5136,Public       ,16,23,39,119,110,229
00360400,RICE UNIVERSITY                         ,TX,77251-1892,Private      ,554,282,836,12324,3263,15587
00360600,SAM HOUSTON STATE UNIVERSITY            ,TX,77340-0000,Public       ,1096,868,1964,23375,11197,34572
00360700,ALAMO CMTY CLG DISTRICT PROGRAM         ,TX,78207-0000,Public       ,103,283,386,1707,2713,4420
00360800,ST PHILLIPS COLLEGE                     ,TX,78203-2098,Public       ,367,1246,1613,6141,11022,17163
00360900,SAN JACINTO CLG-CENTRAL-NORTH-SOUTH     ,TX,77501-0000,Public       ,775,1937,2712,11506,16639,28145
00361000,SCHREINER UNIVERSITY                    ,TX,78028-5697,Private      ,50,58,108,1656,526,2182
00361100,SOUTH PLAINS COLLEGE                    ,TX,79336-6504,Public       ,303,635,938,5320,5565,10885
00361200,UNIV OF HOUSTON-DOWNTOWN                ,TX,77002-1001,Public       ,657,1691,2348,13934,20609,34543
00361300,SOUTHERN METHODIST UNIVERSITY           ,TX,75275-0181,Private      ,464,401,865,8708,5468,14176
00361400,SOUTHWEST TEXAS JR COLLEGE              ,TX,78801-6221,Public       ,168,299,467,2769,2650,5419
00361500,TEXAS STATE UNIVERSITY--SAN MARCOS      ,TX,78666-4602,Public       ,1867,1053,2920,40753,15878,56631
00361600,SOUTHWESTERN ASSEMBLIES OF GOD UNIV     ,TX,75165-2397,Private      ,68,110,178,1848,1253,3101
00361800,SOUTHWESTERN CHRISTIAN COLLEGE          ,TX,75160-3400,Private      ,5,26,31,187,182,369
00361900,SOUTHWESTERN ADVENTIST UNIVERSITY       ,TX,76059-1922,Private      ,30,29,59,803,426,1229
00362000,SOUTHWESTERN UNIVERSITY                 ,TX,78626-6111,Private      ,104,32,136,2741,369,3110
00362100,ST EDWARDS UNIVERSITY                   ,TX,78704-0000,Private      ,299,224,523,6124,2773,8897
00362300,ST MARY'S UNIV OF SAN ANTONIO           ,TX,78228-8500,Private      ,201,243,444,4657,3381,8038
00362400,STEPHEN F AUSTIN STATE UNIVERSITY       ,TX,75962-0001,Public       ,706,414,1120,15766,5549,21315
00362500,SUL ROSS STATE UNIVERSITY               ,TX,79832-0113,Public       ,62,149,211,1830,1942,3772
00362600,TARRANT COUNTY COLLEGE                  ,TX,76102-6599,Public       ,1379,3857,5236,21315,34528,55843
00362700,TEMPLE COLLEGE                          ,TX,76504-7435,Public       ,171,638,809,2440,6049,8489
00362800,TEXARKANA COLLEGE                       ,TX,75599-0001,Public       ,102,442,544,1569,3667,5236
00363000,PRAIRIE VIEW A&M UNIVERSITY             ,TX,77446-2967,Public       ,372,464,836,11621,6417,18038
00363100,TARLETON STATE UNIVERSITY               ,TX,76402-0000,Public       ,547,438,985,11073,6450,17523
00363200,TEXAS A&M UNIVERSITY                    ,TX,77843-1246,Public       ,2507,896,3403,51693,14899,66592
00363208,TEXAS A&M UNIVERSITY - HEALTH SCIENCE CE,TX,77807-3260,Public       ,68,98,166,994,1539,2533
00363400,TEXAS STATE TECHNICAL CLG AT WACO       ,TX,76705-1695,Public       ,203,465,668,3267,4008,7275
00363500,TEXAS CHIROPRACTIC COLLEGE              ,TX,77505-1699,Private      ,1,24,25,23,353,376
00363600,TEXAS CHRISTIAN UNIVERSITY              ,TX,76129-0001,Private      ,796,427,1223,13522,4537,18059
00363700,JARVIS CHRISTIAN COLLEGE                ,TX,75765-1470,Private      ,26,25,51,707,379,1086
00363800,TEXAS COLLEGE                           ,TX,75702-4500,Private      ,59,124,183,1019,1116,2135
00363900,TEXAS A&M UNIVERSITY-KINGSVILLE         ,TX,78363-8203,Public       ,439,505,944,10894,7976,18870
00364100,TEXAS LUTHERAN UNIVERSITY               ,TX,78155-5999,Private      ,86,33,119,2073,402,2475
00364200,TEXAS SOUTHERN UNIVERSITY               ,TX,77004-4598,Public       ,481,971,1452,11646,13694,25340
00364400,TEXAS TECH UNIVERSITY                   ,TX,79409-2011,Public       ,1566,792,2358,31890,12567,44457
00364500,TEXAS WESLEYAN UNIVERSITY               ,TX,76105-1536,Private      ,143,244,387,2071,3521,5592
00364600,TEXAS WOMAN'S UNIVERSITY                ,TX,76204-5587,Public       ,380,955,1335,10112,14260,24372
00364700,TRINITY UNIVERSITY                      ,TX,78212-7200,Private      ,201,111,312,3873,1128,5001
00364800,TYLER JUNIOR COLLEGE                    ,TX,75701-3436,Public       ,494,909,1403,9119,7719,16838
00365100,UNIVERSITY OF DALLAS                    ,TX,75062-4799,Private      ,112,177,289,2465,1854,4319
00365200,UNIVERSITY OF HOUSTON                   ,TX,77204-2010,Public       ,1688,2126,3814,37089,29733,66822
00365400,UNIVERSITY OF ST THOMAS                 ,TX,77006-4626,Private      ,103,309,412,1918,2890,4808
00365600,UNIVERSITY OF TEXAS-ARLINGTON           ,TX,76019-0000,Public       ,1065,2918,3983,25910,33659,59569
00365800,UNIVERSITY OF TEXAS-AUSTIN              ,TX,78713-7758,Public       ,2525,1237,3762,50013,21412,71425
00365900,UT HEALTH CENTER-SAN ANTONIO            ,TX,78229-3900,Public       ,96,244,340,1584,4684,6268
00366100,UNIVERSITY OF TEXAS-EL PASO             ,TX,79968-0629,Public       ,584,1037,1621,19060,14979,34039
00366200,VICTORIA COLLEGE                        ,TX,77901-4494,Public       ,104,272,376,1803,2738,4541
00366300,WAYLAND BAPTIST UNIVERSITY              ,TX,79072-6998,Private      ,72,447,519,1516,4162,5678
00366400,WEATHERFORD COLLEGE                     ,TX,76086-5699,Public       ,173,411,584,2613,3821,6434
00366500,WEST TEXAS A&M UNIVERSITY               ,TX,79016-0000,Public       ,325,404,729,7082,4843,11925
00366800,WHARTON COUNTY JR COLLEGE               ,TX,77488-3298,Public       ,231,380,611,3804,3548,7352
00366900,WILEY COLLEGE                           ,TX,75670-5199,Private      ,34,59,93,1287,889,2176
00400300,CENTRAL TEXAS COLLEGE                   ,TX,76540-4199,Public       ,275,3274,3549,3423,20588,24011
00407221,NORTHWOOD UNIVERSITY                    ,TX,75104-0000,Private      ,12,63,75,362,726,1088
00445300,EL CENTRO COLLEGE                       ,TX,75202-3604,Public       ,355,1500,1855,5549,13259,18808
00450303,EVEREST COLLEGE - FORT WORTH SOUTH      ,TX,76115-1407,Proprietary  ,30,181,211,277,1200,1477
00481102,EVEREST INSTITUTE - EVEREST COLLEGE     ,TX,76011-6630,Proprietary  ,27,166,193,219,998,1217
00494900,BAYLOR COLLEGE OF MEDICINE              ,TX,77030-0000,Private      ,102,162,264,1136,2468,3604
00495100,UNIV OF TEXAS HEALTH SCIENCE CENTER     ,TX,77225-0000,Public       ,78,276,354,1368,4918,6286
00495200,UNIV OF TEXAS MEDICAL BRANCH            ,TX,77550-0000,Public       ,62,131,193,952,3271,4223
00497200,GALVESTON COLLEGE                       ,TX,77550-7447,Public       ,101,265,366,1219,2042,3261
00497700,SOUTH TEXAS COLLEGE OF LAW              ,TX,77002-0000,Private      ,4,85,89,124,1801,1925
00660600,BAPTIST HS SCHOOL OF HEALTH PROFESSIONS ,TX,78229-3234,Proprietary  ,38,136,174,326,1510,1836
00661200,COVENANT SCH OF NSG & ALLIED HEALTH     ,TX,79410-0000,Private      ,13,55,68,218,546,764
00666100,ANGELINA COLLEGE                        ,TX,75902-0000,Public       ,210,506,716,2607,3821,6428
00694100,DALLAS CHRISTIAN COLLEGE                ,TX,75234-7229,Private      ,20,87,107,407,676,1083
00709600,COLLEGE OF THE MAINLAND                 ,TX,77591-2499,Public       ,151,430,581,1388,3375,4763
00728700,BRAZOSPORT COLLEGE                      ,TX,77566-3199,Public       ,145,302,447,1580,2220,3800
00732907,ITT TECHNICAL INSTITUTE                 ,TX,77063-3751,Proprietary  ,36,210,246,547,1756,2303
00732913,ITT TECHNICAL INSTITUTE                 ,TX,76011-3919,Proprietary  ,70,316,386,459,1821,2280
00732975,ITT TECHNICAL INSTITUTE                 ,TX,78249-3303,Proprietary  ,44,165,209,370,1285,1655
00793804,LINCOLN COLLEGE OF TECHNOLOGY - GRAND PR,TX,75052-7605,Proprietary  ,188,128,316,957,796,1753
00849800,MIMS CLASSIC BEAUTY COLLEGE             ,TX,78216-0000,Proprietary  ,6,17,23,47,100,147
00850300,MOUNTAIN VIEW COLLEGE                   ,TX,75211-6599,Public       ,262,725,987,4679,7251,11930
00850400,RICHLAND COLLEGE                        ,TX,75243-2199,Public       ,406,1144,1550,6506,10217,16723
00851000,EASTFIELD COLLEGE                       ,TX,75150-2099,Public       ,299,981,1280,5340,9098,14438
00907905,EVEREST COLLEGE                         ,TX,75206-5209,Proprietary  ,68,331,399,503,2054,2557
00908200,INTERNATIONAL BUSINESS COLLEGE          ,TX,79903-0000,Proprietary  ,18,80,98,165,420,585
00916300,SAN ANTONIO COLLEGE                     ,TX,78212-4299,Public       ,840,2297,3137,14110,20386,34496
00922500,TEXAS STATE TECHNICAL COLLEGE  HARLINGEN,TX,78550-3697,Public       ,244,391,635,4448,4026,8474
00946600,KAPLAN COLLEGE                          ,TX,78216-1899,Proprietary  ,52,185,237,358,1348,1706
00946607,KAPLAN COLLEGE - MCALLEN                ,TX,78503-1622,Proprietary  ,45,83,128,422,645,1067
00946609,KAPLAN COLLEGE - CAREER CENTERS OF TEXAS,TX,78416-9900,Proprietary  ,33,147,180,253,899,1152
00946610,KAPLAN COLLEGE - CAREER CENTERS OF TEXAS,TX,76103-2310,Proprietary  ,24,140,164,191,922,1113
00954900,WESTERN TEXAS COLLEGE                   ,TX,79549-9501,Public       ,24,43,67,670,450,1120
00965100,TEXAS A&M INTERNATIONAL UNIVERSITY      ,TX,78041-1900,Public       ,210,242,452,7070,3497,10567
00974100,UNIVERSITY OF TEXAS AT DALLAS           ,TX,75083-0000,Public       ,652,806,1458,14585,11337,25922
00976800,UNIVERSITY OF NORTH TEXAS HEALTH SCIENCE,TX,76107-2699,Public       ,71,148,219,767,3411,4178
00979700,MIDLAND COLLEGE                         ,TX,79705-6397,Public       ,130,329,459,1729,2408,4137
00982802,EVEREST INSTITUTE- AUSTIN               ,TX,78754-0000,Proprietary  ,52,188,240,333,1114,1447
00993000,UNIVERSITY OF TEXAS-PERMIAN BASIN       ,TX,79762-0001,Public       ,98,300,398,2502,3566,6068
00993200,TEXAS STATE TECH CLG-WEST TEXAS         ,TX,79556-4108,Public       ,43,137,180,530,873,1403
00993201,TEXAS STATE TECHNICAL COLLEGE WEST TEXAS,TX,79601-6110,Public       ,20,86,106,318,749,1067
00993204,TEXAS STATE TECHNICAL COLLEGE WEST TEXAS,TX,76424-3505,Public       ,2,8,10,52,101,153
00993205,TEXAS STATE TECHNICAL COLLEGE WEST TEXAS,TX,76801-2328,Public       ,4,27,31,104,280,384
01001900,UNIV OF TEXAS SOUTHWESTERN MED CTR      ,TX,75390-9096,Public       ,43,124,167,491,2425,2916
01005900,AMERICAN COMMERCIAL COLLEGE             ,TX,79761-0000,Proprietary  ,6,7,13,27,110,137
01005901,AMERICAN COMMERCIAL COLLEGE - AMERICAN C,TX,76310-2303,Proprietary  ,0,12,12,53,182,235
01006000,VERNON COLLEGE                          ,TX,76384-4092,Public       ,73,281,354,1395,2719,4114
01011500,UNIVERSITY OF TEXAS-SAN ANTONIO         ,TX,78249-0600,Public       ,1586,1429,3015,36566,19153,55719
01013000,WADE COLLEGE                            ,TX,75207-3199,Proprietary  ,18,39,57,247,421,668
01038700,EL PASO COMMUNITY COLLEGE               ,TX,79998-0000,Public       ,853,1731,2584,16583,16458,33041
01050900,HALLMARK COLLEGE OF AERONAUTICS         ,TX,78214-0000,Private      ,41,168,209,259,1126,1385
01050901,HALLMARK COLLEGE OF  TECHNOLOGY-        ,TX,78230-1736,Private      ,0,1,1,0,1,1
01062400,LIGHTHOUSE CAREER INSTITUTE             ,TX,75231-5033,Private      ,1,10,11,19,80,99
01063300,HOUSTON COMMUNITY COLLEGE               ,TX,77002-0000,Public       ,1662,6197,7859,26669,57770,84439
01067400,TEXAS TECH U HEALTH SCIENCES CENTER     ,TX,79430-0000,Public       ,112,412,524,1726,5833,7559
01076100,DALLAS INSTITUTE OF FUNERAL SERVICE     ,TX,75227-4314,Private      ,9,64,73,120,451,571
01114500,LONE STAR COLLEGE SYSTEM                ,TX,77073-3499,Public       ,1749,5157,6906,25492,45110,70602
01116100,TEXAS A&M UNIV CORPUS CHRISTI           ,TX,78412-5599,Public       ,687,598,1285,13713,7146,20859
01116300,UNIVERSITY OF TEXAS AT TYLER            ,TX,75799-6699,Public       ,274,656,930,5950,6873,12823
01171100,UNIVERSITY OF HOUSTON-CLEAR LAKE        ,TX,77058-1002,Public       ,183,684,867,3640,8759,12399
01201500,AUSTIN COMMUNITY COLLEGE                ,TX,78752-4390,Public       ,1077,2730,3807,17718,24193,41911
01202000,VICTORIA BEAUTY COLLEGE                 ,TX,77901-6233,Proprietary  ,9,22,31,58,150,208
01226800,BALDWIN BEAUTY SCHOOL #5                ,TX,78704-4785,Proprietary  ,21,70,91,156,378,534
01229700,LAREDO BEAUTY COLLEGE                   ,TX,78040-1051,Proprietary  ,17,44,61,152,250,402
01248200,ATI TECHNICAL TRAINING CENTER           ,TX,75235-4622,Proprietary  ,7,59,66,54,227,281
01248209,ATI CAREER TRAINING CENTER - GARLAND    ,TX,75041-2497,Proprietary  ,1,15,16,13,68,81
01248210,ATI CAREER TRAINING CENTER - WACO       ,TX,76711-1682,Proprietary  ,3,38,41,45,153,198
01248300,COSMETOLOGY CAREER CENTER-A PAUL MITCHEL,TX,75006-2567,Proprietary  ,79,183,262,526,828,1354
01248800,INTERNATIONAL BEAUTY COLLEGE NO 3       ,TX,75040-0000,Proprietary  ,3,16,19,18,81,99
01276400,METROPLEX BEAUTY SCHOOL                 ,TX,75149-0000,Proprietary  ,3,15,18,37,113,150
01293000,CHARLES & SUE'S SCH OF HAIR DESIGN      ,TX,77801-0000,Proprietary  ,8,25,33,67,132,199
01293200,TINT SCHOOL OF MAKEUP & COSMETOLOGY     ,TX,75061-4235,Proprietary  ,12,41,53,63,226,289
01300300,NEILSON BEAUTY COLLEGE                  ,TX,75208-4637,Proprietary  ,4,26,30,45,150,195
01301600,OGLE SCHOOL HAIR SKIN NAILS             ,TX,76013-7400,Proprietary  ,67,121,188,469,871,1340
01303912,SOUTH UNIVERSITY - THE ART INSTITUTE OF ,TX,75231-5993,Proprietary  ,119,144,263,1552,1380,2932
01303915,SOUTH UNIVERSITY - AUSTIN               ,TX,78729-8101,Proprietary  ,29,159,188,227,870,1097
01323100,UNIVERSITY OF HOUSTON-VICTORIA          ,TX,77901-5731,Public       ,92,345,437,3109,4482,7591
02058600,CONLEE'S COLLEGE OF COSMETOLOGY         ,TX,78028-0000,Proprietary  ,11,20,31,34,64,98
02074100,CAPITOL CITY TRADE & TECHNICAL SCH      ,TX,78704-0000,Proprietary  ,0,7,7,118,343,461
02077400,NORTH LAKE COLLEGE                      ,TX,75038-0000,Public       ,227,706,933,3442,6441,9883
02081400,ARLINGTON BAPTIST COLLEGE               ,TX,76012-0000,Private      ,18,44,62,290,387,677
02093600,SOUTHWEST SCHOOL OF ELECTRONIC          ,TX,78735-0000,Proprietary  ,0,2,2,32,97,129
02098300,WESTERN TECHNICAL COLLEGE               ,TX,79927-2105,Proprietary  ,101,270,371,1011,1897,2908
02100200,BROOKHAVEN COLLEGE                      ,TX,75244-0000,Public       ,231,681,912,3338,6816,10154
02113610,AMERICAN INTERCONTINENTAL UNIV - HOUSTON,TX,77042-4516,Proprietary  ,31,224,255,257,1415,1672
02116008,SANFORD-BROWN COLLEGE - HOUSTON         ,TX,77042-8900,Proprietary  ,52,175,227,425,1347,1772
02116012,SANFORD-BROWN COLLEGE - HOUSTON NORTH LO,TX,77008-1058,Proprietary  ,0,0,0,57,247,304
02117100,ART INSTITUTE OF HOUSTON                ,TX,77056-0000,Proprietary  ,586,611,1197,4722,5189,9911
02119200,COURT REPORTING INSTITUTE OF DALLAS     ,TX,75247-6913,Proprietary  ,3,39,42,43,377,420
02128302,INSTITUTE FOR BUSINESS & TECHNOLOGY - LA,TX,78230-2520,Proprietary  ,17,84,101,162,450,612
02136800,AMERICAN COMMERCIAL COLLEGE             ,TX,76904-0000,Proprietary  ,3,12,15,40,125,165
02144800,VET TECH INSTITUTE OF HOUSTON           ,TX,77027-9881,Proprietary  ,33,62,95,411,492,903
02176100,PIPO ACADEMY OF HAIR DESIGN             ,TX,79903-0000,Proprietary  ,4,14,18,52,102,154
02218300,SOUTHWEST SCHOOL OF BUSINESS & TECHNICAL,TX,78221-0000,Proprietary  ,12,49,61,124,363,487
02218305,SOUTHWEST SCHOOL OF BUSINESS AND TECHNIC,TX,78501-6053,Proprietary  ,4,22,26,64,137,201
02218306,SOUTHWEST SCHOOL OF BUSINESS AND TECHNIC,TX,78413-2045,Proprietary  ,0,0,0,2,15,17
02224600,TRI-STATE BEAUTY SCHOOL #1              ,TX,79915-0000,Proprietary  ,8,44,52,102,320,422
02230500,OGLE SCHOOL HAIR SKIN NAILS             ,TX,76132-3638,Proprietary  ,61,173,234,422,1093,1515
02230600,OGLE SCHOOL HAIR SKIN NAILS             ,TX,76053-4650,Proprietary  ,26,82,108,234,513,747
02239100,CENTRAL TEXAS BEAUTY COLLEGE #2         ,TX,78664-4204,Proprietary  ,10,45,55,108,349,457
02248200,MILAN INSTITUTE OF COSMETOLOGY          ,TX,79103-0000,Proprietary  ,97,250,347,545,1449,1994
02254800,TEXAS VOCATIONAL SCHOOLS                ,TX,77901-0000,Proprietary  ,7,27,34,37,154,191
02259400,AMBERTON UNIVERSITY                     ,TX,75041-0000,Private      ,6,61,67,48,460,508
02261300,EVEREST INSTITUTE                       ,TX,78213-3841,Proprietary  ,29,139,168,290,1003,1293
02261302,EVEREST INSTITUTE - HOUSTON GREENSPOINT ,TX,77060-3249,Proprietary  ,50,223,273,392,1476,1868
02261303,EVEREST INSTITUTE - HOUSTON HOBBY       ,TX,77087-2737,Proprietary  ,40,192,232,286,995,1281
02267100,EXPOSITO SCHOOL OF HAIR DESIGN          ,TX,79109-0000,Proprietary  ,7,16,23,32,80,112
02276000,FRANKLIN BEAUTY SCHOOL #2               ,TX,77021-0000,Proprietary  ,0,0,0,19,83,102
02285900,UNIVERSITY OF COSMETOLOGY ARTS&SCI      ,TX,78504-0000,Proprietary  ,30,91,121,258,501,759
02294800,CAPITOL CITY CAREERS                    ,TX,78745-0000,Proprietary  ,1,7,8,33,205,238
02298501,EVEREST COLLEGE- FORT WORTH             ,TX,76137-2472,Proprietary  ,17,77,94,183,906,1089
02305300,PARKER COLLEGE OF CHIROPRACTIC          ,TX,75229-0000,Private      ,19,149,168,121,1471,1592
02306700,FORT WORTH BEAUTY SCHOOL                ,TX,76116-3299,Proprietary  ,13,60,73,113,384,497
02306809,SOUTH TEXAS VOCATIONAL TECHNICAL INSTITU,TX,78501-2400,Proprietary  ,42,109,151,277,479,756
02306810,SOUTH TEXAS VOCATIONAL TECHNICAL INSTITU,TX,78416-1141,Proprietary  ,7,40,47,121,432,553
02312200,TEXAS SCHOOL OF BUSINESS                ,TX,77073-6032,Proprietary  ,32,192,224,323,1239,1562
02312202,TEXAS SCHOOL OF BUSINESS - FRIENDSWOOD C,TX,77546-8938,Proprietary  ,11,59,70,64,337,401
02313901,WESTWOOD COLLEGE - DALLAS               ,TX,75243-0000,Proprietary  ,8,53,61,93,516,609
02315400,NORTHEAST TEXAS COMMUNITY COLLEGE       ,TX,75456-0000,Public       ,84,251,335,1761,2465,4226
02318200,"KD STUDIO, ACTOR'S CONSERVATORY         ",TX,75207-2111,Proprietary  ,16,32,48,215,298,513
02320200,HOUSTON GRADUATE SCHOOL OF THEOLOGY     ,TX,77092-0000,Private      ,1,32,33,21,296,317
02326000,SAN ANTONIO BEAUTY COLLEGE NO 3         ,TX,78217-0000,Proprietary  ,14,36,50,100,199,299
02331200,BAPTIST MISSIONARY ASSN THEOL SEM       ,TX,75766-0000,Private      ,2,6,8,22,92,114
02331300,INTERACTIVE LEARNING SYSTEMS            ,TX,77502-1201,Proprietary  ,9,42,51,46,285,331
02331301,INTERACTIVE LEARNING SYSTEMS            ,TX,77081-0000,Proprietary  ,11,150,161,126,793,919
02331304,INTERACTIVE LEARNING SYSTEMS            ,TX,77060-0000,Proprietary  ,5,34,39,40,251,291
02341300,PALO ALTO COLLEGE                       ,TX,78224-0000,Public       ,344,848,1192,6142,7669,13811
02348500,LAMAR STATE COLLEGE-PORT ARTHUR         ,TX,77640-0000,Public       ,76,230,306,1147,2027,3174
02357700,PAUL MITCHELL THE SCHOOL                ,TX,77043-3412,Proprietary  ,37,99,136,397,853,1250
02358200,LAMAR STATE COLLEGE-ORANGE              ,TX,77630-0000,Public       ,78,214,292,1001,2088,3089
02361400,COLLIN COUNTY COMMUNITY COLLEGE         ,TX,75071-0000,Public       ,673,1490,2163,9267,13107,22374
02362000,UNIVERSAL TECHNICAL INSTITUTE           ,TX,77073-0000,Proprietary  ,757,1223,1980,6858,6067,12925
02362800,AUSTIN GRADUATE SCHOOL OF THEOLOGY      ,TX,78752-1333,Private      ,3,24,27,18,127,145
02521200,ARLINGTON CAREER INSTITUTE              ,TX,75050-0000,Proprietary  ,11,57,68,67,419,486
02521800,SEGUIN BEAUTY SCHOOL                    ,TX,78155-0000,Proprietary  ,12,10,22,52,87,139
02527500,HOUSTON TRAINING SCHOOLS                ,TX,77029-0000,Proprietary  ,21,165,186,200,1056,1256
02530700,SEBRING CAREER SCHOOLS                  ,TX,77083-1510,Proprietary  ,4,31,35,24,143,167
02548800,SOUTH TEXAS VO-TECH INSTITUTE           ,TX,78596-0000,Proprietary  ,24,46,70,194,321,515
02548802,SOUTH TEXAS VOCATIONAL TECHNICAL INSTITU,TX,78520-8710,Proprietary  ,26,44,70,213,267,480
02555400,UNIV OF TX MD ANDERSON CANCER CTR       ,TX,77030-0000,Public       ,16,55,71,284,851,1135
02567200,OFFICE CAREER CENTER                    ,TX,76180-0000,Proprietary  ,0,0,0,0,1,1
02568100,TEXAS BARBER COLLEGE                    ,TX,77063-3949,Proprietary  ,13,86,99,115,560,675
02568101,TEXAS BARBER COLLEGES & HAIRSTYLING SCHO,TX,75228-3841,Proprietary  ,11,75,86,98,377,475
02568106,TEXAS BARBER COLLEGES & HAIRSTYLING SCHO,TX,77009-0000,Proprietary  ,10,65,75,89,433,522
02568107,TEXAS BARBER COLLEGES & HAIRSTYLING SCHO,TX,77063-3951,Proprietary  ,10,57,67,77,430,507
02568108,TEXAS BARBER COLLEGES & HAIRSTYLING SCHO,TX,75241-1327,Proprietary  ,17,77,94,131,461,592
02568109,TEXAS BARBER COLLEGES & HAIRSTYLING SCHO,TX,77301-4407,Proprietary  ,4,13,17,19,86,105
02569300,LE CORDON BLEU COLLEGE OF CULINARY ARTS ,TX,78758-3647,Proprietary  ,129,429,558,1287,2871,4158
02572000,COMPUTER CAREER CENTER                  ,TX,79925-2021,Proprietary  ,59,224,283,557,1572,2129
02572004,COMPUTER CAREER CENTER - AMARILLO CAMPUS,TX,79101-2404,Proprietary  ,18,60,78,111,476,587
02572005,COMPUTER CAREER CENTER - LUBBOCK CAMPUS ,TX,79414-3517,Proprietary  ,22,100,122,140,585,725
02572008,VISTA COLLEGE - BEAUMONT                ,TX,77701-3717,Proprietary  ,23,124,147,190,843,1033
02572009,VISTA COLLEGE - LONGVIEW                ,TX,75604-1905,Proprietary  ,16,149,165,138,839,977
02572011,VISTA COLLEGE - KILLEEN                 ,TX,76541-7436,Proprietary  ,25,231,256,196,1416,1612
02572012,VISTA COLLEGE - COLLEGE STATION         ,TX,77840-5107,Proprietary  ,28,145,173,79,304,383
02591100,CAREER POINT COLLEGE                    ,TX,78201-2027,Proprietary  ,73,617,690,443,3075,3518
02591900,KAPLAN COLLEGE                          ,TX,79907-1525,Proprietary  ,45,174,219,498,1173,1671
02591905,KAPLAN COLLEGE - BROWNSVILLE            ,TX,78521-9905,Proprietary  ,35,56,91,231,460,691
02596500,ATI CAREER TRAINING CENTER              ,TX,76180-1599,Proprietary  ,3,17,20,14,67,81
02596503,ATI- CAREER TRAINING CENTER - HOUSTON (#,TX,77029-1978,Proprietary  ,7,46,53,39,206,245
02596600,ATI-CAREER TRAINING CENTER              ,TX,75220-4443,Proprietary  ,7,44,51,34,182,216
02596601,ATI CAREER TRAINING CENTER - RICHARDSON ,TX,75081-1948,Proprietary  ,3,14,17,18,66,84
02596602,ATI CAREER TRAINING CENTER - DALLAS (STE,TX,75247-6103,Proprietary  ,10,87,97,74,329,403
02600200,OCEAN CORPORATION (THE)                 ,TX,77099-3479,Proprietary  ,29,199,228,183,941,1124
02604700,CENTER FOR ADVANCED LEGAL STUDIES       ,TX,77098-4151,Proprietary  ,6,95,101,50,626,676
02606202,EVEREST COLLEGE - EVEREST INSTITUTE - BI,TX,77036-8014,Proprietary  ,52,215,267,442,1614,2056
02615000,SANFORD-BROWN COLLEGE                   ,TX,75247-6931,Proprietary  ,40,140,180,311,1254,1565
03009400,SW SCH BUS & TECH CAREERS               ,TX,78212-2840,Proprietary  ,4,23,27,55,175,230
03010604,VIRGINIA COLLEGE - VIRGINIA COLLEGE AT A,TX,78723-0000,Proprietary  ,12,79,91,152,682,834
03011800,UNIVERSITY OF COSMETOLOGY ARTS & SCIENCE,TX,78226-1194,Proprietary  ,18,31,49,88,189,277
03019800,PCI HEALTH TRAINING CENTER              ,TX,75247-4720,Proprietary  ,27,112,139,203,739,942
03019801,PCI HEALTH TRAINING CENTER - RICHARDSON ,TX,75081-2321,Proprietary  ,25,44,69,155,281,436
03021500,SW SCH BUS & TECH CAREERS               ,TX,78852-4859,Proprietary  ,19,32,51,188,238,426
03025000,TEXAS COLLEGE OF COSMETOLOGY            ,TX,79605-2001,Proprietary  ,14,61,75,115,327,442
03025001,TEXAS COLLEGE OF COSMETOLOGY - SAN ANGEL,TX,76903-4708,Proprietary  ,7,21,28,63,113,176
03026500,REMINGTON COLLEGE - HOUSTON CAMPUS      ,TX,77082-1849,Private      ,241,1006,1247,2004,6954,8958
03026501,REMINGTON COLLEGE - NORTH HOUSTON CAMPUS,TX,77067-1849,Private      ,24,110,134,236,834,1070
03026506,REMINGTON COLLEGE - FT. WORTH CAMPUS    ,TX,76112-1280,Private      ,31,148,179,323,1148,1471
03028800,CIRCLE J BEAUTY SCHOOL                  ,TX,77587-3714,Proprietary  ,2,26,28,47,235,282
03030608,UTAH COLLEGE OF MASSAGE THERAPY - TEXAS ,TX,75801-4848,Proprietary  ,29,70,99,142,277,419
03030609,UTAH COLLEGE OF MASSAGE THERAPY - TEXAS ,TX,77040-6307,Proprietary  ,25,83,108,167,517,684
03031408,INTERNATIONAL ACADEMY OF DESIGN & TECHNO,TX,78229-2263,Proprietary  ,21,78,99,236,594,830
03032300,SCHOOL OF AUTOMOTIVE MACHINISTS         ,TX,77055-1803,Proprietary  ,31,54,85,196,369,565
03035200,TINT SCHOOL OF MAKEUP & COSMETOLOGY     ,TX,75229-3734,Proprietary  ,17,74,91,148,446,594
03035300,SOUTHERN CAREERS INSTITUTE              ,TX,78704-5252,Proprietary  ,215,751,966,1081,3583,4664
03035301,SOUTHERN CAREERS INSTITUTE-PHARR        ,TX,78577-2118,Proprietary  ,32,89,121,157,444,601
03035302,SOUTHERN CAREERS INSTITUTE - CORPUS CHRI,TX,78414-2904,Proprietary  ,31,174,205,166,660,826
03035303,SOUTHERN CAREERS INSTITUTE - SAN ANTONIO,TX,78221-4351,Proprietary  ,10,36,46,94,247,341
03035305,SOUTHERN CAREERS INSTITUTE - BROWNSVILLE,TX,78520-8680,Proprietary  ,9,18,27,130,144,274
03035306,SOUTHERN CAREERS INSTITUTE - HARLINGEN  ,TX,78550-7911,Proprietary  ,9,24,33,105,170,275
03035308,SOUTHERN CAREERS INSTITUTE - SAN ANTONIO,TX,78238-4114,Proprietary  ,30,113,143,226,808,1034
03061800,STAR COLLEGE OF COSMETOLOGY             ,TX,75702-8214,Proprietary  ,9,57,66,123,279,402
03064600,UNIVERSITY OF TEXAS AT BROWNSVILLE      ,TX,78520-4993,Public       ,374,631,1005,9578,7960,17538
03073402,ITT TECHNICAL INSTITUTE                 ,TX,75080-2208,Proprietary  ,0,1,1,0,2,2
03075400,ICC TECHNICAL INSTITUTE                 ,TX,77004-2930,Private      ,0,0,0,80,191,271
03076403,BRYMAN SCHOOL OF ARIZONA (THE) - ANTHEM ,TX,75038-4201,Proprietary  ,0,0,0,48,157,205
03103400,SOUTH TEXAS COLLEGE                     ,TX,78501-6699,Public       ,1476,1287,2763,16336,12569,28905
03108700,ROYAL BEAUTY CAREERS                    ,TX,77069-4611,Proprietary  ,16,67,83,130,488,618
03115800,KAPLAN COLLEGE                          ,TX,78238-4203,Proprietary  ,31,185,216,281,1226,1507
03115802,KAPLAN COLLEGE - LAREDO                 ,TX,78041-6181,Proprietary  ,27,61,88,241,397,638
03115803,KAPLAN COLLEGE - BEAUMONT               ,TX,77706-3706,Proprietary  ,14,78,92,155,621,776
03115804,KAPLAN COLLEGE - LUBBOCK                ,TX,79401-2601,Proprietary  ,15,70,85,137,502,639
03128100,COLLEGE OF HEALTH CARE PROFESSIONS (THE),TX,77092-8108,Proprietary  ,89,521,610,855,3314,4169
03144300,NATIONAL BEAUTY COLLEGE                 ,TX,75043-4046,Proprietary  ,5,15,20,31,91,122
03153300,AMER COLL OF ACUPUNCTURE & O.M.         ,TX,77063-4104,Proprietary  ,4,27,31,26,200,226
03156400,AOMA                                    ,TX,78745-1479,Proprietary  ,6,37,43,67,359,426
03159300,ARLINGTON MEDICAL INSTITUTE             ,TX,76006-2317,Proprietary  ,22,69,91,175,455,630
03170300,TEXAS A&M UNIVERSITY-TEXARKANA          ,TX,75503-5518,Public       ,79,234,313,1499,2310,3809
03179500,TEXAS HEALTH AND SCIENCE UNIVERSITY     ,TX,78704-6748,Proprietary  ,25,89,114,373,625,998
03237400,FARIS TECHNICAL INSTITUTE               ,TX,77627-3829,Proprietary  ,1,1,2,3,13,16
03272300,KAPLAN COLLEGE                          ,TX,75234-7288,Proprietary  ,42,267,309,349,1773,2122
03272301,KAPLAN COLLEGE - MIDLAND                ,TX,79703-5531,Proprietary  ,0,0,0,1,14,15
03272303,KAPLAN COLLEGE - ARLINGTON              ,TX,76010-8121,Proprietary  ,32,175,207,255,1045,1300
03275300,TOUCH OF CLASS SCHOOL OF COSM           ,TX,75402-6314,Proprietary  ,7,24,31,58,144,202
03276300,ACADEMY OF HAIR DESIGN                  ,TX,75901-4900,Proprietary  ,7,30,37,87,257,344
03277300,ACADEMY OF HAIR DESIGN                  ,TX,77701-4650,Proprietary  ,2,22,24,37,181,218
03303300,NORTHWEST EDUCATIONAL CENTER            ,TX,77092-7055,Proprietary  ,7,86,93,59,381,440
03371300,TONI&GUY HAIRDRESSING ACADEMY           ,TX,75006-2351,Proprietary  ,24,38,62,148,228,376
03372300,NORTHWEST VISTA COLLEGE                 ,TX,78251-4217,Public       ,687,1213,1900,10745,11335,22080
03396500,TEXAS STATE TECHNICAL COLG/MARSHALL     ,TX,75672-7402,Public       ,44,84,128,487,650,1137
03400300,CAREER QUEST                            ,TX,78229-3539,Proprietary  ,16,100,116,110,611,721
03412300,ADVANCED BARBER COLLEGE & HAIR DESI     ,TX,78596-0000,Proprietary  ,12,32,44,108,216,324
03416500,DALLAS NURSING INSTITUTE                ,TX,75243-5502,Private      ,34,184,218,367,1499,1866
03422300,MILAN INSTITUTE                         ,TX,78238-3327,Proprietary  ,125,371,496,730,1887,2617
03422400,COLLEGE OF BIBLICAL STUDIES-HOUSTON     ,TX,77036-3211,Private      ,15,135,150,125,1206,1331
03424400,MEDVANCE INSTITUTE                      ,TX,77057-7386,Proprietary  ,24,111,135,221,856,1077
03426300,COLLEGE OF HEALTH CARE PROFESSIONS (THE),TX,78752-3630,Proprietary  ,31,156,187,284,930,1214
03480304,MEDVANCE INSTITUTE OF BATON ROUGE - GRAN,TX,75050-2342,Proprietary  ,8,47,55,64,327,391
03520300,LUBBOCK HAIR ACADEMY                    ,TX,79410-3524,Proprietary  ,8,25,33,45,136,181
03542300,CONCORDE CAREER INSTITUTE               ,TX,76011-4016,Proprietary  ,32,190,222,313,1568,1881
03556400,KUSSAD INSTITUTE OF COURT REPORTING     ,TX,78704-5712,Proprietary  ,1,3,4,8,48,56
03573300,AVIATION INSTITUTE OF MAINTENANCE       ,TX,75062-6303,Proprietary  ,37,116,153,176,590,766
03610300,MJ'S BEAUTY ACADEMY INC                 ,TX,75224-0000,Proprietary  ,2,45,47,77,276,353
03612400,VALLEY GRANDE INSTITUTE FOR ACADEMI     ,TX,78596-0000,Private      ,10,53,63,135,379,514
03627300,LAMAR INSTITUTE OF TECHNOLOGY           ,TX,77705-4142,Public       ,118,351,469,2089,3226,5315
03680300,JAY'S TECHNICAL INSTITUTE               ,TX,77031-3509,Proprietary  ,4,48,52,26,198,224
03682400,DALLAS BARBER & STYLIST COLLEGE         ,TX,75231-0000,Proprietary  ,20,119,139,160,791,951
03714300,TREND BARBER COLLEGE                    ,TX,77071-2104,Proprietary  ,13,70,83,96,443,539
03723300,CULINARY INST ALAIN & MARIE LENOTRE     ,TX,77022-4322,Proprietary  ,42,110,152,327,781,1108
03727600,AUGUSTE ESCOFFIER SCHOOL OF CULINARY ART,TX,78752-0000,Proprietary  ,68,73,141,364,488,852
03733300,BAPTIST UNIVERSITY OF THE AMERICAS      ,TX,78224-1336,Private      ,13,38,51,133,381,514
03756300,ANAMARC COLLEGE                         ,TX,79930-6230,Proprietary  ,0,0,0,255,930,1185
03922300,SOUTH TEXAS BARBER COLLEGE              ,TX,78415-3463,Proprietary  ,6,25,31,56,125,181
03944400,PROFESSIONAL CAREERS INSTITUTE          ,TX,77036-2252,Proprietary  ,6,17,23,28,187,215
03944401,PROFESSIONAL CAREERS INSTITUTE          ,TX,77090-3914,Proprietary  ,6,33,39,29,230,259
03970300,HANDS ON THERAPY                        ,TX,75149-2294,Proprietary  ,8,35,43,34,145,179
03987300,TEXAS HEALTH SCHOOL                     ,TX,77079-2106,Proprietary  ,22,110,132,296,768,1064
04036300,SOUTHEAST TEXAS CAREER INSTITUTE        ,TX,77656-8601,Proprietary  ,13,37,50,54,184,238
04045300,NORTHWEST BEAUTY SCHOOL                 ,TX,77091-1208,Proprietary  ,12,37,49,75,242,317
04045400,MAI-TRIX BEAUTY COLLEGE                 ,TX,77040-0000,Proprietary  ,6,29,35,42,214,256
04082300,PROFESSIONAL CAREER TRAINING INSTITUTE  ,TX,77090-0000,Proprietary  ,14,71,85,52,341,393
04089400,CCI TRAINING CENTER                     ,TX,76011-4857,Proprietary  ,10,45,55,47,329,376
04117900,CHAMPION BEAUTY COLLEGE                 ,TX,77069-4611,Proprietary  ,14,57,71,102,408,510
04121800,CRISWELL COLLEGE                        ,TX,75246-1537,Private      ,7,41,48,149,444,593
04125400,ACADEMY AT AUSTIN (THE)                 ,TX,78660-3287,Proprietary  ,11,25,36,96,183,279
04125500,MANUEL AND THERESA'S SCHOOL OF HAIR DESI,TX,77803-3236,Proprietary  ,5,16,21,40,91,131
04129800,MEDIATECH INSTITUTE DALLAS              ,TX,75039-3105,Proprietary  ,20,52,72,163,351,514
04129801,MEDIATECH INSTITUTE - AUSTIN            ,TX,78704-8933,Proprietary  ,16,23,39,105,187,292
04129802,MEDIATECH INSTITUTE - HOUSTON           ,TX,77042-4712,Proprietary  ,8,59,67,121,280,401
04131700,SOUTHWEST CAREER COLLEGE                ,TX,79925-6230,Proprietary  ,109,310,419,1105,2061,3166
04135600,CANNON INSTITUTE OF HIGHER LEARNING     ,TX,75247-9998,Proprietary  ,1,18,19,13,94,107
04136500,PCCENTER                                ,TX,75115-4214,Proprietary  ,4,14,18,34,87,121
04138500,CARDIOTECH ULTRASOUND SCHOOL            ,TX,77099-1440,Proprietary  ,12,76,88,103,611,714
04142300,AVEDA INSTITUTE SAN ANTONIO             ,TX,78215-1260,Proprietary  ,45,91,136,328,623,951
04146700,AVIATION INSTITUTE OF MAINTENANCE       ,TX,77061-4004,Proprietary  ,28,95,123,172,523,695
04146800,SOUTH TEXAS TRAINING CENTER             ,TX,78586-7721,Proprietary  ,7,27,34,43,167,210
04152700,ASTRODOME CAREER CENTERS                ,TX,77054-2678,Proprietary  ,8,38,46,53,234,287
04154800,DUVALL'S SCHOOL OF COSMETOLOGY          ,TX,76021-4159,Proprietary  ,3,19,22,39,96,135
04155800,ADVANCED BEAUTY COLLEGE                 ,TX,75061-1918,Proprietary  ,1,33,34,20,134,154
04158500,TEXAS BEAUTY COLLEGE                    ,TX,76117-3201,Proprietary  ,2,15,17,10,47,57
04160700,AVENUE FIVE INSTITUTE                   ,TX,78757-7000,Proprietary  ,17,75,92,156,392,548
04165800,SALON PROFESSIONAL ACADEMY (THE)        ,TX,75067-2348,Proprietary  ,4,15,19,50,129,179
04168700,LAWYER'S ASSISTANT SCHOOL OF DALLAS     ,TX,75201-2829,Proprietary  ,12,70,82,78,444,522
04168800,ABC BEAUTY ACADEMY                      ,TX,75042-8682,Proprietary  ,5,22,27,30,105,135
04169000,SALON & SPA INSTITUTE                   ,TX,78521-1727,Proprietary  ,9,13,22,60,98,158
04169100,DIAMONDS COSMETOLOGY COLLEGE            ,TX,75090-2657,Proprietary  ,4,19,23,29,119,148
04177900,BUCKNER BARBER SCHOOL                   ,TX,75217-1775,Proprietary  ,12,33,45,67,207,274
04178200,VOGUE COLLEGE - SAN ANTONIO             ,TX,78201-5035,Proprietary  ,9,32,41,65,221,286
04178300,VOGUE BEAUTY ACADEMY                    ,TX,78238-4402,Proprietary  ,17,34,51,99,226,325
04178400,VOGUE COLLEGE - MCALLEN                 ,TX,78501-1945,Proprietary  ,9,46,55,108,220,328
04179500,NORTH AMERICAN UNIVERSITY               ,TX,77038-1221,Private      ,13,29,42,275,290,565
04184800,EXCEL LEARNING CENTER                   ,TX,79907-1400,Proprietary  ,9,48,57,78,323,401
04187800,CYBERTEX INSTITUTE OF TECHNOLOGY        ,TX,78752-3825,Proprietary  ,10,103,113,85,400,485
04193000,RGV CAREERS AN INSTITUTE FOR HIGHER LEAR,TX,78577-2106,Proprietary  ,9,47,56,51,306,357
04205200,WADE GORDON HAIRDRESSING ACADEMY        ,TX,79121-0548,Proprietary  ,13,26,39,59,165,224
04206501,MYCOMPUTERCAREER.COM - DALLAS           ,TX,75062-8173,Proprietary  ,7,135,142,27,393,420
04206502,MYCOMPUTERCAREER.COM - HOUSTON          ,TX,77056-6764,Proprietary  ,5,135,140,55,503,558
04207300,SCHOOL FOR ALLIED HEALTH PROFESSIONALS  ,TX,76018-4104,Proprietary  ,0,15,15,47,240,287
04213300,SPA PROFESSIONALS ACADEMY (THE)         ,TX,78504-2569,Proprietary  ,7,26,33,46,136,182
04215000,TOTAL TRANSFORMATION INSTITUTE OF COSMET,TX,78666-8115,Proprietary  ,6,11,17,51,79,130
04215400,GRACE SCHOOL OF THEOLOGY                ,TX,77384-4894,Private      ,0,16,16,12,100,112
04219700,GEMINI SCHOOL OF VISUAL ARTS & COMMUNICA,TX,78613-2642,Proprietary  ,2,9,11,24,29,53
04224100,COSMETOLOGY ACADEMY OF TEXARKANA        ,TX,75503-4855,Proprietary  ,10,37,47,97,248,345
04226400,MT TRAINING CENTER                      ,TX,75051-3542,Proprietary  ,2,29,31,20,173,193
04229000,BARBER INSTITUTE OF TEXAS               ,TX,75602-3456,Proprietary  ,4,16,20,18,77,95
04229500,TEXAS A&M UNIVERSITY - CENTRAL TEXAS    ,TX,76549-5901,Public       ,173,528,701,990,4109,5099
04231200,NEECEE'S COLLEGE OF COSMETOLOGY         ,TX,79605-4735,Proprietary  ,1,23,24,19,102,121
04231300,YAHWEH BEAUTY ACADEMY                   ,TX,76543-4153,Proprietary  ,4,39,43,24,227,251
04231900,ALAMO CITY BARBER COLLEGE               ,TX,78250-3227,Proprietary  ,19,56,75,150,394,544
04232400,EXCEL LEARNING CENTER - SAN ANTONIO     ,TX,78230-4823,Proprietary  ,7,72,79,19,210,229
04232900,PREPARING PEOPLE BARBER STYLING COLLEGE ,TX,75215-2415,Proprietary  ,6,37,43,20,146,166
04235900,BELLA COSMETOLOGY COLLEGE               ,TX,75494-2408,Proprietary  ,3,15,18,8,49,57
04236900,K&G 5 STAR BARBER COLLEGE               ,TX,77591-3689,Proprietary  ,1,19,20,5,40,45
04238200,LAREDO CHI ACADEMY BEAUTY SCHOOL        ,TX,78041-6540,Proprietary  ,9,17,26,9,17,26
00367000,BRIGHAM YOUNG UNIVERSITY                ,UT,84602-8406,Private      ,1643,1070,2713,14951,13683,28634
00367100,DIXIE STATE COLLEGE OF UTAH             ,UT,84770-3876,Public       ,509,437,946,6351,4790,11141
00367200,LDS BUSINESS COLLEGE                    ,UT,84101-3500,Private      ,199,195,394,1209,1386,2595
00367400,STEVENS HENAGER COLLEGE                 ,UT,84401-1420,Proprietary  ,440,3301,3741,1828,16204,18032
00367500,UNIVERSITY OF UTAH                      ,UT,84112-9055,Public       ,1111,1338,2449,15739,17994,33733
00367700,UTAH STATE UNIVERSITY                   ,UT,84322-1400,Public       ,1317,1260,2577,14193,14020,28213
00367800,SOUTHERN UTAH UNIVERSITY                ,UT,84720-2470,Public       ,437,398,835,5573,3824,9397
00367900,SNOW COLLEGE                            ,UT,84627-1299,Public       ,339,199,538,3468,1330,4798
00368000,WEBER STATE UNIVERSITY                  ,UT,84408-1136,Public       ,818,1384,2202,8516,13610,22126
00368100,WESTMINSTER COLLEGE                     ,UT,84105-3697,Private      ,162,216,378,2686,2028,4714
00402700,UTAH VALLEY UNIVERSITY                  ,UT,84058-5999,Public       ,1466,1919,3385,11855,17934,29789
00522000,SALT LAKE COMMUNITY COLLEGE             ,UT,84123-0000,Public       ,1197,2361,3558,9901,18967,28868
00732953,ITT TECHNICAL INSTITUTE                 ,UT,84123-2500,Proprietary  ,61,265,326,388,1900,2288
00943300,SHERMAN KENDALL'S ACADEMY OF BEAUTY     ,UT,84106-1836,Proprietary  ,3,21,24,34,96,130
01009800,NEUMONT UNIVERSITY                      ,UT,84095-0000,Proprietary  ,42,16,58,790,141,931
01116500,UINTAH BASIN APPLIED TECHNOLOGY CLG     ,UT,84066-0000,Public       ,4,26,30,54,147,201
01116600,BROADVIEW UNIVERSITY                    ,UT,84088-4021,Proprietary  ,43,146,189,381,1191,1572
02078800,SHERMAN KENDALL'S ACADEMY OF BEAUTY     ,UT,84047-0000,Proprietary  ,7,11,18,29,40,69
02115400,BRIDGERLAND APPLIED TECHNOLOGY COLLEGE  ,UT,84321-0000,Public       ,57,134,191,442,952,1394
02156600,DAVIS APPLIED TECHNOLOGY COLLEGE        ,UT,84037-0000,Public       ,70,286,356,543,1782,2325
02178500,EAGLE GATE COLLEGE                      ,UT,84123-0000,Proprietary  ,26,166,192,171,1088,1259
02270800,AMERITECH COLLEGE                       ,UT,84604-6927,Proprietary  ,26,91,117,144,891,1035
02270802,AMERITECH COLLEGE - DRAPER              ,UT,84020-6545,Proprietary  ,13,54,67,86,624,710
02298500,EVEREST COLLEGE                         ,UT,84119-2668,Proprietary  ,9,84,93,137,724,861
02346500,OGDEN-WEBER APPLIED TECHNOLOGY COLG     ,UT,84404-0000,Public       ,74,301,375,627,2278,2905
02360800,PROVO COLLEGE                           ,UT,84601-0000,Proprietary  ,37,113,150,253,718,971
02531800,PAUL MITCHELL THE SCHOOL - PROVO        ,UT,84606-0000,Proprietary  ,18,22,40,118,121,239
02556800,PAUL MITCHELL THE SCHOOL                ,UT,84117-7204,Proprietary  ,36,73,109,197,430,627
02556801,PAUL MITCHELL THE SCHOOL                ,UT,84780-0000,Proprietary  ,12,17,29,84,127,211
02572700,EVANS HAIRSTYLING COLLEGE               ,UT,84770-0000,Proprietary  ,5,3,8,50,35,85
02572800,VISTA COLLEGE                           ,UT,84015-0000,Proprietary  ,5,89,94,39,497,536
02573100,EVANS HAIRSTYLING COLLEGE OF CEDAR CITY ,UT,84720-0000,Proprietary  ,2,12,14,45,59,104
02612200,MARINELLO SCHOOL OF BEAUTY              ,UT,84604-1585,Proprietary  ,6,11,17,57,109,166
03030600,UTAH COLLEGE OF MASSAGE THERAPY         ,UT,84111-1606,Proprietary  ,31,89,120,209,483,692
03030601,UTAH CLG OF MASSAGE THER-PROVO CMPS     ,UT,84042-0000,Proprietary  ,10,23,33,58,105,163
03082100,MYOTHERAPY COLLEGE OF UTAH              ,UT,84115-2522,Proprietary  ,2,25,27,20,133,153
03108200,FRANCOIS D. COLLEGE OF HAIR SKIN & NAILS,UT,84070-2004,Proprietary  ,2,9,11,22,57,79
03110400,HAIRITAGE HAIR ACADEMY                  ,UT,84770-5233,Proprietary  ,2,7,9,41,57,98
03339400,WESTERN GOVERNORS UNIVERSITY            ,UT,84107-2533,Private      ,247,10543,10790,2086,71762,73848
03413300,MOUNTAINLAND APPLIED TECHNOLOGY COLLEGE ,UT,84043-0000,Public       ,41,97,138,331,783,1114
03463300,CAREERS UNLIMITED                       ,UT,84058-0000,Proprietary  ,4,18,22,57,187,244
03467308,MARINELLO SCHOOL OF BEAUTY - OGDEN      ,UT,84405-1501,Proprietary  ,7,31,38,64,200,264
03467309,MARINELLO SCHOOL OF BEAUTY - LAYTON     ,UT,84041-3002,Proprietary  ,7,25,32,54,164,218
03617300,HEALING MOUNTAIN MASSAGE SCHOOL         ,UT,84102-4006,Proprietary  ,5,36,41,45,204,249
03829500,SKINWORKS SCHOOL OF ADVANCED SKINCARE   ,UT,84115-0000,Proprietary  ,4,20,24,34,133,167
03838300,NIGHTINGALE COLL. SCH. OF NURSING SCH. O,UT,84403-0000,Proprietary  ,8,66,74,44,426,470
03909300,PAUL MITCHELL THE SCHOOL LOGAN          ,UT,84323-4679,Proprietary  ,11,19,30,68,104,172
03921300,CAMEO COLLEGE OF ESSENTIAL BEAUTY       ,UT,84115-0000,Proprietary  ,18,70,88,110,352,462
04054300,SOUTHWEST APPLIED TECHNOLOGY COLLEGE    ,UT,84720-6608,Public       ,7,47,54,104,280,384
04072300,AVEDA INSTITUTE PROVO                   ,UT,84604-1008,Proprietary  ,17,21,38,118,130,248
04121700,DIXIE APPLIED TECHNOLOGY COLLEGE        ,UT,84770-3025,Public       ,41,90,131,270,443,713
04145500,SKIN SCIENCE INSTITUTE (THE)            ,UT,84115-0000,Proprietary  ,12,30,42,58,186,244
04153000,RENAISSANCE ACADEMIE                    ,UT,84604-0000,Proprietary  ,8,11,19,40,88,128
04161900,MANDALYN ACADEMY                        ,UT,84003-2161,Proprietary  ,3,15,18,34,81,115
04165500,ACAYDIA SCHOOL OF AESTHETICS            ,UT,84601-0000,Proprietary  ,9,14,23,55,65,120
04169900,AMERICAN BEAUTY ACADEMY                 ,UT,84651-0000,Proprietary  ,2,10,12,15,53,68
04173200,TAYLOR ANDREWS ACADEMY OF HAIR DESIGN   ,UT,84088-6577,Proprietary  ,16,30,46,99,163,262
04173201,TAYLOR ANDREWS ACADEMY -  OREM          ,UT,84004-1872,Proprietary  ,15,30,45,79,114,193
04183000,TOP NAILS & HAIR BEAUTY SCHOOL          ,UT,84118-0000,Proprietary  ,6,36,42,15,100,115
04184200,TAYLOR ANDREWS ACADEMY-ST. GEORGE       ,UT,84790-2139,Proprietary  ,19,26,45,92,128,220
04192700,BARBER SCHOOL (THE)                     ,UT,84047-3723,Proprietary  ,10,35,45,35,161,196
04193200,ROCKY MOUNTAIN UNIVERSITY OF HEALTH PROF,UT,84606-7312,Proprietary  ,2,90,92,31,480,511
04210300,MEDSPA ACADEMIES                        ,UT,84095-3519,Proprietary  ,13,41,54,60,213,273
04211500,BEAUTIFUL YOU SCHOOL OF NAIL TECHNOLOGY ,UT,84720-8360,Proprietary  ,2,7,9,13,35,48
04215700,COLE HOLLAND COLLEGE                    ,UT,84102-2959,Proprietary  ,2,8,10,2,8,10
04216800,BONNIE JOSEPH ACADEMY OF COSMETOLOGY & B,UT,84032-2044,Proprietary  ,0,3,3,2,28,30
04218300,MIDWIVES COLLEGE OF UTAH                ,UT,84106-2671,Private      ,1,55,56,22,356,378
00368200,BENNINGTON COLLEGE                      ,VT,05201-6001,Private      ,28,10,38,1032,224,1256
00368300,CASTLETON STATE COLLEGE                 ,VT,05735-0000,Public       ,74,27,101,3072,518,3590
00368400,CHAMPLAIN COLLEGE                       ,VT,05401-3950,Private      ,280,166,446,4656,1503,6159
00368500,COLLEGE OF ST JOSEPH                    ,VT,05701-3899,Private      ,6,19,25,245,212,457
00368600,GODDARD COLLEGE                         ,VT,05667-0000,Private      ,5,65,70,76,774,850
00368700,GREEN MOUNTAIN COLLEGE                  ,VT,05764-1199,Private      ,19,26,45,921,298,1219
00368800,JOHNSON STATE COLLEGE                   ,VT,05656-9898,Public       ,37,66,103,1392,959,2351
00368900,LYNDON STATE COLLEGE                    ,VT,05851-0919,Public       ,43,23,66,1896,363,2259
00369000,MARLBORO COLLEGE                        ,VT,05344-0300,Private      ,14,13,27,325,141,466
00369100,MIDDLEBURY COLLEGE                      ,VT,05753-0000,Private      ,102,31,133,4127,555,4682
00369200,NORWICH UNIVERSITY                      ,VT,05663-1035,Private      ,79,229,308,3236,1606,4842
00369300,SOUTHERN VERMONT COLLEGE                ,VT,05201-6002,Private      ,11,7,18,606,174,780
00369400,ST MICHAELS COLLEGE                     ,VT,05439-0001,Private      ,88,19,107,3955,233,4188
00369600,UNIVERSITY OF VERMONT                   ,VT,05405-0160,Public       ,469,139,608,19564,3275,22839
00369700,VERMONT COLLEGE OF FINE ARTS            ,VT,05602-3128,Private      ,1,37,38,18,425,443
00369800,VERMONT TECHNICAL COLLEGE               ,VT,05061-0000,Public       ,32,43,75,1109,896,2005
00857500,SALON PROFESSIONAL ACADEMY (THE)        ,VT,05495-4001,Proprietary  ,0,0,0,13,22,35
00865800,O'BRIENS AVEDA INSTITUTE                ,VT,05403-7747,Proprietary  ,10,27,37,72,124,196
00886000,SIT                                     ,VT,05301-4801,Private      ,7,21,28,310,535,845
01116700,COMMUNITY COLLEGE OF VERMONT            ,VT,05676-0000,Public       ,114,451,565,1732,4270,6002
01193400,VERMONT LAW SCHOOL                      ,VT,05068-0000,Private      ,0,27,27,6,931,937
01218300,BURLINGTON COLLEGE                      ,VT,05401-8477,Private      ,14,15,29,282,197,479
02143500,STERLING COLLEGE                        ,VT,05827-0000,Private      ,10,6,16,136,61,197
02254000,NEW ENGLAND CULINARY INSTITUTE          ,VT,05602-0000,Proprietary  ,22,30,52,355,212,567
02532600,LANDMARK COLLEGE                        ,VT,05346-0000,Private      ,20,7,27,538,135,673
04146900,ADVANCED WELDING INSTITUTE              ,VT,05403-0000,Proprietary  ,6,9,15,48,68,116
00392800,CASPER COLLEGE                          ,WY,82601-4612,Public       ,69,175,244,1379,1676,3055
00392900,EASTERN WYOMING COLLEGE                 ,WY,82240-1603,Public       ,15,56,71,519,398,917
00393000,SHERIDAN COLLEGE                        ,WY,82801-9133,Public       ,66,128,194,1056,1123,2179
00393100,NORTHWEST COLLEGE                       ,WY,82435-1895,Public       ,30,70,100,911,555,1466
00393200,UNIVERSITY OF WYOMING                   ,WY,82071-2000,Public       ,286,333,619,7501,4928,12429
00393300,WESTERN WYOMING COMMUNITY COLLEGE       ,WY,82902-0000,Public       ,59,146,205,985,1152,2137
00728900,CENTRAL WYOMING COLLEGE                 ,WY,82501-0000,Public       ,28,93,121,537,801,1338
00915700,WYOTECH                                 ,WY,82072-9519,Proprietary  ,89,88,177,1163,773,1936
00925900,LARAMIE COUNTY COMMUNITY CLG            ,WY,82007-3299,Public       ,95,316,411,1717,2505,4222
02211900,CHEEKS INTERNATIONAL ACDMY              ,WY,82001-0000,Proprietary  ,7,15,22,47,132,179
00393500,UNIV OF GUAM                            ,GU,96923-0000,Public       ,183,170,353,2780,1907,4687
01536100,GUAM COMMUNITY COLLEGE                  ,GU,96921-0000,Public       ,161,209,370,1896,1773,3669
03438300,PACIFIC ISLANDS UNIVERSITY              ,GU,96913-2619,Private      ,11,13,24,101,106,207
00393600,PONTIFICAL CATHOLIC UNIV OF PR          ,PR,00717-0777,Private      ,81,204,285,6598,4968,11566
00393700,UNIVERSITY OF THE SACRED HEART          ,PR,00914-0383,Private      ,54,124,178,3553,2187,5740
00393800,INTER-AMER UNIV PR-CNTRL ADMN           ,PR,00936-0000,Private      ,108,434,542,3542,5501,9043
00393801,INTER-AMER UNIV PR SCHL LAW             ,PR,00936-8351,Private      ,1,11,12,32,368,400
00393802,INTER AMERICAN UNIVERSITY OF PUERTO RICO,PR,00926-0000,Private      ,22,84,106,1047,1089,2136
00393803,INTER AMERICAN UNIVERSITY OF PR         ,PR,00683-0000,Private      ,75,111,186,3904,1864,5768
00393804,INTER-AMER UNIV PR-RECINTO AGUADILA     ,PR,00605-2000,Private      ,77,112,189,3354,1944,5298
00393805,INTER-AMER UNIV PR-ARECIBO CAMPUS       ,PR,00614-4050,Private      ,46,120,166,3340,2268,5608
00393806,INTER-AMER UNIV PR-BARRANQUITAS REG     ,PR,00794-0517,Private      ,34,66,100,1715,792,2507
00393807,INTER-AMER UNIV PR-FAJARDO REGIONAL     ,PR,00738-0000,Private      ,28,77,105,1527,1086,2613
00393808,INTER-AMER UNIV PR - GUAYAMA CAMPUS     ,PR,00785-4004,Private      ,20,52,72,1308,1167,2475
00393809,INTER-AMER UNIV PR-PONCE REGIONAL       ,PR,00715-0000,Private      ,57,146,203,3995,2699,6694
00393811,INTER-AMER UNIV PR-BAYAMON REG CLG      ,PR,00959-0000,Private      ,74,108,182,4220,1683,5903
00394100,UNIVERSIDAD DEL ESTE                    ,PR,00984-2010,Private      ,206,579,785,7499,7741,15240
00394200,UNIVERSITY OF PR-CENTRAL ADMINISTRATION ,PR,00936-4984,Public       ,5,21,26,403,215,618
00394300,UNIVERSITY OF PUERTO RICO - HUMACAO UNIV,PR,00791-4300,Public       ,15,17,32,3190,426,3616
00394400,UNIVERSITY OF PUERTO RICO - MAYAGUEZ    ,PR,00680-0000,Public       ,95,74,169,8943,1928,10871
00501900,UNIV ADVENTISTA DE LAS ANTILLAS         ,PR,00681-0118,Private      ,20,43,63,967,612,1579
00502200,BAYAMON CENTRAL UNIVERSITY              ,PR,00960-0000,Private      ,30,100,130,1089,1129,2218
00710800,UNIVERSITY OF PUERTO RICO - RIO PIEDRAS ,PR,00931-3300,Public       ,130,120,250,9475,3128,12603
00720600,UNIVERSITY OF PUERTO RICO - CAYEY UNIVER,PR,00736-5534,Public       ,25,16,41,3463,393,3856
00722800,UNIVERSITY OF PUERTO RICO - ARECIBO     ,PR,00614-4010,Public       ,33,23,56,3787,552,4339
00890200,COLUMBIA CENTRO UNIVERSITARIO           ,PR,00726-0000,Proprietary  ,107,176,283,1377,1284,2661
00965200,"UNIVERSITY OF PUERTO RICO, PONCE TECH UN",PR,00716-0000,Public       ,28,21,49,3356,486,3842
01056700,COLEGIO TECNOLOGICO DE SAN JUAN         ,PR,00918-2973,Public       ,21,48,69,751,836,1587
01072400,CARLOS ALBIZU UNIVERSITY                ,PR,00902-3711,Private      ,5,67,72,146,1083,1229
01081900,CONSERVATORIO DE MUSICA DE PUERTO RICO  ,PR,00907-3373,Public       ,11,4,15,350,107,457
01092200,UNIVERSITY OF PUERTO RICO - UTUADO      ,PR,00641-2500,Public       ,11,8,19,1520,207,1727
01097500,UNIVERSITY OF PUERTO RICO BAYAMON TECHNI,PR,00959-1911,Public       ,41,25,66,4531,611,5142
01120300,RYDER MEMORIAL HOSP SCH OF NURSING      ,PR,00792-0000,Private      ,0,2,2,20,21,41
01171900,UNIVERSIDAD DEL TURABO                  ,PR,00778-0000,Private      ,163,680,843,8753,10281,19034
01194000,ICPR JUNIOR COLLEGE                     ,PR,00919-0000,Proprietary  ,85,143,228,1464,1724,3188
01194100,AMERICAN UNIVERSITY OF PUERTO RICO      ,PR,00960-2037,Private      ,31,46,77,619,481,1100
01194101,AMERICAN UNIVERSITY OF PUERTO RICO      ,PR,00674-0000,Private      ,43,48,91,696,489,1185
01212300,"UNIVERSITY OF PUERTO RICO, AGUADILLA REG",PR,00604-0160,Public       ,41,28,69,2876,467,3343
01252500,CARIBBEAN UNIVERSITY                    ,PR,00960-0493,Private      ,51,116,167,2437,2597,5034
02063100,MBTI BUSINESS TRNG INSTITUTE            ,PR,00907-3917,Proprietary  ,192,575,767,1281,3624,4905
02100000,POLYTECHNIC UNIVERSITY OF PR            ,PR,00917-0000,Private      ,60,189,249,2264,2223,4487
02163300,UNIVERSIDAD CENTRAL DEL CARIBE          ,PR,00960-0000,Private      ,9,30,39,193,444,637
02165100,EDP COLLEGE OF PUERTO RICO              ,PR,00919-0000,Private      ,64,248,312,1095,1788,2883
02166000,CENTER FOR ADVANCED STUDIES OF PUER     ,PR,00902-0000,Private      ,0,37,37,6,241,247
02166400,INSTITUTO DE BANCA Y COMERCIO           ,PR,00925-0000,Proprietary  ,900,1470,2370,7544,10043,17587
02170300,INST EDUC TECNIA OCUP LA REINA          ,PR,00674-0000,Proprietary  ,16,22,38,239,218,457
02189100,CENTRO DE ESTUDIOS MULTIDISCIPLIN       ,PR,00926-0000,Proprietary  ,5,10,15,1378,1427,2805
02189300,EMMA'S BEAUTY ACADEMY                   ,PR,00680-0000,Proprietary  ,18,18,36,247,116,363
02195400,MODERN HAIRSTYLING INSTITUTE            ,PR,00961-0000,Proprietary  ,39,66,105,630,394,1024
02195500,MODERN HAIRSTYLING INSTITUTE            ,PR,00612-0000,Proprietary  ,0,1,1,2,7,9
02195800,LICEO E ARTE Y TECNOLGIA                ,PR,00919-0000,Proprietary  ,59,94,153,901,763,1664
02195900,MODERN HAIRSTYLING INSTITUTE            ,PR,00980-0000,Proprietary  ,1,1,2,9,9,18
02234900,ANTILLES SCHOOL OF TECH CAREERS         ,PR,00909-3006,Proprietary  ,48,135,183,323,527,850
02241901,COMMONWEALTH OF PR DEPT OF EDUC - CARLOS,PR,00986-0000,Public       ,0,0,0,10,5,15
02241902,COMMONWEALTH OF PR DEPT OF EDUC - TOMAS ,PR,00613-0000,Public       ,0,0,0,3,3,6
02241904,COMMONWEALTH OF PR DEPT OF EDUC - ITPR R,PR,00655-0000,Public       ,12,17,29,456,310,766
02241905,COMMONWEALTH OF PR DEPT OF EDUC - JOSE A,PR,00674-0000,Public       ,0,0,0,25,10,35
02241907,COMMONWEALTH OF PR DEPT OF EDUC - ITPR R,PR,00928-0000,Public       ,13,16,29,415,232,647
02241908,COMMONWEALTH OF PR DEPT OF EDUC - ITPR R,PR,00732-0000,Public       ,8,27,35,376,251,627
02241909,COMMONWEALTH OF PR DEPT OF EDUC - TROQUE,PR,00959-0000,Public       ,1,1,2,67,20,87
02241910,COMMONWEALTH OF PR DEPT OF EDUC - ITPR R,PR,00701-1091,Public       ,3,3,6,579,227,806
02260600,NATIONAL COLLEGE OF BUSINESS & TECH     ,PR,00960-2036,Proprietary  ,278,1149,1427,4385,9638,14023
02260800,HUERTAS COLLEGE                         ,PR,00726-0000,Proprietary  ,40,79,119,844,884,1728
02297700,AUTOMECA TECHNICAL COLLEGE              ,PR,00957-0000,Proprietary  ,94,93,187,1251,878,2129
02303800,AMERICAN EDUCATIONAL COLLEGE            ,PR,00961-0000,Proprietary  ,101,114,215,424,567,991
02335500,COLEGIO BIBLICO PENTECOSTAL DE PR       ,PR,00978-0000,Private      ,1,15,16,24,210,234
02340600,HUMACAO COMMUNITY COLLEGE               ,PR,00792-0000,Private      ,9,31,40,369,443,812
02343600,INSTITUTE OF BEAUTY CAREERS             ,PR,00613-0000,Proprietary  ,41,51,92,320,271,591
02460000,UNIVERSITY OF PUERTO RICO - MEDICAL SCIE,PR,00936-0000,Public       ,7,29,36,657,1413,2070
02482400,PONCE SCHOOL OF MEDICINE AND HEALTH SCIE,PR,00716-2347,Private      ,3,7,10,71,785,856
02502400,SERBIA'S SCHOOL OF BEAUTY CULTURE       ,PR,00785-0000,Proprietary  ,0,0,0,45,67,112
02504500,INSTITUCION CHAVIANO DE MAYAGUEZ        ,PR,00708-0000,Proprietary  ,3,9,12,16,26,42
02505400,ATLANTIC COLLEGE                        ,PR,00970-0000,Private      ,34,38,72,1279,405,1684
02534900,PONCE PARAMEDICAL COLLEGE (POPAC)       ,PR,00731-0000,Proprietary  ,113,138,251,1520,1212,2732
02552300,COLEGIO MAYOR DE TECHNOLOGIA            ,PR,00714-0000,Proprietary  ,18,41,59,161,191,352
02562500,INTERNATIONAL TECHNICAL COLLEGE         ,PR,00918-0000,Proprietary  ,13,18,31,55,112,167
02563500,ROGIES SCHOOL OF BEAUTY CULTURE         ,PR,00910-0000,Proprietary  ,0,0,0,3,4,7
02569400,ESCUELA DE ARTES PLASTICAS              ,PR,00902-1112,Public       ,7,9,16,458,146,604
02570400,EDUCATIONAL TECHNICAL COLLEGE           ,PR,00925-3404,Proprietary  ,48,88,136,494,746,1240
02576100,ESCUELA TECNICA DE ELECTRICIDAD         ,PR,00731-0000,Proprietary  ,15,40,55,241,291,532
02587500,UNIVERSIDAD METROPOLITANA               ,PR,00928-0000,Private      ,177,655,832,7000,8733,15733
02588600,SEMINARIO EVANGELICO DE PUERTO RICO     ,PR,00925-0000,Private      ,0,13,13,1,74,75
02593700,HISPANIC AMERICAN COLLEGE               ,PR,00725-0000,Proprietary  ,26,89,115,207,337,544
03016000,UNIVERSITY OF PUERTO RICO CAROLINA REGIO,PR,00985-0000,Public       ,59,47,106,3713,678,4391
03021900,EDIC COLLEGE                            ,PR,00726-0000,Proprietary  ,115,134,249,1295,1304,2599
03025500,MECH TECH COLLEGE                       ,PR,00725-6118,Proprietary  ,185,193,378,2758,1755,4513
03025900,"LICEO DE ARTE, DISENOS Y COMERCIO       ",PR,00726-0000,Proprietary  ,18,50,68,200,380,580
03029700,"UNIVERSAL TECHNOLOGY CLG OF PR, INC     ",PR,00605-0000,Private      ,19,53,72,514,821,1335
03061900,COLEGIO TECHNOLOGICO Y COMERCIAL        ,PR,00602-0960,Proprietary  ,3,7,10,38,44,82
03068400,STAR BEAUTY ACADEMY                     ,PR,00961-6312,Proprietary  ,16,14,30,44,43,87
03070500,D'MART INSTITUTE                        ,PR,00794-3517,Proprietary  ,74,71,145,621,702,1323
03075600,EMMA'S BEAUTY ACADEMY                   ,PR,00795-0000,Proprietary  ,50,44,94,282,153,435
03085700,PROFESSIONAL TECHNICAL INSTITUTION      ,PR,00960-7061,Proprietary  ,43,44,87,267,270,537
03104400,PROFESSIONAL ELECTRIC SCHOOL            ,PR,00674-1797,Proprietary  ,3,13,16,43,48,91
03106900,ESCUELA DE PERITOS ELECTRICITAS         ,PR,00662-0457,Proprietary  ,1,5,6,47,49,96
03112100,JOHN DEWEY COLLEGE                      ,PR,00915-9538,Private      ,104,248,352,1417,2823,4240
03112101,JOHN DEWEY COLLEGE                      ,PR,00986-0000,Private      ,19,60,79,306,551,857
03112102,JOHN DEWEY COLLEGE-BAYAMON CAMPUS       ,PR,00959-0000,Private      ,5,26,31,119,255,374
03112104,JOHN DEWEY COLLEGE - YABUCOA LRNING SITE,PR,00767-0767,Private      ,0,0,0,1,2,3
03112105,JOHN DEWEY COLLEGE - FAJARDO BRANCH     ,PR,00738-0738,Private      ,9,38,47,150,339,489
03112106,JOHN DEWEY COLLEGE - ARROYO BRANCH      ,PR,00714-0714,Private      ,4,12,16,62,129,191
03112107,JOHN DEWEY COLLEGE - JUANA DIAZ BRANCH  ,PR,00795-0000,Private      ,9,14,23,207,254,461
03112108,JOHN DEWEY COLLEGE - HATILLO CAMPUS     ,PR,00659-0000,Private      ,4,5,9,66,105,171
03112109,JOHN DEWEY COLLEGE - MANATI             ,PR,00674-0000,Private      ,33,47,80,338,447,785
03112110,DEWEY UNIVERSITY - MAYAGUEZ             ,PR,00682-0000,Private      ,6,12,18,51,70,121
03115900,TRINITY COLLEGE OF PUERTO RICO          ,PR,00734-0000,Private      ,13,24,37,141,202,343
03122500,ACADEMIA SERRANT INC.                   ,PR,00717-1568,Proprietary  ,48,80,128,231,277,508
03123100,GLOBELLE TECHNICAL INSTITUTE            ,PR,00693-4218,Proprietary  ,1,4,5,56,57,113
03124200,NOVA COLLEGE DE PUERTO RICO             ,PR,00960-4016,Proprietary  ,20,46,66,127,233,360
03157600,"COLEGIO DE CINEMATOGRAFIA, ARTES Y TELEV",PR,00961-6345,Proprietary  ,45,25,70,720,380,1100
03177300,SAN JUAN BAUTISTA SCH OF MEDICINE       ,PR,00726-0000,Private      ,0,8,8,31,349,380
03336300,CENTURY COLLEGE                         ,PR,00603-0000,Proprietary  ,9,20,29,122,172,294
03414300,MONTECLARO                              ,PR,00745-9612,Private      ,0,5,5,13,27,40
03452300,INSTITUTO PRE-VOCACIONAL E INDUSTRI     ,PR,00613-1800,Private      ,15,17,32,77,185,262
03469300,IVAEM COLLEGE                           ,PR,00725-0000,Proprietary  ,1,2,3,88,57,145
03531300,UNIVERSIDAD PENTECOSTAL MIZPA           ,PR,00928-0966,Private      ,0,9,9,34,308,342
03544300,ATENAS COLLEGE                          ,PR,00674-0000,Private      ,39,51,90,1037,738,1775
03552300,LESTON COLLEGE                          ,PR,00961-6309,Proprietary  ,35,39,74,107,113,220
03608300,CARIBBEAN FORENSIC & TECHNICAL COLL     ,PR,00926-0000,Proprietary  ,4,19,23,30,72,102
03638300,ROSSLYN TRAINING ACADEMY OF COSMETOLOGY ,PR,00602-3225,Proprietary  ,0,1,1,16,40,56
03735400,"CHARLIES GUARD,DETECTIVE BUREAU&ACA     ",PR,00605-0000,Proprietary  ,10,13,23,34,48,82
03751300,ESCUELA HOTELERA DE SAN JUAN            ,PR,00917-0091,Proprietary  ,63,73,136,766,477,1243
03758300,BAYAMON COMMUNITY COLLEGE               ,PR,00960-0000,Proprietary  ,14,62,76,78,336,414
03781400,INDUSTRIAL TECHNICAL COLLEGE            ,PR,00792-0000,Proprietary  ,13,19,32,125,185,310
03785300,J.G. GUAYNABO TECHNICAL COLLEGE         ,PR,00960-0000,Proprietary  ,3,18,21,26,71,97
03800300,COLEGIO TECNICO DE ELECTRICIDAD GALLOSA ,PR,00602-0000,Proprietary  ,0,3,3,24,29,53
03800400,INSTITUTE OF BEAUTY OCCUPATIONS AND TECH,PR,00676-5071,Proprietary  ,23,33,56,117,163,280
03843300,ADVANCED TECH COLLEGE                   ,PR,00961-6321,Proprietary  ,1,3,4,9,20,29
03849300,AGUADILLA TECHNICAL COLLEGE             ,PR,00603-0000,Proprietary  ,7,9,16,60,92,152
03965400,MYRANGEL BEAUTY INSTITUTE               ,PR,00754-3917,Proprietary  ,33,46,79,135,168,303
04107300,CARIB TECHNOLOGICAL INSTITUTE           ,PR,00960-0000,Proprietary  ,56,39,95,206,188,394
04117200,INSTITUTO EDUCATIVO PREMIER             ,PR,00731-0000,Proprietary  ,16,40,56,218,259,477
04131600,LIBERTY TECHNICAL COLLEGE               ,PR,00737-1298,Proprietary  ,17,23,40,86,128,214
04164300,GLOBAL INSTITUTE                        ,PR,00725-6485,Proprietary  ,9,12,21,22,31,53
04176000,AMERICAN TECHNICAL INSTITUTE            ,PR,00957-0000,Proprietary  ,3,3,6,29,49,78
04240900,PPG TECHNICAL COLLEGE                   ,PR,00726-3164,Proprietary  ,30,20,50,30,20,50
00394600,UNIVERSITY OF THE VIRGIN ISLANDS        ,VI,00802-9990,Public       ,54,55,109,1223,792,2015
00394601,UNIV OF THE VIRGIN ISLANDS-ST CROIX     ,VI,00850-0000,Public       ,30,47,77,530,720,1250
00667700,MCGILL UNIVERSITY                       ,CN,00000-0000,Public       ,48,13,61,1573,389,1962
00667900,QUEEN'S UNIVERSITY AT KINGSTON          ,CN,00000-0000,Public       ,1,2,3,94,38,132
00668100,ST FRANCIS XAVIER UNIVERSITY            ,CN,00000-0000,Public       ,2,0,2,36,4,40
00668200,ST THOMAS UNIVERSITY                    ,CN,00000-0000,Public       ,1,1,2,34,5,39
00668300,UNIVERSITY OF GUELPH                    ,CN,00000-0000,Public       ,2,2,4,34,77,111
00668400,UNIVERSITY OF MANITOBA                  ,CN,00000-0000,Public       ,3,4,7,76,53,129
00668500,UNIVERSITY OF NEW BRUNSWICK (THE)       ,CN,00000-0000,Public       ,0,1,1,35,14,49
00668600,UNIVERSITY OF OTTAWA                    ,CN,00000-0000,Public       ,2,3,5,57,66,123
00668800,UNIVERSITY OF TORONTO                   ,CN,00000-0000,Public       ,31,24,55,497,374,871
00668900,UNIVERSITY OF WINDSOR                   ,CN,00000-0000,Public       ,3,2,5,35,43,78
00683700,UNIVERSITE LAVAL                        ,CN,00000-0000,Public       ,2,2,4,10,29,39
00683800,DALHOUSIE UNIVERSITY                    ,CN,00000-0000,Public       ,8,4,12,123,77,200
00683805,DALHOUSIE UNIVERSITY - AGRICULTURAL CAMP,CN,00000-0000,Public       ,0,0,0,4,2,6
00685200,BISHOP'S UNIVERSITY                     ,CN,00000-0000,Private      ,2,0,2,59,6,65
00685300,MCMASTER UNIVERSITY                     ,CN,00000-0000,Public       ,0,0,0,35,30,65
00767900,YORK UNIVERSITY                         ,CN,00000-0000,Public       ,4,8,12,80,90,170
00787400,UNIVERSITY AT CALGARY (THE)             ,CN,00000-0000,Public       ,2,9,11,47,75,122
00814800,UNIVERSITY OF WINNIPEG                  ,CN,00000-0000,Public       ,0,1,1,23,16,39
00836200,UNIVERSITY OF ALBERTA (THE)             ,CN,00000-0000,Public       ,0,0,0,31,12,43
00836300,MOUNT SAINT VINCENT UNIVERSITY          ,CN,00000-0000,Public       ,0,0,0,8,6,14
00836400,SAINT MARY'S UNIVERSITY                 ,CN,00000-0000,Public       ,0,0,0,24,18,42
00836500,CONCORDIA UNIVERSITY - SIR GEORGE W     ,CN,00000-0000,Public       ,7,12,19,315,160,475
00836600,UNIVERSITE DE MONTREAL                  ,CN,00000-0000,Public       ,2,10,12,28,71,99
00836800,CARLETON UNIVERSITY                     ,CN,00000-0000,Public       ,1,3,4,63,54,117
00836900,UNIVERSITY OF BRITISH COLUMBIA          ,CN,00000-0000,Public       ,43,24,67,924,517,1441
00837000,"SAFA, UNIVERSITY OF VICTORIA            ",CN,00000-0000,Public       ,7,9,16,167,84,251
00844400,SIMON FRASER UNIVERSITY                 ,CN,00000-0000,Public       ,4,7,11,153,98,251
00844600,UNIVERSITY OF WESTERN ONTARIO (THE)     ,CN,00000-0000,Public       ,5,4,9,62,69,131
00844800,UNIVERSITY OF REGINA                    ,CN,00000-0000,Public       ,0,0,0,6,3,9
00844900,ACADIA UNIVERSITY                       ,CN,00000-0000,Public       ,1,5,6,51,23,74
00852600,UNIVERSITY OF WATERLOO                  ,CN,00000-0000,Public       ,1,0,1,68,24,92
00858200,WILFRID LAURIER UNIVERSITY              ,CN,00000-0000,Public       ,1,1,2,14,13,27
00891300,LAKEHEAD UNIVERSITY                     ,CN,00000-0000,Public       ,0,1,1,11,9,20
00936700,UNIVERSITY OF PRINCE EDWARD ISLAND      ,CN,00000-0000,Public       ,0,0,0,26,104,130
00942100,BRANDON UNIVERSITY                      ,CN,00000-0000,Public       ,2,2,4,18,21,39
00948600,TRINITY WESTERN UNIVERSITY              ,CN,00000-0000,Private      ,2,3,5,113,40,153
00950000,MEMORIAL UNIVERSITY OF NEWFOUNDLAND     ,CN,00000-0000,Public       ,3,3,6,38,41,79
00950100,UNIVERSITY OF KING'S COLLEGE            ,CN,00000-0000,Public       ,0,0,0,18,3,21
00950300,MOUNT ALLISON UNIVERSITY                ,CN,00000-0000,Public       ,3,0,3,45,2,47
00950500,TRENT UNIVERSITY                        ,CN,00000-0000,Public       ,0,0,0,9,5,14
00969800,MEDICINE HAT COLLEGE                    ,CN,00000-0000,Public       ,0,2,2,4,3,7
01012300,NOVA SCOTIA COLLEGE OF ART & DESIGN     ,CN,00000-0000,Public       ,1,0,1,12,5,17
01022100,SAINT PAUL UNIVERSITY                   ,CN,00000-0000,Public       ,0,1,1,2,13,15
01045800,SHERIDAN COLLEGE OF APPLIED ARTS AN     ,CN,00000-0000,Public       ,6,3,9,78,29,107
01067500,REGENT COLLEGE                          ,CN,00000-0000,Private      ,1,5,6,6,79,85
01070300,UNIVERSITY OF LETHBRIDGE                ,CN,00000-0000,Public       ,1,1,2,9,6,15
01072000,RYERSON UNIVERSITY                      ,CN,00000-0000,Public       ,2,5,7,68,49,117
01172200,BRIERCREST BIBLE COLLEGE                ,CN,00000-0000,Private      ,0,0,0,8,5,13
01222800,HUMBER COLLEGE INSTITUTE OF TECHNOLOGY A,CN,00000-0000,Public       ,2,5,7,44,57,101
01227400,PROVIDENCE COLLEGE                      ,CN,00000-0000,Private      ,0,0,0,26,6,32
02102100,KINGSWOOD UNIVERSITY                    ,CN,00000-0000,Private      ,0,0,0,44,13,57
02167000,PRAIRIE BIBLE INST                      ,CN,00000-0000,Private      ,1,2,3,23,7,30
02184600,INSTITUTE FOR CHRISTIAN STUDIES         ,CN,00000-0000,Private      ,0,0,0,2,4,6
02195700,TAYLOR UNIVERSITY COLLEGE AND SEMINARY  ,CN,00000-0000,Private      ,0,0,0,0,2,2
02201100,COLUMBIA BIBLE COLLEGE                  ,CN,00000-0000,Private      ,0,0,0,13,9,22
02216400,TYNDALE COLLEGE & SEMINARY              ,CN,00000-0000,Private      ,2,2,4,10,11,21
02219200,UNIVERSITY OF SASKATCHEWAN              ,CN,00000-0000,Public       ,2,2,4,23,19,42
02324900,EMMANUEL BIBLE COLLEGE                  ,CN,00000-0000,Private      ,0,0,0,2,4,6
02338800,EMILY CARR UNIVERSITY OF ART AND DESIGN ,CN,00000-0000,Public       ,4,1,5,54,37,91
02577200,SALVATION ARMY WM & CATHERINE BOOTH     ,CN,00000-0000,Private      ,0,0,0,3,1,4
02593800,CONCORDIA UNIVERSITY COLLEGE            ,CN,00000-0000,Private      ,0,1,1,6,14,20
02611900,THE KING'S UNIVERSITY COLLEGE           ,CN,00000-0000,Private      ,0,0,0,3,5,8
03018300,ROCKY MOUNTAIN COLLEGE: CENTRE FOR BIBLI,CN,00000-0000,Private      ,1,0,1,1,4,5
03033800,UNIVERSITY COLLEGE OF CAPE BRETON       ,CN,00000-0000,Public       ,0,0,0,3,7,10
03078300,VANCOUVER SCHOOL OF THEOLOGY            ,CN,00000-0000,Private      ,0,1,1,4,11,15
03273300,CANADIAN COLLEGE OF NATUROPATHIC ME     ,CN,00000-0000,Private      ,1,3,4,12,39,51
03298300,ALBERTA COLLEGE OF ART & DESIGN         ,CN,00000-0000,Public       ,2,5,7,40,30,70
03332500,KWANTLEN UNIVERSITY COLLEGE             ,CN,00000-0000,Public       ,2,1,3,8,13,21
03335400,CANADIAN UNIVERSITY COLLEGE             ,CN,00000-0000,Private      ,3,2,5,29,18,47
03339300,ST. STEPHENS UNIVERSITY                 ,CN,00000-0000,Private      ,0,0,0,4,2,6
03348500,REDEEMER UNIVERSITY COLLEGE             ,CN,00000-0000,Private      ,1,0,1,13,2,15
03420300,HOLLAND COLLEGE                         ,CN,00000-0000,Public       ,0,2,2,17,14,31
03560400,NIAGARA COLLEGE-WELLAND CAMPUS          ,CN,00000-0000,Public       ,0,4,4,13,20,33
03613300,UNIV OF NORTHERN BRITISH COLUMBIA       ,CN,00000-0000,Public       ,2,1,3,12,14,26
03644400,CANADIAN MENNONITE UNIVERSITY           ,CN,00000-0000,Private      ,0,1,1,10,4,14
03674400,CANADIAN SOUTHERN BAPTIST SEMINARY      ,CN,00000-0000,Private      ,0,0,0,1,4,5
03711300,CAPILANO UNIVERSITY                     ,CN,00000-0000,Public       ,0,1,1,21,23,44
03846300,PACIFIC LIFE BIBLE COLLEGE              ,CN,00000-0000,Private      ,1,2,3,17,14,31
03847300,CRANDALL UNIVERSITY                     ,CN,00000-0000,Private      ,0,1,1,3,3,6
04075300,QUEST UNIVERSITY CANADA                 ,CN,00000-0000,Private      ,4,2,6,194,22,216
04123100,ATLANTIC SCHOOL OF THEOLOGY             ,CN,00000-0000,Public       ,0,1,1,2,6,8
04156700,AMBROSE UNIVERSITY COLLEGE              ,CN,00000-0000,Private      ,0,3,3,14,13,27
00814700,UNIVERSIDAD AUTONOMA DE GUADALAJARA     ,MX,00000-0000,Private      ,9,267,276,83,1291,1374
01041800,INST TEC Y DE ESTSUPER DE MONTERRE      ,MX,00000-0000,Private      ,9,8,17,100,69,169
01067600,UNIVERSIDAD DE MONTERREY                ,MX,00000-0000,Private      ,5,5,10,41,32,73
01093800,UNIVERSIDAD DE GUANAJUATO               ,MX,00000-0000,Public       ,0,0,0,16,32,48
01230100,UNIV AUTON DE TAMAULIPAS FAC DEMED      ,MX,00000-0000,Public       ,1,0,1,5,6,11
01302100,"UNIVERSIDAD DEL NORESTE, A.C.           ",MX,00000-0000,Private      ,0,2,2,0,2,2
02053300,CENTRO DE ESTUDIOS UNIVERSITARIOS D     ,MX,00000-0000,Private      ,3,7,10,21,58,79
04183900,CETYS UNIVERSIDAD                       ,MX,00000-0000,Private      ,7,6,13,106,72,178
01001000,AMERICAN SAMOA CMNTY COLLEGE            ,AS,96799-2609,Public       ,40,41,81,1059,372,1431
01034300,COLLEGE OF MICRONESIA - FSM             ,FM,96941-0159,Public       ,287,136,423,2030,854,2884
01100900,PALAU COMMUNITY COLLEGE                 ,PW,96940-0009,Public       ,178,19,197,859,316,1175
03022400,COLLEGE OF THE MARSHALL ISLANDS         ,MH,96960-1258,Public       ,206,95,301,829,368,1197
03033000,NORTHERN MARIANAS COLLEGE               ,MP,96950-0000,Public       ,73,55,128,895,481,1376
